Source,YOB,Age,NPA,Date,freq
SIM,1896,0,na,1896,33
STAT,1868,71,na,1939,12.917470247851888
SIM,1875,18,na,1893,20
STAT,1839,17,35-39,1856,0.003961175396405794
STAT,1876,90,na,1966,2.1387971272717774
STAT,1906,62,na,1968,29.30908426489972
SIM,1867,4,na,1871,22
STAT,1810,57,na,1867,8.839280484545533
SIM,1905,65,na,1970,37
SIM,1859,55,na,1914,18
STAT,1838,30,15-19,1868,0.0014022605126265558
SIM,1863,60,na,1923,8
STAT,1871,18,50-100,1889,4.887082439835856E-4
SIM,1867,74,na,1941,6
SIM,1901,51,na,1952,31
SIM,1910,27,30-34,1937,1
STAT,1784,99,na,1883,0.005077049809401326
SIM,1941,16,na,1957,44
STAT,1917,14,na,1931,41.976107287832534
STAT,1898,31,25-29,1929,0.13873748252737633
STAT,1927,35,35-39,1962,0.029970575701672275
STAT,1934,25,25-29,1959,0.8824597886472276
STAT,1925,27,25-29,1952,0.7725481500515131
SIM,1907,9,na,1916,41
STAT,1925,33,na,1958,44.602983205141285
SIM,1884,2,na,1886,30
STAT,1907,36,20-24,1943,0.0024454538082617685
SIM,1888,68,na,1956,23
STAT,1902,27,30-34,1929,0.3551117881100167
STAT,1855,21,na,1876,17.71389079830798
STAT,1859,35,na,1894,18.90354470305797
STAT,1829,32,15-19,1861,0.0013610098077067117
STAT,1942,24,20-24,1966,1.1565884834402953
SIM,1797,62,na,1859,2
STAT,1913,20,35-39,1933,0.09101762729611035
STAT,1922,26,45-49,1948,0.019472397677540918
SIM,1833,62,na,1895,9
SIM,1924,7,na,1931,55
STAT,1931,24,45-49,1955,0.014437651205303326
STAT,1916,34,20-24,1950,0.024753566191240334
SIM,1876,35,na,1911,29
SIM,1869,23,20-24,1892,3
SIM,1914,26,na,1940,34
STAT,1932,17,15-19,1949,0.59851004804428
STAT,1893,70,na,1963,19.843889050226664
STAT,1815,88,na,1903,0.4900594985177104
STAT,1918,42,30-34,1960,0.0013469765011082328
STAT,1900,19,20-24,1919,0.24451997109825843
STAT,1844,69,na,1913,11.462908814437752
STAT,1923,19,15-19,1942,0.5263792424686045
STAT,1909,44,30-34,1953,0.001174473586939097
STAT,1896,23,15-19,1919,0.04319996651637952
STAT,1909,31,25-29,1940,0.0880633210098539
STAT,1852,88,na,1940,1.174939151440764
SIM,1970,1,na,1971,42
STAT,1907,23,15-19,1930,0.04810741266702989
STAT,1940,30,50-100,1970,0.008505840238060652
STAT,1941,15,15-19,1956,0.4643118722595189
SIM,1858,38,na,1896,25
STAT,1912,41,25-29,1953,6.872705987245493E-4
SIM,1854,24,na,1878,16
STAT,1849,24,40-44,1873,0.0192555942023384
STAT,1826,40,na,1866,19.44595001136467
STAT,1904,22,35-39,1926,0.08361605031199978
SIM,1860,6,na,1866,28
STAT,1801,96,na,1897,0.031118014661740297
STAT,1958,3,na,1961,51.37233838869806
STAT,1855,101,na,1956,0.004798846452887402
SIM,1850,10,na,1860,22
SIM,1825,43,na,1868,18
SIM,1829,57,na,1886,19
STAT,1867,15,45-49,1882,6.466456330145035E-4
STAT,1829,101,na,1930,0.0038759722328591106
STAT,1901,18,25-29,1919,0.07908502690618285
STAT,1929,7,na,1936,50.77027050281898
SIM,1941,5,na,1946,49
STAT,1943,23,25-29,1966,0.9752641103101831
STAT,1867,20,40-44,1887,0.020314040627790443
STAT,1920,18,35-39,1938,0.0465553376453534
SIM,1884,54,na,1938,20
SIM,1953,3,na,1956,51
STAT,1841,48,25-29,1889,5.591435865157762E-4
STAT,1942,13,na,1955,40.744732053592244
SIM,1880,40,na,1920,32
STAT,1838,41,na,1879,19.32973701567593
STAT,1903,26,35-39,1929,0.13765278954257318
STAT,1905,34,45-49,1939,0.014327490004650638
SIM,1884,22,na,1906,22
STAT,1899,18,45-49,1917,8.918788751137015E-4
STAT,1855,22,15-19,1877,0.027135404706784657
STAT,1848,15,35-39,1863,0.004451172519721223
STAT,1809,60,na,1869,13.849718136534102
STAT,1929,43,45-49,1972,0.0021416286711253424
STAT,1827,89,na,1916,0.6366428932733392
STAT,1920,23,30-34,1943,0.3158244193719316
STAT,1922,31,40-44,1953,0.044071354118403926
STAT,1857,30,25-29,1887,0.07876931407867066
SIM,1888,36,na,1924,36
STAT,1904,35,40-44,1939,0.013667181257246162
SIM,1892,73,na,1965,18
SIM,1850,42,na,1892,21
STAT,1910,33,15-19,1943,0.0012262933402446363
STAT,1878,15,20-24,1893,0.1838828656322703
STAT,1912,21,30-34,1933,0.27411456920828176
STAT,1926,36,30-34,1962,0.0221670757040685
SIM,1822,78,na,1900,9
STAT,1934,30,20-24,1964,0.03319924588368011
STAT,1917,46,na,1963,38.11875394800553
STAT,1938,18,20-24,1956,1.3281319669416178
SIM,1902,20,25-29,1922,4
SIM,1950,19,25-29,1969,4
STAT,1944,27,35-39,1971,0.16109049823771124
STAT,1913,32,na,1945,37.31393255515785
STAT,1942,19,25-29,1961,0.4492697740975066
SIM,1929,18,20-24,1947,1
SIM,1930,32,na,1962,49
STAT,1932,20,45-49,1952,0.014791212656016435
STAT,1831,94,na,1925,0.16218576338568635
SIM,1863,17,na,1880,17
STAT,1914,32,45-49,1946,0.015708333901869057
STAT,1950,15,50-100,1965,0.004404875361470204
STAT,1915,25,15-19,1940,0.007186813318102143
STAT,1822,58,na,1880,7.599918211866171
STAT,1910,16,25-29,1926,0.08555237937559859
STAT,1919,41,35-39,1960,0.002166372038371075
STAT,1839,90,na,1929,0.43508653548906057
STAT,1954,14,na,1968,48.266130440057005
STAT,1858,17,45-49,1875,5.80641619222853E-4
STAT,1894,2,na,1896,34.16288154772815
STAT,1944,18,50-100,1962,0.00400135124959055
STAT,1917,30,20-24,1947,0.025513157897508385
STAT,1944,15,40-44,1959,0.014951086472668546
STAT,1877,4,na,1881,29.854014409069666
SIM,1936,31,35-39,1967,1
STAT,1897,52,na,1949,28.441670223981333
STAT,1903,39,40-44,1942,0.013297983293536457
STAT,1922,9,na,1931,45.73376086277042
STAT,1908,35,25-29,1943,0.009257805328917854
STAT,1934,38,30-34,1972,0.02501908735200065
SIM,1887,19,na,1906,25
SIM,1911,23,30-34,1934,2
STAT,1899,23,40-44,1922,0.02843781468878234
SIM,1793,80,na,1873,7
STAT,1917,38,30-34,1955,0.018665355872454308
SIM,1880,72,na,1952,22
SIM,1884,86,na,1970,4
STAT,1905,13,na,1918,37.2140683215086
STAT,1848,20,30-34,1868,0.14229405041325247
STAT,1927,40,30-34,1967,0.001599613967645038
STAT,1839,22,30-34,1861,0.126301508356423
STAT,1871,46,45-49,1917,0.002359601220872046
STAT,1909,27,na,1936,35.6008186625559
STAT,1813,97,na,1910,0.035454410321429417
STAT,1940,22,45-49,1962,0.011380699079550197
SIM,1894,32,na,1926,32
SIM,1804,81,na,1885,5
STAT,1882,49,25-29,1931,5.404805481742811E-4
STAT,1889,33,na,1922,29.093069635514816
STAT,1933,26,20-24,1959,0.2414961459746064
STAT,1927,24,na,1951,44.4821485291754
STAT,1919,49,45-49,1968,0.0023232010865999954
STAT,1885,83,na,1968,7.1151919402283275
STAT,1923,22,45-49,1945,0.013001182099156617
STAT,1864,20,15-19,1884,0.030501964066349453
STAT,1865,49,25-29,1914,5.10106941634002E-4
STAT,1924,23,15-19,1947,0.06221147964813429
SIM,1868,48,na,1916,32
STAT,1913,28,45-49,1941,0.017010010915350857
STAT,1845,43,na,1888,13.582677437841252
SIM,1872,53,na,1925,20
STAT,1908,40,20-24,1948,1.6438647455434835E-4
SIM,1843,40,na,1883,22
STAT,1869,25,20-24,1894,0.11444206912313833
STAT,1912,29,40-44,1941,0.0452476328234835
STAT,1889,65,na,1954,20.69074680290809
STAT,1826,72,na,1898,8.825322895503048
STAT,1837,24,na,1861,13.310056955823052
SIM,1876,67,na,1943,25
STAT,1806,105,na,1911,1.3719697735465022E-4
STAT,1885,51,na,1936,21.36516997681672
STAT,1918,37,35-39,1955,0.0252634170967812
STAT,1913,33,40-44,1946,0.03844616422769347
SIM,1922,45,na,1967,48
STAT,1859,21,45-49,1880,0.006364885211864658
STAT,1927,15,40-44,1942,0.017382927531473025
STAT,1920,43,25-29,1963,7.80723601018325E-4
STAT,1930,40,50-100,1970,0.0015427765620564516
SIM,1922,13,na,1935,52
STAT,1903,43,25-29,1946,6.294094400715143E-4
STAT,1940,19,15-19,1959,0.4572168442439615
SIM,1839,35,na,1874,20
SIM,1901,29,30-34,1930,2
STAT,1930,20,35-39,1950,0.12077630155504201
STAT,1818,53,na,1871,6.36165753797155
STAT,1846,60,na,1906,15.456320197309958
SIM,1835,21,na,1856,22
STAT,1861,33,50-100,1894,0.007672701543886114
SIM,1901,21,20-24,1922,3
STAT,1800,79,na,1879,2.6060623755105454
STAT,1875,17,45-49,1892,6.714775728089031E-4
STAT,1780,85,na,1865,1.5727310297440278
STAT,1876,15,na,1891,25.770390618369643
SIM,1789,75,na,1864,5
STAT,1939,25,na,1964,37.43423928652434
SIM,1926,27,na,1953,46
STAT,1930,28,45-49,1958,0.021854095156284677
STAT,1810,49,35-39,1859,0.0013301451626146984
STAT,1858,22,40-44,1880,0.01819324963674004
STAT,1860,45,30-34,1905,7.948032123113832E-4
STAT,1917,25,25-29,1942,0.6886349000367121
SIM,1848,71,na,1919,16
SIM,1946,18,20-24,1964,2
STAT,1877,32,na,1909,24.632959686438276
STAT,1876,30,35-39,1906,0.10368187967234407
STAT,1935,11,na,1946,54.00700468037703
STAT,1808,54,50-100,1862,1.0081855944945507E-4
STAT,1908,48,30-34,1956,7.997924532834679E-4
STAT,1924,36,20-24,1960,0.003091024430163474
SIM,1938,28,na,1966,37
STAT,1926,44,30-34,1970,0.001561850876311604
STAT,1907,3,na,1910,38.66990847589057
SIM,1934,14,na,1948,52
STAT,1910,21,20-24,1931,1.040977946318901
SIM,1904,48,na,1952,26
STAT,1835,103,na,1938,6.455203050002175E-4
STAT,1851,39,na,1890,19.689704661356867
STAT,1835,76,na,1911,4.261353921788766
STAT,1875,22,40-44,1897,0.021420349725928142
STAT,1891,39,25-29,1930,0.03498256030719855
STAT,1855,30,15-19,1885,0.0010423272480493716
STAT,1902,31,15-19,1933,0.0020164208367675278
SIM,1868,16,na,1884,36
STAT,1858,18,na,1876,20.28365217865467
SIM,1885,71,na,1956,14
STAT,1914,24,45-49,1938,0.011328695818717968
SIM,1881,9,na,1890,27
STAT,1931,21,40-44,1952,0.04354695801186037
SIM,1834,36,na,1870,21
STAT,1904,38,45-49,1942,0.006134812854199378
STAT,1864,20,50-100,1884,0.0037703297376799724
STAT,1942,27,25-29,1969,0.6857882515382239
STAT,1809,103,na,1912,7.940856589956937E-4
STAT,1848,40,25-29,1888,0.004255367243790744
STAT,1922,43,35-39,1965,0.0022907299356777476
SIM,1802,58,na,1860,11
STAT,1846,32,15-19,1878,0.0013638723538363154
STAT,1920,35,25-29,1955,0.010707094207809083
STAT,1930,42,30-34,1972,0.0016742565610590892
STAT,1885,20,35-39,1905,0.05797006073615435
SIM,1826,60,na,1886,13
SIM,1888,23,30-34,1911,3
SIM,1851,91,na,1942,2
STAT,1861,49,40-44,1910,0.0014096556817153197
STAT,1886,9,na,1895,26.91325502180755
STAT,1849,27,45-49,1876,0.01020539152629865
SIM,1891,56,na,1947,31
STAT,1922,23,40-44,1945,0.038157876734375276
STAT,1879,87,na,1966,3.9851384328860315
STAT,1875,73,na,1948,12.209410413741995
STAT,1864,16,30-34,1880,0.01634756984555584
STAT,1913,45,35-39,1958,0.0012537606210740449
STAT,1928,31,35-39,1959,0.11377284706637271
SIM,1821,61,na,1882,8
STAT,1935,37,35-39,1972,0.03367185240544038
STAT,1921,22,35-39,1943,0.10552185525470743
SIM,1898,46,na,1944,29
STAT,1860,0,na,1860,31.550549347401944
STAT,1896,35,na,1931,31.24051188638379
STAT,1812,49,45-49,1861,0.002580947517022839
STAT,1907,19,30-34,1926,0.02318932003085964
STAT,1905,31,40-44,1936,0.0360856386593624
STAT,1829,45,50-100,1874,0.0021513485431788183
STAT,1933,22,50-100,1955,0.00869242944855826
STAT,1910,29,30-34,1939,0.37336774635507
STAT,1892,21,na,1913,29.3062029435078
STAT,1902,22,25-29,1924,0.8072699722777729
STAT,1904,30,35-39,1934,0.14627619856583668
STAT,1948,24,15-19,1972,0.060675377746597696
STAT,1900,5,na,1905,36.3399222898396
SIM,1902,3,na,1905,38
STAT,1829,37,na,1866,18.61559679755001
STAT,1884,34,na,1918,23.179759419115417
STAT,1867,23,45-49,1890,0.006652472590653371
STAT,1903,23,30-34,1926,0.25246061775033274
STAT,1850,27,50-100,1877,0.006702578687693526
STAT,1888,48,na,1936,25.966067112713723
STAT,1881,69,na,1950,13.96431277009673
SIM,1910,22,25-29,1932,1
STAT,1918,45,35-39,1963,0.0013659953341804937
STAT,1923,30,45-49,1953,0.01805854310572689
STAT,1922,34,45-49,1956,0.017563000019985297
SIM,1869,26,25-29,1895,1
STAT,1854,25,50-100,1879,0.004569759550618248
STAT,1841,45,20-24,1886,1.2105265234101117E-4
STAT,1824,48,25-29,1872,7.355524156898428E-4
STAT,1888,21,15-19,1909,0.038668722745932485
SIM,1951,20,20-24,1971,2
SIM,1917,34,na,1951,38
STAT,1925,24,20-24,1949,1.314381991786444
SIM,1913,20,na,1933,44
STAT,1928,39,45-49,1967,0.008555127728255781
STAT,1830,45,45-49,1875,2.4063873478580262E-4
STAT,1838,26,30-34,1864,0.2504176257894321
STAT,1918,17,40-44,1935,0.0030267729718306013
STAT,1880,20,na,1900,25.01812885200471
STAT,1937,15,50-100,1952,0.0036386076953770015
STAT,1852,56,na,1908,17.456171233211958
STAT,1829,40,15-19,1869,1.2558234258049384E-4
STAT,1943,28,30-34,1971,0.41405895449973334
STAT,1933,34,20-24,1967,0.032694736470037275
SIM,1900,34,na,1934,33
STAT,1916,37,25-29,1953,0.009996756795675564
STAT,1814,51,50-100,1865,4.232508980314329E-4
STAT,1943,20,20-24,1963,1.1752251193604177
STAT,1908,27,25-29,1935,0.6242407712532875
STAT,1911,42,20-24,1953,1.6747164430917848E-4
STAT,1896,31,15-19,1927,0.0018782204160304676
SIM,1903,4,na,1907,39
SIM,1933,24,20-24,1957,3
STAT,1933,38,15-19,1971,2.602343585501448E-4
STAT,1921,51,na,1972,40.56872236601237
STAT,1934,7,na,1941,53.83876275300309
STAT,1904,27,40-44,1931,0.042923156083731116
STAT,1903,40,20-24,1943,1.5837513743059532E-4
STAT,1865,6,na,1871,25.552317798509222
STAT,1839,15,na,1854,16.767926886267304
STAT,1935,21,25-29,1956,1.252677937732646
SIM,1943,21,25-29,1964,5
SIM,1897,72,na,1969,36
STAT,1820,48,40-44,1868,0.0014285193092936903
STAT,1872,39,15-19,1911,5.687740862448729E-4
STAT,1900,42,45-49,1942,0.0014394010001484144
STAT,1952,17,40-44,1969,0.016662670083485126
STAT,1909,39,35-39,1948,0.022536701425083343
SIM,1919,25,na,1944,43
STAT,1798,59,na,1857,17.904006189433062
STAT,1879,27,30-34,1906,0.2606351804137845
STAT,1851,104,na,1955,5.631023642339496E-4
STAT,1856,70,na,1926,10.164337442927629
SIM,1915,11,na,1926,40
STAT,1907,44,20-24,1951,1.5913919784582542E-4
STAT,1944,24,30-34,1968,0.3078621086797407
SIM,1842,23,na,1865,28
SIM,1854,56,na,1910,16
STAT,1934,17,25-29,1951,0.5836684812044918
STAT,1864,57,na,1921,18.024840297169877
STAT,1913,41,40-44,1954,0.0024327152623819567
STAT,1860,43,na,1903,18.654015543511804
SIM,1840,75,na,1915,4
SIM,1877,84,na,1961,4
SIM,1909,47,na,1956,33
STAT,1860,22,50-100,1882,0.003417523074537148
SIM,1905,33,na,1938,40
SIM,1846,37,na,1883,15
SIM,1888,7,na,1895,39
STAT,1797,74,na,1871,3.998066915173214
STAT,1872,22,15-19,1894,0.03375463088702181
SIM,1781,79,na,1860,6
STAT,1850,38,25-29,1888,0.025772304550302882
STAT,1858,30,40-44,1888,0.033692505608257595
STAT,1848,23,35-39,1871,0.04562000136808861
STAT,1925,32,20-24,1957,0.02878367881320912
SIM,1847,54,na,1901,15
SIM,1916,49,na,1965,44
STAT,1821,52,40-44,1873,1.4289403155537934E-4
STAT,1871,16,na,1887,25.493080033917547
SIM,1853,39,na,1892,24
SIM,1900,25,20-24,1925,1
SIM,1912,35,na,1947,37
STAT,1869,17,20-24,1886,0.17415779473243884
STAT,1897,15,30-34,1912,0.021264215050242955
STAT,1929,35,45-49,1964,0.008725378349218875
STAT,1889,16,35-39,1905,0.006734519558702047
STAT,1808,75,na,1883,1.6708965114323708
STAT,1785,84,na,1869,3.0434045247906667
SIM,1829,25,na,1854,17
STAT,1789,98,na,1887,0.0038237808327904166
STAT,1917,33,25-29,1950,0.0955004819104727
STAT,1804,61,na,1865,11.064286312151934
SIM,1913,31,40-44,1944,1
STAT,1924,28,20-24,1952,0.2104113156779595
STAT,1926,19,40-44,1945,0.016959470334930244
STAT,1912,37,40-44,1949,0.014496532768143134
STAT,1934,26,na,1960,50.20398316531399
STAT,1889,41,25-29,1930,0.007897706418549928
STAT,1916,29,25-29,1945,0.6699189168576133
STAT,1898,7,na,1905,35.14627742286964
STAT,1868,16,15-19,1884,0.05881761462803369
STAT,1893,30,50-100,1923,0.011645595238839342
STAT,1914,41,35-39,1955,0.001981625996246872
STAT,1930,12,na,1942,50.98636412908122
SIM,1878,21,20-24,1899,1
SIM,1818,73,na,1891,8
STAT,1919,46,40-44,1965,0.0016994563515524738
STAT,1868,50,50-100,1918,1.482564742360579E-4
SIM,1924,29,25-29,1953,1
STAT,1934,33,50-100,1967,0.011233740230105276
SIM,1873,70,na,1943,11
STAT,1950,18,20-24,1968,1.5926233853066247
STAT,1882,46,20-24,1928,1.1532776791830066E-4
STAT,1930,25,40-44,1955,0.059041351038979374
STAT,1860,48,35-39,1908,0.0011238607515306953
STAT,1849,68,na,1917,11.84951081596575
STAT,1911,25,30-34,1936,0.38222723818120563
STAT,1830,77,na,1907,3.105692705729542
SIM,1869,33,na,1902,17
STAT,1816,62,na,1878,6.559626155793004
SIM,1839,67,na,1906,17
STAT,1839,40,50-100,1879,0.006927632729956713
STAT,1936,33,35-39,1969,0.08817077612596835
STAT,1915,17,15-19,1932,0.0941645604320046
STAT,1875,16,50-100,1891,5.048450499791263E-4
STAT,1918,34,30-34,1952,0.1644845227330616
STAT,1899,31,40-44,1930,0.05960938064272467
STAT,1901,35,15-19,1936,1.7120865418210096E-4
STAT,1923,27,15-19,1950,0.008048975670436628
SIM,1862,43,na,1905,21
STAT,1831,38,15-19,1869,5.681992439981086E-4
STAT,1935,29,35-39,1964,0.20354560721045892
STAT,1914,21,40-44,1935,0.03278927269305041
STAT,1917,22,20-24,1939,1.1710513261018647
SIM,1882,30,25-29,1912,2
STAT,1919,30,30-34,1949,0.16986046787549774
STAT,1830,42,40-44,1872,0.012273513711135598
STAT,1918,28,45-49,1946,0.01815507723187441
STAT,1921,38,45-49,1959,0.007544942735723505
STAT,1887,16,25-29,1903,0.06200469106611224
STAT,1940,31,35-39,1971,0.09396152452441679
STAT,1836,18,na,1854,29.590459211059954
SIM,1889,21,na,1910,28
STAT,1840,23,na,1863,21.153354841789625
STAT,1874,39,25-29,1913,0.02891523030104849
STAT,1844,37,na,1881,19.446299963553898
STAT,1914,40,45-49,1954,0.0016468910888356703
STAT,1957,11,na,1968,51.50624882598645
STAT,1944,19,35-39,1963,0.04479945699878863
STAT,1937,21,35-39,1958,0.09114399094721229
SIM,1829,89,na,1918,4
SIM,1899,52,na,1951,28
SIM,1927,12,na,1939,52
STAT,1881,20,15-19,1901,0.03157894706045149
SIM,1786,78,na,1864,14
STAT,1861,92,na,1953,0.3502530449793273
STAT,1873,17,35-39,1890,0.005578685376930161
STAT,1855,26,30-34,1881,0.18614024510532998
STAT,1859,30,35-39,1889,0.08166416143095996
STAT,1828,74,na,1902,7.453439507084182
STAT,1926,28,30-34,1954,0.4653791196091776
STAT,1905,18,50-100,1923,7.052185277342252E-4
STAT,1921,19,40-44,1940,0.015734319334417123
STAT,1910,24,25-29,1934,0.8567404248297458
SIM,1927,30,30-34,1957,1
STAT,1874,30,25-29,1904,0.10474558695878393
STAT,1913,42,30-34,1955,0.0012363044384882623
STAT,1807,48,25-29,1855,0.0012072253138982563
STAT,1906,35,15-19,1941,1.777604193777993E-4
STAT,1857,87,na,1944,1.3189035056176248
STAT,1876,47,na,1923,22.743882435110926
STAT,1853,73,na,1926,7.464802327470635
STAT,1866,27,45-49,1893,0.010225686937663384
STAT,1881,29,15-19,1910,0.0042863210696493315
STAT,1809,92,na,1901,0.23045115470617664
STAT,1919,38,40-44,1957,0.01592673517988481
STAT,1932,38,20-24,1970,0.003523961059309566
STAT,1898,29,50-100,1927,0.008567779518817906
STAT,1920,32,20-24,1952,0.026489847168858056
STAT,1824,36,50-100,1860,0.018266833981297033
STAT,1901,27,15-19,1928,0.006348518951844228
STAT,1842,49,30-34,1891,7.111060595917128E-4
STAT,1867,49,35-39,1916,0.001311771940614937
STAT,1886,22,50-100,1908,0.004229872536935113
STAT,1921,30,35-39,1951,0.10171388405193348
STAT,1937,34,40-44,1971,0.03842265156540487
SIM,1825,75,na,1900,4
STAT,1910,37,30-34,1947,0.017324533348405186
STAT,1804,93,na,1897,0.11346224849259905
STAT,1831,62,na,1893,14.831923209572576
STAT,1832,23,50-100,1855,0.0024703719024045147
STAT,1952,18,30-34,1970,0.1451567970380118
STAT,1940,30,45-49,1970,0.016188534746562924
SIM,1810,45,na,1855,17
STAT,1907,27,30-34,1934,0.36834863045594446
STAT,1864,5,na,1869,25.638652584844255
STAT,1866,20,25-29,1886,0.5392420581656094
STAT,1869,24,50-100,1893,0.003926514588303649
SIM,1814,59,na,1873,20
SIM,1871,36,na,1907,24
STAT,1930,36,45-49,1966,0.008858577278938079
SIM,1883,69,na,1952,4
STAT,1926,20,20-24,1946,1.3511752083618203
STAT,1836,53,50-100,1889,1.445844721078893E-4
SIM,1850,74,na,1924,6
SIM,1925,17,25-29,1942,3
STAT,1937,29,45-49,1966,0.01671777330757239
STAT,1846,40,15-19,1886,1.1621360443842801E-4
STAT,1924,43,45-49,1967,0.0019636437675458873
STAT,1930,17,40-44,1947,0.01799861219615935
STAT,1909,35,40-44,1944,0.0142238170916494
STAT,1933,37,25-29,1970,0.013356413632698537
STAT,1829,69,na,1898,9.96831798487815
STAT,1888,25,30-34,1913,0.29627164441857345
STAT,1917,49,35-39,1966,0.0013266182878944144
STAT,1833,38,25-29,1871,0.02637523572751826
STAT,1828,34,50-100,1862,0.0040518601091259826
STAT,1905,43,35-39,1948,0.0018017173700773045
SIM,1899,31,na,1930,28
STAT,1863,72,na,1935,11.181641338217096
STAT,1878,35,50-100,1913,0.012795811906085542
STAT,1915,20,45-49,1935,0.011130541234299131
STAT,1937,0,na,1937,43.55098353085786
STAT,1924,38,50-100,1962,0.004913673820115815
STAT,1912,47,na,1959,35.030611352969586
STAT,1932,25,15-19,1957,0.00921710155242696
STAT,1928,30,na,1958,47.11252164820317
STAT,1900,14,na,1914,35.69525443071702
STAT,1950,4,na,1954,46.379376223999216
SIM,1846,69,na,1915,4
SIM,1909,21,25-29,1930,1
SIM,1940,4,na,1944,37
STAT,1921,8,na,1929,45.1080408781963
STAT,1904,28,na,1932,34.07589832019405
STAT,1867,86,na,1953,2.1232675768678875
STAT,1910,35,na,1945,36.10139461891508
STAT,1913,4,na,1917,40.78821246624961
STAT,1914,49,na,1963,35.92135786056059
STAT,1825,55,na,1880,12.120528392618866
STAT,1856,1,na,1857,27.19270508052209
SIM,1857,21,na,1878,20
STAT,1926,27,40-44,1953,0.05555567196431742
STAT,1850,22,na,1872,22.84937359907753
SIM,1881,57,na,1938,18
STAT,1821,41,na,1862,17.302661727122036
STAT,1901,6,na,1907,36.55390562332522
SIM,1812,57,na,1869,18
STAT,1874,42,50-100,1916,0.010704418491199746
STAT,1893,39,35-39,1932,0.08828329968565592
SIM,1932,0,na,1932,58
STAT,1824,92,na,1916,0.28980166054229534
STAT,1856,25,35-39,1881,0.07348390178278158
STAT,1947,12,na,1959,43.94680544659244
STAT,1907,47,25-29,1954,4.730497719318343E-4
STAT,1854,36,na,1890,14.469868208342216
SIM,1856,58,na,1914,9
STAT,1916,38,15-19,1954,1.9400516867757475E-4
STAT,1806,49,20-24,1855,3.930260583747123E-4
STAT,1902,19,30-34,1921,0.022355997064576853
STAT,1836,102,na,1938,0.002829446720688319
STAT,1838,73,na,1911,9.218702354725973
STAT,1836,26,20-24,1862,0.14756021285268822
STAT,1938,30,40-44,1968,0.03913347740577086
STAT,1806,63,na,1869,12.15428612729776
STAT,1783,82,na,1865,0.8372699129173025
STAT,1909,16,50-100,1925,7.323854114269679E-4
STAT,1795,62,na,1857,10.9192649187408
STAT,1901,30,45-49,1931,0.02459689999966278
STAT,1846,17,na,1863,23.369011634988812
SIM,1944,13,na,1957,35
STAT,1799,76,na,1875,4.238954902977091
STAT,1901,25,50-100,1926,0.009011743872468479
STAT,1905,18,45-49,1923,9.402913703123004E-4
SIM,1874,20,25-29,1894,2
STAT,1921,31,25-29,1952,0.10247105656021824
STAT,1893,30,35-39,1923,0.12871627188119195
STAT,1884,20,40-44,1904,0.02053797213089977
STAT,1938,26,50-100,1964,0.009800390596518771
STAT,1838,22,15-19,1860,0.03322020468457842
SIM,1841,81,na,1922,4
STAT,1903,47,50-100,1950,0.001960470217074714
STAT,1911,17,30-34,1928,0.024233735694636764
STAT,1903,17,45-49,1920,9.287117255126876E-4
STAT,1904,44,50-100,1948,0.00103701070953525
STAT,1920,26,35-39,1946,0.1638538863509779
STAT,1865,31,50-100,1896,0.008321192306657593
STAT,1815,56,na,1871,9.276795560792005
SIM,1878,90,na,1968,2
STAT,1815,47,20-24,1862,1.7295708274434944E-4
STAT,1929,33,50-100,1962,0.010445425311789014
STAT,1841,37,20-24,1878,0.008889709352845152
SIM,1900,66,na,1966,23
STAT,1867,40,35-39,1907,0.01750362732379084
SIM,1868,5,na,1873,38
SIM,1879,32,na,1911,15
SIM,1824,37,na,1861,18
STAT,1851,43,50-100,1894,0.00885446530567393
STAT,1882,54,na,1936,20.0678566308308
STAT,1814,82,na,1896,2.0791932535893616
STAT,1821,39,45-49,1860,0.03460942298942071
STAT,1846,92,na,1938,0.33753855773045394
STAT,1888,28,35-39,1916,0.11236028264062885
STAT,1925,16,20-24,1941,1.6314940345777478
STAT,1882,38,20-24,1920,0.007350740949779891
SIM,1877,20,na,1897,26
STAT,1882,86,na,1968,4.656333805238193
STAT,1880,53,50-100,1933,1.5626350981683116E-4
STAT,1811,63,na,1874,12.070707930500483
STAT,1815,77,na,1892,3.08560972863294
STAT,1874,35,na,1909,24.128178414979672
STAT,1893,38,na,1931,29.558641033534755
STAT,1906,22,45-49,1928,0.010130798180461992
STAT,1884,40,35-39,1924,0.01792050127772566
STAT,1886,68,na,1954,15.85147833696026
SIM,1847,22,na,1869,21
STAT,1862,55,na,1917,17.839501312906624
STAT,1878,49,na,1927,22.742773344311207
STAT,1915,46,20-24,1961,1.1067070422430272E-4
STAT,1866,69,na,1935,13.515803867138949
STAT,1862,16,20-24,1878,0.17621795841035945
STAT,1858,18,50-100,1876,4.329162300642231E-4
SIM,1911,29,na,1940,40
STAT,1830,45,na,1875,8.904778707773993
STAT,1925,40,20-24,1965,2.1306430097562347E-4
STAT,1834,59,na,1893,13.73437300274681
STAT,1920,13,na,1933,44.00772730720498
STAT,1935,30,15-19,1965,0.0017719717052862274
STAT,1877,38,50-100,1915,0.012610649818704496
STAT,1844,40,50-100,1884,0.00867066573074113
STAT,1882,15,35-39,1897,0.005282951795227391
STAT,1924,27,na,1951,43.334063079798
STAT,1901,26,25-29,1927,0.5939419464556233
SIM,1958,9,na,1967,53
STAT,1912,33,25-29,1945,0.08985460528751026
SIM,1917,20,20-24,1937,1
STAT,1863,15,25-29,1878,0.05793263840319598
SIM,1832,56,na,1888,18
STAT,1939,18,15-19,1957,0.4510140172090984
SIM,1861,58,na,1919,21
STAT,1847,20,15-19,1867,0.04382964902813421
STAT,1945,20,30-34,1965,0.3129547726598498
STAT,1861,17,na,1878,22.18731184115435
STAT,1922,42,45-49,1964,0.0018962877013554138
STAT,1911,16,40-44,1927,0.002787750589353107
SIM,1929,24,na,1953,47
STAT,1820,43,50-100,1863,0.009186376153074978
STAT,1846,15,25-29,1861,0.05837642306538518
STAT,1867,31,45-49,1898,0.016755887125151782
STAT,1931,33,35-39,1964,0.11913838826823352
STAT,1826,48,35-39,1874,0.001390770170357666
SIM,1925,10,na,1935,45
STAT,1925,35,25-29,1960,0.011763852038854532
STAT,1929,32,40-44,1961,0.04947030940889512
SIM,1861,69,na,1930,19
SIM,1906,50,na,1956,22
STAT,1847,27,35-39,1874,0.12388899492501491
STAT,1879,23,15-19,1902,0.0340397198279019
STAT,1922,18,45-49,1940,0.005723877394734249
STAT,1935,25,40-44,1960,0.0633095480717389
STAT,1881,16,30-34,1897,0.015203608931663082
SIM,1832,45,na,1877,25
STAT,1894,41,50-100,1935,0.013600664279459966
STAT,1908,42,50-100,1950,0.001081270674076608
STAT,1911,21,15-19,1932,0.05031092455943246
STAT,1912,31,50-100,1943,0.008104936383427795
SIM,1855,27,35-39,1882,1
STAT,1902,38,35-39,1940,0.021421523298729837
SIM,1841,60,na,1901,13
STAT,1845,27,50-100,1872,0.004551412820374409
STAT,1858,25,45-49,1883,0.008774541114662634
SIM,1853,18,na,1871,27
STAT,1909,47,35-39,1956,0.001178079053618829
STAT,1848,49,25-29,1897,3.6472156274479833E-4
STAT,1905,40,30-34,1945,0.0011638426426742927
STAT,1908,10,na,1918,38.22536144950335
STAT,1921,35,40-44,1956,0.01661343943163505
SIM,1919,46,na,1965,43
STAT,1917,37,40-44,1954,0.015407400221266816
SIM,1878,21,50-100,1899,1
SIM,1915,32,na,1947,36
STAT,1911,49,40-44,1960,0.0014742822371203905
STAT,1918,25,40-44,1943,0.04948835158854076
STAT,1869,16,30-34,1885,0.015750286508913722
SIM,1845,74,na,1919,11
SIM,1881,25,na,1906,25
STAT,1870,44,50-100,1914,0.010353014056331841
STAT,1899,26,50-100,1925,0.008787015810552624
STAT,1919,33,35-39,1952,0.09732517222705389
STAT,1852,54,50-100,1906,1.2570213984676668E-4
STAT,1841,40,na,1881,24.118012959207174
STAT,1911,41,30-34,1952,0.0012193358512591578
STAT,1843,95,na,1938,0.056398819955676034
STAT,1935,28,45-49,1963,0.023433963883172655
STAT,1837,88,na,1925,0.6637995086863194
SIM,1851,59,na,1910,15
SIM,1818,41,na,1859,25
STAT,1863,40,na,1903,20.67014739719483
STAT,1812,54,40-44,1866,1.0969879738662363E-4
STAT,1918,31,na,1949,39.988555457823395
STAT,1895,3,na,1898,34.32121521558513
STAT,1891,68,na,1959,19.81799039040083
STAT,1794,77,na,1871,3.902222234581001
STAT,1833,74,na,1907,8.216244609011207
STAT,1856,30,30-34,1886,0.13071931312601673
SIM,1842,55,na,1897,19
STAT,1888,20,25-29,1908,0.6729625537018712
STAT,1845,54,na,1899,12.240201260010586
STAT,1844,15,15-19,1859,0.05962480862148303
STAT,1867,54,na,1921,20.038342695033684
STAT,1916,41,45-49,1957,0.0016933923798036661
STAT,1930,21,25-29,1951,1.181334766862806
STAT,1950,17,30-34,1967,0.14322936578029827
STAT,1881,50,50-100,1931,1.4577438358848565E-4
SIM,1925,8,na,1933,45
STAT,1906,15,50-100,1921,7.15068717238186E-4
STAT,1865,15,35-39,1880,0.005686888739995391
STAT,1890,38,50-100,1928,0.014839456317334765
STAT,1827,37,50-100,1864,0.010047874373680678
STAT,1945,23,35-39,1968,0.10242253570195288
SIM,1890,3,na,1893,33
STAT,1855,39,15-19,1894,3.9138812409401534E-4
STAT,1849,9,na,1858,23.253352211101614
STAT,1903,18,35-39,1921,0.007780740848237542
STAT,1901,23,20-24,1924,0.9612915603218181
STAT,1923,31,35-39,1954,0.10446200825719558
STAT,1888,16,na,1904,29.586670891558285
STAT,1849,20,25-29,1869,0.5444514765613983
STAT,1926,23,25-29,1949,1.1123163088750985
STAT,1896,67,na,1963,22.81056994241285
STAT,1952,6,na,1958,46.83144229846191
STAT,1862,87,na,1949,1.5200254882141773
STAT,1897,31,30-34,1928,0.23280477488732804
STAT,1892,53,na,1945,26.174017632104174
STAT,1922,16,50-100,1938,0.0043147561633792055
STAT,1884,15,45-49,1899,6.429720418036389E-4
STAT,1831,30,na,1861,23.254907460204723
STAT,1865,38,20-24,1903,0.006937648352567431
STAT,1868,20,35-39,1888,0.05729234884356903
STAT,1866,24,40-44,1890,0.01907135290448568
STAT,1942,28,15-19,1970,0.0073518694189942824
STAT,1882,24,50-100,1906,0.003883569047999139
STAT,1887,41,15-19,1928,1.514174007099724E-4
STAT,1852,20,45-49,1872,0.007192637102426317
SIM,1966,2,na,1968,45
STAT,1913,17,40-44,1930,0.002835870133272459
STAT,1835,44,na,1879,11.043644663848657
STAT,1788,81,na,1869,2.4318674241239724
STAT,1943,27,40-44,1970,0.04927887564761664
SIM,1868,91,na,1959,4
STAT,1852,38,35-39,1890,0.060233225832220884
SIM,1817,56,na,1873,6
SIM,1813,42,na,1855,13
STAT,1908,32,20-24,1940,0.022904239331639816
STAT,1874,37,50-100,1911,0.012455344850041933
STAT,1923,48,20-24,1971,1.2802657990754472E-4
SIM,1902,36,na,1938,33
SIM,1791,78,na,1869,2
SIM,1934,23,25-29,1957,1
SIM,1940,31,na,1971,35
STAT,1906,19,15-19,1925,0.0857557230173071
SIM,1915,28,20-24,1943,1
STAT,1930,41,40-44,1971,0.0032803337434405585
STAT,1931,17,20-24,1948,1.766688469538547
SIM,1823,63,na,1886,6
STAT,1927,32,30-34,1959,0.1928173587146565
STAT,1867,28,15-19,1895,0.004326471402890372
STAT,1823,39,50-100,1862,0.008673063986406234
STAT,1917,46,30-34,1963,9.249638441398161E-4
SIM,1949,12,na,1961,38
STAT,1904,31,25-29,1935,0.14736509923267108
STAT,1877,27,20-24,1904,0.12109920313761936
STAT,1914,29,50-100,1943,0.009879838313605512
STAT,1936,17,35-39,1953,0.039930779440436125
STAT,1841,18,na,1859,28.80730693061391
STAT,1891,30,25-29,1921,0.12672452456882907
STAT,1897,20,na,1917,31.5941814002751
STAT,1870,21,na,1891,23.565053638095655
SIM,1792,63,na,1855,8
SIM,1796,77,na,1873,3
STAT,1859,26,15-19,1885,0.0036948785603447263
STAT,1914,17,na,1931,39.62144709204717
STAT,1840,55,na,1895,16.2024222088198
SIM,1859,87,na,1946,1
STAT,1870,39,40-44,1909,0.04304794978680834
SIM,1855,73,na,1928,3
STAT,1907,28,20-24,1935,0.17099794740985963
SIM,1899,20,na,1919,28
STAT,1871,17,25-29,1888,0.05686218322207796
STAT,1903,65,na,1968,26.997751517587492
STAT,1928,44,40-44,1972,0.0031624832703596043
STAT,1921,42,50-100,1963,0.001312881166436534
STAT,1925,19,25-29,1944,0.5174215395508308
SIM,1933,19,25-29,1952,1
SIM,1865,40,na,1905,24
STAT,1858,48,30-34,1906,7.2733912150328E-4
SIM,1869,54,na,1923,15
STAT,1848,33,50-100,1881,0.006223162727559467
STAT,1820,56,na,1876,12.500984320436029
STAT,1911,45,25-29,1956,5.012930242618528E-4
STAT,1839,25,35-39,1864,0.06805453857105664
STAT,1902,35,30-34,1937,0.016376039028997414
STAT,1951,5,na,1956,46.536540039817446
SIM,1939,16,15-19,1955,1
STAT,1872,76,na,1948,9.693551907344816
STAT,1899,26,45-49,1925,0.015251472837075272
STAT,1871,91,na,1962,1.2318165716567693
STAT,1848,8,na,1856,19.686438737999996
STAT,1872,30,15-19,1902,0.001468785046342558
STAT,1840,44,na,1884,18.414140775862442
SIM,1838,18,na,1856,15
STAT,1940,27,15-19,1967,0.007147692627806203
STAT,1880,28,45-49,1908,0.011634329339215098
STAT,1840,37,50-100,1877,0.011378679592789388
STAT,1917,17,25-29,1934,0.09240616683261021
STAT,1918,27,50-100,1945,0.010496853510784564
STAT,1938,33,45-49,1971,0.015708306674432865
STAT,1906,2,na,1908,38.727129511920126
STAT,1952,12,na,1964,46.795393629876116
STAT,1886,49,50-100,1935,0.002494335658430024
STAT,1896,27,30-34,1923,0.33077331787075487
STAT,1918,21,25-29,1939,0.9901926236016567
STAT,1851,16,45-49,1867,6.744625359823952E-4
STAT,1857,44,50-100,1901,0.007801931348212164
SIM,1926,21,25-29,1947,4
STAT,1909,38,45-49,1947,0.006384671007664231
STAT,1883,17,na,1900,24.525692974549013
SIM,1869,65,na,1934,12
STAT,1905,15,40-44,1920,0.00265199715898918
STAT,1829,36,30-34,1865,0.0495083347932862
SIM,1889,53,na,1942,25
STAT,1883,21,50-100,1904,0.003971932588665743
STAT,1849,30,50-100,1879,0.008399402268411557
STAT,1924,27,30-34,1951,0.4532494169455794
STAT,1920,45,50-100,1965,0.00249060494341649
SIM,1890,39,na,1929,23
STAT,1840,28,15-19,1868,0.004400954761830661
SIM,1803,75,na,1878,3
STAT,1847,24,30-34,1871,0.22992392948859683
STAT,1918,29,35-39,1947,0.15719977109545094
STAT,1909,19,40-44,1928,0.002712913406021167
STAT,1804,52,40-44,1856,2.891360486505155E-4
STAT,1931,30,30-34,1961,0.20576216808882816
SIM,1941,18,20-24,1959,3
STAT,1805,78,na,1883,2.6132448911781134
STAT,1905,27,20-24,1932,0.16931315656268747
SIM,1772,86,na,1858,2
STAT,1933,18,20-24,1951,1.802743955005999
STAT,1937,23,na,1960,35.32526793191393
STAT,1895,15,20-24,1910,0.23123095073899305
STAT,1913,36,45-49,1949,0.006703449782404344
SIM,1921,28,na,1949,42
STAT,1935,34,30-34,1969,0.2167251377934799
SIM,1932,27,30-34,1959,1
STAT,1914,37,15-19,1951,1.9014465809205798E-4
STAT,1860,41,15-19,1901,1.1277814162174471E-4
STAT,1801,64,na,1865,8.249191062956445
STAT,1849,40,40-44,1889,0.01774550442488896
SIM,1898,21,25-29,1919,3
SIM,1858,16,20-24,1874,2
SIM,1866,36,na,1902,29
STAT,1871,43,40-44,1914,0.022263292869842265
SIM,1807,78,na,1885,8
SIM,1870,73,na,1943,11
SIM,1874,87,na,1961,4
SIM,1803,64,na,1867,5
STAT,1915,49,25-29,1964,5.267959591208091E-4
SIM,1872,21,na,1893,25
STAT,1887,53,na,1940,23.125276055823193
STAT,1892,17,45-49,1909,8.069992195036101E-4
STAT,1852,17,15-19,1869,0.06142948310902158
STAT,1840,15,30-34,1855,0.016362583283190468
STAT,1826,30,45-49,1856,0.03274322066080045
STAT,1912,24,35-39,1936,0.09271756689540246
SIM,1935,31,na,1966,55
STAT,1903,47,40-44,1950,0.0013665818461250296
STAT,1934,22,20-24,1956,1.4879940672010055
STAT,1912,30,20-24,1942,0.024004849888272083
STAT,1870,10,na,1880,26.63780858398237
STAT,1925,39,40-44,1964,0.017816704719243272
STAT,1816,41,na,1857,9.547465368944327
STAT,1860,49,25-29,1909,4.584951083344661E-4
STAT,1893,21,45-49,1914,0.008818914763665295
STAT,1833,33,40-44,1866,0.04091060181412786
SIM,1887,6,na,1893,26
STAT,1821,95,na,1916,0.0825770725058869
STAT,1859,34,15-19,1893,0.00112218953510116
SIM,1882,42,na,1924,30
STAT,1831,25,30-34,1856,0.2872486232481466
SIM,1914,15,na,1929,37
STAT,1909,32,15-19,1941,0.0012194019084401046
SIM,1799,74,na,1873,10
SIM,1924,47,na,1971,50
SIM,1922,34,na,1956,49
STAT,1808,49,30-34,1857,6.790642064585663E-4
STAT,1895,39,45-49,1934,0.025620069270037682
STAT,1879,38,35-39,1917,0.0728423454644323
STAT,1901,22,45-49,1923,0.009757404535489053
STAT,1920,31,50-100,1951,0.009015857394722222
STAT,1817,52,50-100,1869,4.19882123799513E-4
STAT,1856,33,35-39,1889,0.07349493411417936
STAT,1898,43,40-44,1941,0.0020918418946316813
SIM,1916,3,na,1919,50
STAT,1904,23,25-29,1927,0.8177324112319735
STAT,1836,34,20-24,1870,0.03229635770842293
SIM,1823,31,na,1854,11
STAT,1819,37,25-29,1856,0.032251214133669256
STAT,1894,27,20-24,1921,0.15034932816004817
SIM,1862,25,25-29,1887,1
STAT,1854,25,25-29,1879,0.3021879350960342
STAT,1871,22,20-24,1893,0.6870578099399536
SIM,1856,36,na,1892,12
STAT,1946,26,50-100,1972,0.011014312867471933
STAT,1906,31,35-39,1937,0.08482592468947159
STAT,1895,72,na,1967,19.690385019593503
STAT,1915,12,na,1927,40.97712628217623
SIM,1912,23,25-29,1935,2
STAT,1813,41,15-19,1854,4.7975064709771263E-4
STAT,1850,27,20-24,1877,0.12291997968418347
STAT,1841,29,20-24,1870,0.14058266754767149
STAT,1857,33,na,1890,17.788729733809927
SIM,1857,53,na,1910,22
STAT,1835,38,35-39,1873,0.039240795610051234
SIM,1903,25,25-29,1928,1
STAT,1944,20,15-19,1964,0.05709751591510453
STAT,1910,20,45-49,1930,0.010564550256509465
STAT,1843,37,30-34,1880,0.02639251895414739
STAT,1908,64,na,1972,29.27062646317296
STAT,1929,24,40-44,1953,0.04205158338632149
SIM,1920,22,20-24,1942,2
STAT,1858,50,na,1908,16.619866058381472
SIM,1865,72,na,1937,8
STAT,1840,23,30-34,1863,0.17622405424096083
STAT,1921,20,20-24,1941,1.2535664018542543
STAT,1828,48,45-49,1876,9.98292499657498E-4
STAT,1849,43,45-49,1892,0.01152098711387658
STAT,1842,31,40-44,1873,0.039716340724518406
STAT,1868,37,20-24,1905,0.007459853900189487
SIM,1916,28,na,1944,45
STAT,1883,27,45-49,1910,0.010781947809218696
STAT,1938,22,40-44,1960,0.033057939627972835
SIM,1844,25,na,1869,9
SIM,1842,39,30-34,1881,1
STAT,1923,31,na,1954,43.23317860559826
SIM,1804,60,na,1864,11
SIM,1908,0,na,1908,42
SIM,1919,20,30-34,1939,2
STAT,1857,23,na,1880,18.34555972123008
STAT,1885,40,na,1925,23.054135635368542
STAT,1849,14,na,1863,22.57845262196823
STAT,1914,30,30-34,1944,0.15854118469559889
SIM,1833,41,na,1874,12
SIM,1846,39,15-19,1885,1
SIM,1890,71,na,1961,17
STAT,1912,22,20-24,1934,1.0573074650908731
STAT,1895,50,na,1945,28.356094460025137
STAT,1864,32,30-34,1896,0.1566002006506939
SIM,1882,52,na,1934,30
STAT,1884,38,30-34,1922,0.05195764766521856
SIM,1874,29,25-29,1903,2
STAT,1828,35,25-29,1863,0.013004121287480101
STAT,1878,31,20-24,1909,0.028020897989583383
STAT,1834,39,30-34,1873,0.04588529356764165
STAT,1862,24,20-24,1886,0.5999282464779546
STAT,1890,17,35-39,1907,0.0066651858571770296
STAT,1932,21,35-39,1953,0.12341641289253412
STAT,1847,35,35-39,1882,0.0800372894034476
STAT,1845,32,20-24,1877,0.0187870993515971
STAT,1950,11,na,1961,46.16618095864493
STAT,1861,28,35-39,1889,0.08114587822542473
STAT,1880,32,15-19,1912,0.001497492301638822
SIM,1827,55,na,1882,12
STAT,1820,78,na,1898,4.429569135850503
STAT,1833,104,na,1937,4.938092401069805E-4
SIM,1961,7,na,1968,53
STAT,1839,21,40-44,1860,0.014882514207077042
STAT,1845,27,25-29,1872,0.30097470703299545
STAT,1857,39,25-29,1896,0.021336971023211613
STAT,1889,15,45-49,1904,8.034799566574057E-4
STAT,1913,21,25-29,1934,0.8902598120481006
STAT,1827,36,20-24,1863,0.006392385539495178
STAT,1893,18,15-19,1911,0.0746313592734785
SIM,1874,33,na,1907,25
STAT,1947,15,45-49,1962,0.005591661483016159
SIM,1829,36,na,1865,20
SIM,1882,20,na,1902,33
STAT,1869,49,45-49,1918,0.002238957118838806
STAT,1890,24,50-100,1914,0.004922432503156148
STAT,1896,22,25-29,1918,0.7519417155057242
STAT,1863,23,25-29,1886,0.5132405602114164
STAT,1863,36,30-34,1899,0.047415072646353126
STAT,1878,92,na,1970,1.6355833623626064
STAT,1931,27,50-100,1958,0.012793483608909827
STAT,1838,39,15-19,1877,5.151006321936316E-4
STAT,1945,15,50-100,1960,0.004065426686060908
STAT,1857,2,na,1859,26.350715052017637
STAT,1844,58,na,1902,15.446916129679003
STAT,1897,34,35-39,1931,0.133331530544018
SIM,1892,38,30-34,1930,1
SIM,1904,5,na,1909,33
STAT,1861,15,15-19,1876,0.05804399174531843
STAT,1933,33,45-49,1966,0.021106471332936944
STAT,1895,26,25-29,1921,0.5510650518920629
SIM,1867,85,na,1952,1
STAT,1810,46,na,1856,10.678139625407976
SIM,1854,35,na,1889,17
SIM,1819,36,na,1855,8
SIM,1933,1,na,1934,55
SIM,1940,29,30-34,1969,1
STAT,1855,17,40-44,1872,0.0015316682866582264
STAT,1874,34,40-44,1908,0.04361894337639871
STAT,1888,16,40-44,1904,0.0021426510359029895
STAT,1817,47,30-34,1864,0.0027992098519247608
STAT,1932,29,30-34,1961,0.5106268836765376
SIM,1829,68,na,1897,16
STAT,1846,39,35-39,1885,0.05862886428462876
STAT,1927,36,25-29,1963,0.012190215678229952
STAT,1896,35,30-34,1931,0.07067077740824283
SIM,1892,52,na,1944,32
STAT,1848,47,45-49,1895,0.0015190961590906616
STAT,1851,24,45-49,1875,0.006929639632404229
STAT,1925,44,na,1969,44.53413731933252
STAT,1878,17,35-39,1895,0.0056649695078250075
STAT,1932,38,50-100,1970,0.005612666452160553
STAT,1815,39,20-24,1854,0.01234045954051324
STAT,1940,11,na,1951,39.840616902465925
STAT,1922,39,15-19,1961,2.1644726255778797E-4
STAT,1863,36,50-100,1899,0.010922724968837809
STAT,1829,44,30-34,1873,0.009905074431315256
SIM,1890,61,na,1951,22
STAT,1819,42,20-24,1861,0.0015054595720710715
STAT,1873,25,35-39,1898,0.09876548584585959
STAT,1885,16,15-19,1901,0.05874850154996929
STAT,1847,15,40-44,1862,0.002467564762270419
STAT,1858,72,na,1930,9.609931665512375
STAT,1864,15,40-44,1879,0.0018870655287633311
STAT,1923,23,35-39,1946,0.10846316738464537
STAT,1912,40,35-39,1952,0.0019487668879191958
SIM,1875,72,na,1947,7
STAT,1856,47,50-100,1903,0.0017709135401116967
STAT,1935,32,na,1967,52.09246825756431
STAT,1872,22,na,1894,24.198472651275747
STAT,1884,23,45-49,1907,0.00681091075327006
STAT,1876,39,35-39,1915,0.0711128307346754
STAT,1857,42,40-44,1899,0.016817529044425895
STAT,1939,21,45-49,1960,0.01122607835680011
STAT,1869,24,30-34,1893,0.17151013861635284
STAT,1870,26,20-24,1896,0.11693882851312905
STAT,1907,40,40-44,1947,0.0023077887764017353
STAT,1918,43,20-24,1961,1.8577484036756646E-4
STAT,1835,25,15-19,1860,0.0027978228478796295
STAT,1844,49,40-44,1893,0.0013093142915566482
STAT,1834,32,45-49,1866,0.015785269199284135
STAT,1932,14,na,1946,52.08483944216648
STAT,1879,43,30-34,1922,0.011813224144622155
STAT,1940,23,35-39,1963,0.09520704555630077
STAT,1862,37,40-44,1899,0.03776754597461018
STAT,1927,41,20-24,1968,2.206738119179723E-4
SIM,1907,45,na,1952,38
SIM,1857,75,na,1932,9
STAT,1838,37,35-39,1875,0.06624072320719727
SIM,1844,35,na,1879,7
STAT,1807,80,na,1887,3.160781395115099
STAT,1874,28,20-24,1902,0.11859563414341077
STAT,1927,13,na,1940,48.93855502469182
SIM,1838,43,35-39,1881,1
SIM,1931,17,na,1948,56
STAT,1829,31,25-29,1860,0.09948182371884666
SIM,1902,14,na,1916,37
STAT,1905,35,35-39,1940,0.02224217543337246
STAT,1841,22,35-39,1863,0.07235782404851074
STAT,1866,35,45-49,1901,0.018534008594044842
STAT,1908,36,15-19,1944,1.7972225652071604E-4
STAT,1864,27,35-39,1891,0.08654344716413694
SIM,1872,42,na,1914,21
SIM,1898,67,na,1965,20
STAT,1848,44,40-44,1892,0.014349716954432701
STAT,1880,15,25-29,1895,0.05986551595236835
SIM,1867,53,na,1920,10
STAT,1885,8,na,1893,25.67090404769003
STAT,1892,25,45-49,1917,0.013809828715840428
STAT,1816,41,50-100,1857,0.014892015015223463
SIM,1849,56,na,1905,7
STAT,1955,17,45-49,1972,0.006594093713703678
SIM,1914,47,na,1961,36
STAT,1930,21,50-100,1951,0.008415264925655239
STAT,1937,30,25-29,1967,0.09096786642574332
STAT,1928,32,25-29,1960,0.11500412488969343
SIM,1907,35,na,1942,39
STAT,1889,32,35-39,1921,0.12398887954048822
STAT,1920,42,35-39,1962,0.002205040563403396
STAT,1827,49,40-44,1876,0.0012578428363268568
STAT,1913,29,20-24,1942,0.17907339075290543
SIM,1959,11,na,1970,51
STAT,1886,33,20-24,1919,0.027919597740741094
STAT,1947,20,40-44,1967,0.037767293761366255
STAT,1853,39,40-44,1892,0.027234888966183268
STAT,1889,45,40-44,1934,0.002116952647812984
STAT,1909,15,25-29,1924,0.08489767328019782
SIM,1894,28,25-29,1922,1
SIM,1839,56,na,1895,20
STAT,1839,16,45-49,1855,4.74362406777622E-4
STAT,1922,19,20-24,1941,1.5491886205216663
SIM,1826,38,35-39,1864,1
STAT,1825,34,45-49,1859,0.019188481381976374
STAT,1902,22,50-100,1924,0.0057506059025796575
SIM,1871,20,20-24,1891,1
SIM,1802,79,na,1881,1
STAT,1936,31,20-24,1967,0.02356230736204619
SIM,1831,60,na,1891,5
SIM,1895,49,na,1944,26
STAT,1870,48,30-34,1918,9.495176096727581E-4
SIM,1843,38,35-39,1881,2
STAT,1871,38,na,1909,23.372594835343108
STAT,1928,15,35-39,1943,0.05285856260252823
SIM,1896,33,30-34,1929,1
STAT,1885,29,35-39,1914,0.09460358038405185
SIM,1887,83,na,1970,9
STAT,1866,18,50-100,1884,4.60398666047959E-4
SIM,1936,20,30-34,1956,2
STAT,1896,18,40-44,1914,0.002396202967288622
SIM,1894,21,na,1915,32
STAT,1803,76,na,1879,4.242446689365853
STAT,1837,30,20-24,1867,0.016899694360832905
STAT,1852,40,50-100,1892,0.009132857833857231
STAT,1934,26,15-19,1960,0.009460819093618483
STAT,1899,49,30-34,1948,7.3187554536853E-4
STAT,1855,37,35-39,1892,0.04979830524524047
STAT,1829,27,40-44,1856,0.034412927799022504
STAT,1809,48,35-39,1857,0.004702529889161389
STAT,1864,29,15-19,1893,0.004040277409114686
STAT,1885,72,na,1957,13.090763998644523
STAT,1886,28,25-29,1914,0.43723388837246496
STAT,1818,38,35-39,1856,0.09009048419705037
STAT,1884,32,50-100,1916,0.008976933664390653
STAT,1918,30,15-19,1948,0.001364056788917215
STAT,1891,28,20-24,1919,0.14348074977780437
STAT,1869,33,20-24,1902,0.026080529004179696
SIM,1930,19,20-24,1949,3
STAT,1939,23,50-100,1962,0.00656062619594621
SIM,1836,38,na,1874,8
STAT,1838,42,30-34,1880,0.01043535966339629
STAT,1944,16,30-34,1960,0.13025546205940844
STAT,1854,38,45-49,1892,0.012124451833086978
STAT,1881,24,30-34,1905,0.16843056411639434
STAT,1875,25,45-49,1900,0.011490705372333682
STAT,1928,20,30-34,1948,0.35922512407228363
STAT,1849,36,na,1885,18.888152695397707
STAT,1798,80,na,1878,4.6857249203135085
STAT,1853,26,20-24,1879,0.08603057430104484
STAT,1919,42,25-29,1961,7.671400558439678E-4
STAT,1800,58,na,1858,9.238372962135939
STAT,1830,29,45-49,1859,0.008319069038205609
SIM,1816,61,na,1877,9
STAT,1860,22,45-49,1882,0.005843964234786757
STAT,1824,37,20-24,1861,0.011223731873006756
SIM,1834,37,30-34,1871,1
SIM,1907,13,na,1920,41
STAT,1878,39,45-49,1917,0.020373966979833676
STAT,1898,46,45-49,1944,0.0018009379636335324
STAT,1847,23,40-44,1870,0.027092678398618706
STAT,1926,32,15-19,1958,0.0015449624551846927
SIM,1916,39,40-44,1955,1
STAT,1888,70,na,1958,17.28067294536533
STAT,1850,50,45-49,1900,1.3107029249977974E-4
STAT,1907,47,na,1954,32.7622450398876
STAT,1893,28,30-34,1921,0.31639522711305357
STAT,1937,13,na,1950,38.24373759827489
SIM,1917,45,na,1962,34
STAT,1830,56,na,1886,7.4172648686383615
STAT,1929,27,45-49,1956,0.02151817143959312
SIM,1879,54,na,1933,13
STAT,1826,31,50-100,1857,0.01426777675215549
STAT,1899,39,15-19,1938,1.642512506170782E-4
STAT,1931,40,45-49,1971,0.002219670768206645
STAT,1881,49,45-49,1930,0.002198755208296948
STAT,1944,3,na,1947,42.902177391447346
STAT,1834,24,45-49,1858,0.006496278422091805
STAT,1945,24,25-29,1969,1.004405549704612
STAT,1915,29,30-34,1944,0.39337075364867646
STAT,1865,42,na,1907,20.879133775456594
SIM,1861,37,na,1898,25
STAT,1851,21,40-44,1872,0.021160400003208537
STAT,1879,35,30-34,1914,0.05568553998958546
STAT,1830,26,40-44,1856,0.030391439227617202
STAT,1816,94,na,1910,0.0600017695586334
STAT,1825,49,30-34,1874,8.696260675257143E-4
STAT,1845,15,30-34,1860,0.011915759760526485
STAT,1838,45,35-39,1883,0.0011469091047086894
STAT,1848,31,35-39,1879,0.07717217132393821
STAT,1826,37,30-34,1863,0.06165425343287231
STAT,1846,44,30-34,1890,0.009191469369352216
STAT,1843,22,45-49,1865,0.0037128870194950954
STAT,1866,7,na,1873,25.711747410192707
STAT,1908,39,40-44,1947,0.013802725779891148
SIM,1872,74,na,1946,10
SIM,1932,12,na,1944,53
STAT,1927,33,20-24,1960,0.029832871497256722
STAT,1888,33,30-34,1921,0.20317289088986018
STAT,1857,37,45-49,1894,0.01492340168467188
STAT,1877,22,15-19,1899,0.034054540312837604
SIM,1892,20,na,1912,32
STAT,1909,20,20-24,1929,1.033788697128561
SIM,1920,25,25-29,1945,2
STAT,1929,41,30-34,1970,0.0016501060874145109
STAT,1897,26,35-39,1923,0.1285731862809241
STAT,1789,104,na,1893,1.0497032654577716E-4
STAT,1866,42,50-100,1908,0.00971774811233901
STAT,1918,26,30-34,1944,0.41463339379754216
STAT,1872,26,30-34,1898,0.25853789459053456
SIM,1834,25,na,1859,23
STAT,1929,28,50-100,1957,0.012391573982834744
STAT,1914,33,35-39,1947,0.09083954788638661
SIM,1861,7,na,1868,33
STAT,1837,25,25-29,1862,0.2720156181142305
STAT,1836,37,25-29,1873,0.034106626488986984
STAT,1863,20,20-24,1883,0.6313427326725082
STAT,1853,34,20-24,1887,0.01713477803597023
STAT,1878,5,na,1883,28.08419232538886
STAT,1941,19,30-34,1960,0.12455278729803763
SIM,1922,33,35-39,1955,1
STAT,1885,24,15-19,1909,0.032374404681170185
STAT,1878,49,50-100,1927,0.0024826757465132507
STAT,1837,35,na,1872,12.87210999774078
SIM,1853,24,20-24,1877,1
STAT,1842,34,45-49,1876,0.015480379841530353
STAT,1859,17,25-29,1876,0.05228213595543966
STAT,1880,2,na,1882,33.748549007372546
STAT,1807,90,na,1897,0.3327335095478402
STAT,1820,46,na,1866,14.810380506659898
STAT,1851,39,30-34,1890,0.044541099083695676
STAT,1864,68,na,1932,13.706753492438441
STAT,1887,45,30-34,1932,0.0010671131369389569
STAT,1867,33,na,1900,22.73968751119211
STAT,1845,35,25-29,1880,0.01984014996927345
STAT,1845,24,20-24,1869,0.4929285259244486
SIM,1882,84,na,1966,12
STAT,1933,30,40-44,1963,0.05258170954654214
STAT,1832,39,20-24,1871,0.004284639426798211
STAT,1928,17,50-100,1945,0.004697687502421374
STAT,1867,38,30-34,1905,0.05074898783569282
SIM,1926,26,30-34,1952,2
STAT,1850,4,na,1854,29.0
STAT,1855,21,25-29,1876,0.47426656313992727
STAT,1878,34,25-29,1912,0.104841086097401
STAT,1860,49,50-100,1909,0.0019549722118287942
STAT,1868,28,30-34,1896,0.24283883973176712
STAT,1854,68,na,1922,9.340878592417424
STAT,1872,17,40-44,1889,0.0018775653619106652
STAT,1878,26,25-29,1904,0.4382260271294229
STAT,1868,24,15-19,1892,0.031726286831390414
STAT,1862,27,25-29,1889,0.36630711747474154
STAT,1882,22,na,1904,22.66529621484861
STAT,1942,20,50-100,1962,0.006853509027054995
STAT,1907,25,na,1932,35.14573931637105
STAT,1858,38,15-19,1896,4.2518571998021674E-4
STAT,1918,22,15-19,1940,0.056892336217461724
STAT,1872,15,50-100,1887,5.088963149801511E-4
STAT,1856,16,45-49,1872,5.628646699896379E-4
SIM,1917,5,na,1922,47
STAT,1874,21,35-39,1895,0.059379175238293475
STAT,1846,36,30-34,1882,0.04557579293841974
STAT,1852,24,na,1876,21.427463943986922
STAT,1844,23,15-19,1867,0.031942661602719934
STAT,1938,34,35-39,1972,0.09116323690128457
STAT,1816,38,25-29,1854,0.04321519508467714
SIM,1912,46,na,1958,35
STAT,1896,39,50-100,1935,0.015964533648685497
SIM,1883,1,na,1884,27
STAT,1837,27,50-100,1864,0.004031668275721538
STAT,1883,29,25-29,1912,0.4078453263395021
SIM,1903,22,20-24,1925,2
STAT,1903,32,20-24,1935,0.03843028298626561
SIM,1923,6,na,1929,42
STAT,1839,24,45-49,1863,0.004873748145760119
SIM,1857,85,na,1942,3
STAT,1864,35,35-39,1899,0.06404113570879412
SIM,1952,2,na,1954,35
SIM,1902,46,na,1948,30
STAT,1937,26,40-44,1963,0.04516905386859988
STAT,1859,15,50-100,1874,4.5737890392177997E-4
STAT,1794,98,na,1892,0.007047820653540331
SIM,1877,73,na,1950,10
STAT,1898,38,45-49,1936,0.005775644949856036
STAT,1925,31,45-49,1956,0.01857996878435974
STAT,1862,49,35-39,1911,0.001182651070540979
STAT,1925,12,na,1937,47.564550082052456
STAT,1867,53,50-100,1920,1.4220681489366906E-4
STAT,1875,19,na,1894,25.822542732369577
STAT,1820,36,25-29,1856,0.027596791537602455
STAT,1879,46,35-39,1925,0.0014531280213705288
STAT,1797,63,na,1860,7.583314256371526
STAT,1887,21,na,1908,25.892625379197966
STAT,1911,19,45-49,1930,9.878594359622047E-4
STAT,1926,24,15-19,1950,0.0638981562281939
STAT,1850,19,20-24,1869,0.19062296367306023
SIM,1886,26,25-29,1912,1
STAT,1819,45,25-29,1864,5.330008499283491E-4
SIM,1874,55,na,1929,25
STAT,1821,73,na,1894,7.376996314722608
STAT,1936,22,30-34,1958,0.27311864428554566
STAT,1890,51,na,1941,26.280450315827533
SIM,1946,1,na,1947,55
SIM,1829,33,40-44,1862,1
STAT,1865,20,na,1885,21.965895732989555
STAT,1857,55,na,1912,15.479069925140276
STAT,1932,25,50-100,1957,0.012995540448892324
STAT,1905,39,15-19,1944,1.7316704972808353E-4
SIM,1849,24,na,1873,9
STAT,1828,48,50-100,1876,0.0010389010064119192
SIM,1819,58,na,1877,5
STAT,1915,34,na,1949,37.859164005645844
STAT,1810,47,20-24,1857,1.1702853133936859E-4
STAT,1870,29,25-29,1899,0.41721411214355214
STAT,1888,24,40-44,1912,0.02419890540617337
STAT,1813,54,50-100,1867,4.320217193488832E-4
STAT,1873,26,50-100,1899,0.006526024324263404
STAT,1914,16,45-49,1930,0.0010272895436106927
SIM,1915,27,30-34,1942,1
STAT,1907,43,45-49,1950,0.0015092524132688874
STAT,1931,25,35-39,1956,0.19314107215129542
STAT,1948,16,15-19,1964,0.5160852047179085
SIM,1874,32,40-44,1906,1
STAT,1922,32,30-34,1954,0.17671010583698457
STAT,1785,106,na,1891,2.529927339583051E-4
STAT,1934,29,40-44,1963,0.06237500326623138
STAT,1891,36,na,1927,29.05558710892324
STAT,1842,28,25-29,1870,0.38966811517628197
STAT,1838,34,30-34,1872,0.16492790580456726
SIM,1812,79,na,1891,4
SIM,1871,68,na,1939,15
STAT,1835,54,na,1889,9.486195527202996
STAT,1923,0,na,1923,52.53468765143386
STAT,1927,44,25-29,1971,8.880402700624864E-4
STAT,1867,16,20-24,1883,0.1744659670886961
SIM,1885,49,na,1934,22
STAT,1843,27,15-19,1870,0.002368535720555662
STAT,1914,17,20-24,1931,0.2781233624199978
SIM,1902,68,na,1970,30
STAT,1919,34,25-29,1953,0.09800636290669039
STAT,1874,19,50-100,1893,4.943529923400556E-4
SIM,1919,14,na,1933,47
STAT,1840,48,45-49,1888,0.0018411070644804197
SIM,1837,23,25-29,1860,2
STAT,1910,13,na,1923,38.83314371389061
STAT,1842,26,45-49,1868,0.010376250364942588
SIM,1800,78,na,1878,6
STAT,1951,21,45-49,1972,0.0133658805603295
STAT,1887,37,30-34,1924,0.05817275398120242
STAT,1892,22,40-44,1914,0.0257435336790286
STAT,1926,46,50-100,1972,0.00278173428917124
STAT,1864,24,30-34,1888,0.16000884311789312
STAT,1835,20,45-49,1855,0.008057621574661273
STAT,1835,42,50-100,1877,0.005734248193046926
STAT,1876,48,25-29,1924,5.776612521041079E-4
STAT,1885,43,50-100,1928,0.01035725592391223
STAT,1805,57,na,1862,8.594647116671233
SIM,1924,25,na,1949,53
STAT,1819,47,40-44,1866,0.0015416269227551379
STAT,1890,19,15-19,1909,0.07170057151247311
STAT,1928,23,35-39,1951,0.11662619529065714
STAT,1877,21,na,1898,24.48718216242704
SIM,1862,54,na,1916,21
STAT,1900,18,30-34,1918,0.02204399352532597
STAT,1886,38,40-44,1924,0.04518114643853979
STAT,1947,23,45-49,1970,0.012625483997820146
STAT,1813,44,na,1857,20.894774190698758
STAT,1876,69,na,1945,14.90504204396468
STAT,1917,21,50-100,1938,0.006950629960085218
STAT,1836,21,15-19,1857,0.04232265602712619
STAT,1903,15,30-34,1918,0.022765855025974342
STAT,1898,15,na,1913,34.228744814476485
STAT,1912,25,25-29,1937,0.6479236114013507
STAT,1827,44,20-24,1871,0.0012083518399118886
STAT,1824,60,na,1884,14.263751560978585
STAT,1821,48,35-39,1869,0.0019490852972390347
SIM,1806,61,na,1867,6
STAT,1883,71,na,1954,12.962001340616332
STAT,1840,15,45-49,1855,6.70597539201215E-4
SIM,1826,38,na,1864,14
STAT,1885,26,30-34,1911,0.2495283760700917
STAT,1922,14,na,1936,45.372694465289875
SIM,1863,39,na,1902,12
STAT,1841,93,na,1934,0.2860624925618077
STAT,1803,98,na,1901,0.012174679218544088
SIM,1932,34,na,1966,48
STAT,1825,31,40-44,1856,0.054879093723754414
STAT,1922,15,40-44,1937,0.016143620018756483
STAT,1886,25,20-24,1911,0.12251195265341612
STAT,1864,18,45-49,1882,6.02522905679981E-4
STAT,1894,35,20-24,1929,0.009972960171195968
SIM,1936,23,35-39,1959,2
STAT,1849,35,45-49,1884,0.016148840520315563
STAT,1848,72,na,1920,8.16713832883604
SIM,1845,33,25-29,1878,1
STAT,1940,20,30-34,1960,0.29090765126526696
STAT,1836,39,na,1875,24.850104036836893
STAT,1837,33,25-29,1870,0.0620056411928423
SIM,1901,19,na,1920,41
STAT,1945,21,20-24,1966,1.2103293983649923
SIM,1847,30,30-34,1877,1
STAT,1872,8,na,1880,27.701210782597915
STAT,1869,20,15-19,1889,0.032293987435133294
SIM,1929,20,25-29,1949,3
STAT,1928,36,40-44,1964,0.018843454239657297
SIM,1916,24,20-24,1940,3
STAT,1863,19,na,1882,22.94751641725891
STAT,1834,91,na,1925,0.409514593216742
STAT,1933,17,30-34,1950,0.16250000425211483
SIM,1845,22,20-24,1867,1
STAT,1795,94,na,1889,0.05316425937606283
STAT,1847,26,45-49,1873,0.014359016275925715
STAT,1851,61,na,1912,15.775599124745366
STAT,1862,15,30-34,1877,0.015936601271525172
STAT,1887,28,40-44,1915,0.03258171903590769
STAT,1862,29,40-44,1891,0.025659949160885535
STAT,1864,47,50-100,1911,0.002192572831673147
STAT,1895,29,na,1924,30.761720345540336
STAT,1955,10,na,1965,51.8667491658433
STAT,1846,20,20-24,1866,0.6990978525433404
STAT,1855,74,na,1929,7.813686380587787
SIM,1897,51,na,1948,38
STAT,1844,39,25-29,1883,0.023276523826041205
STAT,1902,16,na,1918,35.703233375717744
STAT,1924,39,25-29,1963,0.01151022110234032
STAT,1842,24,na,1866,19.944079361052292
SIM,1954,13,na,1967,50
STAT,1819,36,50-100,1855,0.015009080032922862
STAT,1830,24,25-29,1854,0.8233470214230926
STAT,1851,15,20-24,1866,0.18413371666115233
STAT,1829,35,40-44,1864,0.04107955464699406
STAT,1853,37,25-29,1890,0.018095213377701057
STAT,1852,103,na,1955,0.001228270736683222
STAT,1859,89,na,1948,0.8349831328715634
STAT,1942,20,40-44,1962,0.03502142858030922
STAT,1834,21,40-44,1855,0.019837084933085055
STAT,1884,66,na,1950,16.058233841547345
SIM,1892,19,na,1911,36
STAT,1896,27,45-49,1923,0.014584231187066626
STAT,1812,47,30-34,1859,0.0010871991541908529
SIM,1934,15,25-29,1949,2
STAT,1838,28,45-49,1866,0.010883259855657374
STAT,1965,5,na,1970,48.77246897527921
SIM,1906,29,30-34,1935,1
STAT,1875,53,50-100,1928,1.5275486488658052E-4
SIM,1863,25,40-44,1888,1
STAT,1857,21,35-39,1878,0.050796392019178786
STAT,1894,19,35-39,1913,0.00699449955884249
STAT,1934,34,15-19,1968,0.0017448368107120511
STAT,1846,49,na,1895,17.85264381576246
STAT,1846,47,35-39,1893,0.0011293097964616896
SIM,1929,14,na,1943,51
STAT,1871,27,40-44,1898,0.02986578277005097
STAT,1889,41,50-100,1930,0.012993000800457883
STAT,1903,35,25-29,1938,0.008919262945737758
STAT,1853,17,30-34,1870,0.012050003579300455
STAT,1829,36,45-49,1865,0.018518203740273374
STAT,1899,27,20-24,1926,0.16059578167448837
STAT,1827,28,35-39,1855,0.13700283279356376
STAT,1872,48,40-44,1920,0.0017296576264324748
SIM,1820,44,na,1864,14
STAT,1819,38,na,1857,15.228036601413221
STAT,1810,48,50-100,1858,0.002364117742130825
STAT,1855,25,40-44,1880,0.024508598278533716
STAT,1859,99,na,1958,0.024221666152493753
STAT,1864,49,45-49,1913,0.002072542129230227
STAT,1847,49,50-100,1896,0.002568811520921664
STAT,1836,26,35-39,1862,0.12136588212606748
STAT,1885,19,na,1904,24.806982495438643
STAT,1907,15,15-19,1922,0.08721105522623136
STAT,1941,28,na,1969,38.45325676910699
STAT,1924,19,30-34,1943,0.1434309943539705
STAT,1844,25,30-34,1869,0.24428266863211906
SIM,1900,28,25-29,1928,1
STAT,1854,16,35-39,1870,0.004035838586088497
STAT,1887,15,35-39,1902,0.00601702947392904
STAT,1916,30,40-44,1946,0.04037890649836751
STAT,1827,57,na,1884,12.833279241001634
STAT,1837,49,35-39,1886,6.89497651570619E-4
STAT,1909,23,25-29,1932,0.8510369496351174
STAT,1931,29,15-19,1960,0.009064811680067343
STAT,1880,41,na,1921,24.413882683558654
STAT,1892,16,20-24,1908,0.21955754820309906
STAT,1902,18,40-44,1920,0.002572516809596099
STAT,1944,18,45-49,1962,0.005335134999454066
STAT,1863,23,50-100,1886,0.0036560807367420605
STAT,1842,17,20-24,1859,0.17080673564093163
STAT,1937,22,25-29,1959,0.893820498133899
STAT,1873,16,45-49,1889,6.680639853657769E-4
STAT,1938,31,30-34,1969,0.1574655995441967
SIM,1822,57,na,1879,12
STAT,1818,49,25-29,1867,5.503195338211774E-4
STAT,1896,26,40-44,1922,0.039482841468992946
STAT,1890,73,na,1963,16.86894707205514
STAT,1919,31,20-24,1950,0.026194180159361556
SIM,1945,22,25-29,1967,3
STAT,1859,67,na,1926,12.599579042377659
STAT,1817,57,na,1874,19.27413098378669
STAT,1953,17,35-39,1970,0.05046693942364499
STAT,1908,24,20-24,1932,1.0105733420625043
STAT,1879,29,45-49,1908,0.011409614663598603
SIM,1850,17,20-24,1867,1
STAT,1886,36,25-29,1922,0.030008683983750273
STAT,1910,45,na,1955,34.227499763224564
STAT,1939,30,35-39,1969,0.0927053441480407
STAT,1890,39,45-49,1929,0.023971228155951096
SIM,1852,86,na,1938,6
SIM,1820,76,na,1896,2
STAT,1835,47,25-29,1882,2.749279281833736E-4
STAT,1852,34,na,1886,20.711169915051784
SIM,1812,47,na,1859,18
STAT,1866,29,25-29,1895,0.3868038224569292
STAT,1922,35,35-39,1957,0.027368001710028286
STAT,1957,2,na,1959,51.59131383153968
STAT,1833,39,15-19,1872,5.090968266236386E-4
STAT,1837,22,20-24,1859,0.4699961588068219
STAT,1839,30,30-34,1869,0.12106110790966873
STAT,1884,28,15-19,1912,0.00442951251585199
STAT,1928,6,na,1934,50.25586266771751
STAT,1827,27,30-34,1854,0.7418856638222796
STAT,1825,104,na,1929,3.5958217613425546E-4
STAT,1845,37,40-44,1882,0.026885751623684517
STAT,1802,81,na,1883,1.8438611758681425
STAT,1877,27,35-39,1904,0.09960213074667745
STAT,1867,36,15-19,1903,5.399634351886606E-4
STAT,1942,16,20-24,1958,1.406890206042394
STAT,1823,48,45-49,1871,0.0016184519035391028
STAT,1843,15,20-24,1858,0.09724682651953426
STAT,1873,22,30-34,1895,0.18109616847065724
STAT,1876,28,30-34,1904,0.2548586234436533
STAT,1894,18,30-34,1912,0.02037338303113958
STAT,1919,38,50-100,1957,0.0044669152032459185
STAT,1855,36,50-100,1891,0.008685771072291073
STAT,1863,93,na,1956,0.295519225361263
STAT,1838,21,25-29,1859,0.5806153426788817
STAT,1889,24,35-39,1913,0.0709983703112393
SIM,1850,64,na,1914,16
SIM,1870,19,na,1889,24
STAT,1827,67,na,1894,9.606699991626414
STAT,1843,29,30-34,1872,0.12958008290046108
STAT,1863,32,15-19,1895,0.0012608741444308533
SIM,1858,27,25-29,1885,1
SIM,1920,2,na,1922,53
SIM,1852,76,na,1928,18
STAT,1841,48,50-100,1889,0.0023841261426571707
STAT,1887,48,35-39,1935,0.0015089100716651923
STAT,1857,34,40-44,1891,0.03218705579016536
STAT,1909,36,30-34,1945,0.01723704097974026
SIM,1838,61,na,1899,4
SIM,1937,20,25-29,1957,2
STAT,1836,72,na,1908,12.188262917602493
STAT,1885,29,na,1914,23.398830707647242
STAT,1828,26,35-39,1854,0.15747791597981137
SIM,1937,11,na,1948,41
STAT,1858,33,45-49,1891,0.013213524915039007
STAT,1893,48,na,1941,28.016499441666525
STAT,1905,66,na,1971,27.248184284932346
STAT,1851,93,na,1944,0.24672980754740545
STAT,1870,31,50-100,1901,0.009139074746562796
STAT,1870,15,30-34,1885,0.01617411531691846
SIM,1851,29,30-34,1880,1
STAT,1894,38,25-29,1932,0.03671653567089755
STAT,1855,26,45-49,1881,0.008207168538588461
STAT,1888,30,50-100,1918,0.01079329372210872
SIM,1859,37,35-39,1896,2
STAT,1873,93,na,1966,0.9614672354826738
STAT,1817,37,15-19,1854,0.0022441322802751553
SIM,1895,21,20-24,1916,1
STAT,1898,35,40-44,1933,0.05961338003033219
STAT,1842,56,na,1898,15.302944662909008
SIM,1911,8,na,1919,42
SIM,1874,7,na,1881,30
STAT,1879,7,na,1886,27.628649924262902
SIM,1879,22,na,1901,16
STAT,1877,38,25-29,1915,0.02957341589838364
STAT,1856,22,30-34,1878,0.14986570563876583
STAT,1846,38,50-100,1884,0.010283231731873947
STAT,1851,48,20-24,1899,1.0003477831816247E-4
SIM,1837,87,na,1924,1
STAT,1873,19,15-19,1892,0.06001256954949829
STAT,1861,38,na,1899,19.714448978986763
STAT,1881,15,40-44,1896,0.001748488208626913
STAT,1830,24,na,1854,8.75134457912897
STAT,1888,27,45-49,1915,0.0129749804409239
STAT,1831,47,40-44,1878,0.001639052322893313
STAT,1865,20,30-34,1885,0.1654353965491295
STAT,1883,38,15-19,1921,5.426018198986411E-4
SIM,1950,16,20-24,1966,3
STAT,1919,25,35-39,1944,0.16190472849238513
STAT,1891,49,50-100,1940,0.0016648731808932753
STAT,1902,48,na,1950,31.334128715349397
SIM,1887,51,na,1938,21
STAT,1929,20,25-29,1949,1.1694388844400672
STAT,1936,25,35-39,1961,0.14293796047534751
STAT,1863,28,45-49,1891,0.00979599363252534
SIM,1805,77,na,1882,3
STAT,1898,18,15-19,1916,0.0798473915699523
SIM,1929,2,na,1931,51
STAT,1886,16,30-34,1902,0.016573275336153756
STAT,1916,29,na,1945,38.12834316459582
SIM,1960,5,na,1965,52
STAT,1835,27,30-34,1862,0.15112348855410487
SIM,1887,41,na,1928,25
STAT,1924,48,na,1972,43.33180286738828
STAT,1925,36,15-19,1961,2.2924872048703674E-4
STAT,1878,43,15-19,1921,1.4154517410203647E-4
STAT,1927,27,35-39,1954,0.1815896598270152
SIM,1859,34,na,1893,15
STAT,1852,25,15-19,1877,0.004588348046315558
STAT,1861,37,25-29,1898,0.024212767617603527
SIM,1900,56,na,1956,27
STAT,1833,42,na,1875,18.85824545229523
SIM,1855,41,na,1896,18
STAT,1826,44,50-100,1870,0.010791400800043836
SIM,1918,51,na,1969,34
STAT,1866,28,20-24,1894,0.10766418566092595
STAT,1853,19,na,1872,17.15022004169225
SIM,1869,22,na,1891,17
STAT,1852,39,25-29,1891,0.024393551215380484
STAT,1887,29,45-49,1916,0.012032427429569054
STAT,1887,21,20-24,1908,0.7544561172842055
STAT,1846,27,40-44,1873,0.02936903785655611
SIM,1944,25,35-39,1969,1
STAT,1878,23,20-24,1901,0.7092662572609679
STAT,1822,38,35-39,1860,0.042394031235140864
STAT,1826,35,15-19,1861,6.814674687666755E-4
SIM,1852,54,na,1906,20
STAT,1857,17,15-19,1874,0.05221647758705029
STAT,1861,17,30-34,1878,0.015406041087337301
STAT,1898,22,35-39,1920,0.07872067660235668
SIM,1874,23,na,1897,23
STAT,1836,39,40-44,1875,0.05078957775662521
STAT,1847,32,30-34,1879,0.21898786867023615
STAT,1836,25,30-34,1861,0.31903292409079365
STAT,1893,26,15-19,1919,0.005740264306152103
STAT,1843,49,25-29,1892,2.392339605576001E-4
STAT,1926,15,25-29,1941,0.5307281715312079
STAT,1842,23,40-44,1865,0.01957797168823223
STAT,1849,32,40-44,1881,0.035433963402189246
STAT,1874,88,na,1962,2.599730850128228
STAT,1881,16,45-49,1897,6.230986000251484E-4
SIM,1937,33,na,1970,39
STAT,1905,19,20-24,1924,0.25449334260769435
STAT,1862,16,35-39,1878,0.0054540561064077035
SIM,1889,8,na,1897,34
STAT,1826,49,25-29,1875,5.646132042726962E-4
STAT,1879,22,25-29,1901,0.5924978046689442
STAT,1817,39,30-34,1856,0.18619913430017648
STAT,1874,56,na,1930,20.69191184695609
STAT,1873,71,na,1944,13.57081936834397
STAT,1884,16,20-24,1900,0.17412223146055056
STAT,1876,17,25-29,1893,0.05755388669654061
STAT,1935,26,30-34,1961,0.5319816762934247
STAT,1860,38,20-24,1898,0.006235707796501796
SIM,1801,62,na,1863,7
SIM,1898,14,na,1912,35
STAT,1837,38,45-49,1875,0.011702256304998368
STAT,1929,28,20-24,1957,0.22725164346399532
SIM,1839,31,35-39,1870,1
STAT,1927,20,15-19,1947,0.06563891484484569
SIM,1856,47,45-49,1903,1
SIM,1805,55,na,1860,14
STAT,1834,31,50-100,1865,0.008380525783155351
STAT,1876,21,45-49,1897,0.00710369905842969
STAT,1899,34,45-49,1933,0.02366738783270694
STAT,1859,36,30-34,1895,0.04256426712612335
STAT,1863,37,35-39,1900,0.06262347782147103
STAT,1827,47,25-29,1874,4.3425015407234317E-4
SIM,1844,25,30-34,1869,1
SIM,1838,26,45-49,1864,1
STAT,1846,28,45-49,1874,0.010807449356705521
STAT,1901,39,30-34,1940,0.015934383515382584
STAT,1799,97,na,1896,0.019847068137856562
STAT,1901,53,na,1954,29.64567316197128
STAT,1920,39,40-44,1959,0.01621621347085809
STAT,1946,20,25-29,1966,1.0213482406454328
STAT,1861,36,20-24,1897,0.006513696883058271
STAT,1897,17,45-49,1914,8.674537296513775E-4
STAT,1916,26,20-24,1942,0.1877681771923359
STAT,1827,102,na,1929,0.0017766922049068307
STAT,1883,18,20-24,1901,0.17170742702264294
STAT,1837,37,40-44,1874,0.025971260514051082
STAT,1897,23,30-34,1920,0.23580826906941532
SIM,1887,73,na,1960,13
STAT,1852,27,30-34,1879,0.2510236662499029
STAT,1866,37,na,1903,21.6981151190308
STAT,1870,53,na,1923,21.045893508978363
SIM,1854,20,20-24,1874,2
STAT,1905,23,40-44,1928,0.029981461035270603
STAT,1945,15,35-39,1960,0.04553278732002369
STAT,1842,37,15-19,1879,4.942352869757349E-4
SIM,1899,25,20-24,1924,1
STAT,1853,48,30-34,1901,6.007256280250978E-4
STAT,1900,27,20-24,1927,0.1626779220432604
STAT,1812,43,50-100,1855,0.012234642147797768
STAT,1887,33,15-19,1920,0.0015478312526729376
STAT,1866,32,40-44,1898,0.03994035896550938
STAT,1822,36,35-39,1858,0.0446114519381687
STAT,1849,44,50-100,1893,0.008081064312360466
SIM,1870,1,na,1871,32
SIM,1909,26,na,1935,35
STAT,1867,47,20-24,1914,1.1429990395157088E-4
STAT,1838,38,50-100,1876,0.011379521951303281
STAT,1889,21,30-34,1910,0.21873983594065352
SIM,1880,19,na,1899,32
STAT,1851,18,25-29,1869,0.05782242310597368
SIM,1910,6,na,1916,34
STAT,1846,25,50-100,1871,0.00636269754874597
STAT,1921,23,25-29,1944,1.0319626532601227
STAT,1824,104,na,1928,4.6410695523912336E-4
STAT,1825,37,15-19,1862,5.886864667507846E-4
SIM,1847,75,na,1922,8
STAT,1796,79,na,1875,0.5641821100299066
STAT,1941,17,50-100,1958,0.003831032406956085
SIM,1860,42,na,1902,23
STAT,1871,25,25-29,1896,0.424606575591374
STAT,1896,38,35-39,1934,0.09244455891375015
STAT,1883,24,40-44,1907,0.020108803733271986
STAT,1862,18,35-39,1880,0.0053899965381340705
STAT,1833,36,45-49,1869,0.018644789066402725
STAT,1916,17,30-34,1933,0.02563929547934256
SIM,1770,84,na,1854,4
STAT,1839,33,35-39,1872,0.06806475597858573
STAT,1919,1,na,1920,45.749014649185305
STAT,1878,47,30-34,1925,9.947210302845497E-4
STAT,1956,0,na,1956,52.117612637392426
STAT,1855,28,45-49,1883,0.0080897366976097
STAT,1909,59,na,1968,31.566249758710804
STAT,1886,17,35-39,1903,0.00569157509478706
SIM,1941,29,25-29,1970,2
STAT,1892,28,15-19,1920,0.005585345992626697
STAT,1901,31,na,1932,33.527366957857076
SIM,1849,34,na,1883,9
SIM,1858,24,20-24,1882,1
STAT,1844,36,20-24,1880,0.007064856627759289
STAT,1900,67,na,1967,24.872558737873316
STAT,1818,75,na,1893,2.572655047896612
STAT,1905,26,45-49,1931,0.016079345181739046
STAT,1846,23,25-29,1869,0.5683210638429295
STAT,1930,33,na,1963,48.55038332261926
STAT,1894,16,30-34,1910,0.020477070335425698
STAT,1829,47,35-39,1876,0.0011950998942955287
STAT,1898,47,na,1945,30.214493155687972
STAT,1850,39,15-19,1889,4.974590027132139E-4
SIM,1843,72,na,1915,15
STAT,1847,29,15-19,1876,0.005742035709597571
SIM,1913,30,na,1943,41
STAT,1833,27,20-24,1860,0.11447402924037613
STAT,1885,38,25-29,1923,0.02829147330181036
STAT,1875,38,15-19,1913,5.743733265025683E-4
STAT,1876,26,15-19,1902,0.004623824046327738
STAT,1780,100,na,1880,0.004036393775310522
STAT,1868,15,25-29,1883,0.05649597611815577
STAT,1915,6,na,1921,41.45073251485215
STAT,1942,23,45-49,1965,0.011707550160075323
STAT,1905,34,na,1939,34.43581380634999
STAT,1920,15,30-34,1935,0.027329181342379272
STAT,1926,29,na,1955,44.331796882602305
SIM,1779,76,na,1855,4
STAT,1854,22,20-24,1876,0.4949155192057756
SIM,1876,26,30-34,1902,1
STAT,1865,52,na,1917,19.37145312833926
STAT,1818,47,25-29,1865,5.666829656691112E-4
STAT,1911,28,35-39,1939,0.1449587273168517
STAT,1912,16,35-39,1928,0.008439386084934287
STAT,1879,26,40-44,1905,0.031110784798974486
STAT,1878,48,35-39,1926,0.0014272232686485663
STAT,1895,23,20-24,1918,0.8918955576944151
STAT,1896,29,45-49,1925,0.014479994956604585
STAT,1909,27,40-44,1936,0.04429532837971256
STAT,1933,29,25-29,1962,0.8695366325261552
STAT,1923,27,50-100,1950,0.011348555541277174
SIM,1946,25,45-49,1971,1
SIM,1883,37,na,1920,13
STAT,1926,21,45-49,1947,0.013632404103984454
STAT,1845,49,35-39,1894,8.01281463478559E-4
STAT,1835,49,25-29,1884,2.679666687189428E-4
SIM,1954,4,na,1958,50
STAT,1840,26,35-39,1866,0.09495410508198857
STAT,1863,39,35-39,1902,0.06199320037212084
STAT,1924,15,15-19,1939,0.5394193686193086
STAT,1838,25,40-44,1863,0.030004367362224258
STAT,1914,29,15-19,1943,0.007007286339201269
STAT,1885,37,20-24,1922,0.007612246914069645
SIM,1946,25,na,1971,43
STAT,1916,33,45-49,1949,0.01603917979430755
STAT,1943,19,40-44,1962,0.014714411032972585
STAT,1894,66,na,1960,22.269126848921342
STAT,1863,27,40-44,1890,0.02652265125630363
STAT,1943,15,25-29,1958,0.45643143845827244
STAT,1901,39,50-100,1940,0.003670708046461118
STAT,1886,15,na,1901,26.31897786967487
STAT,1822,35,30-34,1857,0.03456805850850686
SIM,1794,65,na,1859,2
STAT,1887,26,40-44,1913,0.03280901865729914
STAT,1860,75,na,1935,8.369245731959934
SIM,1824,80,na,1904,5
STAT,1855,48,40-44,1903,0.0011902220408875313
STAT,1828,32,20-24,1860,0.037002607451822864
STAT,1854,27,40-44,1881,0.01919478170083594
STAT,1844,27,30-34,1871,0.24078736286840832
SIM,1819,68,na,1887,2
STAT,1915,44,na,1959,36.944593654025745
STAT,1931,3,na,1934,52.854736873247184
SIM,1913,52,na,1965,40
STAT,1818,46,20-24,1864,1.1980219710976848E-4
STAT,1889,11,na,1900,31.665659724841188
STAT,1938,25,45-49,1963,0.017017517453174456
STAT,1866,38,15-19,1904,5.146079762458039E-4
SIM,1895,70,na,1965,17
STAT,1895,17,35-39,1912,0.007123645156919399
SIM,1933,29,na,1962,47
STAT,1938,20,25-29,1958,0.9087822194476988
STAT,1776,80,na,1856,1.6546351698
STAT,1844,28,35-39,1872,0.0915998584867598
SIM,1842,76,na,1918,11
STAT,1898,69,na,1967,22.78937843497686
STAT,1948,20,35-39,1968,0.1074728301585738
STAT,1902,23,15-19,1925,0.04637864219120178
STAT,1866,26,20-24,1892,0.10841528257546189
STAT,1915,38,20-24,1953,0.002626901564495376
SIM,1891,20,25-29,1911,1
STAT,1883,20,25-29,1903,0.5592183483133986
STAT,1931,16,45-49,1947,0.0065255236948912705
STAT,1919,22,30-34,1941,0.3119923362086745
STAT,1874,37,45-49,1911,0.02022375135242563
STAT,1889,39,20-24,1928,0.00934276056565368
STAT,1901,15,20-24,1916,0.24922241120382713
STAT,1943,24,15-19,1967,0.056184108191831054
STAT,1851,6,na,1857,25.6069777275012
STAT,1931,22,30-34,1953,0.371116564299253
STAT,1829,38,45-49,1867,0.018107231497430445
STAT,1869,37,50-100,1906,0.011896107931422838
STAT,1890,41,na,1931,28.20172768103557
STAT,1895,40,na,1935,30.308560375693695
STAT,1896,26,50-100,1922,0.008431425269814908
STAT,1838,26,45-49,1864,0.011041242901147321
STAT,1865,74,na,1939,10.03789717916686
STAT,1861,52,50-100,1913,1.263312801140844E-4
SIM,1831,39,na,1870,10
STAT,1859,38,30-34,1897,0.04215027678052773
SIM,1814,69,na,1883,19
STAT,1843,20,na,1863,11.54971464777871
STAT,1921,27,40-44,1948,0.051542333944492875
STAT,1935,17,40-44,1952,0.019036516792463692
SIM,1882,74,na,1956,19
STAT,1870,18,35-39,1888,0.005470327335185223
STAT,1895,28,40-44,1923,0.03875317202368279
STAT,1827,35,na,1862,17.450340243292096
STAT,1849,89,na,1938,0.8145758679255561
STAT,1941,28,20-24,1969,0.1873717971016525
STAT,1841,61,na,1902,18.290482419370672
SIM,1896,55,na,1951,23
STAT,1905,32,30-34,1937,0.14469029042219161
STAT,1878,70,na,1948,14.485584371508015
STAT,1834,37,15-19,1871,4.936111266983867E-4
STAT,1923,20,30-34,1943,0.33408184725497414
STAT,1855,34,30-34,1889,0.12259408906966963
SIM,1895,24,25-29,1919,1
STAT,1881,27,35-39,1908,0.09181374530938652
STAT,1887,24,25-29,1911,0.6209286726228646
STAT,1786,79,na,1865,1.1864779961129053
STAT,1785,94,na,1879,0.1200973632338989
STAT,1906,27,15-19,1933,0.006591462310704372
SIM,1938,7,na,1945,40
STAT,1892,19,25-29,1911,0.06963176217843509
STAT,1919,20,15-19,1939,0.05812906849386876
STAT,1826,46,20-24,1872,1.224422831536584E-4
STAT,1869,36,25-29,1905,0.028032006774703886
STAT,1939,26,15-19,1965,0.007051428928133011
STAT,1913,25,40-44,1938,0.046367051483861325
SIM,1863,49,na,1912,11
STAT,1828,37,40-44,1865,0.019578055829896156
STAT,1939,32,35-39,1971,0.09260061668215824
STAT,1927,24,30-34,1951,0.35009398616558135
STAT,1869,27,35-39,1896,0.09349246241327912
STAT,1875,52,na,1927,22.015491614944757
STAT,1860,29,30-34,1889,0.20395486390965692
SIM,1893,37,na,1930,36
STAT,1826,94,na,1920,0.13966608672304048
SIM,1883,15,na,1898,15
STAT,1869,99,na,1968,0.1043650052932265
STAT,1847,23,na,1870,27.798907087138414
STAT,1945,10,na,1955,42.61363457285668
STAT,1879,31,15-19,1910,0.0014799570900704627
STAT,1811,95,na,1906,0.07534730927361488
STAT,1926,39,35-39,1965,0.029328746799697242
STAT,1837,46,30-34,1883,4.954300093239373E-4
STAT,1915,21,35-39,1936,0.09678205305135139
SIM,1895,9,na,1904,31
STAT,1848,38,20-24,1886,0.005084153340014657
STAT,1832,24,35-39,1856,0.035097197478105996
SIM,1879,20,25-29,1899,2
STAT,1842,39,15-19,1881,4.4051018613898874E-4
STAT,1910,25,15-19,1935,0.006879264710553988
STAT,1825,76,na,1901,5.107485133572876
STAT,1877,24,50-100,1901,0.004183109625182021
STAT,1908,31,45-49,1939,0.014836579043595553
STAT,1918,46,25-29,1964,5.607674622465392E-4
STAT,1877,29,35-39,1906,0.09889025567271208
STAT,1881,18,45-49,1899,6.199434897929343E-4
STAT,1877,35,20-24,1912,0.008032743108565287
SIM,1923,30,na,1953,40
STAT,1907,15,na,1922,37.11498714346468
STAT,1813,76,na,1889,6.271758982025074
STAT,1946,22,25-29,1968,1.0206436316955587
SIM,1799,64,na,1863,15
STAT,1843,42,na,1885,10.094460894843861
STAT,1869,38,40-44,1907,0.042205056500973406
STAT,1860,27,15-19,1887,0.0037279986996317373
SIM,1854,23,25-29,1877,3
STAT,1851,17,20-24,1868,0.1819710094641957
SIM,1896,33,na,1929,29
STAT,1893,37,20-24,1930,0.009719459093066533
STAT,1934,21,45-49,1955,0.015061897034902407
SIM,1896,36,35-39,1932,1
STAT,1871,39,35-39,1910,0.06980732950270062
STAT,1903,33,50-100,1936,0.0074482902343340875
STAT,1846,25,40-44,1871,0.02979536325034665
STAT,1788,104,na,1892,2.3921814676572384E-4
STAT,1935,22,15-19,1957,0.07216711877708498
STAT,1927,18,45-49,1945,0.006163285919521179
STAT,1875,49,20-24,1924,1.2077754683793237E-4
STAT,1889,48,45-49,1937,0.0016093956590086133
SIM,1811,62,na,1873,6
STAT,1830,38,35-39,1868,0.04051076284655328
SIM,1864,23,na,1887,23
STAT,1828,102,na,1930,0.0019689894974485945
STAT,1859,48,25-29,1907,4.5206206822246775E-4
STAT,1892,18,20-24,1910,0.21844580077361128
STAT,1948,21,50-100,1969,0.007507627708886457
SIM,1878,48,na,1926,28
STAT,1858,26,20-24,1884,0.09204604048616336
STAT,1852,36,20-24,1888,0.0067023287344526155
STAT,1911,20,50-100,1931,0.006237178561291321
STAT,1843,42,50-100,1885,0.00461410903564888
STAT,1907,31,50-100,1938,0.007727105607229883
STAT,1926,33,50-100,1959,0.009934066686393206
STAT,1917,34,15-19,1951,0.0013219982967431396
STAT,1821,54,50-100,1875,1.9697916483918222E-4
SIM,1902,25,30-34,1927,1
STAT,1884,26,15-19,1910,0.004460414093411242
SIM,1834,57,na,1891,12
STAT,1876,37,na,1913,23.928382011391207
STAT,1860,53,na,1913,17.223609526834277
STAT,1879,27,45-49,1906,0.011491748340241598
STAT,1837,47,35-39,1884,7.074041203213708E-4
STAT,1936,34,25-29,1970,0.0891169561170986
STAT,1843,19,50-100,1862,2.6246085575666047E-4
SIM,1814,80,na,1894,12
STAT,1904,20,20-24,1924,0.9933323392947245
STAT,1929,25,na,1954,46.83694288055291
STAT,1836,28,35-39,1864,0.1196293247612389
STAT,1951,17,25-29,1968,0.5129122769781589
STAT,1844,54,50-100,1898,1.1472281948770808E-4
STAT,1894,49,30-34,1943,6.851798683352803E-4
STAT,1870,17,30-34,1887,0.015984145352511147
SIM,1924,15,na,1939,55
STAT,1917,29,40-44,1946,0.048090698591621746
STAT,1946,24,40-44,1970,0.037127391317181485
STAT,1859,39,35-39,1898,0.055650977492390126
STAT,1845,86,na,1931,1.2969746483155564
SIM,1893,15,na,1908,39
STAT,1856,60,na,1916,13.816245564465722
STAT,1907,39,25-29,1946,0.00899877157202748
STAT,1865,23,35-39,1888,0.05303920293914599
SIM,1912,20,20-24,1932,2
STAT,1884,88,na,1972,3.8524321222769426
STAT,1906,30,na,1936,35.244648103714624
STAT,1888,36,35-39,1924,0.08305183944262051
STAT,1828,34,35-39,1862,0.04478434264067684
STAT,1826,30,na,1856,20.7831211293052
SIM,1873,17,na,1890,30
SIM,1894,27,35-39,1921,1
STAT,1917,31,45-49,1948,0.01639476338669356
STAT,1919,27,na,1946,40.12588719976858
SIM,1939,8,na,1947,30
STAT,1908,63,na,1971,29.694666297907073
SIM,1854,34,na,1888,17
STAT,1915,26,50-100,1941,0.010099217440796721
STAT,1908,20,40-44,1928,0.030934179365247325
SIM,1853,31,30-34,1884,2
STAT,1827,42,20-24,1869,0.0012421514665499765
STAT,1854,39,35-39,1893,0.04279706042442578
STAT,1868,36,30-34,1904,0.05182498032018278
STAT,1892,38,15-19,1930,6.902968095453853E-4
STAT,1854,31,25-29,1885,0.06478191488478621
STAT,1807,105,na,1912,1.2374301882653066E-4
STAT,1836,48,30-34,1884,9.652176859142786E-4
STAT,1894,33,20-24,1927,0.03449599159357405
SIM,1916,4,na,1920,49
STAT,1845,33,25-29,1878,0.07045390182206697
SIM,1852,3,na,1855,29
STAT,1893,60,na,1953,24.047196694747644
SIM,1846,15,na,1861,17
STAT,1871,41,50-100,1912,0.010580487641432648
SIM,1890,72,na,1962,16
STAT,1897,36,50-100,1933,0.01638234773283276
STAT,1823,97,na,1920,0.030895125748847386
SIM,1882,53,na,1935,29
STAT,1900,44,25-29,1944,6.100122791699738E-4
STAT,1886,27,35-39,1913,0.10008508423858212
STAT,1882,34,40-44,1916,0.04120482711654154
STAT,1875,28,15-19,1903,0.0046473831446005864
STAT,1895,25,35-39,1920,0.12611757562564138
STAT,1816,42,45-49,1858,0.02062362143533566
STAT,1861,27,30-34,1888,0.21330712021094703
STAT,1884,19,25-29,1903,0.05522214066548016
STAT,1845,31,30-34,1876,0.12261710334820276
STAT,1874,35,45-49,1909,0.02041581876960133
STAT,1832,36,50-100,1868,0.007040138386549374
SIM,1945,0,na,1945,42
STAT,1885,40,15-19,1925,1.3775017639276017E-4
STAT,1813,53,30-34,1866,1.7370491108255104E-4
STAT,1824,41,40-44,1865,0.030996994744343802
STAT,1848,47,50-100,1895,0.001580889898559017
STAT,1887,52,na,1939,23.37751949113251
STAT,1871,46,30-34,1917,9.678364338785088E-4
STAT,1940,12,na,1952,39.78125438328125
STAT,1880,44,30-34,1924,0.011926188059708066
STAT,1854,49,35-39,1903,8.378620610817835E-4
STAT,1815,43,40-44,1858,0.03394776707520255
STAT,1926,32,50-100,1958,0.009940229628763037
STAT,1891,32,40-44,1923,0.053227288309354165
STAT,1913,10,na,1923,40.16241290750747
STAT,1819,41,30-34,1860,0.011102251017789168
STAT,1876,42,15-19,1918,1.400862658525086E-4
STAT,1883,33,45-49,1916,0.01686247286599794
SIM,1819,37,na,1856,8
STAT,1927,22,15-19,1949,0.06524959857994898
SIM,1855,51,na,1906,14
STAT,1863,47,35-39,1910,0.001233777782426787
SIM,1823,42,na,1865,11
STAT,1854,89,na,1943,0.6421239158964841
STAT,1928,31,20-24,1959,0.03036759993192233
STAT,1828,49,35-39,1877,5.847456605311193E-4
STAT,1811,46,50-100,1857,0.00987941611570547
STAT,1833,34,45-49,1867,0.01628048887493137
STAT,1890,40,25-29,1930,0.007879007933978213
SIM,1852,23,na,1875,27
SIM,1827,56,na,1883,10
STAT,1842,88,na,1930,1.0300098788315408
STAT,1856,101,na,1957,0.0058570468788445825
STAT,1906,48,50-100,1954,0.00198742456038814
STAT,1831,26,35-39,1857,0.10732576585797485
STAT,1856,44,40-44,1900,0.016074559066092082
STAT,1929,30,25-29,1959,0.11697279900429865
STAT,1895,71,na,1966,20.28368273973062
STAT,1857,3,na,1860,24.85926458007344
SIM,1909,57,na,1966,33
STAT,1896,25,50-100,1921,0.00845959572357441
STAT,1859,28,30-34,1887,0.20214289613680914
STAT,1836,40,na,1876,24.764589475850773
STAT,1880,39,35-39,1919,0.07362696802154545
STAT,1886,32,30-34,1918,0.18110376680718232
STAT,1879,33,50-100,1912,0.00944321385087518
SIM,1888,78,na,1966,16
STAT,1862,30,20-24,1892,0.02350849258280364
STAT,1815,44,50-100,1859,0.015567400526884592
STAT,1889,28,15-19,1917,0.00553527104268261
STAT,1856,29,15-19,1885,0.003357116418111895
STAT,1870,102,na,1972,0.031070576124748308
STAT,1854,38,50-100,1892,0.007467171943879182
STAT,1859,13,na,1872,21.925037183957915
STAT,1835,37,30-34,1872,0.029889198432070305
STAT,1877,36,25-29,1913,0.029863879202621558
SIM,1831,61,na,1892,5
STAT,1813,48,35-39,1861,0.004274867765144589
STAT,1850,31,40-44,1881,0.04081426263026795
STAT,1788,105,na,1893,1.0515790513674458E-4
STAT,1835,19,30-34,1854,0.019176742909866352
STAT,1877,19,35-39,1896,0.005633735336818977
STAT,1906,1,na,1907,39.54370706276625
STAT,1952,13,na,1965,46.787438412959034
STAT,1853,15,30-34,1868,0.01219321666330235
SIM,1894,54,na,1948,27
STAT,1895,32,25-29,1927,0.1329751465305584
STAT,1825,29,15-19,1854,0.009396770921984291
STAT,1857,22,na,1879,18.478233437309967
STAT,1919,16,30-34,1935,0.0268554849475178
SIM,1914,48,na,1962,36
SIM,1844,24,na,1868,10
STAT,1881,40,30-34,1921,0.011049977053626424
STAT,1831,44,35-39,1875,0.017480861176526325
STAT,1843,25,15-19,1868,0.0024029177431709346
STAT,1851,30,45-49,1881,0.015644388380524277
STAT,1833,29,20-24,1862,0.11283608359142933
STAT,1852,51,45-49,1903,1.247985059936788E-4
STAT,1864,43,35-39,1907,0.016124277446647576
STAT,1828,41,25-29,1869,0.002860722186634598
SIM,1799,63,na,1862,16
STAT,1897,48,45-49,1945,0.0017456099921479193
SIM,1858,16,na,1874,25
STAT,1839,19,15-19,1858,0.04233880644951253
STAT,1881,42,25-29,1923,0.006102880200226839
STAT,1836,18,35-39,1854,0.007073388650667505
STAT,1844,34,20-24,1878,0.024729235926339094
STAT,1844,59,na,1903,15.18030235728074
STAT,1852,78,na,1930,6.687021977739046
STAT,1869,47,30-34,1916,9.335625744238057E-4
SIM,1872,43,na,1915,21
STAT,1862,23,30-34,1885,0.15618898970934547
STAT,1885,28,30-34,1913,0.2477996530625677
STAT,1855,23,40-44,1878,0.017016851831012217
STAT,1887,47,50-100,1934,0.002668245242048344
STAT,1889,46,45-49,1935,0.002897626422386768
STAT,1850,5,na,1855,27.358599999999996
STAT,1853,27,50-100,1880,0.004657391870789545
SIM,1880,62,na,1942,29
STAT,1844,35,30-34,1879,0.04935560754776801
STAT,1913,20,20-24,1933,1.07484758957907
STAT,1881,43,35-39,1924,0.017106209092603224
STAT,1892,31,45-49,1923,0.021631352271240956
STAT,1848,27,15-19,1875,0.0035027528271392595
STAT,1867,32,na,1899,22.836055666103068
SIM,1903,32,na,1935,37
STAT,1843,18,25-29,1861,0.030537846357999766
SIM,1907,46,na,1953,38
STAT,1919,24,50-100,1943,0.007097968030777309
STAT,1853,40,na,1893,14.672277346412839
STAT,1814,52,35-39,1866,2.3649729258270091E-4
STAT,1860,17,15-19,1877,0.05564342273450247
STAT,1933,39,40-44,1972,0.020263727872860803
STAT,1826,50,50-100,1876,1.5269964006277387E-4
STAT,1868,18,na,1886,24.737400799486082
STAT,1825,40,45-49,1865,0.015094692642815764
STAT,1872,45,35-39,1917,0.0014467190828962545
STAT,1818,37,30-34,1855,0.07311859602626115
SIM,1839,57,na,1896,19
STAT,1844,53,50-100,1897,1.1607274551808343E-4
STAT,1872,23,na,1895,24.123699370783296
SIM,1835,43,na,1878,18
STAT,1885,18,30-34,1903,0.015698458788689737
STAT,1943,2,na,1945,42.6830356765167
STAT,1857,43,45-49,1900,0.011123033681171937
STAT,1858,42,50-100,1900,0.008029117150251217
STAT,1928,16,25-29,1944,0.5447004802900469
STAT,1845,21,na,1866,15.628168627679004
SIM,1921,20,20-24,1941,4
STAT,1870,25,30-34,1895,0.2518512445864549
STAT,1905,21,25-29,1926,0.8286866876603347
SIM,1857,86,na,1943,3
STAT,1868,19,40-44,1887,0.0017809177090224175
SIM,1893,28,30-34,1921,1
STAT,1878,22,50-100,1900,0.004210099760551487
STAT,1899,37,15-19,1936,1.659211734258717E-4
STAT,1827,35,30-34,1862,0.044787844053060126
STAT,1838,23,40-44,1861,0.02083268361101783
SIM,1895,16,na,1911,31
STAT,1873,40,na,1913,23.735309499442547
STAT,1874,17,15-19,1891,0.060205507718828495
STAT,1894,26,30-34,1920,0.3238367059623013
SIM,1816,60,na,1876,9
SIM,1911,51,na,1962,38
STAT,1830,48,35-39,1878,1.3704370805759698E-4
STAT,1841,36,45-49,1877,0.023229574258439138
STAT,1885,19,50-100,1904,4.8120752594693817E-4
STAT,1860,35,15-19,1895,4.6085689970290055E-4
STAT,1829,33,40-44,1862,0.04082648097134415
STAT,1834,27,15-19,1861,0.0042042816285709755
STAT,1869,38,50-100,1907,0.011837103236082981
STAT,1889,17,50-100,1906,5.998231018833981E-4
STAT,1947,23,50-100,1970,0.007383324256659201
STAT,1871,24,35-39,1895,0.057815541704072944
STAT,1866,41,45-49,1907,0.013846148294994483
STAT,1835,86,na,1921,0.9979832157615227
STAT,1851,27,15-19,1878,0.004484745681474842
STAT,1858,36,15-19,1894,4.293617965472452E-4
STAT,1805,49,50-100,1854,0.004796337459559936
SIM,1941,26,na,1967,45
STAT,1780,95,na,1875,0.04694591872695745
STAT,1831,72,na,1903,10.248312704362538
STAT,1845,16,35-39,1861,0.004077985084593071
SIM,1863,70,na,1933,5
SIM,1871,26,na,1897,23
STAT,1819,36,35-39,1855,0.08646603144150282
STAT,1809,47,30-34,1856,0.003302459213538826
STAT,1853,32,20-24,1885,0.017494344388796827
STAT,1869,32,30-34,1901,0.16917443033531124
STAT,1907,21,35-39,1928,0.08561628054840749
SIM,1852,35,30-34,1887,1
STAT,1865,42,40-44,1907,0.020319367966029674
STAT,1823,42,35-39,1865,0.012835481977033646
STAT,1879,24,40-44,1903,0.02143261273519537
STAT,1913,54,na,1967,34.63004003797255
STAT,1892,32,50-100,1924,0.011319367602878536
STAT,1805,54,35-39,1859,1.6004098273298133E-4
STAT,1818,44,20-24,1862,0.0016077739669911346
STAT,1868,26,30-34,1894,0.2445329546515275
STAT,1910,22,50-100,1932,0.006141456374313417
STAT,1890,33,35-39,1923,0.12249464610595467
STAT,1853,25,30-34,1878,0.18600261649034744
STAT,1876,38,30-34,1914,0.05386114733606007
STAT,1815,46,45-49,1861,0.0034503246774176964
STAT,1833,47,50-100,1880,0.0021299424579809775
SIM,1848,61,na,1909,20
STAT,1869,34,25-29,1903,0.09839513920247489
STAT,1880,26,30-34,1906,0.2657097734625844
STAT,1943,21,45-49,1964,0.01188775443452087
STAT,1917,48,50-100,1965,0.0023344810501417074
STAT,1901,21,na,1922,33.19330361480268
STAT,1885,35,20-24,1920,0.007684541345414777
SIM,1867,52,na,1919,10
SIM,1875,71,na,1946,7
STAT,1896,13,na,1909,33.86960759026336
STAT,1896,24,40-44,1920,0.02720022835675724
STAT,1905,35,na,1940,34.596214402530784
SIM,1861,25,30-34,1886,1
STAT,1882,37,45-49,1919,0.019104455853818588
STAT,1865,27,15-19,1892,0.004103682045743136
STAT,1854,24,35-39,1878,0.04130957528402866
STAT,1904,31,50-100,1935,0.013182449748123833
STAT,1918,24,15-19,1942,0.056536180304852385
STAT,1830,55,na,1885,7.565626810390114
STAT,1875,31,45-49,1906,0.017998738497667477
SIM,1883,31,45-49,1914,1
STAT,1886,34,25-29,1920,0.10533347332552422
STAT,1840,42,35-39,1882,0.014801589952509521
STAT,1844,17,30-34,1861,0.01582562163328955
STAT,1907,49,40-44,1956,0.0013905352712884403
STAT,1885,41,na,1926,22.92710734801765
SIM,1856,80,na,1936,3
STAT,1855,45,35-39,1900,9.955247287795773E-4
STAT,1819,43,25-29,1862,0.0059765086105262365
SIM,1866,29,25-29,1895,1
STAT,1895,22,30-34,1917,0.23124889759826436
STAT,1909,29,50-100,1938,0.009391509262597313
STAT,1854,46,30-34,1900,5.933553773899475E-4
STAT,1864,46,40-44,1910,0.0015398916347724736
STAT,1874,32,40-44,1906,0.04399561627993751
STAT,1928,21,20-24,1949,1.3857048279996302
STAT,1899,40,45-49,1939,0.0014370853470515622
STAT,1964,5,na,1969,49.20996459797044
STAT,1860,22,na,1882,19.82049603597399
STAT,1862,38,30-34,1900,0.04575364278993314
STAT,1827,45,25-29,1872,4.455914066436122E-4
STAT,1831,43,25-29,1874,0.006279355501828341
STAT,1868,39,35-39,1907,0.06775896798119574
STAT,1885,36,30-34,1921,0.052883682682312416
STAT,1877,33,20-24,1910,0.027784873697452864
STAT,1883,49,50-100,1932,0.0023351795899147934
STAT,1800,89,na,1889,0.35302608585157264
SIM,1840,42,na,1882,17
STAT,1892,23,45-49,1915,0.008588144394168837
STAT,1862,31,30-34,1893,0.15125186142043345
STAT,1832,37,50-100,1869,0.006967413757016318
STAT,1868,40,15-19,1908,1.3499249330917342E-4
STAT,1935,24,15-19,1959,0.0721180534716188
STAT,1893,16,15-19,1909,0.0750111844820091
STAT,1841,41,40-44,1882,0.023172622290866262
SIM,1876,89,na,1965,2
SIM,1880,37,35-39,1917,2
STAT,1825,32,45-49,1857,0.020915698443740215
STAT,1854,36,30-34,1890,0.03273303712171444
STAT,1828,101,na,1929,0.0038323591760064508
STAT,1923,47,30-34,1970,0.0010356267487276524
STAT,1858,29,25-29,1887,0.32480288381923544
STAT,1775,84,na,1859,1.5607533675062304
STAT,1842,19,20-24,1861,0.16880055793943505
STAT,1894,36,25-29,1930,0.03707715705828758
STAT,1856,92,na,1948,0.3017222431695734
STAT,1865,44,50-100,1909,0.009426492648904878
STAT,1822,36,na,1858,10.401548576219296
STAT,1891,21,50-100,1912,0.005020182598234355
SIM,1879,53,na,1932,13
STAT,1919,41,20-24,1960,1.89996406759576E-4
STAT,1899,33,na,1932,32.529159624513824
SIM,1936,21,20-24,1957,1
STAT,1846,37,35-39,1883,0.0598591671725293
STAT,1835,44,20-24,1879,8.399985725788324E-4
STAT,1844,42,20-24,1886,0.0012704592452546085
SIM,1947,11,na,1958,41
STAT,1868,29,35-39,1897,0.09270966852053455
STAT,1816,40,na,1856,9.669770909645948
SIM,1900,12,na,1912,39
SIM,1860,10,na,1870,28
STAT,1939,20,40-44,1959,0.03355901599165702
STAT,1803,77,na,1880,3.858802235246499
STAT,1828,39,40-44,1867,0.019340037088636502
STAT,1897,45,40-44,1942,0.0012952057500907163
STAT,1947,22,na,1969,40.990099323326554
STAT,1839,37,na,1876,14.124672736080429
SIM,1823,62,na,1885,6
STAT,1856,47,45-49,1903,0.0017016921667457265
STAT,1898,48,na,1946,29.974590080031824
STAT,1895,37,30-34,1932,0.06919152238838
STAT,1883,30,40-44,1913,0.042451560735608414
STAT,1919,23,20-24,1942,1.2033120226269465
SIM,1919,47,na,1966,43
SIM,1811,61,na,1872,6
SIM,1815,75,na,1890,2
STAT,1831,105,na,1936,2.3793540074802276E-4
SIM,1770,85,na,1855,4
SIM,1864,24,na,1888,21
SIM,1923,29,na,1952,40
STAT,1877,26,30-34,1903,0.2608350001870315
STAT,1872,27,35-39,1899,0.09872496084310946
SIM,1889,63,na,1952,22
SIM,1893,69,na,1962,23
STAT,1850,12,na,1862,25.973422232724275
STAT,1827,36,na,1863,17.270651274592353
STAT,1869,67,na,1936,15.359831866987488
STAT,1828,46,30-34,1874,4.199828966227741E-4
STAT,1863,44,30-34,1907,0.010041735873799989
STAT,1818,45,30-34,1863,9.806790249534494E-4
STAT,1833,31,40-44,1864,0.04176909416549457
STAT,1823,45,40-44,1868,0.0012183496041188906
STAT,1828,31,30-34,1859,0.24391445785056998
STAT,1900,35,na,1935,32.98018115341712
STAT,1904,49,na,1953,31.570527781920383
SIM,1882,73,na,1955,20
STAT,1885,43,20-24,1928,0.001556973142425025
STAT,1813,45,30-34,1858,0.0030911276748547987
STAT,1871,37,na,1908,23.48910077518804
SIM,1905,11,na,1916,40
STAT,1862,88,na,1950,1.184434260926251
STAT,1792,64,na,1856,16.70651208
STAT,1880,36,30-34,1916,0.05631307976547466
STAT,1881,26,50-100,1907,0.006107839750958574
STAT,1821,37,30-34,1858,0.10894100906443654
STAT,1852,33,15-19,1885,0.0012488795840093138
STAT,1890,36,40-44,1926,0.0534295811637358
STAT,1940,32,na,1972,38.864840255673606
STAT,1894,34,na,1928,30.320931407896797
STAT,1807,52,45-49,1859,2.973719047709978E-4
STAT,1925,20,40-44,1945,0.04023392127620372
STAT,1893,42,15-19,1935,1.739106383803543E-4
STAT,1873,40,25-29,1913,0.006594640762893512
STAT,1836,41,30-34,1877,0.013369421316352279
STAT,1786,80,na,1866,1.0791847909244152
STAT,1966,6,na,1972,48.783867265773374
STAT,1877,41,20-24,1918,0.0016467828202288357
SIM,1906,29,na,1935,27
STAT,1841,33,40-44,1874,0.05097058805085603
STAT,1855,49,50-100,1904,0.0016930911856331444
STAT,1805,88,na,1893,0.3758851005411951
STAT,1839,17,50-100,1856,3.5367630915127634E-4
STAT,1854,29,40-44,1883,0.01892013417267609
STAT,1845,26,35-39,1871,0.06914863532551843
STAT,1861,46,50-100,1907,0.0020712507723149574
SIM,1898,68,na,1966,20
STAT,1945,11,na,1956,42.60852093670794
SIM,1835,75,na,1910,5
STAT,1922,47,na,1969,41.89580848336283
STAT,1887,38,35-39,1925,0.07681856587117561
STAT,1889,43,40-44,1932,0.02733966447311313
SIM,1865,41,na,1906,24
STAT,1853,18,35-39,1871,0.004123927962064686
SIM,1794,64,na,1858,4
STAT,1927,43,50-100,1970,0.0014635306460014147
STAT,1774,99,na,1873,0.001455484675662578
STAT,1861,34,20-24,1895,0.022536903522175286
SIM,1853,60,na,1913,19
STAT,1842,32,50-100,1874,0.008304442473151563
STAT,1841,62,na,1903,17.890103759210646
STAT,1871,23,25-29,1894,0.5689753686854518
STAT,1903,64,na,1967,27.427819730969087
SIM,1947,1,na,1948,44
STAT,1853,28,35-39,1881,0.06346913639387455
STAT,1832,40,35-39,1872,0.010218209205443484
STAT,1869,35,35-39,1904,0.06918332547815667
STAT,1952,19,50-100,1971,0.004460224262013738
STAT,1851,22,45-49,1873,0.0070302313289909765
STAT,1887,30,25-29,1917,0.11269747374993522
STAT,1811,50,45-49,1861,5.732269937386056E-4
STAT,1867,44,15-19,1911,1.3037078378809951E-4
STAT,1868,18,30-34,1886,0.0156113761368203
STAT,1834,69,na,1903,10.371062555183784
STAT,1880,42,na,1922,24.27399113578186
STAT,1914,16,50-100,1930,7.704671577080195E-4
STAT,1852,41,15-19,1893,1.1872596667824346E-4
STAT,1914,15,50-100,1929,7.721504456796012E-4
SIM,1909,28,30-34,1937,1
SIM,1928,28,na,1956,52
STAT,1851,37,15-19,1888,4.791509521602376E-4
SIM,1924,14,na,1938,55
STAT,1915,45,na,1960,36.87241306310797
SIM,1829,67,na,1896,17
SIM,1940,3,na,1943,37
STAT,1908,18,50-100,1926,7.210774667869823E-4
STAT,1877,49,30-34,1926,9.78365571268568E-4
STAT,1893,34,15-19,1927,0.0017802130258177346
SIM,1845,41,na,1886,23
STAT,1817,49,30-34,1866,0.0027185890898953403
STAT,1837,35,40-44,1872,0.02652907065160218
STAT,1872,44,25-29,1916,0.0064816719154899985
STAT,1864,99,na,1963,0.05442692177512527
STAT,1831,36,35-39,1867,0.07309408898198136
STAT,1810,79,na,1889,2.4445847762727744
SIM,1830,44,na,1874,19
SIM,1866,35,na,1901,29
STAT,1843,39,30-34,1882,0.023523560019985096
SIM,1834,58,na,1892,12
STAT,1840,45,na,1885,18.239419146508762
SIM,1899,30,na,1929,26
STAT,1836,33,30-34,1869,0.21078750672426558
STAT,1853,35,25-29,1888,0.018474934075814593
STAT,1869,42,25-29,1911,0.006214464901848645
SIM,1870,72,na,1942,11
SIM,1895,30,25-29,1925,2
STAT,1859,46,30-34,1905,7.71567168974775E-4
STAT,1894,29,35-39,1923,0.12277606389425445
STAT,1873,41,35-39,1914,0.01849371285325892
STAT,1927,18,30-34,1945,0.15038420701096683
STAT,1879,65,na,1944,17.491281017385788
STAT,1871,16,35-39,1887,0.005538585741597191
STAT,1875,51,na,1926,22.239218149529023
STAT,1851,17,na,1868,23.5611141786748
STAT,1826,43,15-19,1869,1.4362765152861365E-4
SIM,1888,14,na,1902,39
SIM,1901,41,na,1942,38
STAT,1917,21,45-49,1938,0.011885576778871221
SIM,1877,42,na,1919,23
STAT,1833,42,45-49,1875,0.013426431411746946
SIM,1961,6,na,1967,53
STAT,1862,33,na,1895,20.501365325951085
STAT,1948,22,35-39,1970,0.10739868667353658
SIM,1831,29,na,1860,10
SIM,1885,34,30-34,1919,1
STAT,1863,25,40-44,1888,0.026907658071863603
STAT,1906,20,na,1926,34.56481062754455
STAT,1880,47,35-39,1927,0.0014653109822876944
STAT,1854,21,30-34,1875,0.12884933388290928
STAT,1877,34,30-34,1911,0.17868680725284936
STAT,1903,20,50-100,1923,0.005832283870622817
STAT,1868,93,na,1961,0.5876354932821055
STAT,1827,38,35-39,1865,0.057052427931572836
STAT,1851,19,15-19,1870,0.06019857046090257
STAT,1797,96,na,1893,0.018393459137857667
STAT,1933,30,na,1963,50.81782889832817
STAT,1863,18,na,1881,23.083478103287273
STAT,1911,33,50-100,1944,0.007965372947956857
STAT,1880,29,35-39,1909,0.10073842626032588
SIM,1853,17,na,1870,28
STAT,1947,22,40-44,1969,0.0377412388154254
STAT,1880,21,25-29,1901,0.6037853946819589
STAT,1836,40,20-24,1876,0.001870640250162566
SIM,1847,76,na,1923,7
STAT,1902,20,45-49,1922,0.009892208193040297
STAT,1821,41,50-100,1862,0.017043947715872514
STAT,1900,36,25-29,1936,0.008659003745454641
STAT,1872,37,35-39,1909,0.072368025033895
SIM,1843,62,na,1905,18
STAT,1806,50,35-39,1856,2.9022315751922286E-4
SIM,1858,48,na,1906,24
STAT,1808,53,na,1861,4.475807456803231
STAT,1811,96,na,1907,0.048661552748178696
STAT,1937,32,25-29,1969,0.09086510175543164
STAT,1848,42,40-44,1890,0.014528152890485875
STAT,1895,47,30-34,1942,7.055848185501813E-4
SIM,1912,13,na,1925,40
STAT,1835,19,50-100,1854,5.894489450114148E-4
STAT,1920,48,45-49,1968,0.002375419000532642
SIM,1939,24,na,1963,30
STAT,1870,30,50-100,1900,0.009175040906917916
STAT,1852,6,na,1858,25.823665739029778
STAT,1869,39,30-34,1908,0.051120747110332126
STAT,1915,47,25-29,1962,5.299019314951137E-4
STAT,1884,47,20-24,1931,1.1702211986791965E-4
STAT,1933,36,50-100,1969,0.005700608594612599
SIM,1840,32,35-39,1872,2
STAT,1885,39,35-39,1924,0.06914317650407326
STAT,1836,92,na,1928,0.4019606097640414
STAT,1881,46,40-44,1927,0.0016336675160501715
SIM,1929,13,na,1942,51
STAT,1837,101,na,1938,0.002759103685853841
STAT,1829,37,35-39,1866,0.06499050241799639
STAT,1904,18,na,1922,36.09435933280349
SIM,1877,24,30-34,1901,2
STAT,1878,36,40-44,1914,0.04541162911196304
SIM,1846,59,na,1905,8
STAT,1891,14,na,1905,31.59416751495303
STAT,1867,48,30-34,1915,9.146983587087696E-4
STAT,1769,105,na,1874,9.92187123995393E-4
STAT,1844,45,25-29,1889,4.570058118100606E-4
SIM,1890,17,na,1907,30
STAT,1828,73,na,1901,7.977053284691322
STAT,1835,33,15-19,1868,8.157078446797542E-4
SIM,1884,16,15-19,1900,2
SIM,1863,27,35-39,1890,1
STAT,1823,41,25-29,1864,0.004587592402570161
STAT,1895,15,50-100,1910,6.389947611837557E-4
STAT,1878,22,30-34,1900,0.18389713759673412
STAT,1925,23,45-49,1948,0.013342585398391608
STAT,1884,21,45-49,1905,0.0068526481713197295
STAT,1789,77,na,1866,2.137253851839663
STAT,1880,19,40-44,1899,0.0019130083842172365
STAT,1870,21,15-19,1891,0.03287106995758491
SIM,1822,56,na,1878,12
STAT,1818,48,35-39,1866,0.0013573193110867129
SIM,1899,53,na,1952,28
STAT,1863,94,na,1957,0.23191166729450477
STAT,1876,52,45-49,1928,1.466100588392335E-4
STAT,1895,40,25-29,1935,0.008420958981927863
STAT,1900,15,na,1915,35.18484320465291
STAT,1858,28,15-19,1886,0.0035088565572697424
STAT,1904,29,na,1933,33.95186205030852
STAT,1814,41,30-34,1855,0.038123801276877915
STAT,1878,37,30-34,1915,0.05502349652402806
SIM,1880,34,30-34,1914,1
STAT,1957,12,na,1969,51.49852288866254
STAT,1872,34,30-34,1906,0.17711315929660737
STAT,1930,3,na,1933,52.19329966315326
SIM,1857,22,na,1879,22
STAT,1869,31,20-24,1900,0.026298088477469086
STAT,1881,32,30-34,1913,0.1661367949750425
STAT,1945,3,na,1948,43.49073297810564
STAT,1900,29,35-39,1929,0.1328436594655515
SIM,1909,20,20-24,1929,2
STAT,1893,38,30-34,1931,0.06686613038122312
STAT,1867,26,15-19,1893,0.004356654135445218
STAT,1821,42,na,1863,17.085301161000498
STAT,1892,20,40-44,1912,0.025897134261948382
STAT,1904,30,20-24,1934,0.0390432092731085
STAT,1880,73,na,1953,12.489849835303662
STAT,1876,36,na,1912,24.043550618855527
STAT,1873,33,35-39,1906,0.10252663701008241
STAT,1853,41,30-34,1894,0.007258142313587977
STAT,1843,20,45-49,1863,0.003766783848816411
STAT,1872,41,20-24,1913,0.0016322800348286775
STAT,1897,38,15-19,1935,7.42008824215365E-4
STAT,1809,93,na,1902,0.16170757525732415
STAT,1850,46,50-100,1896,0.002192944745563883
SIM,1867,21,na,1888,12
STAT,1823,34,35-39,1857,0.08061098418700154
STAT,1869,98,na,1967,0.15188317561665232
STAT,1873,47,45-49,1920,0.002388208488084781
STAT,1860,39,30-34,1899,0.042891935694825106
STAT,1922,21,25-29,1943,1.0546825734063294
STAT,1806,74,na,1880,6.407969866509147
STAT,1852,44,20-24,1896,0.001340851864074521
SIM,1930,21,25-29,1951,2
STAT,1826,104,na,1930,4.6611115191892846E-4
STAT,1855,27,35-39,1882,0.07081110863636625
STAT,1847,39,15-19,1886,6.09593322251704E-4
STAT,1890,25,35-39,1915,0.11800097602910271
STAT,1890,32,25-29,1922,0.12441721148204975
STAT,1890,72,na,1962,17.439389502688076
STAT,1825,45,na,1870,14.258389483285425
STAT,1837,36,30-34,1873,0.031957478565089875
STAT,1944,18,30-34,1962,0.1301773204530622
STAT,1859,49,35-39,1908,0.0010895104065693677
STAT,1849,28,20-24,1877,0.10705584136327242
SIM,1956,15,na,1971,41
STAT,1880,15,50-100,1895,5.175691977217566E-4
SIM,1856,69,na,1925,7
SIM,1886,12,na,1898,30
STAT,1840,45,40-44,1885,0.0013879153540668232
STAT,1914,28,na,1942,37.32011880609089
STAT,1899,29,15-19,1928,0.006166496264444796
STAT,1840,22,na,1862,21.306334322223165
STAT,1886,67,na,1953,16.44293054880062
STAT,1948,8,na,1956,44.67952805115011
STAT,1840,31,30-34,1871,0.16837638604673358
STAT,1867,19,25-29,1886,0.05478651682874434
STAT,1942,29,40-44,1971,0.048515846779317424
STAT,1931,28,na,1959,48.12710851243372
STAT,1882,53,na,1935,20.303435629704328
STAT,1857,40,40-44,1897,0.017008163818899795
SIM,1944,23,20-24,1967,2
STAT,1885,46,25-29,1931,5.704234778437685E-4
STAT,1932,39,25-29,1971,0.013147602833053603
STAT,1936,23,20-24,1959,1.0562978224869286
SIM,1820,45,na,1865,14
STAT,1819,37,na,1856,15.369186137089967
STAT,1841,44,45-49,1885,0.01483739591669757
STAT,1925,41,45-49,1966,0.0020052289063230665
STAT,1823,74,na,1897,6.382261955289145
SIM,1873,69,na,1942,13
SIM,1878,35,30-34,1913,2
STAT,1831,33,30-34,1864,0.1821850210290236
SIM,1925,31,na,1956,45
STAT,1848,18,na,1866,18.29371624048195
STAT,1936,19,35-39,1955,0.039716638856106844
STAT,1860,43,15-19,1903,1.1145913133303061E-4
STAT,1863,73,na,1936,10.51633367859318
SIM,1895,71,na,1966,15
STAT,1868,32,15-19,1900,0.0013781435749077614
SIM,1851,37,na,1888,19
STAT,1864,42,25-29,1906,0.005752562302927777
SIM,1897,2,na,1899,43
STAT,1847,54,40-44,1901,1.0936766505993704E-4
STAT,1815,55,na,1870,9.462352289182883
STAT,1881,17,35-39,1898,0.00522120583838787
SIM,1842,77,na,1919,8
STAT,1898,41,40-44,1939,0.0021165968065745906
STAT,1859,68,na,1927,12.146372184223337
SIM,1896,26,35-39,1922,1
STAT,1843,17,15-19,1860,0.03217061858134715
STAT,1911,47,40-44,1958,0.0014829745587320933
SIM,1942,12,na,1954,43
STAT,1866,47,na,1913,20.624017917124807
STAT,1871,20,20-24,1891,0.691157188114766
STAT,1920,35,na,1955,40.91196791854688
STAT,1855,54,na,1909,14.74291922152588
STAT,1843,74,na,1917,4.707651870311228
STAT,1906,21,40-44,1927,0.030365304190372318
STAT,1826,29,30-34,1855,0.6585280390193805
STAT,1868,46,25-29,1914,5.590039122466589E-4
STAT,1925,22,50-100,1947,0.007826866835352997
SIM,1891,4,na,1895,38
STAT,1894,42,30-34,1936,0.001021903312615605
STAT,1861,23,15-19,1884,0.028297154411739783
STAT,1893,49,na,1942,27.7806005163677
STAT,1896,43,30-34,1939,0.0010410903487301098
SIM,1944,19,35-39,1963,1
STAT,1882,30,25-29,1912,0.09894838040007801
SIM,1843,18,na,1861,23
STAT,1851,92,na,1943,0.3516172260900747
STAT,1916,39,40-44,1955,0.015045998942884635
SIM,1918,5,na,1923,41
STAT,1852,15,15-19,1867,0.06215956635478906
STAT,1877,44,25-29,1921,0.006539261480282073
STAT,1877,42,30-34,1919,0.011852966524077422
SIM,1928,22,25-29,1950,2
STAT,1871,28,30-34,1899,0.2501798862390204
STAT,1831,26,50-100,1857,0.007115347152736304
STAT,1832,28,15-19,1860,0.002694800613861785
STAT,1859,57,na,1916,15.972886572403304
STAT,1877,16,30-34,1893,0.01649330216875539
STAT,1914,48,20-24,1962,1.0838988579671887E-4
STAT,1819,92,na,1911,0.21379875246285027
STAT,1867,87,na,1954,1.6859806194119462
STAT,1826,47,30-34,1873,9.745612939210294E-4
STAT,1807,59,na,1866,12.077245383367334
STAT,1872,26,45-49,1898,0.011399276246335925
STAT,1888,44,35-39,1932,0.0208754986260698
STAT,1868,27,50-100,1895,0.006190593044200733
SIM,1828,41,na,1869,13
STAT,1857,36,20-24,1893,0.005798411108431735
STAT,1828,96,na,1924,0.057668761402040136
STAT,1846,33,40-44,1879,0.04110472731841018
STAT,1913,5,na,1918,40.63240149462854
STAT,1921,30,20-24,1951,0.027148890249789615
STAT,1843,35,15-19,1878,2.8391756932230524E-4
STAT,1795,84,na,1879,1.347243129952285
STAT,1836,43,25-29,1879,0.00727868966035984
STAT,1776,81,na,1857,1.33909624291914
STAT,1799,98,na,1897,0.012001323632280483
STAT,1814,60,na,1874,10.82476173405494
STAT,1899,9,na,1908,35.518804929968574
STAT,1876,45,20-24,1921,1.2309256107692385E-4
STAT,1906,49,25-29,1955,4.6218146932078323E-4
STAT,1846,39,na,1885,19.52916716210331
STAT,1884,18,15-19,1902,0.0579915399291094
STAT,1837,24,35-39,1861,0.03752592196734296
STAT,1843,73,na,1916,5.03837051062891
STAT,1847,87,na,1934,1.8820283276574012
STAT,1833,50,45-49,1883,1.1520620095522813E-4
STAT,1822,43,30-34,1865,0.006474420467182929
SIM,1841,82,na,1923,4
STAT,1856,37,15-19,1893,4.06802372084508E-4
SIM,1898,13,na,1911,35
STAT,1887,34,40-44,1921,0.04693032774827917
SIM,1876,8,na,1884,33
SIM,1937,12,na,1949,41
SIM,1864,55,na,1919,19
STAT,1863,29,35-39,1892,0.08482078798221061
STAT,1831,40,20-24,1871,0.0016140564914927937
STAT,1815,78,na,1893,2.7891134898085994
SIM,1878,16,na,1894,29
STAT,1875,18,20-24,1893,0.18176158359110473
SIM,1860,41,na,1901,24
STAT,1896,25,30-34,1921,0.33301739266939506
STAT,1907,20,45-49,1927,0.010260941658637893
SIM,1894,9,na,1903,32
STAT,1832,46,45-49,1878,0.0012709991321302684
STAT,1877,37,35-39,1914,0.0730110139294922
STAT,1863,21,25-29,1884,0.5206908377795857
STAT,1856,19,15-19,1875,0.05023799942715922
STAT,1832,32,35-39,1864,0.05918310596623128
STAT,1930,20,20-24,1950,1.4262744532152782
STAT,1814,44,35-39,1858,0.0537860490565923
STAT,1856,91,na,1947,0.4197933093602324
STAT,1824,44,45-49,1868,0.01961746355353752
SIM,1887,72,na,1959,13
SIM,1932,13,na,1945,53
STAT,1859,108,na,1967,1.416785222310945E-4
SIM,1944,26,25-29,1970,1
STAT,1868,50,45-49,1918,1.4246143313180996E-4
STAT,1884,24,na,1908,23.02655151163613
STAT,1843,43,50-100,1886,0.00455537142762507
STAT,1908,23,45-49,1931,0.010258555885630053
STAT,1855,42,30-34,1897,0.008084501409576984
SIM,1851,92,na,1943,2
SIM,1891,57,na,1948,31
STAT,1934,31,45-49,1965,0.021406023972050523
STAT,1806,53,40-44,1859,3.34258671191128E-4
STAT,1895,36,40-44,1931,0.0571046907391842
STAT,1898,37,20-24,1935,0.01039875815752438
STAT,1900,41,20-24,1941,1.5361944838798773E-4
SIM,1802,57,na,1859,11
STAT,1871,49,35-39,1920,0.0013666572515893232
STAT,1938,32,40-44,1970,0.039089269059881644
STAT,1834,30,45-49,1864,0.01611651665766718
STAT,1814,93,na,1907,0.13023473972822458
STAT,1882,23,35-39,1905,0.055751155246000036
STAT,1877,86,na,1963,4.112989811562096
STAT,1901,28,40-44,1929,0.04176845246136951
STAT,1937,12,na,1949,38.30310741476778
STAT,1888,19,45-49,1907,7.592637777119521E-4
STAT,1825,33,50-100,1858,0.010512038249230521
STAT,1891,35,45-49,1926,0.024699703370597667
STAT,1881,35,35-39,1916,0.06794109451336552
STAT,1850,105,na,1955,2.6106096377395623E-4
SIM,1918,21,25-29,1939,2
SIM,1861,36,na,1897,25
STAT,1894,18,50-100,1912,6.262309084740393E-4
STAT,1936,26,25-29,1962,0.626384508782414
STAT,1852,19,30-34,1871,0.01630461848495819
STAT,1859,53,50-100,1912,1.1811184544708655E-4
STAT,1884,36,15-19,1920,5.528234377494655E-4
STAT,1907,46,na,1953,33.00915350812843
STAT,1835,102,na,1937,0.0013186801458576103
STAT,1923,49,25-29,1972,6.126286647456004E-4
STAT,1816,39,15-19,1855,8.263238915264324E-4
SIM,1851,81,na,1932,7
STAT,1882,50,40-44,1932,1.023409213145906E-4
STAT,1860,21,na,1881,19.963836381190923
STAT,1875,20,na,1895,24.456387143631247
SIM,1832,44,45-49,1876,1
STAT,1827,31,15-19,1858,0.0012999231424222057
STAT,1837,31,25-29,1868,0.0633525569582083
STAT,1848,73,na,1921,7.681193598270294
SIM,1832,23,na,1855,25
SIM,1834,89,na,1923,1
STAT,1880,21,na,1901,24.94482573446834
STAT,1949,21,40-44,1970,0.03899659892267374
STAT,1874,51,45-49,1925,1.4793161972081974E-4
STAT,1839,37,15-19,1876,3.7032530891712876E-4
STAT,1864,35,na,1899,21.331984846854382
STAT,1847,25,35-39,1872,0.12568738630595458
STAT,1894,22,15-19,1916,0.04228002434513017
STAT,1845,30,20-24,1875,0.019181338995662735
STAT,1837,39,35-39,1876,0.041081615420115215
SIM,1853,38,30-34,1891,1
STAT,1827,39,25-29,1866,0.02289507852541518
STAT,1913,31,25-29,1944,0.09156092398831697
STAT,1869,17,35-39,1886,0.005390292751133796
SIM,1863,24,30-34,1887,1
SIM,1902,47,na,1949,30
SIM,1934,24,na,1958,52
STAT,1850,34,45-49,1884,0.01590832078038042
STAT,1840,34,35-39,1874,0.09466704730125602
SIM,1853,4,na,1857,29
STAT,1858,28,na,1886,18.45695578778096
STAT,1855,24,30-34,1879,0.14441471540558465
STAT,1860,20,45-49,1880,0.006515160581050005
STAT,1842,25,20-24,1867,0.11042822860416633
STAT,1890,22,30-34,1912,0.21636631918177526
SIM,1874,54,na,1928,25
SIM,1878,68,na,1946,18
STAT,1908,41,45-49,1949,0.0015406279240026326
STAT,1903,17,30-34,1920,0.022660570709635775
STAT,1932,13,na,1945,52.173011832162835
STAT,1936,27,na,1963,35.634545542083615
STAT,1854,69,na,1923,8.970139121084376
STAT,1847,43,35-39,1890,0.019204047723239904
STAT,1846,36,45-49,1882,0.017047267349671
STAT,1948,18,15-19,1966,0.5157755998363119
STAT,1888,26,35-39,1914,0.11314414090407726
STAT,1836,36,35-39,1872,0.08465951726206083
STAT,1798,58,na,1856,18.262126489899998
STAT,1865,21,na,1886,21.808180601626677
STAT,1837,25,na,1862,13.607481218627193
SIM,1938,27,na,1965,36
STAT,1852,47,25-29,1899,4.906703204316278E-4
STAT,1873,44,40-44,1917,0.022559543467415868
STAT,1840,41,25-29,1881,0.00531667216062865
STAT,1828,45,40-44,1873,7.522524136900817E-4
SIM,1858,17,na,1875,27
STAT,1902,7,na,1909,36.74038502922564
STAT,1823,31,30-34,1854,0.27149502296453404
STAT,1831,41,na,1872,21.065788409429906
STAT,1835,55,na,1890,9.30042782749351
STAT,1849,38,15-19,1887,4.409448362898581E-4
STAT,1870,28,35-39,1898,0.09551395672934739
STAT,1924,25,50-100,1949,0.011591947179982706
STAT,1847,36,50-100,1883,0.013749639913206522
STAT,1878,25,35-39,1903,0.1002930669035508
STAT,1871,8,na,1879,27.07795009652336
STAT,1886,46,na,1932,23.403098059786355
STAT,1862,33,25-29,1895,0.08799664783424457
STAT,1858,4,na,1862,23.692438290365754
SIM,1855,40,na,1895,18
STAT,1873,29,15-19,1902,0.004579791989097978
STAT,1883,39,na,1922,22.64819607519171
STAT,1854,58,na,1912,12.087768376943085
STAT,1929,20,50-100,1949,0.008330524338211388
SIM,1881,36,na,1917,25
STAT,1936,17,50-100,1953,0.003565247503769044
STAT,1775,85,na,1860,1.2631177003227922
SIM,1937,7,na,1944,41
STAT,1850,16,15-19,1866,0.06495117001626308
STAT,1902,47,na,1949,31.584912923965692
STAT,1921,36,45-49,1957,0.00755944993170194
STAT,1899,19,20-24,1918,0.24139032144205458
STAT,1921,15,25-29,1936,0.49238840398476863
STAT,1896,46,35-39,1942,0.0010402663186125293
SIM,1929,3,na,1932,51
STAT,1878,32,25-29,1910,0.1057464449450396
STAT,1872,23,40-44,1895,0.02125502952682074
STAT,1900,36,na,1936,33.08618347471384
STAT,1891,17,15-19,1908,0.07283852774719407
STAT,1901,24,25-29,1925,0.7960055672865715
SIM,1847,55,na,1902,14
STAT,1861,41,45-49,1902,0.012643027226971276
STAT,1847,18,45-49,1865,8.657923622173633E-4
STAT,1936,16,30-34,1952,0.11627428102630256
STAT,1845,23,30-34,1868,0.12833202789674894
STAT,1842,29,15-19,1871,0.004149365038823598
STAT,1834,49,30-34,1883,7.071210283673047E-4
STAT,1914,6,na,1920,40.98239043317892
STAT,1932,36,20-24,1968,0.0035307368289208747
STAT,1829,31,50-100,1860,0.008899082271541453
STAT,1852,37,30-34,1889,0.045860595096989525
SIM,1795,81,na,1876,4
STAT,1840,16,35-39,1856,0.005599841882958076
STAT,1849,41,45-49,1890,0.011657326778088933
SIM,1886,35,na,1921,28
STAT,1883,26,20-24,1909,0.11431289903320985
SIM,1944,16,30-34,1960,1
STAT,1837,21,30-34,1858,0.12991960378130574
STAT,1963,4,na,1967,49.65442408481119
STAT,1820,45,na,1865,15.001344659053663
STAT,1868,43,20-24,1911,0.00152580339289075
STAT,1906,39,30-34,1945,0.016544156075243684
SIM,1807,56,na,1863,15
STAT,1805,89,na,1894,0.28763855548713874
STAT,1928,42,25-29,1970,9.05887300144646E-4
STAT,1845,38,30-34,1883,0.03239507270953507
STAT,1837,29,40-44,1866,0.018537066456079644
STAT,1872,87,na,1959,2.6041692417906814
STAT,1831,25,45-49,1856,0.012665170082595616
STAT,1898,44,45-49,1942,0.0013830888713681627
SIM,1951,16,na,1967,49
STAT,1836,47,40-44,1883,0.0017290905324191747
STAT,1862,26,35-39,1888,0.08415869071890444
STAT,1873,0,na,1873,37.59492486031313
STAT,1830,27,30-34,1857,0.22814858733082838
STAT,1930,42,45-49,1972,0.0021795502093281864
SIM,1939,23,na,1962,30
SIM,1903,5,na,1908,39
SIM,1861,29,25-29,1890,1
SIM,1877,83,na,1960,5
STAT,1832,26,na,1858,13.027228195541742
STAT,1893,48,25-29,1941,4.045265718229358E-4
STAT,1894,40,45-49,1934,0.01937436051086363
STAT,1886,8,na,1894,26.964217392679714
STAT,1928,23,50-100,1951,0.008149979660445445
STAT,1886,31,20-24,1917,0.02815249842224007
SIM,1884,21,na,1905,24
SIM,1916,50,na,1966,44
STAT,1903,48,45-49,1951,0.0018688817771657018
SIM,1893,68,na,1961,24
SIM,1936,24,25-29,1960,2
SIM,1931,9,na,1940,63
STAT,1936,9,na,1945,37.88224166610699
SIM,1837,22,na,1859,30
STAT,1863,19,40-44,1882,0.001661846985186478
STAT,1832,43,40-44,1875,0.012213820662225207
SIM,1926,20,20-24,1946,3
STAT,1873,15,35-39,1888,0.0056449874931286045
STAT,1896,28,35-39,1924,0.12629601607001692
SIM,1915,10,na,1925,40
SIM,1919,24,na,1943,44
STAT,1872,54,na,1926,21.424744116127307
STAT,1884,35,na,1919,23.301951738521808
STAT,1837,66,na,1903,7.925012207156799
STAT,1928,17,35-39,1945,0.05261410977526139
STAT,1890,41,35-39,1931,0.022095534167597054
STAT,1794,99,na,1893,0.004108808962807478
STAT,1853,29,25-29,1882,0.27625425493732125
STAT,1921,19,50-100,1940,0.0042145487968457615
SIM,1920,32,na,1952,47
STAT,1819,40,20-24,1859,0.00156320871062403
STAT,1790,85,na,1875,0.537921416816938
STAT,1849,58,na,1907,15.334118809738944
SIM,1926,28,30-34,1954,1
STAT,1886,24,30-34,1910,0.18360417757860298
STAT,1945,16,50-100,1961,0.004064410329389396
SIM,1894,24,30-34,1918,1
STAT,1854,35,40-44,1889,0.027166239564704795
STAT,1822,46,35-39,1868,7.790710668321375E-4
STAT,1921,33,25-29,1954,0.10162333148271889
STAT,1819,48,30-34,1867,8.600121158070866E-4
STAT,1928,24,25-29,1952,1.1404558062225658
STAT,1853,21,15-19,1874,0.024674960367495224
STAT,1876,34,15-19,1910,0.0014339743533307245
STAT,1918,20,20-24,1938,1.1955006171161549
STAT,1896,20,25-29,1916,0.7564282280126479
STAT,1887,37,45-49,1924,0.02175906167829322
STAT,1844,38,35-39,1882,0.05777702087562974
SIM,1835,74,na,1909,5
SIM,1839,88,na,1927,2
SIM,1875,7,na,1882,21
STAT,1842,32,45-49,1874,0.01580522932066014
STAT,1865,45,45-49,1910,0.0021558710761833706
STAT,1918,28,30-34,1946,0.4117608295672351
STAT,1886,39,30-34,1925,0.054725527051153355
STAT,1820,40,45-49,1860,0.013666988838883086
STAT,1948,21,45-49,1969,0.012838042893029651
STAT,1838,37,50-100,1875,0.011498299383939372
STAT,1863,26,30-34,1889,0.22457236870100844
STAT,1851,24,50-100,1875,0.004052420992072129
STAT,1859,34,na,1893,18.804417042071076
STAT,1909,30,20-24,1939,0.023331675473879036
STAT,1930,31,25-29,1961,0.1187905607105589
SIM,1886,56,na,1942,24
STAT,1840,18,50-100,1858,4.941133027249993E-4
SIM,1880,41,na,1921,32
STAT,1820,44,25-29,1864,0.00549506395377592
STAT,1927,21,25-29,1948,1.135648059166961
STAT,1944,15,na,1959,39.34421122182621
STAT,1862,30,50-100,1892,0.00796858441779407
STAT,1902,46,35-39,1948,0.0011168096474379532
SIM,1852,22,na,1874,24
STAT,1877,48,40-44,1925,0.0017450256103792548
STAT,1907,42,20-24,1949,1.6111806278236343E-4
STAT,1912,40,20-24,1952,1.709118746727783E-4
SIM,1825,44,na,1869,17
STAT,1836,61,na,1897,18.034296880413038
STAT,1897,16,35-39,1913,0.007304508725484869
STAT,1880,29,50-100,1909,0.006678628088348131
SIM,1795,60,na,1855,11
STAT,1899,27,50-100,1926,0.008756964216480534
SIM,1896,1,na,1897,33
STAT,1876,91,na,1967,1.7788161827806648
STAT,1837,46,45-49,1883,0.0012078665505210328
STAT,1865,31,35-39,1896,0.09197235773292854
SIM,1859,54,na,1913,18
STAT,1834,32,50-100,1866,0.008293954951815355
SIM,1818,72,na,1890,9
STAT,1854,43,40-44,1897,0.013649046554065156
STAT,1913,34,45-49,1947,0.015392051964384233
STAT,1845,45,40-44,1890,0.001010724629526935
STAT,1863,18,30-34,1881,0.01456761210029631
STAT,1904,50,na,1954,31.296760928127483
SIM,1903,63,na,1966,28
SIM,1943,28,na,1971,46
STAT,1879,25,30-34,1904,0.2624034150578926
STAT,1924,20,45-49,1944,0.013269230826968436
STAT,1876,16,na,1892,25.714211166821602
STAT,1864,39,15-19,1903,4.985939691532326E-4
STAT,1911,44,35-39,1955,0.0018860876509666955
STAT,1922,32,45-49,1954,0.01764925497531105
SIM,1878,37,na,1915,28
STAT,1828,42,na,1870,17.824567152140627
STAT,1882,20,30-34,1902,0.17172141825003773
STAT,1873,37,15-19,1910,5.709192866787258E-4
STAT,1840,76,na,1916,7.423771970782479
STAT,1870,11,na,1881,26.428169030426428
STAT,1915,22,45-49,1937,0.011530340799277375
SIM,1837,55,na,1892,29
STAT,1833,21,50-100,1854,0.004087818663381925
SIM,1886,66,na,1952,21
STAT,1899,64,na,1963,25.683777042746527
STAT,1929,42,40-44,1971,0.0032237118732746967
STAT,1874,43,50-100,1917,0.010640191980252551
SIM,1907,18,20-24,1925,1
STAT,1901,40,45-49,1941,0.0014689309431900977
STAT,1944,25,na,1969,40.22994188436884
STAT,1822,32,40-44,1854,0.040384483439900386
SIM,1850,11,na,1861,22
STAT,1855,102,na,1957,0.0029675586580010403
STAT,1821,36,40-44,1857,0.09755213264481036
STAT,1889,64,na,1953,21.283273126757006
STAT,1929,34,50-100,1963,0.010438426876830121
SIM,1878,47,na,1925,28
SIM,1838,62,na,1900,4
SIM,1888,47,na,1935,30
STAT,1807,104,na,1911,2.814964371949559E-4
STAT,1894,3,na,1897,33.88069614614391
STAT,1886,46,40-44,1932,0.0017808417509899868
STAT,1811,46,25-29,1857,0.002316996597109859
STAT,1954,18,40-44,1972,0.01718722175411481
STAT,1925,36,50-100,1961,0.005012210028058089
STAT,1870,36,35-39,1906,0.0705997672165589
STAT,1891,35,50-100,1926,0.015211981091610795
STAT,1823,38,15-19,1861,4.0007559351040077E-4
STAT,1882,53,45-49,1935,1.3684575772233138E-4
SIM,1867,5,na,1872,22
STAT,1810,56,na,1866,9.016085929625484
SIM,1859,0,na,1859,35
STAT,1865,7,na,1872,25.35122105743495
SIM,1941,27,na,1968,48
SIM,1860,7,na,1867,28
SIM,1912,36,na,1948,37
STAT,1862,41,25-29,1903,0.005565372322422374
SIM,1935,21,25-29,1956,3
SIM,1838,25,35-39,1863,2
SIM,1848,17,na,1865,33
STAT,1842,46,50-100,1888,0.001866756809320715
STAT,1847,40,30-34,1887,0.012670206582440658
STAT,1863,36,45-49,1899,0.017735235476837332
SIM,1896,66,na,1962,21
STAT,1904,41,40-44,1945,0.002248220832282085
STAT,1894,45,35-39,1939,0.0010221845251002812
STAT,1870,45,50-100,1915,0.0024640857387418155
SIM,1829,26,na,1855,17
SIM,1846,36,na,1882,14
STAT,1864,17,35-39,1881,0.005091180397974547
STAT,1822,57,na,1879,7.751933630357484
STAT,1868,17,na,1885,24.883967367279347
STAT,1873,49,na,1922,22.396374227874304
SIM,1895,39,na,1934,27
STAT,1885,47,35-39,1932,0.0013760753512493803
SIM,1828,72,na,1900,6
SIM,1916,16,20-24,1932,1
STAT,1899,39,50-100,1938,0.0035911291618770627
STAT,1792,97,na,1889,0.020106490896666565
STAT,1870,40,20-24,1910,0.001593549387727608
SIM,1835,20,na,1855,21
SIM,1840,21,na,1861,14
SIM,1896,56,na,1952,23
STAT,1881,68,na,1949,14.541463454610213
STAT,1946,16,40-44,1962,0.01540863174344788
STAT,1878,44,40-44,1922,0.02290846628165451
STAT,1866,91,na,1957,0.6805417345953448
STAT,1810,48,30-34,1858,9.317858225954068E-4
STAT,1839,41,35-39,1880,0.011723164612082134
STAT,1929,6,na,1935,50.90670046005192
STAT,1898,16,50-100,1914,6.625240514004031E-4
STAT,1934,8,na,1942,53.7187023120639
STAT,1840,86,na,1926,1.7386023222806621
STAT,1830,34,40-44,1864,0.026719925859980398
STAT,1895,44,40-44,1939,0.0020004295378850913
SIM,1848,72,na,1920,11
STAT,1839,48,50-100,1887,0.0013633559855731673
SIM,1868,37,na,1905,33
STAT,1840,38,15-19,1878,5.150625023490828E-4
STAT,1913,33,na,1946,37.156467759775104
STAT,1845,44,na,1889,13.409769954057518
STAT,1858,18,20-24,1876,0.15665798461734828
STAT,1826,61,na,1887,13.585724100747067
STAT,1838,42,na,1880,19.083669463466364
STAT,1890,29,15-19,1919,0.005471748760161463
STAT,1829,29,35-39,1858,0.0967715467627265
SIM,1919,28,40-44,1947,1
STAT,1853,44,35-39,1897,0.011227007368380535
STAT,1838,17,40-44,1855,0.0018751271463049782
STAT,1820,37,35-39,1857,0.0666891203338611
STAT,1943,22,20-24,1965,1.174414353644803
STAT,1880,40,50-100,1920,0.01122124787576518
STAT,1861,45,25-29,1906,4.892195399672278E-4
STAT,1859,16,15-19,1875,0.05507751380771412
SIM,1858,19,25-29,1877,1
SIM,1926,26,na,1952,45
STAT,1923,21,40-44,1944,0.038968780370799025
SIM,1888,37,na,1925,38
STAT,1855,22,50-100,1877,0.003354191326415
STAT,1869,35,15-19,1904,5.492722266345766E-4
SIM,1850,41,na,1891,21
SIM,1862,22,na,1884,22
SIM,1855,5,na,1860,26
SIM,1877,28,25-29,1905,1
STAT,1895,25,15-19,1920,0.005930178124851165
STAT,1937,18,40-44,1955,0.013485890840375448
STAT,1869,46,40-44,1915,0.0016635373965569057
SIM,1924,6,na,1930,55
STAT,1792,87,na,1879,1.1772093454357946
STAT,1904,41,25-29,1945,6.418558341965492E-4
STAT,1818,42,na,1860,7.388149385904493
SIM,1879,64,na,1943,8
STAT,1922,8,na,1930,45.82036134571381
SIM,1910,11,na,1921,33
STAT,1854,80,na,1934,3.781077165028317
STAT,1933,32,20-24,1965,0.03273695354117489
STAT,1903,42,35-39,1945,0.001785580419615648
STAT,1863,37,50-100,1900,0.010870405116237079
STAT,1914,31,40-44,1945,0.03922474614185237
STAT,1855,19,35-39,1874,0.004541034850171764
STAT,1900,6,na,1906,36.2250881354037
SIM,1903,53,na,1956,34
STAT,1838,24,30-34,1862,0.17679804141779198
STAT,1890,47,45-49,1937,0.0016095180779984758
STAT,1938,17,45-49,1955,0.004895198371745571
STAT,1911,47,50-100,1958,0.0021274448093376694
STAT,1869,34,na,1903,22.923994774068284
STAT,1908,32,na,1940,35.51426460128537
SIM,1875,19,na,1894,18
STAT,1811,47,35-39,1858,0.0055441644509291324
STAT,1908,16,20-24,1924,0.26226193633664285
STAT,1930,34,45-49,1964,0.02018651512775662
STAT,1892,20,na,1912,29.392322448281266
STAT,1828,34,15-19,1862,6.297612807803095E-4
STAT,1835,75,na,1910,4.630446839353644
STAT,1884,48,30-34,1932,9.364832101797745E-4
STAT,1918,28,50-100,1946,0.010459904586426604
STAT,1905,14,na,1919,37.15117654604525
STAT,1916,51,na,1967,36.883319624088536
STAT,1784,78,na,1862,4.216300262140136
STAT,1886,20,15-19,1906,0.034423838893193386
STAT,1928,28,40-44,1956,0.057115410982266
SIM,1894,31,na,1925,32
STAT,1877,53,na,1930,21.869444306812976
STAT,1880,25,40-44,1905,0.03171365086925094
STAT,1889,34,na,1923,28.96622385190396
STAT,1910,48,35-39,1958,0.0011922453986196457
STAT,1837,43,40-44,1880,0.012757128785765029
STAT,1838,19,35-39,1857,0.005559309279982537
STAT,1927,23,na,1950,44.62405301777188
STAT,1860,47,30-34,1907,7.83288746208254E-4
STAT,1862,77,na,1939,7.457669710503788
STAT,1869,23,50-100,1892,0.003939040737850012
SIM,1828,62,na,1890,8
STAT,1832,22,50-100,1854,0.0024882374472759558
STAT,1904,19,40-44,1923,0.0026067460665725388
STAT,1794,78,na,1872,3.5493442779078412
SIM,1862,24,15-19,1886,2
STAT,1824,38,na,1862,19.841375090190997
STAT,1870,35,25-29,1905,0.028873249044468474
STAT,1907,45,50-100,1952,0.002046682359326159
SIM,1895,27,30-34,1922,1
STAT,1854,90,na,1944,0.4819011564019935
SIM,1875,40,na,1915,18
STAT,1824,30,35-39,1854,0.17668125028250134
STAT,1883,49,na,1932,21.39162160273282
STAT,1826,71,na,1897,9.327812135227767
STAT,1887,0,na,1887,34.367012349088185
STAT,1835,48,35-39,1883,6.597134987616948E-4
STAT,1801,65,na,1866,7.94727067005224
STAT,1845,48,45-49,1893,0.0013622013432913257
SIM,1832,77,na,1909,15
STAT,1860,76,na,1936,7.702133154665409
STAT,1909,33,25-29,1942,0.08733478860144592
STAT,1903,33,na,1936,34.07117793098816
STAT,1956,1,na,1957,51.80959754670544
STAT,1775,95,na,1870,0.037703981024388135
STAT,1921,41,40-44,1962,0.002799266508829723
STAT,1874,36,20-24,1910,0.0078578347600542
STAT,1880,18,30-34,1898,0.016716471265307235
STAT,1852,45,30-34,1897,8.367204703295791E-4
STAT,1910,30,45-49,1940,0.015201160459177767
STAT,1856,33,50-100,1889,0.006649448762693394
STAT,1905,32,45-49,1937,0.014451215543206327
STAT,1912,43,25-29,1955,6.792325429646942E-4
STAT,1885,82,na,1967,7.757175810287738
SIM,1936,26,na,1962,36
STAT,1923,35,15-19,1958,2.213481603031057E-4
STAT,1895,18,25-29,1913,0.07337584879467172
STAT,1933,35,25-29,1968,0.01337955027084669
STAT,1856,16,na,1872,19.779146166504376
STAT,1824,105,na,1929,2.0401677645356627E-4
STAT,1911,43,25-29,1954,6.731049367576826E-4
SIM,1949,13,na,1962,38
STAT,1860,11,na,1871,22.485252924789755
STAT,1916,18,20-24,1934,0.2844374383171495
STAT,1817,51,50-100,1868,4.2832985768381196E-4
STAT,1932,33,15-19,1965,0.0017003138097961526
STAT,1880,33,40-44,1913,0.04541043241833513
STAT,1845,85,na,1930,1.6024496192292232
STAT,1870,33,30-34,1903,0.17271091041215902
STAT,1939,24,na,1963,36.397952334793686
STAT,1880,52,50-100,1932,1.5796798436816357E-4
STAT,1838,27,35-39,1865,0.09526338430575454
STAT,1813,42,40-44,1855,0.07673481862046837
STAT,1828,27,25-29,1855,0.663041916351871
SIM,1931,27,na,1958,51
SIM,1933,28,na,1961,47
STAT,1931,22,45-49,1953,0.014528602783801081
STAT,1822,35,45-49,1857,0.012929910752179639
STAT,1811,43,20-24,1854,0.006770697567704065
STAT,1852,48,35-39,1900,0.0011831322295125684
STAT,1903,45,40-44,1948,0.0013866708112997886
STAT,1913,31,40-44,1944,0.038766875791405773
SIM,1882,0,na,1882,39
STAT,1788,82,na,1870,1.968110306343531
STAT,1850,20,35-39,1870,0.06326684802035534
STAT,1900,46,na,1946,31.292531127989946
STAT,1873,30,30-34,1903,0.17893852262193008
STAT,1876,16,15-19,1892,0.0604220468001302
STAT,1846,61,na,1907,15.143947966122326
STAT,1893,46,30-34,1939,6.90434884359495E-4
SIM,1921,27,na,1948,42
SIM,1891,67,na,1958,27
STAT,1886,36,na,1922,24.555377759582456
SIM,1876,66,na,1942,25
SIM,1813,63,na,1876,4
STAT,1863,33,40-44,1896,0.03823514822816975
STAT,1778,82,na,1860,1.7931787478001566
SIM,1941,22,50-100,1963,1
STAT,1891,21,35-39,1912,0.07183880457248137
STAT,1843,47,30-34,1890,4.0870505619200497E-4
STAT,1909,58,na,1967,31.844250061749882
SIM,1928,29,45-49,1957,1
STAT,1813,53,50-100,1866,4.4072237656681945E-4
SIM,1883,38,na,1921,13
STAT,1854,24,15-19,1878,0.02335391087977005
SIM,1823,73,na,1896,6
STAT,1875,10,na,1885,27.108938208958726
STAT,1917,32,20-24,1949,0.025309714813033655
SIM,1959,0,na,1959,54
STAT,1894,65,na,1959,22.661626214964524
STAT,1940,21,40-44,1961,0.03402021513962988
STAT,1846,18,30-34,1864,0.016130994817930223
STAT,1833,43,na,1876,18.618179987687515
STAT,1876,49,35-39,1925,0.0013922157815939422
STAT,1906,32,45-49,1938,0.014547085009155698
STAT,1886,49,45-49,1935,0.002396837200147669
STAT,1915,44,20-24,1959,1.7567796817010166E-4
STAT,1888,44,50-100,1932,0.012179032524515094
STAT,1863,40,15-19,1903,1.2350566922403837E-4
STAT,1887,27,30-34,1914,0.27486238461031254
SIM,1910,55,na,1965,28
SIM,1914,32,45-49,1946,1
STAT,1833,35,20-24,1868,0.007284889605204994
STAT,1911,36,35-39,1947,0.023323090805067098
STAT,1854,28,30-34,1882,0.1602004002631118
SIM,1807,79,na,1886,6
STAT,1853,94,na,1947,0.12560874394410435
SIM,1837,45,na,1882,29
STAT,1878,47,45-49,1925,0.0024251463112217953
STAT,1854,17,25-29,1871,0.041434150132109
STAT,1871,42,15-19,1913,1.3751453877085813E-4
STAT,1902,21,20-24,1923,0.9747287219354304
STAT,1946,19,45-49,1965,0.005497855148499685
SIM,1838,17,na,1855,15
STAT,1841,52,45-49,1893,1.4129346005498452E-4
STAT,1904,15,25-29,1919,0.08157528190657978
SIM,1873,31,35-39,1904,1
STAT,1785,95,na,1880,0.0735212038245282
STAT,1841,26,15-19,1867,0.005555711642938636
STAT,1915,37,30-34,1952,0.01825268734753751
STAT,1846,26,30-34,1872,0.2486732692814353
SIM,1908,62,na,1970,30
SIM,1916,19,25-29,1935,2
STAT,1872,77,na,1949,8.844202889223263
STAT,1901,21,20-24,1922,0.9671823771558974
SIM,1845,19,na,1864,22
STAT,1900,48,40-44,1948,0.0013223071993140895
STAT,1888,41,30-34,1929,0.013495790545382079
SIM,1862,43,40-44,1905,2
STAT,1828,52,na,1880,15.495931003059521
STAT,1901,47,30-34,1948,7.604844819687759E-4
STAT,1885,44,30-34,1929,0.011199897920444851
SIM,1870,41,na,1911,23
SIM,1939,13,na,1952,30
SIM,1912,15,25-29,1927,1
STAT,1836,71,na,1907,12.88222857070645
STAT,1919,48,na,1967,39.39201015337839
STAT,1923,39,30-34,1962,0.0209269762953531
STAT,1921,33,40-44,1954,0.0430272969897301
SIM,1845,10,na,1855,24
STAT,1888,17,na,1905,29.514183547873962
STAT,1882,45,45-49,1927,0.0022842394132418847
SIM,1855,74,na,1929,1
SIM,1815,44,na,1859,12
SIM,1939,29,20-24,1968,1
STAT,1850,76,na,1926,8.43534961972722
SIM,1776,79,na,1855,4
SIM,1822,46,na,1868,15
STAT,1862,19,25-29,1881,0.050356382441871066
STAT,1854,35,na,1889,14.62090212731739
STAT,1877,45,35-39,1922,0.0014595731618201322
STAT,1910,36,50-100,1946,0.004010157151124328
SIM,1924,18,20-24,1942,1
SIM,1822,77,na,1899,9
STAT,1898,30,35-39,1928,0.13771233248828568
STAT,1823,105,na,1928,1.686196881096939E-4
STAT,1830,37,45-49,1867,0.011661777136906635
SIM,1893,14,na,1907,39
STAT,1887,19,30-34,1906,0.017303910681802037
STAT,1922,33,40-44,1955,0.04370675953589787
STAT,1861,38,35-39,1899,0.05918510216237853
STAT,1939,31,45-49,1970,0.01595454422911859
STAT,1866,16,na,1882,24.016333232683724
STAT,1870,43,25-29,1913,0.006333033354401854
STAT,1879,18,40-44,1897,0.0018881051129140479
STAT,1906,31,na,1937,35.10648908314806
STAT,1844,80,na,1924,4.831825033928002
STAT,1908,19,25-29,1927,0.08317528105458792
STAT,1895,29,30-34,1924,0.3245887342541438
STAT,1917,17,50-100,1934,7.989004165628474E-4
STAT,1838,16,30-34,1854,0.016437208208456865
STAT,1923,46,20-24,1969,1.2870266861679056E-4
SIM,1913,53,na,1966,40
STAT,1859,16,50-100,1875,4.546849421776807E-4
STAT,1953,16,50-100,1969,0.004507237926023088
SIM,1872,22,na,1894,25
STAT,1867,53,na,1920,20.274130836664106
STAT,1872,16,30-34,1888,0.016458581403147567
SIM,1842,56,na,1898,19
STAT,1941,27,30-34,1968,0.40239213376963867
STAT,1811,44,30-34,1855,0.047363023911926025
STAT,1815,54,45-49,1869,1.934703450683132E-4
STAT,1913,42,45-49,1955,0.0016094233466798758
STAT,1882,3,na,1885,28.66298293782052
STAT,1853,63,na,1916,11.214016997609841
STAT,1932,22,45-49,1954,0.014703483300981481
SIM,1884,1,na,1885,33
STAT,1828,38,30-34,1866,0.02369750431265241
STAT,1821,40,25-29,1861,0.01072956875135121
STAT,1951,4,na,1955,46.54631476591829
STAT,1935,20,20-24,1955,1.5085217284190555
STAT,1873,32,50-100,1905,0.009315400940572599
STAT,1879,34,na,1913,24.487098809548264
STAT,1906,51,na,1957,31.78808032502835
STAT,1879,28,35-39,1907,0.09951584107764415
STAT,1924,37,50-100,1961,0.004918641648180476
STAT,1917,40,50-100,1957,0.0012182323127356166
STAT,1833,33,50-100,1866,0.008643441873320957
STAT,1836,29,25-29,1865,0.5206957563670327
STAT,1856,15,35-39,1871,0.004756077399795476
STAT,1907,45,25-29,1952,4.800036769769017E-4
SIM,1943,20,20-24,1963,3
STAT,1894,48,40-44,1942,0.0012220957616190832
STAT,1890,37,15-19,1927,6.821110885544534E-4
STAT,1949,17,20-24,1966,1.5667071850809804
STAT,1931,37,15-19,1968,2.5319675913859223E-4
STAT,1913,19,50-100,1932,7.555342653178547E-4
STAT,1821,33,35-39,1854,0.2722221667995961
STAT,1882,27,15-19,1909,0.004348030070932804
STAT,1782,97,na,1879,0.0072777708388835904
STAT,1918,32,na,1950,39.82580203711001
STAT,1871,38,45-49,1909,0.019776489220480878
STAT,1878,17,na,1895,26.07480100344877
SIM,1869,64,na,1933,12
SIM,1885,40,na,1925,24
STAT,1846,19,40-44,1865,0.0018401948735092134
STAT,1864,90,na,1954,0.7071390868825858
STAT,1855,75,na,1930,7.248131760360844
STAT,1902,36,50-100,1938,0.0037549454035005958
SIM,1828,39,35-39,1867,1
STAT,1911,40,20-24,1951,1.6937001588679352E-4
STAT,1913,42,50-100,1955,0.0011360635355773178
STAT,1804,83,na,1887,1.6250737756109253
STAT,1810,44,15-19,1854,1.3616717802158632E-4
STAT,1830,30,25-29,1860,0.07233331583384171
SIM,1927,26,25-29,1953,2
STAT,1847,56,na,1903,21.788125324948517
STAT,1912,46,45-49,1958,0.0020775372112466395
STAT,1829,68,na,1897,10.380312591640353
STAT,1870,32,20-24,1902,0.026851876943277384
STAT,1818,50,50-100,1868,1.4864010258772327E-4
SIM,1850,75,na,1925,5
STAT,1922,40,30-34,1962,0.001460707269612169
STAT,1844,31,15-19,1875,0.0013440560792161702
SIM,1824,68,na,1892,12
STAT,1813,45,45-49,1858,0.007536220357224469
STAT,1853,47,40-44,1900,0.001070943657593073
STAT,1915,33,15-19,1948,0.0012919914485265637
STAT,1859,88,na,1947,1.0911531603198559
STAT,1852,102,na,1954,0.0025091328989279757
STAT,1857,51,45-49,1908,1.091609041511053E-4
STAT,1837,24,15-19,1861,0.021214864381463697
STAT,1827,46,35-39,1873,0.0010691624653169033
STAT,1847,22,50-100,1869,0.0053402373010256405
STAT,1903,20,25-29,1923,0.8187359242339531
STAT,1869,28,25-29,1897,0.40843321645241076
STAT,1827,56,na,1883,13.089973623763639
STAT,1836,19,na,1855,29.416171406306802
STAT,1878,48,na,1926,22.93589356815508
STAT,1884,46,50-100,1930,0.0024131026328305947
STAT,1923,32,45-49,1955,0.017914543459532254
SIM,1900,34,25-29,1934,2
STAT,1880,52,na,1932,22.52116809928521
STAT,1891,36,20-24,1927,0.009506657063271935
STAT,1834,90,na,1924,0.5571627118595129
STAT,1844,43,30-34,1887,0.009079941968311495
STAT,1903,34,35-39,1937,0.08196542373818495
STAT,1835,45,30-34,1880,5.209172122292299E-4
STAT,1950,5,na,1955,46.202207006823535
STAT,1897,42,35-39,1939,0.0016678032074301681
STAT,1824,45,20-24,1869,1.5944000350683372E-4
STAT,1908,42,20-24,1950,1.6254396063944808E-4
SIM,1824,58,na,1882,16
SIM,1937,34,50-100,1971,1
STAT,1912,32,35-39,1944,0.08921752803667883
STAT,1921,44,45-49,1965,0.0018537266168594526
STAT,1834,28,na,1862,19.902238539655425
STAT,1885,50,45-49,1935,1.4537169484029878E-4
STAT,1900,40,45-49,1940,0.0014557173022826887
STAT,1931,31,40-44,1962,0.05107994512366355
STAT,1890,44,40-44,1934,0.026953222830094915
SIM,1863,38,na,1901,12
STAT,1886,42,25-29,1928,0.006652677950119879
STAT,1855,85,na,1940,1.9300977811569855
STAT,1823,43,na,1866,15.720788629633415
STAT,1853,43,25-29,1896,0.004006682340981649
STAT,1935,31,25-29,1966,0.12737812704876675
SIM,1950,21,na,1971,56
STAT,1890,30,30-34,1920,0.21378845188436435
SIM,1855,20,na,1875,20
STAT,1891,37,na,1928,28.916410846671518
SIM,1871,57,na,1928,20
STAT,1883,35,50-100,1918,0.012035610708101862
STAT,1880,40,15-19,1920,1.4668298948681532E-4
STAT,1836,44,35-39,1880,0.02026383731952324
STAT,1887,33,50-100,1920,0.009958687362603674
SIM,1873,38,na,1911,26
STAT,1783,83,na,1866,0.677602540523973
SIM,1816,39,na,1855,12
STAT,1800,80,na,1880,2.370396154893127
STAT,1813,43,na,1856,21.15878511710077
STAT,1846,16,na,1862,23.507470637040992
STAT,1862,45,40-44,1907,0.001491778631622057
STAT,1876,46,30-34,1922,9.85936419449932E-4
STAT,1884,55,na,1939,20.2584639652593
STAT,1903,41,25-29,1944,6.368578879226602E-4
SIM,1881,67,na,1948,10
STAT,1934,32,20-24,1966,0.033161741326391006
STAT,1880,36,45-49,1916,0.021063465145685738
STAT,1812,46,40-44,1858,0.0019485930885531101
SIM,1859,23,na,1882,21
SIM,1859,33,na,1892,19
STAT,1821,62,na,1883,11.833085731767865
SIM,1873,48,na,1921,27
SIM,1871,67,na,1938,17
STAT,1874,43,45-49,1917,0.015073605348553133
STAT,1893,1,na,1894,34.31939821133933
STAT,1853,36,35-39,1889,0.04491596463827396
STAT,1841,21,50-100,1862,0.005093020192283938
STAT,1885,32,15-19,1917,0.0014062968679547517
STAT,1929,16,40-44,1945,0.01780879524734886
STAT,1841,30,35-39,1871,0.12279227216829937
STAT,1891,40,40-44,1931,0.027885359916461915
STAT,1906,47,30-34,1953,7.895864907698753E-4
STAT,1808,76,na,1884,1.5197973399035418
SIM,1902,67,na,1969,30
STAT,1883,18,na,1901,24.461435658955693
STAT,1919,26,25-29,1945,0.7074354003843294
SIM,1869,23,na,1892,12
STAT,1818,41,15-19,1859,1.531271413782697E-4
STAT,1864,40,30-34,1904,0.010415685604404555
SIM,1887,52,na,1939,21
SIM,1917,12,na,1929,47
STAT,1868,47,35-39,1915,0.0013485270764140639
STAT,1852,23,na,1875,21.582425760950525
STAT,1871,92,na,1963,1.0064310935407301
STAT,1837,17,25-29,1854,0.0548129016066457
STAT,1901,52,na,1953,29.96903909379331
STAT,1919,19,35-39,1938,0.04572226094208819
SIM,1909,1,na,1910,41
SIM,1833,73,na,1906,3
STAT,1900,33,20-24,1933,0.03732465119691566
SIM,1966,3,na,1969,45
STAT,1795,61,na,1856,11.334092712
STAT,1850,35,20-24,1885,0.007118358882563239
STAT,1856,41,35-39,1897,0.013177495370880803
SIM,1805,54,na,1859,14
STAT,1873,18,na,1891,25.610375750992763
SIM,1889,7,na,1896,34
STAT,1821,72,na,1893,7.843696241066036
STAT,1834,38,na,1872,18.632466400658465
STAT,1868,18,15-19,1886,0.05812678363428389
SIM,1836,60,na,1896,2
SIM,1796,76,na,1872,3
SIM,1923,7,na,1930,42
STAT,1873,52,40-44,1925,1.0646403970751397E-4
SIM,1932,1,na,1933,57
STAT,1842,40,45-49,1882,0.011919123476792472
STAT,1911,33,30-34,1944,0.15178590519509913
STAT,1877,30,15-19,1907,0.0014818351810446607
STAT,1845,41,25-29,1886,0.003871771779252786
STAT,1945,16,25-29,1961,0.47011688964890547
STAT,1886,17,20-24,1903,0.18389208394176548
STAT,1872,19,35-39,1891,0.005584120503832184
STAT,1874,89,na,1963,2.2341826952916977
SIM,1911,7,na,1918,42
STAT,1921,41,25-29,1962,7.991766264079916E-4
STAT,1870,52,na,1922,21.27545567571937
STAT,1837,56,na,1893,9.862125944089415
STAT,1928,7,na,1935,50.12117695576802
STAT,1815,51,40-44,1866,1.4898047602293388E-4
STAT,1915,30,45-49,1945,0.016015555720966256
STAT,1845,16,20-24,1861,0.13175775826556377
STAT,1883,41,45-49,1924,0.014599356423231756
STAT,1920,45,40-44,1965,0.001736122013942596
STAT,1941,23,15-19,1964,0.05459392402689909
STAT,1859,42,15-19,1901,1.0962772185286608E-4
SIM,1925,41,na,1966,43
STAT,1894,37,35-39,1931,0.09064598781965909
STAT,1878,25,15-19,1903,0.004715883162796459
STAT,1920,31,30-34,1951,0.1718036411739968
STAT,1821,44,40-44,1865,0.03281272333414063
SIM,1837,86,na,1923,2
STAT,1825,47,50-100,1872,0.002266596334816076
STAT,1811,54,25-29,1865,1.2915744914178954E-4
STAT,1861,37,na,1898,19.81272007053663
STAT,1900,26,30-34,1926,0.35039120594674056
SIM,1786,79,na,1865,14
STAT,1920,12,na,1932,44.07604517722969
STAT,1870,42,na,1912,22.931324885342995
SIM,1868,92,na,1960,3
STAT,1816,95,na,1911,0.0399155771811853
SIM,1918,52,na,1970,34
STAT,1905,41,40-44,1946,0.0022644611444003087
STAT,1936,23,40-44,1959,0.031940837045229556
SIM,1945,9,na,1954,40
STAT,1861,35,30-34,1896,0.04524503367152135
STAT,1846,29,35-39,1875,0.0932462233328673
STAT,1882,42,40-44,1924,0.021529256397993315
STAT,1842,57,na,1899,15.077838346917618
STAT,1926,33,25-29,1959,0.11105179621357238
STAT,1816,50,45-49,1866,1.8270444439976314E-4
SIM,1903,32,35-39,1935,1
SIM,1879,33,na,1912,15
SIM,1837,76,na,1913,16
STAT,1839,68,na,1907,8.433452485448354
STAT,1854,46,45-49,1900,0.0014466102162424511
STAT,1894,44,25-29,1938,5.63782320247463E-4
STAT,1888,15,30-34,1903,0.01871246574384886
STAT,1862,34,35-39,1896,0.08662469311713328
STAT,1924,42,20-24,1966,2.0869794291162263E-4
SIM,1890,42,40-44,1932,3
STAT,1862,26,50-100,1888,0.005579445863700551
STAT,1894,30,15-19,1924,0.0018397554908829762
STAT,1870,47,40-44,1917,0.001692752588556936
STAT,1916,44,20-24,1960,1.788352368402086E-4
SIM,1855,19,na,1874,20
STAT,1858,17,50-100,1875,4.354812144171398E-4
STAT,1944,21,25-29,1965,0.9904158027031564
STAT,1845,34,35-39,1879,0.06893959061091569
STAT,1926,30,20-24,1956,0.029358300600774427
STAT,1913,43,40-44,1956,0.0024149541381583003
STAT,1936,30,30-34,1966,0.15227845803073775
STAT,1889,40,35-39,1929,0.022394074164586032
STAT,1927,5,na,1932,49.738201324941954
STAT,1846,71,na,1917,10.81759940274449
STAT,1881,39,15-19,1920,5.289572023842496E-4
SIM,1798,57,na,1855,9
STAT,1878,40,25-29,1918,0.006696638421543177
STAT,1912,43,40-44,1955,0.002379139787626428
STAT,1902,43,30-34,1945,0.0011176943101138728
SIM,1862,12,na,1874,26
STAT,1831,41,30-34,1872,0.01153501378294097
STAT,1931,34,45-49,1965,0.020501196356193584
STAT,1941,20,45-49,1961,0.011551409743153863
STAT,1873,48,20-24,1921,1.2047014589506516E-4
STAT,1832,57,na,1889,9.117713442335036
STAT,1882,23,na,1905,22.59526044954473
STAT,1877,63,na,1940,18.418677886871833
STAT,1893,69,na,1962,20.347906699164977
STAT,1809,104,na,1913,3.6905925087483846E-4
SIM,1845,20,na,1865,24
STAT,1871,35,40-44,1906,0.04405820833202269
STAT,1905,45,na,1950,32.80044809268022
SIM,1847,86,na,1933,3
STAT,1844,46,35-39,1890,0.001096637821753717
STAT,1899,10,na,1909,35.45984371378483
SIM,1962,8,na,1970,48
STAT,1851,49,30-34,1900,8.001526866302924E-4
STAT,1860,1,na,1861,29.764788254338995
STAT,1853,40,20-24,1893,0.0010081813617565203
STAT,1865,53,45-49,1918,1.2915538067582178E-4
STAT,1852,57,na,1909,17.199390954371406
STAT,1862,23,na,1885,20.73819227421263
STAT,1911,52,na,1963,33.97421370379846
SIM,1907,12,na,1919,41
SIM,1900,35,na,1935,35
SIM,1832,46,na,1878,25
STAT,1918,31,25-29,1949,0.09772454907301212
SIM,1819,57,na,1876,5
STAT,1952,20,20-24,1972,1.3299390907899586
STAT,1862,48,45-49,1910,0.002010540553305777
STAT,1867,22,na,1889,22.725819151938648
STAT,1911,22,25-29,1933,0.8703818412238272
SIM,1820,42,25-29,1862,1
SIM,1842,87,na,1929,3
STAT,1903,31,30-34,1934,0.24924502230233714
SIM,1826,39,na,1865,16
STAT,1818,39,50-100,1857,0.014599914211202769
STAT,1809,51,50-100,1860,5.038709641125313E-4
STAT,1854,102,na,1956,0.002156852322964492
STAT,1934,25,na,1959,50.2250776979471
STAT,1832,105,na,1937,1.325320197356328E-4
STAT,1877,22,na,1899,24.413475744118116
STAT,1840,41,50-100,1881,0.008746783177020614
STAT,1864,89,na,1953,0.9422490764345293
STAT,1861,42,20-24,1903,0.0013339026820993658
STAT,1853,33,30-34,1886,0.11183295568756696
STAT,1904,44,45-49,1948,0.0014690985093848284
SIM,1815,54,na,1869,11
STAT,1811,62,na,1873,12.529279562487524
STAT,1906,34,50-100,1940,0.007577944002537044
STAT,1886,35,35-39,1921,0.07406178829452977
STAT,1812,42,25-29,1854,0.007550380857261485
SIM,1948,19,20-24,1967,1
STAT,1899,15,40-44,1914,0.002515454589547519
STAT,1896,36,na,1932,31.09555591123097
STAT,1894,55,na,1949,26.499649336887604
STAT,1904,59,na,1963,29.527807451634136
STAT,1879,88,na,1967,3.470338250125814
SIM,1957,9,na,1966,56
SIM,1866,3,na,1869,38
STAT,1819,44,35-39,1863,0.016549327181515944
SIM,1813,73,na,1886,1
SIM,1864,78,na,1942,7
STAT,1814,83,na,1897,1.7690607878839724
STAT,1881,37,na,1918,22.418146121548457
SIM,1800,55,na,1855,12
SIM,1884,85,na,1969,5
STAT,1878,6,na,1884,27.863169731788044
SIM,1873,6,na,1879,31
STAT,1922,37,na,1959,42.49548114901346
STAT,1867,18,15-19,1885,0.05771579683897316
STAT,1824,52,45-49,1876,1.8133018243241377E-4
STAT,1899,54,na,1953,28.665667091997207
STAT,1874,40,40-44,1914,0.023048959165124432
SIM,1845,28,30-34,1873,1
STAT,1829,26,30-34,1855,0.3913483970029637
STAT,1892,46,50-100,1938,0.0017163789041621206
SIM,1932,33,na,1965,48
STAT,1847,17,35-39,1864,0.007315746939550041
STAT,1875,41,na,1916,23.86570834774726
STAT,1869,88,na,1957,1.6487309762385056
STAT,1872,52,50-100,1924,1.5370420725982977E-4
STAT,1929,19,45-49,1948,0.006310674453949183
STAT,1868,44,30-34,1912,0.010975682098426252
STAT,1845,75,na,1920,6.017708580832146
STAT,1853,102,na,1955,0.0018425497309296547
STAT,1927,43,35-39,1970,0.0025085680597630236
SIM,1944,14,na,1958,34
STAT,1882,31,35-39,1913,0.09744872352676258
STAT,1891,43,45-49,1934,0.01823652458108038
STAT,1878,18,25-29,1896,0.05835101789549971
STAT,1894,41,20-24,1935,0.002044544342422683
STAT,1932,37,30-34,1969,0.0243889731101869
STAT,1844,90,na,1934,0.6158197703337713
STAT,1820,34,30-34,1854,0.17028413986583157
STAT,1857,56,na,1913,15.26886415555687
STAT,1895,51,na,1946,28.088129367377903
STAT,1901,33,20-24,1934,0.03766344949046959
STAT,1839,15,35-39,1854,0.0040082535687115855
SIM,1814,58,na,1872,20
SIM,1840,65,na,1905,6
STAT,1837,28,30-34,1865,0.15723533792580782
STAT,1864,33,50-100,1897,0.008183336001607268
STAT,1893,49,35-39,1942,9.74945567691438E-4
STAT,1896,17,30-34,1913,0.02093604890207194
STAT,1806,95,na,1901,0.06221234404560914
STAT,1931,41,35-39,1972,0.002682050540450721
SIM,1883,2,na,1885,27
STAT,1844,16,50-100,1860,4.893253151156168E-4
SIM,1864,34,na,1898,22
STAT,1871,31,25-29,1902,0.102536123694737
SIM,1832,87,na,1919,1
STAT,1830,76,na,1906,3.4039464978731906
STAT,1805,51,30-34,1856,1.1746549222767245E-4
STAT,1883,70,na,1953,13.624993525570597
STAT,1920,41,25-29,1961,7.830867412980915E-4
STAT,1832,36,15-19,1868,3.220022122244178E-4
STAT,1853,15,50-100,1868,3.747914195992768E-4
STAT,1910,45,30-34,1955,8.305413078158431E-4
SIM,1905,34,na,1939,40
STAT,1876,27,50-100,1903,0.0064970085645589684
SIM,1908,52,na,1960,37
STAT,1860,42,na,1902,18.766615234921336
STAT,1865,46,20-24,1911,1.088466461503633E-4
STAT,1930,31,40-44,1961,0.05029589820265784
STAT,1914,49,30-34,1963,8.716433202078627E-4
STAT,1845,19,25-29,1864,0.04137511034953955
STAT,1872,29,50-100,1901,0.0064983625638364885
SIM,1862,53,na,1915,23
STAT,1888,18,35-39,1906,0.00639540427619758
STAT,1924,45,25-29,1969,6.303593556268243E-4
STAT,1867,16,50-100,1883,4.8212766767703606E-4
STAT,1881,51,50-100,1932,1.4439681566357442E-4
STAT,1815,40,35-39,1855,0.029169155238689678
STAT,1894,34,30-34,1928,0.2218465582386991
STAT,1821,47,45-49,1868,0.003334987571303448
STAT,1876,50,50-100,1926,1.5559471862963426E-4
STAT,1920,34,35-39,1954,0.09839507132897353
STAT,1844,38,na,1882,19.24541968493036
SIM,1862,8,na,1870,26
STAT,1925,11,na,1936,47.63552701730824
STAT,1872,42,30-34,1914,0.011748580549350013
STAT,1820,41,20-24,1861,0.0014265566817110561
SIM,1877,52,na,1929,24
SIM,1853,38,na,1891,23
SIM,1865,19,na,1884,24
STAT,1905,44,45-49,1949,0.0014797107312725728
STAT,1900,22,15-19,1922,0.045746971992335884
STAT,1884,44,15-19,1928,1.3347575072495017E-4
STAT,1871,21,30-34,1892,0.1781246816191628
STAT,1895,29,50-100,1924,0.00824548365539209
STAT,1860,35,50-100,1895,0.0100760063972582
SIM,1886,29,30-34,1915,1
STAT,1916,37,50-100,1953,0.004262801419565102
STAT,1878,29,30-34,1907,0.25812421051702356
STAT,1850,42,45-49,1892,0.013309152907679575
STAT,1873,9,na,1882,27.21967332652139
STAT,1895,47,45-49,1942,0.001720227448565736
STAT,1827,43,30-34,1870,0.008868304813750753
STAT,1909,40,50-100,1949,0.0011050521068930105
STAT,1861,31,15-19,1892,0.0012024792860977575
STAT,1855,16,30-34,1871,0.013426476483849528
SIM,1812,80,na,1892,2
STAT,1927,22,30-34,1949,0.3522994419015279
STAT,1929,30,40-44,1959,0.04952625828187724
STAT,1839,15,40-44,1854,0.0013360846002615668
STAT,1948,22,50-100,1970,0.007505150191742523
STAT,1908,28,35-39,1936,0.14069346344886552
STAT,1903,19,45-49,1922,9.23731234914667E-4
STAT,1893,20,40-44,1913,0.026431041126405347
SIM,1852,21,na,1873,25
STAT,1850,85,na,1935,2.4407967504243238
STAT,1865,25,35-39,1890,0.08786542742920843
STAT,1923,28,50-100,1951,0.011308608625771875
STAT,1916,47,25-29,1963,5.394252814288898E-4
STAT,1887,54,na,1941,22.85632909529397
SIM,1823,32,na,1855,11
SIM,1816,70,na,1886,4
STAT,1900,15,50-100,1915,6.825179705937694E-4
SIM,1841,69,na,1910,5
STAT,1914,39,15-19,1953,1.8823093668470534E-4
STAT,1882,25,50-100,1907,0.006172043219254266
STAT,1906,45,45-49,1951,0.001953323078617347
SIM,1897,20,20-24,1917,3
STAT,1836,62,na,1898,17.6395261217008
STAT,1937,16,50-100,1953,0.003630675530601079
STAT,1869,30,45-49,1899,0.017032432571436103
STAT,1936,28,40-44,1964,0.044316010211234054
STAT,1900,24,15-19,1924,0.04546058799684011
STAT,1921,34,30-34,1955,0.17247357999746193
SIM,1959,9,na,1968,51
STAT,1923,42,40-44,1965,0.002903194744943827
SIM,1895,18,na,1913,31
STAT,1902,21,15-19,1923,0.04666285157931936
SIM,1894,76,na,1970,11
SIM,1835,41,na,1876,18
STAT,1859,28,15-19,1887,0.003642010584075671
STAT,1867,22,35-39,1889,0.056073293532572725
SIM,1916,2,na,1918,50
STAT,1847,21,25-29,1868,0.7550839366745505
STAT,1904,37,35-39,1941,0.021874909842171435
SIM,1827,46,na,1873,14
STAT,1878,18,na,1896,26.00648502481973
STAT,1920,36,35-39,1956,0.02628105436139115
STAT,1921,45,40-44,1966,0.0017717936736297464
SIM,1848,16,na,1864,33
STAT,1870,37,40-44,1907,0.04348561314066844
STAT,1911,27,25-29,1938,0.637751737370043
STAT,1849,37,na,1886,18.693038078054247
STAT,1911,30,25-29,1941,0.09014013353624516
STAT,1850,33,50-100,1883,0.008445854852619825
STAT,1920,16,40-44,1936,0.015597425608242834
STAT,1782,96,na,1878,0.011888285861811216
STAT,1904,48,45-49,1952,0.0018835484255525059
STAT,1925,45,25-29,1970,6.417662782265667E-4
STAT,1914,19,20-24,1933,0.2766318438426287
STAT,1917,15,25-29,1932,0.09283549936024608
STAT,1897,19,50-100,1916,6.471013148454537E-4
STAT,1900,37,20-24,1937,0.002307174806331569
STAT,1940,29,15-19,1969,0.007140618161859828
SIM,1857,44,na,1901,22
STAT,1904,51,na,1955,31.001006537356687
STAT,1950,19,30-34,1969,0.14313341814691455
STAT,1886,13,na,1899,26.745976541533846
STAT,1934,18,35-39,1952,0.05636852778379656
STAT,1782,88,na,1870,0.34484611405222987
STAT,1921,15,45-49,1936,0.0056759458744309235
STAT,1942,26,15-19,1968,0.007358711431143576
STAT,1841,49,na,1890,21.56197766804
STAT,1951,15,30-34,1966,0.14434230776658347
STAT,1786,78,na,1864,1.3044383567102096
SIM,1920,10,na,1930,51
STAT,1904,17,40-44,1921,0.002620800884451673
SIM,1873,15,na,1888,30
SIM,1903,30,na,1933,38
SIM,1887,7,na,1894,26
STAT,1879,20,50-100,1899,0.004245854439813588
SIM,1799,73,na,1872,10
STAT,1835,22,45-49,1857,0.005098759092852888
STAT,1952,16,30-34,1968,0.14524393038238517
SIM,1833,42,na,1875,12
SIM,1837,56,na,1893,28
STAT,1930,27,35-39,1957,0.19001105343669827
STAT,1932,35,45-49,1967,0.009138306266734916
STAT,1790,83,na,1873,0.8212960892349438
STAT,1857,32,na,1889,17.974405340982273
STAT,1916,16,20-24,1932,0.2858850403757804
STAT,1831,39,na,1870,21.41084301577199
STAT,1871,47,na,1918,22.326346440098845
STAT,1811,52,25-29,1863,1.3442444778202737E-4
STAT,1902,34,20-24,1936,0.02170006485836879
STAT,1932,15,20-24,1947,1.7962611606063041
SIM,1831,51,na,1882,8
STAT,1863,22,20-24,1885,0.622309198264423
SIM,1802,70,na,1872,9
STAT,1905,16,45-49,1921,9.450768434603863E-4
STAT,1893,31,50-100,1924,0.011599944505503086
STAT,1915,18,25-29,1933,0.08967939924116564
SIM,1912,15,na,1927,39
STAT,1911,21,50-100,1932,0.006218903628106738
SIM,1940,15,20-24,1955,2
STAT,1866,48,30-34,1914,8.803082882901602E-4
SIM,1875,9,na,1884,21
STAT,1840,75,na,1915,8.066774571909372
STAT,1934,34,50-100,1968,0.011226213624151105
SIM,1920,23,25-29,1943,1
STAT,1908,22,20-24,1930,1.0169395604550484
STAT,1810,77,na,1887,2.9548323653343544
STAT,1844,17,15-19,1861,0.058924496885745144
STAT,1934,32,15-19,1966,0.0017470898308527356
STAT,1913,40,30-34,1953,0.0012503185434848817
STAT,1917,32,15-19,1949,0.0013334144590424085
SIM,1852,13,na,1865,29
STAT,1912,23,25-29,1935,0.8755913928356861
STAT,1896,16,25-29,1912,0.07461733047454468
STAT,1803,75,na,1878,4.6642333073494635
SIM,1827,54,na,1881,12
STAT,1894,24,na,1918,30.120523527476962
STAT,1898,38,na,1936,31.874053557472546
STAT,1932,15,na,1947,48.76697030284605
STAT,1854,67,na,1921,9.689406545872457
SIM,1878,46,na,1924,28
STAT,1935,19,35-39,1954,0.056803280277332585
STAT,1890,18,na,1908,30.598232866546457
STAT,1829,25,25-29,1854,1.0626500215985706
STAT,1889,26,35-39,1915,0.11854029754424705
SIM,1882,51,na,1933,30
STAT,1860,47,25-29,1907,4.6608916680537316E-4
STAT,1937,24,40-44,1961,0.03251401602967525
STAT,1868,16,na,1884,25.03140232698529
SIM,1837,25,25-29,1862,2
STAT,1872,21,na,1893,24.271529956444642
STAT,1924,29,30-34,1953,0.45000995851437847
STAT,1792,98,na,1890,0.012308791597121336
STAT,1819,49,50-100,1868,0.002152841890172877
STAT,1899,31,na,1930,32.800512511309975
STAT,1836,52,50-100,1888,1.4747648599831636E-4
STAT,1885,48,40-44,1933,0.0016693825845704327
STAT,1903,30,20-24,1933,0.0387391910623035
SIM,1816,62,na,1878,9
STAT,1908,41,na,1949,34.37954276423395
STAT,1825,78,na,1903,4.212191029641222
STAT,1918,19,35-39,1937,0.04501649220322574
STAT,1869,18,30-34,1887,0.015565294544353325
STAT,1877,52,na,1929,22.10798951366542
STAT,1931,2,na,1933,53.29495318656824
STAT,1933,31,15-19,1964,0.0017257112666127028
STAT,1858,40,40-44,1898,0.01728844901572964
SIM,1906,27,na,1933,27
STAT,1907,41,45-49,1948,0.001527112945982176
SIM,1898,66,na,1964,20
SIM,1933,0,na,1933,57
STAT,1924,41,45-49,1965,0.0019695874404105826
STAT,1909,29,35-39,1938,0.1416587135573421
STAT,1913,43,50-100,1956,0.0011342685551911048
STAT,1866,60,na,1926,17.564772972018734
SIM,1886,33,na,1919,30
STAT,1943,22,15-19,1965,0.05622233288451306
SIM,1911,30,20-24,1941,1
STAT,1854,103,na,1957,0.0012816016503055011
STAT,1938,23,45-49,1961,0.0110587914142153
STAT,1853,42,na,1895,14.50782418658122
STAT,1903,36,35-39,1939,0.021809041536771646
SIM,1840,44,na,1884,17
STAT,1866,92,na,1958,0.5560230134164347
SIM,1853,62,na,1915,19
SIM,1857,76,na,1933,9
STAT,1823,39,20-24,1862,0.005445458056968721
STAT,1915,11,na,1926,41.038273309407245
STAT,1919,25,na,1944,40.398114393962246
STAT,1890,39,50-100,1929,0.01476332990642684
SIM,1911,41,na,1952,40
SIM,1915,55,na,1970,31
STAT,1952,5,na,1957,46.83893652830644
STAT,1849,8,na,1857,23.43780775815832
STAT,1840,39,20-24,1879,0.006997365293409462
STAT,1910,34,25-29,1944,0.0878160117849708
STAT,1918,44,25-29,1962,7.498619599371842E-4
SIM,1844,26,na,1870,10
STAT,1857,43,50-100,1900,0.007851553164209968
STAT,1889,20,20-24,1909,0.84875160793642
STAT,1878,20,15-19,1898,0.03426292272781073
STAT,1839,35,35-39,1874,0.04762295899372543
STAT,1928,34,40-44,1962,0.04862992869489478
STAT,1905,24,50-100,1929,0.005848556196381033
SIM,1878,26,25-29,1904,1
STAT,1907,29,30-34,1936,0.3626377431643064
SIM,1910,32,na,1942,27
STAT,1871,39,na,1910,23.252693423837794
STAT,1857,24,na,1881,18.33366490108448
STAT,1923,30,na,1953,43.403319618502834
STAT,1917,45,20-24,1962,1.1491891440067782E-4
STAT,1922,30,30-34,1952,0.17813052678028257
STAT,1800,100,na,1900,0.003847210358238327
STAT,1933,31,45-49,1964,0.021131821920238065
STAT,1919,28,40-44,1947,0.04974978121477148
STAT,1863,5,na,1868,25.40505209491129
SIM,1819,67,na,1886,4
STAT,1893,23,45-49,1916,0.008765201407451259
STAT,1891,67,na,1958,20.24350894849826
SIM,1870,74,na,1944,11
SIM,1829,80,na,1909,13
STAT,1856,15,40-44,1871,0.0015853592250555674
STAT,1835,21,na,1856,12.437310545498354
SIM,1878,78,na,1956,7
STAT,1918,41,20-24,1959,1.8633715462022538E-4
STAT,1898,40,50-100,1938,9.996425207881344E-4
SIM,1815,77,na,1892,2
STAT,1857,101,na,1958,0.007133766268671373
SIM,1935,34,25-29,1969,2
SIM,1881,26,na,1907,24
STAT,1867,30,40-44,1897,0.041834254872402346
SIM,1941,16,20-24,1957,3
SIM,1919,45,na,1964,43
STAT,1905,29,20-24,1934,0.16810304373731108
STAT,1924,28,na,1952,43.18152717775711
STAT,1911,24,20-24,1935,1.0412098894627024
STAT,1841,21,30-34,1862,0.2224630978722221
STAT,1839,59,na,1898,10.725126860941725
STAT,1847,23,50-100,1870,0.005301894397204276
STAT,1916,19,25-29,1935,0.09066725013436665
STAT,1883,48,30-34,1931,9.281956389069735E-4
STAT,1921,37,35-39,1958,0.026796637384291326
SIM,1918,20,na,1938,34
STAT,1856,90,na,1946,0.5711473596737856
STAT,1878,34,50-100,1912,0.009378491625317672
STAT,1907,26,20-24,1933,0.17219087920888906
STAT,1940,32,45-49,1972,0.016170246866441886
STAT,1878,33,20-24,1911,0.02778908601538107
SIM,1866,13,na,1879,35
STAT,1910,47,30-34,1957,8.266506211129865E-4
SIM,1878,23,20-24,1901,1
STAT,1889,40,50-100,1929,0.01306498888923758
STAT,1887,26,25-29,1913,0.46330779530208976
STAT,1941,25,15-19,1966,0.0072562146392324825
STAT,1920,8,na,1928,44.36681996735165
STAT,1895,20,45-49,1915,0.00910702923437845
SIM,1887,74,na,1961,11
SIM,1888,16,na,1904,37
STAT,1923,45,45-49,1968,0.002536758623296418
STAT,1907,25,50-100,1932,0.009420592081151976
STAT,1826,32,45-49,1858,0.024700572255950633
STAT,1875,29,na,1904,24.356743346225286
STAT,1854,59,na,1913,11.879133494757047
STAT,1894,56,na,1950,26.139784098892665
STAT,1807,57,na,1864,12.565221383768645
STAT,1931,19,20-24,1950,1.7572140814475488
STAT,1869,30,15-19,1899,0.0013909383155552028
STAT,1922,16,45-49,1938,0.005753008217838943
SIM,1940,30,na,1970,35
STAT,1844,41,50-100,1885,0.008560288155988792
STAT,1865,11,na,1876,24.562536342917955
SIM,1866,4,na,1870,36
STAT,1900,24,45-49,1924,0.009609099068228356
SIM,1864,54,na,1918,21
STAT,1915,43,na,1958,37.009360034085375
STAT,1859,90,na,1949,0.6266381415574509
STAT,1901,25,15-19,1926,0.006391589388964827
STAT,1903,33,25-29,1936,0.08326358533265744
STAT,1949,23,na,1972,42.32557526404387
STAT,1945,18,40-44,1963,0.015164699331163867
SIM,1858,18,na,1876,27
STAT,1875,38,30-34,1913,0.05451324386787245
SIM,1846,60,na,1906,8
STAT,1875,21,na,1896,24.384729929300406
STAT,1878,20,45-49,1898,0.007242225262934806
SIM,1928,30,na,1958,53
STAT,1841,60,na,1901,18.66775780460167
SIM,1902,27,25-29,1929,1
STAT,1933,16,20-24,1949,1.8119187523740639
STAT,1913,23,40-44,1936,0.033565151273796855
STAT,1850,106,na,1956,1.3557156909745324E-4
STAT,1852,22,45-49,1874,0.007089721631340436
STAT,1838,19,40-44,1857,0.0018531032006199781
SIM,1887,82,na,1969,9
STAT,1897,33,30-34,1930,0.23087882181864272
STAT,1913,27,35-39,1940,0.14834521090058564
STAT,1914,42,45-49,1956,0.0016354582628609175
STAT,1914,18,na,1932,39.517638900666014
STAT,1903,16,40-44,1919,0.0026067800749698562
SIM,1877,21,na,1898,26
SIM,1879,87,na,1966,2
SIM,1856,59,na,1915,9
STAT,1907,56,na,1963,31.378206524420783
STAT,1902,37,25-29,1939,0.008763596694049882
STAT,1899,41,40-44,1940,0.002147871523627458
SIM,1851,28,na,1879,21
STAT,1817,67,na,1884,13.990006564255996
STAT,1921,48,45-49,1969,0.0024242261336263372
STAT,1925,42,20-24,1967,2.1247452092267017E-4
SIM,1891,36,na,1927,34
STAT,1904,43,50-100,1947,0.0010436063013598445
STAT,1930,24,30-34,1954,0.3641781396873623
STAT,1870,97,na,1967,0.2417490912849522
STAT,1863,40,50-100,1903,0.009448183005226854
STAT,1899,30,30-34,1929,0.24093315459306042
SIM,1874,64,na,1938,19
STAT,1860,44,20-24,1904,0.0012736790918720534
STAT,1873,62,na,1935,18.58240764995672
STAT,1911,26,40-44,1937,0.04531720499421976
SIM,1879,31,na,1910,16
STAT,1879,67,na,1946,16.407163076587167
STAT,1932,23,na,1955,47.57335489208055
STAT,1813,53,na,1866,18.470284181501466
STAT,1911,15,30-34,1926,0.024346329164926298
SIM,1854,25,25-29,1879,3
STAT,1901,20,45-49,1921,0.00981562276780795
SIM,1871,22,20-24,1893,2
STAT,1860,23,50-100,1883,0.003392985258861972
STAT,1901,36,25-29,1937,0.008737602087267942
STAT,1930,35,40-44,1965,0.019468537843858956
STAT,1846,25,25-29,1871,0.4207508978532612
SIM,1938,6,na,1944,40
STAT,1902,40,25-29,1942,6.351855534043532E-4
SIM,1823,64,na,1887,6
SIM,1834,56,na,1890,12
SIM,1830,66,na,1896,7
STAT,1879,45,50-100,1924,0.0025673270501521965
STAT,1909,38,25-29,1947,0.009221394198472432
STAT,1911,43,30-34,1954,0.0012050749624904545
STAT,1937,27,45-49,1964,0.01673433620384869
SIM,1903,23,25-29,1926,1
STAT,1834,30,50-100,1864,0.00846800022548461
STAT,1909,41,25-29,1950,6.679972858323909E-4
STAT,1926,37,40-44,1963,0.018190584136597607
SIM,1844,34,na,1878,6
SIM,1848,48,na,1896,30
STAT,1849,19,50-100,1868,4.6210846280022406E-4
STAT,1848,22,25-29,1870,0.4507652064567119
SIM,1925,15,25-29,1940,3
STAT,1901,20,15-19,1921,0.04643765033655666
STAT,1808,47,30-34,1855,6.988137246445E-4
SIM,1853,5,na,1858,29
STAT,1924,38,20-24,1962,0.003085092504218114
STAT,1926,20,50-100,1946,0.007995593535502344
STAT,1906,25,20-24,1931,0.17159267761230915
STAT,1915,35,45-49,1950,0.006892113778618578
SIM,1929,4,na,1933,51
STAT,1855,37,50-100,1892,0.008644166228854805
STAT,1903,66,na,1969,26.53015046130288
STAT,1889,23,30-34,1912,0.21740755741875561
STAT,1943,0,na,1943,47.017158394943685
STAT,1927,38,40-44,1965,0.01849831490761135
STAT,1869,89,na,1958,1.4169029136696094
STAT,1836,30,na,1866,26.99267771497683
STAT,1813,77,na,1890,5.704603817280545
STAT,1871,45,35-39,1916,0.001409716033256727
STAT,1816,42,na,1858,9.427100095809028
STAT,1936,26,45-49,1962,0.016440976721965737
STAT,1775,86,na,1861,1.0222411548712358
SIM,1839,87,na,1926,2
STAT,1882,31,na,1913,22.962520997060796
STAT,1825,46,50-100,1871,0.002297306361643002
STAT,1940,10,na,1950,39.9016664521377
STAT,1856,32,30-34,1888,0.12803260103094558
STAT,1837,87,na,1924,0.8518768880243309
SIM,1915,26,20-24,1941,1
STAT,1884,30,40-44,1914,0.042830597568460034
SIM,1936,17,na,1953,34
SIM,1904,4,na,1908,34
STAT,1833,73,na,1906,8.793446432864425
STAT,1917,48,25-29,1965,5.475004378646455E-4
STAT,1823,50,50-100,1873,1.0561664028082443E-4
SIM,1897,0,na,1897,46
STAT,1888,22,25-29,1910,0.668971091191532
STAT,1837,32,20-24,1869,0.01654023395768887
STAT,1822,81,na,1903,1.918176117348274
STAT,1936,15,35-39,1951,0.040116303665228226
STAT,1964,3,na,1967,49.23408640534478
STAT,1910,31,20-24,1941,0.023470602982810188
STAT,1826,95,na,1921,0.09291146753163546
STAT,1872,15,25-29,1887,0.05886235231278925
SIM,1857,52,na,1909,22
STAT,1828,103,na,1931,9.638597387910359E-4
SIM,1906,15,20-24,1921,1
STAT,1922,33,35-39,1955,0.10206367858643833
STAT,1918,27,40-44,1945,0.049154868818359
STAT,1820,55,na,1875,12.75103205911528
SIM,1791,77,na,1868,2
SIM,1862,7,na,1869,26
SIM,1902,37,na,1939,31
STAT,1904,45,40-44,1949,0.0013975531546700695
STAT,1922,45,na,1967,42.092993921573914
STAT,1824,69,na,1893,10.211344435790183
STAT,1903,33,30-34,1936,0.141932522527298
SIM,1799,65,na,1864,14
STAT,1895,41,na,1936,30.24565558709345
STAT,1866,21,35-39,1887,0.05457436172729195
STAT,1916,36,15-19,1952,1.9591064292265176E-4
STAT,1828,28,50-100,1856,0.009641026835612783
STAT,1918,16,30-34,1934,0.026440943729467446
STAT,1915,35,15-19,1950,1.9414407319040734E-4
STAT,1904,34,30-34,1938,0.14242270122978534
STAT,1920,20,25-29,1940,1.0242262741583144
STAT,1827,34,na,1861,17.43407004767103
SIM,1938,29,25-29,1967,1
STAT,1928,30,25-29,1958,0.1151341897963568
STAT,1846,37,50-100,1883,0.010390566281562487
STAT,1926,26,30-34,1952,0.4686257407458363
STAT,1921,32,35-39,1953,0.10090281290235024
SIM,1925,7,na,1932,45
STAT,1889,23,25-29,1912,0.6987104631946708
STAT,1912,44,30-34,1956,0.0012139172748334283
STAT,1898,46,na,1944,30.442200817805166
STAT,1911,53,na,1964,33.820650257857295
STAT,1938,28,15-19,1966,0.006944475086381602
STAT,1938,20,40-44,1958,0.033080761423360514
SIM,1878,38,na,1916,29
STAT,1925,25,30-34,1950,0.4630155097246783
STAT,1842,47,30-34,1889,7.26391377810345E-4
STAT,1920,17,25-29,1937,0.4820577063791389
SIM,1856,22,30-34,1878,1
SIM,1908,1,na,1909,42
STAT,1834,37,30-34,1871,0.0468481778035424
SIM,1934,26,30-34,1960,1
STAT,1872,32,na,1904,24.416023655946116
STAT,1875,20,50-100,1895,0.0042168605281863855
STAT,1928,38,35-39,1966,0.030387758949053035
STAT,1849,69,na,1918,11.379203731680066
SIM,1952,12,na,1964,35
STAT,1880,75,na,1955,10.825340327367096
STAT,1919,44,40-44,1963,0.002678111937590805
STAT,1831,49,20-24,1880,1.1197933038513492E-4
STAT,1830,44,35-39,1874,0.0018280069678704525
STAT,1914,23,35-39,1937,0.09510572531089269
STAT,1849,50,50-100,1899,1.1878825954583405E-4
STAT,1802,82,na,1884,1.492236849630088
STAT,1843,32,45-49,1875,0.008892832892785928
SIM,1855,10,na,1865,24
STAT,1829,29,40-44,1858,0.030043268929457
STAT,1888,43,30-34,1931,0.013337948907563695
STAT,1903,21,30-34,1924,0.2540077022337207
SIM,1868,20,20-24,1888,1
STAT,1830,105,na,1935,1.0534685501257209E-4
STAT,1902,17,na,1919,35.615760453947246
SIM,1851,32,45-49,1883,1
STAT,1849,20,45-49,1869,0.006632084960094439
STAT,1924,25,15-19,1949,0.0082216014615519
STAT,1870,46,30-34,1916,9.643303103236216E-4
STAT,1813,45,na,1858,20.8689459030917
STAT,1843,21,35-39,1864,0.03129570259183584
STAT,1926,45,40-44,1971,0.0019433538945740876
STAT,1893,19,50-100,1912,6.144147603872938E-4
STAT,1912,26,35-39,1938,0.1472988388025628
STAT,1839,32,25-29,1871,0.06955985077316276
STAT,1882,87,na,1969,4.100693492259119
STAT,1823,52,na,1875,13.866709791125128
STAT,1855,31,25-29,1886,0.07419446376097552
SIM,1810,46,na,1856,18
STAT,1917,48,30-34,1965,9.201049113903679E-4
STAT,1853,37,40-44,1890,0.027511782823056323
STAT,1866,43,50-100,1909,0.00965944162366498
STAT,1856,18,45-49,1874,5.56253651134578E-4
SIM,1908,53,na,1961,37
STAT,1921,9,na,1930,45.02278668093651
STAT,1869,97,na,1966,0.21436984039272886
STAT,1890,82,na,1972,10.334034775238887
STAT,1832,31,30-34,1863,0.1031005345507857
STAT,1889,22,40-44,1911,0.025512732192054827
SIM,1902,22,25-29,1924,3
STAT,1910,19,30-34,1929,0.02387546338635153
STAT,1855,20,15-19,1875,0.027529306344073173
STAT,1831,38,50-100,1869,0.012422900082722092
STAT,1901,44,25-29,1945,6.155494004183244E-4
STAT,1933,19,25-29,1952,0.5746424875142451
STAT,1884,31,50-100,1915,0.00901361909410366
STAT,1914,34,45-49,1948,0.01557384541776815
SIM,1820,67,na,1887,8
STAT,1919,45,30-34,1964,9.630358743237366E-4
STAT,1938,31,na,1969,37.79992326317031
STAT,1854,32,20-24,1886,0.016919568172190796
STAT,1844,14,na,1858,23.488282673277798
STAT,1812,44,50-100,1856,0.012026918767000938
STAT,1894,38,40-44,1932,0.05582345641956
SIM,1913,29,na,1942,42
STAT,1797,73,na,1870,4.395557148073501
STAT,1901,62,na,1963,27.386362848715432
STAT,1785,85,na,1870,2.463027281913088
STAT,1884,48,25-29,1932,5.572462023396204E-4
STAT,1838,29,na,1867,21.052262440579426
STAT,1844,15,50-100,1859,4.922245175238321E-4
STAT,1881,4,na,1885,27.010608697257773
STAT,1956,16,20-24,1972,1.7843785664185703
STAT,1899,44,45-49,1943,0.0014035253158419755
STAT,1914,22,45-49,1936,0.011400062189354129
STAT,1847,54,na,1901,22.368423549562518
STAT,1907,29,25-29,1936,0.6091713474040956
STAT,1825,105,na,1930,1.580687288068574E-4
SIM,1915,29,25-29,1944,3
STAT,1911,29,45-49,1940,0.016619697958644784
STAT,1819,47,na,1866,13.846583695873623
STAT,1835,27,15-19,1862,0.002722793406719498
STAT,1857,15,35-39,1872,0.004885320197947611
STAT,1899,33,35-39,1932,0.1380477815660102
STAT,1911,18,35-39,1929,0.008320903283537955
STAT,1848,28,na,1876,16.58133980307904
STAT,1881,39,50-100,1920,0.011564926463150348
STAT,1884,8,na,1892,25.469104927398927
STAT,1853,23,15-19,1876,0.024321899990044825
SIM,1814,90,na,1904,6
STAT,1880,72,na,1952,13.280010457526494
STAT,1852,34,50-100,1886,0.007952239638323266
STAT,1884,86,na,1970,5.023349533675587
STAT,1867,18,20-24,1885,0.17241681058716815
STAT,1940,24,45-49,1964,0.011372961518646843
STAT,1944,17,50-100,1961,0.004002632091859946
STAT,1847,65,na,1912,18.052804954969993
STAT,1838,18,na,1856,23.394328125378934
STAT,1845,17,30-34,1862,0.01177580549327667
STAT,1901,51,na,1952,30.27359142351385
STAT,1922,29,20-24,1951,0.20357603381607028
STAT,1910,17,35-39,1927,0.008263738408318783
STAT,1827,47,40-44,1874,0.0012906879679851415
STAT,1865,22,25-29,1887,0.5240733569965978
STAT,1851,70,na,1921,11.845186152606814
STAT,1910,23,20-24,1933,1.0346376628781366
STAT,1884,65,na,1949,16.55744067798871
SIM,1784,75,na,1859,3
SIM,1873,22,25-29,1895,1
STAT,1841,50,45-49,1891,1.4409097671378714E-4
STAT,1930,23,40-44,1953,0.04274008839493395
STAT,1950,15,15-19,1965,0.5335773434252606
STAT,1888,79,na,1967,11.95456312145899
STAT,1920,33,25-29,1953,0.09995344432162294
STAT,1859,98,na,1957,0.03524997257108268
SIM,1881,58,na,1939,18
STAT,1894,24,15-19,1918,0.04201534404446143
STAT,1925,22,20-24,1947,1.3226620863255119
SIM,1876,39,50-100,1915,1
STAT,1861,17,15-19,1878,0.05736224719052459
STAT,1860,48,50-100,1908,0.0019715728552701694
STAT,1906,28,25-29,1934,0.6123984805051651
STAT,1802,90,na,1892,0.24078316200714855
STAT,1936,24,25-29,1960,0.8771595329065418
STAT,1918,44,30-34,1962,0.001342494793749567
STAT,1853,101,na,1954,0.0035862620789630863
STAT,1783,81,na,1864,1.0345606238938618
STAT,1871,54,50-100,1925,1.4643376787193928E-4
STAT,1913,38,45-49,1951,0.00663825041026721
STAT,1851,37,50-100,1888,0.010475980857249434
STAT,1826,92,na,1918,0.2910531382874665
STAT,1829,46,50-100,1875,0.002123770898087041
SIM,1958,8,na,1966,53
STAT,1951,16,15-19,1967,0.537304109566261
STAT,1813,42,na,1855,21.425876013398845
STAT,1942,22,20-24,1964,1.1573753650116483
STAT,1873,32,30-34,1905,0.17751165868294616
SIM,1868,79,na,1947,8
STAT,1868,48,40-44,1916,0.0016359624595727105
STAT,1924,23,50-100,1947,0.007689924203969648
SIM,1820,75,na,1895,3
STAT,1900,29,15-19,1929,0.0062464455051546635
SIM,1944,24,25-29,1968,3
SIM,1872,84,na,1956,4
STAT,1858,43,45-49,1901,0.011306335166145176
STAT,1860,21,50-100,1881,0.003442238345860427
STAT,1941,29,30-34,1970,0.4019938640628008
STAT,1823,44,na,1867,15.52042006275121
SIM,1841,29,na,1870,16
STAT,1879,20,30-34,1899,0.1854589018175249
STAT,1941,25,45-49,1966,0.017757444717078123
STAT,1935,32,30-34,1967,0.21700498407907146
STAT,1843,18,50-100,1861,2.640159094633998E-4
SIM,1881,32,30-34,1913,1
STAT,1913,17,50-100,1930,7.59607886694581E-4
SIM,1946,16,na,1962,53
STAT,1879,17,30-34,1896,0.01649670813192815
SIM,1933,20,na,1953,50
STAT,1891,48,50-100,1939,0.001679010448872784
STAT,1926,35,20-24,1961,0.003208788680586677
STAT,1847,102,na,1949,0.003131803723074209
STAT,1855,19,40-44,1874,0.0015136783710307602
STAT,1906,17,15-19,1923,0.08621809297522413
SIM,1914,28,25-29,1942,1
SIM,1870,18,na,1888,26
SIM,1876,90,na,1966,2
STAT,1929,34,35-39,1963,0.11537369832406405
SIM,1868,68,na,1936,27
STAT,1882,22,30-34,1904,0.17070290748833652
STAT,1892,45,50-100,1937,0.0017285826980100718
STAT,1926,29,35-39,1955,0.1776698651789061
STAT,1842,44,50-100,1886,0.007993194923033822
STAT,1902,37,30-34,1939,0.01622197694824702
SIM,1895,61,na,1956,20
STAT,1892,34,15-19,1926,0.0017442527338967985
STAT,1916,28,na,1944,38.26763736460299
SIM,1855,29,na,1884,20
STAT,1911,34,40-44,1945,0.037536830856708225
SIM,1929,23,na,1952,45
STAT,1912,46,na,1958,35.117703257047104
STAT,1872,19,40-44,1891,0.0018613736090487066
SIM,1891,21,35-39,1912,1
STAT,1879,5,na,1884,28.0687129774593
STAT,1884,33,45-49,1917,0.017013032661643175
STAT,1871,19,50-100,1890,4.858297524265223E-4
STAT,1909,22,15-19,1931,0.049196674006514
STAT,1925,34,20-24,1959,0.028746559824280257
STAT,1795,63,na,1858,10.519619822714889
SIM,1902,4,na,1906,38
SIM,1944,12,na,1956,36
STAT,1817,42,45-49,1859,0.04727598332541973
STAT,1956,2,na,1958,51.77902988415289
STAT,1874,36,na,1910,24.01622366713418
STAT,1824,93,na,1917,0.2033538252025287
STAT,1828,49,50-100,1877,0.0010258109556455068
STAT,1885,28,na,1913,23.484313609184674
SIM,1874,5,na,1879,31
STAT,1919,23,40-44,1942,0.036386322504010006
STAT,1847,45,35-39,1892,0.0015104416196550377
STAT,1884,22,35-39,1906,0.05717322971574689
STAT,1922,0,na,1922,51.7567248924294
SIM,1851,36,na,1887,19
STAT,1862,54,na,1916,18.065920383263546
SIM,1825,42,45-49,1867,1
STAT,1909,35,20-24,1944,0.0025047187972354534
SIM,1933,28,35-39,1961,1
STAT,1867,33,45-49,1900,0.016617268609948
STAT,1851,62,na,1913,15.43027125990469
SIM,1883,36,na,1919,13
SIM,1898,1,na,1899,38
STAT,1837,55,na,1892,9.997897390654506
SIM,1918,31,na,1949,36
STAT,1863,95,na,1958,0.17790871644830644
STAT,1897,49,50-100,1946,0.001801321930927419
STAT,1940,26,50-100,1966,0.010082339508632975
STAT,1792,66,na,1858,15.505974771065883
STAT,1827,33,15-19,1860,0.0012216021512582724
STAT,1898,16,35-39,1914,0.007420270750484035
STAT,1965,4,na,1969,48.78271334508168
STAT,1846,91,na,1937,0.46962539684789206
STAT,1916,32,20-24,1948,0.024967326473550138
STAT,1944,22,30-34,1966,0.30807156175947187
STAT,1870,49,35-39,1919,0.001361706343549984
STAT,1915,39,30-34,1954,0.01806898216817987
STAT,1887,34,50-100,1921,0.00991526748570272
STAT,1883,21,35-39,1904,0.05683834869125769
STAT,1915,39,50-100,1954,0.004162442693316071
SIM,1893,46,na,1939,35
STAT,1813,74,na,1887,7.580836061623369
STAT,1848,25,35-39,1873,0.0755746827731677
STAT,1888,46,35-39,1934,0.0016406822614986596
SIM,1892,21,na,1913,35
SIM,1866,69,na,1935,21
STAT,1803,67,na,1870,8.378759045552501
STAT,1814,49,20-24,1863,3.3327879243654477E-4
STAT,1813,44,35-39,1857,0.057906536852197425
STAT,1876,28,50-100,1904,0.00647413909441172
STAT,1858,17,na,1875,20.40383074172342
STAT,1833,35,50-100,1868,0.011602754629427761
STAT,1867,40,50-100,1907,0.01021183974054728
STAT,1816,93,na,1909,0.08773984376719418
STAT,1928,35,30-34,1963,0.02296059594807392
STAT,1901,41,20-24,1942,1.550138621414068E-4
STAT,1920,19,45-49,1939,0.005527059745827776
STAT,1929,33,45-49,1962,0.019880003135478427
STAT,1907,4,na,1911,38.480425924358705
STAT,1915,15,20-24,1930,0.28260869330812144
STAT,1925,28,35-39,1953,0.17559747792184666
STAT,1838,31,25-29,1869,0.09981506957840736
STAT,1950,15,45-49,1965,0.005873167148626942
SIM,1855,18,na,1873,22
SIM,1821,38,na,1859,16
SIM,1938,9,na,1947,40
SIM,1800,79,na,1879,6
STAT,1880,3,na,1883,31.83838113355526
STAT,1900,69,na,1969,23.791398071108265
SIM,1868,47,na,1915,32
STAT,1869,57,na,1926,19.472146756442644
STAT,1885,18,15-19,1903,0.05845102375374239
SIM,1943,23,25-29,1966,2
STAT,1874,87,na,1961,2.9853825705980888
STAT,1912,23,30-34,1935,0.272445019848308
STAT,1908,25,30-34,1933,0.3741296369339497
STAT,1931,39,15-19,1970,2.526577364578012E-4
STAT,1792,63,na,1855,17.341199999999997
STAT,1841,19,20-24,1860,0.2211787925085563
STAT,1796,77,na,1873,0.6819413975083108
STAT,1890,23,50-100,1913,0.004938135774920397
STAT,1855,15,25-29,1870,0.048018354058180855
STAT,1944,19,50-100,1963,0.003999950776653195
STAT,1925,26,15-19,1951,0.008314375699219473
SIM,1857,84,na,1941,4
STAT,1879,47,50-100,1926,0.002530133692303709
SIM,1900,33,na,1933,34
STAT,1935,12,na,1947,53.926534243403275
STAT,1935,23,25-29,1958,1.25185130671037
SIM,1893,35,na,1928,36
SIM,1916,25,30-34,1941,1
SIM,1821,60,na,1881,9
STAT,1925,37,25-29,1962,0.011743509353013708
STAT,1917,19,40-44,1936,0.014786319805168237
STAT,1832,34,35-39,1866,0.05796669836110521
STAT,1838,30,50-100,1868,0.00902209076219177
STAT,1922,13,na,1935,45.44950412726495
STAT,1901,54,na,1955,29.300893983097552
STAT,1902,37,50-100,1939,0.0037369592150178284
SIM,1839,36,na,1875,20
SIM,1852,47,40-44,1899,2
STAT,1880,22,20-24,1902,0.7246514622715223
SIM,1917,35,na,1952,37
STAT,1883,16,na,1899,24.58592849937248
STAT,1842,20,35-39,1862,0.05602409614836295
SIM,1865,28,na,1893,22
SIM,1868,17,na,1885,38
STAT,1868,34,15-19,1902,0.0013663444597743165
STAT,1903,10,na,1913,36.82752421883564
STAT,1932,18,25-29,1950,0.5700023586598674
SIM,1867,43,na,1910,11
STAT,1911,61,na,1972,31.832488683224124
STAT,1822,59,na,1881,7.450883815731475
STAT,1806,54,45-49,1860,4.5166447756865867E-4
STAT,1827,104,na,1931,4.042140268595311E-4
STAT,1844,47,40-44,1891,0.0013310004755663195
STAT,1910,44,20-24,1954,1.6384793027329249E-4
STAT,1918,32,30-34,1950,0.16590493455345842
SIM,1854,6,na,1860,21
STAT,1920,30,20-24,1950,0.026702776324919564
STAT,1846,40,na,1886,19.449733347415137
SIM,1834,59,na,1893,12
STAT,1864,21,25-29,1885,0.5254786112647378
SIM,1892,10,na,1902,36
STAT,1873,45,45-49,1918,0.0024233155234103555
STAT,1835,77,na,1912,3.8879740911616345
STAT,1925,13,na,1938,47.49082502942527
STAT,1796,88,na,1884,0.09443473406126239
STAT,1923,24,45-49,1947,0.012919792439610448
STAT,1898,32,35-39,1930,0.13661420806934174
STAT,1924,25,45-49,1949,0.02011994417171747
STAT,1820,45,35-39,1865,0.001215262585075946
SIM,1867,54,na,1921,10
STAT,1875,54,50-100,1929,1.5097832580794957E-4
STAT,1839,18,45-49,1857,4.687908742538337E-4
STAT,1870,23,15-19,1893,0.03267086216137821
STAT,1874,15,35-39,1889,0.005613341376587074
SIM,1923,39,na,1962,38
STAT,1821,54,40-44,1875,1.373079521380137E-4
SIM,1834,67,na,1901,11
STAT,1848,95,na,1943,0.08598221466238744
STAT,1904,15,45-49,1919,9.4034888118022E-4
STAT,1951,18,35-39,1969,0.04964938728674276
STAT,1946,17,45-49,1963,0.00550154056450536
STAT,1872,28,50-100,1900,0.0065221030188250114
STAT,1861,69,na,1930,12.341387124130144
SIM,1845,11,na,1856,24
STAT,1832,44,45-49,1876,0.008023468663355548
SIM,1819,59,na,1878,5
STAT,1860,44,na,1904,18.536122165276808
STAT,1868,39,50-100,1907,0.011761841690005851
SIM,1856,45,50-100,1901,1
SIM,1911,9,na,1920,42
STAT,1884,57,na,1941,19.689398886909043
STAT,1883,72,na,1955,12.263738328397327
STAT,1926,38,25-29,1964,0.01195233509239357
SIM,1888,8,na,1896,39
STAT,1913,35,40-44,1948,0.014788743152288198
STAT,1871,36,na,1907,23.602155098107964
STAT,1847,42,30-34,1889,0.012349676366572002
STAT,1850,77,na,1927,7.696244286046721
STAT,1952,19,35-39,1971,0.04995452098993736
STAT,1895,49,na,1944,28.604137980694965
SIM,1908,21,na,1929,41
STAT,1894,64,na,1958,23.022620910846605
STAT,1910,15,15-19,1925,0.08979152269958904
STAT,1945,16,45-49,1961,0.005419213772519195
STAT,1926,41,25-29,1967,8.765597442284925E-4
SIM,1845,51,na,1896,22
STAT,1919,39,50-100,1958,0.004461912258218284
STAT,1869,43,20-24,1912,0.0015276892301217604
STAT,1926,38,na,1964,45.67005205717586
STAT,1882,51,45-49,1933,1.3974425659665307E-4
SIM,1946,2,na,1948,55
STAT,1930,38,45-49,1968,0.008841576952480902
SIM,1970,0,na,1970,42
SIM,1846,81,na,1927,2
STAT,1884,45,20-24,1929,1.1874236318694881E-4
STAT,1921,17,40-44,1938,0.015819154215548494
STAT,1934,15,30-34,1949,0.1649300184370235
STAT,1947,18,15-19,1965,0.5075708680690927
STAT,1915,48,20-24,1963,1.1008933932818606E-4
STAT,1879,21,15-19,1900,0.03424831601543363
SIM,1854,25,na,1879,15
STAT,1839,34,50-100,1873,0.00609454006624818
STAT,1825,47,30-34,1872,8.933490463232004E-4
STAT,1868,19,20-24,1887,0.1726218020979199
STAT,1965,7,na,1972,48.75783832708993
STAT,1904,33,40-44,1937,0.03553044973023547
SIM,1818,74,na,1892,8
STAT,1873,94,na,1967,0.7545210277173829
STAT,1910,26,25-29,1936,0.6338787974042345
SIM,1960,7,na,1967,52
STAT,1849,80,na,1929,4.796541815603331
STAT,1859,28,50-100,1887,0.0051350086132214605
STAT,1851,37,30-34,1888,0.045475775944685194
STAT,1902,25,na,1927,33.88275481745755
STAT,1918,47,35-39,1965,0.001359596302810415
STAT,1935,27,40-44,1962,0.06325448073042106
SIM,1806,49,na,1855,10
STAT,1913,24,30-34,1937,0.2860006801171037
SIM,1908,61,na,1969,30
STAT,1849,22,40-44,1871,0.019535111319006575
STAT,1861,46,35-39,1907,0.0011806804112564418
SIM,1921,24,30-34,1945,1
SIM,1875,30,40-44,1905,1
STAT,1924,45,30-34,1969,0.0010593539273049803
SIM,1943,16,30-34,1959,2
STAT,1926,27,na,1953,44.650925405125996
STAT,1879,32,25-29,1911,0.10601197901182711
STAT,1919,40,25-29,1959,7.692694589403647E-4
STAT,1935,16,30-34,1951,0.16629706753664153
STAT,1856,39,na,1895,16.895707652983756
STAT,1892,38,30-34,1930,0.06551543496822462
SIM,1880,17,na,1897,30
STAT,1949,15,na,1964,42.55732654698328
SIM,1847,77,na,1924,7
SIM,1942,15,30-34,1957,1
STAT,1919,15,35-39,1934,0.009265529571306342
SIM,1917,26,30-34,1943,1
STAT,1895,48,50-100,1943,0.0017759885892378302
SIM,1932,35,na,1967,48
STAT,1919,48,35-39,1967,0.0013824418834598275
SIM,1806,60,na,1866,6
SIM,1858,69,na,1927,18
STAT,1919,26,45-49,1945,0.018568353442555332
STAT,1838,20,15-19,1858,0.0337024341982972
STAT,1848,21,40-44,1869,0.016527057764011612
STAT,1902,33,15-19,1935,0.001999739340865165
STAT,1911,21,na,1932,36.06757058273491
STAT,1915,35,na,1950,38.03551042543896
STAT,1912,42,35-39,1954,0.0019269242751517996
STAT,1853,104,na,1957,6.235678591949351E-4
STAT,1914,50,na,1964,35.8074773598556
STAT,1864,80,na,1944,5.548331682525216
SIM,1882,43,na,1925,29
STAT,1841,49,50-100,1890,0.0023537762168611455
STAT,1824,37,na,1861,20.044682636799404
STAT,1873,35,35-39,1908,0.0725928075211398
STAT,1909,26,30-34,1935,0.3768136159175528
STAT,1895,33,20-24,1928,0.03494451077543222
STAT,1857,31,35-39,1888,0.07707627434177608
STAT,1913,43,35-39,1956,0.0019441956179872208
SIM,1866,80,na,1946,2
SIM,1888,13,na,1901,39
SIM,1867,3,na,1870,24
STAT,1935,35,35-39,1970,0.033730180448155025
SIM,1892,50,na,1942,32
SIM,1927,26,45-49,1953,1
SIM,1943,27,na,1970,47
SIM,1955,4,na,1959,46
SIM,1868,23,25-29,1891,2
STAT,1868,44,25-29,1912,0.006130561197177102
STAT,1909,37,40-44,1946,0.014090002629344296
SIM,1947,12,na,1959,40
STAT,1875,72,na,1947,12.98182925437745
STAT,1813,41,50-100,1854,0.03670092182110916
STAT,1828,42,20-24,1870,7.000466456312007E-4
STAT,1858,32,35-39,1890,0.07706137061444857
STAT,1880,35,35-39,1915,0.07508187796376566
STAT,1860,84,na,1944,2.704460965306163
STAT,1836,70,na,1906,13.54114046577086
STAT,1804,60,na,1864,11.484623533477201
STAT,1897,22,50-100,1919,0.005415274742991478
STAT,1879,36,40-44,1915,0.04552565974971933
SIM,1837,53,na,1890,29
SIM,1905,20,30-34,1925,2
STAT,1820,42,30-34,1862,0.010159905761564366
STAT,1863,29,40-44,1892,0.026333088902734513
SIM,1884,55,na,1939,20
STAT,1892,39,20-24,1931,0.009427280052424453
STAT,1902,44,40-44,1946,0.00217290018017794
STAT,1903,34,50-100,1937,0.007415815688912388
STAT,1936,27,35-39,1963,0.14281363146500858
STAT,1879,20,25-29,1899,0.5960329840002095
STAT,1942,14,na,1956,40.736583107181524
SIM,1833,63,na,1896,8
SIM,1797,61,na,1858,2
SIM,1924,8,na,1932,55
STAT,1805,53,45-49,1858,2.7520675994579066E-4
SIM,1928,20,25-29,1948,2
STAT,1837,26,35-39,1863,0.06140945519372515
STAT,1855,20,na,1875,17.841996331971547
STAT,1877,28,30-34,1905,0.2590279453217998
SIM,1793,71,na,1864,13
SIM,1829,58,na,1887,19
STAT,1856,20,30-34,1876,0.15204117887980975
STAT,1931,18,45-49,1949,0.006492481177094769
STAT,1869,2,na,1871,32.32968317598755
SIM,1936,6,na,1942,38
STAT,1851,30,na,1881,21.408362073648906
STAT,1868,72,na,1940,12.221606125600108
SIM,1789,66,na,1855,9
SIM,1888,45,na,1933,32
STAT,1888,43,50-100,1931,0.012256493563838558
STAT,1900,25,20-24,1925,0.16378158248208421
STAT,1930,20,15-19,1950,0.06827954447634321
STAT,1875,15,15-19,1890,0.06128718215268223
STAT,1854,45,35-39,1899,8.642602816404249E-4
STAT,1894,47,30-34,1941,6.965285084595508E-4
SIM,1808,64,na,1872,7
STAT,1871,24,15-19,1895,0.032685376190361784
SIM,1885,28,30-34,1913,1
STAT,1843,37,15-19,1880,2.780821288716193E-4
STAT,1916,28,20-24,1944,0.18646732647104544
SIM,1905,64,na,1969,37
STAT,1872,44,45-49,1916,0.015106477235239963
STAT,1916,35,25-29,1951,0.010091697206305596
STAT,1914,27,15-19,1941,0.007057729251367711
STAT,1848,20,50-100,1868,0.0032576480275970042
SIM,1861,60,na,1921,20
STAT,1814,48,45-49,1862,0.006655797236415226
STAT,1856,45,45-49,1901,0.0017267073056288081
STAT,1887,31,15-19,1918,0.001560743005805644
SIM,1916,29,40-44,1945,1
STAT,1847,42,25-29,1889,0.006898017458200355
STAT,1867,21,45-49,1888,0.0067490408885575535
SIM,1859,56,na,1915,18
STAT,1909,38,30-34,1947,0.01706938935470222
STAT,1831,45,40-44,1876,0.0016816100894408643
STAT,1825,48,20-24,1873,1.0926539159561217E-4
STAT,1917,13,na,1930,42.047167000062636
STAT,1843,17,20-24,1860,0.09610463259976444
STAT,1917,15,na,1932,41.37588530516628
STAT,1848,32,50-100,1880,0.006910020955354386
SIM,1831,62,na,1893,5
SIM,1950,18,20-24,1968,2
STAT,1908,29,40-44,1937,0.04352008224134682
SIM,1892,72,na,1964,18
STAT,1845,34,15-19,1879,9.694344567685346E-4
STAT,1885,42,na,1927,22.79573502291351
STAT,1840,78,na,1918,6.122454570818712
STAT,1786,89,na,1875,0.1607243505960594
STAT,1927,34,30-34,1961,0.19256870441824533
STAT,1942,18,20-24,1960,1.4060461979761312
STAT,1920,37,40-44,1957,0.016250809311776686
STAT,1946,26,na,1972,41.45404103685578
SIM,1951,17,25-29,1968,1
STAT,1934,19,40-44,1953,0.01873783919569559
STAT,1844,16,25-29,1860,0.05659863953824361
SIM,1919,33,35-39,1952,1
STAT,1848,9,na,1857,19.531506465131937
STAT,1905,28,45-49,1933,0.01596794809576681
STAT,1941,29,25-29,1970,0.675283112238987
STAT,1872,24,na,1896,24.046986006784223
SIM,1905,42,na,1947,40
STAT,1792,95,na,1887,0.05365102301727502
STAT,1880,25,25-29,1905,0.4478397180570351
STAT,1910,47,25-29,1957,4.918912739380249E-4
STAT,1852,17,30-34,1869,0.01649839724040324
STAT,1874,25,na,1899,24.375329089030327
STAT,1863,16,35-39,1879,0.005576574978234684
STAT,1894,34,25-29,1928,0.13014451870332677
SIM,1930,31,na,1961,49
STAT,1929,31,30-34,1960,0.19928415439989747
STAT,1875,34,15-19,1909,0.0014513354707365693
STAT,1902,28,35-39,1930,0.1355889416549594
STAT,1826,47,25-29,1873,5.799042354218269E-4
STAT,1943,17,25-29,1960,0.45618956174609043
STAT,1866,49,20-24,1915,1.0821026340596134E-4
STAT,1821,38,35-39,1859,0.13257311162102445
STAT,1843,44,20-24,1887,6.760769778230031E-4
STAT,1831,43,45-49,1874,0.014634949466302567
STAT,1851,31,35-39,1882,0.08991464525073661
STAT,1920,17,30-34,1937,0.1355874127156499
SIM,1896,9,na,1905,33
STAT,1837,39,40-44,1876,0.025425828325526728
STAT,1885,50,na,1935,21.568405902358307
SIM,1888,67,na,1955,24
STAT,1827,43,25-29,1870,0.004953467573893635
STAT,1924,22,40-44,1946,0.039417309309152736
STAT,1869,17,40-44,1886,0.0017967643544084446
STAT,1890,15,40-44,1905,0.002232051223473552
STAT,1820,39,30-34,1859,0.048378589461835916
SIM,1806,63,na,1869,6
STAT,1868,70,na,1938,13.578184716139221
STAT,1882,22,25-29,1904,0.5486097584460655
STAT,1844,68,na,1912,11.936675463587544
STAT,1842,87,na,1929,1.321847333014477
STAT,1877,37,50-100,1914,0.012673510430439483
STAT,1817,80,na,1897,4.902612043218301
STAT,1857,19,15-19,1876,0.051603178980336936
STAT,1872,46,40-44,1918,0.001756640696980959
STAT,1884,18,20-24,1902,0.17324054943764927
STAT,1886,28,40-44,1914,0.030962601852753565
SIM,1781,78,na,1859,7
STAT,1922,25,40-44,1947,0.052711463166823826
SIM,1804,82,na,1886,5
STAT,1895,46,35-39,1941,0.0010281645826670993
STAT,1942,25,25-29,1967,0.6863852770023985
STAT,1878,15,na,1893,26.195948331664326
STAT,1909,15,50-100,1924,7.339854998165677E-4
SIM,1895,15,na,1910,31
STAT,1819,37,40-44,1856,0.04903442587302174
STAT,1877,55,na,1932,21.344201915603698
SIM,1842,22,na,1864,27
SIM,1942,24,20-24,1966,3
SIM,1891,25,na,1916,35
STAT,1849,38,20-24,1887,0.006052969263874489
SIM,1884,23,na,1907,26
SIM,1826,83,na,1909,4
STAT,1888,40,20-24,1928,0.001874612525101895
STAT,1869,46,25-29,1915,5.596948206526223E-4
SIM,1839,34,na,1873,21
STAT,1846,54,45-49,1900,1.143784117508801E-4
STAT,1908,30,na,1938,35.79973330714437
STAT,1835,43,50-100,1878,0.005660552227708556
STAT,1864,28,45-49,1892,0.009923508632176867
STAT,1915,19,15-19,1934,0.09365957519814262
STAT,1886,35,15-19,1921,5.880041626203547E-4
STAT,1899,29,20-24,1928,0.15944797355933052
STAT,1819,61,na,1880,10.53699479275274
STAT,1897,53,na,1950,28.13478460226457
STAT,1951,6,na,1957,46.52909419341108
STAT,1819,44,15-19,1863,1.2621032097466956E-4
STAT,1917,47,na,1964,38.02421943821446
SIM,1795,80,na,1875,4
STAT,1938,17,na,1955,36.069201025200684
STAT,1894,1,na,1895,34.88322004158692
STAT,1850,6,na,1856,27.143287817999994
STAT,1915,39,25-29,1954,0.009761404106237432
SIM,1904,17,na,1921,33
STAT,1859,20,40-44,1879,0.01915776462463769
STAT,1878,21,20-24,1899,0.7136126572301077
STAT,1838,35,40-44,1873,0.04185736177386584
SIM,1855,72,na,1927,5
STAT,1917,24,20-24,1941,1.1637203412717465
STAT,1928,40,50-100,1968,0.0014944675230594167
STAT,1934,24,20-24,1958,1.4869824030986232
STAT,1904,16,35-39,1920,0.007881712393495343
STAT,1859,27,25-29,1886,0.3420223061770416
STAT,1878,24,30-34,1902,0.18274590955405604
STAT,1860,23,15-19,1883,0.02744924758415009
STAT,1871,29,35-39,1900,0.09551229263549499
STAT,1904,40,na,1944,33.567234299076816
STAT,1908,49,35-39,1957,0.0011531503439564138
STAT,1904,36,45-49,1940,0.006195067578193211
STAT,1827,88,na,1915,0.8319627997769812
SIM,1902,27,30-34,1929,1
STAT,1855,46,40-44,1901,0.0012087897879415367
STAT,1925,21,45-49,1946,0.01342434906918538
STAT,1858,38,30-34,1896,0.04035398541842773
STAT,1826,63,na,1889,12.60944798914877
STAT,1834,31,35-39,1865,0.09262815795059974
STAT,1841,38,na,1879,24.44492789371212
STAT,1867,48,25-29,1915,5.442833156388329E-4
SIM,1862,20,na,1882,23
STAT,1853,33,25-29,1886,0.06560591387434915
SIM,1867,51,na,1918,11
STAT,1868,27,na,1895,23.095466555708626
STAT,1877,25,50-100,1902,0.006648094337553719
STAT,1813,49,40-44,1862,0.005150155471458422
STAT,1943,3,na,1946,42.330473801828674
STAT,1826,49,na,1875,17.402706840109595
STAT,1830,49,40-44,1879,1.6532087622280904E-4
STAT,1858,94,na,1952,0.15208299631527997
STAT,1892,32,35-39,1924,0.12511054763744994
STAT,1881,39,45-49,1920,0.018777978451480003
STAT,1918,23,25-29,1941,0.9841616582802595
SIM,1905,10,na,1915,40
SIM,1876,26,na,1902,29
SIM,1884,77,na,1961,10
STAT,1895,36,25-29,1931,0.037559236725552725
STAT,1897,75,na,1972,18.35622515917339
STAT,1935,31,50-100,1966,0.011394528063794285
STAT,1875,32,35-39,1907,0.10410038179722393
STAT,1909,18,na,1927,37.56440743169834
STAT,1837,26,50-100,1863,0.00407124597407466
STAT,1840,38,45-49,1878,0.01828471665889246
STAT,1831,93,na,1924,0.23716223113749346
STAT,1937,23,35-39,1960,0.09108384583876776
STAT,1908,21,45-49,1929,0.010321420552499886
SIM,1813,43,na,1856,12
STAT,1829,102,na,1931,0.0019913970137983546
STAT,1889,24,na,1913,28.77476998632731
STAT,1809,102,na,1911,0.0016221720440343476
STAT,1839,99,na,1938,0.010451422079415077
STAT,1850,103,na,1953,0.0012778073727854277
STAT,1899,16,15-19,1915,0.08143958815162346
SIM,1821,52,na,1873,11
STAT,1825,41,35-39,1866,0.017935671411423645
SIM,1926,23,25-29,1949,2
STAT,1867,28,30-34,1895,0.24013259688406566
STAT,1889,25,45-49,1914,0.013686017857462984
STAT,1839,23,35-39,1862,0.041080531585354255
STAT,1853,46,30-34,1899,6.10097090766378E-4
SIM,1854,33,na,1887,17
STAT,1776,79,na,1855,1.81914
STAT,1834,33,15-19,1867,0.0012757735403441247
STAT,1896,34,na,1930,31.076690818960973
STAT,1914,20,30-34,1934,0.28110453258244356
STAT,1834,50,na,1884,16.232275755461043
STAT,1861,43,30-34,1904,0.009598357568097942
STAT,1826,41,na,1867,19.198949376253754
STAT,1839,81,na,1920,2.984242299481224
STAT,1862,39,35-39,1901,0.060408498818534856
STAT,1858,2,na,1860,26.620610697743448
STAT,1893,71,na,1964,19.313461895914102
STAT,1908,34,20-24,1942,0.022708142377854658
SIM,1848,19,na,1867,33
STAT,1848,50,na,1898,14.12463166545226
SIM,1804,80,na,1884,5
STAT,1917,39,35-39,1956,0.02474318619906213
SIM,1914,25,na,1939,36
STAT,1891,23,50-100,1914,0.004989606176601452
STAT,1904,30,15-19,1934,0.0020569484941557695
STAT,1849,25,15-19,1874,0.0042307589881578934
STAT,1860,17,20-24,1877,0.16622592086536153
STAT,1864,66,na,1930,14.700657044484236
STAT,1837,23,30-34,1860,0.11717964954049946
STAT,1805,50,40-44,1855,2.1192521615427294E-4
SIM,1895,47,na,1942,27
STAT,1934,36,30-34,1970,0.025067193323925197
STAT,1911,23,15-19,1934,0.050004495856498146
STAT,1829,34,30-34,1863,0.16223773800242217
STAT,1894,28,30-34,1922,0.3215931776987241
STAT,1846,29,40-44,1875,0.02894881251732315
STAT,1903,24,35-39,1927,0.08244558119715137
SIM,1842,54,na,1896,20
STAT,1786,104,na,1890,1.4829899534157673E-4
STAT,1877,87,na,1964,3.622186737348391
STAT,1852,34,20-24,1886,0.023460273086490232
STAT,1835,37,25-29,1872,0.016147038144780364
STAT,1839,20,30-34,1859,0.12813492014707767
STAT,1919,47,45-49,1966,0.002336898606996651
STAT,1809,69,na,1878,9.901493637145064
STAT,1837,45,35-39,1882,7.257756518500461E-4
STAT,1853,29,50-100,1882,0.004177584123262765
SIM,1925,19,na,1944,45
STAT,1866,42,35-39,1908,0.01665672843547172
STAT,1919,27,35-39,1946,0.16081371544325246
STAT,1898,39,15-19,1937,1.6185962181986175E-4
STAT,1897,46,45-49,1943,0.0017728419233974673
STAT,1872,41,40-44,1913,0.02311805274166612
SIM,1853,49,na,1902,22
SIM,1868,90,na,1958,5
STAT,1840,24,50-100,1864,0.004005466678257199
STAT,1828,45,25-29,1873,2.530942680562516E-4
STAT,1864,35,50-100,1899,0.011116487194197736
SIM,1817,55,na,1872,6
STAT,1856,23,35-39,1879,0.04874496697759849
STAT,1856,32,25-29,1888,0.07510930695430916
STAT,1858,31,45-49,1889,0.013408027220327362
SIM,1837,34,30-34,1871,1
STAT,1871,9,na,1880,26.86484662926372
SIM,1936,28,na,1964,34
STAT,1884,24,15-19,1908,0.03211990930490797
STAT,1898,20,35-39,1918,0.07919036899053924
STAT,1843,19,na,1862,12.297216733801811
SIM,1941,15,15-19,1956,3
STAT,1891,36,50-100,1927,0.01514139749934572
STAT,1932,39,50-100,1971,0.005606380265734134
STAT,1900,28,25-29,1928,0.5845214005773215
SIM,1843,41,na,1884,21
SIM,1953,17,35-39,1970,2
STAT,1924,17,na,1941,43.54663697710915
STAT,1839,67,na,1906,8.748122449973918
STAT,1873,20,30-34,1893,0.18217669134636058
SIM,1877,53,na,1930,24
STAT,1897,21,na,1918,31.5016104487723
STAT,1877,34,25-29,1911,0.10482519410346013
STAT,1841,71,na,1912,13.06522659337659
STAT,1901,29,30-34,1930,0.3498441136097202
STAT,1943,29,35-39,1972,0.158573725537183
SIM,1877,75,na,1952,8
SIM,1847,85,na,1932,3
STAT,1848,24,45-49,1872,0.005412305744275308
STAT,1849,44,15-19,1893,1.0563483533166481E-4
STAT,1794,76,na,1870,4.290183531318096
STAT,1826,44,20-24,1870,0.0016222367524993645
STAT,1924,29,25-29,1953,0.7559421983531898
STAT,1908,46,30-34,1954,8.080664114083324E-4
STAT,1817,53,50-100,1870,4.116010140195384E-4
STAT,1838,38,45-49,1876,0.018476937027709202
STAT,1842,27,15-19,1869,0.004209597849064003
STAT,1862,34,15-19,1896,0.0012181238903593444
STAT,1920,32,50-100,1952,0.008979162855125707
STAT,1867,23,na,1890,22.56264777042774
STAT,1864,39,45-49,1903,0.01770008379996692
STAT,1939,16,na,1955,36.60090826119631
STAT,1858,28,20-24,1886,0.0907290045390796
SIM,1851,39,na,1890,18
STAT,1853,27,30-34,1880,0.18334120779883248
STAT,1834,36,na,1870,19.02346113509766
STAT,1905,44,na,1949,33.02015858073883
STAT,1933,15,15-19,1948,0.6078572543340589
STAT,1941,26,20-24,1967,0.18754617453399544
STAT,1834,27,20-24,1861,0.10871070980997674
STAT,1826,43,50-100,1869,0.010987514539042474
STAT,1876,38,25-29,1914,0.029097401274697093
SIM,1822,79,na,1901,9
STAT,1885,17,25-29,1902,0.0559597825770971
SIM,1872,52,na,1924,20
SIM,1931,17,15-19,1948,2
STAT,1864,25,40-44,1889,0.027155075085025147
STAT,1928,20,15-19,1948,0.06653230847893439
STAT,1805,79,na,1884,2.376929155668877
STAT,1931,27,15-19,1958,0.009073792513391195
SIM,1772,87,na,1859,1
SIM,1921,40,na,1961,41
STAT,1923,17,15-19,1940,0.5292173265010779
STAT,1886,16,50-100,1902,5.094243432367955E-4
STAT,1860,21,35-39,1881,0.04925842496389307
STAT,1809,47,25-29,1856,0.0019650996783730132
STAT,1844,60,na,1904,14.89688611227031
STAT,1854,39,40-44,1893,0.026487534632239466
SIM,1864,57,na,1921,18
STAT,1878,41,15-19,1919,1.4322022341137095E-4
STAT,1941,22,40-44,1963,0.034495309731251665
SIM,1871,88,na,1959,3
STAT,1819,93,na,1912,0.15002258460318207
STAT,1831,40,40-44,1871,0.022859951909094685
STAT,1854,35,25-29,1889,0.017867940611289972
STAT,1922,16,na,1938,42.389785694194416
SIM,1932,29,25-29,1961,1
STAT,1893,35,20-24,1928,0.009811765973813768
SIM,1800,76,na,1876,6
SIM,1951,17,na,1968,45
STAT,1926,17,25-29,1943,0.5282737347161824
STAT,1829,30,15-19,1859,0.0013989394866454597
STAT,1880,0,na,1880,37.91956630754662
STAT,1850,37,15-19,1887,5.078979776979409E-4
STAT,1806,94,na,1900,0.0935186459707912
STAT,1875,28,20-24,1903,0.12016804891830582
STAT,1934,27,25-29,1961,0.8816922154160051
STAT,1815,44,45-49,1859,0.022053817476284557
STAT,1884,38,15-19,1922,5.474465434317716E-4
STAT,1936,21,20-24,1957,1.0569953242941716
STAT,1932,19,15-19,1951,0.5953003613511785
STAT,1854,20,20-24,1874,0.502099787708169
SIM,1942,27,25-29,1969,1
STAT,1859,24,20-24,1883,0.560155215698989
STAT,1863,30,15-19,1893,0.001271009229988805
STAT,1935,28,30-34,1963,0.5314870482425138
SIM,1862,76,na,1938,12
STAT,1882,35,45-49,1917,0.019285893186015115
SIM,1904,15,na,1919,33
STAT,1925,25,25-29,1950,0.7777893703694837
STAT,1831,95,na,1926,0.107892457234694
STAT,1896,21,15-19,1917,0.04346469690671101
STAT,1947,20,25-29,1967,1.0375288708666317
STAT,1866,22,40-44,1888,0.019348195546619033
STAT,1878,27,35-39,1905,0.09961723089957354
STAT,1878,46,35-39,1924,0.0014494882912506485
STAT,1914,58,na,1972,34.276868929587344
SIM,1837,21,na,1858,30
STAT,1897,19,45-49,1916,8.628017531272717E-4
SIM,1886,36,na,1922,28
STAT,1810,49,50-100,1859,0.002333454649615851
SIM,1833,31,na,1864,13
STAT,1880,51,40-44,1931,1.1123349982082057E-4
STAT,1774,90,na,1864,0.12053006865114459
STAT,1901,17,20-24,1918,0.24806984253685171
STAT,1930,26,45-49,1956,0.021874433654705885
STAT,1939,20,35-39,1959,0.09397837525860595
STAT,1918,35,35-39,1953,0.02550334683020471
SIM,1810,54,na,1864,16
STAT,1890,18,45-49,1908,7.913954569721904E-4
SIM,1933,25,25-29,1958,1
STAT,1913,31,na,1944,37.46642088817272
STAT,1845,27,40-44,1872,0.02131344406148426
SIM,1871,37,na,1908,24
SIM,1887,20,25-29,1907,1
STAT,1828,49,40-44,1877,7.150604060861858E-4
STAT,1818,97,na,1915,0.01342538646241183
STAT,1945,17,35-39,1962,0.045508658130039216
STAT,1803,51,50-100,1854,3.0059997706075313E-4
STAT,1877,40,45-49,1917,0.015605122070575352
STAT,1882,25,35-39,1907,0.093097251784861
STAT,1915,36,20-24,1951,0.0026527023888219554
SIM,1883,28,20-24,1911,1
STAT,1862,43,50-100,1905,0.009048850716397976
STAT,1899,32,45-49,1931,0.023871768384000812
STAT,1849,42,35-39,1891,0.01402360586419367
SIM,1937,8,na,1945,41
STAT,1868,38,30-34,1906,0.05132091804067345
SIM,1897,28,na,1925,38
STAT,1928,16,45-49,1944,0.006278966805234657
STAT,1841,21,25-29,1862,0.7149580999092364
STAT,1903,46,50-100,1949,0.0019752450500490804
SIM,1875,6,na,1881,21
STAT,1859,23,45-49,1882,0.005709170338003479
STAT,1906,24,45-49,1930,0.010067377623119576
STAT,1854,24,50-100,1878,0.0028867631110439237
STAT,1843,47,25-29,1890,2.4319639472903683E-4
STAT,1881,38,na,1919,22.306952116785588
STAT,1790,86,na,1876,0.4353398026299478
STAT,1859,36,na,1895,18.815832255635762
STAT,1871,90,na,1961,1.4811006164036713
STAT,1824,49,50-100,1873,0.003095124540111888
STAT,1927,37,35-39,1964,0.029918748969751968
STAT,1855,48,50-100,1903,0.0017074680667552226
STAT,1871,17,40-44,1888,0.0018353212634559732
SIM,1827,27,30-34,1854,1
SIM,1830,34,35-39,1864,1
SIM,1851,82,na,1933,7
STAT,1861,27,25-29,1888,0.3583206334121588
STAT,1925,10,na,1935,47.70852105452166
SIM,1912,44,na,1956,36
STAT,1836,49,35-39,1885,0.0013782052182708773
STAT,1841,34,45-49,1875,0.020283888647761306
SIM,1862,74,na,1936,15
SIM,1944,15,na,1959,32
STAT,1801,63,na,1864,8.562581547598546
STAT,1828,30,20-24,1858,0.03853673904250853
STAT,1933,37,50-100,1970,0.005695421040791503
STAT,1822,34,35-39,1856,0.06857516632565887
STAT,1864,88,na,1952,1.2313279359598153
SIM,1916,5,na,1921,49
STAT,1908,37,25-29,1945,0.00917070998494428
STAT,1847,30,30-34,1877,0.22358324008886377
STAT,1886,18,30-34,1904,0.016489355214053848
STAT,1867,45,20-24,1912,1.1598013027425494E-4
STAT,1917,15,30-34,1932,0.026111656342905118
SIM,1912,8,na,1920,40
STAT,1906,28,50-100,1934,0.00926083896825074
STAT,1851,48,na,1899,18.755192881658736
STAT,1919,28,na,1947,39.98464407682538
SIM,1921,29,na,1950,42
STAT,1876,28,15-19,1904,0.00459179037088962
STAT,1891,38,15-19,1929,6.858022268047822E-4
STAT,1810,48,na,1858,10.408009111367278
STAT,1950,19,25-29,1969,0.5088862297476661
SIM,1901,52,na,1953,31
STAT,1893,18,30-34,1911,0.02004408550369636
STAT,1827,37,30-34,1864,0.0436173843732871
STAT,1851,38,20-24,1889,0.006509490067047806
STAT,1862,22,na,1884,20.888169330002075
STAT,1883,28,15-19,1911,0.004390312773368787
STAT,1907,25,15-19,1932,0.006681565436808596
STAT,1864,48,50-100,1912,0.0021751638033896633
SIM,1834,27,30-34,1861,1
STAT,1812,45,30-34,1857,0.001116546067593958
SIM,1927,43,na,1970,50
STAT,1879,39,45-49,1918,0.020425126924847072
STAT,1897,33,25-29,1930,0.13544322428499533
SIM,1865,50,na,1915,19
STAT,1848,22,30-34,1870,0.1402580434491227
SIM,1843,39,na,1882,22
SIM,1881,66,na,1947,10
STAT,1922,15,50-100,1937,0.0043241828820621
STAT,1908,19,na,1927,37.070419320793704
SIM,1847,19,20-24,1866,2
STAT,1902,21,50-100,1923,0.005767967484708631
SIM,1871,59,na,1930,20
STAT,1853,74,na,1927,6.974812702695464
STAT,1928,16,50-100,1944,0.004709225103925992
STAT,1939,22,50-100,1961,0.006562791917278911
STAT,1921,7,na,1928,45.208856628477804
STAT,1878,24,25-29,1902,0.5873138939025239
STAT,1933,21,50-100,1954,0.008718672653244528
STAT,1853,49,35-39,1902,8.615026094110497E-4
STAT,1835,34,20-24,1869,0.01531293163520469
STAT,1881,2,na,1883,30.348877140736125
STAT,1846,34,30-34,1880,0.16377905270393772
SIM,1826,69,na,1895,8
STAT,1860,27,30-34,1887,0.20691550354982724
SIM,1927,11,na,1938,52
STAT,1865,29,15-19,1894,0.004074352261952931
STAT,1916,31,45-49,1947,0.016172975987915585
STAT,1808,84,na,1892,0.48576435285742714
STAT,1895,21,20-24,1916,0.8973611142252019
STAT,1917,36,30-34,1953,0.01884868271437608
STAT,1850,24,45-49,1874,0.007345388628793967
STAT,1912,27,40-44,1939,0.04557335411668736
SIM,1906,41,na,1947,25
SIM,1850,51,na,1901,20
STAT,1804,94,na,1898,0.07759229325414878
STAT,1831,61,na,1892,15.163860107321849
STAT,1835,30,50-100,1865,0.005426046882841126
STAT,1789,75,na,1864,2.58335358857143
STAT,1957,10,na,1967,51.512430317624556
SIM,1875,49,na,1924,15
STAT,1847,57,na,1904,21.467622001418526
STAT,1919,24,30-34,1943,0.3100392099597401
STAT,1944,25,35-39,1969,0.1612307385076033
STAT,1950,16,20-24,1966,1.5935793901560047
SIM,1899,51,na,1950,28
STAT,1931,20,30-34,1951,0.37333085707344144
STAT,1886,66,na,1952,17.000900089746082
STAT,1912,38,na,1950,36.251702007751824
STAT,1824,34,45-49,1858,0.026733729090191116
STAT,1858,34,15-19,1892,0.0010743659020788386
STAT,1883,19,na,1902,24.39416671089357
STAT,1873,15,40-44,1888,0.0018816626066555555
SIM,1897,41,na,1938,40
STAT,1930,1,na,1931,53.737690305796065
STAT,1908,3,na,1911,39.01213788628212
STAT,1857,64,na,1921,13.013490781342949
STAT,1950,16,50-100,1966,0.004403774142629837
STAT,1875,41,50-100,1916,0.010908852060217404
STAT,1895,27,50-100,1922,0.008304839900829343
STAT,1903,63,na,1966,27.825163059458152
STAT,1872,24,30-34,1896,0.18110905715850237
STAT,1951,15,25-29,1966,0.5131842286964721
STAT,1857,86,na,1943,1.6609829426580498
SIM,1925,33,na,1958,43
STAT,1946,26,40-44,1972,0.05157803751083122
STAT,1883,22,40-44,1905,0.020235481363534376
STAT,1939,19,25-29,1958,0.43050932371112427
STAT,1900,21,40-44,1921,0.028983040780361864
STAT,1942,21,45-49,1963,0.01171528096972124
STAT,1837,35,25-29,1872,0.0174488580852907
STAT,1840,21,na,1861,21.46042013881989
STAT,1853,96,na,1949,0.05396552949726926
SIM,1825,32,50-100,1857,1
STAT,1795,60,na,1855,11.76468
STAT,1853,24,20-24,1877,0.5044063019825005
STAT,1857,35,45-49,1892,0.015065131038791271
STAT,1834,39,na,1873,18.43999302273966
STAT,1855,52,na,1907,15.079100411114412
STAT,1875,33,50-100,1908,0.009378728430625805
SIM,1873,37,na,1910,27
STAT,1899,35,15-19,1934,7.760192935859603E-4
STAT,1783,84,na,1867,0.5483837360460513
STAT,1847,25,40-44,1872,0.03902035333886769
STAT,1849,48,30-34,1897,7.411477302874432E-4
STAT,1906,29,na,1935,34.423981609451296
STAT,1873,23,35-39,1896,0.059145569055718855
STAT,1837,23,25-29,1860,0.3765952213415021
STAT,1839,19,20-24,1858,0.12648048492614816
STAT,1836,33,25-29,1869,0.12365681410205626
STAT,1821,33,15-19,1854,0.0038280115395685935
STAT,1912,20,20-24,1932,1.0636159635661884
STAT,1930,34,50-100,1964,0.010606473984703754
STAT,1913,26,45-49,1939,0.01712867773697136
SIM,1860,19,na,1879,28
STAT,1924,26,20-24,1950,0.21187920668571658
STAT,1854,46,25-29,1900,3.53070964961419E-4
STAT,1887,36,35-39,1923,0.07757306019629615
STAT,1864,37,na,1901,21.13129834591096
STAT,1841,24,35-39,1865,0.07132249591466264
STAT,1842,34,na,1876,19.239285609035576
STAT,1868,17,25-29,1885,0.055832413483537
STAT,1789,78,na,1867,1.9439819860178025
STAT,1804,62,na,1866,10.65933343312718
STAT,1864,36,40-44,1900,0.039451798541264
STAT,1832,27,na,1859,12.933692697097754
STAT,1871,43,20-24,1914,0.0015719286077884496
STAT,1944,17,40-44,1961,0.014943163443414084
STAT,1827,34,20-24,1861,0.022664879041332783
STAT,1856,37,na,1893,17.06748429075318
STAT,1877,24,15-19,1901,0.03384135297180012
STAT,1778,80,na,1858,2.737817545139075
STAT,1922,48,na,1970,41.77933813577903
STAT,1926,45,50-100,1971,0.0027878955383109074
SIM,1828,42,na,1870,16
STAT,1900,44,30-34,1944,0.0010921187534004256
STAT,1836,44,15-19,1880,1.5453833163272108E-4
STAT,1911,27,30-34,1938,0.3796515573566072
SIM,1830,24,25-29,1854,1
SIM,1903,20,20-24,1923,1
SIM,1908,24,20-24,1932,2
STAT,1865,35,45-49,1900,0.018202075954500286
STAT,1915,32,40-44,1947,0.039511532946711045
STAT,1894,25,20-24,1919,0.1513693473698451
STAT,1905,2,na,1907,38.47190661181861
STAT,1843,23,15-19,1866,0.017439524089390132
STAT,1888,47,na,1935,26.169022259262054
STAT,1872,49,45-49,1921,0.0023642649704706782
STAT,1920,44,50-100,1964,0.0012821685103450587
STAT,1863,54,45-49,1917,1.2495910657079473E-4
STAT,1897,24,35-39,1921,0.07700745553014705
SIM,1824,35,na,1859,18
STAT,1812,48,35-39,1860,0.0015515950141031943
STAT,1928,39,na,1967,47.213186019725846
STAT,1836,46,30-34,1882,9.902694705961656E-4
STAT,1921,30,15-19,1951,0.001430309392004005
STAT,1871,93,na,1964,0.8065337497416702
STAT,1876,20,40-44,1896,0.021290393091964364
STAT,1932,32,40-44,1964,0.05181148832693228
STAT,1902,25,30-34,1927,0.3575209830823545
SIM,1925,30,na,1955,45
STAT,1882,85,na,1967,5.230190283099916
STAT,1847,46,40-44,1893,0.0018340141157107725
STAT,1947,25,45-49,1972,0.019428379308384376
STAT,1893,2,na,1895,33.61070263827517
STAT,1900,13,na,1913,35.755681532506955
STAT,1879,11,na,1890,26.769113658587976
STAT,1897,36,35-39,1933,0.09437730967158406
STAT,1843,64,na,1907,7.374004767789918
SIM,1911,19,na,1930,42
STAT,1872,25,35-39,1897,0.09939474339404465
STAT,1880,54,45-49,1934,1.4840918178546427E-4
STAT,1897,16,40-44,1913,0.002434836382802412
STAT,1853,71,na,1924,8.388971106321161
STAT,1842,24,45-49,1866,0.006504492821489131
STAT,1819,90,na,1909,0.40471193534802746
SIM,1903,3,na,1906,39
STAT,1916,19,30-34,1935,0.025501797193742425
STAT,1909,34,15-19,1943,0.0012089618760852815
STAT,1887,35,30-34,1922,0.058725227674755166
STAT,1882,44,35-39,1926,0.017119577227606052
SIM,1802,59,na,1861,11
STAT,1846,35,35-39,1881,0.061115287466488206
STAT,1815,57,na,1872,9.09487759984487
STAT,1798,57,na,1855,18.62741
STAT,1863,35,35-39,1898,0.06321822057864432
STAT,1837,39,50-100,1876,0.007131092331205418
SIM,1915,3,na,1918,40
STAT,1867,77,na,1944,8.271891948770556
SIM,1854,79,na,1933,1
SIM,1899,22,na,1921,23
STAT,1811,49,30-34,1860,0.0037153688924751144
STAT,1906,29,15-19,1935,0.006544351895648023
STAT,1811,52,30-34,1863,2.2590775469984007E-4
STAT,1912,47,35-39,1959,0.0012293808858443139
STAT,1917,18,35-39,1935,0.008924243385130117
SIM,1919,48,na,1967,43
STAT,1939,16,20-24,1955,1.3481417759647956
STAT,1877,84,na,1961,5.133774219862592
STAT,1862,36,30-34,1898,0.04620302456954727
SIM,1864,86,na,1950,1
STAT,1897,30,20-24,1927,0.036183946910028984
STAT,1924,26,na,1950,43.48277416745069
STAT,1898,15,45-49,1913,8.852953457208757E-4
STAT,1905,30,30-34,1935,0.25401136007071895
STAT,1910,18,40-44,1928,0.0027473626302986828
STAT,1920,33,na,1953,40.900611866414856
STAT,1828,75,na,1903,6.913959555561431
STAT,1927,34,25-29,1961,0.11296889865142812
STAT,1856,35,35-39,1891,0.05172522103372515
SIM,1947,16,20-24,1963,1
STAT,1896,76,na,1972,17.237976341990382
STAT,1858,49,na,1907,16.76259035474917
STAT,1831,48,45-49,1879,0.002230667447269951
STAT,1888,25,na,1913,28.078070832802403
SIM,1825,84,na,1909,2
STAT,1841,28,50-100,1869,0.007721127142106388
STAT,1868,35,20-24,1903,0.0075307010366158144
STAT,1832,29,20-24,1861,0.06917954260634883
STAT,1854,27,na,1881,15.292210124557453
SIM,1875,27,na,1902,18
STAT,1926,34,15-19,1960,0.001542970095394908
STAT,1862,23,25-29,1885,0.5019645252511808
STAT,1916,30,na,1946,39.024375191136606
STAT,1886,69,na,1955,15.22233316176631
STAT,1838,82,na,1920,3.621363858659961
STAT,1936,24,30-34,1960,0.2729329551526348
SIM,1899,54,na,1953,28
STAT,1888,26,40-44,1914,0.03512623252068186
STAT,1873,46,50-100,1919,0.0025040865150577213
SIM,1824,57,na,1881,16
STAT,1861,24,20-24,1885,0.5868481911074231
STAT,1806,72,na,1878,7.74547765388511
STAT,1878,36,25-29,1914,0.029868406707592082
SIM,1886,24,25-29,1910,1
SIM,1922,20,30-34,1942,1
SIM,1937,5,na,1942,41
STAT,1864,34,na,1898,21.220122770439996
STAT,1926,22,15-19,1948,0.06430068972130921
STAT,1906,42,40-44,1948,0.0022664221546180403
STAT,1919,18,50-100,1937,0.004093601374390442
SIM,1882,11,na,1893,33
STAT,1906,49,50-100,1955,0.001970690445589672
SIM,1952,10,na,1962,35
STAT,1847,33,35-39,1880,0.12570625645442846
STAT,1898,36,45-49,1934,0.02702158630234152
STAT,1820,87,na,1907,0.9988126144736366
STAT,1928,37,50-100,1965,0.005280147792554533
STAT,1877,47,30-34,1924,9.945702487429366E-4
STAT,1908,43,50-100,1951,0.0010747830500321479
SIM,1853,2,na,1855,31
STAT,1891,15,35-39,1906,0.006765947576537649
STAT,1931,23,35-39,1954,0.12120576910515424
SIM,1823,72,na,1895,6
STAT,1811,73,na,1884,6.996609230804304
STAT,1927,17,40-44,1944,0.017302537419218254
STAT,1866,19,50-100,1885,4.5768691790493653E-4
SIM,1896,11,na,1907,33
SIM,1826,61,na,1887,13
STAT,1865,22,30-34,1887,0.16306827284642114
SIM,1945,20,25-29,1965,2
STAT,1841,43,35-39,1884,0.018183527425099644
STAT,1916,30,50-100,1946,0.008531107237497915
STAT,1925,29,40-44,1954,0.05431678553644611
SIM,1934,1,na,1935,57
STAT,1887,33,30-34,1920,0.1897699437005671
SIM,1813,65,na,1878,4
STAT,1814,45,40-44,1859,0.005055755802077421
SIM,1837,24,na,1861,26
STAT,1848,41,na,1889,15.12086872551286
STAT,1888,47,40-44,1935,0.0019913127442711584
STAT,1848,45,45-49,1893,0.0015414271083299003
STAT,1947,24,40-44,1971,0.037715579132143996
STAT,1873,18,45-49,1891,6.623890702801235E-4
STAT,1931,15,40-44,1946,0.018311389618228018
STAT,1933,36,15-19,1969,2.607347295896671E-4
STAT,1775,94,na,1869,0.06158969751443716
STAT,1833,76,na,1909,7.014038848593118
STAT,1874,38,15-19,1912,5.668575757432941E-4
STAT,1836,37,40-44,1873,0.05185537640293479
STAT,1848,29,15-19,1877,0.0034526338718563867
STAT,1898,33,40-44,1931,0.05825546319808728
STAT,1836,23,15-19,1859,0.04171708452106922
STAT,1892,44,na,1936,28.265096614833134
SIM,1904,49,na,1953,26
STAT,1828,33,25-29,1861,0.075029420869663
STAT,1859,107,na,1966,3.022926564630334E-4
STAT,1866,78,na,1944,7.19593008149287
SIM,1875,41,na,1916,18
STAT,1843,27,30-34,1870,0.13146108697488015
STAT,1881,36,40-44,1917,0.0418543229089893
STAT,1858,15,15-19,1873,0.05337824571198038
STAT,1845,23,25-29,1868,0.412437045515113
STAT,1826,37,15-19,1863,6.496138575628189E-4
STAT,1863,34,30-34,1897,0.15326440092716165
STAT,1902,16,25-29,1918,0.08010771188976357
STAT,1895,24,25-29,1919,0.7385416232357643
STAT,1951,19,40-44,1970,0.01654400429160892
SIM,1913,21,25-29,1934,1
STAT,1893,28,15-19,1921,0.005700495975465233
SIM,1959,1,na,1960,54
STAT,1873,32,25-29,1905,0.10413580254269318
STAT,1846,16,35-39,1862,0.005619293530524062
STAT,1923,29,15-19,1952,0.007991448134551767
STAT,1840,53,na,1893,16.60113465625601
STAT,1872,20,15-19,1892,0.03395603023821935
STAT,1918,40,na,1958,39.23837829863916
STAT,1934,15,25-29,1949,0.5863802900904813
STAT,1908,33,na,1941,35.36439440466793
SIM,1862,23,na,1885,19
STAT,1903,37,40-44,1940,0.013433182298289253
SIM,1936,25,na,1961,35
SIM,1815,43,na,1858,13
SIM,1862,23,25-29,1885,3
STAT,1829,38,na,1867,18.423547110831205
STAT,1876,23,45-49,1899,0.007060432564967844
STAT,1883,25,45-49,1908,0.010855096083434632
STAT,1877,38,40-44,1915,0.044963128013449254
STAT,1832,31,25-29,1863,0.06048310847685299
STAT,1905,25,40-44,1930,0.04352652535806876
STAT,1830,46,na,1876,8.791421638820674
STAT,1862,17,30-34,1879,0.015749420982711586
STAT,1933,19,30-34,1952,0.16162855004181167
SIM,1926,18,na,1944,44
STAT,1852,27,15-19,1879,0.004522695908724289
STAT,1953,15,35-39,1968,0.05049369754878703
SIM,1885,70,na,1955,14
STAT,1832,35,40-44,1867,0.025363538425777658
STAT,1922,28,45-49,1950,0.01933749365417099
SIM,1870,71,na,1941,13
STAT,1824,91,na,1915,0.4032079201690394
STAT,1842,21,40-44,1863,0.019862168485225446
STAT,1874,19,15-19,1893,0.05988263792306151
STAT,1854,23,25-29,1877,0.40817445578968536
SIM,1847,31,na,1878,19
STAT,1862,56,na,1918,17.597240885077344
STAT,1930,11,na,1941,51.062447175372526
STAT,1883,49,20-24,1932,1.1409672715166108E-4
STAT,1875,74,na,1949,11.407984714183968
STAT,1933,28,20-24,1961,0.2412716067220175
SIM,1860,64,na,1924,16
STAT,1921,16,35-39,1937,0.047574016238699814
STAT,1899,39,30-34,1938,0.015588935048591225
SIM,1804,69,na,1873,8
STAT,1845,45,na,1890,13.282532040317763
STAT,1847,28,45-49,1875,0.014153561043954085
STAT,1831,23,30-34,1854,0.5823180596891275
STAT,1855,49,45-49,1904,0.0016269117282803288
STAT,1863,25,25-29,1888,0.3799725882762461
SIM,1840,76,na,1916,3
STAT,1846,30,15-19,1876,0.0013924926608493658
STAT,1833,37,15-19,1870,5.197800166130494E-4
STAT,1832,24,na,1856,12.851344228200343
STAT,1837,20,20-24,1857,0.5819691293152923
SIM,1854,22,20-24,1876,1
SIM,1851,68,na,1919,15
SIM,1894,24,25-29,1918,2
SIM,1854,4,na,1858,21
STAT,1886,24,25-29,1910,0.5900722195840058
STAT,1908,25,25-29,1933,0.6284758256164107
STAT,1839,45,45-49,1884,0.0013613979403785154
STAT,1887,62,na,1949,19.94982684037429
STAT,1928,24,30-34,1952,0.3548590213480245
STAT,1867,38,15-19,1905,5.347116203628498E-4
STAT,1815,54,na,1869,9.65083389843512
STAT,1850,39,50-100,1889,0.010876261366474838
STAT,1846,22,20-24,1868,0.6890948475529514
STAT,1871,46,25-29,1917,5.759026658483151E-4
STAT,1824,37,50-100,1861,0.01787620870135623
STAT,1872,22,30-34,1894,0.18224997366871393
STAT,1900,27,50-100,1927,0.008870499133231855
SIM,1938,20,25-29,1958,1
STAT,1884,28,30-34,1912,0.24585169860394926
STAT,1893,38,25-29,1931,0.03612308173179338
STAT,1940,17,15-19,1957,0.45752333363488357
STAT,1937,28,50-100,1965,0.009636727995487242
STAT,1865,30,50-100,1895,0.008353939750479473
STAT,1899,65,na,1964,25.281055418716264
STAT,1917,34,50-100,1951,0.008505686720321945
SIM,1871,25,25-29,1896,3
STAT,1876,35,20-24,1911,0.007903447825222534
STAT,1873,36,40-44,1909,0.0447199567304908
STAT,1831,24,35-39,1855,0.08051938079653488
STAT,1820,42,50-100,1862,0.009336129598247617
STAT,1888,43,25-29,1931,0.0074500255464182204
STAT,1907,38,20-24,1945,0.002421668733700976
STAT,1917,27,25-29,1944,0.6839944570488867
STAT,1781,100,na,1881,0.0032124598504330443
STAT,1858,19,30-34,1877,0.014001254879461408
STAT,1846,32,30-34,1878,0.16721588955858072
SIM,1912,12,na,1924,40
STAT,1897,21,30-34,1918,0.23725330757634258
SIM,1873,60,na,1933,16
STAT,1836,27,30-34,1863,0.31446805821376567
STAT,1896,47,40-44,1943,0.0012625818089829234
STAT,1943,26,30-34,1969,0.41444429817706957
SIM,1861,27,na,1888,27
STAT,1879,33,na,1912,24.59433008873514
STAT,1927,31,20-24,1958,0.029868703200311427
STAT,1891,25,45-49,1916,0.013719911716458987
STAT,1942,1,na,1943,43.01006488170377
STAT,1821,35,30-34,1856,0.12992649726002406
STAT,1823,98,na,1921,0.01868197358907052
SIM,1846,38,na,1884,14
STAT,1929,38,15-19,1967,2.451124957047102E-4
STAT,1870,24,20-24,1894,0.6802833264697176
STAT,1857,32,40-44,1889,0.03266543988993438
SIM,1866,67,na,1933,26
STAT,1826,39,30-34,1865,0.05853794477713653
STAT,1866,54,50-100,1920,1.3526855638318214E-4
STAT,1916,15,15-19,1931,0.09590788520197831
STAT,1839,32,30-34,1871,0.11857290371791282
SIM,1888,6,na,1894,39
STAT,1809,83,na,1892,2.196576206076076
STAT,1888,29,45-49,1917,0.01288224582679628
SIM,1949,21,na,1970,38
SIM,1851,50,na,1901,15
SIM,1968,3,na,1971,54
SIM,1901,20,na,1921,37
SIM,1795,83,na,1878,3
STAT,1817,37,30-34,1854,0.21298852962291442
STAT,1778,83,na,1861,1.4512195605946667
STAT,1828,72,na,1900,8.481715347890825
STAT,1872,100,na,1972,0.09545346372138995
SIM,1916,25,25-29,1941,1
SIM,1940,22,na,1962,34
SIM,1897,73,na,1970,36
STAT,1928,37,45-49,1965,0.008573379328017754
SIM,1939,14,na,1953,30
STAT,1937,20,25-29,1957,0.894437553786831
SIM,1796,68,na,1864,7
STAT,1849,21,35-39,1870,0.055101584483038625
STAT,1926,38,30-34,1964,0.02212453529247597
STAT,1840,24,na,1864,21.001473754025564
SIM,1858,71,na,1929,15
STAT,1887,17,35-39,1904,0.00598920276441917
STAT,1851,16,na,1867,23.700711368636068
STAT,1957,13,na,1970,51.48976813977147
STAT,1887,23,20-24,1910,0.749860952089673
STAT,1788,90,na,1878,0.3621810794268436
STAT,1862,27,40-44,1889,0.025939941381072765
STAT,1840,35,40-44,1875,0.04142190878153266
STAT,1927,25,35-39,1952,0.1828216237046781
STAT,1856,3,na,1859,24.20160432769475
STAT,1949,23,20-24,1972,1.288784017121062
STAT,1852,37,25-29,1889,0.024775263881913496
STAT,1866,15,na,1881,24.158627548947027
STAT,1868,22,15-19,1890,0.03192615007965391
STAT,1893,43,50-100,1936,9.183251529625944E-4
STAT,1886,30,45-49,1916,0.018233474706919564
STAT,1858,54,45-49,1912,1.0739465153693544E-4
STAT,1905,33,35-39,1938,0.08356977223392154
STAT,1918,48,40-44,1966,0.0016579700405705917
STAT,1834,61,na,1895,13.205562843635477
STAT,1923,39,25-29,1962,0.011305377936579722
STAT,1891,34,35-39,1925,0.1232317697125359
STAT,1845,20,20-24,1865,0.5073432451706985
STAT,1812,58,na,1870,10.012162612874835
STAT,1854,42,35-39,1896,0.011054701062329883
STAT,1902,47,40-44,1949,0.0013554832255191008
STAT,1875,18,15-19,1893,0.060843920009589686
STAT,1896,43,25-29,1939,5.815099268951618E-4
STAT,1894,46,25-29,1940,4.175867898970973E-4
STAT,1898,9,na,1907,35.00162289090287
STAT,1854,26,30-34,1880,0.17859988449494543
STAT,1857,38,20-24,1895,0.005742014361095006
STAT,1833,52,45-49,1885,1.1073211654027442E-4
SIM,1814,81,na,1895,12
SIM,1933,2,na,1935,55
STAT,1852,29,30-34,1881,0.22516303368542392
STAT,1801,94,na,1895,0.07242947066595928
STAT,1938,16,40-44,1954,0.013740222318660608
STAT,1822,33,30-34,1855,0.13286717364429934
STAT,1873,54,40-44,1927,1.0409047586474716E-4
STAT,1837,29,35-39,1866,0.05970923462457924
STAT,1901,29,na,1930,33.15520734915419
STAT,1858,19,25-29,1877,0.04977905159808288
STAT,1824,43,35-39,1867,0.024134455791425057
STAT,1838,51,na,1889,16.955266314607293
SIM,1903,52,na,1955,35
STAT,1894,44,30-34,1938,0.0010093522143777948
STAT,1819,49,40-44,1868,0.001500678061346762
SIM,1825,45,na,1870,17
STAT,1877,47,35-39,1924,0.001438428046354455
SIM,1829,35,na,1864,20
SIM,1897,19,na,1916,41
STAT,1875,16,20-24,1891,0.18268663215061656
STAT,1868,38,25-29,1906,0.027725093501963855
STAT,1852,86,na,1938,1.8989233493135185
STAT,1888,35,45-49,1923,0.023517089899742005
STAT,1859,33,na,1892,18.886763330190714
STAT,1877,6,na,1883,27.942624332003348
SIM,1886,67,na,1953,17
STAT,1863,35,40-44,1898,0.039126397709542265
STAT,1879,42,40-44,1921,0.023251568087482223
SIM,1862,26,30-34,1888,1
SIM,1878,33,30-34,1911,1
STAT,1865,45,50-100,1910,0.0022435675230552945
SIM,1884,32,na,1916,26
STAT,1863,17,40-44,1880,0.0018479097575293977
SIM,1834,81,na,1915,3
SIM,1914,16,na,1930,37
STAT,1885,37,15-19,1922,5.5453461317824E-4
SIM,1876,37,na,1913,29
STAT,1811,45,20-24,1856,4.903223566025379E-4
SIM,1851,23,20-24,1874,1
STAT,1893,17,25-29,1910,0.07145049599083675
SIM,1864,39,45-49,1903,2
STAT,1843,23,20-24,1866,0.36428988909771515
SIM,1896,65,na,1961,21
STAT,1813,99,na,1912,0.012498680271671815
SIM,1869,63,na,1932,13
STAT,1944,26,na,1970,40.213045308777424
SIM,1870,32,na,1902,24
STAT,1882,29,15-19,1911,0.004316953886064617
STAT,1834,20,45-49,1854,0.006686249228557724
STAT,1845,39,40-44,1884,0.02633316094412063
STAT,1876,51,50-100,1927,1.5412434853858415E-4
SIM,1850,20,na,1870,22
STAT,1918,22,20-24,1940,1.1884098869290776
STAT,1917,24,na,1941,38.21829898296238
STAT,1879,25,na,1904,24.868332199741413
STAT,1906,52,na,1958,31.656477672482737
STAT,1906,60,na,1966,29.9834843812205
STAT,1864,16,45-49,1880,6.699822345052213E-4
STAT,1828,41,na,1869,18.054485143054805
STAT,1847,49,45-49,1896,0.002468401954125248
STAT,1914,46,20-24,1960,1.08962276139697E-4
SIM,1859,65,na,1924,14
STAT,1865,44,35-39,1909,0.016157501340502062
STAT,1882,47,45-49,1929,0.0022511472001156734
STAT,1883,30,na,1913,23.35929234659653
STAT,1896,23,30-34,1919,0.23324778121412157
STAT,1831,25,50-100,1856,0.007296937872686613
STAT,1849,26,20-24,1875,0.10860988014212834
STAT,1875,43,na,1918,23.586584091881196
STAT,1865,32,40-44,1897,0.039225051820349306
STAT,1878,45,30-34,1923,0.0010093435837691062
STAT,1880,16,30-34,1896,0.016801547260787555
STAT,1780,87,na,1867,1.0300861222655315
STAT,1846,38,45-49,1884,0.016696889901373687
STAT,1868,26,50-100,1894,0.006211837528548368
STAT,1829,32,30-34,1861,0.16686493061721214
STAT,1843,38,20-24,1881,0.0034378671259090643
SIM,1856,37,na,1893,12
STAT,1861,21,15-19,1882,0.028707920183388788
STAT,1879,26,35-39,1905,0.10021009275216357
STAT,1902,70,na,1972,23.92684618251021
SIM,1804,51,na,1855,13
STAT,1907,22,45-49,1929,0.010200082159508359
STAT,1821,35,35-39,1856,0.1724264002264749
STAT,1808,103,na,1911,2.0956475726126674E-4
STAT,1882,37,50-100,1919,0.011765996411104651
STAT,1841,28,15-19,1869,0.005476218034014936
STAT,1858,37,25-29,1895,0.021909097910172103
STAT,1895,43,35-39,1938,0.0016207192191946356
STAT,1894,28,25-29,1922,0.5402232753415697
STAT,1879,44,35-39,1923,0.018489120486933956
STAT,1881,15,35-39,1896,0.005245464322174594
STAT,1906,23,40-44,1929,0.030180358259468774
SIM,1818,71,na,1889,9
SIM,1853,20,20-24,1873,1
STAT,1821,94,na,1915,0.12413124963304506
STAT,1837,27,40-44,1864,0.01887957424657054
SIM,1892,24,20-24,1916,4
STAT,1855,42,25-29,1897,0.004515667472473786
STAT,1817,89,na,1906,0.8325893140795029
STAT,1820,36,30-34,1856,0.05108342291384971
SIM,1922,11,na,1933,52
STAT,1887,20,na,1907,25.96871371036935
STAT,1880,31,25-29,1911,0.10814657936504453
STAT,1896,41,30-34,1937,0.00105341063927098
STAT,1903,46,45-49,1949,0.0018980367775943406
SIM,1910,34,na,1944,32
SIM,1865,73,na,1938,6
STAT,1884,24,20-24,1908,0.6709448112538935
STAT,1912,49,20-24,1961,1.0475785931572753E-4
STAT,1920,43,40-44,1963,0.00273463131524048
STAT,1877,30,na,1907,24.830962917030604
SIM,1890,40,na,1930,24
STAT,1923,32,na,1955,43.05721956867349
STAT,1863,19,35-39,1882,0.0049855406669025585
STAT,1870,12,na,1882,26.30818514302829
STAT,1943,24,50-100,1967,0.006944884383179403
STAT,1912,60,na,1972,32.621010063774456
SIM,1821,63,na,1884,7
STAT,1919,21,25-29,1940,1.0057168673840315
STAT,1928,27,35-39,1955,0.1840612278974086
STAT,1885,73,na,1958,12.662565108248863
STAT,1876,50,45-49,1926,1.4951284062256014E-4
STAT,1838,43,na,1881,18.847652346250005
STAT,1840,17,45-49,1857,6.627211646263145E-4
STAT,1861,36,15-19,1897,4.7450777965844364E-4
STAT,1960,0,na,1960,51.28991826842475
STAT,1835,31,15-19,1866,8.340052609743223E-4
STAT,1864,33,35-39,1897,0.09044866149607028
STAT,1897,40,35-39,1937,0.0016867085583574897
STAT,1839,42,40-44,1881,0.013082512621578783
STAT,1859,50,45-49,1909,1.1700470424744635E-4
STAT,1890,21,40-44,1911,0.02538850572294035
STAT,1874,9,na,1883,27.067078310967865
STAT,1878,71,na,1949,13.780715835990435
STAT,1814,41,25-29,1855,0.0212943755751117
STAT,1853,45,25-29,1898,3.6561421247076456E-4
STAT,1844,37,25-29,1881,0.023764972218021617
STAT,1855,25,35-39,1880,0.07894397144228706
SIM,1838,63,na,1901,4
STAT,1858,41,50-100,1899,0.008075389129965924
STAT,1864,34,45-49,1898,0.015506830506748228
STAT,1887,39,45-49,1926,0.021540066400931833
SIM,1941,3,na,1944,49
STAT,1890,20,30-34,1910,0.21765728386303815
STAT,1927,14,na,1941,48.85584886670009
STAT,1947,21,30-34,1968,0.32271652631800707
STAT,1844,36,15-19,1880,5.146584945889184E-4
STAT,1869,35,na,1904,23.044838827747
STAT,1873,48,na,1921,22.586553004169424
STAT,1903,43,40-44,1946,0.0022046249949181952
SIM,1931,28,na,1959,56
STAT,1878,27,30-34,1905,0.25998235306306167
SIM,1845,65,na,1910,19
STAT,1849,31,45-49,1880,0.015820824295589002
STAT,1886,21,20-24,1907,0.7169641463392604
STAT,1821,40,50-100,1861,0.017651871060619998
STAT,1895,27,30-34,1922,0.32692533079374864
STAT,1849,44,20-24,1893,0.0012148005407017128
SIM,1797,64,na,1861,1
STAT,1899,17,20-24,1916,0.24269182796359867
STAT,1948,23,45-49,1971,0.012829571182783122
STAT,1830,28,40-44,1858,0.024535979441951263
STAT,1849,35,na,1884,19.085303884524844
STAT,1909,29,na,1938,35.34637294710139
STAT,1845,104,na,1949,3.898943128815241E-4
STAT,1916,50,na,1966,37.02252431551488
STAT,1858,71,na,1929,10.15709433747199
STAT,1862,25,na,1887,20.96597363410559
STAT,1784,77,na,1861,4.635487386501462
STAT,1851,5,na,1856,25.81010324
STAT,1853,27,25-29,1880,0.3079828636008953
STAT,1829,35,35-39,1864,0.06637402109504162
STAT,1850,33,35-39,1883,0.093350226174205
STAT,1939,15,45-49,1954,0.004978212506593427
STAT,1844,21,15-19,1865,0.03240634610791246
STAT,1825,34,50-100,1859,0.010082083375751177
STAT,1889,35,na,1924,29.11891957289534
STAT,1838,41,40-44,1879,0.02067957784099927
STAT,1855,43,35-39,1898,0.01265729449742968
STAT,1838,43,35-39,1881,0.014766788443092491
STAT,1836,40,50-100,1876,0.012443824035608165
STAT,1873,24,45-49,1897,0.007045234749715698
STAT,1870,27,25-29,1897,0.4202174851748097
STAT,1954,17,35-39,1971,0.05157816729051848
STAT,1861,39,25-29,1900,0.02396907688137138
STAT,1913,34,na,1947,36.994465560342476
STAT,1938,34,40-44,1972,0.03903886014047674
STAT,1924,21,35-39,1945,0.11071714730849704
SIM,1867,6,na,1873,20
STAT,1853,6,na,1859,18.860939038606986
STAT,1871,29,40-44,1900,0.029652326429718875
STAT,1789,103,na,1892,2.2585921022845592E-4
STAT,1840,31,25-29,1871,0.09877666751755416
STAT,1880,10,na,1890,27.238653256684376
STAT,1908,15,15-19,1923,0.08798287468963414
SIM,1945,17,35-39,1962,1
STAT,1828,36,30-34,1864,0.02396115048494102
STAT,1881,30,30-34,1911,0.16747222614304055
STAT,1937,17,35-39,1954,0.04056394772170623
STAT,1939,33,45-49,1972,0.01593540451329776
STAT,1820,38,25-29,1858,0.026675516334922638
STAT,1834,103,na,1937,0.0010142141425491297
STAT,1885,40,45-49,1925,0.014928674318454504
SIM,1896,57,na,1953,23
STAT,1831,27,45-49,1858,0.01214022960582766
STAT,1913,29,15-19,1942,0.006925490305641058
STAT,1934,9,na,1943,53.617173964694096
STAT,1899,19,15-19,1918,0.08080438736685992
STAT,1895,42,25-29,1937,5.782143302122363E-4
STAT,1837,44,30-34,1881,0.005857676233492135
STAT,1871,40,15-19,1911,1.3907333215936447E-4
STAT,1942,11,na,1953,40.868879059256194
STAT,1891,20,50-100,1911,0.005034934957660298
SIM,1845,26,30-34,1871,1
SIM,1891,34,na,1925,34
STAT,1853,43,30-34,1896,0.007173253839182331
SIM,1879,85,na,1964,2
STAT,1847,35,50-100,1882,0.013893156216927386
STAT,1850,21,40-44,1871,0.022429934283663928
SIM,1887,29,na,1916,24
STAT,1818,43,na,1861,7.295679374670207
STAT,1874,50,40-44,1924,1.0833689070661196E-4
STAT,1854,44,30-34,1898,0.006932321196155079
SIM,1880,42,na,1922,32
STAT,1822,56,na,1878,7.9069896983419685
STAT,1838,25,35-39,1863,0.09664624199507806
STAT,1885,22,15-19,1907,0.03257835081941709
STAT,1896,24,50-100,1920,0.005322941357275355
STAT,1875,51,40-44,1926,1.0873593109426482E-4
SIM,1909,22,20-24,1931,2
STAT,1880,17,40-44,1897,0.001923322769951318
STAT,1885,7,na,1892,25.72827810787058
STAT,1889,55,na,1944,25.315672673872136
STAT,1842,31,50-100,1873,0.00839112277137992
SIM,1900,36,na,1936,36
STAT,1859,18,30-34,1877,0.014618678267909963
STAT,1899,35,20-24,1934,0.010652627144411468
SIM,1876,57,na,1933,27
SIM,1850,40,na,1890,21
SIM,1892,75,na,1967,12
STAT,1881,35,na,1916,22.63105397174888
STAT,1909,49,na,1958,33.372030118010755
STAT,1849,28,15-19,1877,0.004140281190892459
STAT,1938,19,45-49,1957,0.0048919191370987184
SIM,1872,75,na,1947,10
STAT,1837,89,na,1926,0.5079592980320321
SIM,1866,27,na,1893,30
STAT,1880,32,35-39,1912,0.10649147603242999
STAT,1877,44,30-34,1921,0.011707387440991382
STAT,1930,34,na,1964,48.51785456579314
STAT,1852,58,na,1910,16.92523266255873
STAT,1874,34,35-39,1908,0.10185861098652949
STAT,1862,20,20-24,1882,0.6174719608017634
STAT,1869,39,50-100,1908,0.011776378896481872
STAT,1889,18,50-100,1907,5.982515653564633E-4
SIM,1825,73,na,1898,6
SIM,1843,30,na,1873,23
STAT,1830,25,35-39,1855,0.11097425922425912
SIM,1858,40,na,1898,25
STAT,1858,18,15-19,1876,0.05244059661344165
STAT,1896,40,20-24,1936,1.463224234114006E-4
SIM,1929,31,30-34,1960,2
STAT,1832,22,35-39,1854,0.0356066737029956
STAT,1934,24,na,1958,48.83470370718257
STAT,1814,92,na,1906,0.18559888802654206
SIM,1798,58,na,1856,9
STAT,1861,37,30-34,1898,0.04481937860201929
SIM,1845,73,na,1918,14
STAT,1857,31,50-100,1888,0.0069734702565854845
STAT,1883,28,20-24,1911,0.1135209436583231
STAT,1835,29,30-34,1864,0.14779302926550522
SIM,1791,79,na,1870,1
STAT,1839,21,50-100,1860,0.0029124296066216086
STAT,1820,39,35-39,1859,0.0642035782142603
SIM,1898,12,na,1910,37
SIM,1891,28,20-24,1919,1
STAT,1860,25,15-19,1885,0.003782114892386631
STAT,1824,31,40-44,1855,0.0731803866123744
STAT,1923,36,20-24,1959,0.003036014606799674
STAT,1894,43,20-24,1937,1.403168404030448E-4
STAT,1864,15,35-39,1879,0.005661196258513464
SIM,1897,59,na,1956,38
SIM,1840,73,na,1913,4
STAT,1856,48,na,1904,16.093804419816557
SIM,1874,22,na,1896,21
SIM,1837,35,35-39,1872,1
STAT,1794,67,na,1861,8.473038485130628
STAT,1854,29,35-39,1883,0.06094312350454591
STAT,1927,4,na,1931,49.92892983691899
STAT,1867,27,25-29,1894,0.40480791517136283
STAT,1875,54,45-49,1929,1.450768931156104E-4
STAT,1830,42,20-24,1872,8.665873208159676E-4
STAT,1871,42,50-100,1913,0.010519861447247241
STAT,1896,26,35-39,1922,0.12717709409430186
STAT,1834,35,15-19,1869,5.039693555688733E-4
STAT,1881,91,na,1972,2.0782316373413128
STAT,1894,47,35-39,1941,0.0010073759424434722
SIM,1880,70,na,1950,22
SIM,1952,15,25-29,1967,1
STAT,1875,19,25-29,1894,0.05793830468230482
STAT,1921,29,na,1950,41.12927084655043
STAT,1932,24,50-100,1956,0.00856895893483127
STAT,1944,15,25-29,1959,0.46321667781320497
STAT,1822,34,40-44,1856,0.02936596393781192
STAT,1876,32,15-19,1908,0.0014463574887636091
SIM,1962,6,na,1968,48
SIM,1909,49,na,1958,33
STAT,1890,20,na,1910,28.899723412222606
STAT,1865,47,45-49,1912,0.0021246385597001524
SIM,1904,26,na,1930,32
STAT,1834,53,45-49,1887,1.0309505531984808E-4
STAT,1819,37,50-100,1856,0.01375251235992611
STAT,1880,19,35-39,1899,0.005739024820368998
SIM,1867,29,na,1896,14
STAT,1855,41,40-44,1896,0.015908128577031798
STAT,1847,16,45-49,1863,8.760822176088944E-4
SIM,1937,13,na,1950,41
STAT,1839,21,35-39,1860,0.04167686279275679
STAT,1835,23,na,1858,12.587200941275118
SIM,1967,4,na,1971,50
STAT,1873,39,45-49,1912,0.020063647563055346
STAT,1890,26,50-100,1916,0.007797027810449741
STAT,1888,34,35-39,1922,0.11733147412141919
STAT,1891,22,40-44,1913,0.025575915285670978
SIM,1885,73,na,1958,14
STAT,1868,37,15-19,1905,5.434331339491697E-4
STAT,1870,42,20-24,1912,0.0015756882046288835
STAT,1832,58,na,1890,8.938915081730844
STAT,1881,32,25-29,1913,0.09746282923026414
STAT,1832,38,15-19,1870,3.1538400702172526E-4
STAT,1896,44,35-39,1940,0.001629431953529632
STAT,1846,19,35-39,1865,0.005520584300892375
STAT,1886,33,15-19,1919,0.0014709132676193005
STAT,1836,48,na,1884,22.43374074303567
STAT,1897,30,na,1927,31.94386825285411
STAT,1882,44,40-44,1926,0.02126483234857265
SIM,1839,65,na,1904,17
STAT,1819,42,15-19,1861,1.3090953507671746E-4
STAT,1806,103,na,1909,6.715339844506335E-4
STAT,1918,25,25-29,1943,0.6988425745712007
STAT,1956,15,45-49,1971,0.006576361141303188
STAT,1865,53,na,1918,19.162435149084494
STAT,1806,48,45-49,1854,0.007835059413419283
STAT,1849,29,25-29,1878,0.38325170854826407
STAT,1891,19,15-19,1910,0.07244790965478408
SIM,1849,19,25-29,1868,1
SIM,1954,5,na,1959,50
STAT,1895,40,30-34,1935,0.015076232954347808
STAT,1854,81,na,1935,3.305342036124454
STAT,1836,30,20-24,1866,0.03366603139178136
STAT,1861,16,50-100,1877,4.763519616751056E-4
STAT,1836,49,40-44,1885,0.0016853480915989232
STAT,1907,14,na,1921,37.65339812864549
STAT,1818,51,na,1869,6.618697491103053
STAT,1850,50,50-100,1900,1.364019651910074E-4
STAT,1870,26,15-19,1896,0.004522496166603451
STAT,1924,22,45-49,1946,0.013190528621183674
SIM,1837,78,na,1915,10
STAT,1915,27,50-100,1942,0.010064678117149199
STAT,1861,19,30-34,1880,0.015225092391246479
SIM,1862,45,na,1907,23
STAT,1807,99,na,1906,0.00799275101524488
SIM,1832,47,na,1879,25
STAT,1866,31,45-49,1897,0.016125913175079665
SIM,1848,30,na,1878,31
STAT,1833,48,50-100,1881,0.0019135748482945348
SIM,1832,86,na,1918,2
STAT,1812,44,25-29,1856,0.007310480080796618
STAT,1896,37,na,1933,30.94660819841617
STAT,1853,42,20-24,1895,9.96881233854785E-4
STAT,1884,39,20-24,1923,0.007476395381375066
SIM,1843,19,na,1862,23
STAT,1902,49,50-100,1951,0.001912865555315316
STAT,1801,74,na,1875,4.514355179882344
STAT,1833,34,15-19,1867,0.0013295315086166173
STAT,1875,19,30-34,1894,0.016296191773410244
STAT,1850,18,15-19,1868,0.06418829852595682
STAT,1827,37,25-29,1864,0.023563414417140334
STAT,1847,34,45-49,1881,0.01949428206759906
STAT,1838,100,na,1938,0.008239922303908982
STAT,1845,76,na,1921,5.5380370298540145
STAT,1837,45,40-44,1882,8.875199379299049E-4
STAT,1889,63,na,1952,21.84580254221914
STAT,1864,27,50-100,1891,0.0057375474141242305
STAT,1878,28,40-44,1906,0.030817865434021357
STAT,1815,53,40-44,1868,1.4316841694385604E-4
STAT,1900,47,35-39,1947,0.0010899804278382
SIM,1869,55,na,1924,15
SIM,1828,73,na,1901,6
STAT,1844,91,na,1935,0.4526275311953219
SIM,1857,29,25-29,1886,1
STAT,1888,61,na,1949,21.836838528718154
STAT,1820,35,15-19,1855,5.472169676221963E-4
STAT,1840,32,35-39,1872,0.09665359681240339
SIM,1850,12,na,1862,22
SIM,1931,1,na,1932,63
STAT,1870,20,na,1890,23.63430214337575
STAT,1901,49,45-49,1950,0.0018238650427062526
STAT,1845,36,35-39,1881,0.04389390091400394
STAT,1819,46,35-39,1865,0.0012777642560141112
STAT,1824,46,45-49,1870,0.003094470040864202
STAT,1848,81,na,1929,3.4971227609457167
STAT,1859,32,15-19,1891,0.0011318802418855919
STAT,1954,16,na,1970,45.255814537600244
STAT,1849,47,25-29,1896,4.4454319417159443E-4
STAT,1876,48,30-34,1924,9.707918358090889E-4
STAT,1906,20,30-34,1926,0.260323695528857
SIM,1878,60,na,1938,21
STAT,1817,48,20-24,1865,3.419747559673195E-4
STAT,1824,51,na,1875,17.04608894122322
STAT,1891,37,45-49,1928,0.024467334133540165
STAT,1898,39,20-24,1937,0.002221890892705541
STAT,1888,17,45-49,1905,7.633575075365817E-4
STAT,1871,22,15-19,1893,0.03289128132797963
SIM,1825,53,na,1878,16
STAT,1876,47,20-24,1923,1.2130929560930476E-4
STAT,1812,43,15-19,1855,1.5992997440295755E-4
STAT,1903,24,na,1927,33.41418436701145
STAT,1949,16,15-19,1965,0.5245954790283124
STAT,1832,38,45-49,1870,0.01119613091777747
STAT,1927,42,50-100,1969,0.0014658466837617582
STAT,1890,40,na,1930,28.357980151671267
STAT,1894,10,na,1904,33.197407948323296
STAT,1936,1,na,1937,39.73987846195625
STAT,1901,48,35-39,1949,0.0010911412497245636
SIM,1849,35,na,1884,8
STAT,1835,47,30-34,1882,4.6203166153894174E-4
SIM,1904,46,na,1950,26
STAT,1837,47,50-100,1884,0.0012409889387384621
STAT,1849,29,30-34,1878,0.2281485090263334
SIM,1965,3,na,1968,52
STAT,1929,22,25-29,1951,1.1625027310988465
STAT,1881,33,35-39,1914,0.09595677826912839
STAT,1891,45,na,1936,27.894213533756165
STAT,1886,37,35-39,1923,0.07336503169859424
STAT,1852,16,25-29,1868,0.05900474938716431
STAT,1855,40,30-34,1895,0.008176143118586514
STAT,1803,52,30-34,1855,1.1615142509228028E-4
STAT,1949,0,na,1949,51.062517944978545
STAT,1874,23,50-100,1897,0.004124215335899143
STAT,1912,45,50-100,1957,0.0021668359032962214
STAT,1853,46,35-39,1899,8.823718258884328E-4
STAT,1894,4,na,1898,33.714680735027805
STAT,1895,48,35-39,1943,0.0010123713487307348
STAT,1846,15,na,1861,23.646749994508635
STAT,1878,23,50-100,1901,0.004197090552291383
STAT,1874,35,15-19,1909,5.750935548603231E-4
SIM,1893,60,na,1953,29
STAT,1832,23,45-49,1855,0.004224335792152431
STAT,1809,105,na,1914,1.6223475609207028E-4
STAT,1793,82,na,1875,0.9074237469239906
STAT,1825,39,15-19,1864,5.631873396696214E-4
STAT,1828,39,35-39,1867,0.031248538128783667
STAT,1874,53,45-49,1927,1.44863303042339E-4
STAT,1855,22,30-34,1877,0.14651106124827604
STAT,1886,36,50-100,1922,0.012796256155851247
STAT,1814,42,35-39,1856,0.05786369299958838
STAT,1936,20,15-19,1956,0.050619395213704
STAT,1919,26,50-100,1945,0.0106980104163469
STAT,1875,36,15-19,1911,5.800146895042354E-4
STAT,1867,24,15-19,1891,0.03137272297432201
STAT,1948,16,na,1964,41.856471623187325
STAT,1886,19,35-39,1905,0.005661052344326611
SIM,1842,45,na,1887,23
SIM,1944,0,na,1944,36
SIM,1862,85,na,1947,4
STAT,1845,32,15-19,1877,9.897776448269345E-4
SIM,1921,18,na,1939,37
STAT,1872,86,na,1958,2.9570318527833144
STAT,1813,41,35-39,1854,0.06290729920540736
STAT,1929,40,25-29,1969,9.229083495308809E-4
STAT,1842,27,20-24,1869,0.10884817208162285
STAT,1850,36,45-49,1886,0.01821857393274954
STAT,1857,39,30-34,1896,0.03949609551509368
STAT,1839,39,15-19,1878,3.6271390504125756E-4
STAT,1861,83,na,1944,3.3384840518078907
SIM,1857,29,30-34,1886,1
STAT,1878,46,40-44,1924,0.0017725171063560224
STAT,1939,30,40-44,1969,0.03969923718690523
SIM,1858,9,na,1867,27
STAT,1873,1,na,1874,35.4670521132194
STAT,1856,68,na,1924,11.07077265579794
STAT,1820,35,20-24,1855,0.007511795610438672
SIM,1833,40,na,1873,12
STAT,1841,25,40-44,1866,0.03694677680975243
STAT,1823,41,na,1864,16.12938437319109
STAT,1941,23,50-100,1964,0.006748322659075701
STAT,1910,0,na,1910,44.22218403703759
STAT,1842,48,na,1890,16.66798291101803
STAT,1860,26,25-29,1886,0.3500974758964531
STAT,1921,44,50-100,1965,0.0013085129022687252
STAT,1883,42,35-39,1925,0.01756282758883509
STAT,1797,95,na,1892,0.028480341789414658
STAT,1819,36,na,1855,15.508114788561617
SIM,1887,20,na,1907,21
STAT,1916,6,na,1922,42.0228902158669
STAT,1867,24,20-24,1891,0.6553370214937311
STAT,1848,44,35-39,1892,0.011552458235683573
STAT,1882,76,na,1958,10.090054178821878
STAT,1924,19,15-19,1943,0.5340453206812261
STAT,1862,39,40-44,1901,0.037387432423380204
STAT,1866,43,45-49,1909,0.01368420900607258
STAT,1872,42,25-29,1914,0.006562270243603557
STAT,1822,37,45-49,1859,0.012242072258813278
STAT,1830,25,30-34,1855,0.2896220742337114
STAT,1910,38,35-39,1948,0.022877476398003836
STAT,1890,71,na,1961,17.964861707636437
STAT,1812,89,na,1901,0.4174992452878392
STAT,1870,43,na,1913,22.79373693603094
STAT,1881,27,50-100,1908,0.006086950939010294
SIM,1932,19,15-19,1951,2
STAT,1895,23,15-19,1918,0.04269740810582756
SIM,1889,32,na,1921,30
STAT,1909,17,25-29,1926,0.08450505049138352
STAT,1841,31,40-44,1872,0.05204018512462025
STAT,1922,19,15-19,1941,0.5185843270315775
STAT,1851,84,na,1935,2.808445500822254
STAT,1900,20,35-39,1920,0.08140236317027645
STAT,1833,37,20-24,1870,0.0071351611485178535
STAT,1898,60,na,1958,26.40448804193515
STAT,1880,50,na,1930,22.967072268585987
STAT,1857,41,45-49,1898,0.011254663954005689
STAT,1891,19,45-49,1910,7.974451843095756E-4
STAT,1816,51,35-39,1867,1.0624254650751619E-4
STAT,1893,17,na,1910,31.84479587535952
SIM,1867,20,na,1887,15
STAT,1916,39,na,1955,37.8133145450998
STAT,1876,18,30-34,1894,0.016145654554496847
STAT,1821,63,na,1884,11.399994793985163
STAT,1923,26,45-49,1949,0.019765090081342293
STAT,1834,92,na,1926,0.29433451872860106
STAT,1844,37,30-34,1881,0.04399048073015797
STAT,1845,18,35-39,1863,0.004030087894162918
STAT,1872,16,50-100,1888,5.058989156849183E-4
SIM,1918,15,20-24,1933,1
STAT,1922,37,15-19,1959,2.1690903343149845E-4
STAT,1940,23,40-44,1963,0.03399776550243918
STAT,1825,56,na,1881,11.882844830839613
STAT,1828,32,15-19,1860,0.0019494416338947688
STAT,1861,45,50-100,1906,0.002085977775409347
STAT,1856,24,45-49,1880,0.005783048155757217
STAT,1874,38,20-24,1912,0.007781407560725036
STAT,1872,51,50-100,1923,1.5526618508175227E-4
STAT,1892,15,15-19,1907,0.07365653026339523
STAT,1860,43,45-49,1903,0.0120793825101491
SIM,1878,91,na,1969,2
STAT,1851,35,15-19,1886,4.892057401452334E-4
STAT,1898,46,50-100,1944,0.001874196453991415
STAT,1865,84,na,1949,3.0088964673849725
STAT,1834,81,na,1915,3.8215582345150123
STAT,1888,31,30-34,1919,0.20486772565036654
STAT,1869,33,15-19,1902,0.0013740239560399777
SIM,1889,18,15-19,1907,2
STAT,1814,40,40-44,1854,0.07724930233984101
STAT,1914,33,40-44,1947,0.03890024669704129
STAT,1869,37,35-39,1906,0.06853246435981643
STAT,1861,91,na,1952,0.48731536435891604
STAT,1886,37,30-34,1923,0.05528191493558426
STAT,1895,35,50-100,1930,0.01609061150068482
STAT,1873,17,na,1890,25.677651197129233
STAT,1853,30,20-24,1883,0.017861456095395356
STAT,1881,31,40-44,1912,0.04143437914182572
SIM,1897,50,na,1947,38
SIM,1833,71,na,1904,3
SIM,1927,34,na,1961,50
SIM,1923,21,na,1944,35
STAT,1841,63,na,1904,17.465034893891804
STAT,1836,27,25-29,1863,0.5282542546897379
STAT,1892,21,45-49,1913,0.008640772740925302
STAT,1910,14,na,1924,38.76751570101413
STAT,1889,30,35-39,1919,0.12498551977450988
STAT,1851,17,15-19,1868,0.060914024433299796
STAT,1851,29,15-19,1880,0.004420575932892136
STAT,1870,27,30-34,1897,0.2501541169185805
SIM,1852,55,na,1907,19
STAT,1849,66,na,1915,12.708742062554563
STAT,1815,41,40-44,1856,0.035628772228262925
STAT,1904,39,20-24,1943,0.0023600628029495216
STAT,1912,33,40-44,1945,0.03804442081549083
STAT,1807,47,20-24,1854,2.5486000956156447E-4
STAT,1935,25,25-29,1960,0.8940165947988045
STAT,1914,15,40-44,1929,0.0028826956982033417
SIM,1838,40,na,1878,8
STAT,1799,99,na,1898,0.006996651664383198
STAT,1871,26,35-39,1897,0.09652998352270206
STAT,1856,39,45-49,1895,0.014296135393848506
STAT,1848,10,na,1858,19.377793509251347
STAT,1898,71,na,1969,21.630814340895043
STAT,1825,42,45-49,1867,0.014554204822609718
STAT,1850,43,na,1893,20.429813372680346
STAT,1902,43,25-29,1945,6.242977253206181E-4
STAT,1882,26,40-44,1908,0.028806317929176817
STAT,1892,33,45-49,1925,0.021452399888040166
SIM,1880,21,25-29,1901,1
STAT,1856,42,40-44,1898,0.016274443077930675
STAT,1915,31,35-39,1946,0.09264408009949546
SIM,1891,5,na,1896,38
STAT,1897,22,40-44,1919,0.02767205192343968
STAT,1852,49,25-29,1901,4.826757576555047E-4
SIM,1883,47,na,1930,10
STAT,1825,30,45-49,1855,0.02553611751188327
STAT,1930,29,20-24,1959,0.23079237897626473
STAT,1932,31,35-39,1963,0.12105999184203706
STAT,1906,23,35-39,1929,0.08451681165659466
SIM,1891,65,na,1956,28
STAT,1863,38,45-49,1901,0.01756273829175672
STAT,1851,32,45-49,1883,0.015322844712057904
STAT,1811,47,50-100,1858,0.009726048464383253
STAT,1877,25,20-24,1902,0.12192077989491612
SIM,1917,13,na,1930,47
STAT,1812,45,35-39,1857,0.0016148393546900103
STAT,1847,88,na,1935,1.4665141134772002
STAT,1832,35,50-100,1867,0.00711362210287204
STAT,1846,18,na,1864,23.23136815645872
STAT,1892,15,45-49,1907,8.107486555703317E-4
SIM,1832,55,na,1887,20
STAT,1836,42,20-24,1878,0.0018233168920708221
STAT,1819,46,30-34,1865,8.834827137579552E-4
STAT,1889,45,35-39,1934,0.0017311528701944435
STAT,1865,73,na,1938,10.743072455121004
SIM,1851,14,na,1865,26
STAT,1880,37,35-39,1917,0.07437552459435424
SIM,1863,47,na,1910,11
STAT,1842,41,35-39,1883,0.01423759549922263
STAT,1840,30,40-44,1870,0.04225855090163153
STAT,1841,43,40-44,1884,0.02258640251798365
STAT,1842,23,35-39,1865,0.05482598091006195
STAT,1850,52,45-49,1902,1.2852557155260613E-4
STAT,1916,36,50-100,1952,0.004283318515253164
STAT,1860,36,50-100,1896,0.010029253727574919
STAT,1842,30,45-49,1872,0.016136895634077653
STAT,1878,40,30-34,1918,0.011989142931451204
STAT,1894,31,20-24,1925,0.03478375146840212
STAT,1882,41,35-39,1923,0.017432343163114622
SIM,1822,48,na,1870,15
STAT,1813,46,35-39,1859,0.00440438505075436
STAT,1831,41,25-29,1872,0.006442980697914035
STAT,1827,40,20-24,1867,0.0012776941687811726
STAT,1897,37,40-44,1934,0.05813128483903816
STAT,1852,17,50-100,1869,5.071227628927267E-4
STAT,1851,20,45-49,1871,0.007132283229853694
STAT,1941,21,35-39,1962,0.09663225271221476
STAT,1818,74,na,1892,2.773393251435513
STAT,1863,32,35-39,1895,0.08966480067017658
STAT,1866,25,15-19,1891,0.00420686512669045
STAT,1902,39,na,1941,33.148814671759894
STAT,1847,52,40-44,1899,1.1186156407612956E-4
SIM,1911,6,na,1917,42
SIM,1934,16,na,1950,52
STAT,1821,71,na,1892,8.290294400416474
SIM,1909,3,na,1912,41
STAT,1833,51,na,1884,16.7549945913886
SIM,1860,73,na,1933,10
STAT,1842,25,na,1867,20.362879165676347
STAT,1872,25,40-44,1897,0.030857655022125008
STAT,1878,49,45-49,1927,0.002385633050241815
STAT,1854,47,35-39,1901,8.51739577693734E-4
SIM,1820,53,na,1873,13
STAT,1866,28,15-19,1894,0.004163808318614661
SIM,1911,28,na,1939,40
STAT,1791,70,na,1861,6.162209807367725
STAT,1824,82,na,1906,3.246537001840039
STAT,1877,31,20-24,1908,0.028016650533193483
STAT,1862,35,25-29,1897,0.025076609985832433
STAT,1929,26,40-44,1955,0.05808150577763645
STAT,1811,48,25-29,1859,0.0022456311318750357
STAT,1833,33,35-39,1866,0.09553411322807939
STAT,1811,64,na,1875,11.628920020244168
SIM,1895,72,na,1967,14
STAT,1896,42,40-44,1938,0.0020491427939034524
STAT,1880,30,15-19,1910,0.0015095293575706286
STAT,1905,37,15-19,1942,1.7492761839946942E-4
STAT,1857,38,15-19,1895,4.182924895287475E-4
STAT,1909,32,20-24,1941,0.023145627629725926
SIM,1859,25,na,1884,18
STAT,1898,42,45-49,1940,0.0014002873121590857
STAT,1862,17,25-29,1879,0.055994355255140335
STAT,1883,24,35-39,1907,0.0563125183323881
STAT,1878,47,50-100,1925,0.002523796326516409
STAT,1914,17,50-100,1931,7.685795131716352E-4
STAT,1845,36,30-34,1881,0.03307487014369306
SIM,1816,48,na,1864,12
STAT,1897,43,40-44,1940,0.0020592075256384936
SIM,1920,0,na,1920,57
STAT,1877,43,20-24,1920,0.0016275226741409108
STAT,1870,46,35-39,1916,0.0013946925982075277
STAT,1821,38,40-44,1859,0.08205084299111055
STAT,1832,38,50-100,1870,0.006895440372906339
STAT,1858,16,20-24,1874,0.1585198490527342
STAT,1851,30,50-100,1881,0.008219932827161183
STAT,1896,45,na,1941,29.852643255394657
STAT,1909,41,50-100,1950,0.0010989632697840305
STAT,1955,16,40-44,1971,0.018468638106893608
SIM,1850,29,na,1879,21
SIM,1883,39,na,1922,13
SIM,1945,8,na,1953,40
STAT,1856,17,na,1873,19.66264699558367
STAT,1940,26,45-49,1966,0.017499743993338254
STAT,1887,32,25-29,1919,0.11179881895524843
SIM,1842,85,na,1927,5
STAT,1830,28,35-39,1858,0.0790321681542461
STAT,1843,26,25-29,1869,0.22242989983312936
STAT,1874,98,na,1972,0.239490482654057
STAT,1925,36,20-24,1961,0.003146959312566745
STAT,1879,41,30-34,1920,0.01195302214953469
STAT,1877,46,25-29,1923,5.962704935340618E-4
STAT,1886,38,na,1924,24.316546222913498
STAT,1854,100,na,1954,0.006489146275030447
STAT,1863,10,na,1873,24.420975047961743
STAT,1851,53,45-49,1904,1.205511228776979E-4
STAT,1805,56,na,1861,8.766559345435217
STAT,1854,26,35-39,1880,0.06843397531698849
STAT,1914,18,45-49,1932,0.0010220877797961672
STAT,1832,103,na,1935,6.487005544611794E-4
STAT,1900,7,na,1907,36.12800489920082
SIM,1832,78,na,1910,15
STAT,1885,50,50-100,1935,1.5128511946669768E-4
SIM,1876,65,na,1941,25
STAT,1835,35,30-34,1870,0.03054270384605615
SIM,1851,26,25-29,1877,2
SIM,1848,35,45-49,1883,1
SIM,1895,32,25-29,1927,1
STAT,1850,33,40-44,1883,0.0399753952093962
STAT,1871,26,30-34,1897,0.25192521445080723
STAT,1903,32,na,1935,33.926975951120376
STAT,1841,22,50-100,1863,0.005056452307303338
STAT,1830,40,25-29,1870,0.0036210456259601433
STAT,1852,28,20-24,1880,0.11610433540193593
SIM,1907,14,na,1921,41
SIM,1917,21,na,1938,42
STAT,1912,36,45-49,1948,0.006633402045700035
SIM,1866,58,na,1924,27
STAT,1900,49,30-34,1949,7.413643850008038E-4
STAT,1804,50,25-29,1854,1.0122935763456448E-4
STAT,1806,97,na,1903,0.025137739935660583
SIM,1839,25,na,1864,23
STAT,1834,29,15-19,1863,0.004144124885192926
SIM,1811,53,na,1864,10
STAT,1911,50,na,1961,34.24420990296283
STAT,1867,17,50-100,1884,4.7928793571441834E-4
SIM,1861,5,na,1866,33
SIM,1944,23,na,1967,29
STAT,1815,50,35-39,1865,1.2427812977038437E-4
STAT,1837,58,na,1895,9.562164229552916
STAT,1951,19,na,1970,43.53601997378338
STAT,1891,16,40-44,1907,0.00225039940056904
SIM,1836,37,na,1873,8
STAT,1852,46,20-24,1898,1.0299337866408141E-4
STAT,1910,35,30-34,1945,0.017489066540888453
STAT,1879,32,50-100,1911,0.009483233094534109
STAT,1919,25,40-44,1944,0.05026423015614099
STAT,1837,42,35-39,1879,0.010403591154491902
SIM,1849,32,na,1881,12
STAT,1869,43,na,1912,22.232785621450127
STAT,1872,28,45-49,1900,0.011320302498233518
SIM,1917,4,na,1921,47
STAT,1892,19,30-34,1911,0.019585187316101007
STAT,1861,25,30-34,1886,0.2164035186175417
STAT,1879,23,30-34,1902,0.18378924252170611
STAT,1880,16,35-39,1896,0.005784139116615378
STAT,1887,46,50-100,1933,0.002688354130947835
STAT,1893,29,20-24,1922,0.14686200693541973
STAT,1862,32,20-24,1894,0.02332103479096111
STAT,1875,33,45-49,1908,0.017849838091054997
STAT,1914,36,45-49,1950,0.0067826233252398765
STAT,1860,19,15-19,1879,0.05498987360187588
STAT,1895,45,30-34,1940,7.159570248603158E-4
STAT,1871,41,25-29,1912,0.00643127684208147
STAT,1925,18,20-24,1943,1.6232328323826466
STAT,1870,32,50-100,1902,0.009101878712344287
STAT,1901,42,25-29,1943,6.2320363734853E-4
STAT,1860,40,40-44,1900,0.018470511054149978
SIM,1872,98,na,1970,1
SIM,1849,66,na,1915,1
STAT,1863,17,50-100,1880,4.949757075439182E-4
STAT,1830,46,35-39,1876,1.4082309908736826E-4
STAT,1944,2,na,1946,43.25950086862217
SIM,1943,22,20-24,1965,1
SIM,1770,86,na,1856,4
STAT,1846,17,40-44,1863,0.0018620654050211243
STAT,1858,34,20-24,1892,0.020392680161868716
STAT,1887,18,40-44,1905,0.001991170466345192
STAT,1945,15,40-44,1960,0.015177596652105975
STAT,1816,96,na,1912,0.0257786772109249
SIM,1870,40,na,1910,23
STAT,1886,35,na,1921,24.669845844300006
STAT,1909,57,na,1966,32.09491131915246
SIM,1881,80,na,1961,3
STAT,1832,55,na,1887,9.486110804247001
STAT,1846,35,40-44,1881,0.03782487108399562
STAT,1923,23,40-44,1946,0.038731433255266505
STAT,1891,34,40-44,1925,0.05277157751518297
STAT,1884,27,25-29,1911,0.4144489954491764
SIM,1909,0,na,1909,41
SIM,1934,13,na,1947,52
STAT,1856,36,40-44,1892,0.0318647222154846
STAT,1803,78,na,1881,3.509850749113157
STAT,1845,84,na,1929,1.944578816141086
STAT,1859,48,30-34,1907,7.597154275292307E-4
STAT,1935,22,20-24,1957,1.5074810276388282
STAT,1860,37,15-19,1897,4.565212619598123E-4
STAT,1833,96,na,1929,0.0635707379831176
STAT,1925,20,50-100,1945,0.007873566380308054
STAT,1843,41,50-100,1884,0.004673604014756732
SIM,1812,78,na,1890,5
SIM,1877,50,na,1927,24
STAT,1905,41,50-100,1946,0.0010635842022673509
STAT,1824,43,40-44,1867,0.029978261110391816
STAT,1836,24,20-24,1860,0.8651610417515394
STAT,1914,49,25-29,1963,5.186637888438884E-4
SIM,1865,17,na,1882,25
STAT,1897,42,50-100,1939,9.730176927326773E-4
SIM,1861,8,na,1869,33
SIM,1933,18,20-24,1951,4
STAT,1856,21,40-44,1877,0.017659159596324272
STAT,1901,46,40-44,1947,0.001355125419457909
STAT,1837,48,45-49,1885,0.0011772918916394318
STAT,1836,45,25-29,1881,5.968491390923028E-4
STAT,1846,31,25-29,1877,0.09911977879898902
SIM,1849,55,na,1904,7
STAT,1870,51,na,1921,21.491661793360585
STAT,1826,38,20-24,1864,0.008694206500321563
STAT,1869,37,30-34,1906,0.05164048562849492
STAT,1882,32,40-44,1914,0.0415606528351031
STAT,1850,34,15-19,1884,0.0012991387352786377
STAT,1933,31,na,1964,50.7898790924341
STAT,1866,25,45-49,1891,0.010295061355477099
STAT,1923,8,na,1931,46.50909377237296
STAT,1925,47,50-100,1972,0.002723601309696025
STAT,1887,36,40-44,1923,0.04801075349804843
STAT,1812,42,30-34,1854,0.013517617285918946
STAT,1894,40,15-19,1934,1.7877150515429574E-4
STAT,1949,22,15-19,1971,0.0617178791980267
STAT,1934,16,na,1950,49.69677697645709
STAT,1781,89,na,1870,0.5369536486244287
STAT,1867,39,20-24,1906,0.007302476445988605
STAT,1831,104,na,1935,5.412666365204458E-4
SIM,1805,53,na,1858,14
SIM,1828,70,na,1898,7
STAT,1927,44,40-44,1971,0.003110528141508673
STAT,1878,43,35-39,1921,0.01856010965735024
STAT,1854,22,15-19,1876,0.02369291978094674
STAT,1882,29,45-49,1911,0.010564471117419486
STAT,1845,39,35-39,1884,0.04254763214995281
STAT,1892,36,15-19,1928,6.970767463945604E-4
STAT,1841,46,45-49,1887,0.0023503957349771164
STAT,1838,22,30-34,1860,0.1793644685168675
STAT,1883,61,na,1944,18.145973661152603
STAT,1844,19,30-34,1863,0.015639744834497666
STAT,1883,21,30-34,1904,0.1734939966570142
STAT,1911,39,na,1950,35.74036857457401
STAT,1823,32,35-39,1855,0.15358838318588477
STAT,1851,18,30-34,1869,0.016263597992814616
SIM,1895,36,40-44,1931,2
STAT,1872,21,25-29,1893,0.587488381369494
STAT,1900,4,na,1904,36.47927311313176
STAT,1877,28,25-29,1905,0.43512404718309083
STAT,1897,25,45-49,1922,0.014844360608887653
STAT,1838,40,30-34,1878,0.01070620466259232
STAT,1909,35,25-29,1944,0.009355373549368332
STAT,1876,36,30-34,1912,0.05439015916475896
STAT,1832,66,na,1898,7.408470450916651
STAT,1890,23,35-39,1913,0.07066471466827802
STAT,1927,30,15-19,1957,0.0015744656989348258
STAT,1852,55,na,1907,17.696489561456538
STAT,1929,29,45-49,1958,0.021496873717516275
STAT,1810,52,45-49,1862,1.3673259136108567E-4
SIM,1864,32,na,1896,22
STAT,1892,18,15-19,1910,0.07312380628571304
STAT,1809,45,30-34,1854,0.0034027436527385253
STAT,1819,49,35-39,1868,0.001227190006267814
STAT,1865,44,40-44,1909,0.020069803863121453
STAT,1947,24,35-39,1971,0.10561837837132795
SIM,1869,24,na,1893,17
SIM,1824,30,30-34,1854,3
SIM,1885,28,25-29,1913,1
STAT,1892,75,na,1967,16.26890502676382
STAT,1849,91,na,1940,0.44932232956016693
STAT,1937,20,30-34,1957,0.2783091052383783
SIM,1869,32,na,1901,17
STAT,1866,29,30-34,1895,0.23026307100760524
STAT,1813,43,30-34,1856,0.037963356401104854
STAT,1938,30,25-29,1968,0.09242677613300589
STAT,1902,29,45-49,1931,0.01554544040602771
STAT,1831,24,40-44,1855,0.028752903849992788
SIM,1901,29,na,1930,36
STAT,1842,20,30-34,1862,0.17100856329718342
SIM,1871,1,na,1872,32
STAT,1838,40,na,1878,19.578977397951853
STAT,1899,38,25-29,1937,0.008465034168524095
STAT,1856,39,15-19,1895,4.0270808715517256E-4
STAT,1925,46,30-34,1971,0.0010761403568293796
STAT,1948,20,40-44,1968,0.03837779080597522
STAT,1949,22,45-49,1971,0.013045436533641198
STAT,1821,34,25-29,1855,0.25792777040942194
STAT,1875,83,na,1958,5.031823744958833
SIM,1885,17,na,1902,26
STAT,1885,38,30-34,1923,0.05236932320784652
STAT,1880,34,30-34,1914,0.18202630414577187
STAT,1869,36,50-100,1905,0.01195336454760587
STAT,1876,68,na,1944,15.521073449161912
STAT,1910,25,20-24,1935,0.17787812894666638
STAT,1870,44,15-19,1914,1.35333526965531E-4
STAT,1818,47,30-34,1865,9.523422153724597E-4
SIM,1853,40,na,1893,24
STAT,1839,36,na,1875,14.27210356591635
STAT,1934,27,na,1961,50.181391372889586
STAT,1855,43,na,1898,16.155190903628732
SIM,1913,54,na,1967,40
STAT,1891,35,15-19,1926,6.957663748731396E-4
SIM,1924,46,na,1970,50
STAT,1864,30,30-34,1894,0.1578589753182509
STAT,1939,33,40-44,1972,0.03962980399131864
SIM,1821,43,30-34,1864,2
STAT,1945,19,na,1964,39.89237234326443
SIM,1856,14,na,1870,18
SIM,1908,39,na,1947,39
STAT,1907,19,15-19,1926,0.08634220175380937
SIM,1818,63,na,1881,17
STAT,1895,27,35-39,1922,0.12526771829279015
SIM,1829,66,na,1895,17
STAT,1865,76,na,1941,8.56914613954425
SIM,1841,15,na,1856,22
STAT,1809,52,50-100,1861,4.939033100470431E-4
STAT,1828,36,35-39,1864,0.03179901721767132
STAT,1919,21,20-24,1940,1.210685946431259
STAT,1929,35,50-100,1964,0.005373760505296954
STAT,1824,44,15-19,1868,1.8101467064210802E-4
STAT,1841,28,45-49,1869,0.01340142813195123
SIM,1927,21,20-24,1948,1
STAT,1914,40,50-100,1954,0.001162511353493853
SIM,1842,14,na,1856,30
SIM,1881,0,na,1881,33
STAT,1891,31,35-39,1922,0.12480389379631042
STAT,1854,23,30-34,1877,0.12700569994075075
STAT,1933,15,45-49,1948,0.006690777449978875
SIM,1920,33,na,1953,44
STAT,1897,61,na,1958,25.50218627552761
STAT,1936,25,40-44,1961,0.044375890749356155
STAT,1885,41,20-24,1926,0.0015753984035009787
SIM,1835,52,na,1887,16
STAT,1850,38,30-34,1888,0.047706181025203104
STAT,1866,47,25-29,1913,5.280122198855862E-4
SIM,1924,23,na,1947,53
SIM,1871,90,na,1961,1
SIM,1827,57,na,1884,9
STAT,1896,45,50-100,1941,0.001837899909615187
STAT,1889,66,na,1955,20.06692078680041
STAT,1865,26,40-44,1891,0.02718747749243855
STAT,1898,32,30-34,1930,0.2355317387202195
STAT,1927,16,30-34,1943,0.15114956507684824
SIM,1918,29,na,1947,38
STAT,1920,24,35-39,1944,0.10313817673187346
STAT,1807,50,45-49,1857,3.094306067876274E-4
STAT,1846,69,na,1915,11.893384140366162
STAT,1845,16,15-19,1861,0.04410535134083829
SIM,1944,9,na,1953,36
STAT,1906,42,45-49,1948,0.001508049122680323
STAT,1885,39,50-100,1924,0.012002117508795778
STAT,1850,74,na,1924,9.881167945357207
STAT,1864,42,30-34,1906,0.010298942145361659
STAT,1894,17,50-100,1911,6.278759434458673E-4
STAT,1841,47,20-24,1888,1.179902687457736E-4
STAT,1852,35,30-34,1887,0.04682296104552211
STAT,1780,84,na,1864,1.943322661243084
STAT,1911,24,25-29,1935,0.8649330996254022
STAT,1876,14,na,1890,26.144230473081112
STAT,1902,15,15-19,1917,0.08407707048079417
STAT,1927,45,na,1972,46.09584850962278
STAT,1948,24,20-24,1972,1.2674329022382749
STAT,1883,44,20-24,1927,0.001521387056779963
STAT,1839,42,50-100,1881,0.006144664387235189
STAT,1873,42,40-44,1915,0.022840066997484323
SIM,1848,39,na,1887,31
STAT,1907,17,na,1924,36.943342984136784
STAT,1918,25,20-24,1943,0.1938099821957316
STAT,1790,94,na,1884,0.026229081691932693
STAT,1858,74,na,1932,8.444877173804347
STAT,1865,41,35-39,1906,0.01645269064074331
STAT,1894,29,50-100,1923,0.008139651365825694
STAT,1868,19,na,1887,24.591697508777102
STAT,1949,9,na,1958,45.410846048476735
STAT,1886,15,20-24,1901,0.1847464733826126
STAT,1888,31,50-100,1919,0.01075098401071805
STAT,1931,36,45-49,1967,0.008996670850943833
STAT,1887,31,na,1918,26.153213391015306
STAT,1882,40,25-29,1922,0.0062161687990070465
SIM,1876,34,na,1910,29
SIM,1848,34,35-39,1882,1
STAT,1909,45,35-39,1954,0.0011894051537284422
SIM,1879,3,na,1882,25
SIM,1852,44,na,1896,24
STAT,1896,20,30-34,1916,0.23536675358045736
STAT,1907,25,45-49,1932,0.016351160317966892
STAT,1951,18,30-34,1969,0.14421965138616563
STAT,1871,45,40-44,1916,0.0017238813166927578
STAT,1825,87,na,1912,0.9497965616853482
STAT,1870,49,40-44,1919,0.001665172324843902
STAT,1854,48,45-49,1902,0.0014243894026246674
STAT,1873,31,na,1904,24.360596033074927
STAT,1906,21,50-100,1927,0.0059423300194840325
STAT,1944,15,20-24,1959,1.449187392072471
SIM,1870,43,na,1913,19
STAT,1879,23,35-39,1902,0.060211173028669324
STAT,1801,97,na,1898,0.019468985873117815
STAT,1911,48,50-100,1959,0.0021215305127677106
STAT,1932,32,45-49,1964,0.020833739806195753
STAT,1927,18,25-29,1945,0.5346651614289918
STAT,1865,24,50-100,1889,0.0036798314203602216
STAT,1848,29,45-49,1877,0.008449302860518218
STAT,1844,40,20-24,1884,0.0013034334353504758
STAT,1859,44,15-19,1903,1.0828126540285145E-4
SIM,1952,15,20-24,1967,4
STAT,1921,20,na,1941,41.168976636350415
STAT,1934,31,50-100,1965,0.01124723286503838
STAT,1892,37,25-29,1929,0.03556982202533272
STAT,1883,41,na,1924,22.545574777139205
SIM,1863,61,na,1924,5
STAT,1902,31,20-24,1933,0.038273948490325824
SIM,1808,50,na,1858,15
STAT,1842,43,20-24,1885,0.0012170849074358652
STAT,1887,51,na,1938,23.61508726905924
STAT,1934,37,40-44,1971,0.02057045752514519
STAT,1843,19,15-19,1862,0.03179276476077578
STAT,1782,99,na,1881,0.002727449075349813
STAT,1900,43,20-24,1943,1.5182277369503233E-4
STAT,1889,32,na,1921,29.216362686049948
STAT,1856,34,50-100,1890,0.006580759956974776
SIM,1920,20,25-29,1940,1
STAT,1825,46,25-29,1871,5.387819442065851E-4
SIM,1911,50,na,1961,38
STAT,1859,29,20-24,1888,0.09349583233646941
SIM,1861,80,na,1941,5
STAT,1833,40,45-49,1873,0.013774908313571019
STAT,1914,5,na,1919,41.112305317983754
STAT,1840,41,30-34,1881,0.009518558184115842
SIM,1913,51,na,1964,40
STAT,1919,24,25-29,1943,0.9964126480765639
SIM,1909,46,na,1955,33
STAT,1942,22,na,1964,38.00992056836563
SIM,1922,14,na,1936,52
STAT,1861,33,15-19,1894,0.0011925313858787369
STAT,1877,40,15-19,1917,1.4399190926115996E-4
STAT,1924,47,25-29,1971,6.274064251224908E-4
SIM,1883,16,na,1899,14
STAT,1844,33,15-19,1877,0.0013164313033653151
SIM,1868,28,25-29,1896,1
STAT,1905,46,45-49,1951,0.001926750540989173
STAT,1832,41,40-44,1873,0.012530824805268254
STAT,1848,64,na,1912,11.241959696388497
STAT,1844,18,20-24,1862,0.1749908080950695
STAT,1805,52,50-100,1857,2.9215907450505366E-4
STAT,1830,47,45-49,1877,2.3418030924210803E-4
SIM,1876,68,na,1944,25
STAT,1881,60,na,1941,18.14764300578242
STAT,1855,22,35-39,1877,0.04799847226309807
STAT,1849,25,45-49,1874,0.010353534532633633
STAT,1889,27,40-44,1916,0.03667563845715436
STAT,1804,54,40-44,1858,2.7782720826521076E-4
STAT,1926,42,30-34,1968,0.0015670648693923163
STAT,1857,31,30-34,1888,0.13288448666028
STAT,1850,30,35-39,1880,0.10582853162092717
STAT,1852,89,na,1941,0.8990986868570157
STAT,1928,33,35-39,1961,0.11363636056260892
SIM,1868,39,na,1907,31
STAT,1841,34,50-100,1875,0.010657636342356488
STAT,1865,49,30-34,1914,8.572630629526533E-4
STAT,1898,49,na,1947,29.722204031557943
SIM,1872,44,na,1916,21
STAT,1937,21,40-44,1958,0.032546877314319635
STAT,1937,9,na,1946,38.482927006651565
STAT,1896,14,na,1910,33.81236795343581
STAT,1813,47,45-49,1860,0.007314538015995237
SIM,1823,41,na,1864,11
SIM,1863,16,na,1879,17
STAT,1865,48,20-24,1913,1.0717469539965557E-4
SIM,1894,53,na,1947,27
STAT,1908,21,15-19,1929,0.04883057651374862
SIM,1932,9,na,1941,53
STAT,1890,29,na,1919,28.781975922870895
STAT,1907,48,35-39,1955,0.0011406445591487767
STAT,1924,40,40-44,1964,0.002964002603767568
SIM,1848,70,na,1918,16
SIM,1903,21,na,1924,38
STAT,1856,46,50-100,1902,0.0017842598034414387
STAT,1902,26,40-44,1928,0.042388009177925436
STAT,1829,32,35-39,1861,0.09678576855365924
STAT,1839,36,40-44,1875,0.029169862336881534
STAT,1880,38,45-49,1918,0.02085859679474563
STAT,1818,43,15-19,1861,1.4404910755733025E-4
STAT,1896,23,35-39,1919,0.07641427931549376
STAT,1905,36,na,1941,34.43568796770302
STAT,1807,48,30-34,1855,0.0020288092276323846
STAT,1807,82,na,1889,2.07020589601584
STAT,1821,97,na,1918,0.033366384198276804
STAT,1907,22,40-44,1929,0.030480946215788
STAT,1903,39,35-39,1942,0.021486129322273097
STAT,1875,30,40-44,1905,0.04493726939487966
STAT,1814,51,30-34,1865,1.6681875828697173E-4
STAT,1824,48,30-34,1872,0.0012361367105035823
STAT,1923,49,30-34,1972,0.0010295565159535176
SIM,1900,34,30-34,1934,1
STAT,1886,17,15-19,1903,0.061557095975351674
STAT,1828,33,30-34,1861,0.1278964258534852
STAT,1926,5,na,1931,49.0148709002771
STAT,1959,2,na,1961,51.180387362074455
STAT,1867,52,50-100,1919,1.437579633178688E-4
SIM,1852,24,na,1876,25
STAT,1865,22,na,1887,21.65159786490701
STAT,1860,98,na,1958,0.041789797196710124
STAT,1865,40,25-29,1905,0.00586683621723925
STAT,1871,47,35-39,1918,0.0013892932075452308
STAT,1923,41,35-39,1964,0.002340631665865709
SIM,1859,2,na,1861,33
SIM,1883,30,40-44,1913,1
STAT,1871,101,na,1972,0.055067887382157045
STAT,1895,24,30-34,1919,0.22980123930824084
STAT,1917,26,15-19,1943,0.007361336496254477
STAT,1885,34,15-19,1919,0.0013942567155650325
STAT,1925,35,50-100,1960,0.005016323413256959
STAT,1908,47,40-44,1955,0.0014184522616304846
STAT,1881,46,na,1927,21.468994116942568
SIM,1858,15,na,1873,27
STAT,1891,39,30-34,1930,0.06475495241346918
STAT,1924,48,35-39,1972,0.0015207068371595818
STAT,1878,94,na,1972,1.028603605309381
STAT,1928,31,40-44,1959,0.04872098024796429
SIM,1785,82,na,1867,1
STAT,1867,31,na,1898,22.929378235521657
STAT,1837,20,50-100,1857,0.0034438084560897606
STAT,1874,39,30-34,1913,0.05352393723405091
STAT,1838,22,35-39,1860,0.058761573315635876
STAT,1874,19,45-49,1893,6.591373231200744E-4
STAT,1869,19,35-39,1888,0.0053269821031005915
STAT,1824,40,35-39,1864,0.02537613651207082
STAT,1933,38,35-39,1971,0.03277769647754597
STAT,1936,28,na,1964,35.617440960223384
STAT,1917,42,20-24,1959,1.8262603795794494E-4
STAT,1854,98,na,1952,0.01985622139830271
STAT,1845,22,na,1867,15.515958376932266
STAT,1960,9,na,1969,50.8843967222979
SIM,1832,24,na,1856,21
SIM,1880,73,na,1953,22
STAT,1918,41,25-29,1959,7.53450224272516E-4
STAT,1850,15,40-44,1865,0.002013657730427805
STAT,1890,32,30-34,1922,0.2120836930202849
STAT,1890,43,na,1933,27.871890990734688
STAT,1832,89,na,1921,0.4748511865180802
SIM,1817,47,na,1864,8
STAT,1823,41,30-34,1864,0.008213270235512988
STAT,1883,47,25-29,1930,5.567352327663745E-4
STAT,1887,30,30-34,1917,0.1921060289186053
STAT,1812,48,40-44,1860,0.001897379041442047
STAT,1863,41,na,1904,20.5562548850363
STAT,1920,21,30-34,1941,0.31775979869184007
SIM,1954,2,na,1956,52
STAT,1900,44,na,1944,31.72612744636115
SIM,1882,82,na,1964,12
STAT,1901,35,20-24,1936,0.0023502275935313173
STAT,1845,17,25-29,1862,0.041866849386385574
SIM,1913,31,na,1944,38
STAT,1874,44,50-100,1918,0.010572945966937353
STAT,1908,28,30-34,1936,0.3671836424052267
STAT,1868,41,20-24,1909,0.0015438597903317491
STAT,1841,40,35-39,1881,0.018896018904297953
STAT,1918,29,50-100,1947,0.010421830533732015
STAT,1932,39,30-34,1971,0.024337052186268568
SIM,1886,23,15-19,1909,1
STAT,1807,68,na,1875,8.786580634835344
STAT,1878,23,15-19,1901,0.03395445865909378
STAT,1869,18,25-29,1887,0.05533972539842282
STAT,1871,23,30-34,1894,0.1770397777811372
SIM,1935,15,20-24,1950,1
STAT,1883,31,45-49,1914,0.017003136834681055
SIM,1876,88,na,1964,2
STAT,1881,42,30-34,1923,0.010926124184734192
SIM,1870,63,na,1933,16
STAT,1925,43,25-29,1968,8.577786603318399E-4
SIM,1898,35,na,1933,32
SIM,1858,0,na,1858,33
STAT,1881,15,50-100,1896,4.683449419924045E-4
STAT,1864,45,35-39,1909,0.0012682107487583698
STAT,1850,40,45-49,1890,0.013460018552465541
STAT,1824,50,45-49,1874,1.8866663816067644E-4
STAT,1836,26,15-19,1862,0.005706748609120436
STAT,1947,8,na,1955,43.96878573751221
SIM,1889,32,30-34,1921,2
STAT,1905,19,15-19,1924,0.08519056818645288
STAT,1895,49,45-49,1944,0.001692199532969229
SIM,1896,34,na,1930,31
SIM,1869,27,30-34,1896,1
STAT,1857,19,45-49,1876,5.680040565562049E-4
STAT,1800,78,na,1878,2.86515867444017
SIM,1930,23,na,1953,48
STAT,1853,17,na,1870,17.354048686830666
STAT,1875,15,45-49,1890,6.7459735554058E-4
STAT,1943,16,15-19,1959,0.4778839136226085
STAT,1935,8,na,1943,54.282293854175485
STAT,1896,68,na,1964,22.331091762223338
STAT,1885,44,25-29,1929,0.006255798864042241
STAT,1918,54,na,1972,37.730067701305224
STAT,1865,29,45-49,1894,0.009970775210859002
STAT,1814,43,45-49,1857,0.046100311060163233
STAT,1903,35,na,1938,34.08063779124763
STAT,1891,41,45-49,1932,0.018452336092126168
STAT,1891,38,20-24,1929,0.00941419301986621
STAT,1892,30,40-44,1922,0.054006779670379076
STAT,1878,40,na,1918,24.102417592712857
STAT,1867,46,30-34,1913,9.289678707592718E-4
STAT,1884,42,15-19,1926,1.351354956939023E-4
STAT,1871,48,45-49,1919,0.002323356309594227
STAT,1906,41,35-39,1947,0.0018351329939788274
SIM,1818,40,na,1858,25
STAT,1927,15,20-24,1942,1.6849022619172846
STAT,1927,19,50-100,1946,0.004609752662431871
SIM,1874,53,na,1927,25
STAT,1816,40,45-49,1856,0.021508780912752434
STAT,1932,12,na,1944,52.254005540751
STAT,1824,47,20-24,1871,1.552794246521718E-4
STAT,1850,54,na,1904,18.64385819152543
STAT,1912,30,50-100,1942,0.008136832767877874
STAT,1907,45,na,1952,33.243855125313104
STAT,1912,48,45-49,1960,0.0020666236888880313
STAT,1925,23,50-100,1948,0.007802681816831761
SIM,1891,11,na,1902,38
STAT,1875,37,25-29,1912,0.029596481857202383
SIM,1845,76,na,1921,8
SIM,1861,35,na,1896,25
STAT,1810,88,na,1898,0.4934606741837568
SIM,1866,44,na,1910,28
STAT,1935,25,20-24,1960,0.2479375851234597
SIM,1870,2,na,1872,32
STAT,1947,11,na,1958,43.953398456360894
SIM,1910,7,na,1917,33
SIM,1827,27,25-29,1854,1
STAT,1862,16,15-19,1878,0.058988214967873084
STAT,1898,35,35-39,1933,0.09631992794667579
STAT,1892,34,20-24,1926,0.03310789001679649
STAT,1915,7,na,1922,41.33964455171235
STAT,1838,74,na,1912,8.61358673216176
SIM,1835,66,na,1901,12
STAT,1853,49,40-44,1902,0.0010534946170788894
STAT,1912,20,25-29,1932,0.8835458263396729
STAT,1909,42,30-34,1951,0.0011890779372911422
STAT,1780,101,na,1881,0.0025294868871738453
STAT,1844,43,25-29,1887,0.005071679318366177
STAT,1881,34,45-49,1915,0.0164511610451819
SIM,1853,71,na,1924,12
STAT,1869,34,30-34,1903,0.16772602639721287
STAT,1841,91,na,1932,0.5672018342873224
STAT,1920,38,50-100,1958,0.004553203746010832
SIM,1791,68,na,1859,5
STAT,1879,16,25-29,1895,0.05879525445225586
STAT,1886,18,25-29,1904,0.058625064045050676
SIM,1889,52,na,1941,25
SIM,1890,49,na,1939,24
STAT,1837,22,15-19,1859,0.02249996384399737
STAT,1865,51,45-49,1916,1.3189099142278446E-4
SIM,1874,25,na,1899,21
STAT,1929,26,na,1955,46.680975860760675
STAT,1840,33,45-49,1873,0.01647126617347332
STAT,1870,29,na,1899,23.538007805182005
STAT,1804,53,30-34,1857,1.602544520245248E-4
STAT,1863,27,na,1890,21.13021978541644
STAT,1833,65,na,1898,12.511523122211065
STAT,1928,30,30-34,1958,0.19625969650053343
SIM,1879,62,na,1941,9
STAT,1900,28,30-34,1928,0.347963709126964
STAT,1919,50,na,1969,39.14579131678514
STAT,1902,41,30-34,1943,0.0011309211339464804
STAT,1907,45,30-34,1952,8.06672853805223E-4
STAT,1823,44,35-39,1867,0.012615782068164038
STAT,1839,39,45-49,1878,0.012876342097652666
STAT,1825,43,20-24,1868,0.0015160856336323611
STAT,1834,45,50-100,1879,0.0020752066580356334
STAT,1926,35,25-29,1961,0.011985144512432535
STAT,1910,32,25-29,1942,0.08857435001088347
STAT,1856,79,na,1935,5.064551579632179
STAT,1902,40,20-24,1942,1.5708890231139032E-4
STAT,1922,43,40-44,1965,0.002845396670163895
STAT,1890,35,35-39,1925,0.08673092697135135
STAT,1863,31,25-29,1894,0.09105838178987327
STAT,1923,25,50-100,1948,0.011425547868394378
SIM,1792,64,na,1856,8
STAT,1830,44,40-44,1874,0.0022706321065630404
STAT,1879,56,na,1935,21.110416018524358
SIM,1904,57,na,1961,24
STAT,1842,46,25-29,1888,4.3780615414627604E-4
STAT,1867,29,50-100,1896,0.006077851632903003
SIM,1921,49,na,1970,41
STAT,1910,31,15-19,1941,0.0012365228771209456
STAT,1860,13,na,1873,22.28155028527185
STAT,1942,27,50-100,1969,0.010370656959460177
STAT,1802,59,na,1861,8.705467720756465
SIM,1814,50,na,1864,22
STAT,1834,36,25-29,1870,0.02557295418779048
STAT,1849,42,50-100,1891,0.008181550773484465
SIM,1881,35,na,1916,25
STAT,1916,46,20-24,1962,1.1265966818367487E-4
STAT,1926,45,35-39,1971,0.001589191272592266
SIM,1885,62,na,1947,17
STAT,1806,51,40-44,1857,3.478826169821072E-4
STAT,1830,28,50-100,1858,0.005239574189435953
STAT,1829,25,50-100,1854,0.016069652428782496
STAT,1830,43,30-34,1873,0.005523184834366612
STAT,1816,73,na,1889,3.663031117100784
STAT,1850,18,45-49,1868,7.065303856585406E-4
STAT,1914,27,na,1941,37.4519496689255
STAT,1913,22,35-39,1935,0.09047778530173192
STAT,1903,55,na,1958,29.999307802481052
SIM,1850,43,na,1893,20
STAT,1933,35,30-34,1968,0.02476640170113604
SIM,1807,57,na,1864,15
STAT,1817,58,na,1875,18.896165275194633
STAT,1896,45,45-49,1941,0.0017660601766349244
STAT,1838,24,50-100,1862,0.004047574647253438
STAT,1855,21,50-100,1876,0.0033784485872716103
SIM,1928,39,na,1967,54
SIM,1946,24,na,1970,49
STAT,1856,100,na,1956,0.009122983876956094
STAT,1883,47,na,1930,21.745931217569904
SIM,1825,42,na,1867,17
STAT,1862,79,na,1941,6.031632839144499
STAT,1861,94,na,1955,0.16807402401817118
STAT,1934,18,30-34,1952,0.16373715508673015
SIM,1890,18,na,1908,30
STAT,1857,34,35-39,1891,0.07516295766820703
STAT,1872,55,na,1927,21.1562291142621
STAT,1785,93,na,1878,0.19617982167646586
STAT,1948,23,40-44,1971,0.03833865875575308
STAT,1869,12,na,1881,25.77059051244328
STAT,1928,34,45-49,1962,0.01955441377847171
STAT,1871,44,30-34,1915,0.011307478251061357
STAT,1826,45,30-34,1871,0.0010010397426339747
STAT,1924,28,15-19,1952,0.008137454262736385
STAT,1843,41,na,1884,10.224620311408085
STAT,1829,91,na,1920,0.39361171171338805
STAT,1850,37,20-24,1887,0.0069720531802956445
STAT,1849,24,35-39,1873,0.053923197814401816
STAT,1887,85,na,1972,6.674313975962854
STAT,1858,40,na,1898,17.764717897380162
STAT,1886,0,na,1886,34.4489577763826
STAT,1829,54,45-49,1883,1.047323516236768E-4
SIM,1878,69,na,1947,17
STAT,1883,34,50-100,1917,0.00882131396272201
SIM,1852,78,na,1930,18
STAT,1927,19,35-39,1946,0.05162923938490589
STAT,1846,103,na,1949,0.0011630860708577721
STAT,1866,44,20-24,1910,0.0014428958504458151
STAT,1854,13,na,1867,17.375825714283305
STAT,1893,36,30-34,1929,0.06752287416891639
STAT,1888,39,na,1927,27.254806487429644
STAT,1957,4,na,1961,51.55726905372666
STAT,1820,49,45-49,1869,0.00194346159767085
SIM,1952,4,na,1956,35
SIM,1910,57,na,1967,27
SIM,1931,25,na,1956,57
STAT,1887,8,na,1895,28.37424836870729
STAT,1910,23,50-100,1933,0.0061224792741167945
STAT,1936,18,50-100,1954,0.0035559065553091686
STAT,1910,36,40-44,1946,0.014298169557655315
SIM,1883,67,na,1950,6
STAT,1927,30,50-100,1957,0.01013005237603144
STAT,1930,17,50-100,1947,0.004821055665896522
STAT,1872,40,30-34,1912,0.011881756356419962
STAT,1874,33,na,1907,24.106758942338455
STAT,1916,24,50-100,1940,0.006793169550426489
STAT,1809,91,na,1900,0.3206321544733516
STAT,1816,38,30-34,1854,0.07999408495756134
SIM,1948,17,20-24,1965,4
STAT,1941,26,na,1967,38.48904326571071
STAT,1947,24,50-100,1971,0.007380740093169371
STAT,1896,2,na,1898,35.01440285792253
STAT,1893,32,15-19,1925,0.0017955861173565638
STAT,1912,49,na,1961,34.82528258428534
STAT,1936,7,na,1943,38.038801204935886
STAT,1883,29,30-34,1912,0.24278901057005406
STAT,1887,17,30-34,1904,0.01739720834372171
STAT,1846,38,na,1884,19.733009146587555
STAT,1883,40,40-44,1923,0.022062697448061643
STAT,1912,24,40-44,1936,0.033108790204003986
STAT,1872,49,50-100,1921,0.002460438456754046
STAT,1876,45,na,1921,23.078221035812614
STAT,1909,40,na,1949,34.934357857401565
SIM,1891,2,na,1893,38
STAT,1898,17,40-44,1915,0.002467363838572538
STAT,1847,15,35-39,1862,0.007402693858204088
SIM,1852,75,na,1927,18
STAT,1929,17,45-49,1946,0.006344699778196197
STAT,1901,24,30-34,1925,0.24768145775897452
STAT,1910,34,na,1944,35.93401546140214
STAT,1837,41,25-29,1878,0.0037372353163323325
STAT,1864,4,na,1868,27.176863032482782
STAT,1835,28,20-24,1863,0.06959151151496597
STAT,1895,20,15-19,1915,0.043085298731922524
STAT,1826,103,na,1929,0.0010029072035436103
SIM,1908,30,na,1938,39
STAT,1933,16,25-29,1949,0.5791597342990055
STAT,1861,40,20-24,1901,0.0013490231100944895
STAT,1912,29,35-39,1941,0.14574590488011693
STAT,1832,80,na,1912,2.796109806350145
STAT,1866,38,na,1904,21.590492468040402
SIM,1935,32,na,1967,56
STAT,1903,17,25-29,1920,0.08056575844867105
STAT,1848,41,35-39,1889,0.01184692212289494
STAT,1821,40,na,1861,17.522613162167882
STAT,1942,28,35-39,1970,0.15635279883993747
SIM,1941,16,25-29,1957,1
STAT,1851,33,20-24,1884,0.023506235868621873
STAT,1811,49,35-39,1860,0.0053734674089074
STAT,1884,46,30-34,1930,9.510925710969816E-4
STAT,1912,45,40-44,1957,0.0015104328457460551
STAT,1957,1,na,1958,51.62177067623866
SIM,1932,23,20-24,1955,4
STAT,1867,42,15-19,1909,1.3199191909781243E-4
STAT,1928,18,40-44,1946,0.017492087948654422
SIM,1929,15,na,1944,48
STAT,1843,44,50-100,1887,0.004497381549351403
STAT,1870,33,25-29,1903,0.10131948175738188
STAT,1873,21,40-44,1894,0.02124989289926011
SIM,1899,62,na,1961,25
STAT,1842,28,30-34,1870,0.23196817524787244
STAT,1907,46,50-100,1953,0.002032232781869316
SIM,1898,22,30-34,1920,2
STAT,1908,18,20-24,1926,0.26093395177878553
STAT,1886,34,30-34,1920,0.17955322865240295
STAT,1853,26,15-19,1879,0.003327149309037985
STAT,1857,16,40-44,1873,0.0016188486477233055
STAT,1889,42,35-39,1931,0.022143071803403826
STAT,1876,29,20-24,1905,0.11829839933191931
STAT,1861,15,na,1876,22.451005817141372
STAT,1890,45,45-49,1935,0.0028952785939328762
STAT,1852,7,na,1859,25.62043348966361
STAT,1924,23,20-24,1947,1.2995201535007095
SIM,1882,8,na,1890,34
STAT,1836,93,na,1929,0.2820557598714279
STAT,1887,33,35-39,1920,0.11007124014319082
STAT,1813,44,40-44,1857,0.07192775742515299
STAT,1855,44,45-49,1899,0.010395156758643226
SIM,1937,10,na,1947,41
STAT,1907,26,25-29,1933,0.6208881296036198
STAT,1934,33,25-29,1967,0.1255806982309281
STAT,1870,45,25-29,1915,5.778963255303704E-4
STAT,1858,15,45-49,1873,5.875424866326859E-4
STAT,1919,43,35-39,1962,0.0021598345237448567
STAT,1921,41,50-100,1962,0.0013147744416324842
SIM,1906,52,na,1958,22
STAT,1935,28,25-29,1963,0.8928102146251872
STAT,1922,46,45-49,1968,0.0024846868997640344
STAT,1869,15,20-24,1884,0.17622764265592386
STAT,1892,33,50-100,1925,0.011271599871594387
SIM,1841,38,na,1879,16
STAT,1861,60,na,1921,16.03853275217941
STAT,1950,18,15-19,1968,0.5331239305165283
SIM,1825,76,na,1901,4
SIM,1939,22,na,1961,27
STAT,1911,46,35-39,1957,0.0012157278479442125
STAT,1873,39,15-19,1912,5.651732380032032E-4
STAT,1896,65,na,1961,23.66460637066996
SIM,1867,23,na,1890,14
STAT,1936,21,25-29,1957,0.8780460610137766
STAT,1890,39,15-19,1929,6.752459438511651E-4
SIM,1878,15,na,1893,29
STAT,1872,52,na,1924,21.91329023480055
STAT,1861,18,20-24,1879,0.17035132280352772
STAT,1891,59,na,1950,23.85337537742405
STAT,1942,21,15-19,1963,0.05542492148849416
STAT,1920,46,45-49,1966,0.0023879632235146815
SIM,1860,50,na,1910,19
SIM,1900,67,na,1967,20
STAT,1888,16,35-39,1904,0.006427952735538151
STAT,1925,21,15-19,1946,0.06351051204975439
STAT,1890,74,na,1964,16.254917398632337
SIM,1868,70,na,1938,25
STAT,1900,46,25-29,1946,4.518287649470637E-4
STAT,1847,31,40-44,1878,0.05496085414538154
STAT,1838,36,50-100,1874,0.011618316594359102
STAT,1843,75,na,1918,4.366912027938102
STAT,1877,27,15-19,1904,0.004683394634034048
STAT,1819,43,30-34,1862,0.010699878275066861
STAT,1905,67,na,1972,26.727743965090134
STAT,1808,46,25-29,1854,4.2182772148058323E-4
SIM,1909,9,na,1918,41
STAT,1833,30,35-39,1863,0.09855695106984234
SIM,1898,15,na,1913,34
STAT,1926,32,20-24,1958,0.02932513508639344
STAT,1854,39,50-100,1893,0.007428865351807085
STAT,1927,38,45-49,1965,0.0084240139710065
STAT,1925,47,40-44,1972,0.0018985364192202346
STAT,1912,15,na,1927,38.929791432909106
STAT,1778,91,na,1869,0.20201287212259206
STAT,1892,52,na,1944,26.45951580766892
STAT,1809,94,na,1903,0.11058534241547373
STAT,1941,29,na,1970,38.43364560815472
STAT,1836,43,30-34,1879,0.013031202403133582
SIM,1944,21,25-29,1965,1
STAT,1814,103,na,1917,6.395342887100511E-4
STAT,1941,22,45-49,1963,0.011543440642738562
STAT,1969,1,na,1970,48.86232282601517
SIM,1811,70,na,1881,3
STAT,1843,48,35-39,1891,5.864090015717143E-4
STAT,1852,31,15-19,1883,0.0012750868144852
STAT,1872,22,35-39,1894,0.05970689333322303
STAT,1880,19,na,1899,26.415663833366118
STAT,1849,21,30-34,1870,0.16819267860902656
STAT,1947,14,na,1961,43.93054662276859
STAT,1850,23,na,1873,22.685315096636177
STAT,1916,31,15-19,1947,0.0013207515652151692
STAT,1823,75,na,1898,5.920313834965317
STAT,1899,16,45-49,1915,8.964179600643421E-4
SIM,1902,45,na,1947,30
STAT,1943,21,na,1964,38.58223832123019
SIM,1911,59,na,1970,38
SIM,1856,68,na,1924,8
SIM,1805,76,na,1881,3
STAT,1840,54,50-100,1894,1.1508944388526479E-4
STAT,1829,46,na,1875,16.89675031551843
STAT,1838,71,na,1909,10.36001012471221
STAT,1846,16,30-34,1862,0.016322710073505976
STAT,1927,31,25-29,1958,0.11318041435681399
STAT,1948,7,na,1955,44.68533714497895
STAT,1901,45,30-34,1946,7.716637218493107E-4
STAT,1846,32,35-39,1878,0.0969893333814843
STAT,1878,42,25-29,1920,0.006621579633962269
SIM,1843,16,na,1859,23
STAT,1884,49,35-39,1933,0.0013430136681397014
STAT,1911,34,35-39,1945,0.08765571001817044
STAT,1916,38,35-39,1954,0.02443582995503387
STAT,1862,33,30-34,1895,0.15000058130047864
STAT,1882,45,na,1927,21.77616512909928
STAT,1769,103,na,1872,0.0025264794930050225
SIM,1857,30,na,1887,23
STAT,1826,41,15-19,1867,1.4885895078282433E-4
SIM,1801,63,na,1864,7
STAT,1852,43,15-19,1895,1.1733739288784208E-4
SIM,1938,29,na,1967,35
STAT,1897,18,35-39,1915,0.007267521753888168
SIM,1812,55,na,1867,18
STAT,1825,53,na,1878,12.609738089916618
STAT,1902,44,35-39,1946,0.0017493263917000628
STAT,1888,32,40-44,1920,0.050678783688578366
STAT,1913,6,na,1919,40.50400310590551
STAT,1910,35,50-100,1945,0.004028851019856464
STAT,1795,83,na,1878,1.6647017545437846
SIM,1863,30,na,1893,15
SIM,1847,23,na,1870,16
STAT,1920,44,na,1964,40.533594112428986
STAT,1866,21,30-34,1887,0.1665833781080589
STAT,1815,46,na,1861,10.982635441036527
STAT,1930,40,30-34,1970,0.0016789039094515016
STAT,1857,35,15-19,1892,4.2436993888461357E-4
STAT,1926,16,15-19,1942,0.5545999089618275
STAT,1870,74,na,1944,11.024512982991782
STAT,1819,39,na,1858,15.08018655991623
STAT,1874,67,na,1941,16.081898705428998
SIM,1950,21,15-19,1971,2
STAT,1845,33,30-34,1878,0.12009691832924833
STAT,1827,36,15-19,1863,4.6567052835324E-4
STAT,1867,88,na,1955,1.3137498182581768
STAT,1910,37,na,1947,35.76176084281494
STAT,1866,40,40-44,1906,0.02092444158479111
STAT,1894,27,15-19,1921,0.005814614947839007
SIM,1928,21,40-44,1949,1
STAT,1816,52,45-49,1868,1.7555603340599146E-4
STAT,1901,20,na,1921,33.29084579297611
STAT,1833,38,30-34,1871,0.048822245125323994
STAT,1837,26,30-34,1863,0.1602671999353243
STAT,1892,55,na,1947,25.544691457626346
STAT,1841,94,na,1935,0.19562669616331785
STAT,1916,15,45-49,1931,0.0010556727110011624
SIM,1847,20,na,1867,20
STAT,1912,27,45-49,1939,0.01689172357633927
STAT,1835,46,na,1881,10.80384509973379
STAT,1845,53,na,1898,12.384229853203339
STAT,1854,27,50-100,1881,0.004098979745622063
STAT,1874,31,35-39,1905,0.10315806790291795
STAT,1861,43,25-29,1904,0.005361244789701924
SIM,1838,49,na,1887,5
SIM,1843,61,na,1904,18
STAT,1860,23,20-24,1883,0.5733805181260222
STAT,1834,33,50-100,1867,0.008208278397163104
STAT,1894,40,50-100,1934,0.013676019144948637
STAT,1898,36,15-19,1934,7.611715356582806E-4
STAT,1899,8,na,1907,35.58606258826038
STAT,1805,52,35-39,1857,1.665401895557991E-4
STAT,1942,25,30-34,1967,0.40860294702640093
STAT,1885,18,50-100,1903,4.825344958104167E-4
STAT,1876,30,50-100,1906,0.00938061044357046
STAT,1902,56,na,1958,29.38877557063462
STAT,1909,16,15-19,1925,0.0887163041231175
STAT,1901,27,35-39,1928,0.1350144636743314
STAT,1910,39,45-49,1949,0.006414886233689222
STAT,1911,21,20-24,1932,1.050932412731917
SIM,1894,22,na,1916,30
STAT,1872,43,35-39,1915,0.018393867031025496
STAT,1907,23,20-24,1930,1.004903799864139
STAT,1820,46,40-44,1866,0.0014666455718476267
STAT,1907,48,na,1955,32.502112814270895
STAT,1921,39,20-24,1960,0.0029142390385054886
STAT,1883,43,45-49,1926,0.014428607898261085
SIM,1917,44,na,1961,34
SIM,1941,18,15-19,1959,1
STAT,1814,61,na,1875,10.428575454588536
STAT,1829,60,na,1889,13.174947820504386
STAT,1884,26,na,1910,23.462248847625837
STAT,1840,54,45-49,1894,1.1059083388245158E-4
STAT,1933,18,15-19,1951,0.6034609009729398
SIM,1858,49,na,1907,24
STAT,1906,49,30-34,1955,7.76721643427803E-4
STAT,1830,54,na,1884,7.716906934113242
STAT,1945,17,50-100,1962,0.004063272294497166
SIM,1818,43,na,1861,24
STAT,1874,16,40-44,1890,0.0018600930396568272
STAT,1859,59,na,1918,15.446981269034016
STAT,1894,33,na,1927,30.453709581672893
STAT,1811,46,30-34,1857,0.0038938415410045726
STAT,1917,55,na,1972,36.830872924284826
SIM,1907,37,na,1944,39
STAT,1820,47,na,1867,14.621847274827498
SIM,1915,23,20-24,1938,2
STAT,1944,18,25-29,1962,0.4628230546134038
STAT,1838,44,45-49,1882,0.012049405015104028
STAT,1856,17,35-39,1873,0.004700215806338649
STAT,1883,22,50-100,1905,0.003959977071573859
STAT,1900,21,45-49,1921,0.009698826115803036
STAT,1834,33,20-24,1867,0.02421562497178316
STAT,1856,93,na,1949,0.2117184980320896
STAT,1869,66,na,1935,15.881047857676426
SIM,1851,90,na,1941,2
STAT,1836,100,na,1936,0.010245990230320006
STAT,1838,20,na,1858,21.842857202030054
STAT,1931,33,40-44,1964,0.05101866755786343
SIM,1810,77,na,1887,10
SIM,1942,11,na,1953,43
STAT,1921,18,50-100,1939,0.004226170766453506
STAT,1918,31,50-100,1949,0.008741886403367868
STAT,1864,26,na,1890,21.478730301517274
STAT,1924,26,25-29,1950,0.7639968211173533
STAT,1842,24,15-19,1866,0.03077271513037276
STAT,1863,16,30-34,1879,0.01619862284795142
STAT,1913,44,45-49,1957,0.0016040684169909849
STAT,1843,72,na,1915,5.35711909689411
STAT,1890,42,40-44,1932,0.027288380907470943
SIM,1841,83,na,1924,4
STAT,1791,79,na,1870,2.62579991880853
STAT,1919,40,30-34,1959,0.0013772404773066483
SIM,1861,38,na,1899,25
STAT,1886,30,15-19,1916,0.0014890203433473917
STAT,1918,28,25-29,1946,0.6916899966533595
STAT,1949,19,20-24,1968,1.5656576667381805
STAT,1811,87,na,1898,0.9984362915148433
STAT,1842,42,45-49,1884,0.011617594121598207
SIM,1830,30,25-29,1860,1
STAT,1876,44,15-19,1920,1.3836571512840687E-4
SIM,1865,42,na,1907,24
STAT,1901,23,na,1924,32.991133190349984
STAT,1870,30,20-24,1900,0.02706771614611436
STAT,1808,98,na,1906,0.004743613191696761
STAT,1902,34,25-29,1936,0.08222728371462441
STAT,1882,48,20-24,1930,1.1355626319153048E-4
STAT,1885,19,20-24,1904,0.17413299840101704
STAT,1827,41,50-100,1868,0.008379664275875852
SIM,1909,15,na,1924,41
STAT,1854,41,25-29,1895,0.003942848775014703
STAT,1848,26,40-44,1874,0.023294122380979214
STAT,1909,26,na,1935,35.71114414023944
STAT,1937,21,na,1958,35.34859415459406
STAT,1836,29,50-100,1865,0.007874088040174268
STAT,1854,45,40-44,1899,0.0010568668562544632
STAT,1864,31,40-44,1895,0.03905596041154865
STAT,1861,47,40-44,1908,0.0014330038210437401
STAT,1863,38,50-100,1901,0.010816487906860546
STAT,1881,15,na,1896,24.14389665866101
STAT,1911,30,na,1941,36.8850382332968
SIM,1901,36,40-44,1937,2
SIM,1884,63,na,1947,17
STAT,1874,0,na,1874,37.38416560266238
STAT,1905,43,40-44,1948,0.002237976867350637
SIM,1957,10,na,1967,56
STAT,1847,34,na,1881,26.676699575456066
STAT,1890,24,45-49,1914,0.008417359259671527
STAT,1883,25,15-19,1908,0.004435711802337184
STAT,1924,44,20-24,1968,2.0800355581153908E-4
STAT,1823,33,45-49,1856,0.016150543985398266
STAT,1855,12,na,1867,19.9912227040625
SIM,1892,41,na,1933,36
STAT,1878,26,na,1904,24.72343898918057
STAT,1858,100,na,1958,0.013233931558575628
STAT,1904,32,35-39,1936,0.08332204373242455
STAT,1880,35,40-44,1915,0.04646893555529761
SIM,1874,56,na,1930,25
STAT,1932,35,15-19,1967,2.574171085493807E-4
SIM,1869,4,na,1873,19
STAT,1820,42,25-29,1862,0.005674902340489019
STAT,1893,48,30-34,1941,6.798293841989755E-4
STAT,1915,32,45-49,1947,0.015887846949337932
STAT,1848,49,30-34,1897,6.129348544090527E-4
SIM,1892,4,na,1896,36
SIM,1905,56,na,1961,40
STAT,1805,87,na,1892,0.4823863614142284
STAT,1862,36,35-39,1898,0.06131637021014024
STAT,1937,24,45-49,1961,0.010880424527847474
STAT,1831,42,35-39,1873,0.017936311131989836
SIM,1898,69,na,1967,19
STAT,1861,30,45-49,1891,0.014782646496091996
STAT,1840,44,35-39,1884,0.014427140112895039
STAT,1927,35,40-44,1962,0.01854909318475347
SIM,1834,87,na,1921,3
SIM,1812,58,na,1870,18
STAT,1875,34,20-24,1909,0.02754798900918042
STAT,1906,30,45-49,1936,0.01466401654577083
STAT,1912,19,50-100,1931,7.476393057066128E-4
STAT,1849,12,na,1861,22.7848696053666
STAT,1848,19,na,1867,18.185966251825523
SIM,1889,55,na,1944,24
STAT,1846,40,20-24,1886,0.001336456378858752
STAT,1930,22,35-39,1952,0.12005995548624133
SIM,1893,77,na,1970,21
STAT,1916,35,30-34,1951,0.018680375782300508
SIM,1890,63,na,1953,21
STAT,1852,47,30-34,1899,8.245987408949602E-4
STAT,1911,31,30-34,1942,0.1530520781926524
STAT,1917,45,25-29,1962,5.516107633921436E-4
STAT,1857,78,na,1935,5.849119421391792
STAT,1940,27,20-24,1967,0.18481890789425084
STAT,1867,85,na,1952,2.623358385988963
STAT,1845,28,50-100,1873,0.004518733676324123
SIM,1941,18,na,1959,44
STAT,1879,45,45-49,1924,0.0024669755082695065
STAT,1874,41,45-49,1915,0.01525198679029747
STAT,1897,30,25-29,1927,0.13711054265989492
SIM,1858,60,na,1918,23
STAT,1812,80,na,1892,2.4583991091041826
STAT,1895,46,40-44,1941,0.0012572984010477209
SIM,1919,34,45-49,1953,1
SIM,1900,64,na,1964,23
STAT,1851,36,25-29,1887,0.024823802961226868
SIM,1856,34,na,1890,12
SIM,1820,36,na,1856,15
STAT,1914,8,na,1922,40.7814118233102
STAT,1902,5,na,1907,36.95589448091501
STAT,1832,35,na,1867,12.402200453037775
STAT,1920,33,30-34,1953,0.170382339784923
STAT,1960,10,na,1970,50.87879943865845
SIM,1830,43,na,1873,18
STAT,1908,43,25-29,1951,6.532995051065053E-4
SIM,1870,49,na,1919,21
STAT,1843,45,30-34,1888,4.193128094641823E-4
STAT,1950,16,25-29,1966,0.5093699786360986
STAT,1907,28,15-19,1935,0.006613180339593742
STAT,1857,53,45-49,1910,1.0689674843188201E-4
STAT,1814,54,35-39,1868,2.2723928499883905E-4
STAT,1864,7,na,1871,25.236688171820088
STAT,1866,24,35-39,1890,0.053407250093168254
STAT,1797,64,na,1861,7.305764954588329
STAT,1781,80,na,1861,3.6053790783900244
STAT,1836,46,35-39,1882,0.0014322079126682893
STAT,1901,24,50-100,1925,0.005670363658899174
STAT,1818,42,50-100,1860,0.011359094941706503
STAT,1892,21,50-100,1913,0.005053083666762267
STAT,1842,79,na,1921,5.245239533129648
STAT,1895,18,na,1913,32.70290702176836
SIM,1935,18,na,1953,53
SIM,1845,42,na,1887,23
SIM,1885,48,na,1933,22
STAT,1938,25,50-100,1963,0.009804508490084607
STAT,1881,45,35-39,1926,0.0013454418849793521
STAT,1917,18,30-34,1935,0.02592280268144264
STAT,1850,20,na,1870,23.181058560807365
STAT,1902,16,20-24,1918,0.25061940046388775
STAT,1904,24,30-34,1928,0.2536327581274061
SIM,1859,79,na,1938,3
STAT,1840,44,45-49,1884,0.011924051929116237
STAT,1917,38,na,1955,38.52952222913354
STAT,1843,12,na,1855,12.94098
STAT,1841,37,15-19,1878,6.47594802545821E-4
STAT,1883,47,20-24,1930,1.1598651223677642E-4
STAT,1884,10,na,1894,25.37876951167646
STAT,1934,36,35-39,1970,0.03326685471998341
STAT,1886,1,na,1887,32.49914676623934
STAT,1913,24,na,1937,36.338598305419595
STAT,1929,32,35-39,1961,0.11552267458616117
SIM,1855,65,na,1920,10
SIM,1901,32,30-34,1933,1
STAT,1907,24,50-100,1931,0.005927618864698749
STAT,1836,33,15-19,1869,0.001719257982684696
STAT,1898,18,na,1916,33.98118396653224
STAT,1827,97,na,1924,0.03255673690963846
STAT,1869,3,na,1872,30.499823108226654
STAT,1839,20,35-39,1859,0.041978266748007476
SIM,1851,51,na,1902,15
SIM,1924,18,15-19,1942,1
STAT,1835,40,45-49,1875,0.008336479177420843
STAT,1909,19,na,1928,37.461105311261136
STAT,1839,28,45-49,1867,0.007663569864034513
STAT,1916,45,30-34,1961,9.10800826207229E-4
STAT,1865,23,40-44,1888,0.01893992585764081
STAT,1848,26,45-49,1874,0.008633945950202535
STAT,1906,32,40-44,1938,0.036177188164681656
STAT,1859,36,50-100,1895,0.00980527409050692
STAT,1902,38,40-44,1940,0.013257997970500649
STAT,1822,66,na,1888,5.840452766379065
SIM,1842,15,na,1857,30
STAT,1854,17,30-34,1871,0.011654101034256544
STAT,1871,67,na,1938,15.804627437619548
STAT,1856,25,40-44,1881,0.022813489058503396
STAT,1788,89,na,1877,0.44752388413053695
STAT,1805,70,na,1875,5.578161553576122
STAT,1872,25,na,1897,24.583855753300437
SIM,1881,1,na,1882,32
STAT,1846,36,50-100,1882,0.010499021170251185
STAT,1845,31,15-19,1876,0.001000108768404554
STAT,1898,42,35-39,1940,0.0016942345916406655
SIM,1846,29,na,1875,15
STAT,1792,94,na,1886,0.08763929402671604
STAT,1846,18,35-39,1864,0.005553293197827578
STAT,1925,38,35-39,1963,0.028819501682094503
STAT,1943,4,na,1947,42.12305448019971
STAT,1872,47,45-49,1919,0.002403424311759382
STAT,1926,6,na,1932,48.85998390823223
STAT,1784,75,na,1859,5.603032585197335
STAT,1809,84,na,1893,1.8406649634055694
STAT,1955,2,na,1957,51.94617526560852
SIM,1930,40,na,1970,49
STAT,1915,25,45-49,1940,0.017587605457279918
STAT,1863,48,na,1911,19.669740552643756
STAT,1972,0,na,1972,50.383729825895216
STAT,1913,17,35-39,1930,0.008507609907236884
SIM,1806,64,na,1870,6
STAT,1838,41,25-29,1879,0.005903916330360583
STAT,1839,82,na,1921,2.57486394083839
STAT,1863,15,30-34,1878,0.016294598030350178
STAT,1932,28,25-29,1960,0.8582062782770604
STAT,1857,42,50-100,1899,0.007898946845281658
STAT,1798,83,na,1881,2.483735876409333
SIM,1940,28,25-29,1968,3
STAT,1927,37,30-34,1964,0.022544333413770185
SIM,1896,63,na,1959,22
STAT,1814,54,45-49,1868,3.8306050846402176E-4
STAT,1844,42,50-100,1886,0.00845131568776306
STAT,1932,22,40-44,1954,0.04393847781551157
STAT,1810,46,50-100,1856,0.00242665826078682
SIM,1858,14,na,1872,27
SIM,1814,83,na,1897,7
STAT,1877,24,na,1901,24.260643142897877
STAT,1905,25,50-100,1930,0.009294940084276076
STAT,1920,34,40-44,1954,0.04213575075535634
STAT,1888,20,30-34,1908,0.20939595546581738
STAT,1897,48,50-100,1945,0.0018166178532517988
STAT,1928,38,50-100,1966,0.005274814843284054
STAT,1892,29,na,1921,29.272567939729868
STAT,1903,37,45-49,1940,0.006117385065669109
STAT,1894,48,35-39,1942,9.993773774604716E-4
SIM,1884,78,na,1962,10
SIM,1955,16,na,1971,44
STAT,1875,48,25-29,1923,5.84654992818712E-4
STAT,1881,61,na,1942,17.780879140635555
STAT,1831,46,45-49,1877,0.002288586332179273
STAT,1885,75,na,1960,11.721146850374012
STAT,1837,25,30-34,1862,0.16193002228148648
STAT,1874,35,50-100,1909,0.01257363476933988
STAT,1879,42,25-29,1921,0.006638206717451245
SIM,1829,33,na,1862,19
STAT,1888,23,50-100,1911,0.0047507055149142476
STAT,1912,30,15-19,1942,0.0012646690871317636
STAT,1826,28,50-100,1854,0.021824964818486135
STAT,1871,21,15-19,1892,0.032990582982757734
SIM,1910,16,20-24,1926,1
STAT,1902,25,35-39,1927,0.13699102998163323
STAT,1859,26,20-24,1885,0.09553900200859469
STAT,1909,28,25-29,1937,0.6233082556265417
SIM,1867,50,na,1917,11
STAT,1929,26,50-100,1955,0.01240310619252285
SIM,1937,32,35-39,1969,1
STAT,1822,50,na,1872,8.904346420499154
STAT,1873,47,50-100,1920,0.0024853559479250894
STAT,1877,34,15-19,1911,0.001457433244237607
STAT,1929,23,na,1952,45.817187824297264
STAT,1900,17,25-29,1917,0.07857950270232465
STAT,1818,45,na,1863,7.188600999041123
STAT,1816,40,35-39,1856,0.02602388833347196
SIM,1846,9,na,1855,18
STAT,1875,46,50-100,1921,0.0025317938400386555
SIM,1887,11,na,1898,26
SIM,1837,52,na,1889,29
STAT,1914,37,20-24,1951,0.00261016725086349
STAT,1882,15,40-44,1897,0.0017609840337013383
SIM,1916,25,na,1941,42
STAT,1824,34,50-100,1858,0.014046535536950882
SIM,1912,11,na,1923,40
STAT,1899,21,45-49,1920,0.009574689311424358
STAT,1945,20,25-29,1965,1.00578276468545
STAT,1803,53,30-34,1856,1.1386354666330401E-4
STAT,1865,18,45-49,1883,6.05257364598154E-4
SIM,1875,5,na,1880,21
STAT,1825,49,25-29,1874,5.1746344015203E-4
STAT,1840,79,na,1919,5.478127451785751
STAT,1857,41,35-39,1898,0.013617234707902165
STAT,1886,32,15-19,1918,0.0014771468272302118
STAT,1843,44,na,1887,9.839091757123086
STAT,1827,81,na,1908,3.2771283938215725
STAT,1871,35,35-39,1906,0.07118676125797273
STAT,1869,23,25-29,1892,0.5529624810176509
STAT,1860,37,25-29,1897,0.0234070872851638
SIM,1808,71,na,1879,1
STAT,1842,86,na,1928,1.664690300377151
STAT,1919,38,35-39,1957,0.025733517948013308
STAT,1844,15,20-24,1859,0.17811968122121635
SIM,1901,27,35-39,1928,1
SIM,1941,24,na,1965,45
STAT,1864,50,50-100,1914,1.3740663363054158E-4
SIM,1785,69,na,1854,9
SIM,1937,19,na,1956,41
SIM,1826,84,na,1910,4
STAT,1944,0,na,1944,47.65215904137864
STAT,1910,27,35-39,1937,0.14409288041833423
STAT,1912,32,40-44,1944,0.03820564865280567
SIM,1900,26,na,1926,33
STAT,1926,25,20-24,1951,0.21904735081410226
STAT,1889,24,40-44,1913,0.025353018054419703
STAT,1882,49,50-100,1931,0.002304549020278577
STAT,1883,42,50-100,1925,0.010246377931291782
STAT,1917,27,20-24,1944,0.1896921543796379
STAT,1919,41,50-100,1960,0.0012638891165249607
SIM,1859,3,na,1862,26
STAT,1887,19,35-39,1906,0.005957083897780156
STAT,1819,41,15-19,1860,1.333603820385232E-4
STAT,1858,20,45-49,1878,0.00617652878044634
STAT,1855,38,50-100,1893,0.008601291164359686
STAT,1882,38,15-19,1920,5.354845074225804E-4
STAT,1914,21,35-39,1935,0.09182279284858433
SIM,1928,4,na,1932,55
STAT,1919,30,25-29,1949,0.09964729231720977
STAT,1868,19,25-29,1887,0.05517664459637274
SIM,1880,32,na,1912,31
SIM,1884,46,na,1930,22
STAT,1918,48,45-49,1966,0.0022855194505345612
STAT,1943,25,20-24,1968,0.19315762748477155
SIM,1876,27,na,1903,29
STAT,1821,44,35-39,1865,0.026416382784442558
STAT,1934,27,20-24,1961,0.24451966550083315
STAT,1903,42,40-44,1945,0.0022179325904609594
STAT,1902,40,na,1942,33.03536421728132
SIM,1945,2,na,1947,42
STAT,1908,35,50-100,1943,0.0039476988892277525
STAT,1923,24,40-44,1947,0.03860826729751477
STAT,1881,45,45-49,1926,0.002268030602946208
STAT,1834,67,na,1901,11.202662528795043
SIM,1893,39,na,1932,35
STAT,1839,33,40-44,1872,0.029147390762583224
SIM,1817,48,na,1865,7
STAT,1903,31,50-100,1934,0.013079801813666966
STAT,1908,24,15-19,1932,0.04837882870327812
STAT,1869,32,15-19,1901,0.0013798469100001784
STAT,1828,27,50-100,1855,0.010026681339035871
STAT,1906,54,na,1960,31.35802937876364
STAT,1843,31,50-100,1874,0.004721276172259657
SIM,1800,75,na,1875,8
SIM,1825,67,na,1892,9
STAT,1906,35,20-24,1941,0.002440165449902121
SIM,1821,53,na,1874,11
STAT,1885,41,50-100,1926,0.010479823962646236
STAT,1838,45,50-100,1883,0.0020120062518653643
STAT,1917,49,40-44,1966,0.0016222646454554699
STAT,1895,18,30-34,1913,0.02063827911519685
STAT,1923,35,20-24,1958,0.0030385061818688063
STAT,1811,105,na,1916,1.6616353623595005E-4
STAT,1888,46,50-100,1934,0.0028782254442895577
STAT,1901,39,na,1940,32.8921767181257
STAT,1834,51,na,1885,15.913960827896455
STAT,1914,27,50-100,1941,0.009950959685295978
STAT,1801,88,na,1889,0.47042329017524465
STAT,1851,47,25-29,1898,4.840099525519894E-4
STAT,1864,31,25-29,1895,0.09224369386313266
STAT,1860,99,na,1959,0.02871544124574739
STAT,1832,25,50-100,1857,0.003882532131418906
STAT,1908,46,35-39,1954,0.0011686910914094422
STAT,1895,22,15-19,1917,0.042829752039630006
STAT,1819,62,na,1881,10.151340783337988
STAT,1899,19,50-100,1918,6.670696561553539E-4
STAT,1903,32,15-19,1935,0.0020246571475625373
STAT,1855,47,45-49,1902,0.0016538582813993917
STAT,1881,45,na,1926,21.62164291592903
STAT,1938,16,na,1954,36.15778760483249
STAT,1879,21,50-100,1900,0.004233414086304934
STAT,1885,59,na,1944,19.191996267917858
SIM,1869,57,na,1926,13
SIM,1917,42,na,1959,34
STAT,1828,27,30-34,1855,0.3947067195359732
STAT,1835,40,50-100,1875,0.005884573520139949
SIM,1865,43,na,1908,22
STAT,1868,38,50-100,1906,0.011822491069190796
SIM,1842,31,na,1873,24
STAT,1928,16,40-44,1944,0.01758111132994361
STAT,1875,20,45-49,1895,0.007210831228445407
STAT,1942,21,na,1963,38.02246798279996
SIM,1905,41,na,1946,40
STAT,1938,33,50-100,1971,0.008253517015278723
SIM,1846,45,na,1891,14
STAT,1865,38,15-19,1903,5.053916654288962E-4
STAT,1928,39,15-19,1967,2.4098954213154044E-4
STAT,1914,34,40-44,1948,0.0387306416214422
STAT,1874,16,45-49,1890,6.643187811888288E-4
STAT,1938,30,35-39,1968,0.09138418638956167
STAT,1915,20,50-100,1935,0.006509088689125509
STAT,1920,32,15-19,1952,0.001395588432888597
STAT,1876,41,45-49,1917,0.015269341321653017
STAT,1908,37,20-24,1945,0.002455278729606229
STAT,1834,47,25-29,1881,4.3168702317654395E-4
STAT,1890,35,45-49,1925,0.024444912990577425
STAT,1952,15,20-24,1967,1.615945077137751
STAT,1798,67,na,1865,13.520588211956294
STAT,1930,17,35-39,1947,0.05399583346218353
STAT,1862,45,35-39,1907,0.0012199124352144728
STAT,1809,50,45-49,1859,4.939470385540441E-4
SIM,1796,69,na,1865,7
SIM,1860,12,na,1872,28
SIM,1900,10,na,1910,40
STAT,1915,28,25-29,1943,0.6632118059012272
STAT,1890,5,na,1895,31.832971978976772
STAT,1853,33,15-19,1886,9.121494190098482E-4
SIM,1830,46,na,1876,19
STAT,1917,54,na,1971,37.03195644779636
STAT,1891,28,15-19,1919,0.00554897931766656
STAT,1879,63,na,1942,18.467727383458676
STAT,1913,40,na,1953,36.321842597831356
SIM,1945,22,na,1967,36
STAT,1838,65,na,1903,13.116587284465224
SIM,1905,4,na,1909,40
SIM,1864,26,na,1890,22
SIM,1934,0,na,1934,59
STAT,1886,24,15-19,1910,0.03400544383477651
STAT,1931,37,20-24,1968,0.0034757005290590856
STAT,1898,30,40-44,1928,0.05897259323350402
SIM,1926,19,na,1945,43
SIM,1907,1,na,1908,41
STAT,1920,46,35-39,1966,0.0014165883549072924
STAT,1892,44,50-100,1936,8.94088412709673E-4
STAT,1855,41,25-29,1896,0.004541691363989446
STAT,1824,37,15-19,1861,8.17622954545841E-4
SIM,1920,26,30-34,1946,1
STAT,1947,20,35-39,1967,0.10576319956729557
SIM,1786,70,na,1856,19
STAT,1813,73,na,1886,8.334527371860736
STAT,1912,26,30-34,1938,0.38442243745916893
STAT,1902,19,25-29,1921,0.07948289928187989
STAT,1843,71,na,1914,5.662138497768922
STAT,1849,30,45-49,1879,0.015985959254689954
STAT,1868,15,50-100,1883,4.884377352939961E-4
STAT,1892,21,35-39,1913,0.07230961880801018
STAT,1931,21,na,1952,47.295589391340606
STAT,1847,22,35-39,1869,0.07641878683336834
STAT,1897,44,na,1941,30.382512008592883
STAT,1893,30,na,1923,30.330311047363708
STAT,1782,106,na,1888,1.0112748701012394E-4
STAT,1910,32,30-34,1942,0.150985342248164
STAT,1954,18,35-39,1972,0.051561662276985526
STAT,1886,46,35-39,1932,0.001456295827766085
STAT,1825,30,35-39,1855,0.14829834648717377
STAT,1921,25,45-49,1946,0.019233729321542187
SIM,1872,77,na,1949,8
SIM,1821,37,na,1858,14
STAT,1879,44,50-100,1923,0.010786789038841815
STAT,1869,20,45-49,1889,0.0068260473136398285
STAT,1930,36,na,1966,48.887833148213176
STAT,1937,8,na,1945,38.555797463858255
STAT,1871,99,na,1970,0.12899344232019494
STAT,1827,43,15-19,1870,1.065261914994412E-4
STAT,1903,34,40-44,1937,0.03510007786510296
STAT,1925,35,30-34,1960,0.021775641127626803
SIM,1880,48,na,1928,30
STAT,1888,23,35-39,1911,0.06798258796151505
STAT,1814,90,na,1904,0.35133079265612416
SIM,1847,46,na,1893,15
STAT,1922,18,15-19,1940,0.5200143665395617
STAT,1928,20,25-29,1948,1.1544877087610177
STAT,1894,34,15-19,1928,0.00180945954582564
STAT,1814,51,40-44,1865,2.950348281592024E-4
STAT,1901,55,na,1956,29.14179012876933
STAT,1928,28,35-39,1956,0.18397287850801783
STAT,1923,27,45-49,1950,0.019697493473264115
STAT,1841,27,50-100,1868,0.0077769657562361625
STAT,1877,50,50-100,1927,1.581401473686779E-4
STAT,1856,94,na,1950,0.14478581206422478
STAT,1925,33,50-100,1958,0.009750645102494867
STAT,1881,42,40-44,1923,0.02137648623268618
STAT,1943,17,20-24,1960,1.4272028468372517
STAT,1875,45,20-24,1920,1.2458284184776108E-4
STAT,1853,47,35-39,1900,8.757716846307876E-4
STAT,1916,48,35-39,1964,0.0013074582611191663
STAT,1885,16,20-24,1901,0.17550185250463599
STAT,1945,25,30-34,1970,0.42715697466669866
STAT,1904,27,35-39,1931,0.13825859682292796
SIM,1887,27,na,1914,24
STAT,1896,42,25-29,1938,5.850200471782314E-4
STAT,1856,33,40-44,1889,0.031472757565901816
STAT,1908,38,35-39,1946,0.022416661157143386
STAT,1888,32,25-29,1920,0.11969487265618055
STAT,1943,22,na,1965,38.5695061825842
STAT,1848,23,40-44,1871,0.01629058122401307
STAT,1868,47,na,1915,21.671222840765125
SIM,1951,17,20-24,1968,5
STAT,1870,44,30-34,1914,0.011266515321319658
SIM,1863,7,na,1870,22
STAT,1924,22,50-100,1946,0.007713759721509108
STAT,1872,36,50-100,1908,0.012622359240996828
SIM,1932,8,na,1940,54
STAT,1830,34,35-39,1864,0.06239615917045074
STAT,1852,40,45-49,1892,0.012938215301707195
SIM,1857,29,na,1886,19
STAT,1941,18,25-29,1959,0.4429810385311821
SIM,1853,15,na,1868,28
STAT,1872,84,na,1956,3.6909242640126836
STAT,1842,38,50-100,1880,0.010694155527346772
STAT,1941,15,45-49,1956,0.005110751549843588
STAT,1879,30,30-34,1909,0.18216239219769131
SIM,1877,20,20-24,1897,2
STAT,1901,46,25-29,1947,4.55930044118704E-4
SIM,1892,3,na,1895,36
STAT,1860,34,20-24,1894,0.02178698760142333
SIM,1905,57,na,1962,40
STAT,1843,28,na,1871,11.212180121295987
SIM,1836,22,25-29,1858,3
SIM,1888,12,na,1900,39
STAT,1932,2,na,1934,53.93646353102917
STAT,1845,45,35-39,1890,8.265271522201492E-4
STAT,1804,54,50-100,1858,3.985652003510714E-4
STAT,1858,53,50-100,1911,1.1307834854164496E-4
STAT,1789,101,na,1890,8.980286051685045E-4
STAT,1934,28,35-39,1962,0.20101692510256397
SIM,1908,22,na,1930,41
STAT,1876,18,20-24,1894,0.17958732115748827
STAT,1816,97,na,1913,0.01612842939701516
STAT,1855,13,na,1868,19.900462552986056
STAT,1859,27,na,1886,19.295904615929178
SIM,1839,59,na,1898,19
STAT,1840,30,25-29,1870,0.09980768086084668
STAT,1917,22,15-19,1939,0.056061335828038
STAT,1851,39,25-29,1890,0.024062432706230968
STAT,1821,41,30-34,1862,0.018547825496209657
STAT,1869,20,20-24,1889,0.6745810860988417
STAT,1937,17,45-49,1954,0.00482904050073481
SIM,1805,79,na,1884,3
SIM,1835,45,na,1880,17
STAT,1870,77,na,1947,8.586772891727339
SIM,1831,31,na,1862,10
STAT,1868,16,20-24,1884,0.17570831688947286
STAT,1880,44,na,1924,23.975856034732903
STAT,1848,40,50-100,1888,0.0070007654215851495
STAT,1833,40,35-39,1873,0.016666526904072373
STAT,1877,56,na,1933,21.054347653589797
STAT,1783,100,na,1883,0.0011390247964493496
STAT,1867,62,na,1929,17.490666195277253
STAT,1889,27,45-49,1916,0.013593793101508087
SIM,1860,28,na,1888,23
STAT,1860,83,na,1943,3.227395927427191
SIM,1840,20,25-29,1860,1
STAT,1850,27,15-19,1877,0.004753811407117706
STAT,1925,43,30-34,1968,0.0015357004985043386
STAT,1897,26,40-44,1923,0.03991626611100931
STAT,1862,42,30-34,1904,0.009906719056735314
STAT,1830,31,50-100,1861,0.006240461829088376
STAT,1896,59,na,1955,25.528101185485106
STAT,1903,45,45-49,1948,0.0019115321948902661
STAT,1823,51,na,1874,14.144075114548835
STAT,1834,44,20-24,1878,0.0013187624642344272
STAT,1827,65,na,1892,10.24147126586662
STAT,1812,46,35-39,1858,0.001593475660201814
STAT,1892,45,na,1937,28.07702549588063
STAT,1869,28,30-34,1897,0.2431389796627934
SIM,1881,21,25-29,1902,3
STAT,1821,49,40-44,1870,0.0023481755617229907
STAT,1886,76,na,1962,12.026295427276198
SIM,1847,30,na,1877,18
SIM,1818,49,na,1867,24
SIM,1914,18,na,1932,37
STAT,1881,29,na,1910,22.546501170258534
STAT,1943,28,25-29,1971,0.6955504659178575
STAT,1878,17,40-44,1895,0.0018883232786066682
STAT,1882,62,na,1944,17.515947691047295
SIM,1857,13,na,1870,23
STAT,1916,18,15-19,1934,0.09521422735639173
STAT,1851,20,35-39,1871,0.059685944422403214
SIM,1850,34,na,1884,21
SIM,1896,8,na,1904,33
STAT,1889,41,na,1930,28.42527939274252
SIM,1923,28,25-29,1951,1
STAT,1914,30,25-29,1944,0.0930069248794173
SIM,1884,62,na,1946,18
STAT,1936,29,50-100,1965,0.00945870546349105
STAT,1869,49,50-100,1918,0.002330033336795386
STAT,1919,35,30-34,1954,0.019518533892231675
STAT,1814,40,25-29,1854,0.02205429052274653
STAT,1935,18,25-29,1953,0.5882468031875626
SIM,1859,31,na,1890,21
STAT,1923,38,25-29,1961,0.01131805415723583
STAT,1899,20,30-34,1919,0.24529321185993555
STAT,1840,41,40-44,1881,0.018622644639355677
SIM,1878,93,na,1971,2
SIM,1886,26,30-34,1912,1
STAT,1832,39,15-19,1871,3.1212609022919095E-4
SIM,1806,48,na,1854,10
STAT,1831,86,na,1917,1.8005112728057833
STAT,1769,86,na,1855,3.2372
STAT,1902,24,na,1926,33.1428128745556
STAT,1922,40,25-29,1962,8.158905503287928E-4
STAT,1936,22,25-29,1958,0.877756305813642
STAT,1878,26,30-34,1904,0.26087454400355387
STAT,1828,82,na,1910,3.133609411847053
STAT,1845,23,15-19,1868,0.023768454641929896
SIM,1817,64,na,1881,4
STAT,1848,59,na,1907,12.568377998646346
STAT,1867,15,15-19,1882,0.058747767647322764
STAT,1861,40,50-100,1901,0.00897393616999625
STAT,1918,45,40-44,1963,0.0016704171476599728
STAT,1927,45,30-34,1972,0.001118530613422063
STAT,1910,24,30-34,1934,0.26657943871701645
SIM,1820,68,na,1888,8
STAT,1869,36,30-34,1905,0.05188903410184275
STAT,1840,47,na,1887,17.777999285805645
STAT,1920,43,30-34,1963,0.001397747086426836
SIM,1948,19,15-19,1967,1
SIM,1856,66,na,1922,8
STAT,1838,81,na,1919,4.197125540274866
STAT,1860,29,25-29,1889,0.3426103917737311
SIM,1938,20,35-39,1958,2
STAT,1881,31,25-29,1912,0.09786112400496437
STAT,1890,32,40-44,1922,0.052678220945576365
STAT,1926,39,40-44,1965,0.01815185876957543
STAT,1859,2,na,1861,27.630809163421297
STAT,1917,38,25-29,1955,0.010083583002180357
STAT,1910,35,35-39,1945,0.023209867506329803
STAT,1866,30,45-49,1896,0.016189375527146076
SIM,1837,84,na,1921,2
SIM,1882,41,35-39,1923,1
STAT,1830,31,30-34,1861,0.1189164843570328
STAT,1839,50,na,1889,12.178053144337216
STAT,1874,32,na,1906,24.208920587216504
STAT,1940,20,25-29,1960,0.9349271118985184
SIM,1925,33,30-34,1958,1
STAT,1863,40,20-24,1903,0.0014203151193639871
STAT,1771,89,na,1860,0.5619364946465009
SIM,1801,60,na,1861,9
STAT,1917,33,30-34,1950,0.16279174438588123
STAT,1891,16,45-49,1907,8.037138761886387E-4
STAT,1902,17,35-39,1919,0.007737823078416784
STAT,1903,62,na,1965,28.192225839893567
STAT,1878,15,15-19,1893,0.06155401018530477
SIM,1807,86,na,1893,1
STAT,1926,17,20-24,1943,1.6527203630229585
SIM,1887,43,na,1930,24
STAT,1823,41,40-44,1864,0.016068905601501347
STAT,1921,27,35-39,1948,0.16602159343183395
STAT,1916,5,na,1921,42.15610350293618
STAT,1936,31,15-19,1967,0.001241354221374885
STAT,1823,67,na,1890,9.116399014327543
STAT,1867,38,25-29,1905,0.027416119714762353
SIM,1911,5,na,1916,42
STAT,1953,5,na,1958,47.28769753908536
STAT,1822,82,na,1904,1.6550407175704376
STAT,1826,96,na,1922,0.06000501307595613
STAT,1837,21,15-19,1858,0.024062490558147707
STAT,1908,45,20-24,1953,1.008857793852314E-4
STAT,1783,74,na,1857,2.257509767092479
STAT,1914,37,45-49,1951,0.006750134559511978
STAT,1866,31,35-39,1897,0.09364956353866959
STAT,1965,3,na,1968,48.79637633045421
STAT,1835,25,20-24,1860,0.07234370448654888
STAT,1901,30,15-19,1931,0.0020086837572917543
STAT,1862,27,30-34,1889,0.21806144847772202
SIM,1932,18,25-29,1950,1
STAT,1874,28,15-19,1902,0.00458657152298446
STAT,1914,25,na,1939,37.70603599291616
STAT,1918,39,na,1957,39.2118984097178
SIM,1828,48,na,1876,13
STAT,1851,63,na,1914,15.063648014769354
STAT,1920,30,25-29,1950,0.10118388028644675
STAT,1927,33,15-19,1960,0.0015717119889755186
STAT,1855,77,na,1932,6.085924203708686
SIM,1847,14,na,1861,25
STAT,1789,74,na,1863,2.840192166157008
STAT,1864,42,40-44,1906,0.02014943188080841
STAT,1904,15,40-44,1919,0.002632977507578895
SIM,1854,2,na,1856,24
STAT,1847,58,na,1905,21.125428106715923
STAT,1929,41,25-29,1970,9.216808814260046E-4
STAT,1881,0,na,1881,34.099725556981056
STAT,1924,18,25-29,1942,0.5113504243952383
STAT,1876,26,20-24,1902,0.11955887795356361
STAT,1907,16,20-24,1923,0.259961274217016
STAT,1874,41,35-39,1915,0.018453672604892345
SIM,1820,52,na,1872,14
STAT,1832,24,40-44,1856,0.01253296205844169
STAT,1807,50,35-39,1857,1.8356052970618767E-4
STAT,1853,44,30-34,1897,0.007127918874918701
STAT,1886,43,30-34,1929,0.011838976870085512
STAT,1928,24,40-44,1952,0.041513957505092014
STAT,1922,18,50-100,1940,0.0042929080460506865
STAT,1830,39,40-44,1869,0.024557916858888883
STAT,1934,35,20-24,1969,0.0036285943741837896
STAT,1873,20,35-39,1893,0.05968288531985608
STAT,1922,47,20-24,1969,1.2602669340576296E-4
STAT,1940,27,45-49,1967,0.017491869108541266
STAT,1899,26,15-19,1925,0.006232200760496123
STAT,1857,79,na,1936,5.233558093484519
STAT,1937,18,35-39,1955,0.04045767017867535
SIM,1872,13,na,1885,26
SIM,1896,36,40-44,1932,1
STAT,1926,16,30-34,1942,0.1489514341396098
STAT,1869,80,na,1949,5.99383556216665
STAT,1915,17,45-49,1932,0.0010364836695349899
STAT,1856,36,45-49,1892,0.014510990134297878
SIM,1927,20,na,1947,48
STAT,1833,27,15-19,1860,0.004427172437058646
STAT,1910,26,20-24,1936,0.17579358057076958
STAT,1880,18,50-100,1898,5.138258565577056E-4
STAT,1905,18,15-19,1923,0.08542548827922072
STAT,1880,76,na,1956,10.366670657696554
STAT,1873,10,na,1883,27.00545449744167
STAT,1826,37,25-29,1863,0.03330747006250806
SIM,1870,70,na,1940,13
STAT,1861,15,20-24,1876,0.17339724093903314
STAT,1849,65,na,1914,13.103822305051876
SIM,1866,65,na,1931,26
SIM,1911,10,na,1921,42
SIM,1874,84,na,1958,10
STAT,1863,29,50-100,1892,0.005623340746160873
STAT,1918,47,30-34,1965,9.400637289457583E-4
STAT,1925,24,15-19,1949,0.06292295530132529
SIM,1882,2,na,1884,39
STAT,1901,43,20-24,1944,1.5320087891506853E-4
STAT,1921,20,15-19,1941,0.060011551561134184
SIM,1898,0,na,1898,38
STAT,1832,71,na,1903,6.033416534103943
SIM,1919,49,na,1968,43
STAT,1884,9,na,1893,25.420968319086146
STAT,1877,83,na,1960,5.64970530864836
STAT,1836,37,30-34,1873,0.06313354299638982
SIM,1935,23,na,1958,53
SIM,1862,51,na,1913,23
STAT,1810,49,40-44,1859,0.0016265775093891853
SIM,1915,35,na,1950,38
STAT,1911,28,40-44,1939,0.04500324913820047
STAT,1894,45,30-34,1939,7.067675856061905E-4
STAT,1949,20,45-49,1969,0.013054442548131637
STAT,1848,18,45-49,1866,5.205930765616438E-4
STAT,1867,51,45-49,1918,1.3954255789930877E-4
STAT,1857,95,na,1952,0.09953146854172483
STAT,1808,49,25-29,1857,4.0407125945286554E-4
STAT,1841,85,na,1926,2.683268504410102
STAT,1936,30,25-29,1966,0.08933294609858863
STAT,1856,14,na,1870,20.26370402335624
STAT,1900,26,15-19,1926,0.006313001866567653
STAT,1871,25,30-34,1896,0.2527669283221201
STAT,1886,60,na,1946,19.782532265130904
STAT,1893,41,45-49,1934,0.018956183040042436
STAT,1828,38,35-39,1866,0.03144913046339182
STAT,1902,22,30-34,1924,0.25118643858281303
STAT,1785,104,na,1889,9.74908626216165E-4
SIM,1903,34,30-34,1937,1
STAT,1937,29,15-19,1966,0.006831374296387907
STAT,1888,39,45-49,1927,0.023061384091161465
STAT,1929,40,35-39,1969,0.0026025023002004648
STAT,1869,64,na,1933,16.84367435767007
STAT,1914,45,20-24,1959,1.0920361613134731E-4
STAT,1873,21,25-29,1894,0.5837690549159594
STAT,1955,17,50-100,1972,0.0049455702852777604
STAT,1945,16,40-44,1961,0.015173802252942953
STAT,1920,37,45-49,1957,0.00740051433691625
STAT,1820,86,na,1906,1.2578711850307118
STAT,1900,16,50-100,1916,6.81030081417875E-4
STAT,1888,24,na,1912,27.464893350720597
SIM,1836,30,na,1866,11
SIM,1949,7,na,1956,38
STAT,1896,75,na,1971,18.000664496716254
STAT,1901,37,35-39,1938,0.02136163166799439
SIM,1854,59,na,1913,15
STAT,1847,38,45-49,1885,0.021866440698761827
STAT,1892,61,na,1953,23.085266700226196
STAT,1826,50,45-49,1876,1.467309247312689E-4
STAT,1852,48,na,1900,19.01327948418991
STAT,1878,22,15-19,1900,0.03405970314180196
STAT,1897,22,25-29,1919,0.7601961890120496
STAT,1931,30,50-100,1961,0.010797922279417435
STAT,1892,48,25-29,1940,3.963551376172759E-4
SIM,1908,26,30-34,1934,1
STAT,1912,44,35-39,1956,0.001912010844724263
SIM,1875,58,na,1933,13
STAT,1920,18,40-44,1938,0.015518446780284023
STAT,1852,25,20-24,1877,0.11864156996060371
STAT,1853,100,na,1953,0.006672239630436076
STAT,1925,37,20-24,1962,0.003144095579592309
SIM,1954,15,na,1969,49
SIM,1917,17,20-24,1934,1
STAT,1804,53,na,1857,13.190836975128452
SIM,1966,5,na,1971,45
STAT,1871,83,na,1954,3.957961756391466
STAT,1856,21,25-29,1877,0.4851257819052472
STAT,1921,22,40-44,1943,0.03768111140693255
STAT,1912,22,15-19,1934,0.05061611524002069
STAT,1875,97,na,1972,0.3652689387527193
STAT,1852,32,na,1884,21.145785397872373
STAT,1919,26,40-44,1945,0.05009685026972105
SIM,1835,29,na,1864,21
STAT,1847,30,35-39,1877,0.1296837846495102
STAT,1847,31,25-29,1878,0.12980841210459002
STAT,1837,17,30-34,1854,0.015417115863795256
STAT,1817,37,20-24,1854,0.030805811971556393
SIM,1865,4,na,1869,25
SIM,1910,27,25-29,1937,2
STAT,1936,26,40-44,1962,0.04435725287524142
STAT,1845,42,30-34,1887,0.006843479614255128
SIM,1849,10,na,1859,19
STAT,1791,88,na,1879,0.4395153845229573
SIM,1850,66,na,1916,16
STAT,1893,28,25-29,1921,0.5314915792572542
STAT,1889,19,45-49,1908,7.954751647356441E-4
STAT,1925,46,35-39,1971,0.0015564013432271544
STAT,1888,56,na,1944,23.835122979586725
STAT,1853,70,na,1923,8.818057798811322
STAT,1902,27,25-29,1929,0.5965289893833335
SIM,1890,6,na,1896,31
STAT,1884,51,45-49,1935,1.4286596377270712E-4
STAT,1871,16,50-100,1887,4.945164924490275E-4
SIM,1906,58,na,1964,20
STAT,1805,53,40-44,1858,1.996415138124961E-4
SIM,1897,20,25-29,1917,1
STAT,1842,70,na,1912,10.526970403090637
STAT,1854,28,na,1882,15.182412055863134
STAT,1851,8,na,1859,25.205509914889138
STAT,1869,27,40-44,1896,0.02902525881958071
STAT,1877,30,20-24,1907,0.02812690801260288
STAT,1934,38,25-29,1972,0.013516058610219607
STAT,1829,38,50-100,1867,0.011151828790309331
STAT,1823,44,45-49,1867,0.01042696191553205
STAT,1934,33,30-34,1967,0.2140669923045474
STAT,1939,29,25-29,1968,0.6565009261785932
STAT,1922,31,35-39,1953,0.10291507696688083
STAT,1880,15,30-34,1895,0.016838254655937503
STAT,1927,40,25-29,1967,8.934780756736101E-4
STAT,1858,80,na,1938,4.707175597855
STAT,1848,38,15-19,1886,3.703688329569194E-4
STAT,1892,20,45-49,1912,0.008666164603212708
STAT,1909,35,na,1944,35.74702296339447
STAT,1875,21,35-39,1896,0.0601664613229808
STAT,1853,48,25-29,1901,3.5745656860287716E-4
STAT,1921,24,30-34,1945,0.3200796867480293
STAT,1868,79,na,1947,6.765558231295142
STAT,1848,43,na,1891,14.838809786237261
SIM,1946,23,na,1969,46
STAT,1828,31,15-19,1859,0.001989453195157163
STAT,1887,82,na,1969,8.898533223045423
STAT,1873,25,40-44,1898,0.03066229849039191
STAT,1865,26,45-49,1891,0.01007701459419373
STAT,1917,26,30-34,1943,0.40857703305333204
STAT,1916,30,35-39,1946,0.09429250253925427
STAT,1818,77,na,1895,2.16014059090557
STAT,1932,27,50-100,1959,0.012984236784858931
STAT,1872,44,40-44,1916,0.02270327548967955
SIM,1864,58,na,1922,17
STAT,1880,40,20-24,1920,0.0016868542879899103
STAT,1780,102,na,1882,0.0015851535475852334
STAT,1923,20,25-29,1943,1.0736815454434463
STAT,1898,45,na,1943,30.65865089311051
SIM,1901,11,na,1912,42
STAT,1894,31,na,1925,30.707749406372578
STAT,1922,17,na,1939,42.28593071924365
SIM,1873,62,na,1935,16
STAT,1930,33,50-100,1963,0.010613585086711846
STAT,1858,58,na,1916,15.048422936918222
STAT,1915,37,15-19,1952,1.923176095487348E-4
STAT,1908,43,30-34,1951,0.001169616851131004
STAT,1824,50,35-39,1874,1.119208872004971E-4
STAT,1831,43,40-44,1874,0.021994624182527213
SIM,1859,19,25-29,1878,2
STAT,1827,39,50-100,1866,0.0097628836265591
STAT,1921,38,15-19,1959,2.1253362346483701E-4
STAT,1888,31,35-39,1919,0.11882832543404206
STAT,1845,51,na,1896,12.646537409435272
SIM,1807,49,na,1856,17
STAT,1915,22,40-44,1937,0.03445616341676799
STAT,1941,20,na,1961,37.49061659301561
SIM,1868,13,na,1881,38
STAT,1802,89,na,1891,0.32083887912689024
SIM,1883,61,na,1944,6
STAT,1812,43,30-34,1855,0.013314169425349484
STAT,1939,27,20-24,1966,0.18224775526814585
STAT,1852,27,25-29,1879,0.421678184034156
STAT,1893,46,na,1939,28.453563499549038
STAT,1882,46,na,1928,21.622425403287867
STAT,1943,16,30-34,1959,0.12834746839317687
STAT,1932,38,na,1970,50.293516800483005
STAT,1938,22,35-39,1960,0.09257516538644413
STAT,1850,102,na,1952,0.0026103272037617015
STAT,1902,20,50-100,1922,0.005784917292375295
STAT,1903,30,25-29,1933,0.14679303841465674
STAT,1908,48,25-29,1956,4.7590955439184493E-4
STAT,1851,101,na,1952,0.0048173807528318485
STAT,1864,45,45-49,1909,0.0021378409734980485
STAT,1879,42,na,1921,23.892111280198364
STAT,1916,16,25-29,1932,0.09137998257767105
STAT,1949,6,na,1955,45.428560888637335
STAT,1830,85,na,1915,0.9849433544754267
STAT,1870,42,50-100,1912,0.010481751770112506
SIM,1895,46,na,1941,27
STAT,1917,35,20-24,1952,0.0027389068665157937
SIM,1891,32,na,1923,35
STAT,1876,39,na,1915,23.687553489790872
STAT,1839,36,45-49,1875,0.01328376822891684
STAT,1854,21,15-19,1875,0.023864265205119493
STAT,1797,66,na,1863,6.7807694704150325
STAT,1866,13,na,1879,24.68616050969174
STAT,1940,24,40-44,1964,0.03398586628451332
STAT,1873,27,45-49,1900,0.011288369929366302
STAT,1916,53,na,1969,36.564600266327396
SIM,1930,24,na,1954,43
SIM,1816,63,na,1879,9
STAT,1891,41,35-39,1932,0.02232583687104632
STAT,1854,25,30-34,1879,0.17989150550446745
STAT,1877,38,30-34,1915,0.054742280793252884
SIM,1841,30,na,1871,18
STAT,1832,27,45-49,1859,0.0066424221162238
STAT,1839,66,na,1905,9.04497864924204
SIM,1845,44,na,1889,23
STAT,1927,43,40-44,1970,0.003115981108448456
STAT,1873,7,na,1880,27.653222290510346
STAT,1876,17,30-34,1893,0.016188067290798743
STAT,1928,27,45-49,1955,0.021179943163586373
STAT,1849,31,35-39,1880,0.09187779160274254
STAT,1906,35,45-49,1941,0.006310494137439795
SIM,1924,17,na,1941,49
STAT,1812,47,25-29,1859,6.469284160934385E-4
STAT,1924,24,na,1948,42.5424493109165
STAT,1928,38,na,1966,47.26612407869396
SIM,1896,31,na,1927,33
STAT,1851,47,na,1898,18.905300971371435
SIM,1903,37,35-39,1940,1
STAT,1902,24,20-24,1926,0.9657111842085707
STAT,1904,20,15-19,1924,0.04755345613024662
STAT,1844,29,na,1873,20.389052995657348
STAT,1884,15,15-19,1899,0.05841402181828026
STAT,1944,23,na,1967,39.12995736316729
STAT,1912,35,45-49,1947,0.006664324511433083
SIM,1785,85,na,1870,1
SIM,1922,7,na,1929,52
STAT,1941,27,15-19,1968,0.007249903103920922
SIM,1907,21,na,1928,38
STAT,1850,40,35-39,1890,0.016285535716631154
STAT,1871,28,35-39,1899,0.09586122750360812
SIM,1877,28,na,1905,25
SIM,1858,27,30-34,1885,1
STAT,1888,36,40-44,1924,0.05140162552501095
STAT,1920,10,na,1930,44.20945695292852
STAT,1865,28,na,1893,21.509818612037606
STAT,1869,38,35-39,1907,0.06819254333659176
SIM,1847,51,na,1898,15
STAT,1870,47,35-39,1917,0.0013842602975729348
SIM,1910,24,20-24,1934,2
SIM,1938,5,na,1943,40
STAT,1889,39,15-19,1928,6.805985374326071E-4
STAT,1828,35,30-34,1863,0.024071458685557556
SIM,1932,16,20-24,1948,2
STAT,1863,32,na,1895,21.12834107591726
SIM,1826,52,na,1878,14
STAT,1897,20,20-24,1917,0.920587351762888
SIM,1939,27,25-29,1966,1
STAT,1889,40,40-44,1929,0.027816471539000454
STAT,1924,16,20-24,1940,1.6079170930778492
STAT,1834,39,25-29,1873,0.024788606733801743
STAT,1859,43,na,1902,18.237422270992536
STAT,1882,83,na,1965,6.396056159522014
SIM,1926,18,25-29,1944,1
STAT,1901,34,30-34,1935,0.2422167404056951
STAT,1918,18,25-29,1936,0.466184479135311
STAT,1936,35,30-34,1971,0.01781519185438055
STAT,1861,84,na,1945,2.797549480893459
STAT,1865,98,na,1963,0.09038369089697525
STAT,1872,41,25-29,1913,0.006600088752153395
STAT,1896,30,30-34,1926,0.2311831379127102
STAT,1859,18,20-24,1877,0.16260283905714687
STAT,1917,28,35-39,1945,0.15546953489216
STAT,1841,29,15-19,1870,0.00543689878853071
STAT,1943,18,35-39,1961,0.04415868608320631
SIM,1911,36,30-34,1947,1
STAT,1870,98,na,1968,0.17128164866630147
STAT,1936,29,45-49,1965,0.016417313062881196
SIM,1916,6,na,1922,48
STAT,1927,7,na,1934,49.44815145208367
STAT,1916,31,50-100,1947,0.008497665297126927
SIM,1810,53,na,1863,17
STAT,1858,25,15-19,1883,0.0035855357965737062
SIM,1814,67,na,1881,20
STAT,1810,46,25-29,1856,5.691185457461717E-4
STAT,1862,47,na,1909,19.320336161788493
STAT,1850,15,45-49,1865,7.191633002702168E-4
STAT,1853,44,50-100,1897,0.006549979492308772
STAT,1873,28,45-49,1901,0.011248634867214927
SIM,1831,52,na,1883,8
STAT,1895,26,30-34,1921,0.3280472523969461
STAT,1799,73,na,1872,5.633138289944029
SIM,1890,10,na,1900,31
SIM,1931,20,25-29,1951,1
SIM,1874,9,na,1883,29
STAT,1812,67,na,1879,7.412626775676565
STAT,1932,25,45-49,1957,0.022556136967611662
SIM,1857,51,na,1908,22
STAT,1931,41,40-44,1972,0.0033314698333271053
STAT,1919,22,25-29,1941,1.0026896596132053
STAT,1862,23,15-19,1885,0.028927859851651895
STAT,1815,39,15-19,1854,8.989739869173171E-4
SIM,1944,16,na,1960,28
STAT,1867,94,na,1961,0.40804639214770233
STAT,1907,0,na,1907,42.95130785543862
SIM,1894,24,na,1918,27
STAT,1832,26,45-49,1858,0.006690459616268608
STAT,1927,16,na,1943,45.64394924686863
STAT,1954,17,45-49,1971,0.0061402568731323765
STAT,1914,48,25-29,1962,5.202714275550334E-4
SIM,1876,43,na,1919,28
STAT,1903,36,30-34,1939,0.016433518137299943
STAT,1897,60,na,1957,25.779574497116585
STAT,1896,38,na,1934,30.79311302175202
STAT,1889,20,25-29,1909,0.7050579969455706
STAT,1879,53,40-44,1932,1.0721271962907493E-4
STAT,1912,41,30-34,1953,0.0012304360668757574
STAT,1833,66,na,1899,12.134300700076404
STAT,1923,39,15-19,1962,2.204949868244095E-4
STAT,1892,2,na,1894,32.93176665645076
STAT,1892,24,na,1916,29.03508156919418
STAT,1831,40,25-29,1871,0.006526402251780208
STAT,1846,95,na,1941,0.10775078025880415
STAT,1878,18,30-34,1896,0.01641227479838868
STAT,1834,20,35-39,1854,0.055953344390421635
STAT,1847,35,40-44,1882,0.04953588994010523
STAT,1786,103,na,1889,2.366460742361637E-4
STAT,1871,32,30-34,1903,0.17407344472094916
STAT,1829,29,na,1858,19.456432299419983
STAT,1912,39,na,1951,36.065730776452035
STAT,1918,30,50-100,1948,0.0087762894580434
STAT,1911,36,50-100,1947,0.0040485047211309255
STAT,1852,28,25-29,1880,0.4186505346727909
STAT,1942,20,35-39,1962,0.09807370269828515
STAT,1851,44,20-24,1895,0.0013226511164136907
STAT,1933,24,50-100,1957,0.008686519600508844
SIM,1860,28,25-29,1888,1
STAT,1862,43,20-24,1905,0.001360284774147335
STAT,1899,62,na,1961,26.399577141489413
STAT,1782,73,na,1855,3.63828
STAT,1898,18,20-24,1916,0.23853144792587505
STAT,1854,50,na,1904,13.350042872377907
SIM,1818,70,na,1888,9
STAT,1925,28,30-34,1953,0.45827659622544437
STAT,1845,34,30-34,1879,0.1188563171629072
STAT,1837,80,na,1917,2.991063336850316
SIM,1922,10,na,1932,52
STAT,1945,27,45-49,1972,0.018817531599633692
SIM,1811,48,na,1859,11
STAT,1841,48,na,1889,21.84000087923263
STAT,1847,42,40-44,1889,0.024161604093517686
SIM,1933,28,30-34,1961,1
STAT,1897,21,50-100,1918,0.0054316239310238604
STAT,1839,18,40-44,1857,0.0013126147671058174
STAT,1922,42,50-100,1964,0.0013385560206503704
STAT,1852,85,na,1937,2.346174616446765
STAT,1927,36,40-44,1963,0.018533882928341967
STAT,1894,30,20-24,1924,0.03492064037868659
STAT,1902,26,25-29,1928,0.5985761197127514
STAT,1842,65,na,1907,12.679432999215512
STAT,1906,4,na,1910,38.21904792938312
STAT,1887,77,na,1964,12.279759765142368
STAT,1853,40,50-100,1893,0.006706597626447783
SIM,1945,17,na,1962,36
SIM,1852,20,na,1872,27
STAT,1867,41,50-100,1908,0.010155572503576866
SIM,1901,4,na,1905,42
SIM,1886,42,na,1928,27
STAT,1910,34,20-24,1944,0.02317494954534445
STAT,1871,30,na,1901,23.98276938833913
STAT,1879,45,40-44,1924,0.001789602570468433
STAT,1828,44,na,1872,17.37350863323509
STAT,1852,24,20-24,1876,0.6906135326769095
STAT,1858,21,35-39,1879,0.05131667107033524
STAT,1902,61,na,1963,28.120649347701825
STAT,1894,41,15-19,1935,1.7778647416089556E-4
SIM,1827,31,na,1858,22
STAT,1902,15,30-34,1917,0.02258096336476917
STAT,1904,23,40-44,1927,0.029766439335217484
STAT,1819,44,30-34,1863,0.01050700847641363
STAT,1882,45,50-100,1927,0.0023771576227578062
STAT,1883,30,45-49,1913,0.017070051436311393
SIM,1942,26,30-34,1968,1
STAT,1769,91,na,1860,0.8501329131167551
STAT,1920,39,35-39,1959,0.026201240598775384
SIM,1948,0,na,1948,45
STAT,1867,18,50-100,1885,4.764649297730605E-4
STAT,1929,19,15-19,1948,0.5733248901569354
STAT,1812,104,na,1916,2.6507647054839067E-4
STAT,1919,37,45-49,1956,0.007260265924267725
STAT,1936,34,40-44,1970,0.037732100313235636
STAT,1849,28,na,1877,19.741013590594566
STAT,1921,18,45-49,1939,0.005634894355271343
SIM,1845,50,na,1895,22
STAT,1803,52,50-100,1855,2.9469824306789456E-4
STAT,1899,22,35-39,1921,0.07988384895492832
STAT,1895,74,na,1969,18.353026749670658
STAT,1896,33,50-100,1929,0.011984426553077292
STAT,1837,19,45-49,1856,5.684926764064241E-4
STAT,1837,96,na,1933,0.041518575069678404
STAT,1918,29,40-44,1947,0.04880354976912277
STAT,1900,18,15-19,1918,0.0820777381092017
STAT,1897,36,45-49,1933,0.026600028430097473
SIM,1874,57,na,1931,25
STAT,1829,83,na,1912,2.696542153741983
STAT,1864,46,35-39,1910,0.0012592571808721358
STAT,1910,21,15-19,1931,0.04983437782562989
STAT,1932,16,na,1948,48.66065830758587
STAT,1934,26,30-34,1960,0.5251048362606092
STAT,1887,55,na,1942,22.569253601857078
SIM,1907,38,30-34,1945,1
STAT,1887,45,na,1932,24.8020107867171
STAT,1902,34,50-100,1936,0.007355588542585139
STAT,1828,66,na,1894,11.007739001537962
STAT,1895,22,50-100,1917,0.005294160317716323
STAT,1908,40,na,1948,34.57002359423821
STAT,1849,38,na,1887,18.499938994707957
SIM,1837,31,na,1868,29
SIM,1840,35,na,1875,17
SIM,1795,74,na,1869,8
STAT,1823,33,40-44,1856,0.04016483497236619
STAT,1863,25,35-39,1888,0.08667151692084084
STAT,1903,25,na,1928,34.160184913030044
STAT,1879,41,35-39,1920,0.01882690727856697
STAT,1853,33,na,1886,15.28479596648334
SIM,1870,33,na,1903,24
STAT,1782,95,na,1877,0.019419592051049067
STAT,1881,43,30-34,1924,0.010860567439625783
STAT,1864,34,40-44,1898,0.03856398204364491
STAT,1862,85,na,1947,2.365134904584168
STAT,1890,24,40-44,1914,0.02515362826110603
STAT,1913,16,45-49,1929,0.001015297995682196
STAT,1895,33,30-34,1928,0.22571513998533227
SIM,1920,25,na,1945,43
SIM,1886,64,na,1950,21
STAT,1924,27,15-19,1951,0.008166199284216826
STAT,1812,44,20-24,1856,0.0018079682151249542
STAT,1803,90,na,1893,0.29547373976909924
STAT,1908,36,30-34,1944,0.017057273982158564
SIM,1827,53,na,1880,12
SIM,1903,55,na,1958,33
STAT,1886,20,45-49,1906,0.007276238447606961
STAT,1910,25,50-100,1935,0.009699335772328774
STAT,1865,19,20-24,1884,0.16329934984623026
STAT,1910,17,30-34,1927,0.024004192952295125
SIM,1847,21,25-29,1868,2
SIM,1840,45,na,1885,17
STAT,1782,89,na,1871,0.2790839601024696
STAT,1913,40,50-100,1953,0.0011489413617621676
STAT,1881,46,35-39,1927,0.0013359430652713986
STAT,1847,80,na,1927,6.6080744869427495
STAT,1930,16,45-49,1946,0.006443861682317038
STAT,1878,33,30-34,1911,0.17949650176347598
STAT,1830,35,25-29,1865,0.017592237972956847
STAT,1879,26,na,1905,24.78552065351627
STAT,1866,5,na,1871,26.12127846217537
SIM,1932,10,na,1942,53
STAT,1866,54,45-49,1920,1.2998118631457592E-4
STAT,1857,17,20-24,1874,0.15598846448874107
STAT,1939,18,45-49,1957,0.004964380032402516
STAT,1841,24,45-49,1865,0.008522814650018647
SIM,1874,79,na,1953,13
SIM,1861,50,na,1911,23
STAT,1919,34,na,1953,40.10387272685884
STAT,1838,44,na,1882,18.607721731882243
STAT,1825,31,50-100,1856,0.01159465360145342
STAT,1886,35,30-34,1921,0.05580693398042778
SIM,1860,33,na,1893,25
STAT,1878,19,30-34,1897,0.016367141042693104
STAT,1933,38,50-100,1971,0.005689668665540302
STAT,1860,44,25-29,1904,0.005150093653507202
SIM,1866,29,30-34,1895,2
STAT,1864,30,35-39,1894,0.09156209272228022
STAT,1881,30,25-29,1911,0.09824624930222912
STAT,1811,43,50-100,1854,0.04503985687440849
STAT,1878,37,50-100,1915,0.012675431794408257
STAT,1848,19,20-24,1867,0.14045679723931534
SIM,1893,12,na,1905,39
SIM,1831,68,na,1899,4
SIM,1840,19,na,1859,17
STAT,1891,15,45-49,1906,8.05469800353409E-4
STAT,1921,31,50-100,1952,0.009166482164202645
STAT,1850,31,45-49,1881,0.01641168311273422
STAT,1853,11,na,1864,18.130351393186434
STAT,1919,15,25-29,1934,0.0956886551922751
STAT,1918,16,35-39,1934,0.009102619808282458
STAT,1828,42,30-34,1870,0.005067728892672535
STAT,1903,44,30-34,1947,0.0011197242621531554
STAT,1801,101,na,1902,0.002067937755705029
STAT,1869,24,15-19,1893,0.03176549936243286
STAT,1871,36,25-29,1907,0.02884376777295511
STAT,1867,57,na,1924,19.231376120839013
SIM,1925,26,30-34,1951,1
STAT,1890,41,30-34,1931,0.014028241888233867
STAT,1917,37,25-29,1954,0.01013384688271864
STAT,1840,45,35-39,1885,0.001134977511784183
STAT,1839,29,20-24,1868,0.0803918122618067
SIM,1833,65,na,1898,5
STAT,1871,27,35-39,1898,0.09619985097905442
STAT,1823,45,35-39,1868,9.963139308995113E-4
STAT,1871,62,na,1933,18.22248597549523
STAT,1808,46,na,1854,4.992972467285211
STAT,1821,45,25-29,1866,8.386365195601383E-4
STAT,1869,35,30-34,1904,0.052130921577964486
STAT,1890,36,35-39,1926,0.08632849547020427
STAT,1838,44,40-44,1882,0.01810885206952669
STAT,1838,40,35-39,1878,0.01686307612973289
STAT,1894,25,na,1919,30.792990248527563
STAT,1899,40,na,1939,32.06896121709448
STAT,1915,10,na,1925,41.10115808127159
SIM,1881,27,na,1908,25
STAT,1933,34,15-19,1967,0.0017224861941659883
STAT,1854,32,30-34,1886,0.10928762812047642
STAT,1903,18,40-44,1921,0.0025935804329110614
STAT,1948,19,25-29,1967,0.4923266155811861
STAT,1858,29,30-34,1887,0.1933541117181474
SIM,1825,46,na,1871,17
STAT,1839,21,25-29,1860,0.4088468254699396
STAT,1837,32,30-34,1869,0.10683741567143776
STAT,1907,15,20-24,1922,0.26052922793391187
STAT,1910,37,25-29,1947,0.009359230608107056
SIM,1936,34,na,1970,37
STAT,1886,15,50-100,1901,5.105373145825854E-4
STAT,1903,31,25-29,1934,0.14621760970407124
STAT,1850,84,na,1934,2.9619163051529296
SIM,1781,76,na,1857,7
STAT,1842,34,50-100,1876,0.008133758849577679
STAT,1921,22,na,1943,40.92479599668615
STAT,1874,53,40-44,1927,1.0508727736538025E-4
STAT,1814,68,na,1882,8.032883742892475
STAT,1922,44,40-44,1966,0.0028404172259911082
STAT,1899,30,na,1929,32.92959652970642
SIM,1856,28,na,1884,14
STAT,1845,39,50-100,1884,0.007385568708355009
STAT,1884,16,50-100,1900,4.8117777206438026E-4
STAT,1882,25,45-49,1907,0.010712709699994383
STAT,1869,39,35-39,1908,0.06784271558927503
STAT,1855,40,35-39,1895,0.012878039249338618
STAT,1794,74,na,1868,5.1856549523683375
STAT,1942,28,30-34,1970,0.40805158086939447
STAT,1943,27,25-29,1970,0.6958844904732846
SIM,1913,55,na,1968,39
SIM,1879,78,na,1957,5
STAT,1878,24,50-100,1902,0.004183743804335098
STAT,1884,28,20-24,1912,0.11453453699154745
STAT,1808,99,na,1907,0.002765479054627294
STAT,1916,47,20-24,1963,1.1238027220657937E-4
STAT,1860,26,20-24,1886,0.09709251845724384
STAT,1873,32,40-44,1905,0.044091076703486075
STAT,1845,37,35-39,1882,0.0434404769175623
STAT,1849,20,40-44,1869,0.019818685948400108
STAT,1915,47,50-100,1962,0.002259442973842254
STAT,1925,32,15-19,1957,0.0015164364275729006
STAT,1931,37,45-49,1968,0.008988483880469472
SIM,1865,27,na,1892,23
STAT,1863,11,na,1874,24.228781974334286
STAT,1847,33,50-100,1880,0.011373264314314856
SIM,1876,64,na,1940,25
STAT,1900,8,na,1908,36.047439448275604
SIM,1910,41,na,1951,31
STAT,1891,32,45-49,1923,0.02140304227952504
SIM,1911,42,na,1953,40
STAT,1823,37,50-100,1860,0.00884748872578023
STAT,1824,41,45-49,1865,0.020625014909374722
STAT,1835,28,25-29,1863,0.25093398453700133
SIM,1897,10,na,1907,43
STAT,1883,46,45-49,1929,0.002298258964477051
SIM,1925,40,na,1965,43
STAT,1863,22,30-34,1885,0.16085251028509337
STAT,1950,17,15-19,1967,0.5332945847836589
STAT,1880,22,30-34,1902,0.18730561449713645
STAT,1832,23,40-44,1855,0.01262359950287231
STAT,1946,15,50-100,1961,0.0041283431562678195
SIM,1902,12,na,1914,37
STAT,1877,30,45-49,1907,0.018145490364934375
STAT,1887,39,na,1926,25.456856325843127
STAT,1875,32,50-100,1907,0.009418474392562421
STAT,1909,17,20-24,1926,0.2643766073292049
SIM,1889,18,20-24,1907,1
STAT,1909,39,40-44,1948,0.01394819302011312
STAT,1887,39,50-100,1926,0.013266033113299184
STAT,1921,23,40-44,1944,0.03756467677268513
SIM,1800,54,na,1854,13
SIM,1888,39,na,1927,35
SIM,1853,37,35-39,1890,2
SIM,1834,66,na,1900,11
SIM,1864,79,na,1943,7
STAT,1856,44,35-39,1900,0.01294106865367081
STAT,1838,47,45-49,1885,0.001884450993718799
STAT,1946,19,15-19,1965,0.4994802413139508
STAT,1857,40,45-49,1897,0.011317020738273583
STAT,1842,45,45-49,1887,0.0018169184917947924
STAT,1876,29,25-29,1905,0.42656191915480846
SIM,1895,25,na,1920,27
STAT,1907,49,na,1956,32.40168128567481
STAT,1836,40,15-19,1876,1.626643783649975E-4
STAT,1809,47,na,1856,17.511898937189702
STAT,1824,36,na,1860,20.249965580631027
STAT,1922,38,na,1960,42.45256071305297
STAT,1834,36,20-24,1870,0.006846659699582464
STAT,1934,29,35-39,1963,0.20091440647076167
STAT,1895,29,35-39,1924,0.12437240646003472
STAT,1862,63,na,1925,15.394345951377323
SIM,1879,56,na,1935,12
STAT,1918,46,40-44,1964,0.0016667255257636442
STAT,1792,67,na,1859,14.938456094444874
STAT,1840,51,45-49,1891,1.142621014251081E-4
STAT,1937,15,na,1952,35.747049101259314
STAT,1849,102,na,1951,0.0022732533577928147
STAT,1918,42,25-29,1960,7.523652559495636E-4
STAT,1919,17,50-100,1936,0.004104354783924324
STAT,1843,27,20-24,1870,0.06124356599760167
STAT,1881,52,45-49,1933,1.3735678912105698E-4
STAT,1900,37,30-34,1937,0.015951592837004713
STAT,1920,44,30-34,1964,0.001395301029025589
SIM,1923,26,20-24,1949,2
STAT,1935,29,40-44,1964,0.06319187427919484
STAT,1904,20,na,1924,34.09075962029999
STAT,1833,32,50-100,1865,0.0087336605871866
STAT,1901,44,20-24,1945,1.5223264936032525E-4
STAT,1912,37,35-39,1949,0.023422677777936933
STAT,1901,49,40-44,1950,0.0013230749789259963
SIM,1854,80,na,1934,1
STAT,1853,5,na,1858,19.010552083504166
STAT,1911,47,45-49,1958,0.0020442873608642847
STAT,1928,17,na,1945,46.15184704434863
STAT,1835,30,na,1865,12.66695096743385
STAT,1848,41,30-34,1889,0.007521496783488399
STAT,1869,43,30-34,1912,0.011059141414115578
STAT,1870,21,45-49,1891,0.006948026447063405
STAT,1819,47,35-39,1866,0.0012606762247864656
SIM,1870,11,na,1881,27
SIM,1885,25,na,1910,25
STAT,1911,16,25-29,1927,0.08637048343828267
SIM,1815,68,na,1883,6
STAT,1898,32,50-100,1930,0.012360160435027365
STAT,1799,68,na,1867,8.065452648162468
STAT,1867,35,20-24,1902,0.0074467774523941516
STAT,1829,61,na,1890,12.692744730273928
STAT,1886,38,35-39,1924,0.07300114114136921
SIM,1884,29,25-29,1913,1
STAT,1832,65,na,1897,7.638779657593083
STAT,1869,42,na,1911,22.366987546730506
STAT,1921,15,40-44,1936,0.015892652313102152
SIM,1912,26,35-39,1938,1
STAT,1893,25,20-24,1918,0.1489227457552091
SIM,1929,23,35-39,1952,2
STAT,1908,39,35-39,1947,0.022301663685407237
STAT,1849,81,na,1930,4.193040924364119
STAT,1823,36,45-49,1859,0.014602161794893306
SIM,1866,81,na,1947,2
STAT,1846,63,na,1909,14.460503205727289
STAT,1923,28,20-24,1951,0.2073909173328336
STAT,1847,9,na,1856,32.4826239177
STAT,1876,53,50-100,1929,1.5092758566886527E-4
STAT,1848,15,40-44,1863,0.0014837242591462729
STAT,1917,18,50-100,1935,7.968072974714527E-4
STAT,1911,49,50-100,1960,0.0021149749834832596
STAT,1792,73,na,1865,10.051572839952975
STAT,1864,27,na,1891,21.40527304388606
STAT,1926,40,50-100,1966,0.001444002674351889
STAT,1911,44,na,1955,34.786265868303296
STAT,1826,34,20-24,1860,0.03370651840312468
STAT,1854,28,35-39,1882,0.06138385961659307
STAT,1882,34,35-39,1916,0.09622118582317497
STAT,1818,41,45-49,1859,0.016595152781759142
STAT,1909,56,na,1965,32.31790486270513
STAT,1815,43,35-39,1858,0.027330167039277046
STAT,1901,36,20-24,1937,0.002339322537497332
STAT,1915,26,20-24,1941,0.185211641741437
STAT,1878,78,na,1956,8.467934400080923
SIM,1880,16,na,1896,32
SIM,1829,52,40-44,1881,1
STAT,1875,37,20-24,1912,0.007923880756720627
STAT,1888,43,40-44,1931,0.026095116289559482
STAT,1830,32,20-24,1862,0.017781625764390564
STAT,1898,41,45-49,1939,0.0014083571989088335
SIM,1815,46,na,1861,12
STAT,1780,88,na,1868,0.8336486987494947
STAT,1850,78,na,1928,6.956712172600489
STAT,1899,39,20-24,1938,0.0022547214293367327
STAT,1855,40,25-29,1895,0.0045668547335714245
SIM,1915,40,na,1955,35
SIM,1955,3,na,1958,46
SIM,1865,70,na,1935,8
STAT,1890,20,35-39,1910,0.07130667823542391
STAT,1889,42,30-34,1931,0.014058423075474414
SIM,1852,30,na,1882,28
STAT,1906,39,15-19,1945,1.7431584115866076E-4
STAT,1814,84,na,1898,1.4824198684231327
STAT,1890,27,45-49,1917,0.013486884188689867
STAT,1835,52,na,1887,9.869481251772084
STAT,1844,31,45-49,1875,0.016458346344669122
SIM,1840,51,na,1891,17
STAT,1868,40,20-24,1908,0.001552413589208287
SIM,1845,82,na,1927,4
STAT,1878,36,35-39,1914,0.07337354200986197
SIM,1923,38,na,1961,38
STAT,1830,26,35-39,1856,0.09789302852853946
STAT,1876,12,na,1888,26.383246550838113
SIM,1935,17,na,1952,49
SIM,1885,47,na,1932,22
STAT,1916,38,30-34,1954,0.018412852031528083
STAT,1805,51,50-100,1856,2.9803228116312826E-4
STAT,1861,18,25-29,1879,0.05445091107043584
STAT,1856,35,45-49,1891,0.014578635000701126
SIM,1877,12,na,1889,31
STAT,1869,58,na,1927,19.161760737144952
STAT,1948,16,20-24,1964,1.5417228880499783
STAT,1899,24,na,1923,32.17326661540322
STAT,1879,48,45-49,1927,0.0024119319488540695
STAT,1926,18,35-39,1944,0.05101870951014431
SIM,1860,24,20-24,1884,3
STAT,1819,67,na,1886,8.424742143980124
STAT,1885,32,45-49,1917,0.017220502383889117
STAT,1878,25,na,1903,24.806043112746035
STAT,1908,31,50-100,1939,0.007795490635801752
STAT,1871,33,20-24,1904,0.026835778402822752
STAT,1907,18,25-29,1925,0.08267298635574741
STAT,1870,9,na,1879,26.849111088246875
SIM,1786,75,na,1861,17
STAT,1837,35,35-39,1872,0.04286417197539263
STAT,1890,44,35-39,1934,0.021699102640875354
STAT,1932,29,15-19,1961,0.009199969676920461
STAT,1871,39,50-100,1910,0.012117403538978017
STAT,1896,41,25-29,1937,5.883915306488493E-4
STAT,1857,57,na,1914,15.04425916382863
STAT,1870,41,15-19,1911,1.378060014083457E-4
STAT,1844,50,na,1894,17.05997220881488
STAT,1920,36,30-34,1956,0.019803262916762692
STAT,1842,53,45-49,1895,1.0713534479266814E-4
STAT,1877,41,15-19,1918,1.4319851384113092E-4
STAT,1815,102,na,1917,0.0010465430560000581
STAT,1903,35,40-44,1938,0.013560758858321142
STAT,1888,30,20-24,1918,0.031841799259052686
STAT,1880,18,35-39,1898,0.005754850659683127
STAT,1865,42,45-49,1907,0.013520254808731307
SIM,1863,63,na,1926,5
SIM,1823,33,na,1856,11
STAT,1887,40,30-34,1927,0.012675338832606162
STAT,1904,26,35-39,1930,0.13873306390147105
STAT,1833,30,30-34,1863,0.1699185639363448
STAT,1941,16,20-24,1957,1.386711484951121
SIM,1907,11,na,1918,41
SIM,1846,67,na,1913,5
STAT,1871,24,30-34,1895,0.17647679128779314
STAT,1927,39,45-49,1966,0.008414579075358976
STAT,1832,31,40-44,1863,0.025608535297213315
STAT,1858,38,20-24,1896,0.005836639603568916
SIM,1841,36,na,1877,16
STAT,1905,47,45-49,1952,0.0019123384469425734
STAT,1859,42,45-49,1901,0.011880903521671067
STAT,1928,3,na,1931,50.85770182496613
STAT,1910,39,40-44,1949,0.014086465912295502
STAT,1910,38,50-100,1948,0.003971153393818527
STAT,1841,41,45-49,1882,0.015418774761241571
STAT,1844,42,25-29,1886,0.005137074273872577
STAT,1890,20,25-29,1910,0.6995130409966032
STAT,1924,26,50-100,1950,0.01155334599587336
STAT,1926,27,25-29,1953,0.7845213586901262
SIM,1871,34,na,1905,24
SIM,1810,47,na,1857,18
STAT,1785,87,na,1872,1.6132003336088558
STAT,1898,61,na,1959,26.120375750603923
SIM,1880,11,na,1891,35
STAT,1873,35,45-49,1908,0.020460116426314123
SIM,1893,19,25-29,1912,1
STAT,1915,48,30-34,1963,8.880539710477194E-4
STAT,1882,18,45-49,1900,6.243740060333413E-4
STAT,1879,40,20-24,1919,0.001660316597163352
STAT,1866,20,40-44,1886,0.01962905687840104
STAT,1874,31,30-34,1905,0.17785118721956222
STAT,1883,43,40-44,1926,0.02168451684305498
SIM,1860,71,na,1931,12
STAT,1834,43,45-49,1877,0.01258814973275115
STAT,1859,64,na,1923,13.816766242712585
STAT,1910,25,30-34,1935,0.3818205520772969
STAT,1880,41,50-100,1921,0.011159418799969716
STAT,1816,52,40-44,1868,1.2735251225294377E-4
STAT,1848,27,na,1875,16.70125481263375
STAT,1870,43,30-34,1913,0.011338172571974534
STAT,1821,33,30-34,1854,0.46932863843818046
STAT,1889,16,40-44,1905,0.00224483998287424
SIM,1911,26,na,1937,40
STAT,1885,11,na,1896,25.540715703311417
STAT,1901,27,30-34,1928,0.3523625144628488
STAT,1930,16,35-39,1946,0.05412844816017596
SIM,1830,51,na,1881,17
STAT,1864,52,45-49,1916,1.2947222642837114E-4
STAT,1872,31,na,1903,24.515802974050484
SIM,1809,50,na,1859,1
STAT,1894,30,45-49,1924,0.022528325660427166
STAT,1949,16,na,1965,42.54668721534654
STAT,1931,34,40-44,1965,0.050984485050599666
STAT,1912,21,25-29,1933,0.8809570370684977
STAT,1909,15,30-34,1924,0.02387899978221098
STAT,1912,23,na,1935,36.17423492065671
STAT,1842,49,na,1891,16.52763849490727
SIM,1871,0,na,1871,33
STAT,1823,42,30-34,1865,0.00814912391617804
STAT,1923,35,45-49,1958,0.007857858756268677
SIM,1854,64,na,1918,14
STAT,1933,30,35-39,1963,0.12278839153645991
STAT,1905,31,35-39,1936,0.08426689749649625
STAT,1928,33,na,1961,47.03012276192797
STAT,1857,42,35-39,1899,0.013539207953025885
STAT,1864,37,45-49,1901,0.01788003843376164
SIM,1822,54,na,1876,14
STAT,1940,32,40-44,1972,0.040213834124736066
STAT,1885,19,25-29,1904,0.055659681734891574
STAT,1886,31,15-19,1917,0.0014831833836014701
SIM,1841,14,na,1855,24
STAT,1884,35,20-24,1919,0.007624133122920382
STAT,1829,45,na,1874,17.114618664939815
SIM,1941,30,35-39,1971,1
STAT,1873,26,na,1899,24.34687201155314
STAT,1898,17,50-100,1915,6.60900867474472E-4
STAT,1872,51,40-44,1923,1.0823115189498697E-4
STAT,1901,47,25-29,1948,4.52519687388696E-4
STAT,1909,42,50-100,1951,0.0010926662102481674
STAT,1860,48,40-44,1908,0.0013743211444167654
STAT,1890,33,30-34,1923,0.21118869983573937
STAT,1892,41,40-44,1933,0.027913458546773316
STAT,1819,40,15-19,1859,1.359311995699383E-4
STAT,1817,45,50-100,1862,0.00731323157400318
SIM,1821,34,35-39,1855,1
SIM,1842,79,na,1921,8
STAT,1817,44,20-24,1861,0.00472441323189899
SIM,1826,47,na,1873,15
STAT,1919,37,35-39,1956,0.025759535078442537
STAT,1920,47,35-39,1967,0.001413075215787122
STAT,1814,43,40-44,1857,0.06928339717199337
STAT,1852,41,20-24,1893,0.001365348543056139
STAT,1900,38,na,1938,32.76437926061692
STAT,1920,24,50-100,1944,0.007207420601223491
STAT,1899,49,25-29,1948,4.354961880881568E-4
SIM,1805,84,na,1889,2
SIM,1810,69,na,1879,12
SIM,1855,12,na,1867,24
SIM,1905,19,na,1924,39
STAT,1927,19,40-44,1946,0.017209747458059147
STAT,1797,72,na,1869,4.832566100545864
STAT,1912,28,45-49,1940,0.016832264709350557
SIM,1930,18,na,1948,49
STAT,1917,15,15-19,1932,0.09722311379052857
STAT,1914,42,40-44,1956,0.0024579032500699587
SIM,1926,7,na,1933,50
STAT,1836,47,35-39,1883,0.001413975905940022
STAT,1875,44,45-49,1919,0.01517693232464076
STAT,1933,17,15-19,1950,0.6050461218120875
STAT,1934,22,15-19,1956,0.07123422624793432
STAT,1881,34,40-44,1915,0.0409124404156877
STAT,1861,31,45-49,1892,0.014724698521827315
STAT,1841,64,na,1905,17.015310245374085
STAT,1897,39,na,1936,31.215830452154684
STAT,1859,17,30-34,1876,0.014705292440383818
STAT,1880,25,35-39,1905,0.1021519680603534
SIM,1963,6,na,1969,54
STAT,1870,48,25-29,1918,5.650022085747436E-4
STAT,1880,66,na,1946,17.235061901776533
STAT,1885,43,25-29,1928,0.006295586973716128
STAT,1866,30,50-100,1896,0.008506282004127046
STAT,1844,18,50-100,1862,4.835780386263193E-4
SIM,1822,32,na,1854,19
STAT,1811,66,na,1877,10.793260710864612
STAT,1869,46,35-39,1915,0.0013603693694804314
STAT,1872,78,na,1950,7.994363433597802
STAT,1890,42,45-49,1932,0.018157349372457672
STAT,1906,36,20-24,1942,0.002428843082214575
STAT,1912,34,30-34,1946,0.15249987603320342
STAT,1940,28,20-24,1968,0.18473019481846156
STAT,1907,40,35-39,1947,0.0018579205109634403
STAT,1842,42,40-44,1884,0.01745989059942049
SIM,1935,33,na,1968,54
STAT,1847,79,na,1926,7.4681009978558235
STAT,1858,21,45-49,1879,0.006132181303802739
SIM,1925,15,15-19,1940,1
STAT,1935,32,50-100,1967,0.011387919237517283
STAT,1952,17,25-29,1969,0.516245203562911
STAT,1874,40,45-49,1914,0.015336490854908019
STAT,1893,14,na,1907,32.45685637965222
STAT,1831,64,na,1895,14.106669158724717
STAT,1862,30,15-19,1892,0.001238519048980321
STAT,1892,51,na,1943,26.728403547355317
STAT,1924,40,na,1964,44.010428146133236
STAT,1864,43,30-34,1907,0.010237148492489488
STAT,1789,68,na,1857,4.47084826052
STAT,1843,37,25-29,1880,0.014258027402708704
STAT,1894,15,50-100,1909,6.307931466486541E-4
STAT,1847,20,30-34,1867,0.2366475997922315
STAT,1922,1,na,1923,47.97641370628636
SIM,1847,24,na,1871,19
STAT,1942,24,15-19,1966,0.05536896115460905
SIM,1845,28,35-39,1873,1
SIM,1829,97,na,1926,1
STAT,1840,33,40-44,1873,0.04096243991791213
STAT,1928,24,50-100,1952,0.008124062725125229
STAT,1850,34,50-100,1884,0.008358609171992262
STAT,1842,27,na,1869,20.071517976149142
STAT,1911,60,na,1971,32.178731837798836
STAT,1888,46,45-49,1934,0.002765721522670642
STAT,1911,44,40-44,1955,0.0023427761771970153
SIM,1902,6,na,1908,38
STAT,1845,30,15-19,1875,0.0010105477264184559
SIM,1864,64,na,1928,15
STAT,1945,27,35-39,1972,0.16353103242418626
SIM,1944,15,25-29,1959,1
STAT,1806,50,30-34,1856,2.006685831080673E-4
STAT,1880,82,na,1962,7.1643218191490226
STAT,1876,6,na,1882,27.57157098075412
STAT,1849,54,45-49,1903,1.0943355015347077E-4
SIM,1830,41,35-39,1871,1
SIM,1894,28,30-34,1922,1
SIM,1888,9,na,1897,39
STAT,1863,26,na,1889,21.283031954852273
STAT,1851,79,na,1930,5.90206263586454
STAT,1912,55,na,1967,33.93121579517739
STAT,1898,43,35-39,1941,0.001684069184090821
STAT,1877,17,50-100,1894,5.057240850430359E-4
STAT,1819,37,30-34,1856,0.059699056277267744
STAT,1907,27,15-19,1934,0.006636540963786273
STAT,1856,32,40-44,1888,0.03180126462952479
STAT,1832,49,na,1881,10.604069898257451
STAT,1860,33,50-100,1893,0.007417392244750289
STAT,1886,28,30-34,1914,0.26028392699363995
STAT,1893,18,20-24,1911,0.22294937678187252
SIM,1967,1,na,1968,50
SIM,1816,47,na,1863,12
STAT,1925,36,30-34,1961,0.02175778510190216
STAT,1841,17,45-49,1858,8.24640513173639E-4
STAT,1903,41,na,1944,33.12234066000625
STAT,1910,38,na,1948,35.584382509034576
STAT,1822,41,35-39,1863,0.010501054799860245
STAT,1851,36,20-24,1887,0.00664608907038802
STAT,1939,30,50-100,1969,0.008387509198696257
STAT,1896,46,50-100,1942,0.0018249243362533038
STAT,1878,29,35-39,1907,0.09890524790198872
STAT,1914,19,na,1933,39.40896539368917
STAT,1860,46,na,1906,18.3425218746959
STAT,1823,35,na,1858,17.09633052065169
STAT,1778,90,na,1868,0.32998933666992075
SIM,1796,75,na,1871,3
SIM,1828,32,na,1860,19
STAT,1941,29,50-100,1970,0.010211795684512168
STAT,1884,29,50-100,1913,0.006222604374421537
SIM,1831,36,na,1867,9
STAT,1817,47,25-29,1864,0.0016656455156705719
STAT,1932,29,25-29,1961,0.8577685930751396
STAT,1947,9,na,1956,43.96350948322371
SIM,1895,41,na,1936,27
STAT,1873,41,30-34,1914,0.011741480217188615
STAT,1900,15,20-24,1915,0.24698055261749058
STAT,1901,42,30-34,1943,0.0011157355397202456
STAT,1899,22,45-49,1921,0.009545869496596969
STAT,1931,37,na,1968,49.60474874995629
STAT,1896,45,40-44,1941,0.0012811419574752095
STAT,1921,26,45-49,1947,0.019169681002901447
STAT,1832,34,45-49,1866,0.009981530180129821
STAT,1893,42,20-24,1935,0.0019999722333538363
STAT,1905,44,40-44,1949,0.002223832853548982
STAT,1920,42,40-44,1962,0.0027389588702554837
STAT,1844,34,na,1878,19.827353207430686
STAT,1877,45,30-34,1922,0.0010091905857154365
STAT,1832,40,30-34,1872,0.0064874426348447995
SIM,1816,69,na,1885,6
SIM,1939,19,25-29,1958,3
STAT,1781,94,na,1875,0.06103274263193646
STAT,1888,21,30-34,1909,0.20878242531630267
SIM,1934,27,25-29,1961,1
STAT,1878,41,na,1919,23.969613271777007
SIM,1910,9,na,1919,33
STAT,1863,64,na,1927,15.391383885330013
STAT,1851,40,40-44,1891,0.019180688622748458
STAT,1846,41,20-24,1887,0.0013194432891558798
STAT,1863,6,na,1869,25.20511433492434
STAT,1829,67,na,1896,10.767624027924812
STAT,1912,45,na,1957,35.19548527951482
SIM,1896,26,na,1922,30
STAT,1901,4,na,1905,36.81039785467628
STAT,1904,26,na,1930,34.313621774202645
STAT,1911,49,35-39,1960,0.0012056046359394605
STAT,1815,40,30-34,1855,0.018519215795373703
STAT,1871,20,15-19,1891,0.033087529444028735
STAT,1845,27,30-34,1872,0.17916927474197544
STAT,1869,26,na,1895,23.203367224222458
STAT,1897,29,45-49,1926,0.014638949742961437
STAT,1909,41,na,1950,34.741869545607294
STAT,1862,37,35-39,1899,0.06102266479683365
STAT,1868,40,45-49,1908,0.014629810435253385
STAT,1931,21,35-39,1952,0.12194852085134988
STAT,1882,31,30-34,1913,0.16800790790862968
STAT,1884,63,na,1947,17.48175564185097
STAT,1852,27,na,1879,21.56438108519084
STAT,1864,30,25-29,1894,0.09260671217485812
SIM,1877,22,na,1899,29
STAT,1870,32,25-29,1902,0.10174886195483128
STAT,1885,81,na,1966,8.382782897962693
STAT,1862,34,30-34,1896,0.14934657876600857
STAT,1898,45,50-100,1943,0.0018875223618661904
STAT,1941,19,15-19,1960,0.46375494734537975
STAT,1903,38,45-49,1941,0.006087042835743389
SIM,1794,68,na,1862,1
STAT,1862,53,na,1915,18.278499330477004
STAT,1929,18,na,1947,46.627052060271005
STAT,1834,43,50-100,1877,0.008885752727066957
STAT,1906,39,25-29,1945,0.00893764748583978
STAT,1872,54,45-49,1926,1.4440341014449278E-4
STAT,1846,15,30-34,1861,0.016419420460015467
STAT,1876,42,45-49,1918,0.015181847995879945
STAT,1851,43,45-49,1894,0.012543825885650686
SIM,1855,49,na,1904,14
STAT,1831,30,20-24,1861,0.029142008572169968
STAT,1909,27,25-29,1936,0.6255100510060831
STAT,1867,19,30-34,1886,0.015409694669769354
STAT,1897,33,40-44,1930,0.05734663242710295
STAT,1809,51,45-49,1860,4.841756829228548E-4
SIM,1898,11,na,1909,37
STAT,1859,29,25-29,1888,0.3371284979310761
STAT,1911,40,25-29,1951,6.848439685312921E-4
SIM,1917,2,na,1919,47
STAT,1862,46,25-29,1908,4.983633632359928E-4
STAT,1819,83,na,1902,2.03785159222749
SIM,1914,56,na,1970,32
SIM,1886,7,na,1893,30
STAT,1864,12,na,1876,24.340556500123824
STAT,1863,18,35-39,1881,0.005015079485069621
STAT,1824,40,30-34,1864,0.01611106472828426
STAT,1834,40,40-44,1874,0.019659813671861405
STAT,1884,38,25-29,1922,0.02806907387195631
STAT,1852,33,50-100,1885,0.008035243705804225
SIM,1868,45,na,1913,32
SIM,1971,0,na,1971,52
STAT,1913,16,35-39,1929,0.00852850474385934
STAT,1910,9,na,1919,39.07601946959998
STAT,1948,21,na,1969,41.666441984928966
STAT,1850,68,na,1918,13.606534585399686
STAT,1919,34,40-44,1953,0.041495873262003116
STAT,1936,36,na,1972,36.744435968709176
SIM,1849,8,na,1857,19
SIM,1889,31,40-44,1920,1
STAT,1896,41,35-39,1937,0.001659200843410362
STAT,1873,96,na,1969,0.4332781521735904
STAT,1910,28,35-39,1938,0.14358567347926168
SIM,1878,77,na,1955,8
STAT,1846,104,na,1950,5.40555882291858E-4
STAT,1857,16,45-49,1873,5.781600907356437E-4
STAT,1909,18,35-39,1927,0.008161183000090399
STAT,1854,35,35-39,1889,0.04389367346933035
SIM,1910,31,na,1941,30
STAT,1847,45,45-49,1892,0.0025461730124403206
STAT,1856,28,45-49,1884,0.008274966328751252
STAT,1891,31,30-34,1922,0.21516999234792863
STAT,1816,41,35-39,1857,0.02552569248533852
STAT,1836,27,50-100,1863,0.00798838949263807
STAT,1855,44,40-44,1899,0.015622709647973897
SIM,1876,11,na,1887,32
SIM,1795,90,na,1885,2
STAT,1807,98,na,1905,0.013709928155276895
STAT,1825,53,45-49,1878,1.2669009698148352E-4
STAT,1904,26,45-49,1930,0.01596402698118001
STAT,1928,17,40-44,1945,0.017538037607185246
SIM,1801,55,na,1856,10
STAT,1890,44,na,1934,27.695740639673243
STAT,1883,32,35-39,1915,0.0983420608322147
STAT,1810,87,na,1897,0.6332751651443199
SIM,1879,88,na,1967,2
STAT,1887,42,20-24,1929,0.0017313223650346735
STAT,1891,24,50-100,1915,0.00497373922895986
STAT,1839,45,na,1884,12.97851100205972
STAT,1865,41,30-34,1906,0.010445654867176668
STAT,1836,44,30-34,1880,0.01286531519654169
STAT,1875,41,40-44,1916,0.023225873012886394
SIM,1858,30,na,1888,24
STAT,1814,46,45-49,1860,0.006863222191016983
STAT,1916,34,15-19,1950,0.001304114381220361
STAT,1842,31,35-39,1873,0.0927452841935664
STAT,1852,17,20-24,1869,0.18351086069600656
STAT,1885,40,20-24,1925,0.0015841269429566704
STAT,1863,42,35-39,1905,0.01601316284844132
STAT,1870,82,na,1952,4.634976591907406
STAT,1870,45,20-24,1915,1.203950734349227E-4
STAT,1842,49,25-29,1891,4.231374859268481E-4
STAT,1925,45,20-24,1970,1.3370131420066273E-4
STAT,1924,40,35-39,1964,0.002386215449351063
STAT,1903,47,35-39,1950,0.0011175318860906155
SIM,1861,34,na,1895,25
STAT,1892,37,20-24,1929,0.009523126080538598
STAT,1933,22,na,1955,48.2419509025122
STAT,1936,15,25-29,1951,0.4142963572096629
STAT,1805,54,na,1859,9.119671507709679
SIM,1875,63,na,1938,13
SIM,1954,1,na,1955,52
SIM,1846,61,na,1907,8
STAT,1871,17,30-34,1888,0.015993513229681722
STAT,1959,1,na,1960,51.2106016170285
STAT,1835,20,na,1855,12.11082654510552
STAT,1945,24,40-44,1969,0.0365615651924512
SIM,1850,31,35-39,1881,1
STAT,1923,32,40-44,1955,0.04455173041279152
SIM,1885,63,na,1948,17
STAT,1847,20,50-100,1867,0.005417756993070523
STAT,1860,41,20-24,1901,0.0012969485586007464
STAT,1814,52,30-34,1866,1.6352098508307797E-4
STAT,1858,48,25-29,1906,4.327968284588175E-4
STAT,1881,37,45-49,1918,0.018968891911203146
STAT,1898,17,45-49,1915,8.812011566326294E-4
STAT,1832,87,na,1919,0.7963526853684533
STAT,1837,28,35-39,1865,0.06024773904530498
STAT,1914,45,45-49,1959,0.002147671035745108
STAT,1842,42,15-19,1884,1.0719810784078528E-4
STAT,1840,36,45-49,1876,0.018668414006340093
STAT,1909,17,30-34,1926,0.02376856755095719
STAT,1828,45,35-39,1873,6.151596855109852E-4
STAT,1804,91,na,1895,0.22497180560454347
SIM,1871,12,na,1883,27
STAT,1824,46,na,1870,18.28953242663835
SIM,1904,56,na,1960,25
STAT,1817,98,na,1915,0.025745930567222044
STAT,1927,32,25-29,1959,0.11311476971648707
STAT,1898,40,30-34,1938,0.0010878462750095513
STAT,1908,55,na,1963,32.014886398305336
STAT,1822,87,na,1909,0.6249407430273499
STAT,1847,64,na,1911,18.56978784867717
STAT,1875,11,na,1886,26.895590865254224
STAT,1911,46,30-34,1957,8.405889687690639E-4
STAT,1907,48,30-34,1955,7.886742376826029E-4
STAT,1889,62,na,1951,22.377491746106642
STAT,1890,59,na,1949,23.60731531403015
STAT,1825,46,20-24,1871,1.1224624361234717E-4
STAT,1838,97,na,1935,0.04169647800466768
STAT,1865,15,40-44,1880,0.0018956296897531615
STAT,1865,47,50-100,1912,0.002211064531378682
STAT,1850,30,30-34,1880,0.18245523954750692
SIM,1850,13,na,1863,22
STAT,1925,39,35-39,1964,0.028787223840210548
SIM,1915,19,na,1934,40
STAT,1901,23,15-19,1924,0.046019578980582045
STAT,1791,72,na,1863,5.098104535478561
STAT,1882,42,45-49,1924,0.014325299528509616
SIM,1936,18,na,1954,38
STAT,1837,86,na,1923,1.0728252478110083
STAT,1931,30,25-29,1961,0.12070873916583598
STAT,1839,33,50-100,1872,0.0061581537949500125
STAT,1912,25,40-44,1937,0.0458825387151341
STAT,1944,19,40-44,1963,0.014933153197541304
SIM,1916,41,na,1957,44
STAT,1860,50,45-49,1910,1.1967741598917765E-4
STAT,1918,49,45-49,1967,0.00227845719543241
STAT,1932,26,20-24,1958,0.23822781193692344
STAT,1822,72,na,1894,4.479685375762009
STAT,1875,21,45-49,1896,0.007189703492946061
STAT,1905,40,25-29,1945,6.500742715409122E-4
SIM,1852,79,na,1931,18
STAT,1879,41,25-29,1920,0.006676462849579333
STAT,1918,33,na,1951,39.65773715251341
SIM,1830,73,na,1903,1
STAT,1868,63,na,1931,17.26752054448962
STAT,1854,12,na,1866,17.455071739982827
STAT,1877,48,35-39,1925,0.001427006927666401
STAT,1877,77,na,1954,8.922783508847965
STAT,1832,43,35-39,1875,0.009832922387706009
STAT,1837,34,50-100,1871,0.005487439539478409
STAT,1887,16,30-34,1903,0.017439936187380798
STAT,1831,53,45-49,1884,1.1984368548135226E-4
SIM,1885,41,na,1926,24
STAT,1892,44,45-49,1936,0.001266625254968381
STAT,1794,90,na,1884,0.35392870442296925
STAT,1802,99,na,1901,0.005783967671911935
STAT,1896,48,45-49,1944,0.0017266555542793367
STAT,1921,37,na,1958,41.680374970104594
STAT,1873,44,35-39,1917,0.018161904137273154
SIM,1894,77,na,1971,11
STAT,1901,45,35-39,1946,0.0011160425734283203
STAT,1876,92,na,1968,1.4533461858172863
STAT,1815,51,45-49,1866,2.0537028255536533E-4
STAT,1838,40,25-29,1878,0.005980042268437797
STAT,1854,34,na,1888,14.629909997352478
STAT,1881,30,35-39,1911,0.0971380149123704
STAT,1867,28,20-24,1895,0.11187018823490269
SIM,1806,69,na,1875,4
STAT,1922,47,45-49,1969,0.002478524876252619
SIM,1879,4,na,1883,20
STAT,1840,42,30-34,1882,0.009397386938432051
STAT,1841,21,40-44,1862,0.026025331289129327
STAT,1913,16,50-100,1929,7.614734967616467E-4
STAT,1933,38,30-34,1971,0.02469860349683207
SIM,1884,0,na,1884,33
STAT,1882,22,40-44,1904,0.01997005239023186
STAT,1856,52,45-49,1908,1.0457309127352623E-4
STAT,1951,3,na,1954,46.77551478838136
STAT,1856,78,na,1934,5.660234677044324
STAT,1879,48,50-100,1927,0.0025100444307868184
SIM,1873,78,na,1951,1
STAT,1914,38,20-24,1952,0.0025972208212992082
STAT,1855,24,50-100,1879,0.0033061980555806167
STAT,1835,41,45-49,1876,0.00822929983548599
STAT,1821,42,20-24,1863,0.0024758099920610876
STAT,1919,18,na,1937,40.21707795463666
SIM,1891,59,na,1950,31
STAT,1835,79,na,1914,3.1445254504854336
STAT,1844,18,25-29,1862,0.05593387109014581
STAT,1806,53,35-39,1859,2.733423719315147E-4
STAT,1895,36,35-39,1931,0.09226652967197603
STAT,1883,43,15-19,1926,1.3313595304510596E-4
STAT,1843,34,20-24,1877,0.01350125769146551
STAT,1866,47,20-24,1913,1.1000255094081033E-4
STAT,1836,31,na,1867,26.71384335418112
STAT,1849,51,50-100,1900,1.1766571049312593E-4
STAT,1821,36,35-39,1857,0.15761921874941098
STAT,1920,45,45-49,1965,0.0023932523111222614
SIM,1800,70,na,1870,8
STAT,1859,96,na,1955,0.06824820417374684
STAT,1833,36,50-100,1869,0.011482898174105768
STAT,1902,37,40-44,1939,0.013324085434254555
STAT,1839,25,40-44,1864,0.021127912827243037
STAT,1915,29,15-19,1944,0.007087364807936097
STAT,1868,41,na,1909,22.468119216424025
SIM,1886,26,na,1912,28
STAT,1872,31,20-24,1903,0.027769915222791295
STAT,1881,38,50-100,1919,0.01162456045830144
STAT,1908,32,15-19,1940,0.0012066846317228695
STAT,1863,16,50-100,1879,4.979083879489374E-4
SIM,1858,24,na,1882,23
STAT,1859,37,15-19,1896,4.4632594041894353E-4
STAT,1879,39,40-44,1918,0.04485159108047032
STAT,1856,36,35-39,1892,0.05148521600812868
STAT,1906,5,na,1911,38.07305116629288
STAT,1824,30,30-34,1854,0.3046099133201257
SIM,1855,36,40-44,1891,1
SIM,1935,15,25-29,1950,1
STAT,1788,101,na,1889,0.001677861209573705
STAT,1886,16,25-29,1902,0.058923427593467824
STAT,1829,98,na,1927,0.022065781389184948
SIM,1890,23,30-34,1913,1
STAT,1874,22,50-100,1896,0.004136998661763993
STAT,1892,39,na,1931,28.812983884911382
STAT,1834,43,20-24,1877,0.0013357667752837896
STAT,1845,13,na,1858,17.557282478933686
STAT,1915,37,na,1952,37.677680924167554
STAT,1945,17,40-44,1962,0.01516955358831213
SIM,1894,62,na,1956,26
SIM,1924,9,na,1933,55
STAT,1820,41,25-29,1861,0.005768250856697298
STAT,1890,27,50-100,1917,0.007770361975338002
SIM,1894,16,25-29,1910,1
STAT,1945,18,50-100,1963,0.004061972047362927
STAT,1873,32,na,1905,24.26144840722031
STAT,1833,41,35-39,1874,0.016454362016583533
STAT,1877,46,na,1923,23.290168066117964
STAT,1899,61,na,1960,26.716434049314277
SIM,1800,85,na,1885,1
SIM,1827,32,na,1859,22
STAT,1817,46,25-29,1863,0.0016901787778899314
STAT,1788,99,na,1887,0.004373589236445657
STAT,1891,21,30-34,1912,0.21928155210918374
STAT,1790,93,na,1883,0.04284537503991096
STAT,1887,45,25-29,1932,6.349764059430393E-4
SIM,1846,39,na,1885,12
STAT,1927,22,na,1949,44.762368737169744
SIM,1835,51,na,1886,17
SIM,1887,39,40-44,1926,1
STAT,1854,20,15-19,1874,0.024036849786587197
STAT,1929,21,40-44,1950,0.042444249170731044
STAT,1836,22,20-24,1858,0.8777198502361225
SIM,1903,22,25-29,1925,3
STAT,1865,34,35-39,1899,0.0908138044680004
STAT,1910,40,20-24,1950,1.6776573752018154E-4
STAT,1852,18,20-24,1870,0.18242998172650707
STAT,1879,31,30-34,1910,0.1814483156202763
STAT,1881,51,na,1932,20.586354707050702
STAT,1889,31,na,1920,29.335759226100176
STAT,1882,23,30-34,1905,0.1701754355041975
STAT,1902,49,35-39,1951,0.0010903956781649134
STAT,1807,49,50-100,1856,0.005079220920649196
STAT,1882,41,30-34,1923,0.011067626820694634
STAT,1843,41,20-24,1884,7.025679371797729E-4
SIM,1812,70,na,1882,14
STAT,1847,43,30-34,1890,0.012192464986425539
STAT,1850,20,30-34,1870,0.19311641825779569
SIM,1945,16,na,1961,40
SIM,1823,66,na,1889,6
SIM,1870,48,na,1918,21
STAT,1832,50,na,1882,10.47326084495662
STAT,1840,40,40-44,1880,0.02072831426908228
STAT,1887,76,na,1963,12.876049623192406
STAT,1901,42,20-24,1943,1.541256327113365E-4
STAT,1958,14,na,1972,51.280456028515346
STAT,1879,57,na,1936,20.799881798891867
STAT,1894,17,15-19,1911,0.07605672133993273
STAT,1817,39,35-39,1856,0.24710622644133776
STAT,1895,75,na,1970,17.63028455626863
STAT,1888,37,40-44,1925,0.05115541173874615
STAT,1891,81,na,1972,11.425002568012879
STAT,1850,39,20-24,1889,0.006828754541716349
SIM,1861,0,na,1861,35
SIM,1815,47,na,1862,12
STAT,1826,44,25-29,1870,0.006559478958905901
STAT,1834,36,30-34,1870,0.047337170777675804
STAT,1917,19,30-34,1936,0.12885221030837588
STAT,1933,30,45-49,1963,0.021143450818188074
STAT,1870,48,35-39,1918,0.0013732692708102062
SIM,1916,19,na,1935,42
STAT,1847,52,45-49,1899,1.542016889371692E-4
SIM,1841,67,na,1908,9
STAT,1927,15,25-29,1942,0.5385603217877356
STAT,1890,18,40-44,1908,0.002215907818375494
STAT,1909,42,20-24,1951,1.6425701512926607E-4
STAT,1841,18,45-49,1859,8.197833805510462E-4
SIM,1885,10,na,1895,26
STAT,1847,36,40-44,1883,0.049024184197023944
STAT,1809,53,50-100,1862,4.8413285574698707E-4
STAT,1944,25,25-29,1969,0.7068442228417192
SIM,1808,65,na,1873,7
STAT,1862,84,na,1946,2.870100362333044
SIM,1920,24,na,1944,45
STAT,1897,37,35-39,1934,0.09392524235825725
SIM,1891,26,na,1917,37
STAT,1952,3,na,1955,46.861896101916884
SIM,1882,45,na,1927,30
STAT,1820,53,na,1873,13.265759760066219
STAT,1950,22,45-49,1972,0.013265476848924899
STAT,1882,50,45-49,1932,1.4107743838943324E-4
STAT,1831,33,25-29,1864,0.10687739338857
SIM,1869,25,30-34,1894,1
STAT,1861,18,15-19,1879,0.05702438355457243
STAT,1870,18,40-44,1888,0.00182344255063689
STAT,1871,39,40-44,1910,0.04320446403210512
STAT,1866,39,30-34,1905,0.04859041529894951
STAT,1919,27,40-44,1946,0.049925519041798594
SIM,1837,62,na,1899,28
STAT,1837,81,na,1918,2.6147277478078097
SIM,1882,77,na,1959,14
SIM,1840,14,na,1854,17
STAT,1830,79,na,1909,2.5118299467977385
SIM,1936,24,30-34,1960,1
SIM,1901,5,na,1906,42
STAT,1828,30,15-19,1858,0.0020302656676780572
STAT,1927,33,25-29,1960,0.11304463855926282
SIM,1908,3,na,1911,42
STAT,1854,47,40-44,1901,0.0010415558240349616
SIM,1930,1,na,1931,56
STAT,1843,36,25-29,1879,0.014406850164912246
STAT,1860,33,20-24,1893,0.02188239484293854
STAT,1935,1,na,1936,56.83651787957235
STAT,1833,23,35-39,1856,0.057659681571174105
STAT,1782,74,na,1856,3.3092703396
STAT,1890,28,na,1918,28.887125058082304
STAT,1828,45,na,1873,17.184643712294633
STAT,1845,15,25-29,1860,0.042364432692366234
STAT,1861,47,na,1908,18.831953442966974
STAT,1818,38,40-44,1856,0.05575791413100567
STAT,1949,16,50-100,1965,0.004330726798624181
STAT,1814,50,40-44,1864,3.0098488218555385E-4
STAT,1949,17,25-29,1966,0.5007805763072757
STAT,1885,19,15-19,1904,0.05829028343841961
STAT,1835,28,15-19,1863,0.002691384444810292
STAT,1933,28,30-34,1961,0.5178964869076094
STAT,1843,29,35-39,1872,0.04965109703099743
STAT,1864,20,30-34,1884,0.1646879850809922
STAT,1860,29,35-39,1889,0.07814922255992954
STAT,1920,21,20-24,1941,1.2293550483862667
STAT,1881,67,na,1948,15.084036238094466
STAT,1848,65,na,1913,10.928983538441043
STAT,1858,44,20-24,1902,0.0011921671239997096
STAT,1824,49,20-24,1873,1.5122758938058476E-4
SIM,1806,54,na,1860,9
STAT,1852,20,50-100,1872,0.004206220688003732
STAT,1872,34,25-29,1906,0.10390202604757696
STAT,1828,105,na,1933,1.9692025395282744E-4
STAT,1893,40,na,1933,29.435951140762217
STAT,1929,5,na,1934,51.06807557888119
STAT,1839,44,35-39,1883,0.010265831119918413
STAT,1894,25,50-100,1919,0.00825386535417521
STAT,1867,29,20-24,1896,0.11146298074972764
STAT,1875,44,20-24,1919,0.0016104703534976987
SIM,1851,29,35-39,1880,1
STAT,1861,31,na,1892,20.14982431483446
SIM,1846,35,na,1881,15
STAT,1918,40,20-24,1958,1.8658531308663059E-4
STAT,1841,25,35-39,1866,0.11900824601251535
STAT,1883,19,50-100,1902,4.7319969740957713E-4
SIM,1914,24,na,1938,33
STAT,1775,92,na,1867,0.16434246512512532
SIM,1826,38,40-44,1864,1
STAT,1858,79,na,1937,5.319804255972832
STAT,1878,18,40-44,1896,0.0018833758716167188
STAT,1931,40,50-100,1971,0.0015668264201265123
STAT,1890,22,25-29,1912,0.6953641027484457
STAT,1809,78,na,1887,4.468856165322158
STAT,1854,65,na,1919,10.329642729485549
STAT,1864,41,40-44,1905,0.02026555350237704
SIM,1883,8,na,1891,17
SIM,1886,63,na,1949,21
STAT,1861,42,25-29,1903,0.005393606428271552
STAT,1855,38,40-44,1893,0.0306678054869487
STAT,1833,44,15-19,1877,1.2075452068231103E-4
STAT,1853,16,15-19,1869,0.045132338660556603
STAT,1960,8,na,1968,50.89050358272783
STAT,1798,89,na,1887,0.6978509160086076
STAT,1879,16,35-39,1895,0.005693142699991005
STAT,1935,17,25-29,1952,0.5897920583805193
SIM,1887,31,30-34,1918,1
STAT,1867,45,25-29,1912,5.567045993477003E-4
STAT,1899,48,25-29,1947,4.391942032797724E-4
SIM,1856,29,na,1885,15
STAT,1903,21,20-24,1924,0.9827097460269096
SIM,1829,27,na,1856,21
STAT,1889,35,35-39,1924,0.08741843262354637
STAT,1856,84,na,1940,2.409923102318409
STAT,1807,49,20-24,1856,2.4817041311476427E-4
SIM,1894,30,na,1924,32
STAT,1885,29,40-44,1914,0.029370211619499518
SIM,1855,71,na,1926,7
STAT,1820,49,35-39,1869,0.0011529009493780925
STAT,1879,41,na,1920,24.029802045921496
STAT,1880,37,40-44,1917,0.046031766292985235
STAT,1809,101,na,1910,0.0031573281249452053
STAT,1833,39,20-24,1872,0.006988510104386954
STAT,1842,64,na,1906,13.042537235861905
STAT,1907,38,30-34,1945,0.01674319324226846
STAT,1823,31,25-29,1854,0.1592703956040202
SIM,1860,34,na,1894,25
STAT,1894,19,40-44,1913,0.002331499987938566
STAT,1844,28,40-44,1872,0.028437689325824658
STAT,1870,45,30-34,1915,9.711868897653652E-4
SIM,1814,89,na,1903,6
STAT,1827,28,40-44,1855,0.042533297104431884
STAT,1848,34,35-39,1882,0.06807275445575169
STAT,1813,46,40-44,1859,0.005385933706787608
STAT,1838,30,30-34,1868,0.171922422470235
STAT,1891,16,35-39,1907,0.006751197810820796
STAT,1831,92,na,1923,0.3379823730048362
STAT,1769,92,na,1861,0.5204343667518151
STAT,1803,54,30-34,1857,1.1162071065822761E-4
STAT,1809,90,na,1899,0.43623422377326726
STAT,1838,54,45-49,1892,1.095401539353536E-4
STAT,1890,31,40-44,1921,0.0528934974803213
STAT,1838,38,40-44,1876,0.040573555652096326
STAT,1951,7,na,1958,46.522580120224006
SIM,1878,44,na,1922,28
STAT,1918,17,25-29,1935,0.09377590873206472
SIM,1924,5,na,1929,56
STAT,1924,32,45-49,1956,0.01823913869341053
SIM,1799,71,na,1870,12
STAT,1924,38,30-34,1962,0.02133004372132098
STAT,1823,40,40-44,1863,0.016196323798159572
STAT,1894,0,na,1894,37.63185039439341
STAT,1833,28,na,1861,20.953904102800085
STAT,1882,19,45-49,1901,6.226569775167495E-4
SIM,1893,19,15-19,1912,1
STAT,1907,32,45-49,1939,0.014646571734190244
SIM,1953,5,na,1958,50
STAT,1881,41,40-44,1922,0.0214996793956231
STAT,1920,34,50-100,1954,0.00890228684724193
STAT,1937,22,30-34,1959,0.2781171050188855
SIM,1915,38,30-34,1953,2
STAT,1870,16,15-19,1886,0.059867356594675375
STAT,1850,44,15-19,1894,1.212981753159533E-4
STAT,1866,31,50-100,1897,0.008472937378670864
STAT,1884,34,20-24,1918,0.026256531537428244
STAT,1929,24,45-49,1953,0.014072056767572599
STAT,1827,87,na,1914,1.0676866607337872
STAT,1875,37,30-34,1912,0.054784977355555986
STAT,1830,46,40-44,1876,1.7220653220113947E-4
STAT,1829,48,40-44,1877,0.001442702406256372
STAT,1879,43,25-29,1922,0.006598377477146539
STAT,1900,26,50-100,1926,0.008900940349226207
STAT,1817,44,50-100,1861,0.03142761785658189
STAT,1808,46,30-34,1854,7.089049276538592E-4
STAT,1902,62,na,1964,27.787138446438085
STAT,1817,43,20-24,1860,0.00486705025618663
STAT,1918,35,25-29,1953,0.01038173045301465
STAT,1873,26,40-44,1899,0.03056019303641889
SIM,1832,25,35-39,1857,1
STAT,1834,45,na,1879,17.298486077588546
STAT,1838,59,na,1897,15.084131700221471
STAT,1935,35,25-29,1970,0.01373065440687808
SIM,1866,6,na,1872,36
STAT,1832,33,45-49,1865,0.010085715622510346
STAT,1942,20,45-49,1962,0.011719499989717538
STAT,1916,54,na,1970,36.3843367870144
STAT,1849,47,30-34,1896,7.470795418497302E-4
SIM,1918,15,25-29,1933,1
STAT,1841,30,30-34,1871,0.211701826434672
STAT,1856,33,30-34,1889,0.12671002426229594
STAT,1902,46,30-34,1948,7.721940987357308E-4
STAT,1851,50,45-49,1901,1.2427892463472468E-4
STAT,1928,32,30-34,1960,0.19603798565033095
STAT,1918,32,20-24,1950,0.025684882164206824
STAT,1910,43,25-29,1953,6.667292646362265E-4
STAT,1882,26,35-39,1908,0.09278723793641738
SIM,1944,23,25-29,1967,3
STAT,1808,49,35-39,1857,9.821176544140726E-4
STAT,1839,36,35-39,1875,0.047131013827320226
STAT,1953,19,40-44,1972,0.016811045048848908
STAT,1893,27,25-29,1920,0.5333690382719715
SIM,1893,45,na,1938,35
SIM,1859,9,na,1868,23
STAT,1866,23,45-49,1889,0.006428153081730956
SIM,1924,18,na,1942,51
STAT,1846,30,na,1876,21.191858803289037
STAT,1827,28,na,1855,17.524394280050707
STAT,1883,39,30-34,1922,0.05123365549671803
SIM,1807,48,na,1855,17
STAT,1860,36,25-29,1896,0.023519746872683954
STAT,1929,17,na,1946,46.7495358441828
STAT,1933,22,45-49,1955,0.01486405379067162
STAT,1865,50,45-49,1915,1.331492518527934E-4
STAT,1834,46,25-29,1880,4.804978075681815E-4
STAT,1870,83,na,1953,3.943623483458497
STAT,1936,23,25-29,1959,0.8774666462327237
STAT,1871,61,na,1932,18.630303315061933
SIM,1888,5,na,1893,40
STAT,1957,9,na,1966,51.51809730832848
STAT,1861,28,40-44,1889,0.02519219257723392
STAT,1871,47,40-44,1918,0.0016989071184517217
STAT,1866,43,15-19,1909,1.262672199936532E-4
STAT,1861,47,30-34,1908,8.102498255494398E-4
STAT,1909,25,na,1934,35.8304595706096
STAT,1815,53,35-39,1868,1.170769767427724E-4
STAT,1820,49,na,1869,14.251950188196577
STAT,1841,15,40-44,1856,0.002336436160469186
STAT,1862,49,40-44,1911,0.0014462133057835485
STAT,1863,37,40-44,1900,0.03875830538680622
STAT,1844,18,15-19,1862,0.058577431599088105
STAT,1847,39,45-49,1886,0.021640560366343632
STAT,1853,18,40-44,1871,0.0013746427336117368
STAT,1927,29,40-44,1956,0.056148435218903746
STAT,1855,30,30-34,1885,0.12779324802901665
STAT,1844,19,50-100,1863,4.807297639788104E-4
STAT,1876,29,15-19,1905,0.004575076253939583
STAT,1895,36,50-100,1931,0.016015951063321644
STAT,1888,8,na,1896,30.37824618314378
STAT,1846,94,na,1940,0.16197279216343596
SIM,1812,54,na,1866,18
STAT,1806,51,45-49,1857,4.7955781356690815E-4
STAT,1843,50,na,1893,9.264852753188704
STAT,1834,39,35-39,1873,0.0608947070848018
STAT,1832,34,na,1866,12.397579099663936
STAT,1888,45,45-49,1933,0.0027853863503037864
STAT,1892,3,na,1895,32.659750263868474
SIM,1823,70,na,1893,6
SIM,1896,25,na,1921,32
SIM,1866,59,na,1925,27
STAT,1835,101,na,1936,0.002566624130673849
STAT,1816,48,30-34,1864,0.0012017218879833182
STAT,1916,30,45-49,1946,0.016236623552240367
STAT,1932,37,na,1969,50.34436460873785
STAT,1886,39,na,1925,24.191802340789952
STAT,1802,68,na,1870,6.333505005845617
STAT,1840,43,45-49,1883,0.012077802353070832
SIM,1868,14,na,1882,38
STAT,1847,46,35-39,1893,0.001499777901820273
STAT,1858,39,20-24,1897,0.005806697642402608
STAT,1826,36,25-29,1862,0.034139810208179036
STAT,1850,15,35-39,1865,0.006040972841518273
STAT,1838,42,25-29,1880,0.005828759475475095
STAT,1857,49,30-34,1906,7.095223869178638E-4
STAT,1861,99,na,1960,0.03425380544530309
STAT,1897,42,30-34,1939,0.0010588721973562084
STAT,1919,34,30-34,1953,0.1670633117166108
STAT,1851,102,na,1953,0.002475073883189947
STAT,1911,32,50-100,1943,0.00799912927349099
SIM,1911,24,25-29,1935,1
SIM,1800,69,na,1869,8
SIM,1824,51,na,1875,16
SIM,1799,67,na,1866,13
STAT,1938,22,45-49,1960,0.011062442020081921
STAT,1811,72,na,1883,7.692216355865196
SIM,1869,28,35-39,1897,1
STAT,1838,46,40-44,1884,0.0013846520864435764
STAT,1873,42,45-49,1915,0.015197496603769688
STAT,1901,45,25-29,1946,4.591717970055632E-4
STAT,1903,24,25-29,1927,0.8087848241863749
SIM,1836,20,20-24,1856,2
SIM,1829,82,na,1911,10
SIM,1925,5,na,1930,45
STAT,1895,48,40-44,1943,0.0012379855321643614
STAT,1895,21,15-19,1916,0.04295905880663799
STAT,1897,27,40-44,1924,0.03977975248090968
STAT,1812,47,35-39,1859,0.0015723954716497554
STAT,1936,30,15-19,1966,0.0012420373419129375
SIM,1841,51,na,1892,14
STAT,1846,44,25-29,1890,0.005133973902986144
STAT,1821,48,40-44,1869,0.0023834528722700755
SIM,1872,83,na,1955,4
STAT,1889,32,30-34,1921,0.21376485500922568
SIM,1806,70,na,1876,4
SIM,1847,52,na,1899,15
SIM,1887,80,na,1967,9
SIM,1922,8,na,1930,52
STAT,1875,47,25-29,1922,5.89334307218023E-4
STAT,1879,47,40-44,1926,0.0017636762558580444
STAT,1910,32,20-24,1942,0.023375077628670145
STAT,1848,17,50-100,1865,3.9275815294206157E-4
STAT,1933,9,na,1942,53.07264243252172
STAT,1829,82,na,1911,3.169270548801165
STAT,1874,42,35-39,1916,0.01834793306086631
STAT,1822,88,na,1910,0.48696632578177157
STAT,1923,15,50-100,1938,0.004389180295487325
SIM,1929,21,na,1950,44
STAT,1864,8,na,1872,25.038075435907864
STAT,1892,23,na,1915,29.127707679615366
STAT,1881,25,50-100,1906,0.00612824681284535
SIM,1902,39,na,1941,31
SIM,1899,61,na,1960,25
STAT,1892,33,15-19,1925,0.0017518909785633346
SIM,1864,48,na,1912,22
STAT,1891,40,45-49,1931,0.018554571782648563
STAT,1814,53,45-49,1867,3.907857844762752E-4
STAT,1849,18,15-19,1867,0.05630840630086932
STAT,1877,40,50-100,1917,0.011015380253546021
STAT,1871,43,25-29,1914,0.006356059072021685
STAT,1922,23,na,1945,41.442602479440204
STAT,1926,37,na,1963,45.71622544487518
STAT,1825,42,15-19,1867,1.3429486361642344E-4
STAT,1901,38,35-39,1939,0.021255677974921137
STAT,1840,69,na,1909,11.499541300085392
SIM,1824,83,na,1907,5
STAT,1859,29,15-19,1888,0.003615860948082008
STAT,1944,22,20-24,1966,1.1918730162607372
SIM,1916,51,na,1967,44
STAT,1893,35,25-29,1928,0.03664792070284474
STAT,1884,42,20-24,1926,0.0015540581165438474
STAT,1804,90,na,1894,0.3060840892578822
STAT,1864,32,25-29,1896,0.09186826202910973
STAT,1925,43,50-100,1968,0.0014111842387721483
SIM,1876,33,na,1909,30
STAT,1830,41,50-100,1871,0.005859996807171695
STAT,1927,8,na,1935,49.33788207434553
STAT,1860,26,30-34,1886,0.20841190099900006
STAT,1817,38,20-24,1855,0.028742760819151936
STAT,1886,7,na,1893,27.024481987511866
STAT,1840,14,na,1854,24.0
STAT,1844,28,na,1872,20.53650510229181
STAT,1944,22,na,1966,39.142874511756176
STAT,1814,53,na,1867,12.432851174003812
SIM,1895,56,na,1951,24
STAT,1839,29,45-49,1868,0.0076085454324107465
SIM,1883,62,na,1945,6
STAT,1837,24,30-34,1861,0.1145445342847365
STAT,1875,29,30-34,1904,0.25700527813459767
STAT,1884,29,20-24,1913,0.11411763127689822
STAT,1937,25,35-39,1962,0.14555392902121045
STAT,1897,34,30-34,1931,0.2298721901555134
STAT,1898,24,na,1922,31.70479827407344
SIM,1887,76,na,1963,11
STAT,1775,88,na,1863,0.6695337011395598
STAT,1945,24,30-34,1969,0.31252624473477
STAT,1875,27,na,1902,24.532078705136037
STAT,1913,21,30-34,1934,0.2770091781945053
STAT,1918,43,25-29,1961,7.511765188451632E-4
STAT,1924,48,30-34,1972,0.0010514601555024145
STAT,1832,41,45-49,1873,0.008337855026496747
STAT,1823,73,na,1896,6.830624122703396
SIM,1884,19,20-24,1903,1
SIM,1873,68,na,1941,15
STAT,1901,37,50-100,1938,0.0037080276958895266
SIM,1903,6,na,1909,39
STAT,1823,35,40-44,1858,0.032686815551964045
SIM,1882,24,35-39,1906,1
STAT,1910,48,30-34,1958,8.243525323862925E-4
STAT,1848,30,50-100,1878,0.007055024936593961
STAT,1877,23,20-24,1900,0.709158745449688
STAT,1900,18,25-29,1918,0.07837362440524459
STAT,1941,24,50-100,1965,0.006745960746145028
STAT,1834,28,30-34,1862,0.23167522708246582
STAT,1905,11,na,1916,37.327457584803106
STAT,1800,102,na,1902,0.0010624133429000533
STAT,1897,9,na,1906,34.45557020895137
STAT,1921,45,50-100,1966,0.0025417787729303093
STAT,1891,22,45-49,1913,0.008558672535019449
STAT,1853,48,35-39,1901,8.688180574548192E-4
STAT,1863,32,30-34,1895,0.15458792099522467
STAT,1916,49,35-39,1965,0.0013034182150923074
SIM,1945,25,35-39,1970,1
STAT,1865,4,na,1869,27.30020110774362
STAT,1868,73,na,1941,11.494420561126901
SIM,1901,21,na,1922,37
STAT,1926,42,20-24,1968,2.1647142705103538E-4
STAT,1951,20,50-100,1971,0.007819119602125666
STAT,1865,19,45-49,1884,6.016923987206709E-4
STAT,1873,34,45-49,1907,0.017577520288802967
STAT,1869,31,15-19,1900,0.0013854858373582263
STAT,1890,26,40-44,1916,0.03651207276561373
SIM,1867,2,na,1869,26
STAT,1881,44,45-49,1925,0.014048952175352243
STAT,1907,1,na,1908,39.81414432967738
STAT,1868,29,40-44,1897,0.028782236069373725
STAT,1811,88,na,1899,0.7780015270741965
STAT,1837,17,40-44,1854,0.0017691773007994026
STAT,1946,21,40-44,1967,0.037164915250646476
SIM,1887,9,na,1896,26
STAT,1809,62,na,1871,12.854471297366784
STAT,1841,40,30-34,1881,0.011996900455245221
STAT,1807,51,35-39,1858,1.7994825268253162E-4
STAT,1867,84,na,1951,3.1834555566208325
STAT,1938,22,na,1960,35.90364999416262
SIM,1917,36,na,1953,37
STAT,1850,20,50-100,1870,0.004421163901140273
STAT,1856,41,30-34,1897,0.008366264926733005
STAT,1817,97,na,1914,0.0425770734876086
SIM,1907,42,na,1949,38
STAT,1863,70,na,1933,12.422785512773588
STAT,1843,28,20-24,1871,0.06080383719373891
STAT,1867,37,25-29,1904,0.027552781511057185
STAT,1900,25,15-19,1925,0.006334094400922721
STAT,1841,22,30-34,1863,0.22086581282949946
STAT,1820,46,30-34,1866,8.292715631887523E-4
STAT,1852,54,na,1906,17.92109352570454
STAT,1848,31,30-34,1879,0.13304981926562068
STAT,1865,26,35-39,1891,0.0875728355558692
STAT,1830,42,25-29,1872,0.003504026948094436
STAT,1842,38,30-34,1880,0.04642286267091629
SIM,1900,32,na,1932,36
STAT,1873,52,45-49,1925,1.4676117636617026E-4
STAT,1852,34,25-29,1886,0.0888971781280846
STAT,1813,49,45-49,1862,0.007099513390027416
STAT,1842,34,15-19,1876,0.0012641913226794847
STAT,1912,24,na,1936,35.95887791533283
STAT,1851,85,na,1936,2.3143275994075876
SIM,1817,70,na,1887,2
STAT,1931,40,40-44,1971,0.003335906589090596
SIM,1913,39,na,1952,40
STAT,1832,30,40-44,1862,0.02587583264847202
SIM,1900,63,na,1963,24
STAT,1900,31,45-49,1931,0.024280088207247637
STAT,1856,45,50-100,1901,0.0017969462439235387
STAT,1859,65,na,1924,13.432107470515469
STAT,1837,42,30-34,1879,0.006605139849279072
STAT,1921,16,40-44,1937,0.015858006331059587
STAT,1915,36,15-19,1951,1.932432446908038E-4
STAT,1855,99,na,1954,0.013334146106581917
STAT,1878,25,30-34,1903,0.261746158712065
SIM,1868,23,20-24,1891,3
STAT,1846,48,40-44,1894,0.0013700195306065534
STAT,1823,66,na,1889,9.462735119708894
SIM,1876,80,na,1956,8
SIM,1891,1,na,1892,38
STAT,1878,48,40-44,1926,0.0017452901644939792
SIM,1940,17,na,1957,35
STAT,1886,37,50-100,1923,0.012734962088864722
STAT,1876,27,25-29,1903,0.42963258365742785
STAT,1812,44,30-34,1856,0.013088117510456888
SIM,1871,33,na,1904,24
STAT,1824,31,45-49,1855,0.029426314179176006
STAT,1897,45,35-39,1942,0.001059163583124213
STAT,1873,29,45-49,1902,0.011207689836298268
SIM,1880,10,na,1890,35
STAT,1937,31,40-44,1968,0.03849459166879324
STAT,1903,32,25-29,1935,0.14562250403257576
STAT,1881,20,30-34,1901,0.17050289453663714
STAT,1881,21,20-24,1902,0.6577120260101523
STAT,1907,61,na,1968,30.024236318122753
STAT,1846,22,30-34,1868,0.17811505335699426
STAT,1896,60,na,1956,25.28022332297405
SIM,1862,84,na,1946,5
STAT,1945,20,15-19,1965,0.05796254793796151
SIM,1866,50,na,1916,27
STAT,1920,43,na,1963,40.60465225387326
STAT,1825,49,35-39,1874,0.0012577236519501348
STAT,1916,44,50-100,1960,0.0011896430745636265
STAT,1855,34,25-29,1889,0.07191884717308962
STAT,1911,31,20-24,1942,0.023695043212223123
SIM,1830,52,na,1882,17
STAT,1923,41,45-49,1964,0.001934535418129796
STAT,1840,20,20-24,1860,0.6966778677235506
STAT,1878,21,15-19,1899,0.03416253236421824
STAT,1880,29,40-44,1909,0.031274808896978035
STAT,1936,34,30-34,1970,0.15191027783778746
STAT,1860,40,45-49,1900,0.012290048406874312
SIM,1893,76,na,1969,21
STAT,1837,47,40-44,1884,8.65054179426648E-4
SIM,1822,53,na,1875,14
STAT,1851,32,15-19,1883,0.0012513263577538848
STAT,1953,4,na,1957,47.297630041394044
STAT,1838,49,45-49,1887,0.001836778252167158
STAT,1873,36,35-39,1909,0.0722559768942417
STAT,1921,49,20-24,1970,1.228848491486043E-4
STAT,1888,42,40-44,1930,0.0262526320820518
STAT,1936,6,na,1942,38.14101913622096
STAT,1816,44,15-19,1860,1.7976737752121446E-4
STAT,1943,16,na,1959,38.758201721081676
SIM,1877,21,20-24,1898,1
STAT,1848,102,na,1950,0.0018959619527536891
SIM,1857,14,na,1871,23
SIM,1929,6,na,1935,51
STAT,1891,13,na,1904,31.64765204691231
STAT,1912,18,40-44,1930,0.0027988843520197148
STAT,1919,30,15-19,1949,0.001385442476529318
SIM,1885,57,na,1942,17
STAT,1851,39,35-39,1890,0.05911081680099594
STAT,1918,49,na,1967,38.51395933604776
SIM,1869,3,na,1872,20
SIM,1927,35,na,1962,50
STAT,1811,44,50-100,1855,0.04352277863437158
STAT,1869,28,40-44,1897,0.028923089908535798
SIM,1926,6,na,1932,50
STAT,1924,40,45-49,1964,0.001972210480349447
STAT,1910,49,45-49,1959,0.0020035748617764537
STAT,1953,15,25-29,1968,0.5214676589119874
STAT,1841,33,35-39,1874,0.11902611338439625
SIM,1843,26,25-29,1869,1
SIM,1805,85,na,1890,1
STAT,1869,21,20-24,1890,0.6697375939006521
STAT,1838,28,na,1866,21.204510828326793
SIM,1880,32,35-39,1912,1
STAT,1860,18,30-34,1878,0.014856385975435158
STAT,1881,28,40-44,1909,0.028403757285631367
SIM,1843,15,na,1858,23
STAT,1900,39,na,1939,32.596297995009905
SIM,1818,48,na,1866,24
STAT,1896,1,na,1897,35.7526960309619
STAT,1874,49,30-34,1923,9.615236951468484E-4
STAT,1915,24,50-100,1939,0.006700677952332941
STAT,1864,26,50-100,1890,0.005757237165229316
STAT,1826,29,35-39,1855,0.2523276635661682
STAT,1846,49,50-100,1895,0.0019488531649821776
STAT,1835,51,na,1886,10.066893023768309
STAT,1877,93,na,1970,1.248415769137183
SIM,1855,44,na,1899,16
STAT,1872,46,na,1918,23.085057650070766
SIM,1878,41,30-34,1919,1
SIM,1929,16,35-39,1945,1
STAT,1912,46,50-100,1958,0.0021620471959499362
STAT,1884,45,25-29,1929,5.699633167101485E-4
STAT,1942,18,30-34,1960,0.12640945949785784
SIM,1889,56,na,1945,22
STAT,1851,46,25-29,1897,4.8765763163663157E-4
STAT,1857,32,50-100,1889,0.006901434308834955
STAT,1889,27,35-39,1916,0.11813488972664571
STAT,1871,40,20-24,1911,0.0015993432334507737
STAT,1889,19,na,1908,30.755969238513032
STAT,1919,23,25-29,1942,0.9995913485650001
STAT,1947,15,na,1962,41.20093748598431
STAT,1900,47,30-34,1947,7.536436097637368E-4
STAT,1887,41,30-34,1928,0.012605497715638502
SIM,1902,43,na,1945,31
STAT,1852,26,25-29,1878,0.4247277291293046
STAT,1930,42,na,1972,48.63727215440596
STAT,1848,80,na,1928,4.000460729993498
STAT,1884,32,na,1916,23.37992903827346
STAT,1789,84,na,1873,0.6899262248472493
STAT,1835,26,25-29,1861,0.2571337122220509
STAT,1896,32,20-24,1928,0.03550564962509066
STAT,1856,42,45-49,1898,0.010828812079769134
STAT,1904,25,na,1929,34.42826790633069
STAT,1837,48,50-100,1885,0.001225181729287183
SIM,1924,28,30-34,1952,3
STAT,1812,82,na,1894,1.8542720815487708
STAT,1849,39,30-34,1888,0.04141736156839552
STAT,1856,35,50-100,1891,0.008978647097282721
STAT,1890,75,na,1965,15.6147987514742
STAT,1898,20,25-29,1918,0.7768514422635959
STAT,1916,28,30-34,1944,0.40025751315890745
SIM,1881,22,25-29,1903,2
STAT,1832,28,45-49,1860,0.0065947295254293135
STAT,1866,46,na,1912,20.779448189582883
STAT,1872,32,35-39,1904,0.10361712196913121
STAT,1941,19,25-29,1960,0.442825995167696
STAT,1827,59,na,1886,12.334893093651564
STAT,1856,13,na,1869,20.356120811842004
STAT,1904,18,50-100,1922,7.001608260243592E-4
SIM,1815,74,na,1889,3
STAT,1953,15,na,1968,44.29187181783198
SIM,1854,58,na,1912,15
STAT,1816,101,na,1917,0.001713113785570249
STAT,1883,35,15-19,1918,5.504853826289927E-4
STAT,1878,43,30-34,1921,0.011783634908780753
STAT,1884,31,na,1915,23.4754742183421
SIM,1911,11,na,1922,42
STAT,1911,36,30-34,1947,0.01757438240083704
STAT,1887,49,40-44,1936,0.0010320721665873487
STAT,1904,23,30-34,1927,0.2544418833163519
STAT,1937,16,na,1953,35.669120534218585
SIM,1831,37,na,1868,9
SIM,1882,3,na,1885,34
STAT,1866,47,30-34,1913,8.873538780821321E-4
STAT,1927,25,25-29,1952,0.8014998239315293
STAT,1872,15,35-39,1887,0.005699639783785259
STAT,1893,4,na,1897,33.16974615113405
SIM,1784,74,na,1858,3
STAT,1931,27,na,1958,48.150220618330515
STAT,1897,19,40-44,1916,0.0024158454962295646
STAT,1829,41,20-24,1870,0.0014250059341551736
STAT,1842,52,45-49,1894,1.0830394435222874E-4
SIM,1855,43,na,1898,18
SIM,1862,39,40-44,1901,1
STAT,1915,29,25-29,1944,0.6607977149277471
STAT,1804,63,na,1867,10.269201829474724
STAT,1872,47,na,1919,22.912381418848245
STAT,1840,27,40-44,1867,0.02926737451210992
STAT,1888,47,35-39,1935,0.0016284099581826495
SIM,1906,57,na,1963,22
STAT,1845,29,50-100,1874,0.004486289168528117
SIM,1889,25,35-39,1914,1
STAT,1811,51,25-29,1862,1.3713795839281968E-4
STAT,1840,25,50-100,1865,0.006340672546917025
STAT,1825,52,na,1877,12.861961126309593
STAT,1877,26,25-29,1903,0.43815960006702653
STAT,1857,94,na,1951,0.14961738401437796
STAT,1888,33,25-29,1921,0.11918976029357146
STAT,1916,46,30-34,1962,9.087879563813109E-4
SIM,1830,31,30-34,1861,2
SIM,1866,43,na,1909,28
STAT,1905,20,40-44,1925,0.03025383184671164
STAT,1896,31,30-34,1927,0.23027690001209233
STAT,1861,16,25-29,1877,0.05509805468743074
STAT,1887,23,30-34,1910,0.19382168356949647
SIM,1904,62,na,1966,24
SIM,1838,47,na,1885,6
STAT,1814,102,na,1916,0.0013064518073011345
STAT,1846,26,50-100,1872,0.006317013380345972
STAT,1827,40,50-100,1867,0.008499443656391882
STAT,1916,22,45-49,1938,0.011689497776328803
STAT,1900,29,30-34,1929,0.3466971212257417
STAT,1853,80,na,1933,3.887761476931793
STAT,1852,19,35-39,1871,0.005613065278841242
STAT,1822,36,40-44,1858,0.027610479936895912
STAT,1829,40,30-34,1869,0.010454729278803993
SIM,1885,26,25-29,1911,1
STAT,1957,0,na,1957,51.9286691106828
STAT,1890,29,45-49,1919,0.013390490902648582
STAT,1921,23,30-34,1944,0.3211007872514891
SIM,1840,21,25-29,1861,1
STAT,1823,38,45-49,1861,0.014202681880573014
STAT,1888,40,15-19,1928,1.6300979359576924E-4
SIM,1887,21,na,1908,23
STAT,1897,40,40-44,1937,0.0020951203547559965
STAT,1903,44,50-100,1947,0.001028935806207165
STAT,1878,31,na,1909,24.7373752767094
STAT,1846,40,30-34,1886,0.009674781883759016
SIM,1794,67,na,1861,2
STAT,1831,31,35-39,1862,0.10799842097696055
STAT,1915,42,45-49,1957,0.0016611007413999104
SIM,1810,68,na,1878,12
STAT,1876,19,20-24,1895,0.17909345602430515
STAT,1969,2,na,1971,48.83349405554783
STAT,1832,81,na,1913,2.44430327051517
STAT,1892,44,20-24,1936,1.3440545022436374E-4
SIM,1939,20,na,1959,27
STAT,1930,4,na,1934,51.93755249480381
STAT,1908,2,na,1910,39.337062018555386
STAT,1832,35,35-39,1867,0.040980970922980794
STAT,1941,26,15-19,1967,0.0072531670290840065
STAT,1843,21,50-100,1864,0.002186981569167631
STAT,1896,39,40-44,1935,0.05692136253408435
STAT,1903,40,na,1943,33.30585592615944
SIM,1870,17,na,1887,26
SIM,1903,2,na,1905,39
SIM,1862,29,na,1891,24
STAT,1873,31,40-44,1904,0.04427126073467621
STAT,1836,95,na,1931,0.12831591634034062
STAT,1825,46,30-34,1871,9.054529982960258E-4
SIM,1858,1,na,1859,31
STAT,1831,51,50-100,1882,1.297579633293846E-4
STAT,1938,21,30-34,1959,0.28267072779840696
STAT,1904,16,40-44,1920,0.002627237616612372
STAT,1819,52,na,1871,12.814502957928292
STAT,1892,37,30-34,1929,0.06584201134449333
SIM,1840,41,na,1881,17
STAT,1875,39,20-24,1914,0.007844130421446391
STAT,1899,34,na,1933,32.387332488550896
SIM,1810,75,na,1885,10
SIM,1933,38,na,1971,49
SIM,1848,24,35-39,1872,1
SIM,1835,67,na,1902,12
STAT,1873,22,25-29,1895,0.5820119100606622
STAT,1855,25,50-100,1880,0.005233727035974698
STAT,1859,19,20-24,1878,0.16164510833510026
STAT,1897,43,45-49,1940,0.0013701710849094658
STAT,1887,43,35-39,1930,0.01962239336225546
STAT,1851,14,na,1865,24.281341382185364
SIM,1853,48,na,1901,22
STAT,1852,31,20-24,1883,0.024202590138145165
SIM,1815,78,na,1893,1
STAT,1914,21,45-49,1935,0.010972535860661823
STAT,1860,22,15-19,1882,0.027647758490109076
STAT,1906,21,na,1927,34.463535732405845
SIM,1886,8,na,1894,30
STAT,1901,17,30-34,1918,0.022302520897207717
SIM,1888,61,na,1949,27
STAT,1879,52,40-44,1931,1.0838216316967572E-4
SIM,1939,16,na,1955,29
STAT,1855,31,20-24,1886,0.019580175861491002
STAT,1865,31,30-34,1896,0.15856629875597872
STAT,1876,61,na,1937,18.9787177882003
SIM,1927,20,20-24,1947,2
STAT,1835,19,35-39,1854,0.006601829407289669
STAT,1829,48,50-100,1877,0.0020696712074637566
STAT,1883,50,40-44,1933,1.0370117040861166E-4
STAT,1832,32,30-34,1864,0.10203550602887607
STAT,1949,19,50-100,1968,0.004326613905515426
SIM,1906,36,na,1942,27
STAT,1837,20,15-19,1857,0.027860407202388925
STAT,1920,32,25-29,1952,0.10037703541105765
SIM,1848,62,na,1910,20
STAT,1862,19,40-44,1881,0.001625335754086961
SIM,1867,28,na,1895,15
STAT,1851,43,20-24,1894,0.001331063437337665
SIM,1863,14,na,1877,17
STAT,1846,25,35-39,1871,0.09597302460206873
STAT,1906,29,20-24,1935,0.1692182405163901
STAT,1802,67,na,1869,6.57411771418478
STAT,1836,25,25-29,1861,0.5359224733168546
STAT,1875,51,45-49,1926,1.498929892619774E-4
STAT,1910,46,40-44,1956,0.001465644986263357
STAT,1926,15,30-34,1941,0.14927685768937263
STAT,1824,33,35-39,1857,0.16019520255209632
STAT,1838,66,na,1904,12.721122177838595
STAT,1922,20,40-44,1942,0.03850452734745856
SIM,1827,63,na,1890,5
STAT,1813,51,50-100,1864,4.5865292890838694E-4
STAT,1834,32,15-19,1866,0.0012890898383745332
SIM,1851,29,na,1880,20
STAT,1843,81,na,1924,2.293888308552177
STAT,1869,27,na,1896,23.124011708315614
STAT,1921,19,45-49,1940,0.005619398395794349
STAT,1947,25,50-100,1972,0.011193507537264509
STAT,1830,38,40-44,1868,0.025072521879659367
STAT,1843,18,30-34,1861,0.008589319334172566
STAT,1854,42,30-34,1896,0.00701852326032019
STAT,1902,47,45-49,1949,0.001868539962115996
SIM,1931,24,na,1955,52
SIM,1942,3,na,1945,43
STAT,1834,50,45-49,1884,1.0940601954400578E-4
STAT,1919,20,20-24,1939,1.2142436804148744
STAT,1883,46,na,1929,21.90981664608261
STAT,1910,39,50-100,1949,0.003950781376908237
STAT,1912,43,50-100,1955,0.0011174470797887292
STAT,1873,33,30-34,1906,0.1767625594833041
STAT,1911,39,35-39,1950,0.0229777610532705
STAT,1817,66,na,1883,14.521493215960136
STAT,1868,27,15-19,1895,0.00439068501864496
STAT,1901,39,25-29,1940,0.00860823012772311
STAT,1868,32,45-49,1900,0.016875757358085917
STAT,1930,18,50-100,1948,0.004808424500051873
STAT,1814,52,na,1866,12.681535834652625
STAT,1870,19,50-100,1889,4.855451874668924E-4
SIM,1880,47,na,1927,32
STAT,1850,23,35-39,1873,0.06191384136957913
STAT,1840,23,25-29,1863,0.5663537736527751
STAT,1849,101,na,1950,0.004424565685298795
SIM,1916,10,na,1926,47
STAT,1891,24,35-39,1915,0.07117420003595089
STAT,1803,53,na,1856,12.494010422557322
STAT,1881,24,25-29,1905,0.5413068380287734
SIM,1870,15,25-29,1885,2
STAT,1807,67,na,1874,9.120386791400604
SIM,1921,24,35-39,1945,1
STAT,1917,33,50-100,1950,0.008542933912179045
STAT,1913,47,20-24,1960,1.0696177722775092E-4
STAT,1821,34,na,1855,17.601111717036506
STAT,1849,27,50-100,1876,0.005879755853904977
STAT,1901,31,15-19,1932,0.00200080971696317
STAT,1914,37,50-100,1951,0.0041572531355723785
STAT,1850,41,35-39,1891,0.016195802414832518
SIM,1901,58,na,1959,31
STAT,1901,35,30-34,1936,0.01624925581859758
STAT,1903,28,40-44,1931,0.04243901282708478
SIM,1945,23,na,1968,40
STAT,1847,32,25-29,1879,0.12846749120754963
STAT,1895,43,30-34,1938,0.0010289790265905327
STAT,1913,24,35-39,1937,0.09369665057961293
STAT,1869,24,25-29,1893,0.5512040603280148
STAT,1925,21,20-24,1946,1.3266553188352066
STAT,1856,18,40-44,1874,0.0015575106019244432
STAT,1851,36,30-34,1887,0.04595044403153091
SIM,1933,21,20-24,1954,5
STAT,1893,32,20-24,1925,0.0340822557040321
STAT,1895,25,30-34,1920,0.3291432995845627
STAT,1810,45,25-29,1855,5.765971860304278E-4
STAT,1852,36,15-19,1888,4.882491745352599E-4
SIM,1876,25,25-29,1901,2
STAT,1828,34,30-34,1862,0.07721110592133085
STAT,1826,41,20-24,1867,0.0017118778415424712
SIM,1885,0,na,1885,36
STAT,1910,47,40-44,1957,0.0014620101866974228
SIM,1947,0,na,1947,44
STAT,1891,42,35-39,1933,0.022197909825775235
STAT,1892,47,25-29,1939,3.9952738505460956E-4
SIM,1831,30,na,1861,9
STAT,1846,42,35-39,1888,0.014853004852642451
STAT,1887,26,50-100,1913,0.0070062533164494765
STAT,1870,76,na,1946,9.41139973665286
STAT,1832,25,40-44,1857,0.018181196623053168
STAT,1822,39,45-49,1861,0.0116856022935007
STAT,1830,48,na,1878,8.569018205659043
STAT,1859,23,50-100,1882,0.00333869623130948
STAT,1918,39,40-44,1957,0.015602498461684537
STAT,1934,21,50-100,1955,0.008808127256610414
STAT,1896,35,25-29,1931,0.03817846574660175
STAT,1859,39,40-44,1898,0.03444295423632333
STAT,1828,27,40-44,1855,0.046953137470902795
STAT,1906,28,20-24,1934,0.1698364451768337
SIM,1914,28,20-24,1942,1
STAT,1815,41,45-49,1856,0.023706942059108164
STAT,1829,51,na,1880,15.745097368332347
STAT,1874,16,35-39,1890,0.005580278795878976
STAT,1883,51,40-44,1934,1.0272119434825031E-4
STAT,1829,44,25-29,1873,0.00553256411940714
STAT,1882,32,45-49,1914,0.016711811517139585
STAT,1813,67,na,1880,12.386615825695305
STAT,1836,29,40-44,1865,0.03687293190109943
SIM,1824,82,na,1906,5
STAT,1844,99,na,1943,0.014792901686493415
STAT,1897,38,na,1935,31.131145784629656
STAT,1921,26,35-39,1947,0.16659133580027083
STAT,1805,104,na,1909,1.8262599020891932E-4
SIM,1839,81,na,1920,9
STAT,1834,38,20-24,1872,0.0067059383097143105
STAT,1912,17,na,1929,38.74975442259079
STAT,1936,27,40-44,1963,0.04433729211144757
STAT,1887,44,35-39,1931,0.019498379836206003
STAT,1845,49,40-44,1894,9.79852758794128E-4
SIM,1879,57,na,1936,12
STAT,1824,51,35-39,1875,1.0972324363553835E-4
STAT,1895,18,40-44,1913,0.002368327205992744
STAT,1867,42,20-24,1909,0.0015179069876413674
STAT,1893,37,15-19,1930,7.080401554649395E-4
SIM,1965,4,na,1969,52
STAT,1862,15,25-29,1877,0.05665984255147289
STAT,1890,34,45-49,1924,0.021000904642814126
STAT,1830,52,na,1882,8.02870529577729
STAT,1860,28,20-24,1888,0.09570327524454635
STAT,1808,52,na,1860,4.565333609699568
STAT,1843,44,25-29,1887,0.0027337025275738346
STAT,1839,41,30-34,1880,0.0074429243315169155
SIM,1846,66,na,1912,5
STAT,1769,85,na,1854,4.0
STAT,1842,33,na,1875,19.4401018612624
STAT,1929,32,45-49,1961,0.01989233638403652
STAT,1823,43,45-49,1866,0.010518475664272216
STAT,1907,40,45-49,1947,0.0015355739584934746
SIM,1878,13,na,1891,31
STAT,1870,52,50-100,1922,1.492303078948317E-4
STAT,1908,16,25-29,1924,0.08382911936115081
STAT,1949,19,15-19,1968,0.5240972704755898
STAT,1894,15,25-29,1909,0.0729617553547705
STAT,1850,99,na,1949,0.01686232728951112
STAT,1821,93,na,1914,0.18151558744925136
STAT,1843,18,na,1861,12.370076484294307
SIM,1835,24,25-29,1859,1
STAT,1846,43,35-39,1889,0.014663926100868313
STAT,1884,19,30-34,1903,0.015532221720283554
STAT,1861,53,50-100,1914,1.249681656016534E-4
STAT,1827,31,45-49,1858,0.015917926067424405
STAT,1848,26,35-39,1874,0.07503205655085635
STAT,1831,96,na,1927,0.06968018565588242
STAT,1833,48,30-34,1881,7.542102841751502E-4
STAT,1882,61,na,1943,17.907952777343336
STAT,1939,15,40-44,1954,0.013938998408077396
STAT,1905,38,50-100,1943,0.0038055835706108845
STAT,1854,24,30-34,1878,0.12609379901517612
SIM,1907,43,na,1950,38
SIM,1891,10,na,1901,38
SIM,1900,11,na,1911,40
STAT,1812,54,50-100,1866,1.573716391266279E-4
STAT,1888,44,30-34,1932,0.01325365307046789
SIM,1861,44,na,1905,23
SIM,1866,28,na,1894,28
STAT,1844,66,na,1910,12.802227189561348
SIM,1850,44,na,1894,19
STAT,1894,22,45-49,1916,0.008936816711823033
SIM,1925,24,na,1949,44
STAT,1849,23,45-49,1872,0.006490253094902837
STAT,1864,44,45-49,1908,0.013242513375334249
SIM,1921,10,na,1931,42
SIM,1904,25,na,1929,31
STAT,1927,22,20-24,1949,1.3629826656119084
STAT,1841,31,45-49,1872,0.020925700290856542
SIM,1935,22,20-24,1957,2
STAT,1854,17,40-44,1871,0.0013373559097034575
SIM,1845,81,na,1926,4
STAT,1848,19,45-49,1867,5.175267833406959E-4
STAT,1875,33,15-19,1908,0.0014576910035118812
STAT,1887,26,35-39,1913,0.10568022709808945
SIM,1897,42,na,1939,40
SIM,1845,29,na,1874,24
STAT,1930,0,na,1930,57.971962442603854
STAT,1861,62,na,1923,15.370405920482769
STAT,1928,35,35-39,1963,0.03047117400893007
SIM,1912,34,35-39,1946,2
STAT,1909,47,30-34,1956,8.145575167044525E-4
STAT,1833,29,na,1862,20.803455071342004
STAT,1942,21,50-100,1963,0.0068510417638052564
SIM,1933,24,25-29,1957,1
STAT,1828,37,35-39,1865,0.031633115349475105
SIM,1830,32,25-29,1862,1
SIM,1895,19,na,1914,31
STAT,1814,48,50-100,1862,0.006926541519402185
STAT,1871,68,na,1939,15.236134988688374
STAT,1859,32,20-24,1891,0.02148436739256984
SIM,1884,31,na,1915,26
STAT,1900,60,na,1960,27.565459394247622
STAT,1901,23,50-100,1924,0.005688452939245975
SIM,1834,82,na,1916,3
STAT,1906,20,25-29,1926,0.83663554313878
STAT,1788,102,na,1890,0.0010514652842035538
STAT,1880,32,30-34,1912,0.1835981986300414
STAT,1852,47,50-100,1899,0.0020921637421553578
STAT,1874,22,45-49,1896,0.007074267442066587
STAT,1853,43,na,1896,14.420777241461735
STAT,1839,34,45-49,1873,0.011599286004138913
STAT,1886,39,35-39,1925,0.07262664528731401
STAT,1898,17,na,1915,34.07044854171152
STAT,1916,24,15-19,1940,0.05495673533615899
SIM,1910,25,na,1935,32
STAT,1829,104,na,1933,4.5306137090058855E-4
STAT,1918,47,40-44,1965,0.0016625920464597506
SIM,1795,84,na,1879,3
SIM,1886,32,na,1918,30
STAT,1853,21,45-49,1874,0.005215597710534467
STAT,1920,28,40-44,1948,0.05051693618214817
STAT,1836,45,30-34,1881,0.001003038146197257
STAT,1949,21,45-49,1970,0.0130497429488143
STAT,1819,48,35-39,1867,0.001243819176317719
STAT,1907,33,20-24,1940,0.022607506587209322
STAT,1856,31,40-44,1887,0.0321332005916364
STAT,1840,21,35-39,1861,0.05857079976801554
STAT,1931,15,50-100,1946,0.004904835312148936
STAT,1951,21,15-19,1972,0.06323389789758323
STAT,1868,48,30-34,1916,9.250068129677101E-4
STAT,1845,45,25-29,1890,3.400568820533365E-4
STAT,1847,24,25-29,1871,0.7389359283545179
STAT,1904,34,35-39,1938,0.08260867365614741
STAT,1908,18,30-34,1926,0.023459058355603413
STAT,1813,41,30-34,1854,0.03993923854002615
STAT,1922,23,45-49,1945,0.012769074652985095
STAT,1925,24,25-29,1949,1.0918571766873169
SIM,1872,46,na,1918,21
STAT,1875,25,15-19,1900,0.004695440468281208
STAT,1895,28,35-39,1923,0.12482677592439956
STAT,1894,38,30-34,1932,0.06796465150857377
STAT,1864,21,20-24,1885,0.6325732325273853
STAT,1869,35,50-100,1904,0.012009086709939987
STAT,1917,18,40-44,1935,0.0029747479672777312
STAT,1812,57,na,1869,10.212428332474664
SIM,1802,71,na,1873,7
STAT,1872,33,35-39,1905,0.10317985771442148
STAT,1825,54,50-100,1879,1.2925279688492483E-4
STAT,1948,15,na,1963,41.866938357776775
SIM,1865,74,na,1939,6
SIM,1920,33,30-34,1953,1
STAT,1871,32,20-24,1903,0.02694950531525311
STAT,1855,44,na,1899,16.053090097117785
STAT,1856,22,25-29,1878,0.4816425787911675
STAT,1923,33,na,1956,43.03052409254092
STAT,1921,31,30-34,1952,0.17467390439076852
STAT,1848,32,45-49,1880,0.013151330286534677
STAT,1849,21,40-44,1870,0.0196763877832906
STAT,1907,26,15-19,1933,0.006659315823904021
STAT,1857,28,15-19,1885,0.003473281674445441
SIM,1879,84,na,1963,2
STAT,1827,47,30-34,1874,7.297815159606619E-4
STAT,1925,31,15-19,1956,0.0015173164711261536
STAT,1851,42,45-49,1893,0.012619543144517796
STAT,1865,24,45-49,1889,0.006292511489053276
STAT,1822,51,na,1873,8.72973219215775
SIM,1924,45,na,1969,50
STAT,1845,38,35-39,1883,0.0429917367910039
STAT,1889,30,25-29,1919,0.12641146255678137
STAT,1913,39,na,1952,36.44657951682273
STAT,1880,30,20-24,1910,0.02865257481117459
SIM,1882,76,na,1958,14
STAT,1901,15,25-29,1916,0.07966117976594993
STAT,1952,20,na,1972,43.67716881651607
STAT,1845,14,na,1859,17.477572416479326
SIM,1894,61,na,1955,26
STAT,1884,41,45-49,1925,0.014729709553351011
STAT,1817,50,45-49,1867,4.1986818578131654E-4
STAT,1903,19,na,1922,35.71481638289811
STAT,1850,8,na,1858,26.717733638847925
STAT,1913,41,35-39,1954,0.0019584944816138793
SIM,1968,1,na,1969,54
STAT,1843,22,15-19,1865,0.017565645423531083
STAT,1903,5,na,1908,37.2584872716442
STAT,1930,24,35-39,1954,0.1193083592984772
STAT,1955,16,50-100,1971,0.004946955432798942
STAT,1831,28,50-100,1859,0.0069044941151590695
SIM,1854,31,na,1885,17
STAT,1831,32,35-39,1863,0.10682787232115441
STAT,1902,39,45-49,1941,0.006006634321155507
STAT,1851,36,50-100,1887,0.010585327288135882
STAT,1896,33,35-39,1929,0.13246130188359656
STAT,1849,53,45-49,1902,1.107212381531924E-4
STAT,1932,1,na,1933,55.07373618321251
STAT,1830,31,20-24,1861,0.018410277526181386
STAT,1930,39,20-24,1969,0.0034150648479904446
STAT,1844,105,na,1949,2.290223113918292E-4
STAT,1884,49,40-44,1933,0.0016423138532520422
STAT,1920,26,30-34,1946,0.42762801723529015
STAT,1911,38,na,1949,35.92466209110139
STAT,1946,23,30-34,1969,0.31747401117604124
SIM,1945,3,na,1948,41
STAT,1917,39,na,1956,38.48636916423689
STAT,1798,82,na,1880,3.068992804163268
STAT,1932,18,20-24,1950,1.783269625612565
SIM,1853,79,na,1932,3
SIM,1874,47,na,1921,25
SIM,1947,18,na,1965,37
STAT,1803,84,na,1887,1.2456587018449639
STAT,1929,26,35-39,1955,0.1870847398666116
STAT,1824,52,na,1876,16.711815156403844
STAT,1862,35,30-34,1897,0.0464184059732632
SIM,1940,18,20-24,1958,2
STAT,1903,29,35-39,1932,0.13620155144634832
STAT,1819,99,na,1918,0.009721779259715874
STAT,1879,32,20-24,1911,0.02797692829431909
STAT,1907,39,na,1946,34.38444144748523
SIM,1847,79,na,1926,7
STAT,1914,15,35-39,1929,0.008648086593896097
SIM,1884,47,na,1931,22
STAT,1950,16,15-19,1966,0.5334439490894041
SIM,1888,23,25-29,1911,1
STAT,1886,46,25-29,1932,5.991617059490294E-4
SIM,1950,16,25-29,1966,3
STAT,1825,52,45-49,1877,1.292295249131143E-4
SIM,1865,64,na,1929,13
STAT,1803,74,na,1877,5.1279542062177335
STAT,1880,17,35-39,1897,0.0057699679757796715
SIM,1885,19,na,1904,24
STAT,1897,23,25-29,1920,0.7578471827880022
STAT,1808,52,45-49,1860,1.0081173455272055E-4
STAT,1849,43,15-19,1892,1.0630669363544084E-4
STAT,1835,23,20-24,1858,0.45502363073290814
STAT,1874,11,na,1885,26.642718949275867
STAT,1935,16,35-39,1951,0.057249809103118866
STAT,1861,43,15-19,1904,1.1529559457562966E-4
STAT,1829,42,35-39,1871,0.016030621992234054
STAT,1910,60,na,1970,31.723830638126007
STAT,1922,37,20-24,1959,0.002977569084298137
STAT,1917,25,30-34,1942,0.40994214038080007
STAT,1926,39,30-34,1965,0.02209975581294839
STAT,1889,43,50-100,1932,0.012841039600436034
STAT,1942,16,25-29,1958,0.44969685139125437
SIM,1892,66,na,1958,26
STAT,1889,30,40-44,1919,0.05352258642752435
STAT,1913,39,20-24,1952,0.002553735255218412
STAT,1899,34,15-19,1933,0.0019327759806209192
STAT,1848,23,30-34,1871,0.13925099069715802
STAT,1907,19,25-29,1926,0.08244563564326911
STAT,1835,85,na,1920,1.2330370729845714
STAT,1878,72,na,1950,13.03834867390563
STAT,1962,10,na,1972,50.04110802512623
STAT,1880,11,na,1891,27.19697811720165
STAT,1895,41,20-24,1936,1.4382335259314076E-4
STAT,1948,16,45-49,1964,0.00568062851166805
STAT,1938,31,25-29,1969,0.09237594140613271
STAT,1903,36,40-44,1939,0.013497836937218535
STAT,1908,18,15-19,1926,0.0873465348185464
STAT,1843,40,45-49,1883,0.006706310370900082
STAT,1912,33,30-34,1945,0.15316768714917384
STAT,1858,42,na,1900,17.565603341216462
STAT,1854,43,25-29,1897,0.003896734714024667
SIM,1892,76,na,1968,12
STAT,1933,23,20-24,1956,1.468448748774712
STAT,1854,27,35-39,1881,0.061827783099245616
SIM,1852,21,20-24,1873,1
STAT,1848,16,40-44,1864,0.0014749851232599013
STAT,1937,34,45-49,1971,0.015450000593047259
STAT,1860,38,15-19,1898,4.542569165004915E-4
STAT,1912,26,40-44,1938,0.0457297498612127
STAT,1870,33,15-19,1903,0.0014086917011228305
STAT,1834,102,na,1936,0.0020718543523229483
STAT,1924,26,15-19,1950,0.008194223528684928
SIM,1834,72,na,1906,9
STAT,1881,22,35-39,1903,0.055527127596666545
STAT,1844,47,30-34,1891,7.525750366445907E-4
STAT,1851,24,15-19,1875,0.03278408205165743
STAT,1858,33,15-19,1891,0.0010790706501133329
STAT,1909,26,35-39,1935,0.1443833727201362
STAT,1830,27,35-39,1857,0.08741951226987248
STAT,1843,48,40-44,1891,7.170944345539942E-4
STAT,1801,89,na,1890,0.3807135687388255
STAT,1862,16,na,1878,22.81622468691292
STAT,1919,24,na,1943,39.39287943316632
STAT,1844,21,20-24,1865,0.6769281185199153
STAT,1873,25,50-100,1898,0.0065478285934796945
SIM,1857,45,na,1902,22
STAT,1924,19,25-29,1943,0.5099442107281517
STAT,1923,29,20-24,1952,0.20663601439374213
STAT,1872,40,25-29,1912,0.006636656730739771
STAT,1892,43,45-49,1935,0.018356042374151116
STAT,1878,62,na,1940,18.869817099616828
STAT,1910,20,15-19,1930,0.0499808216330146
SIM,1859,64,na,1923,14
STAT,1830,41,30-34,1871,0.006377055362974771
STAT,1876,24,20-24,1900,0.6955252779371365
STAT,1875,43,45-49,1918,0.015273460595604978
STAT,1938,24,35-39,1962,0.09251222496641293
STAT,1862,26,na,1888,20.81543794341273
STAT,1933,16,15-19,1949,0.6065321255196107
STAT,1834,66,na,1900,11.582810364973472
STAT,1838,31,20-24,1869,0.026341542439991903
STAT,1820,42,15-19,1862,1.220409186989746E-4
STAT,1834,24,15-19,1858,0.030733852857854616
STAT,1943,15,30-34,1958,0.1283795632839979
STAT,1851,4,na,1855,27.3586
STAT,1798,88,na,1886,0.8622895292334207
STAT,1893,79,na,1972,13.727765404517262
STAT,1947,21,25-29,1968,1.0371553604731196
SIM,1926,40,na,1966,46
STAT,1853,37,30-34,1890,0.03349539515961284
STAT,1830,86,na,1916,0.7971836028117764
STAT,1864,11,na,1875,24.45156661254478
STAT,1839,31,40-44,1870,0.029759036911072134
STAT,1933,23,na,1956,48.22603105871437
STAT,1907,36,25-29,1943,0.009134012927625095
STAT,1858,48,na,1906,16.904929864205766
STAT,1836,48,35-39,1884,0.001395975992657406
STAT,1860,52,na,1912,17.411479389446388
SIM,1872,24,25-29,1896,2
STAT,1825,34,15-19,1859,0.0015670101061353095
STAT,1860,32,45-49,1892,0.014176798513654085
STAT,1873,6,na,1879,27.872579491105345
STAT,1818,76,na,1894,2.3675887140287726
SIM,1875,64,na,1939,11
STAT,1863,33,25-29,1896,0.0903050717689658
STAT,1889,24,30-34,1913,0.21671620138616393
STAT,1845,42,20-24,1887,9.453455482458412E-4
STAT,1910,8,na,1918,39.150012994158935
SIM,1840,72,na,1912,4
STAT,1903,43,30-34,1946,0.0011268459284207752
SIM,1916,20,na,1936,43
STAT,1806,98,na,1904,0.0152005399616946
SIM,1839,26,na,1865,23
STAT,1853,45,30-34,1898,6.144350018796484E-4
SIM,1838,24,25-29,1862,2
STAT,1867,25,na,1892,22.993027299639664
STAT,1946,20,na,1966,40.378700712689636
STAT,1809,99,na,1908,0.010478991249443199
STAT,1873,20,50-100,1893,0.004170712250547809
STAT,1897,15,25-29,1912,0.07560125626535934
STAT,1862,42,50-100,1904,0.00910347154567201
STAT,1892,25,15-19,1917,0.005643102534724537
STAT,1793,89,na,1882,0.2063369103178847
STAT,1849,35,15-19,1884,4.548969701635955E-4
STAT,1859,35,25-29,1894,0.023101680809833682
SIM,1861,13,na,1874,33
STAT,1927,44,30-34,1971,0.0015898785415101168
STAT,1911,34,25-29,1945,0.0886557620822079
SIM,1837,25,na,1862,25
SIM,1914,55,na,1969,32
STAT,1871,35,25-29,1906,0.028978226745052155
SIM,1816,53,na,1869,11
SIM,1918,21,na,1939,36
STAT,1892,34,50-100,1926,0.011222455696154238
STAT,1940,29,20-24,1969,0.1846359824191042
STAT,1915,18,20-24,1933,0.28056471395302146
STAT,1893,39,40-44,1932,0.054639429313177154
STAT,1884,39,15-19,1923,5.446381426639664E-4
STAT,1946,26,35-39,1972,0.16613659720680987
SIM,1906,26,na,1932,27
STAT,1905,23,45-49,1928,0.010032935449472983
STAT,1862,19,50-100,1881,4.353576854051665E-4
STAT,1912,19,35-39,1931,0.008373561775335717
STAT,1868,42,na,1910,22.33937689331391
SIM,1814,52,na,1866,22
STAT,1883,25,na,1908,23.332312189694864
STAT,1852,16,30-34,1868,0.016596148555394506
STAT,1888,22,20-24,1910,0.8053100479273433
STAT,1890,65,na,1955,20.52802362258762
STAT,1897,30,15-19,1927,0.0019063114045919365
STAT,1922,41,50-100,1963,0.001340486320952542
SIM,1860,65,na,1925,16
STAT,1857,22,45-49,1879,0.00602642691953476
STAT,1820,45,50-100,1865,0.0021319177856312472
STAT,1847,70,na,1917,14.988157866798565
STAT,1906,27,50-100,1933,0.00929355227224906
STAT,1920,18,30-34,1938,0.13523217369433488
STAT,1866,53,45-49,1919,1.3151065523495851E-4
STAT,1923,39,na,1962,43.198019039662526
STAT,1848,96,na,1944,0.055529893695409685
SIM,1804,68,na,1872,8
STAT,1856,34,45-49,1890,0.012524672253492238
STAT,1836,21,45-49,1857,0.008945827859144169
STAT,1834,42,45-49,1876,0.012750463128375362
STAT,1883,18,15-19,1901,0.05747833369630388
SIM,1923,18,20-24,1941,2
STAT,1866,21,40-44,1887,0.019488120250014132
STAT,1900,66,na,1966,25.35687505135418
SIM,1861,9,na,1870,33
SIM,1890,47,na,1937,24
STAT,1849,7,na,1856,23.623726485599995
STAT,1865,32,45-49,1897,0.015772651006531867
STAT,1855,32,35-39,1887,0.07259975423640785
STAT,1918,15,20-24,1933,0.29474385767737277
STAT,1879,10,na,1889,26.9814577309304
STAT,1830,34,25-29,1864,0.0631080284571576
STAT,1837,43,25-29,1880,0.0036420966397809115
STAT,1866,77,na,1943,7.960892214371862
STAT,1826,48,40-44,1874,0.0017007132329724779
STAT,1865,21,40-44,1886,0.019214860684891887
STAT,1872,1,na,1873,35.81042854110092
STAT,1898,23,45-49,1921,0.009377806806460933
SIM,1941,26,25-29,1967,2
STAT,1881,82,na,1963,6.713577688397702
STAT,1849,44,na,1893,17.679250112989443
STAT,1933,26,25-29,1959,0.8707899690712285
SIM,1841,20,na,1861,21
STAT,1929,23,30-34,1952,0.3606013299871225
STAT,1914,56,na,1970,34.78670676526352
STAT,1867,49,40-44,1916,0.0016041096836812904
STAT,1912,6,na,1918,40.080756294617345
STAT,1843,43,na,1886,9.965958407652495
STAT,1866,35,15-19,1901,5.220848112166685E-4
STAT,1887,83,na,1970,8.162090613506184
SIM,1785,84,na,1869,1
SIM,1926,15,20-24,1941,3
STAT,1921,38,na,1959,41.63827779138483
STAT,1839,44,na,1883,13.102836594374361
STAT,1822,42,35-39,1864,0.010347737953178657
STAT,1864,24,25-29,1888,0.5142408765248454
STAT,1927,37,40-44,1964,0.018517017094877172
STAT,1845,105,na,1950,1.7139364099958917E-4
STAT,1904,18,45-49,1922,9.335477680324789E-4
STAT,1917,49,30-34,1966,9.172617872141712E-4
SIM,1934,17,na,1951,52
STAT,1930,20,50-100,1950,0.008439994108392829
STAT,1783,90,na,1873,0.15407841717743503
SIM,1811,54,na,1865,10
SIM,1899,39,na,1938,28
STAT,1850,19,15-19,1869,0.06381022944763895
STAT,1878,28,35-39,1906,0.09926657824680706
STAT,1861,68,na,1929,12.85146163648212
SIM,1836,36,na,1872,8
SIM,1876,12,na,1888,31
STAT,1889,17,40-44,1906,0.002239340124916198
STAT,1851,78,na,1929,6.596252219438217
STAT,1908,20,45-49,1928,0.010351751183467445
SIM,1801,54,na,1855,10
STAT,1783,105,na,1888,1.100848872131247E-4
STAT,1909,39,30-34,1948,0.016981823387312592
STAT,1949,7,na,1956,45.422200890112926
STAT,1793,73,na,1866,2.6899125761140827
STAT,1905,38,na,1943,34.10075814686693
STAT,1902,38,30-34,1940,0.016141515942583718
STAT,1852,23,20-24,1875,0.6956079981032911
STAT,1826,47,na,1873,17.85437554847376
STAT,1880,40,30-34,1920,0.01221135800924695
STAT,1867,27,30-34,1894,0.24098084947421478
STAT,1926,30,50-100,1956,0.009951471617170998
STAT,1862,57,na,1919,17.33838547165786
STAT,1796,87,na,1883,0.11668693199216902
STAT,1840,53,50-100,1893,1.1644368392936331E-4
STAT,1874,8,na,1882,27.281785966524414
STAT,1945,19,45-49,1964,0.0054140671428617995
STAT,1875,82,na,1957,5.485831129212454
STAT,1839,42,45-49,1881,0.008704941240194981
STAT,1843,45,50-100,1888,0.0010638762989501212
STAT,1905,42,na,1947,33.43075782277882
STAT,1925,16,25-29,1941,0.5214889742370693
STAT,1934,16,15-19,1950,0.6127552162210185
STAT,1952,16,35-39,1968,0.050002007918426364
STAT,1876,67,na,1943,16.100197555223296
SIM,1915,16,20-24,1931,1
STAT,1923,23,na,1946,42.065532184367214
SIM,1865,33,na,1898,24
SIM,1896,32,na,1928,29
STAT,1886,43,20-24,1929,0.0016354142498806862
STAT,1876,43,50-100,1919,0.010652298963289524
STAT,1842,17,15-19,1859,0.05717683107237509
STAT,1898,55,na,1953,27.89347388976415
SIM,1814,68,na,1882,20
STAT,1908,56,na,1964,31.820556037867625
STAT,1845,35,30-34,1880,0.03672538418727532
STAT,1938,16,35-39,1954,0.041220664569354366
STAT,1910,29,25-29,1939,0.6271959756304137
SIM,1846,8,na,1854,18
SIM,1881,33,na,1914,25
SIM,1910,35,na,1945,32
STAT,1879,35,25-29,1914,0.030082992702800546
STAT,1943,23,30-34,1966,0.3034587275124834
STAT,1830,70,na,1900,5.041134792896588
STAT,1878,44,25-29,1922,0.006540252863171572
STAT,1956,15,40-44,1971,0.018413815673428365
STAT,1830,24,30-34,1854,0.2561888997871353
STAT,1907,15,45-49,1922,9.599453778598039E-4
STAT,1911,37,45-49,1948,0.006542072338924166
STAT,1912,36,35-39,1948,0.023535412403348978
STAT,1895,10,na,1905,33.62904285907529
STAT,1919,45,35-39,1964,0.0013928204800250266
STAT,1847,41,40-44,1888,0.024473147258113476
STAT,1929,24,na,1953,45.67148916701599
SIM,1922,20,na,1942,44
STAT,1891,47,50-100,1938,0.0016924484898824515
STAT,1884,23,15-19,1907,0.03222237646205731
STAT,1936,19,50-100,1955,0.003546127812282069
STAT,1908,26,15-19,1934,0.006718250893001654
STAT,1919,29,45-49,1948,0.01837259204905542
STAT,1949,19,30-34,1968,0.14075920101055625
STAT,1838,34,25-29,1872,0.09675364401456261
STAT,1838,96,na,1934,0.06664505395135888
STAT,1847,43,50-100,1890,0.011203886719697121
STAT,1845,15,50-100,1860,3.6626303292818966E-4
STAT,1882,22,50-100,1904,0.003908034020181791
STAT,1877,25,na,1902,24.802282969642615
STAT,1935,37,30-34,1972,0.02537236660713893
SIM,1890,31,na,1921,26
STAT,1880,17,50-100,1897,5.151756166733899E-4
STAT,1872,30,30-34,1902,0.18007858096373447
STAT,1909,49,40-44,1958,0.0014321783040965317
STAT,1781,88,na,1869,0.6634791160563804
STAT,1852,26,na,1878,21.720333076681385
STAT,1928,4,na,1932,50.60849908602379
STAT,1842,71,na,1913,10.014728023276247
STAT,1848,33,40-44,1881,0.02945508700157291
STAT,1898,29,15-19,1927,0.006076707176151301
STAT,1909,23,30-34,1932,0.2648047714174986
STAT,1874,42,na,1916,23.418461294827978
STAT,1894,46,30-34,1940,7.017778064518107E-4
STAT,1912,29,45-49,1941,0.01677099526580852
SIM,1872,50,na,1922,20
STAT,1858,29,50-100,1887,0.004911748312948377
STAT,1892,40,40-44,1932,0.028068113854109466
STAT,1917,23,na,1940,38.34022088537785
STAT,1844,24,25-29,1868,0.5502985126657657
STAT,1876,37,15-19,1913,5.703314206448089E-4
STAT,1819,45,30-34,1864,8.957375480959096E-4
SIM,1852,24,25-29,1876,1
STAT,1858,51,45-49,1909,1.1095981588736917E-4
STAT,1896,32,50-100,1928,0.012035215161056951
STAT,1837,59,na,1896,9.397121274950834
STAT,1873,25,na,1898,24.428217977417948
STAT,1886,36,30-34,1922,0.055547989806758624
STAT,1822,32,25-29,1854,0.09538144467571193
STAT,1906,22,50-100,1928,0.005924443606125385
SIM,1807,70,na,1877,13
SIM,1902,61,na,1963,30
SIM,1914,20,25-29,1934,1
STAT,1925,20,45-49,1945,0.013463797997317522
STAT,1912,16,30-34,1928,0.02451440764118902
STAT,1903,46,35-39,1949,0.0011259540221764959
STAT,1862,38,35-39,1900,0.06071999237944139
STAT,1813,46,na,1859,20.603348260743065
SIM,1854,65,na,1919,14
STAT,1896,16,35-39,1912,0.007225193839903035
STAT,1857,31,40-44,1888,0.03300639596020327
STAT,1917,21,15-19,1938,0.05623058990364797
STAT,1864,22,35-39,1886,0.05318142265956095
STAT,1835,36,15-19,1871,3.1834514597376795E-4
STAT,1882,24,45-49,1906,0.006640902819041117
STAT,1812,88,na,1900,0.5455866148580678
SIM,1870,27,na,1897,23
SIM,1864,85,na,1949,1
SIM,1862,5,na,1867,26
STAT,1872,7,na,1879,27.920948648461305
SIM,1837,83,na,1920,3
STAT,1946,24,45-49,1970,0.012424235098296089
STAT,1951,18,40-44,1969,0.016549796720461078
SIM,1843,31,20-24,1874,1
STAT,1850,21,45-49,1871,0.00750590781880787
STAT,1885,10,na,1895,25.579852878215085
STAT,1922,44,na,1966,42.17539420195583
STAT,1827,38,50-100,1865,0.009903362541587902
STAT,1909,48,45-49,1957,0.001980383872585916
STAT,1908,18,na,1926,37.17264409204685
STAT,1869,95,na,1964,0.3928450624741332
STAT,1824,83,na,1907,2.7622835426455774
STAT,1829,25,35-39,1854,0.24238982539696557
STAT,1857,24,35-39,1881,0.04523616801899258
SIM,1925,34,na,1959,44
STAT,1877,22,45-49,1899,0.00719817903833048
STAT,1909,45,50-100,1954,0.0020865564633479354
STAT,1873,18,40-44,1891,0.001854689847798531
STAT,1885,25,25-29,1910,0.4205668317360388
STAT,1904,15,50-100,1919,7.052616608851647E-4
STAT,1882,77,na,1959,9.62278376980064
STAT,1863,30,20-24,1893,0.024125192971772805
STAT,1874,21,30-34,1895,0.1812496433745495
SIM,1908,55,na,1963,34
STAT,1835,31,20-24,1866,0.015830363293787005
STAT,1899,38,30-34,1937,0.015669318653282565
STAT,1910,59,na,1969,32.03488941433924
STAT,1821,65,na,1886,10.580786152091683
STAT,1904,38,15-19,1942,1.7281165024728617E-4
SIM,1850,65,na,1915,16
STAT,1800,70,na,1870,6.1158898718642725
STAT,1888,55,na,1943,24.1632600510804
STAT,1825,31,na,1856,16.098186336677912
STAT,1838,44,50-100,1882,0.00850546233922935
STAT,1893,15,na,1908,31.99275144124704
STAT,1877,42,15-19,1919,1.423779863568212E-4
SIM,1882,12,na,1894,33
STAT,1893,24,20-24,1917,0.8634625554447576
STAT,1867,23,15-19,1890,0.03147280649898879
STAT,1858,11,na,1869,21.316560059859142
STAT,1793,83,na,1876,0.7343780383855858
STAT,1804,54,35-39,1858,2.27195147469788E-4
STAT,1889,34,40-44,1923,0.052641209882776804
STAT,1838,32,35-39,1870,0.09766967982716031
STAT,1932,37,15-19,1969,2.569719690362367E-4
STAT,1908,35,30-34,1943,0.017136788681641375
STAT,1809,48,40-44,1857,0.005750522251198849
STAT,1919,42,30-34,1961,0.001373428158875471
STAT,1837,24,50-100,1861,0.0026223568385395873
STAT,1887,18,35-39,1905,0.005973511053176393
STAT,1898,20,40-44,1918,0.028278323093219957
STAT,1936,20,20-24,1956,1.0573759796468452
STAT,1899,30,35-39,1929,0.139747162277258
STAT,1893,18,na,1911,31.761362510166066
STAT,1894,62,na,1956,23.66425528938354
STAT,1841,23,45-49,1864,0.008584451008257941
STAT,1799,74,na,1873,5.123733594384392
STAT,1870,45,na,1915,22.572477914548177
STAT,1833,50,na,1883,17.090132081506937
STAT,1845,78,na,1923,4.567271228189301
STAT,1867,28,50-100,1895,0.006100055836146578
SIM,1893,25,25-29,1918,1
SIM,1946,8,na,1954,53
STAT,1908,21,20-24,1929,1.020009789922716
STAT,1911,15,35-39,1926,0.008381523003985706
SIM,1786,76,na,1862,17
SIM,1869,30,na,1899,17
SIM,1902,34,40-44,1936,1
STAT,1808,83,na,1891,0.5796918181527106
SIM,1832,53,na,1885,20
STAT,1844,35,na,1879,19.834613403361427
SIM,1932,19,na,1951,49
STAT,1876,32,20-24,1908,0.027453501280158395
SIM,1881,64,na,1945,13
SIM,1845,13,na,1858,24
STAT,1867,5,na,1872,27.032817481635533
STAT,1855,78,na,1933,5.501127746974317
SIM,1942,16,15-19,1958,2
STAT,1793,80,na,1873,1.3854506463742753
STAT,1863,97,na,1960,0.09708220057369286
STAT,1920,24,25-29,1944,1.0117775983107964
SIM,1826,46,na,1872,15
STAT,1942,26,50-100,1968,0.010375325856095416
SIM,1851,20,na,1871,26
STAT,1845,19,40-44,1864,0.0013354503028097458
STAT,1843,26,30-34,1869,0.13241180372563016
STAT,1945,17,na,1962,39.91911367848829
STAT,1876,39,40-44,1915,0.04401245198154446
STAT,1867,39,15-19,1906,5.319685497503886E-4
STAT,1826,40,45-49,1866,0.01643715351188741
SIM,1887,58,na,1945,20
STAT,1784,105,na,1889,3.0038973258732536E-4
STAT,1889,10,na,1899,31.714182423949833
STAT,1867,51,50-100,1918,1.4521886510078272E-4
STAT,1837,40,20-24,1877,9.362579260643502E-4
STAT,1839,33,30-34,1872,0.11734804562250681
STAT,1821,44,25-29,1865,0.009367868852330286
SIM,1851,26,30-34,1877,1
SIM,1860,23,20-24,1883,1
STAT,1855,15,35-39,1870,0.004649615762678733
STAT,1939,26,45-49,1965,0.01725629210176891
STAT,1863,43,35-39,1906,0.01591708387135067
STAT,1833,22,40-44,1855,0.020738770611861655
STAT,1852,28,15-19,1880,0.004490222952099649
STAT,1902,36,40-44,1938,0.013388214984028047
STAT,1839,26,40-44,1865,0.020976214413143436
STAT,1893,31,45-49,1924,0.022077313872562683
SIM,1907,28,30-34,1935,2
STAT,1930,28,15-19,1958,0.008930226602237483
SIM,1826,53,na,1879,14
STAT,1897,21,35-39,1918,0.07772652935558032
STAT,1916,16,15-19,1932,0.095698806012238
STAT,1934,25,30-34,1959,0.525325472959252
SIM,1847,83,na,1930,3
STAT,1905,37,20-24,1942,0.0024012788231830523
STAT,1931,39,20-24,1970,0.003468301218644629
STAT,1866,18,15-19,1884,0.05576963636592222
STAT,1856,26,40-44,1882,0.02264968820706335
SIM,1901,29,25-29,1930,1
STAT,1898,32,40-44,1930,0.05850234308590982
STAT,1863,17,35-39,1880,0.005543728951612881
STAT,1889,20,15-19,1909,0.04063199269454731
STAT,1897,35,45-49,1932,0.02672402791964463
STAT,1906,24,40-44,1930,0.03008438472020367
STAT,1827,50,na,1877,14.741183558110741
STAT,1836,41,15-19,1877,1.6059366082841103E-4
STAT,1893,17,30-34,1910,0.02009673895977096
STAT,1910,15,50-100,1925,7.412617324965448E-4
SIM,1951,4,na,1955,52
STAT,1878,41,20-24,1919,0.0016470324802731107
STAT,1905,3,na,1908,38.154128663204986
SIM,1906,20,na,1926,26
SIM,1856,50,na,1906,11
SIM,1868,78,na,1946,8
STAT,1835,38,40-44,1873,0.024286526280310698
STAT,1948,17,20-24,1965,1.5412912056413244
STAT,1865,23,30-34,1888,0.16189744264738382
SIM,1943,15,20-24,1958,4
STAT,1821,37,35-39,1858,0.14457640609234015
STAT,1846,23,50-100,1869,0.00404844794991452
STAT,1956,4,na,1960,51.74486123371814
STAT,1847,28,40-44,1875,0.0381858752633021
STAT,1861,26,15-19,1887,0.003870949941605296
STAT,1831,65,na,1896,13.713939489345822
STAT,1879,33,35-39,1912,0.10437382173542123
STAT,1941,21,na,1962,37.47711997104209
STAT,1920,29,35-39,1949,0.1621264168033049
SIM,1867,38,na,1905,10
STAT,1813,52,35-39,1865,2.5628565951888707E-4
SIM,1786,69,na,1855,19
STAT,1914,39,20-24,1953,0.0025838970784859434
STAT,1926,26,35-39,1952,0.1795629513747732
STAT,1859,37,50-100,1896,0.009758306827613396
SIM,1856,60,na,1916,9
STAT,1812,98,na,1910,0.012910214434990831
STAT,1880,43,35-39,1923,0.01890411558296034
SIM,1890,5,na,1895,31
STAT,1916,28,15-19,1944,0.007211443623000021
STAT,1868,44,15-19,1912,1.3184003455102752E-4
STAT,1863,53,50-100,1916,1.315723753841242E-4
STAT,1925,28,40-44,1953,0.05451522094067014
STAT,1849,75,na,1924,7.982359375552779
STAT,1911,17,25-29,1928,0.0861588757538589
SIM,1907,23,20-24,1930,3
STAT,1882,16,40-44,1898,0.0017571450885078695
SIM,1875,26,na,1901,18
SIM,1907,15,na,1922,38
STAT,1884,27,30-34,1911,0.24672015354442567
STAT,1898,25,35-39,1923,0.13104720433248582
STAT,1826,33,20-24,1859,0.03574409658011799
STAT,1930,41,35-39,1971,0.0026408826522877427
STAT,1934,35,50-100,1969,0.005779317526417307
STAT,1781,95,na,1876,0.03736302438441886
STAT,1837,27,35-39,1864,0.060812477042770006
STAT,1918,44,50-100,1962,0.0012336438618195211
STAT,1858,52,50-100,1910,1.1431177256764989E-4
STAT,1863,63,na,1926,15.798187205881463
STAT,1909,45,25-29,1954,4.89355258310174E-4
STAT,1928,32,na,1960,47.0592995276351
STAT,1851,31,50-100,1882,0.008135020921056604
STAT,1931,27,20-24,1958,0.2346223473936238
STAT,1935,15,20-24,1950,1.853755286032355
SIM,1895,40,na,1935,27
STAT,1939,19,20-24,1958,1.3468614451386276
SIM,1879,23,na,1902,13
STAT,1847,21,20-24,1868,0.9089730322269666
SIM,1915,34,na,1949,37
STAT,1831,54,45-49,1885,1.1749351688091012E-4
SIM,1862,50,na,1912,23
STAT,1867,34,20-24,1901,0.025645741473635398
STAT,1826,38,15-19,1864,6.333528710999255E-4
STAT,1828,76,na,1904,6.3628478393876335
STAT,1877,49,35-39,1926,0.0014149915293354496
STAT,1916,23,20-24,1939,1.151639815272077
STAT,1847,44,45-49,1891,0.015771860765670193
STAT,1942,18,15-19,1960,0.47066800755819443
STAT,1852,30,45-49,1882,0.015776772273923614
STAT,1894,49,35-39,1943,9.909626199422544E-4
STAT,1893,29,15-19,1922,0.005679746170114538
STAT,1925,18,15-19,1943,0.5433703132374279
STAT,1897,43,50-100,1940,9.671795865762811E-4
STAT,1934,18,40-44,1952,0.018789510349155755
STAT,1883,15,na,1898,24.63964292094013
SIM,1829,98,na,1927,1
SIM,1864,27,na,1891,20
STAT,1841,49,20-24,1890,1.1500535716872826E-4
STAT,1892,30,na,1922,29.717638955036424
STAT,1900,29,50-100,1929,0.008807100015369211
STAT,1842,20,40-44,1862,0.02000581020247925
STAT,1926,45,25-29,1971,6.538386884114822E-4
STAT,1874,36,50-100,1910,0.012515293104010144
STAT,1846,17,35-39,1863,0.005586195891629276
STAT,1862,42,20-24,1904,0.0013684957486391697
STAT,1861,21,20-24,1882,0.5996726175684579
STAT,1843,38,15-19,1881,2.5044068306567406E-4
STAT,1888,29,40-44,1917,0.03475590564986244
STAT,1911,24,15-19,1935,0.049845481559674505
STAT,1852,38,40-44,1890,0.03727895419499146
STAT,1921,21,50-100,1942,0.007396257676580356
SIM,1967,2,na,1969,50
STAT,1857,63,na,1920,13.357444989831098
STAT,1865,16,40-44,1881,0.0017148626224960176
STAT,1920,24,40-44,1944,0.036829916592735885
SIM,1916,24,25-29,1940,2
STAT,1882,21,40-44,1903,0.020030343724843646
SIM,1897,11,na,1908,43
STAT,1835,34,25-29,1869,0.05802474703595304
STAT,1885,27,15-19,1912,0.004480379767622923
STAT,1917,36,35-39,1953,0.025014224026578255
STAT,1934,21,15-19,1955,0.07125774130256414
STAT,1816,48,50-100,1864,0.003048996848411931
SIM,1944,1,na,1945,36
STAT,1926,35,15-19,1961,2.337528472008743E-4
STAT,1885,22,20-24,1907,0.6805210822359624
STAT,1839,22,25-29,1861,0.40591130526306535
STAT,1836,64,na,1900,16.776985398287167
STAT,1927,30,20-24,1957,0.029885140027326465
STAT,1821,41,20-24,1862,0.0025621621237767057
STAT,1921,34,35-39,1955,0.10003892329868319
STAT,1865,33,40-44,1898,0.03905952210166744
STAT,1867,56,na,1923,19.518493155151294
STAT,1834,53,50-100,1887,1.0728875230919723E-4
SIM,1920,22,25-29,1942,2
STAT,1857,34,45-49,1891,0.012942626570162374
STAT,1810,105,na,1915,1.0539204328313526E-4
STAT,1901,45,na,1946,31.801091177926903
STAT,1949,22,20-24,1971,1.2892094562416219
SIM,1847,45,na,1892,15
STAT,1818,83,na,1901,0.9920818064344384
STAT,1901,19,40-44,1920,0.0025455807465210685
STAT,1818,36,15-19,1854,8.298015198628578E-4
STAT,1851,28,30-34,1879,0.24713008450767074
STAT,1898,22,30-34,1920,0.24028785349613505
SIM,1885,26,na,1911,21
STAT,1860,30,50-100,1890,0.0075087010159996135
STAT,1799,67,na,1866,8.371862827654624
STAT,1894,58,na,1952,25.344728904873676
STAT,1923,29,50-100,1952,0.011267445290374064
STAT,1771,95,na,1866,0.03910141407132413
STAT,1909,45,40-44,1954,0.0014544725846337434
STAT,1812,51,na,1863,11.500352229689522
STAT,1881,28,50-100,1909,0.006065524871704981
STAT,1856,20,35-39,1876,0.049810193477095935
SIM,1869,26,na,1895,16
STAT,1867,41,45-49,1908,0.014387061087961865
SIM,1848,31,na,1879,32
STAT,1804,69,na,1873,8.210631127702378
SIM,1859,30,na,1889,21
STAT,1907,38,50-100,1945,0.0038570286762909423
STAT,1880,45,na,1925,23.894133093050836
SIM,1874,78,na,1952,15
SIM,1866,12,na,1878,35
STAT,1949,1,na,1950,47.33291163427731
STAT,1935,35,40-44,1970,0.020875950682404366
STAT,1834,35,na,1869,19.222024649729338
STAT,1887,15,30-34,1902,0.01747803831089855
SIM,1937,18,na,1955,39
STAT,1911,35,50-100,1946,0.0040673773520444115
STAT,1903,26,30-34,1929,0.35924805184607667
STAT,1783,80,na,1863,1.2783400764782673
SIM,1836,46,na,1882,4
STAT,1943,26,35-39,1969,0.15880229123283032
STAT,1804,51,30-34,1855,1.6677744756082426E-4
STAT,1856,21,50-100,1877,0.00345580447770942
STAT,1861,78,na,1939,6.570660519112422
STAT,1939,23,40-44,1962,0.03352479742222892
STAT,1871,42,30-34,1913,0.011448084541243676
STAT,1853,49,na,1902,13.844597823051021
STAT,1786,94,na,1880,0.018268705222032333
STAT,1843,33,20-24,1876,0.013642181425591877
STAT,1925,18,30-34,1943,0.14593545025477928
STAT,1854,40,20-24,1894,9.805157923816765E-4
STAT,1908,31,15-19,1939,0.0012116159084703437
STAT,1932,17,45-49,1949,0.006587891325616551
SIM,1833,32,na,1865,12
STAT,1908,24,25-29,1932,0.8394833183921989
STAT,1876,35,25-29,1911,0.02952016282806255
STAT,1895,44,25-29,1939,5.711126555514233E-4
STAT,1841,20,40-44,1861,0.026213544538918762
STAT,1885,44,15-19,1929,1.3453331788929564E-4
STAT,1927,27,50-100,1954,0.012038800363431077
STAT,1908,28,40-44,1936,0.043679074070965135
STAT,1865,37,50-100,1902,0.01110477789592881
STAT,1911,38,40-44,1949,0.014294500081486358
STAT,1874,24,35-39,1898,0.0588298388528447
SIM,1874,85,na,1959,5
STAT,1844,26,15-19,1870,0.00436964236033469
STAT,1835,24,na,1859,12.543357994831023
SIM,1905,3,na,1908,40
STAT,1862,31,15-19,1893,0.001233664054308319
STAT,1836,37,50-100,1873,0.014543694398639737
STAT,1872,52,40-44,1924,1.071423465069234E-4
STAT,1891,44,na,1935,27.984414536170448
STAT,1809,68,na,1877,10.277655840922845
STAT,1849,34,na,1883,19.097062251790756
STAT,1886,29,na,1915,24.577675829546187
STAT,1821,34,30-34,1855,0.4396680606268895
STAT,1909,25,20-24,1934,0.17613207542986625
SIM,1829,64,na,1893,18
SIM,1889,77,na,1966,17
STAT,1924,18,na,1942,43.43254478822917
SIM,1770,92,na,1862,1
STAT,1885,26,50-100,1911,0.006338735542286322
STAT,1876,77,na,1953,8.779162107492262
STAT,1853,12,na,1865,18.04803959786137
STAT,1885,48,30-34,1933,9.439032388191932E-4
SIM,1893,22,20-24,1915,3
STAT,1864,28,40-44,1892,0.026773323096979666
STAT,1867,63,na,1930,17.075087966477458
SIM,1851,13,na,1864,27
STAT,1825,38,30-34,1863,0.05464990846414315
STAT,1883,31,35-39,1914,0.0987439487034377
STAT,1865,20,50-100,1885,0.0037874408079454536
SIM,1821,47,na,1868,14
SIM,1939,17,20-24,1956,2
SIM,1901,24,30-34,1925,1
STAT,1913,28,15-19,1941,0.006950791185556485
STAT,1898,35,45-49,1933,0.02714755093869707
STAT,1846,64,na,1910,14.088145248179814
SIM,1842,46,na,1888,23
STAT,1788,68,na,1856,8.35325604
SIM,1872,12,na,1884,27
STAT,1858,47,25-29,1905,4.362607387242884E-4
SIM,1901,27,na,1928,39
STAT,1863,40,30-34,1903,0.010281846234132882
STAT,1924,15,45-49,1939,0.0059374712103977744
SIM,1921,41,na,1962,41
SIM,1933,22,na,1955,53
STAT,1930,21,30-34,1951,0.36757873208768727
SIM,1903,56,na,1959,33
STAT,1920,27,45-49,1947,0.018790199418065423
STAT,1939,17,na,1956,36.59066000688316
STAT,1832,39,50-100,1871,0.00682421047385422
SIM,1900,42,na,1942,35
SIM,1850,72,na,1922,10
STAT,1888,62,na,1950,21.35883013332451
STAT,1892,29,30-34,1921,0.3088756307903581
STAT,1898,14,na,1912,34.72528633679545
SIM,1854,27,na,1881,19
STAT,1850,22,40-44,1872,0.02226888735550722
STAT,1880,54,40-44,1934,1.076595419427929E-4
STAT,1819,68,na,1887,8.116396581510452
SIM,1921,0,na,1921,45
STAT,1862,45,25-29,1907,5.019068254234825E-4
STAT,1906,27,45-49,1933,0.016130659497610663
STAT,1889,33,45-49,1922,0.02126007020031944
STAT,1859,37,na,1896,18.72570441913129
STAT,1955,16,35-39,1971,0.05540591111274446
STAT,1897,32,40-44,1929,0.057589660795660635
SIM,1845,9,na,1854,24
STAT,1877,46,30-34,1923,0.0010020657001802856
STAT,1918,18,na,1936,39.59628721061096
STAT,1944,27,30-34,1971,0.4204160907680929
STAT,1868,48,na,1916,21.499153331409453
STAT,1869,16,25-29,1885,0.05599743248456347
STAT,1873,63,na,1936,18.140889644193756
STAT,1875,40,40-44,1915,0.02335455661986183
STAT,1916,26,25-29,1942,0.6770569548843569
SIM,1916,26,na,1942,43
SIM,1890,41,na,1931,24
STAT,1928,19,45-49,1947,0.006229993023162436
STAT,1844,43,15-19,1887,1.0906837972240084E-4
STAT,1885,44,na,1929,22.515755981703272
STAT,1917,16,15-19,1933,0.09701116740246518
STAT,1926,28,25-29,1954,0.781759843507537
STAT,1830,49,45-49,1879,2.2789560060844732E-4
STAT,1858,37,30-34,1895,0.040555138907408486
STAT,1888,25,25-29,1913,0.4976872932565005
STAT,1870,37,30-34,1907,0.05294341719955938
STAT,1842,23,45-49,1865,0.006551532827188344
STAT,1794,68,na,1862,8.162925276574846
STAT,1884,37,25-29,1921,0.02820899046466102
STAT,1913,30,na,1943,37.61386724778404
STAT,1861,24,25-29,1885,0.48749481740519574
SIM,1838,31,na,1869,12
STAT,1813,42,25-29,1855,0.021907407986948988
STAT,1839,43,40-44,1882,0.012915972235906082
STAT,1852,64,na,1916,14.877709376848063
STAT,1831,102,na,1933,0.002379096592351072
STAT,1857,21,30-34,1878,0.15505146208653484
STAT,1904,31,30-34,1935,0.25120105245305846
STAT,1826,28,20-24,1854,0.4002525530990088
STAT,1837,49,na,1886,11.00675782450998
SIM,1924,26,25-29,1950,2
STAT,1938,32,na,1970,37.7779993076777
STAT,1880,33,25-29,1913,0.10725190168286754
STAT,1821,54,35-39,1875,1.122845405587186E-4
STAT,1912,22,25-29,1934,0.8783053563869215
STAT,1903,39,45-49,1942,0.006055816305996026
SIM,1807,80,na,1887,6
STAT,1926,23,30-34,1949,0.3461032638382073
STAT,1952,18,25-29,1970,0.516080005097771
STAT,1911,28,30-34,1939,0.378315183874712
STAT,1833,21,45-49,1854,0.006990169648037618
SIM,1896,25,25-29,1921,1
STAT,1856,29,45-49,1885,0.00821555207051082
STAT,1917,47,40-44,1964,0.0016318294666834172
STAT,1842,30,35-39,1872,0.09371334302703567
STAT,1850,90,na,1940,0.7019687373573786
SIM,1860,27,na,1887,26
STAT,1947,25,40-44,1972,0.05241717377938574
STAT,1893,19,20-24,1912,0.22233626599572237
SIM,1915,41,na,1956,34
SIM,1865,71,na,1936,8
STAT,1843,49,na,1892,9.34441534325437
STAT,1918,37,30-34,1955,0.01903645432423638
STAT,1935,32,20-24,1967,0.03359603172816139
STAT,1882,30,na,1912,23.05288831927233
STAT,1900,48,25-29,1948,4.4488840004412483E-4
SIM,1912,39,na,1951,37
STAT,1911,38,35-39,1949,0.02309624478903827
STAT,1861,39,40-44,1900,0.036442346595484496
STAT,1859,31,15-19,1890,0.0011365058205753333
STAT,1904,40,35-39,1944,0.0018199925892673126
STAT,1870,29,35-39,1899,0.09516628592685254
STAT,1883,40,na,1923,22.670489172479577
STAT,1896,21,20-24,1917,0.9079232629659028
SIM,1931,17,20-24,1948,3
STAT,1868,26,15-19,1894,0.0044057526928545235
STAT,1854,99,na,1953,0.011575978512996498
STAT,1902,43,35-39,1945,0.0017604524511915932
STAT,1866,20,50-100,1886,0.0038413029953991017
STAT,1879,35,na,1914,24.616182780825568
STAT,1866,29,15-19,1895,0.004148652056334904
STAT,1923,17,20-24,1940,1.580953023959103
STAT,1900,35,25-29,1935,0.04030448416023717
STAT,1940,26,na,1966,37.9464176083746
STAT,1877,27,25-29,1904,0.43666109423479726
STAT,1908,17,25-29,1925,0.08362373801871596
STAT,1932,40,40-44,1972,0.0033856455652749562
SIM,1856,35,na,1891,12
SIM,1961,8,na,1969,53
STAT,1928,40,20-24,1968,2.2465852082093255E-4
STAT,1941,22,35-39,1963,0.09660036406881972
SIM,1852,45,na,1897,24
STAT,1944,16,na,1960,39.334375169020745
STAT,1877,8,na,1885,27.5045381045466
STAT,1859,47,30-34,1906,7.657958465508441E-4
STAT,1891,23,40-44,1914,0.025496885707438247
STAT,1894,24,20-24,1918,0.8776480908484725
STAT,1912,17,45-49,1929,0.0010022271463380633
SIM,1890,62,na,1952,21
STAT,1910,28,50-100,1938,0.009519260401238258
STAT,1920,0,na,1920,50.114866578130226
STAT,1936,17,30-34,1953,0.11598940903778814
STAT,1913,35,35-39,1948,0.023894814790329164
STAT,1921,34,50-100,1955,0.009051014233391505
SIM,1877,80,na,1957,5
STAT,1866,84,na,1950,3.063766634339119
SIM,1882,67,na,1949,21
SIM,1907,52,na,1959,35
SIM,1928,38,na,1966,54
STAT,1930,32,30-34,1962,0.20237496289978937
STAT,1868,34,20-24,1902,0.025934763477884728
STAT,1845,23,na,1868,15.40455379578589
STAT,1929,27,40-44,1956,0.05805536910003652
STAT,1824,32,40-44,1856,0.07082991892672959
SIM,1864,30,na,1894,22
STAT,1902,32,25-29,1934,0.14443983873629226
STAT,1913,46,45-49,1959,0.002108811391231175
STAT,1864,21,50-100,1885,0.00374325877016343
STAT,1902,45,30-34,1947,7.776845516705245E-4
SIM,1871,20,25-29,1891,1
SIM,1898,42,na,1940,32
STAT,1937,33,25-29,1970,0.09080876539234324
STAT,1829,76,na,1905,6.435258391692178
STAT,1930,30,35-39,1960,0.11751521636534648
STAT,1918,35,40-44,1953,0.015784279941281162
STAT,1833,81,na,1914,4.003513421983272
STAT,1876,20,35-39,1896,0.05962143085176509
STAT,1822,35,40-44,1857,0.028392825753178474
SIM,1872,8,na,1880,27
SIM,1889,21,25-29,1910,4
STAT,1895,25,50-100,1920,0.008361182661630488
STAT,1885,21,45-49,1906,0.006906943694330006
SIM,1924,24,na,1948,52
STAT,1904,42,30-34,1946,0.001142544479673558
STAT,1918,24,30-34,1942,0.30525344526432513
STAT,1924,46,20-24,1970,1.3103464391467045E-4
STAT,1851,44,50-100,1895,0.008798505084942074
STAT,1827,33,20-24,1860,0.023187390727365694
STAT,1877,15,30-34,1892,0.01652933612150026
STAT,1900,48,30-34,1948,7.476596795022124E-4
STAT,1807,103,na,1910,6.056812918387038E-4
STAT,1829,30,20-24,1859,0.026553453959930553
SIM,1878,22,na,1900,26
STAT,1863,20,25-29,1883,0.5244564349827617
STAT,1862,94,na,1956,0.1978743774035925
STAT,1863,33,30-34,1896,0.15393555996862485
SIM,1920,34,na,1954,46
STAT,1907,49,25-29,1956,4.678436390343606E-4
STAT,1872,29,45-49,1901,0.011279096597139953
STAT,1915,43,45-49,1958,0.0016584762022284986
STAT,1887,30,na,1917,26.256137449818603
STAT,1811,49,25-29,1860,0.0022107979973555254
STAT,1837,71,na,1908,6.45408522588077
STAT,1932,40,50-100,1972,0.0015901880880612683
STAT,1846,36,35-39,1882,0.060483966546959395
SIM,1887,24,25-29,1911,2
STAT,1880,48,35-39,1928,0.00145367641308833
STAT,1820,38,40-44,1858,0.04055719027904175
STAT,1917,40,45-49,1957,0.001725829114654375
SIM,1903,62,na,1965,28
STAT,1907,38,15-19,1945,1.7641297630619963E-4
STAT,1865,30,30-34,1895,0.1591903248293096
STAT,1915,32,35-39,1947,0.0922670186934905
SIM,1916,29,na,1945,41
STAT,1806,49,50-100,1855,0.008043933009588757
STAT,1909,46,25-29,1955,4.859004101865042E-4
STAT,1916,27,30-34,1943,0.4016713964744977
STAT,1926,43,20-24,1969,2.1612940219629476E-4
STAT,1849,13,na,1862,22.681426297358236
STAT,1879,24,25-29,1903,0.5887886654355983
STAT,1828,51,na,1879,15.805884398096358
STAT,1891,75,na,1966,15.974901711712581
STAT,1890,10,na,1900,31.4647650068577
SIM,1916,19,20-24,1935,2
STAT,1878,47,40-44,1925,0.0017592586784004793
STAT,1830,41,25-29,1871,0.0035619588659650506
STAT,1895,47,40-44,1942,0.001247893809007884
STAT,1896,27,35-39,1923,0.12674214843249937
STAT,1891,51,na,1942,26.554372580376167
STAT,1925,37,na,1962,44.872125767908315
SIM,1823,48,na,1871,11
STAT,1922,36,15-19,1958,2.1710660043789686E-4
STAT,1806,48,na,1854,16.968141851692952
STAT,1895,65,na,1960,23.177685707275334
STAT,1914,16,40-44,1930,0.002876411421581259
STAT,1924,33,15-19,1957,0.0014885594083291055
STAT,1807,89,na,1896,0.44336092840294256
STAT,1850,53,na,1903,18.86323764534074
STAT,1942,17,30-34,1959,0.1264499234733693
STAT,1946,22,40-44,1968,0.037152650828613756
STAT,1810,53,na,1863,9.567460608350178
STAT,1835,46,30-34,1881,4.6799454579264833E-4
STAT,1917,43,25-29,1960,7.372776627569916E-4
STAT,1944,28,45-49,1972,0.018527801480944333
STAT,1844,20,15-19,1864,0.032640706379718845
SIM,1919,3,na,1922,47
STAT,1929,27,na,1956,46.65996942162332
STAT,1842,37,50-100,1879,0.010805779226759188
STAT,1873,78,na,1951,7.9437519690298615
SIM,1874,32,na,1906,22
STAT,1828,35,na,1863,19.195502979734748
STAT,1858,73,na,1931,9.03814073141439
STAT,1903,24,40-44,1927,0.029440736448391555
STAT,1914,4,na,1918,41.269956552012445
STAT,1875,17,50-100,1892,5.036081796066775E-4
STAT,1944,17,35-39,1961,0.044829487734668216
STAT,1899,71,na,1970,22.124422339449794
STAT,1952,20,15-19,1972,0.06366771493081928
STAT,1885,37,30-34,1922,0.05263036984226416
STAT,1927,17,35-39,1944,0.051907609252265924
STAT,1892,20,50-100,1912,0.005067932709601399
SIM,1879,63,na,1942,8
STAT,1844,39,35-39,1883,0.05718018424998448
SIM,1957,11,na,1968,56
STAT,1848,30,30-34,1878,0.1344385696905238
STAT,1838,23,25-29,1861,0.572307638472405
STAT,1851,18,15-19,1869,0.06055524082938768
STAT,1774,85,na,1859,0.3471744066764494
STAT,1818,46,30-34,1864,9.664043542527865E-4
SIM,1832,25,na,1857,21
SIM,1836,39,na,1875,8
STAT,1778,99,na,1877,0.0039848514817100635
STAT,1924,39,50-100,1963,0.004908170505437282
STAT,1882,15,na,1897,24.316444524739325
STAT,1920,25,25-29,1945,0.7207443225603011
STAT,1927,28,45-49,1955,0.020821987289110288
SIM,1858,30,35-39,1888,1
SIM,1861,81,na,1942,5
STAT,1841,17,na,1858,28.97798727566759
STAT,1901,26,50-100,1927,0.008981734765373157
SIM,1910,0,na,1910,39
STAT,1796,72,na,1868,1.0953840593019932
STAT,1878,93,na,1971,1.310723794930146
STAT,1900,32,45-49,1932,0.024181268248244132
SIM,1846,23,25-29,1869,1
STAT,1866,6,na,1872,25.915704000678048
SIM,1783,74,na,1857,1
STAT,1953,18,45-49,1971,0.006006045316154654
STAT,1903,25,25-29,1928,0.6054935208242955
SIM,1936,33,na,1969,37
STAT,1874,23,35-39,1897,0.059017514549110875
STAT,1840,15,35-39,1855,0.005633020372954779
STAT,1869,33,na,1902,23.02438107555772
STAT,1858,15,20-24,1873,0.159459062933412
SIM,1838,65,na,1903,4
SIM,1902,35,25-29,1937,1
STAT,1933,28,15-19,1961,0.009330946191136794
STAT,1949,15,15-19,1964,0.5247266606934855
SIM,1928,14,na,1942,55
STAT,1861,20,45-49,1881,0.006111936521848798
STAT,1820,71,na,1891,7.567316156972111
STAT,1839,40,30-34,1879,0.007538894457966833
STAT,1915,19,na,1934,39.85932655354299
SIM,1931,18,na,1949,55
STAT,1821,96,na,1917,0.05333075073647692
SIM,1911,25,25-29,1936,2
SIM,1841,61,na,1902,13
STAT,1908,19,20-24,1927,0.2602163834113938
STAT,1845,82,na,1927,2.7274021629877954
STAT,1933,39,25-29,1972,0.013327979580435996
STAT,1900,21,35-39,1921,0.08116385424618752
STAT,1849,96,na,1945,0.06658019540826068
STAT,1939,20,50-100,1959,0.006567322589667861
STAT,1840,38,50-100,1878,0.011261137832595875
STAT,1889,31,30-34,1920,0.21463843343329927
STAT,1844,20,45-49,1864,0.006899334018325341
STAT,1875,45,na,1920,23.357628895506984
SIM,1861,6,na,1867,33
STAT,1927,44,na,1971,46.186084686424834
SIM,1894,52,na,1946,29
STAT,1847,30,na,1877,27.75310411434945
STAT,1884,19,50-100,1903,4.7742475089417226E-4
SIM,1862,47,na,1909,23
SIM,1914,46,na,1960,36
STAT,1876,47,30-34,1923,9.785616150324464E-4
STAT,1923,40,45-49,1963,0.0019371117767929308
SIM,1907,36,na,1943,39
STAT,1855,23,25-29,1878,0.46748054487280744
STAT,1895,40,15-19,1935,1.8109590417943633E-4
STAT,1837,46,40-44,1883,8.762150561890105E-4
STAT,1871,42,25-29,1913,0.006394425625776344
STAT,1935,7,na,1942,54.40361391320192
STAT,1853,23,20-24,1876,0.5080541306404992
SIM,1903,22,na,1925,33
STAT,1816,66,na,1882,5.650744315519458
SIM,1815,53,na,1868,11
SIM,1935,23,15-19,1958,1
STAT,1871,52,50-100,1923,1.4977288121437973E-4
STAT,1836,46,na,1882,23.01599824919756
STAT,1839,35,na,1874,14.421073252615868
STAT,1838,23,50-100,1861,0.0040768464044373
STAT,1856,107,na,1963,1.712267052718958E-4
STAT,1840,51,na,1891,16.952759514158103
STAT,1810,47,50-100,1857,0.0023951838465808145
STAT,1894,27,25-29,1921,0.5421315784978822
SIM,1785,81,na,1866,1
STAT,1940,19,50-100,1959,0.0037744916212723158
STAT,1924,38,15-19,1962,2.2474186633169264E-4
SIM,1899,24,na,1923,28
STAT,1817,51,na,1868,21.70441494079506
SIM,1874,88,na,1962,4
STAT,1911,35,30-34,1946,0.017656307668418497
STAT,1907,37,30-34,1944,0.01682665344334747
STAT,1899,7,na,1906,35.66559686927887
SIM,1915,31,na,1946,37
STAT,1921,40,35-39,1961,0.0022565934157984624
SIM,1811,63,na,1874,6
SIM,1885,16,na,1901,26
STAT,1906,17,20-24,1923,0.25756291032714346
SIM,1892,45,na,1937,36
SIM,1896,59,na,1955,23
STAT,1815,42,40-44,1857,0.0347755867537088
STAT,1896,24,25-29,1920,0.7472344296791884
STAT,1888,16,45-49,1904,7.652323267370875E-4
STAT,1853,29,35-39,1882,0.06301342799456651
STAT,1878,44,30-34,1922,0.011709162336157259
STAT,1832,56,na,1888,9.300088171375712
STAT,1909,19,50-100,1928,7.266730570469134E-4
STAT,1835,49,40-44,1884,7.964564937816495E-4
SIM,1919,21,na,1940,46
STAT,1829,33,25-29,1862,0.09642536945823252
STAT,1835,30,45-49,1865,0.010326992518187778
SIM,1882,27,na,1909,30
STAT,1827,36,25-29,1863,0.023876195068110895
SIM,1920,18,na,1938,47
STAT,1833,22,35-39,1855,0.05807667207668473
STAT,1902,40,30-34,1942,0.0011371870345066118
STAT,1851,7,na,1858,25.405450812785762
STAT,1874,20,30-34,1894,0.18178226541220724
STAT,1846,39,45-49,1885,0.016524411028692496
STAT,1930,35,35-39,1965,0.03145616238155749
SIM,1886,73,na,1959,10
STAT,1915,37,50-100,1952,0.0042047617500523245
STAT,1954,18,na,1972,45.228665103798676
STAT,1776,100,na,1876,0.0014743107269792463
STAT,1919,17,30-34,1936,0.13352836945135693
SIM,1903,46,na,1949,35
SIM,1790,68,na,1858,2
STAT,1887,37,35-39,1924,0.07720148523795588
SIM,1906,11,na,1917,29
STAT,1846,20,25-29,1866,0.580740615951895
STAT,1901,28,25-29,1929,0.5898271394579498
SIM,1824,73,na,1897,10
STAT,1894,16,15-19,1910,0.07624351795893212
STAT,1813,54,30-34,1867,1.702756618118999E-4
STAT,1852,17,na,1869,23.760489951759176
STAT,1859,20,35-39,1879,0.05364923671951054
STAT,1904,35,na,1939,34.34809651302953
STAT,1908,49,na,1957,32.858459079537006
STAT,1785,69,na,1854,19.0
STAT,1781,79,na,1860,3.9638280488472843
SIM,1902,21,na,1923,37
STAT,1878,10,na,1888,26.996337478790547
SIM,1860,40,na,1900,24
STAT,1868,37,25-29,1905,0.027863295447382874
STAT,1842,39,30-34,1881,0.04180841639965884
STAT,1833,97,na,1930,0.03977303221913754
SIM,1846,76,na,1922,3
SIM,1849,65,na,1914,1
STAT,1938,28,20-24,1966,0.17956428293668922
STAT,1808,53,50-100,1861,1.0284518532677415E-4
STAT,1832,101,na,1933,0.0025792689769239844
STAT,1880,45,30-34,1925,0.0010280514567398676
STAT,1933,27,30-34,1960,0.5181451966019782
SIM,1941,1,na,1942,49
STAT,1902,48,35-39,1950,0.001099654771339593
STAT,1823,47,50-100,1870,0.0017052396620754586
STAT,1822,32,30-34,1854,0.16258883149260656
STAT,1842,28,20-24,1870,0.10806664220607676
STAT,1913,30,35-39,1943,0.09088436792649512
STAT,1917,41,50-100,1958,0.0012166120637596778
STAT,1933,32,na,1965,50.76042096256047
SIM,1830,32,30-34,1862,2
SIM,1875,73,na,1948,7
STAT,1946,1,na,1947,45.400106597021846
STAT,1890,16,50-100,1906,5.965673598778404E-4
STAT,1831,31,na,1862,23.014942611428026
STAT,1836,101,na,1937,0.005507117288894701
STAT,1937,30,20-24,1967,0.024006734897348614
STAT,1835,45,na,1880,10.942686603313396
STAT,1918,38,45-49,1956,0.007113244567605787
SIM,1842,86,na,1928,4
STAT,1841,32,40-44,1873,0.05150261001228293
STAT,1811,94,na,1905,0.11326334747401666
STAT,1899,16,20-24,1915,0.24328788327762882
STAT,1827,39,35-39,1866,0.05624314086953411
STAT,1891,20,30-34,1911,0.21992593509902383
STAT,1852,42,15-19,1894,1.1804566688917713E-4
SIM,1885,24,20-24,1909,1
STAT,1834,46,50-100,1880,0.0020487892772788406
STAT,1859,31,45-49,1890,0.013916834801022326
STAT,1918,27,35-39,1945,0.15833139521670186
STAT,1877,24,20-24,1901,0.7069036206391577
STAT,1904,45,35-39,1949,0.0011428588908003405
STAT,1857,48,na,1905,16.630862387703257
STAT,1953,17,30-34,1970,0.14659444573142305
SIM,1830,42,na,1872,19
SIM,1866,37,na,1903,28
STAT,1848,33,35-39,1881,0.06878328579804549
STAT,1903,16,35-39,1919,0.007820339772121196
STAT,1921,43,45-49,1964,0.0018569763254289529
STAT,1806,88,na,1894,0.6423759406535086
SIM,1935,27,30-34,1962,1
SIM,1863,48,na,1911,11
STAT,1816,49,30-34,1865,0.0011836456901174112
STAT,1812,51,50-100,1863,1.6702135978978764E-4
STAT,1903,27,45-49,1930,0.015785547865599985
STAT,1905,21,40-44,1926,0.030165188119400776
STAT,1944,25,40-44,1969,0.05005498618881856
STAT,1912,19,40-44,1931,0.0027911874200516615
STAT,1847,15,45-49,1862,8.812729150787081E-4
STAT,1802,74,na,1876,4.023480613458957
SIM,1930,22,25-29,1952,2
SIM,1949,16,na,1965,38
STAT,1806,64,na,1870,11.709439255038664
STAT,1876,31,45-49,1907,0.01778343458033365
SIM,1893,67,na,1960,25
SIM,1844,10,na,1854,13
SIM,1895,21,25-29,1916,4
SIM,1848,24,na,1872,31
STAT,1887,21,25-29,1908,0.6267267288353483
STAT,1853,26,25-29,1879,0.3102101726404537
STAT,1858,19,50-100,1877,4.3036635346914475E-4
SIM,1878,62,na,1940,20
STAT,1911,32,20-24,1943,0.02359860438634938
STAT,1927,27,30-34,1954,0.4739150709915031
STAT,1795,87,na,1882,0.7141255948683832
STAT,1855,20,20-24,1875,0.57505284568635
STAT,1929,25,45-49,1954,0.02159978626439279
SIM,1841,45,na,1886,16
STAT,1865,27,na,1892,21.58580063025612
SIM,1909,21,20-24,1930,2
STAT,1909,30,15-19,1939,0.0012292036342714703
STAT,1909,49,35-39,1958,0.0011711738495087728
SIM,1918,36,na,1954,37
STAT,1911,29,na,1940,36.038127157966606
STAT,1886,17,25-29,1903,0.05877906519586384
SIM,1835,73,na,1908,5
STAT,1883,29,20-24,1912,0.11310772742340683
SIM,1840,20,na,1860,16
STAT,1897,44,40-44,1941,0.0020461933340764587
STAT,1854,30,25-29,1884,0.06545809702707593
STAT,1935,36,25-29,1971,0.013719395270264438
STAT,1937,22,na,1959,35.33692911852305
SIM,1871,83,na,1954,5
STAT,1886,45,na,1931,23.569498720754893
STAT,1811,44,25-29,1855,0.026455022473460536
STAT,1917,40,20-24,1957,1.8313296553622475E-4
STAT,1816,38,20-24,1854,0.011570025599041567
STAT,1831,28,45-49,1859,0.011984012174489531
STAT,1837,43,30-34,1880,0.006520527828412928
SIM,1911,57,na,1968,38
STAT,1896,24,30-34,1920,0.23250605326986076
SIM,1905,19,15-19,1924,1
SIM,1962,4,na,1966,48
STAT,1829,33,30-34,1862,0.16436832341719698
STAT,1861,36,30-34,1897,0.0450350967152855
STAT,1881,14,na,1895,24.49414167251069
STAT,1967,4,na,1971,48.80324990060591
STAT,1908,25,na,1933,35.45677976404927
STAT,1895,2,na,1897,34.60706961056842
STAT,1874,20,25-29,1894,0.5842169075203576
SIM,1859,25,30-34,1884,1
STAT,1907,40,na,1947,34.266762111200194
SIM,1854,20,25-29,1874,1
STAT,1903,22,20-24,1925,0.9797517896913688
STAT,1901,17,15-19,1918,0.0830403287531788
SIM,1861,26,25-29,1887,1
STAT,1814,50,50-100,1864,4.317867231938438E-4
SIM,1911,22,20-24,1933,2
STAT,1828,40,25-29,1868,0.0028902100003616897
STAT,1845,16,25-29,1861,0.04211490618380822
STAT,1825,86,na,1911,1.196142008293367
STAT,1895,31,25-29,1926,0.13351856709864995
STAT,1902,6,na,1908,36.83911385435532
STAT,1853,15,15-19,1868,0.045399743147696535
STAT,1837,28,na,1865,13.321076332632174
STAT,1949,18,25-29,1967,0.5006203265228573
STAT,1903,30,50-100,1933,0.013131276417222476
STAT,1955,16,na,1971,48.60074884761184
STAT,1861,13,na,1874,22.969827024306188
STAT,1899,55,na,1954,28.305626313321728
STAT,1922,22,25-29,1944,1.051507978860376
STAT,1923,9,na,1932,46.42119158514316
STAT,1938,17,40-44,1955,0.013706558773979888
STAT,1858,108,na,1966,1.1641257568280531E-4
STAT,1889,34,35-39,1923,0.12292733625022327
STAT,1820,35,50-100,1855,0.01196415127993966
STAT,1854,83,na,1937,2.4265235420486784
SIM,1879,15,30-34,1894,1
SIM,1879,47,na,1926,14
STAT,1872,26,35-39,1898,0.09906375889854245
SIM,1858,61,na,1919,23
SIM,1875,33,na,1908,18
SIM,1789,71,na,1860,8
STAT,1952,11,na,1963,46.80241399197491
STAT,1856,43,40-44,1899,0.016176796419463096
STAT,1915,46,25-29,1961,5.312193554967456E-4
STAT,1920,28,35-39,1948,0.1627187129183276
STAT,1955,15,45-49,1970,0.0065975899745589
STAT,1815,84,na,1899,1.1875035961561125
STAT,1928,41,35-39,1969,0.0025581885628300285
SIM,1853,30,na,1883,24
SIM,1890,2,na,1892,34
STAT,1842,58,na,1900,14.837497603667757
SIM,1861,65,na,1926,19
STAT,1876,46,na,1922,22.915288795299777
SIM,1859,34,20-24,1893,2
STAT,1839,51,na,1890,11.939241522176763
STAT,1849,17,45-49,1866,6.23467434045452E-4
STAT,1895,44,30-34,1939,0.0010224758791424805
STAT,1937,24,35-39,1961,0.09105196649272418
STAT,1880,51,na,1931,22.750033435647833
STAT,1924,36,25-29,1960,0.011545283337323197
STAT,1846,33,25-29,1879,0.09708254113156577
SIM,1838,41,na,1879,8
SIM,1934,9,na,1943,54
SIM,1859,24,na,1883,21
STAT,1939,32,45-49,1971,0.01594529059346571
SIM,1834,51,na,1885,14
STAT,1937,35,45-49,1972,0.006785586554671114
STAT,1897,40,25-29,1937,5.981464114799878E-4
STAT,1769,104,na,1873,0.0015832689038814576
SIM,1816,38,na,1854,15
STAT,1838,26,35-39,1864,0.09595232197755342
STAT,1855,23,30-34,1878,0.1454591118285134
SIM,1885,32,na,1917,25
SIM,1801,61,na,1862,9
SIM,1796,84,na,1880,2
STAT,1864,17,40-44,1881,0.0016970602309159455
STAT,1887,9,na,1896,28.320621039290433
STAT,1840,48,na,1888,17.551685354897348
SIM,1824,33,na,1857,19
STAT,1865,83,na,1948,3.590697122074744
STAT,1941,27,na,1968,38.471723196241136
SIM,1805,75,na,1880,5
SIM,1927,13,na,1940,52
STAT,1827,66,na,1893,9.932690907200737
SIM,1851,44,na,1895,17
STAT,1900,29,na,1929,32.85696255680816
STAT,1926,34,30-34,1960,0.18917394750177077
SIM,1883,68,na,1951,6
STAT,1854,43,na,1897,14.025055768771798
SIM,1906,51,na,1957,22
STAT,1853,98,na,1951,0.02041647109023545
SIM,1861,26,30-34,1887,1
STAT,1905,25,35-39,1930,0.14020209298787117
STAT,1928,42,40-44,1970,0.003173040722507958
STAT,1902,42,20-24,1944,1.5532818270736076E-4
STAT,1931,26,15-19,1957,0.009077877558292431
SIM,1920,15,25-29,1935,1
STAT,1856,32,50-100,1888,0.006718854529988172
STAT,1912,15,25-29,1927,0.08734717338393932
STAT,1891,39,20-24,1930,0.00936589820967429
STAT,1911,46,50-100,1957,0.0021327339896319575
STAT,1839,43,35-39,1882,0.010398200208573558
STAT,1853,26,30-34,1879,0.18466711770394675
SIM,1873,47,na,1920,27
STAT,1846,22,15-19,1868,0.03298879972633776
STAT,1928,31,30-34,1959,0.19615175366745802
STAT,1949,15,20-24,1964,1.5675378704246536
STAT,1832,42,40-44,1874,0.012371307405497188
STAT,1824,48,20-24,1872,1.5324009375027506E-4
STAT,1863,45,30-34,1908,8.656094589128729E-4
SIM,1864,70,na,1934,13
STAT,1827,36,30-34,1863,0.04419636132613425
STAT,1830,92,na,1922,0.1496430540970748
STAT,1899,19,25-29,1918,0.07715773913458011
STAT,1863,17,na,1880,23.191357568680015
SIM,1898,9,na,1907,37
STAT,1854,28,50-100,1882,0.004069549071048498
STAT,1883,29,15-19,1912,0.004374332034873727
SIM,1937,34,na,1971,39
SIM,1917,14,na,1931,47
STAT,1882,32,50-100,1914,0.008780782268361351
STAT,1852,47,20-24,1899,1.0222298819167405E-4
STAT,1918,24,na,1942,38.78481101605722
STAT,1816,38,15-19,1854,8.428496529938163E-4
STAT,1854,43,30-34,1897,0.006976412120758271
STAT,1851,105,na,1956,3.0663176141995494E-4
STAT,1909,50,na,1959,33.266231681489124
STAT,1835,30,15-19,1865,8.433445732284012E-4
STAT,1917,20,50-100,1937,0.00697105515167964
STAT,1852,3,na,1855,29.2454
STAT,1893,39,na,1932,29.40700520503275
STAT,1915,21,50-100,1936,0.006763246986655783
SIM,1913,24,na,1937,41
STAT,1816,42,50-100,1858,0.01455785038322542
STAT,1887,34,25-29,1921,0.11084164209744217
STAT,1894,27,30-34,1921,0.3227291844279103
SIM,1863,32,na,1895,14
SIM,1847,39,na,1886,17
STAT,1800,94,na,1894,0.0724259450429062
STAT,1822,97,na,1919,0.019056182027105434
STAT,1875,50,45-49,1925,1.5132299153195437E-4
STAT,1918,33,20-24,1951,0.025576491961473873
STAT,1900,39,40-44,1939,0.012970136870438083
STAT,1841,47,45-49,1888,0.0023204751972708574
STAT,1855,84,na,1939,2.342181128991803
STAT,1835,49,35-39,1884,6.5130788193091E-4
STAT,1789,99,na,1888,0.002340842150217637
STAT,1931,15,35-39,1946,0.054934165674061196
SIM,1950,19,20-24,1969,2
SIM,1926,21,20-24,1947,2
STAT,1862,50,50-100,1912,1.3217366373133768E-4
STAT,1865,33,35-39,1898,0.09121148654935558
STAT,1878,40,15-19,1918,1.4401373911388847E-4
STAT,1857,106,na,1963,4.2218452484733295E-4
STAT,1836,23,20-24,1859,0.8714178217114272
SIM,1943,21,20-24,1964,2
STAT,1885,42,50-100,1927,0.010419774571340273
SIM,1805,78,na,1883,3
STAT,1822,47,35-39,1869,7.689445951991431E-4
STAT,1873,43,40-44,1916,0.022703026595499422
STAT,1843,59,na,1902,8.244050129015982
SIM,1933,19,20-24,1952,7
STAT,1850,49,30-34,1899,8.438779703748227E-4
STAT,1906,40,45-49,1946,0.0015251435842768086
STAT,1852,30,50-100,1882,0.008289490465636538
SIM,1822,63,na,1885,12
STAT,1901,19,35-39,1920,0.007636741797404937
STAT,1850,38,20-24,1888,0.0069000318709431935
STAT,1942,19,20-24,1961,1.4055540818068395
STAT,1921,45,35-39,1966,0.0014488966990665818
STAT,1821,56,na,1877,13.800322511447556
STAT,1829,36,na,1865,18.80978910081116
STAT,1831,25,40-44,1856,0.034170241924317155
SIM,1881,43,40-44,1924,1
STAT,1906,42,35-39,1948,0.001824617681923329
SIM,1801,64,na,1865,7
STAT,1858,50,45-49,1908,1.1201838966974829E-4
SIM,1852,85,na,1937,13
STAT,1931,26,45-49,1957,0.022215427313604482
STAT,1900,32,15-19,1932,0.001974741563433959
STAT,1918,21,20-24,1939,1.1919978003080045
STAT,1818,73,na,1891,2.9682277189043993
STAT,1898,30,na,1928,32.450115423503014
STAT,1818,41,50-100,1859,0.011714225459437842
STAT,1898,42,50-100,1940,9.884380998680348E-4
SIM,1871,43,na,1914,24
SIM,1875,57,na,1932,13
STAT,1920,23,35-39,1943,0.1034672024356187
STAT,1923,26,50-100,1949,0.011387500793992627
STAT,1929,23,25-29,1952,1.1589105976597514
STAT,1879,27,35-39,1906,0.09986737423495112
STAT,1865,34,50-100,1899,0.008216372285157572
STAT,1935,21,20-24,1956,1.5079786605968248
STAT,1902,48,40-44,1950,0.0013447206887084793
SIM,1920,1,na,1921,55
STAT,1842,21,50-100,1863,0.003886921708468409
STAT,1861,20,15-19,1881,0.02891553371546582
STAT,1905,36,45-49,1941,0.006239818445020302
STAT,1925,19,20-24,1944,1.6187689420935945
STAT,1926,46,30-34,1972,0.0010963838757629182
STAT,1852,45,25-29,1897,4.978832502736192E-4
STAT,1852,33,na,1885,20.927349434712358
SIM,1882,9,na,1891,34
STAT,1877,16,15-19,1893,0.061410512319727925
STAT,1914,27,20-24,1941,0.18249271203642134
SIM,1887,42,na,1929,24
STAT,1912,14,na,1926,39.494528995049606
SIM,1803,71,na,1874,4
STAT,1922,36,45-49,1958,0.007707283398960858
STAT,1941,30,40-44,1971,0.04083501389272106
STAT,1932,30,45-49,1962,0.020857301903867812
STAT,1846,36,40-44,1882,0.03743414016569795
STAT,1872,23,25-29,1895,0.5839101664138264
STAT,1799,77,na,1876,3.8556262111008723
SIM,1922,27,20-24,1949,1
STAT,1909,46,30-34,1955,8.165826416557587E-4
STAT,1887,37,40-44,1924,0.04778078198879278
STAT,1944,23,20-24,1967,1.1914796981653706
STAT,1866,24,45-49,1890,0.00638199894260413
STAT,1922,25,35-39,1947,0.16978744339563528
STAT,1882,33,40-44,1915,0.04138526688013897
SIM,1888,83,na,1971,13
SIM,1897,57,na,1954,38
STAT,1876,43,na,1919,23.30443743187143
STAT,1920,25,30-34,1945,0.4290567763003704
STAT,1893,46,25-29,1939,4.108372826014314E-4
STAT,1944,9,na,1953,42.106846032521815
SIM,1828,63,na,1891,8
STAT,1806,52,40-44,1858,3.4100260292915433E-4
STAT,1868,37,30-34,1905,0.05157673866444912
STAT,1889,33,50-100,1922,0.011170545290534423
STAT,1901,25,20-24,1926,0.1652682385895386
SIM,1839,63,na,1902,17
STAT,1909,10,na,1919,38.628219401274556
STAT,1866,68,na,1934,14.074417497619464
STAT,1870,29,50-100,1899,0.006309213413880369
STAT,1916,20,na,1936,38.165151888600796
SIM,1829,88,na,1917,4
STAT,1882,45,40-44,1927,0.0016570414711455652
STAT,1925,17,25-29,1942,0.5202113262501886
SIM,1877,6,na,1883,31
SIM,1803,68,na,1871,4
STAT,1837,34,40-44,1871,0.025972807738967044
STAT,1804,105,na,1909,1.1383214534361127E-4
STAT,1929,27,50-100,1956,0.012397524794736218
STAT,1833,41,na,1874,19.10140635519691
STAT,1852,49,40-44,1901,0.0014346196242000337
STAT,1921,40,40-44,1961,0.0028029944915034222
SIM,1810,78,na,1888,10
STAT,1916,29,20-24,1945,0.1857885854026908
SIM,1868,4,na,1872,38
STAT,1859,58,na,1917,15.718278760439198
STAT,1853,18,na,1871,17.251833340065236
STAT,1922,24,45-49,1946,0.012728468995588601
STAT,1842,28,15-19,1870,0.004179372936507724
SIM,1933,17,25-29,1950,2
STAT,1815,54,40-44,1869,1.4034797900630121E-4
STAT,1836,19,30-34,1855,0.02042549131513632
STAT,1952,20,45-49,1972,0.013457577369225596
STAT,1841,44,40-44,1885,0.02229887761392972
SIM,1842,30,na,1872,26
STAT,1860,46,50-100,1906,0.0020023298609528244
STAT,1856,47,na,1903,16.222611958769185
SIM,1852,48,na,1900,20
STAT,1877,53,50-100,1930,1.5339666313794354E-4
STAT,1902,34,15-19,1936,0.0011432440253892687
STAT,1818,52,na,1870,6.48890489882167
STAT,1838,23,30-34,1861,0.1780766316329164
STAT,1843,40,na,1883,10.35645802202851
STAT,1915,40,40-44,1955,0.002503370449842525
STAT,1870,26,30-34,1896,0.2510125799419822
STAT,1924,33,20-24,1957,0.028254541453018343
SIM,1896,35,na,1931,31
STAT,1849,17,50-100,1866,4.6760057553408906E-4
SIM,1885,72,na,1957,14
STAT,1925,30,50-100,1955,0.009767728670423819
STAT,1937,21,30-34,1958,0.2782089139604926
SIM,1841,85,na,1926,2
STAT,1892,19,15-19,1911,0.07292271581842731
SIM,1945,21,30-34,1966,3
STAT,1863,48,35-39,1911,0.0012239815868343184
STAT,1855,35,50-100,1890,0.008726260922973676
STAT,1811,48,40-44,1859,0.006674514805033567
STAT,1874,39,20-24,1913,0.007741488939938517
STAT,1909,31,50-100,1940,0.007877647488516912
STAT,1902,45,25-29,1947,4.6275443950927723E-4
SIM,1868,1,na,1869,39
STAT,1855,26,35-39,1881,0.07132320927898944
STAT,1831,55,na,1886,17.071284484318085
STAT,1926,30,45-49,1956,0.018939897710886045
STAT,1863,39,45-49,1902,0.017472641444320015
SIM,1904,47,na,1951,26
STAT,1846,30,20-24,1876,0.02643108591356511
SIM,1901,36,na,1937,36
STAT,1868,32,na,1900,23.09341311410479
SIM,1825,74,na,1899,5
STAT,1806,67,na,1873,10.470225225010845
STAT,1940,17,20-24,1957,1.36677856453448
STAT,1885,21,15-19,1906,0.032676707709623054
STAT,1849,24,45-49,1873,0.006443653077681433
STAT,1870,73,na,1943,11.798999296836106
STAT,1877,18,35-39,1895,0.005649270831605895
STAT,1939,26,na,1965,37.418516906024024
SIM,1853,70,na,1923,12
STAT,1841,92,na,1933,0.4076706463756702
STAT,1911,23,30-34,1934,0.2699871932733251
STAT,1853,58,na,1911,12.428828660946332
STAT,1861,8,na,1869,23.735826088527016
STAT,1888,18,40-44,1906,0.0021318015488279605
SIM,1895,0,na,1895,34
STAT,1844,84,na,1928,2.5984157437748006
STAT,1876,46,25-29,1922,5.866729050927981E-4
STAT,1842,18,na,1860,21.985333347147524
SIM,1839,66,na,1905,17
STAT,1857,39,15-19,1896,4.1614664905746516E-4
STAT,1868,22,20-24,1890,0.6668974229009972
STAT,1811,46,20-24,1857,4.8270764691485727E-4
STAT,1862,16,25-29,1878,0.05632611607884471
STAT,1916,23,15-19,1939,0.055132055271923726
STAT,1887,31,20-24,1918,0.029624667788397993
STAT,1878,31,25-29,1909,0.10617859181372148
STAT,1905,22,30-34,1927,0.2570742363511055
STAT,1932,32,35-39,1964,0.1209897770467687
STAT,1844,36,30-34,1880,0.04884576412179958
SIM,1913,21,na,1934,40
STAT,1935,34,35-39,1969,0.12570591644782658
STAT,1928,34,35-39,1962,0.11356022420103196
STAT,1806,104,na,1910,3.1210213461327655E-4
STAT,1948,22,45-49,1970,0.012833806338874952
STAT,1832,45,45-49,1877,0.001287387575972397
STAT,1865,43,na,1908,20.753858972803844
STAT,1905,33,40-44,1938,0.03578710850015452
STAT,1863,36,40-44,1899,0.03894485122416999
STAT,1907,24,na,1931,34.378215932437634
SIM,1846,23,30-34,1869,2
STAT,1831,41,50-100,1872,0.010599742371874861
STAT,1921,28,na,1949,41.27952832967042
STAT,1876,83,na,1959,5.270770716692358
STAT,1888,71,na,1959,16.81876055753571
STAT,1962,6,na,1968,50.06613641253674
STAT,1929,38,20-24,1967,0.0033647256540654583
SIM,1830,45,na,1875,19
STAT,1829,36,35-39,1865,0.06570287146685064
STAT,1937,32,40-44,1969,0.03847226480562534
SIM,1863,69,na,1932,5
STAT,1898,21,25-29,1919,0.7745752675377634
STAT,1868,102,na,1970,0.024811118764092904
SIM,1882,83,na,1965,12
STAT,1833,38,20-24,1871,0.007061454933853665
STAT,1842,55,na,1897,15.513619617312113
STAT,1928,43,25-29,1971,9.044559982104175E-4
STAT,1813,42,30-34,1855,0.0392213270419671
STAT,1907,32,50-100,1939,0.007695656287408456
SIM,1935,8,na,1943,60
STAT,1821,53,50-100,1874,2.009460550453676E-4
STAT,1822,38,45-49,1860,0.011948660541875137
SIM,1850,81,na,1931,1
STAT,1897,45,na,1942,30.180351969732627
SIM,1851,5,na,1856,29
STAT,1844,81,na,1925,4.223884808159181
STAT,1880,33,30-34,1913,0.18282341423182272
STAT,1878,27,50-100,1905,0.006604296503998225
STAT,1820,34,25-29,1854,0.09989583612022315
SIM,1895,3,na,1898,32
STAT,1856,5,na,1861,21.539514009359735
STAT,1921,42,30-34,1963,0.001428723625433772
STAT,1913,8,na,1921,40.305370518779675
SIM,1849,25,na,1874,11
STAT,1841,24,50-100,1865,0.004984102324422389
STAT,1864,58,na,1922,17.73752434283299
STAT,1933,36,20-24,1969,0.0035791762922322283
STAT,1833,49,30-34,1882,7.446091872576002E-4
STAT,1922,21,40-44,1943,0.0383917090823305
STAT,1847,46,50-100,1893,0.002631038939775752
STAT,1916,23,45-49,1939,0.011653377228199945
STAT,1843,99,na,1942,0.008033662320208385
SIM,1826,37,na,1863,16
STAT,1873,46,45-49,1919,0.002406206915815078
STAT,1822,44,30-34,1866,0.006380979212843659
STAT,1891,35,na,1926,29.191033504383597
STAT,1935,24,25-29,1959,1.2514131587530213
SIM,1918,27,30-34,1945,1
STAT,1891,23,35-39,1914,0.07140125603012669
STAT,1786,70,na,1856,2.7844186800000004
STAT,1882,48,45-49,1930,0.002233273091346755
STAT,1887,23,15-19,1910,0.03589783446927649
STAT,1824,32,35-39,1856,0.1654014655033771
STAT,1879,24,30-34,1903,0.18320479273048718
SIM,1848,40,na,1888,31
SIM,1832,32,35-39,1864,1
STAT,1890,50,na,1940,26.531169871109515
STAT,1954,15,na,1969,45.26713132043035
STAT,1927,25,40-44,1952,0.05675799747777933
SIM,1804,53,na,1857,13
STAT,1905,36,15-19,1941,1.757695545658399E-4
STAT,1921,50,na,1971,40.721836471143895
STAT,1887,36,50-100,1923,0.013465406581920438
STAT,1933,16,na,1949,49.19206066804368
STAT,1818,49,35-39,1867,0.0013375822137573917
STAT,1906,35,50-100,1941,0.0038864886779056123
STAT,1914,19,45-49,1933,0.0010192770384017278
STAT,1924,34,20-24,1958,0.028235610910244822
STAT,1918,36,25-29,1954,0.01033355922371267
STAT,1907,21,45-49,1928,0.010230877099578092
SIM,1858,39,na,1897,25
STAT,1926,30,15-19,1956,0.001546709743794773
STAT,1930,41,50-100,1971,0.0015407246692289167
STAT,1811,97,na,1908,0.030445100476898003
STAT,1957,3,na,1960,51.571709132283694
SIM,1817,63,na,1880,4
SIM,1897,20,na,1917,37
SIM,1952,3,na,1955,35
STAT,1906,39,na,1945,34.15088539533642
STAT,1943,20,50-100,1963,0.006954407029500415
STAT,1829,92,na,1921,0.28290448167688054
SIM,1844,15,15-19,1859,1
STAT,1887,6,na,1893,28.514082100259294
SIM,1854,55,na,1909,16
STAT,1902,44,25-29,1946,6.20352163696592E-4
STAT,1919,49,na,1968,39.270288842004476
STAT,1938,15,45-49,1953,0.004917942177297287
STAT,1848,43,50-100,1891,0.006782718465720636
STAT,1881,16,35-39,1897,0.005234029209952255
STAT,1913,32,25-29,1945,0.09118827102768451
STAT,1833,103,na,1936,0.001062503744097987
STAT,1807,48,20-24,1855,2.515052854608259E-4
STAT,1832,96,na,1928,0.03881244956192045
STAT,1837,49,45-49,1886,0.0011622960395986958
STAT,1955,17,40-44,1972,0.01846346688822368
STAT,1868,94,na,1962,0.46115282970806515
STAT,1840,17,50-100,1857,4.970408734697359E-4
STAT,1857,20,25-29,1877,0.5019124386041321
STAT,1903,29,40-44,1932,0.042284534820394196
SIM,1852,29,na,1881,23
STAT,1858,18,25-29,1876,0.05007398738377331
STAT,1914,19,15-19,1933,0.09260133767722041
STAT,1910,49,50-100,1959,0.0020850762086616127
STAT,1931,23,40-44,1954,0.043281726593889805
STAT,1944,26,25-29,1970,0.7065473482681259
STAT,1872,20,20-24,1892,0.7092990855871552
SIM,1878,22,30-34,1900,1
STAT,1837,30,25-29,1867,0.06403741057772597
STAT,1906,61,na,1967,29.660862089278563
STAT,1847,17,40-44,1864,0.0024385824543743627
SIM,1886,57,na,1943,24
STAT,1882,40,35-39,1922,0.017528927553936813
STAT,1901,16,30-34,1917,0.022357296273076754
STAT,1861,43,50-100,1904,0.008820112340518932
SIM,1908,9,na,1917,42
SIM,1775,82,na,1857,1
SIM,1950,16,na,1966,52
STAT,1836,26,25-29,1862,0.5320745499584394
STAT,1878,4,na,1882,29.769124788413038
STAT,1830,30,na,1860,10.197191740622504
STAT,1808,74,na,1882,1.8370180540611178
STAT,1880,46,45-49,1926,0.0024887112122807184
STAT,1850,22,35-39,1872,0.06236159764063893
STAT,1888,31,na,1919,28.00034540293804
SIM,1795,59,na,1854,11
STAT,1841,33,na,1874,25.472298838372833
STAT,1953,15,40-44,1968,0.01683123349077068
STAT,1864,98,na,1962,0.07920790781372833
STAT,1868,33,15-19,1901,0.0013723278090216505
SIM,1892,30,35-39,1922,1
SIM,1883,12,na,1895,15
SIM,1921,23,35-39,1944,2
STAT,1934,19,25-29,1953,0.5805383867918312
STAT,1918,36,30-34,1954,0.019128077816979696
STAT,1913,49,na,1962,35.349524532712195
STAT,1883,77,na,1960,10.02843030925594
STAT,1818,36,na,1854,7.649672927398727
STAT,1852,49,35-39,1901,0.0011731702561400725
STAT,1866,36,15-19,1902,5.19662337692623E-4
STAT,1879,17,25-29,1896,0.05865120607884782
STAT,1838,50,na,1888,17.29440968860076
SIM,1800,60,na,1860,11
STAT,1814,46,na,1860,13.861569270630609
STAT,1891,20,25-29,1911,0.7068040955245262
STAT,1880,43,40-44,1923,0.02348147055415952
STAT,1905,28,50-100,1933,0.009199807381127236
STAT,1921,42,25-29,1963,7.980258120659643E-4
STAT,1940,16,45-49,1956,0.005037439553546709
STAT,1884,30,35-39,1914,0.10001767210177112
STAT,1900,47,25-29,1947,4.4844908578525977E-4
STAT,1921,44,na,1965,41.36642761345237
STAT,1930,20,30-34,1950,0.3686589026725177
STAT,1822,47,40-44,1869,9.40309388532205E-4
STAT,1919,15,40-44,1934,0.003088510035923161
SIM,1888,21,na,1909,33
STAT,1861,24,30-34,1885,0.15168666148461113
STAT,1870,19,30-34,1889,0.01579640664382755
STAT,1898,8,na,1906,35.06790122421664
SIM,1939,7,na,1946,30
SIM,1821,68,na,1889,7
STAT,1915,31,45-49,1946,0.015952774742540074
STAT,1851,32,na,1883,20.96834977597497
STAT,1908,62,na,1970,30.08639111016138
STAT,1834,60,na,1894,13.477952258785532
SIM,1871,27,na,1898,24
SIM,1793,73,na,1866,13
STAT,1871,43,30-34,1914,0.011379396033996212
STAT,1805,85,na,1890,0.7505853222346673
STAT,1854,34,40-44,1888,0.026587385593450235
STAT,1951,16,20-24,1967,1.6051110087808198
STAT,1909,41,30-34,1950,0.0011959306197422657
STAT,1872,27,40-44,1899,0.030649717276215658
STAT,1913,23,35-39,1936,0.09399555644912115
STAT,1856,63,na,1919,12.926095003572955
STAT,1804,52,30-34,1856,1.6348346706326306E-4
STAT,1877,5,na,1882,28.164277193516323
STAT,1944,26,30-34,1970,0.4206053631815247
SIM,1920,31,na,1951,46
SIM,1875,70,na,1945,7
STAT,1817,88,na,1905,1.0880249259431842
STAT,1909,34,25-29,1943,0.08695400892314359
SIM,1832,71,na,1903,18
STAT,1870,27,na,1897,23.707449383963702
STAT,1892,26,15-19,1918,0.005624311003283904
STAT,1826,65,na,1891,11.809743482099886
STAT,1861,35,25-29,1896,0.024442719205612466
STAT,1929,37,45-49,1966,0.008710289955552048
STAT,1920,20,30-34,1940,0.3186935708544436
STAT,1854,40,50-100,1894,0.006522561451071174
STAT,1872,39,50-100,1911,0.012435468222983302
STAT,1925,34,na,1959,44.57309920639381
STAT,1850,50,na,1900,19.446545446702775
STAT,1926,31,20-24,1957,0.029342153535444004
SIM,1888,43,na,1931,34
STAT,1927,29,35-39,1956,0.18085817948766975
STAT,1878,48,50-100,1926,0.0025037573836838673
STAT,1849,43,50-100,1892,0.00813246146884356
STAT,1856,40,25-29,1896,0.0046989400568278866
STAT,1786,73,na,1859,2.095284121924916
SIM,1910,59,na,1969,27
STAT,1878,40,20-24,1918,0.0016561579103591896
STAT,1899,15,45-49,1914,8.983764206613836E-4
STAT,1859,46,25-29,1905,4.591143440559801E-4
STAT,1835,34,30-34,1869,0.09890996986159119
STAT,1927,40,50-100,1967,0.0014699155346103983
STAT,1825,83,na,1908,2.140170312363823
STAT,1867,40,45-49,1907,0.014466773007231714
SIM,1935,29,35-39,1964,1
STAT,1904,30,30-34,1934,0.25218963582549425
SIM,1867,75,na,1942,5
SIM,1870,79,na,1949,11
SIM,1941,17,na,1958,48
STAT,1872,26,50-100,1898,0.006567603121051698
STAT,1930,42,35-39,1972,0.002637079781268448
STAT,1825,35,15-19,1860,6.086703791421365E-4
STAT,1853,29,40-44,1882,0.019562871802075128
STAT,1848,21,35-39,1869,0.046282228205173574
STAT,1840,16,40-44,1856,0.0018666140690607532
SIM,1861,84,na,1945,2
SIM,1890,65,na,1955,19
SIM,1905,32,na,1937,40
SIM,1843,65,na,1908,17
STAT,1870,22,15-19,1892,0.03277212803701258
SIM,1922,26,45-49,1948,1
STAT,1890,43,40-44,1933,0.027124650622026115
STAT,1953,19,35-39,1972,0.05043313222652837
STAT,1818,45,25-29,1863,5.83544538149835E-4
STAT,1835,45,25-29,1880,3.0996726379360943E-4
STAT,1844,29,30-34,1873,0.23734206950406353
STAT,1871,52,na,1923,21.35280922925492
STAT,1871,49,45-49,1920,0.002303793649467445
STAT,1805,63,na,1868,7.241767778703932
STAT,1820,48,45-49,1868,0.001969220544981201
STAT,1835,27,50-100,1862,0.003838969512241463
SIM,1892,42,na,1934,36
STAT,1860,19,30-34,1879,0.014768881862039842
STAT,1900,20,45-49,1920,0.009727327184453486
STAT,1933,20,40-44,1953,0.04468333619176424
STAT,1870,38,30-34,1908,0.05268081785024958
SIM,1852,29,30-34,1881,1
SIM,1812,85,na,1897,1
STAT,1919,44,35-39,1963,0.002156054813328303
SIM,1920,15,30-34,1935,1
SIM,1896,72,na,1968,20
STAT,1846,33,50-100,1879,0.008684455997728532
SIM,1821,62,na,1883,7
STAT,1841,30,na,1871,26.27827930172315
SIM,1916,29,25-29,1945,2
STAT,1876,36,15-19,1912,5.730764568732315E-4
STAT,1854,32,15-19,1886,8.913888207833497E-4
STAT,1885,16,50-100,1901,4.8499028339459813E-4
STAT,1903,25,30-34,1928,0.36044834483437516
STAT,1873,39,50-100,1912,0.012356740596377284
STAT,1843,34,50-100,1877,0.004576470025965554
STAT,1831,71,na,1902,10.83182300990619
STAT,1841,35,50-100,1876,0.014455891633143715
STAT,1916,20,40-44,1936,0.035140195696841556
STAT,1907,37,25-29,1944,0.009090261005701775
STAT,1776,89,na,1865,0.2464269005419403
STAT,1889,41,35-39,1930,0.02227068281593916
STAT,1827,29,30-34,1856,0.2720279071451326
STAT,1832,28,50-100,1860,0.0037995014137518586
STAT,1848,34,40-44,1882,0.029150815952846663
SIM,1868,23,na,1891,30
SIM,1789,74,na,1863,7
SIM,1876,58,na,1934,27
STAT,1952,14,na,1966,46.77808092527644
STAT,1928,44,45-49,1972,0.002104277048139229
SIM,1926,28,na,1954,45
STAT,1868,88,na,1956,1.4847317802013948
STAT,1923,6,na,1929,46.73829949612582
STAT,1830,45,35-39,1875,1.4275179202109545E-4
STAT,1874,24,40-44,1898,0.021007721163687917
SIM,1922,44,na,1966,48
STAT,1876,35,30-34,1911,0.05464370596041528
STAT,1941,16,50-100,1957,0.003832105396467096
STAT,1908,29,25-29,1937,0.6145625251768462
STAT,1899,41,35-39,1940,0.0017291766904611544
STAT,1871,30,25-29,1901,0.10293964711141375
STAT,1788,74,na,1862,5.306566222838502
STAT,1868,25,25-29,1893,0.4121473141153184
STAT,1883,45,50-100,1928,0.0024087532588060864
SIM,1887,31,50-100,1918,1
STAT,1848,40,35-39,1888,0.011999678024142271
SIM,1856,38,na,1894,12
STAT,1916,23,50-100,1939,0.006814840743992387
STAT,1798,98,na,1896,0.016508588836430693
STAT,1813,52,40-44,1865,3.134007486317863E-4
SIM,1928,35,na,1963,54
SIM,1893,36,25-29,1929,2
STAT,1791,78,na,1869,2.886858536240784
STAT,1885,49,30-34,1934,9.359555735483358E-4
STAT,1924,37,25-29,1961,0.01153477712948624
STAT,1895,35,40-44,1930,0.057370891676563465
STAT,1884,45,50-100,1929,0.002430260270339188
SIM,1941,4,na,1945,49
STAT,1853,19,30-34,1872,0.011908472577065468
STAT,1920,37,50-100,1957,0.004557807131213356
STAT,1906,45,na,1951,33.018046496921286
STAT,1828,44,40-44,1872,0.009698990473040504
SIM,1919,40,na,1959,43
SIM,1898,45,na,1943,31
STAT,1830,29,50-100,1859,0.004792966026867321
STAT,1861,49,45-49,1910,0.0019432169461929094
SIM,1900,23,20-24,1923,1
STAT,1885,36,25-29,1921,0.028569345660053952
STAT,1869,17,25-29,1886,0.05566760760722939
STAT,1902,41,20-24,1943,1.5622334245965464E-4
STAT,1912,15,30-34,1927,0.024567965806647513
STAT,1826,31,na,1857,20.711958037995366
SIM,1855,50,na,1905,14
STAT,1914,26,45-49,1940,0.017330982243538108
SIM,1876,36,na,1912,29
SIM,1831,46,na,1877,9
SIM,1884,87,na,1971,4
STAT,1885,20,na,1905,23.494555670275748
STAT,1909,28,na,1937,35.475503780863725
STAT,1933,27,25-29,1960,0.8703981135851464
STAT,1813,98,na,1911,0.021438927377265153
STAT,1929,18,45-49,1947,0.0063280766647773245
STAT,1913,30,40-44,1943,0.03891943999619084
STAT,1866,47,50-100,1913,0.002251385453450343
STAT,1917,41,20-24,1958,1.8288939869206153E-4
STAT,1918,30,na,1948,40.14592749359828
STAT,1883,20,35-39,1903,0.057005374438362094
SIM,1838,25,na,1863,8
STAT,1878,43,25-29,1921,0.006581850156158495
STAT,1951,19,25-29,1970,0.5125686831987585
STAT,1883,36,15-19,1919,5.479311304535939E-4
SIM,1835,36,na,1871,19
STAT,1872,38,40-44,1910,0.044567149510097936
STAT,1894,28,50-100,1922,0.00816938793791972
STAT,1909,44,35-39,1953,0.0018498840749901152
STAT,1814,62,na,1876,10.046889592950597
STAT,1935,36,30-34,1971,0.025395476490745517
STAT,1861,25,15-19,1886,0.0038989443621253567
STAT,1784,90,na,1874,0.42043531773623855
STAT,1871,46,35-39,1917,0.0013997634380619346
STAT,1900,44,20-24,1944,1.5086325376527973E-4
STAT,1863,22,15-19,1885,0.029791593395748547
STAT,1932,31,45-49,1963,0.020845830387820685
STAT,1825,29,20-24,1854,0.24297364617742737
STAT,1903,18,50-100,1921,6.947088755938835E-4
STAT,1785,91,na,1876,0.5234751395647039
STAT,1889,35,40-44,1924,0.05410415431922373
STAT,1895,40,20-24,1935,0.0020826027855803315
STAT,1899,16,50-100,1915,6.723134700482565E-4
STAT,1820,43,15-19,1863,1.2008335718112294E-4
STAT,1818,42,15-19,1860,1.4848491204909377E-4
STAT,1834,29,30-34,1863,0.23001179895201387
STAT,1888,15,na,1903,29.651310748991083
STAT,1885,33,15-19,1918,0.0014003622951719826
STAT,1884,40,45-49,1924,0.014811319926144066
STAT,1892,54,na,1946,25.869613807042807
SIM,1938,18,20-24,1956,2
STAT,1838,16,25-29,1854,0.058439664343049286
STAT,1810,72,na,1882,4.746267469203482
STAT,1880,24,40-44,1904,0.021775181165423485
STAT,1776,95,na,1871,0.01714720501017635
STAT,1863,79,na,1942,6.189861202997176
STAT,1923,16,45-49,1939,0.005839482509924217
SIM,1867,59,na,1926,9
STAT,1937,33,30-34,1970,0.1547941646787301
STAT,1857,27,15-19,1884,0.003498400187793801
STAT,1932,19,20-24,1951,1.77836563414213
STAT,1936,15,40-44,1951,0.0133721019959715
STAT,1908,26,20-24,1934,0.17371477169762356
SIM,1856,81,na,1937,3
STAT,1831,26,40-44,1857,0.03331988538570125
STAT,1904,42,25-29,1946,6.381780002666029E-4
STAT,1876,30,45-49,1906,0.017853419986681447
STAT,1914,24,50-100,1938,0.006624968567470007
STAT,1881,36,na,1917,22.526045881319973
STAT,1878,7,na,1885,27.64388658599887
STAT,1905,17,50-100,1922,7.070710538954312E-4
STAT,1914,40,na,1954,36.75083499042498
STAT,1849,17,15-19,1866,0.05664202784487565
STAT,1875,26,15-19,1901,0.004679804651521831
STAT,1929,34,40-44,1963,0.0494065132597242
SIM,1850,19,na,1869,21
STAT,1847,53,40-44,1900,1.1065457779974808E-4
STAT,1835,35,15-19,1870,3.2181013573439227E-4
STAT,1897,41,25-29,1938,5.948506247527327E-4
STAT,1938,23,50-100,1961,0.006467129728413396
SIM,1878,5,na,1883,31
STAT,1835,48,na,1883,10.530530101841833
STAT,1896,10,na,1906,34.02486450440217
STAT,1920,29,40-44,1949,0.05033305453444516
STAT,1926,34,25-29,1960,0.11097739151010928
STAT,1861,44,15-19,1905,1.1456692641791168E-4
STAT,1859,43,20-24,1902,0.0012531544208161526
STAT,1921,30,30-34,1951,0.17536132076817976
STAT,1839,41,50-100,1880,0.006839443965304365
STAT,1832,104,na,1936,3.014900696913778E-4
STAT,1842,35,15-19,1877,5.046066135959579E-4
STAT,1891,49,30-34,1940,6.561878026334891E-4
STAT,1903,31,na,1934,34.06562303688045
STAT,1909,31,20-24,1940,0.023240215306021425
STAT,1843,96,na,1939,0.03642404989197426
STAT,1901,47,50-100,1948,0.0019294936806719509
STAT,1913,20,30-34,1933,0.2778232001710062
SIM,1872,28,na,1900,26
SIM,1859,25,25-29,1884,2
STAT,1861,39,35-39,1900,0.05888148258828555
SIM,1815,50,na,1865,11
STAT,1841,95,na,1936,0.13013870335568561
STAT,1907,34,20-24,1941,0.022508937858489092
STAT,1859,24,15-19,1883,0.026816117247107293
SIM,1938,13,na,1951,40
STAT,1831,37,40-44,1868,0.044763465511555335
SIM,1847,21,na,1868,17
STAT,1837,32,15-19,1869,8.714040153375808E-4
STAT,1911,45,35-39,1956,0.0012184205573760134
STAT,1869,45,40-44,1914,0.0016753654768232778
STAT,1874,82,na,1956,5.076588558653558
STAT,1829,35,50-100,1864,0.011521437703502804
SIM,1905,26,na,1931,40
STAT,1896,15,35-39,1911,0.0072409791745034514
STAT,1858,70,na,1928,10.676618598473725
SIM,1832,22,na,1854,25
SIM,1834,88,na,1922,3
STAT,1887,38,40-44,1925,0.047543789310128357
STAT,1844,48,30-34,1892,7.465995908536328E-4
STAT,1877,17,15-19,1894,0.06126005656454459
STAT,1906,41,45-49,1947,0.0015167400431274436
STAT,1881,23,35-39,1904,0.05535554877239283
STAT,1926,37,35-39,1963,0.029391317057572013
STAT,1927,26,30-34,1953,0.4755414226569899
STAT,1844,32,15-19,1876,0.001330171979917866
STAT,1922,31,50-100,1953,0.009311234025147507
STAT,1949,18,30-34,1967,0.14080848397994922
STAT,1851,19,20-24,1870,0.17983370392916495
STAT,1885,33,20-24,1918,0.0265804604752684
STAT,1923,42,35-39,1965,0.002337261156266863
SIM,1803,65,na,1868,5
STAT,1879,28,40-44,1907,0.030895250476541323
STAT,1933,23,45-49,1956,0.014859148652920698
STAT,1938,27,45-49,1965,0.017002715429301
SIM,1920,18,35-39,1938,1
STAT,1841,40,25-29,1881,0.006700971452869277
STAT,1916,36,20-24,1952,0.0026893184872158944
SIM,1909,62,na,1971,29
SIM,1929,17,na,1946,45
STAT,1915,3,na,1918,41.94712582301242
STAT,1901,24,na,1925,32.88622138680471
SIM,1941,24,20-24,1965,1
STAT,1863,57,na,1920,17.793224888809196
STAT,1958,2,na,1960,51.39186729827141
STAT,1928,41,40-44,1969,0.003177616490253925
STAT,1830,42,30-34,1872,0.006273338542695286
STAT,1846,37,40-44,1883,0.03704744549778627
STAT,1902,49,40-44,1951,0.0013333981405095538
STAT,1852,34,30-34,1886,0.15153564054283908
STAT,1869,36,na,1905,22.93791077558625
STAT,1953,16,30-34,1969,0.1466355036724514
STAT,1931,19,15-19,1950,0.5882199687027356
STAT,1924,21,45-49,1945,0.013230351980645412
STAT,1839,31,35-39,1870,0.06949306721856072
SIM,1796,78,na,1874,3
STAT,1858,19,15-19,1877,0.05213172149938846
SIM,1898,39,na,1937,32
STAT,1902,30,20-24,1932,0.038424572815763634
STAT,1914,23,40-44,1937,0.03396158475631993
STAT,1935,31,30-34,1966,0.21713092001267884
STAT,1875,42,na,1917,23.72895783891466
STAT,1898,70,na,1968,22.224885531142487
STAT,1934,17,na,1951,49.57501987286475
STAT,1860,15,na,1875,21.778275236475196
STAT,1863,41,15-19,1904,1.228251529866139E-4
STAT,1834,25,15-19,1859,0.004265311616330917
STAT,1834,82,na,1916,3.2973168759042433
SIM,1818,64,na,1882,17
STAT,1847,33,na,1880,26.901889335152482
STAT,1851,54,na,1905,17.677832275295916
SIM,1902,20,20-24,1922,1
STAT,1859,43,15-19,1902,1.0896995552174886E-4
STAT,1863,32,25-29,1895,0.0906877741759885
STAT,1891,30,35-39,1921,0.12529505039385433
SIM,1851,60,na,1911,15
STAT,1855,81,na,1936,3.8073596622892887
STAT,1890,46,45-49,1936,0.001621648005076448
STAT,1905,29,15-19,1934,0.006501222738100265
SIM,1860,80,na,1940,7
STAT,1840,22,35-39,1862,0.05815026142568121
SIM,1880,57,na,1937,29
STAT,1895,19,na,1914,32.61297402745847
SIM,1914,49,na,1963,36
STAT,1910,42,25-29,1952,6.707537873603886E-4
STAT,1896,22,50-100,1918,0.005356473814308071
STAT,1818,42,20-24,1860,0.001707576396336893
STAT,1883,1,na,1884,32.44905975421281
STAT,1920,48,50-100,1968,0.002472046210053704
SIM,1929,39,na,1968,48
SIM,1953,2,na,1955,51
STAT,1876,31,15-19,1907,0.0014522682204207212
STAT,1831,48,20-24,1879,1.134237728097157E-4
STAT,1878,33,15-19,1911,0.0014640374010615304
SIM,1840,66,na,1906,6
SIM,1838,19,na,1857,15
STAT,1849,99,na,1948,0.01468488014676568
STAT,1880,48,40-44,1928,0.001777638581048576
SIM,1909,16,na,1925,41
STAT,1865,49,20-24,1914,1.0627228446439045E-4
SIM,1908,31,na,1939,38
STAT,1820,38,35-39,1858,0.06553001429224871
STAT,1916,23,na,1939,37.82155662300476
STAT,1930,32,25-29,1962,0.11872166218534681
STAT,1827,39,40-44,1866,0.03480945015460591
STAT,1933,24,20-24,1957,1.4679347917126409
STAT,1911,26,35-39,1937,0.14597000188466044
STAT,1914,7,na,1921,40.872557626818
SIM,1926,34,na,1960,45
STAT,1913,33,45-49,1946,0.015459455189008311
SIM,1820,37,na,1857,16
STAT,1924,48,25-29,1972,6.256622352606502E-4
STAT,1833,23,40-44,1856,0.02058986623886848
STAT,1838,27,40-44,1865,0.029575051444050728
STAT,1844,32,20-24,1876,0.02524816889130403
STAT,1931,12,na,1943,51.63250604116616
STAT,1872,49,20-24,1921,1.2021686746755259E-4
STAT,1902,55,na,1957,29.56825487774251
STAT,1808,102,na,1910,4.2810254384145036E-4
STAT,1929,15,40-44,1944,0.017847703240412953
STAT,1865,23,50-100,1888,0.0037064436860258865
STAT,1846,85,na,1931,2.2216624842484403
STAT,1802,101,na,1903,0.001742713909153396
SIM,1871,9,na,1880,27
STAT,1882,41,25-29,1923,0.006181917708924521
STAT,1884,25,na,1909,23.540639176082195
STAT,1948,15,45-49,1963,0.0056820490239240275
STAT,1860,15,15-19,1875,0.05630473923302353
STAT,1788,80,na,1868,3.0049022910218364
STAT,1878,56,na,1934,21.057539592018358
STAT,1864,16,35-39,1880,0.005627851812550821
STAT,1894,39,50-100,1933,0.015576289397760196
STAT,1865,40,35-39,1905,0.01654384723903037
STAT,1871,46,40-44,1917,0.001711710714596907
SIM,1900,26,25-29,1926,1
STAT,1850,48,30-34,1898,8.510437588241215E-4
STAT,1884,41,15-19,1925,1.3591428454434135E-4
STAT,1858,27,na,1885,18.59043511188426
STAT,1837,42,25-29,1879,0.003689357408386002
STAT,1942,26,20-24,1968,0.19027525119393957
STAT,1863,24,50-100,1887,0.0036298300770522514
STAT,1934,16,20-24,1950,1.830509251154233
STAT,1896,34,35-39,1930,0.1318837706073841
SIM,1818,42,na,1860,25
STAT,1866,41,50-100,1907,0.009773751709635223
STAT,1912,18,35-39,1930,0.008396652569902949
SIM,1879,60,na,1939,11
STAT,1829,43,35-39,1872,0.015814864719478277
SIM,1864,33,na,1897,19
STAT,1926,17,50-100,1943,0.004567207159328154
STAT,1916,34,50-100,1950,0.008390622288586889
STAT,1892,76,na,1968,15.579591520779838
STAT,1947,18,20-24,1965,1.516287654549693
STAT,1850,26,50-100,1876,0.0067510512355648845
STAT,1818,49,40-44,1867,0.0016356719604798486
SIM,1956,15,45-49,1971,1
STAT,1886,43,15-19,1929,1.422099424531157E-4
STAT,1893,47,30-34,1940,6.85270431424486E-4
SIM,1858,79,na,1937,8
STAT,1848,30,25-29,1878,0.07886731751191438
STAT,1878,47,na,1925,23.119462097206878
STAT,1895,43,25-29,1938,5.747450442309631E-4
STAT,1926,44,35-39,1970,0.002460032388747125
SIM,1861,25,25-29,1886,1
STAT,1815,47,na,1862,10.842846468139314
STAT,1842,29,20-24,1871,0.10729072371503716
SIM,1896,19,na,1915,33
STAT,1867,45,30-34,1912,9.355730162540251E-4
STAT,1935,27,35-39,1962,0.20374726712758423
STAT,1835,61,na,1896,8.40498923935108
SIM,1855,34,na,1889,19
STAT,1844,25,15-19,1869,0.004401243287136332
STAT,1912,48,na,1960,34.93322625340837
STAT,1813,48,45-49,1861,0.0072062056511976265
STAT,1861,93,na,1954,0.24577256166199396
STAT,1855,33,35-39,1888,0.07184979877514575
STAT,1809,49,30-34,1858,0.0032012730822853185
STAT,1830,45,40-44,1875,1.7456504812608675E-4
STAT,1861,32,50-100,1893,0.007705217561997744
STAT,1851,29,30-34,1880,0.2453556905009056
SIM,1890,16,na,1906,30
STAT,1905,40,50-100,1945,0.001069477020651138
STAT,1872,56,na,1928,20.86892752289042
SIM,1923,23,na,1946,38
STAT,1904,19,45-49,1923,9.309805116703893E-4
SIM,1857,2,na,1859,29
SIM,1803,74,na,1877,3
STAT,1828,97,na,1925,0.03608046057118641
STAT,1823,42,na,1865,15.923755823052659
STAT,1804,84,na,1888,1.3151722066019227
SIM,1889,22,na,1911,34
STAT,1884,41,na,1925,22.746877228928195
SIM,1904,41,na,1945,27
STAT,1896,38,50-100,1934,0.016046854009755536
SIM,1930,22,30-34,1952,2
STAT,1939,22,40-44,1961,0.03353586425743387
STAT,1930,33,45-49,1963,0.020200049160694285
STAT,1850,23,40-44,1873,0.02210899674429468
STAT,1942,17,25-29,1959,0.44957093627286476
SIM,1883,31,na,1914,13
SIM,1841,39,na,1880,16
STAT,1897,29,na,1926,31.465455755225115
SIM,1825,77,na,1902,4
SIM,1935,30,na,1965,56
STAT,1841,79,na,1920,6.842945996895529
STAT,1868,21,45-49,1889,0.006797099944104308
STAT,1901,7,na,1908,36.45594115625471
STAT,1835,39,30-34,1874,0.029252164738510097
STAT,1797,97,na,1894,0.011507867709600649
STAT,1893,35,30-34,1928,0.06783764082233198
STAT,1922,22,30-34,1944,0.32718242152139354
STAT,1924,30,40-44,1954,0.04556390120860182
SIM,1885,78,na,1963,11
SIM,1916,29,30-34,1945,1
STAT,1921,33,35-39,1954,0.10047700303190232
STAT,1937,23,50-100,1960,0.006365049371035885
SIM,1947,22,40-44,1969,1
STAT,1844,39,40-44,1883,0.03538939580380346
STAT,1814,99,na,1913,0.008439485261057778
SIM,1891,63,na,1954,28
STAT,1826,87,na,1913,1.2311810730310015
SIM,1859,27,na,1886,21
STAT,1827,32,na,1859,17.787795223418975
SIM,1878,84,na,1962,5
STAT,1907,33,45-49,1940,0.014584763201471961
STAT,1909,37,35-39,1946,0.022765829371466238
STAT,1861,32,15-19,1893,0.001197585195403339
STAT,1831,29,45-49,1860,0.011856539000028067
SIM,1923,45,na,1968,38
SIM,1909,8,na,1917,41
STAT,1924,8,na,1932,47.1864425766021
STAT,1905,60,na,1965,29.621501701297618
STAT,1861,48,30-34,1909,8.038164419345771E-4
STAT,1848,49,na,1897,14.245927956819664
STAT,1836,50,50-100,1886,1.5343521114683477E-4
SIM,1931,3,na,1934,63
STAT,1870,22,20-24,1892,0.6845688464264126
STAT,1910,18,25-29,1928,0.08511917797288751
SIM,1909,19,na,1928,40
STAT,1837,21,50-100,1858,0.0029743502259946737
SIM,1892,29,na,1921,36
STAT,1887,22,25-29,1909,0.6248402813815541
STAT,1880,39,45-49,1919,0.02075159219318858
STAT,1797,94,na,1891,0.04281213064369949
STAT,1872,53,na,1925,21.676845833167057
STAT,1908,29,30-34,1937,0.36584709394687187
STAT,1885,26,15-19,1911,0.004495755250579907
STAT,1830,33,40-44,1863,0.027591747394718626
STAT,1821,42,50-100,1863,0.01646951832888831
STAT,1890,37,50-100,1927,0.014913426914832337
SIM,1916,17,30-34,1933,1
STAT,1839,18,50-100,1857,3.5159315569037534E-4
STAT,1852,46,30-34,1898,8.30813223809052E-4
STAT,1867,54,50-100,1921,1.4055294963645566E-4
STAT,1870,34,15-19,1904,0.0014025498053059345
STAT,1825,39,30-34,1864,0.053451592151139225
STAT,1917,47,50-100,1964,0.0023409889995604843
STAT,1867,30,35-39,1897,0.09769102053180381
STAT,1869,41,25-29,1910,0.006250279000521632
STAT,1881,11,na,1892,24.610365521630545
STAT,1839,20,50-100,1859,0.0029334920797542434
STAT,1853,25,25-29,1878,0.3124535894124349
STAT,1935,20,15-19,1955,0.07221693988623402
STAT,1839,44,40-44,1883,0.012751551909343002
SIM,1877,37,na,1914,28
SIM,1931,40,na,1971,56
STAT,1804,87,na,1891,0.6839896864656666
STAT,1857,20,30-34,1877,0.15617278266607726
STAT,1917,44,25-29,1961,7.359874268471669E-4
SIM,1924,27,25-29,1951,2
STAT,1905,24,45-49,1929,0.01000103071474366
SIM,1889,25,na,1914,32
STAT,1811,45,30-34,1856,0.003955266863545216
SIM,1839,30,30-34,1869,2
STAT,1861,29,30-34,1890,0.21025502645870187
STAT,1813,41,25-29,1854,0.022308403600118133
STAT,1921,46,40-44,1967,0.0017678780096110247
SIM,1918,4,na,1922,41
SIM,1807,55,na,1862,15
STAT,1925,17,30-34,1942,0.14631880552525545
SIM,1822,47,na,1869,15
STAT,1898,21,30-34,1919,0.24101330353978978
STAT,1889,31,25-29,1920,0.12591592962355883
STAT,1938,24,40-44,1962,0.03303546404721785
SIM,1909,2,na,1911,41
STAT,1847,89,na,1936,1.1222205950561581
STAT,1865,34,40-44,1899,0.03888922258530417
STAT,1873,19,na,1892,25.53994721767754
SIM,1834,32,na,1866,22
STAT,1884,0,na,1884,34.52238335227478
STAT,1920,35,35-39,1955,0.02630262251185088
SIM,1836,61,na,1897,2
STAT,1911,30,30-34,1941,0.1536544034541929
STAT,1968,3,na,1971,48.80923133136523
STAT,1961,7,na,1968,50.48294153270701
STAT,1883,23,45-49,1906,0.006750636412324235
STAT,1911,23,25-29,1934,0.8676923613344456
STAT,1916,27,25-29,1943,0.6747414200986526
STAT,1820,47,30-34,1867,8.184211853731351E-4
STAT,1896,66,na,1962,23.25473538832996
STAT,1882,19,15-19,1901,0.05656839785434357
STAT,1854,37,na,1891,14.400557539624241
STAT,1870,29,40-44,1899,0.029544906708252307
STAT,1904,40,40-44,1944,0.0022606771634527093
STAT,1934,19,30-34,1953,0.1632868779102417
STAT,1886,45,40-44,1931,0.00179350388844239
STAT,1935,33,20-24,1968,0.033575202188489944
SIM,1867,22,na,1889,16
STAT,1936,21,na,1957,34.71329141099437
STAT,1865,21,35-39,1886,0.053809128027935395
STAT,1880,32,25-29,1912,0.10770642278702877
STAT,1934,32,50-100,1966,0.011240709469976663
STAT,1916,39,25-29,1955,0.009896143885084509
SIM,1858,64,na,1922,18
STAT,1826,44,30-34,1870,0.011743583249347241
STAT,1880,20,25-29,1900,0.605559684557713
SIM,1858,45,na,1903,24
SIM,1940,5,na,1945,37
STAT,1874,66,na,1940,16.627617098605217
STAT,1868,36,25-29,1904,0.02799740300779019
STAT,1860,68,na,1928,12.423828990468971
STAT,1822,43,25-29,1865,0.003616342978447975
STAT,1840,91,na,1931,0.45407401147433757
STAT,1861,16,na,1877,22.318769392878405
STAT,1886,51,na,1937,22.441558225460305
STAT,1915,43,20-24,1958,1.7598594357135156E-4
STAT,1863,44,25-29,1907,0.0056088975380442635
STAT,1891,29,na,1920,29.081971696467996
STAT,1930,30,50-100,1960,0.010632180564230782
STAT,1836,24,na,1860,26.843098420062404
SIM,1911,20,na,1931,42
SIM,1932,2,na,1934,57
SIM,1834,44,30-34,1878,1
STAT,1816,39,20-24,1855,0.011343171992894687
STAT,1845,26,50-100,1871,0.004584328297550825
STAT,1866,22,na,1888,21.95951090751463
STAT,1936,18,45-49,1954,0.0047412087404122265
SIM,1854,71,na,1925,7
STAT,1845,44,40-44,1889,0.01305025644103116
STAT,1919,18,45-49,1937,0.005458135165853923
SIM,1843,49,na,1892,19
STAT,1902,33,25-29,1935,0.14383030261682522
SIM,1833,72,na,1905,3
STAT,1879,31,50-100,1910,0.009521987584000998
STAT,1861,90,na,1951,0.6630141011685932
STAT,1827,35,25-29,1862,0.0241957317119375
STAT,1942,29,25-29,1971,0.685109489050165
STAT,1846,21,25-29,1867,0.5765708983293599
STAT,1894,26,25-29,1920,0.5439920312447389
SIM,1873,53,na,1926,24
SIM,1853,24,na,1877,24
STAT,1924,45,20-24,1969,1.3132487188152864E-4
STAT,1836,18,40-44,1854,0.0023577963534027646
STAT,1838,72,na,1910,9.801916379293965
SIM,1917,11,na,1928,47
STAT,1908,48,50-100,1956,0.002029225475402835
SIM,1866,74,na,1940,13
STAT,1896,44,na,1940,30.05260817053696
STAT,1911,35,25-29,1946,0.009538465009888985
SIM,1891,66,na,1957,27
SIM,1933,29,25-29,1962,1
SIM,1897,46,50-100,1943,1
STAT,1854,49,45-49,1903,0.001412396043854568
SIM,1944,22,na,1966,34
STAT,1915,19,20-24,1934,0.27979316098965057
SIM,1923,19,20-24,1942,1
STAT,1876,17,50-100,1893,4.975839344138975E-4
STAT,1825,44,50-100,1869,0.009899856528235959
STAT,1950,20,40-44,1970,0.039668644048915604
STAT,1925,29,25-29,1954,0.7670266038020813
STAT,1877,15,25-29,1892,0.05876720927930623
STAT,1823,76,na,1899,5.448405619180231
STAT,1903,41,50-100,1944,0.0010477339380610114
STAT,1813,45,40-44,1858,0.005466953067712441
STAT,1915,41,na,1956,37.12138214960854
SIM,1881,82,na,1963,1
STAT,1850,47,50-100,1897,0.002176541518867064
STAT,1817,54,30-34,1871,1.590275971494315E-4
STAT,1879,15,35-39,1894,0.0057055808662794935
SIM,1898,36,na,1934,33
SIM,1818,79,na,1897,8
STAT,1879,21,20-24,1900,0.7154045706233556
STAT,1841,18,15-19,1859,0.07447733519398785
STAT,1899,58,na,1957,27.51201917526217
SIM,1819,43,na,1862,7
STAT,1877,19,40-44,1896,0.0018779118876685174
SIM,1857,82,na,1939,5
SIM,1932,37,na,1969,48
STAT,1844,44,15-19,1888,1.0767993924853467E-4
STAT,1901,16,25-29,1917,0.07948751839406018
STAT,1842,22,45-49,1864,0.006598913022691268
SIM,1834,35,na,1869,21
STAT,1865,30,25-29,1895,0.0933877377752473
STAT,1870,25,25-29,1895,0.42306837857364565
STAT,1930,23,35-39,1953,0.11968897022378885
STAT,1911,25,50-100,1936,0.009709666764346595
STAT,1849,29,15-19,1878,0.004110553971941852
STAT,1862,78,na,1940,6.74106222802148
STAT,1808,68,na,1876,2.8917159442263456
STAT,1893,15,50-100,1908,6.205975584538981E-4
STAT,1926,46,25-29,1972,6.523937049100929E-4
STAT,1884,45,30-34,1929,9.578550275917793E-4
STAT,1876,40,50-100,1916,0.010838076349790938
SIM,1845,75,na,1920,10
SIM,1793,79,na,1872,7
STAT,1863,42,na,1905,20.438467544545027
STAT,1858,40,35-39,1898,0.013918329249850859
SIM,1921,19,na,1940,42
STAT,1930,30,40-44,1960,0.050323576169551104
STAT,1903,34,na,1937,33.922627595209036
SIM,1807,58,na,1865,15
STAT,1853,22,20-24,1875,0.5117283401225794
STAT,1851,38,na,1889,19.89522230779641
STAT,1838,33,35-39,1871,0.09666075203454576
STAT,1909,34,30-34,1943,0.148223281294162
SIM,1843,31,na,1874,22
STAT,1886,41,25-29,1927,0.006691017480281894
STAT,1828,35,50-100,1863,0.00554519708916464
STAT,1909,43,20-24,1952,1.6327147303849053E-4
STAT,1925,18,na,1943,44.06939762851064
STAT,1820,35,30-34,1855,0.05193585883639227
STAT,1835,23,15-19,1858,0.021783189176792568
STAT,1900,19,50-100,1919,6.75718280953477E-4
STAT,1893,55,na,1948,26.071332204116246
STAT,1826,40,15-19,1866,1.5166924720558662E-4
STAT,1844,35,25-29,1879,0.026663374046107465
STAT,1924,33,45-49,1957,0.018227830427420624
STAT,1847,16,35-39,1863,0.007359091991379266
SIM,1908,15,na,1923,41
STAT,1910,15,20-24,1925,0.2682379661987854
STAT,1932,36,15-19,1968,2.5720602652037027E-4
SIM,1861,22,20-24,1883,1
SIM,1856,3,na,1859,27
STAT,1880,36,40-44,1916,0.04625331969432103
SIM,1861,68,na,1929,19
SIM,1865,12,na,1877,25
STAT,1900,32,20-24,1932,0.03748282873417387
SIM,1878,22,25-29,1900,1
STAT,1818,39,30-34,1857,0.06337759075044809
SIM,1870,64,na,1934,16
SIM,1791,69,na,1860,5
STAT,1927,17,50-100,1944,0.0046346071102697905
STAT,1884,59,na,1943,19.04112787791879
STAT,1900,42,na,1942,32.1206356632278
STAT,1904,33,35-39,1937,0.08297042470787373
SIM,1842,83,na,1925,8
STAT,1860,12,na,1872,22.38316987651121
STAT,1843,44,30-34,1887,0.004894209343857554
STAT,1961,10,na,1971,50.46476984948338
STAT,1898,34,45-49,1932,0.023322771849066393
SIM,1829,26,35-39,1855,1
SIM,1845,72,na,1917,14
STAT,1847,86,na,1933,2.3701635006075197
STAT,1918,20,15-19,1938,0.05723178829562723
STAT,1871,53,40-44,1924,1.032754463646102E-4
SIM,1846,20,20-24,1866,1
STAT,1895,33,15-19,1928,0.0018410130764543208
STAT,1857,23,35-39,1880,0.050069574505703325
STAT,1795,68,na,1863,8.730382158437687
STAT,1840,19,45-49,1859,6.549373004959318E-4
STAT,1883,32,50-100,1915,0.008897490726443524
STAT,1907,48,50-100,1955,0.0020010164491164875
STAT,1903,56,na,1959,29.81721200411999
STAT,1946,15,35-39,1961,0.04623745191689869
STAT,1864,23,35-39,1887,0.05279958004486527
STAT,1824,39,na,1863,19.640026611318863
STAT,1839,38,na,1877,13.97876486671672
STAT,1885,26,na,1911,23.648147063954912
STAT,1775,101,na,1876,0.0020315232544522895
STAT,1852,30,15-19,1882,0.0012883959445928437
STAT,1900,45,na,1945,31.5150272201643
STAT,1893,20,35-39,1913,0.07401725670593241
STAT,1841,48,20-24,1889,1.164882526246399E-4
STAT,1918,39,35-39,1957,0.025209634596342484
SIM,1908,37,na,1945,39
STAT,1881,17,40-44,1898,0.0017404020468964928
STAT,1935,24,30-34,1959,0.3893840045306179
SIM,1805,91,na,1896,1
STAT,1854,17,50-100,1871,3.582202458460573E-4
STAT,1845,20,na,1865,15.74119037456841
STAT,1908,17,30-34,1925,0.023520682543868344
STAT,1852,18,50-100,1870,5.041358098192885E-4
STAT,1830,48,45-49,1878,2.3101653611789103E-4
SIM,1843,46,na,1889,19
SIM,1857,60,na,1917,17
STAT,1913,32,30-34,1945,0.15544107643399635
STAT,1802,58,na,1860,8.879596610284135
STAT,1929,22,40-44,1951,0.04231649198072714
SIM,1928,25,50-100,1953,1
STAT,1863,106,na,1969,0.0011941119490055305
STAT,1888,17,35-39,1905,0.006412204251336082
STAT,1859,36,15-19,1895,4.484741315088711E-4
STAT,1839,40,25-29,1879,0.004210914038795992
STAT,1907,30,40-44,1937,0.03671738811869168
STAT,1911,33,35-39,1944,0.08803956251071715
STAT,1857,26,na,1883,18.53503573745115
STAT,1888,18,na,1906,29.43685638697855
STAT,1848,34,na,1882,16.04045693927103
SIM,1891,41,na,1932,34
SIM,1867,78,na,1945,4
STAT,1824,33,40-44,1857,0.06860043938960345
STAT,1904,43,45-49,1947,0.001478442264496446
STAT,1880,54,50-100,1934,1.544461651976614E-4
STAT,1892,31,50-100,1923,0.011365625699475402
STAT,1818,52,50-100,1870,1.4283405483973792E-4
SIM,1892,26,na,1918,36
STAT,1820,45,40-44,1865,0.0014860925291800566
STAT,1928,43,30-34,1971,0.0016192679901708435
SIM,1905,23,40-44,1928,2
STAT,1936,16,50-100,1952,0.003574003813111166
SIM,1832,33,40-44,1865,1
STAT,1920,16,35-39,1936,0.0467922741155115
STAT,1867,41,15-19,1908,1.327525914468025E-4
STAT,1854,42,25-29,1896,0.003920256251533868
SIM,1870,42,na,1912,21
STAT,1868,33,20-24,1901,0.026048334215062398
SIM,1865,49,na,1914,21
STAT,1854,46,40-44,1900,0.0010494053762493062
SIM,1954,15,35-39,1969,1
STAT,1881,30,na,1911,22.889306563626068
SIM,1810,44,na,1854,18
STAT,1912,32,50-100,1944,0.008071949292347242
STAT,1782,80,na,1862,1.8739112276178376
STAT,1946,25,45-49,1971,0.019125386851775845
STAT,1851,25,15-19,1876,0.004549846927829714
SIM,1924,24,20-24,1948,1
STAT,1852,41,50-100,1893,0.009082535787192678
STAT,1880,41,15-19,1921,1.4587476621474293E-4
SIM,1901,42,na,1943,38
STAT,1880,22,15-19,1902,0.034690989266809344
STAT,1898,24,35-39,1922,0.07822787148517232
STAT,1829,37,40-44,1866,0.04022328090975228
SIM,1894,55,na,1949,27
STAT,1869,25,50-100,1894,0.006240295316116101
STAT,1838,20,20-24,1858,0.7040017808679823
STAT,1916,24,20-24,1940,1.1479776006595124
STAT,1801,73,na,1874,4.963175104590461
STAT,1859,74,na,1933,8.820787006848336
STAT,1811,48,35-39,1859,0.005458131278385556
STAT,1896,28,40-44,1924,0.039209305859436897
STAT,1870,15,15-19,1885,0.06022206455490377
SIM,1910,56,na,1966,27
SIM,1888,77,na,1965,16
STAT,1874,63,na,1937,18.101613284021653
STAT,1882,49,20-24,1931,1.126001194554578E-4
STAT,1848,12,na,1860,19.138007456488065
STAT,1893,31,15-19,1924,0.0018029240181102724
STAT,1925,46,50-100,1971,0.0027303726338279185
STAT,1912,30,na,1942,37.22082092761622
STAT,1920,22,20-24,1942,1.2256546896906242
SIM,1886,11,na,1897,30
STAT,1856,48,50-100,1904,0.0017568524866032104
STAT,1903,28,35-39,1931,0.13669913630248934
SIM,1911,28,35-39,1939,1
STAT,1922,29,15-19,1951,0.007873106343306208
STAT,1838,75,na,1913,7.990135324487891
STAT,1889,22,35-39,1911,0.07144563238723431
STAT,1833,35,na,1868,20.237850308681537
STAT,1791,94,na,1885,0.04043055568321272
STAT,1871,34,40-44,1905,0.04286690035262321
STAT,1939,32,na,1971,38.32416269608265
STAT,1861,46,40-44,1907,0.001443803471006872
STAT,1939,25,45-49,1964,0.01726354278974059
STAT,1904,19,na,1923,35.99509984463828
STAT,1925,26,20-24,1951,0.2149859984989138
STAT,1879,34,35-39,1913,0.10391875187265472
STAT,1853,64,na,1917,10.92525605992139
STAT,1874,30,35-39,1904,0.10356403893554526
STAT,1866,17,15-19,1883,0.05610006575320862
SIM,1931,0,na,1931,63
STAT,1837,18,25-29,1855,0.05184042742174944
STAT,1869,11,na,1880,25.88812258899733
STAT,1832,49,50-100,1881,0.0011582733840566756
STAT,1836,49,na,1885,22.148159223376833
SIM,1828,57,na,1885,9
SIM,1890,19,na,1909,30
STAT,1886,23,50-100,1909,0.004216802230795983
STAT,1827,32,20-24,1859,0.02382781214988855
STAT,1900,37,15-19,1937,1.6807235803123241E-4
STAT,1936,0,na,1936,42.87119019370442
SIM,1922,41,na,1963,48
STAT,1816,72,na,1888,4.027211888145808
STAT,1913,45,45-49,1958,0.002113482186864145
STAT,1911,39,40-44,1950,0.014221169296068337
STAT,1893,30,45-49,1923,0.02216419752686801
STAT,1801,95,na,1896,0.04818298106582275
STAT,1924,33,na,1957,43.81019805204067
SIM,1942,18,na,1960,38
SIM,1940,2,na,1942,37
STAT,1919,41,30-34,1960,0.0013754087474718308
STAT,1855,27,40-44,1882,0.02198370544982089
STAT,1926,41,30-34,1967,0.0015693246969559335
SIM,1846,20,na,1866,16
STAT,1891,24,40-44,1915,0.025415805610888593
STAT,1894,23,20-24,1917,0.8804479152188683
STAT,1863,48,40-44,1911,0.0014967546227342785
STAT,1845,40,25-29,1885,0.003921694956043216
STAT,1911,20,20-24,1931,1.0540206933634721
STAT,1941,21,45-49,1962,0.011547251235646329
STAT,1875,19,15-19,1894,0.060676599229563324
STAT,1869,43,15-19,1912,1.3284254892465935E-4
SIM,1928,25,35-39,1953,1
STAT,1896,69,na,1965,21.81903982811555
STAT,1945,2,na,1947,43.85295841461032
STAT,1857,33,45-49,1890,0.012999303533568736
STAT,1876,43,15-19,1919,1.392457482573936E-4
STAT,1850,26,15-19,1876,0.004788190615738709
STAT,1867,34,45-49,1901,0.016544817318808625
SIM,1857,54,na,1911,21
SIM,1917,24,20-24,1941,3
STAT,1862,7,na,1869,24.45734497167511
STAT,1893,42,45-49,1935,0.01884756411122299
STAT,1890,16,45-49,1906,7.954231465037868E-4
STAT,1888,24,35-39,1912,0.06776640333179743
STAT,1872,15,40-44,1887,0.0018998800379292076
STAT,1913,24,40-44,1937,0.033458414092746185
STAT,1894,35,15-19,1929,7.265071237448242E-4
STAT,1840,22,40-44,1862,0.02076504885015842
STAT,1884,31,40-44,1915,0.042662701625991666
STAT,1915,21,40-44,1936,0.034560189587426134
STAT,1873,29,20-24,1902,0.11842033476860872
STAT,1886,11,na,1897,26.82747009257309
STAT,1829,41,15-19,1870,1.2391356618443323E-4
STAT,1862,42,15-19,1904,1.1899963674372295E-4
STAT,1920,38,45-49,1958,0.007393039817435964
SIM,1880,66,na,1946,28
STAT,1897,19,35-39,1916,0.0072475360690649766
SIM,1853,64,na,1917,17
STAT,1915,13,na,1928,40.91361173643885
STAT,1820,77,na,1897,4.900453735272874
STAT,1824,67,na,1891,11.030137468630794
SIM,1949,17,20-24,1966,2
STAT,1911,23,na,1934,35.84789386304746
STAT,1857,15,45-49,1872,5.815856300969146E-4
STAT,1911,27,40-44,1938,0.045162220153139525
SIM,1922,35,na,1957,48
STAT,1819,38,30-34,1857,0.055122593262484545
STAT,1909,24,20-24,1933,1.0212237974476206
STAT,1884,48,35-39,1932,0.0013544178665762738
STAT,1864,95,na,1959,0.20487085134476138
STAT,1845,28,30-34,1873,0.1778828393493281
STAT,1843,49,30-34,1892,4.0204596536749446E-4
SIM,1797,60,na,1857,2
STAT,1847,41,35-39,1888,0.019702480020538298
STAT,1896,32,15-19,1928,0.0018705760589372235
STAT,1866,18,20-24,1884,0.16660296411822928
STAT,1923,28,15-19,1951,0.008020643276076692
STAT,1826,51,45-49,1877,1.4384872284827182E-4
STAT,1950,10,na,1960,46.17172156523276
STAT,1925,43,na,1968,44.61220868453043
SIM,1892,51,na,1943,32
STAT,1855,18,45-49,1873,5.438022822072139E-4
STAT,1878,16,na,1894,26.138841164301304
STAT,1782,100,na,1882,0.0016696897749476484
SIM,1848,18,na,1866,33
STAT,1782,98,na,1880,0.004455305752147756
STAT,1865,37,45-49,1902,0.01803083493030868
SIM,1842,25,20-24,1867,2
STAT,1883,48,50-100,1931,0.0023550087637051902
STAT,1827,44,15-19,1871,1.0507407871095836E-4
STAT,1883,62,na,1945,17.74875829770997
STAT,1813,51,35-39,1864,2.6144711010646333E-4
SIM,1896,41,na,1937,28
SIM,1934,20,na,1954,52
STAT,1922,17,45-49,1939,0.005738913347705236
STAT,1843,47,35-39,1890,5.91102354264575E-4
SIM,1837,43,40-44,1880,1
STAT,1850,75,na,1925,9.165969009472251
STAT,1834,25,20-24,1859,0.11028877090940234
STAT,1872,23,50-100,1895,0.004159497274599762
STAT,1931,38,20-24,1969,0.0034721900715247362
STAT,1898,31,40-44,1929,0.058741420668028684
STAT,1832,28,20-24,1860,0.06967984388544635
STAT,1876,37,20-24,1913,0.007829093971100673
STAT,1896,34,40-44,1930,0.056476626440058283
SIM,1781,85,na,1866,3
STAT,1821,46,45-49,1867,0.0033851431804493588
SIM,1894,29,30-34,1923,1
SIM,1930,30,na,1960,48
STAT,1882,52,40-44,1934,1.0035397918410956E-4
STAT,1879,37,45-49,1916,0.02063278674598184
SIM,1888,46,na,1934,32
STAT,1817,40,40-44,1857,0.07560632303326462
STAT,1863,26,25-29,1889,0.37724438509242275
STAT,1924,33,50-100,1957,0.00957733457223599
SIM,1905,63,na,1968,38
STAT,1807,83,na,1890,1.675417631645619
STAT,1871,31,30-34,1902,0.17478481893401052
STAT,1827,28,50-100,1855,0.009082839599993939
STAT,1886,29,30-34,1915,0.25933649349938315
STAT,1794,83,na,1877,1.5564995647974806
STAT,1853,34,15-19,1887,9.027269155114763E-4
STAT,1847,23,35-39,1870,0.07587009994390476
STAT,1868,47,40-44,1915,0.0016490559639262858
STAT,1826,33,15-19,1859,0.0018831383742338127
SIM,1909,53,na,1962,33
STAT,1849,40,50-100,1889,0.008334803277260723
STAT,1861,29,25-29,1890,0.3531936214049822
SIM,1844,28,na,1872,10
STAT,1929,33,na,1962,47.781159590463915
STAT,1925,25,15-19,1950,0.00834215507562129
STAT,1845,46,30-34,1891,5.674498073633169E-4
STAT,1849,90,na,1939,0.6113228973607713
STAT,1831,49,na,1880,19.08236267092059
STAT,1880,42,35-39,1922,0.01901822493255568
STAT,1882,21,35-39,1903,0.056092799610101794
STAT,1847,25,30-34,1872,0.32802058586741956
SIM,1811,69,na,1880,4
STAT,1845,44,35-39,1889,0.010506307753575703
SIM,1849,59,na,1908,7
STAT,1858,26,15-19,1884,0.0035597916495543076
SIM,1926,25,na,1951,48
STAT,1912,43,35-39,1955,0.0019153627295008884
STAT,1867,52,45-49,1919,1.381387597668417E-4
STAT,1878,34,20-24,1912,0.027667925600354002
SIM,1874,26,na,1900,25
STAT,1841,39,na,1880,24.19241178857006
STAT,1855,31,15-19,1886,0.0010315600075770212
STAT,1829,32,50-100,1861,0.008756685296916197
STAT,1907,18,na,1925,36.84655142551834
SIM,1959,12,na,1971,51
STAT,1918,3,na,1921,43.74832755081964
STAT,1786,88,na,1874,0.19859675101453034
STAT,1801,98,na,1899,0.011772701067615611
SIM,1846,82,na,1928,2
STAT,1827,46,40-44,1873,0.0013074329545724379
STAT,1950,17,20-24,1967,1.593133187926761
SIM,1868,38,na,1906,31
STAT,1830,33,35-39,1863,0.06443202991106643
STAT,1866,62,na,1928,16.833066631008776
STAT,1844,46,40-44,1890,0.001341031390366259
STAT,1880,24,35-39,1904,0.06097902713825232
STAT,1860,18,25-29,1878,0.052819323010614996
STAT,1903,32,30-34,1935,0.24823059506156672
STAT,1876,24,15-19,1900,0.03329664150000847
STAT,1824,36,45-49,1860,0.02965986994993129
STAT,1917,48,40-44,1965,0.0016272929807660372
STAT,1908,31,na,1939,35.659398352580354
SIM,1869,79,na,1948,4
STAT,1862,47,45-49,1909,0.002026632011476904
STAT,1866,90,na,1956,0.8182636975259348
STAT,1923,48,na,1971,42.56064273079757
STAT,1812,42,na,1854,12.89633323503067
STAT,1891,27,45-49,1918,0.013627458562959464
STAT,1860,30,40-44,1890,0.0355397169216887
SIM,1873,13,na,1886,30
STAT,1835,39,25-29,1874,0.015802893507619722
STAT,1897,54,na,1951,27.80757705734023
SIM,1821,33,35-39,1854,1
SIM,1837,46,na,1883,29
STAT,1855,36,45-49,1891,0.014103092012704464
STAT,1813,83,na,1896,2.6199376484416406
STAT,1848,22,40-44,1870,0.01640839348926601
STAT,1919,25,50-100,1944,0.01073375381655603
SIM,1842,21,na,1863,25
SIM,1920,40,na,1960,43
STAT,1935,33,na,1968,52.06017092724463
STAT,1891,27,15-19,1918,0.005568580721807322
SIM,1838,16,na,1854,14
STAT,1829,46,45-49,1875,0.002040757055259349
STAT,1788,83,na,1871,1.5927916709238195
STAT,1894,37,40-44,1931,0.05610172095549927
STAT,1905,32,35-39,1937,0.08392393122368555
STAT,1844,47,25-29,1891,4.47813240629582E-4
STAT,1849,20,35-39,1869,0.05550007502169438
STAT,1837,33,20-24,1870,0.01636350338580033
SIM,1910,10,na,1920,33
STAT,1850,44,45-49,1894,0.01314568882693522
STAT,1848,40,40-44,1888,0.014905224470658219
STAT,1824,36,15-19,1860,8.354893937243712E-4
STAT,1899,42,40-44,1941,0.002135564219797073
STAT,1852,70,na,1922,12.008185481366867
STAT,1933,17,20-24,1950,1.807479551430747
STAT,1928,38,45-49,1966,0.008564720214896463
STAT,1886,47,30-34,1933,9.993927477293955E-4
STAT,1809,49,25-29,1858,0.0019048897496123764
STAT,1926,38,40-44,1964,0.01817221164661965
STAT,1820,43,20-24,1863,0.0013809585329961442
STAT,1845,29,na,1874,15.17144336143613
STAT,1800,57,na,1857,9.423161152333192
SIM,1830,36,na,1866,19
STAT,1867,34,15-19,1901,0.001351117653692368
STAT,1913,27,50-100,1940,0.009834802161116993
STAT,1843,34,na,1877,10.82500914264423
SIM,1871,23,20-24,1894,1
STAT,1839,29,na,1868,14.824187435486454
SIM,1938,22,na,1960,37
SIM,1867,84,na,1951,1
STAT,1878,19,25-29,1897,0.05819055259628708
STAT,1886,45,35-39,1931,0.001466650379444966
STAT,1899,1,na,1900,37.26054554722287
STAT,1913,42,40-44,1955,0.0024187758039285086
STAT,1896,37,45-49,1933,0.0261851654793997
STAT,1939,22,35-39,1961,0.09391354134430846
STAT,1922,7,na,1929,45.92276912085332
STAT,1829,28,45-49,1857,0.011725461619076682
STAT,1907,27,20-24,1934,0.1716019864019947
SIM,1936,7,na,1943,38
STAT,1869,45,35-39,1914,0.0013700418650476687
STAT,1889,46,50-100,1935,0.0030154959668195393
SIM,1789,65,na,1854,12
SIM,1855,4,na,1859,27
STAT,1870,34,20-24,1904,0.02662198189215832
STAT,1853,36,40-44,1889,0.027798945934560337
STAT,1861,17,50-100,1878,4.735462486208393E-4
STAT,1815,45,50-100,1860,0.003642239268629928
STAT,1868,97,na,1965,0.19304648201244357
STAT,1881,23,40-44,1904,0.019767076642555254
STAT,1917,48,na,1965,37.91851210817624
STAT,1885,48,25-29,1933,5.616614259502748E-4
STAT,1918,16,40-44,1934,0.0030342067784377737
STAT,1908,19,50-100,1927,7.190945037533184E-4
STAT,1933,35,50-100,1968,0.005705286929895114
SIM,1890,56,na,1946,24
STAT,1840,20,15-19,1860,0.03335181903292088
STAT,1857,30,40-44,1887,0.03335091086948505
STAT,1861,44,20-24,1905,0.0013175195826456072
STAT,1841,54,45-49,1895,1.381433912718791E-4
STAT,1873,15,30-34,1888,0.016397344918608
STAT,1879,32,15-19,1911,0.001473933664713876
STAT,1937,28,45-49,1965,0.016726303722470845
STAT,1875,26,20-24,1901,0.12100637644769059
STAT,1818,39,25-29,1857,0.03423846837838667
STAT,1896,19,45-49,1915,8.534331528694146E-4
STAT,1824,54,45-49,1878,1.742790115807798E-4
STAT,1880,26,na,1906,25.1816803288469
SIM,1884,56,na,1940,20
STAT,1868,15,20-24,1883,0.17674937068279448
STAT,1918,46,35-39,1964,0.0013629764844919547
STAT,1924,27,20-24,1951,0.2111545797988514
STAT,1923,39,50-100,1962,0.004820821602624102
SIM,1793,70,na,1863,13
STAT,1849,39,25-29,1888,0.02237489635665414
STAT,1801,70,na,1871,6.595552998624715
STAT,1826,62,na,1888,13.088486598659719
STAT,1843,30,40-44,1873,0.022579699205364373
STAT,1847,39,20-24,1886,0.008368052734440357
STAT,1854,33,20-24,1887,0.016744789032972062
STAT,1838,36,45-49,1874,0.0188646680414704
STAT,1891,45,45-49,1936,0.0016502009305864522
SIM,1849,31,na,1880,12
STAT,1830,35,30-34,1865,0.03256435557550741
STAT,1833,75,na,1908,7.6215528242109745
STAT,1855,59,na,1914,13.683344475876993
SIM,1917,20,na,1937,43
STAT,1877,62,na,1939,18.86695677996377
STAT,1878,87,na,1965,3.8029689016217665
STAT,1823,38,20-24,1861,0.0054919460926693255
STAT,1930,24,40-44,1954,0.042604174913838055
STAT,1847,28,35-39,1875,0.12299947194145329
STAT,1846,41,15-19,1887,1.1473420525392683E-4
STAT,1890,29,20-24,1919,0.14148378823547003
STAT,1848,46,50-100,1894,0.0015928040730252464
STAT,1868,18,25-29,1886,0.05550356056811896
STAT,1868,25,50-100,1893,0.006232592060108531
SIM,1818,67,na,1885,14
STAT,1840,25,45-49,1865,0.01100539673571067
STAT,1833,26,15-19,1859,0.004459189417073234
STAT,1897,16,30-34,1913,0.021217859061433426
STAT,1862,41,30-34,1903,0.009963811697763496
STAT,1855,90,na,1945,0.5550926361154438
STAT,1864,26,45-49,1890,0.009992737936882453
STAT,1943,23,50-100,1966,0.00694731594375972
STAT,1837,65,na,1902,8.1713792928358
STAT,1861,26,20-24,1887,0.10009170483040009
SIM,1862,13,na,1875,26
STAT,1885,47,40-44,1932,0.001682743568504357
STAT,1966,2,na,1968,48.83414767880828
STAT,1838,18,45-49,1856,6.657436407553436E-4
STAT,1855,15,40-44,1870,0.001549872010628652
STAT,1873,31,35-39,1904,0.10338189731337112
STAT,1845,60,na,1905,11.148396568096608
STAT,1874,15,45-49,1889,6.682548019724465E-4
STAT,1862,28,30-34,1890,0.216495767277652
SIM,1850,28,na,1878,22
SIM,1853,3,na,1856,29
STAT,1928,27,50-100,1955,0.012202657240592696
SIM,1855,28,35-39,1883,2
STAT,1874,45,45-49,1919,0.0024180688670900246
STAT,1839,47,45-49,1886,0.0013269573673007709
SIM,1826,62,na,1888,13
STAT,1846,26,25-29,1872,0.4177299064066748
SIM,1880,26,na,1906,32
STAT,1874,97,na,1971,0.3380199046647994
STAT,1844,29,25-29,1873,0.3986953674867725
STAT,1871,36,30-34,1907,0.05339165553238599
STAT,1939,33,50-100,1972,0.008372839607844034
STAT,1858,3,na,1861,25.11388413225117
STAT,1851,69,na,1920,12.389454906656221
STAT,1865,19,15-19,1884,0.054663765485306284
STAT,1865,77,na,1942,7.818317554797384
STAT,1934,15,15-19,1949,0.6140939410124256
STAT,1942,25,15-19,1967,0.007361803388566776
STAT,1872,62,na,1934,18.700800428335175
STAT,1807,54,45-49,1861,2.8578314397591405E-4
STAT,1821,43,40-44,1864,0.03390814990195662
STAT,1902,46,na,1948,31.822948579339137
SIM,1852,29,25-29,1881,3
SIM,1884,84,na,1968,7
STAT,1864,25,30-34,1889,0.22827634494511712
STAT,1882,19,20-24,1901,0.16898913767549134
STAT,1826,47,35-39,1873,0.0014094894753179214
STAT,1850,26,45-49,1876,0.011717683996570142
STAT,1922,29,50-100,1951,0.01110059071833985
SIM,1852,82,na,1934,13
SIM,1938,8,na,1946,40
STAT,1868,48,25-29,1916,5.504172718329684E-4
STAT,1842,80,na,1922,4.641197748494435
STAT,1944,22,15-19,1966,0.05705812541230801
SIM,1898,19,20-24,1917,1
SIM,1892,11,na,1903,36
STAT,1891,69,na,1960,19.363563870748937
STAT,1870,19,25-29,1889,0.05616140468529482
STAT,1813,103,na,1916,9.471353228426785E-4
STAT,1881,21,15-19,1902,0.031486420745564375
SIM,1863,54,na,1917,9
SIM,1949,22,na,1971,38
SIM,1855,59,na,1914,11
STAT,1814,77,na,1891,3.851920265952479
STAT,1820,46,25-29,1866,4.934508427614662E-4
SIM,1867,44,na,1911,11
STAT,1834,40,50-100,1874,0.009233926266572785
STAT,1825,49,na,1874,13.546120992117418
STAT,1838,31,15-19,1869,0.001387775161531124
SIM,1804,59,na,1863,11
STAT,1867,16,15-19,1883,0.058401743295880014
STAT,1888,29,35-39,1917,0.11195129121181702
STAT,1871,32,15-19,1903,0.001419805016249867
STAT,1838,35,30-34,1873,0.05096103302253228
STAT,1874,27,15-19,1901,0.0046027732849474754
STAT,1844,31,50-100,1875,0.008647605653139642
SIM,1914,40,na,1954,36
STAT,1908,25,15-19,1933,0.006740697415394919
STAT,1895,19,30-34,1914,0.02058152384763006
STAT,1919,45,40-44,1964,0.001703220468788496
STAT,1893,38,35-39,1931,0.08873852833601961
STAT,1839,29,15-19,1868,0.0031090756372636834
STAT,1858,95,na,1953,0.10117169246877686
SIM,1909,25,na,1934,40
STAT,1872,18,45-49,1890,6.666093028718967E-4
STAT,1867,16,na,1883,24.854417206163422
STAT,1872,16,25-29,1888,0.05851565305766692
STAT,1834,28,25-29,1862,0.38917601077732134
STAT,1828,28,30-34,1856,0.3795251835148995
STAT,1796,78,na,1874,0.6202734369316343
STAT,1866,20,35-39,1886,0.05496903943040224
STAT,1793,98,na,1891,0.0032536678001739245
STAT,1911,51,na,1962,34.1154516737277
STAT,1914,22,35-39,1936,0.09540051289574049
STAT,1826,51,50-100,1877,1.4970019607420823E-4
STAT,1821,40,30-34,1861,0.019209389137533665
STAT,1906,36,na,1942,34.66413456482093
STAT,1836,38,30-34,1874,0.06248137349723711
SIM,1861,28,na,1889,27
STAT,1916,17,15-19,1933,0.09546434393750802
STAT,1862,44,40-44,1906,0.019144012419131228
STAT,1903,35,35-39,1938,0.021910707218264398
STAT,1854,36,25-29,1890,0.017683364784775345
STAT,1828,38,50-100,1866,0.005459051470521338
STAT,1870,36,40-44,1906,0.04369491176803734
STAT,1898,29,20-24,1927,0.15712628429492825
SIM,1902,15,na,1917,37
STAT,1889,59,na,1948,23.794447670137746
SIM,1900,16,20-24,1916,1
STAT,1831,47,45-49,1878,0.0022594412882920964
STAT,1860,15,20-24,1875,0.16820149926345235
SIM,1939,4,na,1943,31
STAT,1832,30,35-39,1862,0.06042503939055431
STAT,1880,21,30-34,1901,0.18787110652778502
STAT,1887,40,25-29,1927,0.00707991901654927
STAT,1800,85,na,1885,0.822940878663158
STAT,1864,21,15-19,1885,0.03028295996435306
SIM,1843,34,na,1877,20
STAT,1827,49,45-49,1876,0.0017339422292282297
SIM,1832,31,na,1863,25
STAT,1854,18,30-34,1872,0.011585458379164776
STAT,1887,27,25-29,1914,0.4617232826421567
STAT,1826,93,na,1919,0.20423198713631527
STAT,1829,43,40-44,1872,0.019644202797996866
STAT,1875,40,50-100,1915,0.010969292863897476
SIM,1791,75,na,1866,3
STAT,1809,46,20-24,1855,4.158180247875328E-4
STAT,1893,24,15-19,1917,0.041336244805647175
STAT,1909,22,25-29,1931,0.8536748047818936
SIM,1852,7,na,1859,29
STAT,1818,67,na,1885,4.2662493500822
STAT,1842,48,50-100,1890,0.0018195316943099545
STAT,1913,58,na,1971,33.731214277435406
STAT,1862,27,50-100,1889,0.0055393854423991815
STAT,1852,41,45-49,1893,0.01286692573539479
STAT,1835,39,na,1874,11.663813942260424
STAT,1884,56,na,1940,19.983354024611078
SIM,1895,27,25-29,1922,1
STAT,1927,21,30-34,1948,0.35336306472635426
STAT,1852,23,45-49,1875,0.007038817430027411
STAT,1896,16,40-44,1912,0.00240839808607772
SIM,1865,18,na,1883,25
STAT,1896,41,na,1937,30.601653978383986
STAT,1913,18,na,1931,39.05634961387662
STAT,1947,22,50-100,1969,0.00738576155797333
SIM,1820,46,na,1866,14
STAT,1918,32,15-19,1950,0.0013531797378813994
STAT,1853,39,45-49,1892,0.012402593765745562
STAT,1882,38,50-100,1920,0.011707637068905574
STAT,1906,31,40-44,1937,0.03632503104101859
STAT,1860,33,45-49,1893,0.014116972423926464
STAT,1929,15,35-39,1944,0.053543106621156696
STAT,1881,26,45-49,1907,0.010601272839760003
STAT,1963,5,na,1968,49.643996655753384
SIM,1865,28,20-24,1893,1
STAT,1848,43,45-49,1891,0.0096088511873063
STAT,1802,52,na,1854,9.99909654304067
SIM,1896,2,na,1898,33
SIM,1874,32,35-39,1906,1
STAT,1819,39,45-49,1858,0.019610096280776774
STAT,1828,46,25-29,1874,2.499071757471309E-4
STAT,1829,25,40-44,1854,0.07525127946978348
SIM,1856,13,na,1869,21
STAT,1895,59,na,1954,25.231124984095644
STAT,1776,86,na,1862,0.46489994361811476
STAT,1853,28,50-100,1881,0.004207796099255419
STAT,1830,31,15-19,1861,9.699252018340447E-4
SIM,1785,75,na,1860,5
STAT,1863,41,20-24,1904,0.0014124891830562915
STAT,1847,24,na,1871,27.599310934252756
STAT,1873,18,35-39,1891,0.005564069221242604
STAT,1888,42,35-39,1930,0.02113508138646488
STAT,1911,45,40-44,1956,0.001489954278155234
SIM,1883,29,25-29,1912,1
STAT,1929,33,35-39,1962,0.11545105052791776
SIM,1905,35,na,1940,40
STAT,1875,29,25-29,1904,0.4317263013085814
SIM,1850,6,na,1856,23
STAT,1887,23,50-100,1910,0.004437310086767307
STAT,1861,47,25-29,1908,4.821321229529466E-4
STAT,1891,37,50-100,1928,0.015068870205323857
STAT,1833,49,50-100,1882,0.0018892150404757446
STAT,1870,54,40-44,1924,1.017045742287602E-4
SIM,1848,46,na,1894,30
STAT,1897,35,50-100,1932,0.01645871617588889
STAT,1876,21,na,1897,24.09303571542057
STAT,1918,43,30-34,1961,0.0013448482782364812
SIM,1854,26,25-29,1880,1
SIM,1927,19,na,1946,51
STAT,1822,40,20-24,1862,9.354564239556009E-4
STAT,1853,103,na,1956,0.0010948430501184008
STAT,1942,2,na,1944,42.121907041896584
STAT,1838,34,50-100,1872,0.008655034718607681
STAT,1857,28,20-24,1885,0.08980913971914103
STAT,1883,20,40-44,1903,0.02035621776949379
SIM,1851,69,na,1920,14
STAT,1878,21,50-100,1899,0.004222810419915434
STAT,1849,36,20-24,1885,0.006179988363708402
STAT,1942,15,na,1957,38.20542977541069
STAT,1943,22,25-29,1965,0.9755860537079064
STAT,1866,104,na,1970,0.0063669889854593925
STAT,1871,77,na,1948,8.61799278222942
STAT,1864,39,20-24,1903,0.006844334533614576
STAT,1826,33,45-49,1859,0.02305956132139366
STAT,1852,23,15-19,1875,0.03330060153396357
STAT,1829,39,na,1868,18.233576503630825
STAT,1879,36,30-34,1915,0.05542715908403378
STAT,1879,19,45-49,1898,6.724687021343673E-4
STAT,1867,48,35-39,1915,0.0013229108499716986
STAT,1932,21,40-44,1953,0.04407113192259857
STAT,1926,24,20-24,1950,1.3347527218405457
STAT,1848,25,45-49,1873,0.0086963860016947
STAT,1872,48,45-49,1920,0.0023843411227240136
SIM,1859,18,na,1877,22
STAT,1841,51,40-44,1892,1.0353923324300094E-4
STAT,1921,30,25-29,1951,0.10287432390994522
STAT,1893,24,45-49,1917,0.008737328066975563
STAT,1921,49,45-49,1970,0.002416735274873432
STAT,1918,19,45-49,1937,0.005359105221754931
STAT,1831,29,15-19,1860,0.00484493085764148
STAT,1835,36,20-24,1871,0.004370010090369155
STAT,1849,18,20-24,1867,0.1682124540483953
STAT,1855,33,40-44,1888,0.03076826076877475
SIM,1779,75,na,1854,7
SIM,1832,62,na,1894,18
SIM,1911,35,na,1946,40
STAT,1913,39,15-19,1952,1.860337174947318E-4
STAT,1935,28,40-44,1963,0.06322411857967049
STAT,1811,57,na,1868,14.325711384468566
STAT,1864,23,40-44,1887,0.018854358209562144
STAT,1842,24,50-100,1866,0.0038037971165666247
STAT,1889,38,45-49,1927,0.024285831521198353
STAT,1844,26,20-24,1870,0.11298646583986977
STAT,1845,29,45-49,1874,0.007786775267992649
STAT,1840,38,20-24,1878,0.007070402551769239
SIM,1879,38,na,1917,15
STAT,1916,38,na,1954,38.00829710927038
STAT,1947,17,15-19,1964,0.507733342738769
STAT,1837,62,na,1899,8.837524059500806
SIM,1871,58,na,1929,20
SIM,1883,43,na,1926,12
STAT,1895,28,na,1923,30.874102077100964
SIM,1798,73,na,1871,4
STAT,1796,100,na,1896,4.614441591534689E-4
STAT,1874,57,na,1931,20.387533823687367
SIM,1954,12,na,1966,50
STAT,1846,14,na,1860,24.08336655772449
STAT,1872,31,15-19,1903,0.0014630274089608944
STAT,1943,24,20-24,1967,1.1736158875291827
STAT,1857,45,45-49,1902,0.0017843283560967913
STAT,1848,19,15-19,1867,0.04701731778073205
STAT,1917,16,20-24,1933,0.28980551237189645
STAT,1856,32,na,1888,17.49888636837425
STAT,1864,28,35-39,1892,0.08623881423011918
SIM,1893,61,na,1954,29
SIM,1923,18,15-19,1941,2
STAT,1855,16,25-29,1871,0.047735525952778184
STAT,1932,24,45-49,1956,0.014652919220243296
STAT,1825,38,25-29,1863,0.029523513605920114
STAT,1862,44,35-39,1906,0.01541217883514445
STAT,1951,20,na,1971,43.395184991599976
STAT,1829,30,na,1859,19.785041335872172
STAT,1869,42,30-34,1911,0.011125896794884895
STAT,1934,24,50-100,1958,0.008799234041627975
STAT,1923,18,50-100,1941,0.004357435362927848
STAT,1928,23,na,1951,45.23141901380566
STAT,1847,55,na,1902,22.088081471329172
STAT,1821,45,30-34,1866,0.0014093752756219212
STAT,1895,37,25-29,1932,0.03737932798163731
STAT,1891,38,na,1929,28.772985448872024
SIM,1847,92,na,1939,1
STAT,1876,38,35-39,1914,0.07147952067574197
STAT,1850,44,na,1894,20.300696952165005
STAT,1883,17,15-19,1900,0.057629322521309714
STAT,1905,51,na,1956,31.404311235373637
STAT,1917,34,20-24,1951,0.02509302313844261
SIM,1836,52,na,1888,4
STAT,1892,29,25-29,1921,0.5188599028524188
SIM,1942,27,na,1969,37
SIM,1853,33,na,1886,24
SIM,1909,31,30-34,1940,2
STAT,1857,30,35-39,1887,0.07788078282839338
STAT,1849,36,15-19,1885,4.501978844618058E-4
SIM,1923,20,na,1943,42
STAT,1865,80,na,1945,5.5951251490216745
STAT,1909,38,40-44,1947,0.014020116216302758
STAT,1884,87,na,1971,4.423913233822079
STAT,1915,18,15-19,1933,0.09391784928367271
SIM,1889,31,na,1920,29
SIM,1920,22,30-34,1942,1
SIM,1860,18,na,1878,28
STAT,1930,39,45-49,1969,0.008831674386294118
STAT,1869,17,30-34,1886,0.015657517321376227
STAT,1825,31,35-39,1856,0.12815322486527206
STAT,1870,16,20-24,1886,0.17884425491234784
STAT,1833,26,45-49,1859,0.010912550619510521
STAT,1892,40,35-39,1932,0.022596662643847257
STAT,1939,20,45-49,1959,0.01123012120043227
SIM,1856,44,na,1900,11
STAT,1884,34,15-19,1918,0.0013832964557261786
STAT,1851,28,25-29,1879,0.4151376115734762
STAT,1852,101,na,1953,0.004883671802966201
SIM,1927,10,na,1937,52
STAT,1817,43,15-19,1860,4.232217842661081E-4
STAT,1871,19,45-49,1890,6.47773003235363E-4
STAT,1919,41,25-29,1960,7.682463305599739E-4
STAT,1922,44,35-39,1966,0.002286721158290311
SIM,1894,1,na,1895,32
STAT,1853,38,30-34,1891,0.033329257999621165
STAT,1839,32,40-44,1871,0.029451626059780748
STAT,1859,26,50-100,1885,0.00520954917460593
STAT,1873,16,na,1889,25.82978865229125
STAT,1903,21,15-19,1924,0.0470449243901956
STAT,1888,33,50-100,1921,0.010662043005719981
STAT,1821,43,35-39,1864,0.027298272630433097
STAT,1889,26,45-49,1915,0.013640443417997635
STAT,1857,54,na,1911,15.67553038448646
STAT,1869,47,25-29,1916,5.555083033941407E-4
STAT,1886,42,na,1928,23.944195874125196
STAT,1892,22,35-39,1914,0.07209196685539804
STAT,1889,44,45-49,1933,0.01807650271119569
STAT,1922,32,35-39,1954,0.10249621260362562
STAT,1890,43,35-39,1933,0.021837113196275824
STAT,1886,44,20-24,1930,0.0016250784318214404
STAT,1901,61,na,1962,27.715063501847343
SIM,1857,40,50-100,1897,1
SIM,1852,51,na,1903,20
STAT,1888,36,50-100,1924,0.01441643249140064
STAT,1910,10,na,1920,39.01115327728044
STAT,1864,34,50-100,1898,0.00814765665664026
STAT,1806,70,na,1876,9.362157646898467
STAT,1868,45,20-24,1913,1.1728720145952067E-4
STAT,1862,46,30-34,1908,8.375273268435669E-4
STAT,1834,29,na,1863,19.75934046694069
SIM,1805,60,na,1865,12
STAT,1912,22,30-34,1934,0.2732894843549648
STAT,1839,47,50-100,1886,0.0013809352918382686
STAT,1838,38,35-39,1876,0.0655564565364669
STAT,1869,29,30-34,1898,0.24225395377682077
STAT,1841,50,50-100,1891,1.4995230433383894E-4
SIM,1873,44,na,1917,27
STAT,1848,37,15-19,1885,3.742346771721074E-4
STAT,1877,39,30-34,1916,0.05446145289278351
STAT,1893,44,50-100,1937,9.12521337995871E-4
STAT,1833,22,50-100,1855,0.004058468125378846
STAT,1825,41,50-100,1866,0.01046389977942622
STAT,1839,44,50-100,1883,0.0059892169926196595
STAT,1822,42,40-44,1864,0.012853291283763585
STAT,1823,45,na,1868,15.37501495598463
STAT,1894,39,30-34,1933,0.0676159928463348
STAT,1826,30,40-44,1856,0.08142921102185964
STAT,1870,39,45-49,1909,0.0196037602472671
STAT,1849,50,na,1899,16.9353959421186
SIM,1889,31,35-39,1920,2
SIM,1921,25,na,1946,40
SIM,1811,60,na,1871,6
STAT,1827,48,30-34,1875,7.204356238860218E-4
STAT,1906,34,45-49,1940,0.014422538674503643
SIM,1874,6,na,1880,31
STAT,1795,101,na,1896,0.0013968272585219196
STAT,1835,37,35-39,1872,0.0396661727975512
STAT,1860,6,na,1866,23.391327365088877
SIM,1861,59,na,1920,20
SIM,1860,74,na,1934,10
STAT,1833,44,45-49,1877,0.013086770260150789
STAT,1831,44,40-44,1875,0.02171359591918417
STAT,1888,46,na,1934,26.366241747533593
SIM,1820,74,na,1894,3
STAT,1912,40,30-34,1952,0.0012372533327391498
SIM,1868,94,na,1962,1
STAT,1868,43,25-29,1911,0.006169552770687849
STAT,1939,6,na,1945,39.757968132639036
STAT,1898,28,15-19,1926,0.006098907198353303
STAT,1916,17,20-24,1933,0.2851846220268599
STAT,1797,88,na,1885,0.41662291016844455
SIM,1855,28,na,1883,17
STAT,1833,32,45-49,1865,0.0166221283169308
STAT,1879,39,35-39,1918,0.07246866423219979
STAT,1859,37,20-24,1896,0.006126837138534556
STAT,1873,33,50-100,1906,0.009276089948603383
STAT,1841,18,20-24,1859,0.22248925421588778
STAT,1893,21,40-44,1914,0.026353598175904987
SIM,1830,67,na,1897,5
STAT,1862,24,15-19,1886,0.02872015781791704
SIM,1873,7,na,1880,31
SIM,1858,76,na,1934,10
STAT,1866,31,na,1897,22.067298485769317
STAT,1831,30,15-19,1861,0.001535314636404298
STAT,1931,38,15-19,1969,2.529410304118623E-4
SIM,1895,31,na,1926,27
STAT,1900,11,na,1911,35.86462716974654
STAT,1915,49,20-24,1964,1.0974916326966197E-4
STAT,1852,37,35-39,1889,0.060861929564623427
STAT,1824,44,50-100,1868,0.013847621292226702
STAT,1866,36,20-24,1902,0.007133545738086153
STAT,1805,54,40-44,1859,1.9570725843357954E-4
STAT,1839,69,na,1908,8.09872875630091
SIM,1837,77,na,1914,13
STAT,1808,77,na,1885,1.382362066456064
STAT,1813,52,na,1865,18.8397310763255
STAT,1878,54,40-44,1932,1.0570041721070687E-4
STAT,1927,36,35-39,1963,0.0299459998295969
SIM,1915,25,na,1940,38
STAT,1851,21,35-39,1872,0.05925739934145034
STAT,1918,15,50-100,1933,8.145093913466815E-4
STAT,1880,26,25-29,1906,0.44634841179590523
STAT,1904,46,40-44,1950,0.001387686429398099
SIM,1867,13,na,1880,18
STAT,1856,29,20-24,1885,0.08680543811517161
STAT,1872,45,40-44,1917,0.0017691307601476014
STAT,1911,48,45-49,1959,0.002038604242001082
STAT,1852,20,40-44,1872,0.02149378615194458
STAT,1897,23,na,1920,31.30974361836341
STAT,1874,33,45-49,1907,0.01761627060455166
SIM,1842,52,na,1894,20
STAT,1845,43,20-24,1888,9.333112994166715E-4
STAT,1889,38,15-19,1927,6.841080115317649E-4
STAT,1883,17,45-49,1900,6.343347370355368E-4
STAT,1879,6,na,1885,27.847812206326694
SIM,1848,42,35-39,1890,1
STAT,1930,42,40-44,1972,0.0032756100628500047
SIM,1904,10,na,1914,33
STAT,1813,53,25-29,1866,1.0336159898682145E-4
STAT,1888,22,15-19,1910,0.03855232989046722
STAT,1946,18,45-49,1964,0.005499780071524719
SIM,1824,67,na,1891,13
STAT,1852,39,30-34,1891,0.04515402058271998
STAT,1874,30,50-100,1904,0.009369948811568933
STAT,1880,44,25-29,1924,0.0066614744389842185
STAT,1852,104,na,1956,6.995615980779294E-4
STAT,1930,36,40-44,1966,0.019452573642827
STAT,1904,34,40-44,1938,0.035375536969411654
SIM,1877,46,na,1923,27
STAT,1842,16,15-19,1858,0.05751559794426683
SIM,1808,49,na,1857,15
STAT,1833,25,50-100,1858,0.006332648404746592
STAT,1923,17,na,1940,42.92153661196164
STAT,1951,19,30-34,1970,0.1441691745081804
STAT,1865,22,40-44,1887,0.01907689798517437
SIM,1849,28,na,1877,12
SIM,1838,20,30-34,1858,1
STAT,1899,49,na,1948,30.161377670291216
STAT,1906,16,45-49,1922,9.513464899128092E-4
STAT,1887,42,15-19,1929,1.5054977900390423E-4
STAT,1883,35,45-49,1918,0.019542228759280317
STAT,1861,27,35-39,1888,0.08173271914891393
SIM,1915,4,na,1919,40
SIM,1807,64,na,1871,15
STAT,1801,67,na,1868,7.376176302903193
STAT,1879,34,50-100,1913,0.009402041438485359
STAT,1886,82,na,1968,8.311275006040523
STAT,1902,18,na,1920,35.52244716155792
STAT,1915,24,45-49,1939,0.011458158861900672
STAT,1929,19,20-24,1948,1.7127173911657279
SIM,1848,30,35-39,1878,1
STAT,1846,70,na,1916,11.370907775079877
SIM,1883,46,na,1929,10
SIM,1924,17,20-24,1941,3
STAT,1874,27,45-49,1901,0.0112639297783154
STAT,1921,2,na,1923,46.25526400214012
STAT,1898,31,35-39,1929,0.13717250014493165
SIM,1875,79,na,1954,2
STAT,1917,19,25-29,1936,0.4581118535936832
STAT,1937,16,45-49,1953,0.0048409007074681045
STAT,1858,44,15-19,1902,1.0366671203388622E-4
STAT,1845,69,na,1914,8.57850777163566
STAT,1816,44,45-49,1860,0.01948228817105107
STAT,1890,18,35-39,1908,0.0066477230702312266
SIM,1890,25,na,1915,26
STAT,1921,34,40-44,1955,0.04283969797485487
SIM,1962,7,na,1969,48
STAT,1868,49,30-34,1917,9.172182556025219E-4
STAT,1844,44,na,1888,18.021522655374504
SIM,1868,69,na,1937,27
STAT,1859,80,na,1939,4.916707786030245
STAT,1816,63,na,1879,6.319543838490982
STAT,1889,30,50-100,1919,0.011308055716167576
SIM,1936,27,na,1963,37
STAT,1897,32,35-39,1929,0.13448291961619024
STAT,1884,34,45-49,1918,0.016938855839238404
STAT,1930,39,15-19,1969,2.487795897632729E-4
STAT,1857,19,50-100,1876,4.2600304241715366E-4
STAT,1828,29,45-49,1857,0.01611078871294266
STAT,1940,28,15-19,1968,0.007144261735344854
STAT,1934,23,na,1957,48.851801837825754
STAT,1879,16,40-44,1895,0.0018977143432057325
STAT,1882,24,na,1906,22.52340752131517
STAT,1843,15,15-19,1858,0.03255296315667971
STAT,1889,41,40-44,1930,0.027663202780820555
SIM,1813,64,na,1877,4
STAT,1922,48,20-24,1970,1.2567633919809493E-4
SIM,1787,70,na,1857,1
STAT,1873,72,na,1945,12.839759328971281
SIM,1850,59,na,1909,18
STAT,1825,35,20-24,1860,0.008355383244257584
STAT,1926,26,40-44,1952,0.05574632439374401
STAT,1860,77,na,1937,7.0272722476536265
STAT,1877,35,15-19,1912,5.851667901412049E-4
SIM,1894,46,na,1940,29
STAT,1862,40,25-29,1902,0.00559620742533598
STAT,1866,32,35-39,1898,0.0932684098150672
STAT,1902,36,35-39,1938,0.021631920584607743
STAT,1949,22,na,1971,42.33954731465766
STAT,1863,43,40-44,1906,0.01977117282175857
SIM,1948,12,na,1960,39
STAT,1902,47,50-100,1949,0.0019445483641610138
STAT,1904,10,na,1914,37.11654001174113
STAT,1892,26,20-24,1918,0.14542861191886344
STAT,1792,88,na,1880,0.9527155232611886
STAT,1907,21,na,1928,34.69922998324508
STAT,1913,42,35-39,1955,0.0019472723082342314
STAT,1902,23,20-24,1925,0.9687919425859941
STAT,1902,18,35-39,1920,0.007717549981951333
STAT,1869,44,20-24,1913,0.0015180342341873912
STAT,1817,43,45-49,1860,0.04586665764963774
STAT,1920,21,15-19,1941,0.05885248979555095
STAT,1890,40,30-34,1930,0.014105965759569093
STAT,1861,32,20-24,1893,0.022731521736862832
STAT,1833,44,na,1877,18.38117055644426
STAT,1847,95,na,1942,0.14202786063651243
STAT,1894,33,25-29,1927,0.13071443363397092
SIM,1862,44,na,1906,23
STAT,1892,79,na,1971,13.304100984938954
STAT,1920,35,40-44,1955,0.01627895976481003
STAT,1827,42,25-29,1869,0.0050226123875293455
STAT,1900,38,20-24,1938,0.0022957312192921644
STAT,1828,29,na,1857,19.11337007139051
SIM,1897,7,na,1904,43
STAT,1840,29,na,1869,20.833250293453208
STAT,1950,19,na,1969,43.22324361374751
STAT,1895,34,20-24,1929,0.034792152708451346
STAT,1851,25,20-24,1876,0.11764604104773768
STAT,1845,41,30-34,1886,0.006931720415139857
STAT,1903,20,30-34,1923,0.2547541318400121
STAT,1889,23,40-44,1912,0.02543389784958138
STAT,1921,13,na,1934,44.74294898283675
STAT,1885,45,20-24,1930,1.1968319343994424E-4
STAT,1912,25,35-39,1937,0.14779098277520425
STAT,1892,47,50-100,1939,0.0017035403899589875
STAT,1868,57,na,1925,19.448109603730586
STAT,1834,85,na,1919,1.9372955862448258
SIM,1916,35,na,1951,44
STAT,1858,44,45-49,1902,0.011234879127895139
SIM,1930,39,na,1969,49
STAT,1886,47,25-29,1933,5.946799763885308E-4
STAT,1828,43,20-24,1871,6.924782844732543E-4
STAT,1832,59,na,1891,8.784629407420173
SIM,1877,43,na,1920,27
SIM,1888,36,45-49,1924,2
SIM,1849,62,na,1911,3
SIM,1920,25,35-39,1945,1
SIM,1813,67,na,1880,3
STAT,1855,3,na,1858,23.65986747166948
STAT,1882,21,na,1903,22.733724726274705
STAT,1925,29,30-34,1954,0.45660846941518374
STAT,1893,36,15-19,1929,7.114479913434748E-4
STAT,1914,38,15-19,1952,1.8920154058792136E-4
STAT,1867,15,50-100,1882,4.849842247608776E-4
STAT,1817,100,na,1917,0.008413942717810466
STAT,1778,81,na,1859,2.2157157392810536
SIM,1858,35,20-24,1893,1
STAT,1858,41,40-44,1899,0.017193189661652977
STAT,1836,34,15-19,1870,0.0017014980477235624
STAT,1855,28,na,1883,17.3883548068363
SIM,1921,50,na,1971,40
STAT,1826,49,30-34,1875,9.488638663255162E-4
STAT,1850,47,na,1897,19.938403356780142
STAT,1932,17,50-100,1949,0.004940918494212415
STAT,1871,34,35-39,1905,0.10010244607572767
STAT,1939,23,na,1962,36.410696078421125
STAT,1887,24,na,1911,25.653084139722935
STAT,1847,21,15-19,1868,0.043514952148112206
STAT,1884,16,15-19,1900,0.05828667925071644
STAT,1807,52,na,1859,13.8719631775972
STAT,1879,34,40-44,1913,0.044501158122790506
STAT,1854,19,45-49,1873,4.7201711835010893E-4
SIM,1854,18,na,1872,19
STAT,1856,31,35-39,1887,0.0750371954352885
SIM,1848,77,na,1925,10
STAT,1841,70,na,1911,13.733498637055721
SIM,1847,44,50-100,1891,1
STAT,1929,21,35-39,1950,0.11886050464436702
STAT,1930,20,25-29,1950,1.184806249172883
STAT,1909,24,15-19,1933,0.048888694276851274
STAT,1876,25,20-24,1901,0.11995833922317678
SIM,1828,26,na,1854,18
STAT,1917,47,35-39,1964,0.0013344399875147455
STAT,1943,1,na,1944,43.583025145777
STAT,1866,39,25-29,1905,0.02624999432775057
SIM,1928,20,na,1948,49
SIM,1865,80,na,1945,2
STAT,1812,53,40-44,1865,1.1189664049512725E-4
STAT,1893,64,na,1957,22.420592124285697
SIM,1961,5,na,1966,53
STAT,1920,17,40-44,1937,0.015559211915502644
SIM,1912,7,na,1919,40
STAT,1927,33,30-34,1960,0.19269781195225336
STAT,1944,19,na,1963,39.29701929595547
STAT,1935,32,15-19,1967,0.0017699699425182277
SIM,1846,11,na,1857,18
SIM,1956,2,na,1958,47
STAT,1865,25,45-49,1890,0.01011068316914699
STAT,1927,38,na,1965,46.48960848735185
STAT,1880,23,20-24,1903,0.7224122892531032
STAT,1893,24,na,1917,29.633681754182184
STAT,1904,49,45-49,1953,0.0018676889478093529
STAT,1816,41,40-44,1857,0.03170636541226359
STAT,1894,49,na,1943,28.236998642350592
SIM,1882,21,na,1903,33
STAT,1848,37,45-49,1885,0.013285329459659236
STAT,1879,20,15-19,1899,0.03434895846373235
STAT,1840,85,na,1925,2.148093359379099
STAT,1883,32,40-44,1915,0.042113050054511506
SIM,1798,70,na,1868,7
STAT,1870,37,25-29,1907,0.028601616031263096
STAT,1868,49,50-100,1917,0.002327157055723695
STAT,1810,78,na,1888,2.687626874537171
STAT,1899,45,45-49,1944,0.0018405427549758873
STAT,1944,21,30-34,1965,0.3081732589349203
STAT,1938,23,35-39,1961,0.09254461558186662
SIM,1859,58,na,1917,17
SIM,1937,0,na,1937,44
STAT,1885,27,20-24,1912,0.11584981877679276
STAT,1966,5,na,1971,48.79167393360275
SIM,1896,26,30-34,1922,1
STAT,1916,35,na,1951,38.560526725069934
STAT,1900,51,na,1951,30.00126795732068
STAT,1937,29,50-100,1966,0.009631813264209546
SIM,1819,52,na,1871,5
STAT,1921,37,45-49,1958,0.007552570832264094
SIM,1845,18,30-34,1863,1
SIM,1891,32,40-44,1923,1
STAT,1830,30,30-34,1860,0.12330059939220767
STAT,1926,22,25-29,1948,1.115764019695959
STAT,1823,34,50-100,1857,0.007293272870059489
STAT,1858,98,na,1956,0.028963741540546376
STAT,1911,54,na,1965,33.653914452086056
STAT,1915,34,50-100,1949,0.008276380761313063
STAT,1835,70,na,1905,6.310927487666983
STAT,1911,15,40-44,1926,0.00279384116308864
STAT,1821,41,15-19,1862,2.2279671844880944E-4
STAT,1809,47,35-39,1856,0.004776283988687595
STAT,1874,30,40-44,1904,0.04434925929588916
STAT,1856,69,na,1925,10.63137368908932
SIM,1828,66,na,1894,7
STAT,1888,26,30-34,1914,0.2952850598426596
STAT,1839,35,45-49,1874,0.013422421846592142
SIM,1783,71,na,1854,4
STAT,1843,33,15-19,1876,7.187233084268654E-4
STAT,1886,29,50-100,1915,0.006587889820974468
STAT,1837,18,30-34,1855,0.014581053959253971
STAT,1910,18,30-34,1928,0.023941301966760118
STAT,1841,20,35-39,1861,0.07340818116207967
STAT,1798,73,na,1871,9.097538352843983
STAT,1880,41,20-24,1921,0.001677559720863086
STAT,1946,15,40-44,1961,0.015412484864664051
STAT,1822,39,15-19,1861,3.291719347381576E-4
SIM,1843,24,20-24,1867,2
STAT,1905,17,45-49,1922,9.427614051939081E-4
STAT,1853,32,25-29,1885,0.06629069677200392
STAT,1904,30,25-29,1934,0.1479450438043842
STAT,1814,48,20-24,1862,3.3843038079684476E-4
STAT,1896,17,25-29,1913,0.07443451801488206
STAT,1933,38,na,1971,50.98351185814375
STAT,1818,36,20-24,1854,0.011390910339506666
STAT,1947,17,45-49,1964,0.005588698293846463
STAT,1864,36,na,1900,21.23300443716499
STAT,1845,46,25-29,1891,3.3765608046604006E-4
STAT,1899,27,15-19,1926,0.006210886633895226
SIM,1859,80,na,1939,3
STAT,1869,46,50-100,1915,0.002386476543785026
STAT,1830,44,50-100,1874,0.0010664826127281801
STAT,1882,2,na,1884,30.382640383528216
STAT,1838,33,40-44,1871,0.04139306268639923
STAT,1862,32,na,1894,20.588247731377503
STAT,1875,40,35-39,1915,0.018801941586765424
STAT,1888,49,na,1937,25.747432827624674
STAT,1852,35,15-19,1887,4.933454328566693E-4
SIM,1923,21,40-44,1944,1
STAT,1858,16,50-100,1874,4.380613960398144E-4
STAT,1804,78,na,1882,3.7057166202248224
STAT,1843,33,45-49,1876,0.008800969929003453
STAT,1918,31,30-34,1949,0.16658292706661956
SIM,1935,33,30-34,1968,2
STAT,1853,95,na,1948,0.083559960821376
STAT,1835,24,20-24,1859,0.4312393327915068
STAT,1829,26,25-29,1855,0.6574004907115066
STAT,1886,42,30-34,1928,0.01191043950712828
STAT,1874,94,na,1968,0.8074678901621989
STAT,1844,49,45-49,1893,0.0018048958708480282
SIM,1846,51,na,1897,13
STAT,1887,15,25-29,1902,0.062140156607516615
STAT,1844,44,20-24,1888,0.0012383192344754509
STAT,1881,39,20-24,1920,0.007261138864617984
STAT,1951,15,15-19,1966,0.5374384691835566
STAT,1835,42,20-24,1877,8.620111827072536E-4
STAT,1870,36,na,1906,23.516652972915256
STAT,1881,39,na,1920,22.19251745242646
SIM,1786,85,na,1871,4
SIM,1825,52,na,1877,17
SIM,1834,26,na,1860,23
SIM,1865,58,na,1923,14
STAT,1791,63,na,1854,8.0
STAT,1819,77,na,1896,4.437180395871976
STAT,1840,40,50-100,1880,0.009735785332747354
STAT,1858,64,na,1922,13.227945960863202
STAT,1900,36,30-34,1936,0.016028368723188795
STAT,1939,26,20-24,1965,0.18232980367980176
STAT,1865,43,45-49,1908,0.013439133279878914
STAT,1907,39,20-24,1946,0.0024092455730970897
STAT,1886,17,30-34,1903,0.016532670811580188
STAT,1882,40,40-44,1922,0.021773300866546344
SIM,1881,11,na,1892,26
STAT,1854,74,na,1928,6.783416420218299
STAT,1895,17,40-44,1912,0.0023745485231233265
STAT,1954,16,45-49,1970,0.006141976626587823
STAT,1809,50,50-100,1859,5.140397986001531E-4
STAT,1916,39,30-34,1955,0.01831839410060634
STAT,1863,46,45-49,1909,0.002095470953063211
STAT,1963,8,na,1971,49.62265278518824
STAT,1937,29,20-24,1966,0.17663981967601497
STAT,1873,40,30-34,1913,0.011806534220744916
STAT,1840,27,35-39,1867,0.0942723346074999
SIM,1852,4,na,1856,29
STAT,1945,16,35-39,1961,0.04552140412319371
SIM,1873,16,na,1889,30
STAT,1952,19,45-49,1971,0.005946965682684984
SIM,1904,19,na,1923,33
SIM,1804,50,na,1854,13
STAT,1890,13,na,1903,31.321189936384293
STAT,1840,34,40-44,1874,0.04053929791356011
STAT,1870,17,35-39,1887,0.005502738464742555
STAT,1847,27,na,1874,27.775664923796008
STAT,1923,16,15-19,1939,0.5305170933798584
STAT,1823,37,45-49,1860,0.014365673069498834
STAT,1849,32,35-39,1881,0.08274511059906618
STAT,1887,20,50-100,1907,0.004477621456100725
STAT,1891,60,na,1951,23.408032859127548
SIM,1823,57,na,1880,10
STAT,1892,14,na,1906,31.801228084992342
STAT,1846,79,na,1925,5.66574548095143
STAT,1881,76,na,1957,9.714450381675556
STAT,1922,29,45-49,1951,0.019267105177269803
STAT,1834,37,20-24,1871,0.006775933704885781
STAT,1943,19,35-39,1962,0.04414323054307719
STAT,1889,56,na,1945,24.971885838960954
STAT,1824,30,na,1854,21.095418831394174
SIM,1875,8,na,1883,21
STAT,1831,34,30-34,1865,0.18021968902990868
STAT,1844,27,35-39,1871,0.09226230181378278
STAT,1924,36,50-100,1960,0.00492312168891739
STAT,1857,49,25-29,1906,4.2219513525397045E-4
SIM,1912,14,na,1926,40
STAT,1858,32,45-49,1890,0.013269522299141382
STAT,1940,4,na,1944,40.52340313206103
STAT,1854,46,35-39,1900,8.581586040520436E-4
SIM,1866,32,45-49,1898,1
STAT,1846,39,50-100,1885,0.01017700594808369
STAT,1896,20,15-19,1916,0.04359242270523735
STAT,1874,46,20-24,1920,1.2208461315289297E-4
STAT,1942,12,na,1954,40.8079844294579
STAT,1846,24,35-39,1870,0.05751732240788607
STAT,1786,85,na,1871,0.3746653394834317
STAT,1827,32,15-19,1859,0.0012553420488027823
SIM,1909,56,na,1965,33
SIM,1884,53,na,1937,20
SIM,1959,8,na,1967,51
STAT,1869,22,50-100,1891,0.003951250100661053
STAT,1897,51,na,1948,28.73070107681408
STAT,1919,26,35-39,1945,0.16136558574650553
STAT,1936,23,30-34,1959,0.27302851513293147
STAT,1851,43,15-19,1894,1.1574465297648324E-4
SIM,1851,66,na,1917,15
STAT,1918,18,30-34,1936,0.1311227816456396
SIM,1839,32,na,1871,23
SIM,1871,80,na,1951,7
STAT,1899,33,45-49,1932,0.02377102952142033
STAT,1875,43,50-100,1918,0.01078126627188488
STAT,1866,93,na,1959,0.4455857224916623
STAT,1880,51,50-100,1931,1.5957329168248948E-4
STAT,1863,21,30-34,1884,0.1620157836114234
STAT,1780,94,na,1874,0.07668646268574186
STAT,1894,23,15-19,1917,0.04214937906990371
STAT,1917,29,35-39,1946,0.15490362578515268
STAT,1826,30,50-100,1856,0.017204064986762767
STAT,1823,82,na,1905,2.6832600053919706
STAT,1890,28,45-49,1918,0.013439410356345681
STAT,1929,20,20-24,1949,1.407775158712943
STAT,1811,54,50-100,1865,5.507130161979712E-4
STAT,1896,39,35-39,1935,0.09197031832652262
STAT,1876,43,20-24,1919,0.0016013260184710165
STAT,1880,36,35-39,1916,0.07473349805001381
SIM,1854,24,35-39,1878,2
STAT,1813,45,35-39,1858,0.004470639201196148
STAT,1898,25,40-44,1923,0.0406843388777043
STAT,1879,32,na,1911,24.69855800350996
STAT,1879,30,25-29,1909,0.10686411836467082
SIM,1875,17,na,1892,17
STAT,1861,17,25-29,1878,0.05477352714532177
STAT,1879,49,45-49,1928,0.0023916234818447185
STAT,1896,46,40-44,1942,0.0012720970952554344
STAT,1860,27,20-24,1887,0.09639539417472087
STAT,1878,22,20-24,1900,0.7114646831318453
STAT,1905,20,35-39,1925,0.08472256644854749
STAT,1877,33,25-29,1910,0.10528423336091366
STAT,1883,31,na,1914,23.26772392059787
STAT,1875,22,35-39,1897,0.05998536027439864
SIM,1886,22,20-24,1908,2
STAT,1903,23,35-39,1926,0.08270859452774962
STAT,1818,37,35-39,1855,0.097036221004175
STAT,1902,33,30-34,1935,0.24517557807186835
STAT,1781,101,na,1882,0.002013152214470876
STAT,1878,19,na,1897,25.93496719100147
STAT,1815,42,35-39,1857,0.02799661588234404
STAT,1815,87,na,1902,0.6289103186747137
SIM,1928,23,na,1951,47
STAT,1900,29,25-29,1929,0.5823937426792204
STAT,1925,37,15-19,1962,2.2904010415139355E-4
SIM,1917,51,na,1968,34
STAT,1919,33,40-44,1952,0.04167758754369362
STAT,1895,15,15-19,1910,0.07740358106779394
STAT,1873,41,na,1914,23.60452794410063
STAT,1882,33,35-39,1915,0.09664254732953177
STAT,1874,39,15-19,1913,5.639495963797311E-4
SIM,1911,23,35-39,1934,1
STAT,1867,47,na,1914,21.429714555358448
STAT,1910,28,40-44,1938,0.04457697688073123
SIM,1845,66,na,1911,19
STAT,1821,87,na,1908,1.094238756921366
STAT,1834,21,35-39,1855,0.05555159937769844
STAT,1866,99,na,1965,0.07126501056073661
STAT,1815,48,50-100,1863,0.0034897623226797024
SIM,1924,39,na,1963,50
STAT,1838,48,45-49,1886,0.001860461932568758
STAT,1853,22,15-19,1875,0.024497794152056593
STAT,1885,25,30-34,1910,0.2503620818024939
STAT,1826,54,50-100,1880,1.4105077929202112E-4
STAT,1845,91,na,1936,0.3387332881096276
STAT,1914,34,35-39,1948,0.09044348745760196
STAT,1895,28,50-100,1923,0.008275606864378423
STAT,1872,35,30-34,1907,0.0550485360921327
STAT,1929,37,15-19,1966,2.4536030961742374E-4
SIM,1909,22,na,1931,36
STAT,1876,28,25-29,1904,0.42812027696295357
SIM,1930,33,na,1963,48
STAT,1872,93,na,1965,0.8975478578814117
STAT,1887,61,na,1948,20.396301888718337
STAT,1829,48,35-39,1877,0.0011797800078368998
STAT,1891,39,15-19,1930,6.822840613812736E-4
SIM,1840,29,na,1869,16
STAT,1904,28,50-100,1932,0.009133828000705316
SIM,1903,31,na,1934,38
STAT,1890,19,na,1909,30.514087726163446
STAT,1917,44,30-34,1961,0.001317654903964233
STAT,1850,32,45-49,1882,0.016242150426179675
STAT,1859,38,35-39,1897,0.055937939120076115
SIM,1848,49,na,1897,30
SIM,1853,61,na,1914,19
STAT,1917,17,na,1934,41.18453594480676
SIM,1936,24,na,1960,32
STAT,1850,45,20-24,1895,1.0790897903965695E-4
STAT,1924,15,20-24,1939,1.611430010500741
STAT,1945,21,15-19,1966,0.05794168142070385
SIM,1859,86,na,1945,1
STAT,1854,16,40-44,1870,0.0013452796065862502
STAT,1867,103,na,1970,0.013044987264695728
STAT,1833,100,na,1933,0.007859817206620542
STAT,1928,21,15-19,1949,0.06633736881509111
STAT,1953,17,50-100,1970,0.004505975899403799
STAT,1887,25,35-39,1912,0.10603331804718664
STAT,1920,31,25-29,1951,0.1007872394757238
SIM,1935,23,20-24,1958,2
STAT,1841,42,45-49,1883,0.015222493758530974
STAT,1918,20,45-49,1938,0.012097202166034016
STAT,1908,47,25-29,1955,4.772362712258528E-4
STAT,1927,23,20-24,1950,1.3587710491751677
STAT,1942,29,30-34,1971,0.40784347456315123
SIM,1893,25,30-34,1918,2
STAT,1937,21,25-29,1958,0.8941155562674675
SIM,1897,26,na,1923,40
STAT,1919,28,50-100,1947,0.010623895010986048
STAT,1895,22,20-24,1917,0.8946600572713835
STAT,1877,31,na,1908,24.733625542395835
SIM,1834,29,na,1863,22
STAT,1871,26,50-100,1897,0.0063996221030544285
SIM,1945,21,25-29,1966,2
STAT,1836,55,na,1891,19.95560871994909
SIM,1829,42,na,1871,19
STAT,1828,31,20-24,1859,0.03776207214632051
STAT,1860,51,45-49,1911,1.185464644080799E-4
STAT,1873,47,na,1920,22.767325569188763
STAT,1891,33,45-49,1924,0.02131272144110544
SIM,1932,15,20-24,1947,2
STAT,1881,28,35-39,1909,0.09149056092589748
SIM,1891,35,na,1926,36
STAT,1854,21,20-24,1875,0.49849471123242434
STAT,1857,24,40-44,1881,0.016153517038076683
SIM,1884,25,na,1909,26
STAT,1797,57,na,1854,9.000000000000004
STAT,1822,35,na,1857,10.50744189287183
STAT,1933,29,20-24,1962,0.24114855820258932
SIM,1934,26,40-44,1960,2
STAT,1914,44,45-49,1958,0.001630016708887687
SIM,1835,42,na,1877,19
SIM,1875,11,na,1886,21
STAT,1859,12,na,1871,22.025030823898415
SIM,1797,63,na,1860,1
STAT,1875,76,na,1951,9.73876165781199
STAT,1884,19,na,1903,24.611974667301553
STAT,1885,18,25-29,1903,0.055813167946745124
STAT,1835,27,25-29,1862,0.25386243126160274
STAT,1934,37,25-29,1971,0.013529723631087003
STAT,1837,21,20-24,1858,0.5026353914196169
STAT,1938,20,30-34,1958,0.2827725259077337
STAT,1833,38,15-19,1871,5.14410689041437E-4
STAT,1845,19,35-39,1864,0.004006350676466298
SIM,1880,63,na,1943,29
STAT,1875,38,20-24,1913,0.007884578308167293
SIM,1864,43,35-39,1907,1
SIM,1912,4,na,1916,40
STAT,1893,61,na,1954,23.561202849546802
SIM,1843,27,25-29,1870,1
STAT,1913,55,na,1968,34.44199892056634
SIM,1845,21,20-24,1866,1
STAT,1839,91,na,1930,0.3197886035844595
STAT,1944,18,40-44,1962,0.014938381631112189
STAT,1857,100,na,1957,0.011111612387145637
STAT,1848,40,na,1888,15.31583936057294
STAT,1918,34,35-39,1952,0.09540507336692035
SIM,1817,57,na,1874,6
STAT,1857,4,na,1861,23.45223020484128
STAT,1928,26,45-49,1954,0.021252627148434015
SIM,1851,19,30-34,1870,1
SIM,1846,14,na,1860,17
STAT,1864,37,50-100,1901,0.01101190579055424
STAT,1852,79,na,1931,5.983279784801788
STAT,1814,44,40-44,1858,0.0668095538034777
STAT,1932,37,20-24,1969,0.0035275238584065575
STAT,1828,26,40-44,1854,0.04888990140699294
STAT,1833,45,20-24,1878,1.0676991348198106E-4
STAT,1860,37,30-34,1897,0.043328012872082496
STAT,1930,27,na,1957,47.411143234238786
STAT,1940,16,15-19,1956,0.45765147604817685
SIM,1862,21,20-24,1883,2
STAT,1868,27,20-24,1895,0.11353056885752978
STAT,1824,42,45-49,1866,0.020282972370536945
STAT,1898,39,na,1937,31.71053966272272
SIM,1814,74,na,1888,15
STAT,1859,24,45-49,1883,0.005668178494976612
STAT,1895,56,na,1951,26.479655313963605
STAT,1843,19,30-34,1862,0.00853872824329429
STAT,1850,38,15-19,1888,5.026513915883215E-4
SIM,1852,14,na,1866,29
SIM,1931,34,45-49,1965,1
STAT,1919,31,15-19,1950,0.0013800115420213232
SIM,1860,49,na,1909,20
STAT,1923,34,45-49,1957,0.01789144114017081
SIM,1910,19,na,1929,33
STAT,1828,26,na,1854,19.390580845140374
STAT,1881,35,40-44,1916,0.04204943227474411
STAT,1927,18,40-44,1945,0.017257204771179896
STAT,1913,36,40-44,1949,0.014720123384061583
SIM,1918,39,na,1957,35
STAT,1886,26,50-100,1912,0.006658084298059381
SIM,1915,56,na,1971,30
STAT,1861,22,na,1883,20.43275084782612
SIM,1799,58,na,1857,16
STAT,1909,28,30-34,1937,0.37105339914509894
STAT,1874,49,50-100,1923,0.0024395683772523843
STAT,1844,29,50-100,1873,0.006029168447049099
STAT,1917,4,na,1921,42.89808005013861
STAT,1865,40,40-44,1905,0.02054969776771597
SIM,1858,70,na,1928,16
STAT,1918,28,40-44,1946,0.048981843680118396
STAT,1844,24,30-34,1868,0.17122837254049403
STAT,1851,37,20-24,1888,0.006577434970290912
SIM,1912,42,na,1954,37
STAT,1774,94,na,1868,0.016928245631022663
STAT,1919,16,25-29,1935,0.09548005392395593
STAT,1886,14,na,1900,26.700775841178654
STAT,1900,39,35-39,1939,0.02095641361357912
STAT,1869,32,20-24,1901,0.026191055257365783
STAT,1905,29,45-49,1934,0.015909824764698224
STAT,1778,84,na,1862,1.1744719903892635
STAT,1926,19,35-39,1945,0.05087840805899142
STAT,1831,39,50-100,1870,0.01229267184189064
STAT,1840,40,35-39,1880,0.016687645174473322
SIM,1917,28,30-34,1945,1
STAT,1803,68,na,1871,8.072096464485282
STAT,1806,79,na,1885,3.989340440779262
SIM,1927,16,25-29,1943,2
STAT,1877,23,15-19,1900,0.03394931178327092
STAT,1904,44,na,1948,32.78334388295936
STAT,1920,47,40-44,1967,0.0017279891170347396
STAT,1814,50,35-39,1864,2.4613249768196463E-4
STAT,1913,15,45-49,1928,0.0010175161809566813
SIM,1866,68,na,1934,23
STAT,1845,26,40-44,1871,0.021467581295183683
STAT,1899,30,40-44,1929,0.05984396900120941
STAT,1905,20,na,1925,34.3370186036842
STAT,1895,47,35-39,1942,0.001020473911588749
STAT,1823,34,40-44,1857,0.03452006581194783
SIM,1833,47,na,1880,11
STAT,1928,23,40-44,1951,0.041646393034943115
SIM,1846,85,na,1931,2
STAT,1890,25,40-44,1915,0.036634064199397715
STAT,1893,43,20-24,1936,1.380488818351061E-4
STAT,1851,23,50-100,1874,0.004081727797659323
STAT,1875,44,15-19,1919,1.400409078678784E-4
STAT,1952,16,40-44,1968,0.016667336937827723
STAT,1905,44,35-39,1949,0.0017903305162984156
STAT,1953,16,25-29,1969,0.5213372919972596
SIM,1915,7,na,1922,40
STAT,1911,18,45-49,1929,9.905835406991274E-4
STAT,1901,30,na,1931,33.65931145877551
STAT,1836,19,25-29,1855,0.07261931840008595
STAT,1881,41,35-39,1922,0.017308644420460047
STAT,1851,91,na,1942,0.4892133818767214
SIM,1871,52,na,1923,22
SIM,1886,82,na,1968,3
STAT,1935,18,30-34,1953,0.16545500886510742
STAT,1793,67,na,1860,3.997696833718943
SIM,1843,71,na,1914,16
STAT,1900,26,20-24,1926,0.1632361898124189
SIM,1875,42,na,1917,18
STAT,1855,38,35-39,1893,0.049551305651224065
STAT,1914,26,15-19,1940,0.00708194951872174
STAT,1845,24,15-19,1869,0.02359779713760084
STAT,1834,47,30-34,1881,7.254740320525952E-4
STAT,1853,16,20-24,1869,0.1348257203812618
STAT,1856,43,35-39,1899,0.013023376392471229
STAT,1928,31,25-29,1959,0.1150708659919688
STAT,1855,45,40-44,1900,0.001217384522671598
STAT,1842,38,25-29,1880,0.025079017627080084
STAT,1864,64,na,1928,15.591734394364426
STAT,1938,27,15-19,1965,0.006947810035198493
STAT,1908,34,na,1942,35.21020564506359
STAT,1906,16,15-19,1922,0.08642984609816465
SIM,1928,21,25-29,1949,3
STAT,1856,38,na,1894,16.982829568671033
SIM,1899,21,na,1920,28
SIM,1927,41,na,1968,50
STAT,1893,18,50-100,1911,6.161090603031275E-4
STAT,1858,0,na,1858,29.910678894074813
STAT,1869,25,15-19,1894,0.004425936410415231
STAT,1871,16,40-44,1887,0.0018461953540915726
SIM,1854,5,na,1859,21
SIM,1896,10,na,1906,33
STAT,1879,46,40-44,1925,0.001776967976320926
SIM,1860,43,na,1903,23
STAT,1937,15,30-34,1952,0.11837606108999783
STAT,1834,43,15-19,1877,1.1615363890693164E-4
STAT,1901,18,20-24,1919,0.24741989954940513
STAT,1873,50,40-44,1923,1.0857195697791916E-4
SIM,1878,53,na,1931,28
STAT,1846,21,30-34,1867,0.1794031681039808
STAT,1944,24,35-39,1968,0.10085867072713797
STAT,1854,31,30-34,1885,0.11042835300703915
SIM,1867,81,na,1948,4
STAT,1825,77,na,1902,4.659967286169223
STAT,1931,19,45-49,1950,0.006474626853857759
SIM,1918,23,20-24,1941,2
STAT,1842,16,45-49,1858,6.330829532817667E-4
STAT,1848,74,na,1922,7.1770000504798315
SIM,1957,1,na,1958,56
STAT,1880,28,50-100,1908,0.0067030271070176745
STAT,1931,34,35-39,1965,0.11905856554809385
STAT,1946,21,35-39,1967,0.10407630404740853
STAT,1883,39,25-29,1922,0.027677951668131764
STAT,1790,84,na,1874,0.66467492501784
STAT,1887,22,30-34,1909,0.19442244893671104
STAT,1885,28,35-39,1913,0.09494919545550991
STAT,1809,53,na,1862,15.907326137261663
STAT,1831,40,na,1871,21.33740907939784
SIM,1922,38,na,1960,48
STAT,1936,33,40-44,1969,0.03775739776974136
SIM,1887,36,na,1923,25
SIM,1937,20,20-24,1957,1
STAT,1908,44,20-24,1952,1.6054758271135755E-4
STAT,1843,21,45-49,1864,0.0037397383407819108
STAT,1902,23,50-100,1925,0.005732836530340685
SIM,1829,73,na,1902,15
STAT,1771,104,na,1875,5.184940383506926E-4
STAT,1850,48,25-29,1898,5.064061987171542E-4
STAT,1846,45,30-34,1891,7.923154848334432E-4
STAT,1860,33,15-19,1893,0.0011528498798818326
STAT,1852,42,20-24,1894,0.0013575250959044272
STAT,1910,44,na,1954,34.45676921273804
STAT,1911,31,15-19,1942,0.0012483472634998822
STAT,1940,27,50-100,1967,0.010077802455854087
STAT,1865,46,na,1911,20.40730111460718
STAT,1911,20,na,1931,36.17355911092992
STAT,1901,28,30-34,1929,0.3511221984119397
STAT,1840,54,na,1894,16.40806346020375
STAT,1867,31,40-44,1898,0.04167026459330252
SIM,1934,23,na,1957,51
STAT,1915,47,30-34,1962,8.905296434565287E-4
SIM,1940,23,na,1963,31
STAT,1917,45,na,1962,38.20318298239664
STAT,1860,43,50-100,1903,0.008526622923906409
STAT,1903,17,40-44,1920,0.0026003934637861804
SIM,1926,24,25-29,1950,2
STAT,1914,31,30-34,1945,0.15791970325159213
STAT,1914,41,40-44,1955,0.002461447734808083
STAT,1822,45,45-49,1867,0.001330601705895224
STAT,1841,32,35-39,1873,0.12026848685359387
STAT,1875,48,30-34,1923,9.825452057344091E-4
STAT,1922,18,20-24,1940,1.5534606372741704
STAT,1862,22,25-29,1884,0.505594695162447
STAT,1845,16,30-34,1861,0.011845575935536984
STAT,1837,37,50-100,1874,0.007284067772043806
STAT,1856,2,na,1858,25.65359797296454
STAT,1918,24,25-29,1942,0.9810320242069283
STAT,1878,25,25-29,1903,0.43969019548037247
STAT,1859,35,30-34,1894,0.042762685989112835
SIM,1913,6,na,1919,47
STAT,1859,21,40-44,1880,0.019020211874632792
STAT,1898,28,45-49,1926,0.014925276165866568
STAT,1838,45,40-44,1883,0.001402505987666572
STAT,1855,22,na,1877,17.586705062376154
STAT,1828,41,30-34,1869,0.005121615506729459
STAT,1784,84,na,1868,1.4963801843862203
STAT,1880,29,na,1909,24.916196324188377
STAT,1913,39,45-49,1952,0.00660419618566254
STAT,1944,20,50-100,1964,0.007057790171613005
STAT,1868,23,na,1891,22.81692397010339
STAT,1863,24,35-39,1887,0.05194286232305263
STAT,1885,15,20-24,1900,0.1758852824203123
STAT,1837,24,25-29,1861,0.36812641454018596
STAT,1957,14,na,1971,51.479470186143516
STAT,1836,32,25-29,1868,0.12494752200436128
STAT,1934,34,20-24,1968,0.0331189764554673
STAT,1871,46,na,1917,22.494606093679565
STAT,1916,49,40-44,1965,0.0015938942707800336
STAT,1946,25,50-100,1971,0.011018940822617434
STAT,1815,53,na,1868,9.843872159139938
STAT,1860,9,na,1869,22.84339308296255
STAT,1891,30,40-44,1921,0.05365513681700721
STAT,1817,82,na,1899,3.697844098925446
SIM,1887,67,na,1954,14
STAT,1842,89,na,1931,0.7881944595782598
STAT,1908,21,50-100,1929,0.0060359186817400936
STAT,1895,32,30-34,1927,0.22667169453627536
SIM,1903,37,na,1940,35
STAT,1860,74,na,1934,9.022278230266634
STAT,1927,26,25-29,1953,0.7988308295178369
STAT,1864,35,40-44,1899,0.039635708227439316
STAT,1919,2,na,1921,44.804297496679624
STAT,1871,29,50-100,1900,0.006332152526678547
STAT,1906,38,50-100,1944,0.0038308298388884136
STAT,1884,22,45-49,1906,0.00683202170032406
STAT,1832,25,na,1857,13.121440135716195
SIM,1876,4,na,1880,34
STAT,1940,31,40-44,1971,0.040237171684312976
SIM,1905,66,na,1971,36
STAT,1894,17,20-24,1911,0.22720742041792655
SIM,1867,38,35-39,1905,1
STAT,1802,83,na,1885,1.2076672824056303
SIM,1872,68,na,1940,13
STAT,1816,48,25-29,1864,7.150741743875477E-4
SIM,1921,20,25-29,1941,2
STAT,1931,28,50-100,1959,0.012787342736777552
STAT,1857,27,45-49,1884,0.008561302417528142
STAT,1897,44,35-39,1941,0.0016473191150122538
SIM,1848,15,na,1863,33
SIM,1827,47,na,1874,14
STAT,1799,83,na,1882,1.5379135679197549
STAT,1891,49,25-29,1940,3.9045885400219583E-4
STAT,1800,54,na,1854,9.99909654304067
STAT,1864,38,45-49,1902,0.01779135344313018
STAT,1874,29,na,1903,24.038032145946335
SIM,1959,2,na,1961,54
STAT,1887,46,30-34,1933,0.001059579318192168
STAT,1904,37,45-49,1941,0.006165393204493668
STAT,1926,28,na,1954,44.493754147699974
STAT,1913,20,25-29,1933,0.8928759385480456
SIM,1893,36,na,1929,34
STAT,1833,41,40-44,1874,0.020438545008059132
STAT,1926,29,45-49,1955,0.020444488442012958
STAT,1857,88,na,1945,1.0277159896473653
STAT,1862,107,na,1969,5.032935598176713E-4
SIM,1875,48,na,1923,15
STAT,1781,73,na,1854,6.999999999999998
STAT,1855,50,na,1905,15.377656583377696
SIM,1812,48,na,1860,18
STAT,1838,19,na,1857,23.256535532720456
STAT,1899,18,na,1917,34.48328805663274
STAT,1937,25,40-44,1962,0.04518803284239367
STAT,1827,29,25-29,1856,0.45696182995501095
STAT,1858,33,na,1891,18.081878228137903
SIM,1958,3,na,1961,53
STAT,1890,15,30-34,1905,0.019450731314870906
SIM,1881,42,na,1923,23
STAT,1879,3,na,1882,31.537753598939872
STAT,1853,30,50-100,1883,0.006054429913766333
STAT,1887,47,45-49,1934,0.0025639490152996607
STAT,1810,48,20-24,1858,1.1551064343969543E-4
STAT,1921,15,35-39,1936,0.047677954178809615
STAT,1775,79,na,1854,4.0
STAT,1862,26,40-44,1888,0.026127537097432325
STAT,1937,26,50-100,1963,0.009645696409677822
STAT,1930,27,45-49,1957,0.02186459015956126
STAT,1878,35,35-39,1913,0.07371558231178865
SIM,1902,52,na,1954,30
SIM,1952,11,na,1963,35
SIM,1895,62,na,1957,20
STAT,1882,35,50-100,1917,0.01187773950474728
STAT,1795,93,na,1888,0.08684416246212362
STAT,1837,100,na,1937,0.00513331166320088
STAT,1843,68,na,1911,6.482515866913105
SIM,1826,68,na,1894,10
STAT,1874,42,40-44,1916,0.022790616572761876
STAT,1901,24,15-19,1925,0.04587323671942379
STAT,1832,28,na,1860,12.840828783532592
STAT,1909,26,40-44,1935,0.04482462707978383
SIM,1826,31,na,1857,15
STAT,1855,48,45-49,1903,0.0016407266466450803
STAT,1871,12,na,1883,26.32360366191468
STAT,1910,36,25-29,1946,0.00940427709539399
STAT,1941,27,20-24,1968,0.1874617787554551
STAT,1893,41,50-100,1934,0.013380835048744273
STAT,1806,73,na,1879,7.045054109644282
STAT,1842,35,20-24,1877,0.006926871733307508
STAT,1851,47,30-34,1898,8.134056225449128E-4
STAT,1877,27,50-100,1904,0.006603295413262403
STAT,1905,42,45-49,1947,0.001498110646076537
STAT,1920,21,50-100,1941,0.007274721454985623
STAT,1882,52,na,1934,20.52489929307664
STAT,1833,46,50-100,1879,0.0021574062394086493
STAT,1876,18,15-19,1894,0.060116094871971955
SIM,1919,18,na,1937,43
STAT,1901,38,40-44,1939,0.01315535461802706
STAT,1928,25,30-34,1953,0.4836243583054558
STAT,1836,29,35-39,1865,0.11877038620945322
SIM,1868,60,na,1928,29
STAT,1824,98,na,1922,0.022603742612507593
STAT,1849,59,na,1908,15.06945191908285
STAT,1901,36,15-19,1937,1.70414246026696E-4
SIM,1914,5,na,1919,38
STAT,1855,35,30-34,1890,0.03788031803183392
STAT,1856,40,30-34,1896,0.008412618454416841
STAT,1917,44,50-100,1961,0.001210818017202006
STAT,1807,51,40-44,1858,2.2005100563003292E-4
SIM,1900,26,30-34,1926,1
STAT,1965,6,na,1971,48.76466538024316
STAT,1868,28,35-39,1896,0.09304836456756047
STAT,1846,48,na,1894,18.00423951245733
STAT,1886,25,15-19,1911,0.004738031356077527
SIM,1851,35,na,1886,21
SIM,1906,42,na,1948,25
STAT,1819,39,50-100,1858,0.01207740875880103
STAT,1902,15,na,1917,35.78123647122503
STAT,1923,24,35-39,1947,0.1081182545123622
STAT,1855,53,na,1908,14.916396917678487
STAT,1886,20,20-24,1906,0.7190710244408721
STAT,1919,48,45-49,1967,0.0023304020288691996
STAT,1871,24,25-29,1895,0.5671660270130321
SIM,1931,24,35-39,1955,3
STAT,1859,29,50-100,1888,0.005098139251378528
STAT,1837,46,35-39,1883,7.165310055452853E-4
STAT,1860,49,30-34,1909,7.705265089327566E-4
STAT,1940,21,30-34,1961,0.2908029245108115
SIM,1820,77,na,1897,2
STAT,1844,52,50-100,1896,1.1733883151007714E-4
STAT,1954,15,30-34,1969,0.1499017355915803
SIM,1874,0,na,1874,37
STAT,1888,40,na,1928,27.281633968548636
STAT,1831,35,45-49,1866,0.020820223737512772
STAT,1914,34,na,1948,37.43140221218518
STAT,1933,23,15-19,1956,0.07029853996694968
SIM,1850,50,na,1900,20
STAT,1894,15,30-34,1909,0.020521807876596687
SIM,1845,34,35-39,1879,1
SIM,1868,63,na,1931,28
STAT,1869,73,na,1942,11.508627244860902
STAT,1909,19,35-39,1928,0.008138739746840151
STAT,1870,40,15-19,1910,1.3856951946057344E-4
STAT,1882,37,15-19,1919,5.38153750022693E-4
STAT,1881,3,na,1884,28.63113069457046
STAT,1872,38,35-39,1910,0.07200907962972687
STAT,1930,15,45-49,1945,0.006457939991498504
STAT,1851,60,na,1911,16.101000341650114
SIM,1909,24,25-29,1933,1
STAT,1890,31,35-39,1921,0.12351647624917415
STAT,1836,22,15-19,1858,0.04201877935685141
STAT,1869,35,25-29,1904,0.028162681617408654
STAT,1871,15,na,1886,25.64412392382889
SIM,1930,20,35-39,1950,1
STAT,1933,35,15-19,1968,2.6094870752984157E-4
STAT,1843,65,na,1908,7.1687124750546465
STAT,1830,27,40-44,1857,0.027139877419189315
STAT,1924,37,30-34,1961,0.0213516088462557
SIM,1919,15,na,1934,47
STAT,1910,43,30-34,1953,0.001193660452771324
STAT,1853,19,25-29,1872,0.04233852436596028
STAT,1823,40,35-39,1863,0.013039097206168096
STAT,1926,22,na,1948,44.11140062161334
STAT,1909,30,45-49,1939,0.015051945714024094
STAT,1867,22,45-49,1889,0.006700582774977713
STAT,1902,49,na,1951,31.070295351566152
SIM,1825,83,na,1908,2
STAT,1907,55,na,1962,31.56983542545329
STAT,1919,36,45-49,1955,0.007266878783961127
STAT,1887,24,20-24,1911,0.7474763942620279
SIM,1824,36,na,1860,18
SIM,1960,6,na,1966,52
STAT,1902,44,50-100,1946,0.0010205793596662358
STAT,1837,34,35-39,1871,0.06065149485355988
STAT,1868,51,50-100,1919,1.4685545055452727E-4
STAT,1936,36,45-49,1972,0.006658168395661434
SIM,1895,24,20-24,1919,2
SIM,1845,35,na,1880,23
STAT,1895,25,na,1920,31.193362760092338
STAT,1920,34,na,1954,40.72228519867728
STAT,1894,40,na,1934,29.919544464428956
STAT,1877,37,40-44,1914,0.045187256807213014
STAT,1919,5,na,1924,44.047579372900294
STAT,1946,23,25-29,1969,1.020306819297099
STAT,1872,33,40-44,1905,0.04418474125693131
STAT,1935,20,45-49,1955,0.015264644835199872
STAT,1925,47,25-29,1972,6.387599117743017E-4
STAT,1916,35,15-19,1951,1.9682390584577615E-4
SIM,1844,50,na,1894,1
STAT,1931,16,40-44,1947,0.01827147078886028
STAT,1858,22,35-39,1880,0.05094821737205023
SIM,1836,21,na,1857,13
STAT,1941,15,20-24,1956,1.3870582495134989
SIM,1952,17,na,1969,33
STAT,1857,85,na,1942,2.052192375128865
STAT,1883,48,20-24,1931,1.1506557932961641E-4
STAT,1858,9,na,1867,21.65608553538186
STAT,1873,53,45-49,1926,1.451776232731792E-4
STAT,1866,48,20-24,1914,1.0912913068634034E-4
STAT,1927,24,35-39,1951,0.11469425135055342
SIM,1838,56,na,1894,4
STAT,1859,52,50-100,1911,1.194001733171789E-4
SIM,1918,30,na,1948,37
STAT,1877,27,30-34,1904,0.259942944486392
SIM,1899,55,na,1954,26
STAT,1822,35,35-39,1857,0.04587552206161042
STAT,1886,39,40-44,1925,0.04494936715731009
SIM,1937,6,na,1943,41
STAT,1851,94,na,1945,0.16872864618936867
STAT,1864,33,na,1897,21.31304765822988
SIM,1857,20,na,1877,22
STAT,1916,45,25-29,1961,5.419641227677062E-4
STAT,1907,33,15-19,1940,0.0011910515937839667
STAT,1874,26,na,1900,24.294159243163875
STAT,1819,48,40-44,1867,0.0015210131606751803
STAT,1836,24,50-100,1860,0.005119599582487831
STAT,1835,20,40-44,1855,0.024078622701629415
STAT,1911,22,50-100,1933,0.006200184728186137
STAT,1825,47,20-24,1872,1.107457536428284E-4
STAT,1945,26,45-49,1971,0.0188260033011192
STAT,1901,31,20-24,1932,0.037977631776883146
SIM,1862,78,na,1940,10
STAT,1929,21,50-100,1950,0.00830611590190043
STAT,1831,32,40-44,1863,0.045746931640505306
STAT,1886,27,40-44,1913,0.031071975205476842
STAT,1862,19,35-39,1881,0.004876006979945879
STAT,1864,41,35-39,1905,0.016315092569606525
STAT,1887,30,15-19,1917,0.0015668851957730747
STAT,1802,80,na,1882,2.2783407585174134
STAT,1942,5,na,1947,41.41049290870738
STAT,1881,9,na,1890,24.68906092069063
STAT,1819,36,40-44,1855,0.053514703570901635
STAT,1929,42,30-34,1971,0.0016477299346486342
SIM,1814,43,na,1857,22
STAT,1841,36,15-19,1877,6.543542822817921E-4
STAT,1877,17,20-24,1894,0.18300472570303344
STAT,1831,37,35-39,1868,0.07232627592199439
SIM,1904,30,35-39,1934,1
STAT,1827,103,na,1930,8.697263681459916E-4
STAT,1859,25,20-24,1884,0.09622993292701063
STAT,1867,78,na,1945,7.477045851413192
STAT,1932,18,15-19,1950,0.5969419517184041
STAT,1827,72,na,1899,7.653366136469036
STAT,1910,33,20-24,1943,0.023276434801077158
STAT,1850,13,na,1863,25.85550289578771
STAT,1946,19,20-24,1965,1.492118187312419
STAT,1816,45,20-24,1861,1.5589958173607352E-4
STAT,1915,37,20-24,1952,0.002639995944379498
SIM,1958,0,na,1958,53
STAT,1853,17,35-39,1870,0.004148361813144107
STAT,1844,13,na,1857,23.59540581568099
STAT,1845,38,40-44,1883,0.026608021809411863
STAT,1892,38,20-24,1930,0.009475891375179126
STAT,1897,41,30-34,1938,0.001064974501248362
SIM,1925,18,na,1943,42
STAT,1882,55,na,1937,19.815804351547566
STAT,1846,46,45-49,1892,0.0019180405979110134
STAT,1904,22,40-44,1926,0.029858702726642816
STAT,1847,103,na,1950,0.0015330805585192868
STAT,1931,32,45-49,1963,0.020527668521392678
SIM,1822,72,na,1894,10
STAT,1840,20,na,1860,21.61562029252019
STAT,1846,23,20-24,1869,0.6841471465475212
STAT,1899,42,50-100,1941,0.0010030432064247604
SIM,1900,57,na,1957,27
STAT,1908,45,50-100,1953,0.002064795536333745
SIM,1946,17,na,1963,50
STAT,1812,73,na,1885,4.987701372888601
STAT,1888,77,na,1965,13.350928569806799
SIM,1820,43,na,1863,14
STAT,1964,7,na,1971,49.19520271089425
STAT,1878,47,35-39,1925,0.001438646118832093
STAT,1915,25,20-24,1940,0.18583045716379243
STAT,1935,16,40-44,1951,0.01908327080593824
STAT,1836,36,40-44,1872,0.0523966336283153
STAT,1883,36,20-24,1919,0.007521599117163515
STAT,1831,25,35-39,1856,0.11006482590283488
STAT,1807,58,na,1865,12.318817392432939
STAT,1911,41,25-29,1952,6.810704782646847E-4
STAT,1929,30,30-34,1959,0.19939382100144828
STAT,1865,12,na,1877,24.45102242792111
STAT,1905,26,40-44,1931,0.043381582028626374
STAT,1924,39,20-24,1963,0.0030816372006133904
SIM,1854,23,20-24,1877,1
STAT,1837,34,na,1871,12.866133311030008
STAT,1880,4,na,1884,30.036328761396035
STAT,1884,42,50-100,1926,0.01033786466515927
STAT,1806,52,35-39,1858,2.788572693935537E-4
SIM,1854,49,na,1903,17
SIM,1877,77,na,1954,5
SIM,1876,7,na,1883,34
STAT,1862,29,45-49,1891,0.00951083756308133
STAT,1887,44,40-44,1931,0.024219627200670692
STAT,1933,39,30-34,1972,0.024670941060915618
STAT,1920,9,na,1929,44.28296667761336
STAT,1899,23,35-39,1922,0.07963700786165759
STAT,1842,45,50-100,1887,0.001890827037508194
STAT,1913,27,45-49,1940,0.017070097659110932
STAT,1887,49,35-39,1936,8.439842503238294E-4
STAT,1836,26,30-34,1862,0.31674226769582153
STAT,1815,52,45-49,1867,2.0132445434049222E-4
STAT,1910,26,15-19,1936,0.006798646816917111
STAT,1932,25,20-24,1957,0.23832790965898015
STAT,1844,17,25-29,1861,0.05626527355136335
STAT,1853,27,na,1880,15.750067444466353
SIM,1817,54,na,1871,7
STAT,1926,43,50-100,1969,0.0014377303437249096
SIM,1795,68,na,1863,11
STAT,1861,53,na,1914,17.816452338942167
SIM,1889,62,na,1951,22
STAT,1859,18,15-19,1877,0.054430611449676036
STAT,1882,43,45-49,1925,0.014239347731338552
STAT,1868,26,na,1894,23.174724112172267
STAT,1891,42,40-44,1933,0.027572808875949772
STAT,1863,23,20-24,1886,0.6178410182208844
STAT,1876,16,25-29,1892,0.057695240034625415
STAT,1891,66,na,1957,20.637688804667405
STAT,1803,100,na,1903,0.003978766791322093
STAT,1848,71,na,1919,8.632152377406953
SIM,1805,69,na,1874,9
STAT,1904,15,35-39,1919,0.007898932065397914
STAT,1909,29,45-49,1938,0.01630068176793637
SIM,1847,61,na,1908,13
STAT,1922,26,40-44,1948,0.052535933994478305
STAT,1935,19,45-49,1954,0.006762294018218696
STAT,1964,4,na,1968,49.22030086115129
STAT,1810,46,30-34,1856,9.564353430414135E-4
STAT,1873,43,35-39,1916,0.018277417415338088
SIM,1960,9,na,1969,52
STAT,1909,16,30-34,1925,0.02382694356268577
STAT,1872,23,30-34,1895,0.18168682125007768
STAT,1884,81,na,1965,8.129487328231212
SIM,1874,63,na,1937,19
STAT,1895,35,35-39,1930,0.09269664209127955
STAT,1834,20,na,1854,20.501380953419314
STAT,1932,22,na,1954,47.72081220178404
STAT,1938,20,50-100,1958,0.00647373069082415
STAT,1789,90,na,1879,0.19384736217767845
STAT,1873,36,50-100,1909,0.012542448427234652
STAT,1896,49,45-49,1945,0.001712117114512305
SIM,1869,48,na,1917,15
SIM,1872,31,25-29,1903,1
STAT,1866,17,45-49,1883,6.175019746948983E-4
STAT,1828,44,35-39,1872,0.007808320033342634
STAT,1831,46,na,1877,19.830073384579777
STAT,1935,19,50-100,1954,0.005071720513664021
STAT,1941,3,na,1944,41.236279300498445
STAT,1882,30,30-34,1912,0.1686690907443475
STAT,1910,41,na,1951,35.08627679427147
STAT,1919,40,na,1959,40.008933800715916
STAT,1936,26,35-39,1962,0.1428779265319479
SIM,1871,89,na,1960,1
STAT,1878,37,25-29,1915,0.029725337039462715
STAT,1800,88,na,1888,0.4362116469190319
STAT,1803,99,na,1902,0.007097716237619017
STAT,1894,18,35-39,1912,0.007013787474397085
STAT,1929,40,40-44,1969,0.0032326601507014193
STAT,1896,30,25-29,1926,0.13562174890088535
STAT,1850,16,na,1866,25.122653560139987
STAT,1868,21,15-19,1889,0.03215703760969152
STAT,1881,25,30-34,1906,0.24124235270027647
STAT,1832,42,35-39,1874,0.009959709489507437
STAT,1865,37,15-19,1902,5.079109035103077E-4
STAT,1928,35,40-44,1963,0.018858918552870658
STAT,1889,25,na,1914,29.417191596431092
STAT,1836,86,na,1922,2.141338326817675
STAT,1824,47,50-100,1871,0.0031780520987203845
STAT,1827,27,35-39,1854,0.284267738188142
STAT,1923,21,30-34,1944,0.333102987442517
STAT,1790,87,na,1877,0.3523205022684169
SIM,1928,33,25-29,1961,3
STAT,1947,21,na,1968,41.00363052139864
SIM,1851,38,na,1889,19
STAT,1868,25,30-34,1893,0.24534997005179998
STAT,1892,48,30-34,1940,6.66096834915445E-4
SIM,1835,76,na,1911,1
STAT,1846,33,30-34,1879,0.16548854941944063
SIM,1888,15,na,1903,39
STAT,1856,53,45-49,1909,1.0344474761868488E-4
SIM,1924,30,na,1954,51
STAT,1906,28,15-19,1934,0.006568260363370693
STAT,1818,98,na,1916,0.00811819693995581
SIM,1893,30,na,1923,31
STAT,1925,40,na,1965,44.80683664386266
STAT,1840,37,45-49,1877,0.0184755692896546
STAT,1871,28,40-44,1899,0.029760655214700386
STAT,1846,48,35-39,1894,0.0011203430766777841
STAT,1876,52,na,1928,21.752138625659327
SIM,1866,34,na,1900,29
SIM,1904,16,na,1920,33
STAT,1838,31,50-100,1869,0.008928892564618332
STAT,1925,44,20-24,1969,2.1176756826004806E-4
STAT,1857,1,na,1858,27.93164622855378
SIM,1853,22,25-29,1875,2
STAT,1850,41,40-44,1891,0.020117378982155012
SIM,1853,6,na,1859,29
SIM,1905,31,30-34,1936,1
STAT,1795,90,na,1885,0.3785325409409835
STAT,1829,45,30-34,1874,8.47925649501925E-4
STAT,1881,38,45-49,1919,0.018874806207323572
STAT,1898,16,45-49,1914,8.833654018672041E-4
STAT,1904,41,na,1945,33.38227883808891
STAT,1895,49,50-100,1944,0.0017610347653164479
SIM,1859,37,30-34,1896,1
SIM,1862,75,na,1937,12
STAT,1922,20,35-39,1942,0.1078277420623513
STAT,1774,91,na,1865,0.07378609742685768
STAT,1837,31,30-34,1868,0.10799184519509387
STAT,1910,46,35-39,1956,0.001198541463493355
STAT,1905,18,20-24,1923,0.2551951292130301
STAT,1900,19,15-19,1919,0.08185202432940136
STAT,1822,32,na,1854,10.5546172351342
STAT,1871,18,30-34,1889,0.0158993114367589
STAT,1814,47,45-49,1861,0.006758702067210288
STAT,1854,34,35-39,1888,0.06208665219014524
STAT,1825,46,na,1871,14.076885993533446
STAT,1791,104,na,1895,1.224283548772351E-4
STAT,1828,34,25-29,1862,0.04529528110988878
STAT,1904,30,50-100,1934,0.013234328315119094
STAT,1857,45,50-100,1902,0.0018569112014307201
STAT,1845,22,25-29,1867,0.4154197593875155
STAT,1824,61,na,1885,13.741698253846769
STAT,1839,97,na,1936,0.02964705063188764
STAT,1916,42,20-24,1958,1.794322501028797E-4
STAT,1946,20,20-24,1966,1.2295030554454738
SIM,1877,74,na,1951,9
STAT,1896,36,30-34,1932,0.07034286500106861
STAT,1880,1,na,1881,35.77331885453948
SIM,1856,75,na,1931,6
STAT,1833,72,na,1905,9.349756972742613
STAT,1823,49,45-49,1872,0.001598539524879896
STAT,1837,31,na,1868,13.27291946025966
SIM,1897,1,na,1898,44
STAT,1846,43,40-44,1889,0.018214581234166843
SIM,1898,73,na,1971,16
STAT,1931,22,35-39,1953,0.1215814558035873
SIM,1810,84,na,1894,4
STAT,1847,30,50-100,1877,0.011733130885448518
STAT,1846,45,na,1891,18.415120685039575
STAT,1833,48,25-29,1881,4.487862804730989E-4
STAT,1876,24,45-49,1900,0.007037980389411242
STAT,1879,66,na,1945,16.9639188947116
SIM,1904,20,25-29,1924,2
STAT,1840,19,15-19,1859,0.05950106579044482
SIM,1841,76,na,1917,4
SIM,1894,15,na,1909,32
SIM,1927,44,na,1971,50
SIM,1801,70,na,1871,3
STAT,1839,60,na,1899,10.52488874244794
STAT,1854,24,25-29,1878,0.4052437631971152
STAT,1863,36,35-39,1899,0.06292488803515942
SIM,1876,28,35-39,1904,1
STAT,1886,23,25-29,1909,0.5919546353243372
SIM,1842,24,na,1866,26
STAT,1907,49,30-34,1956,7.862372342881637E-4
STAT,1887,34,30-34,1921,0.18894254674603267
SIM,1863,23,na,1886,15
STAT,1810,47,na,1857,10.542209186067511
STAT,1920,37,na,1957,40.841220742558264
STAT,1937,31,35-39,1968,0.08989226547836282
STAT,1940,24,35-39,1964,0.09517372309035603
STAT,1824,51,40-44,1875,1.3417585190774776E-4
SIM,1936,25,30-34,1961,1
STAT,1890,21,25-29,1911,0.6974634677864832
STAT,1830,61,na,1891,6.713860010468558
SIM,1912,45,na,1957,36
STAT,1780,91,na,1871,0.33425760296635093
STAT,1895,25,25-29,1920,0.5529062296367533
STAT,1901,34,25-29,1935,0.14209452403615833
STAT,1906,38,25-29,1944,0.008983734041472536
STAT,1945,23,40-44,1968,0.036574366220628415
SIM,1789,68,na,1857,9
STAT,1819,46,na,1865,14.025117810749306
STAT,1835,23,45-49,1858,0.0046043580174613815
STAT,1891,34,50-100,1925,0.011149385308197014
STAT,1874,49,25-29,1923,5.72146325482208E-4
STAT,1919,23,30-34,1942,0.31102827988978954
STAT,1836,39,45-49,1875,0.02312924797421884
STAT,1923,31,40-44,1954,0.04473379696644495
STAT,1840,24,30-34,1864,0.17495876553151082
STAT,1868,28,50-100,1896,0.006168802156685148
SIM,1937,9,na,1946,41
STAT,1904,25,45-49,1929,0.01601736480598393
STAT,1864,67,na,1931,14.218181480284263
STAT,1878,32,30-34,1910,0.18025718709300845
STAT,1876,21,40-44,1897,0.02122801224020491
SIM,1845,36,25-29,1881,1
STAT,1905,22,25-29,1927,0.8261923407304769
STAT,1870,67,na,1937,15.747372952671961
STAT,1866,44,50-100,1910,0.009598393952603416
STAT,1872,36,45-49,1908,0.020494932725210923
SIM,1899,8,na,1907,29
SIM,1928,29,na,1957,50
SIM,1802,55,na,1857,11
STAT,1890,81,na,1971,11.167462501744046
STAT,1936,16,25-29,1952,0.41339319115094597
STAT,1920,40,20-24,1960,1.939245355460219E-4
SIM,1857,23,na,1880,23
SIM,1804,84,na,1888,1
STAT,1885,66,na,1951,16.185467895193515
SIM,1897,29,na,1926,38
STAT,1837,36,25-29,1873,0.017264384877174646
STAT,1862,16,30-34,1878,0.015842734690035894
STAT,1935,36,na,1971,52.42201555951147
STAT,1781,107,na,1888,1.2192985036677787E-4
SIM,1944,16,25-29,1960,1
STAT,1859,28,25-29,1887,0.33956658601869044
STAT,1880,35,30-34,1915,0.05657559050541979
STAT,1958,12,na,1970,51.299435075312424
STAT,1843,36,na,1879,10.717109653378799
STAT,1914,48,30-34,1962,8.743450464012427E-4
STAT,1866,27,20-24,1893,0.1080445023090538
STAT,1885,44,20-24,1929,0.0015471330721648986
STAT,1879,33,40-44,1912,0.044696032825911496
SIM,1926,11,na,1937,49
SIM,1934,30,na,1964,51
SIM,1888,20,na,1908,39
STAT,1882,43,40-44,1925,0.02140008085960535
STAT,1827,73,na,1900,7.1979908513491235
STAT,1877,25,30-34,1902,0.2617064827746712
STAT,1926,20,45-49,1946,0.013672464424748969
SIM,1785,77,na,1862,4
STAT,1843,34,15-19,1877,7.112988966508157E-4
STAT,1845,42,25-29,1887,0.003822484124502899
STAT,1866,39,15-19,1905,5.119680373276628E-4
STAT,1865,46,45-49,1911,0.0021406506263855155
STAT,1769,94,na,1863,0.19504024842244802
STAT,1929,21,25-29,1950,1.1660124285086577
SIM,1928,23,25-29,1951,1
STAT,1861,18,30-34,1879,0.015315299505332893
SIM,1800,83,na,1883,4
STAT,1856,48,45-49,1904,0.0016881807309417655
STAT,1824,50,40-44,1874,1.3686325603241408E-4
STAT,1870,16,30-34,1886,0.016078849777701815
SIM,1853,22,30-34,1875,2
STAT,1836,44,25-29,1880,0.007186031940983455
STAT,1820,34,20-24,1854,0.026362857010005812
STAT,1815,52,40-44,1867,1.4604553623583818E-4
STAT,1818,37,na,1855,7.592108314878513
SIM,1909,31,na,1940,38
STAT,1896,45,35-39,1941,0.0010476628181083747
STAT,1873,45,40-44,1918,0.0017579305814808496
SIM,1826,76,na,1902,5
STAT,1863,38,35-39,1901,0.062312865371476525
STAT,1852,72,na,1924,10.808463451080865
STAT,1863,26,40-44,1889,0.026714461086907625
STAT,1854,28,40-44,1882,0.01905696316822395
STAT,1813,44,30-34,1857,0.03676430267360656
SIM,1951,10,na,1961,51
SIM,1900,18,na,1918,36
STAT,1872,36,35-39,1908,0.0727163362846987
STAT,1881,53,na,1934,20.159363806687633
STAT,1885,67,na,1952,15.654260838873263
STAT,1845,22,30-34,1867,0.12926011552622718
SIM,1917,50,na,1967,34
STAT,1822,42,30-34,1864,0.006569679189567869
STAT,1846,29,45-49,1875,0.010729851870324375
STAT,1856,86,na,1942,1.6073450672982028
STAT,1872,24,40-44,1896,0.02118743853292545
STAT,1895,16,35-39,1911,0.007141140952252416
SIM,1894,23,30-34,1917,2
STAT,1835,28,30-34,1863,0.1493801936409219
SIM,1936,22,20-24,1958,2
STAT,1886,18,35-39,1904,0.005676663168038719
STAT,1837,36,40-44,1873,0.026248599416893476
STAT,1892,37,na,1929,29.105922043969816
STAT,1875,37,15-19,1912,5.772364191415101E-4
STAT,1889,19,15-19,1908,0.07226893334027554
STAT,1880,22,25-29,1902,0.6019680006439665
STAT,1858,28,25-29,1886,0.32715183398726383
STAT,1825,38,15-19,1863,5.758132793141341E-4
STAT,1853,19,35-39,1872,0.0040996380263681265
STAT,1859,37,30-34,1896,0.042360384286589225
STAT,1861,38,25-29,1899,0.024092672290220205
STAT,1877,48,na,1925,22.93241690556808
STAT,1894,37,25-29,1931,0.03689955747597838
STAT,1857,29,20-24,1886,0.08916431009595764
STAT,1871,37,30-34,1908,0.05313590950238587
STAT,1792,70,na,1862,13.357514088940654
STAT,1881,85,na,1966,5.035495656558322
SIM,1910,28,na,1938,32
STAT,1844,43,20-24,1887,0.0012542862990625172
STAT,1816,51,45-49,1867,1.7909457814871014E-4
STAT,1827,46,25-29,1873,4.3988398129150017E-4
STAT,1848,67,na,1915,10.25159992560332
SIM,1937,21,25-29,1958,2
STAT,1873,34,na,1907,24.053731571127894
SIM,1843,28,30-34,1871,1
STAT,1833,43,45-49,1876,0.013255512939875405
STAT,1886,23,30-34,1909,0.1841899014652625
STAT,1859,49,25-29,1908,4.482557056080344E-4
STAT,1917,22,45-49,1939,0.01184980119276682
STAT,1831,35,35-39,1866,0.07387047379556913
STAT,1881,17,45-49,1898,6.215720084550867E-4
STAT,1871,43,na,1914,22.876610674541233
SIM,1876,27,30-34,1903,1
STAT,1876,46,20-24,1922,1.2222352759572077E-4
STAT,1823,100,na,1923,0.006105394218463779
STAT,1882,38,45-49,1920,0.01900969775278364
STAT,1867,38,na,1905,22.433945342703826
STAT,1833,26,na,1859,21.258074142748526
STAT,1892,29,15-19,1921,0.0055650153332135344
STAT,1894,42,20-24,1936,1.4116382334310333E-4
STAT,1895,49,35-39,1944,0.0010038471819744218
STAT,1928,22,20-24,1950,1.3815338564673518
STAT,1850,40,40-44,1890,0.020228839889948624
STAT,1859,41,15-19,1900,1.1025950883851072E-4
STAT,1902,64,na,1966,27.033715907238257
STAT,1877,45,25-29,1922,6.005100948033735E-4
STAT,1882,30,35-39,1912,0.09783222585210283
STAT,1830,39,35-39,1869,0.03967929315809757
SIM,1901,67,na,1968,27
STAT,1873,22,50-100,1895,0.004145975002542109
STAT,1894,17,30-34,1911,0.02042690151310391
STAT,1899,26,20-24,1925,0.1611469040864641
STAT,1818,48,25-29,1866,5.584399394975838E-4
SIM,1830,38,na,1868,19
STAT,1847,18,na,1865,30.424069221568985
SIM,1938,12,na,1950,40
STAT,1835,48,25-29,1883,2.714249796087107E-4
STAT,1832,44,40-44,1876,0.01205833872519508
SIM,1855,57,na,1912,11
STAT,1855,37,na,1892,16.58772414219732
STAT,1771,105,na,1876,3.2492465901322857E-4
STAT,1896,28,45-49,1924,0.014532894693288152
SIM,1831,55,na,1886,6
SIM,1837,60,na,1897,28
STAT,1805,50,30-34,1855,1.1982687477655066E-4
STAT,1861,30,15-19,1891,0.0012072115553949055
STAT,1876,33,15-19,1909,0.0014402538601610267
STAT,1850,35,45-49,1885,0.018408736177462727
STAT,1854,15,35-39,1869,0.004059750516631457
STAT,1829,37,45-49,1866,0.01831742415651343
STAT,1869,39,40-44,1908,0.04198854456112341
STAT,1895,46,30-34,1941,7.109023682648019E-4
STAT,1865,18,15-19,1883,0.05498764270081406
STAT,1872,92,na,1964,1.1200028174915917
SIM,1896,71,na,1967,20
STAT,1838,32,40-44,1870,0.04182511613608498
STAT,1864,25,45-49,1889,0.010065004670416038
STAT,1805,62,na,1867,7.516885798945331
STAT,1813,81,na,1894,3.568805285156178
STAT,1855,32,40-44,1887,0.031089414419730566
STAT,1876,29,30-34,1905,0.2539309380543183
SIM,1826,28,30-34,1854,1
STAT,1849,53,50-100,1902,1.152251527362874E-4
STAT,1948,21,35-39,1969,0.1074341399397167
STAT,1860,26,15-19,1886,0.0037549593074592954
STAT,1814,43,35-39,1857,0.055777654346588684
STAT,1844,30,15-19,1874,0.0013580850982814166
STAT,1884,18,na,1902,24.679844238958694
SIM,1879,16,na,1895,16
STAT,1809,76,na,1885,5.401621151159651
STAT,1937,15,25-29,1952,0.4208657083745258
STAT,1869,43,25-29,1912,0.00617717811243755
STAT,1857,52,45-49,1909,1.0806274545534515E-4
STAT,1871,15,35-39,1886,0.005571401295226071
SIM,1888,52,na,1940,32
STAT,1849,35,20-24,1884,0.006244493986589874
STAT,1830,31,25-29,1861,0.06976140962207644
STAT,1839,28,15-19,1867,0.003131560239785342
STAT,1853,36,25-29,1889,0.01828408800681141
STAT,1862,16,50-100,1878,4.8696920499115607E-4
STAT,1840,46,40-44,1886,0.0013702471916095522
SIM,1850,26,na,1876,22
STAT,1881,34,35-39,1915,0.09553840671587496
STAT,1879,28,45-49,1907,0.01145129738608395
STAT,1821,33,25-29,1854,0.2753279124461518
SIM,1945,15,25-29,1960,2
STAT,1864,47,40-44,1911,0.0015283732453443759
STAT,1844,38,25-29,1882,0.023519480055009458
STAT,1932,29,50-100,1961,0.012971385568983087
STAT,1823,46,40-44,1869,0.0012034313872810879
STAT,1930,28,na,1958,47.38838588548631
STAT,1867,104,na,1971,0.007429772496607451
STAT,1854,40,25-29,1894,0.00396469424027864
STAT,1855,27,45-49,1882,0.008148241068481395
STAT,1841,45,45-49,1886,0.0023807020723582376
STAT,1891,41,40-44,1932,0.0277317115833222
STAT,1891,36,45-49,1927,0.024585096746958086
STAT,1818,40,15-19,1858,1.5799042888282525E-4
STAT,1801,80,na,1881,2.5563039549252404
STAT,1892,69,na,1961,19.719932383804185
SIM,1836,42,25-29,1878,1
STAT,1885,31,15-19,1916,0.0014120438865731044
STAT,1853,41,20-24,1894,0.0010026262824532417
STAT,1860,91,na,1951,0.4710999357486718
STAT,1890,37,40-44,1927,0.05317365346996151
STAT,1845,25,35-39,1870,0.06964871308547214
STAT,1848,18,15-19,1866,0.047295890576226005
STAT,1890,24,35-39,1914,0.07044000087563287
STAT,1851,36,15-19,1887,4.8415224484953324E-4
STAT,1918,15,15-19,1933,0.09866425757041881
STAT,1856,54,na,1910,15.169322811025742
STAT,1892,40,45-49,1932,0.0186761739805331
STAT,1895,29,40-44,1924,0.038612110477516566
STAT,1797,58,na,1855,8.823510000000002
STAT,1834,36,15-19,1870,4.987633521258467E-4
STAT,1875,40,45-49,1915,0.015539831601719479
SIM,1851,75,na,1926,13
STAT,1880,36,na,1916,24.893591131869943
STAT,1929,31,na,1960,47.83854864609716
STAT,1885,39,25-29,1924,0.02814633804377207
SIM,1916,33,na,1949,43
STAT,1881,47,40-44,1928,0.0016214476830301162
STAT,1947,1,na,1948,46.03771320767367
STAT,1828,38,40-44,1866,0.019464185718406954
STAT,1838,27,45-49,1865,0.010961966777117077
STAT,1851,23,na,1874,21.401326262166542
STAT,1840,33,35-39,1873,0.09565516515733123
SIM,1901,7,na,1908,42
STAT,1844,26,30-34,1870,0.2425287190713405
STAT,1939,31,35-39,1970,0.09265435620875931
STAT,1805,94,na,1899,0.05472226373772
STAT,1854,4,na,1858,19.489040601732377
STAT,1829,42,40-44,1871,0.019912202537250834
SIM,1908,14,na,1922,42
STAT,1874,41,40-44,1915,0.02292195940012459
STAT,1942,29,na,1971,38.992912495076865
STAT,1871,2,na,1873,33.023448416094595
STAT,1937,20,20-24,1957,1.0767274681857077
SIM,1873,0,na,1873,37
STAT,1891,26,50-100,1917,0.007878296566841655
STAT,1824,45,45-49,1869,0.0031356532833021348
SIM,1856,2,na,1858,28
STAT,1807,50,40-44,1857,2.244683043802027E-4
STAT,1946,17,50-100,1963,0.0041261554233790205
STAT,1868,87,na,1955,1.7049812592744713
SIM,1829,41,na,1870,19
SIM,1842,39,na,1881,22
STAT,1954,15,25-29,1969,0.5329498173482643
STAT,1864,73,na,1937,10.653225385107632
STAT,1886,43,25-29,1929,0.006612761882419159
STAT,1940,3,na,1943,40.72294556533115
SIM,1942,1,na,1943,43
STAT,1854,45,30-34,1899,5.975742516062876E-4
SIM,1928,19,40-44,1947,1
STAT,1840,30,30-34,1870,0.17013386891260074
STAT,1813,47,35-39,1860,0.004339132727402258
STAT,1888,43,35-39,1931,0.021008270898146088
STAT,1909,20,45-49,1929,0.010460848524104128
SIM,1871,20,na,1891,24
SIM,1943,15,15-19,1958,1
STAT,1896,33,40-44,1929,0.056723942830800574
STAT,1886,35,25-29,1921,0.030148573364159964
STAT,1849,27,20-24,1876,0.1078300612027079
SIM,1905,49,na,1954,40
STAT,1825,41,45-49,1866,0.014823858063333478
STAT,1834,75,na,1909,7.275161810429496
SIM,1901,35,na,1936,38
STAT,1830,44,30-34,1874,0.0011605840222803933
STAT,1870,28,25-29,1898,0.41873831962699437
STAT,1882,46,45-49,1928,0.002268112682984396
STAT,1876,41,15-19,1917,1.4089358610086663E-4
STAT,1937,23,25-29,1960,0.8935255373695151
STAT,1867,43,15-19,1910,1.3119996758322549E-4
STAT,1868,55,na,1923,20.010200913829927
SIM,1792,79,na,1871,1
STAT,1873,15,45-49,1888,6.720221961008106E-4
STAT,1864,17,45-49,1881,6.060927922261932E-4
STAT,1864,41,na,1905,20.82383681014075
STAT,1873,48,45-49,1921,0.0023692461126893897
STAT,1833,58,na,1891,14.641009133099725
STAT,1910,27,50-100,1937,0.009552886561936272
STAT,1892,32,45-49,1924,0.021543312667497008
STAT,1928,30,20-24,1958,0.03038431130313907
SIM,1886,29,na,1915,27
STAT,1819,44,25-29,1863,0.005868779533360233
STAT,1893,25,15-19,1918,0.0057594432521818695
STAT,1862,47,30-34,1909,8.312626224387767E-4
STAT,1793,76,na,1869,2.024167971067477
SIM,1880,24,na,1904,32
SIM,1884,38,na,1922,24
STAT,1863,24,na,1887,21.051805967167393
SIM,1922,29,na,1951,49
STAT,1841,50,40-44,1891,1.0452701352077223E-4
SIM,1891,19,20-24,1910,2
STAT,1935,15,15-19,1950,0.6205367279063836
STAT,1909,0,na,1909,43.78809863027239
STAT,1873,40,35-39,1913,0.018596177792897777
STAT,1853,16,30-34,1869,0.012121398617155497
STAT,1878,29,40-44,1907,0.03070568840384152
STAT,1861,35,20-24,1896,0.0065440613276184206
STAT,1836,41,20-24,1877,0.0018468269997779956
STAT,1917,30,na,1947,39.55953425333056
STAT,1838,89,na,1927,0.8153693802262127
STAT,1883,19,20-24,1902,0.1712352315983306
STAT,1943,20,45-49,1963,0.011892035567325107
SIM,1846,21,na,1867,17
SIM,1817,40,na,1857,10
STAT,1826,34,15-19,1860,0.001775790811343336
SIM,1935,9,na,1944,60
STAT,1876,49,25-29,1925,5.727973443613914E-4
STAT,1910,51,na,1961,33.63317163944961
STAT,1867,18,25-29,1885,0.055111121333398065
STAT,1919,32,20-24,1951,0.026087569846112973
SIM,1928,20,20-24,1948,4
STAT,1894,45,25-29,1939,4.2055591465455845E-4
STAT,1852,24,15-19,1876,0.033061503214949724
SIM,1814,75,na,1889,15
STAT,1821,46,30-34,1867,0.001388482458372114
SIM,1810,61,na,1871,13
STAT,1804,54,30-34,1858,1.5708921617935E-4
STAT,1815,40,na,1855,11.737149511137915
STAT,1814,40,30-34,1854,0.03948429416143194
STAT,1923,38,30-34,1961,0.020950440789036823
STAT,1878,65,na,1943,17.447469638472175
SIM,1835,69,na,1904,10
STAT,1875,17,20-24,1892,0.18223904990184747
STAT,1812,64,na,1876,8.289955668070927
STAT,1885,27,30-34,1912,0.24867498902393198
STAT,1840,16,45-49,1856,6.666477196953199E-4
STAT,1877,42,20-24,1919,0.001637346754668924
STAT,1872,27,45-49,1899,0.011360290721573456
SIM,1861,10,na,1871,33
STAT,1833,40,40-44,1873,0.020702082518519887
SIM,1843,56,na,1899,18
SIM,1850,58,na,1908,18
STAT,1945,22,20-24,1967,1.2099299896635314
STAT,1890,45,40-44,1935,0.0021003037916493402
STAT,1818,36,30-34,1854,0.07875569864927033
STAT,1832,31,35-39,1863,0.05980084873364992
STAT,1800,63,na,1863,7.939865811841628
STAT,1871,45,30-34,1916,9.747179425529325E-4
STAT,1816,45,50-100,1861,0.003190744646535043
STAT,1920,22,50-100,1942,0.0072528245434061184
STAT,1804,77,na,1881,4.074141209829723
STAT,1871,75,na,1946,10.263740576554106
STAT,1845,17,35-39,1862,0.004053965752444819
STAT,1847,25,45-49,1872,0.014462859607910519
STAT,1881,31,30-34,1912,0.16681573501655989
SIM,1876,51,na,1927,27
STAT,1817,95,na,1912,0.10537222324066836
STAT,1875,89,na,1964,2.414288421559551
STAT,1895,41,25-29,1936,5.815465921854593E-4
SIM,1838,34,na,1872,10
STAT,1870,20,15-19,1890,0.032967665216669745
STAT,1934,10,na,1944,53.5281694559127
STAT,1840,49,45-49,1889,0.0018176697715495836
STAT,1893,33,15-19,1926,0.0017880087439413191
STAT,1854,48,35-39,1902,8.449767654468458E-4
STAT,1836,32,30-34,1868,0.21298766934863703
STAT,1860,34,15-19,1894,0.001147823454405548
SIM,1844,32,30-34,1876,1
STAT,1871,41,15-19,1912,1.3830703809916632E-4
SIM,1865,35,na,1900,24
STAT,1819,54,na,1873,12.316846039449143
STAT,1849,52,na,1901,16.606596364573868
STAT,1938,24,na,1962,35.87923965903816
STAT,1870,33,20-24,1903,0.026738562022576757
SIM,1869,49,na,1918,15
STAT,1820,37,25-29,1857,0.027147357406237606
STAT,1866,42,45-49,1908,0.01376680986526416
STAT,1846,76,na,1922,7.678025541622564
STAT,1880,27,30-34,1907,0.26480104603734234
STAT,1880,18,40-44,1898,0.0019182836642940456
STAT,1865,90,na,1955,0.7131029497270859
STAT,1842,62,na,1904,13.713081987228145
STAT,1826,42,15-19,1868,1.4618766158688723E-4
STAT,1832,47,45-49,1879,0.00125481931317825
SIM,1856,74,na,1930,7
SIM,1852,60,na,1912,19
STAT,1924,20,35-39,1944,0.11104250183888498
STAT,1913,16,na,1929,39.25512109922735
STAT,1827,29,35-39,1856,0.10423271625144244
STAT,1863,43,30-34,1906,0.010105603286571115
STAT,1882,35,40-44,1917,0.04234994465314713
STAT,1891,20,35-39,1911,0.07204991081115807
STAT,1813,101,na,1914,0.0037658619810894516
STAT,1840,41,35-39,1881,0.014992443761594618
SIM,1899,9,na,1908,29
SIM,1930,16,na,1946,48
STAT,1815,44,40-44,1859,0.03314431855728701
SIM,1837,34,40-44,1871,3
STAT,1867,35,15-19,1902,5.424805449170759E-4
STAT,1799,92,na,1891,0.15386847996649242
STAT,1839,74,na,1913,6.1244367436014215
SIM,1899,68,na,1967,21
STAT,1819,86,na,1905,1.1389560363719538
STAT,1849,38,25-29,1887,0.022608441557947737
STAT,1890,15,50-100,1905,5.978707180431745E-4
STAT,1831,27,35-39,1858,0.10550290673333136
STAT,1887,47,35-39,1934,0.0015209867061117194
STAT,1836,24,30-34,1860,0.22362408551041577
SIM,1891,40,na,1931,34
STAT,1851,28,15-19,1879,0.004452545207481853
STAT,1818,69,na,1887,3.95967479463558
STAT,1918,23,15-19,1941,0.05671653889854978
STAT,1834,44,15-19,1878,1.1467500308364641E-4
SIM,1895,54,na,1949,25
STAT,1869,40,20-24,1909,0.001554332315669441
STAT,1814,55,na,1869,11.951543096179615
SIM,1839,19,na,1858,22
STAT,1884,18,50-100,1902,4.787412894401327E-4
STAT,1876,38,20-24,1914,0.007790261665004012
STAT,1884,48,20-24,1932,1.1609296423616835E-4
STAT,1856,24,50-100,1880,0.003381899635150823
STAT,1829,34,40-44,1863,0.04029727739315016
STAT,1946,11,na,1957,43.26792963967791
STAT,1896,25,40-44,1921,0.03961475861518151
SIM,1926,43,na,1969,46
STAT,1833,51,45-49,1884,1.1294700735449612E-4
STAT,1868,27,30-34,1895,0.2436966519466192
STAT,1888,32,na,1920,27.886383997148076
STAT,1838,57,na,1895,15.597683488736285
SIM,1858,22,na,1880,27
STAT,1880,30,25-29,1910,0.10857218231973789
STAT,1851,31,45-49,1882,0.015482781848553465
STAT,1872,28,35-39,1900,0.0983774489809417
STAT,1846,46,35-39,1892,0.0011378206952622513
STAT,1962,7,na,1969,50.059127153438986
SIM,1964,5,na,1969,52
STAT,1872,19,45-49,1891,6.647761272889993E-4
SIM,1821,77,na,1898,2
STAT,1896,42,30-34,1938,0.001047374596307957
SIM,1872,37,na,1909,21
STAT,1775,102,na,1877,0.0012730946778676164
STAT,1857,37,20-24,1894,0.0057706367192223475
STAT,1874,44,45-49,1918,0.014978340162750278
STAT,1863,88,na,1951,1.2155056308513466
STAT,1891,28,45-49,1919,0.013579489908817851
STAT,1888,26,45-49,1914,0.013019507155395347
STAT,1834,43,na,1877,17.683633088996842
SIM,1851,43,na,1894,17
STAT,1882,47,50-100,1929,0.002342719285764376
STAT,1914,25,50-100,1939,0.010018470263222284
STAT,1807,53,45-49,1860,2.915199434316706E-4
STAT,1931,18,50-100,1949,0.004869360882821077
STAT,1862,22,30-34,1884,0.15731853680359528
SIM,1951,6,na,1957,51
STAT,1851,87,na,1938,1.4873726366976765
STAT,1917,30,45-49,1947,0.016459283779107665
STAT,1791,103,na,1894,2.634227448085789E-4
SIM,1880,88,na,1968,4
STAT,1852,32,15-19,1884,0.0012619151676915676
STAT,1901,15,na,1916,35.504218321484146
STAT,1905,29,na,1934,34.19711768924512
STAT,1869,33,50-100,1902,0.00884041783191814
STAT,1877,15,50-100,1892,5.080737528970349E-4
STAT,1878,37,40-44,1915,0.045194107408516725
STAT,1841,42,40-44,1883,0.02287763480910355
STAT,1855,24,40-44,1879,0.016894670834865545
STAT,1822,42,na,1864,9.816740854133581
STAT,1826,56,na,1882,15.26443231652966
STAT,1859,16,25-29,1875,0.05259190225974957
STAT,1856,45,40-44,1901,0.001252594451076469
STAT,1845,34,25-29,1879,0.06972611301624504
SIM,1793,64,na,1857,18
STAT,1897,68,na,1965,22.772189799566103
STAT,1863,34,40-44,1897,0.0380684429818949
STAT,1842,18,20-24,1860,0.1698006839680066
STAT,1893,54,na,1947,26.402953297533273
STAT,1895,30,20-24,1925,0.03537468087235165
STAT,1868,47,25-29,1915,5.548225629830543E-4
STAT,1873,32,35-39,1905,0.10296113299130569
STAT,1880,38,35-39,1918,0.07400662199236624
STAT,1814,51,35-39,1865,2.4126679928470864E-4
SIM,1930,3,na,1933,55
STAT,1881,42,35-39,1923,0.017209465887930816
STAT,1853,44,25-29,1897,0.0039813601085866455
STAT,1889,17,na,1906,30.921796494142814
STAT,1900,45,25-29,1945,4.550413569269681E-4
STAT,1842,19,na,1861,21.85583973373282
STAT,1877,16,na,1893,26.134878993354135
STAT,1924,32,na,1956,43.837377225920726
STAT,1835,37,20-24,1872,0.004323054525560873
STAT,1830,47,35-39,1877,1.3892052262542696E-4
SIM,1837,71,na,1908,22
STAT,1809,46,30-34,1855,0.003354265275813532
SIM,1848,9,na,1857,33
STAT,1896,17,40-44,1913,0.0024024975107668307
STAT,1847,106,na,1953,1.2970202424306395E-4
STAT,1899,18,20-24,1917,0.24205597537433407
STAT,1916,13,na,1929,41.47835538778309
STAT,1901,49,35-39,1950,0.001081953840401883
SIM,1852,34,30-34,1886,2
STAT,1919,35,25-29,1954,0.010544495263208126
STAT,1853,28,25-29,1881,0.27825210505159165
SIM,1866,73,na,1939,16
STAT,1846,30,25-29,1876,0.10015437347700643
STAT,1896,36,45-49,1932,0.026311196108760662
STAT,1893,49,25-29,1942,4.011204580881866E-4
STAT,1844,22,15-19,1866,0.03217366854285767
SIM,1923,46,na,1969,37
SIM,1857,3,na,1860,29
STAT,1883,50,45-49,1933,1.4295254812355567E-4
SIM,1858,54,na,1912,24
STAT,1895,38,30-34,1933,0.06884833243733367
STAT,1952,15,15-19,1967,0.5409307680463638
STAT,1869,72,na,1941,12.236711584115794
STAT,1850,27,45-49,1877,0.011633551025474767
STAT,1869,47,40-44,1916,0.00165109413683066
SIM,1874,17,na,1891,28
SIM,1963,4,na,1967,54
STAT,1829,45,45-49,1874,0.002067256746840571
SIM,1865,7,na,1872,25
STAT,1907,49,50-100,1956,0.001994833308288716
STAT,1946,17,40-44,1963,0.015404317326559717
STAT,1842,26,20-24,1868,0.10963535392278848
STAT,1922,20,na,1942,41.81909364684112
STAT,1864,34,35-39,1898,0.09005430533194743
STAT,1841,77,na,1918,8.460798668060033
STAT,1883,31,40-44,1914,0.04228515061752482
STAT,1836,35,35-39,1871,0.08554317829383615
STAT,1875,32,45-49,1907,0.017925483631981966
STAT,1893,41,15-19,1934,1.7491288923567475E-4
STAT,1894,71,na,1965,19.83205926234551
STAT,1887,38,45-49,1925,0.021651136732368882
STAT,1851,24,20-24,1875,0.6848185508705774
STAT,1859,51,na,1910,17.195623189425287
STAT,1827,41,na,1868,16.475260325634565
STAT,1890,21,30-34,1911,0.21701954802131943
STAT,1870,40,50-100,1910,0.010600567464112988
STAT,1910,27,40-44,1937,0.044734442116983006
SIM,1798,63,na,1861,9
STAT,1827,37,35-39,1864,0.05788494828525171
STAT,1816,89,na,1905,0.3153894072298948
STAT,1844,34,30-34,1878,0.159732181821478
STAT,1834,27,25-29,1861,0.39199050258588813
SIM,1877,36,na,1913,28
STAT,1849,39,15-19,1888,4.3638987613098376E-4
STAT,1870,41,20-24,1911,0.0015847689306012292
STAT,1894,28,35-39,1922,0.12322460144350884
STAT,1847,17,45-49,1864,8.709220933471781E-4
STAT,1839,40,35-39,1879,0.011874324766357868
STAT,1880,26,40-44,1906,0.031608044411856336
STAT,1837,32,25-29,1869,0.06267532006111175
STAT,1844,10,na,1854,24.0
STAT,1821,42,15-19,1863,2.1528783702449874E-4
STAT,1841,88,na,1929,1.343752164719095
STAT,1809,47,20-24,1856,4.0939578542488643E-4
STAT,1874,52,45-49,1926,1.4644342762642828E-4
STAT,1899,16,na,1915,34.65878562500657
STAT,1857,40,50-100,1897,0.007988485204124613
STAT,1853,27,35-39,1880,0.07025070438635833
STAT,1812,52,50-100,1864,1.6374077132466888E-4
STAT,1847,22,40-44,1869,0.02728861062289106
STAT,1835,28,50-100,1863,0.003794684827666048
STAT,1884,50,na,1934,21.39885654293212
STAT,1885,23,15-19,1908,0.03247768371538509
STAT,1826,40,50-100,1866,0.011602696563377394
STAT,1939,20,30-34,1959,0.28686061960586184
STAT,1888,64,na,1952,20.314422212875783
STAT,1860,59,na,1919,15.799833134927697
STAT,1871,51,50-100,1922,1.5129490798874656E-4
STAT,1870,36,25-29,1906,0.028739277168902125
STAT,1853,42,50-100,1895,0.006631427211838752
STAT,1862,39,na,1901,20.121960161322548
SIM,1819,74,na,1893,1
STAT,1853,20,15-19,1873,0.024853407835755948
STAT,1887,39,35-39,1926,0.0764244866282565
STAT,1783,77,na,1860,1.6987834495059795
STAT,1937,31,25-29,1968,0.09091783409920919
STAT,1886,32,20-24,1918,0.02803791775366155
STAT,1870,24,30-34,1894,0.17583747929956245
STAT,1825,34,20-24,1859,0.029743624442102226
STAT,1926,42,50-100,1968,0.0014400055524978557
STAT,1898,38,20-24,1936,0.002233347967780253
STAT,1781,86,na,1867,1.0129970405911612
STAT,1844,21,na,1865,21.002850604496054
STAT,1853,33,20-24,1886,0.017313627811260557
SIM,1815,60,na,1875,10
SIM,1898,8,na,1906,37
STAT,1870,69,na,1939,14.578408441045518
STAT,1890,40,35-39,1930,0.022217955100199152
STAT,1890,48,45-49,1938,0.001596738504459168
STAT,1831,26,45-49,1857,0.012349986180290458
SIM,1896,28,na,1924,32
STAT,1920,41,35-39,1961,0.0022082204007805185
STAT,1834,54,50-100,1888,1.0518481987641389E-4
STAT,1876,37,30-34,1913,0.05412963030235978
STAT,1799,81,na,1880,2.3480797741572323
STAT,1829,26,40-44,1855,0.04655364141025961
SIM,1894,16,na,1910,31
STAT,1841,21,35-39,1862,0.07288111042133597
STAT,1906,38,30-34,1944,0.01662946523188325
STAT,1855,35,45-49,1890,0.014168835409002238
STAT,1885,29,50-100,1914,0.006271907877322689
STAT,1838,44,35-39,1882,0.01457880722621192
SIM,1847,70,na,1917,10
STAT,1862,53,50-100,1915,1.2820905575505753E-4
STAT,1876,41,50-100,1917,0.010778358549103592
STAT,1909,43,na,1952,34.33554184131227
STAT,1819,41,20-24,1860,0.0015336443106095552
STAT,1848,35,na,1883,16.030580572879277
SIM,1927,28,na,1955,47
STAT,1887,31,25-29,1918,0.1122556996528355
STAT,1903,19,50-100,1922,6.927984261860002E-4
STAT,1892,25,20-24,1917,0.14591450722793248
STAT,1855,41,30-34,1896,0.008131092570003103
SIM,1923,14,na,1937,42
STAT,1821,45,50-100,1866,0.0035758529627951544
STAT,1863,18,40-44,1881,0.0016716932584789194
STAT,1866,19,20-24,1885,0.16562167265957292
STAT,1882,51,40-44,1933,1.013737996081677E-4
STAT,1846,37,45-49,1883,0.016871169077948896
STAT,1875,28,25-29,1903,0.4333035261437447
STAT,1911,43,35-39,1954,0.00189808353893275
STAT,1906,14,na,1920,37.39763771356513
STAT,1911,38,50-100,1949,0.004009127986094466
STAT,1845,31,20-24,1876,0.018983195763837547
STAT,1920,49,45-49,1969,0.0023680789558209957
STAT,1879,71,na,1950,13.815319831624278
SIM,1904,32,na,1936,29
STAT,1846,18,40-44,1864,0.00185109783978555
STAT,1863,46,35-39,1909,0.0012430759908382567
STAT,1862,31,20-24,1893,0.023416339291879057
SIM,1864,18,na,1882,23
SIM,1908,46,na,1954,38
STAT,1875,7,na,1882,27.75918821966363
STAT,1894,21,15-19,1915,0.042407671436152976
STAT,1861,26,30-34,1887,0.2148497413538678
STAT,1887,44,30-34,1931,0.012379333610865429
STAT,1941,20,35-39,1961,0.09666705285124122
STAT,1795,100,na,1895,0.0025987967376545043
STAT,1919,40,20-24,1959,1.90249438512798E-4
SIM,1905,17,na,1922,40
STAT,1898,53,na,1951,28.580665326194744
STAT,1831,78,na,1909,6.340465746956974
STAT,1892,42,50-100,1934,0.013035418857769798
SIM,1841,22,na,1863,19
STAT,1892,5,na,1897,32.37556856677298
STAT,1884,1,na,1885,32.56841645453603
STAT,1811,44,20-24,1855,0.006542640050148526
SIM,1845,36,na,1881,22
STAT,1880,68,na,1948,16.069808594249558
STAT,1865,30,35-39,1895,0.09233430822115549
STAT,1867,3,na,1870,30.37383073123385
STAT,1830,93,na,1923,0.1050045310599174
STAT,1838,20,50-100,1858,0.0041659379577536305
STAT,1828,49,45-49,1877,9.857141120925678E-4
STAT,1855,50,50-100,1905,1.0786196364561987E-4
STAT,1827,43,20-24,1870,0.0012250511360774976
STAT,1872,20,25-29,1892,0.5892147806768772
STAT,1867,30,50-100,1897,0.008838587903110078
STAT,1873,41,25-29,1914,0.006558304292289969
STAT,1842,33,45-49,1875,0.015641961301777717
STAT,1899,27,na,1926,32.66991914138581
STAT,1897,33,35-39,1930,0.13391540169541005
STAT,1901,29,40-44,1930,0.04161641529441013
STAT,1868,39,25-29,1907,0.027582863772298783
STAT,1771,97,na,1868,0.01465381612236403
STAT,1855,16,40-44,1871,0.0015407432644860492
SIM,1861,21,na,1882,29
STAT,1894,34,20-24,1928,0.034345589070226064
SIM,1876,39,25-29,1915,1
STAT,1900,37,25-29,1937,0.008617527117513917
STAT,1886,20,na,1906,24.678223465010287
STAT,1807,96,na,1903,0.036238560963794145
STAT,1947,16,45-49,1963,0.0055902635676454045
STAT,1936,27,50-100,1963,0.009468076541481981
SIM,1881,73,na,1954,7
STAT,1871,21,20-24,1892,0.6891320975535896
STAT,1806,50,25-29,1856,1.1940609788869231E-4
STAT,1888,18,45-49,1906,7.613575108668359E-4
STAT,1835,36,30-34,1871,0.03021384485643217
STAT,1892,37,15-19,1929,6.937377487793305E-4
STAT,1895,34,na,1929,30.715166178952966
STAT,1945,25,25-29,1970,0.7175529704663738
STAT,1852,40,15-19,1892,1.1938377125787434E-4
STAT,1936,15,30-34,1951,0.11652831274809339
SIM,1896,23,40-44,1919,1
STAT,1899,48,na,1947,30.417492961023033
STAT,1827,38,25-29,1865,0.023224517645430896
STAT,1924,20,50-100,1944,0.007759784405008256
STAT,1941,12,na,1953,40.28271761534164
STAT,1852,36,30-34,1888,0.04633927985792186
STAT,1837,47,45-49,1884,0.0011924812297364538
STAT,1955,15,40-44,1970,0.018473256420998858
STAT,1816,40,40-44,1856,0.032325192095099514
STAT,1945,26,na,1971,40.822276224889634
STAT,1894,29,25-29,1923,0.538256862619326
STAT,1909,25,15-19,1934,0.006811737778423602
STAT,1802,97,na,1899,0.016407105283798018
STAT,1968,4,na,1972,48.795564746592454
STAT,1868,38,35-39,1906,0.06810836388794086
SIM,1914,6,na,1920,38
STAT,1774,103,na,1877,2.192822547410586E-4
STAT,1856,32,35-39,1888,0.07426206120644195
STAT,1900,42,20-24,1942,1.527392089487246E-4
STAT,1817,48,30-34,1865,0.002758596262709143
STAT,1879,45,35-39,1924,0.0014634600493187188
SIM,1779,81,na,1860,3
STAT,1846,38,35-39,1884,0.05924082197563708
STAT,1919,15,30-34,1934,0.02691415781154697
STAT,1837,28,40-44,1865,0.01870424817087885
STAT,1888,21,50-100,1909,0.004779817947786998
STAT,1970,0,na,1970,49.254614331735205
SIM,1849,18,na,1867,14
STAT,1901,48,50-100,1949,0.0019141735008474168
STAT,1915,36,50-100,1951,0.004224999497646049
SIM,1826,44,na,1870,16
STAT,1836,48,40-44,1884,0.0017070792099414783
STAT,1827,30,15-19,1857,0.0013654988131858005
SIM,1885,29,25-29,1914,1
STAT,1866,21,na,1887,22.118320448333662
STAT,1898,45,45-49,1943,0.0018137429891368379
STAT,1826,88,na,1914,0.959360915727217
STAT,1862,25,35-39,1887,0.08476732007705777
STAT,1888,23,40-44,1911,0.024276103415033178
STAT,1861,27,20-24,1888,0.0993730463897178
SIM,1912,51,na,1963,35
STAT,1846,43,30-34,1889,0.009309985484570805
STAT,1847,42,35-39,1889,0.01945166744987684
STAT,1877,29,25-29,1906,0.4335401956513444
SIM,1932,28,na,1960,47
STAT,1926,25,15-19,1951,0.00847144457454692
STAT,1893,17,15-19,1910,0.07482740708002816
STAT,1878,33,25-29,1911,0.10530019494737154
STAT,1883,27,20-24,1910,0.11392194891851627
STAT,1887,19,40-44,1906,0.0019856947475627427
STAT,1893,20,45-49,1913,0.008844830115904891
STAT,1936,12,na,1948,37.70522890315202
STAT,1847,38,15-19,1885,6.159561492737014E-4
STAT,1821,37,40-44,1858,0.08947980364534477
STAT,1896,21,25-29,1917,0.7542118933045708
STAT,1928,16,35-39,1944,0.05274333093605469
STAT,1849,73,na,1922,9.209730772162326
STAT,1922,20,25-29,1942,1.0577818742980227
STAT,1829,29,45-49,1858,0.011135511175820777
SIM,1886,72,na,1958,10
STAT,1776,96,na,1872,0.010497175963129757
STAT,1861,22,15-19,1883,0.02850179731647205
STAT,1844,18,30-34,1862,0.015732408721869474
STAT,1865,43,40-44,1908,0.02019745175823349
STAT,1794,101,na,1895,0.0012379873014006283
STAT,1834,24,20-24,1858,0.6419918222392778
SIM,1933,13,na,1946,54
STAT,1825,43,50-100,1868,0.010085265109737208
STAT,1833,27,45-49,1860,0.010834198506062442
STAT,1863,27,50-100,1890,0.005663821136087811
STAT,1878,30,20-24,1908,0.028131172184546804
STAT,1902,32,na,1934,33.65143984952815
STAT,1879,50,na,1929,22.605752937453197
SIM,1860,36,na,1896,25
STAT,1823,33,35-39,1856,0.09379260440779107
SIM,1837,30,25-29,1867,2
STAT,1868,44,20-24,1912,0.0015161603154476807
STAT,1894,25,30-34,1919,0.3249186851839639
STAT,1905,16,40-44,1921,0.0026462158051825824
STAT,1828,42,25-29,1870,0.002830623357038211
STAT,1906,46,na,1952,32.78493908865297
SIM,1913,16,40-44,1929,1
STAT,1844,37,35-39,1881,0.05838008717615944
STAT,1883,34,45-49,1917,0.016788952484302188
STAT,1934,2,na,1936,55.08491854049787
STAT,1857,17,na,1874,20.19696452306885
STAT,1895,33,25-29,1928,0.13241399141219937
STAT,1878,86,na,1964,4.318267797951295
STAT,1857,41,40-44,1898,0.01691444883625765
STAT,1922,38,15-19,1960,2.1668995530773258E-4
SIM,1930,20,25-29,1950,3
STAT,1876,8,na,1884,27.13930215115173
STAT,1816,43,45-49,1859,0.020078161507981397
STAT,1810,103,na,1913,5.158593149786955E-4
STAT,1829,30,25-29,1859,0.10061805836144191
STAT,1851,20,50-100,1871,0.004170926024335733
STAT,1885,47,25-29,1932,5.661567102294969E-4
STAT,1904,16,50-100,1920,7.037241904644353E-4
STAT,1874,72,na,1946,12.81196030578009
STAT,1831,23,40-44,1854,0.0681237497994263
SIM,1937,27,na,1964,36
STAT,1836,77,na,1913,8.342292539184317
STAT,1864,31,30-34,1895,0.15724016813500333
SIM,1871,8,na,1879,27
STAT,1915,30,35-39,1945,0.0930086741019752
STAT,1858,49,30-34,1907,7.212149261002227E-4
STAT,1917,15,20-24,1932,0.2904386686695963
SIM,1801,57,na,1858,9
STAT,1872,38,50-100,1910,0.012499591125456903
STAT,1897,32,50-100,1929,0.012167332268861054
STAT,1896,29,35-39,1925,0.1258362985715221
STAT,1866,50,45-49,1916,1.3557735855509252E-4
STAT,1877,49,40-44,1926,0.0017303324947398621
SIM,1836,22,na,1858,10
STAT,1844,46,25-29,1890,4.511881278257184E-4
STAT,1829,38,35-39,1867,0.06424473563323146
STAT,1835,32,15-19,1867,8.247938264434848E-4
SIM,1830,26,30-34,1856,2
STAT,1852,16,15-19,1868,0.06179344650895934
STAT,1925,38,40-44,1963,0.017836681802862474
STAT,1938,15,40-44,1953,0.013770241445010729
STAT,1886,26,35-39,1912,0.10042854987916888
STAT,1854,36,40-44,1890,0.0268856123100014
STAT,1875,29,15-19,1904,0.004630466669954241
SIM,1868,32,na,1900,30
STAT,1831,32,30-34,1863,0.18417816760912503
STAT,1885,19,30-34,1904,0.01565528802702084
SIM,1842,24,20-24,1866,2
SIM,1897,13,na,1910,43
SIM,1806,56,na,1862,7
STAT,1902,45,50-100,1947,0.0019731335268272916
STAT,1838,41,30-34,1879,0.010569914677237518
STAT,1859,83,na,1942,3.1553196804665244
STAT,1948,20,45-49,1968,0.01284266625288069
STAT,1931,13,na,1944,51.55247565680235
STAT,1935,27,na,1962,50.83857328641554
STAT,1874,28,45-49,1902,0.011224280745495729
SIM,1861,24,30-34,1885,1
STAT,1822,45,35-39,1867,7.89339996123003E-4
SIM,1869,17,na,1886,17
SIM,1873,54,na,1927,22
STAT,1838,16,40-44,1854,0.0018862370827222113
STAT,1928,25,25-29,1953,0.8124088226880778
STAT,1915,50,na,1965,36.36890560940893
SIM,1877,68,na,1945,17
SIM,1862,32,25-29,1894,1
STAT,1804,56,na,1860,12.431435254397789
STAT,1819,35,35-39,1854,0.08859671299330783
SIM,1835,37,na,1872,19
STAT,1903,41,35-39,1944,0.0017958707590650907
STAT,1888,39,15-19,1927,6.496165305274373E-4
SIM,1831,23,na,1854,11
STAT,1850,92,na,1942,0.3708317625618581
STAT,1853,24,30-34,1877,0.13037734313390517
SIM,1860,25,na,1885,27
STAT,1843,33,50-100,1876,0.004624238408727711
SIM,1857,91,na,1948,1
SIM,1936,25,25-29,1961,1
STAT,1849,42,45-49,1891,0.011590530295650485
STAT,1864,22,40-44,1886,0.018990711518263276
STAT,1885,28,20-24,1913,0.11544202741469843
STAT,1887,35,40-44,1922,0.0482345618651025
STAT,1840,17,35-39,1857,0.005566858814267455
STAT,1931,31,30-34,1962,0.2056489988963793
SIM,1893,28,20-24,1921,1
STAT,1808,59,na,1867,3.9746932838648945
STAT,1818,37,20-24,1855,0.010575582285098126
STAT,1854,32,25-29,1886,0.06411271770402639
STAT,1832,40,25-29,1872,0.003623616621676258
SIM,1848,55,na,1903,29
STAT,1921,35,na,1956,41.752575770415405
STAT,1859,38,50-100,1897,0.009709905625748427
STAT,1852,45,20-24,1897,1.0372568197885205E-4
STAT,1837,37,30-34,1874,0.03161982047133472
STAT,1903,49,45-49,1952,0.0018531457926019665
STAT,1842,30,40-44,1872,0.040130892847634485
STAT,1860,21,45-49,1881,0.005886227347139217
SIM,1805,82,na,1887,2
STAT,1875,25,20-24,1900,0.12141067399208423
SIM,1870,38,40-44,1908,1
STAT,1922,44,50-100,1966,0.0013341023302090014
STAT,1848,105,na,1953,1.8961670933488682E-4
STAT,1909,16,25-29,1925,0.08471259635244702
STAT,1871,40,25-29,1911,0.006466909513500859
STAT,1860,38,30-34,1898,0.04311310592823696
STAT,1825,37,25-29,1862,0.030183556953461917
STAT,1920,50,na,1970,39.901980573668816
STAT,1855,44,35-39,1899,0.012577300396205925
STAT,1791,96,na,1887,0.015151931017791352
STAT,1869,18,35-39,1887,0.0053585439268296195
STAT,1884,35,15-19,1919,5.554004960511426E-4
STAT,1847,31,50-100,1878,0.011611927643401833
STAT,1834,28,15-19,1862,0.004174094886477834
STAT,1932,28,30-34,1960,0.5108874362690347
STAT,1892,28,25-29,1920,0.520755452700248
STAT,1916,42,45-49,1958,0.001690953894776748
STAT,1846,34,40-44,1880,0.040680115485211006
SIM,1940,28,30-34,1968,1
STAT,1919,29,50-100,1948,0.01058522403314606
STAT,1924,6,na,1930,47.4189864050204
STAT,1822,74,na,1896,3.936593317449018
STAT,1872,17,na,1889,25.926250943065607
STAT,1889,39,45-49,1928,0.02416124520549462
STAT,1850,32,40-44,1882,0.04039265129729726
STAT,1890,15,45-49,1905,7.971609573908996E-4
STAT,1852,40,na,1892,19.980298590641226
STAT,1944,17,30-34,1961,0.13021899053003178
STAT,1862,34,25-29,1896,0.08761298244968727
STAT,1908,40,45-49,1948,0.0015491638166322764
STAT,1832,27,15-19,1859,0.0027142892103924022
STAT,1838,35,45-49,1873,0.01906157410194348
STAT,1897,30,30-34,1927,0.23372096105466225
STAT,1838,47,50-100,1885,0.001961106624140805
STAT,1859,29,30-34,1888,0.20069151014254683
STAT,1870,27,35-39,1897,0.09585135349364501
STAT,1842,36,50-100,1878,0.010918568034556158
STAT,1828,46,40-44,1874,7.427796670308947E-4
STAT,1870,58,na,1928,19.645227589126556
STAT,1811,47,25-29,1858,0.0022810276367929215
STAT,1907,22,50-100,1929,0.005964960554479937
STAT,1791,85,na,1876,0.8291735887383007
STAT,1875,44,50-100,1919,0.01071312866904657
STAT,1901,47,na,1948,31.340382689663638
STAT,1939,23,35-39,1962,0.09388254987566486
SIM,1853,55,na,1908,21
SIM,1857,69,na,1926,10
STAT,1895,37,40-44,1932,0.056831159270543496
STAT,1871,48,35-39,1919,0.0013782622194773223
STAT,1880,31,15-19,1911,0.0015036120024889516
STAT,1882,22,35-39,1904,0.05592396028327538
SIM,1947,7,na,1954,43
STAT,1821,89,na,1910,0.6524754441152828
STAT,1868,35,30-34,1903,0.052066569201276724
SIM,1840,59,na,1899,8
SIM,1825,59,na,1884,14
STAT,1885,35,na,1920,23.486579874269143
STAT,1851,55,na,1906,17.45627708935552
SIM,1855,25,na,1880,20
SIM,1821,45,na,1866,14
STAT,1881,21,na,1902,22.572407734165118
STAT,1857,44,45-49,1901,0.011052736108306937
STAT,1855,69,na,1924,10.332530032136685
STAT,1837,40,na,1877,12.306697524475203
SIM,1851,11,na,1862,27
STAT,1898,42,40-44,1940,0.0021044687068729195
STAT,1855,19,45-49,1874,5.405992867650132E-4
STAT,1900,18,50-100,1918,6.775816304371795E-4
STAT,1911,48,40-44,1959,0.0014788518894588178
SIM,1854,40,na,1894,17
SIM,1872,69,na,1941,13
STAT,1877,17,30-34,1894,0.01645289357844194
STAT,1877,26,20-24,1903,0.12151478369786604
STAT,1806,54,40-44,1860,3.27648129191662E-4
STAT,1840,42,25-29,1882,0.005248990924023849
STAT,1881,22,50-100,1903,0.003880302871820122
STAT,1936,18,35-39,1954,0.03982616079830217
STAT,1940,27,na,1967,37.929341720450864
STAT,1890,57,na,1947,24.41104596571728
STAT,1888,48,50-100,1936,0.0015986199945927531
SIM,1900,29,na,1929,33
STAT,1836,19,35-39,1855,0.007031726391515076
STAT,1889,49,na,1938,26.975399026403792
STAT,1867,27,15-19,1894,0.004341754378301994
STAT,1891,33,40-44,1924,0.05300266915268868
STAT,1858,17,20-24,1875,0.1575861671418135
SIM,1883,21,na,1904,15
STAT,1905,41,30-34,1946,0.0011574298697131576
STAT,1889,31,35-39,1920,0.12449557653699381
STAT,1872,33,30-34,1905,0.1778887542652037
STAT,1896,35,50-100,1931,0.016280001735346154
STAT,1881,43,25-29,1924,0.006066262919025478
STAT,1824,42,40-44,1866,0.030482944653942284
STAT,1878,38,30-34,1916,0.05475057998126887
STAT,1934,30,45-49,1964,0.021417803764120787
STAT,1862,43,15-19,1905,1.1828563892326061E-4
STAT,1851,27,25-29,1878,0.41813985573767254
STAT,1860,18,15-19,1878,0.055315682974596256
STAT,1817,44,15-19,1861,4.108185640929262E-4
STAT,1862,38,40-44,1900,0.03758021894657613
SIM,1887,35,na,1922,24
STAT,1852,48,25-29,1900,4.867743980874008E-4
SIM,1905,1,na,1906,40
SIM,1860,39,35-39,1899,1
STAT,1823,59,na,1882,12.071964756202389
STAT,1827,34,30-34,1861,0.14639799590961014
SIM,1891,72,na,1963,26
SIM,1907,4,na,1911,41
STAT,1852,39,35-39,1891,0.059924229383701594
STAT,1803,82,na,1885,1.9018663105114944
STAT,1883,0,na,1883,34.39586575600256
STAT,1846,34,50-100,1880,0.008594745567271996
STAT,1911,40,30-34,1951,0.0012260916160636692
STAT,1879,42,50-100,1921,0.01092092066006235
SIM,1790,67,na,1857,2
SIM,1820,60,na,1880,9
SIM,1824,74,na,1898,10
STAT,1835,92,na,1927,0.18733608646418096
SIM,1913,5,na,1918,47
STAT,1868,31,15-19,1899,0.0013837755413611008
SIM,1903,47,na,1950,35
STAT,1879,42,30-34,1921,0.011884531332617857
STAT,1834,31,45-49,1865,0.015950033040593465
STAT,1879,36,45-49,1915,0.02073209347372095
STAT,1923,41,50-100,1964,0.0013655544088843315
STAT,1918,5,na,1923,43.36766101577159
STAT,1913,43,45-49,1956,0.0016068804577921208
SIM,1845,58,na,1903,21
STAT,1888,27,35-39,1915,0.11275718794218537
STAT,1820,40,na,1860,15.924308559726141
STAT,1883,18,45-49,1901,6.326727800245039E-4
STAT,1903,17,na,1920,35.907380302447145
STAT,1886,19,25-29,1905,0.05846384511892678
STAT,1841,38,20-24,1879,0.00879787865523026
STAT,1911,35,35-39,1946,0.023431814423994418
STAT,1882,9,na,1891,24.865504882391157
STAT,1892,23,50-100,1915,0.005022306854620894
STAT,1858,88,na,1946,1.044652184612949
STAT,1858,51,50-100,1909,1.154734353270399E-4
STAT,1914,36,15-19,1950,1.9105983470027224E-4
STAT,1788,76,na,1864,4.390215551590665
STAT,1916,44,25-29,1960,7.231163832017555E-4
STAT,1796,95,na,1891,0.005778907532671544
STAT,1861,37,35-39,1898,0.05948012357531209
STAT,1873,28,15-19,1901,0.00459652333403386
STAT,1859,38,20-24,1897,0.006096448026327424
STAT,1931,9,na,1940,51.87490246252491
STAT,1887,40,15-19,1927,1.522563331053831E-4
SIM,1928,13,na,1941,55
STAT,1828,26,25-29,1854,0.6903916471872643
SIM,1924,19,20-24,1943,2
STAT,1872,35,45-49,1907,0.02059047251769301
SIM,1879,70,na,1949,7
STAT,1798,96,na,1894,0.043636078628533276
STAT,1845,38,na,1883,14.320468674007463
STAT,1804,52,50-100,1856,4.14788630237768E-4
SIM,1910,49,na,1959,28
STAT,1862,18,na,1880,22.54824110284956
STAT,1901,31,45-49,1932,0.024500480151664103
STAT,1834,48,30-34,1882,7.162387476245656E-4
STAT,1836,25,20-24,1861,0.1486273572779439
STAT,1843,25,na,1868,11.457200522844959
SIM,1870,57,na,1927,21
STAT,1818,40,50-100,1858,0.012086266926349945
STAT,1826,49,35-39,1875,0.0013723237742331873
STAT,1933,26,50-100,1959,0.01316829798807556
STAT,1853,18,50-100,1871,3.6820778553562603E-4
STAT,1920,33,35-39,1953,0.09882595248179411
STAT,1866,38,25-29,1904,0.02638535117930037
STAT,1922,41,45-49,1963,0.0018990222934579936
STAT,1881,74,na,1955,10.560120335155638
STAT,1848,56,na,1904,13.190308298561494
STAT,1850,60,na,1910,16.980858424079724
STAT,1904,45,45-49,1949,0.0019265335560919518
STAT,1843,46,30-34,1889,4.1397495739970336E-4
STAT,1894,49,40-44,1943,0.001211805715306251
STAT,1938,31,40-44,1969,0.039111953993197696
SIM,1839,40,na,1879,21
STAT,1935,31,15-19,1966,0.00177099712084832
STAT,1864,24,50-100,1888,0.0036632065126212497
STAT,1863,27,30-34,1890,0.22295993909373524
SIM,1868,21,na,1889,36
STAT,1883,35,20-24,1918,0.007556662028977976
STAT,1865,36,na,1901,21.412079146212953
STAT,1900,34,20-24,1934,0.037161915717697086
STAT,1879,17,40-44,1896,0.0018930649430648778
STAT,1850,36,20-24,1886,0.007044826235306359
STAT,1921,42,40-44,1963,0.0027952355650570078
STAT,1803,60,na,1863,10.877603077434467
STAT,1940,26,15-19,1966,0.007150910537548099
STAT,1883,87,na,1970,4.273557412336191
STAT,1894,18,20-24,1912,0.22661213697643154
STAT,1929,20,35-39,1949,0.11920978932709542
STAT,1871,54,na,1925,20.876758761253747
STAT,1923,34,15-19,1957,0.0014610884791699474
STAT,1895,48,45-49,1943,0.0017065688426241244
SIM,1802,63,na,1865,11
STAT,1913,30,25-29,1943,0.09192125530912877
STAT,1827,27,20-24,1854,0.3456210857563979
STAT,1879,29,35-39,1908,0.0991536034161215
STAT,1873,55,na,1928,21.022291278047696
STAT,1875,36,na,1911,24.334645717019445
STAT,1924,43,20-24,1967,2.0836820016182232E-4
STAT,1907,46,25-29,1953,4.766148510174448E-4
STAT,1923,47,na,1970,42.679291160223
STAT,1812,43,na,1855,12.732396952793184
STAT,1822,41,40-44,1863,0.013043731561438107
SIM,1804,76,na,1880,7
SIM,1862,38,na,1900,23
STAT,1895,17,25-29,1912,0.07356859852280144
STAT,1932,30,35-39,1962,0.12112661147835019
STAT,1917,18,25-29,1935,0.0921640626755088
STAT,1845,18,25-29,1863,0.041620253643499784
STAT,1847,26,35-39,1873,0.1247849508722779
STAT,1934,37,50-100,1971,0.005769323619623346
STAT,1920,49,50-100,1969,0.0024644075872646385
STAT,1870,32,30-34,1902,0.17344283919355583
STAT,1916,19,20-24,1935,0.2836552353617772
SIM,1936,32,na,1968,37
STAT,1860,42,15-19,1902,1.121319228702521E-4
STAT,1939,19,15-19,1958,0.45085616230307507
STAT,1862,15,20-24,1877,0.17726203177752914
STAT,1911,24,50-100,1935,0.006161370494195586
STAT,1839,105,na,1944,1.6180793279689754E-4
STAT,1905,19,45-49,1924,9.377055690439416E-4
STAT,1871,36,40-44,1907,0.043853778245362095
SIM,1777,79,na,1856,1
SIM,1910,17,na,1927,33
STAT,1815,48,20-24,1863,1.7050956649097035E-4
STAT,1881,18,35-39,1899,0.005207526279091296
STAT,1848,38,45-49,1886,0.013148092006340956
STAT,1920,46,40-44,1966,0.0017322851842917833
STAT,1882,39,20-24,1921,0.007313031648707523
STAT,1894,36,35-39,1930,0.09108227190207005
STAT,1895,9,na,1904,33.684959892496835
STAT,1902,42,30-34,1944,0.0011244409558489666
STAT,1837,19,na,1856,14.544554594451444
STAT,1845,49,45-49,1894,0.001350731607980813
STAT,1926,18,50-100,1944,0.004555241076570715
STAT,1920,20,15-19,1940,0.05902543431810299
SIM,1869,70,na,1939,10
STAT,1854,29,50-100,1883,0.0040403297087183675
STAT,1851,40,35-39,1891,0.015441705571586499
STAT,1868,17,50-100,1885,4.8270088370298966E-4
STAT,1855,28,35-39,1883,0.07030268487635716
STAT,1929,42,na,1971,47.86667177088562
STAT,1835,38,na,1873,11.785509054068282
STAT,1900,52,na,1952,29.69945520167004
SIM,1916,12,na,1928,47
STAT,1824,46,20-24,1870,1.5734594025255329E-4
SIM,1907,61,na,1968,31
STAT,1937,24,50-100,1961,0.006362821603756024
STAT,1896,21,50-100,1917,0.005372645477194426
STAT,1838,28,35-39,1866,0.09457939320643924
STAT,1844,45,35-39,1889,0.0011107780260250155
STAT,1851,47,50-100,1898,0.0020637646733571114
STAT,1923,47,20-24,1970,1.2838348599862088E-4
STAT,1842,22,50-100,1864,0.003859013610601605
STAT,1848,88,na,1936,0.887812649893575
STAT,1885,15,50-100,1900,4.860498721158105E-4
STAT,1828,36,na,1864,18.99659801513392
STAT,1878,53,40-44,1931,1.0694417800085682E-4
SIM,1864,6,na,1870,23
STAT,1903,46,40-44,1949,0.001376880915372012
STAT,1786,95,na,1881,0.011183735962823751
STAT,1842,34,20-24,1876,0.023995781378512816
SIM,1936,0,na,1936,40
STAT,1818,91,na,1909,0.14481324441692128
STAT,1883,55,na,1938,20.07918316004621
STAT,1859,48,35-39,1907,0.0010987619824616955
STAT,1840,60,na,1900,14.94449269935359
SIM,1948,8,na,1956,41
STAT,1832,41,na,1873,11.705798970348315
STAT,1891,74,na,1965,16.62978254847138
STAT,1939,30,45-49,1969,0.015963324057350136
STAT,1870,17,20-24,1887,0.17779086225091417
STAT,1912,44,40-44,1956,0.0023749762929980824
STAT,1874,37,20-24,1911,0.007820195731553539
STAT,1825,93,na,1918,0.15755508545196262
SIM,1810,82,na,1892,7
STAT,1915,48,25-29,1963,5.284288041255571E-4
STAT,1838,68,na,1906,11.861053918283742
STAT,1928,41,25-29,1969,9.071936590136257E-4
STAT,1852,18,na,1870,23.62054066594331
SIM,1924,31,na,1955,52
STAT,1903,49,na,1952,31.32469718681507
STAT,1873,16,35-39,1889,0.005611738516794079
STAT,1844,50,45-49,1894,1.1498471816373995E-4
STAT,1778,76,na,1854,4.0
STAT,1915,28,na,1943,37.74660886548445
SIM,1856,42,na,1898,11
STAT,1885,43,30-34,1928,0.011271131471343745
SIM,1882,36,na,1918,31
STAT,1820,62,na,1882,10.718968275741338
STAT,1818,47,35-39,1865,0.001377354444344683
STAT,1835,47,35-39,1882,6.68227609966583E-4
STAT,1844,27,20-24,1871,0.11217522301513949
STAT,1875,49,30-34,1924,9.742721751021251E-4
STAT,1830,38,45-49,1868,0.01141786566276431
STAT,1940,32,35-39,1972,0.0939070268401926
STAT,1880,34,40-44,1914,0.04521244293299119
SIM,1852,27,20-24,1879,1
SIM,1944,3,na,1947,36
SIM,1795,66,na,1861,11
SIM,1811,46,na,1857,11
STAT,1870,44,25-29,1914,0.006293008583602037
STAT,1828,58,na,1886,13.759978757866064
STAT,1911,46,na,1957,34.641574667941505
STAT,1833,36,20-24,1869,0.007209636695583225
STAT,1922,30,50-100,1952,0.009347877705754062
STAT,1813,43,40-44,1856,0.0742736538349641
STAT,1876,85,na,1961,4.310020596966125
STAT,1903,33,35-39,1936,0.08232435793879811
STAT,1876,48,35-39,1924,0.0014040377796990077
STAT,1853,35,35-39,1888,0.0453847895139531
STAT,1892,41,35-39,1933,0.022472155032679655
SIM,1896,50,na,1946,25
SIM,1919,30,na,1949,44
STAT,1833,80,na,1913,4.57973577750952
STAT,1913,18,40-44,1931,0.002828440153523286
SIM,1856,20,na,1876,17
STAT,1833,90,na,1923,0.5836908031420439
STAT,1938,7,na,1945,39.171364160139824
STAT,1885,38,35-39,1923,0.06949971001645772
STAT,1940,29,50-100,1969,0.010067827898468835
STAT,1854,16,25-29,1870,0.041679643230738035
STAT,1883,33,na,1916,23.075234121761532
STAT,1891,52,na,1943,26.287235592217584
SIM,1855,68,na,1923,8
STAT,1830,43,40-44,1873,0.010805870643258783
STAT,1868,66,na,1934,15.86144369295041
STAT,1778,98,na,1876,0.006509280737217914
STAT,1891,42,na,1933,28.3323952816108
STAT,1828,68,na,1896,10.263511661187447
STAT,1929,10,na,1939,50.477379193596576
STAT,1853,17,20-24,1870,0.13403159688821625
STAT,1882,33,50-100,1915,0.008743727367188866
STAT,1903,27,na,1930,33.92999270154904
SIM,1795,76,na,1871,7
SIM,1882,58,na,1940,27
STAT,1891,37,20-24,1928,0.009461120175938862
SIM,1870,35,na,1905,24
STAT,1832,63,na,1895,8.06521261184466
STAT,1933,36,25-29,1969,0.013368579039624595
STAT,1861,46,25-29,1907,4.8576565001505934E-4
SIM,1914,31,na,1945,36
SIM,1920,7,na,1927,51
STAT,1793,65,na,1858,4.3072152141849696
STAT,1863,35,na,1898,21.057873326308826
STAT,1857,28,45-49,1885,0.008499832266170291
STAT,1883,44,50-100,1927,0.010120531097829424
STAT,1813,92,na,1905,0.27486761200064236
STAT,1924,47,50-100,1971,0.0026751913037697077
SIM,1876,40,na,1916,29
STAT,1897,0,na,1897,38.99323901367981
STAT,1846,20,50-100,1866,0.004136918910210114
STAT,1826,46,30-34,1872,9.87701047551987E-4
STAT,1912,40,50-100,1952,0.001136935492454598
STAT,1931,34,na,1965,49.27418412437537
STAT,1861,76,na,1937,7.967243337959299
SIM,1873,75,na,1948,3
STAT,1913,40,40-44,1953,0.002446193790165769
STAT,1872,17,30-34,1889,0.01636164035868303
STAT,1840,82,na,1922,3.6560990151367814
STAT,1874,45,20-24,1919,1.229526589249027E-4
STAT,1931,36,15-19,1967,2.534273780526202E-4
STAT,1932,24,15-19,1956,0.06932286980211932
STAT,1821,79,na,1900,4.342062992552657
STAT,1820,49,40-44,1869,0.0014098331577025451
STAT,1901,46,30-34,1947,7.662157759730547E-4
STAT,1898,2,na,1900,35.95977563084922
STAT,1915,22,50-100,1937,0.006742889613225948
SIM,1812,63,na,1875,15
STAT,1843,49,35-39,1892,5.814714377784802E-4
STAT,1920,30,30-34,1950,0.1724797618404113
STAT,1843,18,15-19,1861,0.031981133637903
STAT,1881,40,20-24,1921,0.0015264232824052071
STAT,1885,46,35-39,1931,0.0013864459670831636
STAT,1908,58,na,1966,31.354190436494918
STAT,1883,23,na,1906,22.895581984282355
STAT,1802,65,na,1867,7.08311335655683
STAT,1925,28,na,1953,43.81469933851666
STAT,1927,29,50-100,1956,0.011990305610020862
STAT,1866,53,na,1919,19.51188087687056
STAT,1830,35,40-44,1865,0.026747064009753223
STAT,1901,68,na,1969,24.74817960908481
STAT,1840,100,na,1940,0.008318957441430077
STAT,1946,20,35-39,1966,0.10411378501001216
SIM,1848,33,na,1881,33
STAT,1891,20,na,1911,29.200946472968166
STAT,1836,28,25-29,1864,0.5244613891410655
SIM,1939,29,na,1968,29
STAT,1914,42,35-39,1956,0.001978772454812275
STAT,1925,7,na,1932,47.985346266447394
STAT,1919,32,na,1951,40.45019111547324
SIM,1850,80,na,1930,2
SIM,1851,6,na,1857,29
STAT,1872,32,40-44,1904,0.044371991059201144
STAT,1795,78,na,1873,3.7960817854015305
STAT,1870,16,50-100,1886,4.942268394069749E-4
STAT,1908,17,20-24,1925,0.2616193945926181
STAT,1811,43,30-34,1854,0.049013962000294904
SIM,1854,19,na,1873,19
SIM,1880,2,na,1882,41
STAT,1879,26,30-34,1905,0.2615296116857498
STAT,1922,41,30-34,1963,0.0014587645289435855
STAT,1816,47,25-29,1863,7.259915091189014E-4
SIM,1890,55,na,1945,24
SIM,1837,39,na,1876,29
SIM,1838,23,na,1861,13
STAT,1871,86,na,1957,2.657179745223118
STAT,1850,39,25-29,1889,0.02550607664429825
STAT,1849,20,na,1869,20.33530244454676
SIM,1920,27,na,1947,44
STAT,1846,27,30-34,1873,0.2468877952079947
SIM,1799,80,na,1879,3
STAT,1821,101,na,1922,0.0035440780585417582
STAT,1920,29,na,1949,40.453429577328016
STAT,1925,34,25-29,1959,0.10892831638606454
SIM,1875,66,na,1941,10
STAT,1928,29,40-44,1957,0.05708628212266507
SIM,1878,21,na,1899,27
STAT,1859,40,na,1899,18.555485128381733
STAT,1833,44,20-24,1877,0.0013886769128429303
SIM,1897,34,na,1931,40
STAT,1842,41,na,1883,18.172214713444102
STAT,1883,38,25-29,1921,0.02782067171402472
STAT,1881,25,45-49,1906,0.010636693027541722
STAT,1898,29,45-49,1927,0.014870948160622819
STAT,1862,18,25-29,1880,0.055664548502687546
SIM,1789,80,na,1869,2
STAT,1910,29,na,1939,35.696772831050865
STAT,1912,31,35-39,1943,0.08958212729476855
STAT,1864,38,15-19,1902,5.011649453227383E-4
STAT,1923,20,40-44,1943,0.039083294423459765
STAT,1836,87,na,1923,1.7003296984095746
STAT,1861,54,na,1915,17.60924699824028
STAT,1817,42,na,1859,24.25891504810947
STAT,1871,39,45-49,1910,0.019675035830779813
STAT,1844,42,30-34,1886,0.009197020033335857
STAT,1860,37,na,1897,19.153451409263887
STAT,1893,37,30-34,1930,0.06719943960164727
STAT,1931,31,45-49,1962,0.020539581478650284
STAT,1926,46,35-39,1972,0.0015856791598798368
STAT,1878,54,na,1932,21.618379621059088
STAT,1907,31,na,1938,35.346580457065556
SIM,1863,22,na,1885,17
STAT,1851,48,30-34,1899,8.069471819019065E-4
STAT,1846,87,na,1933,1.427818597459915
STAT,1927,17,30-34,1944,0.15077924864240994
STAT,1859,45,30-34,1904,7.770531643148379E-4
SIM,1867,37,na,1904,11
STAT,1869,27,25-29,1896,0.4098759799016645
SIM,1835,58,na,1893,15
STAT,1812,75,na,1887,4.12641305402061
STAT,1903,41,20-24,1944,1.5750249042335276E-4
STAT,1906,34,15-19,1940,0.0011778036734216416
STAT,1907,43,20-24,1950,1.6015135440566923E-4
STAT,1821,50,50-100,1871,2.133325605413593E-4
STAT,1884,19,15-19,1903,0.05783206319430435
STAT,1822,44,45-49,1866,0.008306770242115458
STAT,1868,19,30-34,1887,0.015519425131374432
SIM,1873,22,na,1895,23
STAT,1878,48,45-49,1926,0.002405890649510694
SIM,1860,89,na,1949,2
STAT,1812,96,na,1908,0.034124729725735096
STAT,1933,33,20-24,1966,0.03271665662997938
STAT,1861,108,na,1969,2.00358988755293E-4
SIM,1846,25,30-34,1871,1
STAT,1919,10,na,1929,43.538087961266434
SIM,1883,75,na,1958,1
STAT,1858,29,15-19,1887,0.003483662967188545
SIM,1844,19,na,1863,12
STAT,1866,75,na,1941,9.48115582258409
SIM,1920,49,na,1969,42
STAT,1845,15,20-24,1860,0.13253840949750403
STAT,1887,28,30-34,1915,0.27389486901648424
STAT,1893,45,30-34,1938,6.953440130919241E-4
STAT,1842,17,45-49,1859,6.293540946869367E-4
STAT,1932,30,na,1962,50.13007614252634
STAT,1901,30,20-24,1931,0.03812708996956385
STAT,1930,35,45-49,1965,0.008865847273702524
SIM,1824,64,na,1888,15
STAT,1845,46,40-44,1891,0.0010035889136424754
SIM,1907,29,na,1936,40
STAT,1877,36,35-39,1913,0.07336241992091333
SIM,1926,32,na,1958,46
STAT,1915,45,20-24,1960,1.1091582820463498E-4
STAT,1908,16,na,1924,37.361828738170715
STAT,1862,42,25-29,1904,0.0055334827390148954
STAT,1838,25,30-34,1863,0.2522286273336879
SIM,1853,15,20-24,1868,1
SIM,1899,15,na,1914,29
STAT,1823,69,na,1892,8.439667285574846
STAT,1811,79,na,1890,3.9619079879837056
STAT,1910,23,25-29,1933,0.8594735507210386
STAT,1938,18,45-49,1956,0.004893631908266611
STAT,1925,40,45-49,1965,0.0020078994125417473
STAT,1870,40,45-49,1910,0.015017470617194559
STAT,1842,37,25-29,1879,0.025340787966776874
SIM,1936,10,na,1946,38
STAT,1853,48,40-44,1901,0.0010624403649517836
STAT,1838,19,45-49,1857,6.618224107112947E-4
SIM,1892,36,na,1928,36
STAT,1870,37,na,1907,23.40400820517499
STAT,1897,17,35-39,1914,0.007286612679107432
STAT,1899,41,45-49,1940,0.0014291670067893077
STAT,1841,100,na,1941,0.010391539266510045
STAT,1916,3,na,1919,42.52613539941669
STAT,1918,44,35-39,1962,0.002114530090188605
SIM,1886,40,na,1926,26
STAT,1867,47,30-34,1914,9.220191910859923E-4
STAT,1870,35,35-39,1905,0.07092887720679845
STAT,1935,19,30-34,1954,0.16500000759072822
STAT,1820,45,25-29,1865,4.999937442429363E-4
STAT,1822,36,45-49,1858,0.012573635484976173
STAT,1858,66,na,1924,12.47196059496159
STAT,1866,35,20-24,1901,0.007166799688641447
SIM,1824,42,na,1866,18
STAT,1818,58,na,1876,5.762381343716847
STAT,1830,46,45-49,1876,2.37387509559195E-4
STAT,1852,44,30-34,1896,0.009706601374023386
SIM,1825,81,na,1906,2
STAT,1927,20,25-29,1947,1.1389852860551024
SIM,1866,20,na,1886,33
STAT,1819,51,50-100,1870,1.3385093757344624E-4
STAT,1913,27,na,1940,37.01477316667851
SIM,1880,35,na,1915,30
SIM,1883,53,na,1936,9
STAT,1858,40,45-49,1898,0.011503519023387095
STAT,1871,27,50-100,1898,0.0063777353954619816
SIM,1855,1,na,1856,35
STAT,1863,37,45-49,1900,0.017650283698903275
STAT,1885,35,30-34,1920,0.053130206842059574
STAT,1909,29,30-34,1938,0.3697027647722108
STAT,1840,24,45-49,1864,0.006849347758840051
STAT,1865,35,50-100,1900,0.011210241317210682
SIM,1914,53,na,1967,32
STAT,1812,47,40-44,1859,0.0019228150294688974
STAT,1803,92,na,1895,0.15609106485540714
STAT,1818,44,30-34,1862,0.01163888526036895
STAT,1876,17,15-19,1893,0.06027401278546989
SIM,1906,44,na,1950,24
STAT,1912,47,45-49,1959,0.002072384918962748
STAT,1906,40,35-39,1946,0.0018453006002864052
STAT,1851,76,na,1927,7.998274511055925
STAT,1941,4,na,1945,41.034221531926
STAT,1849,26,45-49,1875,0.010279196154689325
STAT,1869,40,na,1909,22.620528100480566
STAT,1877,91,na,1968,1.9067016516461597
STAT,1916,45,na,1961,37.53508075996266
STAT,1824,49,25-29,1873,7.258923951659426E-4
SIM,1942,28,na,1970,40
STAT,1905,41,45-49,1946,0.0015067442908631831
STAT,1823,37,15-19,1860,4.046668951529209E-4
STAT,1886,16,20-24,1902,0.18434372607063856
STAT,1853,35,na,1888,15.117590146927682
STAT,1898,49,25-29,1947,4.291550173476196E-4
STAT,1886,47,40-44,1933,0.0017675210546925818
STAT,1940,17,na,1957,37.106881298219186
STAT,1928,32,35-39,1960,0.11370685881507422
SIM,1929,30,na,1959,47
STAT,1919,18,35-39,1937,0.04584834388777958
SIM,1868,86,na,1954,5
STAT,1890,28,15-19,1918,0.0054917386889893885
SIM,1851,21,na,1872,22
STAT,1821,41,25-29,1862,0.010360046715946628
SIM,1839,72,na,1911,14
STAT,1907,63,na,1970,29.281869577032246
SIM,1917,29,na,1946,41
STAT,1879,17,na,1896,26.140275998421117
SIM,1877,5,na,1882,32
SIM,1921,33,na,1954,40
STAT,1862,49,45-49,1911,0.0019936118018469427
STAT,1858,34,na,1892,18.00304123906323
STAT,1918,26,na,1944,39.64207998963796
STAT,1864,15,30-34,1879,0.016444427523670254
SIM,1889,69,na,1958,22
STAT,1855,17,30-34,1872,0.013347394537359655
SIM,1881,41,na,1922,24
STAT,1884,43,15-19,1927,1.343246827197389E-4
STAT,1929,24,50-100,1953,0.008229273277051608
SIM,1915,16,na,1931,39
STAT,1896,73,na,1969,19.446440616358302
STAT,1937,19,40-44,1956,0.013481170778581311
SIM,1926,4,na,1930,50
STAT,1840,37,15-19,1877,5.204386334324403E-4
SIM,1807,62,na,1869,15
STAT,1820,34,50-100,1854,0.008936117483438063
STAT,1820,94,na,1914,0.11330603782732868
STAT,1875,16,45-49,1891,6.731267333055017E-4
SIM,1864,61,na,1925,16
STAT,1910,47,35-39,1957,0.001195569080663891
SIM,1840,69,na,1909,6
SIM,1864,71,na,1935,13
STAT,1932,21,45-49,1953,0.014747874402934309
SIM,1940,15,na,1955,32
STAT,1882,47,20-24,1929,1.1446511621427178E-4
SIM,1911,13,na,1924,42
STAT,1839,52,na,1891,11.81913275246367
STAT,1949,18,20-24,1967,1.566205838781754
STAT,1831,40,50-100,1871,0.010736984282211362
STAT,1940,20,40-44,1960,0.03403246682768785
STAT,1843,47,50-100,1890,0.0010369624126183375
SIM,1828,35,na,1863,19
STAT,1874,48,25-29,1922,5.77004705099143E-4
STAT,1851,34,50-100,1885,0.007885511892857498
STAT,1853,32,30-34,1885,0.1130002482520102
STAT,1878,45,40-44,1923,0.0017851200539368165
STAT,1922,30,na,1952,42.76057921611573
SIM,1876,19,na,1895,31
STAT,1846,42,40-44,1888,0.018449442638960815
STAT,1917,31,20-24,1948,0.025413146318550153
STAT,1882,20,50-100,1902,0.003931351576778893
STAT,1909,30,50-100,1939,0.007908649394141947
STAT,1921,21,35-39,1942,0.10584043496394889
STAT,1830,39,na,1869,9.461023321002603
SIM,1836,54,na,1890,4
STAT,1920,36,50-100,1956,0.004561958513460606
STAT,1918,18,50-100,1936,0.004030412550830983
STAT,1865,22,50-100,1887,0.0037332484096068647
STAT,1861,43,20-24,1904,0.0013258992660067695
SIM,1900,50,na,1950,32
SIM,1832,61,na,1893,18
SIM,1930,30,40-44,1960,1
STAT,1840,28,50-100,1868,0.006205072743942603
STAT,1856,22,na,1878,17.989385522008625
STAT,1878,17,25-29,1895,0.05850429915929706
STAT,1866,46,50-100,1912,0.002268352731884842
STAT,1914,31,45-49,1945,0.015772528091200246
STAT,1837,44,40-44,1881,0.011460288501546442
STAT,1899,17,50-100,1916,6.70666302046638E-4
STAT,1833,47,25-29,1880,4.995304752207338E-4
STAT,1849,16,50-100,1865,4.70371061083873E-4
STAT,1873,49,20-24,1922,1.1945578726662865E-4
STAT,1910,20,20-24,1930,1.044036974654639
STAT,1807,47,50-100,1854,0.005216134655839595
STAT,1829,27,30-34,1856,0.2892887370859502
SIM,1817,72,na,1889,2
STAT,1877,52,50-100,1929,1.550698670029049E-4
STAT,1811,46,35-39,1857,0.005631589008137226
STAT,1894,27,50-100,1921,0.008198245763005497
STAT,1936,31,30-34,1967,0.1521947048788208
STAT,1896,18,30-34,1914,0.02088119645394852
STAT,1880,39,50-100,1919,0.01278042992367987
STAT,1920,41,20-24,1961,1.9366661591374573E-4
STAT,1827,42,30-34,1869,0.008992096334430775
STAT,1805,53,35-39,1858,1.6325824765306613E-4
STAT,1897,14,na,1911,34.183544721132556
STAT,1937,30,35-39,1967,0.08994173343175031
STAT,1799,60,na,1859,10.868650162018142
STAT,1904,40,25-29,1944,6.454120546174915E-4
SIM,1872,90,na,1962,3
STAT,1940,21,45-49,1961,0.011384455950013694
STAT,1856,16,35-39,1872,0.004728064103910678
SIM,1925,26,na,1951,41
STAT,1914,30,40-44,1944,0.03937911226191909
STAT,1875,14,na,1889,26.530933484351827
STAT,1881,22,40-44,1903,0.0198283462324134
STAT,1920,42,25-29,1962,7.819590963906224E-4
STAT,1841,53,45-49,1894,1.3976890362099118E-4
STAT,1912,17,50-100,1929,7.516703597535474E-4
STAT,1872,44,35-39,1916,0.01827761779138942
STAT,1810,47,30-34,1857,9.440301178662831E-4
STAT,1888,54,na,1942,24.470610924289474
STAT,1949,18,50-100,1967,0.004328128750578127
SIM,1885,8,na,1893,26
STAT,1888,40,30-34,1928,0.013570564354978002
STAT,1873,23,na,1896,23.97097479601346
STAT,1801,59,na,1860,9.767556271312543
STAT,1888,19,35-39,1907,0.006377816914438039
STAT,1933,15,na,1948,49.29953365140375
STAT,1840,39,na,1879,19.442197005259924
STAT,1916,48,40-44,1964,0.0015988346699100553
STAT,1877,33,30-34,1910,0.179469293371951
STAT,1886,73,na,1959,13.567058871732057
STAT,1849,19,20-24,1868,0.1672216826940503
STAT,1872,49,na,1921,22.53906666151318
STAT,1831,31,40-44,1862,0.04624819604066172
STAT,1953,2,na,1955,47.32886205455913
SIM,1874,71,na,1945,17
STAT,1912,42,25-29,1954,6.833325381938576E-4
STAT,1894,33,30-34,1927,0.2228180449145264
STAT,1936,32,35-39,1968,0.08822547592103935
STAT,1821,57,na,1878,13.529698186998067
STAT,1820,42,20-24,1862,0.0014034704892355477
STAT,1853,67,na,1920,9.962796277153348
STAT,1918,41,30-34,1959,0.0013489189443881516
STAT,1890,29,50-100,1919,0.007714825743688498
STAT,1841,46,20-24,1887,1.1951165207671008E-4
STAT,1914,33,na,1947,37.59531779778354
STAT,1904,40,50-100,1944,0.0010618069218898533
SIM,1931,33,na,1964,52
STAT,1912,8,na,1920,39.88419931984269
STAT,1937,28,na,1965,36.26929093014193
STAT,1890,41,25-29,1931,0.007835594600261994
STAT,1831,43,35-39,1874,0.017707107261074682
SIM,1826,54,na,1880,14
STAT,1925,31,20-24,1956,0.02880038303536963
STAT,1854,41,na,1895,14.191028647239024
STAT,1868,34,na,1902,22.895696529912332
STAT,1904,5,na,1909,37.55088518515276
SIM,1866,52,na,1918,27
STAT,1824,32,50-100,1856,0.014964685435739646
STAT,1953,13,na,1966,47.235706023417414
STAT,1887,43,40-44,1930,0.024373668787407095
STAT,1793,97,na,1890,0.005380720369402379
SIM,1901,13,na,1914,41
SIM,1834,42,na,1876,19
STAT,1926,43,30-34,1969,0.0015645889068986768
STAT,1880,46,35-39,1926,0.0014763541110382604
STAT,1927,42,35-39,1969,0.0025125378695969878
STAT,1861,86,na,1947,1.8658800167984098
STAT,1839,20,na,1859,15.380893630953
SIM,1837,17,na,1854,30
STAT,1930,30,25-29,1960,0.118855931472869
SIM,1958,10,na,1968,53
STAT,1821,48,45-49,1869,0.0032856009250510853
STAT,1840,21,40-44,1861,0.020915220130696823
STAT,1836,39,50-100,1875,0.014244773613995055
SIM,1897,66,na,1963,36
STAT,1900,49,40-44,1949,0.0013111733726958643
STAT,1897,46,50-100,1943,0.0018449575240310563
STAT,1789,82,na,1871,1.0533763717396432
STAT,1892,49,30-34,1941,6.604882995654572E-4
STAT,1910,6,na,1916,39.342951758074186
STAT,1922,33,45-49,1955,0.01757477511931525
STAT,1929,42,45-49,1971,0.0021450177992481533
STAT,1911,30,15-19,1941,0.0012532600428679242
SIM,1818,57,na,1875,24
STAT,1902,20,20-24,1922,0.977593069629445
STAT,1866,18,45-49,1884,6.138648880639454E-4
STAT,1853,89,na,1942,0.6602416493185339
STAT,1898,32,na,1930,32.19135672339074
STAT,1810,44,50-100,1854,0.010416788357459864
SIM,1931,11,na,1942,63
STAT,1914,11,na,1925,40.57459150732773
STAT,1771,87,na,1858,0.8579622060458405
STAT,1847,45,50-100,1892,0.0026497461475776495
STAT,1884,30,45-49,1914,0.017222464636695967
SIM,1889,47,na,1936,29
SIM,1857,37,na,1894,22
SIM,1885,34,na,1919,23
SIM,1841,43,na,1884,16
STAT,1847,18,35-39,1865,0.007272657190076092
STAT,1790,79,na,1869,1.7034720253844002
STAT,1859,19,na,1878,20.929371470332562
STAT,1869,20,50-100,1889,0.003991840686392849
STAT,1906,31,45-49,1937,0.014606533600911409
SIM,1889,26,40-44,1915,1
STAT,1839,42,na,1881,13.442914740345426
STAT,1822,33,40-44,1855,0.03300209568200615
STAT,1808,91,na,1899,0.08461706726620191
STAT,1874,33,50-100,1907,0.009256006531695168
STAT,1857,48,25-29,1905,4.2578020457650456E-4
SIM,1923,0,na,1923,42
STAT,1812,43,25-29,1855,0.007436743313055034
STAT,1821,47,na,1868,16.137021635119126
STAT,1929,41,40-44,1970,0.0032283607127009868
STAT,1916,41,20-24,1957,1.7969100515029615E-4
SIM,1916,44,na,1960,44
STAT,1863,30,25-29,1893,0.09141673539261232
STAT,1921,20,30-34,1941,0.3240178726421962
STAT,1853,57,na,1910,12.63015330462201
STAT,1867,16,45-49,1883,6.428368902360479E-4
STAT,1868,43,30-34,1911,0.011045489592651808
STAT,1893,48,35-39,1941,9.832243164358278E-4
STAT,1860,45,50-100,1905,0.0020165668227212366
STAT,1912,52,na,1964,34.44116979894766
STAT,1846,45,45-49,1891,0.0019316782463301041
SIM,1867,15,na,1882,16
STAT,1927,41,30-34,1968,0.0015974864810680695
SIM,1837,49,na,1886,29
SIM,1946,10,na,1956,53
STAT,1872,60,na,1932,19.51369415443544
STAT,1842,94,na,1936,0.1499513339600949
STAT,1911,32,30-34,1943,0.1524291562344083
STAT,1900,20,na,1920,32.99138087677186
STAT,1871,32,25-29,1903,0.10211880167129943
SIM,1895,22,na,1917,27
SIM,1842,61,na,1903,18
STAT,1861,34,30-34,1895,0.14557137073786383
STAT,1954,4,na,1958,48.33907311559891
STAT,1918,41,50-100,1959,0.0012395471353663472
STAT,1850,43,45-49,1893,0.013229297990233497
STAT,1820,36,35-39,1856,0.06779318237644676
STAT,1824,45,50-100,1869,0.0032632052759076933
STAT,1840,51,50-100,1891,1.1891005111829701E-4
STAT,1844,53,na,1897,16.548250735831683
STAT,1924,46,25-29,1970,6.289662614508889E-4
STAT,1858,16,45-49,1874,5.840818613864193E-4
STAT,1848,16,35-39,1864,0.004424955113580067
STAT,1831,57,na,1888,16.408313505141283
STAT,1864,42,35-39,1906,0.01622160708918268
STAT,1923,40,35-39,1963,0.0023437488518386553
STAT,1810,62,na,1872,7.730842353991735
STAT,1824,53,45-49,1877,1.7776964005873907E-4
STAT,1854,47,45-49,1901,0.0014357895718249576
STAT,1901,34,50-100,1935,0.01271097384892169
STAT,1929,17,40-44,1946,0.017765163698992854
STAT,1910,44,30-34,1954,0.0011861165187098091
SIM,1810,45,30-34,1855,1
STAT,1864,18,35-39,1882,0.005061193345430478
STAT,1862,46,40-44,1908,0.0014812466744828058
STAT,1858,27,50-100,1885,0.0049830479940596644
STAT,1888,6,na,1894,30.52795599982669
STAT,1912,40,25-29,1952,6.910784409340962E-4
SIM,1833,24,na,1857,14
STAT,1891,44,45-49,1935,0.018121269745727944
STAT,1933,25,na,1958,49.58171583984589
SIM,1859,49,na,1908,18
SIM,1889,15,na,1904,34
STAT,1776,101,na,1877,9.239063032760843E-4
STAT,1856,40,35-39,1896,0.013250505657051156
SIM,1846,42,na,1888,14
STAT,1806,58,na,1864,14.14203098559007
STAT,1839,16,35-39,1855,0.003984644955191874
SIM,1848,23,na,1871,30
SIM,1827,39,na,1866,19
STAT,1867,19,15-19,1886,0.05737585079559159
SIM,1860,57,na,1917,16
STAT,1881,49,20-24,1930,1.1180111652916928E-4
SIM,1894,48,na,1942,29
STAT,1852,47,35-39,1899,0.0011926014853058965
STAT,1872,41,30-34,1913,0.01181628787889609
STAT,1902,45,35-39,1947,0.0011247503851571628
STAT,1837,40,25-29,1877,0.003785738522238535
STAT,1868,28,20-24,1896,0.11313094125515127
STAT,1901,37,40-44,1938,0.01322093043297461
STAT,1877,29,50-100,1906,0.0065561004248069175
STAT,1861,50,45-49,1911,1.237967555347179E-4
STAT,1825,61,na,1886,10.576027202070081
STAT,1864,106,na,1970,0.0013750800774553298
STAT,1809,54,na,1863,15.595383797220295
STAT,1865,47,20-24,1912,1.080324732371586E-4
SIM,1862,16,na,1878,26
STAT,1938,14,na,1952,38.70215955726332
STAT,1931,40,35-39,1971,0.0026856224182670173
STAT,1948,24,na,1972,41.624373039359696
STAT,1908,48,na,1956,32.96030642639459
SIM,1870,89,na,1959,2
STAT,1921,45,45-49,1966,0.002442425860735844
STAT,1815,61,na,1876,8.256578588348603
STAT,1873,53,40-44,1926,1.0531529271906991E-4
STAT,1882,70,na,1952,13.446274374897822
SIM,1865,56,na,1921,14
SIM,1890,23,na,1913,26
STAT,1827,45,35-39,1872,0.0010830346798543834
STAT,1847,71,na,1918,14.258834105000144
STAT,1895,45,40-44,1940,0.0012662380416215693
STAT,1923,15,na,1938,43.120956330745244
STAT,1901,33,25-29,1934,0.1427167691496508
STAT,1834,53,na,1887,15.295935031282037
STAT,1924,34,50-100,1958,0.00957091775807259
SIM,1852,38,na,1890,25
STAT,1845,41,50-100,1886,0.006369689016150872
STAT,1809,54,30-34,1863,1.8703986895285594E-4
STAT,1880,43,30-34,1923,0.012002040958566202
SIM,1915,48,na,1963,31
STAT,1858,56,na,1914,15.520486649364981
STAT,1930,32,40-44,1962,0.050266726581700304
SIM,1866,19,na,1885,35
STAT,1794,61,na,1855,10.597400000000002
SIM,1926,19,30-34,1945,3
STAT,1823,41,35-39,1864,0.012936517245877976
STAT,1821,45,40-44,1866,0.0024926141192085386
SIM,1875,56,na,1931,13
STAT,1928,14,na,1942,49.520812699034664
SIM,1840,80,na,1920,2
SIM,1945,14,na,1959,40
STAT,1857,71,na,1928,9.992424667971425
SIM,1829,25,30-34,1854,1
SIM,1878,17,25-29,1895,1
STAT,1810,48,35-39,1858,0.0013476241241991095
STAT,1916,47,50-100,1963,0.002300049480096347
STAT,1820,47,50-100,1867,0.0020764901095908853
STAT,1888,22,na,1910,27.63791148005477
STAT,1823,80,na,1903,3.557473615868059
STAT,1884,47,30-34,1931,9.439783986651761E-4
STAT,1888,16,30-34,1904,0.018671672568527267
STAT,1908,41,20-24,1949,1.6348070507955396E-4
STAT,1926,32,25-29,1958,0.11112069104201844
STAT,1849,50,45-49,1899,1.141450704350899E-4
STAT,1844,75,na,1919,8.041077372689259
STAT,1883,42,45-49,1925,0.01451570211092664
STAT,1851,44,15-19,1895,1.1501314676967187E-4
STAT,1908,26,na,1934,35.338708687434966
STAT,1886,40,20-24,1926,0.0016639360728446357
STAT,1870,49,45-49,1919,0.002295447833069907
STAT,1866,15,40-44,1881,0.0017495550118994667
SIM,1871,30,25-29,1901,1
STAT,1798,64,na,1862,15.120831019194245
STAT,1831,34,45-49,1865,0.017999781213386676
STAT,1841,49,25-29,1890,5.520256886594304E-4
SIM,1906,34,na,1940,26
STAT,1924,11,na,1935,46.94713955771535
STAT,1922,30,40-44,1952,0.04424479370974612
SIM,1884,48,na,1932,22
STAT,1876,45,30-34,1921,9.92946622605527E-4
STAT,1899,40,50-100,1939,0.0010144131832471128
STAT,1890,32,35-39,1922,0.12301376419084
STAT,1784,83,na,1867,1.8489808283531701
STAT,1878,41,25-29,1919,0.006659739943840474
STAT,1827,51,50-100,1878,1.1226015811455338E-4
STAT,1942,24,50-100,1966,0.006844124540031778
STAT,1831,40,30-34,1871,0.011684365273929015
STAT,1816,44,20-24,1860,0.002067324729835963
STAT,1918,30,25-29,1948,0.09810913688961949
STAT,1847,93,na,1940,0.3121964702219141
STAT,1862,60,na,1922,16.454471664472273
STAT,1869,29,na,1898,22.958740067821278
STAT,1904,42,40-44,1946,0.0022353385269131077
STAT,1854,44,40-44,1898,0.013562784579843463
SIM,1777,80,na,1857,1
STAT,1879,23,50-100,1902,0.00420762963493955
STAT,1843,57,na,1900,8.5247256609261
STAT,1813,46,45-49,1859,0.007424534789492584
STAT,1866,85,na,1951,2.524727532693495
STAT,1870,1,na,1871,34.984211997600966
SIM,1875,34,na,1909,18
STAT,1835,44,30-34,1879,0.00608085912935586
STAT,1944,20,25-29,1964,0.9907724807962429
SIM,1843,24,na,1867,20
STAT,1881,38,15-19,1919,5.316847451267501E-4
STAT,1919,42,35-39,1961,0.0021632524626358208
STAT,1868,46,35-39,1914,0.0013586900781989916
STAT,1896,51,na,1947,28.41873317394292
SIM,1899,47,na,1946,28
STAT,1878,16,20-24,1894,0.183482000985192
STAT,1880,37,45-49,1917,0.02096257114763791
STAT,1899,17,45-49,1916,8.942217360621842E-4
STAT,1897,36,na,1933,31.43690875433142
STAT,1845,18,50-100,1863,3.5982920959674755E-4
STAT,1873,47,20-24,1920,1.2143433451108316E-4
STAT,1851,49,35-39,1900,0.0011572456216839492
STAT,1845,16,na,1861,17.059638211393175
STAT,1897,41,35-39,1938,0.0016774147942009393
STAT,1887,46,45-49,1933,0.002583271889029603
SIM,1941,11,na,1952,48
STAT,1903,3,na,1906,37.58552956349551
STAT,1918,19,30-34,1937,0.13076219399611416
STAT,1813,52,30-34,1865,1.7720322735846893E-4
STAT,1859,17,15-19,1876,0.0547531072513867
SIM,1893,2,na,1895,39
STAT,1934,31,20-24,1965,0.03318098629844409
SIM,1843,44,30-34,1887,1
STAT,1849,19,na,1868,21.65141123690838
STAT,1842,41,45-49,1883,0.011767393034932907
STAT,1870,48,40-44,1918,0.0016793121330037938
SIM,1906,12,na,1918,29
STAT,1847,15,30-34,1862,0.021503063499713593
STAT,1893,33,na,1926,29.961482480685707
STAT,1865,54,45-49,1919,1.2765330359856204E-4
STAT,1903,30,30-34,1933,0.25022590786115284
SIM,1845,68,na,1913,19
SIM,1813,58,na,1871,7
STAT,1891,3,na,1894,32.44709978103478
STAT,1918,33,30-34,1951,0.16520481572964282
STAT,1896,29,na,1925,31.123792938901982
STAT,1930,18,na,1948,47.23976891530295
SIM,1872,59,na,1931,18
STAT,1812,48,45-49,1860,0.0026155458772705023
STAT,1892,15,na,1907,31.346498063422935
SIM,1918,27,45-49,1945,1
STAT,1854,15,20-24,1869,0.1311686080485509
STAT,1900,28,20-24,1928,0.16210529575766824
STAT,1873,56,na,1929,20.736808562491813
STAT,1921,43,30-34,1964,0.0014264662421055862
STAT,1925,36,25-29,1961,0.01175420568018267
STAT,1911,16,30-34,1927,0.02429325416734676
STAT,1845,9,na,1854,18.0
STAT,1844,30,50-100,1874,0.008737867827800823
STAT,1936,24,35-39,1960,0.08941553467679413
STAT,1903,16,na,1919,35.99556944759373
STAT,1792,103,na,1895,5.437814634096643E-4
STAT,1845,37,na,1882,14.469943187130523
STAT,1916,38,25-29,1954,0.009947172881969009
STAT,1904,46,35-39,1950,0.0011347903070312898
STAT,1892,47,30-34,1939,6.714279730212337E-4
STAT,1838,21,15-19,1859,0.03346045072075342
SIM,1845,57,na,1902,21
STAT,1928,26,50-100,1954,0.01224453354531768
STAT,1902,23,25-29,1925,0.8047755080634346
STAT,1913,37,45-49,1950,0.006671340257946628
STAT,1907,45,20-24,1952,1.0000077070161249E-4
STAT,1881,49,50-100,1930,0.002288196094367994
STAT,1867,24,45-49,1891,0.006631317727815094
STAT,1927,31,30-34,1958,0.19292925768411318
STAT,1930,34,40-44,1964,0.05020190338520813
STAT,1933,35,20-24,1968,0.0035821136254050616
STAT,1805,72,na,1877,4.614911144686631
STAT,1809,86,na,1895,1.227667283919696
STAT,1861,48,40-44,1909,0.0014216257707046535
STAT,1822,64,na,1886,6.29264500521782
STAT,1812,101,na,1913,0.0022677480478804682
SIM,1840,38,na,1878,17
STAT,1792,80,na,1872,5.17710434601141
STAT,1796,94,na,1890,0.008686951374949707
STAT,1803,81,na,1884,2.3500139756721796
STAT,1922,35,45-49,1957,0.007713608557978402
STAT,1828,69,na,1897,9.856152883354913
STAT,1815,49,25-29,1864,8.068664020856939E-4
STAT,1876,22,45-49,1898,0.007082316924263817
SIM,1909,36,35-39,1945,3
STAT,1865,37,na,1902,21.30951528710258
STAT,1904,31,35-39,1935,0.14570279586745868
STAT,1837,18,na,1855,14.618219149890132
SIM,1830,28,na,1858,21
STAT,1894,18,na,1912,32.28315923373808
STAT,1843,26,na,1869,11.37493782309095
STAT,1852,44,50-100,1896,0.008919579621421337
SIM,1920,30,30-34,1950,1
STAT,1927,26,35-39,1953,0.18221282769774155
STAT,1921,45,na,1966,41.28560785353684
STAT,1938,6,na,1944,39.276625516524106
STAT,1898,19,50-100,1917,6.573565916068844E-4
STAT,1913,26,na,1939,37.141798116236096
STAT,1851,45,na,1896,19.183211828967796
STAT,1903,17,35-39,1920,0.0078011799396795
STAT,1944,23,30-34,1967,0.30796989814409104
STAT,1869,5,na,1874,27.144951145691987
STAT,1904,39,45-49,1943,0.006103341264257336
SIM,1855,67,na,1922,8
STAT,1863,51,50-100,1914,1.343591799463565E-4
STAT,1823,81,na,1904,3.1098722855195415
STAT,1938,21,50-100,1959,0.0064714001477754555
STAT,1934,29,30-34,1963,0.5243490477184168
SIM,1942,29,30-34,1971,1
STAT,1883,30,50-100,1913,0.008969010021340549
SIM,1804,75,na,1879,7
SIM,1900,28,na,1928,35
SIM,1793,86,na,1879,1
STAT,1902,18,30-34,1920,0.02241764558994923
SIM,1912,29,na,1941,35
STAT,1930,41,30-34,1971,0.0016766709672519317
STAT,1879,22,15-19,1901,0.03414522858422717
STAT,1841,39,25-29,1880,0.03252149721692006
STAT,1842,49,50-100,1891,0.0018042112374438643
STAT,1913,44,35-39,1957,0.0019407932756557434
STAT,1835,20,35-39,1855,0.0674295646966133
STAT,1924,39,15-19,1963,2.2449015544140117E-4
STAT,1945,22,35-39,1967,0.10245634629623067
STAT,1914,40,35-39,1954,0.0019926052511808766
STAT,1942,28,25-29,1970,0.6854590731774853
STAT,1818,59,na,1877,5.649381045566557
STAT,1853,49,45-49,1902,0.001452247253839775
STAT,1930,21,35-39,1951,0.12042242699148575
STAT,1939,32,50-100,1971,0.008378033988917162
STAT,1788,75,na,1863,4.826693439307217
STAT,1904,44,40-44,1948,0.0022078839202984784
SIM,1953,11,na,1964,50
STAT,1846,16,25-29,1862,0.05803258593353006
STAT,1910,24,15-19,1934,0.049373343517289295
STAT,1814,45,na,1859,14.040230489641239
STAT,1849,33,40-44,1882,0.03506793056024461
STAT,1929,29,20-24,1958,0.22713574512582865
STAT,1881,75,na,1956,10.144262796357209
STAT,1952,18,40-44,1970,0.016657338029058406
STAT,1833,24,50-100,1857,0.004000397746870591
SIM,1907,30,na,1937,40
STAT,1939,25,15-19,1964,0.007054391772677534
STAT,1820,47,40-44,1867,0.0014474556474820106
STAT,1884,41,50-100,1925,0.010397442007864329
STAT,1918,26,40-44,1944,0.049323555377750926
STAT,1918,42,50-100,1960,0.0012377621874914196
STAT,1852,94,na,1946,0.17105048864225467
STAT,1930,36,35-39,1966,0.03143036832840463
STAT,1864,49,20-24,1913,1.0538350209578573E-4
STAT,1902,31,50-100,1933,0.012973574910139552
STAT,1877,38,na,1915,24.199208449770147
STAT,1899,27,45-49,1926,0.015199312799972473
STAT,1859,30,45-49,1889,0.014062096255339988
STAT,1899,32,40-44,1931,0.05936677046350878
SIM,1923,16,15-19,1939,2
STAT,1860,38,na,1898,19.05845029027392
STAT,1892,47,na,1939,27.670268259194522
STAT,1920,32,30-34,1952,0.1711044003544187
SIM,1836,25,20-24,1861,1
STAT,1935,34,50-100,1969,0.011373233552242542
STAT,1912,38,40-44,1950,0.01442462996561314
SIM,1864,5,na,1869,23
STAT,1929,37,50-100,1966,0.005364467909522878
SIM,1934,27,30-34,1961,1
STAT,1895,16,20-24,1911,0.23072686726638209
STAT,1852,19,na,1871,23.481415681420913
STAT,1908,39,30-34,1947,0.01680471808209297
STAT,1825,92,na,1917,0.2245333981074
STAT,1810,45,30-34,1855,9.69003613640253E-4
SIM,1860,58,na,1918,16
STAT,1834,22,40-44,1856,0.019694654663265504
STAT,1915,16,15-19,1931,0.09439583021603386
STAT,1877,28,50-100,1905,0.006580051813407721
SIM,1869,71,na,1940,10
STAT,1823,35,50-100,1858,0.00916755579129428
STAT,1869,29,25-29,1898,0.40694651954452393
STAT,1943,27,30-34,1970,0.4142577982428899
SIM,1887,20,20-24,1907,3
STAT,1903,22,30-34,1925,0.2532431390499973
STAT,1888,34,50-100,1922,0.010615556498215037
STAT,1874,18,na,1892,25.55492740408873
STAT,1927,19,45-49,1946,0.006146336883242492
STAT,1912,30,30-34,1942,0.15505319526944217
STAT,1926,27,30-34,1953,0.46702304071248546
STAT,1776,102,na,1878,5.789843630740238E-4
STAT,1929,41,na,1970,47.93569917770152
STAT,1935,28,35-39,1963,0.20364946843936294
STAT,1947,17,20-24,1964,1.5167730219167075
STAT,1874,46,50-100,1920,0.0024986649836005233
SIM,1907,50,na,1957,37
STAT,1938,29,15-19,1967,0.006940933404087545
STAT,1880,43,50-100,1923,0.011028902478264414
STAT,1875,67,na,1942,16.29512253373793
SIM,1920,48,na,1968,42
STAT,1918,28,35-39,1946,0.1577740687055391
STAT,1884,28,na,1912,23.299703288559833
STAT,1928,40,35-39,1968,0.0025615954848248433
STAT,1868,65,na,1933,16.354532858638358
STAT,1887,17,25-29,1904,0.06185277957300029
STAT,1908,44,25-29,1952,6.49170652234232E-4
SIM,1910,18,na,1928,32
STAT,1859,19,15-19,1878,0.05411001514823744
STAT,1919,32,35-39,1951,0.09773762500457317
SIM,1919,31,na,1950,44
SIM,1943,28,35-39,1971,1
STAT,1883,86,na,1969,4.85262063240055
STAT,1841,38,50-100,1879,0.014012515333544863
STAT,1849,18,45-49,1867,6.197952108589243E-4
SIM,1957,2,na,1959,56
STAT,1834,41,50-100,1875,0.009116378385199308
SIM,1795,77,na,1872,7
SIM,1888,30,na,1918,39
SIM,1882,89,na,1971,6
STAT,1934,34,25-29,1968,0.1254965591631134
SIM,1948,9,na,1957,41
STAT,1917,34,25-29,1951,0.09508409980934304
STAT,1883,22,na,1905,22.96654861951667
STAT,1895,67,na,1962,22.341221850380556
SIM,1828,26,25-29,1854,1
SIM,1929,27,20-24,1956,1
STAT,1903,15,40-44,1918,0.002612475271060768
SIM,1878,22,20-24,1900,1
SIM,1901,45,na,1946,37
STAT,1828,39,50-100,1867,0.005424231942506322
STAT,1944,26,35-39,1970,0.16116302159743023
SIM,1870,88,na,1958,2
STAT,1927,24,40-44,1951,0.040956509459040495
STAT,1839,45,50-100,1884,0.0014167768373213288
SIM,1823,58,na,1881,8
STAT,1858,26,45-49,1884,0.008711539909459354
STAT,1907,36,50-100,1943,0.0038949115268113316
SIM,1919,1,na,1920,48
STAT,1933,37,15-19,1970,2.6049746098574046E-4
STAT,1947,19,15-19,1966,0.5073932182652683
STAT,1868,20,45-49,1888,0.006846256062634017
SIM,1882,69,na,1951,21
STAT,1944,24,40-44,1968,0.03601592105114993
STAT,1869,16,20-24,1885,0.17518966184068036
STAT,1861,55,na,1916,17.38855138736396
STAT,1950,22,15-19,1972,0.06275888856266963
STAT,1930,37,45-49,1967,0.00885051597361425
STAT,1890,39,20-24,1929,0.009269284063007475
STAT,1909,38,35-39,1947,0.02265291085778377
SIM,1920,8,na,1928,51
STAT,1944,19,45-49,1963,0.005333267702204259
SIM,1900,26,20-24,1926,1
SIM,1877,90,na,1967,3
STAT,1845,92,na,1937,0.2434611634959137
STAT,1927,15,50-100,1942,0.004656140170816015
STAT,1910,25,25-29,1935,0.6413952892656221
STAT,1953,16,35-39,1969,0.05048107412439984
STAT,1837,73,na,1910,5.7430726373041985
STAT,1858,31,40-44,1889,0.0333444620253243
SIM,1811,77,na,1888,1
SIM,1851,7,na,1858,29
STAT,1911,15,na,1926,38.57859148807026
STAT,1938,27,20-24,1965,0.17965051518397754
SIM,1906,24,15-19,1930,1
STAT,1922,32,40-44,1954,0.043891983707142014
STAT,1925,33,20-24,1958,0.02876583293234493
SIM,1861,43,na,1904,23
STAT,1878,39,50-100,1917,0.012547859211429598
STAT,1863,50,50-100,1913,1.3564098727611567E-4
STAT,1870,54,50-100,1924,1.4590329095993766E-4
STAT,1896,49,50-100,1945,0.0017817625535323184
STAT,1835,21,45-49,1856,0.00615516223606046
STAT,1838,35,na,1873,20.479788191434668
STAT,1882,37,20-24,1919,0.0073873823663168255
STAT,1898,30,50-100,1928,0.012459513161127997
STAT,1904,33,na,1937,34.3385624134865
STAT,1922,34,35-39,1956,0.10199529592178541
STAT,1874,73,na,1947,12.049648667586176
STAT,1878,24,20-24,1902,0.7070107905628779
STAT,1940,23,45-49,1963,0.011376943448853942
STAT,1862,29,50-100,1891,0.005479594064858839
STAT,1879,19,40-44,1898,0.0018829128238535351
SIM,1784,81,na,1865,1
SIM,1886,24,20-24,1910,2
SIM,1842,60,na,1902,19
SIM,1846,74,na,1920,3
STAT,1912,46,40-44,1958,0.0015070947891569562
STAT,1859,22,45-49,1881,0.005750458630973868
STAT,1863,66,na,1929,14.511756692059862
SIM,1935,26,na,1961,57
STAT,1804,55,na,1859,12.680091855687829
STAT,1904,21,35-39,1925,0.08386849448038573
STAT,1808,69,na,1877,2.785879140667662
STAT,1901,34,15-19,1935,0.0019756060069874085
SIM,1829,51,na,1880,19
STAT,1830,36,45-49,1866,0.011915782140205658
STAT,1855,21,15-19,1876,0.027331645924522748
STAT,1911,17,40-44,1928,0.002780920600409192
STAT,1934,23,50-100,1957,0.008802314851826108
SIM,1910,20,20-24,1930,3
STAT,1815,46,20-24,1861,1.7544024449280462E-4
STAT,1857,18,na,1875,20.07800440202798
SIM,1869,16,na,1885,17
STAT,1849,36,45-49,1885,0.015982022997740722
STAT,1814,101,na,1915,0.0025428234016527194
SIM,1799,59,na,1858,16
STAT,1880,58,na,1938,20.795487515144604
STAT,1896,15,25-29,1911,0.07478035164112234
SIM,1942,26,25-29,1968,2
STAT,1917,3,na,1920,43.10931569705418
STAT,1847,20,25-29,1867,0.7605446472417461
STAT,1910,32,15-19,1942,0.0012314902290110632
STAT,1826,30,35-39,1856,0.19015284842739844
STAT,1921,46,35-39,1967,0.0014456946373616452
STAT,1912,20,30-34,1932,0.2749200850575002
STAT,1774,83,na,1857,0.5300643803570001
STAT,1852,39,na,1891,19.96065090077742
STAT,1815,62,na,1877,7.954387812015048
STAT,1859,25,50-100,1884,0.005247224244682755
STAT,1854,18,25-29,1872,0.04119010298783085
STAT,1893,32,na,1925,30.088455764009833
STAT,1917,29,30-34,1946,0.4042695100632067
STAT,1853,56,na,1909,12.818716626193309
STAT,1887,24,50-100,1911,0.004423199440691387
STAT,1923,16,na,1939,43.02695264594422
STAT,1924,32,15-19,1956,0.0014894828877194913
SIM,1906,13,na,1919,29
STAT,1901,19,25-29,1920,0.07886754308219086
STAT,1938,19,20-24,1957,1.3276671207531885
SIM,1865,57,na,1922,14
STAT,1840,93,na,1933,0.22900762246845777
STAT,1948,19,30-34,1967,0.13847572839174538
STAT,1897,46,na,1943,29.967278684826326
STAT,1930,33,30-34,1963,0.20224949042279147
STAT,1824,39,25-29,1863,0.04017013892748569
STAT,1871,37,45-49,1908,0.019875069565525885
STAT,1896,22,15-19,1918,0.04333386816902181
STAT,1798,65,na,1863,14.567408603891739
STAT,1913,36,35-39,1949,0.02378394284970204
STAT,1850,47,25-29,1897,5.104592451234344E-4
SIM,1847,60,na,1907,13
STAT,1921,39,45-49,1960,0.007536492399859497
SIM,1867,68,na,1935,6
STAT,1810,63,na,1873,7.447893523835637
STAT,1914,33,45-49,1947,0.015642044732803166
STAT,1846,23,15-19,1869,0.032751940144302646
SIM,1946,19,20-24,1965,3
STAT,1887,48,na,1935,24.2486242817499
SIM,1805,92,na,1897,1
STAT,1916,37,15-19,1953,1.949722309430523E-4
STAT,1904,47,45-49,1951,0.0018986234961116315
SIM,1899,46,na,1945,28
STAT,1831,54,50-100,1885,1.2227291397694768E-4
STAT,1817,73,na,1890,9.413393802076508
STAT,1860,15,45-49,1875,6.197548468841995E-4
STAT,1908,46,50-100,1954,0.0020502180798472286
STAT,1876,84,na,1960,4.789443934844012
STAT,1934,33,15-19,1967,0.0017460066351576073
STAT,1918,29,45-49,1947,0.018088992750750394
SIM,1956,15,15-19,1971,1
STAT,1843,20,40-44,1863,0.011256295204959993
STAT,1917,31,50-100,1948,0.008614197658477356
STAT,1784,93,na,1877,0.09645763333195985
SIM,1884,16,na,1900,22
STAT,1928,22,35-39,1950,0.11698768724424186
STAT,1943,19,30-34,1962,0.12822557674708
STAT,1921,31,35-39,1952,0.1013151656264499
STAT,1852,20,35-39,1872,0.0601910110003776
STAT,1891,48,25-29,1939,3.9377443474272956E-4
STAT,1916,46,25-29,1962,5.407663820563897E-4
SIM,1925,16,na,1941,45
SIM,1833,56,na,1889,11
STAT,1867,32,45-49,1899,0.016687690664552404
SIM,1835,27,na,1862,21
SIM,1846,43,na,1889,14
STAT,1832,49,25-29,1881,2.7164717610344316E-4
STAT,1907,35,50-100,1942,0.0039130681630880635
STAT,1918,36,35-39,1954,0.02538501130091258
STAT,1908,36,25-29,1944,0.009214849112191677
STAT,1841,36,20-24,1877,0.00898249856300095
STAT,1831,88,na,1919,1.1140476985523038
STAT,1828,80,na,1908,4.154548117841922
STAT,1834,21,na,1855,20.354181038173753
SIM,1888,74,na,1962,20
STAT,1829,31,15-19,1860,0.0013831418899366153
STAT,1851,33,50-100,1884,0.00796781946796154
STAT,1901,27,25-29,1928,0.5919106649987451
STAT,1932,39,20-24,1971,0.003520014222923138
STAT,1872,24,50-100,1896,0.004146270073266533
STAT,1818,90,na,1908,0.1970248223359474
STAT,1918,25,30-34,1943,0.4160187361890518
STAT,1877,18,20-24,1895,0.18252525332169156
SIM,1817,62,na,1879,4
STAT,1895,19,25-29,1914,0.07317406521048637
SIM,1810,83,na,1893,7
SIM,1893,1,na,1894,39
STAT,1913,28,50-100,1941,0.009800183657509863
STAT,1855,27,50-100,1882,0.004694544839163907
SIM,1847,48,na,1895,15
SIM,1876,29,na,1905,30
STAT,1828,28,25-29,1856,0.6375394502463754
STAT,1926,28,40-44,1954,0.05536011599900302
STAT,1850,29,25-29,1879,0.43688459139535557
STAT,1886,74,na,1960,13.073217928801007
STAT,1922,42,35-39,1964,0.0022943550166039813
STAT,1833,36,na,1869,20.028793314992885
STAT,1879,15,25-29,1894,0.0589237081359923
STAT,1882,60,na,1942,18.27733777375084
STAT,1924,28,50-100,1952,0.01147330485846244
STAT,1901,26,15-19,1927,0.00637030539629957
SIM,1870,24,na,1894,24
STAT,1849,15,40-44,1864,0.0017664568190721497
STAT,1888,20,15-19,1908,0.03878235504621789
STAT,1869,51,na,1920,20.962754402293225
STAT,1828,89,na,1917,0.7055488660435852
STAT,1870,0,na,1870,37.083116384991484
STAT,1875,23,40-44,1898,0.02135416084527501
STAT,1927,30,na,1957,46.33852952762304
SIM,1871,41,na,1912,24
STAT,1904,36,40-44,1940,0.01360376553621254
STAT,1944,16,40-44,1960,0.014947348701050378
STAT,1948,15,15-19,1963,0.516214258282479
STAT,1924,37,20-24,1961,0.0030882115979320255
STAT,1898,1,na,1899,36.71800237999614
STAT,1826,34,na,1860,20.201822181960758
STAT,1869,19,25-29,1888,0.0550137744158261
STAT,1936,17,45-49,1953,0.004753663338358726
STAT,1909,32,25-29,1941,0.0877049032933438
STAT,1920,44,25-29,1964,7.793573347165434E-4
STAT,1967,2,na,1969,48.835476118749625
SIM,1824,75,na,1899,10
STAT,1869,26,20-24,1895,0.11406097703295827
STAT,1820,39,40-44,1859,0.03973624554113828
STAT,1940,30,35-39,1970,0.09401323180190783
STAT,1837,22,50-100,1859,0.002781207223023932
STAT,1837,23,20-24,1860,0.4533468183319495
SIM,1876,73,na,1949,18
STAT,1906,16,20-24,1922,0.25819548927586927
STAT,1867,31,35-39,1898,0.09730807173131914
STAT,1896,0,na,1896,38.56983691956708
STAT,1846,47,50-100,1893,0.001981132036920088
STAT,1902,30,15-19,1932,0.0020243563135165133
SIM,1969,0,na,1969,54
STAT,1923,18,15-19,1941,0.527830777105645
STAT,1869,82,na,1951,4.520910336796257
SIM,1941,10,na,1951,48
SIM,1945,24,na,1969,40
STAT,1934,26,25-29,1960,0.8820891555359962
SIM,1907,3,na,1910,41
STAT,1780,79,na,1859,4.980473409064297
STAT,1845,47,45-49,1892,0.001373103787362988
SIM,1869,27,25-29,1896,1
STAT,1940,28,na,1968,37.91113563642505
STAT,1939,31,na,1970,38.34640361017653
STAT,1869,19,na,1888,24.519107842578624
STAT,1791,95,na,1886,0.024750777578149162
STAT,1846,54,na,1900,16.97001616318902
STAT,1886,48,45-49,1934,0.0024171899394377348
STAT,1863,21,20-24,1884,0.6268096918519196
STAT,1910,22,20-24,1932,1.0378446027004804
STAT,1903,25,35-39,1928,0.13811270484972274
STAT,1914,32,35-39,1946,0.09122451534112619
STAT,1862,92,na,1954,0.3593364114447645
SIM,1852,39,na,1891,25
STAT,1858,55,na,1913,15.73415649456112
STAT,1888,35,50-100,1923,0.014483636565062536
SIM,1918,14,na,1932,40
STAT,1834,25,45-49,1859,0.01043809189692311
STAT,1884,21,40-44,1905,0.020477795872556222
SIM,1782,79,na,1861,3
SIM,1839,41,na,1880,21
STAT,1803,61,na,1864,10.479482804800366
STAT,1933,0,na,1933,60.062109519848995
STAT,1903,18,45-49,1921,9.262785007918447E-4
SIM,1841,75,na,1916,4
STAT,1926,35,30-34,1961,0.022185267623519776
SIM,1853,56,na,1909,21
SIM,1827,60,na,1887,6
STAT,1904,43,30-34,1947,0.0011356892127955165
SIM,1840,58,na,1898,9
SIM,1906,33,na,1939,26
STAT,1903,43,35-39,1946,0.001774866937097954
SIM,1872,91,na,1963,3
STAT,1908,33,20-24,1941,0.0228075834416603
SIM,1902,51,na,1953,30
STAT,1808,60,na,1868,3.8967495485683026
STAT,1852,21,45-49,1873,0.007140993968030895
STAT,1838,18,40-44,1856,0.001864082647413242
STAT,1841,78,na,1919,7.647800524046144
SIM,1828,34,na,1862,19
STAT,1905,32,40-44,1937,0.0359387701100188
STAT,1837,31,20-24,1868,0.016718959119552172
STAT,1837,33,15-19,1870,8.620931597371995E-4
STAT,1870,68,na,1938,15.180939947564346
SIM,1807,63,na,1870,15
STAT,1834,30,40-44,1864,0.040080212311723575
STAT,1909,39,45-49,1948,0.006351917645394912
STAT,1878,27,25-29,1905,0.4367272941166402
STAT,1877,90,na,1967,2.2925629160458345
SIM,1887,68,na,1955,14
STAT,1935,17,30-34,1952,0.16588963972117676
STAT,1926,24,25-29,1950,1.1087791430128753
SIM,1914,7,na,1921,38
SIM,1858,55,na,1913,24
STAT,1935,36,35-39,1971,0.033702521700187546
STAT,1821,53,40-44,1874,1.400731459645402E-4
STAT,1943,21,20-24,1964,1.1748020383174478
STAT,1871,47,45-49,1918,0.0023419514037399214
STAT,1931,18,20-24,1949,1.7620597457483562
STAT,1847,49,20-24,1896,1.2551196853229484E-4
STAT,1844,48,40-44,1892,0.0013204323317903225
STAT,1950,19,20-24,1969,1.5920659671217676
SIM,1891,50,na,1941,32
STAT,1917,45,30-34,1962,9.27012541857321E-4
STAT,1915,24,15-19,1939,0.054208478393723857
SIM,1895,64,na,1959,18
STAT,1912,23,35-39,1935,0.0892556822467361
STAT,1836,49,45-49,1885,0.0023232602218463544
STAT,1918,18,40-44,1936,0.015046877182126547
SIM,1847,17,na,1864,25
STAT,1922,31,30-34,1953,0.17743225511530383
STAT,1864,20,25-29,1884,0.5292788332877438
STAT,1929,37,20-24,1966,0.003368127462802888
STAT,1945,27,na,1972,40.80390620058848
STAT,1910,16,15-19,1926,0.08959577718010393
SIM,1845,26,na,1871,23
STAT,1912,41,35-39,1953,0.0019380291823667614
STAT,1854,16,50-100,1870,3.6034266413782914E-4
STAT,1923,23,45-49,1946,0.01296100844647022
SIM,1805,61,na,1866,11
SIM,1923,36,na,1959,38
STAT,1920,40,30-34,1960,0.0014038449836418674
SIM,1918,1,na,1919,41
STAT,1891,45,50-100,1936,0.0017173277452814076
STAT,1783,99,na,1882,0.0018606043915994474
STAT,1912,49,45-49,1961,0.002060237821689368
STAT,1944,27,45-49,1971,0.018536699096510654
STAT,1826,31,45-49,1857,0.02715480108301852
STAT,1903,44,25-29,1947,6.254315724102623E-4
SIM,1866,83,na,1949,2
STAT,1839,21,30-34,1860,0.12721491142042168
SIM,1929,19,20-24,1948,3
STAT,1860,20,40-44,1880,0.019469280359971062
STAT,1940,16,20-24,1956,1.367161369718001
STAT,1863,23,15-19,1886,0.029577689755167075
STAT,1891,27,20-24,1918,0.14398758608080883
STAT,1911,42,30-34,1953,0.0012123490568314438
STAT,1829,54,na,1883,14.83690111046317
STAT,1869,102,na,1971,0.02755168348046246
STAT,1850,44,20-24,1894,0.0013949289407921388
STAT,1944,15,30-34,1959,0.13028803406792544
SIM,1943,22,25-29,1965,2
SIM,1838,55,na,1893,4
STAT,1813,54,45-49,1867,4.1513487758055434E-4
STAT,1934,23,20-24,1957,1.4875030291588291
STAT,1924,42,na,1966,43.888603548940395
STAT,1931,22,40-44,1953,0.04341588166824466
STAT,1847,16,40-44,1863,0.0024530308058206456
SIM,1796,62,na,1858,10
STAT,1819,35,20-24,1854,0.009655794699688853
STAT,1824,36,20-24,1860,0.011468989325418419
STAT,1858,35,na,1893,18.097944439980633
STAT,1876,18,50-100,1894,4.962802645057334E-4
SIM,1841,23,na,1864,21
STAT,1923,30,35-39,1953,0.10487311085173438
STAT,1860,48,25-29,1908,4.623884188209385E-4
STAT,1924,29,20-24,1953,0.2096454184888917
STAT,1854,21,na,1875,15.466649501926385
STAT,1921,47,50-100,1968,0.002529871761466364
STAT,1880,45,45-49,1925,0.0025064064417595405
STAT,1886,26,20-24,1912,0.12210398785108023
STAT,1831,39,15-19,1870,5.62242858009739E-4
SIM,1845,37,na,1882,23
STAT,1870,17,50-100,1887,4.913158433228678E-4
STAT,1934,25,15-19,1959,0.009464794307227511
STAT,1927,18,35-39,1945,0.05177161131602497
SIM,1942,23,20-24,1965,1
SIM,1904,65,na,1969,24
STAT,1889,15,35-39,1904,0.006749232886394386
STAT,1837,26,25-29,1863,0.26922235197412464
STAT,1844,11,na,1855,23.811120000000003
STAT,1935,22,25-29,1957,1.2522645540131947
STAT,1848,25,na,1873,16.943692752533877
STAT,1959,9,na,1968,51.107754010819065
SIM,1837,70,na,1907,22
SIM,1848,8,na,1856,33
STAT,1871,18,25-29,1889,0.05652726496289992
SIM,1879,49,na,1928,14
STAT,1902,27,40-44,1929,0.04224304218653693
STAT,1933,29,15-19,1962,0.009326187408579314
SIM,1917,28,na,1945,39
SIM,1877,29,25-29,1906,1
STAT,1923,19,25-29,1942,0.5026240975240348
STAT,1909,27,30-34,1936,0.3723641208504926
STAT,1847,105,na,1952,3.132142580127117E-4
SIM,1917,27,30-34,1944,1
SIM,1834,41,na,1875,19
STAT,1838,30,25-29,1868,0.10085692157831133
STAT,1860,69,na,1929,11.930727217837257
SIM,1837,18,na,1855,29
STAT,1880,27,45-49,1907,0.01167542684169787
STAT,1942,27,15-19,1969,0.007355400010999563
STAT,1827,63,na,1890,10.813198824920496
STAT,1888,21,25-29,1909,0.670990773419525
STAT,1936,16,35-39,1952,0.04002885012323805
STAT,1868,15,15-19,1883,0.05916610297455378
STAT,1899,26,na,1925,32.78203369662831
SIM,1925,27,na,1952,45
STAT,1919,16,35-39,1935,0.009245330716840892
STAT,1878,32,20-24,1910,0.027906852934765775
STAT,1911,24,30-34,1935,0.26912863399871595
STAT,1900,36,20-24,1936,0.002318279364487463
STAT,1799,91,na,1890,0.21408086368713639
STAT,1942,25,20-24,1967,0.19035520037809842
STAT,1888,17,40-44,1905,0.002137401540865027
STAT,1769,101,na,1870,0.00643336168571822
STAT,1914,32,na,1946,37.754642388663676
STAT,1926,13,na,1939,48.22685365943269
STAT,1918,46,na,1964,38.83735306221522
STAT,1878,34,15-19,1912,0.001457654197992902
STAT,1867,91,na,1958,0.7941383712202543
STAT,1925,27,15-19,1952,0.008285940534328138
STAT,1884,72,na,1956,12.695211284752473
STAT,1905,28,20-24,1933,0.1687171742515868
STAT,1907,39,15-19,1946,1.7550797773774877E-4
STAT,1850,26,20-24,1876,0.12380892778568468
SIM,1913,46,na,1959,40
STAT,1785,78,na,1863,8.575298864263367
STAT,1893,22,45-49,1915,0.00879236983022666
STAT,1909,32,na,1941,35.88855024184983
STAT,1810,94,na,1904,0.0718392006440203
SIM,1935,18,35-39,1953,2
STAT,1887,30,20-24,1917,0.029741253502126336
SIM,1864,17,na,1881,23
STAT,1858,24,na,1882,18.521446383189645
SIM,1874,61,na,1935,22
SIM,1878,75,na,1953,10
STAT,1935,29,45-49,1964,0.023422012561592237
STAT,1878,32,na,1910,24.63669415933318
STAT,1849,41,40-44,1890,0.017519604153560124
STAT,1797,80,na,1877,2.2639499685045616
STAT,1859,72,na,1931,10.03770198515096
STAT,1877,47,40-44,1924,0.0017589920069141533
STAT,1907,53,na,1960,31.8994598845056
STAT,1890,2,na,1892,32.379848496896656
SIM,1890,24,na,1914,25
STAT,1847,23,30-34,1870,0.2315867221536601
SIM,1829,30,25-29,1859,1
STAT,1876,53,na,1929,21.517433049888464
STAT,1790,78,na,1868,1.8728322453295514
STAT,1902,34,30-34,1936,0.14016602517843996
STAT,1863,45,45-49,1908,0.002110370166438265
STAT,1898,31,na,1929,32.3229109710429
STAT,1920,48,40-44,1968,0.0017231853072893829
STAT,1839,21,na,1860,15.270458814682758
STAT,1920,15,40-44,1935,0.003136135688900862
STAT,1943,22,50-100,1965,0.006949609314833613
STAT,1909,43,30-34,1952,0.0011819434696673957
SIM,1814,42,na,1856,22
SIM,1854,62,na,1916,15
SIM,1881,40,na,1921,23
STAT,1847,40,na,1887,25.471596408681677
STAT,1818,53,50-100,1871,1.4001664364256754E-4
SIM,1908,24,na,1932,35
STAT,1898,52,na,1950,28.89241447841686
SIM,1905,29,25-29,1934,2
STAT,1879,31,25-29,1910,0.1064452110206813
STAT,1885,13,na,1898,25.46313091385626
SIM,1885,54,na,1939,19
STAT,1790,103,na,1893,1.8662762579498688E-4
STAT,1904,28,40-44,1932,0.04277206657431638
SIM,1869,2,na,1871,23
STAT,1920,22,30-34,1942,0.31680334169777774
STAT,1896,20,20-24,1916,0.9105912954616052
STAT,1936,21,30-34,1957,0.27320880319059865
STAT,1947,20,50-100,1967,0.0073908603735969025
STAT,1898,44,40-44,1942,0.00207862145385761
SIM,1889,16,na,1905,34
STAT,1811,45,25-29,1856,0.0023535472019057427
STAT,1821,78,na,1899,4.852768331790265
STAT,1879,72,na,1951,13.071088552294675
STAT,1887,24,15-19,1911,0.035783679355664226
STAT,1915,21,45-49,1936,0.011565151906515993
STAT,1845,25,20-24,1870,0.08468095602957483
STAT,1826,78,na,1904,5.460084907533352
STAT,1827,40,na,1867,16.687599433268623
STAT,1925,8,na,1933,47.87833894427322
SIM,1906,2,na,1908,30
STAT,1926,31,15-19,1957,0.0015458590534356857
SIM,1901,14,na,1915,41
STAT,1891,21,na,1912,29.115387699802355
STAT,1922,31,na,1953,42.59295774558854
SIM,1881,51,na,1932,20
STAT,1906,13,na,1919,37.460946713510964
SIM,1877,35,na,1912,28
STAT,1832,38,20-24,1870,0.004329361733505321
STAT,1813,59,na,1872,16.402396325720986
STAT,1916,35,20-24,1951,0.002701855094856026
SIM,1958,11,na,1969,53
STAT,1914,43,na,1957,36.43804506397944
STAT,1862,108,na,1970,2.3588362561534625E-4
STAT,1821,35,40-44,1856,0.10671644739657168
STAT,1899,24,40-44,1923,0.028347382438072027
STAT,1935,33,30-34,1968,0.21687044098894254
SIM,1920,17,na,1937,41
STAT,1789,92,na,1881,0.07264708115096592
STAT,1896,20,na,1916,31.25112083631524
STAT,1890,48,50-100,1938,0.0016616905764877778
STAT,1901,69,na,1970,24.180703850648488
STAT,1876,21,35-39,1897,0.05944674005936945
STAT,1889,45,50-100,1934,0.0030369367402053892
SIM,1934,21,20-24,1955,1
STAT,1836,46,40-44,1882,0.0017513856720240409
STAT,1849,104,na,1953,5.171863147075439E-4
STAT,1931,35,na,1966,49.69067654118971
STAT,1905,35,45-49,1940,0.006268906169647466
SIM,1820,38,na,1858,16
SIM,1921,34,40-44,1955,1
SIM,1893,21,na,1914,36
STAT,1903,40,30-34,1943,0.0011464982581472706
SIM,1873,76,na,1949,3
STAT,1833,30,50-100,1863,0.008916932904900176
STAT,1842,40,na,1882,18.40652983828548
SIM,1843,55,na,1898,18
STAT,1911,20,15-19,1931,0.050458768751875466
STAT,1876,20,na,1896,24.16383575418032
STAT,1902,3,na,1905,37.28028071646817
STAT,1920,43,35-39,1963,0.0022015565993132183
SIM,1897,35,na,1932,40
STAT,1952,17,30-34,1969,0.14520326208187803
STAT,1836,88,na,1924,1.324930907594709
STAT,1925,45,50-100,1970,0.0027364201222981974
STAT,1832,74,na,1906,5.016342260496271
STAT,1855,18,40-44,1873,0.0015226467604498091
STAT,1815,93,na,1908,0.10432551874539397
STAT,1889,27,na,1916,29.218960573783413
STAT,1854,37,45-49,1891,0.012184888881941408
SIM,1863,4,na,1867,24
STAT,1793,66,na,1859,4.149571137345799
STAT,1842,32,40-44,1874,0.03930607092483414
STAT,1873,39,20-24,1912,0.007758286200111001
SIM,1916,43,na,1959,44
SIM,1862,69,na,1931,16
STAT,1919,42,na,1961,39.89818567919793
STAT,1834,22,na,1856,20.20803801831966
SIM,1863,55,na,1918,9
SIM,1867,69,na,1936,6
STAT,1909,36,40-44,1945,0.014157818580344143
STAT,1862,39,45-49,1901,0.017025996943377013
STAT,1920,28,na,1948,40.60121801088767
STAT,1922,19,45-49,1941,0.00570813673189873
STAT,1881,15,30-34,1896,0.015236825210622239
STAT,1871,15,20-24,1886,0.18000932564227284
STAT,1854,31,20-24,1885,0.017096171625077858
STAT,1908,9,na,1917,38.288921058460396
STAT,1914,39,50-100,1953,0.0041154122319090386
STAT,1812,74,na,1886,4.536663537738284
STAT,1943,24,25-29,1967,0.9749227678715743
STAT,1839,24,35-39,1863,0.040785573368571394
STAT,1804,53,40-44,1857,2.834252286752295E-4
STAT,1889,71,na,1960,17.870856138928296
STAT,1911,19,35-39,1930,0.008298020799508228
SIM,1907,39,na,1946,39
STAT,1868,4,na,1872,28.858718159575844
STAT,1933,38,25-29,1971,0.013342923654929511
STAT,1930,18,40-44,1948,0.01795145583220541
STAT,1931,32,35-39,1963,0.11921229989416793
STAT,1921,32,25-29,1953,0.10205399936001815
STAT,1907,29,20-24,1936,0.1689414644878778
STAT,1927,15,30-34,1942,0.1514797910212746
STAT,1871,44,40-44,1915,0.022122588858904856
STAT,1889,16,na,1905,30.99774095949359
SIM,1873,21,na,1894,30
STAT,1886,29,25-29,1915,0.43564235701878923
STAT,1931,25,45-49,1956,0.022224761713524162
STAT,1819,38,25-29,1857,0.02977887205879477
STAT,1815,47,50-100,1862,0.003539854820015569
STAT,1903,48,40-44,1951,0.0013557311862667971
STAT,1926,19,50-100,1945,0.004542714163610147
SIM,1882,80,na,1962,12
STAT,1817,74,na,1891,8.795498632908213
SIM,1901,22,20-24,1923,2
STAT,1806,48,20-24,1854,3.983928666489151E-4
STAT,1847,19,45-49,1866,8.606928452039031E-4
STAT,1883,33,40-44,1916,0.04193533298328146
STAT,1831,89,na,1920,0.8525027203631794
STAT,1925,27,na,1952,43.96947187953261
STAT,1872,39,na,1911,23.86304369915336
STAT,1923,16,20-24,1939,1.584835871845123
STAT,1938,34,45-49,1972,0.015697782108960993
SIM,1784,82,na,1866,1
SIM,1878,20,na,1898,26
STAT,1828,41,20-24,1869,7.074904422931567E-4
STAT,1838,99,na,1937,0.014699185300513734
STAT,1913,34,40-44,1947,0.03827853895166073
STAT,1813,60,na,1873,16.080745333773596
SIM,1816,56,na,1872,11
SIM,1868,39,25-29,1907,1
STAT,1902,54,na,1956,29.729687078579197
SIM,1931,16,20-24,1947,2
SIM,1841,44,na,1885,16
STAT,1870,38,40-44,1908,0.043269924499490735
STAT,1918,22,25-29,1940,0.9872121438046156
STAT,1895,38,50-100,1933,0.015860176053826
STAT,1789,81,na,1870,1.3015894868894637
STAT,1933,19,20-24,1952,1.7977864091297324
STAT,1816,42,40-44,1858,0.030994900515192665
STAT,1893,47,25-29,1940,4.077642197275726E-4
SIM,1933,35,na,1968,49
STAT,1802,75,na,1877,3.6596372615838617
STAT,1953,17,45-49,1970,0.006007967865871731
SIM,1846,22,na,1868,17
SIM,1892,35,na,1927,34
STAT,1912,16,45-49,1928,0.0010046886334901142
STAT,1913,41,30-34,1954,0.0012434292883102805
SIM,1896,49,na,1945,26
STAT,1944,18,35-39,1962,0.04481514229859314
STAT,1873,87,na,1960,2.789626625084445
STAT,1915,47,20-24,1962,1.1039624087782647E-4
SIM,1825,37,na,1862,19
SIM,1871,10,na,1881,27
STAT,1925,47,30-34,1972,0.0010734715287444429
SIM,1886,28,na,1914,30
STAT,1919,39,40-44,1958,0.015908897236483338
STAT,1836,33,na,1869,26.16478595532285
STAT,1848,20,40-44,1868,0.016646580209918826
STAT,1872,22,25-29,1894,0.5857200413415719
STAT,1941,5,na,1946,40.877470805674044
STAT,1849,10,na,1859,23.070348329200243
STAT,1885,20,45-49,1905,0.006927240509021439
SIM,1868,54,na,1922,31
STAT,1922,26,35-39,1948,0.1692220512091278
STAT,1819,44,na,1863,14.319726440115588
STAT,1939,17,15-19,1956,0.45115838789322416
STAT,1845,28,25-29,1873,0.2988137086364987
STAT,1943,28,40-44,1971,0.049255221787305785
STAT,1861,18,50-100,1879,4.7075706121646265E-4
SIM,1856,73,na,1929,7
STAT,1901,24,20-24,1925,0.9582346531599948
SIM,1832,30,na,1862,24
STAT,1871,21,na,1892,23.650731738999667
STAT,1910,36,30-34,1946,0.01740791727213872
STAT,1870,80,na,1950,6.145064922051031
STAT,1857,43,40-44,1900,0.016716623870159333
STAT,1903,42,50-100,1945,0.0010417304225959218
SIM,1869,39,na,1908,16
STAT,1890,35,na,1925,28.889912701102205
STAT,1839,17,45-49,1856,4.715684122017018E-4
SIM,1921,9,na,1930,42
STAT,1866,33,50-100,1899,0.008402842253890336
STAT,1885,57,na,1942,19.845403716515918
STAT,1869,48,45-49,1917,0.002257969219668413
STAT,1882,34,50-100,1916,0.008705604715867917
STAT,1935,26,40-44,1961,0.06328295806154878
STAT,1896,19,40-44,1915,0.002389613409128578
SIM,1918,20,25-29,1938,3
STAT,1858,23,40-44,1881,0.016436986043995697
STAT,1875,31,40-44,1906,0.04476111529885174
STAT,1921,36,40-44,1957,0.01659981641130111
STAT,1862,40,50-100,1902,0.009206663770906426
SIM,1935,15,30-34,1950,3
SIM,1802,64,na,1866,11
STAT,1899,41,50-100,1940,0.0010088237666074202
STAT,1917,25,15-19,1942,0.007385931648644461
STAT,1853,36,na,1889,14.96142544070992
STAT,1940,19,25-29,1959,0.436582952308601
STAT,1887,33,25-29,1920,0.11132702793925732
STAT,1893,53,na,1946,26.71363284755028
STAT,1841,55,na,1896,20.239087383356278
STAT,1863,16,25-29,1879,0.05759141516300117
STAT,1932,20,na,1952,48.00554174447191
STAT,1936,34,na,1970,36.466357488726
STAT,1920,18,45-49,1938,0.005542301073780672
STAT,1820,48,50-100,1868,0.0020493244281910316
STAT,1829,28,40-44,1857,0.03163493720062492
STAT,1843,15,45-49,1858,3.583154272911044E-4
SIM,1872,20,25-29,1892,2
STAT,1909,46,35-39,1955,0.00118100795334312
STAT,1849,51,na,1900,16.77535645046558
SIM,1884,17,na,1901,26
STAT,1862,36,40-44,1898,0.03794932323289575
SIM,1856,84,na,1940,1
STAT,1828,47,45-49,1875,0.0010110289019296926
STAT,1917,38,40-44,1955,0.015330979516169334
STAT,1927,34,35-39,1961,0.11169459027467937
STAT,1906,18,15-19,1924,0.08599220157162905
STAT,1863,42,40-44,1905,0.019890515917262146
SIM,1819,41,na,1860,7
STAT,1906,25,50-100,1931,0.009356602782423975
STAT,1885,49,40-44,1934,0.0016553263832083504
SIM,1886,50,na,1936,27
STAT,1852,46,25-29,1898,4.943681945266876E-4
STAT,1820,93,na,1913,0.16568601442887237
STAT,1884,16,45-49,1900,6.415703627525071E-4
SIM,1789,81,na,1870,2
STAT,1840,27,50-100,1867,0.006249947366030705
STAT,1923,49,20-24,1972,1.2763097777563042E-4
SIM,1933,17,20-24,1950,6
STAT,1821,38,45-49,1859,0.03736542766960761
STAT,1910,29,40-44,1939,0.044414716684885384
STAT,1857,39,na,1896,17.459525516145195
SIM,1829,74,na,1903,15
STAT,1873,35,50-100,1908,0.012600916680632785
STAT,1846,32,25-29,1878,0.09809587148399543
STAT,1912,21,na,1933,36.395911465865545
SIM,1915,17,na,1932,39
STAT,1853,25,na,1878,15.978697804721431
STAT,1900,39,25-29,1939,0.008530795540152201
STAT,1811,49,40-44,1860,0.006570982987739038
SIM,1855,36,na,1891,18
STAT,1926,21,20-24,1947,1.3472162650013197
SIM,1914,32,na,1946,36
STAT,1927,27,45-49,1954,0.02089553958846166
SIM,1858,31,35-39,1889,1
STAT,1898,40,25-29,1938,6.076258497887305E-4
STAT,1895,38,45-49,1933,0.025752177942884688
STAT,1905,42,35-39,1947,0.0018125929276431635
STAT,1855,25,30-34,1880,0.20602900994507364
STAT,1891,4,na,1895,32.28810899210771
STAT,1854,73,na,1927,7.259960208290488
SIM,1898,20,na,1918,34
STAT,1907,48,25-29,1955,4.6929375674269555E-4
STAT,1862,40,na,1902,20.14176663129527
STAT,1890,68,na,1958,19.371257312830362
STAT,1866,54,na,1920,19.284957702272546
STAT,1900,31,15-19,1931,0.0019828116066731185
STAT,1920,25,35-39,1945,0.1644013428225771
STAT,1824,46,50-100,1870,0.003220346783000301
SIM,1840,37,na,1877,17
SIM,1903,20,30-34,1923,1
STAT,1919,31,na,1950,40.61549618494596
SIM,1964,6,na,1970,52
STAT,1795,77,na,1872,4.173490534430039
STAT,1865,37,20-24,1902,0.006972230616424899
STAT,1850,23,50-100,1873,0.0043266141590622455
SIM,1880,3,na,1883,39
STAT,1867,39,na,1906,22.318859203095766
STAT,1915,20,35-39,1935,0.09314504823938026
STAT,1918,21,15-19,1939,0.05706409915592105
STAT,1840,47,45-49,1887,0.0018648465612045536
STAT,1947,24,45-49,1971,0.012621065078420908
SIM,1867,23,20-24,1890,1
STAT,1865,22,35-39,1887,0.05342277848869484
STAT,1922,16,40-44,1938,0.016108426927115598
STAT,1819,46,40-44,1865,0.0015625231437510414
STAT,1920,1,na,1921,46.454476723263596
STAT,1880,23,15-19,1903,0.0345837941099749
STAT,1929,35,35-39,1964,0.03095777647869782
STAT,1843,48,25-29,1891,2.4126541535488832E-4
STAT,1868,23,15-19,1891,0.031827498275907785
STAT,1871,44,na,1915,22.73203049507813
STAT,1847,31,30-34,1878,0.22127362521874577
STAT,1812,102,na,1914,0.0011651235920400274
SIM,1953,12,na,1965,50
STAT,1880,49,40-44,1929,0.0017626708641961476
SIM,1903,34,25-29,1937,2
STAT,1925,17,20-24,1942,1.627496874193033
STAT,1852,61,na,1913,15.992684110577787
STAT,1845,36,25-29,1881,0.01786803319793399
STAT,1888,25,40-44,1913,0.035243593687661806
STAT,1848,23,45-49,1871,0.00545144713470247
STAT,1875,19,20-24,1894,0.18126173923622918
SIM,1955,13,na,1968,46
STAT,1841,24,na,1865,26.13265882897784
STAT,1862,33,20-24,1895,0.023222620024143256
STAT,1941,18,30-34,1959,0.12459639603665053
SIM,1868,31,na,1899,33
STAT,1794,82,na,1876,1.9232664831304593
STAT,1862,8,na,1870,24.264865666748026
STAT,1908,32,50-100,1940,0.007763762988914039
STAT,1909,21,20-24,1930,1.0307596962459735
STAT,1829,75,na,1904,6.99264187559593
STAT,1878,42,15-19,1920,1.4239957153122383E-4
STAT,1839,25,45-49,1864,0.00783104228644217
STAT,1887,79,na,1966,10.995427206519103
STAT,1854,34,25-29,1888,0.06279499035384342
STAT,1912,31,20-24,1943,0.023910750876710053
STAT,1875,41,35-39,1916,0.018698342888622353
SIM,1872,36,na,1908,21
STAT,1905,38,15-19,1943,1.7405997741220814E-4
STAT,1856,22,40-44,1878,0.017532366830422676
STAT,1889,38,20-24,1927,0.009390936067680884
STAT,1892,16,na,1908,31.278162697644667
STAT,1811,89,na,1900,0.5953501085629872
STAT,1874,20,35-39,1894,0.05955366748402166
STAT,1929,33,40-44,1962,0.049439637817061635
STAT,1881,16,40-44,1897,0.0017446765043321064
STAT,1822,41,na,1863,9.943225084382052
STAT,1854,3,na,1857,20.6583004046347
STAT,1897,18,45-49,1915,8.651810008796907E-4
STAT,1859,25,15-19,1884,0.0037215996458015823
STAT,1837,37,45-49,1874,0.011827145472855766
STAT,1807,74,na,1881,5.5818439884747155
STAT,1828,39,45-49,1867,0.008807328853906697
STAT,1872,18,40-44,1890,0.001866506501929011
STAT,1794,92,na,1886,0.13263986170884506
SIM,1813,59,na,1872,7
STAT,1930,40,40-44,1970,0.003284702397629405
STAT,1867,49,na,1916,21.08055710451343
STAT,1864,19,45-49,1883,5.989740457655259E-4
STAT,1879,34,30-34,1913,0.17916265562786834
STAT,1826,57,na,1883,14.96509679880251
STAT,1883,36,45-49,1919,0.01945155281783725
STAT,1825,42,50-100,1867,0.01027355631593137
STAT,1875,68,na,1943,15.708986976199371
SIM,1851,74,na,1925,13
STAT,1893,29,50-100,1922,0.008008089167003853
STAT,1863,27,45-49,1890,0.00983059733514505
SIM,1806,77,na,1883,1
STAT,1869,44,15-19,1913,1.3200298401545559E-4
STAT,1809,75,na,1884,5.938653595830615
STAT,1818,38,na,1856,7.533603113244732
SIM,1937,33,40-44,1970,1
STAT,1877,49,na,1926,22.7393259552232
STAT,1889,31,50-100,1920,0.011263728137760201
STAT,1829,35,30-34,1864,0.05001405851200731
STAT,1887,38,50-100,1925,0.013334438784262447
SIM,1922,21,30-34,1943,1
STAT,1934,15,20-24,1949,1.834508479639848
STAT,1889,7,na,1896,31.8982016531464
STAT,1877,69,na,1946,15.148878870236851
SIM,1800,62,na,1862,9
STAT,1896,26,30-34,1922,0.33190844475180603
STAT,1850,51,45-49,1901,1.298316782356568E-4
STAT,1902,37,35-39,1939,0.021528303685007473
STAT,1907,21,50-100,1928,0.005982969292049005
SIM,1861,74,na,1935,11
STAT,1816,45,45-49,1861,0.003066024991119601
STAT,1816,57,na,1873,7.5001368298342
STAT,1927,45,25-29,1972,6.655719288447231E-4
STAT,1792,102,na,1894,0.0011108462645237464
SIM,1891,19,na,1910,36
STAT,1872,91,na,1963,1.3708221454433644
STAT,1894,17,na,1911,32.36796329757772
STAT,1929,28,45-49,1957,0.021507842717302106
STAT,1824,31,50-100,1855,0.01546128362581991
STAT,1859,23,20-24,1882,0.5642062163322544
STAT,1930,22,25-29,1952,1.1777789492145492
STAT,1892,36,na,1928,29.246010433948406
SIM,1849,27,20-24,1876,1
STAT,1854,96,na,1950,0.05248465794301263
STAT,1831,49,45-49,1880,0.0022022600806645945
STAT,1850,18,20-24,1868,0.19175238522201787
STAT,1886,37,40-44,1923,0.04540636199403019
SIM,1823,35,na,1858,11
STAT,1864,23,30-34,1887,0.16116601510635675
STAT,1833,26,20-24,1859,0.11530189685982964
STAT,1877,39,25-29,1916,0.02942170427482494
STAT,1894,36,20-24,1930,0.009926685636001619
SIM,1881,19,na,1900,26
STAT,1884,17,na,1901,24.744675288213802
STAT,1792,81,na,1873,4.189830547227033
STAT,1848,30,35-39,1878,0.0779776807662536
STAT,1828,44,25-29,1872,0.002769013404532274
STAT,1897,25,35-39,1922,0.1290027654900058
STAT,1906,20,40-44,1926,0.030454535980796033
STAT,1909,23,15-19,1932,0.04904465628383385
STAT,1923,15,45-49,1938,0.005852240393983101
SIM,1821,44,na,1865,14
STAT,1865,15,45-49,1880,6.770104388512252E-4
STAT,1881,54,na,1935,19.924910405615865
STAT,1855,26,40-44,1881,0.02214268996376069
STAT,1906,39,50-100,1945,0.0038111776818149155
STAT,1834,40,35-39,1874,0.015827432491296742
STAT,1854,29,45-49,1883,0.007012731072060178
STAT,1782,81,na,1863,1.516556356511116
STAT,1908,25,20-24,1933,0.17429517462913857
SIM,1897,23,35-39,1920,1
SIM,1850,37,na,1887,21
STAT,1831,24,na,1855,22.662476481170625
STAT,1917,45,50-100,1962,0.0023520070216117594
STAT,1904,66,na,1970,26.898253963194655
STAT,1784,82,na,1866,2.284666784076572
STAT,1876,47,25-29,1923,5.822845917627038E-4
STAT,1840,29,15-19,1869,0.004369355906640713
SIM,1849,40,na,1889,7
STAT,1859,18,25-29,1877,0.051974194174662126
STAT,1829,36,50-100,1865,0.011404937173576211
STAT,1937,27,40-44,1964,0.045148727794358995
SIM,1938,11,na,1949,40
STAT,1946,25,40-44,1971,0.0515997093887745
SIM,1943,12,na,1955,48
STAT,1862,54,50-100,1916,1.267179844366262E-4
STAT,1865,105,na,1970,0.003021501640976149
STAT,1846,77,na,1923,7.005276943665593
SIM,1830,27,na,1857,21
STAT,1868,16,25-29,1884,0.05616321481881984
STAT,1869,15,30-34,1884,0.015843605344392196
STAT,1914,24,35-39,1938,0.09480328910440401
STAT,1889,23,35-39,1912,0.07122486538315775
STAT,1887,69,na,1956,16.297913048695378
SIM,1925,15,20-24,1940,3
STAT,1847,24,40-44,1871,0.02689815296771662
STAT,1830,25,40-44,1855,0.034452580594752424
STAT,1851,24,na,1875,21.247664739604172
SIM,1881,29,na,1910,25
STAT,1857,46,45-49,1903,0.0017717309979027485
STAT,1830,25,25-29,1855,0.48651711666697944
STAT,1849,29,20-24,1878,0.10628718042228416
SIM,1857,29,20-24,1886,1
SIM,1856,1,na,1857,28
STAT,1869,47,50-100,1916,0.0023686256992375134
STAT,1912,41,50-100,1953,0.001130670977891173
STAT,1838,26,40-44,1864,0.0297889360045635
STAT,1881,48,45-49,1929,0.0022174259346668425
SIM,1811,78,na,1889,1
STAT,1868,86,na,1954,2.147196346923331
STAT,1940,16,50-100,1956,0.0037780796651600305
STAT,1857,34,50-100,1891,0.006800363071157721
STAT,1888,49,50-100,1937,0.0015851596142382818
STAT,1908,20,50-100,1928,0.00605365589350807
STAT,1911,14,na,1925,39.13823434527215
STAT,1861,44,na,1905,19.174142132747495
SIM,1942,0,na,1942,43
STAT,1878,35,40-44,1913,0.0456233213229013
STAT,1858,27,20-24,1885,0.0913851499154727
STAT,1848,37,20-24,1885,0.0051372208312009645
STAT,1947,0,na,1947,49.665264097343645
SIM,1927,5,na,1932,52
SIM,1847,69,na,1916,10
SIM,1850,27,na,1877,22
STAT,1809,55,na,1864,15.291376128675497
STAT,1955,5,na,1960,51.90099481877969
STAT,1829,36,40-44,1865,0.04066417333706709
STAT,1886,44,15-19,1930,1.4131117561681206E-4
SIM,1957,3,na,1960,56
STAT,1826,53,50-100,1879,1.4387691185994858E-4
STAT,1867,17,20-24,1884,0.17343836254254374
STAT,1878,25,50-100,1903,0.006649102220017803
STAT,1938,26,45-49,1964,0.01701037009584413
STAT,1853,35,20-24,1888,0.004946303256966475
STAT,1902,31,na,1933,33.78896092047448
STAT,1914,22,40-44,1936,0.034066851326920104
STAT,1845,39,45-49,1884,0.011991952607681045
STAT,1879,27,40-44,1906,0.03100438591496197
STAT,1891,19,20-24,1910,0.21642666653699116
SIM,1924,21,na,1945,47
STAT,1820,35,25-29,1855,0.028057302895528567
STAT,1872,71,na,1943,13.657282169083041
STAT,1863,31,15-19,1894,0.0012660268738072485
STAT,1864,24,40-44,1888,0.018718983917617487
STAT,1860,90,na,1950,0.6409522935356078
STAT,1938,33,35-39,1971,0.0912243572206224
STAT,1873,21,30-34,1894,0.18164291364071586
SIM,1912,20,na,1932,37
STAT,1833,59,na,1892,14.388305315462427
SIM,1875,17,20-24,1892,3
SIM,1896,70,na,1966,20
STAT,1869,37,25-29,1906,0.02789773346225306
STAT,1904,32,25-29,1936,0.0842726535876999
STAT,1847,49,na,1896,23.531827813852193
STAT,1910,39,35-39,1949,0.02276011494408207
STAT,1838,33,30-34,1871,0.16664939404505266
STAT,1895,34,15-19,1929,0.00183298625944098
STAT,1956,10,na,1966,51.699859350955855
STAT,1954,17,50-100,1971,0.004605192654849285
STAT,1837,94,na,1931,0.09663754091609908
STAT,1910,50,na,1960,33.76010965174014
STAT,1884,46,20-24,1930,1.1790404210284895E-4
STAT,1829,85,na,1914,1.8620636344283574
STAT,1896,27,40-44,1923,0.039347810151169
SIM,1950,5,na,1955,65
STAT,1937,34,30-34,1971,0.15469045258839537
STAT,1810,46,20-24,1856,1.1856636922791066E-4
STAT,1886,37,25-29,1923,0.029864942387468108
STAT,1875,34,45-49,1909,0.017772012796978
STAT,1917,48,35-39,1965,0.0013307302443494545
STAT,1909,24,25-29,1933,0.8483306521352775
STAT,1839,32,35-39,1871,0.06877520383419296
STAT,1852,71,na,1923,11.423867175843556
STAT,1928,37,40-44,1965,0.01882630669629921
STAT,1890,38,45-49,1928,0.02409483465774532
STAT,1882,16,na,1898,24.263434675675395
STAT,1914,17,45-49,1931,0.001024772684228847
SIM,1888,51,na,1939,32
STAT,1819,46,25-29,1865,5.257087171694338E-4
STAT,1848,22,35-39,1870,0.04594992180666044
SIM,1859,40,na,1899,18
STAT,1823,47,45-49,1870,0.001638585345727784
STAT,1929,32,30-34,1961,0.19916856959034557
STAT,1797,79,na,1876,2.4890332448349897
STAT,1895,27,25-29,1922,0.5491804094145922
STAT,1932,20,35-39,1952,0.12377908561338126
STAT,1830,32,15-19,1862,9.368053759068593E-4
SIM,1847,31,50-100,1878,1
SIM,1948,11,na,1959,39
STAT,1880,35,na,1915,25.009635842177648
STAT,1900,17,30-34,1917,0.022101900504648143
STAT,1912,34,25-29,1946,0.0894628392084567
SIM,1895,23,na,1918,29
STAT,1884,39,30-34,1923,0.051691104932696
SIM,1896,24,30-34,1920,1
SIM,1871,74,na,1945,11
STAT,1794,102,na,1896,6.360531157136147E-4
STAT,1894,39,40-44,1933,0.05553708208812765
STAT,1879,19,50-100,1898,5.043515266007752E-4
STAT,1888,24,30-34,1912,0.2068509100601843
SIM,1917,24,25-29,1941,2
STAT,1947,21,40-44,1968,0.03775369753561216
STAT,1864,42,na,1906,20.70451622521864
STAT,1887,36,30-34,1923,0.0584527426183443
STAT,1839,31,50-100,1870,0.00628738014941735
SIM,1894,47,na,1941,29
SIM,1867,26,25-29,1893,1
STAT,1942,17,20-24,1959,1.4064962767847022
STAT,1854,33,15-19,1887,8.821807742646577E-4
STAT,1861,36,25-29,1897,0.024329304988498435
STAT,1906,23,45-49,1929,0.010099494014084363
SIM,1918,45,na,1963,34
STAT,1906,47,na,1953,32.539707744269876
STAT,1929,36,45-49,1965,0.008718223538972517
STAT,1844,52,na,1896,16.728753991398882
STAT,1837,34,25-29,1871,0.061343459502556374
SIM,1867,14,na,1881,18
STAT,1845,33,20-24,1878,0.0185930286152951
STAT,1880,90,na,1970,2.666573380194389
STAT,1802,98,na,1900,0.009921212494059821
STAT,1850,37,50-100,1887,0.011104495290703236
STAT,1867,105,na,1972,0.004045808315302622
STAT,1832,27,50-100,1859,0.003826979123861182
STAT,1872,47,40-44,1919,0.0017435010245675417
STAT,1857,20,35-39,1877,0.051163747727864854
STAT,1813,51,40-44,1864,3.19712465335753E-4
STAT,1834,33,45-49,1867,0.015622207368455534
STAT,1885,15,15-19,1900,0.05887685308970484
STAT,1842,95,na,1937,0.09975362540361356
STAT,1859,26,25-29,1885,0.34449578591994673
STAT,1840,15,40-44,1855,0.001877673566366653
SIM,1901,34,na,1935,38
STAT,1921,14,na,1935,44.66733339905576
STAT,1856,25,45-49,1881,0.008455799632421065
STAT,1828,36,25-29,1864,0.01294452950126726
SIM,1863,45,na,1908,11
STAT,1776,97,na,1873,0.006426161181108775
STAT,1926,23,15-19,1949,0.06410200059007037
STAT,1838,36,35-39,1874,0.06693213213212205
STAT,1826,41,50-100,1867,0.01138770890274598
STAT,1835,46,25-29,1881,2.784760906803081E-4
STAT,1868,49,40-44,1917,0.0016221876556631086
STAT,1836,20,15-19,1856,0.042628730310757396
STAT,1813,50,na,1863,19.60094196412054
STAT,1864,105,na,1969,0.0026478983217256163
SIM,1841,54,na,1895,14
STAT,1791,64,na,1855,7.707199999999999
STAT,1831,46,40-44,1877,0.0016601948292871
SIM,1833,25,na,1858,13
SIM,1878,37,40-44,1915,1
STAT,1927,42,20-24,1969,2.2035604162881037E-4
SIM,1872,26,35-39,1898,1
STAT,1867,69,na,1936,14.043811444640955
STAT,1900,24,50-100,1924,0.0056193563943640595
SIM,1878,31,na,1909,26
STAT,1864,16,40-44,1880,0.0018759507127989155
SIM,1803,59,na,1862,9
STAT,1906,30,35-39,1936,0.08515975091305074
SIM,1831,44,na,1875,9
STAT,1961,11,na,1972,50.45871407710144
STAT,1814,49,45-49,1863,0.0065544826691742416
STAT,1836,23,na,1859,27.03722570059265
STAT,1868,36,50-100,1904,0.011938608863363771
STAT,1846,28,50-100,1874,0.006226626725404797
SIM,1929,33,35-39,1962,2
STAT,1865,68,na,1933,13.822353378498555
STAT,1860,23,45-49,1883,0.005802004571580988
STAT,1887,29,40-44,1916,0.03246312157861699
STAT,1923,26,15-19,1949,0.008076597634346091
STAT,1927,39,na,1966,46.43754012584605
SIM,1911,44,na,1955,40
SIM,1886,18,na,1904,30
STAT,1875,30,50-100,1905,0.009494181428205605
STAT,1864,48,45-49,1912,0.002090141117439064
STAT,1901,38,30-34,1939,0.016016548408719317
SIM,1901,68,na,1969,27
STAT,1863,24,40-44,1887,0.018548430344268327
STAT,1823,60,na,1883,11.835233527333264
STAT,1888,20,50-100,1908,0.004793863969216802
SIM,1854,41,na,1895,17
STAT,1854,26,25-29,1880,0.3000182257220448
STAT,1864,26,35-39,1890,0.08684044147397794
STAT,1937,35,40-44,1972,0.014900487742918874
STAT,1871,23,20-24,1894,0.6849348013072392
STAT,1853,38,40-44,1891,0.02737532438025397
SIM,1818,58,na,1876,23
STAT,1806,57,na,1863,14.424903340089218
STAT,1843,38,30-34,1881,0.02376909476894832
SIM,1908,26,25-29,1934,2
STAT,1819,49,45-49,1868,0.002068691721967511
STAT,1866,29,20-24,1895,0.10727228802512015
SIM,1881,21,30-34,1902,2
STAT,1796,63,na,1859,1.718888346331908
STAT,1809,49,35-39,1858,0.004629940410362067
SIM,1937,28,na,1965,40
STAT,1859,33,15-19,1892,0.0011271037072648343
STAT,1934,18,25-29,1952,0.5821392697837364
STAT,1929,25,40-44,1954,0.058275563403771005
STAT,1862,36,25-29,1898,0.024960254515498177
STAT,1901,48,na,1949,31.09154005110771
SIM,1925,23,20-24,1948,3
SIM,1844,41,na,1885,5
STAT,1917,23,20-24,1940,1.1674327775042095
STAT,1860,30,35-39,1890,0.08299206537993278
STAT,1888,5,na,1893,30.6247301470915
STAT,1880,19,45-49,1899,6.832171139362291E-4
SIM,1952,6,na,1958,35
STAT,1840,39,45-49,1879,0.01809583553580611
STAT,1922,24,40-44,1946,0.03803653468635996
STAT,1872,26,40-44,1898,0.030754899030901325
STAT,1862,28,25-29,1890,0.36367703237127297
SIM,1896,32,30-34,1928,2
STAT,1878,35,25-29,1913,0.030007642167248112
STAT,1836,25,50-100,1861,0.00810435016226692
STAT,1931,28,15-19,1959,0.009069437092984769
STAT,1898,21,35-39,1919,0.07895834120939696
STAT,1862,61,na,1923,16.121926792133287
STAT,1926,16,25-29,1942,0.5295711841172699
STAT,1854,37,30-34,1891,0.03257624587390142
STAT,1876,18,25-29,1894,0.05740309551339568
STAT,1899,20,25-29,1919,0.7883301560996174
STAT,1919,43,25-29,1962,7.65927974555734E-4
STAT,1888,32,30-34,1920,0.20403391400696966
STAT,1906,15,45-49,1921,9.534249563175814E-4
STAT,1871,26,40-44,1897,0.029968274268047698
STAT,1908,28,25-29,1936,0.616807705223861
STAT,1839,39,20-24,1878,0.004979072070029636
STAT,1929,40,30-34,1969,0.0016523036512707016
STAT,1922,23,30-34,1945,0.32617142783889247
STAT,1959,0,na,1959,51.51505559559849
STAT,1830,28,45-49,1858,0.009094239176405606
STAT,1872,25,30-34,1897,0.25940170225905723
SIM,1903,15,na,1918,38
STAT,1856,46,45-49,1902,0.0017145167520510683
STAT,1819,38,40-44,1857,0.045275501520569944
STAT,1838,29,45-49,1867,0.010805118049893755
STAT,1844,15,25-29,1859,0.05693398068447515
STAT,1832,95,na,1927,0.06009700627397372
STAT,1849,44,45-49,1893,0.011448174475316876
SIM,1873,55,na,1928,22
STAT,1793,102,na,1895,2.936376567355064E-4
STAT,1855,68,na,1923,10.759577669853156
STAT,1859,15,20-24,1874,0.16551021264379087
STAT,1878,16,35-39,1894,0.00567888277061301
STAT,1890,16,35-39,1906,0.00668155566856501
STAT,1886,29,40-44,1915,0.03084989798200955
STAT,1904,24,25-29,1928,0.8151320221642557
STAT,1825,30,50-100,1855,0.013417281999690443
SIM,1930,24,40-44,1954,1
STAT,1811,48,na,1859,16.845688960337277
STAT,1864,38,50-100,1902,0.01095728673783309
STAT,1868,46,20-24,1914,1.1645915381721641E-4
STAT,1916,27,20-24,1943,0.18712601002633816
STAT,1825,49,20-24,1874,1.0780488839380462E-4
STAT,1914,21,30-34,1935,0.28028089630197683
STAT,1857,70,na,1927,10.503526255567332
STAT,1882,15,45-49,1897,6.289227162407369E-4
SIM,1887,0,na,1887,38
SIM,1877,14,na,1891,31
STAT,1870,90,na,1960,1.3513660228512032
STAT,1867,25,20-24,1892,0.11302700739074584
STAT,1871,33,15-19,1904,0.001413813439081293
STAT,1937,25,50-100,1962,0.00964974930438566
STAT,1861,29,35-39,1890,0.0805632508197662
STAT,1846,35,30-34,1881,0.0460515049849139
STAT,1898,47,45-49,1945,0.0017874669476655536
STAT,1915,28,30-34,1943,0.39480785423810316
STAT,1845,36,40-44,1881,0.027166380332519436
STAT,1854,52,na,1906,13.090852684463563
STAT,1864,27,45-49,1891,0.009958562773138318
SIM,1887,14,na,1901,26
STAT,1874,27,20-24,1901,0.11901456541366691
STAT,1872,16,na,1888,26.07986132627738
STAT,1897,15,na,1912,33.69474963476622
STAT,1896,30,15-19,1926,0.001885612015129777
SIM,1909,22,25-29,1931,2
STAT,1933,27,50-100,1960,0.013162372253980927
SIM,1829,95,na,1924,1
SIM,1888,22,30-34,1910,2
STAT,1880,42,40-44,1922,0.023623209813037744
STAT,1810,49,25-29,1859,5.47259718524775E-4
STAT,1877,21,15-19,1898,0.034157353948221746
SIM,1933,12,na,1945,54
STAT,1906,22,35-39,1928,0.08477877808086452
STAT,1896,50,na,1946,28.68985227796973
STAT,1828,47,30-34,1875,4.146932110122009E-4
STAT,1846,28,40-44,1874,0.029158168164746028
STAT,1878,38,45-49,1916,0.020479024374876795
STAT,1835,39,35-39,1874,0.03882076074596841
SIM,1840,27,na,1867,17
STAT,1856,24,35-39,1880,0.04839497811469933
STAT,1954,3,na,1957,48.352611846916034
SIM,1956,1,na,1957,47
STAT,1819,43,20-24,1862,0.0014780612881547704
STAT,1939,22,45-49,1961,0.01122237375094237
STAT,1827,48,40-44,1875,0.0012741588696358274
STAT,1886,34,20-24,1920,0.027797868294591466
STAT,1885,34,na,1919,23.363419389603997
STAT,1836,38,25-29,1874,0.03375430503735575
STAT,1842,19,25-29,1861,0.053955226280225844
STAT,1879,37,35-39,1916,0.07320544446899856
SIM,1852,91,na,1943,1
SIM,1902,30,na,1932,33
STAT,1912,31,na,1943,37.07491530957999
STAT,1884,49,25-29,1933,5.525541893159211E-4
SIM,1943,2,na,1945,49
SIM,1950,17,20-24,1967,1
STAT,1928,15,na,1943,46.3662752565101
STAT,1880,16,25-29,1896,0.05973500912759219
STAT,1910,21,45-49,1931,0.010533596124257893
STAT,1811,102,na,1913,0.0016614555950444782
STAT,1893,40,50-100,1933,0.013454971944156575
STAT,1851,48,50-100,1899,0.0020473783818506573
STAT,1871,29,45-49,1900,0.010990608682514908
SIM,1814,96,na,1910,1
SIM,1826,77,na,1903,5
STAT,1847,94,na,1941,0.21349867812595813
STAT,1829,32,25-29,1861,0.09788998421275859
STAT,1856,17,45-49,1873,5.595493970833994E-4
STAT,1896,23,25-29,1919,0.7496182156048116
STAT,1816,88,na,1904,0.41214982061588645
STAT,1851,47,20-24,1898,1.0083541148535613E-4
STAT,1908,35,15-19,1943,1.805600551767361E-4
STAT,1842,35,45-49,1877,0.017913532652299377
STAT,1865,29,20-24,1894,0.10535110764293329
SIM,1864,72,na,1936,13
STAT,1882,18,15-19,1900,0.05672438992664183
STAT,1839,22,40-44,1861,0.014775657755070228
STAT,1919,47,40-44,1966,0.0016952416998006238
STAT,1893,36,20-24,1929,0.009766239379695271
STAT,1875,26,45-49,1901,0.01145244132344381
STAT,1855,22,25-29,1877,0.47086132921658247
STAT,1837,45,30-34,1882,5.01822021908904E-4
SIM,1876,18,na,1894,30
STAT,1936,32,20-24,1968,0.023548641223776208
STAT,1857,53,50-100,1910,1.1124509055827389E-4
STAT,1822,95,na,1917,0.047161350045802464
STAT,1932,28,50-100,1960,0.012978004351202202
STAT,1887,25,40-44,1912,0.032918637720909784
STAT,1916,20,35-39,1936,0.09840629709403956
SIM,1913,15,na,1928,45
STAT,1905,34,35-39,1939,0.08320540802698168
STAT,1897,29,15-19,1926,0.005981905793332167
STAT,1908,47,30-34,1955,8.020220746509983E-4
STAT,1899,42,35-39,1941,0.0017192685080248125
STAT,1895,24,20-24,1919,0.8890593298209473
STAT,1901,16,20-24,1917,0.2486791063474028
STAT,1867,70,na,1937,13.426866807877877
STAT,1774,102,na,1876,3.499166303494001E-4
STAT,1910,28,30-34,1938,0.3747317699978621
STAT,1914,12,na,1926,40.514135365981815
SIM,1894,3,na,1897,32
STAT,1855,36,35-39,1891,0.05003798720394735
STAT,1878,39,40-44,1917,0.04473924881978898
SIM,1951,7,na,1958,51
STAT,1919,21,15-19,1940,0.05795875032318171
SIM,1856,53,na,1909,9
STAT,1818,80,na,1898,1.5458897468525146
STAT,1826,45,20-24,1871,1.2409584045642408E-4
STAT,1926,38,35-39,1964,0.02936163182734387
STAT,1851,18,20-24,1869,0.18089920021845157
STAT,1905,20,25-29,1925,0.8311218747533621
STAT,1877,15,na,1892,26.19197750431354
STAT,1919,21,30-34,1940,0.3129342683564273
STAT,1943,23,15-19,1966,0.056203779514661184
STAT,1860,16,20-24,1876,0.16721079243279063
STAT,1811,58,na,1869,14.044784184219134
STAT,1817,42,50-100,1859,0.0333712822517254
STAT,1880,16,40-44,1896,0.0019280464838367178
STAT,1825,32,40-44,1857,0.052015311501836435
STAT,1884,38,20-24,1922,0.007514947059791799
SIM,1887,45,na,1932,25
STAT,1884,24,45-49,1908,0.006789252057074663
STAT,1859,41,na,1900,18.453244405324334
SIM,1883,26,45-49,1909,1
SIM,1934,8,na,1942,54
STAT,1829,39,45-49,1868,0.01789120452075319
STAT,1881,23,30-34,1904,0.16896788198109416
SIM,1921,34,na,1955,40
STAT,1907,18,30-34,1925,0.023253266513772516
STAT,1846,31,15-19,1877,0.0013781082116627922
STAT,1873,38,45-49,1911,0.02016710481073442
STAT,1815,45,45-49,1860,0.0034998716156692243
STAT,1843,19,25-29,1862,0.03035797844295116
SIM,1832,40,na,1872,25
SIM,1927,21,30-34,1948,2
STAT,1858,37,15-19,1895,4.2730515354178405E-4
STAT,1867,60,na,1927,18.250957332009122
SIM,1918,23,30-34,1941,2
STAT,1859,0,na,1859,31.045728809692957
STAT,1882,36,45-49,1918,0.019196406641632004
STAT,1926,44,na,1970,45.371879019373225
SIM,1885,9,na,1894,26
SIM,1915,27,na,1942,35
STAT,1869,48,30-34,1917,9.261500875828808E-4
STAT,1818,39,35-39,1857,0.0841088619995362
STAT,1892,23,40-44,1915,0.025663986159960395
STAT,1799,61,na,1860,10.470857566088275
SIM,1868,85,na,1953,5
STAT,1867,28,25-29,1895,0.40338299130995986
STAT,1846,23,na,1869,21.22683327418479
SIM,1849,19,na,1868,13
STAT,1951,11,na,1962,46.500253296344525
STAT,1917,26,25-29,1943,0.6863417458195902
STAT,1835,24,15-19,1859,0.020644571692992348
STAT,1885,37,25-29,1922,0.028432498494342297
STAT,1889,20,30-34,1909,0.21938262703787445
STAT,1940,18,15-19,1958,0.45737692616812037
STAT,1817,47,20-24,1864,3.470094986183978E-4
STAT,1869,34,20-24,1903,0.02596681789772148
STAT,1814,46,40-44,1860,0.004978744228942781
STAT,1879,30,15-19,1909,0.001485781352974121
SIM,1807,73,na,1880,12
STAT,1854,42,na,1896,14.109714053090343
SIM,1796,83,na,1879,2
STAT,1925,31,50-100,1956,0.009762356419655083
STAT,1849,37,20-24,1886,0.006116149083911293
SIM,1891,71,na,1962,27
SIM,1929,30,30-34,1959,1
STAT,1914,25,45-49,1939,0.017388887238040763
SIM,1862,23,20-24,1885,2
STAT,1881,37,40-44,1918,0.04165384070225523
STAT,1927,16,40-44,1943,0.017345032749454408
STAT,1843,30,35-39,1873,0.052727934688956875
STAT,1899,38,15-19,1937,1.650982044056794E-4
STAT,1877,18,40-44,1895,0.0018830903862306523
STAT,1841,17,15-19,1858,0.07491860578204408
SIM,1836,43,na,1879,6
STAT,1869,23,30-34,1892,0.17205728076919885
SIM,1877,4,na,1881,32
SIM,1925,26,25-29,1951,1
STAT,1940,22,35-39,1962,0.09523847425280423
STAT,1852,30,na,1882,21.589521109954866
STAT,1841,35,45-49,1876,0.023472040436144516
STAT,1930,26,40-44,1956,0.059016553671543
SIM,1950,14,na,1964,60
STAT,1821,49,35-39,1870,0.0019202370292017606
STAT,1917,33,15-19,1950,0.00132778745002525
STAT,1818,46,25-29,1864,5.750505193023793E-4
SIM,1939,31,35-39,1970,1
SIM,1896,18,na,1914,33
STAT,1887,25,25-29,1912,0.4648557649995383
STAT,1925,32,45-49,1957,0.01856919240246481
STAT,1939,29,30-34,1968,0.3908128891307755
STAT,1848,42,50-100,1890,0.006823660428290378
SIM,1895,25,25-29,1920,1
STAT,1855,29,45-49,1884,0.008031652388120864
SIM,1798,64,na,1862,9
SIM,1861,20,na,1881,28
SIM,1836,53,na,1889,4
STAT,1843,23,45-49,1866,0.003686228490695121
STAT,1878,27,40-44,1905,0.030926727514873714
STAT,1892,19,20-24,1911,0.21784507482148388
SIM,1940,14,na,1954,37
STAT,1856,23,na,1879,17.860221733960625
STAT,1929,39,15-19,1968,2.448379697095209E-4
STAT,1852,35,20-24,1887,0.006772286453517448
STAT,1913,29,45-49,1942,0.01694809447561898
STAT,1911,27,35-39,1938,0.14547078447821496
SIM,1815,61,na,1876,9
STAT,1912,9,na,1921,39.808818183128196
SIM,1885,23,na,1908,25
STAT,1888,35,35-39,1923,0.08343899638585088
STAT,1937,29,na,1966,36.25079359176759
STAT,1925,39,30-34,1964,0.02169170819831644
STAT,1801,58,na,1859,9.962929315183295
SIM,1928,31,25-29,1959,1
SIM,1857,90,na,1947,2
STAT,1857,27,20-24,1884,0.09045863270194095
STAT,1904,4,na,1908,37.69487962532149
STAT,1925,25,20-24,1950,0.21570429379725864
STAT,1929,43,35-39,1972,0.0025911977817433514
SIM,1870,25,20-24,1895,1
STAT,1843,26,15-19,1869,0.0023856647937749663
STAT,1840,36,40-44,1876,0.04099402046381943
STAT,1940,15,45-49,1955,0.0050386992283537975
STAT,1877,35,25-29,1912,0.03000309355672477
STAT,1804,76,na,1880,4.479194795155651
STAT,1848,15,45-49,1863,5.299013922648719E-4
STAT,1862,25,20-24,1887,0.10306260354561388
STAT,1931,14,na,1945,51.46535197294236
STAT,1882,29,20-24,1911,0.11162409244466708
STAT,1900,38,15-19,1938,1.6723871913539747E-4
SIM,1825,29,25-29,1854,1
STAT,1840,22,30-34,1862,0.17749849342374335
STAT,1873,49,50-100,1922,0.002444861682591862
STAT,1868,49,25-29,1917,5.457827584041351E-4
STAT,1888,49,45-49,1937,0.0015231989803527201
STAT,1961,6,na,1967,50.49001013412579
STAT,1897,47,45-49,1944,0.0017595810658104544
STAT,1846,24,40-44,1870,0.020539030784178014
STAT,1921,21,20-24,1942,1.2498934522968213
SIM,1822,40,na,1862,18
STAT,1878,46,30-34,1924,0.0010022176180676963
STAT,1852,17,25-29,1869,0.05865721141327391
STAT,1904,21,20-24,1925,0.990421875540591
STAT,1893,29,30-34,1922,0.3152435484863621
STAT,1872,17,45-49,1889,6.705588947620453E-4
STAT,1934,37,30-34,1971,0.025044382178000427
SIM,1878,85,na,1963,5
STAT,1905,27,45-49,1932,0.0160243538212175
SIM,1905,27,na,1932,38
STAT,1867,46,20-24,1913,1.1516131055451866E-4
STAT,1934,32,na,1966,51.419077449035385
STAT,1826,38,30-34,1864,0.06011093817138295
STAT,1941,11,na,1952,40.342828429701896
STAT,1833,38,50-100,1871,0.011246886825261718
STAT,1906,26,15-19,1932,0.006614082472761214
STAT,1951,18,25-29,1969,0.512748145049526
SIM,1932,29,na,1961,47
STAT,1836,35,20-24,1871,0.009323002396562419
STAT,1909,31,15-19,1940,0.0012243851560251266
STAT,1895,24,50-100,1919,0.005261017954002357
SIM,1893,52,na,1945,34
STAT,1857,39,20-24,1896,0.005712557827422587
STAT,1859,47,25-29,1906,4.556801687624415E-4
STAT,1797,89,na,1886,0.33717292119932213
STAT,1893,21,35-39,1914,0.07380038614378404
STAT,1931,17,45-49,1948,0.006509536161838786
STAT,1832,23,35-39,1855,0.0353510177858081
STAT,1919,15,50-100,1934,8.272792727343116E-4
STAT,1932,16,50-100,1948,0.004953053475226721
STAT,1808,90,na,1898,0.11512526158666928
STAT,1856,28,15-19,1884,0.003381394833012928
SIM,1881,20,na,1901,26
STAT,1831,24,30-34,1855,0.24577823783412542
STAT,1918,25,na,1943,39.77452917177997
STAT,1821,58,na,1879,13.264380805551037
STAT,1867,21,40-44,1888,0.020168185816082904
STAT,1846,24,25-29,1870,0.5642405186045375
STAT,1896,48,40-44,1944,0.001252556909419599
STAT,1866,52,50-100,1918,1.3835307061781378E-4
STAT,1829,43,30-34,1872,0.010040705331301086
STAT,1859,82,na,1941,3.7084759537239957
STAT,1887,15,na,1902,27.69526754696032
STAT,1902,22,15-19,1924,0.04652239639606561
STAT,1880,89,na,1969,3.152984262346599
SIM,1857,38,na,1895,22
SIM,1885,33,na,1918,23
SIM,1922,18,20-24,1940,4
STAT,1832,37,45-49,1869,0.011312994147319275
STAT,1896,34,30-34,1930,0.22737615830096583
STAT,1840,38,na,1878,19.645131210666108
STAT,1902,15,25-29,1917,0.08028272823732092
STAT,1830,83,na,1913,1.426342916151938
STAT,1921,28,40-44,1949,0.051360904929008265
STAT,1822,34,30-34,1856,0.11822802610335031
STAT,1902,29,35-39,1931,0.1350953979073354
SIM,1854,72,na,1926,6
SIM,1872,15,na,1887,26
STAT,1927,23,15-19,1950,0.06504797732033697
SIM,1908,45,na,1953,38
STAT,1851,22,40-44,1873,0.021008468331185512
STAT,1837,36,50-100,1873,0.007361852035269508
STAT,1914,18,20-24,1932,0.2773946792104574
STAT,1898,28,20-24,1926,0.15770031343583468
STAT,1863,24,25-29,1887,0.5095554929890985
SIM,1938,17,20-24,1955,2
STAT,1872,21,15-19,1893,0.03385653906962136
SIM,1871,24,25-29,1895,1
STAT,1884,31,35-39,1915,0.09962560282713216
STAT,1889,16,45-49,1905,8.017283703518925E-4
STAT,1771,98,na,1869,0.008970773153788811
STAT,1918,15,na,1933,41.98920242102688
SIM,1862,60,na,1922,21
STAT,1822,48,40-44,1870,9.28096216271062E-4
STAT,1867,39,30-34,1906,0.050488645528095726
STAT,1916,49,30-34,1965,9.012205940268413E-4
STAT,1931,24,35-39,1955,0.12082033475939985
STAT,1817,40,35-39,1857,0.060868022133745335
STAT,1876,36,20-24,1912,0.007866775827313504
STAT,1922,27,45-49,1949,0.019405802077483734
SIM,1913,31,30-34,1944,2
STAT,1898,21,na,1919,32.00084870740587
STAT,1925,35,15-19,1960,2.2943685871117995E-4
SIM,1814,44,40-44,1858,2
STAT,1826,48,25-29,1874,5.722025786016111E-4
STAT,1873,35,40-44,1908,0.04492842462073099
STAT,1877,28,35-39,1905,0.09925153124644917
STAT,1838,22,25-29,1860,0.5764465245184474
STAT,1834,76,na,1910,6.69525866252016
STAT,1884,27,15-19,1911,0.004445159477211776
SIM,1859,71,na,1930,9
SIM,1814,65,na,1879,20
STAT,1909,11,na,1920,38.56911822559061
STAT,1865,49,50-100,1914,0.0021750393359223586
STAT,1827,48,25-29,1875,4.2868896214764334E-4
STAT,1850,38,na,1888,21.08885129085904
STAT,1825,35,45-49,1860,0.021607795889850477
STAT,1936,35,25-29,1971,0.009624298994937549
STAT,1863,49,40-44,1912,0.001484151948810856
STAT,1828,90,na,1918,0.5295003129883898
STAT,1848,19,50-100,1867,3.8814508750552193E-4
STAT,1830,29,40-44,1859,0.022444594092835467
STAT,1866,33,40-44,1899,0.039771810650674935
STAT,1877,36,20-24,1913,0.007995471180541542
STAT,1882,0,na,1882,34.13766163309304
STAT,1887,28,45-49,1915,0.012076385472689641
STAT,1935,21,15-19,1956,0.07219094178787501
STAT,1892,26,45-49,1918,0.01376384198621668
SIM,1837,38,na,1875,29
STAT,1855,33,30-34,1888,0.12387370443649869
STAT,1813,91,na,1904,0.3824298244158418
STAT,1928,44,30-34,1972,0.0016164342711880446
SIM,1838,24,na,1862,11
STAT,1916,20,50-100,1936,0.006876751125914699
STAT,1938,30,30-34,1968,0.15755225328350264
STAT,1894,39,25-29,1933,0.03652817984290585
STAT,1847,34,35-39,1881,0.11321101554432414
STAT,1883,39,15-19,1922,5.398182725625611E-4
STAT,1893,39,25-29,1932,0.03593777032250928
SIM,1844,34,25-29,1878,1
STAT,1843,16,20-24,1859,0.0966740427113342
STAT,1913,22,25-29,1935,0.8875801300138355
STAT,1869,26,35-39,1895,0.09381330391266045
STAT,1923,22,35-39,1945,0.10879935739900831
STAT,1814,76,na,1890,4.221837683807712
STAT,1923,17,50-100,1940,0.004368881833331177
STAT,1841,28,20-24,1869,0.14159935088704048
STAT,1837,48,35-39,1885,6.983934960139656E-4
STAT,1842,16,20-24,1858,0.17181874806704656
SIM,1921,22,25-29,1943,4
STAT,1910,17,25-29,1927,0.08534277604612832
STAT,1920,17,35-39,1937,0.046677633043928496
STAT,1869,37,40-44,1906,0.04241543706883483
STAT,1836,34,25-29,1870,0.122379439212382
STAT,1897,69,na,1966,22.25002348746205
STAT,1845,47,30-34,1892,5.632052828042391E-4
STAT,1876,74,na,1950,11.271520494862914
STAT,1938,25,na,1963,36.90075833005239
STAT,1857,49,na,1906,16.49083052639881
STAT,1934,22,45-49,1956,0.015056926608880897
STAT,1945,9,na,1954,42.68449082763055
STAT,1856,21,30-34,1877,0.15094952321545274
STAT,1846,21,20-24,1867,0.6940783299620791
STAT,1852,38,25-29,1890,0.02451933540601333
STAT,1842,38,15-19,1880,4.891298364612758E-4
STAT,1886,84,na,1970,6.92726190402172
STAT,1897,15,40-44,1912,0.002440155922713928
STAT,1951,15,20-24,1966,1.6055123868775387
STAT,1941,29,20-24,1970,0.1872762374851306
STAT,1895,27,40-44,1922,0.03889006505266817
SIM,1793,65,na,1858,16
STAT,1908,32,45-49,1940,0.014776194166888119
STAT,1913,26,40-44,1939,0.046212649202420075
STAT,1849,41,na,1890,18.002240986371685
STAT,1846,27,45-49,1873,0.010885608022305678
STAT,1836,27,35-39,1863,0.12049447509240234
STAT,1861,75,na,1936,8.657318169228503
STAT,1906,19,25-29,1925,0.08188562430188517
STAT,1909,1,na,1910,40.58981590631729
SIM,1890,34,na,1924,26
STAT,1852,28,30-34,1880,0.24922131632622876
STAT,1923,26,na,1949,42.85859053591129
STAT,1862,28,40-44,1890,0.025753692601956656
SIM,1895,22,20-24,1917,1
STAT,1828,36,40-44,1864,0.01968073417826451
STAT,1862,24,25-29,1886,0.4983604199598774
SIM,1860,28,30-34,1888,1
STAT,1935,18,40-44,1953,0.018986641118467443
SIM,1888,47,45-49,1935,1
SIM,1865,67,na,1932,10
STAT,1921,33,50-100,1954,0.009090649465059168
STAT,1899,47,na,1946,30.66094083122296
STAT,1905,31,30-34,1936,0.14528158647916173
STAT,1907,37,20-24,1944,0.002433740084520197
STAT,1932,16,15-19,1948,0.5999799990419327
SIM,1810,62,na,1872,13
STAT,1917,37,30-34,1954,0.018758397524174214
STAT,1871,85,na,1956,2.9846562263817202
STAT,1876,15,20-24,1891,0.1808956566630896
STAT,1830,43,50-100,1873,0.005075359025848167
STAT,1887,22,20-24,1909,0.7521852043711802
SIM,1846,53,na,1899,13
STAT,1946,21,25-29,1967,1.0209805552788007
STAT,1897,22,30-34,1919,0.2365391751205378
STAT,1834,42,na,1876,17.91164837278236
STAT,1899,28,20-24,1927,0.1600304845229942
STAT,1824,35,45-49,1859,0.03031342926363113
STAT,1860,19,25-29,1879,0.05250821719808248
STAT,1819,75,na,1894,5.284533141929619
STAT,1870,19,35-39,1889,0.005438107107180981
STAT,1870,38,na,1908,23.287924324477324
STAT,1881,26,35-39,1907,0.09212882589394379
STAT,1927,29,na,1956,45.12733810841275
SIM,1850,68,na,1918,12
STAT,1855,46,50-100,1901,0.0017341049748926835
STAT,1888,28,45-49,1916,0.012929308509771842
SIM,1896,28,45-49,1924,1
STAT,1891,26,45-49,1917,0.013674224410443182
SIM,1786,83,na,1869,7
STAT,1881,23,50-100,1904,0.0038683127359461977
STAT,1927,23,30-34,1950,0.3512108366260523
STAT,1875,48,20-24,1923,1.2180312918567572E-4
STAT,1844,42,na,1886,18.489263054033415
SIM,1808,58,na,1866,10
STAT,1866,36,45-49,1902,0.018448010794168475
SIM,1894,37,na,1931,29
STAT,1844,29,35-39,1873,0.0909421715028249
SIM,1881,74,na,1955,6
STAT,1884,17,20-24,1901,0.17369563199347213
STAT,1877,70,na,1947,14.483388621467343
STAT,1848,89,na,1937,0.6793808740780602
STAT,1907,30,na,1937,35.4856843396771
STAT,1855,5,na,1860,21.057366278914035
STAT,1915,39,20-24,1954,0.002613425559469514
SIM,1832,39,na,1871,25
STAT,1878,55,na,1933,21.347437797305773
STAT,1905,24,40-44,1929,0.02988611998917845
STAT,1873,17,45-49,1890,6.641290884919725E-4
STAT,1935,25,30-34,1960,0.532205202478466
STAT,1858,41,35-39,1899,0.013841639255684187
STAT,1860,37,20-24,1897,0.006266791080259887
STAT,1827,94,na,1921,0.12111916030675021
SIM,1841,29,25-29,1870,1
SIM,1855,2,na,1857,32
STAT,1854,23,20-24,1877,0.4913620257778781
SIM,1831,54,na,1885,8
STAT,1833,29,25-29,1862,0.40686582944901784
STAT,1881,19,45-49,1900,6.182386451960035E-4
SIM,1884,7,na,1891,28
STAT,1830,36,30-34,1866,0.03185679020466666
STAT,1883,17,20-24,1900,0.1721584822461278
STAT,1914,28,15-19,1942,0.0070328860444028975
SIM,1891,17,20-24,1908,2
STAT,1798,75,na,1873,7.526553458610009
STAT,1919,17,45-49,1936,0.005472473045232433
STAT,1878,49,35-39,1927,0.0014152060487265456
STAT,1887,32,15-19,1919,0.0015543907817720153
STAT,1863,45,25-29,1908,5.150733920748617E-4
STAT,1850,49,50-100,1899,0.0021410788118663353
STAT,1888,46,40-44,1934,0.0020063200180058423
STAT,1904,12,na,1916,37.00453267548193
STAT,1933,27,20-24,1960,0.2413874727089178
STAT,1851,25,45-49,1876,0.011134408132757463
STAT,1931,21,30-34,1952,0.3722369976622164
STAT,1879,23,25-29,1902,0.5906669864525171
STAT,1837,38,40-44,1875,0.025697016054874393
STAT,1838,90,na,1928,0.6119184124721683
STAT,1925,28,25-29,1953,0.7698287805633316
STAT,1870,26,25-29,1896,0.42165956087299544
STAT,1863,56,na,1919,18.058870879445845
SIM,1902,20,na,1922,32
STAT,1928,25,na,1953,46.2381365892673
STAT,1862,17,35-39,1879,0.005421931715940963
STAT,1870,89,na,1959,1.5978693233670358
SIM,1781,84,na,1865,3
STAT,1930,29,45-49,1959,0.021842949567754972
STAT,1856,39,20-24,1895,0.005528083046337319
SIM,1880,34,na,1914,31
SIM,1892,17,20-24,1909,1
SIM,1883,52,na,1935,9
STAT,1869,41,na,1910,22.495888990646918
SIM,1847,38,na,1885,17
SIM,1871,19,na,1890,27
STAT,1844,44,50-100,1888,0.008237514750568628
STAT,1836,38,40-44,1874,0.0513197103646925
SIM,1878,6,na,1884,31
STAT,1823,91,na,1914,0.3332509949628379
STAT,1840,25,35-39,1865,0.09564080606956808
STAT,1783,76,na,1859,1.8676775283991112
STAT,1876,30,na,1906,24.43128296428724
SIM,1933,28,25-29,1961,1
STAT,1871,26,25-29,1897,0.4231926356946548
STAT,1899,35,45-49,1934,0.02754868164608962
STAT,1861,6,na,1867,24.113885100722285
STAT,1866,3,na,1869,29.34963368256119
SIM,1923,15,na,1938,42
SIM,1911,34,na,1945,41
STAT,1919,11,na,1930,43.471474686685696
STAT,1902,26,30-34,1928,0.3563304382086904
STAT,1865,36,45-49,1901,0.01811761832207141
STAT,1847,27,45-49,1874,0.014255918539064577
STAT,1866,105,na,1971,0.0034670801821420575
STAT,1820,102,na,1922,0.001662081818160309
STAT,1862,71,na,1933,11.516187590436333
STAT,1913,33,30-34,1946,0.15478511509144494
STAT,1916,44,na,1960,37.60855857397941
STAT,1938,23,40-44,1961,0.033047030507895606
STAT,1863,35,30-34,1898,0.04763610416970053
STAT,1911,30,50-100,1941,0.008063427411361476
SIM,1895,33,na,1928,27
SIM,1928,7,na,1935,55
SIM,1948,21,na,1969,36
SIM,1805,51,na,1856,14
SIM,1850,5,na,1855,24
STAT,1858,34,45-49,1892,0.013155913946409432
STAT,1909,35,30-34,1944,0.017317393686445373
STAT,1886,15,30-34,1901,0.016609484011298383
STAT,1886,48,30-34,1934,9.914575693124237E-4
SIM,1921,33,30-34,1954,1
STAT,1839,75,na,1914,5.6811500120995495
STAT,1821,44,50-100,1865,0.01541165511179636
STAT,1928,33,25-29,1961,0.11493282233226187
SIM,1874,29,20-24,1903,2
STAT,1893,22,na,1915,29.82036240562034
STAT,1840,83,na,1923,3.1107552860389793
SIM,1926,33,na,1959,46
STAT,1822,37,35-39,1859,0.04343506051612502
STAT,1939,8,na,1947,39.562994118628524
STAT,1832,34,40-44,1866,0.024823096535885523
STAT,1855,47,40-44,1902,0.0011997480403277338
STAT,1828,33,20-24,1861,0.019800523933249718
STAT,1912,15,35-39,1927,0.008457824141562894
STAT,1812,95,na,1907,0.052838563903403545
STAT,1902,19,40-44,1921,0.002565442388369708
STAT,1876,25,15-19,1901,0.004639272824834436
STAT,1941,27,50-100,1968,0.010221912875935074
SIM,1910,26,30-34,1936,2
SIM,1898,51,na,1949,26
STAT,1844,36,25-29,1880,0.026387941392211175
STAT,1863,28,40-44,1891,0.02642929152388144
SIM,1900,6,na,1906,40
SIM,1900,29,25-29,1929,2
STAT,1867,49,25-29,1916,5.39700450121154E-4
STAT,1924,18,30-34,1942,0.1438265172764807
STAT,1822,44,25-29,1866,0.0035641505659007827
STAT,1873,24,35-39,1897,0.05895748614612165
STAT,1911,7,na,1918,39.61272568925233
STAT,1946,10,na,1956,43.273122414367634
STAT,1919,24,35-39,1943,0.10157191063210957
STAT,1943,16,25-29,1959,0.456317330598658
STAT,1854,26,40-44,1880,0.02124571109110357
STAT,1824,76,na,1900,6.5921492543238935
STAT,1896,37,35-39,1933,0.0929053695467018
SIM,1951,16,25-29,1967,2
STAT,1853,38,25-29,1891,0.018005461119347654
STAT,1840,18,45-49,1858,6.588177369666657E-4
STAT,1871,52,40-44,1923,1.0440194333317514E-4
STAT,1921,24,25-29,1945,1.0286810120227545
STAT,1909,28,40-44,1937,0.044139408823815986
STAT,1877,39,40-44,1916,0.04473246716674026
STAT,1879,20,20-24,1899,0.7175068657399738
STAT,1962,8,na,1970,50.05261946690904
STAT,1829,46,35-39,1875,0.0012106185937907174
STAT,1843,29,20-24,1872,0.06036726564268786
STAT,1881,27,45-49,1908,0.010565016486648026
STAT,1820,47,25-29,1867,4.8699441966068026E-4
STAT,1894,16,na,1910,32.447459573532875
STAT,1883,64,na,1947,16.88087631969205
SIM,1823,56,na,1879,10
SIM,1870,58,na,1928,21
SIM,1856,11,na,1867,21
STAT,1911,49,45-49,1960,0.0020323049548932985
STAT,1863,28,35-39,1891,0.08513066359770624
STAT,1871,31,15-19,1902,0.001425607237707336
STAT,1854,22,25-29,1876,0.41112634293193684
STAT,1856,30,35-39,1886,0.07582042037779106
SIM,1811,47,na,1858,11
STAT,1963,7,na,1970,49.629104568782175
STAT,1879,59,na,1938,20.115048278168643
STAT,1946,9,na,1955,43.2778829814956
STAT,1824,52,35-39,1876,1.0756875244037567E-4
STAT,1827,50,50-100,1877,1.1450615946816276E-4
STAT,1831,33,40-44,1864,0.045251865685983966
STAT,1950,20,35-39,1970,0.11108772430502309
STAT,1844,19,40-44,1863,0.0017947248886197654
STAT,1903,18,na,1921,35.813302966054756
STAT,1845,40,30-34,1885,0.0070210990054796136
STAT,1794,81,na,1875,2.3764567936864687
STAT,1862,19,na,1881,22.44335322862665
SIM,1845,59,na,1904,21
STAT,1858,65,na,1923,12.85967994531277
STAT,1927,20,na,1947,45.02944652130862
STAT,1884,17,15-19,1901,0.05814387688655216
STAT,1849,17,20-24,1866,0.16920909562160655
STAT,1852,38,30-34,1890,0.04538685514963763
STAT,1875,69,na,1944,15.085497283114021
STAT,1868,45,30-34,1913,9.461167234249526E-4
STAT,1790,91,na,1881,0.11432617527661888
STAT,1843,32,20-24,1875,0.013784576096670479
STAT,1826,35,25-29,1861,0.034940691381917244
STAT,1862,70,na,1932,12.10522798414482
STAT,1923,48,25-29,1971,6.145275548902111E-4
STAT,1796,96,na,1892,0.003732191851825264
STAT,1840,20,30-34,1860,0.1800750883900375
STAT,1812,103,na,1915,5.703513007754338E-4
STAT,1845,48,40-44,1893,9.881731769439963E-4
STAT,1877,38,35-39,1915,0.07264887930040191
STAT,1850,42,35-39,1892,0.016103000466995525
STAT,1803,83,na,1886,1.5391804050969524
STAT,1874,26,45-49,1900,0.011302584617707959
STAT,1879,48,40-44,1927,0.0017496726663865328
STAT,1828,67,na,1895,10.64646500750749
STAT,1864,18,na,1882,23.295731625702395
STAT,1960,6,na,1966,50.90424680290732
STAT,1894,35,30-34,1929,0.06895212256739622
SIM,1840,36,na,1876,16
STAT,1816,44,50-100,1860,0.01375220337545087
STAT,1883,24,45-49,1907,0.006729169388533045
STAT,1944,23,15-19,1967,0.05703929623092191
SIM,1870,34,na,1904,23
STAT,1833,30,40-44,1863,0.042205072565091976
SIM,1874,48,na,1922,25
STAT,1893,26,25-29,1919,0.5351994202893611
STAT,1859,39,25-29,1898,0.02265402465093409
SIM,1869,61,na,1930,13
STAT,1938,25,40-44,1963,0.04591274215301252
STAT,1827,44,30-34,1871,0.008747416432678028
STAT,1922,49,20-24,1971,1.252879993099728E-4
STAT,1837,95,na,1932,0.06428715771902573
STAT,1849,40,45-49,1889,0.011807638009955667
STAT,1872,34,40-44,1906,0.043992095785051095
SIM,1865,87,na,1952,1
STAT,1923,46,na,1969,42.785398949618084
STAT,1845,24,25-29,1869,0.40947574752831467
STAT,1828,32,25-29,1860,0.1402126639242971
STAT,1867,26,50-100,1893,0.006142611613528817
STAT,1891,32,50-100,1923,0.011245666213043138
STAT,1843,16,15-19,1859,0.03236122620368685
STAT,1889,6,na,1895,31.983918554873462
STAT,1911,45,na,1956,34.71830211561704
SIM,1840,28,na,1868,17
STAT,1895,34,35-39,1929,0.130349526405854
STAT,1841,19,15-19,1860,0.07403866368969526
STAT,1846,47,45-49,1893,0.0019036936542386389
STAT,1886,49,40-44,1935,0.0017387225775044185
STAT,1845,39,na,1884,14.172538232604975
STAT,1895,23,25-29,1918,0.7408976778513314
STAT,1812,44,na,1856,12.570735550473275
SIM,1922,20,25-29,1942,1
STAT,1864,41,25-29,1905,0.005785714446707411
STAT,1877,16,50-100,1893,5.069661521157191E-4
STAT,1817,42,20-24,1859,0.005016598081183196
SIM,1910,48,na,1958,27
STAT,1817,39,20-24,1856,0.026931100612193257
STAT,1792,101,na,1893,0.002162104917520624
STAT,1847,43,45-49,1890,0.015872172898388007
STAT,1866,106,na,1972,0.0018004894093881915
STAT,1896,32,30-34,1928,0.229339673029043
STAT,1947,18,45-49,1965,0.00558690991039243
SIM,1853,24,25-29,1877,2
STAT,1854,75,na,1929,6.292432739722898
STAT,1858,89,na,1947,0.7993991912313669
SIM,1881,10,na,1891,27
STAT,1838,17,45-49,1855,6.696881036860547E-4
STAT,1874,31,40-44,1905,0.04417541019944929
STAT,1828,43,35-39,1871,0.007895757705356811
STAT,1845,90,na,1935,0.4608616164756838
STAT,1880,40,25-29,1920,0.006820758555594583
STAT,1840,15,50-100,1855,5.02948154400911E-4
SIM,1844,18,na,1862,12
STAT,1866,37,20-24,1903,0.007099376054000718
SIM,1886,41,na,1927,27
STAT,1837,18,40-44,1855,0.0016732357669453897
STAT,1823,36,40-44,1859,0.03206492630989242
STAT,1879,35,35-39,1914,0.07390068544567682
STAT,1889,37,15-19,1926,6.875181013142841E-4
STAT,1949,15,45-49,1964,0.005775746334749263
STAT,1862,29,30-34,1891,0.2157077226847614
STAT,1848,44,45-49,1892,0.009548123247802527
STAT,1862,44,25-29,1906,0.005465520061335697
SIM,1853,54,na,1907,21
STAT,1807,73,na,1880,6.136794296727812
STAT,1821,80,na,1901,3.8420310183302924
SIM,1841,77,na,1918,4
STAT,1829,41,30-34,1870,0.01031580365367888
STAT,1911,13,na,1924,39.20448993325936
STAT,1897,31,35-39,1928,0.1350325018989189
SIM,1849,41,na,1890,6
STAT,1938,8,na,1946,39.084012018062715
STAT,1834,29,25-29,1863,0.3863817270199402
STAT,1914,26,50-100,1940,0.009985108757245755
STAT,1900,38,50-100,1938,0.0036564460789539227
STAT,1890,27,40-44,1917,0.03638720147675533
STAT,1867,36,25-29,1903,0.027685394550956262
STAT,1911,44,50-100,1955,0.0011003676250646906
STAT,1894,19,25-29,1913,0.07223486271106208
STAT,1925,32,50-100,1957,0.00975669425293169
SIM,1870,66,na,1936,15
STAT,1853,43,50-100,1896,0.00659163864856772
STAT,1914,20,25-29,1934,0.9034215760424907
STAT,1883,32,na,1915,23.173024284241034
STAT,1884,20,45-49,1904,0.006872785432637362
STAT,1939,24,45-49,1963,0.011214743832975896
STAT,1800,54,45-49,1854,2.22192416383261E-4
STAT,1899,28,15-19,1927,0.006189024312943914
STAT,1850,93,na,1943,0.2602126477896558
STAT,1886,41,30-34,1927,0.01197907963342782
STAT,1887,46,na,1933,24.62690859056289
STAT,1879,18,45-49,1897,6.743230906336096E-4
STAT,1828,59,na,1887,13.490145574424304
STAT,1870,23,20-24,1893,0.6824535286909549
STAT,1866,45,50-100,1911,0.002284481168937541
STAT,1844,28,25-29,1872,0.4015787025712338
STAT,1861,40,15-19,1901,1.173063637353391E-4
STAT,1894,48,na,1942,28.47677307161359
STAT,1870,41,50-100,1911,0.010542158337385728
STAT,1880,42,20-24,1922,0.001667947303662541
STAT,1830,37,40-44,1867,0.025608127740926145
STAT,1838,34,35-39,1872,0.09566224646602886
STAT,1890,34,na,1924,28.738417861527907
SIM,1804,77,na,1881,7
STAT,1840,40,25-29,1880,0.005917830337496272
STAT,1869,41,30-34,1910,0.011190015584182252
SIM,1936,9,na,1945,38
STAT,1835,22,15-19,1857,0.02412219759308438
STAT,1833,25,45-49,1858,0.010991469369584138
STAT,1824,45,na,1869,18.52535504717472
STAT,1878,36,30-34,1914,0.05528832761329574
STAT,1830,30,15-19,1860,0.0010056836055856117
STAT,1903,26,na,1929,34.04643149726968
SIM,1933,8,na,1941,55
STAT,1835,35,20-24,1870,0.004417574943826046
SIM,1890,78,na,1968,10
STAT,1900,53,na,1953,29.378998080044024
STAT,1946,23,50-100,1969,0.00726817869979347
SIM,1907,60,na,1967,31
STAT,1928,18,35-39,1946,0.0524762608076502
STAT,1835,37,na,1872,11.908471186549262
STAT,1823,40,25-29,1863,0.004623969662194101
STAT,1879,51,40-44,1930,1.094835678623712E-4
STAT,1895,36,30-34,1931,0.06952454495873231
STAT,1930,38,15-19,1968,2.490585353228346E-4
STAT,1815,60,na,1875,8.570249728408351
SIM,1950,6,na,1956,65
STAT,1869,29,40-44,1898,0.02881780986126872
SIM,1815,69,na,1884,6
STAT,1887,48,45-49,1935,0.0025435912601181818
STAT,1850,25,45-49,1875,0.011802425411021273
STAT,1890,42,35-39,1932,0.021968926756816717
STAT,1841,57,na,1898,19.67056659780718
STAT,1830,30,50-100,1860,0.006470530037707797
STAT,1864,24,35-39,1888,0.052420479060143146
STAT,1861,48,25-29,1909,4.7830399389670026E-4
STAT,1886,30,20-24,1916,0.028263290521082722
SIM,1882,59,na,1941,27
STAT,1890,31,25-29,1921,0.12492565891382909
STAT,1840,26,45-49,1866,0.010926377987148269
SIM,1795,75,na,1870,7
SIM,1873,23,na,1896,27
STAT,1851,29,25-29,1880,0.4121569235223786
STAT,1828,45,30-34,1873,4.253389823605564E-4
STAT,1870,30,15-19,1900,0.0014260328237241978
STAT,1928,23,30-34,1951,0.35599107296003724
STAT,1844,44,30-34,1888,0.008964354307054884
STAT,1869,49,40-44,1918,0.0016241926203204098
STAT,1860,28,na,1888,19.46886917704017
SIM,1861,41,na,1902,23
SIM,1894,25,25-29,1919,3
STAT,1885,26,20-24,1911,0.11624738483292131
STAT,1937,30,na,1967,37.22374373636576
SIM,1802,62,na,1864,11
STAT,1838,47,40-44,1885,0.0013670254653831498
STAT,1880,20,30-34,1900,0.1884231864641249
STAT,1896,15,40-44,1911,0.00241365986458251
STAT,1868,17,30-34,1885,0.015703871942561995
STAT,1948,22,na,1970,41.652692059073914
STAT,1848,36,15-19,1884,3.7814087238383234E-4
STAT,1825,39,25-29,1864,0.02887614732543716
STAT,1862,9,na,1871,24.07390117395072
STAT,1918,33,15-19,1951,0.0013474693193875396
STAT,1854,35,30-34,1889,0.03307469875990426
STAT,1848,87,na,1935,1.139360706724128
STAT,1907,30,35-39,1937,0.08574215382867023
STAT,1889,37,45-49,1926,0.024406889694081012
SIM,1869,18,na,1887,16
SIM,1828,79,na,1907,5
STAT,1837,63,na,1900,8.627544487847072
STAT,1891,43,35-39,1934,0.022064722366820583
STAT,1924,30,35-39,1954,0.10640046110669481
STAT,1858,27,15-19,1885,0.003534232345510507
STAT,1870,14,na,1884,26.069849075718487
STAT,1870,18,25-29,1888,0.05649415525977489
STAT,1886,25,25-29,1911,0.4417552049594274
STAT,1854,33,35-39,1887,0.0627347016582752
STAT,1817,75,na,1892,8.158880441858308
STAT,1899,44,20-24,1943,1.4893233119826126E-4
STAT,1821,40,15-19,1861,2.3074342941835967E-4
STAT,1855,34,35-39,1889,0.07110759035379847
STAT,1849,37,15-19,1886,4.455473403153153E-4
STAT,1837,35,30-34,1872,0.03229895025007279
STAT,1913,38,15-19,1951,1.8699299154133878E-4
SIM,1846,84,na,1930,2
STAT,1809,45,20-24,1854,4.2182774115767484E-4
STAT,1853,34,30-34,1887,0.11067772125531437
SIM,1924,32,na,1956,52
STAT,1870,38,25-29,1908,0.02845975201574804
STAT,1877,51,50-100,1928,1.566457229760439E-4
STAT,1831,36,45-49,1867,0.02060140145717871
SIM,1842,70,na,1912,17
STAT,1851,21,50-100,1872,0.004140978775481002
STAT,1880,28,40-44,1908,0.0313890650939199
SIM,1832,84,na,1916,6
STAT,1910,45,35-39,1955,0.0012011961068895806
STAT,1881,21,30-34,1902,0.1700033210556448
STAT,1786,86,na,1872,0.3032166592439413
STAT,1839,46,45-49,1885,0.0013440673445974966
STAT,1865,59,na,1924,17.57838723310031
STAT,1865,104,na,1969,0.005548723034076742
STAT,1889,42,40-44,1931,0.027504692628886454
STAT,1852,92,na,1944,0.35645576312062544
STAT,1810,85,na,1895,0.9853658434693899
STAT,1850,30,40-44,1880,0.04531898367425326
STAT,1832,29,15-19,1861,0.002675451945454258
STAT,1822,41,20-24,1863,9.20969549006474E-4
STAT,1918,16,25-29,1934,0.09400622398081773
STAT,1832,32,na,1864,12.657737258199013
SIM,1863,56,na,1919,9
STAT,1859,27,30-34,1886,0.2036047784460518
SIM,1830,58,na,1888,12
STAT,1871,22,25-29,1893,0.5707389520472779
STAT,1896,35,35-39,1931,0.09378770309895085
STAT,1862,52,50-100,1914,1.2960752090562924E-4
STAT,1850,69,na,1919,13.066491227705171
STAT,1807,52,35-39,1859,1.7640706239821445E-4
STAT,1895,39,40-44,1934,0.056259178930985136
STAT,1816,46,20-24,1862,1.5355669527080738E-4
STAT,1895,57,na,1952,26.090139584295198
STAT,1820,44,20-24,1864,0.0013589943285124337
SIM,1867,46,na,1913,11
STAT,1834,26,15-19,1860,0.004234686678925662
STAT,1872,46,35-39,1918,0.0014365052461710072
SIM,1899,48,na,1947,28
STAT,1887,14,na,1901,28.0970307545607
STAT,1814,75,na,1889,4.641575341983256
STAT,1861,77,na,1938,7.269153476687304
STAT,1882,20,35-39,1902,0.05625763447912561
SIM,1847,30,35-39,1877,1
STAT,1833,33,45-49,1866,0.016450421731416903
STAT,1864,40,40-44,1904,0.020377835375294907
STAT,1832,47,50-100,1879,0.0013058628085188034
STAT,1867,53,45-49,1920,1.3664824254895752E-4
STAT,1883,21,40-44,1904,0.020296574051429178
STAT,1911,46,40-44,1957,0.001486661479200511
SIM,1833,34,na,1867,12
SIM,1897,8,na,1905,43
STAT,1901,39,35-39,1940,0.021146636346909782
SIM,1836,23,na,1859,14
STAT,1829,44,35-39,1873,0.015601235869284837
STAT,1894,38,35-39,1932,0.09019638372007359
STAT,1874,43,35-39,1917,0.01823784546250111
STAT,1849,72,na,1921,9.792377216546866
STAT,1848,41,50-100,1889,0.00691164567776837
STAT,1853,18,25-29,1871,0.04258937578935958
STAT,1839,30,35-39,1869,0.07021842353366341
STAT,1871,30,30-34,1901,0.17547267180749598
STAT,1871,38,40-44,1909,0.0434272458030749
STAT,1936,13,na,1949,37.646785798352134
STAT,1903,22,15-19,1925,0.04690331916778113
STAT,1835,29,50-100,1864,0.0037543663059958787
STAT,1844,33,20-24,1877,0.02498735530665686
SIM,1969,2,na,1971,54
STAT,1846,28,35-39,1874,0.09392057304734723
STAT,1861,19,40-44,1880,0.0017471418194645457
STAT,1933,20,35-39,1953,0.12513082438054896
SIM,1808,59,na,1867,8
STAT,1881,24,40-44,1905,0.019704217338831917
SIM,1852,33,20-24,1885,1
STAT,1862,17,50-100,1879,4.8410095637375835E-4
STAT,1878,85,na,1963,4.850460302322072
STAT,1875,30,45-49,1905,0.018069571216837475
STAT,1860,16,15-19,1876,0.05597310431894101
STAT,1915,51,na,1966,36.23215852431755
STAT,1895,20,20-24,1915,0.8999981086836447
SIM,1906,35,na,1941,27
STAT,1824,40,40-44,1864,0.031520596648468624
STAT,1840,23,35-39,1863,0.05773274254864481
SIM,1857,92,na,1949,1
STAT,1822,43,40-44,1865,0.012666921741080736
SIM,1830,43,40-44,1873,1
STAT,1900,21,na,1921,32.89471613080293
STAT,1853,26,na,1879,15.86397075448354
SIM,1842,62,na,1904,18
STAT,1938,28,45-49,1966,0.01699455412589494
STAT,1862,41,20-24,1903,0.0013763824199052265
STAT,1848,41,40-44,1889,0.014715480963146737
STAT,1861,45,20-24,1906,1.019207422474918E-4
STAT,1872,18,35-39,1890,0.005599519181581533
STAT,1857,16,na,1873,20.31662947065098
STAT,1847,40,35-39,1887,0.019956526604209882
SIM,1795,67,na,1862,11
STAT,1875,27,20-24,1902,0.12059253464023945
SIM,1931,34,na,1965,54
STAT,1858,57,na,1915,15.292180290752823
STAT,1818,43,20-24,1861,0.0016565646474368016
STAT,1821,88,na,1909,0.8526527241682665
STAT,1855,17,45-49,1872,5.470242550695735E-4
STAT,1845,24,50-100,1869,0.0029169097471264615
STAT,1883,37,20-24,1920,0.007485570657392304
STAT,1891,31,40-44,1922,0.05344480868068455
STAT,1874,34,45-49,1908,0.01753946366471581
STAT,1823,36,na,1859,16.921264767164605
STAT,1882,48,50-100,1930,0.002324118094635406
STAT,1885,41,15-19,1926,1.369911729208361E-4
STAT,1828,48,40-44,1876,7.241850668876776E-4
STAT,1863,42,20-24,1905,0.0014043956200373792
SIM,1811,79,na,1890,1
STAT,1886,42,15-19,1928,1.4306835256852686E-4
SIM,1918,12,na,1930,40
STAT,1864,39,50-100,1903,0.010901075856867998
STAT,1923,45,20-24,1968,1.2898773150341313E-4
STAT,1942,4,na,1946,41.56928758729084
STAT,1877,35,30-34,1912,0.055537641569441826
SIM,1881,18,na,1899,26
STAT,1881,41,25-29,1922,0.006138051233796493
STAT,1919,25,30-34,1944,0.4225410795439668
STAT,1893,43,45-49,1936,0.0013009606370917456
STAT,1868,3,na,1871,30.590118888674837
STAT,1771,96,na,1867,0.023937103666183204
STAT,1828,40,30-34,1868,0.005174408205282928
STAT,1861,85,na,1946,2.3053486252250632
STAT,1906,37,50-100,1943,0.003849925469215722
STAT,1861,28,30-34,1889,0.21177557508783235
STAT,1868,48,35-39,1916,0.001337819771427336
SIM,1827,62,na,1889,5
STAT,1826,52,45-49,1878,1.4102313832218077E-4
STAT,1814,50,25-29,1864,1.0126594088155904E-4
STAT,1885,34,20-24,1919,0.02646456966759623
STAT,1885,45,30-34,1930,9.654443913517316E-4
STAT,1873,33,45-49,1906,0.017654493882129058
STAT,1890,30,40-44,1920,0.05310165597173049
SIM,1911,33,na,1944,41
STAT,1827,28,25-29,1855,0.6006277820808582
STAT,1895,31,30-34,1926,0.22759801847145425
SIM,1812,72,na,1884,12
STAT,1836,54,na,1890,20.20888543971416
STAT,1859,23,15-19,1882,0.027010049401812303
STAT,1859,44,20-24,1903,0.0012452344848765957
STAT,1920,23,50-100,1943,0.0072304133155669924
STAT,1883,56,na,1939,19.806507852732786
STAT,1828,48,35-39,1876,5.922074158766497E-4
STAT,1886,21,na,1907,24.605916270257804
STAT,1832,40,na,1872,11.856735209566082
STAT,1855,31,30-34,1886,0.12647314377687696
SIM,1819,51,na,1870,5
STAT,1853,37,35-39,1890,0.04445198272356059
SIM,1781,83,na,1864,3
STAT,1824,33,50-100,1857,0.014493649177841007
SIM,1850,4,na,1854,24
STAT,1886,28,35-39,1914,0.09973278474206232
STAT,1900,27,25-29,1927,0.5865861839448075
SIM,1852,69,na,1921,19
SIM,1907,20,na,1927,41
STAT,1884,33,20-24,1917,0.02637151132681315
STAT,1829,52,na,1881,15.436379830634431
STAT,1819,37,35-39,1856,0.07922705212475689
STAT,1881,24,35-39,1905,0.055179518127296635
STAT,1855,4,na,1859,22.320718972772987
SIM,1855,26,na,1881,20
STAT,1813,54,25-29,1867,1.0132105398593516E-4
SIM,1914,22,na,1936,32
STAT,1844,16,30-34,1860,0.01591938682166918
STAT,1865,41,40-44,1906,0.020436468933015862
STAT,1869,33,25-29,1902,0.09882602065251989
STAT,1869,49,na,1918,21.34447889050735
STAT,1891,46,45-49,1937,0.001638550512016512
STAT,1896,35,40-44,1931,0.058046160396890964
STAT,1861,25,20-24,1886,0.10081556055518633
STAT,1900,38,35-39,1938,0.02106447436708225
STAT,1810,96,na,1906,0.030864415801660335
SIM,1872,0,na,1872,32
STAT,1832,32,45-49,1864,0.01019098853406726
STAT,1935,17,50-100,1952,0.005099065758015779
SIM,1884,39,30-34,1923,2
STAT,1833,25,15-19,1858,0.004491437941493151
STAT,1820,44,15-19,1864,1.1817342625329553E-4
STAT,1876,39,30-34,1915,0.05358483965022608
STAT,1934,30,na,1964,51.4772302980357
STAT,1824,77,na,1901,6.014545136660034
STAT,1880,45,25-29,1925,6.117330923295803E-4
SIM,1770,91,na,1861,2
STAT,1874,95,na,1969,0.6194409172590292
STAT,1871,34,25-29,1905,0.10124450125721533
STAT,1869,44,35-39,1913,0.017308890069668986
STAT,1829,27,45-49,1856,0.012755121388371994
STAT,1809,48,30-34,1857,0.003251463521889533
SIM,1845,67,na,1912,19
STAT,1854,38,35-39,1892,0.043017741438002736
SIM,1872,81,na,1953,8
STAT,1844,40,15-19,1884,1.1334204397826507E-4
STAT,1850,45,45-49,1895,0.0021222098405747907
STAT,1904,11,na,1915,37.05975170552316
SIM,1811,43,30-34,1854,1
SIM,1832,49,na,1881,20
STAT,1832,29,45-49,1861,0.006547379367436732
STAT,1838,37,na,1875,20.058861143069766
STAT,1845,27,35-39,1872,0.06865214812388123
STAT,1866,52,45-49,1918,1.329451332224285E-4
STAT,1831,45,35-39,1876,0.0013751484407981255
STAT,1842,36,20-24,1878,0.006855317148302443
STAT,1870,34,30-34,1904,0.17195789084276197
STAT,1945,15,30-34,1960,0.13226190841004937
STAT,1854,30,30-34,1884,0.11158098457772704
SIM,1893,3,na,1896,39
STAT,1827,47,35-39,1874,0.001055469135132163
STAT,1836,39,30-34,1875,0.06183594090901064
STAT,1866,44,na,1910,20.99876956943983
STAT,1860,44,15-19,1904,1.107547096230059E-4
STAT,1874,26,15-19,1900,0.004618568790209994
SIM,1860,56,na,1916,16
STAT,1864,37,40-44,1901,0.039262824426251335
STAT,1849,29,na,1878,19.599273113014107
STAT,1919,41,na,1960,39.95572191876097
STAT,1889,45,45-49,1934,0.0029182291199737814
STAT,1910,42,30-34,1952,0.001200865646651231
SIM,1874,16,na,1890,28
STAT,1854,38,40-44,1892,0.02662411634911039
STAT,1831,47,na,1878,19.577636596503154
STAT,1811,70,na,1881,9.297779348900187
STAT,1892,39,15-19,1931,6.867555869124168E-4
STAT,1920,39,45-49,1959,0.007384759612840434
SIM,1884,18,na,1902,26
STAT,1865,20,35-39,1885,0.05419827161815376
STAT,1858,97,na,1955,0.04087979215613948
STAT,1835,38,30-34,1873,0.029568668815297006
STAT,1840,23,40-44,1863,0.02061595579941428
SIM,1879,71,na,1950,7
SIM,1892,69,na,1961,21
STAT,1843,48,30-34,1891,4.054599380458406E-4
STAT,1880,23,35-39,1903,0.061173559056050576
STAT,1895,39,35-39,1934,0.09090039951122418
SIM,1834,75,na,1909,7
STAT,1852,25,25-29,1877,0.4277993283065456
STAT,1888,44,45-49,1932,0.017253629459172207
STAT,1830,33,25-29,1863,0.06516712616993339
STAT,1834,26,20-24,1860,0.10949689753427276
STAT,1929,31,25-29,1960,0.11690846396484625
STAT,1857,20,50-100,1877,0.003575384606306064
STAT,1887,29,35-39,1916,0.10456606753697857
STAT,1826,29,50-100,1855,0.016728498587077454
STAT,1939,21,40-44,1960,0.033546934745900016
STAT,1858,43,20-24,1901,0.0011997495410994582
STAT,1849,54,50-100,1903,1.1388508420996438E-4
STAT,1875,27,15-19,1902,0.0046637997196136245
STAT,1898,27,45-49,1925,0.014977998721365779
SIM,1963,5,na,1968,54
STAT,1870,35,20-24,1905,0.007730249277306913
STAT,1838,37,45-49,1875,0.01866979602060201
STAT,1872,69,na,1941,15.015466657886037
STAT,1921,35,45-49,1956,0.00756565376779153
STAT,1843,67,na,1910,6.72439225637491
STAT,1885,17,30-34,1902,0.015739696794290773
STAT,1864,43,45-49,1907,0.013326738361780702
STAT,1855,34,40-44,1889,0.030450424635033297
STAT,1890,35,40-44,1925,0.053678650100200745
STAT,1894,72,na,1966,19.251971528921906
STAT,1943,15,na,1958,38.7678936945053
STAT,1855,46,35-39,1901,9.88496324194394E-4
STAT,1876,39,25-29,1915,0.028948131606157897
SIM,1796,60,na,1856,12
STAT,1887,24,35-39,1911,0.06329597658792248
STAT,1797,70,na,1867,5.841246685370514
STAT,1844,48,25-29,1892,4.4425760349898314E-4
SIM,1923,47,na,1970,36
STAT,1809,48,25-29,1857,0.0019347551348741535
STAT,1939,21,35-39,1960,0.09394454304351282
STAT,1893,35,15-19,1928,7.147644986170579E-4
STAT,1871,18,40-44,1889,0.0018245112212142177
SIM,1889,46,na,1935,29
SIM,1857,36,na,1893,23
STAT,1901,36,30-34,1937,0.016173859271599294
SIM,1854,25,30-34,1879,1
SIM,1792,70,na,1862,4
STAT,1824,85,na,1909,1.9074605325945233
STAT,1846,25,30-34,1871,0.25047165576986297
STAT,1908,27,20-24,1935,0.17312066717841762
STAT,1927,28,50-100,1955,0.011996423786151797
STAT,1916,21,40-44,1937,0.035037234923449824
STAT,1826,44,15-19,1870,1.4106407305372005E-4
STAT,1816,49,25-29,1865,7.043180898106737E-4
SIM,1847,15,na,1862,25
STAT,1846,44,35-39,1890,0.014477254321604259
SIM,1889,28,20-24,1917,1
SIM,1838,54,na,1892,4
SIM,1861,15,20-24,1876,1
SIM,1921,32,na,1953,41
SIM,1894,17,na,1911,32
STAT,1919,33,30-34,1952,0.16779489746957807
STAT,1886,45,25-29,1931,6.034218643110655E-4
SIM,1880,31,30-34,1911,2
STAT,1840,50,50-100,1890,1.2004447137276968E-4
STAT,1842,100,na,1942,0.007965299243263873
STAT,1872,31,30-34,1903,0.17937267292635653
STAT,1869,25,25-29,1894,0.41265671313306956
STAT,1823,44,40-44,1867,0.01567050909370802
STAT,1926,46,na,1972,45.18315765264654
SIM,1809,52,na,1861,1
STAT,1853,15,20-24,1868,0.13562454897472295
STAT,1885,16,25-29,1901,0.056097220767978635
STAT,1835,22,20-24,1857,0.5038825968493031
STAT,1862,24,30-34,1886,0.15506755276323245
SIM,1868,87,na,1955,5
STAT,1932,35,20-24,1967,0.003533634409136367
STAT,1862,109,na,1971,1.0462382330543068E-4
STAT,1816,100,na,1916,0.0031872477359025267
STAT,1815,49,na,1864,10.568583451518846
SIM,1946,22,30-34,1968,3
STAT,1883,43,50-100,1926,0.010184899663704039
STAT,1896,18,45-49,1914,8.557865659257106E-4
SIM,1817,39,40-44,1856,1
SIM,1943,1,na,1944,49
STAT,1864,45,40-44,1909,0.001550840569190962
STAT,1835,38,25-29,1873,0.01597387846770394
STAT,1815,49,50-100,1864,0.0034403887109415287
STAT,1896,20,50-100,1916,0.00538843358760611
STAT,1829,44,40-44,1873,0.019378846847684223
SIM,1917,27,na,1944,38
STAT,1926,23,20-24,1949,1.3390107761085712
SIM,1858,77,na,1935,9
STAT,1919,17,25-29,1936,0.4747371324892743
SIM,1921,43,na,1964,41
STAT,1904,6,na,1910,37.43222438796767
STAT,1890,33,45-49,1923,0.02109286955406987
STAT,1774,104,na,1878,1.374176105785792E-4
STAT,1914,10,na,1924,40.63676575893891
STAT,1875,80,na,1955,6.358812113204305
SIM,1856,51,na,1907,11
STAT,1910,45,40-44,1955,0.001468891235894684
SIM,1900,41,na,1941,36
STAT,1917,46,35-39,1963,0.0013377576264282881
STAT,1869,48,50-100,1917,0.0023498188111855684
STAT,1924,31,na,1955,43.86281766016364
STAT,1896,74,na,1970,18.73859017792286
STAT,1835,43,20-24,1878,8.509327040465096E-4
STAT,1919,28,35-39,1947,0.16024765116489226
STAT,1857,26,45-49,1883,0.00862321711642407
STAT,1874,46,45-49,1920,0.0024009973008883695
STAT,1920,22,15-19,1942,0.058675343801266336
SIM,1883,76,na,1959,1
STAT,1892,60,na,1952,23.561443472811725
SIM,1917,38,na,1955,34
STAT,1883,16,15-19,1899,0.05777086113108087
STAT,1838,80,na,1918,4.801214326883327
STAT,1874,40,30-34,1914,0.011780972205897052
STAT,1867,33,15-19,1900,0.0013570343233421404
SIM,1879,39,na,1918,15
SIM,1866,72,na,1938,16
STAT,1874,23,40-44,1897,0.021074738833177415
STAT,1901,28,50-100,1929,0.008919509651817266
SIM,1843,25,na,1868,22
STAT,1811,59,na,1870,13.769365966366598
STAT,1938,34,50-100,1972,0.008247987158878483
STAT,1878,32,50-100,1910,0.009459479916135237
STAT,1841,101,na,1942,0.005585348440356484
STAT,1885,49,25-29,1934,5.569322367437739E-4
STAT,1910,26,50-100,1936,0.009585669551803443
STAT,1872,15,30-34,1887,0.016556096813378364
SIM,1946,19,na,1965,49
STAT,1858,30,45-49,1888,0.013547977831324946
STAT,1938,22,30-34,1960,0.2825774464582334
SIM,1832,60,na,1892,18
SIM,1935,0,na,1935,61
STAT,1919,40,50-100,1959,0.0012655723277208292
STAT,1825,30,na,1855,16.177682966734753
SIM,1927,17,25-29,1944,1
STAT,1813,53,40-44,1866,3.0721364382468516E-4
STAT,1887,45,35-39,1932,0.0015433454466855017
SIM,1868,84,na,1952,5
STAT,1845,28,40-44,1873,0.021160413533122813
STAT,1842,19,30-34,1861,0.015175879229839534
SIM,1893,54,na,1947,33
STAT,1872,40,na,1912,23.886532596591557
STAT,1876,54,na,1930,21.267185303518268
STAT,1897,13,na,1910,34.241412708610106
STAT,1825,62,na,1887,10.18894460647432
STAT,1846,21,na,1867,21.534965195248844
STAT,1886,25,30-34,1911,0.2629754522109936
STAT,1867,2,na,1869,32.196131790580715
STAT,1847,37,40-44,1884,0.0485177643742687
STAT,1836,42,25-29,1878,0.007372542121567392
SIM,1892,13,na,1905,36
SIM,1863,21,na,1884,17
SIM,1919,23,25-29,1942,2
STAT,1902,35,35-39,1937,0.021732760593762803
STAT,1931,17,50-100,1948,0.004882152121379088
SIM,1878,86,na,1964,4
STAT,1836,34,30-34,1870,0.2086100717798039
STAT,1831,30,30-34,1861,0.18823535938427333
STAT,1910,28,na,1938,35.82718378001013
STAT,1845,44,25-29,1889,0.003725783123330635
SIM,1889,49,na,1938,27
STAT,1894,16,20-24,1910,0.22776544576003863
STAT,1863,44,40-44,1907,0.019646219009525064
STAT,1846,32,na,1878,20.75629636035495
STAT,1927,22,25-29,1949,1.1322297585088685
STAT,1915,20,40-44,1935,0.03326144078153533
STAT,1847,40,40-44,1887,0.024788707504647633
STAT,1893,40,40-44,1933,0.0286467786016251
STAT,1879,38,45-49,1917,0.020530448123721755
STAT,1861,28,25-29,1889,0.3557478912642594
SIM,1894,25,30-34,1919,1
STAT,1857,72,na,1929,9.454132751107805
STAT,1851,42,20-24,1893,0.0013390980254906083
STAT,1852,34,15-19,1886,0.0012359786579064977
STAT,1934,17,20-24,1951,1.8260245034889049
STAT,1904,3,na,1907,37.88049404614762
STAT,1851,39,20-24,1890,0.006442247034655201
STAT,1853,35,15-19,1888,3.6032677266346994E-4
SIM,1958,12,na,1970,53
SIM,1889,78,na,1967,15
STAT,1835,19,20-24,1854,0.21330196778857544
STAT,1852,22,15-19,1874,0.0335414289941415
STAT,1877,36,15-19,1913,5.824516162349492E-4
STAT,1888,25,35-39,1913,0.11352216972927583
STAT,1904,41,50-100,1945,0.0010559563657502405
STAT,1848,36,na,1884,15.864984675561432
STAT,1823,39,15-19,1862,3.966890474372562E-4
SIM,1889,38,na,1927,32
STAT,1826,39,40-44,1865,0.048080735156051775
STAT,1862,41,15-19,1903,1.196854342821597E-4
SIM,1918,22,25-29,1940,2
STAT,1842,15,45-49,1857,6.368339049821109E-4
STAT,1945,23,30-34,1968,0.31263566721829644
STAT,1879,19,na,1898,26.000091056998155
STAT,1893,23,15-19,1916,0.041468113406279136
STAT,1894,36,15-19,1930,7.231361306906484E-4
SIM,1939,30,na,1969,29
STAT,1843,32,15-19,1875,7.262252148967484E-4
SIM,1925,17,na,1942,38
SIM,1932,27,na,1959,45
STAT,1887,26,30-34,1913,0.27580563989876633
STAT,1935,33,15-19,1968,0.0017688725611538668
STAT,1810,93,na,1903,0.10504957249147533
SIM,1935,22,25-29,1957,5
STAT,1847,24,35-39,1871,0.07532535262630752
STAT,1826,32,15-19,1858,0.002017150059032627
STAT,1797,100,na,1897,0.002274147370436356
SIM,1935,24,na,1959,57
STAT,1836,35,15-19,1871,6.791592004302983E-4
STAT,1916,48,50-100,1964,0.002293655342541679
STAT,1929,22,35-39,1951,0.11850273452538744
SIM,1931,10,na,1941,63
STAT,1890,17,45-49,1907,7.934743597948528E-4
STAT,1926,35,na,1961,45.79541734434049
STAT,1899,31,45-49,1930,0.023969323530771053
SIM,1893,43,na,1936,35
STAT,1862,32,25-29,1894,0.08836956740870934
STAT,1814,86,na,1900,0.9887287527483742
STAT,1888,38,40-44,1926,0.05090168089652199
STAT,1845,24,30-34,1869,0.1274106039364503
STAT,1852,29,40-44,1881,0.026784724836775152
STAT,1872,61,na,1933,19.119322395574297
STAT,1857,26,15-19,1883,0.003523700356352411
STAT,1861,33,20-24,1894,0.022635594715133264
STAT,1835,29,40-44,1864,0.01758101921472857
STAT,1945,18,35-39,1963,0.04549409535943759
STAT,1920,36,40-44,1956,0.016265611017802883
STAT,1842,39,25-29,1881,0.022586155862039003
STAT,1897,15,35-39,1912,0.007320467344295432
STAT,1900,35,30-34,1935,0.07460617321678778
SIM,1921,35,na,1956,41
SIM,1900,70,na,1970,18
STAT,1797,81,na,1878,1.8322147095107417
STAT,1801,57,na,1858,10.162210258349525
STAT,1946,22,35-39,1968,0.10404195886707288
STAT,1846,23,35-39,1869,0.05793328338257293
STAT,1859,50,na,1909,17.359672090682245
STAT,1793,96,na,1889,0.00878944161750201
STAT,1867,50,40-44,1917,1.0219320840661932E-4
STAT,1900,24,20-24,1924,0.949614936439756
SIM,1833,23,na,1856,14
SIM,1861,39,30-34,1900,1
SIM,1846,44,na,1890,14
SIM,1812,64,na,1876,15
STAT,1838,53,45-49,1891,1.1082909632562057E-4
STAT,1825,70,na,1895,7.564020476568463
STAT,1860,29,20-24,1889,0.09501612572829048
SIM,1871,25,30-34,1896,1
STAT,1842,15,15-19,1857,0.05785637197520076
STAT,1876,35,15-19,1911,5.757479272556979E-4
STAT,1904,35,45-49,1939,0.0062239466908387015
SIM,1880,25,na,1905,32
STAT,1888,41,40-44,1929,0.026403926581363
STAT,1883,24,na,1907,22.822774033572344
STAT,1855,37,45-49,1892,0.014035538201963614
STAT,1921,48,20-24,1969,1.2326574028608832E-4
SIM,1822,71,na,1893,10
STAT,1840,44,40-44,1884,0.017920460984011177
STAT,1854,18,40-44,1872,0.001329478883395304
STAT,1836,22,na,1858,27.23275689509946
STAT,1870,15,20-24,1885,0.17990388881748282
STAT,1884,50,40-44,1934,1.0462708602899349E-4
STAT,1903,58,na,1961,29.380207635277085
STAT,1898,24,40-44,1922,0.027934622012139806
STAT,1917,43,50-100,1960,0.0012129406633628913
STAT,1910,46,25-29,1956,4.931141971469494E-4
STAT,1931,24,40-44,1955,0.04314409070332124
SIM,1881,23,25-29,1904,6
STAT,1832,26,40-44,1858,0.018050655631299643
STAT,1860,32,20-24,1892,0.021975129891078898
STAT,1863,25,30-34,1888,0.22619645927862897
STAT,1932,38,25-29,1970,0.013162344659071765
STAT,1848,98,na,1946,0.02100830807809544
STAT,1876,23,20-24,1899,0.6977441041884561
STAT,1868,24,na,1892,22.744366151878463
STAT,1891,40,30-34,1931,0.014252992847692438
STAT,1900,41,50-100,1941,0.0010219032676225066
STAT,1895,15,25-29,1910,0.07391040896079566
STAT,1853,39,30-34,1892,0.03315827890608311
STAT,1833,29,30-34,1862,0.24220591922257795
STAT,1848,36,45-49,1884,0.01342399937318422
STAT,1863,40,25-29,1903,0.005743013235355515
STAT,1846,41,30-34,1887,0.009551621910378765
STAT,1910,48,45-49,1958,0.0020097850977284348
STAT,1905,30,25-29,1935,0.1490137438418662
SIM,1878,54,na,1932,28
SIM,1829,29,na,1858,20
STAT,1845,43,35-39,1888,0.010641777582197073
STAT,1861,44,30-34,1905,0.009537695948267566
SIM,1841,29,30-34,1870,1
STAT,1912,48,50-100,1960,0.0021506897337174274
STAT,1874,28,na,1902,24.125850240822924
STAT,1859,28,na,1887,19.157360020786797
STAT,1867,49,30-34,1916,9.069965985284421E-4
STAT,1845,32,25-29,1877,0.07118928715841337
STAT,1898,27,15-19,1925,0.006120451186529889
STAT,1860,36,na,1896,19.245638015357443
STAT,1928,15,30-34,1943,0.15354154175727286
STAT,1943,23,20-24,1966,1.1740267969081004
STAT,1828,28,40-44,1856,0.04514718709677454
STAT,1876,26,25-29,1902,0.4311069694930942
STAT,1814,54,40-44,1868,2.7788118215775443E-4
STAT,1885,29,25-29,1914,0.414747180801729
STAT,1912,54,na,1966,34.11646821759894
STAT,1882,90,na,1972,2.595420532433892
SIM,1870,27,35-39,1897,1
STAT,1865,44,45-49,1909,0.013354197957550084
STAT,1862,27,35-39,1889,0.08355443131954271
STAT,1774,93,na,1867,0.027652399018299623
STAT,1887,42,30-34,1929,0.012533268213727888
SIM,1792,78,na,1870,1
SIM,1910,40,na,1950,32
SIM,1907,28,na,1935,37
STAT,1896,47,35-39,1943,0.0010324851265493074
STAT,1906,17,45-49,1923,9.490156910125229E-4
STAT,1832,22,25-29,1854,0.3492987363613121
STAT,1791,102,na,1893,5.381245808313835E-4
STAT,1912,7,na,1919,39.97333986774777
STAT,1881,45,40-44,1926,0.0016452832155519673
STAT,1895,19,40-44,1914,0.0023618143061762634
STAT,1929,3,na,1932,51.51633372623932
STAT,1837,35,50-100,1872,0.007440514812558338
STAT,1861,21,na,1882,20.58051897405988
SIM,1890,54,na,1944,24
STAT,1906,48,25-29,1954,4.6610608253573415E-4
STAT,1834,42,20-24,1876,0.0013529903423418004
SIM,1825,82,na,1907,2
SIM,1894,68,na,1962,20
STAT,1859,9,na,1868,22.477890287677994
STAT,1874,32,50-100,1906,0.009295232412475816
SIM,1859,62,na,1921,14
STAT,1863,87,na,1950,1.559900452826348
STAT,1842,51,45-49,1893,1.0940455416715022E-4
STAT,1917,17,20-24,1934,0.2890954888665855
SIM,1925,17,20-24,1942,3
STAT,1916,24,45-49,1940,0.01161631948861427
STAT,1947,15,40-44,1962,0.015656655959752398
STAT,1896,42,na,1938,30.426306501087844
STAT,1829,47,45-49,1876,0.0020145969618610726
STAT,1838,88,na,1926,1.0655219740812734
STAT,1834,39,20-24,1873,0.00663666596697496
STAT,1880,44,40-44,1924,0.023333067660257233
STAT,1844,25,20-24,1869,0.11380357551204622
SIM,1944,20,na,1964,34
STAT,1896,38,45-49,1934,0.026055287058621878
STAT,1838,34,40-44,1872,0.04096547234884871
STAT,1866,17,20-24,1883,0.1675900696283402
STAT,1844,19,35-39,1863,0.005384174354122007
STAT,1893,31,na,1924,30.21141622805804
SIM,1856,43,na,1899,11
STAT,1836,37,35-39,1873,0.08378498444874377
STAT,1895,35,25-29,1930,0.037734323988861035
SIM,1866,10,na,1876,35
STAT,1851,45,25-29,1896,4.91124973952738E-4
STAT,1893,39,30-34,1932,0.06652310713236745
STAT,1942,23,50-100,1965,0.006846520822319591
STAT,1899,18,50-100,1917,6.689091563352759E-4
STAT,1931,20,25-29,1951,1.1998211063482764
SIM,1876,28,na,1904,28
SIM,1930,17,na,1947,46
SIM,1879,6,na,1885,20
STAT,1800,86,na,1886,0.6660060531020938
STAT,1851,26,20-24,1877,0.11680134247301491
STAT,1886,44,35-39,1930,0.018529426608118984
STAT,1915,23,45-49,1938,0.011494712046207615
STAT,1819,42,25-29,1861,0.006087292974511465
STAT,1886,33,25-29,1919,0.10579473838488235
SIM,1808,67,na,1875,5
STAT,1873,27,40-44,1900,0.030455677176234344
STAT,1888,34,25-29,1922,0.11867009293869148
STAT,1895,23,50-100,1918,0.0052778013623345785
STAT,1821,44,30-34,1865,0.01677150707022885
STAT,1823,42,45-49,1865,0.010608544204307483
STAT,1823,39,45-49,1862,0.014082459509273764
STAT,1885,46,20-24,1931,1.1883823009425825E-4
STAT,1840,35,35-39,1875,0.06692717754337962
SIM,1833,26,na,1859,10
STAT,1879,15,40-44,1894,0.0019018603988752796
STAT,1879,54,45-49,1933,1.4607439981283857E-4
STAT,1873,30,40-44,1903,0.04444548704388824
STAT,1948,1,na,1949,46.68364435582101
SIM,1866,21,na,1887,30
STAT,1859,105,na,1964,0.0011783967761318202
STAT,1862,62,na,1924,15.769017814653491
STAT,1824,43,45-49,1867,0.019947162215517202
STAT,1879,35,40-44,1914,0.04573788352929529
SIM,1858,21,na,1879,26
STAT,1880,13,na,1893,27.114362115146317
SIM,1843,33,na,1876,23
STAT,1905,34,40-44,1939,0.03563107670709385
STAT,1818,38,25-29,1856,0.03667342680716883
STAT,1889,24,45-49,1913,0.008484082656614945
SIM,1777,78,na,1855,2
STAT,1793,99,na,1892,0.0018968557908233966
STAT,1850,29,na,1879,22.342028057904493
STAT,1878,39,35-39,1917,0.07228714796104246
STAT,1882,79,na,1961,8.616342704460854
STAT,1873,65,na,1938,17.181724209129538
SIM,1865,36,na,1901,24
STAT,1857,23,40-44,1880,0.017879492456733984
STAT,1938,23,na,1961,35.89180178966453
STAT,1852,95,na,1947,0.11378962706437351
STAT,1891,34,45-49,1925,0.021219797975622227
STAT,1831,33,35-39,1864,0.10567179822648597
STAT,1861,15,25-29,1876,0.0554245050220104
STAT,1825,36,20-24,1861,0.008236048579896557
STAT,1876,44,20-24,1920,0.0015912056380342798
STAT,1882,39,na,1921,22.351119503431686
STAT,1815,101,na,1916,0.0020369478298105374
STAT,1901,14,na,1915,36.019262583540716
STAT,1905,28,na,1933,34.322049951067015
STAT,1862,45,30-34,1907,8.434823119660467E-4
STAT,1883,52,45-49,1935,1.4017713397955755E-4
STAT,1875,43,20-24,1918,0.0016207132613091718
SIM,1876,5,na,1881,34
STAT,1837,38,35-39,1875,0.04151978521584728
STAT,1904,43,na,1947,32.99185239006457
STAT,1833,45,45-49,1878,0.0020998082187906465
STAT,1892,27,20-24,1919,0.1449312460661009
STAT,1873,23,50-100,1896,0.004133163939784254
STAT,1918,17,50-100,1935,8.107425631594055E-4
STAT,1881,36,35-39,1917,0.0676258478348235
SIM,1906,43,na,1949,24
STAT,1780,78,na,1858,5.47563509027815
STAT,1873,54,na,1927,21.289106339997023
STAT,1830,32,35-39,1862,0.06661923211642551
STAT,1904,22,30-34,1926,0.255230545702573
STAT,1869,45,25-29,1914,5.636743616458416E-4
STAT,1847,62,na,1909,19.524500382805666
STAT,1859,36,20-24,1895,0.00615632593978613
SIM,1880,87,na,1967,4
STAT,1871,33,35-39,1904,0.10054080398108525
STAT,1835,25,25-29,1860,0.26085787803406235
SIM,1868,76,na,1944,16
STAT,1849,21,na,1870,20.18929497299492
STAT,1921,32,50-100,1953,0.009129174581794337
STAT,1872,34,35-39,1906,0.10272999353478657
SIM,1879,79,na,1958,5
STAT,1826,48,30-34,1874,9.616182316400897E-4
STAT,1880,24,25-29,1904,0.5981995763378967
STAT,1827,49,30-34,1876,7.112102031661914E-4
STAT,1897,16,na,1913,33.62129508056243
STAT,1911,22,30-34,1933,0.27082403955555184
SIM,1919,20,20-24,1939,1
SIM,1871,51,na,1922,23
SIM,1891,28,na,1919,34
STAT,1847,73,na,1920,12.68801342441384
STAT,1856,30,50-100,1886,0.006859846961489111
STAT,1908,34,50-100,1942,0.007697292749497142
STAT,1813,102,na,1915,0.0019348245686441382
STAT,1834,44,na,1878,17.458520439773917
STAT,1850,33,45-49,1883,0.016074369012277247
STAT,1886,39,50-100,1925,0.012606790359951438
STAT,1820,43,30-34,1863,0.00999693877675417
STAT,1875,19,50-100,1894,5.009074321791238E-4
STAT,1913,17,na,1930,39.158946052534255
STAT,1814,45,35-39,1859,0.004134379754223836
SIM,1877,13,na,1890,31
SIM,1877,29,40-44,1906,1
STAT,1845,47,na,1892,13.090105459029552
SIM,1808,56,na,1864,14
STAT,1822,65,na,1887,6.062334198026847
STAT,1834,42,15-19,1876,1.1765134047112909E-4
STAT,1873,57,na,1930,20.431770108537556
STAT,1910,43,20-24,1953,1.648900352963655E-4
STAT,1865,20,40-44,1885,0.019353821120537355
SIM,1891,17,na,1908,36
STAT,1826,55,na,1881,15.569755216321727
STAT,1845,25,15-19,1870,0.003274954126849925
STAT,1847,33,25-29,1880,0.12714042202337558
STAT,1875,58,na,1933,20.328558403366507
STAT,1873,51,40-44,1924,1.0754595198447785E-4
SIM,1802,73,na,1875,4
STAT,1830,60,na,1890,6.85234592154294
STAT,1836,30,15-19,1866,0.0017736577977267311
STAT,1865,17,40-44,1882,0.0017047620816495162
STAT,1858,42,45-49,1900,0.01137458266211789
SIM,1813,49,na,1862,10
STAT,1860,92,na,1952,0.3385983678200004
STAT,1856,54,45-49,1910,1.0224168520387958E-4
STAT,1894,43,25-29,1937,5.673680865544872E-4
STAT,1861,47,35-39,1908,0.0011718489217802431
SIM,1817,39,na,1856,9
STAT,1864,82,na,1946,4.184884586062156
SIM,1858,23,na,1881,26
STAT,1922,21,35-39,1943,0.10751180677810859
SIM,1926,12,na,1938,49
STAT,1934,19,na,1953,49.309159204165645
SIM,1926,10,na,1936,49
SIM,1896,40,na,1936,31
STAT,1833,42,40-44,1875,0.02017836233010654
STAT,1827,74,na,1901,6.725514731866571
STAT,1896,28,na,1924,31.237497429545527
SIM,1821,78,na,1899,2
STAT,1896,31,25-29,1927,0.13509011164519388
STAT,1902,35,40-44,1937,0.013450625888149057
SIM,1822,85,na,1907,1
STAT,1813,50,30-34,1863,1.8441265344084612E-4
SIM,1887,12,na,1899,26
STAT,1880,21,20-24,1901,0.7268392484092341
STAT,1911,8,na,1919,39.5243893109653
STAT,1863,44,35-39,1907,0.015816487901283746
STAT,1848,58,na,1906,12.789118178405628
STAT,1940,2,na,1942,41.06211866550825
STAT,1880,41,30-34,1921,0.012144073426616003
STAT,1918,4,na,1922,43.53396074582062
STAT,1856,42,35-39,1898,0.013101988322405665
STAT,1866,103,na,1969,0.011178981626651555
STAT,1805,61,na,1866,7.802455676713024
STAT,1829,40,25-29,1869,0.005839578539981326
STAT,1873,23,25-29,1896,0.5802134932585747
SIM,1850,35,na,1885,21
STAT,1865,48,50-100,1913,0.0021935086789995344
STAT,1859,39,50-100,1898,0.00966009380988834
STAT,1886,27,50-100,1913,0.006635313649760016
STAT,1882,44,45-49,1926,0.0141493550536765
STAT,1805,93,na,1898,0.08001968785675433
STAT,1839,30,40-44,1869,0.03006965646232798
STAT,1839,27,40-44,1866,0.02082560519365707
STAT,1871,15,15-19,1886,0.06025735908528164
STAT,1921,22,30-34,1943,0.3220960640895257
SIM,1950,3,na,1953,65
STAT,1836,26,50-100,1862,0.008046160928101842
STAT,1827,96,na,1923,0.052036660928056346
STAT,1844,50,50-100,1894,1.196620624348924E-4
STAT,1930,40,25-29,1970,9.377661514584248E-4
STAT,1852,63,na,1915,15.270935978289005
STAT,1879,36,50-100,1915,0.012768421109347092
STAT,1871,15,50-100,1886,4.974464520516113E-4
STAT,1917,49,45-49,1966,0.002236299396475834
SIM,1842,48,na,1890,23
STAT,1944,22,25-29,1966,0.9900889654882643
SIM,1869,72,na,1941,9
STAT,1894,27,na,1921,30.58548825339873
STAT,1877,16,20-24,1893,0.18345418846477216
SIM,1825,68,na,1893,9
STAT,1815,53,45-49,1868,1.9735833194839498E-4
STAT,1875,43,15-19,1918,1.4093159555176552E-4
SIM,1935,27,25-29,1962,2
STAT,1938,5,na,1943,39.40113309711098
STAT,1869,20,na,1889,23.151346977109963
STAT,1896,44,30-34,1940,0.001034510657726135
STAT,1884,32,45-49,1916,0.017085131918338565
STAT,1913,25,na,1938,37.26589354173004
STAT,1850,82,na,1932,4.1542861982287524
STAT,1866,16,45-49,1882,6.211606106918733E-4
STAT,1922,34,40-44,1956,0.043677476007008824
STAT,1811,104,na,1915,3.7799662466377754E-4
SIM,1855,66,na,1921,8
STAT,1850,29,30-34,1879,0.2600759916269935
STAT,1946,12,na,1958,43.26143945023196
STAT,1955,3,na,1958,51.926435719007586
STAT,1817,49,40-44,1866,0.0048080831748727555
STAT,1847,44,50-100,1891,0.011133078155628633
SIM,1827,49,na,1876,14
STAT,1904,32,40-44,1936,0.03568102365003864
STAT,1904,17,50-100,1921,7.020000661977974E-4
SIM,1880,79,na,1959,15
STAT,1885,68,na,1953,15.091177076498992
STAT,1927,27,25-29,1954,0.7960988280808858
STAT,1902,22,20-24,1924,0.9717947884824044
STAT,1930,29,na,1959,47.36421780868472
STAT,1864,40,35-39,1904,0.0164054868018849
STAT,1845,41,20-24,1886,9.5753496839349E-4
STAT,1877,31,15-19,1908,0.001476026387134966
STAT,1856,87,na,1943,1.276312350688138
STAT,1822,38,50-100,1860,0.007358906117449554
STAT,1788,96,na,1884,0.019063409672768313
STAT,1928,22,40-44,1950,0.04177547926587468
STAT,1908,27,15-19,1935,0.006695274474947587
STAT,1940,17,50-100,1957,0.003777021802853785
STAT,1850,21,35-39,1871,0.06281259205156918
SIM,1880,33,na,1913,30
STAT,1937,32,35-39,1969,0.08984012796438541
STAT,1797,59,na,1856,8.650480968899998
STAT,1880,27,na,1907,25.095558982122245
SIM,1851,84,na,1935,4
STAT,1924,39,35-39,1963,0.02827555215326223
SIM,1928,5,na,1933,55
STAT,1778,101,na,1879,0.0015287278630005138
STAT,1853,42,25-29,1895,0.004030867546259204
STAT,1881,20,25-29,1901,0.5479669512512009
STAT,1932,23,45-49,1955,0.014658049537581447
STAT,1872,18,na,1890,25.773545325010954
STAT,1881,40,35-39,1921,0.017404543454896528
STAT,1815,71,na,1886,5.369032397191868
STAT,1834,41,45-49,1875,0.012914869416041568
STAT,1917,33,20-24,1950,0.025202907816522655
STAT,1920,19,na,1939,40.72493368220096
STAT,1855,15,30-34,1870,0.013506026982778092
STAT,1869,15,15-19,1884,0.058991456728045004
SIM,1900,27,na,1927,36
STAT,1922,28,20-24,1950,0.20431975773422287
STAT,1889,21,40-44,1910,0.02558975736171359
STAT,1897,43,35-39,1940,0.0016577963881855868
STAT,1923,49,na,1972,42.429130344759386
STAT,1814,42,30-34,1856,0.03673710152412249
STAT,1895,32,20-24,1927,0.03509260155399006
STAT,1880,47,45-49,1927,0.002470095652412859
SIM,1870,55,na,1925,21
STAT,1840,32,30-34,1872,0.1666370579788709
STAT,1814,78,na,1892,3.4817892475971073
STAT,1926,41,50-100,1967,0.0014420821507950012
STAT,1921,12,na,1933,44.81240821557089
STAT,1855,38,na,1893,16.505449030452017
STAT,1927,43,30-34,1970,0.0015926657064964855
STAT,1907,39,35-39,1946,0.02210602495276319
STAT,1879,19,35-39,1898,0.0056487381445053855
STAT,1923,30,40-44,1953,0.04490984355317338
STAT,1908,30,15-19,1938,0.001216384134276708
SIM,1825,36,na,1861,20
SIM,1804,66,na,1870,9
STAT,1934,33,20-24,1967,0.033141181046768636
STAT,1871,50,50-100,1921,1.5273828477991677E-4
STAT,1877,39,na,1916,24.07506651042283
STAT,1953,17,25-29,1970,0.5211913175555003
STAT,1860,32,15-19,1892,0.0011577355237922357
STAT,1841,31,35-39,1872,0.12152382799680084
STAT,1917,20,15-19,1937,0.056395829684623935
STAT,1833,44,50-100,1877,0.009237720157163978
STAT,1843,31,45-49,1874,0.008985654705897857
SIM,1829,40,na,1869,20
STAT,1845,93,na,1938,0.17083669842508267
STAT,1886,42,20-24,1928,0.0016452859656747349
SIM,1920,47,na,1967,42
STAT,1929,32,na,1961,47.810802287882424
STAT,1934,17,15-19,1951,0.611253965941277
STAT,1820,46,35-39,1866,0.0011993596993702291
STAT,1889,18,40-44,1907,0.0022334730537889175
STAT,1934,20,15-19,1954,0.07146714002283105
STAT,1860,31,45-49,1891,0.014234733880547917
STAT,1793,100,na,1893,0.0010633204506618715
STAT,1771,106,na,1877,2.0362053606381997E-4
SIM,1925,17,15-19,1942,1
SIM,1781,86,na,1867,1
STAT,1917,17,15-19,1934,0.09677349004232917
STAT,1897,33,50-100,1930,0.01211598612668646
STAT,1933,29,35-39,1962,0.1983407784787116
SIM,1876,20,na,1896,31
STAT,1843,39,40-44,1882,0.019321314807931964
STAT,1881,33,30-34,1914,0.16543569770024777
SIM,1916,34,na,1950,43
STAT,1915,23,50-100,1938,0.006722054084321084
STAT,1908,43,20-24,1951,1.6156869687561145E-4
SIM,1818,80,na,1898,5
STAT,1890,30,35-39,1920,0.12400256630910587
STAT,1856,53,na,1909,15.347817933593427
STAT,1843,35,na,1878,10.828972943889175
STAT,1860,108,na,1968,1.679637253398627E-4
STAT,1860,39,na,1899,18.960680440284822
STAT,1824,39,30-34,1863,0.07435749161437206
SIM,1810,60,na,1870,13
SIM,1900,25,30-34,1925,1
STAT,1886,26,15-19,1912,0.00472225371166179
SIM,1951,19,na,1970,43
STAT,1796,93,na,1889,0.014190191406040229
STAT,1860,39,40-44,1899,0.03522972677508085
SIM,1830,37,na,1867,18
SIM,1889,60,na,1949,22
STAT,1817,41,50-100,1858,0.03441494408862546
STAT,1879,48,na,1927,22.993486625753597
STAT,1850,49,25-29,1899,5.021422585239563E-4
SIM,1855,58,na,1913,11
STAT,1819,35,15-19,1854,7.03402351390341E-4
STAT,1896,16,30-34,1912,0.02098746819915988
STAT,1860,48,30-34,1908,7.770694335633602E-4
STAT,1891,22,35-39,1913,0.07162256977071821
STAT,1899,43,45-49,1942,0.0014124520125613632
STAT,1849,15,50-100,1864,4.731579614769725E-4
STAT,1829,25,30-34,1854,0.6325921388918818
STAT,1869,42,20-24,1911,0.0015369106942874858
STAT,1824,31,35-39,1855,0.17089025902050867
STAT,1856,85,na,1941,1.9859212316965078
STAT,1860,100,na,1960,0.019094332656359722
STAT,1847,32,50-100,1879,0.011491976430845496
STAT,1918,32,25-29,1950,0.09732681015828497
STAT,1914,40,40-44,1954,0.002475085455668819
SIM,1884,71,na,1955,13
STAT,1858,19,20-24,1877,0.15573526908795207
STAT,1882,36,15-19,1918,5.407439133677242E-4
STAT,1884,49,na,1933,21.582620764161998
STAT,1871,84,na,1955,3.3166532130033564
STAT,1942,30,na,1972,40.03945951078151
STAT,1950,17,na,1967,43.25221775539522
STAT,1926,39,45-49,1965,0.008266240067722228
SIM,1837,25,30-34,1862,1
STAT,1857,47,50-100,1904,0.0018300097738141717
STAT,1834,49,40-44,1883,0.001250610742067845
STAT,1882,46,50-100,1928,0.0023603748899411353
SIM,1892,58,na,1950,32
STAT,1921,32,40-44,1953,0.043209641677609614
SIM,1900,59,na,1959,27
SIM,1933,14,na,1947,53
STAT,1831,29,50-100,1860,0.006831051450874788
STAT,1902,33,na,1935,33.50943077336313
STAT,1868,56,na,1924,19.73846238542011
STAT,1877,43,25-29,1920,0.0065808524678790704
STAT,1936,33,30-34,1969,0.15201212596218214
STAT,1850,46,20-24,1896,1.0714714164763695E-4
STAT,1927,24,20-24,1951,1.3544501572387906
STAT,1850,15,na,1865,25.27150271110842
STAT,1889,26,na,1915,29.319232348414996
STAT,1885,36,na,1921,23.377602143652524
STAT,1922,19,50-100,1941,0.004281102548924048
SIM,1905,48,na,1953,40
STAT,1895,16,15-19,1911,0.07723484126106613
SIM,1818,66,na,1884,15
STAT,1883,40,45-49,1923,0.014680244570816965
STAT,1865,23,45-49,1888,0.006338018461607617
SIM,1830,69,na,1899,4
STAT,1875,46,25-29,1921,5.937757498267268E-4
SIM,1896,48,na,1944,26
STAT,1933,24,15-19,1957,0.07027393547796124
STAT,1884,33,15-19,1917,0.0013893540393376909
STAT,1951,17,15-19,1968,0.5371536644155827
SIM,1941,24,15-19,1965,1
STAT,1834,22,35-39,1856,0.05515273889416655
STAT,1817,64,na,1881,15.645807852388206
SIM,1860,67,na,1927,16
STAT,1832,43,na,1875,11.409666287233206
STAT,1911,32,15-19,1943,0.0012432664901374374
SIM,1899,70,na,1969,17
STAT,1918,17,30-34,1935,0.026376163417330255
STAT,1817,42,15-19,1859,4.3622594366382746E-4
STAT,1852,43,20-24,1895,0.0013493799453290008
STAT,1876,51,na,1927,21.97318890605423
STAT,1849,83,na,1932,3.078202620044974
STAT,1954,15,45-49,1969,0.006143512504713999
SIM,1948,13,na,1961,39
STAT,1840,39,15-19,1879,5.097419066998171E-4
SIM,1868,16,20-24,1884,1
STAT,1854,19,30-34,1873,0.011517220029311494
SIM,1922,1,na,1923,53
STAT,1863,33,na,1896,21.03917947657688
STAT,1863,55,na,1918,18.307486546750724
STAT,1860,50,na,1910,17.756215116262197
STAT,1921,1,na,1922,47.230575383815925
STAT,1856,23,25-29,1879,0.47818438507544697
STAT,1850,37,na,1887,21.308972981760636
STAT,1877,19,25-29,1896,0.058181731971246826
STAT,1928,42,35-39,1970,0.0025545047712995524
STAT,1886,83,na,1969,7.623433886540611
STAT,1915,46,30-34,1961,8.927436477028319E-4
SIM,1878,26,30-34,1904,3
STAT,1938,25,35-39,1963,0.1478882702377607
STAT,1949,16,20-24,1965,1.567145985957048
STAT,1940,30,40-44,1970,0.04025931430718192
STAT,1839,33,45-49,1872,0.011720357294996224
STAT,1789,91,na,1880,0.1186694781779312
STAT,1910,42,na,1952,34.885232428240286
SIM,1928,32,35-39,1960,1
STAT,1887,21,30-34,1908,0.1950094273129229
SIM,1814,44,na,1858,20
STAT,1937,17,40-44,1954,0.01352131669010352
SIM,1908,47,na,1955,38
SIM,1946,25,35-39,1971,1
STAT,1849,16,45-49,1865,6.271614147784974E-4
STAT,1909,12,na,1921,38.51165023943448
STAT,1882,21,50-100,1903,0.003919832716658933
STAT,1865,14,na,1879,24.229511118969462
STAT,1929,23,50-100,1952,0.008255525849252229
STAT,1917,43,30-34,1960,0.0013199648424385003
STAT,1854,15,15-19,1869,0.043908135801837445
STAT,1892,78,na,1970,14.09855453286595
SIM,1898,34,35-39,1932,1
STAT,1862,25,15-19,1887,0.003985846577921549
STAT,1863,47,45-49,1910,0.002079796830334299
STAT,1893,44,20-24,1937,1.3717641290190825E-4
SIM,1847,33,45-49,1880,1
STAT,1860,32,50-100,1892,0.007448826291701265
STAT,1874,43,40-44,1917,0.022653872873325306
SIM,1835,60,na,1895,13
SIM,1910,32,30-34,1942,3
STAT,1828,29,30-34,1857,0.365395951815448
STAT,1878,15,25-29,1893,0.058776118665468384
SIM,1846,52,na,1898,13
STAT,1817,41,45-49,1858,0.04875450426526506
STAT,1780,92,na,1872,0.20462581938394064
STAT,1807,52,40-44,1859,2.157206358066257E-4
STAT,1834,45,25-29,1879,4.8669341473779344E-4
STAT,1834,84,na,1918,2.350915693329159
STAT,1818,60,na,1878,5.538596683262996
STAT,1822,33,na,1855,10.522153629829003
SIM,1883,22,na,1905,15
STAT,1819,45,na,1864,14.205951121514863
STAT,1849,33,35-39,1882,0.08189035360657781
STAT,1860,44,50-100,1904,0.00847273466702732
SIM,1839,50,na,1889,20
SIM,1956,3,na,1959,47
STAT,1902,32,30-34,1934,0.24621460369948006
STAT,1855,30,25-29,1885,0.07496889241967068
STAT,1846,20,30-34,1866,0.18070059840049638
STAT,1893,23,na,1916,29.728217485786967
STAT,1858,43,15-19,1901,1.0432605268686723E-4
SIM,1820,59,na,1879,9
STAT,1901,39,40-44,1940,0.01308786764883658
STAT,1939,7,na,1946,39.65141677804356
STAT,1897,45,50-100,1942,0.0018580755373245677
STAT,1869,21,50-100,1890,0.003963179270264549
STAT,1841,35,15-19,1876,6.611843162688492E-4
STAT,1881,20,na,1901,22.63873924013871
SIM,1812,61,na,1873,15
SIM,1836,29,30-34,1865,1
STAT,1841,43,45-49,1884,0.015028711412984863
STAT,1852,48,40-44,1900,0.0014468016944674494
STAT,1884,17,50-100,1901,4.799988865228223E-4
STAT,1838,18,35-39,1856,0.005592247618455239
STAT,1907,36,30-34,1943,0.01690764104394797
STAT,1911,42,25-29,1953,6.771679444242281E-4
STAT,1869,101,na,1970,0.044553895568269955
STAT,1862,20,15-19,1882,0.02956002199675888
STAT,1902,33,50-100,1935,0.01286624680047301
STAT,1868,26,20-24,1894,0.11392017585896745
SIM,1832,38,na,1870,25
STAT,1928,25,45-49,1953,0.021323634852492817
STAT,1913,29,50-100,1942,0.009764510988996526
STAT,1890,80,na,1970,11.978528678570024
SIM,1898,21,na,1919,30
STAT,1883,16,45-49,1899,6.358926740870502E-4
SIM,1913,4,na,1917,48
STAT,1951,13,na,1964,46.48537440104616
STAT,1788,98,na,1886,0.007144286380550912
STAT,1875,23,35-39,1898,0.05980000551115074
STAT,1907,34,15-19,1941,0.0011858586088350684
STAT,1842,23,50-100,1865,0.0038313058928774856
SIM,1876,42,na,1918,28
STAT,1906,33,45-49,1939,0.01448569631041706
STAT,1901,46,na,1947,31.57657547421075
STAT,1917,24,30-34,1941,0.30079474750724955
STAT,1935,20,50-100,1955,0.008926693226214352
STAT,1854,72,na,1926,7.719255936513011
STAT,1830,62,na,1892,6.566893614839402
STAT,1909,34,na,1943,35.58128680138839
STAT,1798,74,na,1872,8.274847959596302
STAT,1879,16,30-34,1895,0.01653722433154043
STAT,1856,31,na,1887,17.68153664188493
STAT,1943,13,na,1956,41.34457981889791
SIM,1821,46,na,1867,14
STAT,1912,16,25-29,1928,0.08715675654596236
STAT,1908,46,25-29,1954,4.8083290132778475E-4
STAT,1913,31,35-39,1944,0.0905281012042233
STAT,1857,50,45-49,1907,1.1020231603766118E-4
STAT,1835,69,na,1904,6.600905255542989
STAT,1897,24,25-29,1921,0.7554372287467366
STAT,1905,21,35-39,1926,0.08447432932885324
STAT,1868,40,50-100,1908,0.010326924983526905
SIM,1847,37,na,1884,18
STAT,1822,43,35-39,1865,0.010197698313715102
SIM,1863,24,na,1887,16
SIM,1899,37,na,1936,28
SIM,1909,40,na,1949,36
STAT,1853,41,50-100,1894,0.006669644273526056
SIM,1941,26,30-34,1967,1
SIM,1859,70,na,1929,10
SIM,1878,7,na,1885,31
STAT,1841,54,na,1895,20.495962016219313
STAT,1860,35,25-29,1895,0.0236293872294285
STAT,1933,26,30-34,1959,0.5183784669120883
STAT,1889,72,na,1961,17.34813359686464
SIM,1913,21,35-39,1934,1
STAT,1843,80,na,1923,2.6240457440712173
STAT,1911,28,45-49,1939,0.01668041466803643
STAT,1783,75,na,1858,2.053363158854306
STAT,1904,29,50-100,1933,0.009100580866782747
STAT,1865,36,15-19,1901,5.103555063858961E-4
STAT,1872,43,30-34,1915,0.01167808906605391
STAT,1896,19,35-39,1915,0.007168839812318435
STAT,1844,12,na,1856,23.703017515200003
STAT,1901,35,25-29,1936,0.008778333554962967
SIM,1853,46,na,1899,22
SIM,1898,7,na,1905,37
SIM,1895,63,na,1958,20
STAT,1774,101,na,1875,5.583746315435558E-4
STAT,1892,42,45-49,1934,0.018466843434759673
SIM,1891,73,na,1964,26
SIM,1834,64,na,1898,11
STAT,1916,14,na,1930,41.408256967177735
STAT,1914,43,45-49,1957,0.0016328742388055971
STAT,1899,40,40-44,1939,0.002159771866612494
SIM,1887,69,na,1956,14
STAT,1866,40,45-49,1906,0.013922863271621115
STAT,1869,71,na,1940,12.933435768991359
SIM,1885,56,na,1941,19
STAT,1829,28,35-39,1857,0.10189842562852972
STAT,1867,71,na,1938,12.773515469006542
SIM,1902,50,na,1952,30
STAT,1865,81,na,1946,4.891146502771767
STAT,1878,31,30-34,1909,0.18099383198920455
STAT,1849,28,50-100,1877,0.005837539206873938
STAT,1836,18,25-29,1854,0.07304958042881163
STAT,1867,17,15-19,1884,0.058057757027867286
SIM,1949,8,na,1957,38
STAT,1805,52,30-34,1857,1.1515064529782615E-4
SIM,1847,23,25-29,1870,1
STAT,1820,84,na,1904,1.8859502481577282
STAT,1799,82,na,1881,1.900300961225448
STAT,1909,63,na,1972,30.15878789809629
STAT,1921,47,45-49,1968,0.0024309842698966504
STAT,1878,34,na,1912,24.425764618909284
STAT,1853,46,40-44,1899,0.0010790146874552378
STAT,1846,24,na,1870,21.074424611276157
STAT,1912,35,35-39,1947,0.02364512578700066
STAT,1915,49,35-39,1964,0.0012804068580059258
STAT,1833,46,20-24,1879,1.0541073248335543E-4
STAT,1852,41,na,1893,19.870207145406795
SIM,1849,27,na,1876,9
STAT,1808,50,na,1858,4.749793903401772
STAT,1926,43,na,1969,45.45141900262785
STAT,1873,30,35-39,1903,0.10378874921027541
STAT,1884,49,30-34,1933,9.285980215500611E-4
STAT,1867,93,na,1960,0.5199632908758122
STAT,1871,19,30-34,1890,0.015805664492396385
STAT,1879,81,na,1960,7.323184402376805
STAT,1837,30,30-34,1867,0.10915925831322637
SIM,1887,34,na,1921,24
STAT,1915,48,50-100,1963,0.0022531617223749724
STAT,1916,36,na,1952,38.381605881065575
STAT,1831,52,50-100,1883,1.2721337291740728E-4
STAT,1859,42,na,1901,18.34750731488182
STAT,1821,40,20-24,1861,0.002653549294990634
STAT,1851,46,50-100,1897,0.0020793179717860724
STAT,1862,48,40-44,1910,0.001458493823779774
SIM,1883,44,na,1927,12
STAT,1885,48,35-39,1933,0.001365149312960461
SIM,1874,19,na,1893,27
STAT,1907,19,20-24,1926,0.25793366566522247
STAT,1796,101,na,1897,2.48021621103398E-4
SIM,1929,25,35-39,1954,1
SIM,1829,75,na,1904,15
STAT,1806,51,35-39,1857,2.8448344912272776E-4
SIM,1870,26,na,1896,24
STAT,1918,48,na,1966,38.63333634535492
STAT,1922,30,25-29,1952,0.10449885658918427
SIM,1902,53,na,1955,30
STAT,1825,51,45-49,1876,1.318198545548322E-4
STAT,1951,10,na,1961,46.505833996424094
STAT,1855,18,35-39,1873,0.004567940016871133
STAT,1856,33,45-49,1889,0.01265540256195725
STAT,1908,0,na,1908,43.33142773009715
STAT,1862,106,na,1968,0.0010188541232796296
STAT,1920,21,25-29,1941,1.021225291175031
STAT,1932,20,40-44,1952,0.044200639797204386
STAT,1871,28,50-100,1899,0.006355285766869954
STAT,1920,52,na,1972,39.58737605732722
STAT,1859,1,na,1860,29.288540559064337
STAT,1926,36,40-44,1962,0.01820715264550502
SIM,1880,30,25-29,1910,1
STAT,1949,19,25-29,1968,0.5004451094085743
STAT,1827,42,na,1869,16.265611322361323
STAT,1860,52,45-49,1912,1.1735388697613463E-4
STAT,1882,20,40-44,1902,0.020089205095774255
STAT,1892,36,50-100,1928,0.01524063057443537
STAT,1892,30,45-49,1922,0.02171648087627596
SIM,1915,26,na,1941,36
STAT,1891,43,40-44,1934,0.02740737202269408
SIM,1893,51,na,1944,34
STAT,1884,36,25-29,1920,0.028344761874037668
STAT,1912,42,40-44,1954,0.002393500792380712
STAT,1872,30,25-29,1902,0.10564166708003069
STAT,1830,94,na,1924,0.07180839861063512
STAT,1945,22,40-44,1967,0.03658643974574452
SIM,1873,31,na,1904,24
SIM,1865,34,na,1899,24
SIM,1836,20,na,1856,11
STAT,1841,86,na,1927,2.171757029414405
STAT,1831,79,na,1910,5.67319513174722
SIM,1849,49,na,1898,7
STAT,1865,99,na,1964,0.06210624936294758
STAT,1868,29,25-29,1897,0.4064441694052051
SIM,1820,36,35-39,1856,1
SIM,1838,57,na,1895,4
STAT,1863,23,35-39,1886,0.05231850921924681
STAT,1894,47,40-44,1941,0.0012318768639185966
STAT,1874,47,20-24,1921,1.211714202465093E-4
SIM,1904,31,na,1935,29
STAT,1898,54,na,1952,28.2482721884511
STAT,1815,49,30-34,1864,0.001355983827685012
STAT,1897,28,40-44,1925,0.03963972775217688
SIM,1841,21,na,1862,19
STAT,1891,11,na,1902,31.744080739405636
SIM,1886,19,na,1905,30
STAT,1873,42,35-39,1915,0.018387743878609752
STAT,1841,52,40-44,1893,1.0249762855657638E-4
STAT,1911,25,40-44,1936,0.04546861548378075
STAT,1910,20,na,1930,35.83092196809699
SIM,1940,25,na,1965,35
STAT,1790,69,na,1859,4.149571137345799
STAT,1892,43,15-19,1935,1.693752587117907E-4
STAT,1875,45,50-100,1920,0.0025497953955311054
STAT,1888,41,35-39,1929,0.02125688332793394
STAT,1852,49,na,1901,18.853187670933046
STAT,1941,30,35-39,1971,0.09535760091288142
STAT,1915,40,35-39,1955,0.0020153765166299404
STAT,1945,25,na,1970,40.83942878497933
STAT,1868,41,15-19,1909,1.342486846710398E-4
SIM,1913,48,na,1961,40
STAT,1858,15,50-100,1873,4.4065686497451437E-4
STAT,1841,40,40-44,1881,0.023471413383234847
SIM,1784,72,na,1856,3
STAT,1872,37,45-49,1909,0.02039676199745716
SIM,1865,5,na,1870,25
STAT,1851,41,45-49,1892,0.012692269850762663
SIM,1876,71,na,1947,22
STAT,1935,18,na,1953,49.96388857248465
STAT,1930,40,na,1970,48.77227795567645
SIM,1819,65,na,1884,4
STAT,1845,61,na,1906,10.923087473455375
STAT,1822,40,30-34,1862,0.006771890954839878
STAT,1822,46,45-49,1868,0.001313291225114755
STAT,1881,53,50-100,1934,1.4140181595589742E-4
STAT,1870,37,35-39,1907,0.07026159433159157
STAT,1852,19,20-24,1871,0.18135546913413794
STAT,1894,70,na,1964,20.37672923479149
STAT,1847,104,na,1951,7.125145203774238E-4
STAT,1909,42,25-29,1951,6.641696613845711E-4
STAT,1858,46,25-29,1904,4.395485619678075E-4
STAT,1850,42,40-44,1892,0.020002106400587263
STAT,1830,103,na,1933,5.156381332882035E-4
STAT,1930,38,20-24,1968,0.0034188940092808404
STAT,1897,31,40-44,1928,0.05782500858058361
STAT,1852,22,20-24,1874,0.7006385831301657
STAT,1853,17,50-100,1870,3.7038937897780546E-4
STAT,1917,19,50-100,1936,0.003960620413260285
STAT,1919,32,40-44,1951,0.04185421231968268
STAT,1925,38,50-100,1963,0.005002591191526453
STAT,1841,16,40-44,1857,0.0023226745514840223
SIM,1798,72,na,1870,4
STAT,1867,4,na,1871,28.654671911846016
STAT,1906,23,na,1929,34.25362870633769
STAT,1887,41,25-29,1928,0.0070409086627680854
SIM,1904,63,na,1967,24
STAT,1831,42,30-34,1873,0.0113875912314972
STAT,1902,47,35-39,1949,0.001108455911275118
STAT,1821,47,40-44,1868,0.002419279117315385
STAT,1925,43,20-24,1968,2.1213881117961234E-4
STAT,1899,29,50-100,1928,0.008694376553921645
STAT,1899,17,na,1916,34.57387160022532
STAT,1906,30,40-44,1936,0.036467985544352474
STAT,1877,40,20-24,1917,0.0016559068670663716
STAT,1832,41,35-39,1873,0.010088131402258185
STAT,1934,33,na,1967,51.387197621017
STAT,1852,46,50-100,1898,0.002107931066533026
STAT,1932,40,35-39,1972,0.0027256655387606216
SIM,1927,26,na,1953,47
SIM,1952,18,na,1970,35
STAT,1912,32,30-34,1944,0.15381679401993792
STAT,1830,30,20-24,1860,0.0190890124798817
STAT,1880,59,na,1939,20.436557400633205
STAT,1931,0,na,1931,58.70663170760868
SIM,1810,51,na,1861,17
STAT,1873,54,45-49,1927,1.4348920751451217E-4
STAT,1851,42,15-19,1893,1.1644331285360486E-4
STAT,1815,41,35-39,1856,0.028683485845938234
STAT,1826,29,20-24,1855,0.3067874026225046
STAT,1921,15,na,1936,41.82196863249981
STAT,1812,45,40-44,1857,0.0019747178348955715
STAT,1935,32,25-29,1967,0.12730424773507837
STAT,1901,32,20-24,1933,0.03782306281555122
STAT,1868,53,50-100,1921,1.4380945518779886E-4
STAT,1870,60,na,1930,18.945705122497515
SIM,1861,12,na,1873,33
SIM,1816,54,na,1870,11
STAT,1899,47,25-29,1946,4.427093152428003E-4
SIM,1860,22,20-24,1882,3
STAT,1882,17,40-44,1899,0.0017528400830410257
STAT,1813,53,35-39,1866,2.512261111836549E-4
STAT,1865,67,na,1932,14.338094642800073
STAT,1833,57,na,1890,14.87816711694381
SIM,1869,15,na,1884,17
SIM,1799,57,na,1856,17
STAT,1917,5,na,1922,42.734209384347075
SIM,1848,64,na,1912,20
STAT,1833,49,25-29,1882,4.4307323112267627E-4
STAT,1882,32,35-39,1914,0.09705210722200865
STAT,1878,88,na,1966,3.3117013789102665
STAT,1894,40,20-24,1934,0.002055872198234959
STAT,1933,25,50-100,1958,0.013173830997094339
STAT,1837,33,35-39,1870,0.06130620702183636
SIM,1944,17,25-29,1961,3
STAT,1890,4,na,1894,31.955040232665556
STAT,1913,40,25-29,1953,6.983761262453539E-4
SIM,1948,10,na,1958,39
STAT,1838,34,na,1872,20.472291837870003
STAT,1822,41,50-100,1863,0.006126449491821858
STAT,1925,46,25-29,1971,6.403479747516859E-4
SIM,1918,27,25-29,1945,1
STAT,1932,8,na,1940,52.59873128538276
STAT,1875,42,45-49,1917,0.015365654522741431
STAT,1888,22,50-100,1910,0.004765430695764158
STAT,1882,37,na,1919,22.578360660626057
STAT,1902,38,45-49,1940,0.00603760724632918
STAT,1834,48,50-100,1882,0.0018172338425844865
STAT,1791,87,na,1878,0.5430809150166284
STAT,1868,6,na,1874,27.011051484962426
STAT,1908,34,30-34,1942,0.1466774443792717
STAT,1808,51,45-49,1859,1.0283822489021355E-4
SIM,1878,52,na,1930,28
STAT,1841,39,30-34,1880,0.06019936751922302
STAT,1828,27,na,1855,19.301149730355323
STAT,1922,40,35-39,1962,0.0023007236146707533
SIM,1885,85,na,1970,9
STAT,1883,9,na,1892,25.19600103245684
STAT,1917,46,40-44,1963,0.0016358864651169068
STAT,1897,34,45-49,1931,0.022958918374088363
STAT,1923,33,45-49,1956,0.017903436442587347
SIM,1949,18,20-24,1967,3
STAT,1915,24,20-24,1939,1.132347447154226
STAT,1856,27,40-44,1883,0.02248706344573663
STAT,1936,17,25-29,1953,0.4123803778326261
SIM,1913,45,na,1958,40
SIM,1904,34,na,1938,29
STAT,1846,40,25-29,1886,0.005403932245471054
STAT,1878,34,35-39,1912,0.1036584608276479
STAT,1846,44,40-44,1890,0.0179827096150559
STAT,1913,38,20-24,1951,0.0025669034700196115
STAT,1876,19,15-19,1895,0.059950775611074036
SIM,1911,21,25-29,1932,2
SIM,1912,5,na,1917,40
STAT,1832,72,na,1904,5.708396385411762
STAT,1912,45,45-49,1957,0.0020821387378573046
SIM,1956,0,na,1956,47
STAT,1864,23,50-100,1887,0.0036896985481973065
STAT,1858,50,50-100,1908,1.1657506973604554E-4
STAT,1894,31,15-19,1925,0.0018325436493587144
SIM,1850,57,na,1907,19
STAT,1857,19,na,1876,19.95974495610003
STAT,1882,41,40-44,1923,0.021653329978771677
STAT,1820,39,na,1859,15.954468970767238
STAT,1915,35,50-100,1950,0.004244694881898054
SIM,1903,38,na,1941,37
STAT,1827,40,15-19,1867,1.1110384676439518E-4
STAT,1917,2,na,1919,43.46836438688989
STAT,1921,44,40-44,1965,0.0027859351594517047
SIM,1852,83,na,1935,13
SIM,1844,15,20-24,1859,2
STAT,1863,41,30-34,1904,0.01022519326138281
STAT,1893,23,20-24,1916,0.8662171259051359
STAT,1842,35,50-100,1877,0.011032534111932418
SIM,1887,37,na,1924,25
SIM,1814,76,na,1890,15
STAT,1850,25,15-19,1875,0.004822818452225691
STAT,1871,31,20-24,1902,0.027059638042084395
STAT,1826,32,20-24,1858,0.03828778995382563
STAT,1903,21,25-29,1924,0.8163370279759474
STAT,1873,34,50-100,1907,0.009235646196427472
STAT,1890,66,na,1956,20.172478253444396
SIM,1852,16,na,1868,29
STAT,1856,30,40-44,1886,0.032468601242471126
STAT,1888,47,50-100,1935,0.0028566963179662715
STAT,1817,45,25-29,1862,0.0017151552756143576
SIM,1825,50,na,1875,17
STAT,1824,52,40-44,1876,1.3154121696659594E-4
SIM,1897,44,na,1941,38
SIM,1915,6,na,1921,40
STAT,1878,19,40-44,1897,0.0018781965879697729
STAT,1893,77,na,1970,15.331251629746449
STAT,1791,65,na,1856,7.42511648
STAT,1863,20,30-34,1883,0.16318746964346348
STAT,1818,68,na,1886,4.110104623869191
STAT,1874,41,na,1915,23.55342240520985
STAT,1833,101,na,1934,0.0042245731503864755
STAT,1867,33,20-24,1900,0.025758046556622272
STAT,1947,15,35-39,1962,0.04696996515975209
SIM,1885,19,25-29,1904,2
SIM,1829,72,na,1901,16
STAT,1815,50,40-44,1865,1.5197439834017113E-4
STAT,1945,25,45-49,1970,0.01883391354480801
STAT,1832,94,na,1926,0.09033883451682659
STAT,1835,83,na,1918,1.7856191286664924
SIM,1903,16,na,1919,38
STAT,1838,21,50-100,1859,0.004136026523216959
SIM,1861,75,na,1936,10
STAT,1845,29,30-34,1874,0.17660564056279987
STAT,1851,46,30-34,1897,8.195357499545732E-4
STAT,1885,33,na,1918,23.465729972283135
STAT,1793,103,na,1896,1.4374150572516505E-4
STAT,1910,35,25-29,1945,0.009448116355282503
SIM,1863,6,na,1869,24
SIM,1872,38,na,1910,22
SIM,1898,29,na,1927,32
SIM,1852,61,na,1913,19
STAT,1821,43,25-29,1864,0.009680607673797798
STAT,1899,24,35-39,1923,0.07938376217665755
STAT,1895,39,50-100,1934,0.01577881335066987
STAT,1924,36,30-34,1960,0.021371056507677677
STAT,1902,44,30-34,1946,0.0011106304820739533
SIM,1863,53,na,1916,9
STAT,1882,23,45-49,1905,0.0066620882597069825
STAT,1842,31,na,1873,19.848044497587054
STAT,1916,43,20-24,1959,1.7914874714771703E-4
STAT,1889,58,na,1947,24.21235288086142
STAT,1897,40,30-34,1937,0.0010708750226230144
STAT,1839,23,25-29,1862,0.4029968620912766
STAT,1935,36,40-44,1971,0.02085883240284479
SIM,1928,22,na,1950,52
SIM,1927,29,na,1956,49
STAT,1807,76,na,1883,4.617957687833487
SIM,1947,9,na,1956,42
STAT,1816,87,na,1903,0.5289261320498532
STAT,1913,44,40-44,1957,0.002410727968416524
STAT,1849,52,45-49,1901,1.1192895154031237E-4
SIM,1877,59,na,1936,23
SIM,1918,15,na,1933,38
STAT,1803,69,na,1872,7.776657733885119
STAT,1858,23,35-39,1881,0.046029992147181065
STAT,1924,34,15-19,1958,0.0014875620735255249
STAT,1889,40,na,1929,28.582770457965903
STAT,1880,26,50-100,1906,0.006749789388710749
STAT,1912,33,35-39,1945,0.08884103006836404
SIM,1887,66,na,1953,14
STAT,1891,26,15-19,1917,0.005587690623740514
STAT,1771,103,na,1874,8.273797027952394E-4
SIM,1930,15,na,1945,49
STAT,1880,44,35-39,1924,0.018784641572476037
STAT,1857,30,na,1887,18.35159093154648
STAT,1876,22,na,1898,24.020515677917167
STAT,1887,45,40-44,1932,0.001887290999023104
STAT,1934,24,30-34,1958,0.3843505012544314
STAT,1890,37,na,1927,28.618122919974546
STAT,1844,97,na,1941,0.04196231880786799
STAT,1843,35,25-29,1878,0.014557226312722674
STAT,1909,46,40-44,1955,0.0014442040081862294
SIM,1888,24,25-29,1912,1
STAT,1861,23,na,1884,20.286043696738744
SIM,1871,20,30-34,1891,1
STAT,1863,89,na,1952,0.9301413738963761
STAT,1804,51,50-100,1855,4.231460848670155E-4
STAT,1805,95,na,1900,0.03640343872888086
STAT,1939,10,na,1949,39.42266961444514
SIM,1886,81,na,1967,3
STAT,1824,35,15-19,1859,8.538995174264569E-4
SIM,1785,76,na,1861,5
STAT,1841,19,45-49,1860,8.149548564396008E-4
STAT,1844,47,35-39,1891,0.0010884349708469997
SIM,1805,62,na,1867,11
STAT,1853,30,15-19,1883,9.410111490030112E-4
SIM,1876,74,na,1950,18
STAT,1819,39,30-34,1858,0.05242750461189935
STAT,1881,52,na,1933,20.379255978697795
STAT,1932,29,na,1961,48.81978169237572
STAT,1841,22,45-49,1863,0.008646533116031044
STAT,1902,46,50-100,1948,0.001959203204127891
STAT,1953,19,50-100,1972,0.004502957400220502
SIM,1825,39,na,1864,18
STAT,1919,35,45-49,1954,0.007300754283838137
STAT,1956,11,na,1967,51.69365536783374
SIM,1821,55,na,1876,10
STAT,1916,25,20-24,1941,0.18839553432162698
SIM,1898,52,na,1950,25
STAT,1941,17,25-29,1958,0.44312283783929063
STAT,1829,74,na,1903,7.538261222910167
STAT,1916,27,15-19,1943,0.007236917572856478
STAT,1825,84,na,1909,1.7933985166515136
SIM,1936,31,na,1967,36
SIM,1928,36,na,1964,54
STAT,1848,17,45-49,1865,5.23677537256082E-4
SIM,1857,78,na,1935,8
SIM,1910,26,na,1936,30
STAT,1911,47,na,1958,34.555663562765034
STAT,1861,38,40-44,1899,0.036630259828404205
STAT,1920,27,35-39,1947,0.1632935060596575
STAT,1841,23,na,1864,26.32164826350984
STAT,1856,76,na,1932,6.863308017632803
STAT,1931,15,45-49,1946,0.006539780416198581
STAT,1865,16,35-39,1881,0.005144587569622554
STAT,1922,24,35-39,1946,0.10651717950193741
SIM,1933,18,25-29,1951,1
STAT,1830,42,50-100,1872,0.005764689459015906
STAT,1850,21,50-100,1871,0.004389419944330086
STAT,1876,16,50-100,1892,4.988060091362813E-4
STAT,1920,2,na,1922,45.4951917789282
STAT,1860,81,na,1941,4.396267846276664
STAT,1872,15,na,1887,26.234381835287216
SIM,1893,29,na,1922,36
SIM,1907,28,25-29,1935,1
STAT,1883,78,na,1961,9.515776951846773
STAT,1926,8,na,1934,48.62037339405064
SIM,1950,15,20-24,1965,3
STAT,1900,33,15-19,1933,0.001966408154036267
STAT,1911,21,25-29,1932,0.873009600120189
STAT,1877,15,15-19,1892,0.06154467972152081
SIM,1837,30,na,1867,24
STAT,1807,54,50-100,1861,2.974082205305583E-4
STAT,1816,48,na,1864,8.827129037720729
STAT,1904,28,35-39,1932,0.13777192656211132
SIM,1861,83,na,1944,2
STAT,1908,47,50-100,1955,0.0020348824486099712
STAT,1847,30,25-29,1877,0.13116332929622
STAT,1911,36,25-29,1947,0.009494206532243098
SIM,1868,16,25-29,1884,1
STAT,1903,4,na,1907,37.40136046863439
STAT,1931,33,45-49,1964,0.020514941366909414
STAT,1925,18,25-29,1943,0.5188483725754133
SIM,1895,25,50-100,1920,1
STAT,1870,53,50-100,1923,1.4762011287264645E-4
STAT,1859,17,20-24,1876,0.16356624423569507
STAT,1813,50,50-100,1863,4.678899542156187E-4
STAT,1921,25,30-34,1946,0.4362248774797532
STAT,1835,31,45-49,1866,0.010212630001566986
SIM,1831,36,50-100,1867,1
SIM,1950,17,15-19,1967,1
STAT,1902,29,40-44,1931,0.04194112325613226
SIM,1826,78,na,1904,5
SIM,1826,86,na,1912,4
STAT,1928,42,30-34,1970,0.0016218304823329293
STAT,1896,25,25-29,1921,0.5594140643807692
SIM,1888,22,na,1910,37
STAT,1848,18,50-100,1866,3.904448074212329E-4
STAT,1904,26,40-44,1930,0.043070457046831295
STAT,1923,16,50-100,1939,0.004379611882443162
STAT,1850,51,na,1901,19.262775592231428
STAT,1926,45,30-34,1971,0.0010988122508372687
STAT,1929,41,35-39,1970,0.002599040972141198
SIM,1851,53,na,1904,15
STAT,1798,97,na,1895,0.027300912593941847
STAT,1839,24,40-44,1863,0.014564241030326275
STAT,1889,18,45-49,1907,7.976687538086179E-4
STAT,1909,48,35-39,1957,0.0011748039938497686
STAT,1862,17,na,1879,22.681837123507005
SIM,1800,61,na,1861,11
STAT,1873,20,25-29,1893,0.585484524572958
SIM,1852,47,na,1899,18
STAT,1870,46,40-44,1916,0.0017055098018749603
STAT,1811,43,25-29,1854,0.027377168076142218
STAT,1903,28,45-49,1931,0.01572998273711306
STAT,1867,48,na,1915,21.25956262178891
STAT,1856,37,50-100,1893,0.00889417801097427
STAT,1892,49,25-29,1941,3.930178273585385E-4
STAT,1907,32,15-19,1939,0.0011960991321215194
STAT,1912,32,25-29,1944,0.0902353986698972
SIM,1867,60,na,1927,9
STAT,1936,19,40-44,1955,0.01323888038521766
STAT,1871,0,na,1871,37.1048498009318
SIM,1842,37,na,1879,25
STAT,1915,27,25-29,1942,0.6655545579451944
SIM,1851,73,na,1924,13
SIM,1834,73,na,1907,9
STAT,1888,19,40-44,1907,0.0021259390945686835
STAT,1900,15,15-19,1915,0.08267569356783645
STAT,1826,58,na,1884,14.671631250577994
STAT,1855,35,na,1890,16.74525976836753
STAT,1898,20,30-34,1918,0.24172154767447598
STAT,1911,5,na,1916,39.845083537065335
STAT,1854,2,na,1856,21.897710838069433
STAT,1835,48,40-44,1883,8.067353623395914E-4
STAT,1914,28,20-24,1942,0.18185033769005313
STAT,1927,44,35-39,1971,0.0025041780656584385
STAT,1922,22,40-44,1944,0.03827615003799269
STAT,1942,17,15-19,1959,0.4708186695324448
STAT,1905,25,45-49,1930,0.0161330682991753
STAT,1925,44,50-100,1969,0.0014087146663542978
STAT,1940,5,na,1945,40.36860373209655
STAT,1864,71,na,1935,11.972132150896078
STAT,1835,94,na,1929,0.08989594907792833
STAT,1918,39,45-49,1957,0.00710527773369007
STAT,1912,21,50-100,1933,0.006275517374925996
STAT,1940,20,35-39,1960,0.09530422284442519
STAT,1937,35,35-39,1972,0.02407536538002063
STAT,1930,26,na,1956,47.432487853773004
STAT,1906,24,50-100,1930,0.005887355559482738
SIM,1904,31,30-34,1935,1
SIM,1814,73,na,1887,15
SIM,1854,42,na,1896,17
SIM,1942,21,20-24,1963,2
STAT,1796,62,na,1858,1.784189688947382
STAT,1874,81,na,1955,5.486009443415671
STAT,1874,21,25-29,1895,0.5825051519813227
STAT,1913,19,45-49,1932,0.0010073790204238066
SIM,1923,27,25-29,1950,1
STAT,1874,10,na,1884,26.854060404660547
SIM,1858,42,45-49,1900,2
STAT,1930,19,45-49,1949,0.006393601776902308
SIM,1916,11,na,1927,47
STAT,1937,33,40-44,1970,0.03844841200144584
SIM,1925,23,15-19,1948,2
STAT,1864,18,40-44,1882,0.0016870645461558502
STAT,1816,56,na,1872,7.650156396774957
STAT,1810,47,25-29,1857,5.617369242255019E-4
STAT,1782,82,na,1864,1.2273490593244463
STAT,1905,43,45-49,1948,0.0014891219822000777
SIM,1865,65,na,1930,13
SIM,1943,13,na,1956,48
STAT,1837,23,50-100,1860,0.0026826845752966496
STAT,1908,33,15-19,1941,0.0012015924225769988
STAT,1934,21,20-24,1955,1.4884852673392268
STAT,1829,34,25-29,1863,0.09517547847248256
STAT,1920,45,35-39,1965,0.0014197259492551458
SIM,1842,17,na,1859,30
SIM,1881,3,na,1884,27
STAT,1885,39,40-44,1924,0.04279341300715651
SIM,1879,14,na,1893,16
STAT,1917,21,20-24,1938,1.1745868324675923
STAT,1805,64,na,1869,6.976719078003367
STAT,1871,53,na,1924,21.122412417671267
SIM,1843,78,na,1921,10
STAT,1864,51,na,1915,19.404655532657852
STAT,1942,15,20-24,1957,1.4072420165465302
STAT,1821,53,35-39,1874,1.1454579719777513E-4
STAT,1807,51,na,1858,14.149433483174503
STAT,1873,88,na,1961,2.4292626576560363
STAT,1841,15,na,1856,29.322387748132602
SIM,1906,27,25-29,1933,1
STAT,1847,18,40-44,1865,0.0024242192037180984
STAT,1890,12,na,1902,31.369813146761775
STAT,1889,15,40-44,1904,0.002249744425722315
STAT,1869,21,15-19,1890,0.03206211660534904
STAT,1887,68,na,1955,16.68039449445319
SIM,1892,1,na,1893,36
STAT,1847,48,na,1895,23.73164829247483
SIM,1905,59,na,1964,39
STAT,1842,96,na,1938,0.06442388389441575
STAT,1859,24,50-100,1883,0.0033147243923686777
STAT,1914,30,35-39,1944,0.09195779095951259
STAT,1891,73,na,1964,17.25797275681962
STAT,1891,53,na,1944,26.003596320177557
STAT,1824,43,na,1867,18.904930670967254
SIM,1811,45,na,1856,11
SIM,1848,22,na,1870,33
STAT,1876,49,40-44,1925,0.0017024810089944753
STAT,1875,35,na,1910,24.448084830633587
STAT,1889,17,35-39,1906,0.006718019985783226
STAT,1902,30,na,1932,33.92193490530327
SIM,1874,30,na,1904,25
SIM,1812,86,na,1898,1
STAT,1876,32,45-49,1908,0.017711056001591702
STAT,1928,43,40-44,1971,0.003168027318166395
STAT,1891,39,50-100,1930,0.014917208729340737
STAT,1917,23,15-19,1940,0.05588810630032937
STAT,1913,31,30-34,1944,0.15607630700350067
STAT,1908,31,20-24,1939,0.0229978405426484
SIM,1882,37,na,1919,31
STAT,1820,61,na,1881,11.126186709301784
STAT,1839,26,35-39,1865,0.06756590698411645
SIM,1927,6,na,1933,52
STAT,1831,33,na,1864,22.542413010837024
STAT,1897,1,na,1898,36.145172836120636
STAT,1903,45,35-39,1948,0.001133959778210663
STAT,1933,22,15-19,1955,0.07032174614317689
STAT,1904,57,na,1961,30.022329825470884
SIM,1939,18,20-24,1957,3
STAT,1834,49,35-39,1883,0.0010226957026475796
STAT,1858,20,30-34,1878,0.15777237318721685
STAT,1922,21,30-34,1943,0.32817021386512757
SIM,1803,58,na,1861,9
STAT,1908,19,35-39,1927,0.008053859934225681
STAT,1934,23,15-19,1957,0.07121071895327248
STAT,1915,29,na,1944,37.60921120921405
SIM,1868,22,na,1890,33
STAT,1909,49,45-49,1958,0.0019742644864196245
STAT,1934,22,50-100,1956,0.008805220574615736
STAT,1938,32,45-49,1970,0.015718051866590154
STAT,1778,77,na,1855,3.63828
STAT,1859,49,40-44,1908,0.0013323155798180683
STAT,1852,43,50-100,1895,0.00897630989998927
STAT,1923,20,35-39,1943,0.10944851632668877
STAT,1836,56,na,1892,19.68461155353219
STAT,1912,35,30-34,1947,0.017817041745014413
STAT,1933,25,20-24,1958,0.2415976169737353
STAT,1927,43,25-29,1970,8.895970649261071E-4
SIM,1862,37,na,1899,23
STAT,1907,22,na,1929,34.59478530099554
STAT,1818,82,na,1900,1.1660027812919447
STAT,1878,63,na,1941,18.421470245329935
SIM,1900,5,na,1905,40
STAT,1908,47,na,1955,33.05219151881691
SIM,1905,28,20-24,1933,2
STAT,1937,6,na,1943,38.74580781980765
STAT,1841,37,50-100,1878,0.014158775484297661
STAT,1941,16,15-19,1957,0.46419579429145386
STAT,1823,38,na,1861,16.574658689480895
SIM,1902,18,25-29,1920,2
STAT,1920,26,25-29,1946,0.7183442439661748
STAT,1838,33,50-100,1871,0.00874537443653711
STAT,1856,43,50-100,1899,0.007598004124549659
SIM,1849,63,na,1912,3
STAT,1887,35,25-29,1922,0.03172512282255615
STAT,1902,25,50-100,1927,0.00908205711217666
STAT,1837,41,20-24,1878,9.242625093966509E-4
SIM,1920,16,na,1936,49
STAT,1936,11,na,1947,37.7614935285095
STAT,1913,31,50-100,1944,0.008190523303364233
STAT,1904,29,45-49,1933,0.01579572233438543
STAT,1849,74,na,1923,8.60520404427759
STAT,1914,15,45-49,1929,0.0010295339275728018
STAT,1903,42,25-29,1945,6.332086922248636E-4
STAT,1885,22,45-49,1907,0.006886153793810075
STAT,1919,37,40-44,1956,0.015942837445704974
SIM,1923,9,na,1932,42
STAT,1919,19,40-44,1938,0.015240754529784238
STAT,1879,29,40-44,1908,0.030782791764806708
STAT,1778,97,na,1875,0.010632952297066083
SIM,1856,31,25-29,1887,2
STAT,1893,45,25-29,1938,4.1375841702563236E-4
SIM,1790,66,na,1856,4
STAT,1855,15,na,1870,19.450969311528333
STAT,1882,17,na,1899,24.203989260719997
STAT,1876,76,na,1952,9.622264963603174
STAT,1931,28,20-24,1959,0.2345097286668749
STAT,1826,41,45-49,1867,0.016132587658453483
STAT,1830,31,na,1861,10.100347373657451
STAT,1915,44,45-49,1959,0.0016555738688745986
STAT,1910,38,30-34,1948,0.01723860366299709
SIM,1886,27,na,1913,30
STAT,1893,32,45-49,1925,0.02198745920510136
SIM,1926,41,na,1967,46
STAT,1819,76,na,1895,4.863303005186411
STAT,1888,30,15-19,1918,0.0016775501362853002
STAT,1921,28,35-39,1949,0.16543719742295385
STAT,1876,17,20-24,1893,0.18005907593644174
STAT,1908,18,25-29,1926,0.08340464382510696
STAT,1905,38,20-24,1943,0.0023893684802200653
STAT,1910,23,30-34,1933,0.26742986568991045
STAT,1922,25,45-49,1947,0.01953745741071862
STAT,1868,33,na,1901,22.99595891076325
STAT,1936,34,35-39,1970,0.08811170170596395
STAT,1822,100,na,1922,0.003765820683821734
STAT,1911,33,20-24,1944,0.023499018275838984
SIM,1793,66,na,1859,16
STAT,1909,2,na,1911,39.75163620785184
STAT,1852,31,45-49,1883,0.015613798216333985
STAT,1868,10,na,1878,26.170728907167945
STAT,1931,30,40-44,1961,0.051108054553668056
STAT,1839,76,na,1915,5.228305544635096
STAT,1925,15,20-24,1940,1.6350584620249622
STAT,1848,31,25-29,1879,0.07805261812201628
SIM,1892,67,na,1959,21
STAT,1902,31,25-29,1933,0.14503011128923954
STAT,1913,47,45-49,1960,0.0021035815389809204
STAT,1795,69,na,1864,8.410850171438867
STAT,1858,21,40-44,1879,0.018324821857678173
STAT,1905,22,40-44,1927,0.03007439090316137
STAT,1884,71,na,1955,13.077735034511951
STAT,1815,94,na,1909,0.0713440492492251
STAT,1860,61,na,1921,15.191497226740063
STAT,1790,77,na,1867,2.0590303608623324
STAT,1895,43,na,1938,29.89191389269591
SIM,1884,60,na,1944,18
STAT,1875,47,30-34,1922,9.90409053620153E-4
STAT,1921,40,25-29,1961,8.002409468673253E-4
STAT,1852,44,25-29,1896,0.005421705294159907
STAT,1867,43,50-100,1910,0.010036796786692585
STAT,1923,21,45-49,1944,0.01304043380490939
STAT,1899,21,30-34,1920,0.24457450274918596
STAT,1838,28,40-44,1866,0.029362702574682445
STAT,1846,34,25-29,1880,0.09607967848167667
SIM,1895,32,na,1927,23
STAT,1916,28,25-29,1944,0.6723663302999053
SIM,1924,28,25-29,1952,1
SIM,1868,2,na,1870,39
STAT,1901,16,15-19,1917,0.08324427723239813
STAT,1842,17,na,1859,22.11559419696766
SIM,1908,16,na,1924,40
STAT,1902,22,na,1924,33.3515996850923
STAT,1880,47,40-44,1927,0.0017918659970652744
SIM,1903,24,na,1927,32
STAT,1818,54,50-100,1872,1.3725480883097977E-4
STAT,1863,31,20-24,1894,0.024030622215323455
STAT,1856,24,40-44,1880,0.01728150587832559
STAT,1928,25,50-100,1953,0.012285444074084387
STAT,1945,27,40-44,1972,0.05076912532438638
STAT,1903,25,40-44,1928,0.04287786310317765
STAT,1951,21,20-24,1972,1.3208771944838313
SIM,1943,21,na,1964,38
STAT,1917,52,na,1969,37.38440602558805
STAT,1887,22,50-100,1909,0.004451063874138398
STAT,1930,16,40-44,1946,0.018042817098049578
STAT,1918,43,50-100,1961,0.0012358065232351827
STAT,1938,22,50-100,1960,0.0064692645857266865
STAT,1844,21,45-49,1865,0.006849796800073765
STAT,1908,27,na,1935,35.217850303723935
STAT,1924,47,20-24,1971,1.307096779977621E-4
SIM,1848,21,25-29,1869,3
SIM,1904,2,na,1906,36
SIM,1925,24,25-29,1949,1
STAT,1897,24,30-34,1921,0.23505839877377463
STAT,1895,0,na,1895,38.12114222138487
STAT,1917,30,50-100,1947,0.008648098203434823
STAT,1919,19,na,1938,40.10648099026141
SIM,1910,31,25-29,1941,2
STAT,1834,46,30-34,1880,8.075032677235718E-4
STAT,1857,20,40-44,1877,0.018270214008996605
STAT,1823,58,na,1881,12.31343114087495
STAT,1913,32,40-44,1945,0.03860909460693473
SIM,1950,15,na,1965,51
STAT,1851,48,25-29,1899,4.801669135287269E-4
STAT,1884,40,50-100,1924,0.010455049329670816
STAT,1812,66,na,1878,7.694235806182857
STAT,1937,32,30-34,1969,0.15489019660062248
STAT,1918,36,40-44,1954,0.01571104088235362
STAT,1799,59,na,1858,11.086047554563125
SIM,1836,45,na,1881,6
STAT,1900,33,45-49,1933,0.024079223296236546
STAT,1924,7,na,1931,47.29190352145494
STAT,1921,23,35-39,1944,0.10519579272197038
STAT,1829,31,20-24,1860,0.026253597703894974
STAT,1968,2,na,1970,48.82778589000343
STAT,1874,22,35-39,1896,0.05920044392082621
STAT,1843,20,50-100,1863,0.0022027976563401513
STAT,1926,17,30-34,1943,0.1485865031259678
STAT,1909,47,25-29,1956,4.8469537716924174E-4
SIM,1881,75,na,1956,6
SIM,1827,40,na,1867,18
STAT,1923,18,20-24,1941,1.5768109270363297
STAT,1896,22,20-24,1918,0.9051904139443757
SIM,1891,42,na,1933,34
SIM,1901,20,20-24,1921,3
STAT,1831,25,na,1856,23.567884579796953
STAT,1843,58,na,1901,8.388841533890938
STAT,1924,19,20-24,1943,1.5953758926305168
STAT,1901,37,na,1938,33.22658754255538
SIM,1921,8,na,1929,42
SIM,1884,40,na,1924,22
STAT,1872,24,25-29,1896,0.5820533320846306
SIM,1875,55,na,1930,13
SIM,1796,82,na,1878,2
STAT,1866,86,na,1952,2.0434387231361337
SIM,1839,17,na,1856,24
STAT,1917,24,25-29,1941,0.9667025371730861
STAT,1917,42,25-29,1959,7.384444049167599E-4
SIM,1931,18,20-24,1949,5
STAT,1932,29,20-24,1961,0.23788492831014965
SIM,1786,84,na,1870,7
SIM,1820,61,na,1881,8
SIM,1932,19,20-24,1951,1
STAT,1881,12,na,1893,24.573696077003316
STAT,1905,40,40-44,1945,0.002277007455480003
STAT,1917,32,na,1949,39.24408472327972
STAT,1909,29,25-29,1938,0.6210394135760613
SIM,1882,14,na,1896,33
SIM,1964,7,na,1971,52
STAT,1843,89,na,1932,0.44563029399636567
SIM,1819,73,na,1892,1
SIM,1940,29,20-24,1969,2
STAT,1854,15,50-100,1869,3.6247765754074407E-4
STAT,1938,19,15-19,1957,0.44443094353862495
STAT,1878,42,20-24,1920,0.0016375949841611458
STAT,1903,42,30-34,1945,0.0011336478153126512
STAT,1850,91,na,1941,0.5159470219576733
STAT,1907,35,20-24,1942,0.002456853609007565
STAT,1896,48,50-100,1944,0.0017968923874345166
STAT,1925,19,na,1944,43.948206785032234
STAT,1806,66,na,1872,10.867993798018311
STAT,1905,5,na,1910,37.82213883024215
STAT,1904,25,30-34,1929,0.36327707867933157
STAT,1949,17,50-100,1966,0.004329514195120568
SIM,1892,27,na,1919,36
STAT,1819,84,na,1903,1.7076584987388694
SIM,1844,32,na,1876,9
STAT,1942,18,25-29,1960,0.4494270735732574
SIM,1915,18,na,1933,40
STAT,1864,20,na,1884,21.86665722224034
STAT,1883,15,40-44,1898,0.0017843898903778144
STAT,1868,25,15-19,1893,0.00442047286750331
SIM,1946,19,15-19,1965,1
SIM,1888,21,25-29,1909,2
SIM,1915,49,na,1964,31
STAT,1889,32,25-29,1921,0.12540345178999096
STAT,1898,21,40-44,1919,0.02819546760655681
SIM,1838,32,na,1870,10
STAT,1848,33,na,1881,16.207884384967745
STAT,1788,67,na,1855,8.6706
STAT,1888,31,25-29,1919,0.12018402162419094
STAT,1931,41,50-100,1972,0.0015647425409877438
STAT,1878,15,30-34,1893,0.016531842046833722
SIM,1831,53,na,1884,8
STAT,1856,23,30-34,1879,0.14878966987227948
STAT,1925,34,30-34,1959,0.1856810592236397
STAT,1958,9,na,1967,51.318933822353394
STAT,1929,38,50-100,1967,0.005359049796934261
STAT,1943,24,na,1967,38.54328337315801
STAT,1925,16,30-34,1941,0.14667816703448996
STAT,1877,78,na,1955,8.065393241482763
STAT,1899,22,40-44,1921,0.02852595990488844
STAT,1923,36,15-19,1959,2.2116665481165717E-4
STAT,1911,34,30-34,1945,0.15112411864844855
STAT,1858,44,50-100,1902,0.007930502891082457
STAT,1861,7,na,1868,23.924108824979605
STAT,1901,21,50-100,1922,0.005723311909944897
STAT,1921,41,35-39,1962,0.002253592146555451
STAT,1862,48,na,1910,19.166932692663885
STAT,1808,92,na,1900,0.06081767092690997
STAT,1915,26,15-19,1941,0.007162881229752864
STAT,1781,97,na,1878,0.01400232963713214
SIM,1940,16,na,1956,37
STAT,1867,29,15-19,1896,0.004310723046983854
STAT,1898,24,45-49,1922,0.009347985380816385
SIM,1900,24,20-24,1924,3
STAT,1820,100,na,1920,0.00601872936724542
SIM,1911,26,25-29,1937,1
STAT,1944,16,35-39,1960,0.044842043506850136
STAT,1857,25,40-44,1882,0.023433428330656737
SIM,1850,7,na,1857,23
SIM,1879,25,na,1904,16
STAT,1905,21,30-34,1926,0.25785036595262295
STAT,1905,40,35-39,1945,0.0018331395396371983
STAT,1901,33,30-34,1934,0.24327743000049729
STAT,1935,19,25-29,1954,0.5866291244787967
STAT,1955,16,45-49,1971,0.006595940577065258
SIM,1839,73,na,1912,14
STAT,1814,52,40-44,1866,2.892024028341976E-4
STAT,1928,27,40-44,1955,0.05714283954524773
STAT,1811,56,na,1867,14.612257759125008
STAT,1949,18,na,1967,42.521163015200514
STAT,1888,53,na,1941,24.758552894451952
STAT,1907,34,50-100,1941,0.007629769150381654
STAT,1918,40,50-100,1958,0.0012411979286114
STAT,1912,38,35-39,1950,0.023306501296158365
STAT,1942,19,35-39,1961,0.04350277855854559
SIM,1828,33,na,1861,19
SIM,1955,1,na,1956,47
SIM,1906,3,na,1909,29
STAT,1869,22,25-29,1891,0.5546764311900282
STAT,1822,96,na,1918,0.030458214700080612
STAT,1829,43,na,1872,17.49253131533447
STAT,1881,43,40-44,1924,0.021248227315290066
STAT,1953,19,45-49,1972,0.0060039432002940004
STAT,1903,26,25-29,1929,0.6034772273999504
STAT,1864,46,45-49,1910,0.0021227478162251525
STAT,1837,44,25-29,1881,0.0032718552068688738
STAT,1848,32,35-39,1880,0.07637498279416197
STAT,1912,15,40-44,1927,0.0028192748770869505
STAT,1893,16,50-100,1909,6.192446557764687E-4
STAT,1811,47,40-44,1858,0.006779721084358523
STAT,1857,61,na,1918,13.988756062529406
SIM,1896,17,na,1913,33
STAT,1929,26,45-49,1955,0.02152785897613237
STAT,1893,49,40-44,1942,0.001192219148598993
STAT,1928,24,na,1952,45.08758310134177
STAT,1919,34,35-39,1953,0.09690083447614392
SIM,1934,7,na,1941,54
SIM,1904,54,na,1958,25
STAT,1892,30,50-100,1922,0.011410354288285482
STAT,1889,33,35-39,1922,0.12346564646882736
STAT,1860,36,30-34,1896,0.04353655296076457
STAT,1924,34,na,1958,43.78084521934578
SIM,1897,33,35-39,1930,1
STAT,1927,29,45-49,1956,0.020811368075592838
STAT,1873,24,40-44,1897,0.021053303113201142
SIM,1889,5,na,1894,34
STAT,1802,96,na,1898,0.02622409539486616
SIM,1894,2,na,1896,32
SIM,1951,5,na,1956,52
STAT,1841,15,35-39,1856,0.0070093080755769584
STAT,1863,34,25-29,1897,0.08991134165605312
STAT,1924,35,20-24,1959,0.003093561150306725
STAT,1890,36,45-49,1926,0.02433148859430113
STAT,1961,8,na,1969,50.47637875030776
STAT,1942,30,45-49,1972,0.016658963228177046
STAT,1823,45,45-49,1868,0.0016795006240320834
STAT,1857,23,45-49,1880,0.005983157174252502
STAT,1934,36,25-29,1970,0.013542046893760328
STAT,1812,97,na,1909,0.02135013715290617
STAT,1869,24,20-24,1893,0.6635416299527516
SIM,1857,39,na,1896,22
STAT,1858,47,30-34,1905,7.33160415199968E-4
SIM,1875,35,na,1910,18
STAT,1912,36,40-44,1948,0.014566305370869595
SIM,1943,4,na,1947,49
STAT,1905,15,50-100,1920,7.103562091311954E-4
STAT,1858,106,na,1964,5.028218148954537E-4
SIM,1943,19,25-29,1962,2
STAT,1944,26,40-44,1970,0.05003396309461927
STAT,1835,44,25-29,1879,0.003396515923987489
STAT,1870,42,25-29,1912,0.006371260919921384
STAT,1908,15,20-24,1923,0.26283491645451373
SIM,1913,14,na,1927,45
STAT,1875,91,na,1966,1.698174704903448
SIM,1847,91,na,1938,1
STAT,1918,17,na,1935,41.795016678147675
STAT,1859,73,na,1932,9.440458717034478
STAT,1902,46,25-29,1948,4.594873931663418E-4
STAT,1905,50,na,1955,31.522837102880473
STAT,1868,26,25-29,1894,0.4107748635593144
SIM,1860,81,na,1941,7
STAT,1922,43,45-49,1965,0.0018932915667872724
STAT,1858,24,45-49,1882,0.005460946590006063
STAT,1935,37,25-29,1972,0.013706910620568493
STAT,1823,36,50-100,1859,0.008993136710499035
STAT,1900,30,40-44,1930,0.06061985204362656
STAT,1907,17,25-29,1924,0.08289015857120396
SIM,1843,47,na,1890,19
STAT,1866,30,30-34,1896,0.1620933159410176
STAT,1913,35,45-49,1948,0.006734698784765655
STAT,1785,70,na,1855,18.304600000000004
STAT,1847,34,40-44,1881,0.048480386967632266
STAT,1930,31,50-100,1961,0.010626332864920453
STAT,1844,27,50-100,1871,0.006116688767768218
SIM,1854,73,na,1927,6
STAT,1826,89,na,1915,0.7341317535419384
STAT,1775,100,na,1875,0.0032417751838324624
STAT,1895,12,na,1907,33.52755981376989
STAT,1945,24,35-39,1969,0.10238668781445723
STAT,1833,21,35-39,1854,0.0584966782263499
STAT,1867,17,na,1884,24.708024688819112
SIM,1928,32,30-34,1960,1
SIM,1899,45,na,1944,28
STAT,1822,33,25-29,1855,0.07794547052113006
STAT,1851,45,20-24,1896,1.0231770767965707E-4
STAT,1817,49,35-39,1866,0.003931843726837059
STAT,1887,17,na,1904,27.56718637864187
STAT,1897,25,40-44,1922,0.04004963138351642
STAT,1916,47,35-39,1963,0.0013111031278144902
STAT,1800,61,na,1861,8.55460337434774
STAT,1840,42,40-44,1882,0.01838557837309669
STAT,1925,30,15-19,1955,0.001518151454426088
STAT,1888,15,25-29,1903,0.06652895085545665
STAT,1897,27,35-39,1924,0.12813346598384331
STAT,1926,12,na,1938,48.301721327490306
STAT,1902,16,30-34,1918,0.02253173686463398
STAT,1793,74,na,1867,2.4466637818560852
STAT,1789,69,na,1858,4.307215214184969
STAT,1884,2,na,1886,30.725044083209287
SIM,1835,22,20-24,1857,4
STAT,1935,35,30-34,1970,0.025416317871400057
STAT,1954,17,40-44,1971,0.01719272342561101
STAT,1808,81,na,1889,0.8418597216354381
STAT,1911,37,35-39,1948,0.02321137320011082
STAT,1936,15,50-100,1951,0.003581812163627874
STAT,1904,41,30-34,1945,0.0011491289887792632
STAT,1916,22,15-19,1938,0.055302941360728386
STAT,1854,10,na,1864,17.673771767284336
SIM,1919,39,na,1958,43
STAT,1951,20,15-19,1971,0.06325667029889086
STAT,1901,15,30-34,1916,0.022406141661899692
STAT,1877,19,30-34,1896,0.016364660083023935
STAT,1861,34,25-29,1895,0.08539828669002086
STAT,1849,30,30-34,1879,0.16005664577647125
STAT,1941,26,50-100,1967,0.010226514807598492
SIM,1844,40,na,1884,5
STAT,1843,39,35-39,1882,0.031218287726482344
STAT,1800,72,na,1872,5.059783238305121
STAT,1844,43,na,1887,18.253894735355583
STAT,1947,22,45-49,1969,0.012629651782908504
SIM,1923,13,na,1936,42
STAT,1854,36,50-100,1890,0.007540512793092693
STAT,1898,26,40-44,1924,0.04054886002924155
SIM,1830,60,na,1890,11
STAT,1820,46,50-100,1866,0.0021040195805065018
STAT,1900,18,20-24,1918,0.24519425530033442
SIM,1870,80,na,1950,11
STAT,1921,21,15-19,1942,0.059835717715060036
STAT,1881,24,50-100,1905,0.0038560115014458886
STAT,1813,90,na,1903,0.5203126862800567
STAT,1901,48,30-34,1949,7.544462351819442E-4
SIM,1826,55,na,1881,14
STAT,1899,25,45-49,1924,0.015302429928737971
STAT,1878,45,25-29,1923,6.006011349666635E-4
STAT,1921,41,30-34,1962,0.001430783954328005
STAT,1853,88,na,1941,0.8628015751062215
STAT,1875,20,30-34,1895,0.18419244789499917
STAT,1904,20,30-34,1924,0.25675339649250867
SIM,1834,33,na,1867,22
SIM,1865,25,na,1890,24
STAT,1939,25,20-24,1964,0.1824064143738387
STAT,1915,41,40-44,1956,0.0025000409671442334
SIM,1779,82,na,1861,3
STAT,1831,23,25-29,1854,1.8714699987559498
STAT,1876,42,20-24,1918,0.0016109919702927734
STAT,1942,30,15-19,1972,0.0013604392769096347
SIM,1897,67,na,1964,36
STAT,1836,25,na,1861,27.406768678804937
STAT,1888,35,40-44,1923,0.05164124088270674
STAT,1896,8,na,1904,34.14597558815631
STAT,1930,31,30-34,1961,0.2024924084967174
STAT,1916,40,45-49,1956,0.0016956475910998284
STAT,1922,39,na,1961,42.40501384505438
STAT,1892,19,50-100,1911,6.020035860931895E-4
STAT,1840,30,na,1870,21.118501437906612
STAT,1898,63,na,1961,25.47453423721526
SIM,1871,65,na,1936,18
SIM,1905,28,na,1933,35
STAT,1931,30,35-39,1961,0.11934712407263741
STAT,1833,88,na,1921,1.0163697711012774
STAT,1895,35,na,1930,30.877081465841744
SIM,1885,65,na,1950,14
SIM,1894,39,na,1933,29
STAT,1946,25,35-39,1971,0.16620640389644642
STAT,1827,27,50-100,1854,0.018846021040356632
STAT,1916,29,35-39,1945,0.15280809860895378
SIM,1881,72,na,1953,7
STAT,1933,27,15-19,1960,0.009335427196190963
STAT,1886,21,15-19,1907,0.03432297704523634
STAT,1938,16,45-49,1954,0.004907221063350779
STAT,1920,24,30-34,1944,0.3148200977183289
SIM,1860,0,na,1860,34
STAT,1918,19,25-29,1937,0.4649024718176889
STAT,1878,18,35-39,1896,0.005650127287714507
STAT,1881,46,45-49,1927,0.002252018306889409
STAT,1893,19,15-19,1912,0.07442612303547642
STAT,1853,15,25-29,1868,0.04335088294974886
STAT,1849,43,na,1892,17.791693616646654
STAT,1929,29,15-19,1958,0.008784255406790313
STAT,1864,43,40-44,1907,0.02002853528952357
STAT,1944,27,25-29,1971,0.7062294019614049
STAT,1833,99,na,1932,0.014021116375511605
STAT,1807,48,50-100,1855,0.005147474638629577
STAT,1820,37,40-44,1857,0.04127457276080967
STAT,1899,48,30-34,1947,7.380902654032254E-4
STAT,1916,26,30-34,1942,0.4030498268824355
STAT,1924,17,25-29,1941,0.5126936818416634
SIM,1890,32,na,1922,24
STAT,1839,19,50-100,1858,3.49522272003359E-4
SIM,1918,46,na,1964,34
STAT,1877,29,40-44,1906,0.03070103398225712
STAT,1855,91,na,1946,0.4079930875448513
STAT,1897,21,25-29,1918,0.7624912877882922
SIM,1932,17,25-29,1949,2
STAT,1936,36,30-34,1972,0.017800583397059963
STAT,1847,38,50-100,1885,0.01346703956155021
STAT,1839,23,30-34,1862,0.12539466352642392
STAT,1874,40,35-39,1914,0.01855591570040156
STAT,1908,24,na,1932,34.682463783869856
SIM,1902,22,na,1924,32
STAT,1927,26,40-44,1953,0.05656899334617829
STAT,1912,18,45-49,1930,9.996013112146573E-4
STAT,1889,30,30-34,1919,0.21548312729228497
SIM,1878,4,na,1882,31
STAT,1845,37,50-100,1882,0.0075405518659096985
SIM,1831,45,na,1876,9
STAT,1856,26,35-39,1882,0.07295628736798121
STAT,1821,43,50-100,1864,0.015926160911621683
STAT,1826,28,15-19,1854,0.015479380630705416
STAT,1901,36,35-39,1937,0.02146444636608795
SIM,1924,26,30-34,1950,1
STAT,1942,16,30-34,1958,0.12648533936839249
SIM,1888,50,na,1938,32
STAT,1798,66,na,1864,14.0342414489893
STAT,1874,25,40-44,1899,0.030595912359235485
SIM,1841,52,na,1893,14
STAT,1901,18,35-39,1919,0.007657800749465967
SIM,1859,73,na,1932,7
STAT,1817,41,na,1858,24.5667328486855
STAT,1851,49,40-44,1900,0.0014151460712528835
STAT,1860,39,35-39,1899,0.056922200063648246
STAT,1835,41,20-24,1876,8.732359828459195E-4
STAT,1865,21,50-100,1886,0.003760246982944405
STAT,1836,28,40-44,1864,0.037139594187364684
STAT,1851,25,na,1876,21.69383814678794
SIM,1901,69,na,1970,25
SIM,1871,73,na,1944,13
SIM,1909,26,35-39,1935,2
STAT,1872,21,20-24,1893,0.7072208392663852
STAT,1918,37,25-29,1955,0.010284061475031085
SIM,1875,24,na,1899,18
STAT,1902,25,25-29,1927,0.6005760379190217
STAT,1864,43,na,1907,20.58028912786733
SIM,1880,21,20-24,1901,1
STAT,1953,16,40-44,1969,0.016827025682397995
STAT,1864,40,na,1904,20.93921186753084
SIM,1912,21,na,1933,36
STAT,1919,31,30-34,1950,0.16919461484142576
STAT,1852,18,15-19,1870,0.06106766345350944
STAT,1915,29,20-24,1944,0.18325900285011695
STAT,1961,5,na,1966,50.49808982849835
STAT,1848,35,40-44,1883,0.029785480294713083
STAT,1877,61,na,1938,19.289197309059077
STAT,1922,37,45-49,1959,0.007700269771067803
STAT,1874,50,na,1924,22.157604407482772
STAT,1806,89,na,1895,0.4915653410662845
STAT,1909,45,30-34,1954,8.223887059195507E-4
SIM,1900,8,na,1908,40
STAT,1909,18,40-44,1927,0.0027203944908710622
STAT,1882,16,35-39,1898,0.005271434960313796
STAT,1920,35,50-100,1955,0.0045657023894199325
STAT,1839,42,35-39,1881,0.01053227608311157
STAT,1856,20,25-29,1876,0.4886341752837846
STAT,1816,49,20-24,1865,1.4673294222190765E-4
STAT,1823,42,40-44,1865,0.015943406120719608
STAT,1911,18,30-34,1929,0.02417024330711681
SIM,1854,70,na,1924,7
STAT,1857,21,25-29,1878,0.4983087072949544
STAT,1894,16,25-29,1910,0.0728026987280971
STAT,1883,46,50-100,1929,0.0023917474607989156
STAT,1933,37,20-24,1970,0.003575919241806297
SIM,1817,41,na,1858,10
STAT,1934,24,25-29,1958,1.2352363457325701
STAT,1848,17,40-44,1865,0.0014662974608839
STAT,1890,33,40-44,1923,0.05245591885318606
STAT,1840,92,na,1932,0.32636115500706536
STAT,1898,23,na,1921,31.80594116698443
SIM,1857,47,na,1904,22
STAT,1861,31,20-24,1892,0.022824417114518925
SIM,1858,32,na,1890,25
STAT,1902,43,20-24,1945,1.543962136111165E-4
STAT,1817,46,30-34,1863,0.0028404393624407685
STAT,1902,19,35-39,1921,0.007696326719500964
SIM,1876,23,20-24,1899,1
STAT,1912,32,na,1944,36.924020404269996
STAT,1871,76,na,1947,9.445617815196977
STAT,1836,18,30-34,1854,0.020546510260571083
SIM,1942,24,25-29,1966,1
SIM,1864,40,na,1904,22
STAT,1913,16,40-44,1929,0.0028428350792165406
STAT,1863,58,na,1921,17.509600884081582
SIM,1875,32,na,1907,18
STAT,1862,18,40-44,1880,0.0017966656167361526
STAT,1906,36,15-19,1942,1.769356110318863E-4
STAT,1945,26,50-100,1971,0.010846453350676735
SIM,1793,63,na,1856,18
SIM,1898,60,na,1958,20
STAT,1847,37,45-49,1884,0.022094678730043178
STAT,1839,73,na,1912,6.5546863560099125
STAT,1881,83,na,1964,6.157961998905909
STAT,1874,47,50-100,1921,0.002479974969523192
STAT,1846,31,20-24,1877,0.026158052796077993
STAT,1910,34,15-19,1944,0.0012209467012811693
STAT,1891,50,na,1941,26.807705396371883
SIM,1848,25,na,1873,33
STAT,1863,52,50-100,1915,1.330075265960961E-4
STAT,1855,33,50-100,1888,0.006500605263798555
STAT,1952,19,30-34,1971,0.14510599215904846
SIM,1837,20,30-34,1857,1
STAT,1904,65,na,1969,27.37234294296685
STAT,1889,9,na,1898,31.76691550368595
STAT,1882,68,na,1950,14.645386136363761
STAT,1881,43,na,1924,21.833581701406576
STAT,1874,20,50-100,1894,0.0041616823518085735
STAT,1923,24,na,1947,41.93176379202093
STAT,1901,15,50-100,1916,6.887132307326288E-4
STAT,1922,40,40-44,1962,0.002857810172291098
STAT,1927,16,50-100,1943,0.004645989785243639
STAT,1916,21,50-100,1937,0.00685660224511577
STAT,1823,89,na,1912,0.6041502961240187
STAT,1921,46,na,1967,41.194366660180485
SIM,1889,24,na,1913,32
STAT,1884,37,30-34,1921,0.05221664221058305
STAT,1868,23,20-24,1891,0.6648367098642329
STAT,1810,44,20-24,1854,0.0015659224626714096
STAT,1936,32,15-19,1968,0.0012406342359264873
STAT,1916,44,30-34,1960,0.0012946115839836659
SIM,1859,17,na,1876,22
STAT,1930,31,35-39,1961,0.11745058299634552
STAT,1897,67,na,1964,23.261138940086727
STAT,1906,21,45-49,1927,0.010161383946139876
STAT,1839,84,na,1923,1.8358223593673575
STAT,1879,40,15-19,1919,1.443753640729126E-4
SIM,1816,45,na,1861,12
STAT,1933,1,na,1934,55.675173040519226
STAT,1945,21,30-34,1966,0.31284210894169234
STAT,1828,81,na,1909,3.631822873655053
STAT,1943,17,30-34,1960,0.12831153110202678
STAT,1840,45,45-49,1885,0.0019132478029118079
STAT,1861,21,45-49,1882,0.006068052817621925
STAT,1917,36,25-29,1953,0.01018262164037604
SIM,1807,71,na,1878,12
SIM,1911,36,na,1947,39
STAT,1939,28,25-29,1967,0.6568359124939651
STAT,1907,37,50-100,1944,0.003876254900597906
STAT,1894,26,50-100,1920,0.008226379982545806
STAT,1950,7,na,1957,46.18834737965093
STAT,1885,27,50-100,1912,0.0063170570667317036
STAT,1921,44,35-39,1965,0.0022428595406508247
STAT,1907,37,15-19,1944,1.7729234634406612E-4
STAT,1834,42,50-100,1876,0.009000326888355724
STAT,1876,45,25-29,1921,5.908442656079906E-4
STAT,1971,1,na,1972,49.54316753986291
SIM,1922,28,na,1950,47
STAT,1887,22,15-19,1909,0.03600910259629907
STAT,1928,16,na,1944,46.26519677645089
STAT,1810,71,na,1881,5.2181442541019205
STAT,1855,43,30-34,1898,0.008035994401119519
STAT,1932,26,15-19,1958,0.009213230369774943
STAT,1898,22,25-29,1920,0.7722437959824752
STAT,1917,27,30-34,1944,0.4071796996002897
SIM,1895,24,na,1919,25
STAT,1920,42,30-34,1962,0.0013999590216810924
SIM,1878,83,na,1961,5
STAT,1904,41,35-39,1945,0.0018099644301004499
STAT,1775,103,na,1878,7.978102417792992E-4
STAT,1843,36,30-34,1879,0.026667999387823594
SIM,1884,9,na,1893,26
STAT,1939,19,na,1958,36.56614836283246
SIM,1876,26,25-29,1902,1
STAT,1842,39,20-24,1881,0.006047002703463243
STAT,1908,34,25-29,1942,0.08604715599344533
STAT,1800,64,na,1864,7.649266723128222
STAT,1929,39,20-24,1968,0.0033609571613329044
SIM,1862,14,na,1876,26
STAT,1844,51,na,1895,16.898755471441593
STAT,1939,31,50-100,1970,0.008382896068636974
STAT,1946,22,30-34,1968,0.31757881218406203
STAT,1845,36,na,1881,14.620977888721015
STAT,1904,23,35-39,1927,0.08335767671653573
STAT,1874,50,45-49,1924,1.4934291022242156E-4
SIM,1851,22,na,1873,25
STAT,1845,20,15-19,1865,0.02428786801538285
STAT,1809,54,25-29,1863,1.1129644987449483E-4
STAT,1846,21,15-19,1867,0.03322737225915852
STAT,1940,18,20-24,1958,1.3663411953938287
SIM,1929,38,na,1967,48
STAT,1941,19,20-24,1960,1.3853945244556907
STAT,1905,24,35-39,1929,0.08369282937452589
STAT,1886,75,na,1961,12.558394606764827
STAT,1870,91,na,1961,1.1239176075451174
STAT,1810,48,40-44,1858,0.001647951782363116
STAT,1865,32,35-39,1897,0.09159803023695556
STAT,1927,40,20-24,1967,2.209676989575859E-4
STAT,1901,32,15-19,1933,0.00199266642141513
STAT,1815,63,na,1878,7.6632572180953
STAT,1887,32,20-24,1919,0.029504095390499224
STAT,1926,29,30-34,1955,0.4636851396138002
STAT,1927,16,35-39,1943,0.05203509523559312
STAT,1866,33,35-39,1899,0.09287481712564762
STAT,1883,31,50-100,1914,0.00893385150205689
SIM,1813,71,na,1884,1
STAT,1967,3,na,1970,48.8169186378245
SIM,1853,77,na,1930,5
STAT,1867,30,45-49,1897,0.016821828693630816
STAT,1862,93,na,1955,0.25214635991079126
STAT,1826,29,25-29,1855,1.106218038233969
STAT,1813,52,25-29,1865,1.0544324170945379E-4
SIM,1851,76,na,1927,13
SIM,1877,81,na,1958,5
STAT,1834,100,na,1934,0.00750259734432558
STAT,1948,15,20-24,1963,1.5421084151537663
SIM,1839,42,na,1881,20
STAT,1944,24,20-24,1968,1.1910626802710131
STAT,1835,29,35-39,1864,0.05662973716573024
STAT,1843,28,15-19,1871,0.0023515296340820726
SIM,1860,9,na,1869,28
STAT,1831,52,45-49,1883,1.2224086342758507E-4
STAT,1927,25,30-34,1952,0.4771302664442494
SIM,1804,74,na,1878,8
STAT,1836,38,50-100,1874,0.014393458035501794
STAT,1878,19,45-49,1897,6.707843325854774E-4
STAT,1815,40,25-29,1855,0.010344066522621521
STAT,1845,23,20-24,1868,0.496493348164268
STAT,1846,55,na,1901,16.757331993099847
STAT,1911,15,25-29,1926,0.08655918245603685
STAT,1852,26,30-34,1878,0.25283905063345125
STAT,1816,59,na,1875,7.208865656736299
STAT,1792,104,na,1896,2.527278729342755E-4
STAT,1868,35,25-29,1903,0.028127916540538287
STAT,1888,38,45-49,1926,0.02318029902516055
STAT,1820,48,30-34,1868,8.077141903963485E-4
STAT,1831,36,40-44,1867,0.045238672799527924
STAT,1877,47,na,1924,23.1159576089834
SIM,1800,84,na,1884,3
STAT,1882,31,25-29,1913,0.09856050274890969
STAT,1942,27,20-24,1969,0.1901896273309024
STAT,1871,54,40-44,1925,1.0207435292338973E-4
SIM,1834,29,25-29,1863,1
STAT,1865,107,na,1972,7.751020505642664E-4
STAT,1843,35,20-24,1878,0.003897413415795556
STAT,1859,42,20-24,1901,0.001260718733215446
STAT,1902,24,15-19,1926,0.04623115810903374
SIM,1830,29,na,1859,21
STAT,1931,27,45-49,1958,0.022205430371313357
STAT,1939,30,na,1969,38.36750573833264
STAT,1833,24,40-44,1857,0.020442030999273404
STAT,1850,36,50-100,1886,0.011220402043815856
STAT,1916,37,20-24,1953,0.0026764366516621313
SIM,1884,69,na,1953,16
STAT,1942,28,na,1970,39.01280902768101
STAT,1801,71,na,1872,5.9991171409590835
STAT,1843,26,20-24,1869,0.06168647488729245
STAT,1900,36,15-19,1936,1.688812994556248E-4
STAT,1850,48,50-100,1898,0.002159259779207259
STAT,1835,91,na,1926,0.2606451379694757
SIM,1895,22,15-19,1917,1
SIM,1956,15,20-24,1971,3
STAT,1820,64,na,1884,9.948698499100528
STAT,1851,20,40-44,1871,0.02131343043372267
SIM,1857,67,na,1924,14
STAT,1874,32,45-49,1906,0.017690926313595035
STAT,1837,17,35-39,1854,0.005307531595098442
SIM,1922,18,15-19,1940,1
STAT,1915,26,na,1941,38.00994027210788
STAT,1834,23,45-49,1857,0.006543259021868823
SIM,1837,37,50-100,1874,1
STAT,1839,30,50-100,1869,0.006353006708718408
STAT,1816,47,50-100,1863,0.0030955471509976247
STAT,1937,15,45-49,1952,0.004851476927169335
STAT,1927,31,na,1958,46.31304333638288
SIM,1905,50,na,1955,40
STAT,1876,54,50-100,1930,1.4917229784753634E-4
SIM,1907,51,na,1958,35
STAT,1914,18,15-19,1932,0.092856693584578
SIM,1909,32,na,1941,39
STAT,1893,29,25-29,1922,0.5295569499087576
SIM,1879,17,na,1896,16
STAT,1857,40,30-34,1897,0.008693351564741715
STAT,1872,37,40-44,1909,0.04478930446022062
STAT,1833,31,45-49,1864,0.01679562714534218
STAT,1851,22,35-39,1873,0.05883193121417876
STAT,1861,19,35-39,1880,0.005241425154921353
STAT,1796,85,na,1881,0.17815710234605897
STAT,1841,46,na,1887,22.40684813810823
STAT,1826,38,25-29,1864,0.032473725040762944
STAT,1864,29,na,1893,21.252285550374317
STAT,1801,53,45-49,1854,4.073527633693116E-4
STAT,1861,24,15-19,1885,0.02809398084306349
STAT,1933,24,45-49,1957,0.01485394795089218
STAT,1950,21,40-44,1971,0.039654363337058005
STAT,1847,46,45-49,1893,0.0025281970309724926
STAT,1914,49,20-24,1963,1.0805496104960702E-4
STAT,1943,26,25-29,1969,0.6961977794740479
STAT,1898,41,30-34,1939,0.0010818522420342487
STAT,1945,23,25-29,1968,1.0047572147297674
STAT,1872,28,40-44,1900,0.030541830271403368
STAT,1862,6,na,1868,24.65135110487044
STAT,1879,47,35-39,1926,0.001442258623770677
STAT,1833,82,na,1915,3.4543114507556067
STAT,1905,37,45-49,1942,0.006209929714668655
STAT,1919,19,45-49,1938,0.005443125294147825
STAT,1936,16,40-44,1952,0.013342950813620283
STAT,1884,27,20-24,1911,0.11493912270346363
SIM,1853,23,20-24,1876,1
SIM,1872,9,na,1881,27
STAT,1920,15,35-39,1935,0.009408406521967038
SIM,1893,0,na,1893,42
STAT,1880,43,25-29,1923,0.006703842725006255
STAT,1845,16,50-100,1861,3.641057436642427E-4
STAT,1910,41,25-29,1951,6.746193562718261E-4
SIM,1826,75,na,1901,5
STAT,1898,0,na,1898,39.61120477690099
STAT,1934,28,40-44,1962,0.062406830749913836
SIM,1844,49,na,1893,1
SIM,1888,53,na,1941,32
STAT,1866,83,na,1949,3.6561769924211123
STAT,1862,47,25-29,1909,4.946356052789876E-4
STAT,1892,46,25-29,1938,4.02538372077751E-4
STAT,1894,25,25-29,1919,0.5458095771366039
STAT,1899,70,na,1969,22.732050036937117
STAT,1934,35,15-19,1969,2.643347227675511E-4
STAT,1874,19,na,1893,25.48465135372749
STAT,1825,30,40-44,1855,0.0635058451670134
STAT,1902,17,40-44,1919,0.002579274508809178
SIM,1894,24,20-24,1918,1
STAT,1813,82,na,1895,3.0792365761384524
STAT,1833,37,na,1870,19.82189588004898
SIM,1799,82,na,1881,2
STAT,1871,38,35-39,1909,0.07016728768854287
STAT,1943,21,50-100,1964,0.0069519034429697925
STAT,1868,23,50-100,1891,0.003934178237328674
STAT,1917,35,15-19,1952,1.9952304186919413E-4
STAT,1839,45,40-44,1884,9.875903694077776E-4
STAT,1825,32,35-39,1857,0.12146574330994589
STAT,1926,33,30-34,1959,0.18930077902371664
STAT,1861,30,50-100,1891,0.007767153195762944
STAT,1934,20,45-49,1954,0.01510615807807116
SIM,1837,61,na,1898,28
STAT,1809,77,na,1886,4.913152550460284
STAT,1837,72,na,1909,6.1064036547625715
STAT,1875,66,na,1941,16.848076401226173
STAT,1889,43,45-49,1932,0.018191472819414387
STAT,1947,2,na,1949,45.0870344299352
STAT,1876,42,50-100,1918,0.010716598554617231
SIM,1919,2,na,1921,47
SIM,1806,55,na,1861,8
STAT,1892,21,40-44,1913,0.025821255658560874
STAT,1850,24,50-100,1874,0.004295549069400178
STAT,1910,19,25-29,1929,0.08488510023346207
SIM,1860,59,na,1919,16
STAT,1867,39,25-29,1906,0.027275475020625616
STAT,1844,74,na,1918,8.668503668193075
STAT,1890,23,30-34,1913,0.21569774725550359
SIM,1965,6,na,1971,52
STAT,1892,23,35-39,1915,0.07186920267781485
SIM,1874,39,na,1913,25
STAT,1810,44,25-29,1854,0.0063317733551196
STAT,1844,34,25-29,1878,0.09370561386947952
STAT,1902,53,na,1955,29.87698059290221
SIM,1942,2,na,1944,43
SIM,1861,52,na,1913,23
STAT,1865,39,20-24,1904,0.006902058216518761
STAT,1928,23,25-29,1951,1.1440940252227747
STAT,1907,31,40-44,1938,0.03657345595726641
STAT,1920,48,35-39,1968,0.0014091468666872335
STAT,1851,49,50-100,1900,0.0020301394558754743
STAT,1849,34,45-49,1883,0.013955381442366575
STAT,1879,54,40-44,1933,1.059658356997888E-4
STAT,1924,31,40-44,1955,0.0453852907158641
SIM,1949,15,na,1964,38
STAT,1879,28,na,1907,24.613807518192687
STAT,1903,22,50-100,1925,0.005797691541092456
STAT,1851,22,na,1873,21.55609905336973
STAT,1821,47,35-39,1868,0.0019783824603109403
STAT,1854,5,na,1859,18.385960903674324
STAT,1886,24,20-24,1910,0.710331273938022
STAT,1948,13,na,1961,44.64960073266289
STAT,1824,74,na,1898,7.722043168252473
SIM,1861,24,25-29,1885,1
SIM,1936,23,25-29,1959,2
STAT,1928,24,35-39,1952,0.11625532398963288
STAT,1915,20,na,1935,37.75054732529881
STAT,1864,74,na,1938,9.953947670829168
STAT,1844,24,15-19,1868,0.03171331329241241
STAT,1865,36,50-100,1901,0.011158225797498832
STAT,1872,53,45-49,1925,1.4610258318695706E-4
STAT,1911,16,na,1927,38.494490158626256
STAT,1861,46,na,1907,18.97387805078686
SIM,1836,24,30-34,1860,1
STAT,1953,15,30-34,1968,0.14667217171538022
STAT,1870,24,25-29,1894,0.5651113883393534
SIM,1837,47,na,1884,29
STAT,1834,21,50-100,1855,0.0038820129894928087
STAT,1838,46,35-39,1884,0.0011323089518057473
STAT,1855,53,45-49,1908,1.0053695718868281E-4
STAT,1895,15,30-34,1910,0.020788633790387097
STAT,1827,53,50-100,1880,1.07899456474934E-4
STAT,1853,24,25-29,1877,0.41901033658971903
STAT,1918,34,20-24,1952,0.02546497845652184
STAT,1808,51,50-100,1859,1.0702147454049108E-4
STAT,1904,68,na,1972,25.82989517898893
STAT,1880,29,45-49,1909,0.01159198038042035
STAT,1908,38,40-44,1946,0.013873898881151458
STAT,1871,16,25-29,1887,0.05719908583766177
STAT,1908,30,45-49,1938,0.014894967315472208
SIM,1955,15,na,1970,46
SIM,1892,44,na,1936,36
STAT,1943,25,15-19,1968,0.0074701845482573895
STAT,1885,32,20-24,1917,0.026693105379971882
STAT,1923,32,35-39,1955,0.10403684788358879
STAT,1919,33,25-29,1952,0.09843554186924024
STAT,1891,40,35-39,1931,0.02244953380229699
SIM,1882,68,na,1950,21
STAT,1885,25,15-19,1910,0.004510776135109821
STAT,1794,84,na,1878,1.259675097790601
SIM,1847,8,na,1855,25
STAT,1818,41,20-24,1859,0.001760962030739013
SIM,1912,38,na,1950,37
SIM,1898,35,45-49,1933,1
SIM,1939,15,20-24,1954,2
STAT,1850,24,40-44,1874,0.02195025414767064
SIM,1901,66,na,1967,27
STAT,1903,48,35-39,1951,0.0011086586829150559
STAT,1889,36,40-44,1925,0.053853111043182515
STAT,1810,54,na,1864,9.379842714174712
STAT,1870,20,50-100,1890,0.004075113598517987
STAT,1868,29,30-34,1897,0.24195490635514352
STAT,1849,16,15-19,1865,0.05697762606238308
STAT,1823,32,30-34,1855,0.264796315480139
STAT,1925,36,na,1961,44.91299659480957
STAT,1862,48,35-39,1910,0.0011926935502339481
STAT,1892,38,na,1930,28.961556670631726
STAT,1895,66,na,1961,22.77624819082532
STAT,1847,17,na,1864,30.604328717716324
STAT,1861,49,30-34,1910,7.970483074934877E-4
SIM,1878,23,25-29,1901,1
STAT,1774,84,na,1858,0.42898110302292025
STAT,1835,34,15-19,1869,8.067449437318436E-4
STAT,1858,39,15-19,1897,4.2300451723671824E-4
STAT,1911,36,na,1947,36.2775058779154
SIM,1811,56,na,1867,10
SIM,1833,32,35-39,1865,1
STAT,1899,38,20-24,1937,0.002266347793517477
SIM,1927,33,25-29,1960,1
STAT,1856,22,50-100,1878,0.003430991801559466
STAT,1903,20,15-19,1923,0.04718317108146431
SIM,1862,68,na,1930,16
STAT,1869,28,35-39,1897,0.09316336894558443
STAT,1824,54,na,1878,16.062804366714552
STAT,1888,7,na,1895,30.446141077747154
STAT,1948,17,15-19,1965,0.5159407008605874
STAT,1831,56,na,1887,16.73651659558062
STAT,1895,32,na,1927,30.98040806543028
STAT,1905,28,15-19,1933,0.006524973642157718
STAT,1831,39,45-49,1870,0.019959619085658895
SIM,1911,23,20-24,1934,1
STAT,1881,43,45-49,1924,0.014138306270984863
STAT,1916,45,50-100,1961,0.0023108748175479465
STAT,1837,18,45-49,1855,5.975840571629638E-4
STAT,1856,41,25-29,1897,0.004673048897114766
STAT,1952,16,25-29,1968,0.5163897927048684
STAT,1839,15,45-49,1854,4.7717295548543127E-4
STAT,1849,97,na,1946,0.0416558992571783
SIM,1820,39,na,1859,16
STAT,1824,38,20-24,1862,0.01098572832487347
STAT,1888,44,40-44,1932,0.025930195154609464
STAT,1929,16,35-39,1945,0.05342638264872257
STAT,1848,42,45-49,1890,0.009666852301112977
STAT,1843,29,25-29,1872,0.21767307784463905
STAT,1893,17,20-24,1910,0.22353503858295984
STAT,1891,29,20-24,1920,0.1429584798486132
STAT,1851,56,na,1907,17.219220846482084
STAT,1860,35,20-24,1895,0.006326307554517806
STAT,1889,19,20-24,1908,0.2158920031171253
SIM,1872,36,35-39,1908,1
STAT,1894,19,30-34,1913,0.020317356227803937
SIM,1819,42,na,1861,7
STAT,1953,18,35-39,1971,0.05045079000302943
STAT,1863,43,25-29,1906,0.0056445712282065285
STAT,1879,44,30-34,1923,0.01173856456802814
STAT,1842,93,na,1935,0.21927197666202863
STAT,1887,37,na,1924,25.715673137642078
STAT,1839,22,na,1861,15.16081692039333
SIM,1908,13,na,1921,42
STAT,1866,55,na,1921,19.04326051208308
STAT,1885,35,25-29,1920,0.028702525377806973
SIM,1901,29,35-39,1930,1
SIM,1935,15,na,1950,52
STAT,1903,15,35-39,1918,0.007837425359404699
STAT,1847,31,na,1878,27.466414548848228
STAT,1911,25,35-39,1936,0.14645770604579306
STAT,1897,37,45-49,1934,0.02647261429391732
STAT,1925,30,45-49,1955,0.018590193390724635
SIM,1811,76,na,1887,3
STAT,1908,37,30-34,1945,0.016975569639784034
STAT,1818,44,25-29,1862,0.006500999000858941
STAT,1901,26,20-24,1927,0.16471789535503534
STAT,1845,26,25-29,1871,0.3031513336083031
STAT,1870,39,30-34,1909,0.052410565254677785
SIM,1880,4,na,1884,36
STAT,1848,18,20-24,1866,0.14128898938680357
STAT,1883,22,45-49,1905,0.006771560534375455
STAT,1898,44,35-39,1942,0.0016734258668473661
STAT,1935,34,20-24,1969,0.03355270680302365
SIM,1918,43,na,1961,34
SIM,1918,23,na,1941,32
STAT,1876,7,na,1883,27.354582717135585
SIM,1835,38,na,1873,19
STAT,1803,52,na,1855,12.743918565008002
STAT,1868,103,na,1971,0.014742766769624003
SIM,1916,42,na,1958,44
STAT,1926,26,25-29,1952,0.7872136293023403
SIM,1849,9,na,1858,19
STAT,1921,20,50-100,1941,0.007417992394295643
STAT,1934,0,na,1934,60.678353803595236
STAT,1912,39,45-49,1951,0.006535185599983036
SIM,1893,20,na,1913,36
STAT,1916,33,50-100,1949,0.008427365602614286
STAT,1893,26,20-24,1919,0.14842683301184428
STAT,1918,31,15-19,1949,0.0013587096863046588
STAT,1910,47,50-100,1957,0.00209736975228186
STAT,1858,37,20-24,1895,0.0058657336424353945
STAT,1838,43,30-34,1881,0.009375291795201987
STAT,1832,32,40-44,1864,0.025343999127593102
STAT,1805,49,45-49,1854,0.004608858478481928
STAT,1892,43,20-24,1935,0.0019478153699823918
STAT,1822,42,25-29,1864,0.003669550553331135
SIM,1943,10,na,1953,48
SIM,1914,33,na,1947,35
STAT,1918,35,30-34,1953,0.019217245837666482
STAT,1903,23,20-24,1926,0.9767243566612223
STAT,1842,73,na,1915,8.911458164494947
SIM,1883,28,25-29,1911,1
STAT,1826,35,20-24,1861,0.009354688621556964
STAT,1819,36,25-29,1855,0.035198009019915245
STAT,1814,52,45-49,1866,3.986668640836318E-4
STAT,1948,18,25-29,1966,0.49249899022776567
SIM,1929,32,na,1961,47
STAT,1855,46,na,1901,15.885423803174957
SIM,1852,34,25-29,1886,1
STAT,1857,92,na,1949,0.31179085905155457
STAT,1909,44,50-100,1953,0.0010792459964406027
SIM,1871,7,na,1878,28
STAT,1846,47,40-44,1893,0.0013809845479170147
STAT,1878,32,15-19,1910,0.0014702418215484646
STAT,1817,39,25-29,1856,0.10059033636860823
STAT,1868,64,na,1932,16.82288189046901
STAT,1876,20,45-49,1896,0.007124574060426736
STAT,1887,49,50-100,1936,0.0014805895089295314
STAT,1941,31,40-44,1972,0.040812554635080066
STAT,1842,54,45-49,1896,1.0588936073272942E-4
SIM,1901,12,na,1913,41
STAT,1863,8,na,1871,24.809946961938678
STAT,1834,45,20-24,1879,1.01394466133477E-4
STAT,1817,48,25-29,1865,0.0016414787520727095
STAT,1844,31,20-24,1875,0.025511704801907745
STAT,1882,14,na,1896,24.66919261547832
STAT,1846,38,40-44,1884,0.036664745385794166
STAT,1846,22,50-100,1868,0.004077726022757922
STAT,1931,18,15-19,1949,0.5898420342970523
STAT,1933,21,40-44,1954,0.044552414016722386
STAT,1878,16,40-44,1894,0.001892961033137856
STAT,1924,38,25-29,1962,0.011523127004585455
SIM,1936,21,30-34,1957,2
STAT,1822,73,na,1895,4.213144095904168
STAT,1887,39,40-44,1926,0.047299889670967425
STAT,1932,15,50-100,1947,0.004963874722120943
STAT,1853,18,30-34,1871,0.01197902905821837
STAT,1892,20,30-34,1912,0.22136727674749368
SIM,1909,18,na,1927,40
STAT,1907,34,45-49,1941,0.01452117363391354
SIM,1922,42,na,1964,48
STAT,1811,81,na,1892,3.064573194252012
STAT,1863,22,25-29,1885,0.5169522775643282
STAT,1876,19,50-100,1895,4.949154937783424E-4
STAT,1867,36,20-24,1903,0.007412224405015043
STAT,1886,27,25-29,1913,0.43877838829927845
STAT,1930,34,35-39,1964,0.11723108704334313
SIM,1802,65,na,1867,10
STAT,1926,36,35-39,1962,0.02941808751721267
SIM,1820,50,na,1870,14
STAT,1867,37,30-34,1904,0.05100195754511661
STAT,1951,20,45-49,1971,0.013370694010173165
STAT,1839,48,45-49,1887,0.0013100652000150317
STAT,1866,31,40-44,1897,0.04010358053830027
STAT,1917,21,na,1938,38.575170642492445
SIM,1875,36,20-24,1911,1
SIM,1934,26,25-29,1960,1
STAT,1928,21,30-34,1949,0.35817259445875177
SIM,1894,27,25-29,1921,1
STAT,1823,35,35-39,1858,0.052813507926735725
STAT,1837,41,na,1878,12.150037415900467
STAT,1936,30,20-24,1966,0.023575273762615635
STAT,1873,33,40-44,1906,0.04390501235979736
SIM,1864,63,na,1927,16
STAT,1840,42,45-49,1882,0.012233535256891054
STAT,1821,46,25-29,1867,8.262044300767654E-4
SIM,1871,11,na,1882,27
STAT,1891,76,na,1967,15.298045126187317
STAT,1839,20,25-29,1859,0.4118035751394407
SIM,1926,26,35-39,1952,1
SIM,1859,48,na,1907,18
SIM,1899,17,na,1916,29
STAT,1854,39,45-49,1893,0.012062253395183246
SIM,1902,28,na,1930,34
STAT,1882,26,45-49,1908,0.010677036376693401
STAT,1841,30,25-29,1871,0.1241931924871731
STAT,1842,36,15-19,1878,4.993940272775116E-4
STAT,1875,24,45-49,1899,0.007123189168464227
STAT,1877,25,25-29,1902,0.4396235464767943
STAT,1897,28,45-49,1925,0.014692430188848844
STAT,1958,0,na,1958,51.7279183977783
STAT,1874,64,na,1938,17.635496741958097
STAT,1899,40,35-39,1939,0.0017387572428693653
STAT,1916,47,30-34,1963,9.065341622494853E-4
STAT,1947,21,35-39,1968,0.10572512481545136
SIM,1857,61,na,1918,17
SIM,1813,57,na,1870,7
STAT,1890,35,50-100,1925,0.01505506153735388
STAT,1889,32,50-100,1921,0.01121788476423952
SIM,1901,16,20-24,1917,2
STAT,1857,17,50-100,1874,4.31066045850908E-4
STAT,1863,107,na,1970,5.89867420569752E-4
STAT,1863,21,15-19,1884,0.03000704397146367
STAT,1890,26,35-39,1916,0.1176080327789258
STAT,1910,22,15-19,1932,0.0496843763483747
SIM,1828,56,na,1884,9
STAT,1831,27,40-44,1858,0.03275396855648634
STAT,1883,37,15-19,1920,5.453065403387214E-4
STAT,1887,20,20-24,1907,0.7566731696713422
SIM,1829,41,50-100,1870,1
STAT,1853,28,40-44,1881,0.019704349028096865
STAT,1872,50,40-44,1922,1.0926369380141033E-4
STAT,1898,31,50-100,1929,0.012410671869536377
SIM,1929,21,25-29,1950,2
STAT,1904,44,35-39,1948,0.001777490584621351
STAT,1817,38,15-19,1855,0.002093843766820471
STAT,1850,28,20-24,1878,0.12203741423005103
SIM,1839,28,na,1867,23
SIM,1925,25,na,1950,45
SIM,1884,49,na,1933,20
STAT,1924,37,15-19,1961,2.2496908510765136E-4
STAT,1943,29,30-34,1972,0.41384778443293835
STAT,1847,21,30-34,1868,0.2349484700257233
STAT,1870,21,20-24,1891,0.6866356196415334
STAT,1928,20,20-24,1948,1.3897768742411571
STAT,1843,38,25-29,1881,0.012840775264461429
STAT,1835,19,25-29,1854,0.06817960840022423
STAT,1814,44,na,1858,13.995192117923812
STAT,1884,29,15-19,1913,0.004413389090294292
STAT,1933,17,na,1950,49.07154011940698
STAT,1859,45,25-29,1904,4.623787379458781E-4
STAT,1796,65,na,1861,1.5953682734536248
STAT,1875,46,20-24,1921,1.2370328698431591E-4
STAT,1874,6,na,1880,27.71632424696845
SIM,1827,71,na,1898,4
STAT,1864,36,35-39,1900,0.06374398483910532
STAT,1918,26,35-39,1944,0.15887474685093206
STAT,1827,28,30-34,1855,0.3575517862154145
STAT,1844,49,30-34,1893,7.403132222986452E-4
SIM,1873,77,na,1950,2
STAT,1887,48,40-44,1935,0.0018451814548096639
STAT,1935,26,na,1961,50.86146094384025
SIM,1872,92,na,1964,3
STAT,1897,42,25-29,1939,5.914421306728998E-4
STAT,1927,28,35-39,1955,0.18095046422442415
SIM,1886,10,na,1896,30
STAT,1837,31,15-19,1868,8.80819953714749E-4
SIM,1867,77,na,1944,5
STAT,1934,27,30-34,1961,0.5248685390842923
STAT,1838,26,na,1864,21.51231871339185
STAT,1853,3,na,1856,21.36008544
SIM,1942,27,30-34,1969,1
STAT,1853,19,40-44,1872,0.0013665460879107641
STAT,1841,16,45-49,1857,8.295264238098794E-4
STAT,1875,12,na,1887,26.77348488272597
STAT,1920,45,30-34,1965,9.816390844687027E-4
STAT,1944,21,15-19,1965,0.05707696080937509
STAT,1893,46,50-100,1939,0.0017517645367835552
SIM,1873,20,na,1893,26
STAT,1907,16,15-19,1923,0.0870209351258382
STAT,1920,27,na,1947,40.74463914066276
SIM,1900,19,na,1919,36
STAT,1826,36,30-34,1862,0.0631949681790612
STAT,1841,25,45-49,1866,0.013694290293163183
STAT,1864,33,30-34,1897,0.15593934780394794
STAT,1871,35,30-34,1906,0.053640547673591464
STAT,1893,27,30-34,1920,0.31751287242398607
SIM,1844,43,na,1887,4
SIM,1860,87,na,1947,3
SIM,1865,11,na,1876,25
STAT,1894,19,na,1913,32.19438054584528
STAT,1828,98,na,1926,0.021817493702790715
STAT,1917,39,30-34,1956,0.018644450673877166
SIM,1855,35,na,1890,19
SIM,1893,74,na,1967,21
STAT,1884,40,na,1924,22.872906946201752
STAT,1841,22,40-44,1863,0.025838469410473373
SIM,1851,45,na,1896,17
STAT,1892,45,45-49,1937,0.0016610159503271983
STAT,1897,20,15-19,1917,0.04407096045740197
STAT,1938,29,20-24,1967,0.17947270515239155
SIM,1875,15,20-24,1890,1
STAT,1924,16,15-19,1940,0.5382434343957184
STAT,1903,24,30-34,1927,0.25165779298588675
STAT,1818,38,30-34,1856,0.06788485424974425
STAT,1906,39,20-24,1945,0.0023928807912067386
STAT,1878,23,na,1901,24.341727865460527
SIM,1869,1,na,1870,24
STAT,1866,34,45-49,1900,0.01592277899629534
SIM,1857,4,na,1861,23
STAT,1839,41,25-29,1880,0.00415730910308212
SIM,1927,37,na,1964,50
STAT,1825,54,45-49,1879,1.242005705005678E-4
STAT,1921,29,45-49,1950,0.01896757996698105
STAT,1820,95,na,1915,0.07537570860425215
STAT,1935,16,25-29,1951,0.5912405978452403
STAT,1829,38,40-44,1867,0.039761718285050165
STAT,1901,29,25-29,1930,0.587680168670323
STAT,1830,34,30-34,1864,0.10757501775672107
STAT,1949,17,30-34,1966,0.14085355711822706
STAT,1863,26,50-100,1889,0.005704781467021021
STAT,1803,54,50-100,1857,2.8320295936821646E-4
STAT,1860,17,25-29,1877,0.053132272093244205
STAT,1829,49,50-100,1878,0.0020431400125047274
STAT,1855,28,40-44,1883,0.02182586244469117
STAT,1859,32,45-49,1891,0.01386019328338217
STAT,1933,28,25-29,1961,0.8699803224906253
STAT,1785,76,na,1861,10.365183843275718
STAT,1800,95,na,1895,0.048180635680342934
SIM,1862,82,na,1944,8
STAT,1881,40,40-44,1921,0.021618798977991842
STAT,1888,30,na,1918,28.110538714699675
STAT,1923,17,45-49,1940,0.005825175777774904
STAT,1856,15,45-49,1871,5.661995855485192E-4
STAT,1920,41,na,1961,40.727556812108574
STAT,1844,28,30-34,1872,0.23905850960301317
SIM,1847,20,25-29,1867,1
STAT,1920,23,20-24,1943,1.2218674166994796
STAT,1824,37,45-49,1861,0.02902561143452231
STAT,1832,22,30-34,1854,0.10868619990969375
STAT,1841,34,40-44,1875,0.050444061876290705
STAT,1922,28,15-19,1950,0.007901869147001292
SIM,1845,28,na,1873,20
STAT,1895,32,15-19,1927,0.001848815076075359
STAT,1857,32,45-49,1889,0.013134987959187138
STAT,1887,25,50-100,1912,0.007029662091213217
STAT,1852,4,na,1856,27.59011036
SIM,1848,7,na,1855,33
STAT,1909,26,25-29,1935,0.6329844657805009
STAT,1946,23,40-44,1969,0.03714039045384033
SIM,1866,75,na,1941,13
STAT,1869,50,50-100,1919,1.484397138199751E-4
STAT,1877,92,na,1969,1.5578324504444623
STAT,1851,38,15-19,1889,4.7420132282442214E-4
SIM,1906,0,na,1906,31
SIM,1874,70,na,1944,17
SIM,1884,15,na,1899,26
STAT,1820,92,na,1912,0.23612086992856265
STAT,1921,22,25-29,1943,1.0351613016823205
STAT,1853,21,20-24,1874,0.515429121212888
SIM,1920,17,35-39,1937,2
STAT,1912,17,35-39,1929,0.008418709589026196
STAT,1880,28,35-39,1908,0.10110645375198317
STAT,1869,42,15-19,1911,1.336444154171624E-4
STAT,1813,68,na,1881,11.933265686474861
STAT,1896,29,40-44,1925,0.03906658398610854
SIM,1876,82,na,1958,6
STAT,1856,27,45-49,1883,0.008334810266464468
STAT,1867,15,20-24,1882,0.17549966008660622
STAT,1873,26,35-39,1899,0.09843659677799287
SIM,1857,1,na,1858,31
STAT,1878,38,50-100,1916,0.01261256165270799
SIM,1848,56,na,1904,29
STAT,1869,49,35-39,1918,0.0013281949028576972
STAT,1888,33,na,1921,27.768703456680107
STAT,1886,46,30-34,1932,0.0010069245433133793
STAT,1894,29,40-44,1923,0.038116516983233935
STAT,1869,27,50-100,1896,0.006198244390959557
STAT,1906,15,na,1921,36.86288388082998
STAT,1871,17,35-39,1888,0.0055059634715791846
STAT,1888,22,30-34,1910,0.20815399021610054
SIM,1868,53,na,1921,31
STAT,1808,61,na,1869,3.754128515090703
STAT,1874,29,20-24,1903,0.11816394603512877
STAT,1916,22,na,1938,37.938787476306594
STAT,1906,18,20-24,1924,0.25688809550208624
SIM,1921,12,na,1933,42
STAT,1926,18,40-44,1944,0.017006237488022307
STAT,1826,86,na,1912,1.5505082463711366
STAT,1836,36,25-29,1872,0.034462625409466756
STAT,1970,2,na,1972,48.93463108449365
STAT,1886,52,na,1938,22.21579614971218
STAT,1892,24,45-49,1916,0.008560834094995383
STAT,1907,62,na,1969,29.668148875389818
STAT,1851,26,15-19,1877,0.004517179026887898
STAT,1825,33,45-49,1858,0.02000678259784325
STAT,1910,29,35-39,1939,0.14306302162779716
STAT,1867,27,20-24,1894,0.11226536231023469
SIM,1858,63,na,1921,20
STAT,1882,23,40-44,1905,0.01990834492834604
SIM,1883,30,na,1913,13
STAT,1875,21,40-44,1896,0.02148501963502957
SIM,1858,46,na,1904,24
STAT,1832,26,50-100,1858,0.003854655550715318
STAT,1857,43,35-39,1900,0.013457972705307726
STAT,1888,34,30-34,1922,0.20228705708558037
STAT,1855,21,20-24,1876,0.570923966254322
STAT,1909,33,30-34,1942,0.14887236480471053
STAT,1872,33,25-29,1905,0.10435702266640251
STAT,1783,98,na,1881,0.0030393093397357764
STAT,1901,36,50-100,1937,0.0037258746353930603
STAT,1838,24,25-29,1862,0.5681984696281729
STAT,1889,21,35-39,1910,0.07166133299956301
STAT,1914,24,40-44,1938,0.033853586916794846
STAT,1827,38,40-44,1865,0.035310326122968916
STAT,1865,31,25-29,1896,0.09302165784316829
STAT,1900,19,30-34,1919,0.021983372543131322
SIM,1829,31,30-34,1860,1
STAT,1884,39,25-29,1923,0.02792507952299318
STAT,1845,45,30-34,1890,5.714844878475201E-4
STAT,1842,32,35-39,1874,0.09178722540784687
STAT,1880,67,na,1947,16.669407170160223
STAT,1870,18,30-34,1888,0.01588999873638486
STAT,1917,20,45-49,1937,0.011920503855166863
SIM,1824,40,na,1864,18
STAT,1912,31,15-19,1943,0.0012597115843102072
STAT,1953,14,na,1967,47.22625888221273
STAT,1851,53,na,1904,17.88584464855867
STAT,1827,31,20-24,1858,0.02467401173765295
STAT,1871,22,na,1893,23.579543036465274
SIM,1866,41,na,1907,28
STAT,1951,17,20-24,1968,1.6046615776983608
SIM,1864,33,40-44,1897,2
STAT,1911,19,40-44,1930,0.0027660070933179202
STAT,1881,18,40-44,1899,0.0017358421935336243
STAT,1906,20,35-39,1926,0.085284616552568
SIM,1878,20,20-24,1898,1
STAT,1865,38,45-49,1903,0.01794140198905435
STAT,1898,43,50-100,1941,9.825074712688268E-4
STAT,1894,22,20-24,1916,0.8831769319385587
STAT,1926,44,20-24,1970,2.157511757424512E-4
STAT,1935,29,na,1964,50.788255544144725
SIM,1857,16,na,1873,23
STAT,1879,70,na,1949,14.521958323653244
SIM,1885,22,20-24,1907,2
STAT,1868,39,40-44,1907,0.04193671231733452
SIM,1905,20,25-29,1925,1
STAT,1933,14,na,1947,52.65363582894533
STAT,1925,33,15-19,1958,0.001515496236987805
STAT,1851,44,45-49,1895,0.012464548906053375
STAT,1907,38,25-29,1945,0.009045173311113494
STAT,1922,22,na,1944,41.57105704571145
SIM,1817,61,na,1878,4
STAT,1881,36,50-100,1917,0.01173873422343677
STAT,1840,16,na,1856,23.426097590497744
STAT,1863,47,40-44,1910,0.0015087339704597286
SIM,1918,3,na,1921,41
STAT,1799,90,na,1889,0.3497024791517796
STAT,1821,43,20-24,1864,0.0023941288101306086
STAT,1861,42,50-100,1903,0.00887335245525043
SIM,1912,52,na,1964,35
STAT,1831,32,25-29,1863,0.10804665697522157
STAT,1939,27,15-19,1966,0.007048255785115351
STAT,1822,49,45-49,1871,0.001262778239948072
STAT,1936,33,25-29,1969,0.08917670450911967
STAT,1847,43,40-44,1890,0.023854026873407205
STAT,1891,22,na,1913,29.02775038282595
STAT,1906,12,na,1918,37.51910132055783
STAT,1842,21,45-49,1863,0.006646635868225122
STAT,1833,68,na,1901,11.313907126448832
STAT,1906,32,35-39,1938,0.08448068317598546
STAT,1932,36,50-100,1968,0.005623458323621362
STAT,1902,28,30-34,1930,0.3538617946158694
STAT,1880,81,na,1961,7.742115931085968
STAT,1816,42,35-39,1858,0.024952916831597987
SIM,1877,67,na,1944,17
STAT,1897,34,40-44,1931,0.05709660110972078
STAT,1839,53,na,1892,11.691604310064582
SIM,1913,37,na,1950,40
SIM,1943,23,30-34,1966,1
STAT,1833,42,35-39,1875,0.016244897988112416
STAT,1802,76,na,1878,3.3286962640188347
STAT,1877,34,20-24,1911,0.027663731648131976
STAT,1841,25,50-100,1866,0.007889857366942532
STAT,1834,98,na,1932,0.022957293242792203
STAT,1931,36,na,1967,49.64993018642593
SIM,1784,83,na,1867,1
STAT,1884,74,na,1958,11.832960710008154
SIM,1839,42,45-49,1881,1
STAT,1880,21,15-19,1901,0.034795724397245036
STAT,1858,49,25-29,1907,4.2915267916319424E-4
STAT,1835,60,na,1895,8.578357851530514
STAT,1879,25,25-29,1904,0.4407942772846657
SIM,1923,44,na,1967,38
STAT,1872,37,50-100,1909,0.012561898140232458
STAT,1851,23,45-49,1874,0.006979754268048821
STAT,1872,25,50-100,1897,0.006589546310264881
STAT,1935,23,30-34,1958,0.3895203366484449
STAT,1859,39,30-34,1898,0.04193404586064361
STAT,1929,23,40-44,1952,0.04218573402050669
SIM,1853,23,na,1876,26
STAT,1826,39,35-39,1865,0.07768613260140134
STAT,1894,15,15-19,1909,0.07641009195940361
STAT,1909,23,20-24,1932,1.0244816490917321
SIM,1819,76,na,1895,1
STAT,1932,22,35-39,1954,0.12304492948972759
STAT,1789,83,na,1872,0.8524974976488933
STAT,1852,16,20-24,1868,0.18459814376276923
STAT,1868,32,20-24,1900,0.02615872403047098
STAT,1915,22,35-39,1937,0.0964907390716668
STAT,1883,33,35-39,1916,0.09792705733550276
STAT,1929,35,40-44,1964,0.019160081755256176
STAT,1887,37,50-100,1924,0.013400907284393035
SIM,1870,8,na,1878,27
SIM,1933,37,na,1970,49
STAT,1862,26,25-29,1888,0.3689562231570089
SIM,1822,62,na,1884,12
STAT,1872,38,na,1910,23.986092352923862
STAT,1875,8,na,1883,27.540723408374877
STAT,1887,44,25-29,1931,0.006914582765891489
STAT,1823,48,50-100,1871,0.001684287232442327
STAT,1905,27,50-100,1932,0.009232305095061854
STAT,1909,44,20-24,1953,1.622395973288872E-4
STAT,1946,16,35-39,1962,0.046225892553919457
STAT,1826,80,na,1906,4.322855356608618
STAT,1882,17,45-49,1899,6.260141631407702E-4
STAT,1872,16,40-44,1888,0.0018886897445058043
STAT,1901,17,25-29,1918,0.07929277397399474
STAT,1897,46,40-44,1943,0.0012860615974950758
STAT,1898,33,45-49,1931,0.02342490443239162
STAT,1847,36,35-39,1883,0.07921050420390999
STAT,1860,67,na,1927,12.88738834939677
STAT,1944,25,30-34,1969,0.4207820916600218
STAT,1814,100,na,1914,0.004730922252791161
STAT,1852,37,20-24,1889,0.006633093678625719
SIM,1843,26,30-34,1869,1
STAT,1946,0,na,1946,48.977417145315705
STAT,1852,29,35-39,1881,0.08627554006040039
STAT,1897,49,45-49,1946,0.0017309119560140346
STAT,1865,17,45-49,1882,6.088434525335766E-4
STAT,1873,85,na,1958,3.5580025904241688
STAT,1923,39,20-24,1962,0.0030267944383165885
STAT,1860,28,15-19,1888,0.003701231668968382
STAT,1850,49,20-24,1899,1.0461297540572872E-4
STAT,1903,27,35-39,1930,0.1371820170023376
SIM,1784,80,na,1864,1
STAT,1832,25,35-39,1857,0.058562952098898474
SIM,1846,75,na,1921,3
STAT,1844,38,40-44,1882,0.035758784042967305
STAT,1863,29,45-49,1892,0.009760336215702945
STAT,1861,54,50-100,1915,1.2351478583570616E-4
STAT,1846,26,40-44,1872,0.02958143254220916
STAT,1804,54,na,1858,12.932164886541445
STAT,1854,17,35-39,1871,0.004012067496816436
STAT,1905,15,35-39,1920,0.007955991016325123
STAT,1879,32,30-34,1911,0.18070982097570173
STAT,1917,28,40-44,1945,0.04826638824483294
SIM,1897,36,na,1933,40
SIM,1887,32,30-34,1919,3
SIM,1929,29,20-24,1958,1
STAT,1882,48,na,1930,21.290291785360758
STAT,1898,23,35-39,1921,0.0784774297116554
STAT,1936,19,45-49,1955,0.004728170416376093
SIM,1919,22,na,1941,44
STAT,1838,48,50-100,1886,0.0019361417368154922
SIM,1873,31,25-29,1904,2
STAT,1809,46,na,1855,17.7376084199357
STAT,1866,16,15-19,1882,0.056432452900794294
STAT,1873,23,30-34,1896,0.1805365813100829
STAT,1887,23,25-29,1910,0.622909524912085
STAT,1925,19,35-39,1944,0.050101911934133915
STAT,1835,26,30-34,1861,0.1530708715848539
STAT,1875,49,25-29,1924,5.797321977791785E-4
STAT,1884,15,20-24,1899,0.17450264723151523
STAT,1919,16,40-44,1935,0.003081777084044848
STAT,1862,23,20-24,1885,0.6042668826957098
SIM,1789,72,na,1861,8
STAT,1925,9,na,1934,47.787848883668545
STAT,1892,42,40-44,1934,0.027753514429300304
STAT,1918,23,30-34,1941,0.3062272479126875
STAT,1831,87,na,1918,1.4296959761714327
STAT,1880,25,30-34,1905,0.2665975432817124
STAT,1819,53,na,1872,12.563210577204584
STAT,1825,39,na,1864,15.132356877348348
STAT,1812,53,50-100,1865,1.6052461965848693E-4
STAT,1877,37,25-29,1914,0.029720831221241008
STAT,1886,49,35-39,1935,0.0014218525783409798
STAT,1883,30,30-34,1913,0.17091093081112863
STAT,1921,26,40-44,1947,0.051719213655193635
STAT,1838,21,20-24,1859,0.6989470480813501
STAT,1846,86,na,1932,1.79814696487616
STAT,1885,1,na,1886,32.671362706089745
STAT,1814,49,50-100,1863,0.006821105681802526
STAT,1910,26,30-34,1936,0.3773460086557424
STAT,1856,45,na,1901,16.461086871638425
SIM,1920,9,na,1929,51
STAT,1839,27,45-49,1866,0.007718992228233231
SIM,1868,56,na,1924,31
STAT,1872,30,20-24,1902,0.027879201693429553
SIM,1848,53,na,1901,29
STAT,1879,73,na,1952,12.293358783433144
SIM,1899,14,na,1913,29
STAT,1875,5,na,1880,28.201330458089508
STAT,1891,21,25-29,1912,0.7047331595246396
STAT,1822,46,40-44,1868,9.526926166719954E-4
STAT,1866,52,na,1918,19.724710503200082
STAT,1889,80,na,1969,11.91584807356224
SIM,1926,23,30-34,1949,3
STAT,1826,47,20-24,1873,1.20813388015156E-4
STAT,1946,26,45-49,1972,0.019117354189298098
STAT,1818,48,40-44,1866,0.0016598076108726163
STAT,1834,20,40-44,1854,0.01998054524796545
STAT,1945,20,20-24,1965,1.2107652738635828
STAT,1861,19,50-100,1880,4.6798430212589755E-4
SIM,1897,33,na,1930,36
STAT,1888,37,35-39,1925,0.08265402113169033
STAT,1908,49,30-34,1957,7.973210946028222E-4
STAT,1877,16,25-29,1893,0.05863909676307737
SIM,1866,25,20-24,1891,1
STAT,1938,31,35-39,1969,0.09133392508704737
SIM,1907,2,na,1909,41
STAT,1891,25,40-44,1916,0.037015902626993995
STAT,1884,18,25-29,1902,0.05537442032136391
STAT,1923,37,50-100,1960,0.004831106394296399
SIM,1833,57,na,1890,10
STAT,1929,40,na,1969,47.99953856399162
STAT,1862,44,20-24,1906,0.0013516877743747237
SIM,1931,37,50-100,1968,1
SIM,1914,30,na,1944,37
STAT,1824,34,40-44,1858,0.06648418889631558
STAT,1893,38,20-24,1931,0.009671250575964923
STAT,1854,19,na,1873,16.586750021298847
STAT,1914,27,45-49,1941,0.017271710284265194
SIM,1964,4,na,1968,52
STAT,1848,39,20-24,1887,0.005031634036012307
STAT,1824,30,25-29,1854,0.17869698261739558
STAT,1861,16,30-34,1877,0.015497320303927434
STAT,1896,11,na,1907,33.972806461710434
STAT,1858,25,20-24,1883,0.09271171056804188
STAT,1836,33,20-24,1869,0.03263346136431633
STAT,1869,46,30-34,1915,9.405982493287849E-4
STAT,1904,34,na,1938,34.18884628136371
SIM,1790,69,na,1859,2
SIM,1856,82,na,1938,3
SIM,1854,22,25-29,1876,1
STAT,1837,39,45-49,1876,0.011578759152300954
SIM,1936,11,na,1947,38
SIM,1858,3,na,1861,30
STAT,1873,36,45-49,1909,0.020365181486096024
STAT,1852,31,50-100,1883,0.008203860029126517
SIM,1904,23,na,1927,32
STAT,1904,22,25-29,1926,0.8202670363743702
STAT,1925,6,na,1931,48.114292570536435
STAT,1947,19,20-24,1966,1.515756953870601
STAT,1830,37,35-39,1867,0.04137616450535512
STAT,1896,36,50-100,1932,0.01620446252729414
STAT,1919,33,na,1952,40.279491308965916
STAT,1914,41,na,1955,36.548337889627746
SIM,1880,1,na,1881,42
STAT,1925,27,20-24,1952,0.21425074638404745
SIM,1928,23,30-34,1951,3
STAT,1905,39,50-100,1944,0.0037860609268936508
STAT,1838,31,30-34,1869,0.17014646384611745
STAT,1857,22,35-39,1879,0.0504316739244811
SIM,1855,33,30-34,1888,2
SIM,1882,34,na,1916,31
SIM,1895,55,na,1950,25
STAT,1844,20,na,1864,21.15474164953975
STAT,1840,61,na,1901,14.642464501899656
SIM,1908,24,25-29,1932,1
STAT,1857,41,na,1898,17.380414616279307
STAT,1959,8,na,1967,51.11388767734035
STAT,1884,36,20-24,1920,0.007588757145230029
STAT,1909,36,35-39,1945,0.022875402549679198
STAT,1815,47,45-49,1862,0.0034014891648847315
SIM,1871,42,na,1913,24
STAT,1876,23,15-19,1899,0.033402862603086274
STAT,1924,34,45-49,1958,0.018215617781034244
STAT,1929,38,45-49,1967,0.008701492562696946
STAT,1785,79,na,1864,7.7998345879680295
STAT,1845,48,35-39,1893,8.080855437569932E-4
STAT,1846,22,25-29,1868,0.5724311192793551
STAT,1910,16,20-24,1926,0.26765320743247206
STAT,1827,34,25-29,1861,0.08588321977160247
STAT,1792,72,na,1864,11.050906296330107
STAT,1816,79,na,1895,2.098838639411059
STAT,1851,41,40-44,1892,0.01907500302843711
STAT,1897,16,45-49,1913,8.695842109682496E-4
SIM,1864,49,na,1913,22
STAT,1840,17,40-44,1857,0.0018556197121939863
STAT,1847,33,30-34,1880,0.21672572398687256
STAT,1869,18,na,1887,24.66438104694512
STAT,1878,26,50-100,1904,0.006626960709625142
STAT,1806,80,na,1886,3.6285843847195918
STAT,1807,65,na,1872,9.826525217178121
STAT,1849,31,40-44,1880,0.0393448541134984
STAT,1868,22,45-49,1890,0.006748296766505638
STAT,1795,86,na,1881,0.8823991040014618
STAT,1837,27,na,1864,13.416155498155788
STAT,1848,20,35-39,1868,0.04661693781871192
STAT,1912,42,50-100,1954,0.0011241922331878566
STAT,1834,48,25-29,1882,4.2619164737150663E-4
STAT,1877,22,50-100,1899,0.004209461586316788
STAT,1870,35,15-19,1905,5.631308129062009E-4
STAT,1943,18,40-44,1961,0.014719562879980575
STAT,1861,107,na,1968,4.274963487993792E-4
SIM,1917,26,25-29,1943,3
STAT,1938,21,25-29,1959,0.9084550578486977
STAT,1892,27,15-19,1919,0.005605075859652672
STAT,1843,27,na,1870,11.29326576952115
STAT,1832,35,45-49,1867,0.011550392731448055
STAT,1855,24,25-29,1879,0.4641240345606207
STAT,1859,20,45-49,1879,0.006410915585770488
STAT,1817,72,na,1889,10.349279112192034
STAT,1899,25,na,1924,32.89156260008656
STAT,1817,45,20-24,1862,3.57324032421164E-4
SIM,1851,42,na,1893,17
STAT,1859,35,15-19,1894,4.5056475195795584E-4
STAT,1954,16,50-100,1970,0.004606482469940868
STAT,1903,43,50-100,1946,0.0010354800400603464
STAT,1858,26,na,1884,18.724879748478354
STAT,1853,34,na,1887,15.126904024149564
SIM,1894,70,na,1964,18
STAT,1855,60,na,1915,13.427876434512369
STAT,1887,27,40-44,1914,0.03269681181349119
SIM,1853,57,na,1910,21
STAT,1927,21,15-19,1948,0.0654465928243503
STAT,1836,19,40-44,1855,0.0023439089328812232
SIM,1930,2,na,1932,55
STAT,1865,35,40-44,1900,0.039969987483102036
STAT,1918,38,35-39,1956,0.025237901045513454
STAT,1889,18,na,1907,30.840781387328175
STAT,1899,29,25-29,1928,0.5749395933581452
STAT,1836,79,na,1915,6.747100312343434
STAT,1889,44,50-100,1933,0.012759884230161278
STAT,1834,38,15-19,1872,4.885121237595923E-4
STAT,1935,26,35-39,1961,0.20383899467518804
STAT,1829,37,50-100,1866,0.011281281630596149
SIM,1910,24,15-19,1934,1
STAT,1864,21,30-34,1885,0.1635055253481107
STAT,1833,28,20-24,1861,0.11365210571043023
STAT,1852,19,25-29,1871,0.057968264404669644
STAT,1876,27,30-34,1903,0.25575889475318436
SIM,1920,19,na,1939,46
STAT,1866,37,15-19,1903,5.171731550950756E-4
STAT,1841,37,45-49,1878,0.022989612756349462
STAT,1895,18,35-39,1913,0.007104981206608271
SIM,1879,48,na,1927,14
STAT,1870,28,40-44,1898,0.02965284305697971
STAT,1848,103,na,1951,9.28111295111986E-4
STAT,1822,40,35-39,1862,0.010666236664867206
SIM,1834,50,na,1884,14
STAT,1842,42,na,1884,17.94088242014196
STAT,1903,45,30-34,1948,7.840521891503448E-4
SIM,1946,21,25-29,1967,1
STAT,1867,48,20-24,1915,1.1339236271419542E-4
STAT,1869,25,30-34,1894,0.24565321364812895
STAT,1815,91,na,1906,0.20685558971901447
STAT,1908,16,30-34,1924,0.023578449745745432
STAT,1952,20,50-100,1972,0.007869928585963637
STAT,1888,84,na,1972,8.06369296316521
STAT,1786,72,na,1858,2.303598537688046
STAT,1825,36,15-19,1861,5.999771243532137E-4
STAT,1944,28,35-39,1972,0.1610131747985572
SIM,1824,43,na,1867,18
STAT,1850,20,25-29,1870,0.620642923610528
STAT,1925,37,30-34,1962,0.02173798551745942
STAT,1843,32,50-100,1875,0.004672505389400215
STAT,1843,17,25-29,1860,0.030718779972035065
STAT,1887,41,20-24,1928,0.0017413000141155565
STAT,1914,38,50-100,1952,0.004136633160019942
STAT,1885,29,30-34,1914,0.24689766232541996
STAT,1913,48,na,1961,35.45909313048538
SIM,1835,35,na,1870,19
SIM,1945,25,na,1970,37
STAT,1875,39,15-19,1914,5.7142679133761E-4
STAT,1888,47,45-49,1935,0.0027450339256810652
STAT,1802,73,na,1875,4.423497491626764
STAT,1854,31,15-19,1885,9.006929792590962E-4
STAT,1860,38,25-29,1898,0.023290988132229372
SIM,1880,56,na,1936,29
STAT,1828,27,35-39,1855,0.15123945896470462
STAT,1870,18,50-100,1888,4.884219930056961E-4
STAT,1913,34,35-39,1947,0.08938774088506674
SIM,1840,50,na,1890,17
SIM,1930,26,na,1956,50
STAT,1919,30,20-24,1949,0.026297265439885916
STAT,1890,26,na,1916,29.088650109033534
STAT,1879,22,20-24,1901,0.7132512028657795
STAT,1940,17,45-49,1957,0.005036029070471714
STAT,1897,47,na,1944,29.743123440263812
STAT,1815,41,30-34,1856,0.018210868974357704
STAT,1925,16,15-19,1941,0.5461357156707195
STAT,1857,44,15-19,1901,1.0198603814806307E-4
STAT,1921,43,na,1964,41.43894576854735
STAT,1843,45,25-29,1888,2.495084462020597E-4
STAT,1927,24,25-29,1951,1.125141803439071
STAT,1924,23,45-49,1947,0.013149769887744217
STAT,1847,26,na,1873,27.976536455546825
STAT,1856,51,45-49,1907,1.0563578729370085E-4
STAT,1922,15,35-39,1937,0.0484308572521804
SIM,1871,28,na,1899,23
STAT,1833,32,35-39,1865,0.09653128136457545
STAT,1944,21,20-24,1965,1.1922664641939211
STAT,1863,49,45-49,1912,0.0020459103985911624
STAT,1878,43,20-24,1921,0.001627769414256179
STAT,1870,27,40-44,1897,0.029757589772980608
STAT,1904,42,50-100,1946,0.0010499057357744917
STAT,1814,47,na,1861,13.685181232766972
STAT,1851,31,na,1882,21.18721369342808
STAT,1889,29,50-100,1918,0.007775980241740122
SIM,1789,67,na,1856,9
SIM,1933,16,15-19,1949,1
STAT,1880,46,40-44,1926,0.001805370165906253
SIM,1888,44,na,1932,34
STAT,1799,100,na,1899,0.003922113023503289
STAT,1823,83,na,1906,2.283024942987704
SIM,1926,35,na,1961,46
STAT,1861,29,40-44,1890,0.025011312634529385
STAT,1868,95,na,1963,0.353768781782245
SIM,1804,73,na,1877,8
STAT,1888,28,40-44,1916,0.034882879330625914
STAT,1864,81,na,1945,4.850240590229893
STAT,1911,36,40-44,1947,0.014434897380884042
STAT,1820,45,30-34,1865,8.402672727288652E-4
SIM,1883,13,na,1896,15
STAT,1820,41,50-100,1861,0.00948970296265718
STAT,1887,35,50-100,1922,0.013528177324707076
STAT,1894,26,15-19,1920,0.0058345691744155085
SIM,1922,21,na,1943,46
STAT,1882,32,30-34,1914,0.16732411572344155
STAT,1906,36,50-100,1942,0.00386845537044013
SIM,1884,30,na,1914,26
STAT,1877,17,25-29,1894,0.05849543097600782
STAT,1879,22,30-34,1901,0.18435891155842163
STAT,1871,40,30-34,1911,0.011577854081638873
STAT,1847,53,45-49,1900,1.5253785271353705E-4
STAT,1941,20,40-44,1961,0.034519123825819585
SIM,1842,90,na,1932,1
STAT,1918,31,20-24,1949,0.025789846840849073
STAT,1829,43,25-29,1872,0.005608321919709189
STAT,1909,33,20-24,1942,0.023047953081128475
STAT,1860,101,na,1961,0.012258752508709508
STAT,1832,48,50-100,1880,0.0012892391749663595
STAT,1896,34,25-29,1930,0.1333884145944286
SIM,1938,20,na,1958,34
STAT,1876,29,50-100,1905,0.006450573228108062
STAT,1917,42,50-100,1959,0.0012148601423878631
STAT,1802,100,na,1902,0.0032423187578436738
STAT,1877,22,20-24,1899,0.7113568380793532
STAT,1934,18,na,1952,49.44513332079787
STAT,1874,49,20-24,1923,1.1919715670234272E-4
SIM,1872,45,na,1917,21
STAT,1871,53,50-100,1924,1.4815683182607656E-4
STAT,1909,20,15-19,1929,0.04949020938123493
STAT,1805,86,na,1891,0.6075012422570725
STAT,1847,47,50-100,1894,0.002611358768506229
STAT,1826,32,na,1858,20.557427449004287
STAT,1889,44,35-39,1933,0.02187110882406867
STAT,1860,47,50-100,1907,0.0019873524335928977
SIM,1939,6,na,1945,30
STAT,1852,48,30-34,1900,8.180514268922547E-4
STAT,1827,35,15-19,1862,4.719026267815902E-4
STAT,1847,27,40-44,1874,0.03846203265778502
STAT,1915,38,50-100,1953,0.004183906131772064
SIM,1880,64,na,1944,29
STAT,1861,27,15-19,1888,0.003843156521024571
STAT,1880,33,35-39,1913,0.10604208200357315
STAT,1893,62,na,1955,23.04544811917022
SIM,1968,2,na,1970,54
STAT,1901,29,35-39,1930,0.13404949002774336
STAT,1933,21,45-49,1954,0.014908929668975238
SIM,1818,81,na,1899,5
STAT,1792,105,na,1897,1.1109664566317818E-4
STAT,1836,18,50-100,1854,6.315524410836588E-4
STAT,1871,48,40-44,1919,0.0016854177959312153
STAT,1919,18,40-44,1937,0.01528278218078139
STAT,1865,35,35-39,1900,0.06458124522452902
STAT,1815,50,45-49,1865,2.0949741846373228E-4
SIM,1869,41,na,1910,16
STAT,1909,18,50-100,1927,7.286769185729891E-4
STAT,1870,39,35-39,1909,0.06955444263700128
SIM,1918,16,na,1934,40
STAT,1898,22,40-44,1920,0.02811059924906108
STAT,1922,20,30-34,1942,0.32913457817919267
STAT,1834,101,na,1935,0.004032571046601557
STAT,1884,40,40-44,1924,0.022259688437791324
SIM,1842,47,na,1889,23
STAT,1826,64,na,1890,12.147942192745928
SIM,1851,67,na,1918,15
STAT,1822,40,50-100,1862,0.006222818701602913
STAT,1880,28,na,1908,25.00722261450518
SIM,1839,43,na,1882,21
SIM,1956,4,na,1960,47
SIM,1793,72,na,1865,13
STAT,1831,24,25-29,1855,0.7898889460842495
STAT,1910,44,25-29,1954,6.625155356837252E-4
STAT,1882,41,45-49,1923,0.014407856546521183
STAT,1868,38,40-44,1906,0.04215295698667616
STAT,1913,44,50-100,1957,0.0011322835852195206
STAT,1920,29,45-49,1949,0.018655902345299177
STAT,1835,39,40-44,1874,0.024026562444037683
STAT,1801,72,na,1873,5.45661697790215
STAT,1858,30,50-100,1888,0.0071184289860763365
STAT,1889,57,na,1946,24.60454939826984
STAT,1858,17,15-19,1875,0.052751301780931306
STAT,1867,43,45-49,1910,0.014218795488560278
SIM,1876,59,na,1935,27
SIM,1834,28,na,1862,22
STAT,1928,33,30-34,1961,0.19591644209922776
STAT,1885,43,na,1928,22.658960612776042
STAT,1866,102,na,1968,0.018813499876559326
STAT,1874,36,15-19,1910,5.72425120765771E-4
STAT,1856,62,na,1918,13.240693890409075
STAT,1916,49,50-100,1965,0.0022865679475332257
SIM,1821,69,na,1890,5
STAT,1903,15,25-29,1918,0.08094007871214791
STAT,1838,22,50-100,1860,0.004106329852780264
STAT,1903,6,na,1909,37.1407504518658
STAT,1848,31,40-44,1879,0.033047461953489295
STAT,1818,100,na,1918,0.0026530811868053024
STAT,1850,24,35-39,1874,0.06146929998854555
SIM,1912,59,na,1971,35
STAT,1870,25,15-19,1895,0.004537606395901807
STAT,1890,40,40-44,1930,0.02759770782026006
STAT,1838,29,40-44,1867,0.029151878370196234
STAT,1776,88,na,1864,0.3044938842727546
STAT,1921,11,na,1932,44.87927834029794
STAT,1814,79,na,1893,3.1153657471799865
SIM,1859,63,na,1922,14
STAT,1891,36,15-19,1927,6.925380188937276E-4
STAT,1837,42,20-24,1879,9.124217363124004E-4
STAT,1853,25,15-19,1878,0.0033512110040470437
STAT,1809,49,40-44,1858,0.005661755688757529
STAT,1881,23,25-29,1904,0.5430336851475426
STAT,1880,12,na,1892,27.15645461980702
STAT,1829,26,35-39,1855,0.14995265319783438
STAT,1831,70,na,1901,11.38585890418377
STAT,1913,56,na,1969,34.232935987118516
SIM,1877,60,na,1937,23
STAT,1798,99,na,1897,0.00962434220575073
STAT,1794,85,na,1879,1.0194550566419334
STAT,1862,15,na,1877,22.95140848287707
STAT,1876,44,25-29,1920,0.006434005323758925
STAT,1866,29,na,1895,21.822347631742595
STAT,1944,16,25-29,1960,0.4631008736437517
STAT,1905,23,35-39,1928,0.08395982160723689
SIM,1892,65,na,1957,26
STAT,1834,27,30-34,1861,0.23335068500077144
STAT,1897,46,35-39,1943,0.0010516858882273564
STAT,1818,37,15-19,1855,7.70406753459637E-4
STAT,1835,84,na,1919,1.4962952612486606
STAT,1813,42,35-39,1855,0.061776534697562696
SIM,1842,27,30-34,1869,1
STAT,1809,53,25-29,1862,1.1354255820155273E-4
STAT,1839,98,na,1937,0.01792727504659613
SIM,1868,25,25-29,1893,1
STAT,1894,28,40-44,1922,0.03825576797867632
STAT,1849,22,45-49,1871,0.006537190119964178
STAT,1855,29,40-44,1884,0.0216691527523383
STAT,1896,37,50-100,1933,0.01612684315178841
STAT,1933,37,30-34,1970,0.024723574306882035
STAT,1830,42,35-39,1872,0.009880979186086618
STAT,1818,47,40-44,1865,0.0016843077166287205
STAT,1896,17,35-39,1913,0.007207492114995273
STAT,1871,51,na,1922,21.569801431657396
STAT,1822,34,na,1856,10.449682704223989
STAT,1826,48,na,1874,17.62709467012152
STAT,1928,36,35-39,1964,0.03044618764624274
STAT,1844,27,15-19,1871,0.00433826832818749
STAT,1847,10,na,1857,32.2269856674677
STAT,1875,65,na,1940,17.37183729569126
STAT,1823,51,50-100,1874,1.0354822328690709E-4
STAT,1865,40,30-34,1905,0.010503529313695137
SIM,1867,82,na,1949,1
STAT,1850,48,20-24,1898,1.0550129632074938E-4
STAT,1893,78,na,1971,14.547518046433808
STAT,1926,44,50-100,1970,0.0014352143156233907
STAT,1874,30,30-34,1904,0.17855110756120204
STAT,1937,31,30-34,1968,0.15498008504995145
STAT,1824,34,35-39,1858,0.15525335116689062
STAT,1874,21,40-44,1895,0.02120388531840271
STAT,1796,92,na,1888,0.023179769685452368
STAT,1862,51,50-100,1913,1.3092462260907658E-4
STAT,1867,30,na,1897,23.019615126818746
STAT,1929,15,45-49,1944,0.006374178178677823
SIM,1854,32,na,1886,17
STAT,1864,27,40-44,1891,0.026867898098285634
STAT,1900,39,50-100,1939,0.003637688510568889
STAT,1857,21,40-44,1878,0.018139033872412006
STAT,1858,1,na,1859,28.21773446867018
STAT,1913,22,30-34,1935,0.27617538056813984
STAT,1821,52,50-100,1873,2.0499283951151315E-4
STAT,1885,28,15-19,1913,0.00446460883084089
STAT,1918,26,25-29,1944,0.6965154287978785
STAT,1859,41,45-49,1900,0.011949373431433173
SIM,1846,13,na,1859,17
STAT,1838,21,30-34,1859,0.18066161894086286
STAT,1855,16,35-39,1871,0.004622229525836557
STAT,1841,34,35-39,1875,0.11779657363313545
SIM,1902,22,20-24,1924,1
STAT,1827,37,40-44,1864,0.03582558141109913
STAT,1891,30,30-34,1921,0.21601677811815176
STAT,1863,32,20-24,1895,0.02393281758290709
STAT,1869,26,50-100,1895,0.006219515132713434
STAT,1881,50,40-44,1931,1.0161471697302444E-4
STAT,1937,26,35-39,1963,0.14549279637102153
STAT,1833,35,15-19,1868,5.306873890023131E-4
STAT,1850,7,na,1857,26.929670142872332
SIM,1852,5,na,1857,29
STAT,1834,47,50-100,1881,0.0018406655145851555
STAT,1835,37,15-19,1872,3.149245414845205E-4
STAT,1873,58,na,1931,20.106087693007467
STAT,1875,28,30-34,1903,0.2579441950044139
SIM,1909,55,na,1964,33
SIM,1833,54,na,1887,11
STAT,1907,47,30-34,1954,7.949864299362971E-4
STAT,1849,19,15-19,1868,0.05597674978775721
STAT,1788,73,na,1861,5.834148248995132
STAT,1859,11,na,1870,22.1254805053929
SIM,1834,71,na,1905,9
STAT,1897,30,50-100,1927,0.012265135014758899
STAT,1924,47,30-34,1971,0.0010543913634929248
SIM,1909,23,na,1932,40
STAT,1784,91,na,1875,0.2573820928117705
STAT,1867,46,na,1913,21.591216857452192
STAT,1861,46,30-34,1907,8.163561696987868E-4
STAT,1854,42,20-24,1896,9.69525752014058E-4
STAT,1868,24,20-24,1892,0.6627225291268646
SIM,1829,49,na,1878,19
STAT,1838,33,na,1871,20.685977990511986
STAT,1849,18,50-100,1867,4.648464081441932E-4
STAT,1829,39,40-44,1868,0.03928734406667062
STAT,1873,17,40-44,1890,0.0018595618999764692
STAT,1881,77,na,1958,9.264574184500164
STAT,1848,43,35-39,1891,0.011625934139444866
SIM,1857,19,15-19,1876,1
STAT,1939,20,25-29,1959,0.9219206488349556
STAT,1884,43,20-24,1927,0.0015447337678445847
STAT,1902,38,50-100,1940,0.0037184238973113396
SIM,1825,35,na,1860,21
STAT,1850,35,15-19,1885,5.185560103299061E-4
STAT,1891,25,35-39,1916,0.11923090528010079
STAT,1838,16,35-39,1854,0.005658710920534004
STAT,1867,27,50-100,1894,0.006121603881810548
STAT,1840,22,25-29,1862,0.5704496017936531
STAT,1844,37,40-44,1881,0.036132027891082184
STAT,1859,48,40-44,1907,0.0013436289354545963
SIM,1848,63,na,1911,20
STAT,1941,23,45-49,1964,0.01153963130732646
STAT,1861,9,na,1870,23.549025137210307
STAT,1873,51,45-49,1924,1.4825259749698996E-4
STAT,1826,45,25-29,1871,5.956600064049508E-4
STAT,1947,20,na,1967,41.01839714437059
STAT,1885,31,45-49,1916,0.01729087625022755
STAT,1855,20,50-100,1875,0.0034028812748248525
STAT,1870,17,15-19,1887,0.059514737864332756
SIM,1887,34,25-29,1921,1
STAT,1944,24,25-29,1968,0.9894158193470076
STAT,1908,16,15-19,1924,0.08779107202281079
SIM,1805,90,na,1895,1
STAT,1869,40,15-19,1909,1.3515933909741563E-4
STAT,1836,29,30-34,1865,0.3099685084809404
SIM,1904,24,na,1928,30
STAT,1876,38,15-19,1914,5.675025767984106E-4
SIM,1908,38,na,1946,39
STAT,1928,41,30-34,1969,0.0016241692861049207
STAT,1855,29,na,1884,17.263506419323214
SIM,1901,59,na,1960,31
STAT,1942,16,15-19,1958,0.470950535682436
STAT,1874,44,15-19,1918,1.3820845411163178E-4
STAT,1827,105,na,1932,1.7768844406718126E-4
STAT,1865,33,50-100,1898,0.008252352542241747
STAT,1851,15,na,1866,23.84113565765968
STAT,1926,33,20-24,1959,0.029306953502639864
STAT,1856,42,30-34,1898,0.00831832622870283
STAT,1893,36,25-29,1929,0.03647787435078354
STAT,1840,39,50-100,1879,0.011144810278785158
SIM,1881,81,na,1962,1
STAT,1906,22,na,1928,34.3598004898513
SIM,1889,61,na,1950,22
SIM,1888,60,na,1948,27
STAT,1926,21,50-100,1947,0.007972166446443323
SIM,1931,27,20-24,1958,2
SIM,1913,44,na,1957,40
STAT,1856,46,na,1902,16.34487159832466
SIM,1838,26,na,1864,11
SIM,1879,28,40-44,1907,1
STAT,1866,19,15-19,1885,0.05544115320772695
STAT,1921,40,50-100,1961,0.0013165254204416717
STAT,1863,46,40-44,1909,0.0015201043510052472
STAT,1853,27,40-44,1880,0.02180972481031038
STAT,1882,35,35-39,1917,0.06842664541855048
STAT,1919,43,30-34,1962,0.001371258142384448
STAT,1811,50,na,1861,16.453661967588314
SIM,1862,67,na,1929,16
STAT,1812,72,na,1884,5.483581662641248
STAT,1896,43,na,1939,30.24374866208132
STAT,1818,40,45-49,1858,0.017122211528061662
SIM,1831,47,na,1878,9
STAT,1844,49,35-39,1893,0.0010707009418262313
STAT,1815,44,35-39,1859,0.02668333857031033
STAT,1935,26,25-29,1961,0.8936411078289886
STAT,1935,35,na,1970,52.46503688976102
SIM,1876,75,na,1951,18
STAT,1928,15,50-100,1943,0.004719513643669191
STAT,1815,64,na,1879,7.382782003913011
SIM,1950,16,15-19,1966,2
STAT,1819,78,na,1897,4.010811731632639
STAT,1885,27,na,1912,23.567270400996193
STAT,1897,18,40-44,1915,0.0024225073915563446
SIM,1844,21,20-24,1865,1
STAT,1878,89,na,1967,2.8460430480216936
STAT,1837,32,na,1869,13.13591634232443
STAT,1966,4,na,1970,48.80192233729358
STAT,1859,106,na,1965,6.119532298130153E-4
STAT,1916,26,15-19,1942,0.007261752767320711
STAT,1885,38,40-44,1923,0.043014075212999214
STAT,1855,21,30-34,1876,0.14757061828758086
STAT,1904,2,na,1906,38.19599294789725
SIM,1843,32,na,1875,20
STAT,1875,17,15-19,1892,0.061003749834155185
STAT,1800,87,na,1887,0.5389986987755243
SIM,1813,66,na,1879,3
STAT,1895,30,15-19,1925,0.0018636761143951768
STAT,1918,34,25-29,1952,0.09649353686257235
STAT,1865,41,45-49,1906,0.01359817233621783
STAT,1884,30,50-100,1914,0.009049091532912678
STAT,1846,43,25-29,1889,0.005200172093739447
STAT,1852,35,25-29,1887,0.02529516272481856
STAT,1825,45,50-100,1870,0.002328433919574875
STAT,1923,27,20-24,1950,0.20812351209540944
SIM,1897,37,na,1934,39
STAT,1872,16,35-39,1888,0.0056660689054587625
STAT,1910,41,20-24,1951,1.668413483064453E-4
SIM,1847,78,na,1925,7
STAT,1832,42,45-49,1874,0.008231714132009443
SIM,1873,30,na,1903,27
SIM,1890,58,na,1948,23
STAT,1889,41,30-34,1930,0.014139442078584705
STAT,1839,45,35-39,1884,8.076089488080512E-4
STAT,1844,30,45-49,1874,0.016630135645891164
SIM,1843,64,na,1907,18
SIM,1822,70,na,1892,10
STAT,1830,53,na,1883,7.871262387250021
STAT,1924,31,45-49,1955,0.01824972353305971
STAT,1820,48,35-39,1868,0.0011681816808546896
STAT,1881,20,20-24,1901,0.6596447852308787
STAT,1842,43,50-100,1885,0.008096260316867547
STAT,1872,25,25-29,1897,0.43575189693497823
STAT,1836,21,20-24,1857,0.8840674545598626
STAT,1838,37,40-44,1875,0.040997055232649564
STAT,1880,30,30-34,1910,0.18507398704208883
STAT,1916,21,45-49,1937,0.011724789392399924
STAT,1821,49,na,1870,15.728843610592621
STAT,1873,43,45-49,1916,0.01510631162414707
STAT,1852,32,45-49,1884,0.015452507680759254
STAT,1888,40,25-29,1928,0.007579954895956017
STAT,1831,30,35-39,1861,0.10918114345293058
STAT,1897,43,30-34,1940,0.0010525189641720713
STAT,1876,82,na,1958,5.746337617954253
STAT,1906,40,40-44,1946,0.002292113139016931
STAT,1929,24,35-39,1953,0.11776088681148328
STAT,1861,49,35-39,1910,0.0011527558171452136
SIM,1863,52,na,1915,9
STAT,1866,22,45-49,1888,0.006474641004140687
STAT,1922,23,35-39,1945,0.10685698471332576
STAT,1876,41,20-24,1917,0.0016202761526474432
STAT,1856,45,35-39,1901,0.001024317894597625
SIM,1901,43,na,1944,37
STAT,1817,71,na,1888,11.378210706368982
STAT,1851,22,50-100,1873,0.0041112465478730514
STAT,1898,49,30-34,1947,7.212188555490864E-4
STAT,1845,25,50-100,1870,0.004617481816996863
STAT,1780,77,na,1857,6.020026045579944
STAT,1862,31,na,1893,20.67238433562348
STAT,1831,103,na,1934,0.0011646153638876968
STAT,1918,23,na,1941,38.90854017380992
STAT,1939,33,na,1972,38.30040171521107
STAT,1880,38,40-44,1918,0.045803448732172035
STAT,1820,37,30-34,1857,0.05025149164484164
STAT,1848,34,45-49,1882,0.01172173458650125
STAT,1893,44,25-29,1937,5.546698363860475E-4
STAT,1876,23,na,1899,23.946292284472378
STAT,1825,47,na,1872,13.897692960072096
STAT,1840,52,45-49,1892,1.1311262468477153E-4
STAT,1821,33,na,1854,17.71637458559561
STAT,1905,20,30-34,1925,0.2586080876494358
STAT,1884,58,na,1942,19.375549868651724
STAT,1819,48,50-100,1867,0.002182014205543274
STAT,1866,16,50-100,1882,4.65870458018905E-4
STAT,1823,99,na,1922,0.010891403782692223
STAT,1931,29,20-24,1960,0.23439012870525477
STAT,1794,69,na,1863,7.864162211452207
STAT,1908,40,50-100,1948,0.0010935273968420813
STAT,1879,38,40-44,1917,0.04508286618399419
STAT,1849,27,15-19,1876,0.004170223394867608
STAT,1892,24,15-19,1916,0.04050125292064873
SIM,1872,23,25-29,1895,1
STAT,1824,40,45-49,1864,0.020973413106303858
STAT,1859,38,15-19,1897,4.4411216375446553E-4
STAT,1848,11,na,1859,19.22529027433354
STAT,1924,39,30-34,1963,0.021306154072353103
STAT,1937,23,30-34,1960,0.27802532637422933
SIM,1932,39,30-34,1971,1
SIM,1782,72,na,1854,7
SIM,1786,86,na,1872,4
SIM,1825,51,na,1876,17
SIM,1829,65,na,1894,18
STAT,1913,30,30-34,1943,0.15669053389637444
SIM,1950,17,na,1967,58
STAT,1887,36,25-29,1923,0.03157791825265947
STAT,1925,41,na,1966,44.74724355112633
STAT,1864,97,na,1961,0.1117950456785766
STAT,1874,24,45-49,1898,0.007029981298371572
STAT,1891,31,45-49,1922,0.02149050864972944
STAT,1905,53,na,1958,31.13293756267059
STAT,1816,39,30-34,1855,0.07842564014404728
SIM,1865,59,na,1924,13
STAT,1848,40,30-34,1888,0.007618480034325361
SIM,1861,45,na,1906,23
STAT,1826,42,45-49,1868,0.01584308671216903
SIM,1883,29,na,1912,12
STAT,1918,23,20-24,1941,1.1847377003784672
STAT,1862,5,na,1867,24.846896177789645
STAT,1847,24,50-100,1871,0.00526382679543235
SIM,1872,61,na,1933,18
STAT,1860,17,30-34,1877,0.014944408541746041
STAT,1862,19,30-34,1881,0.014163639578127793
SIM,1810,85,na,1895,4
SIM,1960,8,na,1968,52
STAT,1866,34,15-19,1900,0.0013003194525018694
STAT,1795,103,na,1898,3.5130985763659803E-4
STAT,1888,15,35-39,1903,0.00644199628744478
STAT,1825,33,15-19,1858,0.0016338359403219925
STAT,1833,34,na,1867,20.230407576625485
STAT,1852,43,25-29,1895,0.005456188404878741
STAT,1837,48,na,1885,11.148680490863585
STAT,1878,33,50-100,1911,0.009419560910889146
STAT,1943,20,15-19,1963,0.05626114639169915
SIM,1926,23,20-24,1949,2
STAT,1829,40,20-24,1869,0.0014441968616733512
STAT,1843,19,20-24,1862,0.09497585409926386
STAT,1846,35,25-29,1881,0.02487839910815707
STAT,1896,31,20-24,1927,0.03565074817014315
STAT,1833,43,15-19,1876,1.2231154667143845E-4
STAT,1874,33,35-39,1907,0.10230465930108218
SIM,1948,15,20-24,1963,1
STAT,1868,27,25-29,1895,0.40937001352594143
STAT,1937,34,35-39,1971,0.08972427151890047
STAT,1854,45,25-29,1899,3.5558136942959184E-4
STAT,1870,20,45-49,1890,0.006968443987948091
SIM,1949,20,na,1969,38
STAT,1901,27,50-100,1928,0.00895101723247558
STAT,1842,29,30-34,1871,0.23030264374959272
STAT,1879,17,35-39,1896,0.0056791945003760265
STAT,1830,69,na,1899,5.272767467755069
STAT,1867,46,25-29,1913,5.527742648763053E-4
STAT,1900,34,15-19,1934,0.001957834614484669
STAT,1898,41,50-100,1939,9.941344904985916E-4
STAT,1924,20,40-44,1944,0.03965249542472271
STAT,1893,33,45-49,1926,0.021894672127255828
SIM,1871,23,30-34,1894,2
STAT,1872,31,35-39,1903,0.10404056707713512
SIM,1882,33,35-39,1915,2
STAT,1806,52,45-49,1858,4.700736820366645E-4
STAT,1862,18,50-100,1880,4.812496017407168E-4
STAT,1867,14,na,1881,25.43163286447594
STAT,1872,39,45-49,1911,0.02019147766043249
STAT,1948,24,45-49,1972,0.012825080832869148
STAT,1890,17,40-44,1907,0.002221728747694454
STAT,1881,53,45-49,1934,1.3587470936644072E-4
STAT,1868,36,15-19,1904,5.460487072569303E-4
STAT,1880,49,45-49,1929,0.0024298500252902078
STAT,1895,26,50-100,1921,0.008333339923367258
STAT,1852,96,na,1948,0.07348875484698435
STAT,1841,31,30-34,1872,0.20951494656760186
SIM,1873,46,na,1919,27
STAT,1883,8,na,1891,25.24371164747056
SIM,1813,50,na,1863,10
STAT,1849,38,30-34,1887,0.041849668645503574
STAT,1906,38,na,1944,34.326982817188586
STAT,1863,23,30-34,1886,0.1596975892612464
STAT,1932,30,40-44,1962,0.0518700849763985
SIM,1888,76,na,1964,18
STAT,1905,39,20-24,1944,0.002377111019916536
SIM,1792,71,na,1863,4
SIM,1796,85,na,1881,2
SIM,1885,31,na,1916,25
STAT,1901,38,25-29,1939,0.00865261805836251
STAT,1855,37,40-44,1892,0.030820676040107634
STAT,1844,23,20-24,1867,0.6672423280071066
STAT,1893,38,15-19,1931,7.045282762938334E-4
STAT,1872,22,20-24,1894,0.7050921045401934
STAT,1886,40,15-19,1926,1.4469010110567556E-4
STAT,1895,41,30-34,1936,0.0010411559914269859
SIM,1852,52,na,1904,20
SIM,1948,19,na,1967,37
SIM,1904,40,na,1944,27
STAT,1883,20,30-34,1903,0.17400382787268118
STAT,1850,30,45-49,1880,0.01822306103605669
SIM,1908,54,na,1962,35
STAT,1910,11,na,1921,38.9514662127662
STAT,1854,44,na,1898,13.936417416313155
STAT,1808,52,50-100,1860,1.0491255070120767E-4
STAT,1893,33,20-24,1926,0.033938428584961086
STAT,1918,17,35-39,1935,0.00908031838975217
STAT,1887,27,35-39,1914,0.10531880072141404
STAT,1830,104,na,1934,2.3964797882702551E-4
STAT,1829,34,35-39,1863,0.09410188289948532
STAT,1949,17,15-19,1966,0.5244485922941846
SIM,1812,49,na,1861,18
STAT,1860,24,50-100,1884,0.0033686236247033427
STAT,1791,93,na,1884,0.06604357490152034
STAT,1834,52,45-49,1886,1.0515718777205814E-4
STAT,1853,17,15-19,1870,0.04486650918584593
STAT,1867,6,na,1873,26.82006920805506
STAT,1835,40,20-24,1875,8.846091081258702E-4
STAT,1839,42,30-34,1881,0.006686840671370723
STAT,1901,15,15-19,1916,0.08342614623118214
SIM,1833,70,na,1903,3
SIM,1828,59,na,1887,9
STAT,1850,30,na,1880,22.64793755273406
STAT,1899,29,30-34,1928,0.3422596901178548
SIM,1881,65,na,1946,11
SIM,1889,45,na,1934,30
STAT,1894,17,25-29,1911,0.0726243321162133
STAT,1842,38,20-24,1880,0.006714417819370559
SIM,1840,67,na,1907,6
SIM,1803,72,na,1875,4
STAT,1826,42,20-24,1868,0.0016811580174483976
STAT,1774,100,na,1874,8.910186087471169E-4
STAT,1863,80,na,1943,5.47703678686002
STAT,1835,48,30-34,1883,4.5614476179422955E-4
STAT,1891,28,na,1919,29.18821680564049
STAT,1806,71,na,1877,8.515537730889449
STAT,1864,23,25-29,1887,0.5179598280905353
STAT,1795,70,na,1865,8.103013055164206
STAT,1857,33,35-39,1890,0.0754921032383261
STAT,1865,32,30-34,1897,0.15792093392004186
STAT,1799,84,na,1883,1.2446334505174579
STAT,1882,33,45-49,1915,0.016641287672537253
STAT,1910,16,30-34,1926,0.02406314766407211
STAT,1862,105,na,1967,0.001961938193525312
SIM,1893,50,na,1943,34
STAT,1945,1,na,1946,44.777616188911345
SIM,1897,64,na,1961,36
STAT,1815,42,45-49,1857,0.023139243052211662
SIM,1902,25,25-29,1927,1
STAT,1927,15,35-39,1942,0.05214877957506676
SIM,1824,34,na,1858,18
SIM,1871,30,30-34,1901,1
STAT,1843,17,30-34,1860,0.008640210172086155
STAT,1874,43,na,1917,23.277950527059037
STAT,1855,24,35-39,1879,0.04731168863784147
STAT,1940,19,20-24,1959,1.3658629759754408
STAT,1829,47,40-44,1876,0.0014614364387968636
STAT,1894,21,45-49,1915,0.008963797743029552
STAT,1887,42,35-39,1929,0.019740838392611128
STAT,1853,16,25-29,1869,0.043095546249174846
STAT,1878,57,na,1935,20.747783184619774
STAT,1862,17,40-44,1879,0.0018073106766214532
STAT,1861,22,45-49,1883,0.006024484198391401
STAT,1939,31,40-44,1970,0.03967740260645242
STAT,1842,37,30-34,1879,0.04690741628110003
SIM,1879,24,na,1903,16
STAT,1847,19,40-44,1866,0.0024099405526081985
STAT,1909,24,30-34,1933,0.263962692244391
STAT,1946,20,40-44,1966,0.037178299438444314
SIM,1855,33,na,1888,17
STAT,1870,66,na,1936,16.281739647916584
SIM,1824,66,na,1890,15
STAT,1885,34,25-29,1919,0.10028125227485879
STAT,1861,35,15-19,1896,4.767197593417895E-4
STAT,1933,26,15-19,1959,0.009339630029704327
STAT,1924,9,na,1933,47.09726020013232
STAT,1876,49,30-34,1925,9.626177685515764E-4
SIM,1862,6,na,1868,26
STAT,1910,48,40-44,1958,0.0014579457983784046
STAT,1837,43,35-39,1880,0.0102703208692393
STAT,1831,38,45-49,1869,0.020171070763099243
STAT,1868,31,na,1899,23.18778740885884
STAT,1836,24,25-29,1860,0.7186893143163009
STAT,1876,30,40-44,1906,0.04439972226977105
STAT,1853,39,35-39,1892,0.044004593289689885
STAT,1887,20,15-19,1907,0.036223953409640026
STAT,1827,30,45-49,1857,0.01672091867904269
STAT,1858,10,na,1868,21.485652142218402
STAT,1815,48,na,1863,10.704836686213913
SIM,1870,81,na,1951,5
STAT,1854,40,30-34,1894,0.007098081594682896
STAT,1816,70,na,1886,4.867794377454927
STAT,1841,32,45-49,1873,0.020709537806851988
STAT,1853,65,na,1918,10.62109693121318
SIM,1866,76,na,1942,10
STAT,1827,29,40-44,1856,0.0323596308041655
STAT,1818,43,25-29,1861,0.006698283054053377
STAT,1924,35,na,1959,44.150904924232094
SIM,1891,64,na,1955,28
STAT,1899,19,na,1918,34.38845901447699
SIM,1933,21,na,1954,46
SIM,1917,24,30-34,1941,1
STAT,1855,30,20-24,1885,0.019784550265736056
STAT,1949,16,25-29,1965,0.5009208341408349
STAT,1920,42,na,1962,40.66890913029914
STAT,1875,53,45-49,1928,1.4678399093012785E-4
STAT,1919,46,35-39,1965,0.001389742346764171
STAT,1876,48,40-44,1924,0.0017169376237867594
STAT,1816,86,na,1902,0.666111872111143
STAT,1852,32,20-24,1884,0.02395257738201812
STAT,1906,27,20-24,1933,0.17043638123879432
STAT,1917,30,15-19,1947,0.001344132633958038
STAT,1843,49,40-44,1892,7.110564994150493E-4
STAT,1838,33,25-29,1871,0.09776354139719567
STAT,1853,16,50-100,1869,3.725838981378371E-4
STAT,1936,20,na,1956,34.72579269636504
STAT,1912,19,45-49,1931,9.96852407608817E-4
STAT,1836,26,na,1862,27.20998807969112
STAT,1864,22,50-100,1886,0.0037163821721936576
STAT,1883,39,20-24,1922,0.007410231718307477
STAT,1916,21,na,1937,38.05332799356721
SIM,1873,8,na,1881,31
STAT,1926,41,20-24,1967,2.1678359542845243E-4
STAT,1946,21,30-34,1967,0.31768364778783204
SIM,1885,28,40-44,1913,1
STAT,1857,48,30-34,1905,7.155472951429674E-4
STAT,1806,48,50-100,1854,0.008153773681251898
SIM,1818,37,40-44,1855,1
SIM,1838,58,na,1896,4
STAT,1836,85,na,1921,2.6456853192207213
STAT,1863,38,40-44,1901,0.03856606419208764
STAT,1937,20,15-19,1957,0.051545802343407596
STAT,1920,15,25-29,1935,0.09716419991548599
STAT,1863,26,35-39,1889,0.08604921542934918
STAT,1880,27,50-100,1907,0.006726705109001359
STAT,1898,34,35-39,1932,0.1354445717562439
SIM,1923,43,na,1966,38
STAT,1916,49,25-29,1965,5.362634887979547E-4
STAT,1935,18,50-100,1953,0.005085706205729781
SIM,1903,39,na,1942,37
STAT,1920,38,35-39,1958,0.026230618891934343
STAT,1856,17,40-44,1873,0.0015667386928251838
SIM,1852,84,na,1936,13
STAT,1941,31,45-49,1972,0.01641099631664935
STAT,1897,12,na,1909,34.29456929101117
STAT,1845,62,na,1907,10.683981088661437
STAT,1859,34,20-24,1893,0.021300426815514122
STAT,1849,76,na,1925,7.346085509727466
SIM,1868,83,na,1951,5
STAT,1885,0,na,1885,34.63150594243136
STAT,1839,17,40-44,1856,0.001320391875251046
STAT,1853,81,na,1934,3.398603327904234
STAT,1897,44,45-49,1941,0.0013615116036528384
STAT,1921,42,35-39,1963,0.0022503469738644104
STAT,1953,18,50-100,1971,0.004504533987115991
STAT,1845,99,na,1944,0.011070577646294443
STAT,1861,37,40-44,1898,0.03681285157220235
STAT,1852,37,15-19,1889,4.8320556056231077E-4
STAT,1835,47,40-44,1882,8.171469040175588E-4
SIM,1891,80,na,1971,15
STAT,1891,33,50-100,1924,0.011198209501624092
STAT,1822,32,35-39,1854,0.09430552576893661
STAT,1866,39,20-24,1905,0.007027923991819673
SIM,1921,36,na,1957,40
STAT,1867,43,20-24,1910,0.0015087995457155191
STAT,1925,27,30-34,1952,0.4598954281324706
STAT,1801,56,na,1857,10.365477267566504
STAT,1817,54,50-100,1871,4.0348324131204473E-4
STAT,1877,28,40-44,1905,0.030813194008447856
STAT,1884,18,30-34,1902,0.015575053116353522
STAT,1865,50,na,1915,19.754995033326637
STAT,1907,36,15-19,1943,1.781456640749853E-4
SIM,1935,1,na,1936,61
STAT,1901,18,30-34,1919,0.022244088292457026
STAT,1859,44,25-29,1903,0.005035078504951611
STAT,1937,17,50-100,1954,0.0036217803755511065
STAT,1804,85,na,1889,1.0643688668029363
STAT,1846,32,20-24,1878,0.025887840110694497
SIM,1958,1,na,1959,53
STAT,1883,38,30-34,1921,0.05149783941290624
STAT,1883,52,40-44,1935,1.016878191331069E-4
SIM,1871,44,na,1915,23
STAT,1856,43,45-49,1899,0.010763839207290519
STAT,1930,20,na,1950,46.840964750322115
STAT,1946,15,45-49,1961,0.005504457541690428
STAT,1846,49,45-49,1895,0.0018726764971138097
STAT,1892,29,20-24,1921,0.14389539531933726
STAT,1900,22,na,1922,32.795703035249176
SIM,1854,26,35-39,1880,1
STAT,1920,47,50-100,1967,0.00247893765673944
STAT,1904,36,na,1940,34.18872134520908
STAT,1882,30,40-44,1912,0.04189472326884829
STAT,1893,32,50-100,1925,0.011552732731365693
STAT,1808,67,na,1875,3.0015735356304183
STAT,1827,49,35-39,1876,0.0010286097984337735
STAT,1846,41,35-39,1887,0.015044521612773051
STAT,1902,42,25-29,1944,6.280661220529358E-4
STAT,1867,20,35-39,1887,0.05688726193913631
SIM,1819,66,na,1885,4
STAT,1825,63,na,1888,9.81602923387736
SIM,1854,48,na,1902,17
STAT,1816,47,30-34,1863,0.0012200690756947817
SIM,1843,48,na,1891,19
SIM,1902,44,na,1946,31
STAT,1816,48,20-24,1864,1.4897379327995244E-4
STAT,1886,18,40-44,1904,0.0018922211655702556
STAT,1926,36,25-29,1962,0.011975316693932345
STAT,1879,34,25-29,1913,0.10510434676750988
SIM,1815,52,na,1867,11
SIM,1823,71,na,1894,6
SIM,1899,23,na,1922,28
SIM,1928,30,40-44,1958,1
STAT,1825,38,20-24,1863,0.007904344930639108
STAT,1894,18,15-19,1912,0.0758574527300221
STAT,1882,40,30-34,1922,0.0111289473204302
STAT,1861,38,30-34,1899,0.04459707448415326
STAT,1924,48,20-24,1972,1.3034630509292829E-4
SIM,1919,38,na,1957,43
STAT,1878,44,35-39,1922,0.01844280976431578
STAT,1911,32,25-29,1943,0.08942135200103704
SIM,1867,39,na,1906,11
STAT,1817,44,na,1861,23.654140956534125
SIM,1915,24,na,1939,35
STAT,1902,49,45-49,1951,0.001838095569201237
STAT,1827,27,15-19,1854,0.013366561434768807
STAT,1861,30,20-24,1891,0.0229142409389998
STAT,1836,27,40-44,1863,0.03740818495534407
STAT,1846,26,35-39,1872,0.09528393828542588
STAT,1852,47,40-44,1899,0.0014583812415251594
STAT,1884,42,na,1926,22.61653762240644
STAT,1935,19,na,1954,49.82648787891032
SIM,1919,17,na,1936,42
STAT,1800,71,na,1871,5.562829950751585
STAT,1863,104,na,1967,0.004222683891990864
STAT,1921,17,45-49,1938,0.005649696560259222
STAT,1929,21,30-34,1950,0.3628111032471399
STAT,1907,23,45-49,1930,0.01016856390563548
SIM,1836,51,na,1887,4
SIM,1937,21,30-34,1958,1
SIM,1873,51,na,1924,24
STAT,1846,84,na,1930,2.6959960248628017
STAT,1883,23,35-39,1906,0.05649216341203839
STAT,1904,40,30-34,1944,0.001155495770474578
STAT,1851,45,50-100,1896,0.00209410233426599
STAT,1878,46,25-29,1924,5.963608909537988E-4
STAT,1948,21,40-44,1969,0.03836397480128507
STAT,1833,30,45-49,1863,0.016970936923764664
STAT,1950,17,50-100,1967,0.0044025410858699
STAT,1878,41,30-34,1919,0.011923082753898908
STAT,1885,39,30-34,1924,0.05210066857979027
STAT,1951,17,30-34,1968,0.14426581644742875
SIM,1863,25,na,1888,14
STAT,1840,28,45-49,1868,0.010770038480261366
STAT,1844,26,25-29,1870,0.40740807973189425
STAT,1905,21,na,1926,34.236411139175445
SIM,1912,43,na,1955,37
STAT,1927,21,20-24,1948,1.3670976294766328
SIM,1847,62,na,1909,12
STAT,1857,30,30-34,1887,0.1342715113727606
STAT,1866,24,na,1890,21.64530439637281
SIM,1935,21,20-24,1956,1
STAT,1836,47,na,1883,22.72300459148528
STAT,1864,65,na,1929,15.157660508825321
STAT,1909,36,25-29,1945,0.009311964616099263
STAT,1850,14,na,1864,25.738118912640832
STAT,1910,19,35-39,1929,0.008219421673301345
STAT,1827,70,na,1897,8.50287744779688
STAT,1829,41,35-39,1870,0.01624816523068813
STAT,1844,29,40-44,1873,0.028233506716465236
STAT,1832,33,na,1865,12.52698283232182
STAT,1934,30,15-19,1964,0.0017490657171611637
SIM,1877,76,na,1953,5
SIM,1909,39,na,1948,36
STAT,1864,20,20-24,1884,0.6371479548431592
STAT,1930,32,35-39,1962,0.11738246165820768
SIM,1875,10,na,1885,21
STAT,1833,47,30-34,1880,8.394887233923826E-4
STAT,1912,33,50-100,1945,0.008037885666333535
SIM,1830,37,40-44,1867,1
SIM,1832,48,na,1880,22
STAT,1923,42,45-49,1965,0.0019317496871276898
STAT,1843,42,20-24,1885,6.936242473394746E-4
STAT,1941,28,15-19,1969,0.0072464231504310375
SIM,1817,42,45-49,1859,1
SIM,1900,58,na,1958,27
STAT,1856,49,50-100,1905,0.0017420597886660108
STAT,1851,19,30-34,1870,0.01616780540063694
STAT,1903,29,45-49,1932,0.015672725599949977
SIM,1829,81,na,1910,13
STAT,1876,33,45-49,1909,0.01763631534526498
SIM,1905,25,na,1930,40
STAT,1856,41,40-44,1897,0.01636823305332623
STAT,1881,27,40-44,1908,0.02850409168837444
STAT,1835,43,25-29,1878,0.003440727846313645
STAT,1822,37,40-44,1859,0.026882399357916042
STAT,1882,26,50-100,1908,0.006151490315334151
STAT,1895,44,35-39,1939,0.0016104762737293259
SIM,1861,66,na,1927,19
SIM,1952,19,na,1971,32
STAT,1857,47,na,1904,16.76396829597329
STAT,1934,34,na,1968,51.3527681986109
STAT,1896,32,35-39,1928,0.13302265749823908
STAT,1838,24,35-39,1862,0.05792078642295555
STAT,1939,21,50-100,1960,0.006564958353535578
STAT,1861,31,50-100,1892,0.007736705955235553
STAT,1915,41,45-49,1956,0.0016634961758931965
SIM,1872,29,na,1901,26
STAT,1948,17,45-49,1965,0.005679037935684784
SIM,1891,43,na,1934,33
STAT,1870,16,25-29,1886,0.057165582629035816
SIM,1906,10,na,1916,29
STAT,1848,32,na,1880,16.34470226903598
STAT,1822,34,25-29,1856,0.0693575310639226
SIM,1872,20,20-24,1892,1
SIM,1890,79,na,1969,10
STAT,1864,19,40-44,1883,0.0016771277359789933
STAT,1818,51,50-100,1869,1.457081608446174E-4
SIM,1895,57,na,1952,24
STAT,1854,43,35-39,1897,0.010988372855955903
STAT,1911,30,20-24,1941,0.023788293322045535
STAT,1897,42,40-44,1939,0.002071637349736915
SIM,1882,28,na,1910,31
STAT,1908,15,25-29,1923,0.08401226610125152
STAT,1868,31,45-49,1899,0.016944722378165047
STAT,1930,30,30-34,1960,0.2026038406090524
STAT,1818,39,40-44,1857,0.05205582750303706
STAT,1842,22,35-39,1864,0.05522247830428673
STAT,1785,92,na,1877,0.3204610109387205
STAT,1887,33,20-24,1920,0.029379588107951313
STAT,1834,99,na,1933,0.013383872387615429
STAT,1904,42,35-39,1946,0.001799593333915974
STAT,1874,31,45-49,1905,0.017763222629697907
STAT,1860,51,na,1911,17.588418883413524
STAT,1866,27,15-19,1893,0.004178516697389472
STAT,1818,48,30-34,1866,9.384893518117979E-4
STAT,1910,34,50-100,1944,0.007855524601576621
SIM,1893,4,na,1897,39
STAT,1936,28,45-49,1964,0.016425690164865284
SIM,1868,24,na,1892,35
STAT,1886,24,50-100,1910,0.0042033927997020505
SIM,1864,10,na,1874,23
SIM,1950,7,na,1957,63
SIM,1887,75,na,1962,11
STAT,1840,20,35-39,1860,0.05899437941219511
SIM,1911,58,na,1969,38
SIM,1916,15,25-29,1931,1
STAT,1818,40,20-24,1858,0.0018168898340206925
STAT,1844,35,15-19,1879,5.200304087109022E-4
STAT,1885,31,20-24,1916,0.026802190294470386
SIM,1895,24,30-34,1919,1
STAT,1886,15,25-29,1901,0.059052161305112955
STAT,1887,24,30-34,1911,0.1932053306157456
STAT,1846,23,30-34,1869,0.176836187273891
STAT,1942,3,na,1945,41.773980089730514
STAT,1855,33,25-29,1888,0.07266952334928777
STAT,1861,14,na,1875,22.865544009615842
SIM,1799,66,na,1865,13
STAT,1897,41,40-44,1938,0.0020835762416012904
SIM,1899,60,na,1959,25
STAT,1840,15,na,1855,23.564894820993395
STAT,1810,49,na,1859,10.275517374156292
STAT,1835,32,45-49,1867,0.010099833383788823
SIM,1859,47,na,1906,18
STAT,1954,15,50-100,1969,0.004607634378535502
STAT,1820,41,15-19,1861,1.2404841380527154E-4
STAT,1946,24,35-39,1970,0.10397122235188959
SIM,1878,61,na,1939,20
STAT,1923,40,40-44,1963,0.0029112533410661817
STAT,1881,21,35-39,1902,0.05569476885090777
STAT,1850,21,30-34,1871,0.19172984237470472
STAT,1837,48,40-44,1885,8.540354731561455E-4
STAT,1903,38,35-39,1941,0.021596921529720568
STAT,1909,3,na,1912,39.42328769277498
STAT,1932,17,20-24,1949,1.787954065263555
STAT,1780,93,na,1873,0.12526783411046077
STAT,1915,38,15-19,1953,1.913637142053731E-4
STAT,1892,17,15-19,1909,0.07331589392780383
STAT,1957,15,20-24,1972,1.7783541944322834
STAT,1859,41,20-24,1900,0.0012679842831579402
STAT,1910,43,na,1953,34.675921033670825
STAT,1914,57,na,1971,34.54667848858319
STAT,1841,30,40-44,1871,0.05258337135067269
STAT,1907,39,30-34,1946,0.01665730066093563
STAT,1912,16,40-44,1928,0.002813128857854901
STAT,1875,50,40-44,1925,1.0977328867221724E-4
STAT,1870,19,40-44,1889,0.001812702474013638
SIM,1837,63,na,1900,28
SIM,1848,84,na,1932,1
STAT,1896,38,40-44,1934,0.057214874842023936
STAT,1946,19,na,1965,40.50974597949888
STAT,1968,1,na,1969,48.85661129066492
STAT,1909,27,35-39,1936,0.14267846324355207
SIM,1868,22,20-24,1890,1
SIM,1929,16,na,1945,46
STAT,1900,30,45-49,1930,0.02437564071886559
STAT,1852,19,50-100,1871,5.011664498994529E-4
STAT,1914,29,20-24,1943,0.1811884024608614
SIM,1908,2,na,1910,42
STAT,1829,77,na,1906,5.871401051412109
STAT,1838,30,20-24,1868,0.026616490789851056
STAT,1842,33,15-19,1875,0.0012773867275753382
STAT,1881,29,45-49,1910,0.010489506336046867
STAT,1915,4,na,1919,41.74158490647966
STAT,1858,28,30-34,1886,0.19475243419567234
SIM,1908,17,na,1925,41
STAT,1898,31,30-34,1929,0.2364942704007505
STAT,1830,37,na,1867,9.656662315231209
STAT,1863,35,25-29,1898,0.02573444693891736
STAT,1883,57,na,1940,19.515154122219087
SIM,1890,33,45-49,1923,1
STAT,1916,17,25-29,1933,0.0911561016203558
SIM,1924,17,25-29,1941,3
STAT,1845,19,30-34,1864,0.011637495031987619
SIM,1858,62,na,1920,20
STAT,1880,42,25-29,1922,0.006744308576465047
STAT,1898,25,45-49,1923,0.015079614382752998
STAT,1820,36,40-44,1856,0.041957887953468075
STAT,1860,41,45-49,1901,0.012222330240152436
SIM,1829,44,na,1873,20
STAT,1926,42,na,1968,45.523345889132656
SIM,1957,0,na,1957,57
STAT,1944,28,40-44,1972,0.04998744231627732
STAT,1837,40,30-34,1877,0.006777693133050994
STAT,1853,20,45-49,1873,0.005253316523170831
SIM,1894,13,na,1907,32
STAT,1813,51,25-29,1864,1.0756680992977053E-4
STAT,1935,23,20-24,1958,1.5069835588997071
SIM,1941,29,30-34,1970,2
STAT,1815,40,40-44,1855,0.03623203935784126
STAT,1859,49,30-34,1908,7.533186236294341E-4
STAT,1895,42,na,1937,30.072347980579384
SIM,1865,32,na,1897,24
STAT,1811,71,na,1882,8.45698116237914
STAT,1899,56,na,1955,27.921235907986816
STAT,1889,42,45-49,1931,0.018301280502428966
STAT,1913,25,35-39,1938,0.14935163352083777
STAT,1922,30,35-39,1952,0.10332009172644849
SIM,1898,38,na,1936,33
STAT,1851,16,15-19,1867,0.06127493379334261
SIM,1956,9,na,1965,47
STAT,1896,27,na,1923,31.347841832796973
STAT,1857,24,45-49,1881,0.005405580252887854
SIM,1885,37,30-34,1922,1
STAT,1827,33,na,1860,17.611000895124665
STAT,1892,13,na,1905,31.855063141701816
SIM,1880,80,na,1960,15
STAT,1885,36,15-19,1921,5.57203618510907E-4
SIM,1839,70,na,1909,16
SIM,1846,77,na,1923,2
SIM,1809,45,na,1854,5
STAT,1824,31,30-34,1855,0.2946258694924262
SIM,1842,63,na,1905,18
STAT,1922,49,25-29,1971,6.013823686350522E-4
STAT,1877,37,30-34,1914,0.055015155966848465
STAT,1844,77,na,1921,6.751724309700946
SIM,1866,28,30-34,1894,1
SIM,1844,33,na,1877,8
STAT,1891,22,30-34,1913,0.2186215146373351
SIM,1848,47,na,1895,30
STAT,1861,33,25-29,1894,0.0857722537162236
STAT,1884,46,25-29,1930,5.659393756941751E-4
STAT,1840,26,40-44,1866,0.02947903397605802
SIM,1885,79,na,1964,11
SIM,1943,23,20-24,1966,3
STAT,1933,29,30-34,1962,0.5176323596992864
STAT,1879,25,35-39,1904,0.10054490729345074
STAT,1907,20,40-44,1927,0.03066281289986739
SIM,1904,3,na,1907,36
STAT,1816,43,15-19,1859,1.85265632457919E-4
STAT,1836,51,50-100,1887,1.504263466562453E-4
STAT,1809,52,na,1861,16.225508017331837
STAT,1837,45,25-29,1882,2.986048366050738E-4
STAT,1856,40,40-44,1896,0.016458921711959132
STAT,1920,20,50-100,1940,0.007296099025129254
STAT,1935,17,35-39,1952,0.057109547070816225
STAT,1859,37,25-29,1896,0.022884345408513952
STAT,1825,29,30-34,1854,0.5215499638604547
SIM,1829,25,25-29,1854,2
STAT,1902,46,40-44,1948,0.0013656986514318113
STAT,1879,31,20-24,1910,0.028091259721385136
STAT,1883,34,15-19,1917,0.0013710547328168667
STAT,1876,50,na,1926,22.18281652218893
STAT,1888,16,25-29,1904,0.06638391774259175
STAT,1846,25,na,1871,21.516960200409574
STAT,1907,47,50-100,1954,0.002017031680660934
STAT,1881,13,na,1894,24.535606848083955
STAT,1861,42,15-19,1903,1.1599154383866164E-4
STAT,1911,37,30-34,1948,0.01749020110913703
STAT,1878,49,40-44,1927,0.00173059482130894
STAT,1868,28,15-19,1896,0.0043752298073793305
SIM,1885,24,25-29,1909,3
STAT,1934,17,30-34,1951,0.1641672733428885
STAT,1790,92,na,1882,0.06998819798084055
SIM,1875,80,na,1955,2
STAT,1929,34,na,1963,47.74914621353831
STAT,1810,51,45-49,1861,1.394697305157574E-4
STAT,1882,42,35-39,1924,0.017332455836789978
STAT,1866,53,50-100,1919,1.3686024098584756E-4
STAT,1858,30,35-39,1888,0.07867847215597355
STAT,1913,21,40-44,1934,0.03240652360591643
STAT,1912,39,15-19,1951,1.8408975710356134E-4
STAT,1916,22,20-24,1938,1.1552094123562582
STAT,1918,16,20-24,1934,0.2941013160676361
STAT,1927,18,50-100,1945,0.004622464439640882
STAT,1828,36,50-100,1864,0.00551978605276007
SIM,1928,37,na,1965,54
SIM,1924,22,20-24,1946,4
STAT,1866,26,15-19,1892,0.00419285626581857
STAT,1784,86,na,1870,0.9800788770729957
STAT,1904,43,35-39,1947,0.0017887957739124779
STAT,1877,24,25-29,1901,0.5872248678423148
SIM,1914,39,na,1953,36
STAT,1840,25,40-44,1865,0.02969222414542215
STAT,1900,27,15-19,1927,0.00629141140018399
STAT,1865,33,45-49,1898,0.015706090419284308
STAT,1919,28,45-49,1947,0.01843971260293009
STAT,1915,40,45-49,1955,0.001665711572284335
SIM,1841,68,na,1909,8
STAT,1825,85,na,1910,1.4778679816318456
STAT,1889,5,na,1894,32.08530812855971
SIM,1848,30,30-34,1878,1
STAT,1933,38,20-24,1971,0.0035723075633720736
STAT,1963,6,na,1969,49.63605361628846
SIM,1854,11,na,1865,19
SIM,1907,25,25-29,1932,1
STAT,1836,63,na,1899,17.22041098104919
STAT,1883,33,50-100,1916,0.00885994331557793
STAT,1922,38,45-49,1960,0.0076924924985990245
SIM,1823,55,na,1878,10
STAT,1875,24,15-19,1899,0.03369976370436261
STAT,1891,20,40-44,1911,0.025728515761796987
STAT,1894,21,20-24,1915,0.8858433203327601
STAT,1929,22,30-34,1951,0.3617190418263659
STAT,1796,71,na,1867,1.2042878055586632
SIM,1849,58,na,1907,7
STAT,1912,42,30-34,1954,0.0012233856682125593
STAT,1952,17,35-39,1969,0.04998800735620921
STAT,1882,31,40-44,1913,0.04173049595363439
STAT,1883,21,45-49,1904,0.006792004467823604
SIM,1930,0,na,1930,58
STAT,1885,43,15-19,1928,1.3538897621899977E-4
SIM,1878,39,na,1917,28
STAT,1935,0,na,1935,61.31496275952829
STAT,1890,27,na,1917,28.989166925660626
STAT,1902,35,25-29,1937,0.008846825633768512
STAT,1865,20,25-29,1885,0.5316808850806966
STAT,1911,12,na,1923,39.26535122766224
STAT,1918,2,na,1920,44.11269843993349
STAT,1945,18,45-49,1963,0.005415962729817237
STAT,1825,39,20-24,1864,0.0077310252355071545
STAT,1905,49,25-29,1954,4.59135560768823E-4
SIM,1853,53,na,1906,21
SIM,1876,31,20-24,1907,1
STAT,1902,48,45-49,1950,0.0018537037548167952
STAT,1883,15,35-39,1898,0.005353169361191301
STAT,1859,36,25-29,1895,0.022994489010876046
STAT,1862,95,na,1957,0.15179734988139199
STAT,1911,33,25-29,1944,0.08904399389559267
STAT,1827,30,20-24,1857,0.02591871214902536
STAT,1868,52,50-100,1920,1.453780847219486E-4
STAT,1886,19,40-44,1905,0.0018870175573649363
SIM,1893,28,na,1921,34
SIM,1835,50,na,1885,17
STAT,1908,44,50-100,1952,0.001067990421155945
STAT,1929,17,35-39,1946,0.05329548801123322
STAT,1817,40,50-100,1857,0.0355111815314447
STAT,1879,23,20-24,1902,0.711047256648924
SIM,1919,4,na,1923,47
STAT,1836,20,45-49,1856,0.009010523417280236
STAT,1896,37,40-44,1933,0.057500075215090776
STAT,1907,16,45-49,1923,9.578526969360694E-4
STAT,1918,38,40-44,1956,0.015619992853680653
STAT,1863,30,30-34,1893,0.15583052067294242
STAT,1828,34,na,1862,19.293240820712228
SIM,1862,30,na,1892,22
STAT,1877,45,na,1922,23.455765772471608
STAT,1840,68,na,1908,11.974821984656408
SIM,1910,48,45-49,1958,1
STAT,1822,38,40-44,1860,0.026238095780525827
STAT,1813,42,50-100,1855,0.03604121936488088
STAT,1847,51,40-44,1898,1.1299832724824688E-4
STAT,1848,41,45-49,1889,0.009791498071563985
STAT,1900,49,35-39,1949,0.0010722212184622736
STAT,1924,36,15-19,1960,2.2517399344168328E-4
STAT,1843,33,na,1876,10.9379986688939
STAT,1846,33,35-39,1879,0.09598743356765357
SIM,1898,43,na,1941,32
STAT,1813,43,25-29,1856,0.02120475771620512
STAT,1815,51,35-39,1866,1.2182982880438075E-4
SIM,1835,30,20-24,1865,1
STAT,1885,64,na,1949,17.16654675411644
STAT,1925,39,25-29,1964,0.01171850896234956
STAT,1898,23,30-34,1921,0.23954536402883195
SIM,1826,79,na,1905,5
STAT,1948,22,40-44,1970,0.03835131468960064
STAT,1879,32,35-39,1911,0.10481614587099675
STAT,1920,43,50-100,1963,0.0012844162387628936
STAT,1880,34,25-29,1914,0.10678428339153022
STAT,1905,22,45-49,1927,0.010064033312408327
STAT,1830,40,20-24,1870,8.955274243138067E-4
STAT,1916,22,50-100,1938,0.006835963872357974
STAT,1930,33,35-39,1963,0.11730968453197957
STAT,1847,20,20-24,1867,0.9155466572258479
STAT,1839,30,25-29,1869,0.07101953596973566
STAT,1853,20,20-24,1873,0.519156666075309
STAT,1874,22,30-34,1896,0.18070408194799212
STAT,1861,30,na,1891,20.22912247493621
STAT,1870,20,20-24,1890,0.6886533740274338
STAT,1896,24,35-39,1920,0.07617128190727053
STAT,1899,25,15-19,1924,0.006253023328178957
STAT,1838,31,35-39,1869,0.09868913862919992
STAT,1913,48,20-24,1961,1.0666442348705771E-4
STAT,1815,85,na,1900,0.9785742134484063
STAT,1857,22,30-34,1879,0.15393819258875352
SIM,1883,9,na,1892,15
STAT,1918,25,35-39,1943,0.15940556739034198
STAT,1885,20,40-44,1905,0.020700700452935133
STAT,1855,31,35-39,1886,0.07335753759981391
SIM,1869,78,na,1947,4
STAT,1859,33,45-49,1892,0.01380170326772629
STAT,1957,15,45-49,1972,0.006552519664227112
SIM,1855,3,na,1858,29
STAT,1917,46,25-29,1963,5.503917036050467E-4
SIM,1838,64,na,1902,4
STAT,1939,27,45-49,1966,0.017248526770323114
STAT,1854,66,na,1920,10.018204001191567
STAT,1935,25,35-39,1960,0.2039246430252586
SIM,1878,45,na,1923,28
SIM,1941,2,na,1943,49
STAT,1844,42,15-19,1886,1.1047472294549706E-4
STAT,1833,22,45-49,1855,0.006939980229964711
STAT,1906,43,na,1949,33.45062247998247
SIM,1783,73,na,1856,1
STAT,1828,50,na,1878,16.12203755661398
SIM,1872,21,35-39,1893,1
STAT,1851,52,45-49,1903,1.2186605763962945E-4
SIM,1846,83,na,1929,2
STAT,1839,28,na,1867,14.931394850513142
STAT,1835,32,20-24,1867,0.015655519846265183
STAT,1928,35,45-49,1963,0.008588230558346052
SIM,1873,20,25-29,1893,3
STAT,1842,97,na,1939,0.040306802958541214
STAT,1844,25,25-29,1869,0.41035442449980275
STAT,1866,51,na,1917,19.92515758854082
SIM,1823,49,na,1872,11
STAT,1834,51,45-49,1885,1.0726056750074784E-4
STAT,1818,49,30-34,1867,9.248425588074227E-4
STAT,1892,35,50-100,1927,0.015311676754576604
STAT,1850,22,45-49,1872,0.007452015400668831
STAT,1903,27,40-44,1930,0.042588925846062935
STAT,1904,17,45-49,1921,9.360000882637301E-4
STAT,1886,28,na,1914,24.667465403615356
STAT,1953,17,40-44,1970,0.01682231411520692
SIM,1841,78,na,1919,4
STAT,1840,29,45-49,1869,0.010692709603973088
SIM,1832,85,na,1917,3
STAT,1885,23,20-24,1908,0.6784182720918533
STAT,1926,24,30-34,1950,0.3450026554592018
STAT,1848,44,50-100,1892,0.006739851685017283
STAT,1851,15,15-19,1866,0.06163798150440353
STAT,1864,21,35-39,1885,0.05356602673149304
STAT,1865,103,na,1968,0.009742293098194613
STAT,1883,3,na,1886,28.879778699902126
STAT,1895,42,30-34,1937,0.0010351901675961092
STAT,1849,23,35-39,1872,0.0543131663487861
STAT,1929,28,15-19,1957,0.008788737662998442
SIM,1833,33,na,1866,13
SIM,1886,74,na,1960,10
STAT,1868,23,45-49,1891,0.0067274445294971345
STAT,1861,20,na,1881,20.72935574833291
STAT,1899,72,na,1971,21.47728298602088
STAT,1949,18,15-19,1967,0.5242807687446501
STAT,1848,39,15-19,1887,3.665429229124745E-4
STAT,1844,30,20-24,1874,0.025777991453623667
STAT,1907,24,20-24,1931,1.0017082057805715
STAT,1854,41,30-34,1895,0.007058971165096193
STAT,1871,41,20-24,1912,0.0015905308522344596
STAT,1943,24,30-34,1967,0.30335251695785403
STAT,1886,12,na,1898,26.787497162135157
STAT,1833,98,na,1931,0.024050354852590283
SIM,1928,15,na,1943,55
SIM,1931,19,na,1950,60
SIM,1896,58,na,1954,23
STAT,1879,58,na,1937,20.46833168301753
STAT,1881,26,40-44,1907,0.028601910221331392
STAT,1873,79,na,1952,7.107751511809158
STAT,1889,34,45-49,1923,0.021167376294246046
STAT,1924,24,20-24,1948,1.2953876794125772
STAT,1944,17,na,1961,39.32336154397344
SIM,1853,63,na,1916,18
STAT,1908,27,30-34,1935,0.37160852269742856
STAT,1894,47,na,1941,28.70468829668929
SIM,1936,8,na,1944,38
STAT,1875,52,45-49,1927,1.4838506579000193E-4
SIM,1878,23,na,1901,26
STAT,1859,27,50-100,1886,0.0051721446115322615
SIM,1915,24,20-24,1939,2
STAT,1824,38,50-100,1862,0.01749713682524288
STAT,1837,49,40-44,1886,8.431571262619397E-4
STAT,1890,36,50-100,1926,0.014985206051820561
SIM,1916,27,30-34,1943,2
STAT,1938,15,35-39,1953,0.04131072194319052
STAT,1849,34,15-19,1883,0.0011396536974365395
STAT,1923,43,45-49,1966,0.0019286975226220277
SIM,1932,24,20-24,1956,3
STAT,1870,15,25-29,1885,0.057504282855052054
STAT,1895,45,25-29,1940,4.2602401068695707E-4
STAT,1806,49,na,1855,16.752161017444266
STAT,1874,80,na,1954,6.275606217730527
STAT,1892,16,15-19,1908,0.07349595902742108
STAT,1927,27,40-44,1954,0.05637552738893437
STAT,1910,28,25-29,1938,0.6294873094367635
SIM,1878,55,na,1933,26
STAT,1876,33,20-24,1909,0.02733764750475612
STAT,1918,49,35-39,1967,0.0013516271517170783
STAT,1945,27,50-100,1972,0.01084157244666893
STAT,1839,43,45-49,1882,0.008594127338207296
STAT,1825,79,na,1904,3.76890004568178
STAT,1894,57,na,1951,25.755267874797955
STAT,1820,48,na,1868,14.435714018917265
STAT,1937,25,45-49,1962,0.01674890458529493
SIM,1861,82,na,1943,2
STAT,1841,16,na,1857,29.149678884296094
STAT,1838,22,20-24,1860,0.6939286082761261
STAT,1909,35,35-39,1944,0.022982039211621126
SIM,1873,24,na,1897,24
STAT,1913,24,45-49,1937,0.011196455984561721
STAT,1848,31,50-100,1879,0.006982146528998944
STAT,1887,47,40-44,1934,0.0018599494534702174
STAT,1868,25,na,1893,23.252153784273872
STAT,1870,29,30-34,1899,0.2483662186161127
STAT,1920,27,30-34,1947,0.4261655294163454
STAT,1931,10,na,1941,51.788790124437114
STAT,1838,25,25-29,1863,0.4237023190857748
STAT,1792,89,na,1881,0.7710326729752799
SIM,1871,50,na,1921,23
STAT,1935,16,20-24,1951,1.8497140995088046
STAT,1901,44,na,1945,32.01410757464673
STAT,1845,83,na,1928,2.320582856356536
STAT,1824,49,30-34,1873,0.001219902509188898
STAT,1872,20,30-34,1892,0.1833373808033231
SIM,1943,16,20-24,1959,2
STAT,1806,50,40-44,1856,3.549014603764916E-4
STAT,1911,16,35-39,1927,0.008363251283837018
STAT,1904,58,na,1962,29.787855429533963
STAT,1854,44,25-29,1898,0.0038721073506320296
STAT,1842,18,15-19,1860,0.05684005953735881
STAT,1859,81,na,1940,4.298087612391919
STAT,1822,39,50-100,1861,0.0071968945726053534
STAT,1882,1,na,1883,32.20546998465997
STAT,1914,17,15-19,1931,0.09310061720164632
SIM,1841,84,na,1925,3
STAT,1830,43,25-29,1873,0.0030850221723586575
STAT,1861,52,na,1913,18.01078874954982
STAT,1898,26,35-39,1924,0.13061081714205863
STAT,1937,24,30-34,1961,0.2779280175099983
SIM,1942,4,na,1946,43
STAT,1912,45,35-39,1957,0.0012351670496033881
STAT,1916,29,30-34,1945,0.398800575811009
STAT,1916,35,50-100,1951,0.004303285761185064
STAT,1835,31,50-100,1866,0.0053659581032926475
SIM,1916,19,30-34,1935,1
STAT,1819,51,na,1870,13.070821749491882
SIM,1893,26,25-29,1919,1
STAT,1877,36,50-100,1913,0.012734508727242971
STAT,1942,19,30-34,1961,0.12636521618703353
STAT,1944,16,50-100,1960,0.004003753142739911
STAT,1855,23,35-39,1878,0.04765384323224903
SIM,1858,2,na,1860,30
STAT,1868,101,na,1969,0.04012212158038277
STAT,1900,46,30-34,1946,7.59323348409842E-4
STAT,1845,15,15-19,1860,0.044366671033223955
STAT,1857,31,45-49,1888,0.013272088634784462
STAT,1848,33,45-49,1881,0.011844083973952169
STAT,1909,48,40-44,1957,0.0014366174520232834
STAT,1844,22,45-49,1866,0.006800615259049238
STAT,1889,33,30-34,1922,0.2128627673210868
SIM,1869,46,na,1915,15
STAT,1844,82,na,1926,3.6444522901759044
SIM,1833,49,na,1882,11
STAT,1865,30,40-44,1895,0.03954034836122159
SIM,1880,0,na,1880,42
STAT,1932,40,45-49,1972,0.002252766464542389
STAT,1831,39,20-24,1870,0.007718060079807256
STAT,1884,20,35-39,1904,0.057514357764492555
STAT,1872,29,40-44,1901,0.030430658009215468
STAT,1871,44,25-29,1915,0.00631588877868651
STAT,1911,25,25-29,1936,0.6420784545636601
STAT,1933,20,50-100,1953,0.008744293433003225
STAT,1944,15,35-39,1959,0.044853256821055405
STAT,1946,23,45-49,1969,0.012428585103082156
STAT,1953,16,na,1969,44.280798849877506
STAT,1931,28,45-49,1959,0.02219477176473513
SIM,1805,68,na,1873,9
STAT,1832,97,na,1929,0.02428300906841554
STAT,1885,26,25-29,1911,0.41916634418635773
STAT,1861,106,na,1967,8.654122612238942E-4
STAT,1946,17,35-39,1963,0.046212949304004367
SIM,1835,34,na,1869,19
STAT,1858,52,45-49,1910,1.0984356013954226E-4
SIM,1803,67,na,1870,4
STAT,1774,92,na,1866,0.045170373122773735
STAT,1845,30,na,1875,15.379172425355653
STAT,1916,43,na,1959,37.67448892960624
STAT,1864,44,na,1908,20.450221700579203
STAT,1820,39,45-49,1859,0.01809563137322101
STAT,1872,95,na,1967,0.540342467233403
SIM,1787,71,na,1858,1
STAT,1879,74,na,1953,11.486422712888594
STAT,1848,32,30-34,1880,0.13167541463260687
STAT,1894,41,na,1935,29.754687774429943
STAT,1928,32,40-44,1960,0.048692722079420485
STAT,1941,2,na,1943,41.579727852560595
SIM,1845,34,na,1879,22
STAT,1807,66,na,1873,9.466874394229402
STAT,1923,19,20-24,1942,1.57247469698698
STAT,1853,36,30-34,1889,0.033845014155842706
STAT,1857,36,15-19,1893,4.224008623681888E-4
STAT,1912,28,35-39,1940,0.14627835810361414
STAT,1873,41,40-44,1914,0.0229716948087384
SIM,1830,35,na,1865,19
STAT,1829,33,35-39,1862,0.0953376749024871
SIM,1821,48,na,1869,14
STAT,1903,45,50-100,1948,0.0019892894334492327
STAT,1774,86,na,1860,0.28096824732325043
STAT,1917,34,30-34,1951,0.1620819723803588
SIM,1876,6,na,1882,34
STAT,1874,23,45-49,1897,0.007052407955670604
STAT,1909,48,30-34,1957,8.122930468080139E-4
STAT,1824,32,45-49,1856,0.02848117568254376
STAT,1933,17,25-29,1950,0.577740792949973
STAT,1940,19,na,1959,37.08202384372009
STAT,1847,96,na,1943,0.0917258532348788
STAT,1844,22,20-24,1866,0.6720677746289425
STAT,1846,30,30-34,1876,0.1707248470377505
STAT,1864,15,25-29,1879,0.05846533137558345
STAT,1877,21,45-49,1898,0.007219910970351237
STAT,1844,39,30-34,1883,0.043086331574082114
SIM,1908,60,na,1968,30
STAT,1891,23,45-49,1914,0.008532226236886237
STAT,1811,54,30-34,1865,2.1705627078857568E-4
SIM,1859,34,25-29,1893,1
STAT,1897,34,50-100,1931,0.012063160427174108
SIM,1852,22,20-24,1874,3
STAT,1874,27,na,1901,24.211073218552244
STAT,1830,40,50-100,1870,0.005957204056875166
STAT,1879,30,50-100,1909,0.009559460669826717
STAT,1935,22,30-34,1957,0.3896489207923063
SIM,1921,1,na,1922,45
SIM,1887,26,25-29,1913,1
STAT,1931,39,25-29,1970,0.012954449624430136
STAT,1898,32,45-49,1930,0.023524176457040327
STAT,1885,23,45-49,1908,0.006864875578587202
STAT,1797,87,na,1884,0.5147941556511114
STAT,1851,29,20-24,1880,0.11430346249115249
STAT,1888,21,20-24,1909,0.8077413493890045
STAT,1915,17,20-24,1932,0.28130172447113594
STAT,1875,38,na,1913,24.097961073525312
STAT,1932,38,15-19,1970,2.5671242734750995E-4
STAT,1857,25,35-39,1882,0.07548077111168523
SIM,1921,42,na,1963,41
STAT,1886,16,15-19,1902,0.061708281264449556
STAT,1899,31,35-39,1930,0.13919935340113115
STAT,1905,16,50-100,1921,7.088076325952896E-4
STAT,1868,47,30-34,1915,9.324101495551783E-4
STAT,1883,19,15-19,1902,0.057320268278639015
STAT,1845,18,40-44,1863,0.001343362709166738
STAT,1927,37,na,1964,46.53661046392045
STAT,1919,4,na,1923,44.2164863507602
STAT,1901,27,20-24,1928,0.16415456015292115
STAT,1904,35,35-39,1939,0.0220826585116008
STAT,1805,49,20-24,1854,2.3434874508759717E-4
SIM,1896,21,20-24,1917,1
SIM,1878,29,na,1907,27
SIM,1912,22,na,1934,40
SIM,1923,17,20-24,1940,3
STAT,1837,38,50-100,1875,0.007207151396511326
STAT,1926,27,35-39,1953,0.1789488460810715
STAT,1863,42,25-29,1905,0.005678643086726888
STAT,1786,71,na,1857,2.5326236987676003
SIM,1845,12,na,1857,24
STAT,1843,98,na,1941,0.013780103123910158
STAT,1926,44,25-29,1970,8.723851777253902E-4
STAT,1879,26,25-29,1905,0.43932643234130775
STAT,1846,46,40-44,1892,0.0013913921612834146
STAT,1795,91,na,1886,0.23173005091325122
STAT,1866,20,30-34,1886,0.16778809664194805
SIM,1931,19,20-24,1950,1
STAT,1907,24,45-49,1931,0.01013622787241556
STAT,1879,35,50-100,1914,0.012827942763770995
STAT,1870,32,15-19,1902,0.0014146615729607247
STAT,1870,23,25-29,1893,0.5669141754171801
STAT,1904,42,na,1946,33.190998380346656
SIM,1888,23,na,1911,33
SIM,1798,65,na,1863,9
STAT,1925,5,na,1930,48.26681570817427
STAT,1924,19,na,1943,43.313105290061515
STAT,1887,23,na,1910,25.73492118910425
SIM,1903,61,na,1964,31
STAT,1841,41,35-39,1882,0.018655472583646228
STAT,1859,30,40-44,1889,0.03497106821738619
STAT,1855,83,na,1938,2.7950656097375837
STAT,1841,32,na,1873,25.738174177627737
STAT,1863,33,35-39,1896,0.08928641521134842
STAT,1870,50,na,1920,21.696695566463674
STAT,1925,15,25-29,1940,0.522628303939658
STAT,1930,25,35-39,1955,0.19017647102313545
SIM,1886,58,na,1944,24
SIM,1891,27,na,1918,35
STAT,1832,40,40-44,1872,0.01269239904511253
SIM,1924,29,30-34,1953,1
STAT,1902,23,30-34,1925,0.25041027248759223
SIM,1897,33,30-34,1930,1
STAT,1859,50,50-100,1909,1.2176421744058524E-4
STAT,1917,46,50-100,1963,0.0023468090860939966
STAT,1940,18,50-100,1958,0.0037758131558768724
STAT,1907,60,na,1967,30.350811044966594
STAT,1880,31,30-34,1911,0.1843484970128839
STAT,1927,17,25-29,1944,0.5360696639485371
SIM,1935,17,25-29,1952,5
STAT,1895,49,40-44,1944,0.0012275616939835378
SIM,1894,45,na,1939,29
SIM,1896,74,na,1970,19
SIM,1805,52,na,1857,14
STAT,1909,32,30-34,1941,0.14950326859819493
STAT,1786,93,na,1879,0.029842048453122178
STAT,1908,19,30-34,1927,0.023394545945125515
STAT,1842,20,45-49,1862,0.006694703841809313
STAT,1840,84,na,1924,2.6067196070420837
STAT,1859,33,20-24,1892,0.02139370336217319
STAT,1887,31,30-34,1918,0.19135297328524437
STAT,1911,22,na,1933,35.959007195280876
STAT,1908,17,15-19,1925,0.08757598389635485
SIM,1808,66,na,1874,7
STAT,1839,40,40-44,1879,0.014749518755751053
SIM,1846,25,25-29,1871,1
SIM,1919,34,30-34,1953,1
STAT,1844,33,25-29,1877,0.09468369645384776
STAT,1850,39,30-34,1889,0.04721337617521274
SIM,1938,15,na,1953,38
STAT,1907,27,25-29,1934,0.6187646922003758
STAT,1841,36,50-100,1877,0.014306562272573344
STAT,1894,63,na,1957,23.356146685515764
STAT,1905,38,45-49,1943,0.006179128463283899
STAT,1822,41,25-29,1863,0.0037239203027508694
STAT,1950,6,na,1956,46.194814653702444
STAT,1894,37,30-34,1931,0.068303436553881
STAT,1855,61,na,1916,13.156499051770874
STAT,1913,40,35-39,1953,0.001969345575736185
SIM,1833,27,na,1860,11
SIM,1915,27,25-29,1942,2
SIM,1941,19,na,1960,48
STAT,1833,21,30-34,1854,0.1785558998516397
STAT,1827,46,30-34,1873,7.392494756841063E-4
STAT,1836,23,25-29,1859,0.7238868216960788
SIM,1869,25,na,1894,15
STAT,1861,34,15-19,1895,0.001187331949036306
SIM,1923,16,na,1939,36
STAT,1873,38,50-100,1911,0.012420457543575831
STAT,1816,49,na,1865,8.714787226762512
STAT,1884,80,na,1964,8.719912611130884
SIM,1842,69,na,1911,17
STAT,1933,39,35-39,1972,0.03274098545749113
STAT,1824,84,na,1908,2.3147107402307148
STAT,1853,29,30-34,1882,0.1644532691449
SIM,1925,23,na,1948,38
STAT,1855,20,30-34,1875,0.14863783796416355
STAT,1931,17,15-19,1948,0.5913914799745859
STAT,1908,36,20-24,1944,0.00246709612002113
SIM,1911,23,25-29,1934,1
STAT,1901,60,na,1961,28.01652127072029
STAT,1855,25,25-29,1880,0.34609461358716537
SIM,1870,9,na,1879,27
STAT,1869,96,na,1965,0.2940641715150124
STAT,1826,52,50-100,1878,1.4675967252137656E-4
STAT,1876,36,25-29,1912,0.029383189272540345
STAT,1921,18,35-39,1939,0.04733312135397983
STAT,1952,16,20-24,1968,1.6155410908684666
STAT,1879,4,na,1883,29.752716745239876
STAT,1900,22,45-49,1922,0.00966963264919447
STAT,1809,45,25-29,1854,0.0020247730631068003
SIM,1927,36,na,1963,49
SIM,1876,81,na,1957,7
STAT,1843,41,45-49,1884,0.006620939039878522
STAT,1937,22,40-44,1959,0.032536136844805906
SIM,1861,29,30-34,1890,1
STAT,1924,27,25-29,1951,0.7613839519891318
STAT,1920,20,20-24,1940,1.2329676435819616
STAT,1830,91,na,1921,0.2082019285097181
STAT,1844,46,30-34,1890,7.582467221260938E-4
STAT,1854,41,20-24,1895,9.751131503656532E-4
SIM,1863,25,25-29,1888,2
STAT,1897,31,25-29,1928,0.13657306933266813
STAT,1887,7,na,1894,28.437664360230603
SIM,1913,38,na,1951,40
STAT,1940,29,25-29,1969,0.6657628459092415
SIM,1851,46,na,1897,17
STAT,1860,19,20-24,1879,0.1642735462438368
STAT,1829,34,50-100,1863,0.008513860939598827
STAT,1894,73,na,1967,18.62223954021087
SIM,1932,27,25-29,1959,3
SIM,1946,18,na,1964,49
STAT,1889,31,40-44,1920,0.053312777888728485
STAT,1903,23,25-29,1926,0.8113649647743575
STAT,1914,28,45-49,1942,0.01721091386406458
STAT,1837,30,15-19,1867,8.903417909129358E-4
STAT,1815,46,50-100,1861,0.003590676861788442
STAT,1926,21,na,1947,44.24457679777463
SIM,1939,30,50-100,1969,1
STAT,1883,26,15-19,1909,0.0044209408820354
SIM,1939,21,na,1960,29
STAT,1846,42,25-29,1888,0.005267223853393142
STAT,1848,35,35-39,1883,0.04812569450657116
STAT,1941,16,45-49,1957,0.0051094738619561295
STAT,1890,41,40-44,1931,0.02744564445017042
SIM,1940,18,na,1958,33
STAT,1830,40,30-34,1870,0.006482839723178332
STAT,1934,26,20-24,1960,0.24462974888783265
SIM,1848,57,na,1905,27
STAT,1922,38,20-24,1960,0.002974561739522995
STAT,1926,26,20-24,1952,0.21831792313589127
STAT,1929,23,45-49,1952,0.014116948664325156
STAT,1906,16,na,1922,36.782522793969775
STAT,1869,74,na,1943,10.753200952508235
STAT,1875,9,na,1884,27.323977915150966
SIM,1807,65,na,1872,14
STAT,1829,30,30-34,1859,0.1715152521715527
STAT,1889,36,35-39,1925,0.08701281109617305
SIM,1908,44,na,1952,38
STAT,1881,15,25-29,1896,0.054171909223876005
STAT,1945,18,na,1963,39.90633956211117
STAT,1860,8,na,1868,23.024596658666255
STAT,1933,33,50-100,1966,0.011089840801390957
STAT,1863,20,15-19,1883,0.030224052669631615
STAT,1874,59,na,1933,19.71627680875166
STAT,1895,26,na,1921,31.08948886210125
SIM,1884,14,na,1898,26
STAT,1875,18,50-100,1893,5.022887261761078E-4
STAT,1917,29,25-29,1946,0.6791058206205959
STAT,1910,17,20-24,1927,0.2669974570742625
STAT,1827,39,30-34,1866,0.04238025197117505
STAT,1907,49,35-39,1956,0.0011371199674610067
STAT,1947,21,50-100,1968,0.007388199663862406
STAT,1926,36,na,1962,45.75786510211811
STAT,1876,40,45-49,1916,0.015353941539535858
SIM,1868,77,na,1945,11
SIM,1914,4,na,1918,38
STAT,1813,47,40-44,1860,0.005306139437272478
SIM,1943,0,na,1943,52
STAT,1874,32,35-39,1906,0.10273821456655303
SIM,1891,70,na,1961,27
STAT,1905,27,15-19,1932,0.00654802268199835
SIM,1877,8,na,1885,31
STAT,1875,30,35-39,1905,0.10493715545999624
SIM,1862,83,na,1945,8
STAT,1874,20,40-44,1894,0.02126619527054541
STAT,1928,15,40-44,1943,0.017619521887658703
STAT,1840,29,20-24,1869,0.11297905896584198
STAT,1845,67,na,1912,9.26637237553302
SIM,1926,24,20-24,1950,3
SIM,1958,13,na,1971,53
STAT,1807,49,30-34,1856,0.002001907925036421
SIM,1909,27,25-29,1936,1
STAT,1935,34,25-29,1969,0.1271400781376847
STAT,1941,10,na,1951,40.404647540438766
STAT,1949,20,50-100,1969,0.0076341772196159485
STAT,1835,35,25-29,1870,0.016500081297524394
STAT,1882,78,na,1960,9.130867063488429
STAT,1894,19,50-100,1913,6.245087734757356E-4
STAT,1937,27,35-39,1964,0.14542732461265453
STAT,1851,23,15-19,1874,0.03302117408156305
STAT,1910,26,35-39,1936,0.14458736922107038
SIM,1832,64,na,1896,18
STAT,1870,34,na,1904,23.502385859328907
SIM,1883,30,35-39,1913,1
STAT,1816,102,na,1918,8.801636007502828E-4
STAT,1855,67,na,1922,11.161040289050293
STAT,1836,25,15-19,1861,0.005748019388328638
STAT,1919,17,40-44,1936,0.01532292825280374
STAT,1826,49,40-44,1875,0.0016781559257637068
STAT,1840,31,na,1871,20.900347318053065
STAT,1948,0,na,1948,50.36209152047663
STAT,1856,30,25-29,1886,0.07668544523332277
STAT,1869,19,40-44,1888,0.0017756608038421735
STAT,1833,24,35-39,1857,0.05724568505749307
SIM,1899,44,na,1943,28
STAT,1884,42,45-49,1926,0.014645308317610309
STAT,1950,17,25-29,1967,0.5092273550420803
SIM,1921,26,na,1947,41
SIM,1888,81,na,1969,16
STAT,1863,86,na,1949,1.964486433884954
STAT,1820,91,na,1911,0.32852056366497295
STAT,1918,24,20-24,1942,1.1809702344912634
STAT,1925,28,20-24,1953,0.2134965837567756
SIM,1951,3,na,1954,52
STAT,1886,28,50-100,1914,0.00661195734571286
STAT,1900,49,25-29,1949,4.411424397157532E-4
STAT,1867,42,45-49,1909,0.014304623227927846
STAT,1921,32,30-34,1953,0.17396298159989804
STAT,1940,18,45-49,1958,0.005034417541169164
STAT,1872,36,40-44,1908,0.045004877825002385
STAT,1836,20,20-24,1856,0.8904609642834174
SIM,1877,44,na,1921,27
STAT,1831,28,40-44,1859,0.03233249869964213
STAT,1911,38,45-49,1949,0.0065096236601231
STAT,1842,47,50-100,1889,0.0018429929951380621
STAT,1936,17,40-44,1953,0.013310260584126916
STAT,1900,35,15-19,1935,7.860804613281885E-4
STAT,1927,39,35-39,1966,0.029855055878535233
SIM,1934,26,20-24,1960,1
STAT,1861,25,25-29,1886,0.3635220699007776
STAT,1857,107,na,1964,2.0855071158408557E-4
STAT,1811,43,15-19,1854,5.88756342034376E-4
STAT,1864,59,na,1923,17.431374672675695
SIM,1844,20,20-24,1864,3
STAT,1898,37,15-19,1935,7.575255240024777E-4
STAT,1942,28,20-24,1970,0.19009833630978348
STAT,1914,36,20-24,1950,0.0026227301281774597
SIM,1856,45,na,1901,10
SIM,1867,12,na,1879,18
STAT,1806,50,na,1856,16.567945626863587
STAT,1922,27,50-100,1949,0.011180499843712435
STAT,1906,43,45-49,1949,0.0014990008279442413
STAT,1863,96,na,1959,0.13317356969737976
STAT,1888,24,25-29,1912,0.6647832158934976
STAT,1911,22,20-24,1933,1.0477691061695944
STAT,1850,46,na,1896,20.08866658281966
STAT,1853,32,15-19,1885,9.216702729292068E-4
SIM,1887,59,na,1946,20
STAT,1902,39,40-44,1941,0.013189984440911986
STAT,1887,40,20-24,1927,0.0017509477361416974
STAT,1840,16,50-100,1856,4.999857897714898E-4
SIM,1890,26,na,1916,27
SIM,1942,25,na,1967,39
STAT,1905,16,35-39,1921,0.007938646955909536
STAT,1913,7,na,1920,40.395452377581684
STAT,1888,22,35-39,1910,0.06819330527481422
STAT,1904,32,30-34,1936,0.14365259742280242
SIM,1828,64,na,1892,7
STAT,1846,31,na,1877,20.972946901851056
STAT,1831,54,na,1885,17.412270741463796
STAT,1854,48,40-44,1902,0.0010332858707921243
STAT,1874,21,50-100,1895,0.004149488622517773
STAT,1829,32,20-24,1861,0.025833505746995257
STAT,1847,21,35-39,1868,0.07697144178538742
STAT,1876,44,na,1920,23.15715338730201
STAT,1923,18,na,1941,42.809082186038324
STAT,1930,22,30-34,1952,0.3664723201041033
STAT,1831,35,40-44,1866,0.04571918523271628
STAT,1855,45,na,1900,15.998372311695535
SIM,1863,31,na,1894,14
STAT,1911,37,40-44,1948,0.014365754222429614
SIM,1863,46,na,1909,11
STAT,1950,21,45-49,1971,0.013269855901372354
STAT,1862,15,15-19,1877,0.059337714103945324
STAT,1866,38,30-34,1904,0.04884096947234262
STAT,1846,39,40-44,1885,0.036285998565958905
STAT,1929,25,35-39,1954,0.18770981354571875
STAT,1890,49,50-100,1939,0.0016476991418337512
STAT,1847,40,25-29,1887,0.007077052354282936
STAT,1932,33,45-49,1965,0.020820822887515907
STAT,1866,21,45-49,1887,0.0065214651237290614
STAT,1956,3,na,1959,51.75935385279692
SIM,1948,23,20-24,1971,3
STAT,1909,26,20-24,1935,0.1755455556186848
STAT,1794,103,na,1897,3.113607212041287E-4
STAT,1902,26,35-39,1928,0.13653484985179445
STAT,1896,23,20-24,1919,0.9023933755652873
STAT,1929,39,45-49,1968,0.008691746891026727
SIM,1868,93,na,1961,1
SIM,1937,20,40-44,1957,2
STAT,1892,48,50-100,1940,0.0016900142792627129
STAT,1922,16,35-39,1938,0.04832527798337066
STAT,1916,38,20-24,1954,0.0026631615258698865
STAT,1944,28,30-34,1972,0.4202142910445242
STAT,1817,51,45-49,1868,4.115873232060115E-4
STAT,1842,25,15-19,1867,0.004270705007884372
SIM,1881,49,na,1930,22
STAT,1878,31,15-19,1909,0.0014762501596984378
STAT,1883,30,35-39,1913,0.09913254829274525
STAT,1925,37,35-39,1962,0.02884863880728987
STAT,1827,42,15-19,1869,1.0801317683823108E-4
STAT,1909,41,20-24,1950,1.6520363194028395E-4
STAT,1902,18,25-29,1920,0.07970208000188511
STAT,1925,15,15-19,1940,0.5473288926567113
STAT,1901,28,35-39,1929,0.13453921276219774
STAT,1857,29,15-19,1886,0.0034483435120229236
SIM,1881,59,na,1940,18
STAT,1962,4,na,1966,50.08466605613275
SIM,1848,79,na,1927,6
STAT,1813,51,na,1864,19.216567733289178
STAT,1822,45,40-44,1867,9.652500501758666E-4
SIM,1895,1,na,1896,34
STAT,1894,33,15-19,1927,0.0018173833371757258
STAT,1812,99,na,1911,0.0075265259134553045
STAT,1915,33,45-49,1948,0.015820800235211725
STAT,1872,50,50-100,1922,1.5674744846979173E-4
STAT,1920,27,40-44,1947,0.05069538393359444
STAT,1862,100,na,1962,0.026815554409584753
STAT,1869,15,25-29,1884,0.05632921154053724
STAT,1790,76,na,1866,2.263740405754733
STAT,1902,32,20-24,1934,0.0381181735199702
STAT,1854,30,15-19,1884,9.10094252891465E-4
STAT,1917,17,30-34,1934,0.025990898836393994
STAT,1868,43,15-19,1911,1.3267856306962758E-4
STAT,1801,66,na,1867,7.656400563528329
STAT,1831,32,na,1863,22.777456805264535
STAT,1916,25,25-29,1941,0.6793190874455506
STAT,1855,22,20-24,1877,0.5668247321766159
STAT,1920,23,25-29,1943,1.0150053152131742
STAT,1906,26,45-49,1932,0.016186015671206186
STAT,1872,0,na,1872,37.958902417957304
STAT,1894,24,25-29,1918,0.7290623065341895
STAT,1837,64,na,1901,8.405385217285009
STAT,1861,44,50-100,1905,0.008764369230526847
STAT,1880,31,20-24,1911,0.02854025671791478
STAT,1834,23,15-19,1857,0.03095611778354043
STAT,1912,5,na,1917,40.20781298364567
STAT,1840,18,40-44,1858,0.0018446901120891628
STAT,1920,28,45-49,1948,0.018724057916113826
STAT,1921,15,30-34,1936,0.13849310749318222
STAT,1872,32,25-29,1904,0.10479927560947448
STAT,1905,29,50-100,1934,0.009166320082259935
SIM,1918,22,na,1940,34
STAT,1827,33,25-29,1860,0.08786315471336678
STAT,1872,27,50-100,1899,0.006545141918377701
STAT,1903,16,25-29,1919,0.08076362934055542
SIM,1839,27,na,1866,23
STAT,1929,20,40-44,1949,0.04256897627120566
STAT,1955,15,35-39,1970,0.05541976605425804
STAT,1888,42,50-100,1930,0.012330476422372791
STAT,1940,26,20-24,1966,0.18490211384548128
STAT,1877,26,15-19,1903,0.004699466810526047
STAT,1818,50,na,1868,6.751086225128819
STAT,1926,20,15-19,1946,0.06468434425554985
STAT,1865,42,35-39,1907,0.01635841672337186
STAT,1920,26,na,1946,40.88446400756866
STAT,1825,37,30-34,1862,0.055871690837576204
STAT,1952,19,25-29,1971,0.5158993770959865
SIM,1933,17,15-19,1950,1
SIM,1942,29,25-29,1971,1
STAT,1934,29,25-29,1963,0.8808195559609974
SIM,1868,3,na,1871,38
SIM,1895,34,35-39,1929,1
SIM,1903,23,na,1926,34
STAT,1905,59,na,1964,29.911946703791433
SIM,1907,22,20-24,1929,2
SIM,1828,80,na,1908,3
STAT,1800,55,na,1855,9.803899999999999
STAT,1892,28,30-34,1920,0.31000404551603655
STAT,1887,34,35-39,1921,0.10959132953616647
STAT,1870,36,30-34,1906,0.05319823675360916
SIM,1952,5,na,1957,35
STAT,1816,65,na,1881,5.865418637657732
STAT,1913,33,35-39,1946,0.0897791781015897
STAT,1880,53,40-44,1933,1.0892635545675494E-4
STAT,1871,30,50-100,1901,0.009208399629231642
STAT,1928,18,45-49,1946,0.006247172748220041
SIM,1913,7,na,1920,47
STAT,1809,79,na,1888,4.064737502292078
STAT,1868,34,25-29,1902,0.09827367652983188
STAT,1852,39,40-44,1891,0.03708771315997118
SIM,1903,25,30-34,1928,1
STAT,1866,23,35-39,1889,0.05379348733221355
STAT,1911,45,50-100,1956,0.0021374577713065457
SIM,1933,11,na,1944,54
STAT,1926,29,25-29,1955,0.7789142376771697
STAT,1797,101,na,1898,0.001222331470135837
SIM,1832,32,na,1864,24
STAT,1891,32,35-39,1923,0.12429594194855945
STAT,1847,23,25-29,1870,0.7442798577330408
STAT,1868,31,20-24,1899,0.026265625124728628
STAT,1903,20,20-24,1923,0.9855975468391486
SIM,1893,44,na,1937,35
STAT,1935,31,20-24,1966,0.0336155287348276
STAT,1905,37,na,1942,34.27074102233776
STAT,1897,8,na,1905,34.52081454844794
STAT,1918,38,30-34,1956,0.01901722750536889
STAT,1860,20,50-100,1880,0.003810035572687881
STAT,1880,34,na,1914,24.878488655651946
SIM,1925,26,20-24,1951,2
SIM,1947,18,20-24,1965,3
STAT,1813,104,na,1917,4.4019061264436316E-4
STAT,1856,31,50-100,1887,0.00678898474237693
STAT,1895,58,na,1953,25.674262759321543
STAT,1908,39,25-29,1947,0.009078410868077617
STAT,1893,49,30-34,1942,6.741052207840203E-4
STAT,1924,16,45-49,1940,0.005924527523159108
SIM,1814,51,na,1865,22
SIM,1832,69,na,1901,18
SIM,1903,45,na,1948,35
STAT,1834,46,na,1880,17.078276349820833
STAT,1898,41,35-39,1939,0.0017039985030632167
STAT,1872,63,na,1935,18.256469410157937
STAT,1888,9,na,1897,30.32083129785764
STAT,1917,26,20-24,1943,0.1903431278769772
STAT,1849,40,35-39,1889,0.014286288669710724
SIM,1918,37,na,1955,36
STAT,1921,29,15-19,1950,0.0077507115252259794
STAT,1939,18,20-24,1957,1.3473330116927207
STAT,1918,22,30-34,1940,0.3071764230599428
SIM,1872,67,na,1939,13
STAT,1939,24,40-44,1963,0.03351306374313113
SIM,1855,27,na,1882,18
STAT,1918,27,25-29,1945,0.6941333460313902
SIM,1920,41,na,1961,43
SIM,1934,22,na,1956,52
STAT,1851,27,30-34,1878,0.248917310799209
SIM,1899,1,na,1900,32
STAT,1854,82,na,1936,2.8519152156089023
STAT,1804,50,30-34,1854,1.7012156099769455E-4
STAT,1881,19,40-44,1900,0.0017310686275014064
STAT,1914,39,25-29,1953,0.009651112296134178
STAT,1838,27,na,1865,21.3578602650297
STAT,1884,44,50-100,1928,0.010210894184312608
STAT,1885,47,30-34,1932,9.514578138612512E-4
SIM,1913,23,na,1936,40
STAT,1834,29,20-24,1863,0.1071552283151019
STAT,1796,86,na,1882,0.14418254292866553
STAT,1831,37,50-100,1868,0.012554651181497636
STAT,1875,81,na,1956,5.928256945019242
STAT,1917,22,na,1939,38.459059378858534
STAT,1824,41,35-39,1865,0.024954602822679285
STAT,1853,23,25-29,1876,0.42204058801164235
STAT,1928,29,50-100,1957,0.012190579597135003
STAT,1901,25,30-34,1926,0.35475305746003394
SIM,1909,24,20-24,1933,3
STAT,1930,40,35-39,1970,0.0026443997038939205
STAT,1882,20,25-29,1902,0.5518830766992406
STAT,1909,44,25-29,1953,6.560122764698729E-4
STAT,1887,43,25-29,1930,0.0069585608705936405
SIM,1841,46,na,1887,16
STAT,1874,25,35-39,1899,0.09855165130572734
STAT,1896,21,30-34,1917,0.23467712899246662
STAT,1830,47,40-44,1877,1.6987995299018807E-4
SIM,1922,37,na,1959,48
STAT,1822,48,45-49,1870,0.0012793849721946945
STAT,1849,20,30-34,1869,0.1694090354838002
SIM,1902,60,na,1962,30
STAT,1917,43,20-24,1960,1.823374888179714E-4
SIM,1944,26,30-34,1970,1
STAT,1895,1,na,1896,35.33677399353492
STAT,1886,22,na,1908,24.53185246228432
SIM,1901,38,na,1939,38
STAT,1861,22,20-24,1883,0.5953669681743162
STAT,1899,18,15-19,1917,0.08102721220041106
STAT,1930,42,50-100,1972,0.0015385060257052273
STAT,1793,68,na,1861,3.85138112960483
SIM,1802,66,na,1868,10
STAT,1806,65,na,1871,11.280873778304253
SIM,1914,19,20-24,1933,1
STAT,1907,31,45-49,1938,0.014706426891639219
SIM,1878,20,25-29,1898,2
STAT,1917,37,35-39,1954,0.024894405893490956
STAT,1867,101,na,1968,0.03550165129974551
STAT,1852,44,15-19,1896,1.1659582056479087E-4
STAT,1925,17,15-19,1942,0.5447976831673261
STAT,1930,19,50-100,1949,0.004795201332676729
STAT,1836,53,na,1889,20.61310849734715
SIM,1837,30,30-34,1867,1
STAT,1841,23,50-100,1864,0.0050201469797369015
SIM,1819,50,na,1869,7
STAT,1906,19,20-24,1925,0.25618165323945574
STAT,1938,21,na,1959,35.91550210985887
SIM,1853,31,na,1884,22
SIM,1900,47,25-29,1947,1
STAT,1831,31,25-29,1862,0.10923056026130844
STAT,1858,107,na,1965,2.483839201220562E-4
STAT,1872,53,40-44,1925,1.0598628058811376E-4
STAT,1895,42,20-24,1937,1.4299924478278206E-4
SIM,1929,5,na,1934,51
STAT,1954,17,na,1971,45.24314290952972
STAT,1944,17,25-29,1961,0.4629712053991314
SIM,1878,31,30-34,1909,1
STAT,1850,31,35-39,1881,0.09530914272920991
STAT,1942,15,25-29,1957,0.4498093037171836
SIM,1952,17,25-29,1969,1
STAT,1821,54,na,1875,14.357149085362964
STAT,1811,47,30-34,1858,0.0038333937043337992
STAT,1857,40,35-39,1897,0.013692681382318748
SIM,1861,23,25-29,1884,2
SIM,1884,36,25-29,1920,2
STAT,1902,15,20-24,1917,0.25116694440268567
SIM,1855,37,50-100,1892,1
STAT,1848,30,40-44,1878,0.03339240550232836
STAT,1856,21,35-39,1877,0.04945255628793039
STAT,1915,30,40-44,1945,0.03982913226358934
SIM,1950,15,25-29,1965,2
STAT,1833,39,30-34,1872,0.048317911333179385
STAT,1865,45,na,1910,20.55240106613409
STAT,1824,68,na,1892,10.633383423884148
SIM,1791,76,na,1867,3
STAT,1912,26,45-49,1938,0.016949691521342257
STAT,1800,101,na,1901,0.002067837095449519
STAT,1871,41,30-34,1912,0.011514060105649043
STAT,1932,16,45-49,1948,0.006604071300302294
SIM,1823,65,na,1888,6
STAT,1806,87,na,1893,0.8243832815552842
STAT,1862,32,15-19,1894,0.0012286430416072842
SIM,1935,6,na,1941,60
STAT,1872,23,35-39,1895,0.059522399032823345
STAT,1868,20,40-44,1888,0.02045869430866607
STAT,1921,35,35-39,1956,0.0268430558406073
SIM,1879,21,20-24,1900,2
STAT,1915,15,50-100,1930,7.809744928684569E-4
STAT,1928,44,35-39,1972,0.0025460053336168174
STAT,1871,45,na,1916,22.65454719688961
SIM,1871,82,na,1953,5
STAT,1936,14,na,1950,37.58316273035292
STAT,1886,44,na,1930,23.650111344863504
STAT,1829,35,25-29,1864,0.027019088932881803
STAT,1943,27,35-39,1970,0.15873083020177553
STAT,1925,19,30-34,1944,0.1455341277665786
SIM,1911,27,30-34,1938,1
STAT,1811,48,50-100,1859,0.00957512169929365
STAT,1896,26,25-29,1922,0.5575512155463815
STAT,1775,87,na,1862,0.8272997666372913
STAT,1877,49,50-100,1926,0.0024822994182111557
STAT,1861,100,na,1961,0.02277706793085429
STAT,1903,27,30-34,1930,0.35801942350876304
SIM,1854,16,na,1870,18
SIM,1904,30,30-34,1934,1
STAT,1829,47,50-100,1876,0.002096546665341003
SIM,1854,10,na,1864,19
STAT,1900,39,30-34,1939,0.01579104715036877
STAT,1925,47,35-39,1972,0.0015525414678959507
STAT,1842,21,35-39,1863,0.0556218431380177
STAT,1875,39,25-29,1914,0.02929860643182477
STAT,1880,20,15-19,1900,0.03489797546535854
STAT,1845,22,15-19,1867,0.02394034632856902
STAT,1872,38,45-49,1910,0.020295594057949774
STAT,1921,17,50-100,1938,0.004237272420194419
SIM,1872,35,na,1907,23
STAT,1874,25,45-49,1899,0.011340347976469605
STAT,1932,23,50-100,1955,0.008571959120523448
STAT,1856,34,40-44,1890,0.03114764398024605
STAT,1859,35,20-24,1894,0.006185024453249207
STAT,1796,70,na,1866,1.3240188281920724
SIM,1860,8,na,1868,28
STAT,1831,42,40-44,1873,0.022279326416925583
STAT,1915,34,45-49,1949,0.015751821546186203
SIM,1912,20,25-29,1932,1
STAT,1889,40,30-34,1929,0.014217782057722759
SIM,1924,22,na,1946,47
STAT,1849,27,na,1876,19.88377912470999
STAT,1839,37,45-49,1876,0.013146546903112132
STAT,1941,31,35-39,1972,0.09530515423237934
STAT,1911,18,25-29,1929,0.08593313949938379
STAT,1841,47,na,1888,22.121608961310116
STAT,1920,25,40-44,1945,0.051039318064149755
STAT,1918,44,40-44,1962,0.0026265326103593663
STAT,1869,21,45-49,1890,0.006777036293927897
STAT,1784,85,na,1869,1.2110204832237683
STAT,1934,27,35-39,1961,0.20111345956315435
STAT,1822,44,40-44,1866,0.012484107995494792
STAT,1858,63,na,1921,13.577568345766693
STAT,1935,34,15-19,1969,0.0017676874165378936
SIM,1877,82,na,1959,5
STAT,1825,45,20-24,1870,1.1376713412526059E-4
STAT,1930,29,15-19,1959,0.008925672186670343
STAT,1932,31,40-44,1963,0.05184155642966147
SIM,1876,25,20-24,1901,1
STAT,1814,45,45-49,1859,0.006969383004547072
STAT,1833,21,40-44,1854,0.0208887518501457
STAT,1920,16,25-29,1936,0.48324164841776235
STAT,1808,48,25-29,1856,4.099046356914508E-4
STAT,1861,16,20-24,1877,0.17237593118990222
STAT,1902,41,25-29,1943,6.316856810050952E-4
SIM,1912,37,na,1949,37
STAT,1948,18,20-24,1966,1.5407979924555186
SIM,1781,77,na,1858,7
STAT,1904,20,25-29,1924,0.8251612166569944
SIM,1942,27,35-39,1969,1
STAT,1936,19,na,1955,34.83849198308649
SIM,1933,29,35-39,1962,2
STAT,1862,28,50-100,1890,0.005499612654922758
STAT,1868,28,25-29,1896,0.40792903107833
SIM,1795,73,na,1868,8
STAT,1892,36,20-24,1928,0.009568961405671764
STAT,1836,42,15-19,1878,1.5854930352606535E-4
STAT,1853,32,na,1885,15.444335956918314
STAT,1883,38,20-24,1921,0.007448442226931637
STAT,1885,65,na,1950,16.688630092481837
STAT,1844,19,25-29,1863,0.05560442058942488
SIM,1835,24,20-24,1859,3
SIM,1901,65,na,1966,29
STAT,1848,35,45-49,1883,0.013564116698681605
SIM,1907,15,20-24,1922,2
STAT,1926,34,20-24,1960,0.02928731784379311
STAT,1909,37,25-29,1946,0.00926736030558815
STAT,1946,20,30-34,1966,0.31779805508766357
STAT,1954,15,40-44,1969,0.017201839196256275
STAT,1912,21,15-19,1933,0.05076892971847328
STAT,1906,41,40-44,1947,0.0022794835956209485
STAT,1865,27,45-49,1892,0.01004255120428159
STAT,1883,22,35-39,1905,0.056667265261697
STAT,1902,34,35-39,1936,0.08129974597914416
SIM,1896,73,na,1969,20
STAT,1937,18,45-49,1955,0.004816388414622887
STAT,1944,18,na,1962,39.31077806827938
STAT,1866,46,20-24,1912,1.1083157109258289E-4
STAT,1850,54,45-49,1904,1.2566015661676203E-4
STAT,1866,40,35-39,1906,0.016845540457759944
STAT,1934,18,20-24,1952,1.8212403192897642
SIM,1868,30,na,1898,33
STAT,1907,29,15-19,1936,0.00653364785026062
STAT,1923,7,na,1930,46.6130408534762
STAT,1897,22,35-39,1919,0.07749257250222003
SIM,1922,43,na,1965,48
SIM,1886,59,na,1945,24
SIM,1924,38,na,1962,50
SIM,1851,77,na,1928,9
STAT,1854,6,na,1860,18.241263391362406
STAT,1943,29,25-29,1972,0.6951957351802395
STAT,1805,92,na,1897,0.11403689305508667
SIM,1847,68,na,1915,11
STAT,1826,54,na,1880,15.880634150429184
SIM,1793,62,na,1855,18
SIM,1839,33,na,1872,23
STAT,1905,27,na,1932,34.44329033303928
STAT,1916,36,30-34,1952,0.01859369883867063
STAT,1851,21,na,1872,21.711991149825476
STAT,1877,25,15-19,1902,0.004715168321035094
SIM,1859,41,na,1900,18
STAT,1913,19,15-19,1932,0.09152040252519267
STAT,1805,52,40-44,1857,2.0365485990143987E-4
STAT,1822,40,na,1862,10.071293381308676
STAT,1915,41,35-39,1956,0.0020126960658628217
SIM,1829,43,na,1872,20
STAT,1876,13,na,1889,26.26346661149731
STAT,1835,90,na,1925,0.35461923533261996
STAT,1902,25,20-24,1927,0.16655772766518753
STAT,1929,23,35-39,1952,0.11813656107570403
STAT,1883,2,na,1885,30.612442972124363
STAT,1872,43,40-44,1915,0.022847672781659632
STAT,1891,38,50-100,1929,0.014994128609105449
SIM,1783,72,na,1855,4
STAT,1881,54,45-49,1935,1.3429448649650904E-4
STAT,1903,23,15-19,1926,0.04675838791155267
SIM,1902,26,25-29,1928,1
STAT,1933,19,15-19,1952,0.6018013834952644
SIM,1861,51,na,1912,23
SIM,1898,44,na,1942,31
STAT,1928,25,40-44,1953,0.05753051533170987
STAT,1919,35,na,1954,40.29067490701696
STAT,1932,26,45-49,1958,0.02254666339008527
SIM,1872,39,na,1911,22
STAT,1904,39,15-19,1943,1.7192512648151758E-4
STAT,1941,25,50-100,1966,0.01023081174853288
STAT,1917,36,20-24,1953,0.0027261983386551608
STAT,1869,27,30-34,1896,0.24399785210219307
STAT,1926,16,20-24,1942,1.6567794727311498
STAT,1804,53,35-39,1857,2.3177296790909864E-4
STAT,1858,43,50-100,1901,0.00798094244734971
STAT,1896,47,45-49,1943,0.001740474925185308
SIM,1836,29,na,1865,11
STAT,1850,16,45-49,1866,7.149274284316249E-4
STAT,1892,20,35-39,1912,0.07252210858616764
STAT,1842,37,20-24,1879,0.006784501722160477
STAT,1923,40,na,1963,43.22719076539339
STAT,1877,43,15-19,1920,1.4152371843868035E-4
STAT,1943,16,20-24,1959,1.4276025755584076
STAT,1920,23,15-19,1943,0.05849403698892043
STAT,1835,26,20-24,1861,0.07131088173649996
STAT,1916,29,40-44,1945,0.04744013043796921
STAT,1839,20,20-24,1859,0.49573077401822446
STAT,1942,26,30-34,1968,0.4084313337886498
STAT,1923,15,40-44,1938,0.016386277087885454
STAT,1851,38,25-29,1889,0.02431359211275573
SIM,1925,18,20-24,1943,3
STAT,1815,86,na,1901,0.7920286111387363
SIM,1942,18,20-24,1960,2
STAT,1869,41,15-19,1910,1.3441461113898883E-4
STAT,1946,13,na,1959,43.25408500552542
SIM,1852,15,na,1867,29
SIM,1840,34,na,1874,17
STAT,1903,33,40-44,1936,0.03525378436493407
STAT,1937,20,na,1957,35.36132423131735
SIM,1844,48,na,1892,1
STAT,1910,18,35-39,1928,0.008242087413688993
STAT,1878,20,50-100,1898,0.004235219613382645
STAT,1934,36,20-24,1970,0.003625618926796959
SIM,1918,38,na,1956,36
STAT,1794,75,na,1869,4.716716175025667
SIM,1917,52,na,1969,33
STAT,1894,15,20-24,1909,0.22826305922915818
STAT,1885,17,20-24,1902,0.1750718729659997
STAT,1846,78,na,1924,6.332139882148767
STAT,1917,16,na,1933,41.285685875201025
STAT,1942,19,40-44,1961,0.01450092702576824
SIM,1904,18,na,1922,32
SIM,1847,20,20-24,1867,3
STAT,1917,18,20-24,1935,0.2883380586857549
STAT,1912,23,40-44,1935,0.03187257557520054
STAT,1923,33,40-44,1956,0.044524108339935586
STAT,1921,21,na,1942,41.048351534805946
STAT,1810,55,na,1865,9.19642788035933
STAT,1850,83,na,1933,3.5346328689009523
SIM,1823,50,na,1873,11
SIM,1852,24,20-24,1876,1
STAT,1925,35,na,1960,44.94985547630018
STAT,1814,69,na,1883,7.738880197902616
STAT,1840,35,45-49,1875,0.018863271601988623
SIM,1892,43,na,1935,36
STAT,1889,20,35-39,1909,0.07187191771847812
STAT,1881,36,45-49,1917,0.019060190222368278
STAT,1887,60,na,1947,20.817013736329557
STAT,1870,47,25-29,1917,5.695242309686344E-4
STAT,1886,41,15-19,1927,1.438928586485833E-4
STAT,1871,44,35-39,1915,0.017810127173187904
STAT,1906,44,na,1950,33.23921454590896
STAT,1908,46,20-24,1954,1.001735257827717E-4
SIM,1868,38,50-100,1906,1
SIM,1878,24,na,1902,29
STAT,1844,24,20-24,1868,0.6624515280920155
SIM,1946,21,35-39,1967,2
STAT,1889,28,45-49,1917,0.013545942949790772
STAT,1895,31,15-19,1926,0.0018563705040267487
STAT,1910,36,35-39,1946,0.02310217372110043
STAT,1840,53,45-49,1893,1.1189213946442287E-4
STAT,1908,37,35-39,1945,0.022528402031218225
STAT,1821,86,na,1907,1.3780476757400237
STAT,1835,47,na,1882,10.666312204289929
STAT,1900,43,na,1943,31.927911849248407
SIM,1884,24,na,1908,26
STAT,1876,27,20-24,1903,0.11914998659096242
STAT,1899,41,na,1940,31.892261240788297
STAT,1858,59,na,1917,14.788687157027013
STAT,1938,29,45-49,1967,0.016985886903290733
STAT,1889,33,40-44,1922,0.052871730628316266
STAT,1900,23,45-49,1923,0.00963975348430846
SIM,1886,43,na,1929,26
STAT,1917,45,35-39,1962,0.0013407206189962697
STAT,1927,32,15-19,1959,0.001572687054949588
STAT,1886,23,15-19,1909,0.0341139261198376
SIM,1881,12,na,1893,26
STAT,1834,38,25-29,1872,0.025047345816081874
STAT,1882,36,50-100,1918,0.011822626793445253
STAT,1908,28,20-24,1936,0.17105925528503557
STAT,1844,83,na,1927,3.100845786573267
STAT,1915,21,na,1936,37.53521739839117
STAT,1937,27,50-100,1964,0.009641355846293461
STAT,1820,69,na,1889,8.256566429204602
STAT,1938,21,35-39,1959,0.09260572527578514
SIM,1902,23,na,1925,36
STAT,1846,48,45-49,1894,0.0018885783266239839
SIM,1906,37,na,1943,27
SIM,1964,3,na,1967,52
STAT,1916,39,35-39,1955,0.024310474147364543
STAT,1875,36,20-24,1911,0.007962018826901484
STAT,1814,42,40-44,1856,0.0718745395605536
STAT,1907,17,20-24,1924,0.2593243690951843
STAT,1910,41,30-34,1951,0.0012077862619321016
STAT,1882,24,40-44,1906,0.019845036391473916
SIM,1814,41,na,1855,22
STAT,1869,19,30-34,1888,0.015473614959487078
STAT,1839,46,50-100,1885,0.001398741268182228
STAT,1827,71,na,1898,8.089127431187082
STAT,1892,49,50-100,1941,0.0016757843590313212
SIM,1825,29,na,1854,20
STAT,1921,20,25-29,1941,1.0413376635344593
STAT,1902,4,na,1906,37.097607340957474
STAT,1853,28,na,1881,15.69817518123448
STAT,1804,79,na,1883,3.3706086662578927
SIM,1873,52,na,1925,24
SIM,1795,69,na,1864,11
STAT,1827,34,15-19,1861,0.001194074198362647
STAT,1881,33,40-44,1914,0.041091599790775486
STAT,1922,45,45-49,1967,0.0024901902201505664
STAT,1911,15,20-24,1926,0.27080302133243545
STAT,1809,54,50-100,1863,4.745556993404409E-4
STAT,1950,18,na,1968,43.2383770457135
STAT,1886,15,15-19,1901,0.061843099220750784
STAT,1829,33,50-100,1862,0.00862566913024963
STAT,1850,36,15-19,1886,5.131993267431981E-4
STAT,1900,15,45-49,1915,9.100239607916928E-4
STAT,1875,75,na,1950,10.582274780571334
SIM,1802,56,na,1858,11
STAT,1969,3,na,1972,48.81493732780672
STAT,1847,31,35-39,1878,0.1283441511540807
SIM,1935,7,na,1942,60
STAT,1894,25,15-19,1919,0.005854063204887784
SIM,1915,17,20-24,1932,1
STAT,1874,22,40-44,1896,0.021140061623594324
STAT,1937,15,40-44,1952,0.013584138699396927
SIM,1895,2,na,1897,34
SIM,1888,21,20-24,1909,4
STAT,1903,31,15-19,1934,0.0020329311774547774
STAT,1951,18,20-24,1969,1.604148085993498
STAT,1868,25,20-24,1893,0.11430079751469138
STAT,1883,46,20-24,1929,1.1686062974728617E-4
STAT,1943,26,20-24,1969,0.19307650128122797
SIM,1863,15,na,1878,17
STAT,1931,29,50-100,1960,0.012780821191981793
STAT,1835,78,na,1913,3.5143786607419116
SIM,1901,37,na,1938,38
STAT,1830,43,35-39,1873,0.008699430776429658
STAT,1891,37,15-19,1928,6.89220761783227E-4
STAT,1922,27,15-19,1949,0.007929781979569376
SIM,1834,34,na,1868,21
SIM,1882,29,na,1911,30
STAT,1848,42,35-39,1890,0.011696110804270484
STAT,1876,52,50-100,1928,1.5257385759228604E-4
STAT,1863,15,50-100,1878,5.008584441851881E-4
STAT,1848,32,40-44,1880,0.03270608167150976
STAT,1908,29,35-39,1937,0.14018133924191167
STAT,1923,36,45-49,1959,0.007851415312088533
SIM,1856,32,40-44,1888,1
STAT,1902,28,25-29,1930,0.5944292073407044
STAT,1876,29,na,1905,24.065383912528482
STAT,1899,57,na,1956,27.728579380221706
STAT,1911,35,40-44,1946,0.01450218753102802
SIM,1948,16,20-24,1964,2
STAT,1866,23,na,1889,21.801841619198676
SIM,1838,48,na,1886,5
SIM,1856,4,na,1860,23
STAT,1867,102,na,1969,0.021953866147249625
SIM,1876,28,25-29,1904,1
SIM,1912,53,na,1965,35
STAT,1893,56,na,1949,25.717283512784345
SIM,1789,73,na,1862,7
STAT,1885,25,20-24,1910,0.11663578198693783
STAT,1867,40,na,1907,22.340828127151227
STAT,1902,16,35-39,1918,0.007756827305314804
STAT,1925,44,30-34,1969,0.0015330130226319562
STAT,1841,23,40-44,1864,0.02565294920010618
STAT,1868,89,na,1957,1.275963644587277
STAT,1816,64,na,1880,6.0882485340022106
SIM,1907,38,na,1945,38
STAT,1864,75,na,1939,9.233480938414552
SIM,1861,67,na,1928,19
STAT,1918,47,45-49,1965,0.0022918909072567354
STAT,1908,47,35-39,1955,0.0011599492820456995
STAT,1838,20,30-34,1858,0.18196815025972768
SIM,1828,65,na,1893,7
STAT,1943,19,25-29,1962,0.45588396583295154
STAT,1855,46,45-49,1901,0.001666322372747543
STAT,1923,18,45-49,1941,0.005809913817237134
STAT,1866,30,35-39,1896,0.09401811454769654
STAT,1819,38,50-100,1857,0.012698260113739163
STAT,1829,78,na,1907,5.30721812438192
STAT,1922,28,50-100,1950,0.011141144484262566
STAT,1882,84,na,1966,5.811968311034465
STAT,1909,19,25-29,1928,0.08405186722913359
STAT,1881,51,40-44,1932,1.0065445789762936E-4
STAT,1853,17,25-29,1870,0.042841713481767206
STAT,1929,16,45-49,1945,0.006360282470248305
STAT,1910,33,30-34,1943,0.15034818410387674
STAT,1834,35,20-24,1869,0.0069181239196726835
STAT,1927,36,30-34,1963,0.022564867443143444
SIM,1865,81,na,1946,2
SIM,1887,21,30-34,1908,1
STAT,1879,21,30-34,1900,0.1849155072351996
STAT,1915,26,45-49,1941,0.017529038731107165
STAT,1935,27,25-29,1962,0.893238969330466
STAT,1837,26,na,1863,13.511647789107474
STAT,1889,36,45-49,1925,0.024524361385115708
SIM,1890,64,na,1954,20
STAT,1904,29,15-19,1933,0.006454597126228786
STAT,1900,59,na,1959,27.835744473081245
STAT,1831,37,45-49,1868,0.02038499510595165
SIM,1841,47,na,1888,16
STAT,1917,39,25-29,1956,0.010072289389217913
STAT,1892,30,35-39,1922,0.12611620399903717
STAT,1920,36,na,1956,40.87842010485367
STAT,1812,105,na,1917,1.1652496568836705E-4
SIM,1871,81,na,1952,7
STAT,1828,65,na,1893,11.349939682979807
STAT,1860,25,20-24,1885,0.09779468429044927
SIM,1804,83,na,1887,1
STAT,1816,47,20-24,1863,1.5124823812174778E-4
SIM,1888,54,na,1942,32
STAT,1897,35,40-44,1932,0.058683364695122794
STAT,1915,16,45-49,1931,0.001039029291298672
STAT,1896,44,40-44,1940,0.002023975058177306
STAT,1824,90,na,1914,0.5485822043116183
STAT,1886,43,na,1929,23.80053069888044
SIM,1859,57,na,1916,17
STAT,1926,46,40-44,1972,0.001939059082467079
STAT,1805,96,na,1901,0.023510432834273128
STAT,1833,31,35-39,1864,0.09753885776529085
STAT,1827,27,25-29,1854,1.2462450419719118
STAT,1863,45,40-44,1908,0.0015309125939183107
STAT,1938,26,40-44,1964,0.045893458801308254
STAT,1910,15,30-34,1925,0.024115719933527197
STAT,1833,23,50-100,1856,0.004029328324238625
STAT,1802,72,na,1874,4.863284289968628
SIM,1899,7,na,1906,29
STAT,1942,29,35-39,1971,0.15627305891252913
STAT,1894,18,25-29,1912,0.07243405636606878
STAT,1820,54,50-100,1874,1.185237605597116E-4
STAT,1887,48,50-100,1935,0.00264705937482648
SIM,1907,22,na,1929,37
STAT,1934,37,35-39,1971,0.033236581882188226
STAT,1871,36,35-39,1907,0.07085645468573576
SIM,1881,44,na,1925,22
SIM,1919,23,na,1942,40
STAT,1912,20,50-100,1932,0.006293958673840348
STAT,1876,60,na,1936,19.37018931424111
SIM,1848,85,na,1933,1
SIM,1832,70,na,1902,18
STAT,1887,49,45-49,1936,0.0014227163057053437
STAT,1920,37,35-39,1957,0.02625713860192229
STAT,1870,99,na,1969,0.11769447206456238
STAT,1934,19,35-39,1953,0.05621351433239115
SIM,1951,19,25-29,1970,1
STAT,1852,5,na,1857,26.028510113624
STAT,1833,24,45-49,1857,0.0068406798864992235
STAT,1911,23,20-24,1934,1.04453149963153
STAT,1903,36,45-49,1939,0.006146828373578549
STAT,1847,63,na,1910,19.060598253710207
SIM,1842,84,na,1926,5
SIM,1913,22,na,1935,42
STAT,1853,24,15-19,1877,0.02414726874811631
STAT,1873,21,35-39,1894,0.05950801446586891
STAT,1846,46,na,1892,18.285109933003195
STAT,1932,21,na,1953,47.86488550716064
STAT,1936,31,25-29,1967,0.08928381297823439
STAT,1889,43,35-39,1932,0.022010213372583402
STAT,1849,11,na,1860,22.888784687849437
STAT,1941,24,45-49,1965,0.011535592436368897
STAT,1840,32,40-44,1872,0.04138999860348616
SIM,1894,14,na,1908,32
STAT,1857,46,na,1903,16.89030779830461
STAT,1928,21,25-29,1949,1.1511050597743475
STAT,1924,17,20-24,1941,1.603977696199809
SIM,1824,44,na,1868,16
SIM,1818,36,50-100,1854,1
STAT,1818,37,25-29,1855,0.03950085050999627
STAT,1907,31,35-39,1938,0.08540604458566187
SIM,1868,62,na,1930,28
STAT,1897,21,20-24,1918,0.9178900308222229
STAT,1883,23,50-100,1906,0.003947740742422695
STAT,1900,28,na,1928,32.97699883255867
STAT,1826,85,na,1911,1.915697698668269
STAT,1821,42,30-34,1863,0.017922711161943366
STAT,1835,62,na,1897,8.221004024901688
STAT,1896,39,45-49,1935,0.025921623436011162
STAT,1874,58,na,1932,20.06255653453779
STAT,1908,44,30-34,1952,0.001162224872631856
STAT,1882,27,45-49,1909,0.010640520912285106
STAT,1864,31,35-39,1895,0.09120316931880888
STAT,1838,23,35-39,1861,0.05833966521922961
STAT,1853,87,na,1940,1.107263128649446
STAT,1829,48,45-49,1877,0.0019887720104382433
STAT,1906,38,15-19,1944,1.7521469253134657E-4
SIM,1828,58,na,1886,9
STAT,1896,23,50-100,1919,0.005339922310221858
STAT,1848,21,25-29,1869,0.45402510672298313
STAT,1926,35,35-39,1961,0.029442230145932342
STAT,1893,27,20-24,1920,0.14791921324294377
STAT,1923,38,50-100,1961,0.004826226976838161
SIM,1856,77,na,1933,4
STAT,1903,37,35-39,1940,0.021704576227810513
STAT,1844,34,15-19,1878,0.0013028325680015515
STAT,1867,32,15-19,1899,0.0013627852772119743
STAT,1863,39,50-100,1902,0.010760999323898348
STAT,1914,36,na,1950,37.43126542677233
STAT,1885,28,25-29,1913,0.4162623758498223
STAT,1889,25,40-44,1914,0.036924458030980746
STAT,1851,27,20-24,1878,0.11596270883405868
STAT,1870,24,15-19,1894,0.032566968819705035
STAT,1800,93,na,1893,0.10590756155193493
STAT,1888,78,na,1966,12.668429101318274
STAT,1871,14,na,1885,26.085127912253732
STAT,1922,42,40-44,1964,0.0028498995113918936
STAT,1843,66,na,1909,6.952575793931748
SIM,1919,16,na,1935,44
STAT,1861,46,20-24,1907,1.0120118180722456E-4
SIM,1864,20,20-24,1884,2
STAT,1847,34,50-100,1881,0.010242758311272951
STAT,1875,20,35-39,1895,0.06034326709557083
SIM,1832,63,na,1895,18
STAT,1848,45,50-100,1893,0.0016041292253562618
STAT,1868,24,50-100,1892,0.0039216675505339684
STAT,1961,9,na,1970,50.47032158485772
STAT,1905,22,35-39,1927,0.0842200615975734
STAT,1880,65,na,1945,17.7708531234485
STAT,1884,79,na,1963,9.29548930915368
SIM,1856,76,na,1932,4
SIM,1892,28,na,1920,36
STAT,1855,38,45-49,1893,0.013965921932481876
STAT,1913,17,45-49,1930,0.0010128105155927743
SIM,1920,25,30-34,1945,1
STAT,1795,92,na,1887,0.14186050256807414
SIM,1942,19,na,1961,42
STAT,1858,31,na,1889,18.348042406275816
STAT,1939,17,45-49,1956,0.004965969142528124
STAT,1853,47,25-29,1900,3.6031748946926305E-4
SIM,1877,7,na,1884,31
SIM,1958,2,na,1960,53
STAT,1858,32,na,1890,18.158507128219007
STAT,1821,55,na,1876,14.076359929668353
STAT,1826,105,na,1931,2.0489780127204172E-4
STAT,1852,42,50-100,1894,0.009030492857132064
STAT,1841,26,45-49,1867,0.013595965288858274
STAT,1873,37,50-100,1910,0.012482370099268197
STAT,1806,81,na,1887,2.9366133425535668
STAT,1895,27,na,1922,30.98316281019287
STAT,1874,45,50-100,1919,0.0025164309863642547
STAT,1880,48,45-49,1928,0.0024504830929327004
SIM,1893,28,25-29,1921,1
STAT,1870,39,25-29,1909,0.028313753487907246
SIM,1881,43,na,1924,21
STAT,1855,98,na,1953,0.022871997987241488
STAT,1889,22,25-29,1911,0.7008761705617066
STAT,1857,18,20-24,1875,0.15506969243290233
STAT,1791,71,na,1862,5.604961174487462
STAT,1795,85,na,1880,1.0903238650703841
STAT,1913,30,50-100,1943,0.008222756508879037
SIM,1897,22,25-29,1919,2
STAT,1845,40,50-100,1885,0.006451820693580148
STAT,1914,35,na,1949,37.60575613523984
STAT,1923,44,45-49,1967,0.0019253223019574386
STAT,1845,20,45-49,1865,0.00513377719470084
STAT,1838,41,35-39,1879,0.016648409170601394
STAT,1857,22,40-44,1879,0.01800879560920809
STAT,1881,25,40-44,1906,0.02869747280577462
STAT,1932,28,15-19,1960,0.00920466405558881
STAT,1820,45,20-24,1865,1.0416536824296997E-4
STAT,1930,37,15-19,1967,2.493103387649871E-4
STAT,1785,71,na,1856,16.649315022000003
STAT,1789,85,na,1874,0.558357293768879
STAT,1861,39,30-34,1900,0.044368291492049586
STAT,1825,37,20-24,1862,0.008081058663217938
STAT,1818,44,15-19,1862,1.398064394633394E-4
STAT,1928,28,50-100,1956,0.01219679996511721
SIM,1822,64,na,1886,12
STAT,1866,39,na,1905,21.47973324167939
STAT,1909,16,20-24,1925,0.26502592083525134
STAT,1908,26,30-34,1934,0.3728837852429596
SIM,1801,71,na,1872,1
STAT,1912,25,30-34,1937,0.3857068412404998
STAT,1824,99,na,1923,0.013177755905665804
STAT,1862,43,30-34,1905,0.009847278742394907
SIM,1853,32,na,1885,24
STAT,1832,25,45-49,1857,0.006738844519921645
STAT,1885,35,15-19,1920,5.598010955944655E-4
STAT,1878,79,na,1957,7.99076629663636
STAT,1911,24,35-39,1935,0.0881692014523227
STAT,1866,16,20-24,1882,0.16858302363756547
STAT,1921,39,15-19,1960,2.1229558580655643E-4
SIM,1936,19,na,1955,38
STAT,1888,32,35-39,1920,0.1183446941495255
STAT,1896,47,50-100,1943,0.0018112739022181285
STAT,1916,19,15-19,1935,0.09495238823116166
STAT,1868,35,15-19,1903,5.485941842719521E-4
STAT,1849,16,20-24,1865,0.17021164219412993
STAT,1876,5,na,1881,27.790280488196228
STAT,1874,65,na,1939,17.14452451266198
STAT,1836,84,na,1920,3.210549376526856
STAT,1825,35,50-100,1860,0.013307746152897919
STAT,1911,21,30-34,1932,0.2716416810154082
STAT,1920,33,40-44,1953,0.04232026711999953
STAT,1860,7,na,1867,23.207237618725628
STAT,1932,23,40-44,1955,0.04380270791906163
STAT,1846,15,40-44,1861,0.0018841958656065805
STAT,1897,38,45-49,1935,0.02634131012701948
SIM,1950,15,15-19,1965,1
STAT,1872,46,45-49,1918,0.0024215374115981376
SIM,1853,25,na,1878,24
STAT,1866,40,50-100,1906,0.00982790345768708
STAT,1911,26,25-29,1937,0.6399403333099627
STAT,1897,30,35-39,1927,0.13556391243566665
STAT,1916,25,15-19,1941,0.00728601519792982
STAT,1934,34,30-34,1968,0.21392356741970334
STAT,1925,26,30-34,1951,0.46147366807729506
STAT,1886,19,30-34,1905,0.016444009487215194
STAT,1843,28,25-29,1871,0.21924727326669385
STAT,1887,21,50-100,1908,0.00446450202523435
STAT,1822,40,25-29,1862,0.003782497665927173
STAT,1906,15,40-44,1921,0.0026695905268668773
STAT,1852,10,na,1862,25.02028311714238
STAT,1856,20,20-24,1876,0.5882197546322065
STAT,1924,21,40-44,1945,0.03953631361312825
STAT,1934,16,30-34,1950,0.1645704709968307
STAT,1851,52,na,1903,18.08093796924684
STAT,1852,29,25-29,1881,0.3782366044385976
STAT,1880,34,35-39,1914,0.10557973852603758
SIM,1843,70,na,1913,17
SIM,1862,77,na,1939,10
STAT,1838,35,50-100,1873,0.01173958652314317
STAT,1930,19,15-19,1949,0.580858838971765
STAT,1879,24,35-39,1903,0.06001970149843817
STAT,1838,32,50-100,1870,0.008836657104425823
STAT,1935,24,20-24,1959,1.506456114654092
STAT,1877,33,15-19,1910,0.0014638154797292262
STAT,1902,45,40-44,1947,0.0013754090392489077
STAT,1873,80,na,1953,6.289222847709215
STAT,1926,17,35-39,1943,0.051152729661858375
STAT,1877,94,na,1971,0.9797067589880958
STAT,1818,99,na,1917,0.004732827634024837
STAT,1863,105,na,1968,0.0022994202865447046
STAT,1824,48,50-100,1872,0.0031363137945807583
STAT,1813,43,35-39,1856,0.05979513649396327
STAT,1898,23,40-44,1921,0.02802373749738148
STAT,1947,19,45-49,1966,0.005584954491923795
SIM,1924,19,15-19,1943,1
STAT,1840,24,40-44,1864,0.020467933236774486
STAT,1804,86,na,1890,0.8613937239036158
STAT,1915,23,40-44,1938,0.03434969387181018
STAT,1820,38,na,1858,16.118799096344873
STAT,1879,42,35-39,1921,0.01871902909986077
STAT,1863,41,25-29,1904,0.0057113692324287065
STAT,1884,29,25-29,1913,0.41148685089384907
STAT,1912,30,25-29,1942,0.09096072362791521
STAT,1916,18,25-29,1934,0.09091727263411045
STAT,1925,19,40-44,1944,0.016700638278325013
STAT,1826,36,20-24,1862,0.009140268307966217
STAT,1813,50,25-29,1863,1.0973314809729134E-4
STAT,1882,39,50-100,1921,0.011647576890742082
STAT,1942,15,15-19,1957,0.4710683027581254
SIM,1838,21,35-39,1859,1
STAT,1836,32,15-19,1868,0.0017372032926982685
STAT,1883,15,45-49,1898,6.37281948735293E-4
STAT,1867,37,20-24,1904,0.0073767198501150195
SIM,1939,31,na,1970,29
SIM,1888,82,na,1970,16
SIM,1902,54,na,1956,30
STAT,1898,30,30-34,1928,0.23742497630787737
SIM,1857,0,na,1857,33
STAT,1880,41,25-29,1921,0.006783176175953257
STAT,1817,38,25-29,1855,0.10735706722850809
STAT,1886,50,na,1936,22.655654157246286
STAT,1905,15,45-49,1920,9.471416121749275E-4
STAT,1869,75,na,1944,9.974884267565688
SIM,1920,30,25-29,1950,2
STAT,1927,41,50-100,1968,0.0014679605469493657
STAT,1831,45,45-49,1876,0.0023181073683994713
STAT,1907,54,na,1961,31.742195547274992
STAT,1917,27,35-39,1944,0.15601872078933854
STAT,1939,28,20-24,1967,0.18216027634561713
STAT,1898,19,20-24,1917,0.23787548644407897
STAT,1867,42,50-100,1909,0.01009738107313137
STAT,1812,46,25-29,1858,6.556014078673375E-4
STAT,1881,1,na,1882,32.16968109045593
STAT,1911,33,15-19,1944,0.0012380199055490575
SIM,1868,61,na,1929,29
SIM,1874,62,na,1936,22
STAT,1865,46,50-100,1911,0.002227727936342524
STAT,1906,33,40-44,1939,0.03602452043062671
STAT,1951,16,30-34,1967,0.1443062221896419
STAT,1887,16,40-44,1903,0.0020013042324317533
STAT,1894,78,na,1972,14.938142191791718
STAT,1871,13,na,1884,26.204094501289585
STAT,1834,34,50-100,1868,0.008123486881320408
STAT,1880,50,50-100,1930,1.610956455327741E-4
SIM,1869,47,na,1916,15
STAT,1896,36,40-44,1932,0.05777682621264939
SIM,1822,49,na,1871,14
STAT,1931,36,20-24,1967,0.0034788662973897102
STAT,1833,67,na,1900,11.736052951099893
STAT,1926,42,25-29,1968,8.752974981968033E-4
SIM,1914,33,40-44,1947,1
SIM,1890,57,na,1947,24
STAT,1845,18,30-34,1863,0.011706445998921266
STAT,1826,31,15-19,1857,0.00221757245297967
STAT,1939,32,40-44,1971,0.03965438971294068
SIM,1887,28,na,1915,25
STAT,1839,34,40-44,1873,0.028846298216005737
STAT,1924,31,35-39,1955,0.10598337129915653
STAT,1867,50,45-49,1917,1.408738154553619E-4
STAT,1833,45,50-100,1878,0.002185224142745804
STAT,1861,49,25-29,1910,4.742766742680899E-4
STAT,1847,30,20-24,1877,0.034614456713001465
STAT,1941,1,na,1942,42.456453619809665
STAT,1865,21,25-29,1886,0.5278634163258173
STAT,1867,79,na,1946,6.69016154601047
STAT,1899,37,20-24,1936,0.0022776449122823977
STAT,1849,49,25-29,1898,4.3730018736128497E-4
STAT,1858,24,15-19,1882,0.02583570439208576
STAT,1893,42,50-100,1935,0.013304162863914963
STAT,1887,19,45-49,1906,7.091765231040865E-4
SIM,1908,24,30-34,1932,3
STAT,1847,36,45-49,1883,0.022325299069430395
STAT,1826,39,25-29,1865,0.03162394700485778
STAT,1879,64,na,1943,17.992183403334618
STAT,1946,23,35-39,1969,0.10400762502064674
STAT,1893,22,15-19,1915,0.041596647045650234
STAT,1916,15,20-24,1931,0.2865096313721718
STAT,1921,43,35-39,1964,0.002246791425645704
STAT,1871,33,30-34,1904,0.17333885478422673
SIM,1815,67,na,1882,6
STAT,1964,6,na,1970,49.20209100363476
STAT,1835,99,na,1934,0.00851847851778402
STAT,1863,7,na,1870,25.006750085108482
STAT,1923,38,15-19,1961,2.2074221810869122E-4
STAT,1831,85,na,1916,2.2245836549486433
STAT,1857,25,45-49,1882,0.008685579577792618
SIM,1841,74,na,1915,4
STAT,1856,37,45-49,1893,0.01444148249155459
STAT,1860,66,na,1926,13.32470517318056
STAT,1865,13,na,1878,24.340014786098347
STAT,1837,33,na,1870,13.000325850110078
STAT,1879,17,45-49,1896,6.760944581138676E-4
STAT,1852,21,15-19,1873,0.0337839981005031
STAT,1921,25,35-39,1946,0.1671479384352603
STAT,1784,92,na,1876,0.15756416957750963
STAT,1888,37,45-49,1925,0.023295846423420707
STAT,1929,20,30-34,1949,0.3638772636295745
STAT,1818,66,na,1884,4.428326084785343
STAT,1946,2,na,1948,44.462594395793346
STAT,1935,34,na,1969,52.025290612723374
STAT,1891,17,45-49,1908,8.017447771919764E-4
STAT,1924,35,50-100,1959,0.004927161961726003
STAT,1837,19,35-39,1856,0.0047753393665706636
STAT,1865,24,40-44,1889,0.01880393718998296
STAT,1926,37,25-29,1963,0.011964419155740863
STAT,1894,48,25-29,1942,4.1117240257744015E-4
STAT,1872,94,na,1966,0.7043596569510168
STAT,1881,28,45-49,1909,0.01052782762861503
STAT,1908,19,40-44,1927,0.00268462013351153
STAT,1898,26,45-49,1924,0.015029399266858423
SIM,1845,33,na,1878,23
STAT,1825,48,na,1873,13.720780971826132
SIM,1871,29,na,1900,25
STAT,1909,34,20-24,1943,0.022947464005694758
STAT,1918,48,35-39,1966,0.0013558166250886017
STAT,1878,17,30-34,1895,0.016455387914725256
SIM,1860,11,na,1871,28
STAT,1911,31,25-29,1942,0.08978678421278308
STAT,1859,38,25-29,1897,0.022770839055287723
STAT,1913,37,15-19,1950,1.87925100037525E-4
STAT,1849,98,na,1947,0.025188905721823147
STAT,1857,32,35-39,1889,0.07628007642782554
STAT,1860,28,25-29,1888,0.3450881245076964
STAT,1943,17,35-39,1960,0.044172821386049846
SIM,1864,47,na,1911,22
SIM,1899,6,na,1905,29
STAT,1873,20,20-24,1893,0.7048085885217623
STAT,1907,21,40-44,1928,0.030572970858070786
STAT,1874,18,20-24,1892,0.17938320928845394
STAT,1847,32,na,1879,27.18268648655863
SIM,1813,56,na,1869,8
STAT,1893,40,45-49,1933,0.019061210308844168
STAT,1864,36,50-100,1900,0.01106490669361666
STAT,1923,41,40-44,1964,0.0029073813741225633
STAT,1954,18,45-49,1972,0.006138291990932978
SIM,1880,58,na,1938,29
STAT,1870,36,20-24,1906,0.00769438092066021
SIM,1897,27,na,1924,36
STAT,1839,31,25-29,1870,0.0702859041631683
STAT,1883,40,35-39,1923,0.01776191068051147
STAT,1911,29,40-44,1940,0.04483943731133743
STAT,1862,22,15-19,1884,0.029137063970963408
STAT,1831,48,na,1879,19.32841332798063
STAT,1892,28,20-24,1920,0.14442108807994825
SIM,1940,24,na,1964,33
STAT,1846,18,45-49,1864,6.61106210587447E-4
STAT,1849,30,35-39,1879,0.09283679570234782
STAT,1947,16,40-44,1963,0.015652741795762464
SIM,1835,44,na,1879,17
STAT,1946,16,45-49,1962,0.005503081427305004
STAT,1836,41,50-100,1877,0.012285414155634868
STAT,1913,57,na,1970,33.9967287288074
STAT,1926,19,25-29,1945,0.5254407109730154
STAT,1852,26,20-24,1878,0.11778972348828659
STAT,1958,1,na,1959,51.422206400047436
SIM,1814,45,na,1859,22
STAT,1906,18,45-49,1924,9.465292699020699E-4
STAT,1860,14,na,1874,22.180392046976717
SIM,1879,46,na,1925,14
STAT,1830,63,na,1893,6.410864222550816
SIM,1844,11,na,1855,13
STAT,1873,26,45-49,1899,0.01132710864091824
STAT,1864,28,na,1892,21.329926482771597
STAT,1828,104,na,1932,4.4796345220052177E-4
STAT,1862,46,35-39,1908,0.001211299853421859
STAT,1951,19,35-39,1970,0.0496320100011924
SIM,1931,2,na,1933,63
STAT,1852,47,na,1899,19.16545318245865
STAT,1870,17,25-29,1887,0.05682887734735078
SIM,1914,3,na,1917,38
STAT,1927,41,25-29,1968,8.922897498329639E-4
SIM,1896,42,na,1938,28
SIM,1812,71,na,1883,12
STAT,1827,29,50-100,1856,0.006910288082948376
STAT,1833,28,15-19,1861,0.004395385338960564
STAT,1854,44,35-39,1898,0.010918926339506266
STAT,1892,46,na,1938,27.87880169587971
SIM,1939,26,20-24,1965,1
SIM,1879,61,na,1940,11
STAT,1918,40,25-29,1958,7.544536476238556E-4
STAT,1928,28,45-49,1956,0.021169776790867845
STAT,1846,47,na,1893,18.14833731070433
STAT,1838,16,45-49,1854,6.736559371559028E-4
SIM,1827,48,na,1875,14
SIM,1858,47,na,1905,24
STAT,1925,29,35-39,1954,0.17495830310221122
STAT,1871,30,15-19,1901,0.0014312176107414425
STAT,1820,48,25-29,1868,4.8062331527308684E-4
STAT,1882,13,na,1895,24.710954127954558
STAT,1933,34,50-100,1967,0.01108241060805403
SIM,1865,10,na,1875,25
STAT,1884,26,20-24,1910,0.11533356349060149
SIM,1910,58,na,1968,27
STAT,1880,45,40-44,1925,0.0018182067052452846
STAT,1844,27,25-29,1871,0.4044828897194193
STAT,1898,33,35-39,1931,0.13603769611128919
STAT,1884,43,50-100,1927,0.010275837477168313
STAT,1866,38,20-24,1904,0.007064163148772876
STAT,1906,36,45-49,1942,0.006281213444642072
STAT,1883,79,na,1962,8.979562920610208
STAT,1910,24,50-100,1934,0.006103009790025101
SIM,1867,76,na,1943,5
SIM,1859,10,na,1869,23
SIM,1927,42,na,1969,50
STAT,1817,81,na,1898,4.285765395940572
STAT,1836,36,30-34,1872,0.06379251972515064
STAT,1908,23,15-19,1931,0.04853316416532384
SIM,1863,62,na,1925,5
STAT,1886,21,45-49,1907,0.0072549190689554744
STAT,1919,43,40-44,1962,0.002682806849577565
STAT,1836,28,50-100,1864,0.007931032856080928
STAT,1878,24,na,1902,24.264321170848365
STAT,1919,3,na,1922,44.43421399935705
STAT,1840,27,45-49,1867,0.010847926593200543
STAT,1813,54,40-44,1867,3.011486905803916E-4
STAT,1894,42,na,1936,29.686363898573386
STAT,1874,29,15-19,1903,0.004569876402640797
STAT,1843,25,20-24,1868,0.062132586860954096
STAT,1930,22,40-44,1952,0.042872564619608526
STAT,1861,51,na,1912,18.193818564306742
STAT,1924,24,45-49,1948,0.013107953619501189
STAT,1895,45,35-39,1940,0.0010354750364242541
STAT,1918,46,30-34,1964,9.424008831359355E-4
STAT,1874,47,45-49,1921,0.0023830378410777246
STAT,1920,36,45-49,1956,0.007407254938910659
STAT,1821,45,35-39,1866,0.002038352672277751
STAT,1936,36,35-39,1972,0.0236232837936328
SIM,1909,61,na,1970,31
STAT,1870,28,na,1898,23.62399916213217
SIM,1850,21,35-39,1871,1
STAT,1855,51,na,1906,15.232337728664781
SIM,1909,17,na,1926,41
SIM,1955,16,40-44,1971,1
STAT,1885,17,50-100,1902,4.838020572002813E-4
STAT,1829,99,na,1928,0.012864129892080928
STAT,1925,42,na,1967,44.68280752041271
SIM,1826,30,na,1856,16
SIM,1942,20,na,1962,37
STAT,1819,35,50-100,1854,0.01537893128436313
STAT,1926,32,30-34,1958,0.1894182183190745
SIM,1852,27,25-29,1879,1
SIM,1857,62,na,1919,17
STAT,1908,49,25-29,1957,4.7443899386877416E-4
STAT,1950,21,35-39,1971,0.11104773272427326
STAT,1866,19,25-29,1885,0.05293913085561604
STAT,1926,20,na,1946,44.37459435924721
SIM,1833,48,na,1881,11
STAT,1896,40,25-29,1936,5.91651530582358E-4
SIM,1909,54,na,1963,33
SIM,1844,27,na,1871,10
STAT,1921,40,30-34,1961,0.0014326894312715955
SIM,1882,66,na,1948,23
STAT,1843,31,15-19,1874,7.33805424936341E-4
STAT,1884,50,45-49,1934,1.442289271341246E-4
STAT,1809,85,na,1894,1.5168183697439932
STAT,1840,30,35-39,1870,0.09868183325762907
STAT,1936,30,50-100,1966,0.007991220980601206
STAT,1927,38,35-39,1965,0.029888531033292517
STAT,1914,18,50-100,1932,7.665658348471255E-4
STAT,1938,24,50-100,1962,0.0064648662330084525
STAT,1863,34,35-39,1897,0.08889712644102696
STAT,1823,84,na,1907,1.9131064114754062
STAT,1946,8,na,1954,43.35983306599032
SIM,1880,65,na,1945,28
STAT,1868,39,30-34,1907,0.051057641731124814
STAT,1940,25,na,1965,37.96236180033077
SIM,1926,36,na,1962,46
SIM,1869,20,20-24,1889,1
STAT,1811,53,30-34,1864,2.2143778685042108E-4
STAT,1868,96,na,1964,0.26481362160309957
STAT,1911,46,45-49,1957,0.0020493697979632342
SIM,1852,46,na,1898,24
STAT,1877,7,na,1884,27.72271587851048
STAT,1921,42,na,1963,41.504522914752634
STAT,1824,53,40-44,1877,1.289583150436419E-4
STAT,1883,63,na,1946,17.327047800556375
STAT,1853,44,20-24,1897,9.846374587900815E-4
STAT,1884,11,na,1895,25.339939994323593
STAT,1875,44,na,1919,23.437516880420493
STAT,1857,37,15-19,1894,4.203775622374452E-4
STAT,1927,45,40-44,1972,0.001978227692799932
STAT,1913,32,35-39,1945,0.09015965183232207
STAT,1819,39,35-39,1858,0.06957692298126868
STAT,1847,25,na,1872,28.178860675194723
STAT,1888,34,40-44,1922,0.05024489217360717
STAT,1856,31,25-29,1887,0.07589328458406258
STAT,1887,42,25-29,1929,0.0070005642561304215
STAT,1854,76,na,1930,5.790862926039585
STAT,1859,10,na,1869,22.300989291113968
STAT,1920,19,40-44,1939,0.015475771051638243
STAT,1910,48,50-100,1958,0.0020915390643705175
STAT,1900,16,20-24,1916,0.2464421350127845
STAT,1899,15,50-100,1914,6.737823154960379E-4
STAT,1786,87,na,1873,0.24539324232612175
STAT,1864,30,20-24,1894,0.024439231964527394
STAT,1855,34,50-100,1889,0.006433454011423514
STAT,1856,61,na,1917,13.537019241607872
SIM,1852,6,na,1858,29
SIM,1922,36,na,1958,48
STAT,1950,18,25-29,1968,0.5090644022884667
STAT,1871,78,na,1949,7.789889855784994
STAT,1895,37,35-39,1932,0.09182457299484725
STAT,1896,42,35-39,1938,0.0016496936225776204
STAT,1901,38,na,1939,33.06178366834431
STAT,1904,25,35-39,1929,0.13919658854131362
STAT,1941,18,15-19,1959,0.4639173184068223
STAT,1837,70,na,1907,6.784204622827557
STAT,1803,54,35-39,1857,1.6143491218216524E-4
SIM,1843,79,na,1922,9
SIM,1844,17,na,1861,13
STAT,1831,23,35-39,1854,0.19077315390491434
STAT,1942,23,15-19,1965,0.055388347076085705
STAT,1828,46,35-39,1874,6.074132805148142E-4
STAT,1917,16,30-34,1933,0.02605473293207758
STAT,1853,30,45-49,1883,0.011522947326363515
STAT,1843,17,50-100,1860,2.655801767041877E-4
STAT,1867,18,30-34,1885,0.015500995533461442
SIM,1899,0,na,1899,32
STAT,1847,15,25-29,1862,0.076450440812936
STAT,1870,45,35-39,1915,0.001404609138726939
STAT,1856,77,na,1933,6.261944969127816
STAT,1847,33,40-44,1880,0.05383122771102686
SIM,1821,54,na,1875,11
STAT,1900,40,50-100,1940,0.0010275651516078656
STAT,1845,43,30-34,1888,0.006756362118765661
STAT,1850,43,40-44,1893,0.019882093762183736
STAT,1798,72,na,1870,10.002021122996563
SIM,1785,74,na,1859,5
SIM,1856,12,na,1868,21
STAT,1838,49,50-100,1887,0.001911494652505831
SIM,1814,72,na,1886,15
SIM,1814,82,na,1896,12
STAT,1816,54,45-49,1870,1.6868730001279707E-4
STAT,1907,35,15-19,1942,1.7897611324042085E-4
STAT,1863,59,na,1922,17.207385172822327
STAT,1868,29,50-100,1897,0.006146347716834813
STAT,1834,52,na,1886,15.601888056061398
STAT,1878,42,30-34,1920,0.011854763489719068
STAT,1863,49,na,1912,19.5041213371905
SIM,1864,31,na,1895,21
STAT,1859,51,50-100,1910,1.2061354558577176E-4
STAT,1960,7,na,1967,50.89712020835491
STAT,1845,29,35-39,1874,0.06766984245982324
STAT,1831,30,25-29,1861,0.11042677625701652
STAT,1864,96,na,1960,0.15335607577412114
STAT,1895,64,na,1959,23.546901116786543
STAT,1932,27,20-24,1959,0.23812060942155175
STAT,1881,16,50-100,1897,4.6732395001886117E-4
STAT,1811,44,15-19,1855,5.689252524801912E-4
STAT,1912,24,30-34,1936,0.2830121143802974
SIM,1882,50,na,1932,30
STAT,1869,44,30-34,1913,0.01098924764037837
SIM,1861,29,na,1890,24
STAT,1920,35,30-34,1955,0.01981951491899628
STAT,1918,16,50-100,1934,8.12733760873546E-4
STAT,1903,35,30-34,1938,0.016510125117846757
SIM,1917,53,na,1970,33
STAT,1866,45,45-49,1911,0.0021951854916722473
STAT,1862,26,30-34,1888,0.21963845256715422
SIM,1872,1,na,1873,27
STAT,1897,32,25-29,1929,0.13601721694048416
STAT,1850,52,na,1902,19.068992069773596
SIM,1846,12,na,1858,17
STAT,1788,72,na,1860,6.414182799559279
STAT,1872,31,25-29,1903,0.10522755174507692
STAT,1924,28,25-29,1952,0.7587038804781302
SIM,1874,31,na,1905,25
STAT,1881,44,na,1925,21.695593465053687
STAT,1909,17,35-39,1926,0.008182621468337443
STAT,1904,27,45-49,1931,0.015909430008904366
STAT,1890,11,na,1901,31.416623916397207
STAT,1907,33,50-100,1940,0.007663180617875591
SIM,1869,19,na,1888,17
SIM,1806,53,na,1859,10
SIM,1920,24,30-34,1944,1
SIM,1870,65,na,1935,15
STAT,1818,101,na,1919,0.0014260046070959822
STAT,1849,15,45-49,1864,6.308772819692967E-4
STAT,1889,21,25-29,1910,0.7029921770145204
STAT,1827,38,30-34,1865,0.042990064813700525
STAT,1835,49,30-34,1884,4.5033287815957756E-4
SIM,1823,59,na,1882,8
SIM,1901,44,na,1945,37
STAT,1915,28,15-19,1943,0.007113257063647775
STAT,1855,35,40-44,1890,0.031113383735108156
STAT,1866,61,na,1927,17.209788910254236
STAT,1814,40,35-39,1854,0.062190727653414386
STAT,1870,42,15-19,1912,1.3701637302027589E-4
STAT,1888,31,20-24,1919,0.03171697940595719
SIM,1897,21,25-29,1918,3
STAT,1870,28,30-34,1898,0.2492735744270271
STAT,1922,46,20-24,1968,1.2634001664704769E-4
SIM,1862,46,na,1908,23
SIM,1873,83,na,1956,1
STAT,1881,78,na,1959,8.790969152188511
STAT,1890,45,35-39,1935,0.001717538151337637
SIM,1869,40,na,1909,16
STAT,1881,31,35-39,1912,0.09675723389391391
STAT,1899,20,40-44,1919,0.028696162027268657
STAT,1928,43,35-39,1971,0.0025504686537608993
STAT,1886,44,30-34,1930,0.011764154536266575
STAT,1907,28,25-29,1935,0.6165866404838302
STAT,1919,46,45-49,1965,0.002342708524136509
STAT,1894,29,30-34,1923,0.32042257853190065
STAT,1857,25,na,1882,18.669079729911907
STAT,1799,105,na,1904,1.0832150244353907E-4
STAT,1838,40,20-24,1878,0.0014789352035634185
STAT,1933,18,25-29,1951,0.5762271120724441
STAT,1822,67,na,1889,5.626692195129593
SIM,1882,60,na,1942,27
STAT,1857,46,50-100,1903,0.0018438014083486207
STAT,1891,44,40-44,1935,0.027234157431510645
STAT,1869,22,20-24,1891,0.6677216837430114
SIM,1880,31,na,1911,30
STAT,1837,41,30-34,1878,0.006690856748638734
STAT,1875,0,na,1875,37.738986955587926
SIM,1909,24,na,1933,36
STAT,1870,42,30-34,1912,0.011406612245447222
STAT,1854,23,50-100,1877,0.0029076399659998028
SIM,1888,32,25-29,1920,1
STAT,1880,23,30-34,1903,0.1867268401483402
STAT,1848,20,25-29,1868,0.45730858234421434
STAT,1944,1,na,1945,44.17164534499634
SIM,1932,28,25-29,1960,2
STAT,1811,49,45-49,1860,0.009058130762387458
STAT,1841,20,25-29,1861,0.7201286234254307
SIM,1812,87,na,1899,1
SIM,1900,25,na,1925,34
STAT,1938,15,na,1953,36.23678379350234
STAT,1913,25,45-49,1938,0.01718590680663747
SIM,1873,14,na,1887,30
STAT,1844,38,30-34,1882,0.04353605906421545
STAT,1851,33,15-19,1884,0.0012384001564782867
STAT,1803,53,50-100,1856,2.8889346062259446E-4
STAT,1915,42,na,1957,37.0679273593131
SIM,1870,0,na,1870,36
STAT,1810,86,na,1896,0.79752555272882
STAT,1933,25,15-19,1958,0.009343554322519793
SIM,1932,20,na,1952,44
STAT,1912,17,40-44,1929,0.002806236692153157
STAT,1913,23,na,1936,36.45452369075623
STAT,1875,34,na,1909,24.319882342532107
SIM,1867,83,na,1950,1
STAT,1854,36,35-39,1890,0.043440251822392174
STAT,1807,53,40-44,1860,2.1147548419484988E-4
STAT,1853,28,30-34,1881,0.16564258289005054
STAT,1890,21,35-39,1911,0.0710977496681941
STAT,1912,18,50-100,1930,7.497009834109929E-4
STAT,1829,45,40-44,1874,0.001499637096340371
STAT,1874,44,40-44,1918,0.02251070039676589
STAT,1930,25,45-49,1955,0.02188362477711227
SIM,1856,20,25-29,1876,1
STAT,1873,23,40-44,1896,0.021120466195703486
STAT,1807,50,na,1857,14.43245381576034
STAT,1830,32,30-34,1862,0.11485586890510883
SIM,1938,21,na,1959,39
SIM,1905,24,na,1929,40
STAT,1858,22,45-49,1880,0.006088152242041432
STAT,1817,101,na,1918,0.0045224100713959475
SIM,1897,9,na,1906,43
STAT,1863,31,30-34,1894,0.15521966503190449
STAT,1848,42,na,1890,14.928380066637079
STAT,1905,58,na,1963,30.175377751562568
SIM,1891,33,na,1924,36
STAT,1822,33,35-39,1855,0.07706623236620057
STAT,1875,42,50-100,1917,0.010846344337912355
SIM,1849,7,na,1856,20
STAT,1941,17,20-24,1958,1.3863232057353345
STAT,1877,26,50-100,1903,0.006625956183409666
STAT,1893,48,40-44,1941,0.0012023428756116428
STAT,1805,55,na,1860,8.941910204546373
STAT,1903,57,na,1960,29.611473241291566
STAT,1864,33,25-29,1897,0.0914805779633469
STAT,1850,46,45-49,1896,0.0021072270391003325
STAT,1883,27,15-19,1910,0.0044058212642188385
STAT,1931,20,35-39,1951,0.12230688000977853
STAT,1848,21,50-100,1869,0.003234258114758859
STAT,1900,19,25-29,1919,0.07815809693813015
STAT,1907,23,na,1930,34.48788741441546
STAT,1919,36,35-39,1955,0.02578299760626423
STAT,1837,36,35-39,1873,0.04241100241673793
SIM,1879,40,na,1919,15
SIM,1810,52,na,1862,17
SIM,1898,37,na,1935,33
STAT,1803,51,30-34,1854,1.184775156948231E-4
STAT,1840,52,na,1892,16.782214753445686
SIM,1831,30,35-39,1861,1
STAT,1933,33,15-19,1966,0.001723641033658539
SIM,1913,8,na,1921,47
STAT,1836,39,35-39,1875,0.08206292727355975
STAT,1849,26,15-19,1875,0.00420038213862292
SIM,1819,44,na,1863,7
STAT,1836,30,45-49,1866,0.02171894073715554
STAT,1900,17,15-19,1917,0.0822933466774967
STAT,1820,38,30-34,1858,0.049378083699528
STAT,1930,17,45-49,1947,0.00642807422119536
STAT,1845,46,35-39,1891,8.206918705254751E-4
SIM,1944,21,na,1965,33
SIM,1851,4,na,1855,29
STAT,1925,23,15-19,1948,0.06312368863117243
STAT,1945,26,35-39,1971,0.16360465451871967
STAT,1798,68,na,1866,13.025734683398694
STAT,1825,43,15-19,1868,1.3183354047977949E-4
SIM,1915,5,na,1920,40
STAT,1836,57,na,1893,19.395050917579727
SIM,1854,17,na,1871,19
STAT,1813,84,na,1897,2.1954291512646424
SIM,1933,9,na,1942,55
SIM,1799,56,na,1855,19
STAT,1917,6,na,1923,42.599169282692536
STAT,1878,37,35-39,1915,0.07302208274363471
STAT,1860,49,40-44,1909,0.001362749360380776
STAT,1820,70,na,1890,7.954376097895715
STAT,1878,45,35-39,1923,0.001459794439997028
SIM,1846,46,na,1892,14
STAT,1846,105,na,1951,2.3762296029667795E-4
STAT,1893,45,50-100,1938,0.0017642199294857247
STAT,1820,34,15-19,1854,0.001388898096185061
STAT,1840,20,25-29,1860,0.5787303344587874
STAT,1850,25,50-100,1875,0.0067998743332778186
SIM,1887,38,na,1925,25
STAT,1891,47,45-49,1938,0.001626294154186629
STAT,1915,35,20-24,1950,0.002665068305760686
STAT,1822,71,na,1893,4.734746150911617
SIM,1829,71,na,1900,16
STAT,1868,58,na,1926,19.138106736647117
SIM,1874,8,na,1882,29
STAT,1869,10,na,1879,26.093478262926563
STAT,1881,21,25-29,1902,0.5463614080840348
STAT,1808,66,na,1874,3.1156046664214445
STAT,1863,25,50-100,1888,0.005746038020004655
STAT,1810,50,45-49,1860,1.4226166226480268E-4
STAT,1903,35,50-100,1938,0.0038033381749381597
STAT,1868,17,20-24,1885,0.17467339490299388
STAT,1938,9,na,1947,39.01014323534858
STAT,1923,19,na,1942,42.69135721002668
SIM,1872,66,na,1938,15
STAT,1927,35,30-34,1962,0.02258338581951545
SIM,1828,27,na,1855,19
STAT,1862,20,45-49,1882,0.006248163350760198
STAT,1930,25,na,1955,47.45241786927809
STAT,1850,28,15-19,1878,0.004719679041214602
SIM,1932,36,na,1968,48
STAT,1919,27,50-100,1946,0.01066142322072299
STAT,1924,18,15-19,1942,0.5355179951679374
SIM,1893,38,na,1931,36
STAT,1853,59,na,1912,12.2143070782584
STAT,1828,37,50-100,1865,0.005490988218791558
STAT,1800,56,na,1856,9.611645521000009
STAT,1828,28,na,1856,19.20868974439416
STAT,1866,17,50-100,1883,4.631264810211736E-4
SIM,1889,39,na,1928,32
STAT,1923,24,50-100,1947,0.00755543446309446
STAT,1845,26,30-34,1871,0.18046501353918676
STAT,1896,32,25-29,1928,0.13454029489079788
STAT,1834,20,50-100,1854,0.0039100874171479295
STAT,1849,19,25-29,1868,0.053450556318391074
STAT,1844,40,45-49,1884,0.01228344315374972
STAT,1842,26,15-19,1868,0.004240041345927762
STAT,1927,28,40-44,1955,0.05617708553252533
STAT,1816,71,na,1887,4.427599731901678
SIM,1886,80,na,1966,6
STAT,1929,22,50-100,1951,0.008281114493035712
STAT,1911,23,50-100,1934,0.006181026157376041
STAT,1921,24,40-44,1945,0.03744522110054799
STAT,1793,69,na,1862,3.710420580261293
STAT,1815,52,35-39,1867,1.1942976121594061E-4
STAT,1941,25,20-24,1966,0.18762497702434555
STAT,1859,44,na,1903,18.122161762239863
SIM,1916,40,na,1956,44
STAT,1883,45,45-49,1928,0.0023146000407648503
STAT,1893,63,na,1956,22.74539638465862
SIM,1887,65,na,1952,15
STAT,1893,17,50-100,1910,6.177275063698163E-4
SIM,1879,5,na,1884,20
STAT,1847,50,40-44,1897,1.1407634874387653E-4
SIM,1912,6,na,1918,40
SIM,1916,36,na,1952,44
STAT,1833,102,na,1935,0.0021705011932055636
STAT,1866,44,15-19,1910,1.2546921116329335E-4
STAT,1886,47,35-39,1933,0.0014454027349743946
STAT,1930,15,35-39,1945,0.054246705979210635
SIM,1873,79,na,1952,1
STAT,1877,31,45-49,1908,0.01807436004270384
STAT,1907,25,20-24,1932,0.17276619062366588
STAT,1884,32,15-19,1916,0.001395241960410624
STAT,1829,41,25-29,1870,0.005761980442747102
STAT,1910,38,25-29,1948,0.009312808824290844
STAT,1941,15,50-100,1956,0.0038330636623826924
STAT,1890,42,30-34,1932,0.013947860062214278
STAT,1913,22,40-44,1935,0.032308979969862615
SIM,1904,55,na,1959,25
SIM,1871,13,na,1884,27
SIM,1934,21,na,1955,48
STAT,1899,21,35-39,1920,0.08012502528102422
STAT,1940,28,50-100,1968,0.01007296511067528
STAT,1844,76,na,1920,7.4001230953122
STAT,1855,41,35-39,1896,0.01280708125307477
STAT,1901,48,40-44,1949,0.0013343098680146809
STAT,1928,40,30-34,1968,0.0016263323080746598
STAT,1899,23,45-49,1922,0.009516372759852482
SIM,1866,66,na,1932,26
STAT,1810,70,na,1880,5.736935314601318
STAT,1862,29,35-39,1891,0.08265255608443874
STAT,1866,42,40-44,1908,0.020689911494125097
STAT,1933,39,na,1972,50.926410324862644
STAT,1902,47,30-34,1949,7.664180868771876E-4
SIM,1858,31,na,1889,24
STAT,1915,27,20-24,1942,0.18457821792668128
STAT,1858,42,15-19,1900,1.0495578741133526E-4
STAT,1874,52,40-44,1926,1.0623353723211475E-4
STAT,1902,24,50-100,1926,0.0057146061101742045
SIM,1834,27,na,1861,22
STAT,1940,6,na,1946,40.24103894430313
STAT,1856,4,na,1860,22.831793522747226
STAT,1870,35,na,1905,23.62627890704394
STAT,1923,37,20-24,1960,0.003033251833507486
STAT,1861,24,na,1885,20.14038990299615
STAT,1891,29,15-19,1920,0.005528781032950253
STAT,1905,30,35-39,1935,0.14733284348526188
STAT,1844,28,50-100,1872,0.006072770942415642
STAT,1818,50,45-49,1868,1.4283006623906446E-4
SIM,1889,23,na,1912,29
STAT,1898,38,15-19,1936,1.6269424328792866E-4
STAT,1819,36,30-34,1855,0.06515376173494247
STAT,1900,50,na,1950,30.287484687618672
STAT,1953,18,40-44,1971,0.01681693097469005
SIM,1878,51,na,1929,28
SIM,1927,36,35-39,1963,1
SIM,1883,14,na,1897,15
SIM,1941,15,20-24,1956,4
STAT,1851,51,45-49,1902,1.2310448879692654E-4
STAT,1817,41,15-19,1858,4.498685830515935E-4
STAT,1830,35,35-39,1865,0.043216393314616776
STAT,1771,102,na,1873,0.0013202797370150785
STAT,1858,20,35-39,1878,0.0516877893982144
SIM,1837,69,na,1906,24
SIM,1872,7,na,1879,27
STAT,1812,43,20-24,1855,0.0018391946062975134
STAT,1848,24,40-44,1872,0.016173614850824657
STAT,1865,44,na,1909,20.622694584095726
SIM,1804,52,na,1856,13
STAT,1939,29,15-19,1968,0.007041279737301105
STAT,1837,44,35-39,1881,0.00922627984255136
SIM,1917,3,na,1920,47
STAT,1882,43,35-39,1925,0.01722846110176923
STAT,1919,38,45-49,1957,0.007252933055684213
SIM,1864,41,na,1905,22
STAT,1896,25,35-39,1921,0.1276020087835511
STAT,1862,40,15-19,1902,1.2034855481921362E-4
STAT,1817,40,na,1857,24.87820208187889
STAT,1860,35,na,1895,19.33535405818744
STAT,1859,3,na,1862,26.066905364771653
SIM,1854,3,na,1857,21
STAT,1886,27,30-34,1913,0.2612033628308044
STAT,1842,44,45-49,1886,0.011323692840080744
SIM,1928,21,na,1949,50
STAT,1832,22,40-44,1854,0.012714892430523468
STAT,1811,46,40-44,1857,0.006886628828355024
STAT,1830,38,na,1868,9.55837706022109
STAT,1915,5,na,1920,41.582132052136906
STAT,1925,24,50-100,1949,0.007777869288654235
STAT,1844,51,50-100,1895,1.1853125594488263E-4
STAT,1868,62,na,1930,17.68778225076786
STAT,1859,75,na,1934,8.182338443292652
STAT,1933,15,20-24,1948,1.8158773650298285
STAT,1824,38,15-19,1862,8.002849455467901E-4
SIM,1903,34,40-44,1937,1
STAT,1838,43,25-29,1881,0.005236649492619627
SIM,1907,53,na,1960,35
SIM,1857,83,na,1940,5
STAT,1875,16,15-19,1891,0.06115357609558938
STAT,1904,17,35-39,1921,0.007862402198131281
STAT,1912,27,35-39,1939,0.14679507677385809
SIM,1883,16,15-19,1899,1
SIM,1803,73,na,1876,4
STAT,1875,22,45-49,1897,0.007168062485432295
STAT,1865,82,na,1947,4.220179025521536
STAT,1865,39,15-19,1904,5.027990061852461E-4
STAT,1920,31,15-19,1951,0.0014012916900671703
STAT,1830,90,na,1920,0.28326792994519473
SIM,1840,68,na,1908,6
STAT,1949,17,na,1966,42.53477414292624
SIM,1929,37,na,1966,48
STAT,1928,22,na,1950,45.37161731129759
SIM,1942,29,na,1971,38
STAT,1899,17,15-19,1916,0.08124006116065198
STAT,1928,33,40-44,1961,0.04866253259173124
STAT,1827,43,na,1870,16.058619642308155
STAT,1823,32,25-29,1855,0.15534065214343912
SIM,1878,82,na,1960,5
SIM,1850,8,na,1858,22
STAT,1869,23,15-19,1892,0.03186683590059674
SIM,1877,27,30-34,1904,1
STAT,1917,42,30-34,1959,0.0013220536872643783
STAT,1923,40,50-100,1963,0.001367373014994274
STAT,1929,39,50-100,1968,0.0053530476611616945
STAT,1804,70,na,1874,7.910122028428469
STAT,1901,46,35-39,1947,0.0011081633128599167
STAT,1846,45,40-44,1891,0.001401285235042817
STAT,1846,31,30-34,1877,0.1689612593678506
SIM,1911,27,na,1938,41
STAT,1887,45,50-100,1932,0.002707468861107251
SIM,1923,22,na,1945,40
STAT,1914,46,45-49,1960,0.0021429246827561112
SIM,1796,86,na,1882,2
SIM,1839,71,na,1910,14
STAT,1888,42,25-29,1930,0.007494995519535432
STAT,1910,44,35-39,1954,0.0018682225666414847
STAT,1915,38,25-29,1953,0.009811738323838724
STAT,1916,37,na,1953,38.197757988895304
SIM,1834,65,na,1899,11
STAT,1854,45,na,1899,13.88891441887606
SIM,1858,78,na,1936,9
SIM,1878,92,na,1970,2
STAT,1858,40,50-100,1898,0.008120131052062787
SIM,1847,90,na,1937,1
STAT,1845,68,na,1913,8.933060961185097
STAT,1871,16,30-34,1887,0.016088273158585794
STAT,1878,34,30-34,1912,0.1787138970157872
STAT,1914,20,35-39,1934,0.09209262423760053
STAT,1898,62,na,1960,25.810588094201766
STAT,1911,45,30-34,1956,8.424507850039222E-4
STAT,1866,22,35-39,1888,0.054182517810089995
STAT,1817,49,na,1866,22.39878864773755
SIM,1860,82,na,1942,7
STAT,1862,18,30-34,1880,0.015656656893123413
STAT,1870,44,20-24,1914,0.001556335476044575
SIM,1877,38,na,1915,28
STAT,1853,50,na,1903,13.726718638451793
STAT,1854,19,35-39,1873,0.003964944528750745
STAT,1811,55,na,1866,14.904535704286056
STAT,1937,26,45-49,1963,0.016741870045369114
STAT,1841,42,35-39,1883,0.018417988417656423
SIM,1822,33,na,1855,19
STAT,1860,45,25-29,1905,4.72940749875085E-4
STAT,1872,21,30-34,1893,0.18280020227756946
STAT,1916,4,na,1920,42.31775733595955
STAT,1866,30,na,1896,22.1541427252523
STAT,1822,98,na,1920,0.011523082709970385
STAT,1850,47,20-24,1897,1.0634568102811262E-4
SIM,1883,45,na,1928,11
STAT,1879,44,25-29,1923,0.006556675731490971
SIM,1846,50,na,1896,13
STAT,1795,102,na,1897,7.17661908883392E-4
SIM,1859,26,na,1885,21
STAT,1796,102,na,1898,1.2742854849050382E-4
STAT,1830,27,50-100,1857,0.005795627664527066
STAT,1838,46,45-49,1884,0.0019087493732401451
STAT,1897,31,50-100,1928,0.012217055685501048
SIM,1963,7,na,1970,54
SIM,1798,71,na,1869,4
SIM,1954,14,na,1968,50
STAT,1893,25,na,1918,30.29527931186451
STAT,1909,18,30-34,1927,0.023706293903973684
STAT,1856,30,na,1886,17.86609338656818
STAT,1837,33,30-34,1870,0.1056958696921605
STAT,1851,41,15-19,1892,1.1711437824092535E-4
STAT,1869,30,20-24,1899,0.026401582681580885
SIM,1849,26,na,1875,12
STAT,1855,43,40-44,1898,0.015722073150283688
STAT,1793,90,na,1883,0.1669884615202641
SIM,1807,66,na,1873,14
STAT,1886,77,na,1963,11.469357686039043
SIM,1891,74,na,1965,25
STAT,1878,58,na,1936,20.417063520656935
STAT,1806,54,35-39,1860,2.679365548634104E-4
STAT,1833,36,15-19,1869,5.252053882739189E-4
SIM,1955,2,na,1957,46
STAT,1783,73,na,1856,2.4819527547
STAT,1853,97,na,1950,0.03376353352996651
STAT,1876,39,50-100,1915,0.012344017067402128
STAT,1872,41,35-39,1913,0.01861154053675802
STAT,1835,29,25-29,1864,0.24826781125705608
STAT,1937,33,35-39,1970,0.08978442708504746
SIM,1841,13,na,1854,24
SIM,1816,46,na,1862,12
SIM,1942,26,na,1968,37
STAT,1890,23,25-29,1913,0.6932154276709532
STAT,1855,39,50-100,1894,0.008557166540686518
STAT,1942,27,30-34,1969,0.408247539688445
SIM,1911,37,na,1948,40
STAT,1805,50,35-39,1855,1.7330333136693663E-4
STAT,1913,15,35-39,1928,0.008547137503617228
STAT,1874,48,50-100,1922,0.002460283968265178
SIM,1897,65,na,1962,36
STAT,1917,47,25-29,1964,5.490267321801061E-4
SIM,1890,27,na,1917,27
STAT,1811,48,30-34,1859,0.0037739079107734818
STAT,1873,31,25-29,1904,0.10456136730763525
SIM,1839,64,na,1903,17
STAT,1877,18,25-29,1895,0.058342172946850686
STAT,1946,24,50-100,1970,0.007265634837248546
STAT,1900,17,50-100,1917,6.793615577184014E-4
STAT,1857,17,45-49,1874,5.747547278012107E-4
STAT,1811,65,na,1876,11.20330154750323
STAT,1785,105,na,1890,6.109459887908841E-4
STAT,1873,40,40-44,1913,0.02309897013417772
SIM,1859,16,na,1875,22
STAT,1945,25,40-44,1970,0.050813323311949654
STAT,1862,30,na,1892,20.75373899247399
STAT,1945,24,na,1969,39.70887643577633
STAT,1941,28,25-29,1969,0.6756276823569892
STAT,1883,44,15-19,1927,1.3229453382186088E-4
STAT,1916,37,30-34,1953,0.0185046350212334
SIM,1877,45,na,1922,27
STAT,1828,29,35-39,1857,0.14000847547117845
STAT,1873,45,35-39,1918,0.0014375600582644719
STAT,1860,45,na,1905,18.47294083700515
STAT,1941,21,40-44,1962,0.03450669694124229
STAT,1896,41,20-24,1937,1.4551618685840388E-4
SIM,1935,16,25-29,1951,1
SIM,1948,14,na,1962,39
STAT,1883,49,25-29,1932,5.476642647809563E-4
STAT,1887,32,30-34,1919,0.19057416668397348
STAT,1843,40,50-100,1883,0.004733866130599261
STAT,1924,25,na,1949,43.62805559257398
SIM,1889,30,na,1919,32
STAT,1817,43,na,1860,23.954727063546397
STAT,1887,46,40-44,1933,0.0018739667245700014
STAT,1888,30,25-29,1918,0.12065699705263731
SIM,1873,9,na,1882,31
STAT,1842,16,na,1858,22.24662682899041
SIM,1848,78,na,1926,9
STAT,1929,31,35-39,1960,0.11558971662180179
SIM,1895,32,30-34,1927,1
STAT,1962,5,na,1967,50.07414827626095
STAT,1936,28,35-39,1964,0.14274508092190527
STAT,1902,31,30-34,1933,0.24722079232423974
STAT,1916,32,50-100,1948,0.008463079799367623
STAT,1902,48,50-100,1950,0.0019291086501495762
STAT,1927,16,25-29,1943,0.5373862602862381
SIM,1886,20,20-24,1906,1
STAT,1879,47,45-49,1926,0.0024312359623954887
STAT,1844,45,na,1889,17.850526362899707
SIM,1836,50,na,1886,4
STAT,1936,10,na,1946,37.81935714494126
SIM,1923,12,na,1935,42
STAT,1827,49,na,1876,14.924661256474035
SIM,1847,93,na,1940,1
STAT,1857,18,50-100,1875,4.285270668408461E-4
SIM,1815,51,na,1866,11
STAT,1874,37,15-19,1911,5.696832044373032E-4
STAT,1902,36,25-29,1938,0.008805776362827828
STAT,1855,40,20-24,1895,0.0011294372066041312
STAT,1872,30,na,1902,24.612283123896184
SIM,1830,68,na,1898,5
STAT,1855,2,na,1857,25.079359202532835
STAT,1863,48,45-49,1911,0.0020632832435014434
STAT,1836,28,30-34,1864,0.31221017755579084
STAT,1873,70,na,1943,14.264951929219805
STAT,1842,43,15-19,1885,1.0583347592797207E-4
STAT,1849,41,50-100,1890,0.0082287012315412
SIM,1860,72,na,1932,12
STAT,1771,88,na,1859,0.6943488133528988
STAT,1919,35,40-44,1954,0.01603174594324592
STAT,1922,22,35-39,1944,0.10718819623970646
STAT,1898,18,45-49,1916,8.788924096022523E-4
STAT,1831,40,35-39,1871,0.01840375252962554
STAT,1886,25,50-100,1911,0.006680329796280995
STAT,1939,5,na,1944,39.88400157762433
SIM,1828,31,na,1859,19
SIM,1839,20,25-29,1859,1
STAT,1861,19,25-29,1880,0.05413019520423098
STAT,1922,15,45-49,1937,0.005765577176082801
STAT,1890,26,45-49,1916,0.013533167621956962
STAT,1915,52,na,1967,36.082157388026864
STAT,1832,30,25-29,1862,0.061114420439998124
SIM,1852,53,na,1905,20
STAT,1925,46,20-24,1971,1.334058342962793E-4
SIM,1892,12,na,1904,36
STAT,1832,44,35-39,1876,0.009707749285710512
STAT,1866,15,45-49,1881,6.248409237326586E-4
STAT,1867,18,na,1885,24.56249442340198
STAT,1900,12,na,1912,35.81118887526362
SIM,1895,30,na,1925,25
STAT,1912,34,50-100,1946,0.008002840484828322
STAT,1850,45,na,1895,20.231500979736584
STAT,1900,38,30-34,1938,0.015872472936533173
STAT,1936,35,40-44,1971,0.014632688669986871
SIM,1809,51,na,1860,1
STAT,1823,35,45-49,1858,0.014885366167280457
STAT,1840,90,na,1930,0.6177877707133843
SIM,1908,18,20-24,1926,1
STAT,1914,43,40-44,1957,0.0024540197629348477
STAT,1842,48,25-29,1890,4.26730557218629E-4
STAT,1896,22,30-34,1918,0.23397075083419927
STAT,1897,22,na,1919,31.406790601321497
STAT,1829,31,30-34,1860,0.16957840729077864
STAT,1885,37,na,1922,23.26562342938446
STAT,1850,32,35-39,1882,0.09432459928481714
SIM,1845,22,25-29,1867,1
STAT,1840,32,25-29,1872,0.09775630454209784
SIM,1878,3,na,1881,31
STAT,1842,41,40-44,1883,0.017685020915677054
STAT,1879,40,25-29,1919,0.0067134539810147255
STAT,1886,81,na,1967,8.981569540876105
STAT,1832,41,30-34,1873,0.006404857490103226
STAT,1932,34,45-49,1966,0.020806872936181275
SIM,1880,35,40-44,1915,2
STAT,1928,18,na,1946,46.03092920509241
STAT,1890,20,20-24,1910,0.8420765680134472
STAT,1857,41,50-100,1898,0.007944468650649884
STAT,1878,20,20-24,1898,0.7157096866118806
SIM,1865,26,na,1891,24
STAT,1860,31,15-19,1891,0.0011624667635197613
SIM,1867,45,na,1912,11
SIM,1849,64,na,1913,3
STAT,1842,20,50-100,1862,0.003915031635612104
STAT,1888,40,35-39,1928,0.02137465769181584
STAT,1825,48,25-29,1873,5.244738551936899E-4
STAT,1849,22,35-39,1871,0.05470595510645041
STAT,1937,30,30-34,1967,0.1550653710040037
SIM,1910,42,na,1952,31
STAT,1917,44,20-24,1961,1.8201839821253997E-4
STAT,1832,102,na,1934,0.0013251768149640047
SIM,1822,39,na,1861,17
SIM,1909,26,25-29,1935,2
STAT,1834,21,45-49,1855,0.00663824195909668
STAT,1945,21,25-29,1966,1.0054206828901624
STAT,1931,11,na,1942,51.709553275546725
STAT,1882,39,15-19,1921,5.327374718995028E-4
STAT,1846,35,50-100,1881,0.010608608091839883
STAT,1892,39,25-29,1931,0.03521182758810459
STAT,1901,49,50-100,1950,0.0018980561599702811
STAT,1900,30,35-39,1930,0.1415589982107111
STAT,1852,40,20-24,1892,0.0013729132953133154
SIM,1879,30,na,1909,16
STAT,1911,43,40-44,1954,0.002357676693902478
STAT,1901,43,30-34,1944,0.0011090411264819237
STAT,1852,49,30-34,1901,8.111634338778219E-4
STAT,1852,16,na,1868,23.901268422769288
STAT,1841,53,40-44,1894,1.0139167914445087E-4
STAT,1867,20,45-49,1887,0.00679784944759126
SIM,1842,53,na,1895,20
STAT,1862,64,na,1926,14.99794154312936
SIM,1892,59,na,1951,31
STAT,1854,33,30-34,1887,0.10815868692199188
SIM,1933,15,na,1948,53
STAT,1864,33,40-44,1897,0.03873285730147935
SIM,1859,19,na,1878,20
STAT,1872,35,40-44,1907,0.04521467391195383
STAT,1936,18,40-44,1954,0.013275387701396501
STAT,1846,34,35-39,1880,0.0949958833788997
SIM,1837,79,na,1916,10
STAT,1882,21,25-29,1903,0.5502660592845121
STAT,1837,22,25-29,1859,0.39042582918473073
STAT,1914,41,50-100,1955,0.0011561059159361025
STAT,1924,35,15-19,1959,2.2535878764755424E-4
STAT,1848,27,45-49,1875,0.008571954218280076
SIM,1881,71,na,1952,7
STAT,1814,42,25-29,1856,0.020519822556890027
STAT,1824,42,35-39,1866,0.02454075896643663
STAT,1843,97,na,1940,0.022788706814913698
STAT,1871,82,na,1953,4.651828494654068
SIM,1897,58,na,1955,38
STAT,1915,49,30-34,1964,8.853098842771822E-4
SIM,1838,27,na,1865,12
SIM,1908,48,na,1956,37
STAT,1878,46,50-100,1924,0.002542816594644349
SIM,1885,29,30-34,1914,1
STAT,1901,22,15-19,1923,0.04616222024112714
STAT,1776,94,na,1870,0.02801007058410329
STAT,1835,31,na,1866,12.536311443542463
STAT,1806,51,30-34,1857,1.966999847328608E-4
STAT,1854,16,30-34,1870,0.011723150390053963
STAT,1913,19,na,1932,38.948944652438435
STAT,1816,51,40-44,1867,1.2991945657243916E-4
STAT,1874,96,na,1970,0.46368249861424626
STAT,1844,16,20-24,1860,0.17707055629882343
STAT,1906,44,45-49,1950,0.0014895271427116331
SIM,1818,65,na,1883,17
SIM,1880,27,na,1907,32
STAT,1864,36,45-49,1900,0.017966096033763364
STAT,1845,31,na,1876,15.220305574201728
STAT,1868,41,45-49,1909,0.014549200179755136
SIM,1894,44,na,1938,29
STAT,1877,29,30-34,1906,0.2580850836008284
STAT,1878,23,25-29,1901,0.589187510184912
STAT,1832,98,na,1930,0.01468369275358019
SIM,1872,36,45-49,1908,1
STAT,1872,24,35-39,1896,0.05933311780389898
STAT,1857,15,na,1872,20.437003420799492
STAT,1955,17,na,1972,48.58714063793451
STAT,1966,3,na,1969,48.81559070269033
STAT,1833,47,20-24,1880,1.0406885385884236E-4
SIM,1803,66,na,1869,5
STAT,1921,0,na,1921,50.95211808903936
SIM,1877,11,na,1888,31
STAT,1838,43,40-44,1881,0.018342350187412454
STAT,1915,31,40-44,1946,0.03967300206511608
STAT,1828,43,30-34,1871,0.005012940539996801
SIM,1879,77,na,1956,5
STAT,1883,42,40-44,1925,0.021815409298848065
SIM,1908,16,30-34,1924,1
STAT,1879,41,20-24,1920,0.0016511682527129818
STAT,1873,42,30-34,1915,0.011674201535544118
STAT,1911,48,35-39,1959,0.0012093415011781006
STAT,1884,48,na,1932,21.765889554208428
SIM,1932,26,na,1958,48
STAT,1901,48,25-29,1949,4.489266810708299E-4
STAT,1832,34,50-100,1866,0.0052445327741345365
SIM,1907,59,na,1966,33
STAT,1805,65,na,1870,6.721371159748447
STAT,1903,19,40-44,1922,0.002586448086720555
STAT,1843,105,na,1948,1.243764037988213E-4
STAT,1831,34,40-44,1865,0.04476370843161698
STAT,1866,49,25-29,1915,5.194092401196159E-4
STAT,1928,36,45-49,1964,0.008581188209288207
STAT,1901,26,30-34,1927,0.353571729778692
STAT,1937,23,40-44,1960,0.03252539991964713
SIM,1962,5,na,1967,48
SIM,1824,72,na,1896,10
STAT,1830,32,na,1862,10.003743785805177
STAT,1841,31,na,1872,26.006824676536343
STAT,1822,47,45-49,1869,0.0012962208872429333
STAT,1895,34,30-34,1929,0.2247310219749962
STAT,1967,5,na,1972,48.79300121812679
STAT,1847,41,25-29,1888,0.006986961477812916
STAT,1874,17,45-49,1891,6.626912001749163E-4
STAT,1879,44,40-44,1923,0.022965990468106313
STAT,1837,97,na,1934,0.025976096492344287
STAT,1921,27,45-49,1948,0.01910412069387153
STAT,1910,35,20-24,1945,0.0025295488746295597
STAT,1858,96,na,1954,0.06533971414711016
STAT,1900,20,40-44,1920,0.02906821063752984
STAT,1893,41,20-24,1934,0.0020114981175674987
STAT,1835,68,na,1903,6.873723334697116
STAT,1834,83,na,1917,2.805489090694367
STAT,1812,45,50-100,1857,0.0028328896021971857
STAT,1887,35,35-39,1922,0.07793467709803102
STAT,1803,91,na,1894,0.21717319873028798
STAT,1846,41,25-29,1887,0.005335140187986206
STAT,1859,27,20-24,1886,0.09485303197417298
SIM,1894,0,na,1894,32
STAT,1875,37,na,1912,24.21808276403492
STAT,1877,15,20-24,1892,0.18385499234809097
STAT,1954,16,35-39,1970,0.0515926132222207
STAT,1918,22,na,1940,39.02914021708075
STAT,1906,37,20-24,1943,0.0024172089238507664
STAT,1899,0,na,1899,40.19649774232207
STAT,1876,81,na,1957,6.209772975084832
SIM,1824,65,na,1889,15
STAT,1936,25,30-34,1961,0.3730413601225172
STAT,1858,16,15-19,1874,0.053063847844736806
STAT,1823,50,na,1873,14.426988367075484
STAT,1841,38,15-19,1879,6.40905148235523E-4
STAT,1849,82,na,1931,3.617839570359849
STAT,1776,87,na,1863,0.3762435243701403
STAT,1909,17,50-100,1926,7.305910671689718E-4
STAT,1917,19,35-39,1936,0.04435895684717389
STAT,1855,43,25-29,1898,0.004488573467638944
STAT,1876,15,50-100,1891,4.998957819409127E-4
SIM,1939,5,na,1944,31
STAT,1845,21,20-24,1866,0.5037005206703726
STAT,1895,17,30-34,1912,0.020692493448030678
STAT,1940,18,na,1958,37.095007096203766
STAT,1867,15,na,1882,25.00167708418929
STAT,1924,25,20-24,1949,0.212587121801315
STAT,1904,24,40-44,1928,0.0296717820581315
STAT,1891,33,35-39,1924,0.12377141307353648
STAT,1828,83,na,1911,2.666200231975946
STAT,1890,43,45-49,1933,0.01804840527622293
STAT,1834,41,15-19,1875,1.1916835361261771E-4
STAT,1902,33,20-24,1935,0.03795731482771593
STAT,1828,26,30-34,1854,0.4109879263073727
STAT,1878,30,15-19,1908,0.001482059834248692
STAT,1919,31,25-29,1950,0.09925667493132634
STAT,1906,37,na,1943,34.49809336025544
STAT,1892,77,na,1969,14.858100637452527
STAT,1869,47,35-39,1916,0.001350193806596718
STAT,1874,31,50-100,1905,0.009333218612227585
SIM,1873,45,na,1918,27
SIM,1903,27,35-39,1930,2
STAT,1833,54,45-49,1887,1.0643178519751786E-4
STAT,1921,17,35-39,1938,0.047457459898915005
STAT,1823,32,40-44,1855,0.06577119916099886
STAT,1905,19,50-100,1924,7.032791767829558E-4
STAT,1896,44,25-29,1940,5.778347841571842E-4
STAT,1891,40,25-29,1931,0.007961131172725459
SIM,1938,14,na,1952,40
SIM,1866,16,15-19,1882,2
STAT,1872,17,50-100,1889,5.02919171071534E-4
STAT,1860,42,20-24,1902,0.0012895170433599634
STAT,1930,32,50-100,1962,0.0106201695918588
STAT,1928,26,35-39,1954,0.18469287753859057
STAT,1950,15,20-24,1965,1.5939778846271613
STAT,1864,53,45-49,1917,1.2807522110520897E-4
STAT,1890,23,40-44,1913,0.025233871973983298
STAT,1875,42,15-19,1917,1.4178228928749047E-4
STAT,1836,24,15-19,1860,0.04141755585420795
STAT,1841,40,45-49,1881,0.015617586639158056
STAT,1871,19,35-39,1890,0.0054412942353193345
SIM,1857,93,na,1950,1
STAT,1839,43,50-100,1882,0.006066442809585684
STAT,1910,12,na,1922,38.893428528109176
STAT,1880,26,35-39,1906,0.10181180200671243
STAT,1934,30,50-100,1964,0.011253422247274379
SIM,1885,30,na,1915,25
SIM,1919,33,40-44,1952,1
STAT,1817,50,na,1867,22.138551748469613
STAT,1883,47,50-100,1930,0.0023738571897921395
STAT,1816,43,50-100,1859,0.014172819847372826
SIM,1855,64,na,1919,11
STAT,1851,35,20-24,1886,0.00671545976981016
STAT,1874,48,20-24,1922,1.2020931916975207E-4
STAT,1887,22,na,1909,25.8146885768066
SIM,1872,60,na,1932,18
STAT,1890,22,50-100,1912,0.004953441910423603
STAT,1916,33,15-19,1949,0.001309825219175968
STAT,1865,43,35-39,1908,0.016260266223031623
STAT,1888,32,50-100,1920,0.010707227505794432
STAT,1894,31,45-49,1925,0.022440014623838288
STAT,1855,82,na,1937,3.2850660638164446
STAT,1870,33,50-100,1903,0.009063468784178193
STAT,1910,38,40-44,1948,0.014159102106099792
SIM,1903,60,na,1963,31
STAT,1849,32,45-49,1881,0.014248229449910166
STAT,1827,40,45-49,1867,0.012040878547726511
STAT,1898,15,40-44,1913,0.0024788275708073214
STAT,1905,52,na,1957,31.27429738685919
STAT,1841,33,50-100,1874,0.010768878860990521
STAT,1886,22,20-24,1908,0.7148060842587795
STAT,1818,38,50-100,1856,0.015638225381409965
STAT,1842,66,na,1908,12.297148094289165
STAT,1845,37,30-34,1882,0.032733206735108725
STAT,1887,78,na,1965,11.65201844594829
STAT,1847,45,40-44,1892,0.0018470543192043553
STAT,1829,44,50-100,1873,0.009101960268262297
STAT,1846,56,na,1902,16.529767424633548
STAT,1920,46,50-100,1966,0.0024851007064915394
STAT,1884,39,35-39,1923,0.06859964160687089
SIM,1945,18,na,1963,38
STAT,1947,21,45-49,1968,0.012633820943819969
STAT,1913,15,50-100,1928,7.63137135717511E-4
SIM,1901,3,na,1904,42
STAT,1924,21,50-100,1945,0.007737048236701579
STAT,1886,36,35-39,1922,0.07371814159684313
STAT,1840,31,40-44,1871,0.04182202007081769
STAT,1819,45,35-39,1864,0.0012954881899819948
STAT,1863,17,25-29,1880,0.05725220172769109
STAT,1895,73,na,1968,19.046312525602595
STAT,1936,28,50-100,1964,0.00946353186474207
STAT,1836,31,20-24,1867,0.03331826128750427
SIM,1862,39,na,1901,22
STAT,1852,32,50-100,1884,0.008119114155025637
STAT,1920,47,45-49,1967,0.002382041074720364
STAT,1854,51,na,1905,13.223884967233936
STAT,1899,63,na,1962,26.055854647107218
STAT,1817,48,35-39,1865,0.003989705340436967
STAT,1823,34,45-49,1857,0.013880745225476077
SIM,1875,81,na,1956,2
SIM,1892,22,40-44,1914,1
STAT,1856,27,35-39,1883,0.07243246122467911
STAT,1836,42,30-34,1878,0.013199228582995107
STAT,1883,88,na,1971,3.721499265810603
STAT,1834,45,30-34,1879,8.179153298728529E-4
STAT,1841,26,50-100,1867,0.007833208191047887
STAT,1844,104,na,1948,5.209907217903711E-4
SIM,1808,51,na,1859,15
STAT,1825,31,45-49,1856,0.022067244087373733
STAT,1911,37,na,1948,36.10373662476016
STAT,1817,37,25-29,1854,0.11506276824512575
STAT,1852,27,20-24,1879,0.11694399327364065
STAT,1939,29,20-24,1968,0.18206737460468084
STAT,1877,49,45-49,1926,0.002385271431840186
STAT,1884,28,25-29,1912,0.41299013498519516
STAT,1892,43,50-100,1935,0.012957206344623183
STAT,1824,53,na,1877,16.38409648012462
STAT,1834,34,20-24,1868,0.023965477565824636
SIM,1853,78,na,1931,4
STAT,1858,35,45-49,1893,0.015313396122749538
STAT,1847,32,35-39,1879,0.12701835607265904
STAT,1812,68,na,1880,7.141324635686804
STAT,1894,46,40-44,1940,0.0012411607463009278
SIM,1908,20,20-24,1928,2
STAT,1884,22,40-44,1906,0.020416157706979826
STAT,1831,42,25-29,1873,0.006360636569743674
STAT,1919,23,35-39,1942,0.1018959397204205
SIM,1906,19,na,1925,29
STAT,1893,15,15-19,1908,0.0751750661261641
SIM,1898,50,na,1948,28
STAT,1862,21,20-24,1883,0.6130385121232065
STAT,1899,36,45-49,1935,0.027420855763251765
STAT,1819,47,30-34,1866,8.716675607430516E-4
SIM,1851,27,25-29,1878,1
STAT,1927,42,25-29,1969,8.910048525932044E-4
STAT,1825,94,na,1919,0.10774562073717915
STAT,1843,27,25-29,1870,0.22083285315232754
STAT,1832,37,20-24,1869,0.004374550843720957
SIM,1865,63,na,1928,13
STAT,1896,43,40-44,1939,0.0020368479371400314
STAT,1936,20,30-34,1956,0.27330719378035956
SIM,1910,24,na,1934,29
SIM,1894,60,na,1954,26
STAT,1874,12,na,1886,26.521761005246155
STAT,1881,37,50-100,1918,0.011682505686506509
SIM,1914,38,na,1952,37
SIM,1907,44,na,1951,38
STAT,1873,30,na,1903,24.45646537735416
STAT,1949,20,40-44,1969,0.03901064275406522
STAT,1769,90,na,1859,1.3886976267057975
STAT,1890,25,45-49,1915,0.01357838363947642
STAT,1923,22,na,1945,42.19591756965743
SIM,1861,73,na,1934,12
STAT,1841,25,na,1866,26.681410777551402
STAT,1923,37,15-19,1960,2.2096539315577857E-4
STAT,1816,58,na,1874,7.353059146601152
STAT,1927,31,15-19,1958,0.0015735997428004112
STAT,1897,20,25-29,1917,0.7647319524088503
STAT,1860,24,20-24,1884,0.5692636460058776
STAT,1897,39,45-49,1936,0.005656373551028369
STAT,1821,39,40-44,1860,0.07599892491067828
STAT,1878,25,20-24,1903,0.12193926366031174
STAT,1843,38,35-39,1881,0.031544138679036784
SIM,1880,9,na,1889,35
STAT,1849,42,40-44,1891,0.01741921682176022
STAT,1879,46,45-49,1925,0.0024495586611811247
STAT,1817,99,na,1916,0.015009620061384774
STAT,1865,32,50-100,1897,0.008287325053969499
STAT,1851,21,45-49,1872,0.007081073436263345
SIM,1902,29,na,1931,32
STAT,1850,61,na,1911,16.637675275329066
STAT,1863,28,50-100,1891,0.00564388448568878
STAT,1885,9,na,1894,25.622386039039895
STAT,1939,16,15-19,1955,0.45128474762255844
STAT,1948,14,na,1962,44.64067081251636
STAT,1897,28,35-39,1925,0.12768243618358024
STAT,1845,35,35-39,1880,0.048738524672707784
STAT,1821,37,45-49,1858,0.04074852870631756
SIM,1857,68,na,1925,14
STAT,1847,34,30-34,1881,0.1951831197520986
STAT,1925,34,15-19,1959,0.0015144808545090233
STAT,1820,63,na,1883,10.32665403684921
SIM,1852,37,na,1889,28
STAT,1898,40,40-44,1938,0.0021283238711043762
STAT,1915,27,na,1942,37.87994627637728
STAT,1862,32,30-34,1894,0.15063626634445226
STAT,1902,60,na,1962,28.42651868879324
STAT,1919,36,40-44,1955,0.015957358642069257
STAT,1917,28,30-34,1945,0.40574642705769676
STAT,1838,45,45-49,1883,0.0019333610595279366
STAT,1873,22,35-39,1895,0.05932889534232664
SIM,1819,35,na,1854,8
STAT,1851,49,25-29,1900,4.761239081168149E-4
SIM,1860,32,na,1892,25
STAT,1936,29,na,1965,35.5992760653337
STAT,1870,43,20-24,1913,0.00156623407540111
STAT,1879,27,na,1906,24.700754172881258
SIM,1823,40,na,1863,11
STAT,1860,21,40-44,1881,0.01758983666761942
STAT,1933,23,50-100,1956,0.008689560946840237
STAT,1843,30,50-100,1873,0.004770556015903945
STAT,1899,39,25-29,1938,0.008421608543239563
STAT,1917,39,40-44,1956,0.015313808819111223
SIM,1891,12,na,1903,38
SIM,1786,90,na,1876,1
STAT,1862,38,45-49,1900,0.017113790689614748
STAT,1839,38,15-19,1877,3.664998484760148E-4
STAT,1841,27,45-49,1868,0.013498346258084274
SIM,1799,81,na,1880,3
SIM,1890,70,na,1960,18
STAT,1895,25,20-24,1920,0.15333746171311793
SIM,1895,26,na,1921,29
STAT,1938,27,50-100,1965,0.009795980420750331
SIM,1886,65,na,1951,21
STAT,1869,38,30-34,1907,0.05138434881977758
STAT,1878,16,30-34,1894,0.016495802631171633
STAT,1831,23,na,1854,19.888998600130577
STAT,1860,38,35-39,1898,0.057215716690269335
STAT,1879,40,30-34,1919,0.01201924820715612
STAT,1886,38,30-34,1924,0.05500771663750373
STAT,1912,47,40-44,1959,0.0015033571940798467
STAT,1890,20,15-19,1910,0.040312440812877874
STAT,1904,67,na,1971,26.384497312497643
STAT,1947,23,40-44,1970,0.03772878420661632
SIM,1811,55,na,1866,10
STAT,1828,34,20-24,1862,0.011953581505548618
STAT,1891,18,45-49,1909,7.996442058757337E-4
STAT,1841,16,35-39,1857,0.00696802325101181
STAT,1840,99,na,1939,0.014840175966302292
STAT,1881,33,25-29,1914,0.09705153609091242
SIM,1856,27,na,1883,16
STAT,1883,36,50-100,1919,0.011979765474416265
STAT,1892,22,45-49,1914,0.008614764014975115
STAT,1832,64,na,1896,7.85753338708966
STAT,1860,27,25-29,1887,0.3475837760195165
STAT,1903,41,30-34,1944,0.0011401810527448787
STAT,1837,24,20-24,1861,0.44315203517785556
STAT,1928,29,45-49,1957,0.021158980204704504
STAT,1829,84,na,1913,2.25962142857117
STAT,1854,24,20-24,1878,0.4878340464327928
STAT,1882,28,45-49,1910,0.010603066278673861
STAT,1879,41,15-19,1920,1.4357985581687078E-4
STAT,1875,46,30-34,1921,9.97873144742829E-4
STAT,1943,18,30-34,1961,0.1282704714120742
SIM,1902,13,na,1915,37
STAT,1880,19,50-100,1899,5.124128354521719E-4
SIM,1903,54,na,1957,33
STAT,1820,79,na,1899,3.9634012799935965
STAT,1875,35,20-24,1910,0.007999134812431166
STAT,1835,19,15-19,1854,0.07140192998764844
STAT,1924,18,20-24,1942,1.5997752746357647
STAT,1834,31,40-44,1865,0.03966618371854345
STAT,1830,24,35-39,1854,0.08393001658563246
STAT,1870,41,25-29,1911,0.006407978637514342
STAT,1891,18,15-19,1909,0.07264769080449648
SIM,1932,18,20-24,1950,3
STAT,1850,17,15-19,1867,0.06456860762486731
STAT,1844,73,na,1917,9.277477276631144
SIM,1847,9,na,1856,25
STAT,1873,24,30-34,1897,0.1799624749815168
STAT,1913,15,40-44,1928,0.002849045999495441
STAT,1927,31,50-100,1958,0.010124480847224617
SIM,1864,7,na,1871,23
STAT,1872,43,25-29,1915,0.006522896622141933
STAT,1807,81,na,1888,2.558020383066649
STAT,1862,86,na,1948,1.9142692377232882
STAT,1853,10,na,1863,18.27416910403519
SIM,1862,24,20-24,1886,1
SIM,1920,26,na,1946,45
STAT,1782,72,na,1854,4.0
STAT,1853,45,40-44,1898,0.0010866866955256493
STAT,1922,41,40-44,1963,0.0028540092847619517
SIM,1892,25,20-24,1917,1
STAT,1830,26,30-34,1856,0.2554825071475469
STAT,1959,3,na,1962,51.160938814876864
SIM,1849,57,na,1906,7
STAT,1922,17,50-100,1939,0.0043041850107789275
STAT,1854,26,50-100,1880,0.004536948677044813
STAT,1847,48,20-24,1895,1.2657775321435976E-4
STAT,1861,40,45-49,1901,0.01271307627725898
STAT,1843,21,40-44,1864,0.011175475005388383
STAT,1881,32,40-44,1913,0.041265741218718476
STAT,1869,36,35-39,1905,0.06886231484793805
STAT,1849,48,25-29,1897,4.4101352120987206E-4
STAT,1909,18,25-29,1927,0.0842836472590961
STAT,1861,45,na,1906,19.10878608051529
SIM,1841,53,na,1894,14
STAT,1943,29,40-44,1972,0.04923010162419426
STAT,1814,41,40-44,1855,0.07458755724847826
STAT,1907,18,20-24,1925,0.2586449392481549
SIM,1849,33,na,1882,9
STAT,1936,32,25-29,1968,0.08923202836670702
STAT,1862,37,30-34,1899,0.04598171208185914
STAT,1821,34,40-44,1855,0.10920656327028927
STAT,1835,41,50-100,1876,0.0058089175142850905
STAT,1880,17,25-29,1897,0.059588658355229605
STAT,1934,24,15-19,1958,0.07118579520163885
SIM,1826,29,na,1855,17
SIM,1843,41,50-100,1884,1
STAT,1892,1,na,1893,33.62614658339793
STAT,1919,37,50-100,1956,0.004471431348908316
STAT,1891,43,na,1934,28.16240090992115
STAT,1857,19,20-24,1876,0.15415633194447256
STAT,1910,23,15-19,1933,0.04953085162545826
STAT,1867,39,35-39,1906,0.06700384897853008
STAT,1897,36,40-44,1933,0.05841107388293741
STAT,1858,38,25-29,1896,0.021800428784537654
STAT,1859,16,20-24,1875,0.1645353574913189
STAT,1847,48,50-100,1895,0.00259062457988429
STAT,1819,82,na,1901,2.3951055336226426
STAT,1915,15,45-49,1930,0.0010412993238246096
STAT,1811,86,na,1897,1.257397256488688
STAT,1815,92,na,1907,0.14867538655464435
STAT,1834,37,25-29,1871,0.02530878557103061
SIM,1837,48,na,1885,29
STAT,1838,40,15-19,1878,1.2860306812539075E-4
STAT,1926,29,40-44,1955,0.055158605176766656
STAT,1927,6,na,1933,49.58102860875513
STAT,1832,88,na,1920,0.6205339394928063
STAT,1847,37,35-39,1884,0.07839225969548358
STAT,1872,40,50-100,1912,0.010918370681940149
STAT,1882,47,na,1929,21.46068966127125
STAT,1919,20,30-34,1939,0.3138538601667159
STAT,1873,86,na,1959,3.167618546202829
STAT,1956,16,15-19,1972,0.5973131649547927
STAT,1814,51,na,1865,12.93519474125091
STAT,1863,16,40-44,1879,0.0018588584337039136
STAT,1839,27,35-39,1866,0.0670807837719705
STAT,1864,34,30-34,1898,0.1552594522475228
STAT,1870,2,na,1872,33.00410559853675
STAT,1940,21,35-39,1961,0.09526991332420115
STAT,1874,54,45-49,1928,1.4317854282795667E-4
STAT,1926,18,30-34,1944,0.14819720648777773
STAT,1858,46,30-34,1904,7.386857848708014E-4
STAT,1916,52,na,1968,36.73062268084481
STAT,1847,48,45-49,1895,0.002489362385410403
STAT,1833,89,na,1922,0.7777566399398302
STAT,1890,38,20-24,1928,0.009317080686931432
STAT,1906,22,40-44,1928,0.030273904624759287
STAT,1930,15,40-44,1945,0.018082236373343462
STAT,1874,34,50-100,1908,0.00921565034321698
SIM,1845,43,na,1888,23
STAT,1890,42,na,1932,28.040131781423216
STAT,1882,28,20-24,1910,0.11203188851887577
STAT,1934,35,25-29,1969,0.01355316048535832
STAT,1869,25,na,1894,23.280892596569007
STAT,1898,22,na,1920,31.90452615279659
STAT,1791,89,na,1880,0.3556998006944294
STAT,1896,46,45-49,1942,0.0017535917917878817
STAT,1846,17,25-29,1863,0.05769077400238157
STAT,1936,23,35-39,1959,0.08944684107116908
STAT,1874,71,na,1945,13.541437546404925
STAT,1938,31,45-49,1969,0.015727173627293978
STAT,1839,38,45-49,1877,0.013010743073602987
STAT,1877,46,40-44,1923,0.0017722484251341578
STAT,1865,28,15-19,1893,0.004089237084942123
STAT,1916,25,50-100,1941,0.010272828684523871
STAT,1830,27,45-49,1857,0.010059371668955427
STAT,1864,35,45-49,1899,0.018049847325353002
SIM,1888,28,35-39,1916,1
SIM,1900,7,na,1907,40
STAT,1856,24,30-34,1880,0.14772136004259653
STAT,1836,47,30-34,1883,9.776633402354762E-4
STAT,1818,84,na,1902,0.8313347913378664
STAT,1893,18,25-29,1911,0.0712632956913408
STAT,1848,63,na,1911,11.539091297293812
STAT,1867,25,15-19,1892,0.0043712102656297625
STAT,1908,34,15-19,1942,0.001196353479614563
SIM,1828,71,na,1899,7
SIM,1836,47,na,1883,4
STAT,1938,20,35-39,1958,0.0926390753429086
STAT,1871,17,50-100,1888,4.916037903085027E-4
STAT,1903,44,35-39,1947,0.0017636497780554948
STAT,1858,81,na,1939,4.114918764132884
STAT,1812,45,25-29,1857,6.64391042082356E-4
STAT,1897,25,30-34,1922,0.33667310585600335
STAT,1841,84,na,1925,3.256156717241587
STAT,1812,42,15-19,1854,1.6237379272115188E-4
STAT,1918,19,50-100,1937,0.004019328916316198
SIM,1872,97,na,1969,1
STAT,1908,45,25-29,1953,4.8425171846011307E-4
SIM,1882,35,na,1917,30
STAT,1903,42,na,1945,32.93254964802443
SIM,1889,14,na,1903,34
SIM,1886,49,na,1935,27
STAT,1834,48,35-39,1882,0.0010358824867033128
STAT,1849,45,45-49,1894,0.001848167018707595
STAT,1826,38,35-39,1864,0.0797736635844549
STAT,1901,47,35-39,1948,0.0010998742512797243
STAT,1971,0,na,1971,49.83770839648614
STAT,1861,17,20-24,1878,0.17136063695519368
STAT,1936,21,15-19,1957,0.05060117223142706
STAT,1931,19,50-100,1950,0.004855970140393319
STAT,1788,69,na,1857,8.047526868936
SIM,1944,2,na,1946,36
STAT,1832,24,45-49,1856,0.004194005061164778
STAT,1895,28,30-34,1923,0.32577455362935454
STAT,1893,29,35-39,1922,0.12079161908173636
STAT,1850,17,45-49,1867,7.107165058781628E-4
STAT,1877,76,na,1953,9.779678981178858
STAT,1914,31,35-39,1945,0.09159731641895132
STAT,1810,48,25-29,1858,5.54451062646936E-4
SIM,1795,91,na,1886,1
STAT,1951,18,na,1969,43.55126291580393
SIM,1878,14,na,1892,31
STAT,1828,37,30-34,1865,0.023836140343829696
SIM,1870,50,na,1920,21
STAT,1881,30,15-19,1911,0.0013659631263205844
STAT,1840,34,45-49,1874,0.01630111799390135
STAT,1881,35,45-49,1916,0.019149041776209897
STAT,1888,45,50-100,1933,0.0028986901970809494
STAT,1927,30,30-34,1957,0.19303542716905628
STAT,1876,19,30-34,1895,0.01610125400447198
STAT,1860,24,45-49,1884,0.005760346178757036
STAT,1864,48,20-24,1912,1.0627836593697506E-4
STAT,1900,16,15-19,1916,0.08249546055585862
STAT,1821,51,50-100,1872,2.0912112746312753E-4
STAT,1876,28,20-24,1904,0.11873057863816222
STAT,1865,28,45-49,1893,0.01000720142404252
STAT,1886,39,45-49,1925,0.020469653523158444
STAT,1879,43,na,1922,23.74875861251716
STAT,1893,15,45-49,1908,8.274634112718643E-4
STAT,1905,26,50-100,1931,0.00926398793379544
STAT,1890,58,na,1948,24.021933893023743
STAT,1860,35,30-34,1895,0.04373950426053344
STAT,1814,44,45-49,1858,0.044454246440676116
STAT,1932,39,na,1971,50.237188061666465
STAT,1888,63,na,1951,20.851344329356717
STAT,1864,30,15-19,1894,0.0012875540285665608
SIM,1903,34,35-39,1937,1
STAT,1828,37,25-29,1865,0.012876995287474385
SIM,1965,5,na,1970,52
SIM,1877,29,na,1906,25
STAT,1894,42,50-100,1936,9.390462852077506E-4
SIM,1869,5,na,1874,19
STAT,1908,41,50-100,1949,0.0010875020608854815
STAT,1889,17,45-49,1906,7.997641358445306E-4
STAT,1789,67,na,1856,4.6406978
STAT,1865,35,na,1900,21.51189433593166
STAT,1871,25,35-39,1896,0.09685250235554604
STAT,1804,92,na,1896,0.16169623556020954
STAT,1857,40,na,1897,17.47671129551762
STAT,1880,17,30-34,1897,0.016760383469998634
SIM,1851,12,na,1863,27
STAT,1854,27,25-29,1881,0.271056323994644
STAT,1877,32,20-24,1909,0.027902622765523376
STAT,1838,44,30-34,1882,0.009255944330649062
STAT,1944,24,na,1968,39.116261878090164
STAT,1837,26,40-44,1863,0.019064909458563505
SIM,1862,27,25-29,1889,1
SIM,1922,6,na,1928,53
STAT,1877,43,30-34,1920,0.011781848724932962
STAT,1873,48,50-100,1921,0.0024656222216985642
SIM,1837,32,na,1869,29
STAT,1858,54,50-100,1912,1.1176324734810561E-4
STAT,1911,18,40-44,1929,0.00277363458843612
STAT,1919,17,na,1936,40.32272349018094
STAT,1937,16,35-39,1953,0.04066357347672421
SIM,1924,16,na,1940,55
STAT,1861,61,na,1922,15.714394005257864
STAT,1865,75,na,1940,9.311354181338764
STAT,1876,78,na,1954,7.935572420583333
SIM,1886,25,na,1911,30
STAT,1879,45,30-34,1924,0.0010118780907846698
STAT,1877,60,na,1937,19.687073055510947
STAT,1834,34,45-49,1868,0.015460829966339391
STAT,1808,47,25-29,1855,4.15823038756027E-4
STAT,1926,15,20-24,1941,1.66039914286259
SIM,1862,15,na,1877,26
STAT,1845,15,na,1860,17.16071482169294
SIM,1866,29,na,1895,26
STAT,1875,49,35-39,1924,0.0014090713282655975
STAT,1922,44,45-49,1966,0.001889978306545394
STAT,1854,27,30-34,1881,0.16135895757852556
SIM,1862,27,30-34,1889,1
STAT,1891,5,na,1896,32.164768415757855
STAT,1894,49,45-49,1943,0.0016704798427167118
STAT,1895,28,25-29,1923,0.547247294373453
STAT,1882,25,40-44,1907,0.028902563465516992
STAT,1841,24,40-44,1865,0.025468761024849417
STAT,1881,41,30-34,1922,0.01098909168006094
STAT,1870,81,na,1951,5.3718928535585695
STAT,1866,32,45-49,1898,0.016060280708457084
SIM,1798,56,na,1854,9
SIM,1850,73,na,1923,8
STAT,1945,26,40-44,1971,0.05079198171615866
STAT,1837,28,50-100,1865,0.003994227994068928
SIM,1824,81,na,1905,5
STAT,1855,92,na,1947,0.29324095174198644
SIM,1833,58,na,1891,9
STAT,1881,30,20-24,1911,0.025927525337562207
STAT,1887,18,25-29,1905,0.06169072529051901
STAT,1819,48,45-49,1867,0.0020967237514411302
STAT,1929,42,35-39,1971,0.0025952983531413146
STAT,1910,39,30-34,1949,0.017150169626205917
STAT,1875,38,25-29,1913,0.029449683307190663
STAT,1900,37,na,1937,32.92770065587001
SIM,1882,75,na,1957,18
SIM,1953,13,na,1966,50
STAT,1803,54,40-44,1857,1.9741183501322202E-4
STAT,1788,103,na,1891,5.147132859233236E-4
STAT,1956,16,45-49,1972,0.006574717051017862
STAT,1855,42,40-44,1897,0.01581697500028541
STAT,1903,44,40-44,1947,0.0021906917649503117
STAT,1894,32,na,1926,30.582768866288635
STAT,1810,61,na,1871,8.024540537670475
STAT,1835,27,20-24,1862,0.0704036575235351
STAT,1865,17,35-39,1882,0.0051142859488374735
STAT,1821,64,na,1885,10.982754984525307
STAT,1947,20,30-34,1967,0.32283274610660545
STAT,1866,41,35-39,1907,0.01675272152983768
SIM,1896,33,35-39,1929,1
STAT,1870,45,40-44,1915,0.0017176363142535906
STAT,1921,21,25-29,1942,1.0382865441803029
STAT,1828,43,na,1871,17.597587863132066
STAT,1848,16,45-49,1864,5.267802730644319E-4
STAT,1888,33,35-39,1921,0.11784527954021456
STAT,1836,78,na,1914,7.540681649094096
STAT,1906,3,na,1909,38.407243422151666
SIM,1934,15,20-24,1949,2
STAT,1843,37,20-24,1880,0.003817308743323666
STAT,1907,16,na,1923,37.03407647149192
SIM,1849,17,na,1866,16
STAT,1917,24,15-19,1941,0.05571038212229433
STAT,1823,33,30-34,1856,0.16170452186094636
STAT,1825,41,40-44,1866,0.02227853179738508
STAT,1858,35,20-24,1893,0.0059214412256087786
STAT,1853,45,35-39,1898,8.886456642782373E-4
STAT,1874,19,20-24,1893,0.17888990546291067
STAT,1876,15,15-19,1891,0.060554054639243765
SIM,1805,86,na,1891,1
SIM,1826,45,na,1871,15
STAT,1915,28,20-24,1943,0.18392850259957938
STAT,1901,47,40-44,1948,0.0013449890813203636
STAT,1891,27,na,1918,29.291322259995695
STAT,1886,53,na,1939,21.97608770925678
STAT,1891,25,50-100,1916,0.007904618947938287
STAT,1853,34,25-29,1887,0.06492820478402708
STAT,1855,42,35-39,1897,0.012733696677494645
STAT,1946,16,50-100,1962,0.004127311070478753
STAT,1908,30,20-24,1938,0.023088346862348803
SIM,1853,22,na,1875,22
STAT,1791,92,na,1883,0.10788260789558682
STAT,1937,16,40-44,1953,0.013554525277032246
STAT,1874,51,40-44,1925,1.073131070894345E-4
STAT,1810,45,20-24,1855,1.2012441935980943E-4
SIM,1893,75,na,1968,21
STAT,1828,99,na,1927,0.012719380653789957
STAT,1820,101,na,1921,0.0032350068476007425
STAT,1817,59,na,1876,18.525611474148064
STAT,1885,41,45-49,1926,0.014846417322959818
STAT,1892,32,40-44,1924,0.053576127146578306
STAT,1919,22,20-24,1941,1.2070417817325005
SIM,1872,32,35-39,1904,1
SIM,1817,71,na,1888,2
STAT,1842,47,na,1889,16.882902256746423
STAT,1862,47,35-39,1909,0.0012022393305182633
STAT,1855,45,45-49,1900,0.0016781702547460499
STAT,1862,35,40-44,1897,0.03812622893515488
STAT,1901,5,na,1906,36.66978213487142
STAT,1921,24,35-39,1945,0.10486127010111451
STAT,1819,43,15-19,1862,1.2852707547705605E-4
STAT,1918,16,na,1934,41.897665959749034
STAT,1861,0,na,1861,32.525145322167916
SIM,1834,40,na,1874,20
STAT,1868,37,50-100,1905,0.011881422926908265
STAT,1910,36,na,1946,35.93388414788332
SIM,1893,41,45-49,1934,2
STAT,1890,24,30-34,1914,0.21501182841923105
STAT,1909,17,40-44,1926,0.0027275406473671643
SIM,1852,77,na,1929,18
STAT,1886,34,15-19,1920,0.0014645000857724801
SIM,1841,37,na,1878,16
STAT,1877,17,na,1894,26.070848539820414
STAT,1917,23,25-29,1940,0.9697864581098755
STAT,1908,17,na,1925,37.270292257762186
STAT,1910,34,30-34,1944,0.1496926660211838
STAT,1839,24,30-34,1863,0.1244943298423042
STAT,1853,46,25-29,1899,3.630329761307208E-4
STAT,1890,22,35-39,1912,0.07088374544169283
STAT,1901,33,15-19,1934,0.0019842573691167585
SIM,1854,63,na,1917,15
STAT,1919,20,25-29,1939,1.008672277156099
SIM,1913,13,na,1926,47
STAT,1908,49,40-44,1957,0.0014101381316433315
STAT,1863,19,45-49,1882,5.935166360953051E-4
STAT,1920,44,35-39,1964,0.002197703875264421
SIM,1918,2,na,1920,41
STAT,1823,31,35-39,1854,0.15747379847233958
SIM,1900,65,na,1965,23
STAT,1839,35,40-44,1874,0.02947433218838759
STAT,1812,49,40-44,1861,0.0018722805699632422
STAT,1864,6,na,1870,25.43687638900153
SIM,1927,39,45-49,1966,2
STAT,1941,18,20-24,1959,1.385879582309499
STAT,1867,29,30-34,1896,0.2392585142314076
STAT,1821,46,35-39,1867,0.002008135787811857
STAT,1875,35,45-49,1910,0.020686504409142513
STAT,1908,38,30-34,1946,0.016891370814370688
STAT,1886,22,15-19,1908,0.03421966488433017
STAT,1808,82,na,1890,0.6813170727195603
STAT,1828,26,50-100,1854,0.010440270629594921
STAT,1949,23,15-19,1972,0.061697512297891326
STAT,1907,18,15-19,1925,0.08658029757213273
STAT,1884,37,15-19,1921,5.501754134826454E-4
STAT,1912,37,45-49,1949,0.006601628049901133
SIM,1925,23,25-29,1948,2
SIM,1942,20,20-24,1962,2
SIM,1875,25,na,1900,17
SIM,1828,55,na,1883,9
STAT,1855,44,30-34,1899,0.007985206916504445
SIM,1824,41,na,1865,18
STAT,1865,91,na,1956,0.5930805922585201
STAT,1933,39,50-100,1972,0.005683296236634898
STAT,1821,35,25-29,1856,0.0701901762954034
STAT,1848,101,na,1949,0.003690221403623515
SIM,1838,30,na,1868,12
STAT,1870,43,15-19,1913,1.361942747821542E-4
STAT,1917,35,25-29,1952,0.010230089254517002
STAT,1859,51,45-49,1910,1.15899009792308E-4
STAT,1868,42,20-24,1910,0.0015350134737331486
STAT,1930,18,45-49,1948,0.006411232666735831
STAT,1854,11,na,1865,17.534679183475806
STAT,1858,25,na,1883,18.860296678630927
SIM,1811,71,na,1882,3
STAT,1867,61,na,1928,17.882105484329216
STAT,1829,44,na,1873,17.2699096820976
STAT,1830,24,40-44,1854,0.02997081787194817
SIM,1860,29,na,1889,25
STAT,1873,25,45-49,1898,0.011364953937530219
STAT,1873,21,50-100,1894,0.004158492063653708
STAT,1938,33,40-44,1971,0.03906503371306451
SIM,1925,35,25-29,1960,1
STAT,1945,0,na,1945,48.30587748005453
STAT,1816,41,45-49,1857,0.0210970213320228
STAT,1856,23,40-44,1879,0.01740648443658023
SIM,1812,56,na,1868,18
SIM,1897,68,na,1965,36
STAT,1845,33,15-19,1878,9.795532417558725E-4
STAT,1839,43,na,1882,13.271786435700825
STAT,1853,66,na,1919,10.3008708587371
STAT,1870,30,45-49,1900,0.017462174737088887
STAT,1866,20,na,1886,22.278278487876594
STAT,1844,43,50-100,1887,0.008343730439057832
STAT,1826,35,30-34,1861,0.06467745035986348
STAT,1837,29,45-49,1866,0.006870747360192074
SIM,1865,3,na,1868,25
SIM,1896,27,na,1923,32
STAT,1903,32,50-100,1935,0.013026567020285346
STAT,1883,45,20-24,1928,1.1769153196294453E-4
STAT,1894,35,25-29,1929,0.037249997044574414
STAT,1931,38,na,1969,49.554647953718835
STAT,1837,18,35-39,1855,0.005019707010201103
SIM,1873,39,na,1912,25
STAT,1919,39,45-49,1958,0.007244809770661848
STAT,1936,35,35-39,1971,0.023642670783675424
STAT,1882,28,15-19,1910,0.004332725005083118
STAT,1833,37,50-100,1870,0.011364279835967262
SIM,1864,65,na,1929,13
STAT,1893,26,30-34,1919,0.31860249294987464
STAT,1831,63,na,1894,14.479516714113126
STAT,1877,47,25-29,1924,5.918103902424269E-4
STAT,1831,41,40-44,1872,0.022567752219894942
SIM,1874,24,na,1898,21
STAT,1827,58,na,1885,12.581618635085597
STAT,1861,41,50-100,1902,0.008924489781699569
STAT,1925,45,30-34,1970,0.0010785238946365268
STAT,1805,51,40-44,1856,2.0774888669540035E-4
STAT,1941,19,na,1960,37.61228885506367
STAT,1862,21,15-19,1883,0.02934778103882215
STAT,1893,15,20-24,1908,0.2245736149726054
STAT,1828,35,35-39,1863,0.03194540803362401
SIM,1860,51,na,1911,18
STAT,1934,20,20-24,1954,1.492859345220724
STAT,1886,36,40-44,1922,0.04562490529037107
STAT,1887,15,20-24,1902,0.19440736011956863
SIM,1912,50,na,1962,35
SIM,1870,10,na,1880,27
STAT,1852,19,15-19,1871,0.06070797491576828
SIM,1885,64,na,1949,17
STAT,1909,42,na,1951,34.542798633110976
STAT,1888,36,45-49,1924,0.023407970602607197
SIM,1881,50,na,1931,20
STAT,1949,23,45-49,1972,0.013041131539585091
STAT,1856,35,40-44,1891,0.032013263759327865
STAT,1948,20,50-100,1968,0.007510331428200609
SIM,1935,33,35-39,1968,1
SIM,1885,24,na,1909,21
SIM,1801,53,na,1854,10
STAT,1927,33,35-39,1960,0.11176947582348111
STAT,1819,45,40-44,1864,0.0015841969829532134
STAT,1934,28,30-34,1962,0.5246166021855316
SIM,1839,74,na,1913,12
STAT,1836,46,25-29,1882,5.892512495516573E-4
STAT,1872,42,40-44,1914,0.02298558629945638
SIM,1851,15,na,1866,26
STAT,1876,15,45-49,1891,6.665277092545501E-4
SIM,1876,50,na,1926,27
STAT,1922,21,na,1943,41.69656370245581
STAT,1871,23,15-19,1894,0.03278964726867616
STAT,1907,32,na,1939,35.20271987460529
SIM,1910,8,na,1918,33
STAT,1785,77,na,1862,9.427860268328295
STAT,1842,44,20-24,1886,0.0012015914165642069
SIM,1831,75,na,1906,2
STAT,1863,25,na,1888,21.436949250470647
SIM,1794,66,na,1860,2
SIM,1872,14,na,1886,26
STAT,1878,26,35-39,1904,0.09995909099076197
STAT,1926,18,25-29,1944,0.5268896575312263
SIM,1905,18,na,1923,40
STAT,1842,26,na,1868,20.216673693266795
STAT,1846,19,45-49,1865,6.572122950070869E-4
STAT,1885,12,na,1897,25.50266003691348
SIM,1867,16,20-24,1883,1
STAT,1817,45,30-34,1862,0.002882413754854417
STAT,1847,35,45-49,1882,0.02255832658303313
STAT,1855,76,na,1931,6.670383177742481
STAT,1836,45,40-44,1881,0.0017739682883345393
SIM,1842,78,na,1920,8
STAT,1843,29,15-19,1872,0.0023346456513093647
STAT,1894,46,35-39,1940,0.0010149679023530736
STAT,1933,24,na,1957,48.20915194784381
STAT,1894,47,25-29,1941,4.144632407086669E-4
STAT,1899,20,35-39,1919,0.08036048149179516
STAT,1841,27,15-19,1868,0.005515821633342333
STAT,1869,65,na,1934,16.374746463552537
STAT,1827,44,25-29,1871,0.004885944333738904
STAT,1826,29,15-19,1855,0.011864706273902292
SIM,1954,3,na,1957,52
STAT,1883,32,45-49,1915,0.016933934067763903
STAT,1865,25,40-44,1890,0.02727831427898757
STAT,1867,25,45-49,1892,0.010697247600555442
STAT,1921,37,40-44,1958,0.01658471057836683
STAT,1852,18,30-34,1870,0.016401221680657264
STAT,1862,34,20-24,1896,0.023121369400837984
SIM,1848,32,na,1880,32
SIM,1905,5,na,1910,40
STAT,1902,24,25-29,1926,0.8022163219477928
STAT,1807,97,na,1904,0.0226726556669978
STAT,1867,36,30-34,1903,0.05124743274797943
STAT,1876,75,na,1951,10.455687841444734
STAT,1897,26,45-49,1923,0.014794928888060053
STAT,1865,51,na,1916,19.568310330261703
STAT,1851,31,40-44,1882,0.03850417536539477
STAT,1839,32,50-100,1871,0.0062224315124738685
STAT,1825,48,50-100,1873,0.0022362982594492957
STAT,1853,31,20-24,1884,0.01767694725392993
STAT,1898,43,45-49,1941,0.0013918855882861319
STAT,1912,20,15-19,1932,0.05091811980951515
STAT,1809,45,na,1854,17.966267842969007
STAT,1850,53,45-49,1903,1.2713878063555346E-4
SIM,1884,39,na,1923,22
STAT,1908,33,25-29,1941,0.08642396447857191
STAT,1853,4,na,1857,20.151104604096
STAT,1897,47,50-100,1944,0.001831157241751304
STAT,1806,56,na,1862,14.713433776445314
STAT,1887,38,na,1925,25.58812339887938
STAT,1833,33,na,1866,20.44156898423261
STAT,1912,31,25-29,1943,0.09060415759129378
STAT,1921,39,na,1960,41.59164292025853
STAT,1901,49,30-34,1950,7.480937978817122E-4
STAT,1947,23,35-39,1970,0.10565535774653925
STAT,1904,24,35-39,1928,0.08309259930457716
STAT,1892,68,na,1960,20.182722203940532
STAT,1888,30,30-34,1918,0.20567396760337178
SIM,1907,0,na,1907,43
STAT,1862,44,30-34,1906,0.009785043940742972
STAT,1939,16,45-49,1955,0.0049673600033290554
STAT,1932,27,15-19,1959,0.009209084416108543
STAT,1942,25,50-100,1967,0.01037968532393147
STAT,1885,40,50-100,1925,0.010537887724005506
STAT,1840,33,30-34,1873,0.16491569716994908
STAT,1884,36,30-34,1920,0.05246796375697898
STAT,1838,42,35-39,1880,0.016436474921859637
STAT,1873,34,35-39,1907,0.10207962087271842
STAT,1884,25,20-24,1909,0.11571890745241806
SIM,1800,68,na,1868,9
STAT,1843,51,na,1894,9.177299894671075
STAT,1906,20,45-49,1926,0.010191244291915187
STAT,1836,44,20-24,1880,0.0017771907177886773
STAT,1880,80,na,1960,8.304407352954518
SIM,1872,76,na,1948,8
STAT,1929,25,50-100,1954,0.012444546532475995
STAT,1864,10,na,1874,24.645526909321138
SIM,1862,36,na,1898,23
STAT,1875,52,50-100,1927,1.5442106821259442E-4
STAT,1897,39,15-19,1936,1.593344851749159E-4
STAT,1910,35,15-19,1945,1.842717955083033E-4
STAT,1930,35,na,1965,48.927954070551
STAT,1845,17,50-100,1862,3.6196116083406037E-4
STAT,1903,47,45-49,1950,0.0018838394624979356
SIM,1942,23,25-29,1965,1
STAT,1917,53,na,1970,37.2154285103524
STAT,1937,7,na,1944,38.64196905485057
STAT,1864,46,50-100,1910,0.0022090968763079305
STAT,1899,23,na,1922,32.2759039900917
STAT,1910,7,na,1917,39.23751264736255
STAT,1849,52,50-100,1901,1.1648199344556507E-4
STAT,1892,35,45-49,1927,0.02486157928194417
STAT,1853,42,30-34,1895,0.007216553158131118
STAT,1825,44,45-49,1869,0.014024796788524137
STAT,1928,26,40-44,1954,0.05733893871565528
STAT,1878,61,na,1939,19.292121642368272
STAT,1799,69,na,1868,7.770257081239722
STAT,1821,48,na,1869,15.931625536955657
STAT,1929,19,na,1948,46.49882766710527
SIM,1874,40,na,1914,25
STAT,1913,18,45-49,1931,0.0010101569520419215
STAT,1855,14,na,1869,19.8101144529955
STAT,1942,20,na,1962,38.03616100076024
SIM,1887,50,na,1937,24
STAT,1905,41,35-39,1946,0.0018230389407737973
STAT,1920,30,50-100,1950,0.00905133864219965
STAT,1877,45,20-24,1922,1.251062755865629E-4
SIM,1884,61,na,1945,18
STAT,1821,43,30-34,1864,0.01733141044185564
STAT,1868,45,25-29,1913,5.629785407443137E-4
STAT,1895,26,35-39,1921,0.12569760409880804
STAT,1954,2,na,1956,48.37099282418922
STAT,1929,16,na,1945,46.864353510282974
STAT,1845,21,15-19,1866,0.02411348112303239
SIM,1861,14,na,1875,33
STAT,1840,46,45-49,1886,0.0018888921583807405
STAT,1789,102,na,1891,4.613891367634743E-4
STAT,1792,74,na,1866,9.142609108036027
STAT,1897,2,na,1899,35.398775017054746
STAT,1823,49,50-100,1872,0.0016635648587530506
SIM,1914,54,na,1968,32
STAT,1888,60,na,1948,22.287264136925412
STAT,1842,31,45-49,1873,0.01597020150217763
STAT,1877,23,50-100,1900,0.00419645435001507
SIM,1849,23,45-49,1872,1
STAT,1876,51,45-49,1927,1.4809994427867696E-4
STAT,1892,22,50-100,1914,0.0050378738849253145
SIM,1903,14,na,1917,39
SIM,1869,23,25-29,1892,2
STAT,1881,34,30-34,1915,0.1647143980582747
SIM,1925,28,30-34,1953,1
SIM,1927,4,na,1931,52
STAT,1920,41,30-34,1961,0.0014019778698136241
STAT,1908,22,15-19,1930,0.048683596478442226
STAT,1917,20,20-24,1937,1.178038485229314
SIM,1896,24,na,1920,31
STAT,1821,100,na,1921,0.006593756271822276
STAT,1843,24,20-24,1867,0.3616742876939935
SIM,1829,96,na,1925,1
STAT,1834,74,na,1908,7.842825521689373
STAT,1875,32,40-44,1907,0.0445789375595854
STAT,1894,16,50-100,1910,6.294180175889601E-4
STAT,1895,24,15-19,1919,0.042561630348051036
STAT,1814,43,30-34,1857,0.03541269566950415
STAT,1867,38,20-24,1905,0.007340131319658451
SIM,1840,52,na,1892,14
STAT,1832,48,na,1880,10.740346934094713
STAT,1906,37,15-19,1943,1.7608808945504358E-4
STAT,1856,38,15-19,1894,4.047846323189688E-4
SIM,1935,16,na,1951,57
STAT,1812,44,35-39,1856,0.020614767691194535
STAT,1864,32,35-39,1896,0.09083197241968134
SIM,1925,20,20-24,1945,1
SIM,1926,42,na,1968,46
STAT,1843,35,30-34,1878,0.026946355237426223
STAT,1879,22,50-100,1901,0.004220671509905156
STAT,1897,24,40-44,1921,0.027498820068996333
STAT,1842,40,35-39,1882,0.014421177083495527
STAT,1828,33,15-19,1861,0.001043168803135393
STAT,1880,83,na,1963,6.571402545396251
SIM,1838,33,na,1871,10
STAT,1821,33,20-24,1854,0.07265998933074538
STAT,1877,79,na,1956,7.610908332325211
SIM,1899,16,na,1915,27
STAT,1880,43,na,1923,24.128347188967172
STAT,1827,52,50-100,1879,1.1005821183190026E-4
SIM,1815,45,na,1860,12
STAT,1887,17,40-44,1904,0.0019964010370622956
SIM,1859,32,na,1891,21
STAT,1879,43,35-39,1922,0.01860671492526161
STAT,1877,44,20-24,1921,0.00161723673084034
STAT,1860,36,15-19,1896,4.5871852368827915E-4
STAT,1826,37,20-24,1863,0.00891742546822772
STAT,1922,24,na,1946,41.310815003555575
SIM,1827,70,na,1897,4
STAT,1931,31,35-39,1962,0.11928148315439745
STAT,1893,28,20-24,1921,0.1473985376123286
SIM,1827,30,na,1857,22
STAT,1809,48,na,1857,17.289061240457404
STAT,1854,25,35-39,1879,0.06892888470920053
STAT,1908,22,45-49,1930,0.010290353076636862
STAT,1866,76,na,1942,8.725412891965915
STAT,1948,19,15-19,1967,0.5155950783763693
STAT,1863,28,na,1891,21.055841411771787
STAT,1843,29,na,1872,11.131676668025083
STAT,1899,36,20-24,1935,0.010603198954461398
STAT,1832,33,35-39,1865,0.05857174448160013
STAT,1883,41,35-39,1924,0.01766404255266185
STAT,1943,23,na,1966,38.55677824554396
STAT,1831,44,45-49,1875,0.014447956753969895
SIM,1885,7,na,1892,26
STAT,1851,34,15-19,1885,0.001225607482861867
STAT,1830,29,35-39,1859,0.07229566436079893
STAT,1899,47,30-34,1946,7.439976063980255E-4
STAT,1910,37,35-39,1947,0.022991514308976373
STAT,1810,45,50-100,1855,0.0024585463522238155
STAT,1878,28,25-29,1906,0.43519001404134966
STAT,1882,17,35-39,1899,0.005258519944661026
STAT,1934,36,50-100,1970,0.005774578486045648
STAT,1869,23,20-24,1892,0.6656584237402453
SIM,1888,75,na,1963,20
SIM,1860,88,na,1948,3
STAT,1816,50,35-39,1866,1.0838399259163475E-4
STAT,1852,25,na,1877,21.877412901312823
STAT,1912,34,40-44,1946,0.0378785471407353
SIM,1864,62,na,1926,16
STAT,1848,29,20-24,1877,0.0892752465421905
STAT,1934,23,25-29,1957,1.2356688298230083
STAT,1932,37,50-100,1969,0.005618340976546869
STAT,1827,41,20-24,1868,0.0012596881177721197
STAT,1908,57,na,1965,31.60099420120634
STAT,1805,54,45-49,1859,2.697833705166374E-4
STAT,1897,23,40-44,1920,0.027586545282996262
STAT,1923,22,40-44,1945,0.03885148434188292
STAT,1788,66,na,1854,9.0
SIM,1843,63,na,1906,18
STAT,1875,13,na,1888,26.651933261358394
SIM,1929,31,na,1960,46
STAT,1858,49,35-39,1907,0.0010430794390474006
STAT,1831,26,na,1857,23.41766507005191
STAT,1881,47,45-49,1928,0.0022351732099538764
SIM,1847,47,na,1894,15
STAT,1818,81,na,1899,1.3513858989035312
STAT,1819,85,na,1904,1.4072130624707533
STAT,1896,45,30-34,1941,7.243840053352315E-4
STAT,1851,34,45-49,1885,0.015007909824210889
STAT,1856,38,45-49,1894,0.01436985273839648
STAT,1909,15,20-24,1924,0.2656049396035871
STAT,1847,21,50-100,1868,0.005378857497860277
STAT,1878,19,35-39,1897,0.005634589437673292
STAT,1862,15,50-100,1877,4.898544476880386E-4
SIM,1806,71,na,1877,4
STAT,1943,25,25-29,1968,0.6964903054023168
STAT,1891,15,40-44,1906,0.0022553159894259885
STAT,1894,32,20-24,1926,0.034642181599925735
STAT,1843,88,na,1931,0.5823481750537297
SIM,1879,23,30-34,1902,1
STAT,1838,58,na,1896,15.349056413925828
STAT,1869,34,15-19,1903,0.0013680332115916436
SIM,1826,48,na,1874,15
STAT,1822,89,na,1911,0.372641241477985
STAT,1880,15,35-39,1895,0.005796776088488282
SIM,1875,65,na,1940,11
STAT,1859,19,25-29,1878,0.05166806617097337
STAT,1932,3,na,1935,53.49094834226287
STAT,1888,45,35-39,1933,0.0016523478372295
STAT,1836,48,45-49,1884,0.0023532166700561694
STAT,1872,40,20-24,1912,0.0016413237285731158
STAT,1914,47,20-24,1961,1.0869204969487056E-4
SIM,1896,64,na,1960,22
STAT,1878,23,30-34,1901,0.18332889544156017
STAT,1837,27,25-29,1864,0.26660516767619696
STAT,1954,16,40-44,1970,0.017197538736457213
STAT,1871,27,30-34,1898,0.2510636302173856
STAT,1902,28,40-44,1930,0.042094346678040316
STAT,1836,43,20-24,1879,0.0018001060680347604
STAT,1857,42,45-49,1899,0.011190174729549236
STAT,1873,38,20-24,1911,0.007798291435173441
STAT,1902,17,30-34,1919,0.02247653410931563
SIM,1902,69,na,1971,30
STAT,1872,45,45-49,1917,0.002438755022053838
SIM,1845,27,25-29,1872,1
STAT,1863,108,na,1971,2.7645906267263136E-4
STAT,1898,44,50-100,1942,9.762980240504075E-4
STAT,1894,43,30-34,1937,0.001015771892739911
STAT,1846,16,40-44,1862,0.0018730979519581573
SIM,1846,28,na,1874,13
SIM,1905,40,na,1945,40
SIM,1953,4,na,1957,51
STAT,1831,41,35-39,1872,0.01816851271850738
STAT,1844,18,35-39,1862,0.0054160750360845444
STAT,1939,28,15-19,1967,0.007044872622338497
STAT,1809,61,na,1870,13.342818452736953
STAT,1871,1,na,1872,35.00471530219906
STAT,1850,29,15-19,1879,0.004685791745698679
STAT,1948,17,na,1965,41.84475181113284
SIM,1827,33,na,1860,21
STAT,1805,71,na,1876,5.073728404286236
STAT,1828,35,40-44,1863,0.019771336938569414
STAT,1943,17,40-44,1960,0.01472427464786789
STAT,1852,15,20-24,1867,0.18569186887041597
STAT,1926,7,na,1933,48.729039151358165
SIM,1887,43,50-100,1930,1
STAT,1861,15,30-34,1876,0.015589140340533178
SIM,1884,79,na,1963,8
SIM,1909,30,na,1939,40
STAT,1897,27,45-49,1924,0.014744330231262887
STAT,1834,39,15-19,1873,4.834657935211559E-4
STAT,1819,35,30-34,1854,0.06675926988473256
STAT,1863,49,50-100,1912,0.00212913386893541
STAT,1916,48,30-34,1964,9.040139972784317E-4
STAT,1827,98,na,1925,0.01968673324188928
SIM,1829,34,na,1863,20
STAT,1873,33,na,1906,24.159065094941834
STAT,1889,29,20-24,1918,0.14260531324970133
SIM,1880,89,na,1969,4
STAT,1873,31,30-34,1904,0.1782370836132521
STAT,1879,24,na,1903,24.3252499697473
SIM,1934,31,na,1965,49
STAT,1834,46,20-24,1880,1.0010371457959786E-4
STAT,1841,22,na,1863,26.512004455500346
STAT,1828,28,35-39,1856,0.14542236191406496
STAT,1877,23,na,1900,24.3380381040688
SIM,1853,25,30-34,1878,1
STAT,1874,15,40-44,1889,0.0018711139005309543
STAT,1843,11,na,1854,13.0
SIM,1965,2,na,1967,52
STAT,1836,47,25-29,1883,5.817500811448648E-4
SIM,1880,55,na,1935,30
STAT,1834,44,50-100,1878,0.008772637094851392
STAT,1895,19,35-39,1914,0.007085442508290099
STAT,1861,48,na,1909,18.682427732629797
STAT,1780,86,na,1866,1.272811222371842
STAT,1837,28,45-49,1865,0.0069327131155800985
STAT,1854,23,15-19,1877,0.023522804616919538
STAT,1896,48,35-39,1944,0.0010242871946445063
STAT,1845,25,30-34,1870,0.18177012302248827
STAT,1900,27,30-34,1927,0.3491928680224027
STAT,1911,6,na,1917,39.71917307308821
STAT,1823,38,50-100,1861,0.008747106188919877
STAT,1918,45,30-34,1963,9.444882020624936E-4
STAT,1923,25,15-19,1948,0.008103582564285158
SIM,1892,74,na,1966,15
SIM,1842,38,na,1880,23
STAT,1835,93,na,1928,0.13145373187191578
STAT,1820,40,20-24,1860,0.0014502456672927239
STAT,1855,30,na,1885,17.466172739587858
SIM,1842,16,na,1858,30
STAT,1932,38,30-34,1970,0.024364340247345597
STAT,1854,25,40-44,1879,0.02139935848502605
STAT,1910,30,15-19,1940,0.001241389122481071
SIM,1881,2,na,1883,30
STAT,1840,52,50-100,1892,1.1771381600404694E-4
STAT,1917,27,40-44,1944,0.04843688608384809
STAT,1856,20,15-19,1876,0.02815964123015201
STAT,1822,43,na,1865,9.69186048946238
STAT,1947,22,35-39,1969,0.10569023552426224
SIM,1921,7,na,1928,42
STAT,1913,47,na,1960,35.55794421540422
SIM,1834,80,na,1914,3
SIM,1922,12,na,1934,52
STAT,1916,46,50-100,1962,0.002305767784201165
STAT,1886,26,30-34,1912,0.26209974395513097
STAT,1792,71,na,1863,12.149594089877748
STAT,1866,41,40-44,1907,0.020809147911658908
STAT,1919,24,40-44,1943,0.03627061399844726
SIM,1914,17,na,1931,37
STAT,1825,44,15-19,1869,1.2940989871442372E-4
STAT,1890,38,15-19,1928,6.787278175552232E-4
SIM,1826,85,na,1911,4
SIM,1877,29,35-39,1906,1
STAT,1812,42,50-100,1854,0.012421594235478381
STAT,1841,15,45-49,1856,8.344412829665522E-4
SIM,1894,26,30-34,1920,1
STAT,1865,52,45-49,1917,1.3056416804907127E-4
STAT,1859,20,na,1879,19.657152790944522
SIM,1910,27,na,1937,29
SIM,1916,18,na,1934,47
STAT,1871,34,30-34,1905,0.17258309737736746
STAT,1852,87,na,1939,1.5078400855223992
SIM,1943,14,na,1957,48
STAT,1847,22,30-34,1869,0.23326154001093866
STAT,1849,30,40-44,1879,0.03975552872523001
STAT,1943,15,15-19,1958,0.47800341447622746
STAT,1956,12,na,1968,51.68590131952857
STAT,1858,28,50-100,1886,0.004947269709462316
STAT,1843,39,25-29,1882,0.012708130055979545
STAT,1845,47,35-39,1892,8.145530953339441E-4
STAT,1885,74,na,1959,12.201647738308605
STAT,1925,22,15-19,1947,0.06331934540848462
SIM,1898,53,na,1951,25
STAT,1851,33,45-49,1884,0.015164559726182344
STAT,1930,19,na,1949,47.109859550785856
STAT,1885,19,35-39,1904,0.005389525289156437
STAT,1892,35,15-19,1927,7.003262602420838E-4
STAT,1945,25,35-39,1970,0.16367339734560482
STAT,1826,33,na,1859,20.382954927719357
STAT,1860,36,20-24,1896,0.006296953487464843
SIM,1930,41,na,1971,49
STAT,1784,76,na,1860,5.09635034851794
STAT,1839,83,na,1922,2.1907972354229353
SIM,1817,49,na,1866,8
STAT,1877,48,25-29,1925,5.871114157439018E-4
STAT,1899,24,45-49,1923,0.009486110694476158
STAT,1860,82,na,1942,3.7931878231244314
STAT,1927,30,25-29,1957,0.11324269784062638
STAT,1835,25,30-34,1860,0.15528785551062882
STAT,1860,60,na,1920,15.504850250298595
STAT,1820,60,na,1880,11.548875554600146
STAT,1832,30,30-34,1862,0.10417667965158653
SIM,1833,55,na,1888,11
SIM,1879,15,na,1894,15
STAT,1892,34,45-49,1926,0.021358867424528312
STAT,1896,12,na,1908,33.922186980082486
STAT,1880,18,45-49,1898,6.851011420769407E-4
STAT,1880,27,35-39,1907,0.10146360564384944
STAT,1830,36,35-39,1866,0.042277378160727
STAT,1850,41,45-49,1891,0.013385853850241458
STAT,1875,47,20-24,1922,1.2277798639767322E-4
STAT,1849,31,50-100,1880,0.008312636442978864
STAT,1912,35,40-44,1947,0.014634208096437066
STAT,1926,22,20-24,1948,1.3431611440436657
STAT,1898,16,40-44,1914,0.0024734237267029615
STAT,1914,35,45-49,1949,0.006814241405360751
STAT,1885,58,na,1943,19.529067981274654
STAT,1920,40,25-29,1960,7.841296337109269E-4
STAT,1816,55,na,1871,7.803176691699178
STAT,1863,18,45-49,1881,5.970331614160456E-4
STAT,1825,43,45-49,1868,0.014287458946403597
STAT,1869,36,40-44,1905,0.04261958488041199
SIM,1946,22,25-29,1968,1
STAT,1827,80,na,1907,3.7488027566651856
STAT,1842,63,na,1905,13.3872591592116
STAT,1872,42,35-39,1914,0.0185048964094824
STAT,1924,17,15-19,1941,0.5369247379814488
STAT,1844,44,25-29,1888,0.005007116840643375
STAT,1860,29,15-19,1889,0.0036746568255851884
STAT,1860,37,50-100,1897,0.009981213602219834
STAT,1865,28,20-24,1893,0.10573598663428209
STAT,1814,46,35-39,1860,0.004071403000347006
STAT,1868,80,na,1948,5.986436545379194
STAT,1897,21,15-19,1918,0.0439418325432618
SIM,1892,2,na,1894,36
STAT,1848,25,40-44,1873,0.02346258373217623
STAT,1907,17,15-19,1924,0.08680773383477988
SIM,1905,58,na,1963,40
STAT,1876,26,30-34,1902,0.25663659189747384
STAT,1848,28,20-24,1876,0.08992087844945756
STAT,1864,44,40-44,1908,0.01990195494649378
SIM,1889,70,na,1959,20
STAT,1824,39,15-19,1863,7.834602525663378E-4
STAT,1858,36,20-24,1894,0.005893965738321957
STAT,1855,36,na,1891,16.667561763042304
STAT,1919,35,35-39,1954,0.025903188400442284
SIM,1836,22,20-24,1858,1
STAT,1881,37,35-39,1918,0.06730192002369473
STAT,1821,36,25-29,1857,0.0641625687077715
STAT,1843,46,50-100,1889,0.0010503331536644862
STAT,1906,38,20-24,1944,0.002405219567588468
STAT,1871,18,35-39,1889,0.005473533346731584
STAT,1940,25,45-49,1965,0.017507096974067368
STAT,1864,72,na,1936,11.327193391927306
STAT,1823,43,40-44,1866,0.015808043597377378
STAT,1901,22,na,1923,33.09339177092212
STAT,1885,45,25-29,1930,5.744793017138683E-4
SIM,1928,3,na,1931,56
STAT,1919,22,15-19,1941,0.057784294484708947
STAT,1880,37,na,1917,24.774350830348286
SIM,1884,45,na,1929,22
STAT,1888,42,30-34,1930,0.01341845966555704
STAT,1805,51,35-39,1856,1.6988810867073036E-4
STAT,1869,48,35-39,1917,0.0013394732677723402
STAT,1790,70,na,1860,3.9976968337189436
SIM,1917,43,na,1960,34
STAT,1886,48,35-39,1934,0.0014339262372586982
SIM,1877,26,30-34,1903,1
STAT,1873,27,50-100,1900,0.006503705321074424
STAT,1814,48,na,1862,13.511037456795425
STAT,1870,31,20-24,1901,0.026961610698821588
STAT,1901,35,50-100,1936,0.0037432432842318974
STAT,1858,23,45-49,1881,0.0055004397473923375
STAT,1815,95,na,1910,0.04746091532255452
STAT,1890,34,40-44,1924,0.05222721104698616
STAT,1923,38,20-24,1961,0.0030301882491556424
STAT,1938,22,25-29,1960,0.9081552676796073
STAT,1918,19,40-44,1937,0.015005498269875699
STAT,1848,66,na,1914,10.599474684757045
STAT,1841,51,45-49,1892,1.4272931698384192E-4
SIM,1884,26,30-34,1910,1
STAT,1867,26,20-24,1893,0.11265062745613469
STAT,1928,19,40-44,1947,0.01744398470679562
STAT,1890,27,35-39,1917,0.11720581330682188
STAT,1895,26,40-44,1921,0.039023525509912074
STAT,1798,90,na,1888,0.5647707463257662
STAT,1917,37,na,1954,38.72158127224385
STAT,1932,26,50-100,1958,0.01299008232190379
SIM,1904,39,na,1943,26
STAT,1861,41,20-24,1902,0.0013415899927578683
SIM,1835,68,na,1903,10
STAT,1796,61,na,1857,1.85197185898628
STAT,1854,18,35-39,1872,0.003988436419260188
STAT,1903,40,25-29,1943,6.403864170807752E-4
STAT,1884,37,20-24,1921,0.007552406998504378
STAT,1853,7,na,1860,18.71250344837315
STAT,1840,36,35-39,1876,0.06623581979935653
STAT,1868,18,20-24,1886,0.17364456860701527
STAT,1824,51,45-49,1875,1.8496203901348206E-4
STAT,1879,40,na,1919,24.162939844464496
STAT,1857,15,40-44,1872,0.0016284401602672802
STAT,1873,89,na,1962,2.0876840353630217
STAT,1875,23,45-49,1898,0.007145913172352307
STAT,1897,43,na,1940,30.575750753354086
STAT,1865,38,na,1903,21.203820091278555
STAT,1817,46,20-24,1863,3.5212059515251585E-4
STAT,1913,27,40-44,1940,0.046054601942147784
STAT,1839,38,20-24,1877,0.005031042741549846
STAT,1891,42,45-49,1933,0.01834660420631829
STAT,1867,55,na,1922,19.787203377011107
STAT,1932,28,20-24,1960,0.23800631152902937
STAT,1899,21,40-44,1920,0.02861208227252876
STAT,1861,18,35-39,1879,0.00527248006248942
STAT,1810,104,na,1914,2.397507752294985E-4
STAT,1908,48,40-44,1956,0.0014145089643431516
SIM,1872,20,na,1892,23
STAT,1846,53,na,1899,17.16969977153194
STAT,1906,25,15-19,1931,0.0066361809553425076
STAT,1836,54,50-100,1890,1.417491706098536E-4
SIM,1949,0,na,1949,42
STAT,1851,30,40-44,1881,0.03890607512139881
STAT,1849,42,na,1891,17.899088145519777
STAT,1869,29,35-39,1898,0.09282425428262248
STAT,1850,39,na,1889,20.87100345702447
STAT,1845,35,40-44,1880,0.03016476709825159
STAT,1881,32,35-39,1913,0.09636343195196567
STAT,1803,54,na,1857,12.24900297702419
STAT,1841,47,50-100,1888,0.0024148674047192466
SIM,1825,60,na,1885,14
SIM,1890,33,na,1923,25
STAT,1902,57,na,1959,29.18599301919723
SIM,1894,23,na,1917,29
SIM,1897,12,na,1909,43
STAT,1814,41,35-39,1855,0.060047849218972174
STAT,1823,36,35-39,1859,0.051808694461089703
STAT,1859,15,15-19,1874,0.055403842439683874
STAT,1856,23,50-100,1879,0.0034063572804242694
STAT,1876,19,25-29,1895,0.05724523700073381
STAT,1810,49,30-34,1859,9.197003691625195E-4
STAT,1845,28,35-39,1873,0.06815922570035175
SIM,1814,66,na,1880,20
SIM,1874,77,na,1951,17
STAT,1873,22,40-44,1895,0.021185930721633325
SIM,1899,13,na,1912,29
STAT,1845,52,na,1897,12.51931324309635
SIM,1860,35,na,1895,25
STAT,1929,43,40-44,1972,0.0032186184085149223
STAT,1851,46,20-24,1897,1.0159534466343869E-4
STAT,1866,30,40-44,1896,0.04026140524686799
STAT,1945,15,25-29,1960,0.4702344482609706
STAT,1909,19,30-34,1928,0.02364110159573776
SIM,1822,41,35-39,1863,1
SIM,1877,51,na,1928,24
SIM,1934,37,na,1971,51
SIM,1882,38,na,1920,30
SIM,1930,25,na,1955,50
SIM,1856,83,na,1939,2
STAT,1895,38,35-39,1933,0.09136912311279284
STAT,1904,33,25-29,1937,0.08391702298955984
STAT,1845,44,30-34,1889,0.006670353628993773
STAT,1828,47,50-100,1875,0.0010521554996022313
STAT,1829,28,na,1857,19.553982643383772
SIM,1915,42,na,1957,34
STAT,1822,49,na,1871,9.014355715596828
STAT,1866,44,45-49,1910,0.013597724805154204
SIM,1853,44,30-34,1897,1
STAT,1941,28,30-34,1969,0.4021989855454291
STAT,1873,8,na,1881,27.435591431084028
STAT,1828,47,35-39,1875,5.997629087605184E-4
STAT,1844,15,30-34,1859,0.01601370755919282
STAT,1935,10,na,1945,54.089762016261915
STAT,1817,39,15-19,1856,0.001961868503351364
STAT,1914,42,na,1956,36.4957082830667
STAT,1887,18,30-34,1905,0.01735162765786116
STAT,1889,26,40-44,1915,0.03680149958573759
SIM,1842,32,na,1874,25
STAT,1901,22,50-100,1923,0.005706084741095964
STAT,1886,29,35-39,1915,0.09936975740560124
SIM,1933,36,na,1969,49
STAT,1915,38,30-34,1953,0.018162154018293717
STAT,1884,27,na,1911,23.38200795656696
STAT,1921,30,50-100,1951,0.009202556184445673
STAT,1806,96,na,1902,0.040178598154975764
STAT,1852,25,30-34,1877,0.25466756374111227
STAT,1903,34,30-34,1937,0.14131369672907895
SIM,1832,79,na,1911,9
STAT,1837,23,15-19,1860,0.02170291571564234
STAT,1843,36,20-24,1879,0.003857153135210387
STAT,1882,16,45-49,1898,6.275516647193322E-4
SIM,1943,9,na,1952,48
STAT,1842,47,25-29,1889,4.322328818039938E-4
STAT,1910,37,50-100,1947,0.003990948498370444
STAT,1923,25,na,1948,43.001786484906006
STAT,1924,0,na,1924,53.299791956312575
SIM,1936,22,25-29,1958,3
SIM,1865,66,na,1931,13
SIM,1918,47,na,1965,34
STAT,1804,52,na,1856,13.45468308131548
STAT,1885,16,30-34,1901,0.015778353761005236
STAT,1927,15,na,1942,45.74367044844624
STAT,1928,22,25-29,1950,1.147640233544427
STAT,1928,38,40-44,1966,0.018807292126535948
STAT,1926,15,15-19,1941,0.5558115782023086
STAT,1840,29,50-100,1869,0.006160520321641096
SIM,1877,23,20-24,1900,2
STAT,1842,44,15-19,1886,1.0448621577940899E-4
STAT,1850,35,50-100,1885,0.011337518611068189
SIM,1859,72,na,1931,8
STAT,1875,6,na,1881,27.979385987384344
SIM,1810,76,na,1886,10
STAT,1854,22,30-34,1876,0.12792419566562996
SIM,1885,80,na,1965,11
STAT,1838,25,50-100,1863,0.0064073296594253405
STAT,1864,50,na,1914,19.589778943675583
STAT,1909,22,20-24,1931,1.0276571095602742
STAT,1864,37,35-39,1901,0.06343865115172598
STAT,1889,42,50-100,1931,0.012918550905871264
STAT,1837,57,na,1894,9.717054071451859
STAT,1862,24,na,1886,20.5892920536838
STAT,1825,38,na,1863,15.28745706832303
STAT,1871,37,35-39,1908,0.0705170522677911
STAT,1819,38,35-39,1857,0.0731535947465485
STAT,1871,25,40-44,1896,0.03006840204686376
STAT,1906,21,35-39,1927,0.08503473262606902
STAT,1867,19,50-100,1886,4.73658551336697E-4
STAT,1813,66,na,1879,12.857188940933469
STAT,1877,20,15-19,1897,0.03425772909446853
STAT,1816,46,50-100,1862,0.0031427935721111033
STAT,1948,9,na,1957,44.67416650778397
STAT,1871,15,30-34,1886,0.01618359453036966
STAT,1912,16,na,1928,38.844924487585374
SIM,1877,69,na,1946,17
STAT,1890,25,50-100,1915,0.007823078662395516
STAT,1867,22,40-44,1889,0.020023378241923434
STAT,1910,49,35-39,1959,0.0011885613603379106
STAT,1923,48,30-34,1971,0.0010327477063661896
STAT,1814,104,na,1918,2.9722995602088337E-4
STAT,1898,19,45-49,1917,8.764754554758461E-4
STAT,1881,84,na,1965,5.595616909165822
STAT,1812,81,na,1893,2.149083333196694
SIM,1820,35,na,1855,16
STAT,1852,65,na,1917,14.463513947796613
STAT,1830,33,30-34,1863,0.11108499070992546
STAT,1900,17,20-24,1917,0.24583835178200328
STAT,1854,37,35-39,1891,0.04323217301616289
STAT,1909,43,50-100,1952,0.0010861102129866781
STAT,1939,18,na,1957,36.57895099568099
SIM,1900,43,na,1943,35
SIM,1862,52,na,1914,23
STAT,1930,23,25-29,1953,1.174139612261476
STAT,1888,33,40-44,1921,0.050464919221412566
STAT,1894,44,20-24,1938,1.3943003797169755E-4
SIM,1934,15,15-19,1949,1
STAT,1915,28,50-100,1943,0.010029250450176833
STAT,1846,17,30-34,1863,0.016226569311173028
STAT,1828,32,30-34,1860,0.2390088896789595
STAT,1862,37,25-29,1899,0.024840694896368937
STAT,1890,37,45-49,1927,0.02421494076393444
STAT,1926,25,25-29,1951,0.7898438091869329
STAT,1840,62,na,1902,14.321940953953074
STAT,1870,34,25-29,1904,0.10087772881691968
STAT,1848,104,na,1952,4.3134900551624646E-4
SIM,1887,10,na,1897,26
STAT,1878,24,15-19,1902,0.03384648348055787
SIM,1927,21,na,1948,49
STAT,1823,46,45-49,1869,0.0016589357923911228
STAT,1874,49,na,1923,22.34788443062753
STAT,1858,20,40-44,1878,0.018457345599079553
SIM,1875,22,40-44,1897,1
SIM,1889,76,na,1965,17
STAT,1840,31,35-39,1871,0.0976624499200778
SIM,1935,19,na,1954,49
STAT,1895,23,30-34,1918,0.2305343385046857
STAT,1936,24,40-44,1960,0.031929657752263724
STAT,1850,21,na,1871,23.014618560340782
STAT,1888,23,30-34,1911,0.20751079438633285
STAT,1914,32,40-44,1946,0.039065101425055024
STAT,1885,42,20-24,1927,0.001566371370648918
SIM,1934,25,25-29,1959,3
STAT,1907,44,50-100,1951,0.0010586216002725214
STAT,1940,22,40-44,1962,0.03400898846863383
STAT,1797,65,na,1862,7.038373957250397
SIM,1826,51,na,1877,14
SIM,1921,11,na,1932,42
STAT,1858,39,25-29,1897,0.021688592584872976
STAT,1915,19,30-34,1934,0.025154580484487935
STAT,1901,37,30-34,1938,0.01609638648568832
STAT,1918,15,25-29,1933,0.09421160528032882
SIM,1871,72,na,1943,13
STAT,1853,43,20-24,1896,9.90899946451656E-4
STAT,1886,45,30-34,1931,0.0010140839761852464
STAT,1844,41,20-24,1885,0.0012868407277184643
SIM,1942,10,na,1952,43
STAT,1902,29,30-34,1931,0.35257373768346784
STAT,1794,100,na,1894,0.0023032750402809886
STAT,1919,25,25-29,1944,0.7097990311580858
STAT,1846,21,50-100,1867,0.0041072158324348025
STAT,1871,20,na,1891,23.720232018814787
STAT,1889,48,na,1937,27.204460584525496
STAT,1864,47,45-49,1911,0.0021068696625597886
STAT,1904,64,na,1968,27.80837831494519
STAT,1952,15,25-29,1967,0.516518922435477
STAT,1902,16,40-44,1918,0.0025856092514752933
STAT,1817,49,25-29,1866,0.001617672831288974
STAT,1934,38,40-44,1972,0.020549681363044796
STAT,1857,18,45-49,1875,5.713694224544615E-4
STAT,1847,32,40-44,1879,0.05439310852205973
SIM,1868,55,na,1923,31
STAT,1857,77,na,1934,6.470909074345665
SIM,1848,54,na,1902,29
SIM,1901,28,na,1929,40
SIM,1937,26,na,1963,37
SIM,1811,52,na,1863,10
SIM,1885,27,na,1912,25
STAT,1904,28,45-49,1932,0.015853428815273025
STAT,1918,19,na,1937,39.487397420781775
STAT,1955,1,na,1956,51.97684160215378
STAT,1800,96,na,1896,0.03111649994143588
STAT,1825,40,40-44,1865,0.022685564620085412
STAT,1878,29,45-49,1907,0.011381036370745813
SIM,1891,49,na,1940,32
SIM,1901,10,na,1911,42
STAT,1823,90,na,1913,0.45340271423515366
STAT,1856,26,45-49,1882,0.008395086991060279
SIM,1929,32,35-39,1961,1
STAT,1883,48,25-29,1931,5.523147550182094E-4
SIM,1889,54,na,1943,24
STAT,1892,31,40-44,1923,0.05379507309407119
STAT,1893,16,20-24,1909,0.22408404449196512
STAT,1896,43,35-39,1939,0.001639795460842154
STAT,1912,38,45-49,1950,0.006568883974773619
SIM,1893,78,na,1971,21
SIM,1807,87,na,1894,1
STAT,1825,54,na,1879,12.362461146847417
SIM,1894,35,20-24,1929,1
STAT,1784,106,na,1890,1.8824523372049917E-4
STAT,1852,31,na,1883,21.36650135688903
STAT,1869,33,30-34,1902,0.16846051423929617
SIM,1943,3,na,1946,49
STAT,1866,33,45-49,1899,0.0159925063238674
SIM,1887,44,na,1931,25
STAT,1919,32,25-29,1951,0.09885270026435583
STAT,1851,37,25-29,1888,0.0245673730766374
STAT,1832,33,40-44,1865,0.025082195616605053
STAT,1888,31,15-19,1919,0.0016709741397510618
STAT,1936,8,na,1944,37.95397467824888
STAT,1864,25,35-39,1889,0.08746846505305894
SIM,1820,54,na,1874,11
STAT,1915,27,15-19,1942,0.007138384175947108
STAT,1856,38,20-24,1894,0.005556588344544834
STAT,1914,28,50-100,1942,0.009915932307203737
STAT,1851,86,na,1937,1.8731473291325191
SIM,1857,12,na,1869,23
STAT,1878,28,30-34,1906,0.2590672151802797
STAT,1895,35,30-34,1930,0.06984864266067788
STAT,1879,43,50-100,1922,0.010855395136101982
STAT,1954,18,50-100,1972,0.004603718993199731
STAT,1840,46,na,1886,18.007231340773707
STAT,1943,26,15-19,1969,0.00746704707074712
STAT,1845,38,50-100,1883,0.007462657965134853
STAT,1814,50,30-34,1864,1.7018304117726404E-4
STAT,1844,17,20-24,1861,0.1760276107222234
STAT,1873,27,35-39,1900,0.09809994361701216
STAT,1874,34,na,1908,24.00165347334987
SIM,1779,80,na,1859,3
STAT,1905,45,45-49,1950,0.0019404501188280989
STAT,1920,34,30-34,1954,0.16963947278346073
STAT,1870,43,50-100,1913,0.01041886125949183
SIM,1875,59,na,1934,13
STAT,1909,29,40-44,1938,0.04397874137569729
SIM,1875,29,25-29,1904,1
SIM,1906,1,na,1907,30
STAT,1901,21,15-19,1922,0.04630158802107055
STAT,1910,33,25-29,1943,0.08820056625383754
STAT,1902,19,45-49,1921,9.16229201613672E-4
SIM,1852,17,20-24,1869,1
STAT,1847,37,50-100,1884,0.0136076061329031
STAT,1833,31,50-100,1864,0.008824820987992562
STAT,1925,34,50-100,1959,0.0097441121702762
STAT,1928,22,30-34,1950,0.3570944949494311
SIM,1862,61,na,1923,21
STAT,1862,49,na,1911,19.005547119391665
STAT,1812,42,20-24,1854,0.0018672985154388317
STAT,1869,45,30-34,1914,9.472860891179577E-4
STAT,1783,97,na,1880,0.004964731516442512
STAT,1836,94,na,1930,0.19288665194567464
STAT,1845,38,45-49,1883,0.012117122482929704
STAT,1849,67,na,1916,12.291641148061526
STAT,1929,36,50-100,1965,0.005369354021682609
STAT,1838,35,35-39,1873,0.06763075786082441
STAT,1835,21,15-19,1856,0.029120034300868545
SIM,1868,52,na,1920,31
STAT,1932,34,15-19,1966,0.0016991745995435887
STAT,1888,45,40-44,1933,0.0020205853505809437
STAT,1855,32,30-34,1887,0.12516667620166183
STAT,1824,39,20-24,1863,0.01075477120483623
STAT,1837,27,30-34,1864,0.1587091985432858
STAT,1919,44,25-29,1963,7.645876006002616E-4
STAT,1871,27,25-29,1898,0.421745316880579
STAT,1871,28,45-49,1899,0.011030760651285585
STAT,1889,29,45-49,1918,0.013496635717453537
STAT,1903,30,15-19,1933,0.0020409316294421912
STAT,1926,11,na,1937,48.37379828693784
STAT,1916,45,20-24,1961,1.1290919751017239E-4
SIM,1894,23,20-24,1917,1
STAT,1889,19,50-100,1908,5.966063735517332E-4
STAT,1923,21,35-39,1944,0.10912783217385157
STAT,1886,23,20-24,1909,0.7125973334584198
STAT,1937,15,35-39,1952,0.040752413738674505
STAT,1823,43,35-39,1866,0.012726506315523831
STAT,1869,26,30-34,1895,0.2448351884466806
STAT,1805,50,50-100,1855,3.04023557531995E-4
STAT,1926,19,30-34,1945,0.14778966416993636
SIM,1906,4,na,1910,29
SIM,1922,9,na,1931,52
STAT,1862,46,na,1908,19.46594140348655
STAT,1882,63,na,1945,17.099768773908007
STAT,1870,59,na,1929,19.306150960938226
STAT,1857,54,45-49,1911,1.0565353924761923E-4
STAT,1886,35,20-24,1921,0.008071692489514991
STAT,1899,25,50-100,1924,0.008816374337095154
STAT,1825,32,50-100,1857,0.010989604199211432
STAT,1917,36,15-19,1953,1.9859725495492104E-4
SIM,1845,27,na,1872,23
STAT,1838,47,35-39,1885,0.0011178946588492604
STAT,1933,2,na,1935,54.525480717232504
STAT,1890,34,35-39,1924,0.12196056944893274
STAT,1847,30,15-19,1877,0.0018236245415631958
STAT,1903,21,50-100,1924,0.00581519527888189
STAT,1863,15,40-44,1878,0.0018698719796641351
STAT,1869,38,25-29,1907,0.027759360704280277
STAT,1871,43,50-100,1914,0.010456742278563755
STAT,1891,18,20-24,1909,0.2170234811100439
STAT,1840,40,30-34,1880,0.010594825238297884
STAT,1819,44,20-24,1863,0.0014514186128163195
STAT,1910,46,30-34,1956,8.287058115255702E-4
STAT,1939,23,45-49,1962,0.011218670367604556
SIM,1807,72,na,1879,12
SIM,1966,4,na,1970,45
STAT,1970,1,na,1971,48.96351956103465
SIM,1819,75,na,1894,1
STAT,1888,38,35-39,1926,0.08224405718687719
SIM,1854,57,na,1911,16
STAT,1841,27,20-24,1868,0.14262338680429523
STAT,1857,96,na,1953,0.06428040832830212
STAT,1839,23,40-44,1862,0.014669568532388828
STAT,1833,41,45-49,1874,0.01359955373073926
SIM,1853,22,20-24,1875,1
STAT,1884,73,na,1957,12.279950923628222
SIM,1857,15,na,1872,23
STAT,1893,19,25-29,1912,0.07106732162818957
STAT,1799,75,na,1874,4.660394365444212
STAT,1925,44,25-29,1969,8.562775476762594E-4
STAT,1882,44,na,1926,21.850644176569812
STAT,1800,62,na,1862,8.241504890846608
STAT,1916,32,15-19,1948,0.001315376106344743
SIM,1857,31,na,1888,23
STAT,1935,28,na,1963,50.814170771238054
STAT,1845,34,20-24,1879,0.018400962629699105
SIM,1779,83,na,1862,3
SIM,1832,54,na,1886,20
STAT,1929,32,25-29,1961,0.11684065705574669
STAT,1815,79,na,1894,2.495587186141143
STAT,1920,11,na,1931,44.141816483790535
STAT,1862,22,20-24,1884,0.6086368956061621
SIM,1792,62,na,1854,8
STAT,1861,20,50-100,1881,0.0035742320203105723
STAT,1865,29,na,1894,21.431522872289808
STAT,1896,40,30-34,1936,0.001059247090740963
STAT,1879,36,35-39,1915,0.0735577862652089
SIM,1860,28,35-39,1888,1
STAT,1902,38,na,1940,33.31974496342222
STAT,1841,39,15-19,1880,6.342845980542505E-4
STAT,1866,45,20-24,1911,1.1161960550746558E-4
STAT,1900,23,15-19,1923,0.045605613848879574
STAT,1821,34,35-39,1855,0.25501830132233266
STAT,1850,29,20-24,1879,0.12116118559587928
STAT,1871,22,30-34,1893,0.17758852632748912
STAT,1886,59,na,1945,20.158898907738376
SIM,1882,1,na,1883,39
STAT,1870,75,na,1945,10.226558733282836
SIM,1907,18,25-29,1925,1
STAT,1895,36,na,1931,30.733811807840237
STAT,1852,28,35-39,1880,0.09549393303453785
STAT,1832,37,15-19,1869,3.186759293721395E-4
STAT,1842,43,45-49,1885,0.011469702148430263
STAT,1836,32,20-24,1868,0.032974083648404345
SIM,1906,59,na,1965,20
STAT,1871,24,20-24,1895,0.6827567086390821
STAT,1915,15,15-19,1930,0.09460206271274761
STAT,1945,19,40-44,1964,0.01515939168639796
SIM,1864,16,na,1880,23
STAT,1832,26,35-39,1858,0.058142470102828386
STAT,1936,22,15-19,1958,0.05058447384459068
STAT,1793,75,na,1868,2.2254119760628392
SIM,1891,3,na,1894,38
STAT,1830,84,na,1914,1.1952325734478397
STAT,1877,14,na,1891,26.57193313672211
STAT,1837,25,40-44,1862,0.019262713859514235
STAT,1883,44,45-49,1927,0.014337419096344069
STAT,1907,23,50-100,1930,0.0059465288263665945
STAT,1897,39,20-24,1936,0.0021872276576679218
STAT,1851,83,na,1934,3.3514869277208668
STAT,1859,28,20-24,1887,0.09417198720459843
STAT,1922,43,50-100,1965,0.0013364411021377426
STAT,1850,17,20-24,1867,0.1928884984780536
STAT,1892,35,20-24,1927,0.009613568362875509
SIM,1822,61,na,1883,12
STAT,1856,15,na,1871,19.896335583088767
STAT,1864,44,35-39,1908,0.016022372013184762
STAT,1807,51,45-49,1858,3.033413398133819E-4
STAT,1945,22,25-29,1967,1.0050888940648088
SIM,1919,25,35-39,1944,1
STAT,1825,44,20-24,1869,0.0014882137548361558
STAT,1932,15,15-19,1947,0.601290813014304
SIM,1883,60,na,1943,6
STAT,1904,37,40-44,1941,0.013538603499294085
STAT,1871,23,na,1894,23.50668224848259
STAT,1769,102,na,1871,0.004031594767589038
STAT,1919,29,40-44,1948,0.04956869201114971
SIM,1866,42,na,1908,28
STAT,1833,53,45-49,1886,1.0856065973491964E-4
STAT,1813,69,na,1882,11.496508162349876
STAT,1883,20,50-100,1903,0.003983604549997234
SIM,1940,15,15-19,1955,2
STAT,1879,48,35-39,1927,0.0014308070902979378
STAT,1902,25,15-19,1927,0.006441459132621827
STAT,1934,1,na,1935,56.24640684178064
STAT,1921,25,40-44,1946,0.05189201406202017
STAT,1926,14,na,1940,48.145350276748246
SIM,1877,66,na,1943,20
SIM,1934,15,na,1949,47
STAT,1845,22,20-24,1867,0.5000839509319596
SIM,1856,67,na,1923,8
STAT,1847,47,45-49,1894,0.002509286117180819
SIM,1913,16,na,1929,42
SIM,1882,81,na,1963,12
SIM,1945,21,na,1966,35
STAT,1826,28,25-29,1854,1.4432359031121555
STAT,1877,46,35-39,1923,0.0014492685752976822
STAT,1896,3,na,1899,34.72518389031609
STAT,1941,17,15-19,1958,0.4640658194690523
STAT,1876,16,20-24,1892,0.18050130413156404
STAT,1816,53,45-49,1869,1.7208740110423283E-4
STAT,1931,35,45-49,1966,0.009004054175367633
STAT,1904,25,40-44,1929,0.043214360868523455
STAT,1935,19,40-44,1954,0.018934427855391654
SIM,1786,68,na,1854,19
STAT,1825,32,na,1857,15.957140687737931
STAT,1901,34,20-24,1935,0.037499236850691155
SIM,1843,17,na,1860,23
STAT,1947,13,na,1960,43.93933448966652
STAT,1890,15,35-39,1905,0.006696153282721346
STAT,1873,34,40-44,1907,0.04371358650590863
STAT,1832,36,45-49,1868,0.011431077174532196
STAT,1836,45,35-39,1881,0.0014506750054881538
STAT,1930,27,40-44,1957,0.058989996222390796
SIM,1866,45,na,1911,28
STAT,1829,90,na,1919,0.5355261383855617
STAT,1842,30,50-100,1872,0.008478707823193508
STAT,1886,33,30-34,1919,0.18033950891125605
STAT,1885,28,50-100,1913,0.006294821025856808
SIM,1829,50,na,1879,19
STAT,1851,39,15-19,1890,4.693028231596458E-4
STAT,1886,38,25-29,1924,0.02971681227322626
STAT,1854,37,50-100,1891,0.007504393736813778
SIM,1871,75,na,1946,11
STAT,1883,48,na,1931,21.573268523702403
STAT,1886,37,na,1923,24.43775750011407
STAT,1926,17,40-44,1943,0.017050910874513527
STAT,1852,18,25-29,1870,0.05831172043804973
SIM,1888,29,na,1917,38
SIM,1893,22,na,1915,32
STAT,1851,34,20-24,1885,0.02326341645209902
STAT,1850,22,50-100,1872,0.004357903909129797
STAT,1869,35,20-24,1904,0.007540008707877154
STAT,1849,33,45-49,1882,0.014101045239692592
STAT,1890,31,30-34,1921,0.21295040115297767
SIM,1866,26,na,1892,29
STAT,1840,43,35-39,1883,0.014613165712414073
STAT,1935,25,na,1960,50.88283173316816
SIM,1908,31,50-100,1939,1
STAT,1819,47,25-29,1866,5.18678212963862E-4
STAT,1874,42,45-49,1916,0.015164592905989068
STAT,1857,93,na,1950,0.21878364579647583
STAT,1913,41,na,1954,36.121709245117295
STAT,1814,53,35-39,1867,2.3182207585995465E-4
STAT,1954,15,35-39,1969,0.051605514600870914
STAT,1852,50,45-49,1902,1.2598910301719136E-4
STAT,1860,39,25-29,1899,0.023171505363111043
STAT,1932,36,na,1968,50.39021970867272
STAT,1878,26,40-44,1904,0.031032859895717062
STAT,1920,44,40-44,1964,0.002729845710438809
STAT,1952,19,40-44,1971,0.016651507960748234
STAT,1823,31,40-44,1854,0.06743505170848822
SIM,1835,65,na,1900,13
STAT,1872,85,na,1957,3.321462745185014
STAT,1936,20,25-29,1956,0.878362271431492
SIM,1937,29,na,1966,39
STAT,1932,23,35-39,1955,0.12266472065760431
STAT,1834,49,25-29,1883,4.2076622770046736E-4
STAT,1899,33,40-44,1932,0.05911624269215278
STAT,1783,91,na,1874,0.09432372542768216
STAT,1896,34,50-100,1930,0.011932174453305874
STAT,1874,18,45-49,1892,6.609549492304584E-4
SIM,1817,65,na,1882,4
STAT,1890,22,40-44,1912,0.0253120863207143
STAT,1864,22,30-34,1886,0.16233155567611132
SIM,1844,42,na,1886,5
STAT,1921,28,45-49,1949,0.019036874189029104
STAT,1921,43,50-100,1964,0.0013108068141935636
SIM,1931,26,na,1957,56
STAT,1942,22,15-19,1964,0.05540663126440294
STAT,1881,44,35-39,1925,0.01699809785113798
STAT,1837,79,na,1916,3.3803437195993826
STAT,1888,48,45-49,1936,0.0015361332220826562
STAT,1911,37,50-100,1948,0.0040291123835167085
SIM,1852,90,na,1942,1
STAT,1842,72,na,1914,9.475234624662356
STAT,1875,96,na,1971,0.5010616589428104
STAT,1934,20,50-100,1954,0.008834010908572535
STAT,1830,26,25-29,1856,0.4291682982560713
STAT,1905,42,40-44,1947,0.002251485782042894
STAT,1855,35,35-39,1890,0.05027124578438693
STAT,1900,29,20-24,1929,0.16151523248111027
STAT,1862,35,35-39,1897,0.06160220443873597
STAT,1906,33,35-39,1939,0.08412417469298278
STAT,1928,40,na,1968,47.245069197335965
SIM,1900,49,na,1949,32
STAT,1814,91,na,1905,0.25822813260225136
STAT,1823,40,30-34,1863,0.008278397264573257
STAT,1876,22,15-19,1898,0.03350639737096254
SIM,1847,53,na,1900,15
STAT,1820,43,25-29,1863,0.005583875735988367
STAT,1881,81,na,1962,7.2550198173678675
SIM,1890,30,na,1920,26
STAT,1796,64,na,1860,1.65597703285616
STAT,1835,28,35-39,1863,0.0572378896737703
STAT,1858,32,40-44,1890,0.033000013732602695
STAT,1934,36,15-19,1970,2.6411796829488174E-4
STAT,1873,38,15-19,1911,5.680875270167994E-4
STAT,1849,45,na,1894,17.618989477295212
SIM,1869,56,na,1925,14
SIM,1943,11,na,1954,48
STAT,1910,37,40-44,1947,0.01422968132547415
STAT,1838,32,30-34,1870,0.1683888508745871
SIM,1890,48,na,1938,24
STAT,1895,33,na,1928,30.849670743394167
SIM,1918,44,na,1962,34
STAT,1895,16,30-34,1911,0.020743314568724056
STAT,1927,34,40-44,1961,0.047831007721925466
SIM,1868,43,30-34,1911,1
STAT,1928,25,35-39,1953,0.18530995970440622
STAT,1869,22,15-19,1891,0.03196560963436693
STAT,1847,19,na,1866,30.244871453853936
STAT,1928,34,25-29,1962,0.11485581734129925
STAT,1905,12,na,1917,37.27183967300175
STAT,1919,48,40-44,1967,0.0016905289278751777
STAT,1854,28,45-49,1882,0.007063446618783044
STAT,1879,43,40-44,1922,0.02311205867895733
STAT,1892,22,na,1914,29.217991272647843
SIM,1880,71,na,1951,22
SIM,1893,59,na,1952,29
STAT,1925,38,30-34,1963,0.02171603015208678
STAT,1935,9,na,1944,54.179700318791106
STAT,1910,52,na,1962,33.493930308862275
SIM,1839,21,25-29,1860,2
SIM,1930,9,na,1939,53
STAT,1837,42,na,1879,11.995371485622568
STAT,1913,23,25-29,1936,0.9220891949953244
STAT,1833,83,na,1916,2.939066354760902
STAT,1854,15,30-34,1869,0.01179260885621708
STAT,1859,26,na,1885,19.43545115522367
STAT,1880,24,30-34,1904,0.18613304879666845
STAT,1906,48,30-34,1954,7.833171740331623E-4
STAT,1854,34,30-34,1888,0.10704140768608772
STAT,1936,36,40-44,1972,0.014620689865277477
STAT,1834,68,na,1902,10.799702757634288
STAT,1880,15,40-44,1895,0.001932258808038241
STAT,1838,46,50-100,1884,0.001986393412279117
STAT,1832,24,50-100,1856,0.00245263463214525
STAT,1859,19,30-34,1878,0.014532574252911976
STAT,1858,41,na,1899,17.666834301765597
STAT,1888,35,30-34,1923,0.06287283456052147
STAT,1843,24,45-49,1867,0.00365976137013193
STAT,1848,28,45-49,1876,0.008510407586992825
STAT,1839,26,45-49,1865,0.007774815402825518
STAT,1812,65,na,1877,7.986543290619531
SIM,1820,51,na,1871,14
STAT,1931,32,40-44,1963,0.05105031875549184
STAT,1901,44,30-34,1945,0.001102031986562558
SIM,1899,69,na,1968,20
STAT,1873,37,45-49,1910,0.02026763226677764
STAT,1909,25,25-29,1934,0.6350993466046947
STAT,1851,103,na,1954,0.001211598167299143
STAT,1906,29,30-34,1935,0.36323185092018456
STAT,1875,20,40-44,1895,0.021548155731322353
STAT,1904,45,50-100,1949,0.0020049010194877204
SIM,1856,28,45-49,1884,1
STAT,1892,38,25-29,1930,0.03539339570808708
STAT,1904,21,25-29,1925,0.8227434942921894
STAT,1929,30,35-39,1959,0.11565332595107487
STAT,1793,72,na,1865,2.957345312745674
STAT,1811,80,na,1891,3.505654664087501
STAT,1845,32,30-34,1877,0.12135046867061577
STAT,1866,48,25-29,1914,5.238198028596945E-4
STAT,1869,81,na,1950,5.239691171734843
STAT,1816,50,40-44,1866,1.3253813920640804E-4
STAT,1827,64,na,1891,10.534758955178795
STAT,1876,29,35-39,1905,0.09729851503638991
STAT,1856,36,50-100,1892,0.00893698617475133
STAT,1895,11,na,1906,33.57759042350091
SIM,1864,19,na,1883,23
STAT,1862,25,25-29,1887,0.3716244869734785
STAT,1769,87,na,1856,2.6198659600000003
STAT,1902,23,na,1925,33.24854324206531
SIM,1877,39,45-49,1916,1
STAT,1869,39,45-49,1908,0.01912131390192702
STAT,1870,46,25-29,1916,5.738163774721261E-4
STAT,1938,32,35-39,1970,0.0912809514104969
STAT,1920,30,15-19,1950,0.0014068063710416532
SIM,1841,50,na,1891,14
SIM,1884,16,20-24,1900,2
SIM,1886,22,25-29,1908,1
STAT,1838,42,40-44,1880,0.02041632681508335
STAT,1909,15,15-19,1924,0.08891012820259915
STAT,1841,106,na,1947,1.1884466316646562E-4
SIM,1820,69,na,1889,8
STAT,1878,22,25-29,1900,0.5910137426496995
STAT,1836,35,25-29,1871,0.034822340183562964
SIM,1909,48,na,1957,33
STAT,1837,21,25-29,1858,0.4175392411095323
STAT,1885,18,20-24,1903,0.17461318465882877
STAT,1887,84,na,1971,7.4167284986808015
STAT,1781,87,na,1868,0.8198185049504269
STAT,1891,77,na,1968,14.589592656393583
STAT,1932,19,30-34,1951,0.15988254079066047
STAT,1911,0,na,1911,44.6450635488117
STAT,1844,27,na,1871,20.6850235715354
STAT,1863,71,na,1934,11.818292769722023
STAT,1825,47,25-29,1872,5.315795926888648E-4
SIM,1912,21,25-29,1933,4
STAT,1883,26,na,1909,23.25461559010317
STAT,1913,19,20-24,1932,0.27340272111416397
STAT,1832,23,30-34,1855,0.10790583299434216
STAT,1888,19,50-100,1907,5.694478332839641E-4
STAT,1873,20,15-19,1893,0.033741058222555596
STAT,1883,41,40-44,1924,0.02194113198512282
STAT,1884,25,45-49,1909,0.010952017873080729
STAT,1933,18,na,1951,48.94297268429412
STAT,1828,44,30-34,1872,0.004957427203959974
STAT,1865,16,45-49,1881,6.124507876729705E-4
STAT,1874,7,na,1881,27.49819677514481
STAT,1847,44,40-44,1891,0.02370326942356728
STAT,1861,44,25-29,1905,0.005327361722631007
STAT,1864,32,40-44,1896,0.03889700265267365
SIM,1893,18,20-24,1911,2
STAT,1842,40,40-44,1882,0.017913054094297463
SIM,1905,21,25-29,1926,1
STAT,1848,82,na,1930,3.017387460599183
STAT,1884,70,na,1954,13.746646871267842
STAT,1895,29,45-49,1924,0.014311544750805637
STAT,1845,37,25-29,1882,0.01768345641499934
STAT,1914,26,na,1940,37.580474893059744
SIM,1859,78,na,1937,3
SIM,1921,23,25-29,1944,1
STAT,1949,8,na,1957,45.41629600399722
STAT,1868,104,na,1972,0.008396742813639349
SIM,1839,49,na,1888,20
STAT,1928,15,25-29,1943,0.5458905216271941
SIM,1819,72,na,1891,1
STAT,1828,38,45-49,1866,0.008863865343683792
STAT,1803,51,na,1854,12.998825505952867
STAT,1925,21,50-100,1946,0.007850496830813751
SIM,1943,15,25-29,1958,3
STAT,1865,5,na,1870,25.75500972504533
SIM,1845,21,25-29,1866,2
STAT,1834,22,45-49,1856,0.0065905793818303625
STAT,1878,36,50-100,1914,0.012736439338841304
STAT,1879,33,30-34,1912,0.1799472255311844
STAT,1830,87,na,1917,0.6330036398126911
STAT,1824,50,na,1874,17.387048951455412
STAT,1898,25,na,1923,32.41263529813735
STAT,1864,41,30-34,1905,0.01035829517672429
STAT,1867,29,25-29,1896,0.4019146772215915
STAT,1935,15,25-29,1950,0.5925323182991322
SIM,1878,30,na,1908,27
SIM,1881,34,na,1915,25
STAT,1863,17,30-34,1880,0.016103212959376993
STAT,1819,42,30-34,1861,0.010898218022680522
STAT,1852,53,50-100,1905,1.2718125787586294E-4
STAT,1910,27,30-34,1937,0.37605548530613975
STAT,1949,20,35-39,1969,0.10924506322629925
SIM,1947,19,na,1966,40
SIM,1806,62,na,1868,6
STAT,1927,39,40-44,1966,0.01847759679491483
STAT,1862,40,20-24,1902,0.0013840083056694658
SIM,1825,69,na,1894,9
STAT,1844,67,na,1911,12.382058093199943
STAT,1901,38,50-100,1939,0.0036896358785179157
STAT,1912,44,50-100,1956,0.001115491547399099
STAT,1934,16,25-29,1950,0.5851019810580842
STAT,1889,79,na,1968,12.70237940640696
STAT,1860,34,50-100,1894,0.007385052414563176
STAT,1871,69,na,1940,14.631412790987332
STAT,1897,74,na,1971,19.10872682140013
SIM,1829,59,na,1888,19
STAT,1897,17,40-44,1914,0.0024288710336645464
STAT,1829,103,na,1932,9.748286661945703E-4
STAT,1852,62,na,1914,15.642604255397243
STAT,1860,43,20-24,1903,0.0012817799410998042
SIM,1928,12,na,1940,55
SIM,1955,14,na,1969,46
STAT,1840,24,35-39,1864,0.05731822145714554
STAT,1932,20,30-34,1952,0.377824633545684
STAT,1945,19,35-39,1964,0.045478172426061794
STAT,1859,40,15-19,1899,1.1087040476878675E-4
SIM,1811,49,na,1860,11
STAT,1868,17,15-19,1885,0.05847117887787457
STAT,1911,29,35-39,1940,0.14443107754941828
SIM,1891,18,na,1909,38
STAT,1831,31,30-34,1862,0.18619626926966898
STAT,1932,19,25-29,1951,0.5684348521735527
SIM,1833,64,na,1897,8
SIM,1879,18,na,1897,16
STAT,1857,30,50-100,1887,0.007046258102787275
STAT,1859,22,15-19,1881,0.027205384059358496
STAT,1913,26,35-39,1939,0.14885429258121338
STAT,1866,82,na,1948,4.297138113418637
STAT,1854,37,40-44,1891,0.026756830227036493
STAT,1929,36,40-44,1965,0.01914437048821687
STAT,1930,23,30-34,1953,0.3653399206349817
STAT,1932,37,25-29,1969,0.013175652067660101
STAT,1798,81,na,1879,3.792157178009722
STAT,1911,47,35-39,1958,0.0012127128428813107
STAT,1839,80,na,1919,3.4137618104752163
STAT,1846,24,50-100,1870,0.0040193800936341355
STAT,1955,4,na,1959,51.91189631700627
SIM,1874,46,na,1920,25
STAT,1927,20,20-24,1947,1.3711149964161322
STAT,1838,32,25-29,1870,0.09878397990966241
STAT,1865,106,na,1971,0.0015690960171753242
STAT,1906,30,30-34,1936,0.1468209235700493
STAT,1936,26,30-34,1962,0.37288468275126563
STAT,1887,44,na,1931,24.886838860337832
STAT,1855,26,50-100,1881,0.004728495436397241
STAT,1911,9,na,1920,39.449688215167576
STAT,1929,34,45-49,1963,0.019866683533377658
STAT,1883,49,30-34,1932,9.203802316273767E-4
STAT,1847,16,na,1863,30.785656232928268
STAT,1932,0,na,1932,59.41328232416988
STAT,1793,101,na,1894,5.715241090262493E-4
STAT,1827,95,na,1922,0.0805733102024625
STAT,1879,33,25-29,1912,0.10556460846039724
STAT,1869,1,na,1870,34.269327089238445
STAT,1894,20,15-19,1914,0.04253229104892633
STAT,1809,70,na,1879,9.539098970025558
STAT,1863,24,30-34,1887,0.15855096057035067
STAT,1898,16,na,1914,34.154126150780954
STAT,1926,4,na,1930,49.20282569442983
STAT,1904,33,30-34,1937,0.1430463834616782
STAT,1856,52,na,1908,15.515227235464089
SIM,1859,1,na,1860,33
STAT,1896,36,35-39,1932,0.09335252815657176
STAT,1886,35,50-100,1921,0.012855907566961948
STAT,1846,27,35-39,1873,0.09459979960853655
STAT,1896,30,20-24,1926,0.03579104908254675
STAT,1901,13,na,1914,36.080238186075185
SIM,1905,43,na,1948,40
STAT,1819,100,na,1919,0.005449737799618927
STAT,1885,30,45-49,1915,0.01735892322928635
STAT,1902,36,30-34,1938,0.016300054207902873
STAT,1904,15,30-34,1919,0.022944517365652832
SIM,1849,24,20-24,1873,2
STAT,1914,39,30-34,1953,0.01786482498665529
STAT,1916,18,30-34,1934,0.02557212052518669
STAT,1918,15,30-34,1933,0.026498710919271463
STAT,1894,39,35-39,1933,0.08973367627158965
STAT,1848,57,na,1905,12.996278863489653
STAT,1815,39,50-100,1854,0.019654837866129444
SIM,1924,18,30-34,1942,2
STAT,1865,21,30-34,1886,0.16424757040190674
STAT,1848,24,35-39,1872,0.04529244975826573
STAT,1900,26,25-29,1926,0.5885991931855018
STAT,1899,30,45-49,1929,0.024063653050729914
STAT,1940,15,40-44,1955,0.014108361270191236
STAT,1844,48,35-39,1892,0.001079792797178474
SIM,1857,46,na,1903,22
STAT,1950,19,15-19,1969,0.5329373371408475
STAT,1872,32,30-34,1904,0.1786426261475463
SIM,1936,35,na,1971,37
STAT,1864,54,45-49,1918,1.2658570628375538E-4
STAT,1840,26,50-100,1866,0.006295146518030163
STAT,1846,48,50-100,1894,0.001965401848546943
STAT,1890,46,40-44,1936,0.0011763819415927393
STAT,1829,45,35-39,1874,0.0012263387498353906
STAT,1866,51,45-49,1917,1.3429615251674704E-4
STAT,1912,41,40-44,1953,0.0024072945903836113
STAT,1920,34,25-29,1954,0.09951764730438066
STAT,1860,97,na,1957,0.058982649781527605
STAT,1815,70,na,1885,5.902824848216047
SIM,1884,76,na,1960,11
STAT,1870,35,30-34,1905,0.05344622724804009
STAT,1864,22,25-29,1886,0.5217056748358571
STAT,1923,44,20-24,1967,2.043017931361694E-4
STAT,1839,31,30-34,1870,0.11981054666496188
STAT,1917,47,30-34,1964,9.226699338063495E-4
STAT,1786,96,na,1882,0.006846459481721443
STAT,1830,32,25-29,1862,0.06737928186753485
SIM,1904,20,20-24,1924,1
STAT,1933,18,30-34,1951,0.16207425424097432
STAT,1860,49,35-39,1909,0.0011143978440028067
STAT,1919,47,35-39,1966,0.0013862957857441957
STAT,1854,19,40-44,1873,0.0013216482527721057
STAT,1801,100,na,1901,0.0038473976366165514
SIM,1850,36,na,1886,19
SIM,1916,26,25-29,1942,2
SIM,1826,82,na,1908,4
STAT,1792,96,na,1888,0.032844083270715425
STAT,1906,44,20-24,1950,1.5805824607734105E-4
SIM,1909,33,na,1942,39
STAT,1821,42,25-29,1863,0.01001088375303595
STAT,1887,28,35-39,1915,0.10494807854287463
SIM,1950,4,na,1954,65
STAT,1921,46,50-100,1967,0.0025361614418421326
STAT,1940,31,45-49,1971,0.01617963105245231
STAT,1927,37,45-49,1964,0.008432530827141916
STAT,1915,49,50-100,1964,0.002246199452652834
STAT,1919,29,35-39,1948,0.15966434971465204
SIM,1927,29,35-39,1956,2
STAT,1937,24,25-29,1961,0.8932128034314356
STAT,1878,38,40-44,1916,0.04496994463577049
STAT,1803,85,na,1888,1.0081115874031294
STAT,1877,54,na,1931,21.615102669524727
STAT,1881,25,35-39,1906,0.09243663990482688
STAT,1894,26,na,1920,30.69044959099995
STAT,1883,54,na,1937,20.33458555461214
STAT,1927,44,50-100,1971,0.001460969467370912
SIM,1870,56,na,1926,21
STAT,1832,42,na,1874,11.556784149455773
STAT,1860,107,na,1967,3.583761315606868E-4
SIM,1856,21,na,1877,18
STAT,1839,19,45-49,1858,4.660296960044787E-4
SIM,1785,83,na,1868,1
STAT,1879,49,na,1928,22.79988146836473
STAT,1853,38,35-39,1891,0.044231500889251735
STAT,1854,97,na,1951,0.03283702624204586
SIM,1815,39,na,1854,15
SIM,1949,14,na,1963,38
SIM,1901,30,20-24,1931,1
STAT,1871,33,25-29,1904,0.1016878603282465
STAT,1914,25,40-44,1939,0.04691468648613299
STAT,1895,38,40-44,1933,0.05654927672056164
STAT,1865,69,na,1934,13.273744172905943
STAT,1890,44,45-49,1934,0.017934339354877194
SIM,1926,17,na,1943,47
STAT,1885,46,30-34,1931,9.586283539487885E-4
STAT,1914,41,45-49,1955,0.0016378167189361862
SIM,1881,28,na,1909,25
STAT,1895,37,50-100,1932,0.015939234657728327
STAT,1908,26,25-29,1934,0.6263830011171078
STAT,1828,37,na,1865,18.79981820584217
STAT,1828,47,40-44,1875,7.334243553072159E-4
STAT,1914,23,45-49,1937,0.01136483599718903
STAT,1932,34,20-24,1966,0.03225225603364417
STAT,1824,75,na,1899,7.16312168373436
STAT,1923,31,45-49,1954,0.017987753616752436
SIM,1948,1,na,1949,43
STAT,1900,41,45-49,1941,0.0014476962999471108
STAT,1884,49,20-24,1933,1.1511546147729988E-4
SIM,1895,48,na,1943,27
STAT,1855,32,25-29,1887,0.07342803495032464
SIM,1802,72,na,1874,7
STAT,1875,29,50-100,1904,0.006528670272792346
SIM,1827,64,na,1891,5
STAT,1903,34,25-29,1937,0.08290055610060708
STAT,1851,49,na,1900,18.597274157595177
STAT,1923,26,20-24,1949,0.20883773715648463
SIM,1888,38,na,1926,36
STAT,1872,53,50-100,1925,1.520457388634963E-4
SIM,1804,67,na,1871,8
STAT,1828,29,40-44,1857,0.04346641571512055
SIM,1862,21,na,1883,22
STAT,1889,22,30-34,1911,0.2180814290344721
SIM,1931,31,45-49,1962,1
STAT,1903,48,na,1951,31.590690803379523
STAT,1840,77,na,1917,6.773301070702517
STAT,1921,16,45-49,1937,0.005663572312424665
STAT,1831,24,50-100,1855,0.005626791769447284
STAT,1888,26,na,1914,27.984570856929153
STAT,1898,18,50-100,1916,6.591693072016894E-4
STAT,1848,97,na,1945,0.034742277990533074
STAT,1908,23,na,1931,34.79310586050625
STAT,1811,45,50-100,1856,0.010035263834476258
SIM,1868,46,na,1914,32
STAT,1928,19,35-39,1947,0.05233195109042916
STAT,1945,16,30-34,1961,0.13222884293294684
STAT,1948,20,na,1968,41.68144730595908
SIM,1847,44,na,1891,15
SIM,1915,28,30-34,1943,1
STAT,1778,106,na,1884,1.4774905243729365E-4
STAT,1930,10,na,1940,51.140692434797764
STAT,1904,18,35-39,1922,0.007841802704372177
STAT,1887,46,35-39,1933,0.0015324494278319025
STAT,1851,40,45-49,1891,0.012762591731201582
STAT,1854,101,na,1955,0.003487851231366115
SIM,1821,39,na,1860,15
SIM,1843,54,na,1897,18
STAT,1930,26,35-39,1956,0.19009659690530567
STAT,1906,26,20-24,1932,0.1710212739958601
STAT,1836,23,30-34,1859,0.22524131817491166
STAT,1862,43,25-29,1905,0.005500281842580808
STAT,1850,104,na,1954,5.938737545757554E-4
STAT,1871,29,na,1900,23.62358757252661
STAT,1800,65,na,1865,7.369303561061729
STAT,1907,28,30-34,1935,0.3670520432767394
SIM,1923,19,25-29,1942,1
STAT,1933,36,30-34,1969,0.02474609325174111
STAT,1888,23,25-29,1911,0.6669039705197501
STAT,1813,75,na,1888,6.895301056570766
STAT,1910,30,20-24,1940,0.023562969824522308
STAT,1931,39,30-34,1970,0.023979513266215658
STAT,1902,32,50-100,1934,0.012920772460255291
STAT,1918,41,na,1959,39.18619125550199
STAT,1859,29,na,1888,19.019810175837552
STAT,1910,49,40-44,1959,0.0014534407458614155
SIM,1891,58,na,1949,31
SIM,1886,71,na,1957,10
STAT,1915,19,25-29,1934,0.08943278089325245
STAT,1906,47,50-100,1953,0.002003331008596396
STAT,1886,26,25-29,1912,0.44028416012691246
STAT,1825,50,45-49,1875,1.344621062160317E-4
STAT,1849,21,45-49,1870,0.0065844665900809595
STAT,1788,91,na,1879,0.22172001320352508
STAT,1924,29,15-19,1953,0.00810783392922002
STAT,1907,46,30-34,1953,8.009777434573583E-4
STAT,1904,19,50-100,1923,6.982353837527921E-4
STAT,1894,20,45-49,1914,0.00899013884985964
STAT,1836,32,na,1868,26.43788935233243
SIM,1903,48,na,1951,35
STAT,1879,89,na,1968,2.9823739887756235
STAT,1911,26,30-34,1937,0.3809544214780623
STAT,1854,26,na,1880,15.342760419991107
STAT,1904,36,35-39,1940,0.02198019497610698
STAT,1918,18,35-39,1936,0.045140628932790916
STAT,1926,31,50-100,1957,0.009945998307781555
SIM,1796,67,na,1863,7
SIM,1792,77,na,1869,2
SIM,1860,26,na,1886,26
SIM,1905,2,na,1907,40
STAT,1861,47,50-100,1908,0.002055757816538041
STAT,1924,27,50-100,1951,0.011513833552567472
STAT,1915,34,15-19,1949,0.0012863583658109879
STAT,1838,67,na,1905,12.303614947961933
SIM,1915,33,na,1948,37
SIM,1885,18,na,1903,26
STAT,1817,43,50-100,1860,0.03237646413049475
STAT,1902,39,35-39,1941,0.02131163088420735
STAT,1936,29,35-39,1965,0.14267228093063505
STAT,1928,37,35-39,1965,0.030418481615484657
STAT,1881,22,30-34,1903,0.16949161105926738
STAT,1832,48,45-49,1880,0.0012388454633214907
STAT,1872,70,na,1942,14.355837207605106
STAT,1842,48,30-34,1890,7.17144415570819E-4
STAT,1905,49,30-34,1954,7.716028248397577E-4
STAT,1861,79,na,1940,5.879164206081031
STAT,1848,21,30-34,1869,0.14127237913128535
STAT,1886,44,25-29,1930,0.0065709692273222715
STAT,1896,33,25-29,1929,0.13397253484635868
SIM,1869,31,na,1900,17
STAT,1829,42,25-29,1871,0.005684834508567604
STAT,1911,44,30-34,1955,0.0011974588887275152
SIM,1886,9,na,1895,30
STAT,1896,21,na,1917,31.159555052264842
SIM,1875,31,na,1906,18
STAT,1941,27,25-29,1968,0.6759521393838938
STAT,1856,44,50-100,1900,0.007549984738482506
STAT,1829,50,na,1879,16.060034644830786
STAT,1902,20,15-19,1922,0.046799975507556525
STAT,1913,21,35-39,1934,0.0907509456481328
STAT,1867,21,35-39,1888,0.056478811398413306
STAT,1888,41,25-29,1929,0.007538189344479299
STAT,1859,40,45-49,1899,0.012015579273228666
STAT,1908,30,50-100,1938,0.007826169219140783
STAT,1812,50,na,1862,11.730385059585224
STAT,1827,48,35-39,1875,0.0010419523490676733
STAT,1846,45,35-39,1891,0.0011459108256916344
SIM,1890,4,na,1894,32
STAT,1943,21,15-19,1964,0.05624089237899814
STAT,1909,21,15-19,1930,0.04934520306774789
STAT,1847,54,45-49,1901,1.5076383748647868E-4
SIM,1898,28,na,1926,33
STAT,1837,34,30-34,1871,0.10456710352987976
STAT,1866,4,na,1870,27.688444416128227
STAT,1828,31,25-29,1859,0.14309047647063225
STAT,1922,31,25-29,1953,0.10408922107135468
STAT,1840,21,25-29,1861,0.5745750506573735
SIM,1853,25,25-29,1878,1
STAT,1829,42,30-34,1871,0.010177687546277467
STAT,1852,45,50-100,1897,0.002122918873781926
STAT,1822,41,30-34,1863,0.006667018579259774
STAT,1830,47,na,1877,8.679507594633586
SIM,1884,8,na,1892,26
STAT,1920,19,35-39,1939,0.046427310466828665
STAT,1851,32,50-100,1883,0.00805098615494209
STAT,1920,51,na,1971,39.75194912671183
STAT,1845,25,25-29,1870,0.30534370138424194
SIM,1918,23,25-29,1941,2
STAT,1941,24,15-19,1965,0.054574816153489684
STAT,1889,8,na,1897,31.827068663459887
STAT,1916,20,45-49,1936,0.011759243977253276
SIM,1880,86,na,1966,7
STAT,1882,69,na,1951,14.064110760611486
SIM,1854,26,na,1880,17
STAT,1819,60,na,1879,10.937299971717602
STAT,1937,21,20-24,1958,1.0763398462971603
STAT,1905,30,40-44,1935,0.06309238752840773
STAT,1867,64,na,1931,16.63540445134067
SIM,1849,27,25-29,1876,1
SIM,1922,27,na,1949,47
STAT,1824,47,na,1871,18.05671175687282
SIM,1866,11,na,1877,35
STAT,1907,38,na,1945,34.56174319005021
SIM,1948,20,na,1968,34
SIM,1928,6,na,1934,55
STAT,1841,20,50-100,1861,0.005129852533474282
STAT,1921,34,45-49,1955,0.017226123969887944
STAT,1829,59,na,1888,13.43847634156243
STAT,1877,21,20-24,1898,0.7135044865839709
SIM,1837,24,30-34,1861,2
STAT,1904,18,40-44,1922,0.0026139343861344084
SIM,1813,72,na,1885,1
STAT,1923,29,30-34,1952,0.4435501855235223
STAT,1910,21,50-100,1931,0.006159997968197697
STAT,1952,15,30-34,1967,0.14528025044499634
STAT,1920,33,50-100,1953,0.008941270787877072
STAT,1819,35,25-29,1854,0.036065352498374025
STAT,1811,53,25-29,1864,1.3176463222784262E-4
SIM,1839,89,na,1928,2
STAT,1860,85,na,1945,2.2286381030701965
SIM,1897,43,na,1940,39
STAT,1892,41,45-49,1933,0.018573268261900366
STAT,1912,28,40-44,1940,0.04541293591019663
STAT,1854,21,25-29,1875,0.41409957790126767
STAT,1896,33,30-34,1929,0.22837185960886044
SIM,1808,57,na,1865,10
STAT,1925,41,20-24,1966,2.1278092545532585E-4
SIM,1863,5,na,1868,24
SIM,1897,74,na,1971,32
STAT,1867,17,25-29,1884,0.05543764908651764
STAT,1845,43,25-29,1888,0.0037738239015979768
STAT,1945,19,50-100,1964,0.004060550357146349
STAT,1825,60,na,1885,10.97781523984854
SIM,1874,86,na,1960,4
STAT,1856,16,40-44,1872,0.0015760214592199892
STAT,1861,39,na,1900,19.613313855724563
STAT,1917,31,15-19,1948,0.0013388636340329228
SIM,1933,23,20-24,1956,4
STAT,1914,21,25-29,1935,0.9007745508246864
STAT,1850,67,na,1917,14.114223193676217
STAT,1911,41,20-24,1952,1.684367870992572E-4
STAT,1873,30,25-29,1903,0.10497286092245124
STAT,1889,25,35-39,1914,0.11893635560842307
STAT,1901,37,25-29,1938,0.008695748973269928
SIM,1848,26,na,1874,30
STAT,1798,100,na,1898,0.005395117510277686
STAT,1868,49,35-39,1917,0.0013265553289519179
STAT,1849,29,50-100,1878,0.0057956256753685835
SIM,1885,58,na,1943,17
STAT,1923,29,25-29,1952,0.7450908496148386
SIM,1856,52,na,1908,10
STAT,1925,23,20-24,1948,1.3185750604787665
STAT,1890,36,na,1926,28.755863506169096
STAT,1903,31,20-24,1934,0.038587333433339276
STAT,1919,26,30-34,1945,0.42113401774908554
SIM,1837,54,na,1891,29
SIM,1908,20,na,1928,37
STAT,1878,35,30-34,1913,0.05554606133790361
STAT,1880,42,50-100,1922,0.011095475330245894
STAT,1840,21,30-34,1861,0.17878214925539715
STAT,1858,29,20-24,1887,0.09007757028648897
STAT,1915,37,25-29,1952,0.009860647133621489
SIM,1872,11,na,1883,27
STAT,1895,22,25-29,1917,0.743194147767934
SIM,1858,19,20-24,1877,1
SIM,1927,26,30-34,1953,2
STAT,1771,94,na,1865,0.06387241345898942
STAT,1868,49,na,1917,21.31813046035899
STAT,1881,22,25-29,1903,0.5447168602457019
STAT,1919,44,30-34,1963,0.0013688584406352754
STAT,1872,17,35-39,1889,0.005632695759605609
STAT,1865,97,na,1962,0.12756868766421822
STAT,1873,49,45-49,1922,0.0023492970604205438
STAT,1936,35,na,1971,36.774591133438605
STAT,1831,53,50-100,1884,1.2471868265203511E-4
SIM,1922,21,25-29,1943,1
STAT,1873,64,na,1937,17.673761735855756
STAT,1868,5,na,1873,27.225314711743852
SIM,1916,27,na,1943,43
STAT,1842,32,na,1874,19.643014197927
STAT,1946,18,40-44,1964,0.015399387945015223
STAT,1807,75,na,1882,5.077077836596948
STAT,1931,20,40-44,1951,0.04367492554370341
STAT,1794,91,na,1885,0.2166680742736533
SIM,1839,80,na,1919,9
STAT,1860,46,25-29,1906,4.696017881809666E-4
STAT,1923,47,25-29,1970,6.16240704047463E-4
STAT,1908,1,na,1909,40.16650024869085
STAT,1793,81,na,1874,1.1212452081107012
SIM,1877,32,25-29,1909,1
STAT,1816,54,50-100,1870,1.7554915599619358E-4
STAT,1905,35,40-44,1940,0.013765907897532965
STAT,1868,30,45-49,1898,0.017011407093973425
STAT,1928,16,30-34,1944,0.15320682119624204
STAT,1907,42,45-49,1949,0.0015183625888016974
STAT,1870,44,na,1914,22.649680518595225
SIM,1786,77,na,1863,14
STAT,1868,19,35-39,1887,0.0053427528177282186
STAT,1884,44,20-24,1928,0.001534971050431807
SIM,1870,28,na,1898,24
STAT,1808,85,na,1893,0.4002989726156913
STAT,1909,28,35-39,1937,0.1421762350529348
STAT,1851,38,30-34,1889,0.045006011179176596
STAT,1878,38,35-39,1916,0.07265989321322627
STAT,1910,27,25-29,1937,0.6317109319171119
SIM,1906,65,na,1971,19
STAT,1904,16,45-49,1920,9.382989206192467E-4
SIM,1926,5,na,1931,50
STAT,1930,24,45-49,1954,0.014256974878100213
SIM,1854,66,na,1920,14
STAT,1832,45,40-44,1877,9.339014949384059E-4
STAT,1872,9,na,1881,27.483202253738867
STAT,1912,25,na,1937,36.876483374786766
SIM,1917,28,35-39,1945,1
STAT,1941,13,na,1954,40.22027940303786
STAT,1857,62,na,1919,13.682542192320637
STAT,1937,28,40-44,1965,0.045127056405017706
SIM,1883,54,na,1937,9
STAT,1853,23,30-34,1876,0.1313202223302363
SIM,1843,26,na,1869,20
STAT,1875,90,na,1965,2.041836146765559
STAT,1911,31,50-100,1942,0.008031818775908937
STAT,1806,53,45-49,1859,4.6077714061361656E-4
STAT,1941,24,20-24,1965,1.1399997856695065
STAT,1841,20,30-34,1861,0.22407193436093356
STAT,1920,20,na,1940,40.49248291667556
STAT,1935,18,35-39,1953,0.056959920057490725
SIM,1882,10,na,1892,33
STAT,1873,44,45-49,1917,0.01501083973468246
STAT,1884,64,na,1948,17.031600434073304
STAT,1910,21,na,1931,35.72593736673046
STAT,1924,46,30-34,1970,0.001057012755125636
STAT,1840,37,na,1877,19.85018360732982
SIM,1852,62,na,1914,19
STAT,1924,10,na,1934,47.0190787482001
STAT,1827,33,30-34,1860,0.14977302665806747
STAT,1872,47,35-39,1919,0.0014257601869296476
STAT,1909,21,45-49,1930,0.010430198237928501
STAT,1909,28,50-100,1937,0.009425819244647832
STAT,1931,25,40-44,1956,0.059961728070673036
SIM,1866,51,na,1917,27
STAT,1838,95,na,1933,0.1031928742104871
SIM,1782,78,na,1860,4
STAT,1859,26,30-34,1885,0.20507723297883987
STAT,1934,31,15-19,1965,0.0017481037310167252
SIM,1946,9,na,1955,53
STAT,1825,69,na,1894,7.9115760107193625
STAT,1906,23,50-100,1929,0.005906137075382456
STAT,1845,77,na,1922,5.052794225298206
STAT,1940,30,30-34,1970,0.162084897771183
STAT,1836,38,35-39,1874,0.08291948555938823
SIM,1837,85,na,1922,2
STAT,1861,45,30-34,1906,8.221606237021235E-4
STAT,1871,21,25-29,1892,0.5724620628564758
SIM,1903,17,na,1920,38
STAT,1919,45,45-49,1964,0.0023478973773404313
STAT,1848,29,na,1877,16.46228578329294
SIM,1900,40,na,1940,36
SIM,1870,25,na,1895,23
STAT,1938,30,na,1968,37.82072466173426
STAT,1860,46,30-34,1906,7.891919016324644E-4
STAT,1885,17,15-19,1902,0.058604567721171855
STAT,1861,70,na,1931,11.79922998776711
STAT,1781,96,na,1877,0.022872896267653535
SIM,1937,20,na,1957,36
STAT,1830,36,40-44,1866,0.026165898009981484
STAT,1869,44,25-29,1913,0.0061381383467669455
STAT,1871,15,25-29,1886,0.05753798456675997
STAT,1902,32,15-19,1934,0.0020082140039618833
STAT,1844,36,na,1880,19.629721846904697
STAT,1915,39,15-19,1954,1.9038201835149955E-4
STAT,1923,33,35-39,1956,0.10397234503790097
SIM,1928,21,20-24,1949,1
SIM,1904,61,na,1965,24
SIM,1877,26,25-29,1903,1
SIM,1883,51,na,1934,10
STAT,1933,32,15-19,1965,0.0017247103540780676
STAT,1811,49,na,1860,16.631347400666318
STAT,1820,85,na,1905,1.554136161496857
STAT,1869,32,25-29,1901,0.09924483385137269
STAT,1934,31,na,1965,51.44891782137181
STAT,1870,31,15-19,1901,0.0014204427750551993
STAT,1888,20,20-24,1908,0.8101149862988598
SIM,1824,59,na,1883,16
STAT,1924,28,30-34,1952,0.4516539789979309
STAT,1825,48,30-34,1873,8.814074595842734E-4
STAT,1894,24,30-34,1918,0.22685169840589714
SIM,1882,13,na,1895,33
STAT,1926,34,50-100,1960,0.009927410861713323
STAT,1857,65,na,1922,12.651195197990358
STAT,1850,38,50-100,1888,0.010989785854350276
STAT,1892,39,30-34,1931,0.06517934078683761
SIM,1876,72,na,1948,20
STAT,1912,43,30-34,1955,0.0012160453542032833
STAT,1881,52,50-100,1933,1.4294418369799878E-4
STAT,1873,46,40-44,1919,0.0017455195915755941
STAT,1822,44,35-39,1866,0.010050521322872924
STAT,1781,93,na,1874,0.09969738088787033
STAT,1896,9,na,1905,34.081439694294694
SIM,1875,28,na,1903,18
STAT,1878,39,na,1917,24.078716404080392
STAT,1877,36,30-34,1913,0.055279946912559594
SIM,1810,67,na,1877,12
STAT,1916,36,25-29,1952,0.01004487173126834
STAT,1819,50,50-100,1869,1.3653443277010296E-4
SIM,1913,47,na,1960,40
STAT,1837,37,35-39,1874,0.04196289390276009
STAT,1832,70,na,1902,6.342019187781386
STAT,1925,38,25-29,1963,0.011731648408567164
STAT,1856,31,30-34,1887,0.12936898262142496
STAT,1872,35,35-39,1907,0.07305531293672513
STAT,1833,52,na,1885,16.42642914745145
STAT,1834,37,na,1871,18.826948781572096
SIM,1889,6,na,1895,34
STAT,1931,23,45-49,1954,0.014483709401199137
SIM,1931,32,na,1963,56
STAT,1936,27,45-49,1963,0.016433578282440856
STAT,1819,69,na,1888,7.8193364666271705
STAT,1872,29,35-39,1901,0.09801935506665109
STAT,1846,22,na,1868,21.380344145146964
STAT,1886,48,40-44,1934,0.0017534869375183226
SIM,1949,6,na,1955,38
STAT,1919,27,45-49,1946,0.0185048496737818
SIM,1925,32,na,1957,45
STAT,1820,44,30-34,1864,0.009837937038282438
STAT,1831,46,35-39,1877,0.0013576359616600353
STAT,1856,24,na,1880,17.731985341910764
STAT,1905,1,na,1906,39.28310268220617
STAT,1911,34,50-100,1945,0.007930643921903765
SIM,1847,84,na,1931,3
STAT,1804,50,50-100,1854,4.316307362923637E-4
STAT,1907,24,15-19,1931,0.04795443109474874
SIM,1967,3,na,1970,50
STAT,1805,49,na,1854,9.981259912760562
SIM,1871,66,na,1937,17
SIM,1883,0,na,1883,29
STAT,1880,23,25-29,1903,0.6001079195219765
STAT,1889,40,25-29,1929,0.00794146388455382
STAT,1897,20,50-100,1917,0.005447585356117282
STAT,1928,31,na,1959,47.086609761296636
STAT,1905,33,45-49,1938,0.014390231413613988
SIM,1850,67,na,1917,14
STAT,1877,24,30-34,1901,0.18271820861165386
SIM,1864,31,30-34,1895,1
STAT,1846,9,na,1855,24.80325
SIM,1849,11,na,1860,17
STAT,1888,57,na,1945,23.484508320557005
STAT,1916,48,25-29,1964,5.379256791465173E-4
STAT,1888,0,na,1888,35.00081460288476
SIM,1918,53,na,1971,34
SIM,1927,27,na,1954,52
SIM,1894,38,na,1932,29
STAT,1922,17,40-44,1939,0.01606896128114416
STAT,1911,44,25-29,1955,6.688509135573743E-4
STAT,1845,47,40-44,1892,9.960820685684295E-4
SIM,1885,86,na,1971,6
STAT,1872,79,na,1951,7.15303662584597
STAT,1890,3,na,1893,32.11239094831229
SIM,1923,8,na,1931,42
STAT,1942,26,25-29,1968,0.6860969951860573
STAT,1882,52,45-49,1934,1.3833842937529083E-4
STAT,1936,29,40-44,1965,0.04429340904602632
STAT,1905,17,40-44,1922,0.0026397325764598864
STAT,1819,39,40-44,1858,0.043061863099812143
STAT,1821,70,na,1891,8.7143338873762
STAT,1910,42,20-24,1952,1.6588534738064934E-4
STAT,1831,34,35-39,1865,0.10453185727368147
STAT,1939,15,na,1954,36.68087256338448
STAT,1887,16,na,1903,27.634891863707953
SIM,1861,11,na,1872,33
STAT,1952,18,35-39,1970,0.049972011193855206
STAT,1843,46,25-29,1889,2.463322036819075E-4
STAT,1904,31,40-44,1935,0.062394351750645276
SIM,1923,16,20-24,1939,3
STAT,1823,34,na,1857,17.074186063219557
STAT,1950,18,30-34,1968,0.1431835323832486
STAT,1901,22,20-24,1923,0.9642711582006583
STAT,1945,17,45-49,1962,0.00541769639266289
STAT,1866,23,40-44,1889,0.019209275502594294
STAT,1868,34,30-34,1902,0.16751897906130653
STAT,1915,34,20-24,1949,0.024416536932873215
STAT,1941,29,15-19,1970,0.007242727474624316
SIM,1855,11,na,1866,24
SIM,1818,56,na,1874,24
STAT,1832,43,45-49,1875,0.008126924411108963
STAT,1865,43,50-100,1908,0.009486446993906366
SIM,1878,76,na,1954,8
STAT,1799,66,na,1865,8.689913667899756
STAT,1910,58,na,1968,32.317016972509236
SIM,1798,62,na,1860,9
STAT,1901,40,20-24,1941,1.5587272083319775E-4
STAT,1881,90,na,1971,2.4988056094714524
STAT,1893,3,na,1896,33.33307823448302
SIM,1889,79,na,1968,13
STAT,1897,32,30-34,1929,0.23185725945353658
STAT,1917,16,25-29,1933,0.09263311797164073
SIM,1876,10,na,1886,32
STAT,1890,64,na,1954,21.115890000192994
STAT,1915,16,20-24,1931,0.28199260635670975
SIM,1876,34,30-34,1910,1
STAT,1862,28,35-39,1890,0.08295451050266843
STAT,1893,16,na,1909,31.923007243105122
STAT,1926,45,na,1971,45.283233598900125
SIM,1903,24,25-29,1927,2
STAT,1831,28,35-39,1859,0.10414532177623337
STAT,1931,41,45-49,1972,0.00221671860608493
SIM,1893,53,na,1946,33
STAT,1868,16,30-34,1884,0.015796915776485496
STAT,1922,35,40-44,1957,0.016938333752844172
STAT,1910,24,20-24,1934,1.0313475151101839
SIM,1843,85,na,1928,1
STAT,1930,21,40-44,1951,0.04300200064153957
SIM,1869,38,35-39,1907,1
STAT,1863,65,na,1928,14.962887757962427
STAT,1870,84,na,1954,3.304638170433716
SIM,1872,51,na,1923,20
STAT,1853,26,35-39,1879,0.07075875222735067
STAT,1837,25,50-100,1862,0.004113486424928896
STAT,1892,31,na,1923,29.601145810332692
SIM,1803,57,na,1860,9
STAT,1866,79,na,1945,6.43863039971656
STAT,1823,37,na,1860,16.747486670984983
STAT,1887,13,na,1900,28.14459512031403
STAT,1839,77,na,1916,4.770201412814169
STAT,1880,27,40-44,1907,0.03149994489996778
STAT,1826,70,na,1896,9.804919519023446
STAT,1845,29,40-44,1874,0.021008481763954992
STAT,1833,29,15-19,1862,0.004363826472226828
STAT,1830,39,45-49,1869,0.011183517836696272
SIM,1864,25,na,1889,22
SIM,1911,43,na,1954,40
STAT,1849,23,40-44,1872,0.01939484921973611
STAT,1815,49,20-24,1864,1.6809717494245218E-4
STAT,1887,21,15-19,1908,0.03611781722614978
STAT,1847,41,30-34,1888,0.012508914852646187
STAT,1851,35,50-100,1886,0.010695815057681732
STAT,1864,40,25-29,1904,0.005817770361398714
STAT,1819,41,25-29,1860,0.00620125735062402
STAT,1820,40,15-19,1860,1.2610832570623932E-4
STAT,1890,6,na,1896,31.732379787523204
SIM,1830,59,na,1889,11
STAT,1838,36,na,1874,20.268231979417134
STAT,1834,77,na,1911,6.108620098510144
STAT,1879,30,20-24,1909,0.028201810819798754
STAT,1875,50,na,1925,22.451383725737234
STAT,1854,15,25-29,1869,0.041926590850849536
SIM,1878,79,na,1957,6
STAT,1866,26,45-49,1892,0.010260778801163366
SIM,1899,38,na,1937,28
SIM,1835,59,na,1894,13
STAT,1884,47,25-29,1931,5.617061491639824E-4
STAT,1924,42,45-49,1966,0.001966751234496391
STAT,1901,25,25-29,1926,0.5959263813053708
STAT,1932,16,20-24,1948,1.7923453112761818
STAT,1812,90,na,1902,0.3133248336036177
SIM,1943,20,na,1963,39
STAT,1909,25,30-34,1934,0.37807259766778645
STAT,1886,32,25-29,1918,0.10624308420020719
SIM,1911,40,na,1951,40
STAT,1855,47,35-39,1902,9.811023716894194E-4
STAT,1817,96,na,1913,0.06805254293552082
STAT,1841,39,20-24,1880,0.008706996568721733
SIM,1840,74,na,1914,4
SIM,1930,10,na,1940,53
STAT,1923,30,30-34,1953,0.18080803229024142
STAT,1861,41,15-19,1902,1.1666000567115733E-4
STAT,1900,23,20-24,1923,0.9526443454583139
STAT,1855,39,na,1894,16.420776076925783
STAT,1827,36,35-39,1863,0.05865331281364911
STAT,1868,30,15-19,1898,0.0013892212888132493
STAT,1850,36,na,1886,21.531392263846154
STAT,1905,4,na,1909,37.96717343275528
STAT,1905,43,na,1948,33.23017327584215
STAT,1935,15,30-34,1950,0.16666038718069545
STAT,1858,31,35-39,1889,0.07786572353860234
STAT,1855,23,50-100,1878,0.00333010823269134
STAT,1916,38,50-100,1954,0.004241657924524062
STAT,1929,31,40-44,1960,0.04949901883982221
SIM,1816,52,na,1868,11
STAT,1856,19,45-49,1875,5.529773171293956E-4
STAT,1836,35,30-34,1871,0.06445837473617531
STAT,1894,27,35-39,1921,0.12365988423601963
STAT,1913,23,30-34,1936,0.28691306365954117
STAT,1879,49,50-100,1928,0.0024889098566795924
SIM,1900,4,na,1904,40
SIM,1918,20,20-24,1938,1
STAT,1869,48,40-44,1917,0.0016379844493842246
STAT,1878,64,na,1942,17.94711738651269
STAT,1899,28,50-100,1927,0.008726139702438525
STAT,1859,29,35-39,1888,0.07689880589935587
STAT,1863,62,na,1925,16.182687869664697
STAT,1846,62,na,1908,14.81244694514391
STAT,1919,42,40-44,1961,0.00268705239235749
STAT,1945,22,30-34,1967,0.31273887104574144
STAT,1883,51,45-49,1934,1.4160164654378811E-4
STAT,1846,20,15-19,1866,0.03346767013069694
STAT,1911,42,35-39,1953,0.0019095407836345576
STAT,1856,44,45-49,1900,0.010695811743500443
STAT,1921,18,40-44,1939,0.015777708031503752
STAT,1882,32,na,1914,22.869063536602766
STAT,1840,101,na,1941,0.004471356435194253
STAT,1859,27,15-19,1886,0.003668349332281452
STAT,1824,78,na,1902,5.436607494478373
STAT,1917,31,na,1948,39.40446087905749
STAT,1846,24,30-34,1870,0.1755665034492645
SIM,1893,13,na,1906,39
SIM,1928,24,25-29,1952,2
STAT,1835,44,50-100,1879,0.005587816484984021
STAT,1871,19,40-44,1890,0.001813764850121266
STAT,1931,20,na,1951,47.43457268932029
STAT,1870,47,30-34,1917,9.571171196024012E-4
STAT,1924,24,15-19,1948,0.0620136471428532
STAT,1830,78,na,1908,2.807266693635989
STAT,1905,31,25-29,1936,0.08522828705975385
SIM,1839,58,na,1897,19
STAT,1895,16,25-29,1911,0.07374928426926113
STAT,1901,43,25-29,1944,6.194644155244389E-4
STAT,1851,77,na,1928,7.297465698397205
STAT,1940,29,30-34,1969,0.3963264801471685
SIM,1927,32,30-34,1959,1
SIM,1918,13,na,1931,40
STAT,1811,103,na,1914,8.133157428861729E-4
SIM,1776,78,na,1854,4
SIM,1834,74,na,1908,9
SIM,1818,59,na,1877,23
SIM,1839,18,na,1857,24
STAT,1916,33,20-24,1949,0.024861964355831757
STAT,1916,46,na,1962,37.45212823148315
STAT,1845,31,25-29,1876,0.07193234831652308
STAT,1856,20,50-100,1876,0.0034807965972778743
STAT,1854,33,25-29,1887,0.06345043333014379
STAT,1911,43,na,1954,35.00751335269232
STAT,1807,49,25-29,1856,0.0011912179273838607
STAT,1882,21,30-34,1903,0.17121827449456514
SIM,1836,44,na,1880,6
SIM,1935,23,25-29,1958,1
STAT,1893,40,15-19,1933,1.758819990504427E-4
STAT,1887,25,30-34,1912,0.27672714127922615
STAT,1903,19,35-39,1922,0.00775934381090489
STAT,1898,15,35-39,1913,0.007436482281858487
STAT,1841,39,50-100,1880,0.013867766050149352
STAT,1877,39,35-39,1916,0.07227619054959086
STAT,1881,28,na,1909,22.62887025799763
STAT,1906,47,25-29,1953,4.698365850207992E-4
STAT,1829,46,40-44,1875,0.0014804135912786453
STAT,1846,42,30-34,1888,0.009430029763459644
STAT,1887,75,na,1962,13.445745875956693
STAT,1937,22,35-39,1959,0.0911139134301997
STAT,1925,35,20-24,1960,0.0031495419369550475
SIM,1887,13,na,1900,26
STAT,1900,28,50-100,1928,0.00883927497628288
STAT,1910,45,25-29,1955,4.942063932760894E-4
SIM,1922,0,na,1922,56
STAT,1925,37,50-100,1962,0.005007648916932556
STAT,1890,49,45-49,1939,0.001583293966251622
SIM,1867,36,na,1903,10
STAT,1867,19,20-24,1886,0.17140127557280968
STAT,1863,27,35-39,1890,0.0854313820625665
STAT,1833,39,25-29,1872,0.026102779542452992
STAT,1873,24,na,1897,23.89474709616212
SIM,1876,13,na,1889,31
STAT,1868,37,35-39,1905,0.06844786529982802
STAT,1828,43,25-29,1871,0.002800020853616646
SIM,1931,35,na,1966,56
STAT,1928,5,na,1933,50.41517461951518
STAT,1931,21,25-29,1952,1.196305630506676
STAT,1928,34,30-34,1962,0.1957851780830213
STAT,1898,56,na,1954,27.514680514341148
SIM,1892,68,na,1960,21
SIM,1823,34,na,1857,11
STAT,1839,16,40-44,1855,0.0013282150619660263
STAT,1922,46,na,1968,41.99996840500724
STAT,1866,49,30-34,1915,8.728960925027569E-4
STAT,1914,20,40-44,1934,0.03288562758186527
STAT,1862,25,30-34,1887,0.2212268614322378
STAT,1867,50,50-100,1917,1.4660427550429827E-4
STAT,1927,23,25-29,1950,1.1287311685550765
STAT,1895,34,25-29,1929,0.13183666640964223
STAT,1842,50,45-49,1892,1.1044829051249329E-4
STAT,1826,45,50-100,1871,0.002539828100783041
STAT,1935,33,50-100,1968,0.011380858727590029
SIM,1866,5,na,1871,36
STAT,1951,12,na,1963,46.493278258350074
STAT,1920,31,20-24,1951,0.026598101441725874
STAT,1933,8,na,1941,53.17313966649139
STAT,1829,81,na,1910,3.6731537850318308
STAT,1843,43,20-24,1886,6.847944106708432E-4
STAT,1869,50,na,1919,21.162742317190688
STAT,1890,30,25-29,1920,0.12541729470908872
STAT,1858,87,na,1945,1.3406383108915958
STAT,1835,22,na,1857,12.57488161917058
STAT,1919,32,30-34,1951,0.16850599275902117
STAT,1863,39,40-44,1902,0.03836822028278222
STAT,1844,16,15-19,1860,0.0592736184987025
STAT,1867,24,na,1891,22.49089855051778
STAT,1891,46,na,1937,27.69728038620785
STAT,1857,54,50-100,1911,1.0995131015508116E-4
STAT,1942,23,20-24,1965,1.1569934311411947
STAT,1890,28,50-100,1918,0.00774301030118481
SIM,1770,90,na,1860,4
STAT,1941,30,45-49,1971,0.016420027331681783
STAT,1900,28,15-19,1928,0.006269265632055343
STAT,1904,34,45-49,1938,0.014224735797486761
SIM,1944,25,25-29,1969,1
STAT,1814,85,na,1899,1.2216029167727664
STAT,1875,28,na,1903,24.445725788093952
SIM,1860,66,na,1926,16
STAT,1936,25,25-29,1961,0.626647700816757
STAT,1855,36,40-44,1891,0.030969017634577246
STAT,1864,104,na,1968,0.004862633271615705
STAT,1856,21,na,1877,18.119483412913343
STAT,1887,43,30-34,1930,0.012458068604445522
STAT,1906,29,25-29,1935,0.6101693500361264
STAT,1870,13,na,1883,26.18874598247894
STAT,1904,21,30-34,1925,0.2560011090407856
SIM,1867,61,na,1928,9
STAT,1841,49,30-34,1890,9.277098468271209E-4
STAT,1870,26,35-39,1896,0.09618029008573825
STAT,1927,21,na,1948,44.8975102430012
STAT,1873,42,25-29,1915,0.006520725208695149
STAT,1925,20,na,1945,43.697358143009396
STAT,1872,14,na,1886,26.685536534803827
SIM,1843,57,na,1900,18
STAT,1894,32,15-19,1926,0.0018250851967058248
STAT,1919,16,50-100,1935,8.254758039197507E-4
STAT,1890,19,45-49,1909,7.892191194655171E-4
STAT,1901,16,na,1917,35.426819125543304
STAT,1845,12,na,1857,17.637356075516532
STAT,1928,17,45-49,1945,0.006263583336561833
SIM,1851,52,na,1903,15
SIM,1894,63,na,1957,22
STAT,1849,41,35-39,1890,0.014104424214945309
STAT,1900,38,25-29,1938,0.008574784183011051
STAT,1769,93,na,1862,0.31859951063812614
STAT,1801,81,na,1882,2.068816790720995
STAT,1902,24,30-34,1926,0.24961396782108172
STAT,1859,44,30-34,1903,0.009014414705853516
SIM,1850,33,na,1883,21
STAT,1855,47,50-100,1902,0.0017211338696804857
STAT,1889,42,na,1931,28.262402541822095
SIM,1888,69,na,1957,21
STAT,1918,27,30-34,1945,0.41321534759075457
STAT,1860,29,na,1889,19.329082696349023
STAT,1812,59,na,1871,9.815824104036363
STAT,1919,17,35-39,1936,0.045968782096873405
SIM,1858,25,na,1883,24
SIM,1870,59,na,1929,20
STAT,1958,13,na,1971,51.29071417134962
STAT,1827,41,15-19,1868,1.0953810311382344E-4
STAT,1939,17,20-24,1956,1.3477642962675258
STAT,1943,28,35-39,1971,0.15865463940327865
STAT,1892,16,45-49,1908,8.089812235011884E-4
STAT,1881,19,35-39,1900,0.005193205581823791
STAT,1806,51,25-29,1857,1.1704461788653565E-4
STAT,1880,52,40-44,1932,1.1011449081262311E-4
STAT,1846,15,35-39,1861,0.005652587269541661
STAT,1834,28,20-24,1862,0.1079301669135411
STAT,1842,22,40-44,1864,0.019719558115501527
STAT,1858,41,45-49,1899,0.011440134633568232
STAT,1782,75,na,1857,3.010013022789972
STAT,1807,72,na,1879,6.7469181005616
STAT,1847,44,35-39,1891,0.019082678141629034
STAT,1821,49,45-49,1870,0.0032369709875703337
SIM,1920,23,na,1943,45
STAT,1833,27,na,1860,21.105441170403598
SIM,1877,91,na,1968,3
STAT,1860,31,50-100,1891,0.007479266908016894
STAT,1877,42,25-29,1919,0.006620575923419586
SIM,1953,10,na,1963,50
STAT,1884,21,35-39,1905,0.05734584069624258
STAT,1911,22,15-19,1933,0.05015948867650857
STAT,1820,44,50-100,1864,0.00904026644777293
STAT,1902,17,25-29,1919,0.07991144799563363
STAT,1876,34,20-24,1910,0.027218455361635377
STAT,1837,22,30-34,1859,0.12148311832650396
STAT,1851,15,45-49,1866,6.784586574749225E-4
STAT,1900,45,30-34,1945,7.64722287761438E-4
STAT,1934,35,30-34,1969,0.025087765291464205
STAT,1881,29,50-100,1910,0.0060434463611719735
STAT,1899,42,45-49,1941,0.0014209778798404053
STAT,1914,43,35-39,1957,0.0019756459943336717
SIM,1886,34,na,1920,28
STAT,1891,2,na,1893,32.71734505115734
SIM,1793,87,na,1880,1
STAT,1926,40,20-24,1966,2.1707230158956648E-4
STAT,1877,18,30-34,1895,0.016409786997266418
SIM,1879,20,20-24,1899,1
STAT,1884,29,30-34,1913,0.24495679842103094
STAT,1906,53,na,1959,31.513390393403117
STAT,1847,47,na,1894,23.921585682796234
STAT,1919,26,na,1945,40.26358867303037
SIM,1864,4,na,1868,23
STAT,1909,9,na,1918,38.692448866392766
STAT,1851,46,na,1897,19.047778353455282
STAT,1826,36,15-19,1862,6.658474439570711E-4
SIM,1901,50,na,1951,31
STAT,1869,4,na,1873,28.773533120301025
STAT,1884,33,50-100,1917,0.008939051004326928
STAT,1941,28,50-100,1969,0.010217006357754623
STAT,1880,45,35-39,1925,0.0014868512810827042
STAT,1882,24,35-39,1906,0.05557386657231779
STAT,1864,19,na,1883,23.158519766427027
STAT,1861,26,25-29,1887,0.36091198143889003
STAT,1957,15,15-19,1972,0.5952965319567753
STAT,1912,46,35-39,1958,0.001232437330423765
STAT,1841,56,na,1897,19.9642405766903
STAT,1909,43,25-29,1952,6.601846434162641E-4
STAT,1813,54,35-39,1867,2.4626645314534176E-4
STAT,1879,15,30-34,1894,0.016573354243791888
SIM,1887,21,25-29,1908,1
STAT,1897,45,45-49,1942,0.0017854471804917393
SIM,1869,62,na,1931,13
STAT,1910,19,40-44,1929,0.0027398073830653615
STAT,1898,34,40-44,1932,0.058001469378543606
STAT,1881,50,na,1931,20.782751710716997
STAT,1879,21,25-29,1900,0.594286607357089
STAT,1817,38,30-34,1855,0.1987247851096
SIM,1818,50,na,1868,24
STAT,1856,83,na,1939,2.875906180792163
STAT,1876,26,50-100,1902,0.006519304586243923
SIM,1879,86,na,1965,2
STAT,1869,26,25-29,1895,0.41128256627833637
STAT,1824,33,45-49,1857,0.027584687315202677
STAT,1832,79,na,1911,3.160017411453082
STAT,1952,4,na,1956,46.84877477100835
SIM,1927,7,na,1934,52
STAT,1856,55,na,1911,14.979206620100943
STAT,1864,49,50-100,1913,0.0021568489241651214
STAT,1903,16,30-34,1919,0.022716225462017722
SIM,1826,36,25-29,1862,2
STAT,1876,27,15-19,1903,0.0046080105680892935
STAT,1818,43,30-34,1861,0.011992087354159032
STAT,1814,53,40-44,1867,2.834852806835664E-4
STAT,1818,44,na,1862,7.204301618396585
STAT,1887,16,35-39,1903,0.006003912349675874
STAT,1927,32,20-24,1959,0.029851379352455253
STAT,1855,100,na,1955,0.007474722282966624
STAT,1857,33,40-44,1890,0.03232800589587135
STAT,1913,18,50-100,1931,7.576177140314412E-4
STAT,1805,53,30-34,1858,1.1288141689753636E-4
STAT,1835,43,30-34,1878,0.006160012731906255
STAT,1829,39,35-39,1868,0.06347826859997766
STAT,1891,24,45-49,1915,0.008505093757452939
STAT,1855,39,45-49,1894,0.013894276752968242
STAT,1838,20,25-29,1858,0.5848143094205209
SIM,1935,32,20-24,1967,1
SIM,1849,42,na,1891,7
STAT,1853,31,15-19,1884,9.312905038338103E-4
STAT,1912,47,50-100,1959,0.00215668531890398
SIM,1906,28,na,1934,27
STAT,1880,16,50-100,1896,5.16440896870723E-4
STAT,1809,46,25-29,1855,0.001995926425875734
STAT,1810,64,na,1874,7.175300620863253
STAT,1828,40,20-24,1868,7.147831275016357E-4
STAT,1835,100,na,1935,0.004775203502714188
STAT,1825,91,na,1916,0.31239863943484436
STAT,1886,38,50-100,1924,0.01267179667690395
STAT,1908,54,na,1962,32.18967634083607
STAT,1801,87,na,1888,0.58127182772179
STAT,1925,26,na,1951,44.12036352278049
STAT,1830,44,25-29,1874,6.482541412233593E-4
SIM,1863,8,na,1871,22
STAT,1928,18,50-100,1946,0.00468537956116503
SIM,1901,6,na,1907,42
STAT,1844,36,35-39,1880,0.06482356910598235
STAT,1917,35,30-34,1952,0.01893654829848103
SIM,1910,33,na,1943,32
STAT,1885,34,30-34,1919,0.17094112679272944
SIM,1893,34,30-34,1927,2
STAT,1829,49,45-49,1878,0.00196327786540317
STAT,1908,38,25-29,1946,0.009125223263418953
STAT,1840,43,40-44,1883,0.018151529960407163
STAT,1841,33,45-49,1874,0.0204956082813072
STAT,1849,49,30-34,1898,7.34907266398423E-4
STAT,1843,20,35-39,1863,0.03152203077278441
STAT,1920,22,25-29,1942,1.0181514030485945
STAT,1902,63,na,1965,27.425349903865452
STAT,1852,93,na,1945,0.2501250089817429
STAT,1837,49,50-100,1886,0.0012095758765110975
STAT,1845,17,40-44,1862,0.0013513219957215377
STAT,1840,18,35-39,1858,0.005534070015851419
SIM,1799,72,na,1871,12
STAT,1924,48,50-100,1972,0.0026677542719452264
STAT,1775,93,na,1868,0.10060717030029921
STAT,1843,28,30-34,1871,0.1305171963704005
STAT,1928,30,15-19,1958,0.0016007639880156815
SIM,1883,29,20-24,1912,2
SIM,1895,17,na,1912,31
STAT,1903,22,25-29,1925,0.8138798535217399
STAT,1923,25,45-49,1948,0.019831127736705527
SIM,1925,28,25-29,1953,1
SIM,1863,20,25-29,1883,1
STAT,1864,13,na,1877,24.230050373613267
STAT,1873,27,na,1900,24.263605709273612
STAT,1878,16,25-29,1894,0.05864798672677768
STAT,1860,28,30-34,1888,0.20542985023433946
STAT,1876,37,25-29,1913,0.029242443795924885
STAT,1913,45,40-44,1958,0.001533170127377737
STAT,1815,43,45-49,1858,0.022588422130626007
SIM,1840,43,na,1883,17
STAT,1948,23,na,1971,41.63894667069441
SIM,1851,28,30-34,1879,1
SIM,1914,57,na,1971,32
SIM,1857,77,na,1934,8
STAT,1902,35,50-100,1937,0.003772449569503089
STAT,1853,41,na,1894,14.591433098234111
SIM,1912,28,na,1940,35
STAT,1835,36,25-29,1871,0.016322421844334953
STAT,1890,33,na,1923,28.86426606155631
STAT,1934,28,25-29,1962,0.8812690031526053
STAT,1824,44,na,1868,18.664705168260742
STAT,1882,34,45-49,1916,0.016568731658284985
STAT,1918,43,35-39,1961,0.0021182370049472633
SIM,1825,66,na,1891,9
STAT,1860,20,35-39,1880,0.054521602663774135
STAT,1899,32,35-39,1931,0.13863281203278857
SIM,1874,49,na,1923,25
STAT,1881,44,40-44,1925,0.021113938518657435
STAT,1854,30,20-24,1884,0.017274618433495866
STAT,1855,20,25-29,1875,0.4776964234603726
STAT,1931,1,na,1932,54.41869932768494
STAT,1838,39,45-49,1877,0.01828607026821295
STAT,1917,28,25-29,1945,0.6815867965600749
STAT,1944,27,40-44,1971,0.05001144781122668
STAT,1875,29,20-24,1904,0.11973063722024323
STAT,1860,42,45-49,1902,0.012152296287876358
SIM,1911,22,25-29,1933,1
STAT,1887,47,na,1934,24.442699314305482
SIM,1870,87,na,1957,3
SIM,1832,33,45-49,1865,1
STAT,1806,59,na,1865,13.864705757962646
SIM,1941,25,na,1966,46
STAT,1844,17,50-100,1861,4.8644318900958585E-4
SIM,1945,1,na,1946,42
STAT,1845,103,na,1948,8.389153818777952E-4
STAT,1876,44,30-34,1920,0.011518944967987079
STAT,1818,36,25-29,1854,0.04254618179536476
STAT,1809,53,30-34,1862,1.9081457881665287E-4
SIM,1829,28,na,1857,21
STAT,1907,20,50-100,1927,0.006000550906204179
STAT,1871,45,25-29,1916,5.799974478299949E-4
STAT,1883,85,na,1968,5.450667916161826
STAT,1859,15,45-49,1874,6.098385385623733E-4
STAT,1885,27,25-29,1912,0.4177327952892404
STAT,1908,45,30-34,1953,8.138119235888697E-4
SIM,1901,24,20-24,1925,1
SIM,1885,1,na,1886,36
STAT,1821,39,35-39,1860,0.12279476466016061
STAT,1891,46,50-100,1937,0.0017052034113997207
STAT,1928,40,25-29,1968,9.084018334521167E-4
STAT,1890,16,40-44,1906,0.00222718535180638
STAT,1900,68,na,1968,24.349737553203216
SIM,1889,17,na,1906,34
STAT,1842,29,25-29,1871,0.38687029810931617
SIM,1861,25,20-24,1886,2
STAT,1889,70,na,1959,18.36166340165452
STAT,1867,44,20-24,1911,0.0014992639325865967
STAT,1884,31,45-49,1915,0.01715495257532012
STAT,1877,32,15-19,1909,0.001470018959739326
SIM,1831,25,40-44,1856,1
STAT,1827,27,na,1854,16.22517040471482
STAT,1870,23,30-34,1893,0.17639842629518115
STAT,1813,48,40-44,1861,0.00522755256932148
STAT,1863,15,35-39,1878,0.005609615614202335
STAT,1869,41,20-24,1910,0.001545767944610101
STAT,1940,25,15-19,1965,0.007153915181924506
SIM,1789,82,na,1871,2
STAT,1954,5,na,1959,48.32892191024464
STAT,1926,43,25-29,1969,8.739145281496524E-4
STAT,1834,38,30-34,1872,0.04636423612683181
STAT,1909,36,na,1945,35.581156776844324
STAT,1869,56,na,1925,19.762858403559004
SIM,1919,16,30-34,1935,1
STAT,1921,21,30-34,1942,0.3230685002753544
STAT,1865,66,na,1931,14.824639304783052
SIM,1813,41,na,1854,13
STAT,1897,35,35-39,1932,0.09481726176617918
SIM,1812,65,na,1877,14
STAT,1879,18,35-39,1897,0.005664315010785042
SIM,1821,70,na,1891,4
STAT,1881,22,na,1903,22.504464786885258
STAT,1932,39,15-19,1971,2.5642490942888094E-4
STAT,1817,40,45-49,1857,0.05030750731370926
STAT,1936,22,20-24,1958,1.0566465158371545
STAT,1871,42,20-24,1913,0.0015814171104511566
STAT,1853,25,20-24,1878,0.0866527409812905
SIM,1880,18,na,1898,32
STAT,1895,16,50-100,1911,6.376017526043751E-4
STAT,1885,80,na,1965,8.99160443420255
STAT,1884,19,20-24,1903,0.1727641379266958
STAT,1909,37,30-34,1946,0.01715447555344731
STAT,1898,37,45-49,1935,0.026892152903953304
STAT,1889,44,40-44,1933,0.027166877793643053
STAT,1943,18,25-29,1961,0.45604358108633164
STAT,1912,53,na,1965,34.285495711456434
SIM,1892,34,na,1926,36
STAT,1893,19,30-34,1912,0.019988964268561196
STAT,1890,67,na,1957,19.78718391880361
STAT,1900,48,35-39,1948,0.0010813259832411649
STAT,1888,15,40-44,1903,0.0021473322201429
STAT,1847,72,na,1919,13.490710711763786
STAT,1875,35,15-19,1910,5.82718503359825E-4
STAT,1857,18,15-19,1875,0.05190892253406255
STAT,1855,29,35-39,1884,0.06979791159894497
STAT,1866,14,na,1880,24.57408534097774
STAT,1918,37,40-44,1955,0.01563578499652715
STAT,1835,26,15-19,1861,0.002757879426286752
STAT,1880,39,40-44,1919,0.04556847704017599
STAT,1900,35,20-24,1935,0.010790739520587154
STAT,1920,38,40-44,1958,0.01623439599437179
STAT,1933,21,na,1954,48.38759757120153
STAT,1895,31,20-24,1926,0.035236012123332036
STAT,1861,48,35-39,1909,0.0011625444413413076
STAT,1864,107,na,1971,6.792620566613837E-4
SIM,1875,62,na,1937,13
SIM,1894,69,na,1963,18
STAT,1844,33,30-34,1877,0.16139943801618517
STAT,1851,28,20-24,1879,0.11513009658463014
STAT,1826,28,30-34,1854,0.8591536896614923
STAT,1812,46,30-34,1858,0.001101774598840242
STAT,1898,19,15-19,1917,0.07962781124313494
STAT,1808,48,30-34,1856,6.888675193984492E-4
STAT,1932,9,na,1941,52.49931968325339
STAT,1912,22,35-39,1934,0.08953233716858704
STAT,1885,37,35-39,1922,0.06984614690510703
STAT,1832,73,na,1905,5.368746800479761
SIM,1853,47,na,1900,22
SIM,1886,6,na,1892,30
STAT,1929,4,na,1933,51.26390369098074
SIM,1834,28,30-34,1862,1
SIM,1946,18,15-19,1964,2
STAT,1909,40,20-24,1949,1.6611894734012807E-4
STAT,1848,43,40-44,1891,0.014440983973142963
SIM,1939,15,na,1954,26
STAT,1903,11,na,1914,36.77117810678082
STAT,1908,35,20-24,1943,0.0024785968092158914
STAT,1872,44,30-34,1916,0.01160428354315645
SIM,1834,49,na,1883,15
STAT,1837,25,35-39,1862,0.06204659750608215
STAT,1888,23,na,1911,27.552510333581385
STAT,1854,29,na,1883,15.073402337302033
STAT,1853,19,50-100,1872,3.6603904167882117E-4
STAT,1863,45,35-39,1908,0.0012519145072595094
STAT,1869,34,50-100,1903,0.008801873610170976
STAT,1858,39,30-34,1897,0.04014696947323122
STAT,1938,18,15-19,1956,0.4445865488307156
SIM,1904,33,na,1937,29
STAT,1842,25,45-49,1867,0.010451290631678035
STAT,1856,34,35-39,1890,0.07273573144477992
STAT,1844,41,15-19,1885,1.118991997584217E-4
STAT,1914,35,15-19,1949,1.919504849504423E-4
STAT,1926,28,35-39,1954,0.17831894614286609
STAT,1791,86,na,1877,0.6710501853659068
STAT,1869,28,na,1897,23.042615187102328
STAT,1843,82,na,1925,1.9792127103849892
STAT,1874,40,na,1914,23.683920808866695
SIM,1919,32,na,1951,44
STAT,1836,31,15-19,1867,0.001755335912676214
STAT,1879,37,40-44,1916,0.04530759183951822
SIM,1828,40,na,1868,16
STAT,1935,27,30-34,1962,0.5317422845390928
STAT,1869,16,15-19,1885,0.05864399704791683
STAT,1934,38,35-39,1972,0.0332030129344872
SIM,1873,61,na,1934,16
STAT,1913,41,50-100,1954,0.0011426106948588589
STAT,1876,38,na,1914,23.80969723661471
STAT,1887,32,50-100,1919,0.010000891123143337
STAT,1904,46,45-49,1950,0.0019129322291859428
STAT,1927,35,25-29,1962,0.012200219858513937
STAT,1830,41,20-24,1871,8.809145695046593E-4
STAT,1950,20,45-49,1970,0.013274634769889515
STAT,1870,46,50-100,1916,0.0024466892934262995
STAT,1863,31,na,1894,21.214684843229204
STAT,1846,27,50-100,1873,0.006271657224275092
STAT,1896,52,na,1948,28.132840718213053
SIM,1876,44,na,1920,28
SIM,1831,38,na,1869,10
SIM,1869,25,20-24,1894,1
STAT,1901,19,30-34,1920,0.022182917049652775
STAT,1894,23,na,1917,30.2166123547651
STAT,1838,98,na,1936,0.0252134432846425
SIM,1845,52,na,1897,22
STAT,1868,36,20-24,1904,0.007495758583805918
STAT,1897,37,na,1934,31.286325961398184
STAT,1820,47,35-39,1867,0.001183667004175241
STAT,1854,49,40-44,1903,0.0010245856037600545
STAT,1939,24,50-100,1963,0.006558329976777626
SIM,1861,76,na,1937,9
STAT,1818,46,35-39,1864,0.0013976922485196617
STAT,1877,50,45-49,1927,1.5195877377972988E-4
STAT,1843,30,45-49,1873,0.00907944537663853
STAT,1839,22,35-39,1861,0.0413776229179048
STAT,1834,34,15-19,1868,0.00126259479967237
STAT,1918,33,25-29,1951,0.09691609101941705
STAT,1842,33,50-100,1875,0.008218657582403912
SIM,1945,15,na,1960,36
STAT,1875,39,30-34,1914,0.05423359092683025
SIM,1830,53,na,1883,17
STAT,1908,48,35-39,1956,0.001156724623041612
STAT,1849,100,na,1949,0.008231903263872433
STAT,1935,30,50-100,1965,0.011400798502970917
STAT,1826,43,20-24,1869,0.0016517179033683385
STAT,1853,47,30-34,1900,6.055335645274456E-4
STAT,1831,43,30-34,1874,0.011242071900824832
STAT,1874,33,40-44,1907,0.043809954779236174
SIM,1846,36,40-44,1882,1
SIM,1928,43,na,1971,54
SIM,1845,80,na,1925,4
STAT,1862,31,25-29,1893,0.08873070136325782
STAT,1897,44,50-100,1941,9.610670115891191E-4
STAT,1926,33,15-19,1959,0.0015440045784624783
STAT,1843,36,15-19,1879,2.8098470083120575E-4
STAT,1868,40,na,1908,22.592604467037393
STAT,1914,40,30-34,1954,0.0012650858874605918
STAT,1795,76,na,1871,4.588421489747946
STAT,1845,46,na,1891,13.188757364113114
SIM,1825,38,na,1863,19
STAT,1859,97,na,1956,0.04975225836061971
STAT,1936,32,30-34,1968,0.15210643194999107
STAT,1860,24,15-19,1884,0.0272521619864959
STAT,1877,20,45-49,1897,0.007241127473849617
STAT,1882,38,na,1920,22.466371991749362
STAT,1816,39,25-29,1855,0.04236787432800466
SIM,1882,44,na,1926,29
STAT,1857,31,na,1888,18.162018997223594
STAT,1894,26,20-24,1920,0.15086528744310354
STAT,1903,26,40-44,1929,0.04273507981904405
STAT,1924,30,45-49,1954,0.0183215439854828
STAT,1913,49,20-24,1962,1.0633483041848275E-4
STAT,1873,95,na,1968,0.5788232612031133
STAT,1838,36,40-44,1874,0.04142497522674181
STAT,1861,16,15-19,1877,0.05770211263393849
STAT,1852,33,20-24,1885,0.02370514725766187
STAT,1933,32,45-49,1965,0.02111956546352433
SIM,1795,82,na,1877,4
SIM,1837,23,na,1860,28
STAT,1871,37,40-44,1908,0.043643718647566825
SIM,1816,55,na,1871,11
STAT,1893,34,20-24,1927,0.03379045703633065
STAT,1885,24,20-24,1909,0.6762609019866012
STAT,1836,41,25-29,1877,0.007467604729777462
STAT,1915,36,na,1951,37.8590256570649
STAT,1841,23,35-39,1864,0.07183829487184247
SIM,1911,26,40-44,1937,1
STAT,1881,40,25-29,1921,0.006172059280431671
STAT,1844,98,na,1942,0.025374194559929696
STAT,1846,50,50-100,1896,1.241558228025092E-4
STAT,1885,42,15-19,1927,1.362062134999997E-4
STAT,1921,36,na,1957,41.71833865828365
STAT,1850,98,na,1948,0.02892387054582603
STAT,1794,60,na,1854,11.0
STAT,1880,20,20-24,1900,0.7289751455858002
STAT,1839,46,na,1885,12.813294557003502
STAT,1875,31,50-100,1906,0.009456964237007037
STAT,1913,48,45-49,1961,0.0020977335823025543
STAT,1925,22,45-49,1947,0.01338394177848713
STAT,1891,80,na,1971,12.254773265843118
STAT,1826,42,50-100,1868,0.011183355294189621
STAT,1833,32,40-44,1865,0.041337619422765016
SIM,1843,23,na,1866,22
STAT,1827,35,20-24,1862,0.006477935243520841
STAT,1944,23,25-29,1967,0.9897622361296529
SIM,1898,59,na,1957,20
STAT,1955,15,50-100,1970,0.004948192480919174
SIM,1805,83,na,1888,2
STAT,1824,30,40-44,1854,0.07566026452847406
STAT,1859,47,35-39,1906,0.0011075559769184277
STAT,1890,42,25-29,1932,0.007790696643202493
STAT,1891,21,40-44,1912,0.025653131210614924
STAT,1876,40,15-19,1916,1.4167421100349582E-4
STAT,1911,17,35-39,1928,0.008342761318191621
SIM,1801,56,na,1857,10
STAT,1857,36,45-49,1893,0.014995228830771274
SIM,1928,22,35-39,1950,1
STAT,1930,41,25-29,1971,9.365189224769853E-4
STAT,1934,25,20-24,1959,0.24473253655318494
SIM,1947,8,na,1955,42
STAT,1837,17,na,1854,14.689887884056034
SIM,1830,50,na,1880,17
SIM,1904,64,na,1968,24
STAT,1926,25,30-34,1951,0.4701914783688045
STAT,1848,26,na,1874,16.822037038570702
STAT,1789,76,na,1865,2.3497409235569156
STAT,1953,6,na,1959,47.280131507479105
SIM,1847,16,na,1863,24
STAT,1932,15,45-49,1947,0.006618499629494592
STAT,1864,26,40-44,1890,0.026960101645914655
SIM,1949,9,na,1958,38
STAT,1889,35,45-49,1924,0.024638684882972713
SIM,1822,55,na,1877,12
STAT,1815,103,na,1918,5.123037567731484E-4
STAT,1876,47,35-39,1923,0.0014152750637048243
STAT,1917,25,20-24,1942,0.1909790882408191
STAT,1825,29,25-29,1854,0.8761175586719852
SIM,1874,18,na,1892,27
STAT,1874,18,15-19,1892,0.060047769288605196
STAT,1943,14,na,1957,41.33631090293414
STAT,1906,26,50-100,1932,0.009325445295158503
SIM,1796,61,na,1857,10
STAT,1900,25,50-100,1925,0.008930679512001173
STAT,1838,17,35-39,1855,0.005625381113212058
STAT,1847,29,45-49,1876,0.014051938475658499
STAT,1825,40,35-39,1865,0.01826335938601782
STAT,1940,15,50-100,1955,0.0037790244212653466
STAT,1797,71,na,1868,5.31302274761246
STAT,1854,20,na,1874,15.578503154576227
STAT,1867,95,na,1962,0.31302870927218834
STAT,1867,47,25-29,1914,5.486395133750306E-4
STAT,1823,65,na,1888,9.822228689753882
SIM,1885,55,na,1940,19
SIM,1934,25,30-34,1959,3
STAT,1892,31,35-39,1923,0.12562182847936093
STAT,1821,36,30-34,1857,0.11876901081316016
STAT,1830,48,40-44,1878,1.6758487689539156E-4
STAT,1853,35,30-34,1888,0.034198282413170765
SIM,1886,0,na,1886,36
STAT,1872,45,na,1917,23.249196980754913
STAT,1816,80,na,1896,1.8571363816964817
STAT,1912,24,25-29,1936,0.9095522155537615
STAT,1785,86,na,1871,1.9933279792522622
SIM,1871,35,na,1906,24
STAT,1916,12,na,1928,41.54274664508297
STAT,1869,103,na,1972,0.016371210324090793
STAT,1850,20,40-44,1870,0.022592145891162475
STAT,1872,40,15-19,1912,1.4272381019325538E-4
STAT,1833,34,50-100,1867,0.008554155118769556
STAT,1842,35,na,1877,19.24633047183838
SIM,1784,76,na,1860,2
STAT,1931,29,na,1960,48.10256368709234
STAT,1895,46,25-29,1941,4.2301628117150716E-4
STAT,1863,42,30-34,1905,0.010166602903995087
STAT,1872,54,40-44,1926,1.04753660144874E-4
STAT,1875,41,45-49,1916,0.015454207129594005
SIM,1865,6,na,1871,25
STAT,1896,15,30-34,1911,0.021033320838588002
STAT,1907,30,45-49,1937,0.014764302959239436
SIM,1911,12,na,1923,42
SIM,1874,15,na,1889,28
STAT,1912,22,na,1934,36.28635977235327
STAT,1921,36,35-39,1957,0.026821044534818
STAT,1922,41,35-39,1963,0.0022976636522632414
SIM,1803,51,na,1854,11
STAT,1823,68,na,1891,8.788482141782184
STAT,1833,23,45-49,1856,0.006890151171913564
STAT,1848,28,15-19,1876,0.0034776030618403997
STAT,1918,42,20-24,1960,1.860688291175723E-4
STAT,1879,46,50-100,1925,0.0025492017211781225
STAT,1851,19,25-29,1870,0.057481849033879484
STAT,1926,37,30-34,1963,0.022146903665177804
SIM,1858,56,na,1914,23
STAT,1891,22,50-100,1913,0.005005071848613669
STAT,1808,50,45-49,1858,1.0490545203363535E-4
STAT,1897,23,50-100,1920,0.005398541544035636
SIM,1858,53,na,1911,24
STAT,1891,12,na,1903,31.69678205910392
SIM,1904,30,na,1934,28
STAT,1916,15,na,1931,40.81615475233521
STAT,1859,66,na,1925,13.027129430279427
SIM,1883,20,na,1903,15
STAT,1865,60,na,1925,17.250198743458323
STAT,1867,92,na,1959,0.6488348734380845
STAT,1868,16,50-100,1884,4.8556083703311465E-4
SIM,1841,28,na,1869,18
STAT,1935,23,15-19,1958,0.0721433036278886
SIM,1866,82,na,1948,2
SIM,1902,26,30-34,1928,1
STAT,1835,46,35-39,1881,6.768516161225468E-4
STAT,1815,100,na,1915,0.0037897408878500762
STAT,1870,25,20-24,1895,0.11732953586756804
STAT,1808,51,na,1859,4.656650485744056
STAT,1889,47,45-49,1936,0.0016222765346940843
STAT,1838,29,35-39,1867,0.093900313163217
STAT,1879,18,na,1897,26.071788475305258
STAT,1909,47,40-44,1956,0.001440622382245927
STAT,1821,52,35-39,1873,1.1685259616756608E-4
STAT,1924,41,na,1965,43.951894276698866
SIM,1929,22,na,1951,48
STAT,1910,15,25-29,1925,0.08573929103004406
STAT,1912,31,30-34,1943,0.154445386743986
STAT,1878,33,na,1911,24.532727309980814
STAT,1873,19,45-49,1892,6.605675003368531E-4
STAT,1873,24,50-100,1897,0.004120020478455738
STAT,1922,49,30-34,1971,0.0010106564903633577
SIM,1897,40,na,1937,40
STAT,1839,41,40-44,1880,0.014561757381990345
STAT,1853,72,na,1925,7.937057232823642
STAT,1930,2,na,1932,52.62800700098137
STAT,1886,41,20-24,1927,0.0016547677850832618
STAT,1908,4,na,1912,38.820978410639334
STAT,1879,80,na,1959,7.855049826102185
STAT,1884,25,15-19,1909,0.00447531689868386
STAT,1951,21,50-100,1972,0.0078163047190689
STAT,1920,16,30-34,1936,0.13592041773911068
STAT,1847,22,25-29,1869,0.7496624340092273
SIM,1946,21,40-44,1967,1
STAT,1894,36,30-34,1930,0.06863218471868351
STAT,1843,18,20-24,1861,0.09553857631375182
STAT,1882,23,50-100,1905,0.0038959581950594262
STAT,1865,31,40-44,1896,0.03938535019564558
SIM,1835,28,na,1863,21
STAT,1878,30,na,1908,24.83472740814933
STAT,1912,56,na,1968,33.72525331530068
STAT,1921,43,40-44,1964,0.002790819092864217
STAT,1859,17,50-100,1876,4.520068478682542E-4
STAT,1918,30,20-24,1948,0.025891340897165972
SIM,1814,91,na,1905,4
STAT,1856,22,35-39,1878,0.04909748693378307
STAT,1810,95,na,1905,0.04779030983642806
SIM,1920,31,30-34,1951,1
STAT,1883,26,45-49,1909,0.010818948613476789
STAT,1922,40,50-100,1962,0.0013422715421035388
STAT,1858,53,45-49,1911,1.0865834812563658E-4
SIM,1926,8,na,1934,49
SIM,1902,5,na,1907,38
STAT,1813,44,25-29,1857,0.02053501599179917
STAT,1910,27,na,1937,35.9537409481476
SIM,1772,88,na,1860,1
STAT,1920,32,35-39,1952,0.09924476539174734
STAT,1918,47,na,1965,38.741036426620944
STAT,1938,21,40-44,1959,0.0330688523492481
STAT,1898,40,35-39,1938,0.0017134395550113296
STAT,1833,35,45-49,1868,0.018839400069116705
STAT,1880,35,25-29,1915,0.030563824588025604
SIM,1847,13,na,1860,25
STAT,1893,47,na,1940,28.240730844572415
STAT,1841,87,na,1928,1.7244836692065082
STAT,1930,41,na,1971,48.70741082599535
STAT,1884,33,na,1917,23.281265737731946
SIM,1849,48,na,1897,7
STAT,1931,35,15-19,1966,2.536353590470387E-4
STAT,1852,46,35-39,1898,0.0012015893738220858
STAT,1837,19,40-44,1856,0.0015917798810190442
STAT,1827,45,30-34,1872,7.488411211599597E-4
STAT,1852,36,25-29,1888,0.025033863693871183
STAT,1865,24,35-39,1889,0.05265838146204294
STAT,1953,3,na,1956,47.310877086978394
STAT,1851,30,35-39,1881,0.09085315837676862
STAT,1894,48,30-34,1942,6.909980721023822E-4
STAT,1935,30,20-24,1965,0.033634027449925046
SIM,1900,71,na,1971,18
STAT,1904,43,40-44,1947,0.00222192649575163
STAT,1812,47,45-49,1859,0.0026506095056572517
STAT,1847,78,na,1925,8.346485088577749
STAT,1904,27,na,1931,34.19626918773486
STAT,1804,53,50-100,1857,4.0659600532593425E-4
STAT,1849,51,45-49,1900,1.1306639951947831E-4
STAT,1868,2,na,1870,32.425396320410044
STAT,1862,33,15-19,1895,0.0012234581679717012
STAT,1820,88,na,1908,0.7782947654501471
SIM,1828,49,na,1877,13
STAT,1889,29,15-19,1918,0.0055151226560872435
SIM,1872,85,na,1957,4
STAT,1925,26,25-29,1951,0.7751993317661533
STAT,1893,37,25-29,1930,0.03630314533264328
STAT,1942,22,50-100,1964,0.006848780920023199
SIM,1824,50,na,1874,16
STAT,1842,19,15-19,1861,0.05650527158668378
STAT,1927,45,35-39,1972,0.001617709565599727
STAT,1943,17,na,1960,38.747349424599776
SIM,1920,24,25-29,1944,2
STAT,1921,31,40-44,1952,0.04338622360769291
STAT,1944,20,20-24,1964,1.1926958346944112
STAT,1906,25,45-49,1931,0.016240095188182837
STAT,1897,20,30-34,1917,0.23795050254881064
STAT,1948,23,50-100,1971,0.0075026734921792475
STAT,1853,48,45-49,1901,0.0014645790090963662
STAT,1860,20,na,1880,19.976788851111806
STAT,1845,40,20-24,1885,9.698815606607009E-4
SIM,1850,19,15-19,1869,1
STAT,1861,36,35-39,1897,0.059766404653602834
STAT,1901,21,45-49,1922,0.009786862993098278
STAT,1877,85,na,1962,4.619883420454348
SIM,1930,19,na,1949,47
STAT,1813,52,50-100,1865,4.4959826990510386E-4
STAT,1930,33,40-44,1963,0.050235561211219644
STAT,1874,36,45-49,1910,0.020321089370510376
SIM,1935,25,na,1960,56
SIM,1889,48,na,1937,27
STAT,1877,48,30-34,1925,9.866733609679179E-4
STAT,1870,48,45-49,1918,0.0023149396247099654
STAT,1864,25,50-100,1889,0.005798873073899917
STAT,1935,37,40-44,1972,0.0208398508653582
STAT,1892,62,na,1954,22.579930212158246
STAT,1859,40,50-100,1899,0.00848158534503281
STAT,1872,48,na,1920,22.73045711038259
STAT,1826,46,25-29,1872,5.87722931721918E-4
STAT,1862,41,50-100,1903,0.009155935053528727
SIM,1834,43,na,1877,19
SIM,1784,73,na,1857,3
STAT,1937,19,45-49,1956,0.004814702678677766
STAT,1917,32,50-100,1949,0.008579137874007355
SIM,1855,42,na,1897,18
STAT,1819,91,na,1910,0.2974632724808002
STAT,1817,65,na,1882,15.073171284990803
STAT,1868,46,30-34,1914,9.394371393575727E-4
STAT,1943,25,30-34,1968,0.41461843792099634
STAT,1861,23,20-24,1884,0.5910922333428247
SIM,1833,26,20-24,1859,1
STAT,1847,26,40-44,1873,0.038740187201894614
STAT,1875,31,35-39,1906,0.10452580181059307
STAT,1871,60,na,1931,19.014588141399617
STAT,1855,17,35-39,1872,0.004595004593929378
SIM,1807,47,na,1854,17
STAT,1802,66,na,1868,6.823871407706853
STAT,1925,29,na,1954,43.65521383292442
STAT,1871,43,35-39,1914,0.01792340308065766
STAT,1899,36,15-19,1935,7.724185640637215E-4
SIM,1868,15,na,1883,38
STAT,1951,16,25-29,1967,0.5130559326392979
STAT,1849,103,na,1952,0.0011128029837067389
STAT,1867,40,40-44,1907,0.021741874555879816
STAT,1847,41,na,1888,25.14734298639917
SIM,1880,49,na,1929,30
STAT,1922,39,20-24,1961,0.002971230230374729
STAT,1907,2,na,1909,38.99198224926954
STAT,1889,32,40-44,1921,0.053095794882721356
STAT,1895,43,20-24,1938,1.4214124931408536E-4
STAT,1824,35,50-100,1859,0.018669346180454967
SIM,1884,70,na,1954,16
STAT,1896,58,na,1954,25.97645479525114
STAT,1810,92,na,1902,0.14970724311169353
STAT,1838,64,na,1902,13.492210422631278
STAT,1884,43,45-49,1927,0.014557436467704644
STAT,1864,29,45-49,1893,0.009887387060755743
SIM,1879,55,na,1934,13
STAT,1863,34,na,1897,20.947448654059016
STAT,1897,23,35-39,1920,0.07725312045318818
SIM,1820,34,30-34,1854,1
STAT,1885,30,15-19,1915,0.001417600882030664
STAT,1885,49,35-39,1934,0.001353654755745334
STAT,1839,44,45-49,1883,0.008484724097191918
STAT,1908,23,20-24,1931,1.0137972172132426
STAT,1874,74,na,1948,11.258709729045819
STAT,1937,14,na,1951,38.17910568173381
SIM,1925,6,na,1931,45
STAT,1817,52,45-49,1869,4.034697938901774E-4
SIM,1864,56,na,1920,19
STAT,1792,65,na,1857,16.095053737872004
STAT,1892,17,20-24,1909,0.2190196322100014
STAT,1893,30,40-44,1923,0.055120207515389645
STAT,1902,27,35-39,1929,0.1360679006653013
STAT,1922,15,na,1937,42.48239732035279
STAT,1821,46,40-44,1867,0.0024556631862897435
STAT,1867,37,15-19,1904,5.373770103341068E-4
STAT,1881,59,na,1940,18.4929055524466
SIM,1827,61,na,1888,5
STAT,1841,53,na,1894,20.737134895048726
SIM,1951,18,na,1969,51
STAT,1911,39,45-49,1950,0.00647622929074667
SIM,1853,16,na,1869,29
SIM,1916,23,20-24,1939,3
SIM,1932,11,na,1943,53
STAT,1920,26,40-44,1946,0.050869357134996115
STAT,1894,42,25-29,1936,5.707928436161843E-4
STAT,1898,30,25-29,1928,0.1392834737444546
STAT,1903,48,50-100,1951,0.0019449040835511407
STAT,1829,27,35-39,1856,0.11084653469517193
STAT,1931,16,50-100,1947,0.004894142771168452
STAT,1850,23,45-49,1873,0.0073985099300920305
STAT,1899,32,na,1931,32.66701442538895
STAT,1921,33,30-34,1954,0.1732288578175465
STAT,1826,79,na,1905,4.885465571864541
STAT,1918,45,25-29,1963,5.620095032487188E-4
STAT,1866,45,na,1911,20.927194180497192
STAT,1802,69,na,1871,6.101698722631669
STAT,1858,19,na,1877,20.1641814673224
STAT,1909,33,na,1942,35.73710055982921
STAT,1918,49,40-44,1967,0.0016528469131452297
SIM,1908,23,na,1931,38
STAT,1880,42,30-34,1922,0.012074487885881495
STAT,1836,43,15-19,1879,1.5653097089217855E-4
STAT,1873,16,40-44,1889,0.0018705796139023543
SIM,1946,0,na,1946,55
STAT,1813,51,30-34,1864,1.807720017631188E-4
STAT,1912,34,35-39,1946,0.08845368317726598
STAT,1858,35,15-19,1893,4.313633223630095E-4
SIM,1861,42,na,1903,23
SIM,1876,41,na,1917,27
STAT,1848,34,50-100,1882,0.006158877456583777
STAT,1908,33,50-100,1941,0.007730999909100821
STAT,1834,30,35-39,1864,0.0935949942411105
SIM,1845,83,na,1928,4
STAT,1804,52,35-39,1856,2.3644303098377048E-4
STAT,1892,4,na,1896,32.499717487575516
STAT,1851,16,20-24,1867,0.18304916907001811
STAT,1846,93,na,1939,0.23685080595945954
STAT,1871,40,50-100,1911,0.010639109132754123
SIM,1947,10,na,1957,42
STAT,1795,79,na,1874,3.45280210954767
STAT,1844,45,30-34,1889,7.680236633606753E-4
SIM,1898,22,na,1920,30
STAT,1896,18,35-39,1914,0.007188608485653985
STAT,1921,46,45-49,1967,0.0024370280995836178
STAT,1879,25,40-44,1904,0.031214729849372885
STAT,1889,16,50-100,1905,6.012962777639193E-4
SIM,1914,23,na,1937,34
STAT,1893,27,15-19,1920,0.005720632602225064
STAT,1903,32,35-39,1935,0.14397985743738836
STAT,1907,20,35-39,1927,0.0858678734175208
STAT,1926,21,15-19,1947,0.06449481912688113
SIM,1948,7,na,1955,41
STAT,1860,18,20-24,1878,0.16524685019146457
STAT,1881,48,20-24,1929,1.1275047553315844E-4
SIM,1831,69,na,1900,4
SIM,1917,37,na,1954,37
STAT,1817,68,na,1885,13.477972324004227
STAT,1815,39,na,1854,11.619742721972713
STAT,1862,47,40-44,1909,0.0014701669493576736
STAT,1814,54,na,1868,12.189043214444817
STAT,1928,39,50-100,1967,0.005268907050659574
SIM,1852,68,na,1920,19
STAT,1857,33,50-100,1890,0.00683014249242469
SIM,1883,23,na,1906,15
STAT,1870,8,na,1878,27.062089734457054
SIM,1887,81,na,1968,9
SIM,1935,22,na,1957,50
STAT,1931,40,30-34,1971,0.0017050758138792937
STAT,1888,27,40-44,1915,0.03500610080546114
SIM,1800,77,na,1877,6
SIM,1872,82,na,1954,8
STAT,1788,97,na,1885,0.011670238133475307
STAT,1935,33,25-29,1968,0.1272253191014827
STAT,1822,80,na,1902,2.1942576098152258
STAT,1869,59,na,1928,18.83102874682183
STAT,1839,34,35-39,1873,0.06736164704932696
STAT,1860,30,45-49,1890,0.014290753634796318
STAT,1924,24,50-100,1948,0.007665470245001022
STAT,1917,38,35-39,1955,0.02477092964025923
SIM,1821,76,na,1897,2
SIM,1851,83,na,1934,4
SIM,1867,67,na,1934,6
STAT,1778,100,na,1878,0.0024394463800732663
STAT,1847,8,na,1855,32.74029
STAT,1885,36,20-24,1921,0.007648885073572052
SIM,1846,68,na,1914,4
STAT,1812,49,35-39,1861,0.001531070563080205
STAT,1866,32,50-100,1898,0.008438452523539676
STAT,1889,73,na,1962,16.780676146911198
STAT,1818,45,20-24,1863,1.2157178445220146E-4
STAT,1916,32,45-49,1948,0.01610715197564477
STAT,1861,33,30-34,1894,0.14620884128587022
STAT,1877,39,50-100,1916,0.012545957185134547
STAT,1870,38,35-39,1908,0.06991309682370692
STAT,1938,24,45-49,1962,0.011054920837220322
STAT,1915,25,50-100,1940,0.010132960198256918
SIM,1812,62,na,1874,15
SIM,1887,8,na,1895,26
STAT,1943,15,20-24,1958,1.4279595654497694
STAT,1929,18,40-44,1947,0.017718618970101494
STAT,1820,54,na,1874,13.005618221654382
STAT,1820,35,35-39,1855,0.06892445629398793
STAT,1843,24,15-19,1867,0.017314308306428314
STAT,1843,42,45-49,1885,0.006536654485900872
STAT,1848,46,45-49,1894,0.0015305446329450915
STAT,1948,19,20-24,1967,1.540258713158159
STAT,1868,42,15-19,1910,1.3347943970787478E-4
STAT,1918,40,30-34,1958,0.0013507153958646513
STAT,1871,30,20-24,1901,0.02716612926881817
SIM,1902,38,na,1940,31
STAT,1913,41,25-29,1954,6.945280737897425E-4
SIM,1815,76,na,1891,2
STAT,1909,33,15-19,1942,0.0012142560323864869
STAT,1829,53,na,1882,15.133672424453664
STAT,1831,27,50-100,1858,0.006994497556381821
STAT,1844,35,20-24,1879,0.007138598348701378
STAT,1812,44,40-44,1856,0.025606332039037397
STAT,1849,39,20-24,1888,0.005990442091378665
STAT,1942,22,45-49,1964,0.01171141492700123
STAT,1853,41,25-29,1894,0.004054097525077901
STAT,1880,74,na,1954,11.67001609211433
STAT,1912,44,45-49,1956,0.0015802796966772185
STAT,1883,23,40-44,1906,0.020172953726121053
STAT,1838,24,40-44,1862,0.02068310494269072
STAT,1834,40,45-49,1874,0.013081395581797868
STAT,1864,19,35-39,1883,0.0050313829166258916
SIM,1867,30,na,1897,15
STAT,1875,59,na,1934,19.977687485324406
STAT,1927,42,30-34,1969,0.0015951861005353315
STAT,1912,21,20-24,1933,1.0604995687929397
STAT,1852,26,15-19,1878,0.004555403707343013
STAT,1865,34,45-49,1899,0.01563761186505622
SIM,1920,21,20-24,1941,1
STAT,1903,38,40-44,1941,0.013366553714089738
STAT,1869,18,40-44,1887,0.0017861814123609795
SIM,1852,31,na,1883,25
SIM,1969,1,na,1970,54
STAT,1871,49,40-44,1920,0.0016712265780894752
STAT,1877,44,15-19,1921,1.4062928853814785E-4
STAT,1835,53,na,1888,9.675940724620746
SIM,1892,37,na,1929,36
STAT,1869,100,na,1969,0.06939751026973093
STAT,1898,15,50-100,1913,6.639715092906569E-4
STAT,1880,32,20-24,1912,0.02842409787307287
SIM,1923,37,na,1960,38
STAT,1835,33,20-24,1868,0.01548305763417728
STAT,1813,41,20-24,1854,0.0055171321436385985
STAT,1831,50,50-100,1881,1.323534520179075E-4
STAT,1933,20,45-49,1953,0.014952741200693266
STAT,1850,97,na,1947,0.04783255973445242
STAT,1861,32,40-44,1893,0.03646985682209486
STAT,1864,33,20-24,1897,0.02414204124722445
STAT,1882,29,30-34,1911,0.23960434514762066
STAT,1910,46,20-24,1956,1.027321291977827E-4
STAT,1887,38,20-24,1925,0.008372142443169698
STAT,1879,23,na,1902,24.40285103604192
STAT,1842,27,35-39,1869,0.08952585637487763
STAT,1861,49,na,1910,18.52512169112107
STAT,1884,37,40-44,1921,0.04288866912604594
STAT,1940,25,50-100,1965,0.01008657587049858
SIM,1965,1,na,1966,52
STAT,1875,31,30-34,1906,0.18020924901953106
STAT,1840,19,25-29,1859,0.05681582228505962
SIM,1936,5,na,1941,38
STAT,1849,44,35-39,1893,0.013851366815081175
STAT,1861,44,35-39,1905,0.015022587176933107
SIM,1919,7,na,1926,47
STAT,1880,16,15-19,1896,0.06255821996662941
STAT,1887,42,na,1929,25.19630185543037
SIM,1879,2,na,1881,28
SIM,1844,14,na,1858,13
SIM,1848,28,na,1876,31
SIM,1881,23,20-24,1904,1
STAT,1833,21,25-29,1854,0.5738479240221555
SIM,1916,17,na,1933,46
SIM,1948,3,na,1951,43
STAT,1811,50,30-34,1861,2.3512022477163968E-4
STAT,1916,21,15-19,1937,0.05546990577711748
SIM,1878,26,na,1904,25
STAT,1889,46,30-34,1935,0.0011885179574193086
STAT,1824,36,30-34,1860,0.07929552952336462
SIM,1808,63,na,1871,8
STAT,1828,31,na,1859,19.455214178669724
STAT,1893,22,35-39,1915,0.07357824698149124
STAT,1844,35,45-49,1879,0.018461077313763452
STAT,1888,17,30-34,1905,0.01862592697073438
STAT,1838,38,25-29,1876,0.02668628026539319
SIM,1855,6,na,1861,24
STAT,1871,51,40-44,1922,1.0546290010826426E-4
SIM,1835,53,na,1888,16
STAT,1895,61,na,1956,24.493641636326863
STAT,1863,52,45-49,1915,1.2780853553840063E-4
SIM,1827,34,na,1861,21
STAT,1891,27,30-34,1918,0.30907352092811685
SIM,1910,12,na,1922,33
STAT,1847,36,25-29,1883,0.032244477917637154
STAT,1895,30,45-49,1925,0.022821240452177403
STAT,1845,28,15-19,1873,0.0032049168979810362
STAT,1871,23,50-100,1894,0.004053108905256236
STAT,1842,78,na,1920,5.8621748101498135
STAT,1900,39,15-19,1939,1.663807845062329E-4
STAT,1855,35,20-24,1890,0.005478858212587461
STAT,1908,15,30-34,1923,0.023629963065227626
STAT,1887,25,15-19,1912,0.004985795675737438
SIM,1795,71,na,1866,9
SIM,1829,26,30-34,1855,1
STAT,1882,11,na,1893,24.786247075225628
STAT,1853,30,na,1883,15.768429069779176
STAT,1831,26,20-24,1857,0.1304898261121691
STAT,1871,18,15-19,1889,0.059198870600450114
STAT,1873,26,25-29,1899,0.43155133067534046
STAT,1886,32,45-49,1918,0.018088080148160126
STAT,1919,37,na,1956,40.06723178462879
STAT,1819,70,na,1889,7.533148751948619
SIM,1825,33,35-39,1858,2
STAT,1870,42,35-39,1912,0.017966270656995416
STAT,1873,43,15-19,1916,1.3938927506094114E-4
STAT,1884,24,35-39,1908,0.05681531536101901
STAT,1835,42,40-44,1877,0.012208701669149499
STAT,1812,48,na,1860,12.024889708189649
STAT,1856,34,25-29,1890,0.07356556350415808
STAT,1915,23,na,1938,37.306601683564466
STAT,1853,33,45-49,1886,0.011169527290042697
STAT,1851,25,35-39,1876,0.09676196092677367
STAT,1879,39,25-29,1918,0.029500055163649407
STAT,1898,44,30-34,1942,0.0010624419696803958
STAT,1866,80,na,1946,5.697157722885201
STAT,1949,19,35-39,1968,0.04845808471990225
SIM,1840,22,20-24,1862,1
SIM,1912,9,na,1921,40
STAT,1869,40,45-49,1909,0.014647892346284642
SIM,1894,64,na,1958,22
STAT,1803,51,35-39,1854,1.7135177897512378E-4
STAT,1890,35,15-19,1925,6.885891802162084E-4
SIM,1872,4,na,1876,27
STAT,1919,21,40-44,1940,0.03660929872681708
SIM,1865,83,na,1948,1
STAT,1896,36,20-24,1932,0.010174111613428221
STAT,1847,49,30-34,1896,0.0010124631753565577
STAT,1852,34,40-44,1886,0.037639046359314435
STAT,1889,2,na,1891,32.63651967102334
STAT,1923,42,na,1965,43.10753423568899
STAT,1889,33,25-29,1922,0.12487424922343716
STAT,1847,16,30-34,1863,0.021376410455700285
STAT,1833,34,30-34,1867,0.16300557254067702
STAT,1835,37,45-49,1872,0.011179819893146476
STAT,1882,21,20-24,1903,0.6624124605831847
SIM,1890,50,na,1940,24
STAT,1883,16,40-44,1899,0.0017804999204167904
STAT,1834,30,30-34,1864,0.1613638291408784
STAT,1832,22,20-24,1854,0.42048720165032044
SIM,1886,45,na,1931,27
STAT,1829,45,20-24,1874,1.0511475382848544E-4
STAT,1821,84,na,1905,2.0661331517595927
STAT,1833,29,35-39,1862,0.09280584892077855
STAT,1912,49,35-39,1961,0.0012221749806720931
STAT,1866,19,45-49,1885,6.102492238732489E-4
STAT,1919,16,45-49,1935,0.0011006344052263343
STAT,1825,98,na,1923,0.01751299536805329
SIM,1897,33,25-29,1930,2
STAT,1948,18,na,1966,41.831361490553284
STAT,1950,20,50-100,1970,0.007762944605667311
SIM,1841,34,30-34,1875,1
STAT,1817,46,40-44,1863,0.005023586962281057
STAT,1865,31,na,1896,21.672086807905274
STAT,1892,43,25-29,1935,0.007875949004082264
SIM,1881,14,na,1895,26
STAT,1878,81,na,1959,6.988425373949122
SIM,1852,33,na,1885,27
SIM,1827,66,na,1893,5
STAT,1791,69,na,1860,6.396314933950308
STAT,1818,45,45-49,1863,0.0023909116701575214
STAT,1868,41,40-44,1909,0.021865752994015556
SIM,1857,64,na,1921,17
SIM,1853,50,na,1903,22
STAT,1850,26,30-34,1876,0.26575944687051567
STAT,1885,36,45-49,1921,0.01978072610472512
STAT,1877,19,20-24,1896,0.18202330887505686
STAT,1836,50,na,1886,21.874940016539238
STAT,1820,67,na,1887,8.895824275828307
SIM,1882,31,na,1913,31
STAT,1841,40,15-19,1881,1.4410692258949045E-4
STAT,1803,87,na,1890,0.6602793079297555
SIM,1851,23,35-39,1874,1
STAT,1890,15,20-24,1905,0.21634952733575266
STAT,1963,3,na,1966,49.6683312175521
STAT,1798,91,na,1889,0.3457413554857075
SIM,1953,17,na,1970,46
STAT,1825,35,35-39,1860,0.07666479189583811
STAT,1898,19,40-44,1917,0.0024541318721158618
STAT,1854,39,20-24,1893,0.004664277209016189
STAT,1813,53,45-49,1866,4.234954439763411E-4
SIM,1823,52,na,1875,11
STAT,1874,47,25-29,1921,5.81622790052157E-4
STAT,1865,37,30-34,1902,0.04820535646180466
STAT,1834,38,40-44,1872,0.03808173598191527
STAT,1837,39,20-24,1876,0.00447731784878032
STAT,1882,41,15-19,1923,1.3294447573763821E-4
STAT,1827,40,40-44,1867,0.018096037782329825
STAT,1862,98,na,1960,0.05868843916473042
STAT,1892,26,35-39,1918,0.11961267492560983
STAT,1840,24,20-24,1864,0.6768837422199538
STAT,1940,22,na,1962,36.93656750465236
STAT,1875,26,35-39,1901,0.09952578229955714
STAT,1865,32,25-29,1897,0.09264305969574659
SIM,1893,33,40-44,1926,1
STAT,1899,40,30-34,1939,0.0011039202312501826
STAT,1860,23,35-39,1883,0.04855361337143869
STAT,1894,31,40-44,1925,0.05580613785881236
STAT,1946,5,na,1951,43.71164743558178
STAT,1857,12,na,1869,21.004644048599737
STAT,1809,52,40-44,1861,3.442843922711976E-4
SIM,1816,50,na,1866,12
STAT,1876,43,40-44,1919,0.022679649668998558
STAT,1888,34,20-24,1922,0.03131744838435248
SIM,1867,42,na,1909,11
STAT,1843,23,35-39,1866,0.030847909671195366
STAT,1848,51,na,1899,13.99115389621374
STAT,1881,37,15-19,1918,5.343350469596701E-4
STAT,1864,14,na,1878,24.120045944917063
STAT,1897,35,25-29,1932,0.03859757154631861
SIM,1864,39,30-34,1903,2
STAT,1792,86,na,1878,1.4546019343084078
STAT,1848,45,30-34,1893,6.322463738420703E-4
STAT,1870,6,na,1876,27.493128741685627
STAT,1872,27,20-24,1899,0.12003271414243356
SIM,1840,32,na,1872,15
STAT,1855,18,30-34,1873,0.013268778383534605
STAT,1853,8,na,1861,18.56523604623445
STAT,1838,18,30-34,1856,0.016244148137032136
STAT,1899,48,40-44,1947,0.00130538278102162
STAT,1880,44,45-49,1924,0.015525533115176276
STAT,1923,10,na,1933,46.34413240711183
SIM,1903,42,na,1945,35
STAT,1845,102,na,1947,0.0017137509843883707
STAT,1871,59,na,1930,19.376344493085522
SIM,1844,46,na,1890,4
STAT,1848,28,40-44,1876,0.022960819651502973
STAT,1936,17,na,1953,35.026331015927035
SIM,1907,56,na,1963,33
STAT,1839,42,25-29,1881,0.0037349921019932744
SIM,1889,10,na,1899,34
STAT,1872,50,45-49,1922,1.5062051262062189E-4
STAT,1868,28,na,1896,23.01417051343252
STAT,1819,41,45-49,1860,0.014452930388715042
STAT,1891,47,25-29,1938,3.969260274002879E-4
STAT,1854,26,15-19,1880,0.0032178359075505395
SIM,1882,27,30-34,1909,1
STAT,1855,50,45-49,1905,1.0364586100233146E-4
STAT,1870,25,45-49,1895,0.011104453041869957
STAT,1820,43,35-39,1863,0.015745929110219888
STAT,1875,21,50-100,1896,0.004204505126838801
STAT,1876,38,45-49,1914,0.02014633908045117
STAT,1908,53,na,1961,32.3491576882391
STAT,1840,87,na,1927,1.3805371740069596
STAT,1875,39,40-44,1914,0.04454531042799846
STAT,1877,64,na,1941,17.944396931284878
STAT,1838,43,20-24,1881,0.001295085374936801
STAT,1863,29,20-24,1892,0.10312761139894899
SIM,1836,27,na,1863,12
STAT,1860,17,50-100,1877,4.593567265387706E-4
STAT,1881,25,20-24,1906,0.11238718839925028
STAT,1849,25,na,1874,20.172415068685762
STAT,1858,61,na,1919,14.219283078151975
SIM,1862,11,na,1873,26
STAT,1808,48,40-44,1856,0.0012183276766786144
SIM,1866,25,na,1891,30
STAT,1873,50,na,1923,22.20568134060494
STAT,1874,18,40-44,1892,0.0018506743078829896
STAT,1845,11,na,1856,17.7177948642
STAT,1832,68,na,1900,6.907587730225256
SIM,1895,38,na,1933,26
STAT,1899,35,35-39,1934,0.0977431458612677
STAT,1829,28,30-34,1857,0.26593584492459477
STAT,1809,47,45-49,1856,0.008051450141134626
STAT,1860,36,40-44,1896,0.03575918970991141
STAT,1857,18,40-44,1875,0.0015998347719122972
SIM,1891,24,na,1915,37
SIM,1879,75,na,1954,5
STAT,1841,23,25-29,1864,0.7047281594004894
STAT,1864,28,25-29,1892,0.3780755964248427
SIM,1875,61,na,1936,13
STAT,1843,36,40-44,1879,0.021904032001624017
STAT,1819,38,15-19,1857,5.807936752830222E-4
STAT,1858,93,na,1951,0.22238908009721275
STAT,1850,46,25-29,1896,5.14306255917699E-4
STAT,1908,21,na,1929,35.00631881500714
STAT,1902,44,20-24,1946,1.5342042954109427E-4
STAT,1886,29,15-19,1915,0.004672468200527755
STAT,1848,32,25-29,1880,0.07724633457681586
STAT,1865,41,15-19,1906,1.2547334063129842E-4
STAT,1896,19,30-34,1915,0.02082377316370015
STAT,1844,40,40-44,1884,0.018460584128167735
STAT,1859,43,40-44,1902,0.017748480270372593
STAT,1874,27,30-34,1901,0.25546820927664987
STAT,1939,17,25-29,1956,0.43079791006149964
STAT,1812,91,na,1903,0.23029375269865893
STAT,1890,23,20-24,1913,0.8344954761607727
STAT,1948,16,50-100,1964,0.004260471383751036
STAT,1922,21,50-100,1943,0.007513055161540703
STAT,1818,44,50-100,1862,0.010695191837410047
STAT,1847,33,20-24,1880,0.03355279755564807
STAT,1856,39,30-34,1895,0.03822065397139606
STAT,1811,53,35-39,1864,3.2026126211888423E-4
SIM,1896,23,na,1919,32
STAT,1843,52,na,1895,9.084976257730682
SIM,1866,57,na,1923,27
STAT,1893,47,35-39,1940,9.910935996167848E-4
STAT,1898,27,40-44,1925,0.04041018292794155
STAT,1827,35,45-49,1862,0.016752541258459618
STAT,1849,41,30-34,1890,0.008954763124562816
STAT,1842,24,30-34,1866,0.16614984003221894
STAT,1833,46,25-29,1879,5.059714923179413E-4
STAT,1888,29,25-29,1917,0.49080047741028027
SIM,1834,79,na,1913,4
SIM,1893,47,na,1940,35
STAT,1824,40,15-19,1864,1.9352631675942952E-4
STAT,1865,24,25-29,1889,0.5165746808294561
STAT,1803,55,na,1858,12.009884850776716
STAT,1840,16,20-24,1856,0.1809282275032633
STAT,1855,38,25-29,1893,0.02017101136924862
STAT,1807,69,na,1876,8.464991783600372
SIM,1800,67,na,1867,9
STAT,1936,16,45-49,1952,0.004765338417481554
SIM,1929,26,20-24,1955,1
STAT,1910,49,25-29,1959,4.890080976044298E-4
STAT,1925,15,30-34,1940,0.146998624034886
STAT,1868,44,45-49,1912,0.014288162741325692
STAT,1911,15,50-100,1926,7.483501295615205E-4
STAT,1857,43,30-34,1900,0.008544337285684073
STAT,1894,26,45-49,1920,0.014278386833056864
STAT,1900,57,na,1957,28.30192871168037
STAT,1892,18,35-39,1910,0.006761034257666185
STAT,1824,49,na,1873,17.59992390069568
SIM,1931,38,na,1969,56
STAT,1860,28,40-44,1888,0.024437324021287222
STAT,1843,44,40-44,1887,0.009575307482321127
STAT,1927,23,40-44,1950,0.04108716664898428
STAT,1820,35,na,1855,16.624393538560447
STAT,1841,36,30-34,1877,0.06210416278071102
SIM,1858,81,na,1939,2
STAT,1826,47,45-49,1873,0.002375996540794994
STAT,1890,43,50-100,1933,0.012740050746707934
STAT,1853,30,40-44,1883,0.028656451335453012
STAT,1916,40,na,1956,37.83884996698737
STAT,1862,66,na,1928,14.140799825223992
STAT,1883,33,30-34,1916,0.16883258636084494
STAT,1850,30,15-19,1880,0.0014881699202649581
STAT,1847,19,35-39,1866,0.007229821239226546
STAT,1867,32,35-39,1899,0.0969120278793727
STAT,1823,32,20-24,1855,0.04099493591875038
STAT,1818,37,45-49,1855,0.02734943649530026
STAT,1875,34,35-39,1909,0.1032091158851485
STAT,1882,24,25-29,1906,0.5451753660098172
STAT,1861,103,na,1964,0.005373221146015111
STAT,1907,36,na,1943,34.90120070019036
STAT,1835,34,40-44,1869,0.024567665584693713
STAT,1903,22,na,1925,33.624680712239574
STAT,1851,38,50-100,1889,0.01036776397499405
STAT,1869,45,na,1914,22.016971759719446
STAT,1861,41,30-34,1902,0.009711944783749659
SIM,1881,26,25-29,1907,1
STAT,1885,28,45-49,1913,0.010925813035958057
STAT,1896,39,25-29,1935,0.037438657008463216
STAT,1840,44,15-19,1884,1.1002586174190441E-4
STAT,1856,27,na,1883,17.915124259083587
STAT,1852,13,na,1865,24.59848890717526
STAT,1833,26,30-34,1859,0.2474988587707696
STAT,1858,34,35-39,1892,0.07640160192214682
STAT,1873,35,15-19,1908,5.763413763245729E-4
STAT,1842,15,40-44,1857,0.0017831353675638352
STAT,1873,23,20-24,1896,0.6984633001583267
SIM,1828,51,na,1879,12
STAT,1885,41,40-44,1926,0.02231243573661357
STAT,1848,48,35-39,1896,8.940035393066938E-4
STAT,1899,11,na,1910,35.40559015290274
SIM,1902,57,na,1959,30
SIM,1910,44,na,1954,31
STAT,1835,45,45-49,1880,0.0012700047724217502
SIM,1907,24,na,1931,41
STAT,1818,50,40-44,1868,1.0361231914333301E-4
STAT,1832,25,25-29,1857,0.2567431294232434
STAT,1891,31,15-19,1922,0.0017550030963756117
STAT,1937,20,50-100,1957,0.006371546140608359
SIM,1903,10,na,1913,39
SIM,1915,2,na,1917,41
STAT,1897,48,30-34,1945,7.159959635547029E-4
STAT,1829,48,25-29,1877,4.853951983261862E-4
STAT,1882,19,50-100,1901,4.669927331375622E-4
STAT,1856,31,20-24,1887,0.020028500558335886
STAT,1895,27,15-19,1922,0.005890216958935012
STAT,1844,27,45-49,1871,0.010616631926669238
STAT,1852,37,45-49,1889,0.01715379535995625
STAT,1880,41,40-44,1921,0.0237593508936584
STAT,1836,18,20-24,1854,0.22853782263061664
STAT,1889,30,20-24,1919,0.03336042262862123
STAT,1857,44,na,1901,17.068580367370686
SIM,1944,24,na,1968,29
STAT,1771,92,na,1863,0.17043353523340452
STAT,1847,54,50-100,1901,1.5689660349943842E-4
STAT,1834,33,35-39,1867,0.09072434445618431
STAT,1947,16,20-24,1963,1.517197837311154
STAT,1879,44,20-24,1923,0.001621543481194341
SIM,1940,10,na,1950,37
SIM,1955,16,20-24,1971,1
STAT,1897,40,20-24,1937,1.4792868429907923E-4
STAT,1839,34,25-29,1873,0.0681301669113494
STAT,1883,25,30-34,1908,0.2461957782531348
STAT,1886,25,na,1911,24.922544946746903
STAT,1840,27,25-29,1867,0.413294981514771
STAT,1887,74,na,1961,13.9969455934258
SIM,1871,79,na,1950,10
STAT,1883,60,na,1943,18.520268283155158
STAT,1910,38,20-24,1948,0.0024933229222938334
STAT,1889,38,30-34,1927,0.06492806184381482
STAT,1828,36,15-19,1864,2.5246425885463167E-4
SIM,1819,47,na,1866,7
STAT,1880,48,50-100,1928,0.0025501637569315715
STAT,1854,79,na,1933,4.27317612791953
SIM,1822,35,na,1857,19
STAT,1827,43,45-49,1870,0.011544775193217513
STAT,1850,65,na,1915,15.046833085665128
STAT,1891,47,na,1938,27.490104728919007
SIM,1856,15,na,1871,17
SIM,1826,49,na,1875,15
STAT,1842,32,30-34,1874,0.15824711864260668
STAT,1870,30,40-44,1900,0.04342673331671692
SIM,1812,68,na,1880,14
STAT,1824,44,30-34,1868,0.015069470262844562
STAT,1906,15,20-24,1921,0.2587595851715432
STAT,1851,42,25-29,1893,0.00541461368606339
STAT,1884,45,40-44,1929,0.0016940576489654837
STAT,1832,36,na,1868,12.274085722357892
STAT,1891,9,na,1900,31.84558728141076
STAT,1868,36,45-49,1904,0.019384726802302934
STAT,1888,37,25-29,1925,0.03364624156821297
SIM,1881,46,na,1927,22
STAT,1829,37,20-24,1866,0.007083050009148824
STAT,1933,17,50-100,1950,0.0049948761643708725
STAT,1845,31,45-49,1876,0.012246614369202428
STAT,1866,45,25-29,1911,5.357740814434618E-4
STAT,1917,16,35-39,1933,0.008969661995185356
STAT,1817,54,40-44,1871,2.8125541923073796E-4
STAT,1929,15,na,1944,46.966741005675345
STAT,1831,51,na,1882,18.47816296417526
STAT,1852,21,35-39,1873,0.05975883954139489
STAT,1831,41,45-49,1872,0.015016301736520535
STAT,1894,12,na,1906,33.097227456450256
SIM,1957,8,na,1965,56
STAT,1860,39,45-49,1899,0.016043391629467347
STAT,1898,26,na,1924,32.30470122259455
SIM,1878,58,na,1936,25
STAT,1878,48,20-24,1926,1.2233342749906387E-4
STAT,1937,20,45-49,1957,0.010895343485296511
SIM,1874,44,na,1918,24
STAT,1849,16,40-44,1865,0.0017560523884078147
STAT,1886,17,50-100,1903,5.081762535958655E-4
SIM,1870,30,na,1900,24
STAT,1852,29,45-49,1881,0.009927734676992917
STAT,1858,47,40-44,1905,0.0012966638724138334
STAT,1833,37,35-39,1870,0.06546864800849664
STAT,1897,32,20-24,1929,0.03589541446738043
STAT,1816,42,30-34,1858,0.015842366628274512
STAT,1860,20,30-34,1880,0.16642233576604243
STAT,1857,26,40-44,1883,0.02326517631524262
SIM,1849,13,na,1862,17
STAT,1828,63,na,1891,11.983547212787169
STAT,1892,35,25-29,1927,0.03590763293522532
STAT,1811,45,35-39,1856,0.005720427284579248
SIM,1846,80,na,1926,2
STAT,1870,17,45-49,1887,6.550877910971571E-4
STAT,1921,47,35-39,1968,0.0014421093146609872
STAT,1837,67,na,1904,7.664913306517911
SIM,1806,72,na,1878,4
SIM,1932,23,na,1955,42
STAT,1825,44,25-29,1869,0.006017559888322118
STAT,1851,17,35-39,1868,0.005632116637318985
STAT,1854,34,15-19,1888,8.730678468665038E-4
STAT,1829,80,na,1909,4.201827752901956
STAT,1902,47,25-29,1949,4.560504274654576E-4
STAT,1826,39,45-49,1865,0.02189565842692993
STAT,1876,35,40-44,1911,0.0448821625738739
STAT,1896,28,20-24,1924,0.15355441485919435
STAT,1826,31,35-39,1857,0.15769868297033743
STAT,1922,25,na,1947,42.36499220761095
STAT,1903,48,30-34,1951,7.665582889824532E-4
STAT,1790,95,na,1885,0.016056919230167353
STAT,1834,22,30-34,1856,0.16834882289255293
STAT,1926,39,na,1965,45.618901598871844
STAT,1848,83,na,1931,2.5673139469762085
SIM,1920,22,na,1942,43
STAT,1914,49,45-49,1963,0.002125080819994854
SIM,1924,36,na,1960,50
STAT,1869,37,15-19,1906,5.441047974422132E-4
STAT,1871,21,45-49,1892,0.006973288163847822
SIM,1893,7,na,1900,39
STAT,1808,49,50-100,1857,0.0017229149656548986
STAT,1912,26,50-100,1938,0.009765431114296596
STAT,1848,37,30-34,1885,0.0355182688317376
STAT,1841,28,30-34,1869,0.3039471049624503
STAT,1880,52,45-49,1932,1.517933402773354E-4
STAT,1820,40,30-34,1860,0.010498517370918652
STAT,1846,24,15-19,1870,0.03251678121406657
STAT,1930,35,50-100,1965,0.005460272095786244
STAT,1841,20,20-24,1861,0.8668936877551073
STAT,1849,49,40-44,1898,0.0012997533447756246
STAT,1894,34,45-49,1928,0.02215734325552373
STAT,1889,49,35-39,1938,9.466874447874242E-4
STAT,1860,40,25-29,1900,0.0052732387808470055
STAT,1805,51,45-49,1856,2.863828113599872E-4
STAT,1819,102,na,1921,0.0015049538794320474
STAT,1872,42,45-49,1914,0.015294323338023438
STAT,1867,34,50-100,1901,0.008693039554525701
STAT,1876,58,na,1934,20.085384791029103
STAT,1886,24,45-49,1910,0.007187801413614694
SIM,1861,26,na,1887,25
STAT,1881,28,25-29,1909,0.4010995361902984
STAT,1833,29,50-100,1862,0.006152724162710178
STAT,1855,41,50-100,1896,0.007471814777660754
STAT,1834,49,45-49,1883,0.0017239727534882577
STAT,1908,37,50-100,1945,0.003910559828678767
SIM,1879,29,25-29,1908,1
STAT,1872,44,na,1916,23.32871410580037
SIM,1867,31,na,1898,15
STAT,1839,39,30-34,1878,0.034424842950456856
STAT,1820,34,45-49,1854,0.017007449508949238
SIM,1886,13,na,1899,30
STAT,1836,48,50-100,1884,0.002448940733968678
STAT,1917,41,25-29,1958,7.395092983063211E-4
STAT,1830,47,50-100,1877,2.437062875228958E-4
STAT,1827,32,40-44,1859,0.03822871638553741
STAT,1810,53,50-100,1863,1.3950201682028495E-4
STAT,1823,35,25-29,1858,0.021498966673823092
STAT,1865,45,30-34,1910,8.842725439445274E-4
SIM,1822,67,na,1889,10
STAT,1821,52,na,1873,14.937243418041234
STAT,1859,38,45-49,1897,0.01576597993832294
STAT,1867,41,25-29,1908,0.0061729950899965785
STAT,1868,39,na,1907,22.57038795792114
STAT,1825,66,na,1891,8.835959105697617
STAT,1938,26,20-24,1964,0.17973139431141766
STAT,1842,40,30-34,1882,0.009155866470836776
STAT,1851,46,40-44,1897,0.0014494268608703227
STAT,1863,37,20-24,1900,0.006825077644475555
STAT,1894,23,40-44,1917,0.026623403729648398
STAT,1857,76,na,1933,7.092339896036373
SIM,1847,39,30-34,1886,1
STAT,1853,62,na,1915,11.486946854881834
STAT,1881,17,20-24,1898,0.16869467701295085
STAT,1864,52,50-100,1916,1.3473889304484909E-4
STAT,1844,35,50-100,1879,0.01136975431705111
STAT,1887,28,50-100,1915,0.006957714262513243
STAT,1797,104,na,1901,1.4287800280400102E-4
STAT,1865,21,20-24,1886,0.6354440703009798
STAT,1953,16,45-49,1969,0.006009650568030784
STAT,1872,33,na,1905,24.31298803611802
STAT,1872,19,20-24,1891,0.18042027722205792
STAT,1914,38,na,1952,37.0671998958378
STAT,1898,34,50-100,1932,0.012254337675558703
STAT,1910,24,na,1934,35.39542490640996
STAT,1866,28,35-39,1894,0.08855204674425168
STAT,1874,31,15-19,1905,0.0014506176296167678
STAT,1872,35,20-24,1907,0.007962000841857685
STAT,1854,21,45-49,1875,0.005044239387365762
STAT,1844,26,na,1870,20.834616115242873
STAT,1857,22,25-29,1879,0.49473085077657675
STAT,1899,32,30-34,1931,0.2390119426317835
STAT,1834,41,35-39,1875,0.01562594927568253
SIM,1871,47,na,1918,23
STAT,1882,75,na,1957,10.536485050407652
STAT,1883,17,30-34,1900,0.015477770730456466
STAT,1819,59,na,1878,11.156070514507082
STAT,1846,48,25-29,1894,4.6094114689605937E-4
STAT,1846,16,15-19,1862,0.06077533642470261
STAT,1815,105,na,1920,1.0466562905853177E-4
STAT,1894,42,45-49,1936,0.00133031557452317
STAT,1842,41,20-24,1883,0.0012486737909443324
STAT,1886,37,15-19,1923,5.824723521121617E-4
SIM,1860,84,na,1944,4
STAT,1893,44,30-34,1937,9.930379288216877E-4
STAT,1833,43,20-24,1876,0.001406582710750788
STAT,1824,41,50-100,1865,0.014558834011956068
STAT,1827,51,45-49,1878,1.0787213908202607E-4
SIM,1843,29,na,1872,23
STAT,1889,37,40-44,1926,0.05359515464128566
STAT,1837,18,15-19,1855,0.054290522579260724
STAT,1856,47,30-34,1903,6.979822114236338E-4
STAT,1842,48,40-44,1890,0.0012683380549403868
STAT,1890,39,30-34,1929,0.06408697115531121
STAT,1833,30,15-19,1863,0.001385916328694117
STAT,1876,46,45-49,1922,0.0024037292848269696
STAT,1879,47,25-29,1926,5.93386399220626E-4
STAT,1847,7,na,1854,33.0
STAT,1873,45,50-100,1918,0.0025218910659835655
STAT,1815,45,na,1860,11.124226540523471
STAT,1921,39,35-39,1960,0.026739590859018992
STAT,1876,27,40-44,1903,0.030424317475187982
STAT,1901,30,50-100,1931,0.012923794835298846
STAT,1839,31,20-24,1870,0.01854869345147274
SIM,1899,63,na,1962,25
STAT,1843,47,45-49,1890,9.964296815140258E-4
SIM,1842,66,na,1908,18
STAT,1843,20,30-34,1863,0.09621819119380799
STAT,1885,45,35-39,1930,0.0013963038724224659
STAT,1924,43,50-100,1967,0.0013861014790015156
SIM,1851,48,na,1899,17
STAT,1863,83,na,1946,3.5149133762476263
STAT,1892,47,40-44,1939,0.0011874841814901109
STAT,1836,21,50-100,1857,0.0052314784795355704
STAT,1853,41,45-49,1894,0.009448662747904938
STAT,1874,38,35-39,1912,0.07139827987060733
STAT,1900,25,na,1925,33.31800499830873
STAT,1843,28,40-44,1871,0.01552593751304939
STAT,1928,36,50-100,1964,0.005284957103518735
STAT,1850,33,na,1883,21.996763539102385
STAT,1905,23,50-100,1928,0.005867213936699735
STAT,1938,31,50-100,1969,0.00826343015994116
SIM,1825,86,na,1911,2
STAT,1823,48,30-34,1871,6.638395949576052E-4
STAT,1824,81,na,1905,3.76270485366593
STAT,1867,97,na,1964,0.17081521662102953
STAT,1862,20,40-44,1882,0.01867141147137181
SIM,1889,42,na,1931,31
STAT,1807,47,35-39,1854,0.0029733666695232904
STAT,1942,0,na,1942,46.39905161140046
STAT,1920,27,25-29,1947,0.7158875066518106
STAT,1855,27,20-24,1882,0.08609423076465066
STAT,1876,51,40-44,1927,1.0743521371773481E-4
SIM,1814,48,na,1862,22
STAT,1949,20,15-19,1969,0.06176048659663259
STAT,1823,40,20-24,1863,0.0011435624041859127
STAT,1838,84,na,1922,2.5819541909341135
STAT,1834,70,na,1904,9.91546177713456
STAT,1859,5,na,1864,23.199638572829873
STAT,1861,19,45-49,1880,6.239790695011967E-4
STAT,1891,35,30-34,1926,0.06603454638027204
STAT,1942,15,30-34,1957,0.12651696861054504
STAT,1828,29,50-100,1857,0.009282103876352412
STAT,1878,40,50-100,1918,0.011017050237157723
STAT,1874,44,20-24,1918,0.0015893971364390458
STAT,1927,26,45-49,1953,0.020967247575168747
STAT,1894,18,45-49,1912,8.349745446320522E-4
STAT,1895,22,45-49,1917,0.009053013798349167
STAT,1852,43,30-34,1895,0.009768337265541617
STAT,1861,81,na,1942,4.547588960977139
STAT,1912,58,na,1970,33.2309722592085
SIM,1946,15,na,1961,50
STAT,1822,36,20-24,1858,0.004862020346088134
STAT,1861,1,na,1862,30.684222096933212
STAT,1857,46,35-39,1903,0.0010510268646278756
STAT,1865,95,na,1960,0.233776957539279
STAT,1890,26,25-29,1916,0.5155999364577928
SIM,1897,61,na,1958,37
STAT,1853,42,35-39,1895,0.011366613018806558
STAT,1945,4,na,1949,43.27762838651292
STAT,1887,17,15-19,1904,0.06477608100486383
SIM,1950,15,30-34,1965,3
STAT,1908,23,30-34,1931,0.26204309331050885
STAT,1888,1,na,1889,33.019768496361486
STAT,1962,2,na,1964,50.117738430969816
STAT,1828,31,45-49,1859,0.024361416334280045
STAT,1800,90,na,1890,0.28570401127967776
STAT,1841,105,na,1946,2.8699508130032743E-4
STAT,1887,46,20-24,1933,1.3135281290163565E-4
STAT,1877,31,40-44,1908,0.04494917873990283
STAT,1943,19,na,1962,38.72139304018843
STAT,1842,35,35-39,1877,0.06355748915385262
STAT,1873,50,50-100,1923,1.557550970461623E-4
STAT,1833,25,40-44,1858,0.029654648537135127
SIM,1907,25,30-34,1932,1
STAT,1898,23,25-29,1921,0.7698575626528892
STAT,1865,16,25-29,1881,0.05313011655378819
STAT,1929,15,15-19,1944,0.5790942047159866
STAT,1860,54,50-100,1914,1.1940482883760641E-4
STAT,1878,22,45-49,1900,0.0071992703162302345
STAT,1911,29,25-29,1940,0.6331936063159339
STAT,1845,36,15-19,1881,3.484900519609254E-4
STAT,1884,29,40-44,1913,0.029139332221696963
STAT,1842,19,35-39,1861,0.005224482919332699
STAT,1883,42,20-24,1925,0.0015403052085761117
STAT,1946,15,15-19,1961,0.5000800688567083
STAT,1869,19,50-100,1888,4.7562331394085925E-4
STAT,1909,48,50-100,1957,0.002060941857238553
SIM,1880,29,na,1909,32
STAT,1827,27,45-49,1854,0.032710715922323046
STAT,1886,57,na,1943,20.845225359555716
STAT,1838,19,50-100,1857,4.963668080334712E-4
STAT,1882,43,na,1925,21.989618565906333
STAT,1928,41,na,1969,47.182233255303515
STAT,1863,41,40-44,1904,0.02000514540040648
STAT,1867,48,45-49,1915,0.0022300497154148263
STAT,1832,46,30-34,1878,5.213250682456501E-4
STAT,1866,33,30-34,1899,0.16012219717163714
STAT,1928,41,50-100,1969,0.001492479881253748
SIM,1925,42,na,1967,43
STAT,1840,42,50-100,1882,0.008635436627177143
STAT,1918,32,50-100,1950,0.008706306925706161
STAT,1937,17,15-19,1954,0.4387184182690007
STAT,1887,20,45-49,1907,0.007656732398188816
STAT,1828,95,na,1923,0.08929402691426558
STAT,1906,20,50-100,1926,0.005959792210661266
STAT,1864,49,30-34,1913,8.500935521112481E-4
STAT,1868,33,40-44,1901,0.041791263703074295
SIM,1847,11,na,1858,25
SIM,1856,47,na,1903,10
STAT,1878,38,na,1916,24.202877163931362
STAT,1916,25,30-34,1941,0.4043964671179383
STAT,1897,19,25-29,1916,0.07484806719024462
STAT,1799,65,na,1864,9.02004740284384
STAT,1846,28,na,1874,21.056804666088134
STAT,1842,14,na,1856,22.7916340668
STAT,1817,38,40-44,1855,0.16322461948698042
STAT,1849,25,50-100,1874,0.005965107278832528
STAT,1884,21,30-34,1905,0.17504307079874507
STAT,1806,52,na,1858,15.924522688419792
SIM,1864,77,na,1941,9
SIM,1860,63,na,1923,16
STAT,1783,93,na,1876,0.03534916987586072
STAT,1884,51,50-100,1935,1.4867746035996122E-4
STAT,1873,18,25-29,1891,0.05746226344430833
SIM,1890,24,25-29,1914,1
STAT,1919,24,45-49,1943,0.012137524870154752
STAT,1850,34,30-34,1884,0.15927930401153836
SIM,1938,27,25-29,1965,3
STAT,1853,38,15-19,1891,3.5117038409058967E-4
STAT,1866,42,20-24,1908,0.001460837979375543
STAT,1862,36,15-19,1898,4.868135343552888E-4
STAT,1864,101,na,1965,0.023235100521081596
STAT,1831,34,20-24,1865,0.02790104760212335
STAT,1864,41,20-24,1905,0.001430875634134331
SIM,1876,9,na,1885,32
STAT,1893,38,45-49,1931,0.02501075083404115
STAT,1892,32,20-24,1924,0.03339379435324628
SIM,1929,35,na,1964,48
STAT,1822,43,45-49,1865,0.008428412235458588
STAT,1870,34,35-39,1904,0.09973981089089443
STAT,1846,52,45-49,1898,1.1698657028094341E-4
STAT,1847,66,na,1913,17.508512885577655
SIM,1925,21,na,1946,44
STAT,1909,48,25-29,1957,4.833479240207111E-4
STAT,1921,44,30-34,1965,0.0014239699261819022
STAT,1865,29,30-34,1894,0.22613920171287813
STAT,1871,26,15-19,1897,0.004538939111688621
STAT,1894,39,15-19,1933,7.124291269485758E-4
SIM,1864,66,na,1930,13
SIM,1860,52,na,1912,18
STAT,1834,50,50-100,1884,1.1385643371134788E-4
STAT,1826,29,na,1855,19.37518616714017
STAT,1819,81,na,1900,2.7759040513926916
STAT,1858,43,25-29,1901,0.004851161125941753
SIM,1865,22,25-29,1887,1
STAT,1873,27,15-19,1900,0.004612760250114262
STAT,1816,45,35-39,1861,0.0018188283870980875
STAT,1886,21,40-44,1907,0.021679903601029938
STAT,1894,43,35-39,1937,0.001599916991832332
STAT,1913,37,50-100,1950,0.004108725531513554
STAT,1912,15,45-49,1927,0.0010068836398249323
SIM,1899,30,30-34,1929,1
STAT,1902,39,25-29,1941,0.00867539499137208
STAT,1856,18,25-29,1874,0.048255013975149266
STAT,1869,32,45-49,1901,0.016896615177432545
SIM,1855,28,25-29,1883,1
STAT,1848,28,50-100,1876,0.004903204222963002
STAT,1864,36,25-29,1900,0.025948471508722832
STAT,1868,52,45-49,1920,1.3969555395247193E-4
STAT,1897,6,na,1903,34.69093973561758
STAT,1836,30,40-44,1866,0.05401289710557955
STAT,1883,36,35-39,1919,0.06901440833818961
STAT,1883,49,40-44,1932,0.0016277799107710853
STAT,1877,43,35-39,1920,0.01855729628368924
STAT,1893,27,na,1920,30.091131197327403
STAT,1843,63,na,1906,7.568904047000172
STAT,1815,46,30-34,1861,0.001415217919865639
STAT,1814,71,na,1885,6.7814239122314905
STAT,1879,12,na,1891,26.729227679236683
STAT,1917,35,50-100,1952,0.004362298682238349
SIM,1879,43,na,1922,15
STAT,1847,28,25-29,1875,0.5392362955051428
STAT,1825,41,20-24,1866,0.0015730045719908985
STAT,1902,30,25-29,1932,0.14560086668665123
SIM,1843,26,40-44,1869,1
STAT,1843,84,na,1927,1.4111359012180467
STAT,1847,98,na,1945,0.03470211907939948
STAT,1834,48,na,1882,16.646933234657954
STAT,1893,31,25-29,1924,0.1296744539754632
STAT,1835,26,40-44,1861,0.018208855640370007
STAT,1861,35,45-49,1896,0.016923549444009617
STAT,1883,41,30-34,1924,0.011214730532117512
STAT,1830,34,na,1864,9.81156789552955
STAT,1847,77,na,1924,9.23375677730941
STAT,1846,29,20-24,1875,0.11337150376754762
STAT,1826,40,25-29,1866,0.0070526195240320074
STAT,1811,74,na,1885,6.363905858062673
STAT,1924,16,na,1940,43.65358826836665
STAT,1882,37,30-34,1919,0.051075677194188
STAT,1884,48,45-49,1932,0.0022831615433313523
SIM,1911,18,na,1929,42
SIM,1836,59,na,1895,4
STAT,1876,22,35-39,1898,0.05926780537179074
STAT,1928,30,45-49,1958,0.0196018072000391
STAT,1799,103,na,1902,5.301980520281725E-4
SIM,1870,62,na,1932,17
STAT,1861,16,40-44,1877,0.001778381089378198
STAT,1844,51,45-49,1895,1.1389811257709259E-4
STAT,1865,48,35-39,1913,0.0012503714006204996
STAT,1930,29,35-39,1959,0.1898229890085019
SIM,1874,76,na,1950,17
STAT,1844,32,40-44,1876,0.040507499460219004
STAT,1882,33,15-19,1915,0.0013589958185260482
STAT,1835,33,na,1868,12.279035915826455
SIM,1884,22,35-39,1906,3
STAT,1794,66,na,1860,8.794933034181675
STAT,1900,46,50-100,1946,0.0019265476641292087
STAT,1932,35,na,1967,50.43157359902395
STAT,1788,92,na,1880,0.135732557682934
STAT,1891,79,na,1970,13.063676089292079
STAT,1852,49,50-100,1901,0.002058075814522246
STAT,1880,37,20-24,1917,0.008105885330294244
STAT,1864,17,20-24,1881,0.16449361688375183
STAT,1854,47,na,1901,13.687703060129374
STAT,1855,0,na,1855,28.178942567974488
STAT,1934,28,50-100,1962,0.013326764493561313
STAT,1850,43,20-24,1893,0.0014038009628775253
STAT,1874,26,40-44,1900,0.03049402797107923
STAT,1925,40,50-100,1965,0.0014173407577326021
SIM,1885,39,na,1924,24
STAT,1828,28,15-19,1856,0.006837909032178093
STAT,1869,13,na,1882,25.653592031516787
STAT,1874,22,25-29,1896,0.580751811473859
STAT,1895,19,15-19,1914,0.07663243605625622
STAT,1866,36,35-39,1902,0.06545382581531264
SIM,1923,16,25-29,1939,1
STAT,1813,46,20-24,1859,3.775187324367344E-4
STAT,1896,43,45-49,1939,0.0013552932927250337
STAT,1923,39,45-49,1962,0.007827571101376905
STAT,1915,16,25-29,1931,0.09013580921211171
STAT,1839,100,na,1939,0.00585875367505771
STAT,1873,61,na,1934,18.99827999913785
STAT,1822,40,40-44,1862,0.01324890979800889
STAT,1872,38,25-29,1910,0.029312970562753844
STAT,1829,52,45-49,1881,1.0896517101866586E-4
SIM,1845,63,na,1908,20
STAT,1877,75,na,1952,10.626736117070548
SIM,1885,28,na,1913,22
STAT,1834,46,40-44,1880,0.0014281462725012062
SIM,1817,67,na,1884,4
STAT,1839,47,na,1886,12.650181317292846
SIM,1813,53,na,1866,9
STAT,1851,22,30-34,1873,0.17957922973522897
STAT,1902,69,na,1971,24.5345674174402
SIM,1906,39,na,1945,25
SIM,1938,24,20-24,1962,2
STAT,1941,31,15-19,1972,0.001340189281685102
SIM,1902,25,na,1927,31
STAT,1873,39,na,1912,23.71196930771566
STAT,1854,18,15-19,1872,0.04313683986649971
SIM,1885,3,na,1888,29
STAT,1833,85,na,1918,2.029535704004368
STAT,1856,38,40-44,1894,0.0315547982286999
STAT,1867,65,na,1932,16.17227479141534
STAT,1886,40,45-49,1926,0.015680788606412335
STAT,1898,47,35-39,1945,0.0010603617500934005
STAT,1818,42,40-44,1860,0.02418447836684091
STAT,1939,30,20-24,1969,0.02474438211954497
STAT,1860,32,na,1892,19.400057595303903
SIM,1927,0,na,1927,53
STAT,1837,99,na,1936,0.009157307139520274
STAT,1942,18,35-39,1960,0.04351800986199729
STAT,1863,51,na,1914,19.15530978860704
STAT,1823,44,50-100,1867,0.007360208389872179
STAT,1895,33,50-100,1928,0.011845008057055824
SIM,1851,70,na,1921,14
STAT,1912,3,na,1915,40.56074345053846
STAT,1891,38,35-39,1929,0.08637989756260715
STAT,1875,47,40-44,1922,0.00175163253786766
STAT,1885,33,40-44,1918,0.04264499310780303
STAT,1841,29,na,1870,25.92333417140113
SIM,1956,15,25-29,1971,1
STAT,1852,30,25-29,1882,0.09266726658530737
STAT,1875,43,25-29,1918,0.00655331875547644
STAT,1903,27,25-29,1930,0.6014133352822428
STAT,1839,58,na,1897,10.913493763296218
STAT,1842,44,25-29,1886,0.004858608709247538
STAT,1918,20,na,1938,39.26201029478434
STAT,1905,48,40-44,1953,0.0013762408755251892
SIM,1862,18,15-19,1880,1
STAT,1840,31,45-49,1871,0.01681690899954315
SIM,1841,25,40-44,1866,1
STAT,1888,27,na,1915,27.88886362459845
STAT,1824,47,35-39,1871,0.0018115932213837247
STAT,1891,44,20-24,1935,0.0019229029338061843
STAT,1897,39,40-44,1936,0.012420845874915492
STAT,1849,28,35-39,1877,0.08805169342479163
STAT,1778,105,na,1883,2.357685104397748E-4
STAT,1838,101,na,1939,0.004428875839128039
STAT,1849,19,45-49,1868,6.161446170669655E-4
STAT,1845,32,50-100,1877,0.006368191691635532
STAT,1878,35,15-19,1913,5.852555041871252E-4
STAT,1885,42,30-34,1927,0.011339166470164733
STAT,1948,15,25-29,1963,0.4929178523101533
SIM,1868,80,na,1948,8
STAT,1862,23,45-49,1885,0.006114541922899675
SIM,1915,43,na,1958,33
STAT,1816,104,na,1920,2.0024541807066296E-4
STAT,1863,44,45-49,1907,0.013072349862505151
STAT,1904,39,35-39,1943,0.021654748604569868
SIM,1878,1,na,1879,36
SIM,1935,4,na,1939,61
STAT,1954,17,15-19,1971,0.5578424498067661
STAT,1832,26,15-19,1858,0.0027339187469958325
STAT,1873,30,45-49,1903,0.017871822302983006
STAT,1869,41,35-39,1910,0.017625114654147934
STAT,1892,23,30-34,1915,0.21937433961808467
STAT,1832,49,35-39,1881,6.602535596918416E-4
STAT,1810,89,na,1899,0.3776109117056364
STAT,1916,28,35-39,1944,0.1533663521307096
STAT,1889,42,15-19,1931,1.688699588219003E-4
SIM,1838,29,na,1867,12
STAT,1842,16,30-34,1858,0.01544722720065466
STAT,1867,45,40-44,1912,0.0016546497942758647
STAT,1881,32,45-49,1913,0.01659322561891538
STAT,1848,16,25-29,1864,0.04569819791152641
STAT,1825,32,30-34,1857,0.2094148048072292
STAT,1931,38,40-44,1969,0.019717900683829233
STAT,1892,42,35-39,1934,0.022343389584342396
STAT,1841,29,50-100,1870,0.007665689449226064
STAT,1883,28,na,1911,23.093508506272183
SIM,1857,32,na,1889,21
STAT,1884,30,20-24,1914,0.026696147022996438
STAT,1897,16,20-24,1913,0.23600520230867245
STAT,1892,64,na,1956,21.72865087463323
SIM,1833,30,na,1863,13
SIM,1837,44,na,1881,29
STAT,1887,49,25-29,1936,3.472392309149448E-4
STAT,1868,28,45-49,1896,0.01070708424320656
STAT,1866,23,50-100,1889,0.0037591539921999957
STAT,1874,35,30-34,1909,0.054581600078537566
STAT,1908,26,35-39,1934,0.14287758263440595
STAT,1841,32,15-19,1873,0.001691225813586809
STAT,1916,20,25-29,1936,0.9653582222158553
SIM,1792,74,na,1866,2
STAT,1827,42,50-100,1869,0.008263007424317563
STAT,1814,41,45-49,1855,0.04962963322708632
SIM,1950,20,na,1970,55
STAT,1841,27,40-44,1868,0.03641812578978122
STAT,1839,49,50-100,1888,0.0013460004638768206
STAT,1832,41,25-29,1873,0.0035774879820823185
STAT,1877,34,45-49,1911,0.017846681755932417
STAT,1904,39,na,1943,33.682511308337894
SIM,1796,88,na,1884,2
STAT,1838,27,20-24,1865,0.11582402746945752
STAT,1818,85,na,1903,0.6850697481498821
STAT,1834,42,25-29,1876,0.005470786966526583
SIM,1867,10,na,1877,18
STAT,1858,31,30-34,1889,0.134245548182266
STAT,1842,104,na,1946,5.004363667933245E-4
STAT,1923,15,20-24,1938,1.588298362274883
STAT,1850,18,30-34,1868,0.01723934491500384
STAT,1840,40,20-24,1880,0.0014635494570049569
STAT,1909,30,35-39,1939,0.08741260920990546
SIM,1931,15,20-24,1946,1
STAT,1863,24,15-19,1887,0.029365321942724985
STAT,1853,17,45-49,1870,4.938525053037404E-4
STAT,1898,20,20-24,1918,0.9351768416291789
SIM,1865,51,na,1916,19
SIM,1882,35,30-34,1917,1
STAT,1888,38,15-19,1926,6.529662473764786E-4
STAT,1858,39,40-44,1897,0.03297512090507236
STAT,1877,40,30-34,1917,0.01198732559634037
STAT,1774,89,na,1863,0.1489312599173911
STAT,1854,9,na,1863,17.81396769302847
SIM,1832,28,30-34,1860,1
SIM,1930,27,35-39,1957,1
STAT,1789,66,na,1855,4.817
STAT,1840,48,30-34,1888,7.551659491923469E-4
STAT,1865,26,50-100,1891,0.005805792496780934
STAT,1898,28,30-34,1926,0.3385082870805723
STAT,1870,22,40-44,1892,0.020700319080907133
SIM,1831,71,na,1902,4
STAT,1882,28,40-44,1910,0.028606748864726094
SIM,1872,10,na,1882,27
STAT,1870,31,30-34,1901,0.1741516363535147
STAT,1836,33,45-49,1869,0.02105279963568461
STAT,1848,62,na,1910,11.819932903070777
STAT,1859,46,45-49,1905,0.001881093509366897
STAT,1899,31,50-100,1930,0.012594051268933605
STAT,1847,37,15-19,1884,6.223853903560795E-4
STAT,1893,35,40-44,1928,0.0557191349031414
SIM,1935,20,na,1955,57
STAT,1837,34,15-19,1871,8.5288654087613E-4
STAT,1879,19,30-34,1898,0.016408239668041794
STAT,1909,21,50-100,1930,0.006099531365701119
STAT,1938,19,na,1957,36.04503870026431
STAT,1831,37,25-29,1868,0.029442092690486397
STAT,1891,19,30-34,1910,0.019457666453096583
STAT,1861,40,40-44,1901,0.019106272663663507
STAT,1889,17,25-29,1906,0.06937955278726621
STAT,1870,39,50-100,1909,0.012073506541009232
STAT,1835,29,45-49,1864,0.0065163892919780295
STAT,1903,54,na,1957,30.16309339964111
STAT,1857,27,30-34,1884,0.19417207322193292
STAT,1934,16,35-39,1950,0.05665540702636251
STAT,1815,42,15-19,1857,2.135109082054841E-4
STAT,1937,34,na,1971,37.133743841906515
SIM,1921,39,na,1960,41
STAT,1826,44,40-44,1870,0.022975809299588555
STAT,1793,92,na,1885,0.06258132263991406
STAT,1911,26,20-24,1937,0.17747462607188094
STAT,1869,29,15-19,1898,0.00436469191127167
STAT,1848,36,40-44,1884,0.029477796283268704
SIM,1901,62,na,1963,30
STAT,1880,20,35-39,1900,0.06172929888137897
STAT,1861,28,50-100,1889,0.005379706252006772
STAT,1850,37,35-39,1887,0.0639720513743563
STAT,1883,45,25-29,1928,5.649193270702163E-4
STAT,1877,43,50-100,1920,0.010826563669423825
STAT,1912,38,30-34,1950,0.01756188189754436
STAT,1933,20,na,1953,48.5297898554781
STAT,1935,20,35-39,1955,0.1277409651159006
STAT,1818,96,na,1914,0.02145830170608461
SIM,1834,44,40-44,1878,1
STAT,1865,100,na,1965,0.04129755051389199
STAT,1878,52,40-44,1930,1.081106923715458E-4
STAT,1821,48,20-24,1869,1.670644601563001E-4
STAT,1844,103,na,1947,0.0011209887292158774
STAT,1851,41,35-39,1892,0.015356621773887054
STAT,1801,53,na,1854,10.998343662241226
STAT,1874,24,na,1898,23.843013211464218
STAT,1902,17,50-100,1919,6.90876932569855E-4
STAT,1835,21,35-39,1856,0.051508985172468505
STAT,1805,67,na,1872,6.238370470805612
STAT,1857,39,50-100,1896,0.009098477858970394
STAT,1939,18,50-100,1957,0.0037232850243018867
STAT,1860,32,25-29,1892,0.08326957785670408
STAT,1856,15,20-24,1871,0.15366659841451943
STAT,1830,25,15-19,1855,0.005218123811915904
STAT,1894,36,50-100,1930,0.015810383404533522
SIM,1843,21,35-39,1864,1
STAT,1838,46,25-29,1884,4.65864249756171E-4
STAT,1876,79,na,1955,7.100432779041142
SIM,1943,20,35-39,1963,2
STAT,1872,65,na,1937,17.29119291225832
SIM,1837,33,na,1870,29
STAT,1820,38,50-100,1858,0.011374932012883475
STAT,1879,28,20-24,1907,0.12099428961739034
STAT,1871,34,15-19,1905,0.0014076492124868978
STAT,1867,16,35-39,1883,0.005399830878442914
STAT,1855,32,na,1887,17.10718540686822
SIM,1884,43,na,1927,22
STAT,1847,48,40-44,1895,0.001805842542345662
STAT,1950,21,na,1971,43.06791040269047
SIM,1831,50,na,1881,8
STAT,1932,34,40-44,1966,0.05174467302948279
STAT,1847,13,na,1860,31.683700210001472
STAT,1862,49,20-24,1911,1.013700954663597E-4
SIM,1848,27,30-34,1875,1
SIM,1892,62,na,1954,28
STAT,1771,100,na,1871,0.0033619259915069694
STAT,1844,16,40-44,1860,0.001826814954000678
STAT,1882,48,35-39,1930,0.0013248230221373726
STAT,1810,48,45-49,1858,0.002271709234768669
STAT,1921,48,25-29,1969,5.91675525773204E-4
SIM,1846,16,na,1862,16
STAT,1915,37,45-49,1952,0.006827274327050202
SIM,1871,15,na,1886,27
SIM,1945,19,na,1964,35
STAT,1875,27,25-29,1902,0.43483414232472756
SIM,1939,9,na,1948,30
STAT,1900,30,15-19,1930,0.001990614816754798
SIM,1806,51,na,1857,10
SIM,1892,6,na,1898,36
STAT,1810,68,na,1878,6.181112800106608
SIM,1859,44,na,1903,18
SIM,1867,63,na,1930,7
STAT,1891,26,40-44,1917,0.03689263967124611
STAT,1850,45,35-39,1895,0.0012589380427740183
STAT,1868,82,na,1950,4.515329554485899
STAT,1925,22,na,1947,43.43818121575061
SIM,1829,46,na,1875,20
STAT,1952,20,35-39,1972,0.11261866488387715
STAT,1824,35,40-44,1859,0.06656534074827176
SIM,1905,54,na,1959,40
STAT,1924,19,50-100,1943,0.004408738684210444
STAT,1858,18,35-39,1876,0.004848662675061062
SIM,1883,27,25-29,1910,1
STAT,1929,19,30-34,1948,0.15398048798217095
STAT,1930,26,30-34,1956,0.4961165867232841
STAT,1809,71,na,1880,8.67647825016615
STAT,1909,45,20-24,1954,1.019490169035912E-4
SIM,1846,26,na,1872,14
SIM,1880,8,na,1888,35
STAT,1906,44,40-44,1950,0.002238585776401248
STAT,1855,42,na,1897,16.252707146507777
STAT,1867,29,40-44,1896,0.02846148128159087
SIM,1884,33,na,1917,26
STAT,1869,0,na,1869,36.3253414132271
STAT,1855,10,na,1865,20.24169895625425
STAT,1919,40,45-49,1959,0.00179289413607561
STAT,1864,44,25-29,1908,0.005681908872518232
SIM,1889,28,30-34,1917,1
STAT,1856,52,50-100,1908,1.0882691175677E-4
STAT,1927,35,na,1962,46.617223474759626
SIM,1914,37,na,1951,37
STAT,1862,25,50-100,1887,0.005619795998973181
SIM,1869,76,na,1945,4
STAT,1823,86,na,1909,1.2759835161309958
STAT,1896,40,40-44,1936,0.0020723708123209414
STAT,1831,45,25-29,1876,5.657753527905428E-4
SIM,1852,2,na,1854,32
STAT,1904,36,30-34,1940,0.01656248543486944
SIM,1855,62,na,1917,11
STAT,1881,49,30-34,1930,9.018623066246132E-4
SIM,1857,43,na,1900,22
STAT,1868,60,na,1928,18.45664170549425
STAT,1917,25,na,1942,39.1935607772926
SIM,1864,0,na,1864,30
STAT,1918,41,40-44,1959,0.002639101181369594
STAT,1917,35,na,1952,39.089324821613914
SIM,1859,66,na,1925,10
SIM,1906,18,na,1924,29
STAT,1900,43,35-39,1943,0.0017311096421789595
STAT,1899,19,35-39,1918,0.007471181533172041
SIM,1888,16,20-24,1904,1
STAT,1909,5,na,1914,39.080254549193015
SIM,1854,45,na,1899,17
STAT,1938,1,na,1939,40.92308909858583
SIM,1856,26,na,1882,17
SIM,1905,28,25-29,1933,2
STAT,1806,51,50-100,1857,4.990652492313536E-4
STAT,1948,19,40-44,1967,0.01589065798990694
SIM,1821,40,na,1861,15
STAT,1891,40,50-100,1931,0.013097344750219802
STAT,1847,17,20-24,1864,0.23636830365931985
STAT,1840,23,50-100,1863,0.004034433913757981
SIM,1865,19,30-34,1884,1
STAT,1871,48,na,1919,22.149075249364458
STAT,1840,43,25-29,1883,0.005182171269561027
STAT,1903,30,40-44,1933,0.06215214132166444
SIM,1895,27,na,1922,27
STAT,1942,28,50-100,1970,0.010365679044119638
SIM,1839,46,na,1885,21
STAT,1907,18,40-44,1925,0.0026684077391034076
STAT,1954,9,na,1963,48.302346463865376
STAT,1823,43,25-29,1866,0.004513117601490577
STAT,1929,31,15-19,1960,0.0016254325438878159
SIM,1880,61,na,1941,29
STAT,1834,104,na,1938,4.7136616489113343E-4
SIM,1831,43,25-29,1874,1
STAT,1820,42,45-49,1862,0.013226183635418784
STAT,1845,32,na,1877,15.063079817620226
SIM,1894,43,na,1937,29
SIM,1804,70,na,1874,8
STAT,1877,43,na,1920,23.6856829221347
STAT,1834,26,25-29,1860,0.39482534858875523
STAT,1913,34,30-34,1947,0.15411025198964626
STAT,1880,45,20-24,1925,1.2744440018025625E-4
STAT,1922,44,25-29,1966,8.109249509107037E-4
STAT,1857,19,30-34,1876,0.01385930179770945
SIM,1871,25,na,1896,21
STAT,1885,17,40-44,1902,0.0018061947861024502
SIM,1854,13,na,1867,19
SIM,1862,32,na,1894,22
STAT,1884,13,na,1897,25.262965099332266
STAT,1831,83,na,1914,3.2215244899167947
STAT,1910,41,50-100,1951,0.0011098576436642973
STAT,1892,10,na,1902,32.00108546540005
SIM,1872,32,na,1904,22
STAT,1835,38,20-24,1873,0.0042766943993929754
STAT,1895,39,30-34,1934,0.06849514049193008
STAT,1903,24,20-24,1927,0.9736183732070396
SIM,1911,24,20-24,1935,1
STAT,1850,28,45-49,1878,0.011550022129111858
STAT,1881,36,25-29,1917,0.02752867412077173
STAT,1890,34,25-29,1924,0.12335200098469128
STAT,1802,53,50-100,1855,2.266688793261302E-4
STAT,1851,49,45-49,1900,0.0019507854738333693
STAT,1814,45,25-29,1859,0.0017010019388586555
STAT,1830,33,15-19,1863,9.060487502436443E-4
STAT,1828,48,30-34,1876,4.0946912736343613E-4
SIM,1884,65,na,1949,17
SIM,1934,35,na,1969,51
STAT,1839,18,25-29,1857,0.040667616549393625
SIM,1875,82,na,1957,1
STAT,1923,36,40-44,1959,0.017240943974372622
SIM,1912,18,15-19,1930,1
STAT,1935,25,50-100,1960,0.013519536679036184
SIM,1922,24,na,1946,50
STAT,1854,38,30-34,1892,0.032414667694366885
STAT,1871,47,20-24,1918,1.1908227928564269E-4
STAT,1888,80,na,1968,11.214336572978253
SIM,1875,50,na,1925,14
STAT,1775,107,na,1882,1.230425223942155E-4
STAT,1894,22,50-100,1916,0.005226208802538792
STAT,1890,47,30-34,1937,6.601752122747817E-4
STAT,1865,36,40-44,1901,0.039784526741180465
STAT,1872,12,na,1884,26.929501346923935
STAT,1858,82,na,1940,3.5504342080691345
SIM,1839,24,na,1863,24
STAT,1885,30,na,1915,23.754595236453902
STAT,1891,46,35-39,1937,9.720214915343742E-4
SIM,1816,71,na,1887,2
STAT,1880,34,50-100,1914,0.009552319083881001
STAT,1800,68,na,1868,6.5894076014433365
STAT,1913,46,25-29,1959,5.146929452479653E-4
STAT,1875,18,35-39,1893,0.005625634775468605
STAT,1784,88,na,1872,0.6419188220396415
SIM,1880,83,na,1963,7
STAT,1905,24,na,1929,33.9196787785379
STAT,1923,18,25-29,1941,0.5040101253687987
STAT,1855,46,25-29,1901,4.0669562642171495E-4
STAT,1935,22,na,1957,49.50790888684015
SIM,1931,18,25-29,1949,1
STAT,1856,28,50-100,1884,0.004767556598584328
STAT,1924,35,45-49,1959,0.008000236010064462
STAT,1908,42,na,1950,34.18254798419489
SIM,1864,45,na,1909,22
SIM,1847,18,25-29,1865,1
SIM,1872,64,na,1936,16
STAT,1860,44,40-44,1904,0.018039172074383693
STAT,1898,20,50-100,1918,0.00553391881615954
STAT,1885,62,na,1947,18.049115660525647
STAT,1904,18,15-19,1922,0.08481283188812434
STAT,1922,24,30-34,1946,0.3251342026983647
STAT,1872,46,25-29,1918,5.910192953177913E-4
STAT,1838,19,20-24,1857,0.17961863838168907
STAT,1907,35,45-49,1942,0.006353651264430422
STAT,1928,19,na,1947,45.904344149778396
STAT,1900,26,45-49,1926,0.015449209707534734
STAT,1861,43,45-49,1904,0.012495159184874967
STAT,1809,48,20-24,1857,4.030740052343974E-4
STAT,1843,103,na,1946,6.087815025163341E-4
SIM,1930,24,30-34,1954,1
SIM,1866,14,na,1880,35
STAT,1839,49,45-49,1888,0.0012933880700188405
STAT,1874,19,30-34,1893,0.01608295395395913
STAT,1842,43,35-39,1885,0.013877413561452095
STAT,1891,29,45-49,1920,0.01353006056554975
SIM,1802,69,na,1871,9
STAT,1840,35,25-29,1875,0.027244264129816776
STAT,1873,29,na,1902,24.09018917712248
SIM,1895,59,na,1954,20
STAT,1900,31,40-44,1931,0.06038222222361555
STAT,1921,45,20-24,1966,1.2419115017423368E-4
STAT,1953,18,na,1971,44.254234338127176
STAT,1932,37,45-49,1969,0.009122503815897598
STAT,1813,86,na,1899,1.4642841564085982
STAT,1821,43,15-19,1864,2.0818512516865975E-4
SIM,1809,48,na,1857,3
STAT,1907,30,25-29,1937,0.08672037439061202
STAT,1872,97,na,1969,0.2948570302213356
STAT,1917,47,20-24,1964,1.1438057453972469E-4
STAT,1913,53,na,1966,34.8016119850589
STAT,1875,62,na,1937,18.788019079350068
STAT,1824,38,45-49,1862,0.028410112188253914
STAT,1873,38,40-44,1911,0.04428499962698851
STAT,1856,59,na,1915,14.079102406393083
STAT,1914,20,15-19,1934,0.052063545179090676
SIM,1934,25,na,1959,45
SIM,1793,69,na,1862,16
STAT,1829,29,20-24,1858,0.11765769578932399
STAT,1852,18,40-44,1870,0.0018821074810068117
SIM,1821,72,na,1893,3
SIM,1942,6,na,1948,43
STAT,1891,43,30-34,1934,0.014008679772603358
STAT,1845,40,35-39,1885,0.011058758054334329
STAT,1851,28,na,1879,21.2298999514787
STAT,1831,73,na,1904,9.63853809845297
STAT,1899,16,30-34,1915,0.021872602672494162
STAT,1844,19,45-49,1863,6.409730186384139E-4
SIM,1904,59,na,1963,24
SIM,1847,43,na,1890,17
STAT,1803,66,na,1869,8.697071876222239
STAT,1878,19,15-19,1897,0.06094076894711238
STAT,1880,28,30-34,1908,0.26386894635529096
STAT,1947,6,na,1953,44.18547233662818
STAT,1910,45,45-49,1955,0.0020248734345052906
STAT,1829,26,na,1855,19.383792441315965
STAT,1838,50,45-49,1888,1.1656483372373293E-4
SIM,1864,13,na,1877,23
STAT,1849,37,25-29,1886,0.022844424462646888
SIM,1885,60,na,1945,17
STAT,1856,27,15-19,1883,0.003405848827595061
SIM,1800,56,na,1856,12
SIM,1873,5,na,1878,31
STAT,1831,42,20-24,1873,0.0015730606771320074
STAT,1853,46,50-100,1899,0.0015479322841440973
STAT,1873,47,30-34,1920,9.795702621361291E-4
SIM,1909,36,na,1945,34
STAT,1923,40,25-29,1963,8.311483084563244E-4
SIM,1849,5,na,1854,21
STAT,1844,21,50-100,1865,0.004005729275479904
STAT,1881,45,50-100,1926,0.002360289471054077
SIM,1905,7,na,1912,40
STAT,1808,97,na,1905,0.007844702561141677
STAT,1923,44,40-44,1967,0.002893535133776634
STAT,1876,54,45-49,1930,1.4334145907913846E-4
STAT,1878,60,na,1938,19.690057708660298
STAT,1906,47,45-49,1953,0.0019250249137020448
STAT,1796,89,na,1885,0.07642603027577966
STAT,1900,40,30-34,1940,0.0011182326674388807
STAT,1921,36,30-34,1957,0.020210155548610435
STAT,1848,29,30-34,1877,0.19163190057950522
STAT,1882,17,15-19,1899,0.056873398230004445
STAT,1831,44,50-100,1875,0.010198557679459357
SIM,1888,19,25-29,1907,1
SIM,1941,20,25-29,1961,2
STAT,1864,25,na,1889,21.634062872944998
STAT,1858,15,30-34,1873,0.014336039588501263
STAT,1875,84,na,1959,4.572317600569193
STAT,1769,99,na,1868,0.016769492769886395
STAT,1826,28,40-44,1854,0.1022023677396069
SIM,1964,0,na,1964,52
STAT,1892,32,na,1924,29.480669146884605
STAT,1891,58,na,1949,24.27231554370846
SIM,1904,37,na,1941,29
STAT,1888,37,na,1925,27.531902843357642
STAT,1854,15,na,1869,16.983356634606274
STAT,1869,49,30-34,1918,9.183519038454329E-4
STAT,1933,20,25-29,1953,1.2275237838994724
STAT,1920,24,20-24,1944,1.2179818783143757
STAT,1877,18,45-49,1895,6.725321172536311E-4
STAT,1934,32,35-39,1966,0.1242411561282467
STAT,1881,58,na,1939,18.81769903783971
STAT,1903,9,na,1912,36.88875955970475
SIM,1919,36,na,1955,44
STAT,1846,101,na,1947,0.004624493997153485
STAT,1893,19,40-44,1912,0.0022938156632444978
STAT,1915,34,40-44,1949,0.03917325097462527
STAT,1875,42,35-39,1917,0.01859120138387054
STAT,1860,16,25-29,1876,0.05344707536715673
STAT,1938,29,25-29,1967,0.6471450330524697
STAT,1869,16,45-49,1885,6.455034142097997E-4
STAT,1890,31,20-24,1921,0.032968313903118836
STAT,1863,48,25-29,1911,5.035809906444677E-4
STAT,1886,41,35-39,1927,0.018867949772007654
STAT,1919,29,15-19,1948,0.007507581947237423
STAT,1781,81,na,1862,2.9178332881410474
SIM,1840,64,na,1904,6
STAT,1847,101,na,1948,0.006095612369251837
STAT,1829,48,na,1877,16.469298675867442
SIM,1846,48,na,1894,14
STAT,1863,61,na,1924,16.54485473992158
SIM,1876,14,na,1890,31
STAT,1864,46,na,1910,20.236629621913853
STAT,1923,31,20-24,1954,0.027882403900722042
STAT,1859,14,na,1873,21.825497515142747
STAT,1880,31,na,1911,25.195874921179904
STAT,1817,90,na,1907,0.6248416284303853
STAT,1802,54,45-49,1856,2.1351178385764068E-4
SIM,1877,0,na,1877,37
STAT,1898,37,na,1935,31.78215238644432
STAT,1809,46,50-100,1855,0.00851040857036882
STAT,1900,23,40-44,1923,0.02880651379996566
STAT,1913,23,50-100,1936,0.0065685232320526355
SIM,1909,58,na,1967,33
SIM,1821,50,na,1871,12
STAT,1917,20,40-44,1937,0.035622089233440825
STAT,1804,50,na,1854,13.998313547009246
STAT,1926,30,35-39,1956,0.10999148605317743
SIM,1886,4,na,1890,30
STAT,1850,25,40-44,1875,0.031842583159819214
STAT,1839,26,na,1865,15.148141235620407
STAT,1870,38,15-19,1908,5.550661535545981E-4
STAT,1908,42,35-39,1950,0.0018533544783348455
STAT,1841,16,15-19,1857,0.07536249085316926
STAT,1855,17,50-100,1872,4.1026819130218035E-4
STAT,1841,47,35-39,1888,0.001376553085045822
STAT,1915,42,40-44,1957,0.0024964409081515457
STAT,1888,49,40-44,1937,0.0011049646830447284
STAT,1801,85,na,1886,0.8874833088358308
STAT,1883,44,35-39,1927,0.01734711953536281
STAT,1888,18,20-24,1906,0.20663246999538218
STAT,1866,17,30-34,1883,0.015067051245841406
SIM,1901,30,na,1931,38
STAT,1922,48,50-100,1970,0.002572175640415179
STAT,1902,36,20-24,1938,0.0023575748700826286
STAT,1821,35,15-19,1856,0.0013689575071508114
SIM,1811,72,na,1883,3
STAT,1848,94,na,1942,0.12924991681556647
STAT,1940,8,na,1948,40.043695939631746
STAT,1942,24,na,1966,37.98407821252497
STAT,1859,27,40-44,1886,0.024220218909242305
STAT,1938,29,na,1967,36.83217069496886
STAT,1922,36,na,1958,42.53418725941957
SIM,1869,44,na,1913,16
STAT,1918,52,na,1970,38.089161513972755
STAT,1888,59,na,1947,22.7112838055755
STAT,1916,41,30-34,1957,0.0013008066022978438
STAT,1896,47,25-29,1943,4.2479387635082093E-4
STAT,1865,39,45-49,1904,0.01784936259685051
STAT,1786,69,na,1855,2.8902
SIM,1826,71,na,1897,6
STAT,1875,40,20-24,1915,0.0016489786972485726
STAT,1797,85,na,1882,0.785985487060737
STAT,1816,53,35-39,1869,1.0208574656008214E-4
STAT,1850,42,30-34,1892,0.010223639942981429
SIM,1847,65,na,1912,12
STAT,1863,29,na,1892,20.979198149032918
STAT,1882,32,25-29,1914,0.09815936150272164
STAT,1849,79,na,1928,5.420801292440816
STAT,1839,15,20-24,1854,0.1295047661573494
SIM,1861,15,na,1876,28
STAT,1851,19,50-100,1870,4.969611305396451E-4
SIM,1912,24,na,1936,40
STAT,1839,46,40-44,1885,9.750183440052163E-4
STAT,1879,51,45-49,1930,1.5092361004138177E-4
SIM,1839,78,na,1917,9
STAT,1789,87,na,1876,0.3657053168657015
SIM,1821,37,30-34,1858,2
STAT,1815,41,25-29,1856,0.010171836766034037
STAT,1927,42,45-49,1969,0.002076616141279968
STAT,1930,23,na,1953,46.41926241382575
STAT,1897,28,15-19,1925,0.006003759477831474
STAT,1832,37,40-44,1869,0.024842234237186612
STAT,1840,34,na,1874,20.259313275368143
SIM,1834,47,na,1881,19
STAT,1872,43,20-24,1915,0.0016131895078077343
STAT,1822,47,25-29,1869,3.1636577311804754E-4
SIM,1870,83,na,1953,5
STAT,1810,45,40-44,1855,0.0017137749829320345
SIM,1814,70,na,1884,17
STAT,1930,30,15-19,1960,0.0016525090870083902
SIM,1885,82,na,1967,11
STAT,1945,19,15-19,1964,0.49186809946138743
STAT,1935,35,20-24,1970,0.0036761149097647113
STAT,1913,37,35-39,1950,0.023670017763451973
SIM,1890,32,25-29,1922,2
SIM,1877,31,na,1908,27
STAT,1913,43,20-24,1956,1.7051096252748658E-4
STAT,1894,40,30-34,1934,0.014882726749220409
STAT,1806,84,na,1890,1.5565941317687546
STAT,1839,27,15-19,1866,0.003154207449271108
STAT,1901,30,30-34,1931,0.24627219722772078
SIM,1881,78,na,1959,6
STAT,1807,52,30-34,1859,1.2197288308863312E-4
STAT,1849,57,na,1906,15.582503922259765
STAT,1858,23,50-100,1881,0.0032166315537864565
STAT,1880,63,na,1943,18.762906532067273
STAT,1825,43,35-39,1868,0.01728667178760583
SIM,1908,41,na,1949,37
SIM,1859,12,na,1871,23
STAT,1864,40,45-49,1904,0.01355915829591623
STAT,1890,38,40-44,1928,0.052909912148750494
STAT,1840,32,20-24,1872,0.0257982272190841
STAT,1878,59,na,1937,20.0646650042904
STAT,1893,39,20-24,1932,0.009621637060510224
STAT,1931,18,na,1949,47.83843083471553
STAT,1884,6,na,1890,25.594621555540364
SIM,1824,69,na,1893,11
STAT,1826,48,20-24,1874,1.1920887610276506E-4
STAT,1888,45,25-29,1933,6.798231033143063E-4
SIM,1873,59,na,1932,16
STAT,1895,47,50-100,1942,0.0017902027994655862
STAT,1892,34,35-39,1926,0.12403940107270868
SIM,1856,79,na,1935,4
STAT,1830,37,30-34,1867,0.03117770896553173
STAT,1911,34,20-24,1945,0.023396562556156325
STAT,1885,44,45-49,1929,0.014580047302617903
STAT,1871,30,35-39,1901,0.10177847039658722
STAT,1910,42,40-44,1952,0.0023494413507410008
STAT,1872,34,50-100,1906,0.00929448861523093
STAT,1859,47,50-100,1906,0.001942969622180072
STAT,1860,31,35-39,1891,0.08266673648364345
SIM,1929,29,25-29,1958,2
STAT,1843,16,25-29,1859,0.03090078559921443
STAT,1931,20,15-19,1951,0.06914484005444212
STAT,1922,48,40-44,1970,0.0017929823695467262
STAT,1900,34,45-49,1934,0.02397423788266495
STAT,1838,94,na,1932,0.15512127083531824
STAT,1895,35,15-19,1930,7.359532177894689E-4
STAT,1913,30,15-19,1943,0.0012780238041567795
STAT,1907,32,40-44,1939,0.03642460199152034
STAT,1855,64,na,1919,12.239256897443493
STAT,1927,25,50-100,1952,0.012120475538065301
SIM,1873,49,na,1922,27
STAT,1815,48,45-49,1863,0.0033533546803949936
STAT,1783,72,na,1855,2.72871
STAT,1891,26,na,1917,29.391842360869862
STAT,1817,47,na,1864,22.980039251051306
STAT,1870,31,na,1901,23.80221655170477
STAT,1823,54,na,1877,13.328189885476712
STAT,1902,41,50-100,1943,0.0010392248235081825
STAT,1924,30,25-29,1954,0.10761436948439469
STAT,1823,47,40-44,1870,0.0011886686903930105
STAT,1847,17,50-100,1864,6.531915700103834E-4
STAT,1818,53,45-49,1871,1.3454368059411697E-4
STAT,1925,2,na,1927,49.09601846445476
STAT,1851,71,na,1922,11.268799394420965
STAT,1912,26,na,1938,36.753684685148755
SIM,1854,67,na,1921,9
STAT,1836,82,na,1918,4.503010750315173
STAT,1916,8,na,1924,41.816808970508085
STAT,1912,31,45-49,1943,0.015425524179809693
STAT,1865,17,15-19,1882,0.05531343885567397
STAT,1910,18,50-100,1928,7.359005255916434E-4
STAT,1920,45,na,1965,40.45440150301892
STAT,1852,38,20-24,1890,0.006564573820925515
STAT,1917,40,35-39,1957,0.0020881138891415134
STAT,1911,29,50-100,1940,0.009575307925291897
SIM,1862,86,na,1948,4
STAT,1851,33,35-39,1884,0.08806660337274498
STAT,1914,48,50-100,1962,0.00221837957480806
STAT,1896,44,20-24,1940,1.4290537855291392E-4
STAT,1947,19,25-29,1966,0.4844948999591432
STAT,1904,44,30-34,1948,0.001128511656970649
STAT,1861,71,na,1932,11.225079456562359
STAT,1859,54,45-49,1913,1.1217514800813265E-4
STAT,1888,69,na,1957,17.71958711828525
STAT,1923,47,45-49,1970,0.0025248751288198205
STAT,1950,20,25-29,1970,1.0897620499084664
SIM,1884,11,na,1895,26
STAT,1890,30,45-49,1920,0.021352524691287074
STAT,1947,19,50-100,1966,0.0041887158689428465
STAT,1804,72,na,1876,6.54418305282373
STAT,1823,64,na,1887,10.195379582472368
STAT,1893,43,40-44,1936,0.001955192285082985
SIM,1841,49,na,1890,14
STAT,1841,31,25-29,1872,0.12291027680878058
SIM,1841,27,na,1868,17
STAT,1823,32,na,1855,17.096913699916016
STAT,1886,49,30-34,1935,9.83109496578813E-4
STAT,1897,43,25-29,1940,5.878934778888623E-4
STAT,1841,38,45-49,1879,0.022752130056576374
STAT,1899,28,25-29,1927,0.5770400190274051
STAT,1883,40,50-100,1923,0.010362525549705058
STAT,1833,64,na,1897,12.869818879825402
STAT,1864,48,40-44,1912,0.0015162379617763414
STAT,1906,29,50-100,1935,0.009227129514406312
STAT,1874,43,30-34,1917,0.011579032474507393
STAT,1905,30,15-19,1935,0.0020718071259576516
STAT,1866,15,15-19,1881,0.056766809408208635
STAT,1902,26,na,1928,33.76992524391543
STAT,1876,3,na,1879,31.224909356762822
STAT,1814,46,50-100,1860,0.007142404098921363
STAT,1925,18,35-39,1943,0.050240072132498315
STAT,1894,76,na,1970,16.507376900583044
STAT,1847,44,25-29,1891,0.006767165195959015
STAT,1922,41,20-24,1963,2.0151101940936512E-4
SIM,1820,66,na,1886,8
SIM,1841,17,na,1858,21
STAT,1906,19,na,1925,36.49563176376451
STAT,1892,28,50-100,1920,0.00787499078266384
STAT,1959,13,na,1972,51.079650484998275
STAT,1813,50,40-44,1863,3.2615130382823254E-4
STAT,1862,44,50-100,1906,0.008991661979870346
STAT,1856,46,40-44,1902,0.0012437511342518694
STAT,1915,45,45-49,1960,0.0021813445385751797
STAT,1870,33,45-49,1903,0.017249827792499246
STAT,1873,34,25-29,1907,0.10324423337233497
STAT,1845,48,30-34,1893,5.587334328587734E-4
STAT,1868,45,50-100,1913,0.0024004779614969843
STAT,1888,39,50-100,1927,0.014202977804127116
STAT,1873,31,20-24,1904,0.027594106843296586
STAT,1876,32,50-100,1908,0.009305809028137591
STAT,1858,42,35-39,1900,0.013762326662749118
STAT,1899,45,50-100,1944,0.0019154122876257691
STAT,1866,59,na,1925,17.898946299429074
STAT,1941,18,na,1959,37.62545776528154
STAT,1969,0,na,1969,49.15281596838835
STAT,1911,41,45-49,1952,0.0015873336092361691
STAT,1920,30,40-44,1950,0.0428412334464609
SIM,1906,60,na,1966,20
SIM,1857,8,na,1865,23
STAT,1826,52,40-44,1878,1.0230153075736531E-4
STAT,1874,78,na,1952,7.926553161828401
STAT,1870,63,na,1933,17.725074672451502
STAT,1820,99,na,1919,0.010736802481840663
SIM,1869,12,na,1881,19
SIM,1872,96,na,1968,3
STAT,1912,46,30-34,1958,8.521423823639755E-4
STAT,1822,33,50-100,1855,0.006972561709583297
STAT,1906,18,25-29,1924,0.08211143073641029
STAT,1843,40,25-29,1883,0.002877448058255515
STAT,1807,47,na,1854,14.978892844376466
STAT,1842,27,50-100,1869,0.005935271387638849
STAT,1855,96,na,1951,0.06045606395868725
STAT,1902,42,40-44,1944,0.0021999197707964434
STAT,1802,91,na,1893,0.17697562407525422
STAT,1852,45,45-49,1897,0.0020399383348345215
STAT,1859,34,50-100,1893,0.00722012475349562
SIM,1917,23,na,1940,44
STAT,1867,49,20-24,1916,1.1243759902014191E-4
STAT,1795,72,na,1867,6.703765191211621
STAT,1886,47,na,1933,23.228042886299157
STAT,1906,40,25-29,1946,6.543868688482959E-4
STAT,1845,46,50-100,1891,0.0014397280199216337
STAT,1920,31,45-49,1951,0.017159212566846264
STAT,1905,56,na,1961,30.624209566252834
STAT,1925,40,35-39,1965,0.002429396175859025
STAT,1842,50,50-100,1892,1.1494110214117892E-4
STAT,1842,46,na,1888,17.100592803130272
STAT,1916,19,50-100,1935,7.838665576526364E-4
SIM,1824,47,na,1871,16
STAT,1882,36,40-44,1918,0.042153440909956506
STAT,1837,45,na,1882,11.585523001086486
STAT,1932,32,25-29,1964,0.12237013294415373
SIM,1899,26,25-29,1925,1
SIM,1837,65,na,1902,26
STAT,1832,33,25-29,1865,0.059239981541695325
STAT,1839,79,na,1918,3.858055479493712
STAT,1867,21,50-100,1888,0.003946807687552827
STAT,1791,91,na,1882,0.17622693961839137
STAT,1880,24,15-19,1904,0.03447381764470516
STAT,1866,41,30-34,1907,0.010636141589707692
STAT,1880,21,50-100,1901,0.004301078912612818
STAT,1902,43,45-49,1945,0.00145501646774651
SIM,1805,87,na,1892,1
SIM,1899,4,na,1903,31
SIM,1922,46,40-44,1968,1
STAT,1815,45,40-44,1860,0.0025388899154919803
STAT,1853,33,50-100,1886,0.005868734641591515
SIM,1890,36,40-44,1926,1
STAT,1920,23,na,1943,40.12793503113305
STAT,1855,43,20-24,1898,0.0011100773233842258
STAT,1930,34,30-34,1964,0.2021139832642082
STAT,1833,45,35-39,1878,0.0012456489450869323
STAT,1856,42,25-29,1898,0.004646272326934301
STAT,1901,63,na,1964,27.02979240442515
STAT,1914,46,40-44,1960,0.001554528412513786
STAT,1901,31,35-39,1932,0.14228399023237615
STAT,1834,27,na,1861,20.046170040546528
STAT,1884,17,25-29,1901,0.05551988241328671
STAT,1816,84,na,1900,0.998714228816798
STAT,1814,50,na,1864,13.193927389772217
STAT,1910,40,25-29,1950,6.783571039143942E-4
STAT,1892,31,30-34,1923,0.21658016469223323
SIM,1898,18,30-34,1916,1
STAT,1959,4,na,1963,51.14661375200871
STAT,1881,40,45-49,1921,0.01438488004793498
STAT,1884,41,25-29,1925,0.006320013809213104
STAT,1829,50,50-100,1879,1.2964908034438332E-4
STAT,1894,44,na,1938,29.321753602262003
STAT,1862,34,na,1896,20.411979373129938
STAT,1876,45,50-100,1921,0.0025192943169622534
STAT,1906,42,25-29,1948,6.470522209409803E-4
SIM,1810,88,na,1898,3
SIM,1951,0,na,1951,53
SIM,1877,41,na,1918,27
SIM,1832,35,na,1867,25
STAT,1878,30,45-49,1908,0.018148241306875396
STAT,1786,90,na,1876,0.13007421693739088
STAT,1876,19,40-44,1895,0.001847684959416583
SIM,1845,31,na,1876,24
STAT,1881,48,na,1929,21.139217296982714
STAT,1911,37,25-29,1948,0.009448729282953658
STAT,1877,42,45-49,1919,0.015430213188097626
SIM,1894,11,na,1905,32
STAT,1867,11,na,1878,25.781180785128665
STAT,1855,19,20-24,1874,0.14671867592770657
SIM,1826,28,na,1854,17
STAT,1817,41,35-39,1858,0.0589890138311273
STAT,1817,50,25-29,1867,1.0247630207912507E-4
STAT,1857,15,15-19,1872,0.0528370651861945
STAT,1870,85,na,1955,2.723220130727608
STAT,1899,21,na,1920,32.47369147352318
STAT,1875,1,na,1876,35.60296029390165
STAT,1825,40,30-34,1865,0.011595231018878193
SIM,1912,56,na,1968,35
STAT,1950,22,40-44,1972,0.03964127739715676
SIM,1815,65,na,1880,6
STAT,1882,45,30-34,1927,9.36925319533324E-4
STAT,1830,33,50-100,1863,0.0058294831709673695
STAT,1903,41,45-49,1944,0.0014842897498398558
SIM,1923,19,na,1942,40
STAT,1865,39,50-100,1904,0.01099301324581149
STAT,1822,44,20-24,1866,8.814566028290235E-4
STAT,1864,78,na,1942,7.007951824118326
STAT,1832,30,20-24,1862,0.016128307143553525
STAT,1892,40,20-24,1932,0.0019817855063885975
STAT,1864,15,50-100,1879,5.05463858002551E-4
STAT,1921,32,15-19,1953,0.0014189040396900574
STAT,1898,16,15-19,1914,0.08025376299945483
STAT,1852,42,40-44,1894,0.01922668665646447
STAT,1874,46,35-39,1920,0.001424320434716022
STAT,1884,32,35-39,1916,0.0992201266236257
SIM,1851,27,na,1878,20
STAT,1831,49,40-44,1880,0.0015975717180759378
STAT,1846,82,na,1928,3.7813151766247626
STAT,1911,41,na,1952,35.4217931855086
STAT,1879,77,na,1956,9.351619550394153
SIM,1947,21,na,1968,40
SIM,1900,24,na,1924,32
STAT,1881,26,na,1907,22.786735889227543
STAT,1812,49,30-34,1861,0.0010586259317071406
SIM,1914,1,na,1915,38
STAT,1908,18,35-39,1926,0.008076069124317546
SIM,1955,6,na,1961,46
STAT,1869,77,na,1946,8.375453372021587
SIM,1904,27,na,1931,29
STAT,1863,45,20-24,1908,1.0730696168783437E-4
STAT,1849,15,15-19,1864,0.05731521266497981
STAT,1851,30,30-34,1881,0.15663672661222997
STAT,1932,5,na,1937,53.02550851628941
STAT,1841,44,30-34,1885,0.01139758439894775
SIM,1865,2,na,1867,29
SIM,1810,66,na,1876,12
STAT,1892,0,na,1892,36.275725579742314
STAT,1841,35,40-44,1876,0.05154231664458064
STAT,1899,43,na,1942,31.519261472375312
STAT,1822,46,50-100,1868,0.0013667132388070259
STAT,1836,41,45-49,1877,0.017404336770357094
STAT,1850,21,25-29,1871,0.6161867074190046
SIM,1942,22,na,1964,39
STAT,1940,31,20-24,1971,0.025079674626463298
SIM,1828,61,na,1889,8
SIM,1798,68,na,1866,9
STAT,1915,20,30-34,1935,0.28431696310603854
STAT,1871,54,45-49,1925,1.4070997261618113E-4
STAT,1856,49,na,1905,15.958294586601717
STAT,1893,46,45-49,1939,0.0016832916586314623
SIM,1903,20,na,1923,36
STAT,1949,13,na,1962,45.38587518232995
SIM,1883,59,na,1942,6
STAT,1796,90,na,1886,0.06185158630218847
STAT,1934,20,40-44,1954,0.04514179245856896
SIM,1830,54,na,1884,16
STAT,1813,54,na,1867,18.108082135675023
STAT,1879,51,50-100,1930,1.570628752766407E-4
STAT,1930,37,35-39,1967,0.031401766693225766
STAT,1879,55,na,1934,21.401042171209387
SIM,1873,27,na,1900,22
SIM,1871,3,na,1874,31
SIM,1860,20,na,1880,26
STAT,1914,42,25-29,1956,7.017191186448889E-4
STAT,1876,15,25-29,1891,0.05782129044780164
STAT,1862,40,35-39,1902,0.01578070314808489
STAT,1882,4,na,1886,27.040658103539883
STAT,1932,30,25-29,1962,0.12250852850113943
STAT,1858,27,25-29,1885,0.3295177715872603
STAT,1849,17,30-34,1866,0.015212608483588196
STAT,1847,41,20-24,1888,0.0017279582370206949
STAT,1897,18,50-100,1915,6.488857506597678E-4
STAT,1808,65,na,1873,3.23396789124086
STAT,1844,43,45-49,1887,0.011820284822537806
STAT,1925,42,35-39,1967,0.0024226714012314508
STAT,1856,49,45-49,1905,0.0016739662491872358
STAT,1868,92,na,1960,0.7332794595349341
SIM,1927,33,na,1960,49
STAT,1903,12,na,1915,36.71638905140172
STAT,1944,23,50-100,1967,0.007050593670885556
STAT,1899,43,35-39,1942,0.001708952896976664
STAT,1845,64,na,1909,10.161553858271473
SIM,1886,77,na,1963,10
STAT,1936,36,50-100,1972,0.004100613283482989
STAT,1897,47,40-44,1944,0.0012764418567458129
STAT,1862,31,45-49,1893,0.015106564817307313
SIM,1892,30,na,1922,35
STAT,1860,40,50-100,1900,0.00867532826234513
STAT,1877,11,na,1888,26.86025319047098
STAT,1824,31,25-29,1855,0.17283992272435558
STAT,1940,32,25-29,1972,0.09497839932693293
STAT,1882,39,45-49,1921,0.018912178003311866
STAT,1880,48,25-29,1928,5.980840039210569E-4
STAT,1891,22,25-29,1913,0.7026119127144704
STAT,1825,29,50-100,1854,0.013248863095521356
STAT,1860,47,45-49,1907,0.0019096709083803079
STAT,1833,42,30-34,1875,0.010313729312827381
STAT,1910,31,35-39,1941,0.0879331040222176
STAT,1908,30,40-44,1938,0.037042337687548575
STAT,1904,47,35-39,1951,0.0011263020755346957
STAT,1820,49,30-34,1869,7.9714865606589E-4
STAT,1781,91,na,1872,0.2660268519388408
STAT,1926,45,20-24,1971,1.3621639977317524E-4
STAT,1847,40,50-100,1887,0.011642892509666571
STAT,1897,41,50-100,1938,9.78625215215864E-4
STAT,1949,16,30-34,1965,0.14089300716023193
SIM,1928,18,na,1946,51
STAT,1928,19,15-19,1947,0.5659949806867091
SIM,1897,18,na,1915,43
STAT,1918,46,50-100,1964,0.0023910501683913534
STAT,1814,42,20-24,1856,0.005074794890736995
STAT,1841,83,na,1924,3.8857676494881526
STAT,1862,12,na,1874,23.588887062875795
STAT,1914,41,20-24,1955,1.737937030942143E-4
STAT,1922,35,50-100,1957,0.0047506346846146515
STAT,1828,53,na,1881,15.1920773686161
STAT,1881,33,20-24,1914,0.02561223638477743
SIM,1877,63,na,1940,21
STAT,1890,43,15-19,1933,1.6653662323749555E-4
STAT,1811,44,45-49,1855,0.06165726990871324
STAT,1866,44,35-39,1910,0.016452149164288978
STAT,1847,45,na,1892,24.273236703969484
STAT,1924,32,40-44,1956,0.045358967247248895
STAT,1883,81,na,1964,7.853189923447058
STAT,1825,52,50-100,1877,1.3448631892599655E-4
STAT,1868,17,40-44,1885,0.001802083737379523
STAT,1875,30,na,1905,24.727072335229096
STAT,1920,48,30-34,1968,9.743244045250613E-4
STAT,1817,79,na,1896,5.5406763293005525
STAT,1902,40,40-44,1942,0.002224856918712681
SIM,1862,64,na,1926,18
SIM,1868,26,na,1894,35
STAT,1782,76,na,1858,2.737817545139075
STAT,1871,38,30-34,1909,0.052872355391254046
STAT,1888,42,20-24,1930,0.0018536010661487769
STAT,1832,46,na,1878,11.019107738759061
STAT,1843,31,35-39,1874,0.052183255123619945
STAT,1831,30,50-100,1861,0.009878155929967332
STAT,1914,31,20-24,1945,0.024448633672898172
STAT,1846,19,50-100,1865,4.929092212553151E-4
STAT,1911,30,40-44,1941,0.038165313415428524
STAT,1811,51,50-100,1862,5.84741021161168E-4
STAT,1848,20,45-49,1868,0.00557057791493591
STAT,1894,49,50-100,1943,0.0017384315622772212
STAT,1932,22,25-29,1954,1.2070613151043283
STAT,1925,45,40-44,1970,0.001907472008467362
STAT,1915,18,40-44,1933,0.0028945513343807557
STAT,1918,19,20-24,1937,1.4544614496225197
SIM,1806,50,na,1856,10
STAT,1857,25,50-100,1882,0.005004128184154604
SIM,1910,32,40-44,1942,1
STAT,1874,14,na,1888,26.281490071247656
STAT,1833,105,na,1938,2.170736038586276E-4
SIM,1914,25,35-39,1939,1
STAT,1929,38,35-39,1967,0.030873029341030145
SIM,1865,61,na,1926,13
STAT,1920,41,45-49,1961,0.0018250973182346844
STAT,1840,65,na,1905,13.242398092091818
STAT,1921,29,20-24,1950,0.2004112535453711
STAT,1844,79,na,1923,5.460676544830707
STAT,1911,43,45-49,1954,0.001568768758529315
SIM,1931,22,30-34,1953,3
STAT,1868,31,50-100,1899,0.0089031591606871
STAT,1888,22,40-44,1910,0.024351349083701814
SIM,1795,61,na,1856,11
STAT,1866,23,15-19,1889,0.03041155229582492
STAT,1915,23,35-39,1938,0.09619258268793539
STAT,1923,20,na,1943,42.44768244453219
STAT,1839,22,45-49,1861,0.004944496210699309
STAT,1946,17,na,1963,40.53690116314526
STAT,1931,41,20-24,1972,2.3522273940369722E-4
STAT,1885,24,50-100,1909,0.0040017810146122275
STAT,1912,39,50-100,1951,0.0040248709988740085
SIM,1842,13,na,1855,30
STAT,1896,30,50-100,1926,0.01213195593086688
SIM,1884,44,na,1928,22
STAT,1912,36,15-19,1948,1.868564178753172E-4
SIM,1922,23,na,1945,50
STAT,1847,12,na,1859,31.828200239086925
STAT,1941,20,25-29,1961,0.9482963696738123
STAT,1875,21,15-19,1896,0.034014442560276845
SIM,1876,25,na,1901,27
SIM,1931,24,25-29,1955,1
STAT,1921,34,15-19,1955,0.0014067559497287234
SIM,1894,74,na,1968,14
STAT,1902,32,40-44,1934,0.061155797077091616
STAT,1934,38,45-49,1972,0.009358193098485578
STAT,1862,48,30-34,1910,8.246623972166129E-4
STAT,1927,17,20-24,1944,1.6771101635075887
STAT,1923,42,25-29,1965,8.288476194571409E-4
STAT,1910,29,45-49,1939,0.016462275632413804
SIM,1888,58,na,1946,27
SIM,1926,19,20-24,1945,3
SIM,1859,77,na,1936,5
STAT,1921,41,na,1962,41.56437561563917
STAT,1917,36,na,1953,38.90795035444164
STAT,1897,15,45-49,1912,8.714840461889414E-4
STAT,1867,15,30-34,1882,0.01577815665341479
STAT,1917,46,45-49,1963,0.0022550771385496135
SIM,1901,61,na,1962,31
STAT,1927,40,45-49,1967,0.002082380346665392
SIM,1935,17,20-24,1952,2
STAT,1931,19,35-39,1950,0.05438687564899846
SIM,1901,1,na,1902,42
STAT,1859,20,20-24,1879,0.6335558779523043
STAT,1904,25,50-100,1929,0.009228278429046473
STAT,1930,27,20-24,1957,0.2310210332452285
SIM,1916,39,na,1955,43
STAT,1814,49,na,1863,13.339109391424456
SIM,1852,43,na,1895,24
STAT,1914,20,50-100,1934,0.006435544026305177
STAT,1907,19,45-49,1926,9.503817752554629E-4
SIM,1892,63,na,1955,28
STAT,1924,16,40-44,1940,0.016588681098797856
SIM,1818,43,50-100,1861,1
STAT,1846,30,35-39,1876,0.0990246151221554
STAT,1923,45,50-100,1968,0.002639948800247373
STAT,1903,31,45-49,1934,0.024893816508712377
STAT,1857,25,15-19,1882,0.003549183493838169
SIM,1884,64,na,1948,17
STAT,1855,31,na,1886,17.285747175187904
STAT,1897,62,na,1959,25.199730346299848
SIM,1833,52,na,1885,11
STAT,1829,27,50-100,1856,0.007348762608204319
STAT,1942,23,na,1965,37.99737729457804
STAT,1950,22,na,1972,43.053697992257554
STAT,1944,14,na,1958,41.950810124271094
STAT,1880,46,25-29,1926,6.074142566977334E-4
STAT,1915,30,25-29,1945,0.09406979740460761
STAT,1932,15,35-39,1947,0.05559540718826
STAT,1929,37,na,1966,48.06947985112923
STAT,1867,20,50-100,1887,0.003975350705619173
STAT,1900,37,35-39,1937,0.021169474962898227
STAT,1943,18,15-19,1961,0.47759722609283367
SIM,1829,47,na,1876,19
SIM,1825,33,na,1858,18
STAT,1916,47,40-44,1963,0.001603291821172916
STAT,1852,98,na,1950,0.027802581625123828
STAT,1920,23,45-49,1943,0.012364006298515518
STAT,1909,26,15-19,1935,0.006789054691621452
STAT,1928,39,30-34,1967,0.022872095680029535
STAT,1863,22,35-39,1885,0.05269687276570458
STAT,1905,29,35-39,1934,0.13826202739096943
STAT,1859,16,35-39,1875,0.005092472295903906
SIM,1927,18,25-29,1945,3
STAT,1890,48,35-39,1938,9.472177582030659E-4
STAT,1895,30,30-34,1925,0.2284937138296665
STAT,1877,42,na,1919,23.828654851242156
SIM,1862,33,na,1895,23
STAT,1826,50,na,1876,17.189860316197468
STAT,1889,75,na,1964,15.533090466668886
STAT,1849,47,na,1896,17.363739807986832
STAT,1908,15,45-49,1923,9.684409123366404E-4
STAT,1899,22,15-19,1921,0.04516144928625535
STAT,1878,30,30-34,1908,0.18170611997952424
STAT,1908,43,na,1951,33.97745269628971
STAT,1800,69,na,1869,6.34823528323051
SIM,1910,22,na,1932,31
STAT,1925,15,45-49,1940,0.006024532547072116
STAT,1847,41,50-100,1888,0.011494678488018517
SIM,1876,45,na,1921,28
SIM,1837,30,35-39,1867,2
STAT,1889,23,na,1912,28.86656566514245
STAT,1914,26,25-29,1940,0.660292814892897
SIM,1821,51,na,1872,11
SIM,1886,30,30-34,1916,1
STAT,1899,18,30-34,1917,0.02176184897718117
STAT,1918,42,45-49,1960,0.0017534964373043804
STAT,1919,18,25-29,1937,0.47349332120215243
STAT,1807,91,na,1898,0.24455912951766257
STAT,1847,21,40-44,1868,0.02748595981435815
STAT,1874,1,na,1875,35.26822182955169
STAT,1940,17,35-39,1957,0.04230265202963674
STAT,1897,42,na,1939,30.760312629128865
STAT,1825,88,na,1913,0.740100476796457
STAT,1832,78,na,1910,3.531692757223259
STAT,1832,41,50-100,1873,0.005885544707720157
SIM,1866,24,20-24,1890,1
STAT,1840,97,na,1937,0.042096419503106434
STAT,1822,68,na,1890,5.42075526078785
STAT,1903,8,na,1911,36.95861133512814
STAT,1885,61,na,1946,18.45305299048741
SIM,1853,72,na,1925,12
SIM,1817,46,na,1863,10
STAT,1883,15,15-19,1898,0.0578970767584142
STAT,1933,32,40-44,1965,0.0525223089883199
STAT,1858,24,20-24,1882,0.5396756149716354
STAT,1904,37,20-24,1941,0.0023840572790343245
STAT,1913,35,20-24,1948,0.0026041984878144952
STAT,1926,41,40-44,1967,0.00307031543957406
STAT,1839,22,50-100,1861,0.002891518362046065
STAT,1903,38,15-19,1941,1.7146601576455337E-4
STAT,1886,41,50-100,1927,0.011007802882237612
SIM,1785,71,na,1856,9
STAT,1920,38,15-19,1958,2.0825466751124507E-4
STAT,1844,49,50-100,1893,0.0018783153608146514
STAT,1908,23,50-100,1931,0.005999155717257544
STAT,1914,27,35-39,1941,0.15009729621351106
STAT,1784,89,na,1873,0.5195049026766819
STAT,1780,75,na,1855,7.27656
SIM,1858,25,25-29,1883,1
STAT,1909,17,na,1926,37.663084713648104
STAT,1923,22,30-34,1945,0.332100347450315
STAT,1870,36,15-19,1906,5.605178859343161E-4
STAT,1913,28,30-34,1941,0.3857904935350951
STAT,1935,21,na,1956,49.524251889963814
STAT,1864,21,40-44,1885,0.019128050923896852
STAT,1813,87,na,1900,1.1627148343962472
STAT,1923,24,25-29,1947,1.0606317791369997
STAT,1913,32,15-19,1945,0.0012678327840645474
SIM,1918,18,na,1936,35
STAT,1808,96,na,1904,0.012538484074389317
STAT,1835,24,50-100,1859,0.0025518632966205234
SIM,1835,31,na,1866,21
STAT,1860,45,45-49,1905,0.001937743367035077
STAT,1849,31,15-19,1880,0.0012919934133956746
STAT,1858,17,30-34,1875,0.01416765838946772
SIM,1883,70,na,1953,4
STAT,1792,76,na,1868,7.563841286945108
STAT,1922,25,20-24,1947,0.2064325727155286
STAT,1858,83,na,1941,3.0208514415935426
STAT,1911,28,50-100,1939,0.00961028937863011
STAT,1859,21,30-34,1880,0.16258372309689792
SIM,1840,54,na,1894,11
STAT,1908,48,45-49,1956,0.001949907218980368
STAT,1893,38,50-100,1931,0.015403548093914496
SIM,1930,22,na,1952,45
STAT,1810,54,45-49,1864,1.3141841064503052E-4
SIM,1816,40,na,1856,12
STAT,1923,17,35-39,1940,0.04893148559914858
STAT,1940,24,25-29,1964,0.9336469193264172
SIM,1906,26,40-44,1932,1
STAT,1892,43,na,1935,28.3469705075636
STAT,1904,29,20-24,1933,0.1668974386400152
SIM,1898,24,na,1922,31
STAT,1939,2,na,1941,40.56919125824502
STAT,1896,57,na,1953,26.3972265870487
SIM,1936,15,na,1951,35
STAT,1922,18,30-34,1940,0.13966263682636068
STAT,1926,17,na,1943,44.86995912957595
STAT,1867,12,na,1879,25.664134224364183
SIM,1872,63,na,1935,18
STAT,1852,16,50-100,1868,5.101274133574018E-4
SIM,1847,32,na,1879,19
STAT,1932,18,40-44,1950,0.018397771414839507
STAT,1910,17,50-100,1927,7.37833649753999E-4
STAT,1927,39,50-100,1966,0.005182346357268311
STAT,1931,31,20-24,1962,0.03183793368206656
STAT,1848,35,15-19,1883,3.8208783976864224E-4
STAT,1947,18,50-100,1965,0.004190182432794322
SIM,1870,20,na,1890,22
SIM,1930,18,30-34,1948,2
STAT,1837,46,na,1883,11.43803933113378
STAT,1833,32,na,1865,20.65493445717522
STAT,1868,21,25-29,1889,0.5579981443498112
STAT,1858,21,15-19,1879,0.02901131165312253
STAT,1915,22,25-29,1937,0.9465667450275413
STAT,1915,48,35-39,1963,0.001284375578543626
STAT,1845,96,na,1941,0.050193206591130926
STAT,1841,82,na,1923,4.56697810338977
STAT,1896,4,na,1900,34.55503048925354
SIM,1883,27,na,1910,14
SIM,1923,22,25-29,1945,1
STAT,1881,47,na,1928,21.308406040947848
SIM,1906,49,na,1955,22
STAT,1941,30,25-29,1971,0.09644552280176717
STAT,1834,20,15-19,1854,0.031632603563082465
STAT,1846,22,35-39,1868,0.058352252555924466
STAT,1799,102,na,1901,0.00108309783467105
STAT,1902,35,45-49,1937,0.006125328764617763
SIM,1879,10,na,1889,17
SIM,1875,51,na,1926,14
SIM,1913,42,na,1955,40
STAT,1830,99,na,1929,0.006804514633144398
STAT,1933,10,na,1943,52.98454184608373
STAT,1923,25,35-39,1948,0.172339542821998
STAT,1919,49,30-34,1968,9.529062092986366E-4
STAT,1854,32,35-39,1886,0.06338951535185994
STAT,1938,33,30-34,1971,0.1572766974493733
STAT,1901,33,35-39,1934,0.14110689973779553
STAT,1805,68,na,1873,6.010046111574129
STAT,1878,15,35-39,1893,0.005691289782338506
STAT,1883,38,na,1921,22.764980424770762
STAT,1880,43,20-24,1923,0.0016579396198405658
STAT,1854,44,50-100,1898,0.0063702410851906735
STAT,1876,20,20-24,1896,0.7040828589146659
STAT,1911,40,40-44,1951,0.002398794861531642
SIM,1876,77,na,1953,13
STAT,1819,42,50-100,1861,0.010014578701568268
STAT,1917,43,40-44,1960,0.0025824537415966436
SIM,1856,17,15-19,1873,1
STAT,1881,16,na,1897,24.091262963945137
STAT,1826,39,50-100,1865,0.0134850340905437
STAT,1838,63,na,1901,13.848817472549424
STAT,1863,3,na,1866,28.544888174280214
STAT,1884,15,30-34,1899,0.01568852100964584
STAT,1874,25,15-19,1899,0.004634000010244105
STAT,1932,4,na,1936,53.22884269538579
STAT,1923,21,20-24,1944,1.2887150638024407
SIM,1912,57,na,1969,35
SIM,1865,1,na,1866,32
STAT,1887,31,35-39,1918,0.1109894362820047
STAT,1914,19,35-39,1933,0.008561928708896077
STAT,1898,68,na,1966,23.324202395915194
SIM,1818,83,na,1901,1
STAT,1924,19,45-49,1943,0.0058783182456139255
STAT,1801,53,40-44,1854,2.9550336027636817E-4
SIM,1866,79,na,1945,4
SIM,1899,10,na,1909,29
STAT,1848,17,15-19,1865,0.04757611388702056
STAT,1905,41,20-24,1946,1.5988520992462862E-4
STAT,1930,19,20-24,1949,1.7352238711404233
SIM,1857,9,na,1866,23
SIM,1934,2,na,1936,55
STAT,1961,0,na,1961,50.872543172632625
STAT,1862,13,na,1875,23.481793515610338
STAT,1902,17,15-19,1919,0.08368824270010154
STAT,1910,34,40-44,1944,0.03718128075901654
STAT,1875,95,na,1970,0.6693763395134731
STAT,1902,27,45-49,1929,0.015657346391744747
STAT,1907,24,40-44,1931,0.03029013019488871
STAT,1781,92,na,1873,0.16285631821991955
STAT,1931,16,30-34,1947,0.1592228105269757
STAT,1860,65,na,1925,13.73893403431516
STAT,1916,19,na,1935,40.409517569749994
STAT,1846,30,50-100,1876,0.00895924477566365
STAT,1911,1,na,1912,41.38418810720649
STAT,1921,26,15-19,1947,0.007833295957773266
STAT,1907,42,40-44,1949,0.0022819220927545653
STAT,1838,31,40-44,1869,0.042261679283079175
STAT,1953,15,20-24,1968,1.6314273489382918
STAT,1867,18,35-39,1885,0.005336408202167677
STAT,1846,50,na,1896,17.700638309871994
STAT,1899,25,20-24,1924,0.1616853161893748
STAT,1836,34,50-100,1870,0.010947373672742304
STAT,1769,88,na,1857,2.1202575214280004
SIM,1896,45,na,1941,27
SIM,1857,42,na,1899,22
STAT,1835,98,na,1933,0.014611706063198372
SIM,1817,66,na,1883,4
STAT,1888,25,45-49,1913,0.013063006968600795
SIM,1813,52,na,1865,9
STAT,1905,34,30-34,1939,0.14345150991596073
STAT,1864,79,na,1943,6.270434974148113
SIM,1824,79,na,1903,5
STAT,1828,42,35-39,1870,0.00798205347414794
SIM,1930,28,25-29,1958,2
STAT,1951,20,40-44,1971,0.03995569825993349
SIM,1913,26,30-34,1939,1
STAT,1915,15,35-39,1930,0.008746915940722008
STAT,1818,86,na,1904,0.5544749020600701
STAT,1931,23,20-24,1954,1.4313461319082281
STAT,1881,27,na,1908,22.708805252486393
STAT,1836,35,50-100,1871,0.01484888791445684
SIM,1893,25,na,1918,36
STAT,1901,40,25-29,1941,6.302679500988403E-4
SIM,1931,16,na,1947,58
STAT,1821,47,30-34,1868,0.0013679101576522313
STAT,1938,18,na,1956,36.057658880872594
STAT,1916,17,45-49,1933,0.0010507905846971763
STAT,1809,82,na,1891,2.5816560176720365
STAT,1909,18,15-19,1927,0.08826708193116949
SIM,1818,51,na,1869,24
STAT,1857,97,na,1954,0.04021703747060223
STAT,1931,24,30-34,1955,0.368793310106681
STAT,1853,83,na,1936,2.4949886865306232
STAT,1889,36,15-19,1925,6.908271634271E-4
STAT,1935,16,15-19,1951,0.6191839578395473
STAT,1937,29,30-34,1966,0.37916248538769126
STAT,1957,15,40-44,1972,0.018347059521381926
SIM,1871,2,na,1873,31
STAT,1860,53,45-49,1913,1.160876385356622E-4
STAT,1863,50,na,1913,19.33805440271266
STAT,1855,11,na,1866,20.08239678546853
STAT,1889,21,45-49,1910,0.008563304619335113
STAT,1905,26,30-34,1931,0.36468280615775883
STAT,1858,25,30-34,1883,0.1990083700719281
STAT,1844,102,na,1946,0.0022899753415915125
STAT,1909,44,45-49,1953,0.0015289318326722043
STAT,1869,23,na,1892,22.845124854254287
STAT,1860,103,na,1963,0.004504445976526131
SIM,1841,16,na,1857,21
SIM,1878,0,na,1878,40
STAT,1857,66,na,1923,12.269761662770955
STAT,1920,15,45-49,1935,0.001120048187953963
STAT,1906,28,40-44,1934,0.04336683599181602
STAT,1778,93,na,1871,0.07570722319748721
STAT,1911,31,na,1942,36.740448883422275
STAT,1940,16,25-29,1956,0.43699796946870895
SIM,1889,43,na,1932,31
SIM,1870,52,na,1922,21
STAT,1887,23,35-39,1910,0.0634978999096351
STAT,1881,47,30-34,1928,9.167998598606623E-4
SIM,1922,18,25-29,1940,1
STAT,1915,40,25-29,1955,7.146997774038322E-4
SIM,1892,5,na,1897,36
SIM,1905,55,na,1960,40
STAT,1913,36,30-34,1949,0.017921642981791535
STAT,1915,31,50-100,1946,0.008381966338406535
STAT,1917,28,15-19,1945,0.007310337439683745
STAT,1875,31,na,1906,24.630142211674986
STAT,1843,30,na,1873,11.28409280398624
STAT,1879,32,40-44,1911,0.04488544942247431
STAT,1925,30,40-44,1955,0.046232006198546324
STAT,1933,22,40-44,1955,0.04441831125053204
STAT,1919,15,20-24,1934,0.299364853017954
STAT,1936,23,50-100,1959,0.006250653496878014
SIM,1877,62,na,1939,21
STAT,1847,24,45-49,1871,0.009001143477219984
STAT,1910,26,40-44,1936,0.04488795893654602
STAT,1850,51,50-100,1901,1.351129666199524E-4
STAT,1919,48,20-24,1967,1.1849502291399738E-4
SIM,1923,40,na,1963,38
STAT,1839,57,na,1896,11.090272710298374
STAT,1833,52,50-100,1885,1.1523647363401183E-4
STAT,1897,20,40-44,1917,0.027837159144500374
SIM,1899,16,30-34,1915,1
STAT,1923,32,25-29,1955,0.10522379011975765
STAT,1949,16,45-49,1965,0.0057743023981655745
STAT,1935,34,45-49,1969,0.021645831733048442
SIM,1898,2,na,1900,38
STAT,1914,18,25-29,1932,0.08866613279264726
STAT,1927,25,20-24,1952,0.2222799128993609
STAT,1903,44,na,1947,32.52806943864341
STAT,1887,32,na,1919,26.046769812513865
STAT,1817,69,na,1886,12.984678536945676
STAT,1912,39,20-24,1951,0.0025270499841152263
STAT,1922,28,25-29,1950,0.7367388609867643
STAT,1889,18,15-19,1907,0.07246822094788219
STAT,1905,33,20-24,1938,0.022305967329103525
STAT,1898,47,50-100,1945,0.0018601774645155594
STAT,1872,20,35-39,1892,0.06006313866203669
STAT,1929,37,25-29,1966,0.012580290694183323
STAT,1895,33,35-39,1928,0.13092033908426137
STAT,1939,27,40-44,1966,0.046535998232659505
STAT,1889,22,50-100,1911,0.004992707250137554
SIM,1935,10,na,1945,60
STAT,1878,41,35-39,1919,0.018779750482690604
STAT,1908,38,15-19,1946,1.7797423443289846E-4
SIM,1784,77,na,1861,2
STAT,1858,32,20-24,1890,0.020568781861105796
STAT,1864,29,50-100,1893,0.0056965400886866075
STAT,1851,20,15-19,1871,0.0337427876523008
STAT,1838,34,45-49,1872,0.016472485533872986
STAT,1882,64,na,1946,16.659449727979876
STAT,1893,28,na,1921,29.985210415512793
STAT,1842,36,na,1878,19.047515878064285
STAT,1922,22,15-19,1944,0.06059765962573899
STAT,1915,45,30-34,1960,8.947209810709989E-4
STAT,1901,44,40-44,1945,0.0021560775980972832
STAT,1823,49,35-39,1872,9.482861601490552E-4
STAT,1905,18,30-34,1923,0.022943114100190294
STAT,1924,42,40-44,1966,0.002955797993212918
STAT,1933,19,na,1952,48.80837950941231
STAT,1953,7,na,1960,47.27351228906806
STAT,1931,15,20-24,1946,1.7748967618221787
STAT,1819,48,na,1867,13.670322228075579
STAT,1876,21,30-34,1897,0.1814558789727292
SIM,1904,39,35-39,1943,1
STAT,1872,49,30-34,1921,9.697493616817816E-4
STAT,1785,74,na,1859,12.528663759188179
STAT,1927,43,20-24,1970,2.2000787908303687E-4
SIM,1858,26,35-39,1884,1
STAT,1789,88,na,1877,0.29596531293941225
STAT,1922,36,25-29,1958,0.011131646146817121
STAT,1876,23,25-29,1899,0.5796160571357013
SIM,1857,11,na,1868,23
SIM,1850,52,na,1902,20
SIM,1930,17,20-24,1947,2
STAT,1905,37,35-39,1942,0.022032926064730073
SIM,1889,20,na,1909,34
SIM,1906,40,na,1946,25
STAT,1872,43,na,1915,23.477089310241098
STAT,1876,57,na,1933,20.41073185682692
SIM,1829,78,na,1907,13
STAT,1931,34,25-29,1965,0.12041688851636403
SIM,1859,13,na,1872,23
STAT,1837,102,na,1939,0.0014175722917179865
STAT,1922,17,20-24,1939,1.5575413957309852
STAT,1793,70,na,1863,3.57461918702373
STAT,1910,30,25-29,1940,0.0892863232237258
STAT,1860,42,40-44,1902,0.018263485666417483
STAT,1925,17,50-100,1942,0.004497503353805629
STAT,1911,17,45-49,1928,9.931856871995906E-4
STAT,1933,36,35-39,1969,0.03284072047695555
STAT,1814,49,40-44,1863,0.0047547772539797625
SIM,1816,49,na,1865,12
STAT,1872,21,50-100,1893,0.004184986769751801
SIM,1812,46,na,1858,18
SIM,1838,51,na,1889,5
SIM,1852,66,na,1918,19
STAT,1825,44,na,1869,14.371074354017944
STAT,1907,46,35-39,1953,0.0011584388856905772
STAT,1923,16,25-29,1939,0.5065752099771097
STAT,1910,25,na,1935,36.185658359865485
SIM,1915,20,25-29,1935,3
STAT,1877,15,40-44,1892,0.0018968091387388066
STAT,1905,0,na,1905,42.37842267433996
STAT,1934,28,15-19,1962,0.009452022575398338
STAT,1833,63,na,1896,13.209975755530314
STAT,1829,58,na,1887,13.70727602440093
STAT,1857,29,30-34,1886,0.1913937722868536
STAT,1924,43,30-34,1967,0.0015084045539881632
STAT,1849,34,20-24,1883,0.021631916372387844
STAT,1880,22,35-39,1902,0.06136317125522924
STAT,1953,8,na,1961,47.26736673247048
STAT,1861,38,15-19,1899,4.69892602352406E-4
STAT,1941,18,50-100,1959,0.0038298064765858605
STAT,1927,32,45-49,1959,0.019257997223771337
STAT,1932,30,50-100,1962,0.010958921271671274
STAT,1868,22,35-39,1890,0.05647258427225991
STAT,1844,15,na,1859,23.062454613398035
STAT,1850,32,na,1882,22.22636185708606
STAT,1886,40,30-34,1926,0.012045450063276477
STAT,1914,39,na,1953,36.877045160372155
STAT,1867,25,25-29,1892,0.40755426498752656
STAT,1910,46,na,1956,34.15185698874788
STAT,1840,46,30-34,1886,7.74765936878378E-4
STAT,1884,76,na,1960,10.885359828998233
STAT,1939,24,35-39,1963,0.09384969098320836
STAT,1806,85,na,1891,1.2827269602253604
SIM,1931,16,25-29,1947,2
STAT,1905,44,25-29,1949,6.348931879078328E-4
SIM,1900,0,na,1900,42
STAT,1880,62,na,1942,19.219563357440048
STAT,1869,43,35-39,1912,0.017418978010696577
SIM,1867,32,na,1899,14
STAT,1837,40,35-39,1877,0.01067537553115791
SIM,1875,39,na,1914,18
STAT,1815,104,na,1919,2.3809829399788838E-4
STAT,1909,41,40-44,1950,0.0023397861854697866
STAT,1802,71,na,1873,5.346794958022614
STAT,1909,36,45-49,1945,0.006447379781102185
SIM,1888,39,50-100,1927,1
STAT,1942,15,45-49,1957,0.005185120610178241
STAT,1826,82,na,1908,3.26055682767221
STAT,1922,29,35-39,1951,0.16743798647457292
SIM,1929,33,30-34,1962,2
STAT,1907,20,25-29,1927,0.8423572482214124
SIM,1860,85,na,1945,3
STAT,1778,92,na,1870,0.1236682400560084
STAT,1840,105,na,1945,2.2975420734170222E-4
SIM,1930,29,35-39,1959,2
STAT,1910,23,35-39,1933,0.08761266815813369
SIM,1832,67,na,1899,18
STAT,1943,28,45-49,1971,0.018256404586595963
SIM,1861,47,na,1908,23
STAT,1823,33,na,1856,17.194313676513932
SIM,1948,15,40-44,1963,1
STAT,1868,0,na,1868,36.43288384195906
STAT,1873,48,35-39,1921,0.0014054849840632498
STAT,1911,15,15-19,1926,0.09065016403781086
STAT,1855,95,na,1950,0.09360987250311577
STAT,1908,37,40-44,1945,0.013943056441099309
STAT,1925,41,25-29,1966,8.603750354135083E-4
SIM,1887,35,45-49,1922,1
STAT,1926,28,45-49,1954,0.020519178250846048
STAT,1840,39,40-44,1879,0.03973669386230732
STAT,1875,24,20-24,1899,0.7039459975831699
STAT,1831,52,na,1883,18.115806188591385
STAT,1925,37,40-44,1962,0.017854715065078203
STAT,1879,13,na,1892,26.68779737633386
SIM,1820,34,na,1854,15
STAT,1838,16,15-19,1854,0.06120165427512723
STAT,1932,26,40-44,1958,0.06083020895898356
STAT,1921,38,30-34,1959,0.020171370625111075
SIM,1906,61,na,1967,20
STAT,1878,27,na,1905,24.63888482783759
SIM,1824,48,na,1872,16
STAT,1866,27,30-34,1893,0.23192065131812178
SIM,1926,9,na,1935,49
STAT,1920,27,50-100,1947,0.010825825225784565
STAT,1891,17,50-100,1908,6.013085828939824E-4
SIM,1943,8,na,1951,49
STAT,1916,44,35-39,1960,0.0020391104398955716
STAT,1936,30,45-49,1966,0.0152090980892231
STAT,1858,28,35-39,1886,0.07462313490492346
STAT,1811,52,na,1863,15.814677443120347
STAT,1937,34,50-100,1971,0.008117796871659672
STAT,1838,62,na,1900,14.185873834865838
STAT,1866,31,15-19,1897,0.0013169082228542501
SIM,1883,58,na,1941,9
STAT,1941,24,40-44,1965,0.0344718569048427
STAT,1924,24,40-44,1948,0.03917055010214908
STAT,1879,35,45-49,1914,0.020828738821854362
STAT,1932,19,50-100,1951,0.004914421361216245
STAT,1943,25,50-100,1968,0.01053249602441533
STAT,1829,47,na,1876,16.681655421007548
SIM,1895,60,na,1955,20
STAT,1912,57,na,1969,33.49254906742509
STAT,1935,26,45-49,1961,0.0234557726853231
STAT,1912,32,20-24,1944,0.023813434120641845
STAT,1904,38,30-34,1942,0.016401394700033413
STAT,1924,38,na,1962,44.03004150174626
SIM,1913,25,20-24,1938,1
SIM,1873,28,na,1901,27
STAT,1847,76,na,1923,10.120516426608877
SIM,1942,23,na,1965,38
STAT,1919,30,45-49,1949,0.016965134470157975
SIM,1863,0,na,1863,35
STAT,1862,44,15-19,1906,1.1753807368526565E-4
STAT,1900,33,50-100,1933,0.012651795213143765
STAT,1849,27,30-34,1876,0.23146034727682163
STAT,1905,25,20-24,1930,0.17046183261118614
STAT,1906,36,40-44,1942,0.013792933475753562
STAT,1909,29,20-24,1938,0.17223283478668616
STAT,1930,28,30-34,1958,0.4956553054588143
SIM,1899,3,na,1902,31
SIM,1845,84,na,1929,4
SIM,1945,20,na,1965,38
STAT,1846,81,na,1927,4.382507564294711
STAT,1945,20,45-49,1965,0.012251664352021165
STAT,1930,35,20-24,1965,0.0034282789477679313
STAT,1877,20,35-39,1897,0.0605967988134132
STAT,1878,28,na,1906,24.55215595324361
SIM,1825,85,na,1910,2
SIM,1837,66,na,1903,26
STAT,1917,38,45-49,1955,0.006981629747274188
STAT,1853,29,na,1882,15.585462283433221
STAT,1916,25,45-49,1941,0.017830372793205443
STAT,1947,23,na,1970,40.976572590549864
STAT,1934,27,40-44,1961,0.06243680041411261
SIM,1832,66,na,1898,18
STAT,1889,44,15-19,1933,1.6679588447805307E-4
STAT,1829,26,50-100,1855,0.009941370326566215
SIM,1914,22,30-34,1936,3
STAT,1875,17,30-34,1892,0.016384056107583707
STAT,1925,34,35-39,1959,0.10769958646399809
STAT,1931,33,50-100,1964,0.0107790369228544
SIM,1925,20,na,1945,41
SIM,1929,34,na,1963,48
STAT,1799,87,na,1886,0.6597358587201312
SIM,1851,26,na,1877,19
STAT,1832,47,35-39,1879,7.443843393638207E-4
STAT,1857,41,15-19,1898,1.0384927099582025E-4
STAT,1931,27,35-39,1958,0.19297307592218643
STAT,1935,31,40-44,1966,0.05393187196834676
SIM,1860,62,na,1922,16
STAT,1831,48,30-34,1879,9.149517334699231E-4
STAT,1921,24,50-100,1945,0.00732783245104303
STAT,1862,44,na,1906,19.67139907925715
SIM,1786,89,na,1875,1
STAT,1916,43,45-49,1959,0.0016882821876230004
STAT,1876,16,35-39,1892,0.005586628337395585
STAT,1876,39,20-24,1915,0.007750297622662542
STAT,1906,22,30-34,1928,0.25877966865018354
STAT,1914,15,20-24,1929,0.2794155641233609
SIM,1845,85,na,1930,2
SIM,1841,71,na,1912,4
STAT,1897,23,45-49,1920,0.009231505688554138
STAT,1809,47,50-100,1856,0.008378966743284125
STAT,1811,50,50-100,1861,5.965447009787556E-4
STAT,1870,32,na,1902,23.705341530339336
STAT,1943,20,na,1963,38.596132929084646
SIM,1868,58,na,1926,30
STAT,1929,35,30-34,1964,0.023327259952959256
SIM,1864,44,na,1908,22
SIM,1894,10,na,1904,32
STAT,1853,36,15-19,1889,3.566045971018562E-4
STAT,1901,47,45-49,1948,0.0018540737352867854
SIM,1821,71,na,1892,3
STAT,1810,51,40-44,1861,1.0117465187508941E-4
STAT,1863,22,50-100,1885,0.003682521239239801
STAT,1899,29,35-39,1928,0.1311433725265834
STAT,1935,19,20-24,1954,1.835286965552667
SIM,1900,35,35-39,1935,1
STAT,1837,77,na,1914,4.179546010350927
STAT,1858,35,25-29,1893,0.022117171267825964
STAT,1803,97,na,1900,0.020133753193444723
SIM,1881,8,na,1889,27
STAT,1867,43,na,1910,21.957880034907937
STAT,1822,37,na,1859,10.29649901897164
STAT,1883,16,50-100,1899,4.769195055652876E-4
STAT,1901,32,na,1933,33.39091057433861
SIM,1921,17,na,1938,34
STAT,1890,37,30-34,1927,0.06473853572164893
STAT,1914,34,25-29,1948,0.09147534489497798
STAT,1918,42,na,1960,39.129763140094084
STAT,1904,34,15-19,1938,0.0011616502790420722
SIM,1834,78,na,1912,4
SIM,1938,25,25-29,1963,1
STAT,1918,35,20-24,1953,0.002779505839748458
STAT,1892,27,50-100,1919,0.007902808669179352
STAT,1811,85,na,1896,1.5535506091017564
STAT,1933,33,30-34,1966,0.2113248852886967
STAT,1946,19,30-34,1965,0.13414769289699266
STAT,1864,24,na,1888,21.245378181447126
STAT,1844,70,na,1914,10.9593432302195
SIM,1867,23,25-29,1890,1
STAT,1840,49,35-39,1889,0.001078278679541108
STAT,1899,30,15-19,1929,0.001965136623914722
STAT,1916,40,40-44,1956,0.002548360798793432
STAT,1810,90,na,1900,0.28338943701684594
STAT,1818,63,na,1881,4.952445069417645
STAT,1833,32,15-19,1865,0.0013574311869502236
STAT,1872,98,na,1970,0.20890915448211847
STAT,1896,56,na,1952,26.791327007326473
STAT,1924,20,25-29,1944,1.0893184209862892
SIM,1936,16,na,1952,38
STAT,1926,26,15-19,1952,0.008443234664113676
SIM,1834,37,na,1871,20
STAT,1842,18,30-34,1860,0.015265794760981713
STAT,1856,22,45-49,1878,0.005866995757117351
STAT,1931,18,25-29,1949,0.5632228557872501
STAT,1921,18,15-19,1939,0.5119302557684893
STAT,1922,33,20-24,1955,0.027242255413412696
STAT,1932,24,na,1956,47.556704217868315
STAT,1859,23,25-29,1882,0.4686861279928881
SIM,1891,46,na,1937,33
STAT,1849,23,15-19,1872,0.030705347072354956
STAT,1886,43,35-39,1929,0.018647277401295164
STAT,1823,46,30-34,1869,6.804448510786342E-4
SIM,1874,65,na,1939,17
STAT,1953,19,na,1972,44.238745356108836
STAT,1933,25,45-49,1958,0.022865592818339133
STAT,1913,39,35-39,1952,0.023431789563086728
STAT,1911,33,45-49,1944,0.01515990344614469
STAT,1912,21,45-49,1933,0.010731134302236515
STAT,1902,21,35-39,1923,0.08253960504547106
STAT,1939,21,30-34,1960,0.2867573497828036
STAT,1854,14,na,1868,17.296939465540458
STAT,1882,38,35-39,1920,0.06744669977674549
STAT,1843,38,50-100,1881,0.005475543333147936
STAT,1942,30,40-44,1972,0.04142922427104537
STAT,1835,20,30-34,1855,0.2058227401292803
STAT,1846,102,na,1948,0.002375972525857518
STAT,1841,51,na,1892,21.17636343344386
STAT,1888,38,na,1926,27.395344605254593
SIM,1915,21,na,1936,39
STAT,1815,47,35-39,1862,0.002017832558253139
STAT,1824,70,na,1894,9.762760074725914
SIM,1791,67,na,1858,5
SIM,1870,51,na,1921,21
STAT,1907,16,40-44,1923,0.0026819882036134496
STAT,1907,43,30-34,1950,0.001159356524293409
SIM,1918,17,20-24,1935,1
SIM,1866,28,35-39,1894,1
STAT,1839,20,15-19,1859,0.023731948193115707
STAT,1869,40,30-34,1909,0.011252014182326882
STAT,1820,37,15-19,1857,5.294698016452892E-4
SIM,1932,20,25-29,1952,3
SIM,1834,24,25-29,1858,1
SIM,1942,7,na,1949,43
STAT,1929,15,50-100,1944,0.004780633634008366
STAT,1873,83,na,1956,4.351119778110576
STAT,1924,46,35-39,1970,0.0015287374564530048
SIM,1915,54,na,1969,31
SIM,1904,58,na,1962,24
STAT,1913,27,20-24,1940,0.18036247512648976
STAT,1920,7,na,1927,44.46597910074632
STAT,1901,32,45-49,1933,0.02440076319744683
STAT,1910,20,30-34,1930,0.2698593700237998
STAT,1850,55,na,1905,18.410195862120798
STAT,1920,20,40-44,1940,0.03728306330592616
SIM,1886,5,na,1891,30
STAT,1802,52,45-49,1854,2.22192416383261E-4
STAT,1837,45,50-100,1882,0.0012732178539509062
SIM,1812,67,na,1879,14
SIM,1881,47,na,1928,22
STAT,1900,34,30-34,1934,0.24003790072346118
STAT,1830,31,35-39,1861,0.06897448906503433
STAT,1863,4,na,1867,26.929247503615954
STAT,1902,58,na,1960,28.9580504137173
SIM,1826,70,na,1896,8
SIM,1943,19,20-24,1962,3
STAT,1873,28,na,1901,24.178197817176994
STAT,1894,37,15-19,1931,7.196723086246399E-4
SIM,1796,66,na,1862,7
STAT,1867,76,na,1943,9.066279344977485
SIM,1842,33,na,1875,26
STAT,1854,25,na,1879,15.45371811606445
SIM,1938,29,40-44,1967,2
STAT,1922,34,50-100,1956,0.009228016902689012
SIM,1900,55,na,1955,28
STAT,1893,15,25-29,1908,0.07178246541556303
STAT,1947,7,na,1954,44.06705527076602
SIM,1928,29,30-34,1957,1
STAT,1817,104,na,1921,5.286233191639464E-4
STAT,1820,89,na,1909,0.5955745033654158
STAT,1869,24,na,1893,22.77247735721775
STAT,1861,102,na,1963,0.009042782137352927
STAT,1883,19,30-34,1902,0.015394766618972027
SIM,1817,45,na,1862,10
STAT,1865,10,na,1875,24.757376899113982
STAT,1936,29,15-19,1965,0.006708597395726138
STAT,1823,39,40-44,1862,0.030923710664870506
SIM,1803,53,na,1856,10
SIM,1854,14,na,1868,19
STAT,1901,29,15-19,1930,0.006303144898452653
STAT,1856,48,35-39,1904,0.0010014631468700603
STAT,1867,47,50-100,1914,0.0023393379415883055
STAT,1939,31,25-29,1970,0.0937114371467772
STAT,1922,40,45-49,1962,0.0019015513567624872
STAT,1801,86,na,1887,0.7182402418408377
SIM,1846,70,na,1916,3
STAT,1922,26,30-34,1948,0.44163792414445946
STAT,1956,15,25-29,1971,0.5704994441509513
STAT,1905,28,25-29,1933,0.6083625987297241
STAT,1858,36,50-100,1894,0.009387409001660409
SIM,1913,28,25-29,1941,1
STAT,1879,17,15-19,1896,0.06142319394898818
STAT,1845,42,35-39,1887,0.010778994178084084
STAT,1926,44,45-49,1970,0.002033220286292924
STAT,1830,34,50-100,1864,0.005645287915330306
STAT,1850,11,na,1861,26.091879365041564
STAT,1892,21,15-19,1913,0.04087944215793748
STAT,1887,19,15-19,1906,0.06442870016153135
STAT,1863,30,35-39,1893,0.09038553908038419
SIM,1839,77,na,1916,9
STAT,1884,51,40-44,1935,1.0363836006601952E-4
STAT,1944,25,20-24,1969,0.196029078978433
SIM,1878,23,35-39,1901,1
STAT,1801,75,na,1876,4.106122040965586
STAT,1814,105,na,1919,1.306593163672201E-4
STAT,1914,24,30-34,1938,0.28937859564317814
STAT,1926,25,40-44,1951,0.05593257988476029
STAT,1821,35,50-100,1856,0.02993038535067719
STAT,1861,28,20-24,1889,0.09865954791663965
STAT,1946,26,20-24,1972,0.2019937664276469
STAT,1908,5,na,1913,38.67268227311069
STAT,1876,46,50-100,1922,0.0025015080990844997
STAT,1824,59,na,1883,14.549058600127077
STAT,1867,22,20-24,1889,0.6621821089355191
STAT,1824,48,na,1872,17.82685482402623
STAT,1864,47,30-34,1911,8.641736590156043E-4
STAT,1853,84,na,1937,2.0907256696520666
STAT,1940,21,20-24,1961,1.125063789707256
STAT,1907,57,na,1964,31.16169689940228
STAT,1794,88,na,1882,0.540376812900717
STAT,1903,15,45-49,1918,9.330266556329003E-4
STAT,1906,32,25-29,1938,0.08544451179096019
SIM,1901,26,40-44,1927,1
STAT,1903,43,na,1946,32.73495435013632
STAT,1891,57,na,1948,24.665483348280038
STAT,1948,17,40-44,1965,0.01590131008671831
SIM,1856,25,na,1881,17
SIM,1826,59,na,1885,14
STAT,1825,30,15-19,1855,0.002085384112270924
STAT,1932,40,25-29,1972,9.66584922348387E-4
STAT,1883,50,na,1933,21.20948363498436
SIM,1818,52,na,1870,24
STAT,1881,32,50-100,1913,0.008718474423916312
STAT,1938,27,25-29,1965,0.6477861827953795
SIM,1869,6,na,1875,19
SIM,1889,64,na,1953,22
STAT,1937,33,15-19,1970,0.0012625563413729563
STAT,1885,30,50-100,1915,0.009120790115017574
SIM,1885,50,na,1935,22
STAT,1846,18,15-19,1864,0.060061511385668405
STAT,1906,25,35-39,1931,0.1411321946626781
STAT,1836,29,na,1865,26.628083085348464
STAT,1874,36,35-39,1910,0.07209953739051571
STAT,1872,48,50-100,1920,0.002481331266013883
STAT,1929,42,20-24,1971,2.2761434916629625E-4
STAT,1947,23,30-34,1970,0.3225035685544669
STAT,1898,26,15-19,1924,0.006141454962501644
STAT,1871,17,na,1888,25.34292579251778
STAT,1941,27,45-49,1968,0.017741999096331337
STAT,1925,31,30-34,1956,0.18602871650531036
STAT,1864,24,45-49,1888,0.0062640828979028465
STAT,1928,38,20-24,1966,0.0033118380116184676
STAT,1800,54,35-39,1854,1.318090607500952E-4
STAT,1815,89,na,1904,0.37500823005070744
STAT,1952,16,15-19,1968,0.540795535354352
STAT,1930,24,15-19,1954,0.06744965957917952
SIM,1873,80,na,1953,1
SIM,1885,61,na,1946,17
STAT,1916,22,40-44,1938,0.03493177284633023
SIM,1869,43,na,1912,16
STAT,1834,23,20-24,1857,0.6466346590915549
STAT,1918,53,na,1971,37.9169985039296
SIM,1835,64,na,1899,13
STAT,1877,19,50-100,1896,5.030119904483876E-4
STAT,1918,38,25-29,1956,0.010273674572941302
STAT,1919,22,45-49,1941,0.012213986548740731
STAT,1836,36,15-19,1872,6.721434858898534E-4
STAT,1869,24,45-49,1893,0.006714339690163675
STAT,1881,24,45-49,1905,0.006593779416230595
STAT,1884,25,25-29,1909,0.4172607535196162
STAT,1888,41,45-49,1929,0.01756884446051081
STAT,1942,30,20-24,1972,0.025822676427072918
SIM,1839,21,20-24,1860,1
STAT,1884,23,30-34,1907,0.17397693612496995
STAT,1946,16,na,1962,40.5482546744541
STAT,1837,31,50-100,1868,0.005667162054416626
STAT,1861,20,25-29,1881,0.5017506385989863
SIM,1956,7,na,1963,47
STAT,1833,35,35-39,1868,0.06684248097788122
SIM,1910,20,25-29,1930,1
SIM,1924,33,30-34,1957,1
SIM,1894,75,na,1969,14
SIM,1924,35,na,1959,48
STAT,1841,34,15-19,1875,0.0016564655571243254
STAT,1813,49,25-29,1862,0.001732762575038654
STAT,1898,38,30-34,1936,0.015441160915772729
SIM,1943,18,na,1961,44
STAT,1939,20,20-24,1959,1.109811726805876
STAT,1897,73,na,1970,19.830559175384114
STAT,1849,38,35-39,1887,0.0555389998760105
STAT,1873,37,30-34,1910,0.05418542412667207
STAT,1925,33,25-29,1958,0.10900134728874797
STAT,1840,66,na,1906,12.843139789615252
SIM,1916,16,na,1932,46
STAT,1823,31,45-49,1854,0.02711607727318851
STAT,1911,19,30-34,1930,0.02410377513802224
STAT,1835,23,35-39,1858,0.0385312035255061
STAT,1946,23,15-19,1969,0.05879955891214001
STAT,1858,36,35-39,1894,0.05408006354229205
SIM,1948,2,na,1950,43
STAT,1903,42,20-24,1945,1.5660000115322694E-4
SIM,1808,62,na,1870,8
STAT,1834,31,20-24,1865,0.024723780019618734
STAT,1919,38,na,1957,40.02676388052623
STAT,1900,41,40-44,1941,0.0021757188927155535
STAT,1828,32,na,1860,19.260756313344398
STAT,1826,32,25-29,1858,0.14508256025442248
STAT,1923,43,na,1966,43.039424331596585
STAT,1894,29,15-19,1923,0.005773056806310886
STAT,1847,22,15-19,1869,0.04320251479168876
SIM,1858,37,na,1895,25
SIM,1865,84,na,1949,1
SIM,1899,19,na,1918,28
SIM,1901,2,na,1903,42
STAT,1780,96,na,1876,0.028739352526268802
STAT,1842,67,na,1909,11.893555693834589
STAT,1920,19,25-29,1939,0.4794725297216572
STAT,1827,38,15-19,1865,4.529605061378248E-4
STAT,1893,23,25-29,1916,0.7195666034677773
STAT,1838,24,15-19,1862,0.03274487512658786
STAT,1934,24,35-39,1958,0.12591702439794958
STAT,1889,54,na,1943,25.63768195928071
STAT,1896,17,15-19,1913,0.07795246069417862
STAT,1901,17,35-39,1918,0.007677916891722283
STAT,1951,21,30-34,1972,0.3414161531014002
SIM,1881,13,na,1894,26
STAT,1822,105,na,1927,1.0400499729611726E-4
SIM,1938,22,20-24,1960,1
STAT,1836,51,na,1887,21.445972442814927
STAT,1874,29,45-49,1903,0.011183424363582125
STAT,1931,30,45-49,1961,0.020550884465106098
STAT,1943,22,35-39,1965,0.09944889765543975
STAT,1897,63,na,1960,24.87162985719102
STAT,1819,101,na,1920,0.002929179569917178
STAT,1820,66,na,1886,9.233780647527823
SIM,1835,54,na,1889,16
STAT,1864,39,30-34,1903,0.04732109479561478
STAT,1872,31,40-44,1903,0.04455332308415365
SIM,1921,3,na,1924,45
STAT,1902,28,20-24,1930,0.16485302739606783
STAT,1944,28,25-29,1972,0.7058904118484641
STAT,1926,37,20-24,1963,0.003203239870567376
STAT,1913,16,15-19,1929,0.09223984157300007
STAT,1916,40,20-24,1956,1.7993031246587568E-4
SIM,1874,27,30-34,1901,1
STAT,1859,24,na,1883,19.22429790417366
SIM,1880,51,na,1931,30
SIM,1873,38,35-39,1911,1
STAT,1945,20,50-100,1965,0.007164716268330207
SIM,1827,35,na,1862,21
STAT,1889,47,35-39,1936,9.623674371771025E-4
STAT,1890,22,45-49,1912,0.008470385344078431
STAT,1863,39,na,1902,20.649821342323463
STAT,1849,24,na,1873,19.757532506115638
STAT,1917,32,35-39,1949,0.09482337488547465
STAT,1902,20,25-29,1922,0.8120866046741451
SIM,1850,31,na,1881,20
SIM,1848,27,na,1875,31
STAT,1833,28,30-34,1861,0.2439575343189883
STAT,1846,44,45-49,1890,0.011965471394260354
STAT,1937,25,15-19,1962,0.006844095452880154
STAT,1865,38,35-39,1903,0.06365636998896823
SIM,1890,51,na,1941,24
STAT,1879,25,15-19,1904,0.004727724956961386
STAT,1812,47,na,1859,12.179934906730052
STAT,1850,96,na,1946,0.07645258488684155
STAT,1815,39,35-39,1854,0.11322984654506063
STAT,1877,37,15-19,1914,5.796616729931842E-4
STAT,1843,24,25-29,1867,0.3004428462270971
STAT,1860,21,20-24,1881,0.5817037964157583
STAT,1916,33,30-34,1949,0.16058950720329532
STAT,1879,43,45-49,1922,0.015378476486880139
STAT,1833,28,45-49,1861,0.010756408960788912
SIM,1892,23,30-34,1915,1
STAT,1926,3,na,1929,49.445106717344814
STAT,1838,52,na,1890,16.622773542177857
STAT,1877,42,50-100,1919,0.01089191516038614
STAT,1851,19,35-39,1870,0.005565965693284961
STAT,1847,40,45-49,1887,0.016494097769293604
SIM,1833,51,35-39,1884,1
SIM,1852,12,na,1864,29
STAT,1866,34,20-24,1900,0.024681534151277464
STAT,1850,86,na,1936,1.9755076658909352
STAT,1884,18,35-39,1902,0.005361903435162544
SIM,1825,54,na,1879,15
SIM,1827,45,na,1872,17
STAT,1832,36,30-34,1868,0.030560933648971614
SIM,1840,36,30-34,1876,1
SIM,1928,1,na,1929,57
STAT,1898,27,na,1925,32.19421914441332
STAT,1932,29,45-49,1961,0.022514211756281544
STAT,1918,23,40-44,1941,0.03582466329433043
SIM,1888,57,na,1945,27
SIM,1842,12,na,1854,30
STAT,1852,77,na,1929,7.397884720535281
SIM,1850,21,na,1871,19
STAT,1867,33,25-29,1900,0.09760404938739418
SIM,1933,18,na,1951,48
STAT,1908,41,25-29,1949,6.610306686149719E-4
SIM,1833,29,35-39,1862,1
STAT,1838,42,45-49,1880,0.013584770021377614
SIM,1891,13,na,1904,38
STAT,1850,27,35-39,1877,0.10109968992917075
STAT,1905,40,45-49,1945,0.0015150924502641383
SIM,1879,74,na,1953,6
STAT,1922,49,50-100,1971,0.0025642276176862954
STAT,1851,26,25-29,1877,0.42116381190716606
STAT,1834,24,30-34,1858,0.16594001258167318
SIM,1886,76,na,1962,10
STAT,1874,33,15-19,1907,0.0014386169244052802
STAT,1836,20,50-100,1856,0.005269312140705837
STAT,1845,15,45-49,1860,4.883507105709194E-4
STAT,1878,53,50-100,1931,1.534199187957269E-4
STAT,1858,40,20-24,1898,0.001220673318677411
SIM,1926,16,na,1942,49
STAT,1890,29,30-34,1919,0.3036990463861464
STAT,1853,28,15-19,1881,0.0029843840747730485
STAT,1899,34,30-34,1933,0.2369656177925377
STAT,1798,92,na,1890,0.21165594300124038
STAT,1870,28,15-19,1898,0.004491164486825077
STAT,1933,25,30-34,1958,0.5185962773485748
STAT,1862,2,na,1864,29.592695784316444
SIM,1884,75,na,1959,11
STAT,1855,42,45-49,1897,0.010524418508720814
STAT,1897,49,35-39,1946,0.0010268121787279315
STAT,1860,46,35-39,1906,0.001141393246679907
STAT,1899,36,25-29,1935,0.03960400151376081
SIM,1858,27,na,1885,24
SIM,1953,18,na,1971,44
STAT,1840,38,30-34,1878,0.048884108126540295
STAT,1947,15,30-34,1962,0.13643656792454642
STAT,1826,51,na,1877,16.852767174948465
STAT,1942,23,30-34,1965,0.2990559970854668
SIM,1930,21,na,1951,46
STAT,1917,29,50-100,1946,0.010269603611657024
STAT,1882,35,15-19,1917,5.432646613966046E-4
STAT,1887,45,45-49,1932,0.002601639463642921
STAT,1888,48,30-34,1936,6.300749832098013E-4
SIM,1876,56,na,1932,27
STAT,1857,37,30-34,1894,0.03989764759162978
STAT,1868,25,40-44,1893,0.029186102749573617
STAT,1862,38,50-100,1900,0.010539991370345956
STAT,1913,43,na,1956,35.85798657481798
STAT,1839,16,30-34,1855,0.011574445078577248
STAT,1860,24,25-29,1884,0.4728873350386661
STAT,1829,26,15-19,1855,0.007050927987997215
STAT,1843,17,35-39,1860,0.0029744985301906673
STAT,1840,23,45-49,1863,0.006898881729659004
STAT,1848,39,30-34,1887,0.034788251513070814
SIM,1891,23,na,1914,38
STAT,1927,21,40-44,1948,0.04133894975304005
STAT,1825,99,na,1924,0.010209901169621389
STAT,1860,17,35-39,1877,0.005144796290442503
STAT,1885,29,20-24,1914,0.1150218184349089
SIM,1946,24,20-24,1970,2
SIM,1901,22,25-29,1923,1
STAT,1858,62,na,1920,13.908022971571228
STAT,1910,15,35-39,1925,0.008302132942148892
STAT,1815,44,15-19,1859,2.0349544659411102E-4
STAT,1813,49,50-100,1862,0.007388307142911411
STAT,1825,36,25-29,1861,0.03076245969037368
SIM,1863,28,na,1891,17
STAT,1938,17,30-34,1955,0.11944286455455004
STAT,1817,47,50-100,1864,0.007102127457198063
STAT,1835,30,25-29,1865,0.06065715801001333
STAT,1924,35,30-34,1959,0.02138859515570535
STAT,1875,32,20-24,1907,0.027785880626985122
STAT,1830,66,na,1896,5.888833989057553
STAT,1839,23,20-24,1862,0.4851292179864573
STAT,1889,44,na,1933,27.915281452811236
SIM,1876,46,na,1922,28
STAT,1814,48,30-34,1862,0.0027300049707254595
STAT,1909,38,na,1947,35.235085849625264
STAT,1843,22,30-34,1865,0.0948414582469446
STAT,1928,27,15-19,1955,0.008654748252935317
STAT,1818,38,20-24,1856,0.009818594735766205
STAT,1876,31,25-29,1907,0.10445370221778047
STAT,1881,39,30-34,1920,0.05020284132068107
STAT,1934,31,25-29,1965,0.1257315308548954
STAT,1944,21,40-44,1965,0.03605232164319957
SIM,1936,20,45-49,1956,1
SIM,1848,82,na,1930,5
STAT,1841,37,35-39,1878,0.08156749937458027
STAT,1903,19,25-29,1922,0.08013370080209135
STAT,1859,35,40-44,1894,0.03512356621729207
STAT,1939,16,35-39,1955,0.041725831758767346
SIM,1808,52,na,1860,15
STAT,1875,25,30-34,1900,0.2606115256903432
STAT,1825,29,35-39,1854,0.19984188374104286
STAT,1866,36,50-100,1902,0.011361706947168586
STAT,1938,24,20-24,1962,1.0924976289290174
STAT,1805,99,na,1904,0.005185444203833774
STAT,1908,34,35-39,1942,0.08507652944944237
STAT,1928,20,45-49,1948,0.014063072467440317
STAT,1878,41,50-100,1919,0.010956346290350985
STAT,1904,60,na,1964,29.241092441278767
STAT,1865,35,15-19,1900,5.127345949062608E-4
STAT,1917,39,20-24,1956,0.002696659030367922
STAT,1885,21,25-29,1906,0.5670156090477564
STAT,1824,37,35-39,1861,0.10298331544877024
STAT,1836,49,50-100,1885,0.002417765718425257
STAT,1839,49,30-34,1888,5.305083275238408E-4
STAT,1892,27,25-29,1919,0.5225949870546803
STAT,1831,33,45-49,1864,0.01819607245207519
STAT,1917,31,25-29,1948,0.09629713118625982
STAT,1849,45,25-29,1894,4.5107804810054996E-4
STAT,1866,81,na,1947,4.980341338191785
SIM,1845,64,na,1909,20
SIM,1903,43,na,1946,35
STAT,1910,22,25-29,1932,0.8621375557683625
STAT,1919,37,15-19,1956,2.0451455739974356E-4
SIM,1847,23,20-24,1870,4
STAT,1899,41,20-24,1940,1.5165324885150683E-4
STAT,1823,38,30-34,1861,0.03797080642204713
STAT,1876,24,35-39,1900,0.05889677860941876
STAT,1907,35,30-34,1942,0.016986458210042576
STAT,1891,28,35-39,1919,0.11801058990255818
STAT,1848,46,35-39,1894,9.079502072501423E-4
STAT,1869,44,na,1913,22.09227441632257
STAT,1848,47,30-34,1895,6.230868997387135E-4
STAT,1870,26,50-100,1896,0.006376438572229928
SIM,1843,73,na,1916,15
STAT,1898,15,25-29,1913,0.07679938674157118
STAT,1919,0,na,1919,49.35381747776096
STAT,1851,16,30-34,1867,0.01645688922382463
STAT,1926,22,35-39,1948,0.113738302613731
STAT,1855,34,45-49,1889,0.012244315774744687
STAT,1883,26,35-39,1909,0.09402050567251438
STAT,1904,48,25-29,1952,4.5971351003505314E-4
STAT,1908,31,30-34,1939,0.14854867566478405
STAT,1918,31,40-44,1949,0.041376553344612384
STAT,1916,41,na,1957,37.788524296531286
STAT,1848,39,45-49,1887,0.013012272215915452
STAT,1837,21,45-49,1858,0.005086138692654447
STAT,1900,44,45-49,1944,0.001421722161912512
STAT,1905,22,15-19,1927,0.04761287907985136
STAT,1884,22,20-24,1906,0.675171502202488
STAT,1878,29,15-19,1907,0.0046506264858940565
STAT,1920,16,20-24,1936,1.5118361185037956
SIM,1947,22,na,1969,39
STAT,1839,36,50-100,1875,0.008181168335979644
STAT,1786,91,na,1877,0.07962883412473194
STAT,1816,51,na,1867,8.445755513302599
SIM,1843,22,25-29,1865,2
STAT,1870,18,20-24,1888,0.17674367407225633
STAT,1899,44,25-29,1943,6.022046358465686E-4
STAT,1867,35,50-100,1902,0.011860595869338936
STAT,1877,29,15-19,1906,0.004649921535853132
STAT,1891,78,na,1969,13.843772679798745
STAT,1909,33,40-44,1942,0.03697753096520674
STAT,1884,26,35-39,1910,0.09485998563687115
STAT,1892,25,30-34,1917,0.3132097129409347
STAT,1898,28,50-100,1926,0.008599080170639033
STAT,1920,42,20-24,1962,1.9338773598682996E-4
STAT,1894,45,na,1939,29.126651668425588
STAT,1932,34,na,1966,50.008871204247775
SIM,1874,75,na,1949,17
SIM,1930,11,na,1941,53
STAT,1943,21,25-29,1964,0.9759081033820224
SIM,1893,58,na,1951,30
SIM,1915,44,na,1959,33
SIM,1868,27,na,1895,35
SIM,1834,68,na,1902,11
SIM,1828,82,na,1910,1
SIM,1889,74,na,1963,18
STAT,1811,75,na,1886,5.788417851318061
STAT,1845,20,40-44,1865,0.01534128687479687
STAT,1912,47,20-24,1959,1.0537550835306818E-4
STAT,1812,92,na,1904,0.16552133181463413
STAT,1825,34,30-34,1859,0.19212134339966916
STAT,1930,16,50-100,1946,0.004832896261737778
STAT,1886,16,45-49,1902,6.792324576490606E-4
STAT,1909,37,20-24,1946,0.0024811549678556235
STAT,1869,78,na,1947,7.570656057504033
STAT,1955,17,30-34,1972,0.16089591932615863
SIM,1840,31,na,1871,17
STAT,1897,31,45-49,1928,0.023251815803034773
SIM,1826,81,na,1907,5
STAT,1888,25,50-100,1913,0.007526148457440799
STAT,1870,86,na,1956,2.4244284179841746
STAT,1945,27,15-19,1972,0.007689397345337715
STAT,1822,47,na,1869,9.248316490224234
STAT,1832,29,40-44,1861,0.017664629491477384
STAT,1854,48,na,1902,13.579022697831943
STAT,1948,21,25-29,1969,1.0539206676823138
STAT,1938,21,15-19,1959,0.052353621168390756
SIM,1951,1,na,1952,52
SIM,1851,21,20-24,1872,1
SIM,1900,45,na,1945,35
SIM,1914,0,na,1914,42
STAT,1822,39,25-29,1861,0.01687754076374337
STAT,1842,25,35-39,1867,0.09082542724130749
SIM,1845,30,na,1875,23
SIM,1940,21,na,1961,32
STAT,1855,18,50-100,1873,4.0785171165541026E-4
STAT,1912,17,25-29,1929,0.08694322249242475
STAT,1838,49,30-34,1887,7.533904024452366E-4
STAT,1852,67,na,1919,13.567058454216026
SIM,1875,29,na,1904,17
STAT,1893,20,20-24,1913,0.8740863975590206
SIM,1938,17,na,1955,37
STAT,1817,42,25-29,1859,0.020284505025613863
STAT,1896,46,na,1942,29.64188359401158
STAT,1865,35,30-34,1900,0.048663168573331736
STAT,1866,37,25-29,1903,0.026516874878698714
STAT,1928,35,15-19,1963,2.4192201632948444E-4
STAT,1848,21,20-24,1869,0.5465572208868729
STAT,1844,38,15-19,1882,4.5871331979682566E-4
STAT,1851,31,20-24,1882,0.02399950467445169
STAT,1843,21,20-24,1864,0.36957797620434923
STAT,1889,15,30-34,1904,0.019604914928320765
SIM,1898,57,na,1955,22
SIM,1920,17,25-29,1937,1
STAT,1839,19,35-39,1858,0.0039146501717291044
SIM,1860,21,na,1881,24
STAT,1858,33,30-34,1891,0.13229812756869774
SIM,1885,29,na,1914,23
STAT,1829,44,45-49,1873,0.012894443750322277
SIM,1923,18,na,1941,38
STAT,1839,101,na,1940,0.0031490215128067685
STAT,1883,19,45-49,1902,6.30932929879436E-4
STAT,1835,34,na,1869,12.152373117215044
STAT,1862,102,na,1964,0.010646112008549194
SIM,1815,64,na,1879,7
STAT,1836,28,15-19,1864,0.0056250938956804615
STAT,1859,20,50-100,1879,0.003749073584821478
STAT,1896,35,45-49,1931,0.02643384916890438
STAT,1879,40,40-44,1919,0.023515135786804288
STAT,1844,28,20-24,1872,0.1113698049138908
STAT,1842,105,na,1947,2.199868224786776E-4
STAT,1855,49,30-34,1904,6.673095569733731E-4
STAT,1914,34,50-100,1948,0.008182867880857097
STAT,1846,41,40-44,1887,0.018687332380160255
SIM,1955,5,na,1960,46
STAT,1851,24,30-34,1875,0.1770097297365142
STAT,1937,33,na,1970,37.15864013079414
STAT,1933,28,35-39,1961,0.19844198389049578
STAT,1847,25,20-24,1872,0.15281442487222063
STAT,1825,34,na,1859,15.664634630989426
STAT,1855,16,15-19,1871,0.04999161423744164
STAT,1894,15,40-44,1909,0.002354961653489419
STAT,1884,33,25-29,1917,0.09992862961499462
STAT,1850,24,30-34,1874,0.18762956300245295
STAT,1874,29,30-34,1903,0.25364233016130083
STAT,1899,37,35-39,1936,0.020898523515693008
STAT,1884,50,50-100,1934,1.5009586629646273E-4
STAT,1947,18,35-39,1965,0.0469300519423178
STAT,1877,30,50-100,1907,0.009534071149840794
STAT,1837,28,15-19,1865,0.002832910658057156
SIM,1825,64,na,1889,12
SIM,1928,17,na,1945,55
STAT,1851,23,20-24,1874,0.6897711074218664
STAT,1956,16,na,1972,48.44436792709889
STAT,1888,19,30-34,1907,0.01852603994270537
SIM,1905,44,na,1949,40
STAT,1901,22,30-34,1923,0.2492417544601118
STAT,1860,96,na,1956,0.08091009448898834
STAT,1889,1,na,1890,33.324674193111086
STAT,1943,25,40-44,1968,0.04932177627115682
SIM,1871,18,15-19,1889,2
SIM,1902,26,na,1928,32
STAT,1949,14,na,1963,45.37679800729348
SIM,1949,4,na,1953,38
STAT,1830,38,20-24,1868,0.004415102953127029
SIM,1830,55,na,1885,14
STAT,1950,17,45-49,1967,0.005870054781159866
STAT,1841,40,50-100,1881,0.011024178772520366
STAT,1887,42,40-44,1929,0.0245207935486993
STAT,1925,26,35-39,1951,0.17682249739380712
STAT,1841,29,35-39,1870,0.11562696426571328
STAT,1914,38,40-44,1952,0.014749118324004275
STAT,1879,54,na,1933,21.672664342035944
STAT,1899,33,20-24,1932,0.03684692710238998
STAT,1835,38,50-100,1873,0.006811556307696206
STAT,1889,48,30-34,1937,6.601249997399092E-4
STAT,1935,23,40-44,1958,0.04556888716416085
STAT,1882,20,45-49,1902,0.006722610940141186
STAT,1887,63,na,1950,19.475818954646996
STAT,1941,17,na,1958,37.637501765846594
STAT,1951,16,35-39,1967,0.04967919034969711
SIM,1818,62,na,1880,18
STAT,1825,33,20-24,1858,0.031012054369450273
STAT,1903,20,40-44,1923,0.029802968410603564
STAT,1904,39,50-100,1943,0.0037589079720710813
STAT,1934,15,na,1949,49.805352645223664
STAT,1863,18,15-19,1881,0.054240473690525516
STAT,1928,35,50-100,1963,0.005289294324865125
SIM,1897,22,20-24,1919,1
STAT,1848,52,na,1900,13.850402888017827
SIM,1798,67,na,1865,9
STAT,1884,45,na,1929,22.26261668429024
STAT,1839,26,25-29,1865,0.2962125674970563
STAT,1782,77,na,1859,2.4902367045321485
STAT,1832,47,na,1879,10.878834497244641
SIM,1851,32,25-29,1883,1
STAT,1899,44,na,1943,31.320059739869905
STAT,1856,81,na,1937,3.917478411644348
STAT,1889,22,20-24,1911,0.8437175087803337
STAT,1913,24,15-19,1937,0.05297036370681938
STAT,1920,39,50-100,1959,0.004548104157815298
STAT,1859,39,20-24,1898,0.006065173247952363
STAT,1940,28,40-44,1968,0.04716987601269694
STAT,1849,39,50-100,1888,0.009541068358592765
STAT,1892,24,20-24,1916,0.8460206172574286
STAT,1873,15,20-24,1888,0.18238686069299048
STAT,1930,38,25-29,1968,0.012769908788891922
STAT,1824,34,30-34,1858,0.2676668280646042
STAT,1881,35,15-19,1916,5.394096916478669E-4
STAT,1924,27,45-49,1951,0.01998436368655456
STAT,1843,25,35-39,1868,0.051103045105270216
STAT,1815,99,na,1914,0.0067605132059333824
STAT,1835,22,25-29,1857,0.4185752947132152
STAT,1911,42,na,1953,35.21882631055564
STAT,1891,25,30-34,1916,0.31117037717911833
STAT,1885,39,15-19,1924,5.489534689535969E-4
STAT,1906,39,45-49,1945,0.006188211625202758
SIM,1853,28,na,1881,25
STAT,1853,22,40-44,1875,0.015473885466126092
STAT,1868,38,na,1906,22.686771093631467
STAT,1862,26,15-19,1888,0.003957228199492071
STAT,1871,39,20-24,1910,0.007608016363570103
STAT,1861,15,50-100,1876,4.791742982920459E-4
STAT,1884,27,50-100,1911,0.006267398645800096
STAT,1924,31,15-19,1955,0.0014903472891471966
SIM,1878,27,na,1905,29
STAT,1927,24,45-49,1951,0.013705603444571229
STAT,1934,21,30-34,1955,0.38473895684273524
STAT,1907,38,35-39,1945,0.022220013622647375
SIM,1865,29,na,1894,22
SIM,1920,11,na,1931,50
STAT,1843,32,25-29,1875,0.05223340377020223
STAT,1833,84,na,1917,2.4628494332989925
STAT,1892,17,30-34,1909,0.019690784959226413
STAT,1831,30,40-44,1861,0.04675467363945945
SIM,1866,46,na,1912,27
SIM,1905,23,20-24,1928,1
STAT,1844,48,na,1892,17.352584711708623
STAT,1847,18,30-34,1865,0.021125337933101316
STAT,1918,20,35-39,1938,0.10123447329268402
STAT,1852,35,50-100,1887,0.010786323782342252
STAT,1891,18,40-44,1909,0.0022390043209219077
SIM,1896,12,na,1908,33
STAT,1920,49,20-24,1969,1.204107989334031E-4
STAT,1833,36,30-34,1869,0.049846760095968265
STAT,1871,27,na,1898,23.793645209005778
STAT,1832,67,na,1899,7.165324450717565
STAT,1917,35,40-44,1952,0.015553726168136023
STAT,1845,65,na,1910,9.878656198857199
STAT,1909,22,35-39,1931,0.08702155793342296
SIM,1865,30,na,1895,24
STAT,1874,45,na,1919,23.05199123963741
STAT,1793,93,na,1886,0.03831103409370259
STAT,1897,38,30-34,1935,0.07042337469406253
STAT,1823,53,na,1876,13.594783601909905
STAT,1838,20,35-39,1858,0.05961456519796777
STAT,1901,32,25-29,1933,0.1433215862435989
STAT,1919,43,50-100,1962,0.001260075046993573
STAT,1950,21,15-19,1971,0.06277960583259436
SIM,1934,33,40-44,1967,1
STAT,1851,34,25-29,1885,0.08815123628722647
SIM,1939,22,20-24,1961,1
SIM,1856,24,25-29,1880,1
STAT,1872,37,15-19,1909,5.745567443135487E-4
STAT,1897,24,20-24,1921,0.9093983266220913
STAT,1899,26,30-34,1925,0.34590649366617415
STAT,1900,15,40-44,1915,0.0025480677098430786
STAT,1892,28,35-39,1920,0.11878400290685194
STAT,1840,34,15-19,1874,0.0013312161670980855
SIM,1820,55,na,1875,10
STAT,1851,48,35-39,1899,0.0011670723710481758
STAT,1841,19,40-44,1860,0.0022818741529256068
STAT,1952,19,20-24,1971,1.6140068107975885
STAT,1850,17,40-44,1867,0.001990006700378715
STAT,1859,24,35-39,1883,0.047433700502997965
STAT,1845,23,45-49,1868,0.005023987709285056
STAT,1848,38,35-39,1886,0.04664963250448572
STAT,1828,38,15-19,1866,2.496863774032156E-4
STAT,1916,7,na,1923,41.91026887008838
STAT,1938,32,20-24,1970,0.024364191327849023
SIM,1937,32,na,1969,39
SIM,1843,28,na,1871,22
SIM,1881,77,na,1958,6
STAT,1923,20,45-49,1943,0.013078754555757759
SIM,1861,18,20-24,1879,2
SIM,1835,20,25-29,1855,1
SIM,1948,20,20-24,1968,3
STAT,1853,18,20-24,1871,0.13324215078254456
STAT,1929,34,20-24,1963,0.030794890026154792
STAT,1910,19,15-19,1929,0.0888969609254055
STAT,1834,80,na,1914,4.371591931312788
SIM,1897,62,na,1959,36
STAT,1855,31,40-44,1886,0.031413920215557264
STAT,1902,27,na,1929,33.65443209958121
STAT,1861,82,na,1943,3.923750707310295
STAT,1859,78,na,1937,6.210164292500519
STAT,1876,2,na,1878,33.09827152508249
STAT,1848,24,25-29,1872,0.44431545612022283
STAT,1857,36,35-39,1893,0.053203302345221616
STAT,1944,24,45-49,1968,0.01205229493767534
STAT,1924,38,35-39,1962,0.02830725628029615
STAT,1816,46,25-29,1862,7.370721029175093E-4
SIM,1820,65,na,1885,8
STAT,1895,29,15-19,1924,0.0058481184756808925
STAT,1883,37,25-29,1920,0.02795935009047347
STAT,1883,23,15-19,1906,0.031937218929487046
STAT,1943,29,na,1972,39.56696980860065
STAT,1829,41,40-44,1870,0.020182420687663558
STAT,1874,55,na,1929,20.97677647143822
STAT,1941,19,45-49,1960,0.005104621392425405
SIM,1792,73,na,1865,4
STAT,1804,73,na,1877,5.952392579356882
STAT,1841,26,30-34,1867,0.30835924709143336
SIM,1803,63,na,1866,5
SIM,1948,17,na,1965,35
STAT,1802,92,na,1894,0.12719946004784824
STAT,1869,39,15-19,1908,5.38628624673771E-4
STAT,1839,38,40-44,1877,0.028570325664924675
SIM,1805,88,na,1893,1
STAT,1831,36,15-19,1867,5.803212368222304E-4
STAT,1867,23,30-34,1890,0.16992981422073908
STAT,1889,39,35-39,1928,0.08572446931033924
STAT,1882,74,na,1956,10.968421488629895
STAT,1805,53,50-100,1858,2.8640161072745573E-4
STAT,1865,85,na,1950,2.4795112229132608
STAT,1861,27,50-100,1888,0.005418611885343539
STAT,1902,24,40-44,1926,0.02920163509846044
STAT,1907,27,45-49,1934,0.016240976202645016
STAT,1928,21,40-44,1949,0.04190160309117912
STAT,1825,65,na,1890,9.110645054078073
STAT,1929,20,45-49,1949,0.01424519607555873
STAT,1927,39,15-19,1966,2.3703042467769614E-4
SIM,1946,25,30-34,1971,3
STAT,1914,16,30-34,1930,0.025065869960249093
SIM,1852,87,na,1939,2
STAT,1922,20,50-100,1942,0.00753513310152818
STAT,1884,7,na,1891,25.526027969771516
STAT,1857,29,45-49,1886,0.008438803470499192
STAT,1896,32,40-44,1928,0.056964332313162114
SIM,1803,76,na,1879,3
STAT,1825,37,35-39,1862,0.07414772759100545
STAT,1856,30,45-49,1886,0.013055837846008065
STAT,1889,25,25-29,1914,0.521423375132017
SIM,1865,20,na,1885,25
STAT,1947,25,25-29,1972,0.7402015120708547
STAT,1926,33,40-44,1959,0.04701930695646313
STAT,1827,46,na,1873,15.509457747316524
STAT,1888,26,20-24,1914,0.13756397780306873
STAT,1839,45,30-34,1884,5.584039014942259E-4
STAT,1833,24,15-19,1857,0.03236321404642863
STAT,1856,19,35-39,1875,0.004645010324496753
STAT,1867,30,20-24,1897,0.02607513044584664
STAT,1808,86,na,1894,0.32398997946596203
SIM,1854,78,na,1932,3
STAT,1877,26,45-49,1903,0.011500558657190803
STAT,1889,18,35-39,1907,0.006700418773420475
STAT,1912,37,na,1949,36.432406745208034
STAT,1906,21,20-24,1927,1.0041942435642566
STAT,1933,6,na,1939,53.43518708502676
STAT,1842,13,na,1855,22.89558
STAT,1890,62,na,1952,22.20150309479273
STAT,1938,25,30-34,1963,0.38596074333364705
STAT,1817,46,na,1863,23.276296234969212
SIM,1847,38,40-44,1885,1
STAT,1953,18,25-29,1971,0.5210245363338825
STAT,1869,42,50-100,1911,0.010223797032323989
STAT,1891,29,30-34,1920,0.30686451461548053
STAT,1910,37,45-49,1947,0.006480105614346647
STAT,1892,74,na,1966,16.93583834061733
STAT,1892,16,35-39,1908,0.0067954435364438945
STAT,1873,22,45-49,1895,0.0070896169842123
STAT,1888,58,na,1946,23.11016525792733
STAT,1863,102,na,1965,0.01247739913829726
STAT,1810,44,30-34,1854,0.011335916766817144
STAT,1910,56,na,1966,32.797703759351414
STAT,1861,24,40-44,1885,0.017745395326403696
SIM,1926,0,na,1926,52
STAT,1935,27,20-24,1962,0.24772192628460596
STAT,1898,48,25-29,1946,4.327991864979321E-4
STAT,1776,91,na,1867,0.12208907184476803
STAT,1937,1,na,1938,40.37001969376401
SIM,1856,46,na,1902,11
STAT,1918,27,20-24,1945,0.19250397204027367
STAT,1806,51,na,1857,16.243048545089447
SIM,1867,11,na,1878,18
STAT,1921,37,20-24,1958,0.0029204563068188387
STAT,1841,38,30-34,1879,0.06082771784455729
SIM,1855,30,na,1885,20
STAT,1865,28,40-44,1893,0.026999123692370074
STAT,1865,25,50-100,1890,0.00582519038074883
STAT,1833,53,na,1886,16.10430687186993
STAT,1936,18,25-29,1954,0.41129994124270464
STAT,1907,26,50-100,1933,0.009389221509521737
SIM,1889,23,25-29,1912,1
STAT,1833,27,35-39,1860,0.0941530326549023
STAT,1898,37,35-39,1935,0.09541377179432924
STAT,1911,22,40-44,1933,0.03168294165597694
STAT,1915,45,50-100,1960,0.0022700771940432334
STAT,1854,30,50-100,1884,0.0058555117810142705
STAT,1894,19,20-24,1913,0.22598895359974638
STAT,1902,37,na,1939,33.48583470355186
STAT,1851,15,35-39,1866,0.0056990537786883394
STAT,1893,59,na,1952,24.504699433164838
STAT,1826,36,40-44,1862,0.05190582860024342
STAT,1814,52,50-100,1866,4.1488382058531677E-4
STAT,1906,17,35-39,1923,0.00797173328147759
STAT,1851,82,na,1933,3.9390331057788384
STAT,1905,55,na,1960,30.811233755146574
SIM,1854,68,na,1922,9
STAT,1827,28,20-24,1855,0.16657207787144168
STAT,1856,26,na,1882,18.04468509808784
STAT,1856,37,30-34,1893,0.038609238786391685
STAT,1831,29,25-29,1860,0.45172208944677295
SIM,1829,42,45-49,1871,1
STAT,1925,23,30-34,1948,0.34082110479621663
STAT,1898,34,15-19,1932,0.0019046332256862978
STAT,1882,33,na,1915,22.772556088478307
SIM,1891,77,na,1968,18
STAT,1862,15,45-49,1877,6.531392635840517E-4
STAT,1879,21,35-39,1900,0.06058014848452186
STAT,1888,33,45-49,1921,0.020292275523246812
STAT,1915,26,40-44,1941,0.04729281093238216
STAT,1863,41,50-100,1904,0.009396123516868051
STAT,1842,18,45-49,1860,6.256471990692308E-4
STAT,1893,27,40-44,1920,0.037770386998303734
STAT,1830,35,na,1865,9.856045553806217
STAT,1856,23,20-24,1879,0.5756402558103391
STAT,1882,16,25-29,1898,0.054440117901955375
STAT,1956,16,35-39,1972,0.05522763346091574
STAT,1872,34,45-49,1906,0.01768951069947505
STAT,1926,29,20-24,1955,0.21601625320100407
STAT,1874,24,50-100,1898,0.004111100331130987
STAT,1930,16,15-19,1946,0.5854249523026733
STAT,1882,43,50-100,1925,0.010051304252141556
STAT,1842,29,35-39,1871,0.08824488035009263
STAT,1854,19,50-100,1873,3.5401283876258175E-4
STAT,1851,27,35-39,1878,0.09537744747917969
STAT,1857,44,20-24,1901,0.001172839375356652
STAT,1842,36,25-29,1878,0.025605290618869805
SIM,1887,62,na,1949,18
SIM,1917,22,na,1939,45
SIM,1952,17,20-24,1969,1
STAT,1901,42,na,1943,32.4121967683311
STAT,1833,39,35-39,1872,0.06412305182805457
STAT,1853,25,45-49,1878,0.008201100311707944
STAT,1927,28,25-29,1955,0.7932965602060411
STAT,1838,83,na,1921,3.0812012255022414
STAT,1871,37,50-100,1908,0.01224059973064823
STAT,1852,26,40-44,1878,0.030076981502522967
STAT,1867,26,35-39,1893,0.0926533142569922
STAT,1944,17,20-24,1961,1.4484194241977895
SIM,1875,30,na,1905,17
STAT,1889,36,50-100,1925,0.015103991982280357
STAT,1917,24,35-39,1941,0.09854333332994127
STAT,1951,20,20-24,1971,1.321352881521179
STAT,1816,39,35-39,1855,0.10407923788195317
STAT,1847,32,45-49,1879,0.02187182624533299
STAT,1821,49,50-100,1870,0.0033686443781424493
STAT,1897,17,30-34,1914,0.021165875306732924
STAT,1892,46,30-34,1938,6.764881040394489E-4
STAT,1887,20,30-34,1907,0.19558248399101652
SIM,1935,28,25-29,1963,2
STAT,1836,25,45-49,1861,0.014066581764143537
SIM,1937,27,30-34,1964,1
STAT,1885,38,50-100,1923,0.012064005858851689
STAT,1887,27,15-19,1914,0.0049521983361588435
STAT,1851,72,na,1923,10.661749171043507
STAT,1926,28,50-100,1954,0.011821962746537452
SIM,1937,22,na,1959,39
STAT,1880,39,15-19,1919,5.845519622833914E-4
STAT,1842,22,15-19,1864,0.031219416515690088
STAT,1866,49,40-44,1915,0.001543799697929433
STAT,1835,65,na,1900,7.601330599285053
STAT,1912,28,15-19,1940,0.006878158853450335
STAT,1873,60,na,1933,19.390155032341468
STAT,1843,24,50-100,1867,0.002140211409110711
STAT,1901,39,45-49,1940,0.0059601309889647704
STAT,1901,25,35-39,1926,0.13593044612821809
STAT,1861,27,na,1888,20.21540887646483
STAT,1929,27,30-34,1956,0.48803648751110645
STAT,1844,20,25-29,1864,0.5663909036403583
SIM,1931,37,na,1968,55
STAT,1888,15,15-19,1903,0.06967325865599135
STAT,1930,22,na,1952,46.56314252422559
STAT,1936,22,45-49,1958,0.010692145480403023
SIM,1793,68,na,1861,16
STAT,1850,32,50-100,1882,0.008534011188193863
STAT,1908,45,40-44,1953,0.0014393037299613074
STAT,1816,43,20-24,1859,0.0021305546581929596
STAT,1921,38,50-100,1959,0.0046467572711718355
STAT,1901,44,50-100,1945,0.0010126780394839137
STAT,1817,49,45-49,1866,0.0066279651302853385
STAT,1939,23,25-29,1962,0.9209806091825057
STAT,1903,28,50-100,1931,0.009062705516199724
STAT,1929,23,15-19,1952,0.06678719643169953
STAT,1851,27,na,1878,21.38343300042173
STAT,1891,25,15-19,1916,0.005606359801880777
STAT,1870,96,na,1966,0.3316219581680849
STAT,1855,20,35-39,1875,0.04869522534329276
STAT,1898,58,na,1956,26.898210935980543
SIM,1811,51,na,1862,11
STAT,1865,20,45-49,1885,0.0064765235348126365
STAT,1867,37,40-44,1904,0.04189097554591158
STAT,1900,56,na,1956,28.498568836653277
STAT,1834,34,25-29,1868,0.09081153148726862
STAT,1843,46,35-39,1889,5.98724112213047E-4
STAT,1843,94,na,1937,0.0847796584024954
STAT,1883,34,20-24,1917,0.026024169788570813
STAT,1939,14,na,1953,39.17646198232152
STAT,1886,27,15-19,1913,0.004706103603967905
SIM,1880,82,na,1962,10
STAT,1877,23,40-44,1900,0.021443880168453357
STAT,1847,47,30-34,1894,0.0010292326117442828
STAT,1916,36,35-39,1952,0.024675833069145645
STAT,1824,34,15-19,1858,0.0021831859866910546
SIM,1809,47,na,1856,4
SIM,1836,49,na,1885,4
SIM,1875,37,40-44,1912,1
STAT,1865,41,na,1906,20.99946068518269
STAT,1926,36,45-49,1962,0.008291420544196343
STAT,1819,36,15-19,1855,6.864860757976243E-4
STAT,1874,28,35-39,1902,0.09754298584866263
STAT,1924,15,na,1939,43.748961003353976
SIM,1852,20,25-29,1872,1
STAT,1908,22,na,1930,34.90094979537394
STAT,1850,28,30-34,1878,0.2619568417507639
STAT,1900,18,45-49,1918,9.03442173916239E-4
SIM,1866,56,na,1922,27
SIM,1914,24,25-29,1938,1
SIM,1909,37,na,1946,37
STAT,1843,53,na,1896,8.986949363909762
STAT,1905,36,25-29,1941,0.009012183327748603
SIM,1851,16,na,1867,26
STAT,1911,18,20-24,1929,0.26884442700038236
SIM,1826,50,na,1876,14
STAT,1866,24,50-100,1890,0.0037321632665360004
STAT,1847,97,na,1944,0.05738828007640195
STAT,1864,32,45-49,1896,0.015640740281252792
STAT,1881,21,40-44,1902,0.019888209743742072
STAT,1889,36,30-34,1925,0.06556577036709532
STAT,1879,36,20-24,1915,0.008016763362249105
STAT,1933,21,15-19,1954,0.07053405364464728
SIM,1888,24,20-24,1912,2
STAT,1806,49,35-39,1855,0.004585303846750403
STAT,1892,39,40-44,1931,0.05353571318482635
SIM,1866,15,na,1881,35
STAT,1951,17,na,1968,43.56520378101387
SIM,1905,6,na,1911,40
SIM,1891,27,30-34,1918,1
STAT,1883,5,na,1888,25.703105854925067
STAT,1909,48,na,1957,33.475469318203984
STAT,1875,28,35-39,1903,0.09883627150157585
STAT,1886,26,na,1912,24.83955287207423
STAT,1825,48,40-44,1873,0.0015588528595167853
SIM,1847,42,na,1889,17
STAT,1938,28,35-39,1966,0.14768871076854806
STAT,1892,33,na,1925,29.35626072308477
STAT,1846,26,15-19,1872,0.004480348783005137
STAT,1856,26,25-29,1882,0.31984428480184574
STAT,1941,22,50-100,1963,0.006750550340688126
STAT,1940,9,na,1949,39.968013354305846
SIM,1904,38,na,1942,28
STAT,1903,23,45-49,1926,0.009883417736347608
STAT,1889,29,40-44,1918,0.03641351080342157
STAT,1906,24,25-29,1930,0.8264668871085429
STAT,1879,29,30-34,1908,0.25877237198846137
SIM,1922,5,na,1927,53
STAT,1883,59,na,1942,18.872620100430197
STAT,1862,67,na,1929,13.676698774960142
STAT,1866,16,40-44,1882,0.001739250132879379
STAT,1943,29,20-24,1972,0.19279860437882254
STAT,1810,47,35-39,1857,0.0013653328157146004
STAT,1838,35,20-24,1873,0.007370800690289888
STAT,1856,16,30-34,1872,0.0137339007399899
STAT,1915,55,na,1970,35.547906062299354
SIM,1893,48,na,1941,35
STAT,1914,30,45-49,1944,0.01583459972211092
STAT,1848,35,30-34,1883,0.036263605267128345
STAT,1810,54,50-100,1864,1.3676424407377513E-4
STAT,1875,35,50-100,1910,0.012740343849553882
STAT,1857,33,15-19,1890,0.0010615764533068311
STAT,1890,52,na,1942,26.016068985650303
STAT,1832,39,35-39,1871,0.039313695183275224
SIM,1849,23,na,1872,11
SIM,1861,57,na,1918,22
SIM,1883,48,na,1931,10
STAT,1875,85,na,1960,4.114628608752216
SIM,1887,29,30-34,1916,1
STAT,1882,27,30-34,1909,0.24132916990172898
STAT,1941,16,40-44,1957,0.01430653029246752
SIM,1898,47,na,1945,29
STAT,1931,26,25-29,1957,0.8463852093794458
SIM,1822,36,na,1858,19
STAT,1896,44,50-100,1940,9.50631413121734E-4
STAT,1839,48,35-39,1887,7.771573231262442E-4
STAT,1851,45,30-34,1896,8.253628114030788E-4
STAT,1817,91,na,1908,0.4592585968963332
STAT,1916,43,25-29,1959,7.243840552985278E-4
SIM,1906,8,na,1914,29
STAT,1834,27,35-39,1861,0.08941279588563837
STAT,1799,64,na,1863,9.362723067099688
STAT,1839,30,45-49,1869,0.012091206391231766
STAT,1829,27,na,1856,19.61534849830425
STAT,1829,30,35-39,1859,0.09948306956228754
STAT,1880,18,15-19,1898,0.06224145135261256
STAT,1896,21,35-39,1917,0.07688254778006351
STAT,1947,22,20-24,1969,1.2481197134014077
STAT,1864,102,na,1966,0.014368353811231645
STAT,1925,30,20-24,1955,0.028816231962949253
STAT,1860,86,na,1946,1.8037928214819252
STAT,1888,2,na,1890,31.150849599467424
STAT,1915,29,45-49,1944,0.017344234566358183
STAT,1839,27,na,1866,15.039377581548665
STAT,1864,25,20-24,1889,0.10634673513698382
SIM,1810,55,na,1865,16
SIM,1846,28,30-34,1874,1
STAT,1884,47,35-39,1931,0.0013652580152170974
STAT,1873,44,50-100,1917,0.010595886841176684
STAT,1844,24,40-44,1868,0.020031525066797364
STAT,1929,14,na,1943,50.16213123782374
STAT,1824,38,30-34,1862,0.07595430774270835
STAT,1876,26,na,1902,24.3218024449407
STAT,1888,30,40-44,1918,0.05108614695391718
STAT,1864,45,na,1909,20.380516065335126
STAT,1769,98,na,1867,0.027393075190117935
STAT,1880,29,20-24,1909,0.12248074467895095
STAT,1857,47,25-29,1904,4.2918795695472513E-4
SIM,1861,16,na,1877,29
STAT,1851,38,40-44,1889,0.036966144133940795
STAT,1901,36,40-44,1937,0.013284563492101786
STAT,1840,20,40-44,1860,0.02106647743870673
STAT,1929,41,45-49,1970,0.002148111079202205
SIM,1852,24,40-44,1876,1
STAT,1871,16,15-19,1887,0.059902443240269346
SIM,1910,45,na,1955,31
STAT,1848,17,35-39,1865,0.004398892127961079
STAT,1904,26,15-19,1930,0.0065233713593112735
STAT,1907,26,na,1933,35.02870400444756
STAT,1856,71,na,1927,9.669740782954769
STAT,1917,9,na,1926,42.310144356102064
STAT,1926,18,15-19,1944,0.5517916474002069
STAT,1824,80,na,1904,4.304267832329646
STAT,1890,8,na,1898,31.576763448161028
STAT,1819,54,50-100,1873,1.261131158902806E-4
STAT,1906,41,na,1947,33.84647802530476
STAT,1841,15,25-29,1856,0.07238779590724999
STAT,1887,73,na,1960,14.525680358474263
STAT,1846,37,20-24,1883,0.006523806691970116
STAT,1797,86,na,1883,0.6360980546782545
SIM,1882,63,na,1945,27
STAT,1863,18,50-100,1881,4.4777487106203415E-4
SIM,1830,65,na,1895,7
STAT,1905,42,50-100,1947,0.0010574898647883588
STAT,1849,78,na,1927,6.058385815683329
SIM,1860,31,na,1891,25
STAT,1918,16,15-19,1934,0.0984491694889153
STAT,1861,27,45-49,1888,0.009404991838608375
STAT,1878,33,35-39,1911,0.10411239085176158
STAT,1868,29,20-24,1897,0.11271914462898255
STAT,1890,18,25-29,1908,0.0686535697485668
STAT,1872,16,15-19,1888,0.06128123438725005
SIM,1944,15,20-24,1959,1
SIM,1885,81,na,1966,11
STAT,1950,21,50-100,1971,0.0077601499456092715
STAT,1883,27,30-34,1910,0.24453676057516635
STAT,1838,28,30-34,1866,0.2468345383127075
STAT,1850,24,15-19,1874,0.03475098797080498
STAT,1936,15,20-24,1951,1.2961386888835391
STAT,1836,22,40-44,1858,0.0265409112003563
STAT,1892,49,35-39,1941,9.55251673358145E-4
STAT,1852,15,35-39,1867,0.0057472795648017905
SIM,1940,11,na,1951,37
STAT,1914,23,20-24,1937,1.123124856606218
SIM,1843,83,na,1926,2
STAT,1917,21,30-34,1938,0.30360348372988194
STAT,1913,38,25-29,1951,0.009587639480211806
STAT,1816,61,na,1877,6.808829308483498
STAT,1893,16,35-39,1909,0.006935541429687166
STAT,1854,0,na,1854,24.60407106469263
STAT,1945,21,na,1966,39.749009426123436
STAT,1849,42,20-24,1891,0.001229906348871055
SIM,1856,7,na,1863,23
STAT,1842,33,20-24,1875,0.024246245090295573
STAT,1934,35,40-44,1969,0.020606090685766704
STAT,1843,39,45-49,1882,0.008798802847348162
STAT,1842,26,30-34,1868,0.23533546035072267
SIM,1874,34,na,1908,25
STAT,1866,26,na,1892,22.05486643858396
STAT,1837,32,35-39,1869,0.06196833179865448
STAT,1923,28,40-44,1951,0.052956171384774535
STAT,1867,8,na,1875,26.399582470664804
STAT,1864,18,30-34,1882,0.014701561887569693
STAT,1782,87,na,1869,0.42610418145586293
STAT,1865,39,30-34,1904,0.047720190990759165
STAT,1897,27,25-29,1924,0.5617440013096169
STAT,1849,35,30-34,1884,0.04317385283241125
STAT,1823,34,15-19,1857,0.0011335585977867582
STAT,1948,22,20-24,1970,1.2682951964837885
SIM,1896,22,na,1918,33
STAT,1918,34,45-49,1952,0.01642820181368802
STAT,1885,25,40-44,1910,0.029782328657068997
STAT,1854,28,15-19,1882,0.002886332215882251
SIM,1846,49,na,1895,13
SIM,1925,21,30-34,1946,1
STAT,1859,31,25-29,1890,0.08174264153267725
STAT,1852,22,25-29,1874,0.5820205009161438
STAT,1875,35,25-29,1910,0.029877563231708034
STAT,1879,44,na,1923,23.59866645808606
STAT,1940,20,45-49,1960,0.01138855583011254
STAT,1894,11,na,1905,33.14661591416236
STAT,1903,16,20-24,1919,0.25267145805476565
SIM,1858,82,na,1940,2
STAT,1907,31,15-19,1938,0.0012009871498212927
SIM,1911,16,20-24,1927,2
STAT,1869,21,40-44,1890,0.02025184459765332
STAT,1833,24,30-34,1857,0.17473735463255635
STAT,1845,26,15-19,1871,0.003251439956219144
STAT,1911,25,45-49,1936,0.016852902294274046
SIM,1927,22,na,1949,52
STAT,1903,23,na,1926,33.52078044883872
STAT,1848,93,na,1941,0.1890005510127314
STAT,1890,25,15-19,1915,0.00554852726344828
STAT,1933,17,45-49,1950,0.006659834885827832
SIM,1870,31,na,1901,24
STAT,1942,26,35-39,1968,0.15649830846317359
STAT,1841,72,na,1913,12.361402836791392
STAT,1868,39,15-19,1907,5.379637211750292E-4
STAT,1860,16,45-49,1876,6.161044908360516E-4
STAT,1810,69,na,1879,5.9548840716227085
STAT,1841,35,20-24,1876,0.009076256290481624
STAT,1925,45,na,1970,44.44712863877084
SIM,1889,29,35-39,1918,1
SIM,1901,63,na,1964,30
SIM,1859,67,na,1926,10
SIM,1867,86,na,1953,1
STAT,1815,43,25-29,1858,0.009691918179161482
STAT,1849,39,40-44,1888,0.03401857034807011
STAT,1861,34,35-39,1895,0.08443497950204104
STAT,1847,14,na,1861,31.539856211048065
STAT,1877,41,35-39,1918,0.01877690381549178
SIM,1892,7,na,1899,36
STAT,1814,59,na,1873,11.041281259554815
STAT,1865,27,50-100,1892,0.005785936686441944
STAT,1886,47,45-49,1933,0.002436536035560081
STAT,1864,35,15-19,1899,5.084464639977822E-4
STAT,1921,31,na,1952,41.93081029228988
STAT,1835,24,40-44,1859,0.013040020497019906
SIM,1907,22,25-29,1929,1
SIM,1892,61,na,1953,28
STAT,1872,32,45-49,1904,0.01784226908474482
STAT,1890,44,50-100,1934,0.012659533625988737
STAT,1832,40,20-24,1872,8.961632619721521E-4
STAT,1845,26,20-24,1871,0.08407294676528249
STAT,1946,17,15-19,1963,0.49981506142581916
SIM,1848,44,40-44,1892,1
STAT,1885,18,45-49,1903,6.433793277472223E-4
STAT,1856,50,na,1906,15.822418429164276
STAT,1798,71,na,1869,10.996428117678203
STAT,1853,20,50-100,1873,0.003072115042887271
STAT,1839,70,na,1909,7.74295160203661
STAT,1882,34,25-29,1916,0.09731896023475241
STAT,1936,31,40-44,1967,0.03780274747284077
STAT,1877,52,45-49,1929,1.490085043680343E-4
STAT,1850,44,30-34,1894,0.010098072379310536
STAT,1945,24,45-49,1969,0.0122348881889388
STAT,1882,23,15-19,1905,0.03151829816954566
STAT,1884,31,25-29,1915,0.10076221776890379
SIM,1922,33,na,1955,45
STAT,1946,15,na,1961,40.55839427302235
STAT,1892,41,30-34,1933,0.014267354849045767
STAT,1872,13,na,1885,26.8072414108089
STAT,1896,49,25-29,1945,4.1787264804336627E-4
STAT,1912,27,50-100,1939,0.0097320333398857
STAT,1861,42,40-44,1903,0.018892121387896334
STAT,1824,38,25-29,1862,0.04103278671621933
STAT,1875,44,35-39,1919,0.018362862761177736
STAT,1858,24,35-39,1882,0.045699496803564284
STAT,1856,16,25-29,1872,0.048828519976575446
STAT,1817,40,25-29,1857,0.021585228125384145
STAT,1826,46,35-39,1872,0.0014284932512390767
STAT,1926,15,50-100,1941,0.004588427069872686
STAT,1836,53,40-44,1889,1.0078526727584671E-4
STAT,1810,45,na,1855,10.815822740555674
STAT,1852,41,30-34,1893,0.00988393602539899
STAT,1823,95,na,1918,0.07646105804814245
SIM,1888,56,na,1944,29
STAT,1833,27,40-44,1860,0.029230336552445117
SIM,1854,36,na,1890,17
STAT,1866,35,25-29,1901,0.02676870885256291
SIM,1821,41,na,1862,15
STAT,1893,37,35-39,1930,0.08918086542854521
STAT,1820,41,40-44,1861,0.020204383992379026
STAT,1851,23,40-44,1874,0.020857627528567606
STAT,1874,28,40-44,1902,0.030282766516266275
STAT,1893,40,35-39,1933,0.023062525514129992
STAT,1844,57,na,1901,15.697128355668353
STAT,1832,48,30-34,1880,5.081366142472679E-4
STAT,1879,37,30-34,1916,0.05516166299202129
STAT,1831,28,15-19,1859,0.004897020149168157
STAT,1880,39,20-24,1919,0.008024303199942634
STAT,1843,30,25-29,1873,0.05332950051857817
STAT,1889,77,na,1966,14.186094330549391
SIM,1806,52,na,1858,10
STAT,1883,32,20-24,1915,0.026248902412464498
STAT,1834,26,45-49,1860,0.010363146397103205
STAT,1841,33,25-29,1874,0.12038406611034816
STAT,1871,79,na,1950,6.970081847362181
STAT,1833,47,35-39,1880,0.0012141365839689528
SIM,1943,19,na,1962,40
SIM,1869,77,na,1946,4
STAT,1919,34,45-49,1953,0.01668576322525872
STAT,1931,39,45-49,1970,0.00896934857757704
STAT,1927,36,na,1963,46.5789973515103
STAT,1853,20,40-44,1873,0.01569850672702803
STAT,1864,38,25-29,1902,0.025696090405678287
STAT,1847,29,35-39,1876,0.12211633573291368
STAT,1889,21,na,1910,29.04346064475233
STAT,1831,31,15-19,1862,0.0015186830911508465
STAT,1813,48,20-24,1861,3.664172504072116E-4
STAT,1841,22,15-19,1863,0.040906694456777366
STAT,1899,25,35-39,1924,0.13298355055739608
STAT,1877,44,na,1921,23.535989406066825
STAT,1904,20,40-44,1924,0.030036856751697132
SIM,1872,26,30-34,1898,1
STAT,1896,18,20-24,1914,0.23226052069121084
STAT,1897,72,na,1969,20.50115185247869
STAT,1881,89,na,1970,2.9546138950627894
STAT,1864,26,30-34,1890,0.22663732078841123
STAT,1845,46,45-49,1891,0.0013834520083857132
STAT,1870,35,45-49,1905,0.01999114148073452
STAT,1882,36,20-24,1918,0.0074229382404887665
STAT,1836,23,45-49,1859,0.008817826949982984
STAT,1887,43,15-19,1930,1.4964648032988077E-4
STAT,1898,26,30-34,1924,0.34086982010485745
STAT,1828,29,25-29,1857,0.6138046811155186
STAT,1823,104,na,1927,3.8358399442592843E-4
STAT,1881,35,20-24,1916,0.007404623017365972
STAT,1821,40,45-49,1861,0.02500681740753858
STAT,1920,49,40-44,1969,0.0017178606646898586
STAT,1847,23,20-24,1870,0.8959670392255339
STAT,1880,26,15-19,1906,0.004787295649450552
STAT,1815,45,20-24,1860,1.7795958043171232E-4
STAT,1829,27,20-24,1856,0.13477048052608637
STAT,1871,33,40-44,1904,0.04305461848923629
SIM,1851,30,25-29,1881,1
STAT,1909,47,50-100,1956,0.002066687247787403
SIM,1873,82,na,1955,1
STAT,1897,17,25-29,1914,0.07525162623516043
SIM,1905,53,na,1958,40
STAT,1868,44,50-100,1912,0.010085761906151385
STAT,1879,15,50-100,1894,5.09426768675999E-4
STAT,1931,41,na,1972,49.466695317434535
STAT,1889,40,15-19,1929,1.7078418096656787E-4
STAT,1865,39,25-29,1904,0.025779873152343348
STAT,1934,29,50-100,1963,0.0133199678436696
STAT,1884,14,na,1898,25.220270688314397
SIM,1855,61,na,1916,11
STAT,1920,38,30-34,1958,0.01976525885314146
STAT,1874,25,30-34,1899,0.25720138949197635
STAT,1857,25,30-34,1882,0.19699070439343339
STAT,1878,17,15-19,1895,0.06126934387811521
SIM,1785,73,na,1858,6
STAT,1899,42,25-29,1941,6.096929332279085E-4
STAT,1891,45,30-34,1936,6.768620772502968E-4
STAT,1847,53,50-100,1900,1.58742782054735E-4
SIM,1912,47,na,1959,35
STAT,1839,48,40-44,1887,9.503523815170428E-4
STAT,1903,49,40-44,1952,0.0013443159296784302
STAT,1867,47,35-39,1914,0.001333498830687356
STAT,1814,44,20-24,1858,0.004717175015899271
STAT,1839,49,25-29,1888,3.156743736659769E-4
SIM,1926,15,na,1941,46
STAT,1874,45,30-34,1919,9.918180786209904E-4
STAT,1878,50,40-44,1928,1.1025121227095517E-4
STAT,1917,31,30-34,1948,0.16414972627952978
STAT,1809,54,35-39,1863,2.705122072858111E-4
STAT,1843,49,45-49,1892,9.801947080315277E-4
STAT,1827,77,na,1904,5.238369048283588
SIM,1888,48,na,1936,32
STAT,1814,45,50-100,1859,0.007252883318244108
STAT,1825,33,40-44,1858,0.04975492603202032
STAT,1886,18,50-100,1904,5.068448318114443E-4
STAT,1828,33,50-100,1861,0.006711708371895748
STAT,1862,41,45-49,1903,0.012970908029668833
STAT,1871,36,45-49,1907,0.019970729359156236
STAT,1834,43,35-39,1877,0.015230644837519037
SIM,1933,17,na,1950,44
STAT,1825,51,50-100,1876,1.3718201790464518E-4
SIM,1909,35,na,1944,38
STAT,1834,28,40-44,1862,0.027559395995573475
STAT,1876,45,35-39,1921,0.0014360798267331707
STAT,1873,19,35-39,1892,0.005548768030884184
SIM,1922,25,na,1947,48
STAT,1935,31,na,1966,52.1226994232298
STAT,1865,36,20-24,1901,0.007005788342585886
SIM,1913,40,na,1953,40
STAT,1807,54,30-34,1861,1.1721952696143132E-4
STAT,1876,25,40-44,1901,0.030630726034836606
STAT,1849,37,45-49,1886,0.015816928700174055
STAT,1905,49,45-49,1954,0.0018811804389549966
STAT,1890,28,25-29,1918,0.5120278798970506
STAT,1868,31,40-44,1899,0.0421398795351336
STAT,1860,18,40-44,1878,0.0017048312454716282
SIM,1883,24,40-44,1907,1
STAT,1884,19,40-44,1903,0.0017823861701033157
STAT,1927,20,35-39,1947,0.11610542269791337
STAT,1938,0,na,1938,44.14763215088658
STAT,1881,57,na,1938,19.122511877161664
SIM,1821,49,na,1870,12
STAT,1850,28,50-100,1878,0.006654454172715887
SIM,1892,53,na,1945,32
STAT,1809,80,na,1889,3.6971632899598053
STAT,1886,27,20-24,1913,0.12168639221262953
STAT,1928,21,35-39,1949,0.11734088330298381
STAT,1851,43,35-39,1894,0.01517701656113595
STAT,1938,23,15-19,1961,0.05231907347972896
STAT,1926,21,30-34,1947,0.3482241926147643
STAT,1823,37,25-29,1860,0.020748372804363435
STAT,1903,38,30-34,1941,0.016273681769558575
STAT,1881,22,15-19,1903,0.031391646619120216
STAT,1897,24,50-100,1921,0.005381374181925601
SIM,1876,79,na,1955,10
STAT,1819,36,20-24,1855,0.009423580400314135
STAT,1869,30,50-100,1899,0.008949244177206054
STAT,1800,59,na,1859,9.057208468348449
STAT,1881,19,15-19,1900,0.05616699228177702
STAT,1877,24,45-49,1901,0.007153117186507012
STAT,1885,46,45-49,1931,0.0023371517698248414
STAT,1850,28,25-29,1878,0.44004410809145245
STAT,1844,17,45-49,1861,6.485909186794477E-4
SIM,1858,26,na,1884,25
STAT,1835,44,35-39,1879,0.009577809659364424
SIM,1862,31,na,1893,23
STAT,1846,100,na,1946,0.008603869834142932
STAT,1855,42,50-100,1897,0.007429001278984757
STAT,1861,17,45-49,1878,6.313949981611189E-4
STAT,1830,35,45-49,1865,0.012180441409225707
STAT,1880,26,45-49,1906,0.011715493830598521
STAT,1826,52,na,1878,16.522284429803424
STAT,1883,15,30-34,1898,0.015549682710550959
SIM,1854,44,na,1898,17
STAT,1882,30,50-100,1912,0.008851363444086675
SIM,1872,33,na,1905,23
STAT,1858,24,50-100,1882,0.0031935361392302704
STAT,1879,50,50-100,1929,1.585612793666557E-4
SIM,1829,69,na,1898,16
STAT,1851,59,na,1910,16.407325101291217
SIM,1809,49,na,1858,3
STAT,1841,54,50-100,1895,1.4376278322310323E-4
STAT,1943,21,30-34,1964,0.30365910945624747
SIM,1879,27,25-29,1906,1
STAT,1923,33,50-100,1956,0.009406890276172348
STAT,1891,29,25-29,1920,0.5154815607655026
STAT,1944,20,35-39,1964,0.10099696553476185
SIM,1880,84,na,1964,7
STAT,1840,67,na,1907,12.421627941720079
STAT,1937,21,50-100,1958,0.006369252383997739
STAT,1885,31,na,1916,23.66147722312698
STAT,1850,27,40-44,1877,0.03138696522722828
STAT,1856,44,25-29,1900,0.004589206438513106
STAT,1872,29,15-19,1901,0.004608970893586484
STAT,1901,11,na,1912,36.19017272997038
SIM,1867,62,na,1929,9
STAT,1871,19,25-29,1890,0.05619431937226844
STAT,1892,44,35-39,1936,0.0015325142940160455
STAT,1854,19,25-29,1873,0.04094749328123255
STAT,1950,20,na,1970,43.08342043404672
STAT,1838,36,30-34,1874,0.0504346055514095
STAT,1909,21,25-29,1930,0.8562521236741523
STAT,1840,37,25-29,1877,0.026684304838351377
STAT,1905,25,na,1930,34.67696492419491
STAT,1889,39,40-44,1928,0.053055743248945915
STAT,1900,20,50-100,1920,0.005688495646252926
STAT,1830,65,na,1895,6.0719018292081826
STAT,1879,49,25-29,1928,5.837182684584194E-4
STAT,1843,18,40-44,1861,9.856596350177984E-4
SIM,1884,66,na,1950,17
STAT,1872,32,15-19,1904,0.0014570728874064246
STAT,1896,23,na,1919,30.96977157835161
SIM,1813,54,na,1867,9
SIM,1913,1,na,1914,48
STAT,1895,37,15-19,1932,7.290295359475515E-4
STAT,1918,1,na,1919,45.04283294014754
STAT,1866,34,40-44,1900,0.03959840555623798
STAT,1897,64,na,1961,24.516462982830344
STAT,1902,42,50-100,1944,0.0010332700652694806
STAT,1805,98,na,1903,0.008894568009457744
STAT,1832,43,25-29,1875,0.0034869848803607143
STAT,1855,48,25-29,1903,4.0044853400357993E-4
STAT,1883,80,na,1963,8.423548384566026
STAT,1916,22,25-29,1938,0.9596325081596624
STAT,1940,29,45-49,1969,0.01747455644013336
SIM,1939,25,25-29,1964,1
STAT,1882,31,20-24,1913,0.02601045791014484
STAT,1894,41,35-39,1935,0.023312249795540096
STAT,1813,105,na,1918,1.9350339141233566E-4
STAT,1940,31,50-100,1971,0.008501162025929716
SIM,1912,55,na,1967,35
SIM,1930,12,na,1942,53
STAT,1857,33,30-34,1890,0.13015327312327715
SIM,1945,10,na,1955,40
STAT,1918,43,na,1961,39.067938114332726
STAT,1939,13,na,1952,39.24278228438212
STAT,1846,42,45-49,1888,0.012276029745356402
STAT,1884,47,50-100,1931,0.0023950526251370215
STAT,1961,2,na,1963,50.54204902948132
STAT,1834,40,25-29,1874,0.005612778746335382
STAT,1897,32,na,1929,31.68914639076545
STAT,1862,11,na,1873,23.696469032282355
STAT,1839,16,25-29,1855,0.041150947093382025
STAT,1839,78,na,1917,4.311832759056856
STAT,1883,18,40-44,1901,0.0017714842148492665
SIM,1856,70,na,1926,7
STAT,1794,65,na,1859,9.129056502160758
STAT,1918,49,30-34,1967,9.345536301922913E-4
STAT,1898,43,20-24,1941,1.4769720437878922E-4
STAT,1818,65,na,1883,4.596560187653461
STAT,1858,41,25-29,1899,0.004908569894167374
STAT,1890,49,30-34,1939,6.49418881683748E-4
SIM,1843,84,na,1927,2
STAT,1775,106,na,1881,1.9634340624924678E-4
STAT,1878,29,50-100,1907,0.0065570943605598436
STAT,1833,44,30-34,1877,0.010052813134267752
STAT,1830,97,na,1927,0.0193020421834827
STAT,1858,5,na,1863,22.351446283131054
STAT,1888,44,15-19,1932,1.5920305116967306E-4
STAT,1863,52,na,1915,18.962607372133647
STAT,1855,36,30-34,1891,0.037704553356166196
STAT,1919,31,40-44,1950,0.042025255107972136
STAT,1874,29,25-29,1903,0.42607710569461316
SIM,1895,58,na,1953,21
STAT,1788,93,na,1881,0.08309275716233852
STAT,1815,40,20-24,1855,0.0025582100329038736
SIM,1947,3,na,1950,43
STAT,1860,30,25-29,1890,0.08393891055710072
STAT,1822,38,20-24,1860,0.004620352700101154
STAT,1778,104,na,1882,3.762243452531233E-4
STAT,1862,43,40-44,1905,0.01926577209879561
STAT,1830,48,50-100,1878,2.4041381854818575E-4
STAT,1862,26,20-24,1888,0.10232261405215633
STAT,1834,47,na,1881,16.861581162861196
STAT,1854,16,20-24,1870,0.1303960249471449
SIM,1870,43,40-44,1913,1
STAT,1882,39,30-34,1921,0.050561623221689715
STAT,1835,27,45-49,1862,0.006663233627962318
SIM,1890,39,30-34,1929,1
STAT,1904,23,45-49,1927,0.009960981022891474
STAT,1869,27,15-19,1896,0.00439611174486433
STAT,1860,87,na,1947,1.4323016898977228
STAT,1847,35,15-19,1882,6.354458948104178E-4
SIM,1817,44,na,1861,10
SIM,1882,29,25-29,1911,1
STAT,1848,38,40-44,1886,0.028871930555272183
STAT,1826,30,25-29,1856,0.1923222763917947
SIM,1898,26,na,1924,35
STAT,1876,33,50-100,1909,0.00926653851403885
STAT,1891,28,40-44,1919,0.03663704888028109
STAT,1834,23,40-44,1857,0.019553247042783262
STAT,1845,98,na,1943,0.018989309673055184
SIM,1810,65,na,1875,12
STAT,1826,60,na,1886,14.101851879538156
SIM,1864,46,na,1910,22
SIM,1906,9,na,1915,29
STAT,1841,18,30-34,1859,0.020002718552203154
SIM,1872,41,na,1913,21
STAT,1891,24,25-29,1915,0.6982134400269275
STAT,1836,20,40-44,1856,0.026926183080024837
STAT,1931,36,40-44,1967,0.01975581368854289
STAT,1871,31,45-49,1902,0.017456963316097397
SIM,1814,79,na,1893,12
STAT,1824,37,40-44,1861,0.06373741811798142
STAT,1875,41,30-34,1916,0.011871397856287182
STAT,1881,38,25-29,1919,0.027260923585345435
SIM,1843,52,na,1895,19
STAT,1838,48,25-29,1886,4.540788406100582E-4
STAT,1849,24,50-100,1873,0.0037682183176626105
STAT,1820,44,45-49,1864,0.012807044171045216
STAT,1833,54,na,1887,15.788501414112558
SIM,1832,33,na,1865,23
STAT,1861,45,45-49,1906,0.002004441188131563
SIM,1876,23,na,1899,28
STAT,1847,26,25-29,1873,0.5470639310970957
STAT,1864,23,20-24,1887,0.6235220915766047
STAT,1875,27,45-49,1902,0.011413273974117632
STAT,1815,48,25-29,1863,8.1844588097843E-4
STAT,1800,67,na,1867,6.839742164670266
STAT,1830,30,45-49,1860,0.012314879825205197
STAT,1842,31,20-24,1873,0.024755042688872898
STAT,1852,44,35-39,1896,0.015288625903354735
SIM,1877,64,na,1941,21
STAT,1892,9,na,1901,32.05429559608956
STAT,1844,45,45-49,1889,0.0018724543841175103
STAT,1876,28,45-49,1904,0.011237052336162534
SIM,1842,43,na,1885,23
STAT,1836,36,20-24,1872,0.00922669578180593
STAT,1841,30,20-24,1871,0.03277501347718994
STAT,1814,47,25-29,1861,0.0016495815071423017
STAT,1895,17,20-24,1912,0.23016158644157952
SIM,1847,74,na,1921,10
STAT,1893,21,25-29,1914,0.7239761241958387
SIM,1924,22,25-29,1946,2
STAT,1904,38,50-100,1942,0.003778290602863772
STAT,1861,31,30-34,1892,0.1474284913357334
STAT,1888,36,15-19,1924,6.593795320109116E-4
STAT,1859,28,45-49,1887,0.008912746496784698
STAT,1886,80,na,1966,9.633879523405918
STAT,1832,32,15-19,1864,8.322379299589807E-4
STAT,1945,21,40-44,1966,0.03659851725643914
STAT,1925,39,20-24,1964,0.0031374022126086976
STAT,1828,26,20-24,1854,0.19146628685515626
SIM,1824,38,na,1862,18
STAT,1846,72,na,1918,10.234855322918643
STAT,1824,33,25-29,1857,0.1620228478124897
STAT,1914,39,45-49,1953,0.006682197457630343
STAT,1860,18,50-100,1878,4.566511154194573E-4
STAT,1905,33,na,1938,34.58661143219438
STAT,1921,46,25-29,1967,5.948000733695017E-4
SIM,1779,77,na,1856,4
STAT,1890,16,30-34,1906,0.01940832872060448
STAT,1936,34,45-49,1970,0.015172325398315242
STAT,1863,39,20-24,1902,0.006756386273778445
STAT,1902,68,na,1970,25.110347689971242
STAT,1808,55,na,1863,4.302373697354966
STAT,1826,49,45-49,1875,0.0023133457876252134
STAT,1918,30,35-39,1948,0.09700244915107833
STAT,1900,41,35-39,1941,0.0017515956391683284
SIM,1896,43,na,1939,28
STAT,1847,46,na,1893,24.101867652839477
STAT,1892,25,25-29,1917,0.5261404430421656
STAT,1860,105,na,1965,0.0013970212939173716
STAT,1905,46,40-44,1951,0.0013977105606631647
STAT,1838,85,na,1923,2.1276851705811652
STAT,1876,53,40-44,1929,1.0520685132483757E-4
SIM,1792,75,na,1867,2
STAT,1854,24,na,1878,15.135884175438196
STAT,1937,30,45-49,1967,0.015487446276646792
SIM,1930,20,na,1950,43
STAT,1843,32,na,1875,11.052167559786492
STAT,1809,51,30-34,1860,1.9859409386030258E-4
STAT,1858,38,na,1896,17.838761753600117
STAT,1913,20,na,1933,36.8883296710297
STAT,1892,15,50-100,1907,6.080614916777487E-4
STAT,1909,4,na,1913,39.23011358308038
STAT,1886,42,45-49,1928,0.015505031621038378
STAT,1854,16,15-19,1870,0.04364951688196462
STAT,1819,40,35-39,1859,0.01782397729826182
STAT,1847,22,na,1869,27.999946704476557
STAT,1819,51,45-49,1870,1.2861897931275531E-4
SIM,1885,51,na,1936,22
STAT,1821,42,40-44,1863,0.03506500401496341
STAT,1850,23,25-29,1873,0.607370032204083
STAT,1855,17,20-24,1872,0.14846241267616495
STAT,1825,34,25-29,1859,0.11270645786843161
STAT,1913,38,50-100,1951,0.004088346252877245
STAT,1853,40,35-39,1893,0.011495459040338503
STAT,1898,34,30-34,1932,0.23351520999756703
STAT,1912,27,na,1939,36.627987083525504
STAT,1816,82,na,1898,1.4007636642298968
STAT,1853,23,45-49,1876,0.005140970603990602
STAT,1849,34,40-44,1883,0.0347056788375573
SIM,1890,38,na,1928,24
STAT,1816,41,20-24,1857,0.002238668966532107
STAT,1871,49,50-100,1920,0.002397507285508273
SIM,1940,19,na,1959,35
SIM,1920,42,na,1962,42
STAT,1861,34,50-100,1895,0.007639248565154768
STAT,1932,23,20-24,1955,1.4485752182517102
STAT,1890,41,20-24,1931,0.0019378352484799735
STAT,1917,34,35-39,1951,0.09401153500319648
STAT,1832,24,15-19,1856,0.019841811889803607
STAT,1927,41,40-44,1968,0.00312541274399625
STAT,1849,88,na,1937,1.0644850148655387
STAT,1828,26,15-19,1854,0.007404773584156639
STAT,1831,43,50-100,1874,0.010330552534845341
STAT,1898,45,40-44,1943,0.0013157322010891185
STAT,1831,31,45-49,1862,0.018596703432590404
STAT,1909,24,35-39,1933,0.08647678785641295
SIM,1940,23,20-24,1963,1
STAT,1838,33,20-24,1871,0.02580013705019975
STAT,1872,64,na,1936,17.78636532284637
STAT,1840,34,20-24,1874,0.02526798874518633
STAT,1876,42,30-34,1918,0.011662180805616125
STAT,1815,48,30-34,1863,0.0013754437854561915
STAT,1865,38,40-44,1903,0.03939757282215406
STAT,1947,17,30-34,1964,0.13636426609410612
STAT,1810,52,50-100,1862,1.4229459484377353E-4
STAT,1860,53,50-100,1913,1.2080984736243148E-4
STAT,1877,54,40-44,1931,1.0568439495786309E-4
STAT,1895,17,15-19,1912,0.07704561589997655
STAT,1888,28,na,1916,27.790694824639854
STAT,1874,40,25-29,1914,0.006580362880667819
STAT,1866,38,35-39,1904,0.06481720609178859
STAT,1937,27,15-19,1964,0.006838142383370191
STAT,1892,42,15-19,1934,1.7039764457926624E-4
SIM,1871,48,na,1919,23
STAT,1845,30,35-39,1875,0.0718632869562979
STAT,1835,41,30-34,1876,0.006321469073535018
STAT,1886,31,35-39,1917,0.10547392302026624
STAT,1881,49,na,1930,20.96122508734212
STAT,1866,18,35-39,1884,0.005156466015107537
STAT,1852,36,35-39,1888,0.06149719559512104
STAT,1910,28,20-24,1938,0.17457568939504872
STAT,1880,64,na,1944,18.279761688866543
STAT,1851,24,25-29,1875,0.5688787994427541
STAT,1929,17,15-19,1946,0.5764160914902994
SIM,1909,27,na,1936,39
SIM,1905,13,na,1918,40
STAT,1864,77,na,1941,7.752930960071605
STAT,1943,24,35-39,1967,0.09938128389138177
STAT,1846,39,15-19,1885,4.6547642236194613E-4
STAT,1887,29,50-100,1916,0.006932388182597696
STAT,1929,32,50-100,1961,0.010451905493194795
STAT,1805,90,na,1895,0.21586698312198785
STAT,1887,43,45-49,1930,0.01621793616712358
STAT,1818,40,40-44,1858,0.025732689313384852
STAT,1925,21,na,1946,43.56932488365036
STAT,1854,8,na,1862,17.955275712888906
STAT,1856,49,30-34,1905,6.866098859058914E-4
STAT,1879,34,20-24,1913,0.027737401002652914
STAT,1867,42,na,1909,22.090422570329913
STAT,1875,41,25-29,1916,0.006630870901813104
STAT,1846,42,15-19,1888,1.1327363882104433E-4
STAT,1929,35,na,1964,48.1527481738894
SIM,1825,31,na,1856,21
STAT,1847,43,15-19,1890,1.4645604625365577E-4
STAT,1834,40,30-34,1874,0.010048684488615333
STAT,1856,29,30-34,1885,0.18633038530770776
STAT,1874,48,35-39,1922,0.0014024420057125039
STAT,1873,16,25-29,1889,0.0579545624273486
STAT,1891,41,15-19,1932,1.7026378212342278E-4
STAT,1884,5,na,1889,25.797649053592135
SIM,1923,10,na,1933,42
STAT,1844,20,50-100,1864,0.004034698410064162
STAT,1879,46,20-24,1925,1.2455383495640175E-4
SIM,1934,21,25-29,1955,3
STAT,1855,39,35-39,1894,0.049297107453233305
STAT,1863,42,15-19,1905,1.221213648600006E-4
SIM,1829,77,na,1906,15
STAT,1859,25,40-44,1884,0.02457180326875073
STAT,1883,23,30-34,1906,0.17243729692772
STAT,1894,36,45-49,1930,0.02567132958656911
STAT,1885,31,40-44,1916,0.04300073060980984
STAT,1892,29,40-44,1921,0.03674292642132166
STAT,1920,45,25-29,1965,5.84115813227786E-4
STAT,1839,44,25-29,1883,0.0036405044693781307
SIM,1908,42,na,1950,38
STAT,1825,38,40-44,1863,0.044887257063271825
STAT,1825,67,na,1892,8.54596292784862
SIM,1841,26,na,1867,19
STAT,1926,21,25-29,1947,1.1191326088485931
STAT,1867,7,na,1874,26.608995263387666
STAT,1863,39,15-19,1902,4.921871414716729E-4
STAT,1920,34,15-19,1954,0.0013836399618451071
STAT,1881,44,50-100,1925,0.009916907389477524
STAT,1852,44,na,1896,19.513701776711894
STAT,1861,18,na,1879,22.05662857440994
STAT,1916,18,40-44,1934,0.002934505751021163
STAT,1899,46,40-44,1945,0.0013257470630244884
STAT,1897,26,15-19,1923,0.0060456434635945445
STAT,1936,35,50-100,1971,0.00410397854589062
STAT,1827,45,45-49,1872,0.0018256870292093568
STAT,1836,81,na,1917,5.218945724850111
STAT,1925,29,50-100,1954,0.01159916310751759
STAT,1832,28,30-34,1860,0.14956980163074513
STAT,1883,34,40-44,1917,0.04175249493147435
STAT,1802,93,na,1895,0.08925586111557508
STAT,1885,27,35-39,1912,0.09528459723778693
STAT,1834,24,25-29,1858,0.5333026341404815
SIM,1929,12,na,1941,51
STAT,1861,80,na,1941,5.2021196561087395
STAT,1870,54,na,1924,20.801129767468947
STAT,1837,36,15-19,1873,3.3671676766392313E-4
STAT,1913,22,50-100,1935,0.006322697127292268
STAT,1940,26,40-44,1966,0.0472137746249228
STAT,1874,45,25-29,1919,5.901727353096141E-4
STAT,1891,42,20-24,1933,0.0019468138573472322
SIM,1893,30,35-39,1923,1
STAT,1885,30,35-39,1915,0.10081014118544068
STAT,1795,95,na,1890,0.03254609630483814
STAT,1791,81,na,1872,1.932890709859541
STAT,1874,47,na,1921,22.718032635008058
SIM,1848,59,na,1907,27
STAT,1933,22,25-29,1955,1.2202431185236173
STAT,1797,103,na,1900,3.074231921938226E-4
STAT,1863,26,15-19,1889,0.004046122615886883
STAT,1919,31,35-39,1950,0.09813704276864153
STAT,1823,34,20-24,1857,0.021516224486157833
STAT,1865,34,25-29,1899,0.09184988680174101
STAT,1894,24,45-49,1918,0.00888087068598828
STAT,1920,47,20-24,1967,1.2112073720946591E-4
STAT,1826,32,50-100,1858,0.012978266698435877
STAT,1866,39,40-44,1905,0.03991023084267632
STAT,1812,52,40-44,1864,1.1413851820543863E-4
STAT,1833,44,25-29,1877,0.00561508483670923
STAT,1849,45,50-100,1894,0.0019233466908860747
STAT,1856,49,25-29,1905,4.0856125048568584E-4
STAT,1838,39,50-100,1877,0.011261971489546316
STAT,1829,51,50-100,1880,1.271059230666592E-4
STAT,1827,33,45-49,1860,0.014958863407341408
STAT,1882,42,na,1924,22.12235268199832
STAT,1891,16,na,1907,31.074507851968676
STAT,1904,46,25-29,1950,4.668851501815207E-4
STAT,1850,41,20-24,1891,0.0014204135803562107
STAT,1811,43,35-39,1854,0.07720066995531154
STAT,1870,65,na,1935,16.787894672286004
STAT,1842,34,30-34,1876,0.15499461954740895
STAT,1890,25,20-24,1915,0.1434690609473969
STAT,1907,32,25-29,1939,0.08602886217077221
STAT,1823,63,na,1886,10.582706645705183
SIM,1820,56,na,1876,10
STAT,1843,34,40-44,1877,0.021661063461821214
STAT,1873,16,30-34,1889,0.016300764557037408
STAT,1884,54,na,1938,20.516146768673842
STAT,1859,87,na,1946,1.4003146227251044
STAT,1914,36,40-44,1950,0.014893980779450965
STAT,1908,41,30-34,1949,0.0011834581276782398
STAT,1858,27,45-49,1885,0.008648991052909435
STAT,1906,33,20-24,1939,0.022453945273860607
STAT,1842,22,30-34,1864,0.16856169623009443
STAT,1844,30,40-44,1874,0.04135753287252583
SIM,1898,4,na,1902,38
STAT,1929,33,15-19,1962,0.0016234826093406945
STAT,1785,96,na,1881,0.045008210557299685
STAT,1811,54,45-49,1865,5.291867753915827E-4
SIM,1908,50,na,1958,37
STAT,1876,34,30-34,1910,0.17581065883616048
STAT,1874,79,na,1953,7.092362707077582
SIM,1884,34,30-34,1918,1
STAT,1871,49,20-24,1920,1.1714205441849481E-4
STAT,1939,23,30-34,1962,0.28656812115982233
STAT,1836,39,25-29,1875,0.03340562306631984
SIM,1819,70,na,1889,1
STAT,1861,29,na,1890,19.92615775784337
STAT,1843,46,40-44,1889,7.321540555320947E-4
STAT,1944,22,50-100,1966,0.0070529211348600625
STAT,1874,26,20-24,1900,0.11942299204646578
STAT,1875,24,40-44,1899,0.02128625461378704
STAT,1842,33,40-44,1875,0.03890003921218061
SIM,1865,39,na,1904,24
STAT,1867,49,50-100,1916,0.0023012227688341395
STAT,1848,39,na,1887,15.378390117636316
STAT,1938,20,na,1958,35.928436346943776
SIM,1874,13,na,1887,28
STAT,1897,7,na,1904,34.59796801712613
STAT,1875,25,25-29,1900,0.4377841999250827
STAT,1927,44,45-49,1971,0.0020697067513731366
STAT,1859,6,na,1865,23.0170574172617
STAT,1865,62,na,1927,16.531596810807223
STAT,1799,88,na,1887,0.533924230462202
STAT,1857,45,30-34,1902,7.318770552232508E-4
STAT,1795,74,na,1869,5.546142827729885
STAT,1814,70,na,1884,7.455637182659379
STAT,1827,101,na,1928,0.0034580797323890185
STAT,1945,21,35-39,1966,0.10249016805168772
SIM,1857,7,na,1864,23
STAT,1822,38,15-19,1860,3.3658202712290384E-4
STAT,1846,80,na,1926,5.013278231365065
STAT,1863,35,50-100,1898,0.01097364267083046
STAT,1861,23,30-34,1884,0.15278364807780975
STAT,1826,46,40-44,1872,0.001746843171772507
STAT,1882,39,25-29,1921,0.02731489975143125
STAT,1916,17,na,1933,40.62739395491443
STAT,1828,46,45-49,1874,0.001023925242868955
STAT,1873,29,30-34,1902,0.2541926759983265
STAT,1893,37,40-44,1930,0.055194941852209474
STAT,1873,33,15-19,1906,0.001441738394054757
STAT,1912,25,50-100,1937,0.00979805864959976
STAT,1878,37,15-19,1915,5.797495524373744E-4
STAT,1884,35,40-44,1919,0.043295988013704
STAT,1836,73,na,1909,11.463061274005144
STAT,1890,44,25-29,1934,0.007695010683774947
STAT,1882,15,15-19,1897,0.057137640332607376
SIM,1805,67,na,1872,9
STAT,1930,36,25-29,1966,0.012794462397304356
STAT,1873,44,25-29,1917,0.006440637140023937
STAT,1876,4,na,1880,29.457579487170047
SIM,1871,4,na,1875,30
SIM,1880,28,na,1908,30
STAT,1898,49,35-39,1947,0.0010430851221346026
STAT,1949,12,na,1961,45.393592092985756
STAT,1867,34,35-39,1901,0.09608230578395106
STAT,1835,33,30-34,1868,0.10000885528940605
STAT,1817,44,40-44,1861,0.06691206896978902
STAT,1890,33,15-19,1923,0.0017225302565979767
SIM,1832,44,na,1876,24
SIM,1841,18,na,1859,21
STAT,1878,37,45-49,1915,0.02058110666392989
STAT,1847,26,30-34,1873,0.32566539806089134
STAT,1934,31,30-34,1965,0.21432410415858977
STAT,1870,20,40-44,1890,0.020823828973414345
STAT,1816,85,na,1901,0.8230004473987705
STAT,1957,15,25-29,1972,0.5684311955971709
SIM,1892,35,40-44,1927,1
SIM,1911,17,na,1928,42
STAT,1918,47,50-100,1965,0.0023851203639737423
STAT,1827,37,na,1864,17.092790042845586
STAT,1887,40,40-44,1927,0.02479874852863297
STAT,1863,42,45-49,1905,0.013234901987507874
STAT,1806,53,25-29,1859,1.1246086045983436E-4
SIM,1810,57,na,1867,16
SIM,1960,4,na,1964,52
STAT,1893,24,35-39,1917,0.07311763436748779
STAT,1857,44,40-44,1901,0.016610974807299932
STAT,1899,28,45-49,1927,0.01514581121891657
STAT,1868,46,45-49,1914,0.002290363271485324
STAT,1864,43,15-19,1907,1.2296875937645234E-4
STAT,1816,43,40-44,1859,0.03017513778649933
STAT,1826,33,35-39,1859,0.13391600399281164
SIM,1881,69,na,1950,9
STAT,1837,44,na,1881,11.696243308893703
SIM,1883,25,na,1908,15
STAT,1921,23,45-49,1944,0.012570567418222066
STAT,1933,16,50-100,1949,0.005007143666353438
SIM,1951,2,na,1953,52
STAT,1863,84,na,1947,2.9453919618942233
STAT,1866,35,30-34,1901,0.049550588999085626
STAT,1894,67,na,1961,21.843786526106946
SIM,1810,89,na,1899,1
STAT,1862,29,25-29,1891,0.3623532479734415
STAT,1882,19,30-34,1901,0.01519283334026737
SIM,1869,10,na,1879,19
STAT,1873,25,15-19,1898,0.004644054730261829
STAT,1885,39,na,1924,23.031465278116972
SIM,1816,59,na,1875,9
STAT,1902,23,35-39,1925,0.08203688114730624
STAT,1941,8,na,1949,40.54846738288644
STAT,1912,35,na,1947,36.77840972670766
STAT,1816,44,30-34,1860,0.014965633117890067
STAT,1902,28,na,1930,33.53596849859074
STAT,1883,35,30-34,1918,0.052246061097022685
STAT,1851,28,40-44,1879,0.029397859871060424
STAT,1856,25,15-19,1881,0.00345528864410207
STAT,1893,45,35-39,1938,0.0010056628293076983
SIM,1887,31,na,1918,23
STAT,1857,40,25-29,1897,0.004855745938912179
SIM,1855,21,na,1876,20
STAT,1846,29,na,1875,20.905616808585595
SIM,1891,76,na,1967,22
STAT,1841,38,25-29,1879,0.032860950839087834
STAT,1869,47,45-49,1916,0.002276040985090029
STAT,1833,62,na,1895,13.531483810876741
STAT,1867,47,40-44,1914,0.0016306785663371493
STAT,1868,34,45-49,1902,0.016731273860388318
SIM,1869,21,na,1890,17
STAT,1823,55,na,1878,13.067197877461881
STAT,1866,15,30-34,1881,0.015246121638769601
SIM,1820,64,na,1884,8
STAT,1883,18,35-39,1901,0.005314452336847331
STAT,1859,79,na,1938,5.556606602357766
STAT,1907,30,50-100,1937,0.007757515066289737
SIM,1831,59,na,1890,6
SIM,1830,34,na,1864,19
STAT,1903,34,15-19,1937,0.0011526048433314693
STAT,1916,18,50-100,1934,7.860281350239523E-4
STAT,1875,29,40-44,1904,0.03057258353541047
STAT,1818,43,45-49,1861,0.015611320935487592
SIM,1834,48,na,1882,19
STAT,1888,27,30-34,1915,0.2942751849379979
STAT,1824,35,20-24,1859,0.01172171008262351
STAT,1843,16,45-49,1859,3.562049494243595E-4
STAT,1901,38,20-24,1939,0.0023165697213173076
STAT,1838,39,35-39,1877,0.06487925834044524
STAT,1811,51,40-44,1862,4.0760449061849244E-4
STAT,1809,46,35-39,1855,0.004851210111846121
STAT,1871,24,50-100,1895,0.004040220018937522
SIM,1917,21,25-29,1938,1
STAT,1837,47,na,1884,11.292433127773618
STAT,1858,45,40-44,1903,0.001315725032526673
STAT,1898,29,35-39,1927,0.12923382075683837
STAT,1854,36,15-19,1890,3.448883626096519E-4
STAT,1845,95,na,1940,0.07771891456131014
STAT,1835,88,na,1923,0.61749177664431
STAT,1874,42,20-24,1916,0.0016091609803323662
SIM,1896,27,30-34,1923,1
SIM,1900,22,na,1922,35
STAT,1923,33,20-24,1956,0.027751705784885658
SIM,1907,25,na,1932,39
SIM,1849,6,na,1855,20
STAT,1840,22,20-24,1862,0.6867094889591486
STAT,1884,47,40-44,1931,0.0016695155119010987
STAT,1833,43,40-44,1876,0.019921491777644282
STAT,1898,30,15-19,1928,0.0019365226722853587
STAT,1859,47,na,1906,17.79874709542039
STAT,1816,47,35-39,1863,0.0017645627135813675
STAT,1901,43,na,1944,32.21772358772114
STAT,1822,70,na,1892,4.9769232355536595
STAT,1889,35,50-100,1924,0.015174401203866303
STAT,1905,16,15-19,1921,0.08586024860270065
STAT,1813,85,na,1898,1.8091653463911408
STAT,1771,93,na,1864,0.10433600159918557
STAT,1801,54,30-34,1855,1.6378903829809884E-4
STAT,1891,26,20-24,1917,0.14448171354111947
STAT,1833,32,30-34,1865,0.16642617822846717
STAT,1903,45,25-29,1948,4.665434468987681E-4
SIM,1889,26,30-34,1915,1
STAT,1861,40,na,1901,19.632619654405907
STAT,1885,34,45-49,1919,0.017073067316902814
STAT,1845,29,25-29,1874,0.2966682262084885
SIM,1856,34,25-29,1890,1
STAT,1898,41,25-29,1939,6.042778313563945E-4
STAT,1886,24,na,1910,24.378278802234483
STAT,1885,24,30-34,1909,0.1747977757609582
STAT,1850,44,25-29,1894,0.00564036477548521
STAT,1847,18,50-100,1865,6.493442716630225E-4
STAT,1876,40,35-39,1916,0.018577029619871916
SIM,1868,36,na,1904,33
STAT,1843,23,50-100,1866,0.0021556892579830287
STAT,1848,34,25-29,1882,0.06884938724537917
SIM,1948,20,15-19,1968,1
SIM,1810,86,na,1896,4
STAT,1846,27,20-24,1873,0.11501722165672043
STAT,1870,62,na,1932,18.156472458054882
SIM,1836,26,na,1862,12
SIM,1891,68,na,1959,27
STAT,1858,24,40-44,1882,0.016318968484199805
STAT,1874,76,na,1950,9.611328676601351
STAT,1895,37,45-49,1932,0.02588054544830828
STAT,1862,30,35-39,1892,0.08807505819953575
SIM,1869,13,na,1882,18
SIM,1883,28,na,1911,13
STAT,1812,60,na,1872,9.623335793356208
STAT,1887,28,20-24,1915,0.1275989638684548
STAT,1842,17,35-39,1859,0.0052865753748468315
STAT,1864,69,na,1933,13.16273244632356
STAT,1876,37,35-39,1913,0.07183582637455979
STAT,1822,41,45-49,1863,0.008679136804952149
STAT,1935,23,na,1958,49.49157127690748
STAT,1860,55,na,1915,16.80994698807872
STAT,1864,35,20-24,1899,0.006979582400373447
STAT,1891,45,25-29,1936,4.027609015894994E-4
STAT,1917,22,40-44,1939,0.03541080818528576
STAT,1833,41,20-24,1874,0.0014430899232907406
STAT,1842,37,35-39,1879,0.06225117357768842
STAT,1884,17,45-49,1901,6.399985153637632E-4
SIM,1831,48,na,1879,9
STAT,1864,29,35-39,1893,0.08592490494632155
STAT,1844,33,45-49,1877,0.01612007316122251
SIM,1878,57,na,1935,25
STAT,1837,36,na,1873,12.739175902678818
SIM,1868,28,na,1896,32
STAT,1889,44,30-34,1933,0.013885756398587589
STAT,1852,23,35-39,1875,0.058903783317180054
STAT,1881,23,20-24,1904,0.6537060999652731
STAT,1936,16,na,1952,35.112356288834675
SIM,1839,38,35-39,1877,2
STAT,1883,83,na,1966,6.665680637151279
STAT,1872,33,50-100,1905,0.00933519004382199
STAT,1946,20,45-49,1966,0.012441270888976301
STAT,1903,21,na,1924,33.726196563896906
STAT,1908,44,35-39,1952,0.001830591430363579
STAT,1812,71,na,1883,6.028762670977765
STAT,1833,22,na,1855,21.27576292431436
STAT,1885,15,40-44,1900,0.0018145866304944455
STAT,1872,17,20-24,1889,0.18198972062979948
STAT,1849,35,25-29,1884,0.023323805425108902
STAT,1914,47,50-100,1961,0.00222456386234538
STAT,1888,23,15-19,1911,0.03843320319110568
STAT,1836,51,45-49,1887,1.4454648969534922E-4
STAT,1857,48,35-39,1905,0.0010348824521220355
STAT,1914,22,15-19,1936,0.05393362339682221
STAT,1861,26,35-39,1887,0.08232380406207963
STAT,1855,33,20-24,1888,0.019177738807220596
STAT,1922,45,35-39,1967,0.0014772314885893936
STAT,1926,2,na,1928,49.85692491716056
STAT,1852,29,50-100,1881,0.005719786049623068
STAT,1847,39,30-34,1886,0.057855941254237715
STAT,1853,35,45-49,1888,0.012791598908319246
STAT,1917,0,na,1917,47.88223098836346
SIM,1858,58,na,1916,23
STAT,1898,46,30-34,1944,7.386898095074429E-4
STAT,1893,42,30-34,1935,0.014478059618972234
SIM,1877,61,na,1938,22
STAT,1819,39,25-29,1858,0.02832290463486176
STAT,1883,30,25-29,1913,0.10026353804244784
STAT,1870,23,45-49,1893,0.006905708108635499
STAT,1851,40,30-34,1891,0.009803790181401255
STAT,1902,36,na,1938,33.64700385200293
STAT,1833,23,25-29,1856,0.5656370510709154
STAT,1916,49,20-24,1965,1.1172156537774107E-4
STAT,1834,39,50-100,1873,0.010570318967807822
STAT,1894,75,na,1969,17.237739941922296
SIM,1921,2,na,1923,45
STAT,1878,53,45-49,1931,1.4742304924778382E-4
STAT,1923,31,50-100,1954,0.009451192519951718
SIM,1879,20,na,1899,13
STAT,1916,9,na,1925,41.73777520155382
STAT,1890,19,35-39,1909,0.00662944183178809
STAT,1850,66,na,1916,14.593171068132317
STAT,1950,12,na,1962,46.15925603150114
SIM,1877,72,na,1949,12
SIM,1891,79,na,1970,15
STAT,1894,21,40-44,1915,0.026786552561225148
STAT,1895,38,na,1933,30.434887328908232
STAT,1854,36,45-49,1890,0.012243535416586855
STAT,1860,34,40-44,1894,0.03495447104714261
STAT,1890,18,50-100,1908,5.935465927291428E-4
STAT,1827,30,40-44,1857,0.041583301462619064
STAT,1786,81,na,1867,0.8733842512951293
STAT,1934,38,na,1972,51.64506312489554
STAT,1883,38,35-39,1921,0.06834315752881136
STAT,1900,58,na,1958,28.080890648442146
STAT,1921,20,40-44,1941,0.03790593837704989
STAT,1835,36,35-39,1871,0.04009701343036751
STAT,1850,25,20-24,1875,0.12470430469338314
STAT,1871,28,na,1899,23.70989157787007
SIM,1912,0,na,1912,41
STAT,1829,43,20-24,1872,0.001387004363455959
STAT,1841,52,50-100,1893,1.4704099039200186E-4
STAT,1848,43,30-34,1891,0.007381193640657984
SIM,1963,8,na,1971,54
STAT,1923,46,35-39,1969,0.0015015310789723002
SIM,1779,85,na,1864,2
STAT,1934,34,35-39,1968,0.12408093664661748
STAT,1860,95,na,1955,0.10808909824191879
STAT,1888,38,50-100,1926,0.014276214785979194
STAT,1889,35,25-29,1924,0.03558570607085281
SIM,1908,10,na,1918,42
STAT,1934,6,na,1940,53.98343836782887
STAT,1873,49,30-34,1922,9.636099816215433E-4
SIM,1880,17,20-24,1897,2
STAT,1896,34,20-24,1930,0.03520166442685598
STAT,1878,34,40-44,1912,0.04438969361091887
SIM,1822,34,na,1856,19
SIM,1847,66,na,1913,12
SIM,1932,24,na,1956,42
STAT,1884,46,na,1930,22.10544261049914
STAT,1931,5,na,1936,52.39483290267726
STAT,1857,28,35-39,1885,0.07386656100773048
STAT,1881,50,45-49,1931,1.4007636231019312E-4
STAT,1915,46,na,1961,36.79092503023851
SIM,1919,17,20-24,1936,3
STAT,1899,25,40-44,1924,0.041285488413095685
STAT,1915,23,15-19,1938,0.05438141128159935
STAT,1873,41,20-24,1914,0.0016219462435476265
STAT,1871,16,20-24,1887,0.1789490707142399
STAT,1836,40,35-39,1876,0.021329365122845445
STAT,1902,20,30-34,1922,0.25268515992654594
STAT,1915,44,50-100,1959,0.0011686403746802387
SIM,1919,13,na,1932,47
STAT,1846,26,45-49,1872,0.010964331925530982
SIM,1920,21,na,1941,47
STAT,1821,83,na,1904,2.465640955833255
STAT,1835,43,45-49,1878,0.008019115678900261
SIM,1922,22,na,1944,50
SIM,1834,70,na,1904,10
STAT,1834,27,50-100,1861,0.0059277758470874745
STAT,1831,28,na,1859,23.098628829766874
STAT,1925,44,35-39,1969,0.0024146106041517752
STAT,1850,32,30-34,1882,0.16262171546874887
STAT,1875,45,40-44,1920,0.001777381807954904
STAT,1946,18,20-24,1964,1.492640611526453
STAT,1849,26,na,1875,20.027577128492585
STAT,1946,21,20-24,1967,1.229060434345514
STAT,1852,40,40-44,1892,0.01944463039034791
STAT,1904,62,na,1966,28.583390491331404
SIM,1848,29,25-29,1877,2
STAT,1845,33,50-100,1878,0.006302408271460938
STAT,1888,26,50-100,1914,0.007501086383077517
STAT,1921,46,30-34,1967,9.99594577379917E-4
STAT,1849,30,25-29,1879,0.09389595806771467
STAT,1906,16,50-100,1922,7.13509867434607E-4
STAT,1813,88,na,1901,0.9060106532582437
SIM,1884,3,na,1887,30
STAT,1929,29,50-100,1958,0.012385254280103498
STAT,1929,24,25-29,1953,1.1552252619591932
STAT,1782,85,na,1867,0.6505740186125596
STAT,1859,21,50-100,1880,0.00372215523648246
STAT,1873,48,40-44,1921,0.0017187073479766665
STAT,1822,45,30-34,1867,5.457722256434312E-4
STAT,1887,65,na,1952,18.44607164195967
STAT,1898,27,20-24,1925,0.15825737941136261
STAT,1837,31,45-49,1868,0.01078588913789004
STAT,1853,16,35-39,1869,0.004172940432290294
STAT,1874,38,50-100,1912,0.012393566339585726
STAT,1908,32,40-44,1940,0.03674696039769748
STAT,1889,32,20-24,1921,0.033094405097345334
STAT,1908,52,na,1960,32.49603978808122
SIM,1852,32,na,1884,28
STAT,1863,23,40-44,1886,0.01868257120552399
STAT,1917,22,50-100,1939,0.006929708563905362
SIM,1825,34,na,1859,21
STAT,1903,29,50-100,1932,0.00902971726812076
STAT,1878,80,na,1958,7.495978047548638
STAT,1885,44,50-100,1929,0.01029179806647311
STAT,1852,97,na,1949,0.04597823947001576
STAT,1877,33,na,1910,24.52900859656151
STAT,1857,21,na,1878,18.61186663978362
STAT,1899,32,50-100,1931,0.01254279348026904
STAT,1905,32,15-19,1937,0.0011801455441603878
STAT,1846,43,20-24,1889,0.001286064082625365
STAT,1807,70,na,1877,8.155173084320596
STAT,1899,44,50-100,1943,9.907237495199951E-4
STAT,1827,49,25-29,1876,4.231994556565194E-4
SIM,1924,37,na,1961,50
STAT,1837,33,40-44,1870,0.026253175326147946
STAT,1857,26,20-24,1883,0.09111282276942544
STAT,1914,32,25-29,1946,0.09226528341931298
STAT,1889,16,15-19,1905,0.07283703718547083
STAT,1847,11,na,1858,31.973359290264728
SIM,1937,24,25-29,1961,3
STAT,1861,33,45-49,1894,0.014602883673668356
STAT,1859,34,30-34,1893,0.13758466533723068
STAT,1914,43,20-24,1957,1.73269241526303E-4
SIM,1894,65,na,1959,22
STAT,1858,25,25-29,1883,0.3343011013789636
STAT,1911,39,25-29,1950,0.009353632025515516
STAT,1929,8,na,1937,50.6570527995977
STAT,1845,45,50-100,1890,0.0014499647712063507
STAT,1870,27,50-100,1897,0.006354631152312904
STAT,1889,3,na,1892,32.36694201854069
STAT,1845,10,na,1855,17.85834
STAT,1852,20,30-34,1872,0.1837276997262242
STAT,1863,21,45-49,1884,0.006342651315608165
STAT,1910,27,15-19,1937,0.006775395444803254
STAT,1831,38,35-39,1869,0.07156726906586532
STAT,1912,35,25-29,1947,0.009625298361136564
STAT,1920,40,40-44,1960,0.002746561585632938
STAT,1934,22,40-44,1956,0.04499467386275316
SIM,1932,32,na,1964,48
STAT,1827,36,50-100,1863,0.01018124981035696
STAT,1904,29,40-44,1933,0.04261637625198587
STAT,1887,27,45-49,1914,0.0121190445093626
STAT,1930,33,20-24,1963,0.03131163243132111
STAT,1952,15,40-44,1967,0.016671504814031225
STAT,1927,25,na,1952,45.617252422982034
STAT,1930,39,35-39,1969,0.031334916451847675
SIM,1866,25,25-29,1891,1
SIM,1914,27,na,1941,35
STAT,1925,41,50-100,1966,0.0014154556945248174
STAT,1894,13,na,1907,33.04592675389276
SIM,1928,27,na,1955,53
STAT,1875,20,25-29,1895,0.5919628191111472
SIM,1869,66,na,1935,11
STAT,1870,50,50-100,1920,1.52184968869031E-4
STAT,1856,29,50-100,1885,0.004733325542206493
STAT,1935,18,45-49,1953,0.006780941607639708
STAT,1843,42,25-29,1885,0.0028046545294947694
STAT,1845,101,na,1946,0.003335573561423899
STAT,1903,43,45-49,1946,0.0014669300609558343
STAT,1860,102,na,1962,0.007580689963860871
STAT,1935,21,45-49,1956,0.0152591495630592
STAT,1833,46,45-49,1879,0.002073077660165441
STAT,1813,48,50-100,1861,0.0074993394280824625
SIM,1912,29,40-44,1941,1
STAT,1877,3,na,1880,31.64512869309907
STAT,1920,5,na,1925,44.72680485875647
STAT,1857,13,na,1870,20.909282964619095
STAT,1899,23,20-24,1922,0.9404513003059808
STAT,1864,15,na,1879,23.682764407062447
SIM,1882,62,na,1944,27
STAT,1858,41,30-34,1899,0.008787923484247138
STAT,1796,99,na,1895,8.231695580453268E-4
STAT,1907,42,35-39,1949,0.0018370961432439597
SIM,1875,60,na,1935,13
STAT,1853,39,25-29,1892,0.01791309310380541
STAT,1883,16,20-24,1899,0.1725813064469227
STAT,1854,70,na,1924,8.57608090949514
STAT,1872,10,na,1882,27.26690945200194
STAT,1909,28,45-49,1937,0.016360233016115024
STAT,1832,47,40-44,1879,9.102757043228436E-4
STAT,1871,32,35-39,1903,0.10096688423254654
STAT,1924,42,35-39,1966,0.0023796102026361885
STAT,1780,76,na,1856,6.6185406792
STAT,1858,60,na,1918,14.512582367805317
STAT,1834,44,40-44,1878,0.01867768982734691
STAT,1871,52,45-49,1923,1.4391856687558723E-4
SIM,1934,19,20-24,1953,4
STAT,1926,19,20-24,1945,1.6438571625237404
STAT,1868,27,35-39,1895,0.09337705178986075
SIM,1836,28,na,1864,12
SIM,1816,73,na,1889,2
SIM,1918,49,na,1967,34
STAT,1915,42,25-29,1957,7.127214278134374E-4
STAT,1935,20,na,1955,49.5420870412987
STAT,1909,31,45-49,1940,0.014992942086825122
STAT,1907,17,30-34,1924,0.023314350111063507
STAT,1885,84,na,1969,6.465432612246677
STAT,1841,20,na,1861,26.89685672049019
STAT,1865,15,15-19,1880,0.061506410815816544
STAT,1904,43,20-24,1947,1.5688199600546662E-4
STAT,1812,49,na,1861,11.871818158144197
STAT,1915,32,na,1947,38.18609813397859
STAT,1839,25,15-19,1864,0.00319999440148505
STAT,1859,44,45-49,1903,0.01173498131414562
STAT,1932,26,na,1958,48.89014976455199
STAT,1854,78,na,1932,4.775779122803355
STAT,1821,41,35-39,1862,0.02921421766542723
STAT,1848,31,20-24,1879,0.020598356155014347
STAT,1878,82,na,1960,6.466879188291297
STAT,1803,64,na,1867,9.370435493798192
STAT,1929,38,na,1967,48.02092967647962
STAT,1817,105,na,1922,2.3237752487127928E-4
STAT,1865,43,30-34,1908,0.010323486457199021
STAT,1924,17,30-34,1941,0.14420433262796603
SIM,1827,65,na,1892,5
STAT,1872,39,35-39,1911,0.07163967305122641
SIM,1878,35,na,1913,27
STAT,1791,68,na,1859,6.639313819753277
SIM,1882,40,na,1922,30
STAT,1881,43,15-19,1924,1.304572757887489E-4
STAT,1874,33,30-34,1907,0.17637985554279295
STAT,1821,85,na,1906,1.7026176850390098
SIM,1887,4,na,1891,26
SIM,1887,18,na,1905,25
STAT,1809,53,45-49,1862,4.652090966772574E-4
STAT,1954,7,na,1961,48.31442431623942
STAT,1859,15,30-34,1874,0.014880063366191246
SIM,1876,0,na,1876,42
STAT,1899,21,25-29,1920,0.7860203487422455
STAT,1870,94,na,1964,0.5774944788593608
SIM,1827,43,na,1870,18
SIM,1872,3,na,1875,27
SIM,1931,39,na,1970,56
SIM,1829,91,na,1920,2
STAT,1824,42,30-34,1866,0.015580691568293361
SIM,1910,43,na,1953,31
STAT,1857,35,na,1892,17.80453547570859
SIM,1892,64,na,1956,28
STAT,1923,41,na,1964,43.16969860167539
SIM,1903,33,na,1936,38
STAT,1933,32,35-39,1965,0.1226496798235206
SIM,1816,51,na,1867,11
STAT,1891,33,30-34,1924,0.21338992874205087
STAT,1820,58,na,1878,12.015502995161023
STAT,1876,44,45-49,1920,0.014995383324246707
STAT,1904,49,35-39,1953,0.0011079510722789478
STAT,1919,19,15-19,1938,0.49450803303992874
STAT,1891,0,na,1891,36.03953116621034
SIM,1882,33,30-34,1915,1
STAT,1868,30,35-39,1898,0.09879197737410418
STAT,1819,40,50-100,1859,0.010398736007227936
STAT,1884,15,25-29,1899,0.05577783588400822
SIM,1898,55,na,1953,24
STAT,1910,33,35-39,1943,0.08720564887610821
STAT,1854,56,na,1910,12.466957401542954
STAT,1908,16,35-39,1924,0.008117171077559632
SIM,1857,87,na,1944,3
STAT,1838,42,50-100,1880,0.00958924939937556
SIM,1907,57,na,1964,33
STAT,1885,47,20-24,1932,1.1794932013315315E-4
STAT,1862,42,35-39,1904,0.015603826277794422
STAT,1867,31,30-34,1898,0.1677654151078948
STAT,1848,15,15-19,1863,0.04814155122898865
STAT,1923,43,30-34,1966,0.0014815600336840471
STAT,1803,86,na,1889,0.8158647076853522
STAT,1938,30,50-100,1968,0.008267977547592335
STAT,1884,40,20-24,1924,0.0015716741121983848
STAT,1844,23,30-34,1867,0.17246668332678033
SIM,1877,10,na,1887,31
SIM,1911,30,na,1941,41
STAT,1883,37,45-49,1920,0.01935837987983981
STAT,1810,91,na,1901,0.2082912362073817
SIM,1822,38,35-39,1860,2
STAT,1881,29,35-39,1910,0.09115753528412725
STAT,1905,42,25-29,1947,6.427879610687156E-4
STAT,1936,24,50-100,1960,0.0062484657681541045
SIM,1909,38,na,1947,37
STAT,1850,35,35-39,1885,0.06531447887165011
STAT,1927,24,50-100,1951,0.008014973079996468
SIM,1851,17,na,1868,26
STAT,1863,26,45-49,1889,0.009901691479971242
SIM,1847,63,na,1910,12
STAT,1834,58,na,1892,13.975591715760846
STAT,1855,1,na,1856,26.58401441862713
STAT,1896,17,45-49,1913,8.580346166212582E-4
STAT,1905,22,na,1927,34.133359541646506
STAT,1894,23,50-100,1917,0.005210059817338947
STAT,1950,22,25-29,1972,1.0890102435577613
SIM,1880,81,na,1961,15
STAT,1829,26,45-49,1855,0.017255066198565896
STAT,1925,38,15-19,1963,2.2880877364620056E-4
STAT,1846,23,40-44,1869,0.020687567518964167
STAT,1890,31,na,1921,29.105047010448505
STAT,1864,19,15-19,1883,0.05441680306935708
STAT,1868,47,20-24,1915,1.1558803934666371E-4
STAT,1867,22,50-100,1889,0.003918469608356198
SIM,1880,33,20-24,1913,2
SIM,1928,41,na,1969,54
SIM,1849,44,na,1893,7
STAT,1921,29,40-44,1950,0.0511739512350667
STAT,1864,22,15-19,1886,0.030065528311809014
STAT,1912,33,45-49,1945,0.015297911523907064
SIM,1819,56,na,1875,5
SIM,1849,46,na,1895,7
STAT,1869,23,35-39,1892,0.056367666361174795
STAT,1898,57,na,1955,27.109939563975185
SIM,1878,89,na,1967,3
STAT,1816,46,45-49,1862,0.0030199482257179918
STAT,1925,16,35-39,1941,0.05049576151106627
STAT,1894,33,40-44,1927,0.055344463468703003
STAT,1857,29,25-29,1886,0.32150983825174856
STAT,1929,21,20-24,1950,1.4036503774979134
STAT,1892,45,40-44,1937,0.0012049403832062205
STAT,1942,9,na,1951,40.999563536245354
STAT,1868,43,40-44,1911,0.0216100194559837
STAT,1859,40,35-39,1899,0.014537880809557625
SIM,1937,18,20-24,1955,1
STAT,1931,35,35-39,1966,0.03194652259269322
STAT,1929,18,20-24,1947,1.7174403521340973
STAT,1859,37,35-39,1896,0.05621677432070682
STAT,1901,40,30-34,1941,0.0011283829383021188
STAT,1934,25,45-49,1959,0.02316229191462917
STAT,1836,59,na,1895,18.756471278862744
STAT,1870,53,40-44,1923,1.029013165401218E-4
SIM,1865,29,25-29,1894,2
SIM,1898,23,na,1921,34
SIM,1872,86,na,1958,4
STAT,1865,101,na,1966,0.026513440405423794
STAT,1937,35,na,1972,37.447618601943994
SIM,1854,47,na,1901,17
STAT,1865,64,na,1929,15.723231814264947
STAT,1880,47,50-100,1927,0.0025705741154079115
STAT,1931,32,25-29,1963,0.12057237679666638
SIM,1874,11,na,1885,29
STAT,1872,33,20-24,1905,0.027540179584996285
STAT,1830,46,50-100,1876,2.47043950220281E-4
STAT,1918,21,45-49,1939,0.012061757363687538
SIM,1879,76,na,1955,5
STAT,1816,53,na,1869,8.117761026359714
SIM,1856,48,na,1904,11
STAT,1914,46,25-29,1960,5.230189010731665E-4
SIM,1962,9,na,1971,48
STAT,1837,36,45-49,1873,0.011953443830512472
STAT,1952,18,45-49,1970,0.005949047849432284
STAT,1831,42,na,1873,20.79762526395886
STAT,1818,62,na,1880,5.140590688621175
STAT,1842,30,15-19,1872,0.0013178050955091247
STAT,1838,29,20-24,1867,0.11416676544158981
STAT,1865,31,20-24,1896,0.024548737563013182
SIM,1809,46,na,1855,5
STAT,1906,16,25-29,1922,0.0825293246566847
STAT,1822,48,35-39,1870,7.589571879532136E-4
SIM,1861,78,na,1939,8
STAT,1832,77,na,1909,3.9071287597473834
SIM,1841,40,na,1881,16
STAT,1908,35,45-49,1943,0.006409881196482499
STAT,1868,15,40-44,1883,0.0018235013218608346
STAT,1918,18,45-49,1936,0.005373883401107979
STAT,1884,20,50-100,1904,0.004019172920766177
STAT,1935,15,40-44,1950,0.019124963225770415
SIM,1848,26,20-24,1874,1
STAT,1946,24,25-29,1970,1.0199497119103453
STAT,1840,42,15-19,1882,1.1288153278691472E-4
STAT,1941,17,30-34,1958,0.12463627964613729
STAT,1889,74,na,1963,16.16985953516363
SIM,1785,70,na,1855,9
SIM,1896,14,na,1910,33
STAT,1851,44,40-44,1895,0.01873276497637527
STAT,1858,22,20-24,1880,0.6016589342363454
STAT,1831,35,30-34,1866,0.055662774949720446
SIM,1811,50,na,1861,11
STAT,1915,54,na,1969,35.74198504107239
SIM,1834,45,na,1879,19
STAT,1924,32,25-29,1956,0.10713034949374534
STAT,1926,40,35-39,1966,0.0024750960951780646
SIM,1845,62,na,1907,21
STAT,1848,36,20-24,1884,0.00519084223145186
SIM,1917,19,20-24,1936,1
SIM,1866,16,na,1882,33
SIM,1864,35,na,1899,22
STAT,1841,52,na,1893,20.963329217303425
STAT,1921,36,50-100,1957,0.0046556919206129695
STAT,1839,48,na,1887,12.489144509123713
STAT,1844,49,25-29,1893,4.405169544775219E-4
STAT,1853,32,40-44,1885,0.02806746694926246
STAT,1870,16,35-39,1886,0.005535341626925145
STAT,1849,77,na,1926,6.702421497365145
STAT,1931,22,15-19,1953,0.0687347295136066
STAT,1895,52,na,1947,27.805562785942076
SIM,1841,58,na,1899,13
STAT,1830,39,30-34,1869,0.02989908486759492
STAT,1870,7,na,1877,27.27675781848856
STAT,1948,18,30-34,1966,0.13852421186589842
STAT,1844,17,na,1861,22.791578983033897
SIM,1871,70,na,1941,13
STAT,1889,37,20-24,1926,0.009437747294260413
STAT,1831,32,20-24,1863,0.028513886853290683
STAT,1940,21,na,1961,36.94876059564891
STAT,1844,26,35-39,1870,0.09292953588141128
STAT,1905,45,35-39,1950,0.0011511144788756656
STAT,1917,8,na,1925,42.390261951189814
STAT,1829,71,na,1900,9.066660036111902
STAT,1806,75,na,1881,5.828497151480727
STAT,1867,19,40-44,1886,0.0017683256883362507
STAT,1947,17,25-29,1964,0.48481967484148336
STAT,1850,40,15-19,1890,1.241985651438541E-4
STAT,1891,36,35-39,1927,0.08722830109339909
STAT,1892,12,na,1904,31.904515140169078
SIM,1823,53,na,1876,10
SIM,1863,59,na,1922,8
STAT,1914,48,40-44,1962,0.0015463623106046515
SIM,1858,29,na,1887,25
STAT,1867,51,40-44,1918,1.0122748258717677E-4
STAT,1875,40,na,1915,23.99793698050987
SIM,1872,30,na,1902,23
STAT,1915,22,30-34,1937,0.29452938636318016
SIM,1913,11,na,1924,47
STAT,1899,26,25-29,1925,0.5810656193251703
STAT,1840,28,35-39,1868,0.09359545924501805
STAT,1887,24,40-44,1911,0.022602547497511914
SIM,1844,23,na,1867,10
STAT,1809,51,na,1860,16.550054242094284
STAT,1927,24,15-19,1951,0.06484112475245829
STAT,1802,53,35-39,1855,1.2920864495934484E-4
STAT,1937,31,20-24,1968,0.023993531193155067
STAT,1890,40,45-49,1930,0.018363171654287448
STAT,1824,45,35-39,1869,0.0018601333062470064
STAT,1840,56,na,1896,15.98239331522403
STAT,1848,92,na,1940,0.2693466595592581
SIM,1899,16,25-29,1915,1
STAT,1827,45,na,1872,15.709438313174175
STAT,1829,49,35-39,1878,0.0011646563624560268
STAT,1937,28,20-24,1965,0.1767299519515103
STAT,1918,40,45-49,1958,0.0017583637372383012
STAT,1818,36,35-39,1854,0.10451726092667392
SIM,1929,27,25-29,1956,2
SIM,1799,76,na,1875,10
STAT,1880,53,na,1933,22.27816469549393
STAT,1857,47,45-49,1904,0.0017584784500384357
SIM,1834,30,30-34,1864,1
STAT,1827,42,40-44,1869,0.017592644953140227
STAT,1893,21,30-34,1914,0.22526910513298212
STAT,1818,45,50-100,1863,0.002488169089941931
STAT,1855,16,45-49,1871,5.502653177913648E-4
STAT,1872,36,30-34,1908,0.0547931108846652
STAT,1833,25,20-24,1858,0.11613575155600177
STAT,1824,40,na,1864,19.644286967747778
STAT,1878,32,45-49,1910,0.01800352640313457
STAT,1956,14,na,1970,51.66677929336099
STAT,1884,43,25-29,1927,0.006246097329305794
STAT,1775,97,na,1872,0.014130108031506704
STAT,1898,35,na,1933,32.083991338811394
STAT,1914,35,50-100,1949,0.004196735072349611
SIM,1935,21,na,1956,52
STAT,1816,40,50-100,1856,0.015182668836082066
STAT,1887,44,20-24,1931,0.001710058125241529
STAT,1864,50,45-49,1914,1.3203569051329546E-4
STAT,1865,46,35-39,1911,0.0012698774919990218
STAT,1852,46,na,1898,19.30989116839827
SIM,1900,31,35-39,1931,1
STAT,1872,75,na,1947,10.53314923268189
STAT,1933,21,35-39,1954,0.12476419106511392
STAT,1910,40,50-100,1950,0.0011160068413601921
SIM,1823,75,na,1898,5
STAT,1826,30,30-34,1856,0.32783582063422567
SIM,1854,76,na,1930,6
STAT,1909,25,40-44,1934,0.04497439180449278
SIM,1873,18,na,1891,30
STAT,1887,43,na,1930,25.0451240442978
STAT,1835,32,na,1867,12.407010913755613
STAT,1945,22,na,1967,39.73589225301285
STAT,1851,42,50-100,1893,0.008907912782368143
STAT,1822,99,na,1921,0.006717841989085636
STAT,1837,98,na,1935,0.015707485787955666
STAT,1848,19,30-34,1867,0.01262765608084484
SIM,1852,10,na,1862,29
STAT,1829,89,na,1918,0.7135781611576084
STAT,1842,103,na,1945,0.0010767629890552641
STAT,1883,31,15-19,1914,0.001388545905512532
STAT,1838,32,15-19,1870,0.0013734394441125076
STAT,1862,31,50-100,1893,0.00793734756687632
STAT,1869,18,50-100,1887,4.7844133339455336E-4
STAT,1893,41,40-44,1934,0.028488934851530145
STAT,1838,29,15-19,1867,0.004415289306623567
STAT,1816,40,15-19,1856,1.9846627379782047E-4
SIM,1915,20,na,1935,33
STAT,1864,19,20-24,1883,0.1625615887058675
STAT,1826,50,40-44,1876,1.0644209445374114E-4
STAT,1916,39,50-100,1955,0.004219898219371253
SIM,1852,64,na,1916,19
STAT,1844,49,na,1893,17.206475948436026
STAT,1856,41,20-24,1897,0.001155700279643956
STAT,1887,11,na,1898,28.230350186888412
STAT,1910,23,na,1933,35.508341432164265
STAT,1935,30,35-39,1965,0.12601058594900524
SIM,1925,11,na,1936,45
STAT,1899,45,35-39,1944,0.0010918473985417295
STAT,1810,99,na,1909,0.006807433412715529
STAT,1936,35,20-24,1971,0.002576718340066921
STAT,1904,32,50-100,1936,0.0075385557831905495
STAT,1927,45,50-100,1972,0.0028379247721778008
STAT,1866,37,45-49,1903,0.018359644822464403
STAT,1922,42,25-29,1964,8.136320960979642E-4
STAT,1928,21,na,1949,45.50859819185507
STAT,1912,30,40-44,1942,0.03851275108614808
STAT,1863,43,20-24,1906,0.001395969246317155
STAT,1863,81,na,1944,4.787916018337291
SIM,1903,19,na,1922,38
STAT,1872,48,25-29,1920,5.819408791291629E-4
SIM,1825,87,na,1912,1
STAT,1850,31,na,1881,22.458356681607057
STAT,1867,96,na,1963,0.2343176403256966
STAT,1901,43,35-39,1944,0.0017468230373190983
STAT,1800,81,na,1881,1.9183616081550072
STAT,1905,23,25-29,1928,0.8236394063976197
STAT,1832,91,na,1923,0.26192924406669527
STAT,1872,54,50-100,1926,1.5027744692051382E-4
SIM,1865,31,na,1896,24
STAT,1892,20,25-29,1912,0.7114363194581421
SIM,1792,72,na,1864,4
STAT,1859,18,35-39,1877,0.005032659640816298
STAT,1829,57,na,1886,13.981452304084012
STAT,1881,26,30-34,1907,0.24043901566578452
STAT,1911,48,30-34,1959,8.361732661499244E-4
STAT,1870,47,20-24,1917,1.1865088698653298E-4
STAT,1841,37,40-44,1878,0.050482952406616224
STAT,1910,21,40-44,1931,0.03147758732737633
STAT,1868,18,45-49,1886,6.398103673306388E-4
STAT,1865,96,na,1961,0.17499374156602726
STAT,1918,15,40-44,1933,0.0030408358004828254
STAT,1856,0,na,1856,28.824152088745063
STAT,1845,41,45-49,1886,0.009023726132072384
STAT,1876,59,na,1935,19.738711049535944
STAT,1962,1,na,1963,50.14732535292804
STAT,1865,19,na,1884,23.263621199600777
SIM,1937,21,na,1958,37
STAT,1878,69,na,1947,15.1511755117387
STAT,1925,35,45-49,1960,0.0081450075156063
SIM,1807,77,na,1884,9
SIM,1832,30,20-24,1862,1
STAT,1933,7,na,1940,53.2919807836389
STAT,1876,56,na,1932,20.71545621779063
STAT,1808,87,na,1895,0.2572642431949471
STAT,1860,42,25-29,1902,0.005214134065227043
STAT,1793,91,na,1884,0.10222699637347525
STAT,1878,37,na,1915,24.32352183221917
STAT,1866,49,na,1915,20.287987798593694
STAT,1860,49,45-49,1909,0.001878556362985851
STAT,1843,33,35-39,1876,0.05111071749051863
STAT,1859,41,40-44,1900,0.017958516252222414
SIM,1859,22,na,1881,21
STAT,1909,40,35-39,1949,0.0018941170977863897
SIM,1871,56,na,1927,20
STAT,1844,42,40-44,1886,0.01799356924745824
STAT,1813,51,45-49,1864,4.4072512785076946E-4
STAT,1860,30,30-34,1890,0.14308369338126253
STAT,1891,21,20-24,1912,0.8483605673631228
STAT,1841,45,35-39,1886,0.0014122808923508544
STAT,1879,33,15-19,1912,0.0014677136646487835
STAT,1880,42,45-49,1922,0.015718590096225324
SIM,1850,54,na,1904,19
STAT,1821,51,na,1872,15.236021696362082
STAT,1921,43,20-24,1964,1.9704939412525257E-4
STAT,1853,36,20-24,1889,0.004895207944322011
STAT,1848,39,25-29,1887,0.018793653013091494
STAT,1824,30,20-24,1854,0.04715875239476768
STAT,1874,44,na,1918,23.130833879728012
STAT,1922,49,45-49,1971,0.002463997226253407
STAT,1793,94,na,1887,0.023453248851482845
STAT,1906,32,30-34,1938,0.14565016683046758
STAT,1902,49,25-29,1951,4.486199316322406E-4
STAT,1844,46,na,1890,17.623289162299994
STAT,1893,29,na,1922,29.876064249600333
STAT,1910,43,45-49,1953,0.0015539093292002918
STAT,1940,25,35-39,1965,0.15214289014268562
STAT,1843,39,50-100,1882,0.005418980970516519
SIM,1803,52,na,1855,10
STAT,1891,48,na,1939,27.27183329737139
SIM,1929,26,na,1955,44
STAT,1776,90,na,1866,0.1994332906085923
STAT,1879,14,na,1893,26.64269499876786
STAT,1892,27,45-49,1919,0.013716769646623817
STAT,1822,42,20-24,1864,9.075232667201154E-4
STAT,1909,19,20-24,1928,0.2629588097813029
STAT,1799,85,na,1884,1.0072818515037787
STAT,1846,27,na,1873,21.209085902870726
STAT,1866,22,50-100,1888,0.0037863399127737118
SIM,1786,87,na,1873,4
STAT,1834,51,50-100,1885,1.1162370904626837E-4
STAT,1912,39,40-44,1951,0.014350631613889553
STAT,1851,40,25-29,1891,0.005475990934539024
STAT,1825,36,45-49,1861,0.02129918538154506
STAT,1880,21,45-49,1901,0.00735484466032728
STAT,1900,33,40-44,1933,0.059882690690201336
SIM,1949,5,na,1954,38
STAT,1910,22,45-49,1932,0.010501889999923873
SIM,1889,41,na,1930,31
STAT,1847,50,45-49,1897,1.5725477995390402E-4
SIM,1796,65,na,1861,7
STAT,1851,19,na,1870,23.284381638179198
SIM,1847,12,na,1859,25
STAT,1842,18,25-29,1860,0.05427490547346454
STAT,1817,43,35-39,1860,0.055494952584507665
STAT,1913,49,50-100,1962,0.002176319443065431
STAT,1937,34,25-29,1971,0.09074792351953037
STAT,1920,43,45-49,1963,0.001819589676795034
STAT,1823,45,50-100,1868,0.0017478192906137324
SIM,1934,4,na,1938,54
STAT,1850,34,na,1884,21.769536971743452
STAT,1883,52,50-100,1935,1.4587925444422824E-4
STAT,1901,42,50-100,1943,0.001025270493709291
SIM,1902,56,na,1958,30
STAT,1892,63,na,1955,22.043431070317364
SIM,1960,10,na,1970,52
STAT,1854,45,50-100,1899,0.001516159460902639
STAT,1943,10,na,1953,41.47677489811722
STAT,1840,25,30-34,1865,0.2496046274954297
SIM,1939,11,na,1950,30
STAT,1921,18,na,1939,41.51948947138899
STAT,1921,24,20-24,1945,1.238330274658779
SIM,1805,65,na,1870,9
STAT,1847,29,50-100,1876,0.008095913547074993
STAT,1831,47,25-29,1878,5.514568520075077E-4
STAT,1910,26,na,1936,36.07712471467178
STAT,1842,36,45-49,1878,0.01772848586000114
STAT,1887,47,30-34,1934,0.0010516536648920909
STAT,1921,25,25-29,1946,0.7327855453400128
STAT,1852,12,na,1864,24.71067537337036
STAT,1893,44,45-49,1937,0.001292738565865326
STAT,1897,42,20-24,1939,1.4627063633635684E-4
STAT,1879,18,20-24,1897,0.1830113235947484
SIM,1879,34,na,1913,15
SIM,1915,23,na,1938,36
SIM,1860,61,na,1921,16
SIM,1861,49,na,1910,23
STAT,1867,54,45-49,1921,1.3505902348811316E-4
SIM,1868,81,na,1949,8
STAT,1890,63,na,1953,21.673995381260447
STAT,1906,35,35-39,1941,0.022389730182242846
STAT,1927,37,50-100,1964,0.005193402429666673
STAT,1936,19,15-19,1955,0.4295543692506122
STAT,1850,20,20-24,1870,0.7471324084697423
SIM,1837,75,na,1912,16
SIM,1935,3,na,1938,61
STAT,1861,26,na,1887,20.361605201813855
STAT,1936,36,25-29,1972,0.009616407069761697
STAT,1900,31,25-29,1931,0.1426127833723391
STAT,1892,41,na,1933,28.682429301349046
STAT,1915,44,40-44,1959,0.0024881346625865116
STAT,1939,4,na,1943,40.0369426987335
STAT,1877,37,20-24,1914,0.007957172873586748
SIM,1938,18,na,1956,36
STAT,1826,53,45-49,1879,1.382530588546956E-4
SIM,1895,69,na,1964,18
STAT,1883,29,50-100,1912,0.006167536353238794
STAT,1939,24,15-19,1963,0.0530568834040566
SIM,1847,34,na,1881,18
STAT,1825,64,na,1889,9.456762563917447
SIM,1897,70,na,1967,36
STAT,1849,15,30-34,1864,0.015393408809688564
STAT,1829,46,30-34,1875,8.370562844702481E-4
STAT,1883,19,25-29,1902,0.05473344271379561
STAT,1851,26,45-49,1877,0.011054463082364267
SIM,1812,66,na,1878,14
STAT,1896,37,30-34,1933,0.07000592267771344
STAT,1893,26,na,1919,30.194396031756
SIM,1902,34,na,1936,32
SIM,1885,2,na,1887,34
STAT,1943,18,na,1961,38.734950272783905
STAT,1932,25,35-39,1957,0.1960208407933107
STAT,1855,86,na,1941,1.5621632411350295
SIM,1856,57,na,1913,9
SIM,1900,2,na,1902,40
STAT,1874,18,50-100,1892,4.957162119228435E-4
STAT,1914,32,30-34,1946,0.1572769700593581
STAT,1882,43,30-34,1925,0.010938184063097975
STAT,1898,48,45-49,1946,0.001773274460101089
STAT,1901,19,50-100,1920,6.818518198659361E-4
SIM,1814,92,na,1906,2
SIM,1887,63,na,1950,16
STAT,1836,19,45-49,1855,8.371101296075686E-4
STAT,1855,16,50-100,1871,4.1269898834352353E-4
STAT,1882,34,na,1916,22.673267743932524
STAT,1897,49,40-44,1946,0.001255644604234496
STAT,1884,34,35-39,1918,0.0983706435081488
STAT,1870,40,35-39,1910,0.01816992696975014
STAT,1833,28,25-29,1861,0.40980825270342847
STAT,1846,46,30-34,1892,7.867217375105191E-4
STAT,1907,59,na,1966,30.648407077690972
SIM,1839,68,na,1907,17
STAT,1830,35,15-19,1865,3.4311106641628404E-4
STAT,1934,36,na,1970,51.74436474696412
STAT,1820,36,na,1856,16.45406893491112
SIM,1875,15,25-29,1890,2
STAT,1874,41,15-19,1915,1.4073345200560505E-4
STAT,1830,68,na,1898,5.49069307593909
STAT,1921,23,50-100,1944,0.007351209296606239
SIM,1772,84,na,1856,2
STAT,1839,41,20-24,1880,0.0010281517268019235
SIM,1917,33,na,1950,38
STAT,1799,56,na,1855,11.764680000000004
STAT,1840,18,15-19,1858,0.059853603515149054
STAT,1883,17,50-100,1900,4.757510527766527E-4
STAT,1830,43,na,1873,9.095693767168846
STAT,1835,104,na,1939,3.0001201695190104E-4
STAT,1869,55,na,1924,20.03493279085886
STAT,1816,50,na,1866,8.614689463771905
STAT,1925,18,50-100,1943,0.004485719895018658
STAT,1901,37,15-19,1938,1.6959796178822806E-4
STAT,1858,44,35-39,1902,0.013593296665691096
STAT,1827,90,na,1917,0.47778775854377575
STAT,1866,30,25-29,1896,0.09509075441897073
STAT,1839,29,30-34,1868,0.1725633517850914
STAT,1881,45,30-34,1926,9.302769600498589E-4
STAT,1925,33,45-49,1958,0.018557679503175283
STAT,1856,16,50-100,1872,4.221485024922285E-4
STAT,1863,46,25-29,1909,5.114369739268131E-4
STAT,1865,19,30-34,1884,0.014681297513642572
STAT,1867,15,25-29,1882,0.056096519985870195
SIM,1863,27,na,1890,14
SIM,1781,80,na,1861,3
STAT,1843,30,30-34,1873,0.090906372857738
STAT,1835,35,na,1870,12.158248656991073
SIM,1826,80,na,1906,5
STAT,1940,22,30-34,1962,0.2907069595457229
STAT,1835,40,40-44,1875,0.012528757064383592
STAT,1872,45,20-24,1917,1.2400449735281083E-4
STAT,1843,83,na,1926,1.6839933425039646
STAT,1881,33,50-100,1914,0.008681682461847383
STAT,1814,54,30-34,1868,1.5711973412799442E-4
SIM,1857,41,na,1898,22
STAT,1952,8,na,1960,46.818798661373584
STAT,1915,47,45-49,1962,0.0021711259882024087
STAT,1845,42,na,1887,13.757814415348635
STAT,1856,51,50-100,1907,1.0993283608781341E-4
STAT,1931,26,50-100,1957,0.012799243268380594
STAT,1921,49,35-39,1970,0.0014336565209913628
SIM,1862,42,na,1904,23
STAT,1894,37,20-24,1931,0.00987913681180517
SIM,1830,32,na,1862,17
STAT,1829,30,50-100,1859,0.009000723407441893
STAT,1841,42,30-34,1883,0.011693403502164463
SIM,1841,72,na,1913,4
STAT,1836,47,50-100,1883,0.002480517724602873
STAT,1822,45,25-29,1867,3.247570236991878E-4
STAT,1860,46,40-44,1906,0.0013957608812926448
STAT,1860,33,35-39,1893,0.08198284907245984
SIM,1828,28,na,1856,19
STAT,1930,36,30-34,1966,0.023683366695229528
STAT,1916,21,35-39,1937,0.09811796664355403
SIM,1803,55,na,1858,9
STAT,1904,48,na,1952,31.838608868593937
STAT,1814,72,na,1886,6.168179747848398
STAT,1816,53,50-100,1869,1.7908756627875796E-4
STAT,1911,36,20-24,1947,0.0025418886205511872
SIM,1898,58,na,1956,21
STAT,1886,48,50-100,1934,0.002515516305724222
STAT,1910,40,40-44,1950,0.0023760733976282106
STAT,1867,45,na,1912,21.744734684323518
STAT,1909,37,na,1946,35.41072303588325
STAT,1827,79,na,1906,4.236701275558504
STAT,1821,49,30-34,1870,0.0013277067453035328
STAT,1870,32,40-44,1902,0.043080446564990375
SIM,1813,62,na,1875,5
STAT,1858,29,40-44,1887,0.02300083008148296
STAT,1894,35,50-100,1929,0.015884085561539075
STAT,1925,32,40-44,1957,0.04617977877955195
STAT,1903,40,40-44,1943,0.002243073922345323
SIM,1907,23,na,1930,37
STAT,1876,88,na,1964,2.9427106427963525
SIM,1849,25,25-29,1874,1
STAT,1940,19,30-34,1959,0.12279681904457744
SIM,1884,74,na,1958,11
STAT,1915,46,40-44,1961,0.0015789019855736144
SIM,1861,46,na,1907,23
STAT,1853,93,na,1946,0.18367610906341114
STAT,1905,17,20-24,1922,0.2558654968146845
STAT,1892,24,40-44,1916,0.025582374683971735
STAT,1843,61,na,1904,7.9266321107653575
STAT,1861,30,40-44,1891,0.0367630067140256
STAT,1838,31,na,1869,21.120064831035126
STAT,1925,41,30-34,1966,0.0015403488474218549
STAT,1918,34,15-19,1952,0.00134159435315501
STAT,1899,42,30-34,1941,0.0010915470211516481
SIM,1838,38,na,1876,8
STAT,1831,44,20-24,1875,0.0015331165431309332
STAT,1854,31,45-49,1885,0.011029239949201474
STAT,1843,86,na,1929,0.9411845249037952
STAT,1818,94,na,1912,0.049945777417254984
STAT,1840,21,15-19,1861,0.033112352972264524
STAT,1850,47,35-39,1897,0.0012406995666393974
SIM,1950,18,na,1968,58
STAT,1905,20,20-24,1925,1.0005078031084367
SIM,1894,33,na,1927,29
STAT,1921,22,20-24,1943,1.2461312730054082
STAT,1819,79,na,1898,3.58871390499562
SIM,1849,12,na,1861,17
STAT,1852,43,45-49,1895,0.012716439061425392
STAT,1868,24,30-34,1892,0.17129842002953474
STAT,1838,17,20-24,1855,0.18175338788425785
STAT,1929,43,30-34,1972,0.0016451265213518892
SIM,1855,19,20-24,1874,1
STAT,1873,40,45-49,1913,0.015369767531916986
STAT,1891,48,35-39,1939,9.570906496577222E-4
STAT,1909,15,na,1924,37.83807289801855
STAT,1797,75,na,1872,3.636521724034101
STAT,1897,45,25-29,1942,4.357701555165915E-4
STAT,1910,30,30-34,1940,0.15219898388594413
SIM,1904,60,na,1964,24
SIM,1905,45,na,1950,40
STAT,1892,41,25-29,1933,0.007969153191532213
STAT,1900,36,45-49,1936,0.005995285417688626
SIM,1812,69,na,1881,14
STAT,1817,40,30-34,1857,0.03864452116313843
STAT,1937,32,na,1969,37.181692780317896
SIM,1915,52,na,1967,31
STAT,1805,76,na,1881,3.158696175295227
SIM,1916,37,na,1953,44
STAT,1882,38,40-44,1920,0.04174344635939496
STAT,1855,32,15-19,1887,0.0010209039926987508
STAT,1816,39,na,1855,9.5464024334193
SIM,1938,17,25-29,1955,1
STAT,1884,31,30-34,1915,0.17176098874733609
SIM,1885,59,na,1944,17
STAT,1922,46,40-44,1968,0.0018024508341171522
STAT,1815,47,40-44,1862,0.002467520951259166
STAT,1806,50,50-100,1856,5.09134337644916E-4
STAT,1868,59,na,1927,18.807783014372585
SIM,1874,67,na,1941,17
STAT,1839,16,na,1855,16.669163796907203
STAT,1918,26,50-100,1944,0.010532875946521669
STAT,1856,82,na,1938,3.380078723134976
STAT,1833,40,15-19,1873,1.2710412254374542E-4
STAT,1847,19,20-24,1866,0.23359208515504054
STAT,1821,34,50-100,1855,0.023072762070342465
STAT,1859,45,na,1904,18.06039143934908
SIM,1838,20,na,1858,14
STAT,1829,39,15-19,1868,5.039776520691537E-4
SIM,1842,57,na,1899,19
STAT,1858,35,50-100,1893,0.009431169628737746
SIM,1892,31,30-34,1923,2
STAT,1840,36,50-100,1876,0.011497448233036658
STAT,1863,30,na,1893,21.29817368407076
SIM,1885,5,na,1890,28
SIM,1881,15,na,1896,26
STAT,1865,30,na,1895,21.757375720730533
SIM,1877,42,45-49,1919,3
STAT,1839,102,na,1941,0.0016179042728498613
STAT,1829,42,15-19,1871,1.222545137256828E-4
STAT,1871,36,15-19,1907,5.625558234975876E-4
STAT,1869,42,45-49,1911,0.014483712503963925
STAT,1876,70,na,1946,14.25026354697331
STAT,1926,40,na,1966,45.64970815239376
SIM,1951,14,na,1965,51
STAT,1862,103,na,1965,0.00632591975547993
STAT,1849,18,35-39,1867,0.00520628073581484
STAT,1955,9,na,1964,51.872455135908254
SIM,1927,9,na,1936,52
STAT,1896,33,15-19,1929,0.0018626822279685083
SIM,1814,47,na,1861,22
STAT,1859,4,na,1863,24.59151852112558
STAT,1900,35,40-44,1935,0.061278537692084085
SIM,1872,19,na,1891,26
STAT,1838,18,50-100,1856,4.993077305665078E-4
STAT,1842,68,na,1910,11.46574449552736
STAT,1894,22,na,1916,30.31027109244075
STAT,1828,41,45-49,1869,0.0066673282992717586
STAT,1855,29,15-19,1884,0.0032819695944123774
STAT,1872,16,45-49,1888,6.74531887579891E-4
SIM,1845,53,na,1898,22
SIM,1885,37,na,1922,23
SIM,1865,82,na,1947,1
STAT,1922,32,15-19,1954,0.001441310563432547
STAT,1928,40,45-49,1968,0.002117162330401174
STAT,1809,50,40-44,1859,3.583209022174926E-4
STAT,1900,47,50-100,1947,0.001912137087601522
STAT,1876,41,40-44,1917,0.022948041239075123
STAT,1895,32,45-49,1927,0.022639262840163172
STAT,1846,49,35-39,1895,0.0011109097879721567
SIM,1935,29,na,1964,56
STAT,1936,33,20-24,1969,0.02353404106621747
STAT,1939,28,30-34,1967,0.39101230540653265
STAT,1774,98,na,1872,0.002377543656543138
STAT,1918,29,na,1947,39.224143695824125
STAT,1914,35,35-39,1949,0.02417703323064852
SIM,1889,44,na,1933,30
STAT,1930,22,50-100,1952,0.008389934978229017
STAT,1939,1,na,1940,41.424609443248094
STAT,1817,102,na,1919,0.0023235238464818096
STAT,1901,18,40-44,1919,0.0025526003976145076
STAT,1867,74,na,1941,10.620238980698307
STAT,1894,20,35-39,1914,0.0752332612782986
SIM,1928,28,20-24,1956,1
STAT,1842,15,20-24,1857,0.17283675656320377
STAT,1856,48,40-44,1904,0.0012246463596340704
STAT,1910,24,45-49,1934,0.01043614634329587
STAT,1882,46,35-39,1928,0.0013454905765274978
STAT,1932,22,30-34,1954,0.37558368737121356
STAT,1944,24,15-19,1968,0.05701933247724111
SIM,1874,45,na,1919,25
SIM,1822,76,na,1898,9
STAT,1871,6,na,1877,27.509241724107063
SIM,1950,9,na,1959,60
SIM,1851,3,na,1854,32
STAT,1904,46,30-34,1950,7.846264405060612E-4
STAT,1900,16,na,1916,35.10814024646675
STAT,1907,37,na,1944,34.73402394883645
SIM,1827,68,na,1895,5
STAT,1857,67,na,1924,11.86706808499881
STAT,1874,41,50-100,1915,0.010766108291711252
STAT,1894,17,35-39,1911,0.007032211869495162
STAT,1789,97,na,1886,0.006246170787661173
STAT,1836,22,50-100,1858,0.005193916464052502
STAT,1885,43,40-44,1928,0.022051477966963714
STAT,1949,17,35-39,1966,0.0484905679694982
STAT,1918,11,na,1929,42.80044908047228
STAT,1919,39,na,1958,39.981933904980096
STAT,1909,35,50-100,1944,0.003989303777407153
STAT,1847,16,15-19,1863,0.0795920855756931
SIM,1854,22,na,1876,17
STAT,1913,15,25-29,1928,0.08826954651327952
STAT,1831,39,40-44,1870,0.04382938116594476
STAT,1923,37,30-34,1960,0.020971622127385483
STAT,1889,43,na,1932,28.09282812657117
STAT,1927,34,na,1961,46.22649182404272
STAT,1878,91,na,1969,2.0018645121508474
SIM,1872,6,na,1878,27
STAT,1878,16,45-49,1894,6.7605734743467E-4
STAT,1882,42,50-100,1924,0.010111976108794324
SIM,1869,75,na,1944,6
STAT,1912,34,20-24,1946,0.02360955300402381
SIM,1850,32,na,1882,21
STAT,1885,53,na,1938,20.922025316451638
STAT,1937,31,15-19,1968,0.0012640727741413565
STAT,1853,20,na,1873,16.107721927327752
STAT,1916,41,25-29,1957,7.265766637157245E-4
STAT,1893,15,30-34,1908,0.020190111339889984
STAT,1812,46,na,1858,12.336979201135058
STAT,1946,24,20-24,1970,1.2278195010176205
SIM,1928,2,na,1930,57
SIM,1846,27,na,1873,15
STAT,1955,17,25-29,1972,0.5720377451171669
STAT,1902,27,15-19,1929,0.006398052642678107
STAT,1899,73,na,1972,20.774761059548144
STAT,1906,38,40-44,1944,0.013658780072395656
SIM,1920,44,na,1964,42
STAT,1865,50,50-100,1915,1.3856549237855646E-4
STAT,1871,36,50-100,1907,0.012299514404646486
STAT,1929,25,30-34,1954,0.48988752827151166
SIM,1880,30,na,1910,31
SIM,1882,65,na,1947,25
SIM,1950,0,na,1950,68
STAT,1927,28,30-34,1955,0.472246889941613
STAT,1864,45,30-34,1909,8.768771458869791E-4
STAT,1822,48,30-34,1870,5.247646840041257E-4
STAT,1932,28,40-44,1960,0.06077365000397683
STAT,1908,35,40-44,1943,0.014075475337648672
SIM,1907,54,na,1961,35
SIM,1905,29,30-34,1934,1
STAT,1914,44,25-29,1958,6.993843342331645E-4
STAT,1925,32,35-39,1957,0.10783865353087625
STAT,1926,27,50-100,1953,0.011863723051679364
SIM,1890,60,na,1950,22
SIM,1935,28,30-34,1963,2
STAT,1901,34,45-49,1935,0.024191853603734957
SIM,1937,27,25-29,1964,2
SIM,1855,63,na,1918,11
SIM,1871,14,na,1885,27
STAT,1805,49,40-44,1854,0.0033433752999851127
STAT,1933,27,45-49,1960,0.022845704074184233
STAT,1868,81,na,1949,5.233223099239585
STAT,1859,33,25-29,1892,0.08106639899693671
STAT,1884,12,na,1896,25.30218348373205
SIM,1859,45,na,1904,18
STAT,1859,31,30-34,1890,0.1393398958791541
STAT,1938,2,na,1940,40.07802730870003
STAT,1904,42,45-49,1946,0.0014873664632761028
STAT,1928,28,20-24,1956,0.22367964238554397
STAT,1842,76,na,1918,7.108170185670766
STAT,1902,45,45-49,1947,0.0018960077894788652
STAT,1913,22,na,1935,36.66953832202965
STAT,1869,23,40-44,1892,0.020128496705989055
STAT,1875,31,15-19,1906,0.0014698508215467033
STAT,1902,50,na,1952,30.800866311178517
SIM,1863,50,na,1913,11
STAT,1930,30,20-24,1960,0.03136649181692935
STAT,1900,32,50-100,1932,0.012705412052003219
SIM,1808,61,na,1869,8
STAT,1900,31,20-24,1931,0.037636007283819016
SIM,1804,71,na,1875,8
SIM,1937,25,30-34,1962,1
STAT,1937,33,50-100,1970,0.008123239442085867
SIM,1936,28,20-24,1964,1
STAT,1827,99,na,1926,0.01147716861268903
STAT,1904,22,20-24,1926,0.9874407056952144
STAT,1929,27,25-29,1956,0.8198204690039702
STAT,1899,53,na,1952,29.002971652313622
SIM,1886,55,na,1941,26
STAT,1934,25,40-44,1959,0.06249115590892489
STAT,1853,32,50-100,1885,0.005929991453304145
SIM,1893,9,na,1902,39
STAT,1865,30,45-49,1895,0.015899433816801225
SIM,1863,19,na,1882,17
SIM,1879,73,na,1952,6
STAT,1912,18,15-19,1930,0.09081379750055582
STAT,1913,33,25-29,1946,0.09080345652394767
STAT,1788,79,na,1867,3.30365149578574
STAT,1945,26,25-29,1971,0.717251598218778
SIM,1880,50,na,1930,30
STAT,1784,97,na,1881,0.013547312536231839
STAT,1917,28,45-49,1945,0.017889894304739227
STAT,1876,17,na,1893,25.65121134946289
STAT,1848,53,na,1901,13.700957040856117
STAT,1935,24,45-49,1959,0.015243743008003845
STAT,1944,27,20-24,1971,0.19585857072921764
STAT,1943,19,50-100,1962,0.003941359139677453
STAT,1833,53,50-100,1886,1.1297668638604885E-4
SIM,1877,19,na,1896,28
STAT,1859,54,50-100,1913,1.1673820468453692E-4
STAT,1919,47,na,1966,39.501825227510885
STAT,1937,19,30-34,1956,0.11747876924437492
SIM,1825,65,na,1890,10
STAT,1902,30,45-49,1932,0.024788814877651957
STAT,1867,20,na,1887,23.05571057863379
STAT,1913,45,20-24,1958,1.0746520002057916E-4
SIM,1932,21,na,1953,52
SIM,1872,55,na,1927,20
STAT,1896,25,na,1921,31.560515884929046
STAT,1868,24,35-39,1892,0.05611905607978042
SIM,1843,50,na,1893,19
SIM,1921,17,20-24,1938,5
STAT,1860,20,15-19,1880,0.030823184234583544
STAT,1934,23,45-49,1957,0.015051957823099963
STAT,1934,38,15-19,1972,2.636111045465802E-4
STAT,1912,1,na,1913,41.760928781757706
SIM,1928,16,na,1944,55
SIM,1914,36,na,1950,37
STAT,1910,21,35-39,1931,0.08814956060759174
SIM,1852,22,25-29,1874,1
STAT,1845,33,na,1878,14.907478203104212
STAT,1909,34,45-49,1943,0.014804079667357632
SIM,1894,42,na,1936,29
STAT,1840,44,30-34,1884,0.009159652340785364
STAT,1907,34,40-44,1941,0.03611274908997005
STAT,1902,8,na,1910,36.65845397061047
STAT,1877,17,40-44,1894,0.0018880370432840562
SIM,1891,14,na,1905,38
SIM,1867,40,na,1907,11
SIM,1875,83,na,1958,1
STAT,1864,32,50-100,1896,0.008218016029250706
STAT,1839,22,15-19,1861,0.023392380855948594
STAT,1913,17,20-24,1930,0.27487682919941037
STAT,1853,26,50-100,1879,0.004691073780533776
SIM,1840,22,na,1862,16
STAT,1928,26,25-29,1954,0.8097035013085265
STAT,1844,22,25-29,1866,0.5582867290745038
STAT,1858,35,30-34,1893,0.040940295975818206
STAT,1922,33,50-100,1955,0.00923420381924791
SIM,1886,75,na,1961,10
STAT,1912,16,20-24,1928,0.2726725499535496
STAT,1907,36,35-39,1943,0.022438253497243592
STAT,1947,20,20-24,1967,1.2489813621623145
STAT,1915,45,25-29,1960,5.323959505474555E-4
STAT,1843,104,na,1947,2.8293729110949136E-4
STAT,1924,34,40-44,1958,0.04530047302161493
STAT,1933,29,40-44,1962,0.06157600603537055
SIM,1874,42,na,1916,25
SIM,1903,44,na,1947,35
STAT,1927,45,20-24,1972,1.3866082497745937E-4
STAT,1917,38,15-19,1955,1.9666565007213252E-4
STAT,1930,32,15-19,1962,0.00165064227889047
SIM,1936,26,25-29,1962,1
STAT,1885,20,20-24,1905,0.684581458570614
STAT,1904,40,20-24,1944,1.5961803705233008E-4
STAT,1819,43,50-100,1862,0.009832320555512423
STAT,1869,25,35-39,1894,0.09412674597676304
STAT,1918,39,15-19,1957,2.0014869235722137E-4
STAT,1861,51,50-100,1912,1.2761508789834169E-4
SIM,1808,53,na,1861,15
STAT,1928,44,25-29,1972,9.028732002135491E-4
STAT,1846,58,na,1904,16.02700590995686
STAT,1889,31,45-49,1920,0.021437418200972943
SIM,1819,45,na,1864,7
STAT,1839,16,50-100,1855,3.557718050832165E-4
STAT,1904,24,15-19,1928,0.046975480759246596
STAT,1918,37,20-24,1955,0.0027533568758646237
SIM,1856,17,na,1873,17
STAT,1923,19,30-34,1942,0.1413720806658419
STAT,1953,18,30-34,1971,0.14654753550878902
STAT,1919,36,25-29,1955,0.010495568805186838
STAT,1940,24,na,1964,36.91145490492276
STAT,1928,29,30-34,1957,0.4798899575370368
SIM,1848,81,na,1929,5
STAT,1943,18,45-49,1961,0.005256985464482506
STAT,1811,84,na,1895,1.885239678059554
STAT,1851,30,15-19,1881,0.0012775849327823338
STAT,1943,28,15-19,1971,0.007460104329853493
SIM,1890,80,na,1970,10
SIM,1879,0,na,1879,37
STAT,1844,20,30-34,1864,0.17623560743836197
STAT,1916,42,50-100,1958,0.0011936145105396017
STAT,1946,3,na,1949,44.09533336608409
SIM,1835,63,na,1898,13
SIM,1880,7,na,1887,35
STAT,1862,96,na,1958,0.113627906253716
SIM,1828,81,na,1909,1
STAT,1908,33,45-49,1941,0.014713838627503853
STAT,1907,18,35-39,1925,0.008005222753817346
SIM,1839,45,na,1884,21
SIM,1956,6,na,1962,47
STAT,1839,40,45-49,1879,0.009814146395562377
STAT,1866,100,na,1966,0.04738766877236181
STAT,1858,51,na,1909,16.462808324129774
SIM,1934,36,na,1970,51
STAT,1860,10,na,1870,22.663615579399632
STAT,1876,30,20-24,1906,0.027674176424913093
STAT,1868,100,na,1968,0.062494543045097065
SIM,1903,64,na,1967,28
STAT,1868,9,na,1877,26.378326335427758
SIM,1863,9,na,1872,21
STAT,1924,36,35-39,1960,0.028361684647595177
STAT,1938,18,35-39,1956,0.041106515645498276
STAT,1868,32,50-100,1900,0.008866923302903102
STAT,1810,49,20-24,1859,1.1401244667769186E-4
STAT,1865,33,na,1898,21.49279743502749
STAT,1834,30,15-19,1864,0.001316140864695221
STAT,1890,35,30-34,1925,0.06535336543998913
STAT,1922,36,30-34,1958,0.020605387661474038
STAT,1938,30,20-24,1968,0.024391746220110703
STAT,1771,90,na,1861,0.4547752051174132
STAT,1886,27,na,1913,24.754601601251757
STAT,1849,15,na,1864,22.169119219060992
STAT,1823,44,30-34,1867,0.008009638559496077
STAT,1807,79,na,1886,3.4750281947679658
STAT,1867,25,30-34,1892,0.24261574268368258
SIM,1887,60,na,1947,20
STAT,1904,0,na,1904,42.074492172811524
STAT,1906,37,30-34,1943,0.016712358530193
STAT,1888,49,35-39,1937,9.035926167231692E-4
STAT,1915,32,50-100,1947,0.008347851735409225
STAT,1905,23,20-24,1928,0.9915003780798826
STAT,1852,15,na,1867,24.042880991811053
STAT,1920,40,35-39,1960,0.002211161245236685
STAT,1840,47,40-44,1887,0.0013528039448603628
STAT,1860,2,na,1862,28.080101239143406
SIM,1858,83,na,1941,1
STAT,1927,29,15-19,1956,0.008504137622196147
STAT,1916,42,35-39,1958,0.0020459176888369883
SIM,1936,29,30-34,1965,2
SIM,1939,0,na,1939,39
SIM,1902,59,na,1961,30
SIM,1869,35,na,1904,17
STAT,1844,71,na,1915,10.426061588637022
STAT,1859,48,50-100,1907,0.0019275424433799625
STAT,1930,15,25-29,1945,0.560226407332006
SIM,1822,39,40-44,1861,1
STAT,1879,27,50-100,1906,0.006620880188772579
SIM,1931,36,na,1967,56
STAT,1905,47,na,1952,32.32526172971587
STAT,1942,17,45-49,1959,0.005182372859213291
SIM,1879,65,na,1944,7
STAT,1826,38,na,1864,19.682807753837068
STAT,1860,41,na,1901,18.87476765357634
SIM,1922,4,na,1926,53
STAT,1878,51,na,1929,22.336041769370414
STAT,1937,24,na,1961,35.31290408813774
STAT,1933,26,35-39,1959,0.19862666378445587
STAT,1900,55,na,1955,28.672611588998503
STAT,1801,54,na,1855,10.782666322719637
STAT,1893,18,35-39,1911,0.00690042275387909
STAT,1922,23,25-29,1945,1.0482588192056976
STAT,1903,28,15-19,1931,0.006427733991599614
STAT,1907,34,na,1941,34.90132823996471
STAT,1843,24,30-34,1867,0.09348442421131063
SIM,1824,71,na,1895,10
STAT,1919,38,20-24,1957,0.0028045912518847474
STAT,1873,20,na,1893,24.188742497478763
STAT,1887,20,25-29,1907,0.6285684343479877
STAT,1924,14,na,1938,46.7254290244131
STAT,1889,23,50-100,1912,0.004977279784734627
SIM,1866,55,na,1921,27
STAT,1852,17,35-39,1869,0.005679775996725816
STAT,1828,61,na,1889,12.741546719908465
STAT,1832,37,35-39,1869,0.04013867709804012
STAT,1916,27,45-49,1943,0.017710220839834895
SIM,1822,37,na,1859,18
STAT,1908,32,35-39,1940,0.08581121078030805
STAT,1885,21,30-34,1906,0.17642998792052575
STAT,1901,15,35-39,1916,0.007713589613349966
STAT,1953,19,15-19,1972,0.545458350123404
STAT,1862,47,20-24,1909,1.0304908924007599E-4
STAT,1897,10,na,1907,34.39837396240451
STAT,1907,39,40-44,1946,0.013681642984602737
SIM,1893,49,na,1942,35
STAT,1881,48,40-44,1929,0.0016085733884268567
STAT,1925,35,40-44,1960,0.017885643882727856
STAT,1939,17,40-44,1956,0.013904716980358157
STAT,1866,27,na,1893,21.97943879536402
STAT,1893,37,50-100,1930,0.015480330533359959
STAT,1922,38,25-29,1960,0.011110283617311208
STAT,1822,49,40-44,1871,9.16049298652296E-4
SIM,1869,7,na,1876,19
STAT,1954,16,25-29,1970,0.5328165798939273
SIM,1893,21,30-34,1914,1
STAT,1888,81,na,1969,10.455013843621892
SIM,1891,22,na,1913,38
STAT,1917,25,40-44,1942,0.04876549782340756
STAT,1871,81,na,1952,5.391424045170563
STAT,1901,30,25-29,1931,0.1444736255215047
STAT,1905,36,50-100,1941,0.003842961139109272
STAT,1794,87,na,1881,0.6677089001615184
SIM,1913,23,20-24,1936,2
STAT,1859,15,25-29,1874,0.052903503897707094
STAT,1959,5,na,1964,51.135872963120796
SIM,1856,8,na,1864,23
SIM,1879,45,na,1924,14
STAT,1911,20,40-44,1931,0.03187198012939118
STAT,1921,49,na,1970,40.85134637993629
STAT,1904,25,25-29,1929,0.6102453251807409
STAT,1921,42,45-49,1963,0.0018599149911149152
SIM,1861,24,na,1885,27
STAT,1831,84,na,1915,2.6995408768155755
STAT,1869,26,45-49,1895,0.010795105887079529
STAT,1913,42,na,1955,35.91473185114274
SIM,1912,25,25-29,1937,2
STAT,1883,6,na,1889,25.5008224118468
STAT,1899,36,30-34,1935,0.07330953511938411
SIM,1835,22,25-29,1857,1
STAT,1798,104,na,1902,3.389593940930323E-4
STAT,1930,14,na,1944,50.82130186808383
STAT,1852,35,na,1887,20.698417715830928
STAT,1934,22,35-39,1956,0.1260026916749777
STAT,1926,31,40-44,1957,0.04707578096517052
STAT,1924,37,45-49,1961,0.007986401571543162
STAT,1916,45,45-49,1961,0.002220547466762986
SIM,1814,61,na,1875,20
SIM,1846,78,na,1924,2
STAT,1855,94,na,1949,0.14071594086813144
STAT,1862,3,na,1865,27.917749202924135
SIM,1910,46,na,1956,31
STAT,1790,97,na,1887,0.006017560936832774
STAT,1863,49,30-34,1912,8.391700286863028E-4
STAT,1931,39,na,1970,49.4991467480107
SIM,1897,39,na,1936,40
STAT,1900,19,35-39,1919,0.007568046148857724
STAT,1859,25,na,1884,19.576006884655506
STAT,1872,35,na,1907,24.334590748590138
STAT,1924,33,30-34,1957,0.1825029922517359
STAT,1936,35,15-19,1971,1.877079821645436E-4
STAT,1936,20,45-49,1956,0.010699526882848398
STAT,1945,23,20-24,1968,1.2095307127669421
STAT,1840,47,35-39,1887,0.0011062649107313773
STAT,1783,95,na,1878,0.013247608756404529
STAT,1815,43,50-100,1858,0.015944768517103036
STAT,1868,21,30-34,1889,0.17362415477881732
STAT,1913,18,30-34,1931,0.0246478346409802
SIM,1862,65,na,1927,17
STAT,1850,45,50-100,1895,0.0022085370169032197
SIM,1853,37,na,1890,22
SIM,1921,38,na,1959,41
STAT,1862,68,na,1930,13.184747920024826
STAT,1810,46,45-49,1856,0.0023318051729895786
STAT,1844,48,50-100,1892,0.001894265072727013
STAT,1835,22,50-100,1857,0.002981730577269126
STAT,1943,15,40-44,1958,0.014732081619880707
STAT,1895,63,na,1958,23.888022071974333
STAT,1861,101,na,1962,0.014623105382287758
STAT,1872,66,na,1938,16.76986344595373
STAT,1877,19,na,1896,25.931035923625316
STAT,1912,17,30-34,1929,0.02445434734246811
STAT,1836,28,na,1864,26.820655391056263
STAT,1895,20,50-100,1915,0.005325748293206046
STAT,1895,15,35-39,1910,0.0071567426512321
STAT,1806,86,na,1892,1.0382007197975998
STAT,1890,7,na,1897,31.64733700969264
SIM,1938,26,na,1964,39
STAT,1857,26,50-100,1883,0.0049681985437923714
STAT,1918,21,40-44,1939,0.03604419765655743
SIM,1860,30,na,1890,22
STAT,1879,45,na,1924,23.518229186526913
SIM,1920,17,30-34,1937,1
SIM,1815,55,na,1870,10
STAT,1938,33,25-29,1971,0.09226512349483391
STAT,1835,63,na,1898,8.025672969270024
STAT,1928,25,15-19,1953,0.008713464906890388
STAT,1869,22,30-34,1891,0.17259058567894686
STAT,1946,25,30-34,1971,0.4337676483168812
STAT,1901,16,45-49,1917,9.162824478528426E-4
SIM,1881,24,na,1905,21
SIM,1844,12,na,1856,13
STAT,1817,38,na,1855,24.810654030600592
STAT,1867,28,35-39,1895,0.09201141565370702
STAT,1948,19,35-39,1967,0.04767197120957041
STAT,1835,43,na,1878,11.186037424213069
STAT,1888,17,15-19,1905,0.0693510435932886
STAT,1906,40,na,1946,34.0340053950314
STAT,1938,15,30-34,1953,0.11999781352283871
SIM,1886,47,na,1933,27
SIM,1915,0,na,1915,42
STAT,1848,61,na,1909,12.08446177124329
STAT,1884,25,30-34,1909,0.24839398407721977
STAT,1914,16,na,1930,39.718758049267876
STAT,1922,39,35-39,1961,0.02726251335542919
SIM,1807,68,na,1875,14
STAT,1832,40,50-100,1872,0.005961433759478315
STAT,1840,29,40-44,1869,0.028848603817513828
STAT,1919,33,20-24,1952,0.02597748030136237
STAT,1877,10,na,1887,27.07332022060716
STAT,1883,58,na,1941,19.20408256551092
STAT,1891,25,na,1916,29.49004420808279
STAT,1881,48,35-39,1929,0.001315422166466692
STAT,1830,39,25-29,1869,0.016152379092678127
STAT,1890,60,na,1950,23.16656673711721
STAT,1902,17,45-49,1919,9.211692434264734E-4
STAT,1914,47,na,1961,36.13314905453372
SIM,1944,26,na,1970,32
STAT,1824,71,na,1895,9.287704169489748
STAT,1873,38,35-39,1911,0.07155319780592434
SIM,1890,29,na,1919,26
STAT,1922,20,15-19,1942,0.060959219773546895
STAT,1950,22,20-24,1972,1.310954842414526
STAT,1925,0,na,1925,54.08132856806989
STAT,1851,73,na,1924,10.02737509536642
STAT,1903,29,25-29,1932,0.5971149215904039
STAT,1954,15,15-19,1969,0.5581382239958079
STAT,1839,25,20-24,1864,0.08274271171782391
STAT,1866,25,50-100,1891,0.005931418418900349
STAT,1878,17,50-100,1895,5.058007552000912E-4
STAT,1893,30,20-24,1923,0.034356213718869724
STAT,1952,18,15-19,1970,0.5404711064884192
STAT,1929,40,20-24,1969,2.282461538754975E-4
STAT,1953,15,50-100,1968,0.0045083650172774055
STAT,1904,9,na,1913,37.17825591656263
STAT,1931,26,30-34,1957,0.5038503919873425
STAT,1886,42,50-100,1928,0.010944728171722387
STAT,1886,78,na,1964,10.883044121128725
STAT,1888,46,30-34,1934,0.0011344145917221268
STAT,1904,17,na,1921,36.18917497122815
STAT,1905,24,30-34,1929,0.25546490695204527
STAT,1905,26,25-29,1931,0.6126067145238479
SIM,1846,58,na,1904,10
STAT,1852,22,50-100,1874,0.004146036199695396
STAT,1804,71,na,1875,7.194809693397683
STAT,1860,24,30-34,1884,0.1471414639691419
SIM,1868,50,na,1918,31
STAT,1894,17,40-44,1911,0.002344070758883954
STAT,1892,48,45-49,1940,0.0016239550918608894
STAT,1897,23,15-19,1920,0.04367419606333821
STAT,1922,20,20-24,1942,1.2733620078714667
SIM,1927,23,na,1950,52
SIM,1830,63,na,1893,7
STAT,1797,84,na,1881,0.971191754677792
STAT,1804,82,na,1886,2.007999228482548
STAT,1858,31,15-19,1889,0.0010949545062656884
SIM,1868,32,30-34,1900,1
STAT,1913,25,50-100,1938,0.00990152468825868
SIM,1911,29,25-29,1940,1
STAT,1916,24,40-44,1940,0.034713093877170066
STAT,1858,20,na,1878,18.938475843354617
SIM,1941,25,25-29,1966,2
STAT,1859,76,na,1935,7.530124245977795
STAT,1876,15,30-34,1891,0.016263279412302354
STAT,1882,30,45-49,1912,0.016846143433058944
SIM,1858,25,30-34,1883,1
STAT,1911,20,45-49,1931,0.010665574933419218
STAT,1902,19,50-100,1921,6.871719012102541E-4
SIM,1782,74,na,1856,7
STAT,1840,30,50-100,1870,0.008928231611662348
STAT,1933,25,25-29,1958,0.871155854530131
SIM,1850,63,na,1913,16
SIM,1848,50,na,1898,30
STAT,1848,18,25-29,1866,0.04516145850658038
STAT,1863,101,na,1964,0.020177233037884285
STAT,1920,26,20-24,1946,0.19921837935949352
STAT,1881,29,30-34,1910,0.2379041287193411
STAT,1841,104,na,1945,6.528699044571702E-4
STAT,1845,24,35-39,1869,0.04174097359587752
STAT,1875,36,50-100,1911,0.012681228654091948
STAT,1903,40,35-39,1943,0.0018058208318485762
STAT,1920,44,20-24,1964,1.9274428954308377E-4
STAT,1880,61,na,1941,19.649695185040592
STAT,1840,33,na,1873,20.470776395534003
SIM,1899,42,na,1941,28
STAT,1903,47,25-29,1950,4.597845427804386E-4
STAT,1942,16,35-39,1958,0.04354413243990697
STAT,1899,32,15-19,1931,0.0019494665348653956
STAT,1921,39,50-100,1960,0.0046415529030281255
STAT,1859,37,40-44,1896,0.03479313163019632
STAT,1904,27,20-24,1931,0.16809887275168034
STAT,1907,35,25-29,1942,0.009176592315971207
STAT,1924,32,20-24,1956,0.028272070136502975
STAT,1849,45,30-34,1894,7.580617270306249E-4
SIM,1857,10,na,1867,23
STAT,1904,43,25-29,1947,6.343489322650033E-4
STAT,1891,49,40-44,1940,0.001160530491763382
SIM,1878,80,na,1958,6
SIM,1870,29,na,1899,24
STAT,1924,39,40-44,1963,0.017500025924158422
SIM,1930,20,20-24,1950,3
STAT,1876,25,na,1901,24.40306465022596
SIM,1933,31,na,1964,49
STAT,1889,19,25-29,1908,0.06900748446847643
SIM,1913,26,25-29,1939,2
STAT,1871,25,na,1896,23.955069110803628
SIM,1833,29,na,1862,12
STAT,1866,35,na,1901,21.90418474755169
STAT,1922,35,20-24,1957,0.0029827269762561907
STAT,1872,36,25-29,1908,0.02960087583267404
STAT,1900,16,30-34,1916,0.02215618315337391
STAT,1923,22,25-29,1945,1.0673133461831656
STAT,1868,23,25-29,1891,0.5522798832657688
STAT,1888,50,na,1938,25.524161499151678
STAT,1841,74,na,1915,10.862775333486633
STAT,1909,60,na,1969,31.259741473553728
STAT,1853,51,na,1904,13.597001147318425
STAT,1859,19,40-44,1878,0.0016676725217335462
STAT,1841,16,50-100,1857,6.221448178574092E-4
STAT,1925,38,45-49,1963,0.008122710498451199
STAT,1828,84,na,1912,2.2341958083888835
SIM,1862,88,na,1950,4
STAT,1924,18,40-44,1942,0.016504682968370925
SIM,1843,81,na,1924,5
STAT,1851,81,na,1932,4.565301112374352
STAT,1811,53,na,1864,15.504552014164712
SIM,1923,25,35-39,1948,1
STAT,1856,25,na,1881,18.175182911391637
STAT,1807,48,na,1855,14.788220363282992
STAT,1843,20,15-19,1863,0.017820630988225037
SIM,1876,23,25-29,1899,2
STAT,1872,46,50-100,1918,0.0025200406242023637
STAT,1810,100,na,1910,0.003816042948165944
STAT,1831,35,25-29,1866,0.030070694347998438
SIM,1851,25,na,1876,22
STAT,1852,52,50-100,1904,1.2856851212165568E-4
SIM,1887,49,na,1936,24
STAT,1926,31,45-49,1957,0.018929480767145065
STAT,1921,36,15-19,1957,2.1294227692127916E-4
STAT,1897,41,45-49,1938,0.0013863857255286736
STAT,1911,35,45-49,1946,0.006604203192652399
STAT,1902,30,40-44,1932,0.06164737606495392
SIM,1872,95,na,1967,3
STAT,1840,28,30-34,1868,0.2442666545817613
SIM,1828,30,na,1858,18
STAT,1848,48,50-100,1896,0.0015683376327644584
STAT,1857,21,20-24,1878,0.5998659945671981
STAT,1873,35,30-34,1908,0.0547000296654378
STAT,1815,66,na,1881,6.85225204068774
STAT,1930,33,25-29,1963,0.11864805475479193
STAT,1906,34,25-29,1940,0.08471296999045505
STAT,1923,46,50-100,1969,0.0026341145133988277
STAT,1851,47,45-49,1898,0.0019830963506196043
STAT,1905,42,30-34,1947,0.001150797796559701
STAT,1825,33,na,1858,15.811244353906435
SIM,1904,30,20-24,1934,1
STAT,1921,27,20-24,1948,0.20185394145198618
SIM,1948,16,na,1964,34
STAT,1821,46,20-24,1867,1.7212593096185583E-4
STAT,1855,66,na,1921,11.539775728458297
STAT,1880,49,35-39,1929,0.0014414364576901264
SIM,1883,50,na,1933,10
STAT,1916,42,40-44,1958,0.002541306720001375
STAT,1946,21,15-19,1967,0.05883838583929372
STAT,1917,23,45-49,1940,0.01181318530708117
STAT,1932,27,30-34,1959,0.5111327800034363
STAT,1776,93,na,1869,0.04575463194502156
STAT,1920,24,na,1944,40.00032819773403
STAT,1886,22,30-34,1908,0.18476081237550288
STAT,1884,43,na,1927,22.480838396671995
STAT,1847,99,na,1946,0.020230988402099102
STAT,1910,57,na,1967,32.5713996034119
STAT,1869,86,na,1955,2.1498502031358586
STAT,1921,24,15-19,1945,0.05928215770419066
SIM,1805,56,na,1861,14
SIM,1924,26,35-39,1950,2
SIM,1815,63,na,1878,7
STAT,1865,15,20-24,1880,0.1837406700476538
STAT,1877,17,35-39,1894,0.005664110801906892
STAT,1915,46,35-39,1961,0.0012911581687503739
STAT,1926,28,15-19,1954,0.008384740258580907
STAT,1931,16,25-29,1947,0.5660892947846249
STAT,1867,40,20-24,1907,0.0015351131928750229
STAT,1829,49,30-34,1878,8.052766845332348E-4
STAT,1915,27,30-34,1942,0.39620248699231597
STAT,1896,27,50-100,1923,0.008402589795392143
STAT,1905,36,30-34,1941,0.016682126676981233
STAT,1887,47,25-29,1934,6.257773813426537E-4
STAT,1926,46,45-49,1972,0.0026730020086424573
SIM,1859,14,na,1873,23
STAT,1832,34,30-34,1866,0.09993834057092876
STAT,1850,48,40-44,1898,0.0015051517690156902
STAT,1840,19,50-100,1859,4.912029753719489E-4
STAT,1901,45,50-100,1946,0.001957857537155078
SIM,1855,32,na,1887,19
STAT,1897,19,na,1916,33.35906053954073
STAT,1794,104,na,1898,1.4470800878683084E-4
STAT,1931,16,na,1947,48.081897416919794
STAT,1791,99,na,1890,0.003476205125331922
STAT,1917,41,45-49,1958,0.0017235337619318847
STAT,1916,26,35-39,1942,0.154436280753416
STAT,1856,22,15-19,1878,0.02775672047917558
STAT,1931,32,30-34,1963,0.20552972247701945
STAT,1850,15,50-100,1865,5.393724752026623E-4
SIM,1842,88,na,1930,3
STAT,1804,74,na,1878,5.414117718405638
STAT,1857,23,15-19,1880,0.02830627942200827
STAT,1853,19,45-49,1872,4.8805205557176165E-4
STAT,1845,21,30-34,1866,0.13019491501604244
STAT,1827,48,na,1875,15.117101419501852
STAT,1888,20,40-44,1908,0.024496643100474134
STAT,1866,58,na,1924,18.213307995430203
STAT,1882,65,na,1947,16.195650647552913
STAT,1915,25,35-39,1940,0.15284253745343648
STAT,1814,81,na,1895,2.4097647870811536
STAT,1930,17,20-24,1947,1.7445796944026675
STAT,1776,82,na,1858,1.08373058939446
STAT,1917,44,45-49,1961,0.0017153255292849945
STAT,1878,30,25-29,1908,0.10659644989731892
STAT,1952,18,50-100,1970,0.004461785887074214
SIM,1880,39,na,1919,32
SIM,1866,1,na,1867,40
SIM,1911,39,na,1950,40
STAT,1900,32,30-34,1932,0.24211075636887763
STAT,1933,4,na,1937,53.81013225530028
STAT,1783,92,na,1875,0.05774309823231846
STAT,1863,49,35-39,1912,0.0012136756618731737
STAT,1912,34,15-19,1946,0.0012438433060052365
SIM,1873,29,na,1902,27
STAT,1906,19,30-34,1925,0.023031806754202373
STAT,1909,47,20-24,1956,1.009782082872781E-4
STAT,1936,18,30-34,1954,0.1156855167861091
STAT,1898,22,20-24,1920,0.9296301387950209
STAT,1951,16,na,1967,43.57740545454115
STAT,1864,100,na,1964,0.03619118163436955
STAT,1828,100,na,1928,0.007130103213095035
STAT,1904,26,50-100,1930,0.009197548261877755
STAT,1922,36,50-100,1958,0.004746739164173264
SIM,1892,21,15-19,1913,1
STAT,1893,33,25-29,1926,0.12860167996262345
STAT,1937,15,15-19,1952,0.4407567680230496
STAT,1933,22,20-24,1955,1.4689334968286651
STAT,1942,15,50-100,1957,0.003888840457633681
STAT,1875,48,45-49,1923,0.0023954614497431847
STAT,1920,29,25-29,1949,0.710770924627629
SIM,1856,5,na,1861,23
STAT,1934,28,45-49,1962,0.02313103686868942
STAT,1862,65,na,1927,14.580398850568637
STAT,1855,39,30-34,1894,0.037146286694131114
STAT,1826,42,25-29,1868,0.00679772580978623
SIM,1900,47,na,1947,34
STAT,1927,30,45-49,1957,0.01927977722178302
STAT,1898,40,20-24,1938,1.5027306154517342E-4
STAT,1916,42,na,1958,37.73410882154426
STAT,1887,22,45-49,1909,0.007611318934763615
STAT,1901,31,40-44,1932,0.06093031559339489
STAT,1860,41,50-100,1901,0.008627527203619605
SIM,1836,48,na,1884,4
STAT,1896,5,na,1901,34.42303027278459
SIM,1947,23,na,1970,37
STAT,1830,36,20-24,1866,0.0046076391569055625
STAT,1848,84,na,1932,2.1513320681476533
STAT,1893,68,na,1961,20.82543389845659
STAT,1862,76,na,1938,8.173863642894176
SIM,1847,88,na,1935,2
STAT,1893,57,na,1950,25.33898227231129
STAT,1884,21,15-19,1905,0.032419835927563444
STAT,1856,28,na,1884,17.78649366690336
STAT,1939,29,40-44,1968,0.04648993898642154
STAT,1876,18,35-39,1894,0.005558339992292289
STAT,1880,20,50-100,1900,0.004313718106665346
SIM,1802,68,na,1870,9
SIM,1840,30,na,1870,17
STAT,1889,16,20-24,1905,0.21758912346260306
STAT,1941,15,35-39,1956,0.04293032097265262
STAT,1829,28,50-100,1857,0.006755532251442079
STAT,1869,41,50-100,1910,0.01028271700073822
STAT,1769,89,na,1858,1.715924412091681
STAT,1856,40,45-49,1896,0.010951561869181933
SIM,1900,24,25-29,1924,1
STAT,1931,29,35-39,1960,0.1927820798168325
STAT,1929,24,20-24,1953,1.390664743700978
STAT,1859,34,35-39,1893,0.07980249370917425
STAT,1864,48,35-39,1912,0.0012399142239381685
STAT,1880,35,50-100,1915,0.013032978345290413
STAT,1914,16,25-29,1930,0.08911738589463296
STAT,1869,20,35-39,1889,0.057123233536388734
SIM,1910,54,na,1964,28
STAT,1835,74,na,1909,4.991749681285056
STAT,1827,29,45-49,1856,0.011994068665141496
SIM,1866,20,25-29,1886,2
STAT,1899,38,50-100,1937,0.003609646649187395
STAT,1803,89,na,1892,0.39371301003237813
SIM,1848,73,na,1921,11
STAT,1876,28,na,1904,24.153301931559362
STAT,1845,73,na,1918,6.942994331291575
STAT,1908,38,45-49,1946,0.006318084570993125
STAT,1849,41,15-19,1890,1.0756472984106461E-4
STAT,1811,52,50-100,1863,5.731709133363059E-4
STAT,1903,44,20-24,1947,1.5467662741106285E-4
SIM,1858,80,na,1938,6
STAT,1851,25,50-100,1876,0.006415001446014292
STAT,1913,30,20-24,1943,0.02425833752448285
STAT,1862,22,40-44,1884,0.01840425255871565
SIM,1860,22,na,1882,24
STAT,1918,24,45-49,1942,0.011950170057771988
STAT,1858,20,25-29,1878,0.5070532471722287
STAT,1879,53,na,1932,21.927683298801004
STAT,1831,46,50-100,1877,0.0023816813655089457
STAT,1835,66,na,1901,7.372150481716609
STAT,1875,35,30-34,1910,0.0553052769239864
STAT,1922,22,45-49,1944,0.012808653391966275
STAT,1935,37,20-24,1972,0.0036697579740877645
SIM,1853,29,na,1882,22
SIM,1900,44,na,1944,35
STAT,1852,32,25-29,1884,0.09076264927973823
SIM,1927,17,20-24,1944,1
STAT,1919,17,20-24,1936,1.4852294831006239
STAT,1911,17,15-19,1928,0.09023093794084196
STAT,1915,43,30-34,1958,0.0012739851787113932
STAT,1846,46,25-29,1892,4.6813193846967767E-4
STAT,1848,15,20-24,1863,0.14381526677660028
STAT,1872,26,15-19,1898,0.004658079835989386
STAT,1814,41,na,1855,14.523892208481843
STAT,1923,38,40-44,1961,0.01720785720809343
SIM,1873,40,na,1913,27
SIM,1846,47,na,1893,14
STAT,1903,26,20-24,1929,0.1673623144235004
STAT,1911,32,40-44,1943,0.03786098146591559
STAT,1846,21,45-49,1867,0.007023338805854198
STAT,1834,47,45-49,1881,0.001768717679786327
STAT,1881,44,25-29,1925,0.006027924137377236
STAT,1923,34,25-29,1957,0.10508809514046559
STAT,1897,37,50-100,1934,0.016303876287192508
STAT,1839,28,25-29,1867,0.2919742254965632
SIM,1856,15,20-24,1871,1
SIM,1917,24,na,1941,37
STAT,1871,37,20-24,1908,0.007685366155474084
STAT,1847,22,45-49,1869,0.009131805436805912
STAT,1913,48,25-29,1961,5.119892088550025E-4
STAT,1924,35,25-29,1959,0.011554758239079246
STAT,1868,27,40-44,1895,0.028989428944863758
STAT,1874,21,20-24,1895,0.7012220080010856
STAT,1822,48,na,1870,9.130586783541888
STAT,1858,91,na,1949,0.4409508322009576
STAT,1861,21,50-100,1882,0.0035485690344047426
SIM,1886,24,na,1910,27
STAT,1891,20,45-49,1911,0.008609738449543426
STAT,1869,46,na,1915,21.861531939095833
STAT,1866,8,na,1874,25.50939595807449
STAT,1890,19,30-34,1909,0.01925695043009393
STAT,1906,32,na,1938,34.96360567257961
STAT,1933,24,40-44,1957,0.044388111929196644
STAT,1798,69,na,1867,12.548992793986304
STAT,1907,37,45-49,1944,0.006293877546718384
STAT,1863,46,30-34,1909,8.59498256132948E-4
STAT,1836,32,40-44,1868,0.052902754308214235
STAT,1906,31,20-24,1937,0.022641252383554078
STAT,1921,21,45-49,1942,0.012647600145042633
STAT,1842,99,na,1941,0.014209285625816352
STAT,1930,19,40-44,1949,0.017902089328666847
STAT,1901,40,na,1941,32.779604596485406
STAT,1880,49,30-34,1929,9.966503502940865E-4
STAT,1940,22,25-29,1962,0.9342821232606496
STAT,1852,66,na,1918,14.027439002270548
SIM,1936,23,20-24,1959,3
SIM,1839,22,na,1861,23
STAT,1833,27,50-100,1860,0.006242038036878052
STAT,1886,25,35-39,1911,0.10076409431323195
SIM,1927,31,na,1958,51
STAT,1844,23,35-39,1867,0.05650179068692258
STAT,1887,16,50-100,1903,5.360635033298079E-4
STAT,1905,20,15-19,1925,0.04789696463206565
STAT,1915,57,na,1972,35.08833857362094
SIM,1829,55,na,1884,19
STAT,1822,47,50-100,1869,0.0013489485143390858
STAT,1823,47,35-39,1870,9.720421556004108E-4
STAT,1868,50,na,1918,21.136618229526018
STAT,1937,35,30-34,1972,0.01814123527471892
STAT,1870,40,na,1910,23.19126247405518
STAT,1917,21,25-29,1938,0.9757293318733602
SIM,1819,48,na,1867,7
STAT,1788,70,na,1858,7.752987385532942
STAT,1900,35,35-39,1935,0.09901039552154223
STAT,1890,38,35-39,1928,0.08548884366629655
SIM,1835,55,na,1890,16
STAT,1855,29,20-24,1884,0.08486235597509235
STAT,1955,0,na,1955,52.285850981454175
STAT,1821,49,25-29,1870,7.900403697564025E-4
STAT,1920,47,25-29,1967,5.813795114856969E-4
SIM,1795,92,na,1887,1
STAT,1893,43,35-39,1936,0.0015740573342232084
STAT,1864,91,na,1955,0.5197472288587004
STAT,1915,19,45-49,1934,0.0010309252200944264
STAT,1875,94,na,1969,0.8725608617898599
SIM,1845,22,na,1867,21
STAT,1937,33,45-49,1970,0.015460359033599776
STAT,1857,98,na,1955,0.02431884038809846
STAT,1907,32,20-24,1939,0.022703314574714615
STAT,1839,25,na,1864,15.257691460305395
STAT,1866,15,35-39,1881,0.005248664731806954
STAT,1868,61,na,1929,18.083632976626202
STAT,1790,74,na,1864,2.736241132875662
SIM,1866,47,na,1913,27
SIM,1896,38,50-100,1934,1
STAT,1831,31,50-100,1862,0.009771149200874543
STAT,1926,43,40-44,1969,0.0030610500725282343
SIM,1822,45,na,1867,15
STAT,1888,23,45-49,1911,0.008123706120966901
STAT,1865,18,25-29,1883,0.05250608697610107
STAT,1874,13,na,1887,26.401352210282337
SIM,1937,24,20-24,1961,1
STAT,1821,74,na,1895,6.892770276624216
STAT,1885,24,35-39,1909,0.057265479616559097
STAT,1786,92,na,1878,0.04874717967447839
STAT,1828,33,na,1861,19.35843059133858
STAT,1857,10,na,1867,21.26781777227827
STAT,1928,23,20-24,1951,1.3772649168508673
SIM,1894,25,35-39,1919,1
STAT,1899,45,na,1944,31.111661418745996
STAT,1850,88,na,1938,1.2223249039861053
SIM,1943,16,na,1959,43
SIM,1906,6,na,1912,29
STAT,1929,43,25-29,1972,9.188995021724395E-4
STAT,1928,41,20-24,1969,2.2435972498824076E-4
STAT,1891,15,50-100,1906,6.041023502650568E-4
STAT,1894,53,na,1947,27.15250212118728
STAT,1905,39,35-39,1944,0.021811174464134078
STAT,1867,43,25-29,1910,0.006100798085162115
SIM,1901,18,na,1919,39
STAT,1900,47,na,1947,31.0584629951526
STAT,1834,34,30-34,1868,0.15479887981114654
SIM,1893,57,na,1950,30
STAT,1917,41,40-44,1958,0.002590270465017636
STAT,1876,1,na,1877,35.08402748047752
SIM,1889,75,na,1964,17
STAT,1842,26,50-100,1868,0.0059781948264930685
STAT,1853,16,40-44,1869,0.001390980224632861
SIM,1798,66,na,1864,9
SIM,1885,33,40-44,1918,1
STAT,1846,36,15-19,1882,4.802047711833237E-4
STAT,1887,40,45-49,1927,0.016500778941810845
STAT,1910,54,na,1964,33.17815903278895
STAT,1877,33,40-44,1910,0.044577322068273535
SIM,1877,39,na,1916,27
SIM,1886,44,na,1930,27
STAT,1870,41,45-49,1911,0.014934724354093818
SIM,1833,51,na,1884,10
STAT,1895,60,na,1955,24.760059880642583
STAT,1847,19,15-19,1866,0.07819396080978086
SIM,1921,5,na,1926,42
SIM,1882,54,na,1936,29
SIM,1926,18,15-19,1944,1
SIM,1852,29,45-49,1881,1
STAT,1927,41,35-39,1968,0.00251616114164095
STAT,1829,39,20-24,1868,0.0069182378079803925
STAT,1949,18,45-49,1967,0.005770838334104169
STAT,1858,48,45-49,1906,0.001773264798690743
STAT,1859,22,na,1881,19.50336071904604
STAT,1912,37,20-24,1949,0.0025527421988872966
STAT,1924,15,35-39,1939,0.04987476740794835
SIM,1878,49,na,1927,28
STAT,1920,22,40-44,1942,0.03706193072040919
STAT,1897,16,50-100,1913,6.521881582261871E-4
SIM,1899,22,15-19,1921,2
STAT,1879,30,40-44,1909,0.04524624504368141
STAT,1879,53,50-100,1932,1.538051630938706E-4
SIM,1844,15,na,1859,10
STAT,1868,42,30-34,1910,0.011112162568060172
STAT,1844,29,45-49,1873,0.010464724405058008
STAT,1828,40,35-39,1868,0.008150081400636416
SIM,1941,6,na,1947,49
STAT,1865,19,35-39,1884,0.005054217085679737
STAT,1828,30,na,1858,19.651573456713557
STAT,1856,28,25-29,1884,0.3152678096125992
STAT,1850,47,30-34,1897,8.578551285447669E-4
STAT,1879,22,na,1901,24.478489568809525
STAT,1930,26,15-19,1956,0.00893853751139898
STAT,1860,19,na,1879,21.269694502345445
STAT,1922,27,35-39,1949,0.16864331179399253
STAT,1877,18,15-19,1895,0.06109955521634548
STAT,1891,70,na,1961,18.88392839367049
SIM,1965,0,na,1965,52
STAT,1877,35,35-39,1912,0.07370440837577695
STAT,1930,37,40-44,1967,0.01943487180081202
STAT,1898,25,25-29,1923,0.5745179868267344
STAT,1903,25,45-49,1928,0.01589264220554236
STAT,1892,44,30-34,1936,9.729785689073955E-4
STAT,1936,32,45-49,1968,0.015191916660084565
SIM,1859,42,na,1901,18
SIM,1901,40,na,1941,38
STAT,1848,15,50-100,1863,3.974260441986538E-4
STAT,1865,28,35-39,1893,0.08696613431393499
SIM,1880,53,na,1933,30
STAT,1875,47,35-39,1922,0.0014324097889427429
STAT,1829,46,25-29,1875,4.980830735620087E-4
STAT,1894,32,30-34,1926,0.22376232191299925
STAT,1880,27,20-24,1907,0.1233624391248247
STAT,1896,37,25-29,1933,0.037819291353919586
STAT,1901,37,45-49,1938,0.006020726927470423
STAT,1911,10,na,1921,39.384201732730396
STAT,1818,103,na,1921,3.5864812377597296E-4
STAT,1891,15,30-34,1906,0.01965346712437441
STAT,1798,60,na,1858,17.55290862805828
STAT,1873,25,20-24,1898,0.1200819856339509
SIM,1853,51,na,1904,21
STAT,1868,84,na,1952,3.219332417750354
STAT,1923,2,na,1925,47.69194957392317
SIM,1799,62,na,1861,16
SIM,1914,13,na,1927,37
STAT,1927,11,na,1938,49.087668167952764
STAT,1870,23,na,1893,23.42152598711065
SIM,1818,60,na,1878,21
STAT,1890,49,25-29,1939,3.8643106636844174E-4
STAT,1884,38,45-49,1922,0.019434349980608397
STAT,1921,28,30-34,1949,0.4317601631944374
SIM,1865,62,na,1927,13
SIM,1910,23,na,1933,32
STAT,1895,31,35-39,1926,0.13201245496923733
STAT,1882,16,30-34,1898,0.015312263732291805
STAT,1840,64,na,1904,13.621624107237304
STAT,1929,37,30-34,1966,0.023286921200042016
STAT,1931,32,50-100,1963,0.0107857240717789
STAT,1881,41,20-24,1922,0.0015180126901191545
STAT,1946,6,na,1952,43.57351862968534
STAT,1833,48,40-44,1881,0.0013338925662348426
SIM,1919,8,na,1927,47
STAT,1875,22,20-24,1897,0.7083805831502357
STAT,1923,21,na,1944,42.3233107349697
SIM,1869,52,na,1921,15
STAT,1847,35,20-24,1882,0.008722938004005264
SIM,1859,76,na,1935,5
STAT,1812,69,na,1881,6.879952154020668
STAT,1817,47,45-49,1864,0.0068245198805027005
SIM,1940,21,20-24,1961,1
SIM,1855,52,na,1907,14
STAT,1849,18,40-44,1867,0.0017354270124174346
STAT,1914,25,20-24,1939,0.18373080251679214
STAT,1906,63,na,1969,28.927479987770724
STAT,1904,47,40-44,1951,0.0013773065349062007
STAT,1906,26,40-44,1932,0.043669375750108756
SIM,1901,60,na,1961,31
STAT,1835,36,40-44,1871,0.02481644817082037
STAT,1875,32,na,1907,24.529897532873466
STAT,1913,36,25-29,1949,0.009681807074947337
STAT,1913,11,na,1924,40.10096441575899
STAT,1818,39,45-49,1857,0.023705889987712076
STAT,1957,15,50-100,1972,0.004914389748170333
STAT,1868,47,50-100,1915,0.002365701778297393
SIM,1865,24,25-29,1889,2
STAT,1889,34,15-19,1923,0.0017286147826481172
STAT,1909,20,50-100,1929,0.006117455510346436
STAT,1919,16,na,1935,42.554537728704254
SIM,1873,26,na,1899,27
STAT,1902,33,45-49,1935,0.024487373093995575
SIM,1903,41,na,1944,36
STAT,1915,24,25-29,1939,0.9406410726903686
STAT,1932,21,20-24,1953,1.457452120570764
STAT,1937,30,40-44,1967,0.03851577534523311
STAT,1891,48,30-34,1939,6.617598203205884E-4
STAT,1895,38,20-24,1933,0.00995794838048183
STAT,1935,36,45-49,1971,0.009498978499287394
STAT,1808,95,na,1903,0.019414527157904274
STAT,1876,37,40-44,1913,0.04445992131379481
STAT,1873,37,na,1910,23.953046062014923
STAT,1874,48,30-34,1922,9.696884720817773E-4
STAT,1911,2,na,1913,40.529604622792675
STAT,1943,19,20-24,1962,1.4262467807765897
SIM,1835,32,na,1867,21
SIM,1840,33,na,1873,17
STAT,1819,35,45-49,1854,0.02497078050472062
STAT,1881,26,25-29,1907,0.4038977241132826
STAT,1822,45,na,1867,9.488349324648429
STAT,1813,96,na,1909,0.056668121667752605
STAT,1874,24,25-29,1898,0.5771162041993682
STAT,1904,21,45-49,1925,0.010022022144144991
STAT,1899,42,na,1941,31.709518583878584
STAT,1834,46,35-39,1880,0.0011678766274021881
STAT,1859,21,25-29,1880,0.5225160975160633
STAT,1849,46,na,1895,17.49459941158551
STAT,1862,14,na,1876,23.375186173049464
SIM,1829,38,na,1867,20
STAT,1815,97,na,1912,0.01917722543314116
SIM,1897,16,na,1913,43
STAT,1897,29,25-29,1926,0.55772911177378
STAT,1878,39,30-34,1917,0.05446970950596496
STAT,1931,30,na,1961,49.3936084245386
STAT,1822,32,50-100,1854,0.008532285513246324
STAT,1874,23,15-19,1897,0.033364898226352614
STAT,1949,23,25-29,1972,1.0705929380400194
STAT,1869,40,25-29,1909,0.006284908848275631
SIM,1867,21,25-29,1888,2
STAT,1877,41,na,1918,23.965979916161757
STAT,1919,36,na,1955,40.10372617544843
STAT,1859,33,50-100,1892,0.007251742350142239
SIM,1912,58,na,1970,35
STAT,1831,34,15-19,1865,0.0014699359739898427
STAT,1864,22,45-49,1886,0.006355013272306955
STAT,1834,37,35-39,1871,0.062172557762934975
STAT,1870,19,45-49,1889,6.473935832891901E-4
STAT,1886,26,45-49,1912,0.011556322875493233
STAT,1917,28,50-100,1945,0.010307121534040937
STAT,1831,81,na,1912,4.388269939444402
STAT,1808,47,35-39,1855,0.0010106810071752684
STAT,1776,99,na,1875,0.002408296133456249
STAT,1859,22,35-39,1881,0.04812225527093597
STAT,1932,16,40-44,1948,0.01849140413749344
STAT,1809,46,40-44,1855,0.0059323369230911745
STAT,1827,41,30-34,1868,0.009119046437875734
STAT,1849,32,20-24,1881,0.022085853345387495
STAT,1929,39,25-29,1968,0.012553508905829546
STAT,1840,18,20-24,1858,0.17880316976343624
STAT,1881,25,15-19,1906,0.004346465884544795
SIM,1880,59,na,1939,29
STAT,1913,45,na,1958,35.725300069505565
STAT,1835,97,na,1932,0.024163961803896832
STAT,1851,46,35-39,1897,0.0011852789777441674
STAT,1889,12,na,1901,31.618477891851175
STAT,1923,16,30-34,1939,0.1424834022104864
STAT,1918,36,45-49,1954,0.00715470725593196
STAT,1843,37,45-49,1880,0.009871914400930442
SIM,1951,19,20-24,1970,4
STAT,1850,17,35-39,1867,0.005970019755479102
STAT,1893,51,na,1944,27.279448229966285
STAT,1866,89,na,1955,0.9675235566030944
STAT,1938,20,45-49,1958,0.011070079059507597
SIM,1888,79,na,1967,16
STAT,1873,43,50-100,1916,0.010663278762958582
STAT,1869,48,20-24,1917,1.1481199857757544E-4
STAT,1875,38,35-39,1913,0.07234492272960902
STAT,1832,69,na,1901,6.633425573212617
STAT,1872,35,15-19,1907,5.800133793353168E-4
STAT,1909,46,45-49,1955,0.001990841975717272
STAT,1928,40,40-44,1968,0.003181848348557505
STAT,1837,38,30-34,1875,0.03128592984019902
STAT,1948,19,na,1967,41.81672051403159
STAT,1818,54,na,1872,6.236905496590235
STAT,1919,44,50-100,1963,0.0012578699156613343
STAT,1906,33,50-100,1939,0.007611128522896878
STAT,1848,33,15-19,1881,9.672364850368732E-4
STAT,1841,17,25-29,1858,0.07153757895611697
STAT,1931,20,50-100,1951,0.008546952783017604
SIM,1866,24,na,1890,30
STAT,1954,13,na,1967,48.27578559717644
SIM,1926,38,na,1964,46
STAT,1844,41,30-34,1885,0.009315607719606444
STAT,1858,23,30-34,1881,0.1405024510315117
STAT,1862,0,na,1862,33.2500869820301
STAT,1890,16,25-29,1906,0.06900297188595204
STAT,1881,19,20-24,1900,0.1677900020425391
STAT,1886,48,20-24,1934,1.229079676866496E-4
SIM,1868,59,na,1927,30
STAT,1864,53,50-100,1917,1.332850603888951E-4
SIM,1904,29,na,1933,31
STAT,1852,69,na,1921,12.559943813075263
STAT,1860,37,45-49,1897,0.016206502872223798
SIM,1823,61,na,1884,7
SIM,1941,15,na,1956,40
STAT,1892,47,35-39,1939,9.710735151401982E-4
SIM,1907,8,na,1915,41
STAT,1839,38,35-39,1877,0.04616231638028919
STAT,1940,18,25-29,1958,0.43673580984204563
STAT,1922,42,30-34,1964,0.0014566639080219061
STAT,1853,31,30-34,1884,0.11417972480929021
STAT,1879,15,15-19,1894,0.06170857506604453
STAT,1838,54,na,1892,16.25217691298165
STAT,1928,34,50-100,1962,0.010274352938824562
STAT,1824,54,50-100,1878,1.813683270082322E-4
SIM,1894,73,na,1967,14
STAT,1899,49,45-49,1948,0.0017843246750460287
STAT,1840,98,na,1938,0.025455283909333427
STAT,1861,29,45-49,1890,0.009270421005707222
STAT,1904,36,15-19,1940,1.7450896661797894E-4
STAT,1903,7,na,1910,37.0412132406548
STAT,1907,15,35-39,1922,0.008063542668004842
STAT,1865,33,15-19,1898,0.0012826237743863878
STAT,1839,29,35-39,1868,0.06612096189240234
STAT,1880,42,15-19,1922,1.4503890380433248E-4
STAT,1886,40,25-29,1926,0.0067280892520607495
STAT,1840,25,25-29,1865,0.41929443395194405
STAT,1854,30,35-39,1884,0.06471971856748758
STAT,1918,18,15-19,1936,0.48821740578431344
STAT,1940,13,na,1953,39.71959343898716
SIM,1846,24,na,1870,16
SIM,1888,59,na,1947,27
STAT,1914,26,30-34,1940,0.39307018828239376
STAT,1853,31,na,1884,15.605541197488355
SIM,1871,28,30-34,1899,2
STAT,1846,39,20-24,1885,0.00638972099394993
STAT,1830,38,15-19,1868,3.2163005691909216E-4
STAT,1865,25,30-34,1890,0.22931234255011881
SIM,1943,26,50-100,1969,1
SIM,1891,45,na,1936,33
STAT,1899,22,na,1921,32.375945662187874
STAT,1906,29,45-49,1935,0.016015370654521778
STAT,1891,18,35-39,1909,0.006717012573858686
SIM,1890,69,na,1959,18
STAT,1875,2,na,1877,33.58783274126682
STAT,1802,79,na,1881,2.5048547759022544
STAT,1914,28,25-29,1942,0.655718331626563
STAT,1935,26,50-100,1961,0.013513858473630985
STAT,1832,24,20-24,1856,0.4144706825590362
SIM,1879,42,na,1921,15
STAT,1877,36,45-49,1913,0.02067702991733617
STAT,1886,21,50-100,1907,0.004242642892040152
STAT,1834,21,20-24,1855,0.6560213055667404
STAT,1879,76,na,1955,9.80572256225205
STAT,1846,83,na,1929,3.2172942048794138
STAT,1822,79,na,1901,2.4798354615695786
STAT,1840,15,15-19,1855,0.060923798764718144
STAT,1858,47,35-39,1905,0.0010603559728771758
SIM,1837,67,na,1904,26
STAT,1916,23,30-34,1939,0.2976722114142101
STAT,1923,26,40-44,1949,0.05332560915731302
STAT,1881,80,na,1961,7.78193460979724
STAT,1917,16,50-100,1933,8.008625297607608E-4
SIM,1922,28,25-29,1950,1
SIM,1824,60,na,1884,16
STAT,1839,26,30-34,1865,0.17633438839791868
STAT,1912,4,na,1916,40.36199580763082
SIM,1906,38,na,1944,25
STAT,1895,30,25-29,1925,0.13404401965570026
STAT,1891,41,50-100,1932,0.013025178380646088
STAT,1837,78,na,1915,3.777933434216306
STAT,1848,19,35-39,1867,0.004347225785499291
STAT,1865,16,30-34,1881,0.014943802257448584
STAT,1866,37,50-100,1903,0.011307284370891645
STAT,1824,103,na,1927,9.985948774402348E-4
STAT,1949,15,40-44,1964,0.016172093669946652
STAT,1920,25,45-49,1945,0.018917678300724213
SIM,1840,53,na,1893,12
STAT,1911,38,15-19,1949,1.8336970237398735E-4
SIM,1864,15,na,1879,23
STAT,1934,13,na,1947,53.283918125884654
STAT,1863,28,30-34,1891,0.22217512010812523
STAT,1896,36,15-19,1932,7.411605419100095E-4
SIM,1798,69,na,1867,9
SIM,1889,72,na,1961,19
STAT,1852,36,40-44,1888,0.03806123789711725
STAT,1844,26,40-44,1870,0.02885049512353379
SIM,1930,8,na,1938,53
STAT,1837,32,50-100,1869,0.00560658026530891
STAT,1917,29,20-24,1946,0.18833638904191533
SIM,1905,22,na,1927,35
STAT,1876,43,35-39,1919,0.018258597464537844
SIM,1955,7,na,1962,46
STAT,1824,42,50-100,1866,0.014317392220527164
STAT,1854,33,40-44,1887,0.026864900010559307
SIM,1839,48,na,1887,21
STAT,1860,36,35-39,1896,0.057777676329335066
STAT,1915,21,20-24,1936,1.1429209871438197
STAT,1898,24,15-19,1922,0.04422526076381994
STAT,1835,49,50-100,1884,0.001142580109403722
SIM,1918,6,na,1924,41
STAT,1871,50,na,1921,21.77558066897925
STAT,1908,38,50-100,1946,0.003891163451928522
STAT,1885,27,40-44,1912,0.029581637117661933
STAT,1817,78,na,1895,6.192360330480299
STAT,1871,70,na,1941,13.988654827079259
STAT,1792,75,na,1867,8.315842966396328
STAT,1873,51,na,1924,21.995837651936217
STAT,1850,22,15-19,1872,0.035255438566143674
SIM,1860,39,na,1899,23
STAT,1913,33,20-24,1946,0.02396334655504723
SIM,1947,20,na,1967,40
STAT,1944,26,45-49,1970,0.01854504436647558
SIM,1832,58,na,1890,18
STAT,1862,24,35-39,1886,0.050801663483958204
STAT,1932,24,25-29,1956,1.2029103296171824
SIM,1893,27,40-44,1920,1
STAT,1830,29,15-19,1859,0.0033994164983522416
SIM,1842,21,20-24,1863,1
SIM,1832,75,na,1907,16
STAT,1868,20,20-24,1888,0.6765782067191398
STAT,1921,47,40-44,1968,0.0017634936721471896
STAT,1915,49,40-44,1964,0.001565754668465008
STAT,1940,16,30-34,1956,0.12291355009612372
STAT,1818,36,40-44,1854,0.06468679252750861
STAT,1915,16,40-44,1931,0.002909282723101078
STAT,1901,34,40-44,1935,0.06016279133062872
STAT,1884,23,na,1907,23.100009541979624
SIM,1887,71,na,1958,13
SIM,1864,43,na,1907,21
STAT,1860,27,35-39,1887,0.07928364848988388
STAT,1875,60,na,1935,19.604704059973404
STAT,1860,33,na,1893,19.318189352251725
STAT,1931,17,35-39,1948,0.05468011389036917
STAT,1858,29,na,1887,18.324434845224694
STAT,1840,24,15-19,1864,0.03240422169662535
STAT,1876,21,25-29,1897,0.5831679576907575
STAT,1800,98,na,1898,0.011772128012119023
STAT,1836,35,45-49,1871,0.024110148747989266
STAT,1857,24,25-29,1881,0.4437633365773441
STAT,1897,41,na,1938,30.937584991128027
SIM,1931,22,25-29,1953,3
STAT,1873,31,50-100,1904,0.009353469561688676
STAT,1934,21,25-29,1955,1.236484775121396
STAT,1809,52,35-39,1861,2.815409756373947E-4
STAT,1878,31,35-39,1909,0.10498087925216858
STAT,1908,17,45-49,1925,9.639622033554346E-4
STAT,1809,49,na,1858,17.06905872037945
SIM,1920,13,na,1933,49
SIM,1853,26,na,1879,26
SIM,1888,26,20-24,1914,1
SIM,1942,21,25-29,1963,1
STAT,1836,34,35-39,1870,0.12099897833870964
SIM,1839,76,na,1915,9
SIM,1842,34,na,1876,25
STAT,1906,33,15-19,1939,0.0011829613850605058
STAT,1820,44,na,1864,15.129810831537654
STAT,1810,45,35-39,1855,0.0014014515079660483
STAT,1949,20,20-24,1969,1.2900994716132184
STAT,1908,22,25-29,1930,0.8447717362826559
STAT,1815,49,35-39,1864,0.0019611336359703674
STAT,1880,46,30-34,1926,0.0010207934134552838
STAT,1920,47,na,1967,40.26489208245352
STAT,1855,36,25-29,1891,0.02036912641393146
SIM,1888,25,na,1913,39
STAT,1829,36,15-19,1865,5.216396040152304E-4
SIM,1919,23,20-24,1942,1
STAT,1817,48,50-100,1865,0.006999083061685791
STAT,1826,38,50-100,1864,0.013847395113404512
SIM,1824,49,na,1873,16
STAT,1945,22,45-49,1967,0.012243212159115995
STAT,1855,35,15-19,1890,3.9912217166262765E-4
STAT,1902,18,20-24,1920,0.24935036882946757
STAT,1808,64,na,1872,3.3568277882923603
STAT,1880,84,na,1964,5.971302064950663
STAT,1870,16,40-44,1886,0.0018451139824716138
STAT,1851,43,30-34,1894,0.00963574167731925
STAT,1939,25,25-29,1964,0.6577234402228955
STAT,1861,32,35-39,1893,0.08516412070600891
STAT,1925,3,na,1928,48.69048535193836
SIM,1893,71,na,1964,21
STAT,1899,27,35-39,1926,0.13208742608759766
SIM,1872,72,na,1944,12
STAT,1871,39,15-19,1910,5.542264273414858E-4
SIM,1923,21,20-24,1944,3
STAT,1908,31,25-29,1939,0.08714489894230633
STAT,1838,32,45-49,1870,0.01681815394772519
STAT,1874,49,40-44,1923,0.0017005460361996165
STAT,1878,50,45-49,1928,1.519818114467033E-4
STAT,1862,99,na,1961,0.040327174087652844
STAT,1822,90,na,1912,0.2796597989043983
STAT,1843,21,na,1864,11.466787696607664
STAT,1921,40,na,1961,41.61972985634811
STAT,1841,20,15-19,1861,0.041500502218139286
STAT,1898,22,50-100,1920,0.005501096143681766
STAT,1828,43,40-44,1871,0.009807599897888495
STAT,1939,26,35-39,1965,0.14996330673203348
STAT,1845,87,na,1932,1.0298627194949679
STAT,1935,33,40-44,1968,0.05386717311588592
STAT,1895,34,40-44,1929,0.05581961658783323
SIM,1868,25,na,1893,33
STAT,1866,18,40-44,1884,0.0017188221045535952
STAT,1913,19,40-44,1932,0.0028206619431010967
STAT,1848,27,50-100,1875,0.004938663829257065
STAT,1886,23,40-44,1909,0.021547857831679056
SIM,1909,60,na,1969,33
STAT,1847,45,30-34,1892,0.0010443624908310603
SIM,1920,3,na,1923,51
STAT,1946,18,na,1964,40.52392935477305
STAT,1900,38,40-44,1938,0.013037016766449964
STAT,1849,48,35-39,1897,0.0010719078748684288
STAT,1891,18,50-100,1909,5.997331544068003E-4
STAT,1929,36,20-24,1965,0.0033711952504808258
STAT,1862,25,45-49,1887,0.009754183658724222
SIM,1917,47,na,1964,34
STAT,1839,35,30-34,1874,0.03588478471443761
STAT,1858,26,35-39,1884,0.07570637561337333
STAT,1880,33,na,1913,24.987433867313445
STAT,1932,23,15-19,1955,0.06934714130157485
SIM,1886,78,na,1964,9
STAT,1888,36,20-24,1924,0.009051481527876081
STAT,1793,71,na,1864,3.251366373941174
STAT,1841,46,50-100,1887,0.0024460050489929263
STAT,1830,88,na,1918,0.4932490962148451
STAT,1855,26,15-19,1881,0.003353690660181478
STAT,1906,19,35-39,1925,0.00792898251009435
STAT,1906,49,na,1955,32.009533561226924
SIM,1873,57,na,1930,19
SIM,1896,54,na,1950,23
STAT,1932,19,45-49,1951,0.0065525618149549925
SIM,1928,19,na,1947,52
STAT,1842,52,50-100,1894,1.127095283441618E-4
STAT,1785,73,na,1858,13.77427109424033
SIM,1857,33,na,1890,23
STAT,1883,27,na,1910,23.175084804785016
STAT,1909,43,40-44,1952,0.0023124209353632824
STAT,1896,27,15-19,1923,0.0059595461806374594
STAT,1891,23,15-19,1914,0.04036590932165598
STAT,1896,48,na,1944,29.186566216028847
STAT,1835,42,35-39,1877,0.009828801264348411
STAT,1871,21,50-100,1892,0.004077946450029277
STAT,1940,15,20-24,1955,1.3675032455293834
STAT,1891,56,na,1947,25.033729509362768
STAT,1824,32,15-19,1856,0.0023258896439341094
STAT,1924,31,50-100,1955,0.009588837729365175
STAT,1928,43,45-49,1971,0.002107965988619314
STAT,1910,27,45-49,1937,0.016580781582304846
STAT,1912,30,35-39,1942,0.08993467120589567
STAT,1928,44,20-24,1972,2.2329122441112898E-4
SIM,1815,66,na,1881,6
SIM,1902,48,na,1950,30
STAT,1905,27,35-39,1932,0.1392573255657592
STAT,1919,32,45-49,1951,0.01682985371428281
STAT,1844,44,35-39,1888,0.01411953104744432
STAT,1849,15,35-39,1864,0.005299370150389221
SIM,1881,55,na,1936,18
STAT,1904,20,35-39,1924,0.08411495128765857
STAT,1879,33,45-49,1912,0.017972568407771092
STAT,1882,21,15-19,1903,0.031711443027050236
STAT,1825,36,na,1861,15.603157916611925
STAT,1802,70,na,1872,5.878376549383351
STAT,1884,77,na,1961,10.381258815317326
STAT,1876,33,25-29,1909,0.10358957506051214
STAT,1872,29,20-24,1901,0.11917481786433351
STAT,1922,23,20-24,1945,1.2618981164510543
STAT,1896,33,45-49,1929,0.022809070032140374
STAT,1891,44,15-19,1935,1.6720895979685586E-4
STAT,1832,27,25-29,1859,0.25306953380923103
STAT,1923,29,45-49,1952,0.01955671180003991
SIM,1822,68,na,1890,10
STAT,1852,27,45-49,1879,0.011067964023156547
STAT,1799,96,na,1895,0.03172231781004804
STAT,1841,27,35-39,1868,0.11730542276047737
STAT,1848,100,na,1948,0.0068656559259214385
STAT,1857,28,40-44,1885,0.022932287759031205
STAT,1881,16,15-19,1897,0.056608519267350374
SIM,1898,34,30-34,1932,1
STAT,1846,31,50-100,1877,0.008866695777131055
STAT,1854,15,45-49,1869,4.8330354338765885E-4
STAT,1931,28,25-29,1959,0.8455982539539283
SIM,1930,16,15-19,1946,2
SIM,1884,12,na,1896,26
SIM,1899,65,na,1964,24
STAT,1925,17,45-49,1942,0.005996671138407506
STAT,1847,68,na,1915,16.32477170344155
STAT,1931,19,na,1950,47.70687514992007
STAT,1857,75,na,1932,7.706635838742542
STAT,1846,28,30-34,1874,0.24511514083840125
STAT,1914,29,35-39,1943,0.14902452273925923
STAT,1806,83,na,1889,1.9233833334594777
STAT,1869,44,40-44,1913,0.02149998452519348
STAT,1835,25,50-100,1860,0.003944756362034555
SIM,1956,14,na,1970,47
STAT,1829,42,45-49,1871,0.013249331994813098
STAT,1898,21,45-49,1919,0.009435274222677245
STAT,1789,89,na,1878,0.23952472776186634
STAT,1845,56,na,1901,11.922656885711527
SIM,1842,68,na,1910,17
STAT,1853,85,na,1938,1.7228833953334823
STAT,1887,21,35-39,1908,0.06388701650355502
SIM,1931,7,na,1938,63
STAT,1914,17,35-39,1931,0.008608092142396861
STAT,1843,27,35-39,1870,0.05037183986218102
SIM,1859,11,na,1870,23
STAT,1863,27,20-24,1890,0.1038699896595076
STAT,1919,39,30-34,1958,0.019368966486719465
STAT,1900,27,na,1927,33.09348791000188
STAT,1818,42,35-39,1860,0.019470082732079067
STAT,1851,50,na,1901,18.438928531273298
SIM,1871,45,na,1916,23
SIM,1826,58,na,1884,14
SIM,1831,70,na,1901,4
STAT,1851,21,20-24,1872,0.6997839291027551
STAT,1895,32,50-100,1927,0.011895205825640028
STAT,1928,10,na,1938,49.83203023677373
STAT,1884,26,50-100,1910,0.006288906706737136
STAT,1910,24,40-44,1934,0.03118637775810096
STAT,1863,92,na,1955,0.3687629156720445
STAT,1885,33,35-39,1918,0.09958425003575978
STAT,1826,83,na,1909,2.774212171256623
STAT,1908,39,20-24,1947,0.002430567441300721
STAT,1827,68,na,1895,9.261146992927607
STAT,1913,3,na,1916,40.989058854637335
STAT,1906,18,na,1924,36.596271510418184
STAT,1889,17,30-34,1906,0.019514248882053276
STAT,1862,21,30-34,1883,0.15845625269796673
STAT,1905,38,25-29,1943,0.008924528655359434
SIM,1843,32,25-29,1875,1
STAT,1940,19,35-39,1959,0.04227431399067392
STAT,1911,23,45-49,1934,0.010569554326382749
SIM,1831,28,na,1859,10
STAT,1880,23,40-44,1903,0.021844647143339307
STAT,1902,16,50-100,1918,6.925737382285148E-4
STAT,1855,54,50-100,1909,1.034097886424024E-4
STAT,1860,33,30-34,1893,0.14134373913343456
STAT,1908,17,50-100,1925,7.229716525165758E-4
STAT,1936,17,20-24,1953,1.2901444894307459
STAT,1823,36,15-19,1859,4.1132855018161845E-4
SIM,1851,27,35-39,1878,1
STAT,1929,21,15-19,1950,0.06719646991050662
STAT,1939,17,50-100,1956,0.0037244768568960927
STAT,1922,16,15-19,1938,0.5226609023541648
STAT,1899,39,35-39,1938,0.02068818917217081
STAT,1841,39,35-39,1880,0.07989101881563551
STAT,1826,37,45-49,1863,0.023061289200928772
STAT,1832,38,na,1870,12.021812865519918
STAT,1909,21,30-34,1930,0.26642750115902303
STAT,1875,15,50-100,1890,5.05948016655435E-4
STAT,1873,46,20-24,1919,1.2234950883718528E-4
STAT,1890,27,15-19,1917,0.0055111378943775964
SIM,1927,39,30-34,1966,1
STAT,1867,31,25-29,1898,0.09841824627627736
STAT,1869,27,20-24,1896,0.11367088849150554
STAT,1859,43,35-39,1902,0.014288684419450925
STAT,1934,29,20-24,1963,0.24427765089040135
SIM,1897,30,na,1927,40
SIM,1930,23,20-24,1953,2
SIM,1917,21,30-34,1938,2
STAT,1872,18,30-34,1890,0.016265270296970384
SIM,1845,16,20-24,1861,1
STAT,1920,28,15-19,1948,0.007651201246656497
STAT,1937,16,25-29,1953,0.4199482211302695
STAT,1897,32,15-19,1929,0.0018911103905239204
STAT,1897,4,na,1901,34.93435986785034
STAT,1903,52,na,1955,30.45016895689884
STAT,1944,23,40-44,1967,0.03602853103701286
STAT,1843,15,35-39,1858,0.003009850146898854
STAT,1858,44,30-34,1902,0.008630253165116201
STAT,1895,16,45-49,1911,8.50135670139167E-4
STAT,1944,25,50-100,1969,0.010689070485569729
SIM,1925,22,na,1947,43
STAT,1875,18,na,1893,25.893750546372107
STAT,1880,30,na,1910,25.295031444442113
STAT,1930,29,50-100,1959,0.012584643152259203
STAT,1862,46,45-49,1908,0.0020419054643502446
STAT,1855,63,na,1918,12.562747649415957
STAT,1845,22,40-44,1867,0.015121776875432267
STAT,1930,18,30-34,1948,0.15643410887301137
STAT,1857,20,45-49,1877,0.006113907443825994
SIM,1917,20,50-100,1937,1
STAT,1859,56,na,1915,16.21135561347756
STAT,1910,40,45-49,1950,0.0015810096964575255
STAT,1899,20,15-19,1919,0.045430908212227186
SIM,1877,33,na,1910,28
STAT,1825,31,20-24,1856,0.03420592841826243
STAT,1855,32,45-49,1887,0.012501257764698672
SIM,1901,20,25-29,1921,1
STAT,1837,37,20-24,1874,0.004573364799216446
STAT,1835,32,25-29,1867,0.05932290435539039
STAT,1892,22,20-24,1914,0.8513502175841736
SIM,1944,17,20-24,1961,2
STAT,1913,32,45-49,1945,0.015524970564791728
SIM,1914,22,25-29,1936,1
STAT,1872,89,na,1961,1.9488925516350253
STAT,1941,18,40-44,1959,0.014297947656157155
STAT,1853,82,na,1935,2.932382923382332
STAT,1846,20,35-39,1866,0.05919930267622376
SIM,1938,20,20-24,1958,2
STAT,1838,36,25-29,1874,0.02724628101039218
STAT,1916,45,40-44,1961,0.001610837821877588
STAT,1862,45,na,1907,19.604348101080202
SIM,1831,73,na,1904,2
STAT,1877,95,na,1972,0.7515722430901278
STAT,1878,38,20-24,1916,0.007918905657608572
STAT,1863,20,35-39,1883,0.05346182853793987
STAT,1860,30,na,1890,19.55599801523086
SIM,1887,40,na,1927,25
STAT,1849,33,30-34,1882,0.14118427096236508
STAT,1866,32,20-24,1898,0.02489467239839934
SIM,1918,40,na,1958,34
STAT,1820,37,50-100,1857,0.011576133745577479
STAT,1886,58,na,1944,20.512952467324396
STAT,1904,37,na,1941,34.024957369965556
STAT,1817,50,50-100,1867,4.3694756889209514E-4
STAT,1951,21,25-29,1972,1.0972527418453137
STAT,1835,20,25-29,1855,0.6614788547333147
STAT,1900,24,na,1924,32.590396234355325
SIM,1837,64,na,1901,26
SIM,1943,7,na,1950,49
STAT,1873,28,25-29,1901,0.4285615596279928
STAT,1820,98,na,1918,0.018416786706188213
STAT,1893,28,45-49,1921,0.013950282230757893
STAT,1877,21,40-44,1898,0.021575288760287883
SIM,1915,12,na,1927,40
STAT,1906,22,25-29,1928,0.8316733065523815
STAT,1921,40,20-24,1961,1.9790905390442752E-4
STAT,1857,38,50-100,1895,0.009145393728799134
SIM,1841,80,na,1921,4
SIM,1838,60,na,1898,4
STAT,1926,34,45-49,1960,0.01889410465989359
SIM,1828,39,na,1867,14
STAT,1835,37,50-100,1872,0.006885394786748939
STAT,1831,53,na,1884,17.760555229373857
STAT,1861,22,25-29,1883,0.4945713658783262
STAT,1832,48,25-29,1880,3.0236227994375424E-4
STAT,1873,82,na,1955,4.743709147126788
STAT,1842,45,na,1887,17.32109028242554
STAT,1816,103,na,1919,4.3085768583927837E-4
STAT,1840,19,30-34,1859,0.015980473381094706
STAT,1898,29,40-44,1927,0.04012136378576932
STAT,1866,49,50-100,1915,0.0022147033033561095
SIM,1942,8,na,1950,43
STAT,1877,39,15-19,1916,5.738276360880199E-4
STAT,1888,27,25-29,1915,0.4943335719885272
STAT,1797,61,na,1858,8.170446108742016
SIM,1952,1,na,1953,35
STAT,1857,42,20-24,1899,0.0011874234046058934
STAT,1900,34,25-29,1934,0.14081632506824407
STAT,1852,20,25-29,1872,0.5904691985023279
STAT,1821,45,45-49,1866,0.003436080214192282
STAT,1936,31,35-39,1967,0.08827667639334752
STAT,1882,15,20-24,1897,0.1706896595070933
STAT,1846,49,30-34,1895,7.681147673355147E-4
SIM,1964,1,na,1965,52
STAT,1919,18,30-34,1937,0.13317852512339434
STAT,1888,39,25-29,1927,0.033307607112677155
STAT,1852,39,45-49,1891,0.01688950671305346
SIM,1849,41,25-29,1890,1
STAT,1855,97,na,1952,0.03782433641575268
STAT,1875,48,50-100,1923,0.0024929039452995737
STAT,1888,36,na,1924,27.66441539309053
STAT,1875,23,30-34,1898,0.18253419029812148
STAT,1878,29,na,1907,24.46278610557381
STAT,1897,39,35-39,1936,0.020068900288825967
SIM,1875,38,na,1913,18
STAT,1856,31,15-19,1887,0.0010551795006268176
STAT,1781,83,na,1864,1.9110830271389003
STAT,1929,28,35-39,1957,0.1869107914688394
SIM,1894,8,na,1902,32
SIM,1921,15,na,1936,37
STAT,1882,25,30-34,1907,0.2429664262313488
STAT,1909,28,15-19,1937,0.006685272808345925
SIM,1929,1,na,1930,51
STAT,1887,29,30-34,1916,0.2728978916932642
STAT,1837,30,35-39,1867,0.06331505770274322
SIM,1824,46,na,1870,16
STAT,1939,22,20-24,1961,1.109046088560013
SIM,1942,14,na,1956,43
STAT,1914,47,30-34,1961,8.767825017561245E-4
STAT,1791,90,na,1881,0.28786784870200166
STAT,1869,15,na,1884,25.105385462382234
STAT,1884,16,35-39,1900,0.005389192045610047
STAT,1902,59,na,1961,28.705246633605555
SIM,1830,26,20-24,1856,1
STAT,1833,31,na,1864,20.870527001096544
STAT,1868,30,na,1898,23.27904125056103
STAT,1817,37,35-39,1854,0.28265862796955854
SIM,1828,53,na,1881,11
STAT,1864,37,15-19,1901,5.036631143700136E-4
STAT,1867,35,40-44,1902,0.042288819216745106
STAT,1856,38,35-39,1894,0.05098445835840544
STAT,1836,38,15-19,1874,6.583287251633906E-4
STAT,1836,31,30-34,1867,0.21521079688041161
STAT,1879,37,25-29,1916,0.02979997869417576
STAT,1893,37,na,1930,29.705982707765294
STAT,1847,48,35-39,1895,0.0014767404001835272
STAT,1831,28,20-24,1859,0.1266229485560832
STAT,1836,103,na,1939,0.0013850707587113459
STAT,1857,45,25-29,1902,4.3549708651409783E-4
STAT,1838,103,na,1941,0.001113887011469589
STAT,1924,37,na,1961,44.074556804118494
STAT,1800,92,na,1892,0.15092997228435934
STAT,1855,19,50-100,1874,4.0544946507375994E-4
SIM,1893,6,na,1899,39
SIM,1948,21,25-29,1969,2
STAT,1906,16,30-34,1922,0.02321285907328462
STAT,1884,28,35-39,1912,0.09420279929900241
STAT,1861,104,na,1965,0.0030603181037129057
STAT,1842,17,40-44,1859,0.0017621918936444195
STAT,1854,16,na,1870,16.883324664028432
STAT,1927,27,20-24,1954,0.22078205494430614
SIM,1837,28,30-34,1865,1
SIM,1942,5,na,1947,43
STAT,1775,83,na,1858,1.9285226337652666
STAT,1860,64,na,1924,14.13237947901082
SIM,1879,11,na,1890,17
STAT,1864,23,na,1887,21.39902316779186
STAT,1928,22,50-100,1950,0.0081752411556163
STAT,1852,24,40-44,1876,0.02088310118497519
STAT,1871,15,45-49,1886,6.632619360688151E-4
SIM,1875,52,na,1927,13
STAT,1895,69,na,1964,21.37009336429828
STAT,1896,30,40-44,1926,0.05742221971159561
STAT,1933,11,na,1944,52.90347549705922
STAT,1842,38,40-44,1880,0.03812988948901176
STAT,1935,18,15-19,1953,0.6160486697151265
STAT,1856,25,20-24,1881,0.08934389136684992
SIM,1828,50,na,1878,12
STAT,1820,50,45-49,1870,1.2329143720066855E-4
STAT,1924,1,na,1925,49.4067751518235
STAT,1841,24,30-34,1865,0.21770556591999723
STAT,1893,25,50-100,1918,0.008120457100434287
STAT,1860,15,35-39,1875,0.005205941678364336
STAT,1864,16,15-19,1880,0.06086789832177534
SIM,1857,19,na,1876,22
SIM,1936,14,na,1950,38
STAT,1881,18,na,1899,23.969274902534888
STAT,1854,37,20-24,1891,0.004711698357218159
STAT,1882,18,25-29,1900,0.05416445595530926
STAT,1931,25,20-24,1956,0.23482660215527104
SIM,1899,11,na,1910,29
STAT,1850,29,35-39,1879,0.099653110313443
STAT,1929,15,20-24,1944,1.729952305522382
STAT,1953,17,na,1970,44.268400226199546
STAT,1801,77,na,1878,3.397066970236308
SIM,1935,27,20-24,1962,1
STAT,1867,17,45-49,1884,6.390505809525576E-4
STAT,1913,26,15-19,1939,0.006999281942078779
STAT,1837,19,25-29,1856,0.04931674963177018
STAT,1834,25,35-39,1859,0.090710725548913
STAT,1830,32,40-44,1862,0.028528373647759824
STAT,1922,26,25-29,1948,0.7418785672122741
STAT,1938,27,30-34,1965,0.38562503043352736
STAT,1839,31,15-19,1870,9.772174924627078E-4
STAT,1824,39,35-39,1863,0.0986803683568656
SIM,1791,65,na,1856,5
SIM,1813,51,na,1864,9
STAT,1844,36,50-100,1880,0.011252304754955974
STAT,1848,30,na,1878,16.68768920301182
STAT,1848,30,45-49,1878,0.013427305607371645
STAT,1870,50,40-44,1920,1.0608333342591895E-4
SIM,1877,30,na,1907,26
STAT,1840,36,15-19,1876,5.258708796189033E-4
STAT,1877,32,30-34,1909,0.18022986339547994
SIM,1870,60,na,1930,19
STAT,1873,49,25-29,1922,5.733877521328714E-4
STAT,1935,21,40-44,1956,0.045598977523597775
STAT,1837,75,na,1912,4.97769922324259
STAT,1923,19,35-39,1942,0.04866907607283492
STAT,1826,34,40-44,1860,0.05407785340388363
STAT,1845,25,45-49,1870,0.008014484100852847
STAT,1883,35,25-29,1918,0.028224883426213588
STAT,1953,17,20-24,1970,1.6305628066432685
STAT,1835,39,45-49,1874,0.010941542443985194
STAT,1948,10,na,1958,44.66925234946812
STAT,1796,68,na,1864,1.4265298940517872
STAT,1925,31,25-29,1956,0.10913226676490277
SIM,1860,53,na,1913,17
STAT,1885,23,25-29,1908,0.5635620875880435
STAT,1875,63,na,1938,18.341615746024715
STAT,1814,95,na,1909,0.059247823817498095
STAT,1875,44,30-34,1919,0.011658404753663296
STAT,1905,35,20-24,1940,0.0024240840591380594
SIM,1839,79,na,1918,9
SIM,1878,29,30-34,1907,1
SIM,1923,41,na,1964,38
STAT,1816,44,25-29,1860,0.008359182496446457
STAT,1897,36,30-34,1933,0.07111505691905498
STAT,1901,19,15-19,1920,0.08259500049334287
STAT,1918,15,45-49,1933,0.001086012521795575
STAT,1860,15,50-100,1875,4.6481613516314966E-4
STAT,1911,27,50-100,1938,0.009644237093198173
STAT,1878,17,20-24,1895,0.1830324700827782
STAT,1881,22,45-49,1903,0.006635317657987809
STAT,1918,51,na,1969,38.247506189597686
STAT,1885,70,na,1955,13.855565549544183
STAT,1853,47,50-100,1900,0.0015363537506586998
STAT,1831,38,30-34,1869,0.05392726737889551
STAT,1867,34,na,1901,22.640542473643322
STAT,1862,28,15-19,1890,0.003900606407158396
STAT,1830,57,na,1887,7.271812304564367
STAT,1908,44,na,1952,33.76271519524915
STAT,1870,22,35-39,1892,0.057968992745258234
STAT,1899,24,30-34,1923,0.24231186314912423
SIM,1888,70,na,1958,21
STAT,1915,28,40-44,1943,0.04696516815428657
STAT,1862,42,na,1904,19.916009096258104
STAT,1816,48,40-44,1864,0.002125359368197625
STAT,1921,43,25-29,1964,7.967649312828999E-4
STAT,1847,38,25-29,1885,0.03158174777662841
STAT,1903,22,40-44,1925,0.029626201619563874
STAT,1819,50,na,1869,13.332267491339271
SIM,1900,13,na,1913,39
STAT,1883,39,40-44,1922,0.04208128301040424
SIM,1907,34,na,1941,40
STAT,1893,25,40-44,1918,0.03802663370569654
STAT,1868,45,35-39,1913,0.0013683506336727214
STAT,1928,37,15-19,1965,2.4150367176344298E-4
STAT,1774,87,na,1861,0.2273876025587066
STAT,1809,49,45-49,1858,0.007804756680872654
STAT,1834,43,30-34,1877,0.009669789753615782
STAT,1858,38,35-39,1896,0.053554067778536385
STAT,1853,34,35-39,1887,0.0641958035989997
STAT,1928,22,45-49,1950,0.013979661843438738
STAT,1947,23,25-29,1970,1.036470950881426
STAT,1853,9,na,1862,18.419127638550584
STAT,1842,90,na,1932,0.5915241780242926
STAT,1916,48,45-49,1964,0.0022040010656711575
STAT,1896,15,15-19,1911,0.07831463919516429
STAT,1917,22,35-39,1939,0.09916411794298811
SIM,1842,65,na,1907,18
STAT,1857,49,40-44,1906,0.0012548577728849312
STAT,1849,36,35-39,1885,0.056704463215140506
STAT,1918,33,40-44,1951,0.04103425237623988
STAT,1845,43,40-44,1888,0.013218528306371265
STAT,1846,43,50-100,1889,0.008555121777859265
STAT,1874,20,45-49,1894,0.007116476550434529
STAT,1888,24,20-24,1912,0.8002686670644321
SIM,1873,71,na,1944,7
STAT,1839,56,na,1895,11.255846208018324
STAT,1930,32,45-49,1962,0.02021258096089004
SIM,1893,26,na,1919,38
STAT,1790,101,na,1891,7.420416741431879E-4
STAT,1804,51,na,1855,13.723806697951849
STAT,1919,20,45-49,1939,0.012286862148378755
SIM,1862,34,na,1896,23
SIM,1934,33,na,1967,50
STAT,1919,35,15-19,1954,2.056550747063765E-4
STAT,1879,27,15-19,1906,0.004695866655670343
STAT,1824,57,na,1881,15.13690716989049
SIM,1924,26,na,1950,48
STAT,1921,20,35-39,1941,0.10615145873805142
SIM,1853,43,40-44,1896,1
STAT,1859,30,20-24,1889,0.021797332553913903
STAT,1907,33,30-34,1940,0.1460274131992954
STAT,1917,49,50-100,1966,0.002327267503696768
STAT,1937,34,20-24,1971,0.023948691202915953
STAT,1898,6,na,1904,35.24072255932864
STAT,1829,49,na,1878,16.259645223738154
STAT,1882,28,35-39,1910,0.0921444115150238
SIM,1891,48,na,1939,33
STAT,1867,38,45-49,1905,0.0189822602654262
STAT,1915,42,20-24,1957,1.7626444138874576E-4
SIM,1908,19,na,1927,41
STAT,1842,34,25-29,1876,0.09092636064652732
STAT,1910,20,25-29,1930,0.8672815594150309
STAT,1839,47,30-34,1886,5.442774291337916E-4
STAT,1861,51,45-49,1912,1.2262687619491483E-4
STAT,1815,43,na,1858,11.298090896692809
STAT,1833,22,15-19,1855,0.032833003354476795
SIM,1848,24,25-29,1872,1
STAT,1850,43,15-19,1893,1.2206965553895954E-4
SIM,1939,25,na,1964,29
SIM,1872,26,25-29,1898,1
STAT,1897,26,20-24,1923,0.15632306544811525
STAT,1864,26,25-29,1890,0.38071316259592186
STAT,1904,28,30-34,1932,0.3595589771990174
SIM,1920,19,25-29,1939,1
STAT,1876,48,na,1924,22.563296008576135
STAT,1838,26,15-19,1864,0.0045117768716787365
STAT,1827,44,35-39,1871,0.01377783760832846
SIM,1901,49,na,1950,33
STAT,1831,50,na,1881,18.84776768839826
STAT,1872,39,30-34,1911,0.0539818251275539
SIM,1822,65,na,1887,12
STAT,1912,19,25-29,1931,0.08647696381355847
SIM,1919,5,na,1924,47
STAT,1769,106,na,1875,6.21773904994193E-4
STAT,1840,21,45-49,1861,0.006999026939879253
STAT,1948,16,35-39,1964,0.04771728833888917
STAT,1886,55,na,1941,21.44769625623459
SIM,1839,90,na,1929,2
STAT,1789,86,na,1875,0.4518785578471537
SIM,1853,20,na,1873,25
STAT,1894,35,35-39,1929,0.09150686374986944
STAT,1863,2,na,1865,30.257460434895286
STAT,1921,49,30-34,1970,9.912710797790934E-4
STAT,1926,24,35-39,1950,0.11302628107165205
SIM,1912,28,30-34,1940,2
STAT,1813,65,na,1878,13.345639340807011
STAT,1911,19,na,1930,38.19424637163282
STAT,1926,18,na,1944,44.75239983665649
STAT,1955,15,30-34,1970,0.16098122810837015
SIM,1826,72,na,1898,6
STAT,1900,17,40-44,1917,0.0025362837655761453
STAT,1844,32,35-39,1876,0.09459279180494802
STAT,1867,21,15-19,1888,0.0319296705164588
SIM,1896,24,20-24,1920,1
SIM,1851,79,na,1930,9
SIM,1866,78,na,1944,10
STAT,1848,16,30-34,1864,0.012853441276008438
STAT,1861,26,40-44,1887,0.025557886253458287
SIM,1882,85,na,1967,12
STAT,1933,23,30-34,1956,0.37955998099364835
SIM,1864,12,na,1876,23
STAT,1828,64,na,1892,11.674970872057898
STAT,1947,5,na,1952,44.3255410463346
SIM,1916,48,na,1964,44
STAT,1886,44,40-44,1930,0.023016056126751124
STAT,1856,35,30-34,1891,0.038975915405560675
STAT,1919,23,50-100,1942,0.007120611575587675
STAT,1920,26,50-100,1946,0.010862976605776321
STAT,1898,46,25-29,1944,4.395509567928935E-4
SIM,1811,73,na,1884,3
STAT,1909,31,40-44,1940,0.0372859914323638
SIM,1795,72,na,1867,9
STAT,1945,25,15-19,1970,0.007696091490373048
STAT,1942,25,na,1967,39.0655237911964
STAT,1923,33,15-19,1956,0.001462068064773345
STAT,1837,44,50-100,1881,0.005382729500045779
STAT,1821,43,na,1864,16.87051468496002
STAT,1778,94,na,1872,0.04634644789703772
STAT,1883,52,na,1935,20.79770293124654
SIM,1856,23,na,1879,17
STAT,1819,43,40-44,1862,0.02093384596140293
STAT,1928,43,50-100,1971,0.0014879759877025871
STAT,1908,26,40-44,1934,0.044357146110322584
STAT,1938,4,na,1942,39.55222258739483
STAT,1925,30,25-29,1955,0.10919232254230098
STAT,1845,39,25-29,1884,0.017320003187647693
SIM,1819,39,na,1858,8
STAT,1886,47,50-100,1933,0.0025356493616557688
STAT,1854,87,na,1941,1.07687865015791
STAT,1858,45,45-49,1903,0.0018137331072400004
STAT,1929,18,25-29,1947,0.5489607614652182
SIM,1823,44,na,1867,11
STAT,1846,41,50-100,1887,0.008777166060546902
STAT,1879,47,na,1926,23.177516103616284
STAT,1926,17,45-49,1943,0.006089609545770875
STAT,1903,49,50-100,1952,0.00192852799116764
STAT,1875,33,na,1908,24.426381365284747
STAT,1909,8,na,1917,38.76571606976462
STAT,1905,30,50-100,1935,0.013329928186549173
STAT,1835,35,50-100,1870,0.007035938896548231
STAT,1835,26,35-39,1861,0.05865204379840602
STAT,1874,40,50-100,1914,0.010825758219500707
SIM,1912,27,na,1939,40
STAT,1890,38,na,1928,28.476177030291474
STAT,1866,30,20-24,1896,0.025094779312962844
STAT,1873,52,50-100,1925,1.5273112227260255E-4
STAT,1875,42,40-44,1917,0.023092788760522554
STAT,1813,89,na,1902,0.6933065321928056
STAT,1882,18,20-24,1900,0.16945513930858994
STAT,1862,36,20-24,1898,0.006682621312643426
STAT,1894,40,25-29,1934,0.008312874434477539
STAT,1874,3,na,1877,31.388842983170726
STAT,1852,23,30-34,1875,0.1797985518796076
STAT,1837,29,50-100,1866,0.003958526912729177
STAT,1873,34,30-34,1907,0.17599187472395686
SIM,1890,74,na,1964,14
SIM,1891,16,na,1907,38
SIM,1886,69,na,1955,11
SIM,1921,6,na,1927,42
SIM,1882,55,na,1937,29
SIM,1920,46,na,1966,42
STAT,1815,49,40-44,1864,0.0023981862693132705
STAT,1895,27,45-49,1922,0.014414568369348565
STAT,1927,32,na,1959,46.28618177124773
STAT,1854,37,25-29,1891,0.01759866146745627
SIM,1950,2,na,1952,67
SIM,1811,59,na,1870,8
STAT,1831,27,na,1858,23.25978423449361
STAT,1848,35,50-100,1883,0.00835382853181828
STAT,1916,32,25-29,1948,0.09460780190914993
STAT,1895,6,na,1901,33.91506530121845
SIM,1928,26,na,1954,52
STAT,1944,28,na,1972,40.17565586265805
STAT,1899,47,50-100,1946,0.001887663343588105
STAT,1932,20,15-19,1952,0.0699771351876368
STAT,1940,14,na,1954,39.652467326075275
STAT,1838,49,35-39,1887,0.0010896142189063193
STAT,1886,21,35-39,1907,0.0607122126791356
SIM,1924,12,na,1936,55
STAT,1863,41,35-39,1904,0.016105447060095673
STAT,1865,39,na,1904,21.095044494210303
STAT,1917,24,40-44,1941,0.035189130371647385
STAT,1880,24,20-24,1904,0.7201150181732783
STAT,1847,47,35-39,1894,0.0014885595631146575
SIM,1834,20,25-29,1854,2
STAT,1917,37,50-100,1954,0.004321259160370436
STAT,1923,22,15-19,1945,0.06150851174340354
STAT,1866,44,40-44,1910,0.020435796345961335
STAT,1956,13,na,1969,51.677114716304246
SIM,1943,15,na,1958,40
STAT,1934,16,40-44,1950,0.018885136768881056
STAT,1841,21,na,1862,26.703737289237058
STAT,1864,36,30-34,1900,0.048032277311727975
STAT,1833,93,na,1926,0.2163682245278348
SIM,1898,54,na,1952,25
SIM,1873,19,na,1892,30
STAT,1890,46,25-29,1936,3.9579205203410604E-4
STAT,1849,49,na,1898,17.080829874080283
STAT,1866,72,na,1938,11.631029110008434
STAT,1796,60,na,1856,1.9223291042
STAT,1858,31,25-29,1889,0.07875408297949227
STAT,1825,41,15-19,1866,1.3678301364784714E-4
STAT,1870,53,45-49,1923,1.4184994582720181E-4
STAT,1912,38,25-29,1950,0.009487453386823214
STAT,1901,43,45-49,1944,0.0014437517376955555
STAT,1907,19,50-100,1926,7.127863314415971E-4
STAT,1856,23,15-19,1879,0.0275574272261351
SIM,1869,73,na,1942,6
SIM,1844,38,na,1882,6
STAT,1914,46,35-39,1960,0.0012712265084919333
STAT,1786,98,na,1884,0.002565808953900176
SIM,1894,40,na,1934,29
STAT,1857,36,na,1893,17.72192243110131
SIM,1861,18,na,1879,27
STAT,1874,16,na,1890,25.684985408186893
STAT,1845,35,na,1880,14.758886246907721
STAT,1858,39,35-39,1897,0.053279335410832504
STAT,1929,31,50-100,1960,0.010457971116442333
SIM,1927,8,na,1935,52
STAT,1850,15,20-24,1865,0.1951809589369857
STAT,1896,47,30-34,1943,7.138897157477178E-4
STAT,1845,44,20-24,1889,9.214302465750971E-4
STAT,1869,37,45-49,1906,0.01931571801208731
STAT,1817,44,45-49,1861,0.04452245875774251
SIM,1887,3,na,1890,26
SIM,1835,61,na,1896,13
STAT,1889,22,15-19,1911,0.04039099700367486
STAT,1851,36,45-49,1887,0.017187402648155922
SIM,1799,77,na,1876,9
STAT,1892,32,15-19,1924,0.001759315289083266
STAT,1884,35,45-49,1919,0.019716715265015936
STAT,1801,54,35-39,1855,2.368849728525348E-4
STAT,1886,34,40-44,1920,0.04459817025884307
STAT,1875,23,25-29,1898,0.5866334646610679
STAT,1912,43,20-24,1955,1.679822439547424E-4
STAT,1859,40,30-34,1899,0.009229960542789928
STAT,1884,26,30-34,1910,0.24756683211024266
STAT,1909,23,50-100,1932,0.006062380955501624
STAT,1854,71,na,1925,8.158768812439105
STAT,1858,85,na,1943,2.0860113781629552
STAT,1862,90,na,1952,0.6802085271386008
STAT,1882,27,35-39,1909,0.09246990558267483
STAT,1872,41,50-100,1913,0.010858210459482659
SIM,1877,92,na,1969,3
STAT,1826,39,15-19,1865,6.167791839678651E-4
STAT,1828,47,25-29,1875,2.4675959425712575E-4
STAT,1927,32,50-100,1959,0.01011860864833323
STAT,1942,22,25-29,1964,0.9614317651229586
STAT,1832,33,30-34,1865,0.10098147925159777
STAT,1867,17,40-44,1884,0.0017893420617903998
SIM,1858,7,na,1865,27
STAT,1875,51,50-100,1926,1.5599033094186961E-4
STAT,1875,37,45-49,1912,0.020491890442536687
STAT,1848,17,30-34,1865,0.012777734506892742
STAT,1948,18,35-39,1966,0.047688662241354866
STAT,1865,21,15-19,1886,0.03042039458992924
SIM,1870,54,na,1924,21
STAT,1888,18,50-100,1906,5.710181331501267E-4
SIM,1866,49,na,1915,27
STAT,1892,37,45-49,1929,0.02462768715283194
STAT,1925,25,na,1950,44.267775214243926
STAT,1881,48,25-29,1929,5.412022573135784E-4
STAT,1848,21,15-19,1869,0.026165145136185796
STAT,1895,35,20-24,1930,0.010102629264039854
STAT,1834,41,40-44,1875,0.0194095442438186
STAT,1810,65,na,1875,6.912684618139657
STAT,1871,26,45-49,1897,0.011107714470601679
STAT,1916,26,50-100,1942,0.010238620165004405
STAT,1922,45,30-34,1967,0.0010214000573617924
STAT,1825,46,45-49,1871,0.0022075093739338902
STAT,1879,79,na,1958,8.373539384809595
STAT,1899,37,30-34,1936,0.01574742588567551
STAT,1844,37,50-100,1881,0.010133822336333207
STAT,1890,26,30-34,1916,0.3069349832842395
STAT,1829,40,45-49,1869,0.013609985421632503
STAT,1810,51,50-100,1861,1.4514307524751645E-4
STAT,1854,26,45-49,1880,0.007874704109221555
STAT,1886,17,na,1903,26.19726157179909
STAT,1877,45,50-100,1922,0.002560508338961094
STAT,1845,30,50-100,1875,0.0065018256059970235
STAT,1849,46,30-34,1895,7.527098112377891E-4
STAT,1949,22,35-39,1971,0.10916969711098658
STAT,1840,35,30-34,1875,0.0504308721767069
STAT,1886,29,45-49,1915,0.011434487523918294
STAT,1839,39,25-29,1878,0.01859732884815935
STAT,1828,44,20-24,1872,6.848097754619359E-4
STAT,1854,55,na,1909,12.638589446222657
SIM,1876,1,na,1877,39
STAT,1879,31,45-49,1910,0.01812249261045216
STAT,1938,33,15-19,1971,0.0012828047628735144
STAT,1819,38,45-49,1857,0.02061817302054227
STAT,1897,24,15-19,1921,0.04353531211985679
SIM,1857,88,na,1945,3
SIM,1853,74,na,1927,9
STAT,1830,28,25-29,1858,0.34648127271245943
STAT,1888,45,30-34,1933,0.0011424805040809382
STAT,1857,37,50-100,1894,0.009190980994532007
STAT,1843,34,45-49,1877,0.008710055909636846
STAT,1844,100,na,1944,0.008292456898397615
STAT,1883,84,na,1967,6.056970681366623
STAT,1844,41,25-29,1885,0.0052033124412496825
STAT,1820,54,45-49,1874,1.1389091017113457E-4
STAT,1795,59,na,1854,12.0
STAT,1834,24,50-100,1858,0.003798993374045971
STAT,1829,29,15-19,1858,0.004550297663695783
STAT,1869,45,20-24,1914,1.1743216415410113E-4
STAT,1819,49,25-29,1868,5.049010260552143E-4
STAT,1828,36,45-49,1864,0.008962480123481345
STAT,1866,40,na,1906,21.50087619634492
STAT,1859,18,45-49,1877,5.991260367124138E-4
STAT,1937,17,20-24,1954,1.3106018554128325
STAT,1891,1,na,1892,33.407203809830335
STAT,1907,12,na,1919,37.775692418655645
STAT,1881,36,30-34,1917,0.05095733322668366
STAT,1915,31,na,1946,38.34215068727577
SIM,1932,31,na,1963,48
STAT,1881,40,15-19,1921,1.3273246650857866E-4
STAT,1960,2,na,1962,50.95671264249601
STAT,1838,30,45-49,1868,0.017171076072748634
STAT,1860,25,30-34,1885,0.20991912028262927
STAT,1845,36,45-49,1881,0.012371395373351385
STAT,1874,91,na,1965,1.5714910055471119
SIM,1832,25,20-24,1857,1
SIM,1929,21,20-24,1950,2
STAT,1855,30,45-49,1885,0.012763591577880354
STAT,1899,24,25-29,1923,0.778748614577289
STAT,1843,25,30-34,1868,0.1333693959888299
STAT,1865,29,25-29,1894,0.3798764050489483
STAT,1927,2,na,1929,50.59268184175158
STAT,1918,40,35-39,1958,0.0021274781556952617
STAT,1885,42,25-29,1927,0.006333588504744597
STAT,1815,96,na,1911,0.030651682942765386
STAT,1866,42,15-19,1908,1.270293963718845E-4
STAT,1886,45,20-24,1931,1.2571289426229574E-4
STAT,1954,17,20-24,1971,1.6664660504326185
STAT,1891,16,20-24,1907,0.21812798985504198
STAT,1814,45,30-34,1859,0.0028586282859107306
STAT,1845,19,na,1864,16.759966422315998
STAT,1807,61,na,1868,11.407051573388275
STAT,1820,59,na,1879,11.779878981425913
STAT,1896,31,45-49,1927,0.022999339534021182
SIM,1904,8,na,1912,33
SIM,1945,17,20-24,1962,2
SIM,1882,71,na,1953,21
STAT,1823,35,30-34,1858,0.03979595980616952
STAT,1790,71,na,1861,3.6361851090457393
STAT,1853,39,50-100,1892,0.007638473184096632
STAT,1846,52,na,1898,17.356981603028608
STAT,1860,34,45-49,1894,0.014055422424158144
STAT,1808,46,45-49,1854,0.0017283219294307235
STAT,1849,33,25-29,1882,0.08282462950408682
STAT,1938,21,20-24,1959,1.0936017950684696
SIM,1896,47,na,1943,26
SIM,1892,33,na,1925,36
STAT,1929,39,na,1968,47.967146235241984
STAT,1939,28,35-39,1967,0.149823873248847
STAT,1866,39,50-100,1905,0.011193481583178708
STAT,1848,29,25-29,1877,0.3219098543439066
STAT,1899,46,45-49,1945,0.001827548523125757
STAT,1881,43,50-100,1924,0.009979980868566864
SIM,1812,76,na,1888,8
SIM,1878,34,na,1912,30
STAT,1918,25,50-100,1943,0.010568067611668524
STAT,1936,34,50-100,1970,0.007971899736345163
SIM,1799,61,na,1860,16
STAT,1884,48,50-100,1932,0.002376035907293433
STAT,1890,22,na,1912,28.72831393048468
SIM,1881,38,na,1919,24
SIM,1946,21,20-24,1967,2
STAT,1876,27,35-39,1903,0.09799893174698562
STAT,1875,45,45-49,1920,0.0024501291300228767
STAT,1943,17,45-49,1960,0.005258668238318767
STAT,1836,43,40-44,1879,0.025494980109701984
STAT,1864,20,45-49,1884,0.006447263605773552
STAT,1885,17,35-39,1902,0.005418584044577779
SIM,1815,41,na,1856,15
STAT,1871,18,45-49,1889,6.516109919781143E-4
SIM,1869,9,na,1878,19
STAT,1902,15,50-100,1917,6.940868475561875E-4
SIM,1899,12,na,1911,29
SIM,1819,55,na,1874,5
STAT,1913,21,50-100,1934,0.006341785902859878
STAT,1925,26,40-44,1951,0.05489553509985338
STAT,1873,37,35-39,1910,0.07190987076491832
STAT,1942,30,25-29,1972,0.09784894905606656
SIM,1893,30,30-34,1923,1
STAT,1909,17,45-49,1926,9.741214228919624E-4
STAT,1899,45,30-34,1944,7.549344866495922E-4
SIM,1938,22,25-29,1960,1
STAT,1847,42,na,1889,24.82721731018232
SIM,1888,28,na,1916,35
STAT,1894,68,na,1962,21.38463013332817
STAT,1847,44,30-34,1891,0.01211540860771133
STAT,1830,33,20-24,1863,0.017197830216900977
STAT,1890,34,30-34,1924,0.21026791710445555
STAT,1898,16,30-34,1914,0.02155412018773325
STAT,1828,39,na,1867,18.412529858213105
STAT,1885,30,30-34,1915,0.1738032095606471
STAT,1813,50,35-39,1863,2.6671251542787644E-4
STAT,1888,83,na,1971,8.874073340631696
SIM,1874,20,na,1894,20
STAT,1910,38,15-19,1948,1.8163281851606004E-4
STAT,1835,23,30-34,1858,0.1176130666982783
STAT,1843,26,50-100,1869,0.00336363911677175
STAT,1902,28,15-19,1930,0.0063755314973758795
SIM,1942,20,25-29,1962,1
STAT,1823,43,30-34,1866,0.008079936317996696
STAT,1867,29,35-39,1896,0.09167649410072753
SIM,1912,1,na,1913,41
STAT,1854,34,20-24,1888,0.01657181536226146
SIM,1866,23,25-29,1889,3
STAT,1869,34,40-44,1903,0.04166048106315686
STAT,1828,32,50-100,1860,0.012542633268371873
STAT,1928,27,20-24,1955,0.2237870601744278
STAT,1923,34,50-100,1957,0.009400587659687314
SIM,1911,53,na,1964,38
STAT,1868,20,50-100,1888,0.004003658668711097
STAT,1903,48,25-29,1951,4.56133853510762E-4
STAT,1841,25,20-24,1866,0.14469372945018166
SIM,1833,22,na,1855,14
STAT,1774,81,na,1855,0.8093
STAT,1858,23,25-29,1881,0.4515506903521514
STAT,1867,21,25-29,1888,0.5540528053030382
SIM,1841,15,20-24,1856,2
STAT,1866,33,25-29,1899,0.0939344132722575
STAT,1834,22,25-29,1856,0.5410441358069628
STAT,1829,43,50-100,1872,0.00922659406797578
STAT,1774,97,na,1871,0.0038837329813831527
STAT,1877,40,na,1917,24.098764106387964
STAT,1894,43,50-100,1937,9.334120074965037E-4
STAT,1926,15,na,1941,45.07843150353467
STAT,1930,39,30-34,1969,0.02361144193219063
SIM,1873,27,35-39,1900,2
SIM,1900,3,na,1903,40
STAT,1820,40,25-29,1860,0.005864036753694985
STAT,1875,20,20-24,1895,0.71260718513338
STAT,1825,90,na,1915,0.4250321624963869
STAT,1874,75,na,1949,10.443804318857485
SIM,1898,70,na,1968,18
STAT,1904,31,na,1935,34.33296392556796
STAT,1862,25,40-44,1887,0.026316489491984774
STAT,1812,52,45-49,1864,1.5734048084725696E-4
STAT,1895,24,40-44,1919,0.026883799789053614
STAT,1871,38,15-19,1909,5.570842696447631E-4
STAT,1870,61,na,1931,18.562812421971845
STAT,1901,35,45-49,1936,0.00607790650065286
STAT,1892,39,50-100,1931,0.015014972525187893
STAT,1810,44,35-39,1854,0.01785491997057222
STAT,1845,28,45-49,1873,0.007843088644459874
STAT,1846,29,15-19,1875,0.0043845333300327905
SIM,1893,23,na,1916,39
STAT,1841,80,na,1921,6.05491233589304
STAT,1828,33,40-44,1861,0.03176744087823395
STAT,1917,1,na,1918,44.38491283697339
STAT,1832,28,35-39,1860,0.057310541616027506
STAT,1903,46,na,1949,32.083513096992085
STAT,1871,34,20-24,1905,0.026718774408986446
SIM,1803,56,na,1859,9
STAT,1882,24,30-34,1906,0.16963427761929423
STAT,1870,37,50-100,1907,0.01219625643715433
STAT,1834,44,45-49,1878,0.012427902586653225
STAT,1889,27,20-24,1916,0.14363187716367756
STAT,1821,35,20-24,1856,0.01879205068837018
STAT,1916,32,na,1948,38.71319304385101
STAT,1845,94,na,1939,0.11682838458497703
STAT,1856,28,20-24,1884,0.08743320855257915
STAT,1916,40,25-29,1956,7.275442976315742E-4
STAT,1839,23,15-19,1862,0.023224423561402883
STAT,1868,7,na,1875,26.79847450977577
STAT,1852,26,35-39,1878,0.0968801374040647
STAT,1821,104,na,1925,4.142663484968237E-4
SIM,1939,26,na,1965,28
STAT,1895,38,25-29,1933,0.03719392651484841
STAT,1824,73,na,1897,8.264526700899516
STAT,1844,16,35-39,1860,0.005480444544690814
SIM,1853,58,na,1911,21
SIM,1845,23,na,1868,24
STAT,1807,77,na,1884,4.200355774122705
STAT,1897,37,20-24,1934,0.010236529400344184
STAT,1873,46,25-29,1919,5.872776150236195E-4
SIM,1841,73,na,1914,4
STAT,1890,45,50-100,1935,0.0030130526334834007
STAT,1908,30,25-29,1938,0.0874878513194787
STAT,1906,26,30-34,1932,0.3671021144687264
STAT,1923,30,15-19,1953,0.0014747347111759568
STAT,1873,29,35-39,1902,0.09739880495567192
STAT,1872,19,15-19,1891,0.06039492338547232
STAT,1843,87,na,1930,0.7473475719998586
STAT,1900,44,50-100,1944,0.0010035685820035654
STAT,1852,18,35-39,1870,0.005646322116105101
STAT,1817,43,30-34,1860,0.035233211042854186
STAT,1922,48,35-39,1970,0.001466223903711547
STAT,1851,31,15-19,1882,0.0012643874804266928
STAT,1832,30,50-100,1862,0.005466950998105637
STAT,1901,21,25-29,1922,0.803438441991942
STAT,1881,45,20-24,1926,1.153235943568785E-4
STAT,1894,52,na,1946,27.44867330616075
SIM,1867,66,na,1933,6
STAT,1836,35,40-44,1871,0.05294354040065406
STAT,1933,28,na,1961,49.51481059523294
STAT,1810,81,na,1891,1.9437575658856605
STAT,1924,17,35-39,1941,0.04964411361598228
STAT,1859,41,50-100,1900,0.008434851809781676
STAT,1899,24,50-100,1923,0.005547433366037505
STAT,1849,49,35-39,1898,0.0010628824105620364
STAT,1856,36,20-24,1892,0.005611163880099881
STAT,1845,20,35-39,1865,0.0429616057642457
STAT,1875,34,40-44,1909,0.044197270492112105
STAT,1884,34,30-34,1918,0.1695973576389725
STAT,1870,100,na,1970,0.07826093919933075
STAT,1840,38,35-39,1878,0.06487445571377319
STAT,1872,42,15-19,1914,1.411241006856357E-4
STAT,1826,33,50-100,1859,0.012116040619499625
STAT,1842,43,40-44,1885,0.017237626192089867
SIM,1832,26,35-39,1858,1
STAT,1816,53,40-44,1869,1.2483628407701362E-4
STAT,1913,16,20-24,1929,0.27555193143141743
STAT,1863,34,50-100,1897,0.008042960981527581
STAT,1832,36,35-39,1868,0.04055763749334641
STAT,1858,27,40-44,1885,0.023334713608409906
STAT,1938,24,25-29,1962,0.9075378269895185
STAT,1877,47,20-24,1924,1.2329383705182042E-4
STAT,1849,41,25-29,1890,0.005001759603553814
STAT,1873,23,15-19,1896,0.033437292423448894
SIM,1879,51,na,1930,14
STAT,1861,35,50-100,1896,0.010422826148255295
STAT,1910,3,na,1913,39.81410333468342
STAT,1857,15,30-34,1872,0.014190692259477838
STAT,1915,47,na,1962,36.699683536163505
STAT,1897,29,20-24,1926,0.1546749914159738
STAT,1903,26,50-100,1929,0.009125929606074919
STAT,1911,33,na,1944,36.43650159408448
STAT,1881,20,45-49,1901,0.00667490774196121
STAT,1867,35,45-49,1902,0.019258057054302245
SIM,1897,4,na,1901,43
SIM,1808,55,na,1863,14
STAT,1891,17,35-39,1908,0.006734657376184286
STAT,1869,21,na,1890,22.98512030581431
STAT,1923,49,40-44,1972,0.001820868545502511
STAT,1826,28,35-39,1854,0.32920123413326235
STAT,1897,25,50-100,1922,0.008552461310540159
SIM,1862,35,na,1897,23
STAT,1876,24,30-34,1900,0.17977717063309182
STAT,1919,36,50-100,1955,0.004475504057600732
STAT,1939,25,30-34,1964,0.39154064780803705
STAT,1860,28,35-39,1888,0.07871439189372649
SIM,1864,3,na,1867,26
SIM,1891,7,na,1898,38
STAT,1860,31,40-44,1891,0.03540040123135566
STAT,1862,33,40-44,1895,0.03725776202395594
SIM,1928,10,na,1938,55
SIM,1857,72,na,1929,10
STAT,1860,24,na,1884,19.53689550703725
STAT,1883,44,40-44,1927,0.02154747069660687
STAT,1951,16,40-44,1967,0.016559731075354377
SIM,1921,31,na,1952,41
SIM,1933,4,na,1937,55
STAT,1931,6,na,1937,52.22926523070479
STAT,1855,72,na,1927,8.891661847506347
STAT,1843,33,30-34,1876,0.08811818571366688
STAT,1859,86,na,1945,1.7635093794157852
SIM,1833,38,na,1871,12
SIM,1903,50,na,1953,35
STAT,1830,37,15-19,1867,3.2850080348667955E-4
STAT,1880,41,35-39,1921,0.019127827383462914
SIM,1907,64,na,1971,30
SIM,1794,62,na,1856,4
STAT,1934,20,25-29,1954,1.240118321804283
SIM,1828,75,na,1903,6
SIM,1869,14,na,1883,18
STAT,1852,29,15-19,1881,0.004056764632826367
SIM,1946,24,25-29,1970,2
STAT,1816,38,na,1854,9.642710541486654
STAT,1893,19,35-39,1912,0.00688144659130592
SIM,1851,33,30-34,1884,1
STAT,1861,41,25-29,1902,0.0054246899014066124
STAT,1917,27,45-49,1944,0.017953089178648064
STAT,1804,96,na,1900,0.03333612819367795
STAT,1869,48,25-29,1917,5.510975674651911E-4
STAT,1939,0,na,1939,44.68866989217236
STAT,1848,26,20-24,1874,0.09122618351604496
STAT,1880,27,25-29,1907,0.44482190022756324
STAT,1959,7,na,1966,51.120533346675415
STAT,1857,40,20-24,1897,0.001200883419590503
STAT,1870,18,na,1888,25.178899284745604
STAT,1888,48,35-39,1936,9.112654719973871E-4
STAT,1921,36,25-29,1957,0.010918129949085868
STAT,1904,49,30-34,1953,7.660690267714226E-4
STAT,1938,28,50-100,1966,0.009791278350148378
STAT,1915,20,15-19,1935,0.05265852143281163
STAT,1841,39,40-44,1880,0.04944536159021559
STAT,1831,41,15-19,1872,1.3855873394033266E-4
STAT,1849,30,20-24,1879,0.024779468419260205
STAT,1899,28,40-44,1927,0.040862935919163866
STAT,1881,39,35-39,1920,0.06662455613455025
STAT,1864,44,30-34,1908,0.010172449714016957
SIM,1885,6,na,1891,28
STAT,1932,16,30-34,1948,0.1611393724886614
STAT,1940,30,na,1970,38.908794781871585
STAT,1952,9,na,1961,46.81318040553421
STAT,1861,41,na,1902,19.524443920110123
STAT,1836,46,20-24,1882,1.2276068271637323E-4
STAT,1850,41,na,1891,20.67158032091324
STAT,1865,55,na,1920,18.70220748541394
SIM,1954,7,na,1961,50
STAT,1857,20,na,1877,18.746466267584875
STAT,1877,36,40-44,1913,0.045404745538341666
STAT,1786,82,na,1868,0.7068298745731482
STAT,1814,48,35-39,1862,0.003948354298293068
STAT,1876,15,40-44,1891,0.0018662780397448841
STAT,1841,17,20-24,1858,0.22380748027470587
STAT,1854,23,40-44,1877,0.01485803914528027
STAT,1854,18,45-49,1872,4.748137714640322E-4
STAT,1850,16,35-39,1866,0.006005391511481729
STAT,1851,35,30-34,1886,0.04643006661971253
STAT,1897,3,na,1900,35.10638113541387
STAT,1857,19,25-29,1876,0.049274361851208606
STAT,1874,16,20-24,1890,0.18029615346551497
SIM,1819,71,na,1890,1
STAT,1948,5,na,1953,44.94744959967991
STAT,1920,48,25-29,1968,5.797632764437666E-4
STAT,1872,46,30-34,1918,9.932407697595545E-4
STAT,1894,39,45-49,1933,0.025291230998928566
STAT,1853,31,25-29,1884,0.06698262731213833
STAT,1899,48,35-39,1947,0.0010674859215214815
STAT,1887,41,45-49,1928,0.016409859649841464
STAT,1858,21,na,1879,18.802497586799316
STAT,1895,27,20-24,1922,0.15230418014557093
STAT,1931,25,50-100,1956,0.012804621209288497
STAT,1806,60,na,1866,13.592818878048995
STAT,1839,28,20-24,1867,0.0809731998366337
STAT,1942,26,40-44,1968,0.04858577676444872
STAT,1879,49,20-24,1928,1.216079782681782E-4
STAT,1884,53,na,1937,20.75755715842634
STAT,1919,24,15-19,1943,0.05742255475832427
SIM,1824,45,na,1869,16
STAT,1859,27,35-39,1886,0.07801508059201653
STAT,1800,82,na,1882,1.552530049479848
STAT,1888,67,na,1955,18.52482439632783
STAT,1899,43,40-44,1942,0.0021227508344782917
STAT,1812,45,20-24,1857,1.384148068904902E-4
SIM,1889,34,na,1923,32
SIM,1885,20,na,1905,26
STAT,1827,48,45-49,1875,0.0017564339574083058
STAT,1840,31,15-19,1871,0.0013733377765368384
STAT,1846,27,25-29,1873,0.4147306056786751
STAT,1873,90,na,1963,1.7656170192275682
SIM,1960,3,na,1963,52
SIM,1872,18,na,1890,25
STAT,1855,49,35-39,1904,9.651171282914197E-4
STAT,1872,68,na,1940,15.636061956957688
STAT,1849,42,15-19,1891,1.0694838393907528E-4
SIM,1805,63,na,1868,11
STAT,1814,41,15-19,1855,4.579435913400572E-4
STAT,1834,38,35-39,1872,0.06153031524124385
STAT,1859,101,na,1960,0.010340339476969742
STAT,1844,45,40-44,1889,0.0013583228401209998
STAT,1864,2,na,1866,30.535679017376943
STAT,1902,16,45-49,1918,9.234316509713532E-4
STAT,1843,16,40-44,1859,9.973741009246437E-4
SIM,1855,22,na,1877,20
STAT,1943,29,15-19,1972,0.00745629967664527
SIM,1892,17,na,1909,35
SIM,1859,36,na,1895,17
SIM,1891,75,na,1966,24
STAT,1827,40,35-39,1867,0.014568490889093084
STAT,1886,48,25-29,1934,5.899582173760057E-4
STAT,1836,46,45-49,1882,0.0024142933351322267
STAT,1920,19,50-100,1939,0.0041452948093708315
STAT,1910,30,40-44,1940,0.037803810310249264
STAT,1899,21,20-24,1920,0.9462144075464307
STAT,1900,17,na,1917,35.022125302862925
STAT,1865,18,20-24,1883,0.16426688177991397
STAT,1793,95,na,1888,0.014357609881900765
STAT,1894,31,35-39,1925,0.1303180509846343
STAT,1847,20,45-49,1867,0.0092643641051518
STAT,1901,32,40-44,1933,0.060682329208929756
SIM,1881,54,na,1935,20
STAT,1939,16,40-44,1955,0.013908611391547789
STAT,1882,19,35-39,1901,0.0052303195801944
STAT,1843,31,40-44,1874,0.022346450912572962
STAT,1816,81,na,1897,1.6234714821514302
SIM,1913,17,na,1930,44
STAT,1898,41,20-24,1939,1.494450569760595E-4
STAT,1850,29,40-44,1879,0.030937866479951476
STAT,1853,30,35-39,1883,0.06691831811798724
SIM,1943,5,na,1948,49
STAT,1921,5,na,1926,45.474039911008894
SIM,1887,54,na,1941,21
SIM,1933,32,na,1965,49
STAT,1917,39,15-19,1956,1.9644538454405183E-4
STAT,1882,17,50-100,1899,4.6951062235557736E-4
STAT,1843,36,35-39,1879,0.03539129609937585
STAT,1888,47,20-24,1935,1.3957800151809547E-4
STAT,1823,37,20-24,1860,0.005554972134559698
STAT,1818,88,na,1906,0.34307560184415786
STAT,1876,40,30-34,1916,0.011794377230065841
STAT,1940,32,50-100,1972,0.008496231351954675
SIM,1925,20,25-29,1945,3
STAT,1904,7,na,1911,37.33190602660792
STAT,1841,18,35-39,1859,0.006886181672474316
SIM,1883,40,na,1923,13
STAT,1821,39,15-19,1860,9.749134395866903E-4
SIM,1921,47,na,1968,40
STAT,1884,17,40-44,1901,0.0017919962787872137
STAT,1916,16,na,1932,40.72717553497512
STAT,1919,37,20-24,1956,0.002807426752905182
STAT,1837,29,25-29,1866,0.26176849362191745
SIM,1903,18,na,1921,38
STAT,1890,28,20-24,1918,0.1420006706767334
STAT,1847,46,20-24,1893,1.2855239628398055E-4
STAT,1874,15,30-34,1889,0.016305420483186735
SIM,1914,50,na,1964,36
STAT,1939,17,30-34,1956,0.12116967171272194
STAT,1854,26,20-24,1880,0.08320404208524688
SIM,1914,26,30-34,1940,1
SIM,1916,34,40-44,1950,1
STAT,1827,100,na,1927,0.006433756409215093
STAT,1853,38,45-49,1891,0.012466547152638598
STAT,1892,36,30-34,1928,0.06615891253553853
STAT,1925,44,45-49,1969,0.001995679116387463
STAT,1823,46,35-39,1869,9.84114454485324E-4
STAT,1906,49,40-44,1955,0.0013737060445087378
STAT,1840,36,na,1876,20.057376304555895
STAT,1895,19,45-49,1914,8.435049042293193E-4
STAT,1862,43,45-49,1905,0.012819205218298881
SIM,1879,35,na,1914,15
STAT,1884,22,15-19,1906,0.032322252221421495
STAT,1910,49,30-34,1959,8.218052830612188E-4
STAT,1920,21,na,1941,40.373839941729706
STAT,1887,28,25-29,1915,0.4600980166872563
STAT,1825,45,30-34,1870,9.177215146461439E-4
SIM,1895,28,25-29,1923,2
SIM,1862,62,na,1924,21
STAT,1920,16,15-19,1936,0.5060807352382423
STAT,1808,48,35-39,1856,9.96295999581486E-4
STAT,1890,37,35-39,1927,0.085914981976902
STAT,1828,28,45-49,1856,0.016733765145645566
STAT,1947,23,15-19,1970,0.05973108635994341
STAT,1875,39,35-39,1914,0.0719737932760061
STAT,1847,39,35-39,1886,0.07678104076197553
STAT,1821,42,45-49,1863,0.023331817699452116
STAT,1882,17,30-34,1899,0.015274748686147694
STAT,1908,34,40-44,1942,0.036432347592158985
STAT,1887,17,45-49,1904,7.130001969955334E-4
STAT,1893,15,40-44,1908,0.0023168981149728957
STAT,1817,41,40-44,1858,0.0732723403650293
STAT,1832,35,20-24,1867,0.0044663490151842355
STAT,1882,26,20-24,1908,0.11281345580868163
STAT,1838,19,15-19,1857,0.06012657818008665
STAT,1825,74,na,1899,5.982907722665419
STAT,1911,18,15-19,1929,0.08999453288343694
STAT,1817,46,35-39,1863,0.004108073459937174
STAT,1824,89,na,1913,0.7309751150085522
STAT,1941,17,35-39,1958,0.042907570907659565
SIM,1875,69,na,1944,7
STAT,1868,36,na,1904,22.909595352992906
STAT,1845,47,25-29,1892,3.35130412984154E-4
STAT,1868,41,35-39,1909,0.01760335754755827
STAT,1873,30,15-19,1903,0.0014594863244432688
STAT,1894,32,25-29,1926,0.13126838622383546
STAT,1837,43,na,1880,11.842674350404309
STAT,1865,27,35-39,1892,0.08727333645826811
SIM,1852,73,na,1925,19
STAT,1877,13,na,1890,26.61691572429617
STAT,1873,43,20-24,1916,0.0016029765766226662
SIM,1831,74,na,1905,2
STAT,1921,28,25-29,1949,0.7252855647995766
STAT,1867,37,35-39,1904,0.06768506909262861
STAT,1884,32,40-44,1916,0.042489064430373896
SIM,1834,44,na,1878,17
STAT,1868,20,na,1888,23.219887339993623
STAT,1880,16,20-24,1896,0.18688278345614606
STAT,1842,46,45-49,1888,0.0017937891193942454
STAT,1868,42,25-29,1910,0.006206793531879121
STAT,1916,36,40-44,1952,0.01527212328408708
STAT,1806,92,na,1898,0.19488550181955552
STAT,1872,17,25-29,1889,0.05817099586115726
STAT,1864,38,20-24,1902,0.0068796270202283495
SIM,1830,30,na,1860,20
STAT,1909,37,15-19,1946,1.8074641112758032E-4
SIM,1902,33,na,1935,33
STAT,1868,49,45-49,1917,0.0022361932656872027
STAT,1873,38,25-29,1911,0.029127393264030795
SIM,1868,72,na,1940,23
SIM,1843,37,na,1880,22
STAT,1856,35,na,1891,17.229576257188402
STAT,1852,21,na,1873,21.89571951631401
STAT,1893,20,15-19,1913,0.041844836331293045
SIM,1847,73,na,1920,10
STAT,1875,17,na,1892,25.961770384780227
STAT,1939,21,15-19,1960,0.0531105069658551
STAT,1892,43,30-34,1935,0.014100489288326166
STAT,1871,24,na,1895,23.431930998932433
STAT,1887,2,na,1889,30.58676333725245
STAT,1856,29,35-39,1885,0.07139606514870676
STAT,1870,45,45-49,1915,0.002367769687695951
SIM,1850,77,na,1927,4
STAT,1827,41,25-29,1868,0.0050935214546085445
STAT,1934,24,40-44,1958,0.04496408268141131
SIM,1871,76,na,1947,10
STAT,1883,47,45-49,1930,0.0022810679874227624
STAT,1846,16,45-49,1862,6.689633915955652E-4
STAT,1893,27,35-39,1920,0.12166115412523751
STAT,1873,15,50-100,1888,5.040166470756081E-4
STAT,1915,24,30-34,1939,0.2926855812153393
SIM,1822,38,na,1860,16
SIM,1929,0,na,1929,51
STAT,1862,36,45-49,1898,0.017281878414374775
STAT,1910,15,40-44,1925,0.002767377807610838
STAT,1826,36,35-39,1862,0.08386650225577032
SIM,1868,51,na,1919,31
STAT,1864,47,35-39,1911,0.0012498379371592126
STAT,1877,32,25-29,1909,0.10573041571523197
SIM,1918,30,35-39,1948,1
STAT,1884,37,35-39,1921,0.06929708595365054
STAT,1883,30,20-24,1913,0.026459894820333032
STAT,1803,54,45-49,1857,2.721331372991287E-4
SIM,1792,82,na,1874,1
STAT,1935,27,15-19,1962,0.009580406065723258
SIM,1822,59,na,1881,12
STAT,1900,39,20-24,1939,0.0022839541181371944
STAT,1888,21,45-49,1909,0.008173488379282457
STAT,1904,47,na,1951,32.09343070841877
STAT,1858,42,40-44,1900,0.017094672684891704
STAT,1867,28,45-49,1895,0.01058776243214486
STAT,1945,27,20-24,1972,0.19882584404954365
SIM,1871,55,na,1926,20
STAT,1821,60,na,1881,12.749252635851299
STAT,1836,74,na,1910,10.710625931979449
STAT,1831,45,30-34,1876,9.508169214923879E-4
STAT,1846,8,na,1854,25.0
SIM,1889,50,na,1939,26
STAT,1900,33,na,1933,32.95090343191783
SIM,1902,65,na,1967,30
STAT,1876,19,35-39,1895,0.005543054557313485
STAT,1877,54,45-49,1931,1.4568643243459653E-4
STAT,1933,19,50-100,1952,0.004968089667450967
STAT,1846,40,45-49,1886,0.012594648496770803
STAT,1869,54,50-100,1923,1.423126273010854E-4
SIM,1877,65,na,1942,21
STAT,1912,28,50-100,1940,0.0096977765825293
STAT,1912,49,40-44,1961,0.0014945454014895665
STAT,1834,35,30-34,1869,0.04783126777377892
STAT,1906,22,15-19,1928,0.047928743255847485
STAT,1830,26,50-100,1856,0.0064899875276456746
STAT,1860,16,40-44,1876,0.0017250929938404157
SIM,1823,60,na,1883,7
SIM,1875,21,na,1896,18
STAT,1857,16,20-24,1873,0.15691268017497162
STAT,1828,39,25-29,1867,0.012720444185763317
STAT,1860,40,na,1900,18.979343838124393
SIM,1864,27,30-34,1891,1
STAT,1819,46,45-49,1865,0.002153945457135276
STAT,1930,18,25-29,1948,0.5561745460910641
STAT,1894,36,40-44,1930,0.0563717415977525
SIM,1860,55,na,1915,17
STAT,1841,32,50-100,1873,0.010881282509311713
SIM,1829,92,na,1921,2
STAT,1838,22,na,1860,21.53031982432054
STAT,1814,74,na,1888,5.103043572219025
STAT,1878,27,20-24,1905,0.12111756234810274
SIM,1833,59,na,1892,9
STAT,1862,10,na,1872,23.884439571711727
STAT,1893,17,45-49,1910,8.236366751597552E-4
STAT,1844,40,35-39,1884,0.014861974478256315
STAT,1935,31,45-49,1966,0.021686359997219684
STAT,1874,19,25-29,1893,0.05718017432124051
STAT,1910,33,45-49,1943,0.0150163083415966
STAT,1942,29,45-49,1971,0.017982355890899453
STAT,1930,28,50-100,1958,0.012591064595202756
STAT,1775,82,na,1857,2.3829514812372006
STAT,1875,32,15-19,1907,0.0014638685287030077
STAT,1851,33,40-44,1884,0.03771278784054437
STAT,1829,27,25-29,1856,0.4859571654670031
SIM,1872,40,na,1912,21
SIM,1923,27,35-39,1950,1
STAT,1872,49,35-39,1921,0.0014025300691836236
SIM,1912,54,na,1966,35
STAT,1856,27,30-34,1883,0.1890351853518713
STAT,1862,40,40-44,1902,0.019601769501964718
STAT,1868,46,40-44,1914,0.0016614838632231948
STAT,1866,47,45-49,1913,0.0021633834197349257
STAT,1810,60,na,1870,8.329396447654632
STAT,1920,45,20-24,1965,1.2169080009899298E-4
STAT,1880,17,na,1897,26.558089422530806
STAT,1847,49,25-29,1896,6.024574208520499E-4
STAT,1896,18,25-29,1914,0.07423949957768307
STAT,1900,21,50-100,1921,0.005671828354009402
STAT,1905,32,na,1937,34.733185474898434
STAT,1921,33,20-24,1954,0.026818749017077193
STAT,1850,25,na,1875,22.995376454089413
STAT,1912,46,25-29,1958,5.07059925114734E-4
STAT,1835,29,15-19,1864,0.0026627884883636058
STAT,1888,41,15-19,1929,1.6211160963305657E-4
STAT,1841,15,30-34,1856,0.020360371443855996
STAT,1886,19,50-100,1905,5.054510085239628E-4
STAT,1834,26,40-44,1860,0.027959452354512714
STAT,1908,13,na,1921,38.05093748788191
SIM,1900,69,na,1969,18
STAT,1868,17,35-39,1885,0.005406250899123071
SIM,1858,73,na,1931,15
STAT,1925,41,40-44,1966,0.0030136254515990887
STAT,1942,21,35-39,1963,0.09803839616531375
STAT,1812,48,25-29,1860,6.383705136463543E-4
SIM,1861,77,na,1938,9
STAT,1858,48,50-100,1906,0.0018453976010304545
STAT,1895,39,15-19,1934,7.21692177940577E-4
SIM,1832,37,na,1869,25
STAT,1897,28,30-34,1925,0.3332272931506823
STAT,1903,16,15-19,1919,0.08458070005142133
STAT,1825,48,35-39,1873,0.001274762855348335
STAT,1852,17,45-49,1869,6.761636838569689E-4
STAT,1930,16,20-24,1946,1.7488644122125883
STAT,1805,97,na,1902,0.014709302302762978
STAT,1860,106,na,1966,7.254871281442301E-4
STAT,1904,28,25-29,1932,0.6039995304965349
STAT,1886,37,45-49,1923,0.020677766040889667
STAT,1954,6,na,1960,48.321189282739
STAT,1832,37,25-29,1869,0.016339382009223934
STAT,1844,48,45-49,1892,0.0018202221412775851
STAT,1869,29,45-49,1898,0.010681295851204699
SIM,1896,20,na,1916,33
STAT,1864,54,na,1918,18.781179496903604
STAT,1911,17,na,1928,38.40017865773763
SIM,1863,36,na,1899,12
STAT,1826,37,na,1863,19.88417928934422
STAT,1854,29,25-29,1883,0.267177928786118
STAT,1879,20,na,1899,24.624542178122734
SIM,1811,75,na,1886,3
STAT,1785,81,na,1866,5.741575245521923
STAT,1836,58,na,1894,19.085893805953507
STAT,1832,44,na,1876,11.26442123539673
STAT,1855,46,30-34,1901,6.834746009903896E-4
STAT,1890,43,20-24,1933,0.0019151710637911453
STAT,1936,20,35-39,1956,0.08953813895144465
SIM,1882,39,na,1921,28
STAT,1853,35,40-44,1888,0.028089106403710668
STAT,1861,25,na,1886,20.5088588080557
STAT,1834,31,15-19,1865,0.0013025451295629183
STAT,1876,16,30-34,1892,0.016227825463183538
STAT,1897,27,30-34,1924,0.3344043966268085
SIM,1812,60,na,1872,15
SIM,1912,28,25-29,1940,1
STAT,1852,16,45-49,1868,6.801698844765357E-4
SIM,1944,6,na,1950,36
SIM,1889,13,na,1902,34
STAT,1880,39,na,1919,24.52500800887208
STAT,1931,20,20-24,1951,1.4443493977244666
STAT,1867,25,40-44,1892,0.02886084719364376
STAT,1940,30,15-19,1970,0.001322022157272661
STAT,1855,19,15-19,1874,0.04911345514099698
STAT,1914,32,50-100,1946,0.00825353132121968
STAT,1923,26,30-34,1949,0.4482762471577976
SIM,1826,41,na,1867,16
SIM,1899,22,25-29,1921,1
STAT,1908,37,45-49,1945,0.006349578480255191
STAT,1825,40,25-29,1865,0.006476615550557128
STAT,1869,21,35-39,1890,0.056713088719597474
STAT,1916,31,35-39,1947,0.09392287592930042
STAT,1832,38,25-29,1870,0.01617059619306865
STAT,1816,52,50-100,1868,1.826972954817783E-4
STAT,1855,43,50-100,1898,0.0073844272713108495
STAT,1892,39,35-39,1931,0.08649997758745842
STAT,1867,34,30-34,1901,0.1656521152620903
STAT,1871,23,40-44,1894,0.020711384999027534
STAT,1824,39,40-44,1863,0.06107428053359565
STAT,1811,82,na,1893,2.6441750434645215
STAT,1899,67,na,1966,24.3686826568718
STAT,1925,22,25-29,1947,1.098735451574394
STAT,1916,39,45-49,1955,0.006851851421907485
STAT,1841,16,30-34,1857,0.020240448856051682
SIM,1909,50,na,1959,33
STAT,1849,37,40-44,1886,0.03473243622031852
SIM,1898,27,na,1925,32
SIM,1877,21,35-39,1898,1
STAT,1880,28,15-19,1908,0.004754129449023311
STAT,1914,46,na,1960,36.22298205001776
STAT,1830,25,45-49,1855,0.012769818662195289
STAT,1910,32,na,1942,36.24432490248271
STAT,1914,43,30-34,1957,0.0012543186185865864
STAT,1895,53,na,1948,27.505540763481765
STAT,1875,36,30-34,1911,0.05504866043905908
SIM,1814,56,na,1870,22
STAT,1889,26,30-34,1915,0.3093680200709208
STAT,1888,49,25-29,1937,3.717638157003375E-4
STAT,1900,16,35-39,1916,0.007627538325081468
SIM,1878,50,na,1928,28
STAT,1831,59,na,1890,15.771089300885503
SIM,1781,82,na,1863,3
STAT,1944,20,30-34,1964,0.3082842412617744
STAT,1917,20,25-29,1937,0.9785966199698717
SIM,1880,91,na,1971,3
STAT,1871,37,25-29,1908,0.028705606125322657
STAT,1909,41,45-49,1950,0.0015568646366554387
SIM,1825,30,na,1855,22
STAT,1837,26,20-24,1863,0.07466342369712332
STAT,1811,50,25-29,1861,1.3990624810249672E-4
STAT,1840,37,20-24,1877,0.007144202160082897
STAT,1898,17,20-24,1915,0.2391580419959042
SIM,1909,28,na,1937,39
STAT,1915,27,35-39,1942,0.15181259098814784
STAT,1867,30,15-19,1897,0.0013737395389379892
SIM,1905,14,na,1919,40
STAT,1881,32,15-19,1913,0.0013550708740633856
STAT,1893,24,30-34,1917,0.22318506615011602
STAT,1858,20,20-24,1878,0.6103927062897141
STAT,1860,21,15-19,1881,0.02784770501209593
SIM,1929,27,na,1956,44
STAT,1851,30,25-29,1881,0.09188968969389764
STAT,1840,63,na,1903,13.981651636887149
STAT,1810,97,na,1907,0.0193103217463088
STAT,1831,48,35-39,1879,0.0013232773010727066
STAT,1889,28,35-39,1917,0.11771905491480794
STAT,1824,102,na,1926,0.0020399470449424637
STAT,1922,16,25-29,1938,0.4990735636246682
STAT,1829,88,na,1917,0.9325015500667881
STAT,1845,33,40-44,1878,0.02983016708420803
STAT,1905,30,20-24,1935,0.039325242913037406
STAT,1846,36,na,1882,20.14709832324554
SIM,1902,0,na,1902,38
STAT,1806,48,25-29,1854,0.0019122856707119767
STAT,1877,51,40-44,1928,1.091927841737949E-4
STAT,1913,39,30-34,1952,0.01765628893526248
STAT,1926,31,na,1957,45.49659953953566
STAT,1827,45,40-44,1872,0.0013243966911677216
SIM,1910,47,na,1957,30
STAT,1847,48,25-29,1895,6.07573187087325E-4
STAT,1880,19,25-29,1899,0.05926909659614547
STAT,1856,26,30-34,1882,0.19040227367687126
SIM,1867,87,na,1954,1
STAT,1861,19,15-19,1880,0.056688509935435984
STAT,1825,43,40-44,1868,0.02147238641124096
STAT,1872,30,45-49,1902,0.017985687779243874
STAT,1852,42,35-39,1894,0.015478736989356982
STAT,1879,9,na,1888,27.195486207382498
STAT,1932,39,40-44,1971,0.019989484856393853
STAT,1888,30,35-39,1918,0.11929596561926958
STAT,1847,40,15-19,1887,1.5219468445037677E-4
STAT,1883,68,na,1951,14.84004310219603
STAT,1864,17,na,1881,23.433756451199972
STAT,1892,34,40-44,1926,0.053117429733539265
STAT,1851,38,35-39,1889,0.05972780502692408
SIM,1928,42,na,1970,54
SIM,1899,71,na,1970,12
SIM,1842,74,na,1916,11
STAT,1803,51,40-44,1854,2.095387463777881E-4
STAT,1863,91,na,1954,0.513068586237088
STAT,1830,36,25-29,1866,0.017209990016095196
STAT,1853,49,25-29,1902,3.5444678429524096E-4
STAT,1934,27,45-49,1961,0.023142145098336623
SIM,1844,22,na,1866,10
SIM,1848,36,na,1884,32
STAT,1870,42,40-44,1912,0.02231654020252416
STAT,1826,33,30-34,1859,0.23087986021835422
STAT,1893,18,45-49,1911,8.214787470708366E-4
STAT,1848,25,30-34,1873,0.19723579627675322
STAT,1856,17,50-100,1873,4.196620478125495E-4
STAT,1904,26,20-24,1930,0.168675743795461
SIM,1868,8,na,1876,38
STAT,1841,32,20-24,1873,0.03210137908438684
STAT,1866,45,30-34,1911,9.00398117770392E-4
STAT,1868,53,40-44,1921,1.0024502746796237E-4
SIM,1941,29,na,1970,44
STAT,1923,34,30-34,1957,0.1791349528282308
STAT,1880,46,50-100,1926,0.0025899469183572233
STAT,1883,89,na,1972,3.198219254044974
STAT,1921,26,20-24,1947,0.20254665099840075
SIM,1893,18,na,1911,37
STAT,1906,37,35-39,1943,0.022179092651811436
STAT,1884,36,35-39,1920,0.06963061660719902
STAT,1886,44,45-49,1930,0.015314597582266255
STAT,1860,19,45-49,1879,6.052819204661822E-4
STAT,1864,32,15-19,1896,0.001277287014030307
STAT,1869,17,50-100,1886,4.8127604932507787E-4
STAT,1901,28,45-49,1929,0.015481440127984287
SIM,1793,83,na,1876,6
SIM,1802,61,na,1863,11
STAT,1913,18,25-29,1931,0.08763113327607427
STAT,1835,21,40-44,1856,0.018393495869238292
SIM,1876,48,na,1924,27
STAT,1886,22,25-29,1908,0.5937894447084866
STAT,1885,15,45-49,1900,6.480664961544141E-4
STAT,1908,50,na,1958,32.7542888032658
STAT,1936,21,35-39,1957,0.08950590522142213
STAT,1856,51,na,1907,15.672896575008673
STAT,1891,26,25-29,1917,0.5209740567829141
STAT,1941,29,40-44,1970,0.04781999451134212
STAT,1824,35,25-29,1859,0.04378175170058083
STAT,1812,45,na,1857,12.496048366879686
STAT,1863,40,45-49,1903,0.0133849259624276
STAT,1855,104,na,1959,0.0010043008166034416
SIM,1861,72,na,1933,12
STAT,1819,53,45-49,1872,1.2361299179387055E-4
STAT,1796,81,na,1877,0.4153029144888468
STAT,1817,45,35-39,1862,0.004168780225852188
STAT,1882,20,15-19,1902,0.03180463059469268
STAT,1869,40,50-100,1909,0.010339688685394751
SIM,1921,18,25-29,1939,1
STAT,1814,53,50-100,1867,4.066821547023175E-4
STAT,1854,1,na,1855,23.211480642431027
STAT,1935,37,50-100,1972,0.005844879418941872
STAT,1801,83,na,1884,1.3550056718715955
STAT,1826,53,na,1879,16.198282450902973
STAT,1889,68,na,1957,19.269892432325303
STAT,1836,50,40-44,1886,1.0695483781564337E-4
STAT,1864,70,na,1934,12.584493609956565
STAT,1851,20,na,1871,21.869010646265682
STAT,1910,26,45-49,1936,0.01663768245630542
SIM,1888,33,na,1921,38
STAT,1944,17,15-19,1961,0.4848522655066657
STAT,1850,62,na,1912,16.273476563552116
STAT,1875,30,25-29,1905,0.10613436918275586
STAT,1912,24,50-100,1936,0.006479215775497861
STAT,1877,46,45-49,1923,0.0024430527378102532
STAT,1866,41,25-29,1907,0.005940907939279058
STAT,1938,28,40-44,1966,0.04585078779761015
STAT,1927,23,35-39,1950,0.11506014260403426
STAT,1839,37,50-100,1876,0.008096656867068978
SIM,1918,27,na,1945,35
STAT,1815,42,20-24,1857,0.0024553753117461125
SIM,1922,32,na,1954,49
SIM,1851,78,na,1929,9
SIM,1853,29,20-24,1882,2
STAT,1924,41,50-100,1965,0.0013902970127763364
STAT,1845,21,25-29,1866,0.41842404402360484
STAT,1827,30,50-100,1857,0.008785567387297853
STAT,1932,27,35-39,1959,0.19585033970975949
STAT,1869,26,40-44,1895,0.029124865860824727
SIM,1793,61,na,1854,18
SIM,1953,14,na,1967,50
STAT,1838,42,15-19,1880,1.2534967451105703E-4
STAT,1929,12,na,1941,50.32505258171326
STAT,1834,42,30-34,1876,0.009794473399997748
STAT,1867,32,40-44,1899,0.04150066661640778
STAT,1901,18,50-100,1919,6.837320830944455E-4
STAT,1832,34,20-24,1866,0.015472140766395102
STAT,1914,36,30-34,1950,0.018133313094100947
STAT,1895,20,25-29,1915,0.7476284673039781
STAT,1934,29,na,1963,50.13172407983506
STAT,1851,41,50-100,1892,0.00895924928074682
STAT,1878,28,20-24,1906,0.12069122852863745
STAT,1909,29,15-19,1938,0.006660938415323547
SIM,1837,24,20-24,1861,1
STAT,1845,29,20-24,1874,0.08227498685921629
SIM,1901,64,na,1965,30
STAT,1892,31,25-29,1923,0.12705503082103278
STAT,1826,43,na,1869,18.714165612654792
SIM,1901,54,na,1955,31
STAT,1882,33,20-24,1915,0.025795277954088525
STAT,1896,15,20-24,1911,0.23395259273622607
STAT,1891,6,na,1897,32.06312774756407
STAT,1870,30,35-39,1900,0.10140976357801067
STAT,1851,42,na,1893,19.488177791543986
STAT,1845,43,45-49,1888,0.008795444385738328
STAT,1855,20,40-44,1875,0.017388722049259498
STAT,1880,29,15-19,1909,0.004736824417828867
STAT,1801,53,50-100,1854,4.239230445728569E-4
STAT,1865,24,30-34,1889,0.1607350190091756
SIM,1873,24,30-34,1897,1
STAT,1933,39,45-49,1972,0.009227971713002674
STAT,1864,92,na,1956,0.424649078394424
STAT,1902,39,30-34,1941,0.01605870996579826
STAT,1871,30,40-44,1901,0.04358462474765456
STAT,1821,34,45-49,1855,0.043912676469465416
STAT,1916,44,40-44,1960,0.0025328511953368513
STAT,1831,33,50-100,1864,0.009560648178513426
STAT,1865,36,25-29,1901,0.026167315478704337
STAT,1841,19,35-39,1860,0.006845622062423443
STAT,1937,16,30-34,1953,0.11811800127682164
STAT,1899,35,40-44,1934,0.06049422402821717
STAT,1901,12,na,1913,36.13624937260272
STAT,1855,40,na,1895,16.43693939330694
STAT,1946,24,na,1970,40.32341029264981
SIM,1884,35,na,1919,24
STAT,1918,49,20-24,1967,1.158537600966358E-4
STAT,1894,30,35-39,1924,0.13083090814456103
STAT,1867,35,na,1902,22.759892305859086
SIM,1905,20,na,1925,35
STAT,1826,59,na,1885,14.38392056175416
STAT,1909,15,40-44,1924,0.0027402131989998375
SIM,1851,56,na,1907,15
STAT,1912,0,na,1912,45.051489580734554
STAT,1871,33,45-49,1904,0.017312544920534696
STAT,1801,61,na,1862,9.22553236239446
STAT,1889,46,na,1935,27.623720653161545
STAT,1871,40,na,1911,23.27558154062122
STAT,1888,46,20-24,1934,1.4062991326935025E-4
STAT,1914,23,25-29,1937,0.9329798663284302
STAT,1843,35,35-39,1878,0.035760704173487985
SIM,1813,45,na,1858,12
STAT,1839,34,30-34,1873,0.1161358403112263
SIM,1804,78,na,1882,6
STAT,1940,29,35-39,1969,0.15186010134641398
SIM,1898,33,na,1931,34
STAT,1819,39,20-24,1858,0.007582905295752224
STAT,1874,70,na,1944,14.23406725923952
STAT,1937,27,25-29,1964,0.6375612069837086
STAT,1851,37,35-39,1888,0.06035123326656774
STAT,1843,55,na,1898,8.771108178950799
SIM,1821,74,na,1895,2
STAT,1835,95,na,1930,0.05980238116460104
SIM,1818,76,na,1894,8
STAT,1889,29,35-39,1918,0.117290557554918
STAT,1834,29,45-49,1863,0.010141523123034976
STAT,1924,46,40-44,1970,0.0018694275138657027
STAT,1860,35,35-39,1895,0.058047014476506044
STAT,1894,43,40-44,1937,0.0019873134803869647
STAT,1928,29,25-29,1957,0.8061356478993906
STAT,1938,26,15-19,1964,0.006950937957279269
STAT,1874,40,20-24,1914,0.0016274015934312051
STAT,1782,79,na,1861,2.060216616222872
SIM,1813,55,na,1868,9
STAT,1866,18,na,1884,23.73425400423687
STAT,1819,105,na,1924,1.505116713466821E-4
STAT,1954,16,30-34,1970,0.14986426015768242
STAT,1923,21,25-29,1944,1.0705356585152965
STAT,1850,25,25-29,1875,0.4496604166859818
STAT,1794,96,na,1890,0.018629045719463173
STAT,1880,23,45-49,1903,0.0073100485145739845
STAT,1946,14,na,1960,43.245434188524314
STAT,1944,23,35-39,1967,0.10089398362140542
STAT,1919,39,25-29,1958,0.010463694481363467
STAT,1928,26,30-34,1954,0.48201388919229854
STAT,1830,32,45-49,1862,0.011471446446799089
STAT,1887,31,50-100,1918,0.01004176109078282
STAT,1904,21,15-19,1925,0.047414124503784995
SIM,1933,16,na,1949,52
STAT,1901,18,na,1919,35.247432557328764
STAT,1900,54,na,1954,29.03732033237311
STAT,1891,40,20-24,1931,0.001968881928088044
STAT,1899,47,35-39,1946,0.001076029596517833
STAT,1829,30,40-44,1859,0.04260166456345671
SIM,1916,23,25-29,1939,1
STAT,1931,39,50-100,1970,0.0055240161761856265
STAT,1947,16,15-19,1963,0.5078755478921787
STAT,1841,26,na,1867,26.489838248168585
STAT,1794,64,na,1858,9.475873471206933
STAT,1853,42,40-44,1895,0.014118872037696021
STAT,1837,27,20-24,1864,0.07393760008442267
STAT,1908,23,25-29,1931,0.8421613916175426
STAT,1838,26,50-100,1864,0.006361325032470667
STAT,1923,30,50-100,1953,0.009488386996979877
STAT,1896,21,40-44,1917,0.0274542163910651
STAT,1844,72,na,1916,9.864409650857143
STAT,1819,89,na,1908,0.5392707804978513
STAT,1917,27,na,1944,38.929450601832144
SIM,1900,29,20-24,1929,1
STAT,1840,35,50-100,1875,0.011617456559294163
SIM,1931,34,30-34,1965,1
STAT,1907,46,40-44,1953,0.0014166052626633373
STAT,1828,60,na,1888,13.225603819709844
SIM,1861,40,na,1901,25
STAT,1858,34,40-44,1892,0.03271748078862962
STAT,1814,58,na,1872,11.262131661435571
STAT,1918,27,15-19,1945,0.007444905055726046
STAT,1921,32,na,1953,41.7601518944002
STAT,1850,94,na,1944,0.177949021317434
STAT,1885,41,35-39,1926,0.017962966294187248
STAT,1859,24,30-34,1883,0.14478714575609614
STAT,1825,47,35-39,1872,0.0012920337452678335
STAT,1894,15,na,1909,32.518349575607694
STAT,1847,45,20-24,1892,1.294664292746596E-4
STAT,1875,43,30-34,1918,0.011732554498091229
STAT,1892,38,35-39,1930,0.08694601062194905
SIM,1896,68,na,1964,21
STAT,1889,25,30-34,1914,0.31040165759069765
STAT,1863,17,20-24,1880,0.17911524538332252
STAT,1875,86,na,1961,3.6631715577999224
STAT,1899,46,na,1945,30.892013089129623
STAT,1897,33,na,1930,31.555418192996438
STAT,1836,31,25-29,1867,0.12625170208691916
STAT,1824,32,20-24,1856,0.044148016526561765
STAT,1817,76,na,1893,7.5085360818377875
STAT,1899,33,15-19,1932,0.001941239786088264
STAT,1852,21,40-44,1873,0.021339460767373617
STAT,1929,30,45-49,1959,0.01991483379339107
STAT,1913,15,20-24,1928,0.27615394703595586
STAT,1918,39,50-100,1957,0.004375977675270405
STAT,1818,40,na,1858,7.576395046305181
STAT,1836,21,na,1857,27.429702156583737
STAT,1866,48,35-39,1914,0.0012731731447982774
STAT,1896,32,na,1928,31.34505466404874
STAT,1883,41,25-29,1924,0.00626408374627168
STAT,1807,50,50-100,1857,3.2201761399250074E-4
STAT,1835,89,na,1924,0.4725232322415255
STAT,1901,25,40-44,1926,0.04220036865530477
SIM,1831,58,na,1889,6
STAT,1926,29,15-19,1955,0.008354219804039671
STAT,1956,16,40-44,1972,0.018409212219510005
STAT,1848,28,35-39,1876,0.07395846430137819
STAT,1885,38,na,1923,23.150225937174707
STAT,1816,75,na,1891,3.0906287442112927
STAT,1904,37,15-19,1941,1.7367306866787884E-4
STAT,1843,19,45-49,1862,3.499478076755474E-4
SIM,1861,56,na,1917,22
SIM,1854,24,20-24,1878,1
STAT,1914,39,35-39,1953,0.02370853927478828
STAT,1906,33,na,1939,34.81605925664136
STAT,1854,39,15-19,1893,3.3978182618817364E-4
STAT,1873,26,30-34,1899,0.25690111867957915
STAT,1905,33,25-29,1938,0.08452320838995005
SIM,1901,48,na,1949,33
SIM,1949,2,na,1951,40
SIM,1868,35,na,1903,33
SIM,1914,21,25-29,1935,1
SIM,1830,57,na,1887,13
SIM,1891,69,na,1960,27
STAT,1874,54,50-100,1928,1.4900275449489E-4
SIM,1945,11,na,1956,40
STAT,1851,26,na,1877,21.538076388893984
STAT,1884,33,30-34,1917,0.1703400402143068
SIM,1836,21,25-29,1857,1
STAT,1849,40,25-29,1889,0.005066253004298533
SIM,1843,43,na,1886,20
SIM,1888,71,na,1959,21
SIM,1834,23,na,1857,22
SIM,1878,31,40-44,1909,1
STAT,1870,39,na,1909,23.16845727269276
STAT,1854,15,40-44,1869,0.0013532502505620605
STAT,1924,16,35-39,1940,0.04976604041499904
STAT,1900,28,40-44,1928,0.04139272796959451
SIM,1927,3,na,1930,52
STAT,1912,23,15-19,1935,0.05045971144392901
SIM,1868,29,na,1897,33
SIM,1848,74,na,1922,11
STAT,1897,47,25-29,1944,4.2945706995436896E-4
SIM,1932,16,35-39,1948,1
STAT,1891,23,20-24,1914,0.8431934584190088
STAT,1864,103,na,1967,0.008537675834633844
STAT,1897,20,35-39,1917,0.07795493732193362
STAT,1856,30,15-19,1886,0.001066193277180088
STAT,1906,32,50-100,1938,0.007643383601696034
STAT,1908,20,20-24,1928,1.0230072010217093
STAT,1852,91,na,1943,0.4959453531466531
STAT,1863,109,na,1972,1.2262065265781892E-4
STAT,1862,21,25-29,1883,0.509251118191059
STAT,1878,51,45-49,1929,1.5054558332853188E-4
SIM,1873,41,na,1914,27
STAT,1790,66,na,1856,4.640697800000001
STAT,1904,33,50-100,1937,0.007506743077785487
STAT,1868,31,30-34,1899,0.16965609534297602
STAT,1869,30,25-29,1899,0.10004257792972586
STAT,1906,21,25-29,1927,0.8341842009973836
STAT,1854,92,na,1946,0.25457580330699103
STAT,1832,42,20-24,1874,8.734921711778171E-4
STAT,1893,40,30-34,1933,0.014642175383124716
STAT,1834,78,na,1912,5.521642793244303
SIM,1916,20,20-24,1936,1
STAT,1846,24,20-24,1870,0.6792349700353103
STAT,1825,101,na,1926,0.0030762510768838945
STAT,1817,92,na,1909,0.33008752393327057
SIM,1829,60,na,1889,19
STAT,1821,38,na,1859,17.592279787506687
SIM,1908,27,na,1935,41
SIM,1883,24,na,1907,13
STAT,1933,36,40-44,1969,0.02032545488765836
STAT,1887,25,20-24,1912,0.12891843001039807
SIM,1864,8,na,1872,23
STAT,1903,20,45-49,1923,0.009973205038757349
STAT,1923,17,40-44,1940,0.01631049614407447
STAT,1876,25,50-100,1901,0.006541086403969139
STAT,1913,37,40-44,1950,0.01464961399305193
SIM,1947,24,na,1971,37
SIM,1876,86,na,1962,4
STAT,1836,53,45-49,1889,1.389329620256576E-4
SIM,1903,13,na,1916,39
STAT,1895,16,40-44,1911,0.002380380455238661
STAT,1907,6,na,1913,38.2122970563241
STAT,1895,34,45-49,1929,0.022445434509319417
STAT,1893,67,na,1960,21.272583605851587
STAT,1836,37,na,1873,25.371573369974982
STAT,1903,38,20-24,1941,0.0023537604657186727
SIM,1848,52,na,1900,29
STAT,1885,16,na,1901,25.00198941600569
SIM,1886,20,25-29,1906,1
STAT,1850,42,25-29,1892,0.005710501613137897
STAT,1923,37,25-29,1960,0.011329496949154472
STAT,1869,8,na,1877,26.509089439888683
STAT,1927,20,30-34,1947,0.3544014610071051
SIM,1843,21,na,1864,22
STAT,1862,35,45-49,1897,0.017362440136608624
SIM,1937,24,na,1961,36
STAT,1938,32,25-29,1970,0.09232236336011718
STAT,1931,23,25-29,1954,1.189019292879624
STAT,1865,19,50-100,1884,4.512692990405031E-4
STAT,1893,22,40-44,1915,0.0262742738453955
STAT,1901,41,50-100,1942,0.0010311791502401668
STAT,1851,42,30-34,1893,0.009693905107967051
SIM,1928,27,25-29,1955,1
SIM,1921,15,20-24,1936,4
STAT,1849,32,50-100,1881,0.0074863578003499
STAT,1826,31,40-44,1857,0.06753135406416926
STAT,1835,73,na,1908,5.342426560731472
STAT,1906,11,na,1917,37.57508820197878
STAT,1874,18,35-39,1892,0.005552022602193463
SIM,1881,70,na,1951,8
STAT,1843,32,30-34,1875,0.08903794771354781
STAT,1848,22,na,1870,16.836113408431704
STAT,1884,69,na,1953,14.378284928162
SIM,1892,38,na,1930,35
STAT,1914,20,20-24,1934,1.0875424697433977
STAT,1823,88,na,1911,0.7895015826928099
SIM,1894,67,na,1961,22
STAT,1845,40,40-44,1885,0.01373647449830929
STAT,1940,26,30-34,1966,0.3968977389564789
STAT,1922,29,30-34,1951,0.43698184864910683
SIM,1891,53,na,1944,32
STAT,1910,37,15-19,1947,1.8253820802787836E-4
STAT,1870,88,na,1958,1.8593063956609173
STAT,1897,31,15-19,1928,0.0018988386638859368
STAT,1901,33,40-44,1934,0.060426249779668074
STAT,1927,34,15-19,1961,0.0015706589419429054
STAT,1769,97,na,1866,0.04474676596771854
STAT,1877,30,35-39,1907,0.10537804801636258
STAT,1847,36,30-34,1883,0.059686587111352586
STAT,1860,39,15-19,1899,4.5192657851884406E-4
STAT,1851,54,50-100,1905,1.2399585670760984E-4
STAT,1925,37,45-49,1962,0.008130922730408911
STAT,1872,20,40-44,1892,0.021448123840423824
STAT,1876,20,15-19,1896,0.033706315619633824
STAT,1851,10,na,1861,24.810336339975823
SIM,1897,32,na,1929,40
STAT,1858,32,15-19,1890,0.0010836436262159643
STAT,1919,32,15-19,1951,0.0013743948950452965
SIM,1948,6,na,1954,41
SIM,1825,40,na,1865,18
SIM,1888,65,na,1953,25
STAT,1862,37,50-100,1899,0.010592530320736808
STAT,1917,17,40-44,1934,0.002982562280452517
STAT,1879,43,15-19,1922,1.4190060038358197E-4
SIM,1922,20,20-24,1942,4
STAT,1839,43,20-24,1882,9.119489364722162E-4
STAT,1825,44,30-34,1869,0.010773373304368462
STAT,1869,91,na,1960,0.9966285162165637
SIM,1886,2,na,1888,33
STAT,1839,37,35-39,1876,0.046644150454484015
STAT,1882,73,na,1955,11.382753724190426
STAT,1851,34,30-34,1885,0.15026409540448518
STAT,1842,43,na,1885,17.712494986933557
STAT,1918,19,15-19,1937,0.4868748079184066
STAT,1899,38,45-49,1937,0.005860985559387099
STAT,1921,39,40-44,1960,0.01654940390545951
STAT,1915,39,40-44,1954,0.014841141920428316
STAT,1821,44,na,1865,16.658284346947493
SIM,1863,41,na,1904,11
STAT,1938,21,45-49,1959,0.011066093831046172
SIM,1851,21,15-19,1872,1
STAT,1842,40,25-29,1882,0.005114087599229489
SIM,1871,39,na,1910,24
SIM,1883,18,na,1901,15
STAT,1821,38,50-100,1859,0.02301251033915831
STAT,1812,94,na,1906,0.07942782139288605
STAT,1845,34,50-100,1879,0.006237304394016749
STAT,1854,33,45-49,1887,0.010802552769913785
STAT,1833,23,na,1856,21.123002946517797
STAT,1899,44,30-34,1943,0.0010781405533141016
SIM,1878,71,na,1949,17
SIM,1888,28,30-34,1916,2
STAT,1905,16,25-29,1921,0.08198543271716427
STAT,1891,43,25-29,1934,0.007824668013108353
STAT,1825,95,na,1920,0.07167669673920105
STAT,1889,38,50-100,1927,0.014957086907136227
STAT,1913,48,50-100,1961,0.002183065114268522
STAT,1862,39,25-29,1901,0.02459068435137808
STAT,1847,74,na,1921,11.855172223235316
STAT,1875,4,na,1879,29.893290712412032
STAT,1858,46,35-39,1904,0.0010683472100080356
SIM,1913,33,na,1946,41
STAT,1947,24,15-19,1971,0.05971018047971742
STAT,1843,21,15-19,1864,0.017692678857729585
STAT,1878,52,50-100,1930,1.5509337632628752E-4
STAT,1884,47,na,1931,21.940093899772627
STAT,1850,22,20-24,1872,0.7364421035528911
STAT,1830,58,na,1888,7.129212065271856
SIM,1825,62,na,1887,13
STAT,1907,49,45-49,1956,0.0019168593710477049
STAT,1858,37,45-49,1895,0.015169331146728878
STAT,1943,18,20-24,1961,1.426746141926264
STAT,1794,80,na,1874,2.9364349359773487
STAT,1892,35,30-34,1927,0.06646732090453561
STAT,1928,26,20-24,1954,0.22455503840577548
SIM,1859,68,na,1927,10
SIM,1898,17,na,1915,35
STAT,1827,35,50-100,1862,0.010317506126955192
STAT,1882,29,25-29,1911,0.4024956158833126
STAT,1844,56,na,1900,15.931480432835361
STAT,1952,19,15-19,1971,0.5402819416011483
SIM,1870,4,na,1874,27
STAT,1828,36,20-24,1864,0.0034656452991534584
SIM,1839,91,na,1930,2
STAT,1886,41,40-44,1927,0.02343654772128612
STAT,1873,35,20-24,1908,0.007911594261415775
STAT,1806,55,na,1861,15.007735468992252
SIM,1908,49,na,1957,37
STAT,1871,19,20-24,1890,0.17580562842606642
STAT,1928,29,35-39,1957,0.18387905233997875
STAT,1836,45,45-49,1881,0.002445423577270886
SIM,1845,60,na,1905,21
STAT,1915,15,40-44,1930,0.0029156388157193457
STAT,1864,21,45-49,1885,0.006400972253084098
STAT,1906,15,15-19,1921,0.08661867480924881
STAT,1918,31,45-49,1949,0.01663778390266276
STAT,1890,22,15-19,1912,0.04007334044195863
STAT,1919,21,35-39,1940,0.10252036038716228
STAT,1945,22,15-19,1967,0.05792256066583501
STAT,1825,36,50-100,1861,0.013117680015399175
STAT,1913,2,na,1915,41.33044835807504
STAT,1860,38,50-100,1898,0.009931706782752825
STAT,1823,31,15-19,1854,0.002214410107813121
STAT,1930,27,15-19,1957,0.008934515169518849
STAT,1853,86,na,1939,1.3944501336810602
SIM,1877,49,na,1926,24
STAT,1852,24,45-49,1876,0.006988278720879815
SIM,1843,27,na,1870,21
STAT,1897,17,na,1914,33.53892290761506
STAT,1907,29,40-44,1936,0.04313830741708413
STAT,1846,17,20-24,1863,0.18048733201456055
STAT,1897,35,30-34,1932,0.07144656899921134
STAT,1899,31,25-29,1930,0.14078745987648375
STAT,1916,26,na,1942,38.53460361874489
SIM,1858,67,na,1925,18
STAT,1876,34,na,1910,24.028963846320636
STAT,1834,33,40-44,1867,0.038850913097750156
STAT,1871,15,40-44,1886,0.0018571338726011929
STAT,1861,19,na,1880,21.926715032106678
STAT,1839,30,15-19,1869,9.87417515396756E-4
STAT,1931,39,35-39,1970,0.03182338659836043
SIM,1923,11,na,1934,42
STAT,1811,44,na,1855,17.417486327201043
SIM,1866,34,50-100,1900,1
STAT,1827,54,na,1881,13.618492366800874
SIM,1938,15,25-29,1953,2
STAT,1864,49,na,1913,19.75800758077249
STAT,1840,44,20-24,1884,0.0012652973416920925
STAT,1924,42,25-29,1966,8.438655844694717E-4
STAT,1865,71,na,1936,12.073102604133144
STAT,1929,31,20-24,1960,0.030852548399069084
STAT,1883,48,35-39,1931,0.0013424317097713355
STAT,1920,38,20-24,1958,0.0028587682579762222
SIM,1883,56,na,1939,9
STAT,1853,20,30-34,1873,0.13418997052004128
STAT,1842,19,50-100,1861,4.6647160280003475E-4
STAT,1837,39,15-19,1876,3.2616226843094605E-4
STAT,1913,27,15-19,1940,0.006975344397836869
STAT,1917,28,20-24,1945,0.18902443799622157
STAT,1941,15,na,1956,37.65745758234319
STAT,1797,82,na,1879,1.4828113644070433
STAT,1944,21,45-49,1965,0.01206447595813752
SIM,1923,3,na,1926,42
STAT,1838,31,45-49,1869,0.016993698856917143
STAT,1862,32,40-44,1894,0.037415656092667025
STAT,1876,0,na,1876,37.18892037362468
STAT,1919,36,30-34,1955,0.019427967894971723
STAT,1878,20,25-29,1898,0.5945400672217821
STAT,1832,25,30-34,1857,0.15283835890138325
STAT,1932,18,45-49,1950,0.006570631050343437
SIM,1849,15,na,1864,17
SIM,1925,28,20-24,1953,1
SIM,1911,16,na,1927,40
STAT,1907,16,35-39,1923,0.008045964144988593
SIM,1945,19,25-29,1964,1
STAT,1892,46,35-39,1938,9.78391886450851E-4
STAT,1826,75,na,1901,7.194054865263999
STAT,1924,30,na,1954,44.03543657152403
STAT,1815,69,na,1884,6.127075823350682
STAT,1949,21,20-24,1970,1.2896350358034365
STAT,1841,23,30-34,1864,0.21927999629338366
STAT,1867,46,50-100,1913,0.002356968062697282
STAT,1869,37,20-24,1906,0.007469074006979412
STAT,1857,18,35-39,1875,0.004799504037851315
STAT,1880,20,40-44,1900,0.022043097921340914
STAT,1867,26,30-34,1893,0.2418078322605459
STAT,1841,28,25-29,1869,0.5105807957382369
STAT,1867,19,na,1886,24.417821331248128
STAT,1945,13,na,1958,42.59488729652548
STAT,1916,11,na,1927,41.60473770426232
STAT,1940,15,15-19,1955,0.45776591752755874
STAT,1856,46,25-29,1902,4.184583222850218E-4
SIM,1866,71,na,1937,16
STAT,1826,34,45-49,1860,0.02174506009140186
STAT,1823,47,25-29,1870,3.999259114113611E-4
SIM,1845,17,na,1862,24
SIM,1835,30,30-34,1865,2
SIM,1929,11,na,1940,51
SIM,1858,57,na,1915,23
STAT,1947,22,25-29,1969,1.0368130992041633
SIM,1858,52,na,1910,24
SIM,1811,81,na,1892,1
SIM,1906,63,na,1969,19
SIM,1911,48,na,1959,40
STAT,1837,19,20-24,1856,0.1542889433984853
STAT,1863,16,45-49,1879,6.638778505985832E-4
SIM,1931,30,na,1961,56
STAT,1890,38,25-29,1928,0.03480022200977437
STAT,1939,27,35-39,1966,0.14989582324400413
STAT,1937,31,50-100,1968,0.008132996112795821
STAT,1808,62,na,1870,3.616727411438384
SIM,1872,93,na,1965,3
STAT,1845,57,na,1902,11.74727460292271
STAT,1937,19,25-29,1956,0.41767554167401655
STAT,1936,28,30-34,1964,0.3725379805393985
STAT,1851,45,35-39,1896,0.0011937065459586356
STAT,1929,36,15-19,1965,2.455837908671128E-4
STAT,1821,38,25-29,1859,0.053966968309306085
SIM,1803,62,na,1865,6
STAT,1864,31,50-100,1895,0.008251600041419284
STAT,1930,29,40-44,1959,0.058931610566881724
STAT,1954,16,20-24,1970,1.6669327916142702
SIM,1845,19,20-24,1864,2
SIM,1866,86,na,1952,1
STAT,1914,27,40-44,1941,0.0465985466449501
STAT,1910,20,50-100,1930,0.006178099800613492
STAT,1891,23,na,1914,28.938054634143022
STAT,1827,30,30-34,1857,0.16741529960321577
SIM,1883,34,na,1917,12
STAT,1865,20,15-19,1885,0.03064039260886086
STAT,1843,26,45-49,1869,0.005838210802074552
STAT,1905,49,35-39,1954,0.0011159544992409105
STAT,1820,81,na,1901,3.065728269705198
STAT,1839,27,30-34,1866,0.17506830748922164
STAT,1863,29,15-19,1892,0.003988360693816548
STAT,1837,34,20-24,1871,0.01618875134513828
STAT,1894,21,30-34,1915,0.22896997536305366
SIM,1782,77,na,1859,4
STAT,1860,23,40-44,1883,0.01733815341136823
STAT,1925,21,35-39,1946,0.11234059650022829
SIM,1798,60,na,1858,9
STAT,1878,24,40-44,1902,0.021378929284754135
STAT,1888,37,30-34,1925,0.06228134111708753
STAT,1845,25,40-44,1870,0.021622833237831315
STAT,1930,15,30-34,1945,0.157573767828925
STAT,1925,34,40-44,1959,0.04612022604800642
SIM,1828,38,na,1866,16
SIM,1828,54,na,1882,9
STAT,1883,41,15-19,1924,1.3471148741150567E-4
STAT,1901,36,45-49,1937,0.006049705014489831
STAT,1860,56,na,1916,16.581667907980606
STAT,1913,18,35-39,1931,0.008485319969279927
SIM,1849,37,na,1886,8
STAT,1927,30,35-39,1957,0.1119653009624891
STAT,1949,15,35-39,1964,0.048516278200805146
SIM,1919,29,25-29,1948,3
STAT,1878,35,20-24,1913,0.008033960910315156
STAT,1922,23,50-100,1945,0.007467295403230057
SIM,1803,77,na,1880,2
SIM,1868,19,na,1887,37
STAT,1907,43,50-100,1950,0.0010653546416074804
STAT,1894,47,50-100,1941,0.0017672252193776424
STAT,1828,43,45-49,1871,0.006525855031673473
STAT,1865,17,30-34,1882,0.014855783262152207
STAT,1862,32,50-100,1894,0.007905042562279134
STAT,1867,99,na,1966,0.08316063003152774
STAT,1931,15,na,1946,48.1869449569259
STAT,1882,40,50-100,1922,0.010226600217954065
STAT,1906,37,25-29,1943,0.009028515478244625
STAT,1872,41,na,1913,23.75491780198434
STAT,1893,25,45-49,1918,0.014094538300838635
STAT,1856,34,30-34,1890,0.12540110971166651
SIM,1926,1,na,1927,52
STAT,1896,54,na,1950,27.50563275478691
SIM,1839,75,na,1914,9
STAT,1879,32,45-49,1911,0.01804873406552762
STAT,1954,1,na,1955,48.39954855783834
STAT,1832,45,25-29,1877,3.142098463182259E-4
STAT,1882,36,25-29,1918,0.02772541179086111
SIM,1905,23,25-29,1928,2
STAT,1931,32,15-19,1963,0.0016763736216578514
SIM,1859,15,na,1874,23
STAT,1812,44,45-49,1856,0.01703813496874296
STAT,1849,44,40-44,1893,0.017205272607218016
STAT,1950,1,na,1951,47.986869545895914
STAT,1840,48,50-100,1888,0.001915999552092233
STAT,1929,17,25-29,1946,0.550402816845353
STAT,1932,24,30-34,1956,0.3742920856804144
SIM,1935,30,35-39,1965,1
STAT,1887,18,20-24,1905,0.193001300645911
STAT,1926,18,45-49,1944,0.0060736547687609554
STAT,1846,30,40-44,1876,0.04240534048176048
STAT,1902,17,20-24,1919,0.2500053829327513
SIM,1892,20,25-29,1912,2
STAT,1866,31,20-24,1897,0.024996407778056035
STAT,1785,97,na,1882,0.02755312633896772
STAT,1940,17,40-44,1957,0.014100884826303327
STAT,1879,16,50-100,1895,5.083162183202855E-4
STAT,1893,16,30-34,1909,0.020146096897169025
STAT,1817,42,30-34,1859,0.03631580723598083
STAT,1892,31,15-19,1923,0.0017665049642879183
STAT,1921,17,30-34,1938,0.13785262409717594
STAT,1916,48,na,1964,37.25538824693839
STAT,1926,25,50-100,1951,0.01194421044434362
STAT,1928,11,na,1939,49.755787230511466
STAT,1945,26,30-34,1971,0.42697756873733866
STAT,1842,47,35-39,1889,0.00105056604276378
STAT,1906,28,45-49,1934,0.016073879576179062
STAT,1884,27,45-49,1911,0.010878216480588182
STAT,1876,18,45-49,1894,6.617070193409776E-4
STAT,1836,49,25-29,1885,5.670329983666414E-4
STAT,1927,17,15-19,1944,0.5614055215610452
STAT,1873,22,15-19,1895,0.0335409339092284
SIM,1862,19,na,1881,26
STAT,1863,27,25-29,1890,0.3745357704074593
STAT,1827,38,na,1865,16.91700776326322
SIM,1918,17,15-19,1935,2
SIM,1815,62,na,1877,8
STAT,1856,39,25-29,1895,0.02064793938844466
STAT,1880,60,na,1940,20.055006873963386
STAT,1912,39,25-29,1951,0.009438782750948815
STAT,1852,15,30-34,1867,0.01669447903692198
STAT,1910,16,na,1926,38.12986908049801
STAT,1835,57,na,1892,9.039176594457304
SIM,1848,6,na,1854,33
STAT,1884,20,25-29,1904,0.5642114356803712
SIM,1938,28,30-34,1966,1
STAT,1842,40,15-19,1882,1.0998038582338279E-4
STAT,1887,31,40-44,1918,0.04752903941723116
SIM,1935,17,15-19,1952,1
SIM,1846,26,50-100,1872,1
STAT,1946,17,25-29,1963,0.47725874029513243
SIM,1835,39,na,1874,19
STAT,1865,93,na,1958,0.38832040823246733
STAT,1915,9,na,1924,41.16949945035919
STAT,1869,44,45-49,1913,0.014305822388293237
STAT,1929,38,40-44,1967,0.01910763089247041
SIM,1849,23,25-29,1872,1
STAT,1836,42,40-44,1878,0.025823716014567434
SIM,1871,27,25-29,1898,1
STAT,1837,26,45-49,1863,0.007066391904300747
STAT,1848,37,na,1885,15.70109938386288
STAT,1892,16,50-100,1908,6.067359176258915E-4
STAT,1818,37,50-100,1855,0.01684389098081104
STAT,1898,19,35-39,1917,0.007362395190073664
SIM,1923,33,na,1956,38
STAT,1841,35,25-29,1876,0.03390071896333426
SIM,1942,9,na,1951,43
STAT,1864,48,25-29,1912,5.101361327010466E-4
STAT,1839,23,na,1862,15.051962254904904
STAT,1906,34,30-34,1940,0.1444031682456116
STAT,1924,29,40-44,1953,0.053531846304114325
SIM,1842,42,na,1884,23
STAT,1871,29,25-29,1900,0.41873102415011015
STAT,1881,23,na,1904,22.434925990693802
STAT,1776,83,na,1859,0.8770631659969365
STAT,1874,85,na,1959,3.8076776383196527
STAT,1884,37,na,1921,23.0827322334861
SIM,1933,26,na,1959,51
SIM,1870,86,na,1956,4
STAT,1832,27,20-24,1859,0.0701837633059833
STAT,1835,24,45-49,1859,0.004363686070952159
SIM,1835,24,na,1859,17
STAT,1837,40,40-44,1877,0.013260261507046104
STAT,1883,45,30-34,1928,9.493783226985289E-4
SIM,1818,54,na,1872,24
STAT,1900,16,25-29,1916,0.07877249531584847
STAT,1850,18,25-29,1868,0.06129152332623879
STAT,1877,39,45-49,1916,0.02037087865852904
STAT,1932,15,40-44,1947,0.018531803469055978
SIM,1837,68,na,1905,26
STAT,1817,38,35-39,1855,0.2637291088025883
SIM,1789,83,na,1872,2
STAT,1927,38,30-34,1965,0.022521563637022277
STAT,1914,52,na,1966,35.525155682228316
STAT,1940,22,15-19,1962,0.053842016644629904
STAT,1855,31,45-49,1886,0.012631743676880847
STAT,1905,25,15-19,1930,0.0065924466179318394
STAT,1897,38,35-39,1935,0.09345937315616025
STAT,1951,15,50-100,1966,0.004436750361280125
SIM,1824,61,na,1885,16
STAT,1876,22,40-44,1898,0.02116411592336189
STAT,1825,40,15-19,1865,1.3928206415300988E-4
STAT,1916,47,45-49,1963,0.0022101452695204244
SIM,1939,1,na,1940,35
STAT,1832,49,40-44,1881,8.07395779704076E-4
STAT,1837,37,25-29,1874,0.01708197188499791
STAT,1861,49,50-100,1910,0.0020222630559371515
STAT,1834,36,45-49,1870,0.017706096894779616
STAT,1933,32,25-29,1965,0.12404897332574222
STAT,1823,44,20-24,1867,0.001106436576431886
STAT,1911,29,30-34,1940,0.37693811660540816
STAT,1860,26,45-49,1886,0.009189155176939369
STAT,1854,32,50-100,1886,0.005735161742839605
STAT,1886,70,na,1956,14.845275969349355
STAT,1937,16,20-24,1953,1.3138207161674424
STAT,1884,29,35-39,1913,0.09385990110955401
SIM,1871,6,na,1877,28
STAT,1845,36,20-24,1881,0.004783817384129375
STAT,1879,47,30-34,1926,9.97218819412381E-4
STAT,1820,50,50-100,1870,1.2830668189302418E-4
STAT,1931,36,30-34,1967,0.02405255924173946
STAT,1890,35,20-24,1925,0.009452450284609686
STAT,1923,37,35-39,1960,0.027831592374095028
STAT,1858,43,30-34,1901,0.008685143270586303
STAT,1863,48,50-100,1911,0.002147213405812349
STAT,1847,32,15-19,1879,0.0017861430555033437
SIM,1867,34,na,1901,13
STAT,1896,22,na,1918,31.065764791557513
STAT,1854,19,20-24,1873,0.1281054716774768
SIM,1902,49,na,1951,30
SIM,1919,33,na,1952,42
STAT,1906,25,40-44,1931,0.04381528063462206
STAT,1885,48,na,1933,21.938347022851826
STAT,1832,44,50-100,1876,0.005663624922609366
STAT,1834,28,50-100,1862,0.005885214416505386
STAT,1843,23,40-44,1866,0.011015571306868676
STAT,1863,30,40-44,1893,0.038705826370574965
STAT,1908,21,35-39,1929,0.08637398622620254
SIM,1864,42,na,1906,22
STAT,1901,40,40-44,1941,0.0022076320878280436
STAT,1902,67,na,1969,25.64950018383546
SIM,1932,15,na,1947,51
STAT,1877,43,40-44,1920,0.02305067403645364
STAT,1878,27,45-49,1905,0.011462964322626541
STAT,1932,27,25-29,1959,0.8586184151163164
STAT,1928,38,15-19,1966,2.4125975305496202E-4
STAT,1937,10,na,1947,38.41904534782052
SIM,1843,53,na,1896,19
STAT,1926,16,45-49,1942,0.006104565731813818
STAT,1862,21,35-39,1883,0.05191183508765492
STAT,1858,15,na,1873,20.646328223715418
SIM,1907,48,na,1955,38
STAT,1841,42,na,1883,23.507876743208026
STAT,1854,30,40-44,1884,0.027714944393901417
STAT,1844,30,30-34,1874,0.16650635022156487
STAT,1886,20,35-39,1906,0.06089062220218801
SIM,1881,60,na,1941,18
STAT,1867,22,15-19,1889,0.03170041548215064
STAT,1838,46,30-34,1884,7.82910760608035E-4
SIM,1914,34,na,1948,36
STAT,1815,45,25-29,1860,8.542059462258841E-4
STAT,1950,19,40-44,1969,0.016425146999512315
STAT,1915,17,30-34,1932,0.02529020667841189
STAT,1873,28,20-24,1901,0.11885295954133916
STAT,1876,25,45-49,1901,0.011353251634677965
SIM,1889,18,na,1907,31
STAT,1908,38,20-24,1946,0.002443100547107382
SIM,1880,5,na,1885,35
STAT,1871,26,20-24,1897,0.1173639960897794
STAT,1905,46,30-34,1951,7.902942904374647E-4
STAT,1834,45,35-39,1879,0.0011829353949802865
SIM,1897,69,na,1966,36
STAT,1889,18,30-34,1907,0.019463121549982296
STAT,1936,24,15-19,1960,0.050550082244883075
SIM,1903,27,30-34,1930,1
STAT,1856,43,20-24,1899,0.0011421836483393466
STAT,1836,38,45-49,1874,0.02337066696395652
SIM,1862,30,40-44,1892,1
STAT,1948,17,35-39,1965,0.047703927498154275
STAT,1828,29,20-24,1857,0.17022642673372948
SIM,1823,39,na,1862,11
STAT,1888,33,15-19,1921,0.001657150463781766
STAT,1856,37,35-39,1893,0.05123860182344973
STAT,1931,19,30-34,1950,0.15798092735327046
STAT,1914,32,15-19,1946,0.0012828069863776478
STAT,1836,42,50-100,1878,0.012129020833433635
STAT,1879,84,na,1963,5.648190563557392
STAT,1896,32,45-49,1928,0.02290573222211771
STAT,1866,56,na,1922,18.784653034328993
STAT,1829,41,45-49,1870,0.013429131792406797
STAT,1858,36,30-34,1894,0.04075033300249042
STAT,1885,5,na,1890,25.879193431798953
SIM,1908,12,na,1920,42
STAT,1811,76,na,1887,5.264971225023372
STAT,1921,48,30-34,1969,9.943436015077522E-4
STAT,1840,47,25-29,1887,4.5514898725084363E-4
STAT,1931,15,15-19,1946,0.5941391710391849
STAT,1880,16,45-49,1896,6.885878624942976E-4
STAT,1795,75,na,1870,5.044605131818272
STAT,1849,47,45-49,1896,0.0018213922697380446
STAT,1802,62,na,1864,7.92144235704054
STAT,1892,8,na,1900,32.11499293273242
STAT,1878,38,25-29,1916,0.029577899367746983
STAT,1866,41,15-19,1907,1.2776146959265044E-4
STAT,1889,0,na,1889,35.32401334864436
SIM,1886,48,na,1934,27
STAT,1922,27,40-44,1949,0.05235626110021716
STAT,1819,35,40-44,1854,0.05483340398709884
STAT,1823,61,na,1884,11.402063980232862
STAT,1819,44,50-100,1863,0.009655088849030803
STAT,1905,29,30-34,1934,0.3608380487569606
STAT,1911,17,50-100,1928,7.448892653996928E-4
STAT,1839,36,20-24,1875,0.005136617128664533
STAT,1843,39,15-19,1882,2.4785363080960564E-4
STAT,1854,7,na,1861,18.097704648472384
SIM,1884,19,na,1903,25
STAT,1871,89,na,1960,1.7512688640626095
STAT,1893,23,50-100,1916,0.005125848971596798
STAT,1909,27,50-100,1936,0.009459115330611584
SIM,1851,72,na,1923,14
STAT,1823,38,35-39,1861,0.05039133358568835
STAT,1792,100,na,1892,0.004022595615770757
STAT,1864,45,20-24,1909,1.087037824387992E-4
STAT,1798,101,na,1899,0.002899821710599154
SIM,1862,1,na,1863,29
STAT,1865,42,50-100,1907,0.009543709249402784
STAT,1926,15,40-44,1941,0.017130131893144347
STAT,1860,32,30-34,1892,0.14194273748562394
STAT,1830,25,20-24,1855,0.13492577176913131
STAT,1856,56,na,1912,14.77578899419997
STAT,1930,18,35-39,1948,0.05385436437851261
STAT,1867,1,na,1868,34.12776318696281
SIM,1873,56,na,1929,21
STAT,1906,30,15-19,1936,0.0011975237469986559
STAT,1847,38,20-24,1885,0.008455396985298484
STAT,1861,40,35-39,1901,0.015381795870083164
STAT,1935,19,15-19,1954,0.6143545358734096
SIM,1908,59,na,1967,30
STAT,1838,41,50-100,1879,0.009712894546958338
STAT,1913,15,30-34,1928,0.0248273998630078
STAT,1861,16,35-39,1877,0.005335142959236163
STAT,1820,43,na,1863,15.324656897662525
STAT,1851,20,20-24,1871,0.7048447141503545
STAT,1813,95,na,1908,0.08774464126434604
STAT,1848,6,na,1854,20.0
STAT,1900,2,na,1902,36.96422624036207
STAT,1911,25,15-19,1936,0.006886591978160909
STAT,1825,30,20-24,1855,0.03958294947177392
STAT,1862,28,45-49,1890,0.00954558348697391
STAT,1886,26,40-44,1912,0.03117860603812724
STAT,1837,23,40-44,1860,0.013708517182419246
STAT,1834,94,na,1928,0.14124070491118101
STAT,1856,41,na,1897,16.819151469652077
STAT,1866,34,na,1900,21.78932213136214
STAT,1954,18,20-24,1972,1.6659327812964801
STAT,1851,26,50-100,1877,0.006368941735631909
STAT,1895,31,40-44,1926,0.05653173298273289
STAT,1919,17,15-19,1936,0.49717427676549547
STAT,1876,18,na,1894,25.584005175727285
STAT,1934,17,40-44,1951,0.018838868183797302
SIM,1927,17,15-19,1944,2
STAT,1870,52,45-49,1922,1.4339720163282E-4
STAT,1828,40,40-44,1868,0.010123504354551671
STAT,1853,45,45-49,1898,0.0014980026891235326
STAT,1890,29,35-39,1919,0.11636812141818975
STAT,1891,19,25-29,1910,0.06917838370100725
STAT,1875,46,35-39,1921,0.0014432049620589438
STAT,1897,44,20-24,1941,1.4447412867922278E-4
STAT,1849,71,na,1920,10.349927828677735
STAT,1865,26,20-24,1891,0.10647363186727103
SIM,1943,19,15-19,1962,2
SIM,1871,49,na,1920,23
STAT,1892,21,20-24,1913,0.8539205183443902
SIM,1887,70,na,1957,13
STAT,1825,49,50-100,1874,0.0022064066284357897
STAT,1888,39,20-24,1927,0.008917462160737414
SIM,1927,39,35-39,1966,1
STAT,1906,48,na,1954,32.28134246478038
STAT,1908,27,40-44,1935,0.04420544467062527
STAT,1923,15,15-19,1938,0.5316761473811497
STAT,1854,49,na,1903,13.464687326716207
STAT,1899,20,45-49,1919,0.009602825590404242
STAT,1859,15,40-44,1874,0.001707548323207692
STAT,1894,46,45-49,1940,0.0017109458901528225
STAT,1819,46,20-24,1865,1.0952265451922616E-4
STAT,1904,39,40-44,1943,0.013402343477044523
STAT,1928,22,15-19,1950,0.06613769333495773
SIM,1834,76,na,1910,7
STAT,1816,91,na,1907,0.17396968011835026
STAT,1892,66,na,1958,21.017506410626105
STAT,1927,21,45-49,1948,0.01383358249063777
STAT,1863,24,20-24,1887,0.6134049197100587
STAT,1886,37,20-24,1923,0.00799575582754746
STAT,1883,37,50-100,1920,0.011922382397793814
STAT,1864,39,35-39,1903,0.06280016934539588
STAT,1910,23,40-44,1933,0.031285866814571295
STAT,1919,39,35-39,1958,0.02570469640791154
SIM,1923,48,na,1971,37
STAT,1853,25,50-100,1878,0.00472499927533065
STAT,1855,93,na,1948,0.20576717583735182
STAT,1841,26,35-39,1867,0.11815376680614552
SIM,1852,57,na,1909,19
STAT,1858,30,25-29,1888,0.07957610413520898
STAT,1884,24,40-44,1908,0.020288349011405932
SIM,1832,80,na,1912,9
SIM,1938,25,na,1963,38
STAT,1869,41,40-44,1910,0.021892778265601882
STAT,1934,28,20-24,1962,0.24440229606139266
STAT,1848,49,50-100,1897,0.0015551322298965821
SIM,1905,20,20-24,1925,2
SIM,1917,26,na,1943,39
STAT,1834,72,na,1906,8.924821021880913
STAT,1836,31,35-39,1867,0.12482756142990024
STAT,1859,20,15-19,1879,0.03033000180952105
STAT,1870,20,30-34,1890,0.17800094267856947
STAT,1929,34,25-29,1963,0.11668998114375373
STAT,1880,40,45-49,1920,0.0158967678695549
STAT,1838,60,na,1898,14.802510961378333
SIM,1888,55,na,1943,29
STAT,1869,48,na,1917,21.525725499210676
STAT,1843,28,35-39,1871,0.050010170051970566
STAT,1912,36,20-24,1948,0.002565028686294647
SIM,1849,53,na,1902,7
STAT,1840,103,na,1943,0.0011245711186598588
STAT,1907,42,25-29,1949,6.514773759701314E-4
STAT,1842,44,30-34,1886,0.008698476847095335
STAT,1951,20,25-29,1971,1.0976478950875455
SIM,1861,71,na,1932,13
STAT,1870,23,35-39,1893,0.0577898685576754
STAT,1831,28,30-34,1859,0.27179982389985086
STAT,1911,32,35-39,1943,0.0884126639525971
STAT,1914,33,15-19,1947,0.001277393540895134
STAT,1873,24,15-19,1897,0.033330961833542325
SIM,1898,64,na,1962,20
STAT,1860,18,na,1878,21.395715265257817
STAT,1801,82,na,1883,1.6742934287305022
STAT,1828,32,40-44,1860,0.05936601215851556
STAT,1871,37,15-19,1908,5.598611811030343E-4
STAT,1849,22,30-34,1871,0.16698505517661374
STAT,1833,49,45-49,1882,0.001815369504415792
STAT,1881,21,45-49,1902,0.006655350262277266
STAT,1857,41,20-24,1898,0.001194266551948559
STAT,1863,38,na,1901,20.75630116731178
STAT,1946,26,15-19,1972,0.007811913681384821
STAT,1889,26,20-24,1915,0.14412478392470007
STAT,1958,5,na,1963,51.3471689635811
STAT,1923,48,40-44,1971,0.0018265124690318196
STAT,1929,9,na,1938,50.561310969806456
SIM,1876,49,na,1925,27
STAT,1927,42,40-44,1969,0.003120912149644896
STAT,1889,4,na,1893,32.20834400264984
SIM,1848,26,25-29,1874,1
SIM,1869,51,na,1920,15
STAT,1838,36,15-19,1874,5.313991629560783E-4
SIM,1817,38,na,1855,10
SIM,1922,47,na,1969,48
STAT,1860,93,na,1953,0.2375944746992943
STAT,1932,33,35-39,1965,0.12091476338499973
STAT,1861,22,50-100,1883,0.0035230903087377177
STAT,1813,44,15-19,1857,4.4161327662977E-4
STAT,1898,24,20-24,1922,0.9238104925564458
STAT,1936,35,45-49,1971,0.006663632574372421
SIM,1839,53,na,1892,20
STAT,1887,40,na,1927,25.481914046680217
STAT,1863,20,40-44,1883,0.019090842482762056
STAT,1920,30,35-39,1950,0.10004250891981233
STAT,1932,17,30-34,1949,0.16074458102606412
SIM,1886,79,na,1965,9
STAT,1859,21,na,1880,19.51601443390554
SIM,1826,74,na,1900,5
STAT,1856,88,na,1944,0.9945281099032109
STAT,1846,23,45-49,1869,0.006922845730573586
STAT,1854,40,40-44,1894,0.013887087582183965
STAT,1906,27,30-34,1933,0.36584662523724343
SIM,1914,28,na,1942,34
STAT,1905,35,15-19,1940,1.765889271879921E-4
STAT,1868,20,15-19,1888,0.03238959490108127
SIM,1903,40,na,1943,36
STAT,1850,16,50-100,1866,5.361955713237186E-4
STAT,1839,17,na,1856,16.570982422143416
SIM,1889,27,25-29,1916,1
STAT,1857,23,20-24,1880,0.5912828434169116
STAT,1846,41,45-49,1887,0.012434318621406914
STAT,1854,22,40-44,1876,0.014965491373340863
STAT,1950,15,25-29,1965,0.5094973529743422
STAT,1837,25,45-49,1862,0.007139707931347779
STAT,1847,36,na,1883,26.38487367046291
SIM,1912,19,20-24,1931,1
SIM,1899,18,na,1917,28
STAT,1843,22,na,1865,11.384456160946016
STAT,1851,41,na,1892,19.6004885911714
STAT,1916,21,30-34,1937,0.29949635358544624
STAT,1940,23,15-19,1963,0.05382424877913719
STAT,1906,64,na,1970,28.514395573545364
SIM,1864,20,na,1884,21
SIM,1953,15,na,1968,47
STAT,1839,72,na,1911,6.969363483264126
SIM,1793,82,na,1875,6
STAT,1880,35,15-19,1915,5.961030350020396E-4
STAT,1904,19,20-24,1923,0.25266816166953615
STAT,1914,15,15-19,1929,0.09353317624697545
STAT,1937,28,15-19,1965,0.006834860075026173
STAT,1850,46,40-44,1896,0.0015286324947667712
STAT,1899,16,35-39,1915,0.007529912259653953
STAT,1900,48,45-49,1948,0.0018228066549225179
STAT,1927,10,na,1937,49.162887385652816
STAT,1945,23,50-100,1968,0.0071574107400298095
STAT,1874,17,50-100,1891,4.970184001311872E-4
STAT,1887,24,45-49,1911,0.007563670755384764
STAT,1822,44,na,1866,9.56856533926138
SIM,1843,58,na,1901,18
STAT,1922,37,40-44,1959,0.016909043074836393
SIM,1893,17,na,1910,39
STAT,1901,17,na,1918,35.34002341868572
SIM,1940,24,20-24,1964,2
STAT,1914,42,30-34,1956,0.0012563035782402062
SIM,1924,21,30-34,1945,2
STAT,1866,0,na,1866,34.955463842825324
SIM,1858,20,na,1878,25
STAT,1922,19,40-44,1941,0.01598278673593045
STAT,1913,46,na,1959,35.64634715635198
STAT,1865,18,30-34,1883,0.014768282698738137
STAT,1915,49,45-49,1964,0.002158400129058123
SIM,1880,54,na,1934,30
STAT,1837,30,40-44,1867,0.027113426052654547
SIM,1856,0,na,1856,30
SIM,1789,77,na,1866,2
SIM,1884,68,na,1952,16
STAT,1872,29,30-34,1901,0.2558121958001624
STAT,1942,27,na,1969,39.03154416888203
STAT,1798,61,na,1859,16.910472172271348
STAT,1868,85,na,1953,2.652923072171357
STAT,1932,24,20-24,1956,1.448068216925323
SIM,1925,1,na,1926,45
STAT,1923,3,na,1926,47.29801407044256
STAT,1945,15,15-19,1960,0.4924587855567664
STAT,1924,25,25-29,1949,0.7665494307216563
SIM,1821,75,na,1896,2
STAT,1880,15,45-49,1895,6.900922636290088E-4
STAT,1866,48,45-49,1914,0.0021462061553822304
STAT,1839,28,30-34,1867,0.173811317041449
STAT,1889,19,30-34,1908,0.01940959796571985
STAT,1891,7,na,1898,31.97719856520059
STAT,1866,50,na,1916,20.11524666956823
STAT,1898,5,na,1903,35.35243625790361
STAT,1904,24,45-49,1928,0.009929305103238681
SIM,1900,9,na,1909,40
STAT,1863,15,45-49,1878,6.678112589135842E-4
SIM,1842,80,na,1922,8
SIM,1829,39,na,1868,20
STAT,1895,41,40-44,1936,0.002036976364218319
STAT,1841,27,na,1868,26.299641209546728
STAT,1865,25,20-24,1890,0.10682937368163085
SIM,1832,74,na,1906,16
SIM,1873,72,na,1945,5
STAT,1854,105,na,1959,3.9747946920149803E-4
STAT,1869,33,40-44,1902,0.041842916177691585
STAT,1922,41,25-29,1963,8.148054158968558E-4
STAT,1936,21,50-100,1957,0.006254780971173341
STAT,1878,41,40-44,1919,0.02332699226464984
STAT,1914,38,45-49,1952,0.0067166538920968
SIM,1799,83,na,1882,1
STAT,1816,44,na,1860,9.19216489167106
STAT,1869,18,15-19,1887,0.05795520524610237
SIM,1877,86,na,1963,4
STAT,1887,42,45-49,1929,0.016315831154047868
STAT,1872,19,na,1891,25.702668075367182
STAT,1874,18,25-29,1892,0.05733785341814041
STAT,1821,39,25-29,1860,0.04998646476600203
SIM,1936,15,15-19,1951,2
STAT,1788,95,na,1883,0.03114020332707425
SIM,1846,23,na,1869,14
STAT,1778,102,na,1880,9.580078899065322E-4
STAT,1848,25,20-24,1873,0.0918859244536219
SIM,1952,9,na,1961,35
SIM,1869,67,na,1936,11
STAT,1877,20,40-44,1897,0.021638690122346364
SIM,1873,25,na,1898,27
SIM,1896,69,na,1965,21
STAT,1919,43,45-49,1962,0.0017851063216896802
STAT,1928,15,15-19,1943,0.5716905350547252
STAT,1844,33,35-39,1877,0.09361564826560292
STAT,1881,55,na,1936,19.675192727508286
STAT,1830,36,15-19,1866,3.356558748530582E-4
STAT,1840,20,45-49,1860,0.007049643379342934
STAT,1940,28,45-49,1968,0.01748347301136915
SIM,1823,38,na,1861,11
STAT,1874,23,20-24,1897,0.6969510757480532
STAT,1905,9,na,1914,37.446817826240895
STAT,1891,47,40-44,1938,0.0011797523684017968
STAT,1858,15,35-39,1873,0.0049353578021188674
STAT,1881,30,50-100,1911,0.008788554760333306
STAT,1874,47,40-44,1921,0.0017287121950017917
SIM,1941,14,na,1955,48
STAT,1919,25,15-19,1944,0.00761292686172048
STAT,1846,54,50-100,1900,1.1903109271135927E-4
SIM,1907,7,na,1914,41
STAT,1875,15,35-39,1890,0.00566661883643044
SIM,1939,32,30-34,1971,1
STAT,1923,35,35-39,1958,0.02787980363046627
STAT,1913,43,25-29,1956,6.894573614108026E-4
STAT,1903,49,25-29,1952,4.522932064642013E-4
SIM,1867,72,na,1939,6
STAT,1913,22,45-49,1935,0.010811811675708799
STAT,1954,12,na,1966,48.283993876135376
SIM,1919,9,na,1928,47
STAT,1850,44,50-100,1894,0.009279309733598515
SIM,1884,4,na,1888,28
STAT,1890,32,na,1922,28.98658946911597
STAT,1923,40,30-34,1963,0.0014880235784061468
STAT,1839,35,20-24,1874,0.0051902322275753894
STAT,1786,76,na,1862,1.576708123359762
STAT,1859,32,40-44,1891,0.034468955127174
STAT,1870,24,na,1894,23.347045534471647
SIM,1905,51,na,1956,40
SIM,1837,58,na,1895,28
STAT,1920,49,25-29,1969,5.779718079195555E-4
SIM,1909,13,na,1922,41
STAT,1875,55,na,1930,21.254899637536184
STAT,1831,30,45-49,1861,0.018800361402120942
STAT,1923,28,45-49,1951,0.019628158296238207
STAT,1859,92,na,1951,0.33103657492930666
STAT,1794,95,na,1889,0.03043066699249105
STAT,1908,22,35-39,1930,0.08611400052766166
STAT,1930,22,45-49,1952,0.014346788266117912
SIM,1852,35,na,1887,27
STAT,1895,23,40-44,1918,0.026969562999391673
STAT,1866,19,na,1885,23.594459248151907
STAT,1850,63,na,1913,15.886818760402114
STAT,1864,26,15-19,1890,0.004083326878325273
STAT,1900,38,45-49,1938,0.005936973823255229
SIM,1917,32,na,1949,41
SIM,1857,66,na,1923,14
SIM,1889,71,na,1960,19
STAT,1807,71,na,1878,7.417700782305485
STAT,1870,23,50-100,1893,0.004038425948399266
STAT,1864,108,na,1972,3.183565407160573E-4
SIM,1853,52,na,1905,21
STAT,1882,48,30-34,1930,9.160204891770077E-4
STAT,1856,29,na,1885,17.65878664237499
STAT,1914,29,30-34,1943,0.3889261499841411
STAT,1910,27,20-24,1937,0.1751923665252175
STAT,1889,29,25-29,1918,0.5142081080132762
STAT,1853,23,35-39,1876,0.043021803237234306
STAT,1929,26,15-19,1955,0.008796916895577279
STAT,1904,32,45-49,1936,0.01434757399851046
STAT,1949,23,35-39,1972,0.10913367111093994
SIM,1888,29,30-34,1917,1
STAT,1931,27,40-44,1958,0.05990957270001815
SIM,1818,55,na,1873,24
STAT,1849,25,35-39,1874,0.08997589202369144
STAT,1883,31,20-24,1914,0.02635617203263733
STAT,1797,102,na,1899,6.280094627263905E-4
SIM,1902,1,na,1903,38
STAT,1885,23,50-100,1908,0.00401454727494656
STAT,1816,40,20-24,1856,0.002282362025402578
STAT,1828,35,45-49,1863,0.009003740039448404
STAT,1905,19,40-44,1924,0.00262557623179751
SIM,1853,80,na,1933,1
STAT,1907,31,30-34,1938,0.14724554980597077
STAT,1906,40,30-34,1946,0.0011715635829833413
STAT,1892,67,na,1959,20.616072038183148
STAT,1840,49,50-100,1889,0.0018916088777940993
STAT,1824,52,50-100,1876,1.8870632513669474E-4
STAT,1868,14,na,1882,25.612728264053473
STAT,1845,72,na,1917,7.382237460171793
STAT,1855,36,15-19,1891,3.9727024478611284E-4
STAT,1854,43,45-49,1897,0.009081905875011079
STAT,1881,19,30-34,1900,0.01508502600972283
STAT,1836,47,20-24,1883,1.2119793922539386E-4
STAT,1915,33,35-39,1948,0.09187765187460395
STAT,1833,56,na,1889,15.175763845963148
STAT,1873,84,na,1957,3.9537755199735183
STAT,1870,4,na,1874,29.373771477313642
STAT,1887,16,45-49,1903,7.147513377730772E-4
SIM,1881,7,na,1888,27
STAT,1833,46,40-44,1879,0.0015038597249857483
STAT,1878,23,40-44,1901,0.021447131161848803
STAT,1930,40,20-24,1970,2.3192066407656963E-4
STAT,1830,36,50-100,1866,0.0073386570635635955
STAT,1913,25,25-29,1938,0.6547655881462049
SIM,1893,5,na,1898,39
STAT,1824,79,na,1903,4.864458921759467
STAT,1860,28,50-100,1888,0.005218506662990464
SIM,1950,8,na,1958,61
STAT,1892,38,45-49,1930,0.02450553382455389
SIM,1817,42,na,1859,9
STAT,1842,44,40-44,1886,0.01701819121066456
SIM,1894,34,na,1928,29
SIM,1921,25,25-29,1946,1
STAT,1955,16,15-19,1971,0.5992413226863728
STAT,1910,53,na,1963,33.342537743866224
STAT,1868,69,na,1937,14.202082186596403
STAT,1864,55,na,1919,18.545796128014445
SIM,1892,9,na,1901,36
STAT,1825,47,45-49,1872,0.0021779997389865875
STAT,1877,48,20-24,1925,1.2231488398562894E-4
SIM,1856,28,25-29,1884,1
STAT,1854,18,na,1872,16.685024817473767
SIM,1834,38,na,1872,20
STAT,1902,42,35-39,1944,0.0017710789247400334
STAT,1874,15,20-24,1889,0.1813643897209715
SIM,1941,30,na,1971,43
STAT,1916,24,35-39,1940,0.0972102448887932
STAT,1933,21,30-34,1954,0.38083158019147917
STAT,1852,51,50-100,1903,1.2987505517673357E-4
STAT,1827,33,35-39,1860,0.08687204339515969
STAT,1830,29,25-29,1859,0.31694807803367386
SIM,1900,48,na,1948,35
SIM,1930,14,na,1944,51
SIM,1871,77,na,1948,10
SIM,1907,21,30-34,1928,1
STAT,1848,18,30-34,1866,0.012702473650647146
STAT,1815,90,na,1905,0.281436176488455
SIM,1830,24,na,1854,17
SIM,1882,49,na,1931,30
STAT,1894,24,35-39,1918,0.07431885934755843
STAT,1939,33,20-24,1972,0.024701104675313834
STAT,1827,91,na,1918,0.3511740025296751
STAT,1918,45,na,1963,38.92337371813229
SIM,1805,57,na,1862,14
STAT,1905,45,40-44,1950,0.0014076485594931862
STAT,1816,54,40-44,1870,1.2236977006717083E-4
STAT,1880,38,na,1918,24.65147005022977
STAT,1822,38,30-34,1860,0.03194469046433283
SIM,1835,23,na,1858,20
STAT,1925,15,50-100,1940,0.004518399410304086
STAT,1835,105,na,1940,1.318822825318862E-4
STAT,1841,47,30-34,1888,9.517881326574978E-4
STAT,1941,23,35-39,1964,0.09656848594867701
SIM,1875,20,na,1895,18
STAT,1870,39,20-24,1909,0.007580455254642448
STAT,1897,66,na,1963,23.7140778265743
STAT,1885,85,na,1970,5.818242807760784
STAT,1928,33,45-49,1961,0.01956752401956481
STAT,1845,41,na,1886,13.935209633989318
STAT,1883,45,40-44,1928,0.0016790657907523076
STAT,1854,25,45-49,1879,0.007931653380493495
STAT,1819,104,na,1923,3.423910265171685E-4
STAT,1911,48,20-24,1959,1.0365784674745876E-4
STAT,1832,23,15-19,1855,0.019985306389681528
SIM,1868,32,35-39,1900,2
STAT,1888,27,15-19,1915,0.005301958954074039
STAT,1893,52,na,1945,27.00501698077281
SIM,1864,52,na,1916,21
STAT,1821,36,20-24,1857,0.017178276321432144
STAT,1900,22,35-39,1922,0.08091955104490653
STAT,1835,48,50-100,1883,0.0011573259628849528
STAT,1875,23,na,1898,24.23620987666629
STAT,1896,37,15-19,1933,7.376103829142608E-4
STAT,1921,24,45-49,1945,0.012530593013832117
STAT,1875,28,50-100,1903,0.0065525214508735255
STAT,1844,21,40-44,1865,0.020469275108484883
SIM,1860,4,na,1864,30
STAT,1904,53,na,1957,30.73311793637831
STAT,1922,17,15-19,1939,0.5213803831433971
STAT,1914,25,15-19,1939,0.007105611204031163
SIM,1851,41,na,1892,17
STAT,1886,22,35-39,1908,0.06052946891897142
STAT,1911,38,20-24,1949,0.002517165597707415
STAT,1892,45,35-39,1937,9.85348446483021E-4
SIM,1842,64,na,1906,18
STAT,1906,34,20-24,1940,0.022356046072466572
SIM,1928,32,na,1960,52
STAT,1937,18,20-24,1955,1.3071680785516513
SIM,1945,18,20-24,1963,1
STAT,1931,35,40-44,1966,0.01977202675047827
STAT,1905,27,40-44,1932,0.043233217018088486
STAT,1870,24,50-100,1894,0.004025583753883358
STAT,1804,59,na,1863,11.714341775698655
STAT,1874,38,na,1912,23.78263607342801
SIM,1832,24,20-24,1856,3
STAT,1878,31,40-44,1909,0.044955993247448395
SIM,1894,22,35-39,1916,2
STAT,1829,39,30-34,1868,0.04783205518698597
STAT,1955,8,na,1963,51.87868057757756
SIM,1852,67,na,1919,19
STAT,1848,28,25-29,1876,0.3242378823391014
STAT,1857,42,na,1899,17.280824840528023
SIM,1833,60,na,1893,9
STAT,1797,76,na,1873,3.307671064529697
STAT,1876,49,na,1925,22.373313056183942
STAT,1913,29,40-44,1942,0.04572544108064579
STAT,1924,22,20-24,1946,1.3035481171828043
STAT,1913,47,40-44,1960,0.0015259879624791694
SIM,1916,47,na,1963,44
SIM,1863,35,na,1898,12
STAT,1927,26,na,1953,45.46534697241348
STAT,1879,85,na,1964,5.082806688145297
STAT,1898,42,20-24,1940,1.4858873679958674E-4
SIM,1912,33,na,1945,38
STAT,1869,36,45-49,1905,0.019408685616188855
SIM,1861,87,na,1948,2
STAT,1904,21,40-44,1925,0.02994884876141467
STAT,1909,43,35-39,1952,0.0018616497011010745
STAT,1785,82,na,1867,4.646656846200892
STAT,1925,38,20-24,1963,0.0031409200430569206
STAT,1888,35,15-19,1923,6.624533153943414E-4
STAT,1912,31,40-44,1943,0.03836178110189039
STAT,1945,22,50-100,1967,0.007159773465273351
STAT,1868,34,35-39,1902,0.09716513275618432
STAT,1923,32,30-34,1955,0.17936626079591278
SIM,1932,22,20-24,1954,1
STAT,1905,37,40-44,1942,0.013636401341621796
SIM,1934,32,na,1966,50
STAT,1949,21,50-100,1970,0.007631428915816882
STAT,1840,25,15-19,1865,0.004497129073273848
STAT,1886,23,na,1909,24.456049038175863
STAT,1919,40,40-44,1959,0.0026945110273758023
STAT,1868,15,45-49,1883,6.512503137253283E-4
STAT,1851,44,35-39,1895,0.015081097816469569
STAT,1931,17,40-44,1948,0.018226705685427568
STAT,1837,49,30-34,1886,4.767383760127818E-4
SIM,1904,66,na,1970,24
STAT,1810,59,na,1869,8.496003067814476
STAT,1923,25,40-44,1948,0.053503776733836696
STAT,1834,73,na,1907,8.393794171078996
STAT,1866,26,50-100,1892,0.005911666795565412
SIM,1901,17,na,1918,40
STAT,1876,40,na,1916,23.710869648513036
STAT,1936,17,15-19,1953,0.43187040168139723
STAT,1847,34,15-19,1881,0.0015919830446026522
STAT,1885,22,40-44,1907,0.020577920857932207
STAT,1851,37,45-49,1888,0.01700985677880047
STAT,1923,43,35-39,1966,0.0023335682836399616
STAT,1860,42,35-39,1902,0.014703297359054754
STAT,1867,20,25-29,1887,0.5580596737606399
STAT,1922,35,15-19,1957,2.1728477395253806E-4
STAT,1903,28,20-24,1931,0.16620283473588734
STAT,1934,5,na,1939,54.154566798913436
STAT,1895,26,45-49,1921,0.014464035370315041
STAT,1928,36,25-29,1964,0.0123938287617547
STAT,1939,11,na,1950,39.362352929935035
SIM,1882,33,na,1915,27
STAT,1897,70,na,1967,21.69889040567762
STAT,1905,35,50-100,1940,0.003860875601902097
STAT,1899,34,50-100,1933,0.012435407089574135
SIM,1889,12,na,1901,34
SIM,1914,34,20-24,1948,1
SIM,1871,61,na,1932,19
STAT,1920,22,35-39,1942,0.10378790706846026
SIM,1888,34,na,1922,38
STAT,1842,30,20-24,1872,0.025013431435602675
STAT,1895,44,45-49,1939,0.0013310609426600082
STAT,1908,6,na,1914,38.550476597127656
SIM,1865,37,na,1902,24
SIM,1930,17,15-19,1947,2
STAT,1840,73,na,1913,9.307125689497733
STAT,1840,18,30-34,1858,0.01607515605023057
STAT,1911,11,na,1922,39.323943904079314
SIM,1897,29,25-29,1926,1
STAT,1866,16,25-29,1882,0.05388569385317487
STAT,1915,25,na,1940,38.136936269886604
SIM,1931,6,na,1937,63
STAT,1901,19,20-24,1920,0.24673949482564425
STAT,1811,45,na,1856,17.505427509304337
STAT,1833,40,20-24,1873,0.0014616973303055298
SIM,1875,36,na,1911,17
STAT,1894,20,40-44,1914,0.02686526779586704
STAT,1909,25,35-39,1934,0.14486577575339502
STAT,1924,31,30-34,1955,0.1827221931766472
STAT,1813,42,45-49,1855,0.05105839424656232
STAT,1865,48,30-34,1913,8.645425108943844E-4
STAT,1942,22,35-39,1964,0.09800604349457921
STAT,1828,46,50-100,1874,0.0010655764374390153
STAT,1859,22,40-44,1881,0.017184118471382664
STAT,1814,89,na,1903,0.46814144634916904
STAT,1822,45,50-100,1867,0.001384727874708301
SIM,1904,25,25-29,1929,1
STAT,1886,54,na,1940,21.720505809198123
STAT,1882,40,na,1922,22.37312018198148
STAT,1865,33,20-24,1898,0.02434565016300294
SIM,1884,13,na,1897,26
STAT,1795,81,na,1876,2.541659428322485
STAT,1928,30,40-44,1958,0.04874779153330763
SIM,1853,21,na,1874,27
STAT,1931,29,30-34,1960,0.5031251951753025
STAT,1878,52,45-49,1930,1.4903109476024684E-4
STAT,1869,26,15-19,1895,0.004411198042168547
STAT,1910,41,35-39,1951,0.001902354039108667
STAT,1935,33,35-39,1968,0.1257901958790656
STAT,1825,44,40-44,1869,0.02107763578618192
STAT,1821,37,50-100,1858,0.025096084713687124
SIM,1836,40,na,1876,8
STAT,1848,36,25-29,1884,0.019388311440257777
SIM,1857,35,na,1892,23
STAT,1922,33,25-29,1955,0.10322810920268075
STAT,1910,22,na,1932,35.61840229525659
STAT,1892,35,40-44,1927,0.054593608728666546
SIM,1839,85,na,1924,3
STAT,1856,35,20-24,1891,0.005637321049770816
SIM,1852,63,na,1915,19
SIM,1784,78,na,1862,1
STAT,1841,17,30-34,1858,0.020121232612289527
STAT,1916,41,50-100,1957,0.0011953357940830817
STAT,1842,37,na,1879,18.85075503904387
STAT,1829,55,na,1884,14.546366981113321
STAT,1905,48,45-49,1953,0.0018971544796738495
STAT,1851,41,30-34,1892,0.009749771297501734
STAT,1895,38,15-19,1933,7.254135494492516E-4
STAT,1826,101,na,1927,0.0039876140370840776
STAT,1852,48,20-24,1900,1.0141133766543218E-4
STAT,1836,23,35-39,1859,0.0737912828615823
SIM,1869,20,na,1889,15
STAT,1861,48,50-100,1909,0.0020394350994747297
STAT,1855,62,na,1917,12.868503287527608
STAT,1915,35,25-29,1950,0.009954294894298117
SIM,1948,22,30-34,1970,3
STAT,1918,20,50-100,1938,0.007074387501153246
STAT,1845,35,45-49,1880,0.013736841476478098
STAT,1845,21,35-39,1866,0.042653141434858426
STAT,1893,36,50-100,1929,0.01555483820837809
SIM,1840,78,na,1918,2
STAT,1853,76,na,1929,5.954253991502606
STAT,1915,19,50-100,1934,7.731939150708196E-4
STAT,1831,23,50-100,1854,0.01333145885629894
STAT,1857,15,20-24,1872,0.15784237174454702
STAT,1909,24,45-49,1933,0.0103337050250042
SIM,1886,1,na,1887,33
SIM,1870,92,na,1962,1
SIM,1910,29,50-100,1939,1
STAT,1900,27,40-44,1927,0.04153894505619228
STAT,1859,40,40-44,1899,0.018058015919941287
STAT,1940,27,30-34,1967,0.3967191349739485
SIM,1796,63,na,1859,10
STAT,1891,17,na,1908,30.998375307731347
STAT,1916,48,20-24,1964,1.1206785504984506E-4
STAT,1924,46,na,1970,43.56063146447385
STAT,1871,25,45-49,1896,0.01114482674365806
STAT,1884,75,na,1959,11.366978717248035
STAT,1924,36,40-44,1960,0.01755333419823099
STAT,1854,22,na,1876,15.355598958502549
STAT,1844,23,50-100,1867,0.0039484135080419145
STAT,1814,40,50-100,1854,0.0362828648254805
STAT,1943,16,45-49,1959,0.005260141077820557
STAT,1869,54,45-49,1923,1.367499189666744E-4
STAT,1885,20,15-19,1905,0.032772731813837594
STAT,1914,19,30-34,1933,0.02487036479340214
SIM,1885,53,na,1938,20
STAT,1912,34,45-49,1946,0.015231212629662831
STAT,1820,96,na,1916,0.048679893887884164
STAT,1844,47,50-100,1891,0.0019094259144880478
SIM,1928,24,20-24,1952,2
STAT,1943,12,na,1955,41.35160959252864
SIM,1892,39,na,1931,36
STAT,1878,68,na,1946,15.777379712528967
STAT,1887,12,na,1899,28.188286965109953
STAT,1820,48,20-24,1868,1.001298620193395E-4
STAT,1902,35,15-19,1937,1.7254449276251144E-4
STAT,1825,39,45-49,1864,0.01999314818059731
STAT,1909,18,45-49,1927,9.715692247639856E-4
SIM,1913,18,na,1931,44
STAT,1907,39,45-49,1946,0.0062305324687273985
SIM,1874,14,na,1888,28
STAT,1888,41,50-100,1929,0.01240153723070473
STAT,1891,38,30-34,1929,0.06508885825632418
STAT,1874,41,20-24,1915,0.0016184346106513988
STAT,1799,95,na,1894,0.04911868109262195
STAT,1924,45,na,1969,43.657113685719295
STAT,1880,33,45-49,1913,0.01825983317677929
STAT,1858,102,na,1960,0.005254037098547234
STAT,1877,24,35-39,1901,0.05986029173010738
STAT,1857,27,50-100,1884,0.0049325268782479436
STAT,1874,69,na,1943,14.888101560805719
STAT,1895,16,na,1911,32.869343605531775
STAT,1870,55,na,1925,20.540430485926247
STAT,1845,88,na,1933,0.802489628284869
STAT,1791,82,na,1873,1.5642884514893263
SIM,1903,28,na,1931,36
SIM,1824,55,na,1879,16
STAT,1922,15,25-29,1937,0.5001639209723879
STAT,1846,15,45-49,1861,6.729269312204533E-4
STAT,1902,29,15-19,1931,0.006352324562725433
STAT,1841,24,20-24,1865,0.8422633625378443
STAT,1861,21,40-44,1882,0.01813318644655013
STAT,1808,89,na,1897,0.1534021713925345
STAT,1941,25,25-29,1966,0.6765406018413216
STAT,1856,28,30-34,1884,0.18767791272104492
STAT,1888,34,na,1922,27.647631909608982
STAT,1885,17,na,1902,24.940734541936475
STAT,1897,40,50-100,1937,9.840473159266202E-4
STAT,1889,37,25-29,1926,0.03525092377627351
STAT,1941,20,30-34,1961,0.2950675684706553
STAT,1832,49,30-34,1881,4.56518175351476E-4
SIM,1928,18,20-24,1946,2
STAT,1830,39,50-100,1869,0.006887672265409851
STAT,1911,40,35-39,1951,0.0019311863461708406
STAT,1836,39,20-24,1875,0.008943704020586437
STAT,1916,16,50-100,1932,7.900285083683848E-4
STAT,1790,102,na,1892,3.812461713412871E-4
STAT,1811,47,20-24,1858,4.752141131659428E-4
STAT,1896,53,na,1949,27.829287366863532
STAT,1902,0,na,1902,41.40782528586834
STAT,1814,96,na,1910,0.03826402205605479
STAT,1843,42,35-39,1885,0.007908824173048135
STAT,1877,35,50-100,1912,0.012793872294690338
STAT,1886,33,40-44,1919,0.044793469787114897
STAT,1916,10,na,1926,41.668490494719244
STAT,1800,60,na,1860,8.879596610284143
SIM,1865,15,20-24,1880,2
SIM,1891,54,na,1945,31
STAT,1851,29,45-49,1880,0.010818055508110108
STAT,1887,3,na,1890,28.85555253236396
STAT,1946,18,15-19,1964,0.49965512060616296
STAT,1801,53,35-39,1854,2.41649944708508E-4
STAT,1908,28,na,1936,35.10552584730308
STAT,1934,16,50-100,1950,0.005058517547273601
STAT,1872,31,50-100,1903,0.009413062660158287
STAT,1850,37,30-34,1887,0.048204129684847566
STAT,1826,81,na,1907,3.778953695640123
STAT,1905,39,30-34,1944,0.01643512533770978
STAT,1917,26,45-49,1943,0.018014699450769698
STAT,1932,38,40-44,1970,0.020011898182358098
STAT,1886,34,50-100,1920,0.009422537806707635
STAT,1831,24,15-19,1855,0.0455207401743385
STAT,1906,23,15-19,1929,0.04778064343918691
SIM,1923,32,na,1955,38
STAT,1872,31,45-49,1903,0.017915183883149235
STAT,1877,22,30-34,1899,0.18386926214918559
STAT,1878,34,45-49,1912,0.017849387397078663
STAT,1819,42,40-44,1861,0.02132188904169133
STAT,1900,48,50-100,1948,0.001896954719125966
STAT,1935,15,35-39,1950,0.05737488635537359
SIM,1904,18,35-39,1922,1
STAT,1907,42,50-100,1949,0.00107178535372986
STAT,1836,36,na,1872,25.636397354648512
STAT,1950,21,30-34,1971,0.33896331286270104
STAT,1851,34,40-44,1885,0.03732321474215155
STAT,1904,17,30-34,1921,0.022838406796917104
STAT,1916,32,35-39,1948,0.09354060982426814
STAT,1897,36,20-24,1933,0.010285798374558312
STAT,1833,25,25-29,1858,0.4187638154529746
STAT,1912,16,15-19,1928,0.09127598082280657
STAT,1873,91,na,1964,1.4684460187213764
STAT,1853,22,45-49,1875,0.005178149718972827
STAT,1884,43,35-39,1927,0.017613322790997678
STAT,1870,47,50-100,1917,0.0024283880575114705
STAT,1893,8,na,1901,32.77708994336448
STAT,1835,21,50-100,1856,0.0035995102167191598
STAT,1876,48,50-100,1924,0.0024630834117644303
STAT,1915,30,30-34,1945,0.16035297526433928
STAT,1936,30,na,1966,36.554739859738
STAT,1932,35,25-29,1967,0.013198475581713987
STAT,1815,42,50-100,1857,0.016333583284166953
STAT,1806,82,na,1888,2.3766011781286025
SIM,1919,27,na,1946,44
STAT,1852,9,na,1861,25.218754716763307
STAT,1847,38,30-34,1885,0.05845983131168744
STAT,1880,27,15-19,1907,0.0047709230983294295
STAT,1871,34,50-100,1905,0.009056761451976194
STAT,1822,40,45-49,1862,0.0088156598525332
STAT,1857,73,na,1930,8.891611852416894
STAT,1869,54,na,1923,20.289216292264133
SIM,1915,13,na,1928,40
STAT,1823,42,50-100,1865,0.007488384122758122
SIM,1931,31,na,1962,55
STAT,1915,38,40-44,1953,0.014917669565298297
SIM,1869,36,na,1905,17
STAT,1867,24,40-44,1891,0.019816393225118478
SIM,1918,42,na,1960,34
STAT,1868,1,na,1869,34.37078261650418
STAT,1898,16,20-24,1914,0.23974541827066745
SIM,1964,2,na,1966,52
STAT,1865,61,na,1926,16.901572226853034
STAT,1817,52,35-39,1869,2.3934648823462353E-4
STAT,1897,29,30-34,1926,0.3320143458036138
STAT,1825,102,na,1927,0.0015805162782814067
STAT,1931,38,45-49,1969,0.008979405511750197
STAT,1906,48,40-44,1954,0.0013853708672106517
STAT,1874,39,50-100,1913,0.012329987344263655
STAT,1936,31,na,1967,36.5346347528151
STAT,1796,59,na,1855,1.96078
SIM,1947,4,na,1951,43
STAT,1936,32,40-44,1968,0.03778082187930652
SIM,1952,0,na,1952,37
SIM,1848,58,na,1906,27
SIM,1863,1,na,1864,33
STAT,1812,49,25-29,1861,6.299261681678225E-4
STAT,1901,37,20-24,1938,0.0023281171825427194
SIM,1841,25,25-29,1866,2
STAT,1887,36,15-19,1923,6.158814599672655E-4
STAT,1900,21,20-24,1921,0.9584821719604391
STAT,1835,58,na,1893,8.895092119541657
STAT,1837,22,na,1859,13.456974931252402
STAT,1868,30,40-44,1898,0.04230571794949562
STAT,1914,45,35-39,1959,0.0012740421416249246
STAT,1930,23,50-100,1953,0.00836401007914629
SIM,1913,43,na,1956,40
STAT,1827,32,45-49,1859,0.015372017983261358
STAT,1856,24,15-19,1880,0.027359564898651455
STAT,1877,50,na,1927,22.5457130214134
STAT,1945,19,30-34,1964,0.1321032651437752
SIM,1890,25,20-24,1915,1
SIM,1862,25,na,1887,23
STAT,1908,16,50-100,1924,7.2474728336081E-4
STAT,1863,23,45-49,1886,0.0062518978216137165
STAT,1919,22,50-100,1941,0.007142682464402682
STAT,1830,42,45-49,1872,0.008166643423675094
STAT,1870,3,na,1873,31.136073221659572
STAT,1850,49,45-49,1899,0.0020573884382341923
STAT,1937,26,25-29,1963,0.6378482386911195
STAT,1833,43,25-29,1876,0.005687486540368118
SIM,1899,49,na,1948,28
STAT,1859,25,45-49,1884,0.009107517246266204
STAT,1796,66,na,1862,1.5369777946452219
SIM,1832,59,na,1891,18
SIM,1855,38,30-34,1893,1
SIM,1864,9,na,1873,23
STAT,1845,32,40-44,1877,0.0301415290796003
STAT,1960,12,na,1972,50.86506307862839
STAT,1901,21,35-39,1922,0.0819005838453952
STAT,1924,39,45-49,1963,0.007969399570413236
SIM,1884,72,na,1956,13
STAT,1882,49,45-49,1931,0.0022144689319176154
STAT,1862,29,20-24,1891,0.10049141121859792
STAT,1874,26,25-29,1900,0.4306169903078719
SIM,1890,68,na,1958,18
STAT,1836,20,30-34,1856,0.2301635293441574
STAT,1846,20,40-44,1866,0.021139654093183642
SIM,1887,17,na,1904,26
STAT,1861,105,na,1966,0.0016664656201958257
STAT,1882,25,20-24,1907,0.11319037977332684
STAT,1886,18,15-19,1904,0.061395816383896254
SIM,1881,39,na,1920,24
STAT,1885,45,50-100,1930,0.0024495159287547807
STAT,1846,35,15-19,1881,4.8521706344874916E-4
SIM,1892,32,na,1924,36
STAT,1894,23,45-49,1917,0.008909201948183504
STAT,1909,49,20-24,1958,1.003863336276366E-4
STAT,1878,16,15-19,1894,0.06141982244310082
STAT,1880,30,40-44,1910,0.0459694389598799
STAT,1932,30,30-34,1962,0.2088301195751445
STAT,1825,37,na,1862,15.444127422286707
STAT,1839,88,na,1927,0.7576079665874924
STAT,1813,46,50-100,1859,0.007726549751290839
STAT,1808,56,na,1864,4.218004149149837
STAT,1903,47,na,1950,31.843528419026594
SIM,1844,44,na,1888,4
STAT,1887,21,40-44,1908,0.022813603689171312
STAT,1871,22,40-44,1893,0.020775581546004687
SIM,1849,43,na,1892,7
STAT,1835,31,40-44,1866,0.025397819356278398
STAT,1915,32,20-24,1947,0.02462738678729321
STAT,1864,76,na,1940,8.497480172813528
STAT,1860,62,na,1922,14.858955352446722
SIM,1796,59,na,1855,12
SIM,1849,47,na,1896,7
STAT,1859,30,15-19,1889,0.0011483684668377673
STAT,1837,33,45-49,1870,0.010556574255889342
STAT,1830,24,45-49,1854,0.010029373842836581
SIM,1931,27,30-34,1958,1
STAT,1869,9,na,1878,26.30046290599676
SIM,1879,13,na,1892,16
STAT,1858,17,25-29,1875,0.05037067063380641
SIM,1814,93,na,1907,2
SIM,1905,47,na,1952,40
STAT,1846,51,na,1897,17.533367277843716
STAT,1923,27,30-34,1950,0.446743142392518
SIM,1882,26,25-29,1908,2
STAT,1907,36,40-44,1943,0.013887262599372369
STAT,1902,15,45-49,1917,9.254491300749164E-4
STAT,1923,23,15-19,1946,0.06131845044211642
STAT,1918,15,35-39,1933,0.009122506873266182
SIM,1893,24,na,1917,39
SIM,1927,28,30-34,1955,3
SIM,1897,38,na,1935,40
SIM,1870,21,na,1891,24
SIM,1919,0,na,1919,48
STAT,1909,21,40-44,1930,0.031168603011098594
STAT,1818,55,na,1873,6.11512554074284
SIM,1874,10,na,1884,29
STAT,1887,49,na,1936,24.04892137298578
STAT,1890,48,40-44,1938,0.0011583119987885488
STAT,1926,16,na,1942,44.980160522856956
STAT,1857,69,na,1926,10.986147725132401
STAT,1929,28,40-44,1957,0.05802750252286849
STAT,1841,42,50-100,1883,0.010745289681112208
STAT,1839,46,25-29,1885,3.2804355243861745E-4
SIM,1822,60,na,1882,12
STAT,1847,43,na,1890,24.511166833823708
STAT,1919,28,30-34,1947,0.41821641744566623
STAT,1857,18,25-29,1875,0.04956630740180523
STAT,1848,33,20-24,1881,0.018359242639850334
STAT,1778,96,na,1874,0.017368996532173678
STAT,1859,18,50-100,1877,4.493445275343103E-4
STAT,1918,33,35-39,1951,0.09582286104105937
STAT,1841,42,20-24,1883,0.0016153050155343672
STAT,1947,3,na,1950,44.714615525543934
STAT,1869,51,40-44,1920,1.0249481806904379E-4
SIM,1876,76,na,1952,17
SIM,1872,87,na,1959,3
STAT,1774,82,na,1856,0.6549664900000001
STAT,1904,46,50-100,1950,0.0019907464182901367
STAT,1883,48,45-49,1931,0.002262956307602625
STAT,1849,16,25-29,1865,0.05440626371275521
STAT,1905,17,15-19,1922,0.08564989099362398
STAT,1882,18,30-34,1900,0.01523472884458999
STAT,1892,42,30-34,1934,0.014185602905760736
STAT,1870,17,na,1887,25.328081685875407
STAT,1931,25,15-19,1956,0.009081691868877357
STAT,1890,31,50-100,1921,0.011175144111175725
STAT,1879,37,15-19,1916,5.812053295697118E-4
STAT,1941,22,20-24,1963,1.140775381169145
SIM,1843,22,na,1865,21
STAT,1917,23,40-44,1940,0.03530138878799323
STAT,1866,87,na,1953,1.6225925181062473
STAT,1925,4,na,1929,48.45190197371386
STAT,1886,36,45-49,1922,0.02077728925642795
STAT,1879,29,50-100,1908,0.0065735595186346505
STAT,1921,21,40-44,1942,0.037794873977605135
STAT,1937,24,20-24,1961,1.0752531088592894
STAT,1900,45,40-44,1945,0.0013524840436174644
STAT,1889,34,20-24,1923,0.032811064012188376
SIM,1864,21,na,1885,23
STAT,1900,24,25-29,1924,0.7888451682390978
SIM,1911,47,na,1958,40
STAT,1846,39,30-34,1885,0.044177938905120964
STAT,1824,47,30-34,1871,0.0012525873125033902
STAT,1848,21,na,1869,16.957870921649118
STAT,1931,31,na,1962,49.36644193990506
SIM,1858,51,na,1909,24
STAT,1833,42,25-29,1875,0.005760821801906387
STAT,1868,33,45-49,1901,0.016804541662034794
STAT,1884,68,na,1952,14.972545249098728
STAT,1888,28,50-100,1916,0.007449119144657275
STAT,1872,25,15-19,1897,0.0046736430674038385
STAT,1927,27,15-19,1954,0.008538532580120342
STAT,1945,26,20-24,1971,0.19891535595972548
STAT,1863,69,na,1932,12.993594101659488
STAT,1860,25,na,1885,19.894323467985984
SIM,1818,82,na,1900,1
SIM,1945,19,35-39,1964,1
SIM,1867,65,na,1932,7
STAT,1817,70,na,1887,12.509439302493464
STAT,1836,21,30-34,1857,0.22851095520346643
STAT,1884,40,30-34,1924,0.011377553707255732
STAT,1945,18,30-34,1963,0.1321495174748914
STAT,1784,96,na,1880,0.022129622882537555
STAT,1898,19,25-29,1917,0.07603426110839091
STAT,1923,34,20-24,1957,0.027733112142009783
STAT,1866,45,40-44,1911,0.0015924396433539666
STAT,1780,82,na,1862,2.9670566218480636
STAT,1800,97,na,1897,0.019468038188359366
STAT,1937,19,35-39,1956,0.04044350999411282
STAT,1889,15,50-100,1904,6.026099674930544E-4
SIM,1844,21,30-34,1865,2
SIM,1918,31,35-39,1949,1
STAT,1914,35,40-44,1949,0.014963411006521219
STAT,1938,16,15-19,1954,0.44582112381993566
STAT,1856,40,50-100,1896,0.007730514238446228
STAT,1913,35,50-100,1948,0.0041477465957547805
STAT,1854,37,15-19,1891,3.4323634735275183E-4
STAT,1920,28,20-24,1948,0.19783820207727673
STAT,1914,17,40-44,1931,0.0028693642135983848
STAT,1868,40,35-39,1908,0.017700889448419067
STAT,1940,25,40-44,1965,0.04723361274227454
STAT,1783,96,na,1879,0.008109921128495724
SIM,1843,59,na,1902,18
STAT,1842,92,na,1934,0.31248678446918715
SIM,1908,28,na,1936,41
STAT,1843,77,na,1920,3.666695982493007
STAT,1874,43,25-29,1917,0.00646756771492561
STAT,1882,43,20-24,1925,0.0015109804065762185
STAT,1812,46,20-24,1858,1.3658363301027548E-4
STAT,1925,31,na,1956,44.65655501265926
STAT,1890,16,15-19,1906,0.07226420748295498
STAT,1940,32,30-34,1972,0.16190179354178383
STAT,1833,22,20-24,1855,0.685840455819774
SIM,1841,22,20-24,1863,2
SIM,1926,13,na,1939,49
SIM,1948,5,na,1953,43
STAT,1903,22,35-39,1925,0.08296495624253904
SIM,1857,73,na,1930,10
STAT,1919,29,30-34,1948,0.416694109686164
SIM,1896,53,na,1949,23
SIM,1882,43,25-29,1925,1
STAT,1865,65,na,1930,15.285497040555807
STAT,1826,74,na,1900,7.7553899929540115
STAT,1876,32,40-44,1908,0.04404567685976458
STAT,1897,25,15-19,1922,0.006065842719851654
STAT,1831,37,na,1868,21.86006317841662
SIM,1864,2,na,1866,26
STAT,1819,45,45-49,1864,0.0021838229457823402
SIM,1879,50,na,1929,14
STAT,1825,96,na,1921,0.046290961055078225
STAT,1953,17,15-19,1970,0.5458239910651306
STAT,1920,46,20-24,1966,1.2142186343077425E-4
STAT,1919,36,20-24,1955,0.002809983838197941
STAT,1842,47,45-49,1889,0.0017709541839043565
STAT,1895,31,na,1926,31.10701361082634
STAT,1927,45,45-49,1972,0.0027269961210664275
STAT,1900,31,50-100,1931,0.012757334403023528
SIM,1878,72,na,1950,12
STAT,1845,17,15-19,1862,0.043845570821440756
STAT,1938,34,15-19,1972,0.0012819452836823888
STAT,1878,35,na,1913,24.554525266424783
STAT,1906,17,na,1923,36.692405613124556
STAT,1832,43,50-100,1875,0.0057366525090495665
STAT,1906,43,35-39,1949,0.0018136699758317892
SIM,1920,4,na,1924,51
SIM,1918,17,na,1935,37
STAT,1930,15,20-24,1945,1.7526852660926702
SIM,1832,81,na,1913,8
SIM,1851,88,na,1939,2
STAT,1812,45,45-49,1857,0.002722157765539651
STAT,1934,31,40-44,1965,0.053234703489197795
SIM,1877,93,na,1970,3
STAT,1877,21,30-34,1898,0.18442437953157564
STAT,1858,52,na,1910,16.297192472389035
SIM,1839,54,na,1893,20
STAT,1882,46,40-44,1928,0.0016453427583592772
STAT,1911,48,na,1959,34.45959881806053
STAT,1950,18,40-44,1968,0.016430897813747125
STAT,1952,17,50-100,1969,0.004463214115591204
STAT,1881,88,na,1969,3.438036159441917
SIM,1885,22,30-34,1907,1
STAT,1880,17,20-24,1897,0.18642492063667856
STAT,1867,23,50-100,1890,0.003890334996568201
STAT,1824,42,na,1866,19.148243013597867
STAT,1826,41,40-44,1867,0.024245399921357352
SIM,1912,26,na,1938,37
SIM,1938,31,na,1969,39
SIM,1879,19,na,1898,16
STAT,1882,28,25-29,1910,0.4039660523137348
STAT,1896,28,50-100,1924,0.008373012679312359
STAT,1900,41,25-29,1941,6.211568920672271E-4
STAT,1918,30,30-34,1948,0.1672385019944378
STAT,1829,42,20-24,1871,0.0014059268319100227
SIM,1928,26,25-29,1954,1
STAT,1873,39,25-29,1912,0.0289779697365863
SIM,1904,7,na,1911,33
STAT,1893,25,35-39,1918,0.12248654334255218
STAT,1844,32,45-49,1876,0.01628833162692869
STAT,1858,38,45-49,1896,0.015094091264241107
STAT,1883,53,na,1936,20.573859541074846
STAT,1871,20,50-100,1891,0.004089929944767447
STAT,1846,67,na,1913,12.847050930499785
SIM,1854,21,na,1875,19
STAT,1920,44,45-49,1964,0.0018164053948606432
STAT,1923,45,25-29,1968,6.191410823351712E-4
STAT,1885,54,na,1939,20.678702162021303
SIM,1823,45,na,1868,11
SIM,1949,19,na,1968,38
STAT,1826,34,35-39,1860,0.12628217481841103
STAT,1854,86,na,1940,1.3561849381750644
SIM,1928,11,na,1939,55
STAT,1861,45,40-44,1906,0.0014540691995557351
STAT,1896,16,na,1912,33.2562234141923
STAT,1935,37,15-19,1972,2.6733339598551827E-4
SIM,1831,64,na,1895,4
STAT,1842,19,40-44,1861,0.001741494407274682
STAT,1835,32,35-39,1867,0.058653731911863335
SIM,1851,31,30-34,1882,1
STAT,1914,47,25-29,1961,5.217218141985052E-4
STAT,1855,32,20-24,1887,0.01937791264484181
SIM,1804,62,na,1866,11
STAT,1867,27,45-49,1894,0.010625163005925716
STAT,1871,49,30-34,1920,9.449458706706769E-4
SIM,1827,69,na,1896,5
SIM,1843,32,35-39,1875,1
STAT,1873,69,na,1942,14.9204053356133
STAT,1920,20,45-49,1940,0.012476328857587175
STAT,1808,93,na,1901,0.04267575968941272
STAT,1857,43,25-29,1900,0.0047725127376565535
STAT,1867,35,35-39,1902,0.06832788239543461
SIM,1890,75,na,1965,13
STAT,1922,37,50-100,1959,0.004742419631533867
STAT,1851,26,40-44,1877,0.029824603649571072
STAT,1855,34,na,1889,16.75557644529919
STAT,1884,25,40-44,1909,0.029548209604929203
STAT,1911,19,15-19,1930,0.08974704791800749
SIM,1842,36,na,1878,24
STAT,1902,29,50-100,1931,0.008956382907341826
STAT,1852,31,40-44,1883,0.03883000035279712
STAT,1899,39,45-49,1938,0.005830918703467441
SIM,1835,30,na,1865,17
STAT,1912,24,15-19,1936,0.05241684958938598
STAT,1870,43,40-44,1913,0.02218264096130901
STAT,1837,19,30-34,1856,0.013871224124478724
STAT,1919,20,35-39,1939,0.10282162775648877
STAT,1821,52,45-49,1873,1.9698009040786026E-4
STAT,1861,22,35-39,1883,0.05041541641724897
SIM,1804,72,na,1876,8
STAT,1904,25,20-24,1929,0.1692393107000922
STAT,1873,59,na,1932,19.759056619426154
STAT,1803,52,40-44,1855,2.0542483408008742E-4
STAT,1863,16,20-24,1879,0.1801764848792614
STAT,1870,38,45-49,1908,0.01970484610780012
STAT,1849,45,40-44,1894,0.0013407042089583503
STAT,1841,43,15-19,1884,1.386732407669586E-4
STAT,1930,15,na,1945,47.583921645851746
SIM,1856,22,na,1878,16
STAT,1928,34,20-24,1962,0.030310847848472405
STAT,1796,91,na,1887,0.03786430410247373
SIM,1872,56,na,1928,20
STAT,1896,33,20-24,1929,0.03535581578367278
STAT,1847,15,50-100,1862,6.60954686309031E-4
STAT,1881,38,20-24,1919,0.007298580583008819
STAT,1846,19,25-29,1865,0.057013178098734296
STAT,1889,78,na,1967,13.46090118837171
STAT,1847,15,na,1862,30.968058095108454
STAT,1895,17,50-100,1912,6.360396283104946E-4
SIM,1871,16,20-24,1887,1
STAT,1885,33,45-49,1918,0.017147831863829108
STAT,1895,5,na,1900,34.02257664341163
STAT,1818,42,45-49,1860,0.0160920512135314
STAT,1884,32,30-34,1916,0.17106192152313449
SIM,1880,75,na,1955,17
STAT,1893,73,na,1966,18.135278289497762
STAT,1904,18,30-34,1922,0.02277857017110918
STAT,1864,46,20-24,1910,1.0793633373478126E-4
SIM,1951,13,na,1964,51
STAT,1882,50,50-100,1932,1.4681618140483126E-4
STAT,1917,34,45-49,1951,0.016188242567639052
STAT,1820,44,40-44,1864,0.01924749546144703
STAT,1817,41,30-34,1858,0.0374515568845114
STAT,1916,26,40-44,1942,0.0479456087078594
SIM,1909,34,na,1943,38
STAT,1933,26,40-44,1959,0.06166476073043102
STAT,1839,16,15-19,1855,0.04309583337644143
STAT,1859,19,35-39,1878,0.0050030172755318875
STAT,1903,26,15-19,1929,0.0064725757478336955
STAT,1813,50,45-49,1863,4.4960109680877806E-4
STAT,1790,72,na,1862,3.3073648896347327
STAT,1894,47,45-49,1941,0.001698148014894479
STAT,1910,22,40-44,1932,0.0313828397895209
STAT,1913,23,20-24,1936,1.1100146233409753
STAT,1882,44,15-19,1926,1.3055922534784787E-4
STAT,1860,24,40-44,1884,0.017213665469874614
SIM,1811,44,na,1855,11
STAT,1905,15,25-29,1920,0.08216455143930192
STAT,1876,30,15-19,1906,0.0014579835158026679
STAT,1804,50,35-39,1854,2.460435800668445E-4
STAT,1840,21,20-24,1861,0.6916757206332955
STAT,1825,36,40-44,1861,0.04677093839343875
STAT,1938,15,20-24,1953,1.334729775283118
SIM,1841,88,na,1929,1
STAT,1805,75,na,1880,3.472735661131334
STAT,1838,17,25-29,1855,0.05809545472006875
SIM,1880,85,na,1965,7
STAT,1814,47,20-24,1861,3.436628300188953E-4
SIM,1929,15,20-24,1944,1
STAT,1871,44,50-100,1915,0.010390655667363234
STAT,1934,26,45-49,1960,0.023152563752025037
STAT,1920,26,15-19,1946,0.007704578269048663
STAT,1913,49,30-34,1962,8.577676002969921E-4
STAT,1932,32,50-100,1964,0.010946541186530172
STAT,1926,35,50-100,1961,0.005110686604218598
STAT,1875,27,40-44,1902,0.030792664472784254
STAT,1902,20,40-44,1922,0.029560925213368283
STAT,1876,40,40-44,1916,0.023075185511242054
STAT,1915,29,50-100,1944,0.009992743978538192
STAT,1880,41,45-49,1921,0.01580917667859366
STAT,1924,28,40-44,1952,0.05372741409140704
SIM,1822,81,na,1903,6
SIM,1814,62,na,1876,20
STAT,1927,29,20-24,1956,0.21989269961082564
STAT,1810,66,na,1876,6.659680361115745
STAT,1929,42,25-29,1971,9.203536609567512E-4
STAT,1828,37,20-24,1865,0.0034475643306222823
STAT,1804,52,45-49,1856,3.985753945312767E-4
SIM,1852,36,na,1888,26
STAT,1838,32,na,1870,20.901894561330533
SIM,1817,69,na,1886,2
SIM,1927,20,35-39,1947,2
STAT,1875,54,na,1929,21.524666966344824
STAT,1911,4,na,1915,39.99787542117422
STAT,1925,24,na,1949,43.16625065178411
STAT,1895,28,20-24,1923,0.15176806943145846
SIM,1921,23,20-24,1944,2
STAT,1821,50,35-39,1871,1.2160650882116408E-4
STAT,1871,43,45-49,1914,0.014813718270415934
SIM,1918,11,na,1929,40
SIM,1833,69,na,1902,3
STAT,1891,44,25-29,1935,0.007775216111265508
STAT,1778,78,na,1856,3.3092703396
SIM,1861,19,na,1880,29
SIM,1909,44,na,1953,33
STAT,1874,17,na,1891,25.622057193936836
STAT,1869,22,35-39,1891,0.056542382322551495
STAT,1870,22,45-49,1892,0.006927112887457741
STAT,1885,49,45-49,1934,0.0022818751565038486
STAT,1951,18,50-100,1969,0.004432980186419041
SIM,1844,37,na,1881,7
STAT,1834,34,40-44,1868,0.0384495831654504
STAT,1908,41,40-44,1949,0.002315384297811723
STAT,1807,51,50-100,1858,3.1568064803310026E-4
STAT,1907,28,40-44,1935,0.043663419430025156
SIM,1888,27,na,1915,39
STAT,1843,31,30-34,1874,0.0899673100261176
STAT,1786,97,na,1883,0.004191265565520233
STAT,1848,86,na,1934,1.4348727494794131
STAT,1865,18,50-100,1883,4.539430234486153E-4
STAT,1881,22,20-24,1903,0.6557323128118616
STAT,1871,41,35-39,1912,0.01813550910364037
STAT,1943,24,45-49,1967,0.011875751842736633
SIM,1869,29,na,1898,15
STAT,1858,21,50-100,1879,0.003586071074535907
STAT,1908,36,45-49,1944,0.006380139347730818
STAT,1846,57,na,1903,16.286614545817184
SIM,1859,74,na,1933,7
STAT,1890,36,20-24,1926,0.009408590915289101
STAT,1899,43,30-34,1942,0.0010849977390247378
STAT,1866,71,na,1937,12.293267426261123
STAT,1922,39,30-34,1961,0.020542810510009554
STAT,1923,29,35-39,1952,0.16995477087680552
STAT,1850,43,25-29,1893,0.005676238603459071
STAT,1909,7,na,1916,38.85235682548545
STAT,1953,19,20-24,1972,1.6294705121858524
STAT,1841,58,na,1899,19.35701776623814
STAT,1866,37,40-44,1903,0.04031599338352767
STAT,1942,16,40-44,1958,0.014514711653686814
STAT,1854,27,20-24,1881,0.07517203908144278
SIM,1924,11,na,1935,55
SIM,1853,73,na,1926,10
STAT,1855,17,25-29,1872,0.0474543637049163
STAT,1862,53,45-49,1915,1.2319762706794072E-4
STAT,1865,44,15-19,1909,1.2322213513375117E-4
SIM,1874,41,na,1915,25
SIM,1946,15,20-24,1961,2
STAT,1843,24,40-44,1867,0.01093647950488536
STAT,1940,21,25-29,1961,0.9345905381382347
STAT,1823,94,na,1917,0.11493755343656789
STAT,1876,33,35-39,1909,0.10242106704795939
STAT,1860,31,30-34,1891,0.14252280530320796
STAT,1853,39,na,1892,14.657849316041302
STAT,1927,35,15-19,1962,2.3794757964294786E-4
STAT,1872,48,20-24,1920,1.2123768880731013E-4
STAT,1815,75,na,1890,3.674857774363001
SIM,1882,70,na,1952,21
STAT,1935,24,na,1959,49.47424922696056
STAT,1944,26,50-100,1970,0.010684581075965791
STAT,1850,40,20-24,1890,0.001428283422011494
SIM,1838,37,na,1875,8
STAT,1911,30,45-49,1941,0.015346523232486125
STAT,1914,31,25-29,1945,0.09264233773388994
STAT,1856,38,25-29,1894,0.020754409509227002
SIM,1851,34,35-39,1885,1
STAT,1891,19,50-100,1910,5.980838882321815E-4
STAT,1894,22,30-34,1916,0.2282807757372109
STAT,1934,34,45-49,1968,0.021366019610114893
STAT,1924,34,35-39,1958,0.10578530569154318
STAT,1932,10,na,1942,52.41217081257919
SIM,1862,56,na,1918,21
SIM,1907,49,na,1956,38
STAT,1846,42,20-24,1888,0.0013026467760849263
STAT,1898,40,45-49,1938,0.0014161602418413797
STAT,1932,7,na,1939,52.71628860898079
STAT,1936,19,20-24,1955,1.2832257090135488
STAT,1840,46,35-39,1886,0.0011205292480591697
SIM,1848,21,na,1869,30
STAT,1812,61,na,1873,9.27112170331937
STAT,1869,38,20-24,1907,0.007432027399904792
STAT,1884,28,45-49,1912,0.010839925158576515
STAT,1912,51,na,1963,34.5843490038235
STAT,1916,43,40-44,1959,0.0025372914553837733
STAT,1834,41,30-34,1875,0.009920764735075256
STAT,1881,24,na,1905,22.36358292604338
SIM,1792,66,na,1858,8
STAT,1908,12,na,1920,38.11000800028235
STAT,1893,22,30-34,1915,0.22459104512653183
STAT,1881,46,20-24,1927,1.1450940978071896E-4
STAT,1925,36,45-49,1961,0.008138328609443505
SIM,1944,19,20-24,1963,1
STAT,1921,18,30-34,1939,0.1374914502220413
STAT,1898,44,25-29,1942,5.93436057564838E-4
STAT,1903,44,45-49,1947,0.001457659062970593
STAT,1812,42,40-44,1854,0.02644662964886454
STAT,1811,54,40-44,1865,3.838846434932734E-4
STAT,1800,76,na,1876,3.463190831108091
STAT,1840,102,na,1942,0.002297293509274103
STAT,1899,36,40-44,1935,0.06021353082872624
STAT,1920,41,40-44,1961,0.002742908658724046
STAT,1855,53,50-100,1908,1.0462659595333973E-4
STAT,1922,30,20-24,1952,0.02757761004827369
STAT,1865,34,na,1899,21.399088838210773
STAT,1922,47,30-34,1969,0.0010166152891821997
STAT,1866,9,na,1875,25.308637011884446
STAT,1827,60,na,1887,12.093005840085056
STAT,1873,36,20-24,1909,0.007874884464042808
STAT,1857,21,15-19,1878,0.028717177653685914
SIM,1847,89,na,1936,1
SIM,1889,19,na,1908,34
STAT,1884,35,35-39,1919,0.0699552087759193
SIM,1922,16,na,1938,50
STAT,1912,42,45-49,1954,0.0015926056682466134
STAT,1926,24,45-49,1950,0.013506286225697888
STAT,1864,49,25-29,1913,5.058407864637039E-4
SIM,1802,67,na,1869,9
STAT,1881,47,35-39,1928,0.0013259502111431691
STAT,1826,31,30-34,1857,0.2718827383974544
STAT,1885,30,40-44,1915,0.04316995684062506
SIM,1837,89,na,1926,1
STAT,1817,44,35-39,1861,0.05386858045293241
STAT,1846,16,20-24,1862,0.18155670098335241
STAT,1879,78,na,1957,8.873564758978004
SIM,1845,54,na,1899,22
STAT,1938,18,40-44,1956,0.013702172675172214
STAT,1928,18,30-34,1946,0.15243104604736238
STAT,1830,42,na,1872,9.207909415849718
STAT,1858,35,40-44,1893,0.03362672768095733
STAT,1867,40,30-34,1907,0.011112884447922865
STAT,1870,35,40-44,1905,0.0438986012779671
SIM,1892,35,35-39,1927,1
STAT,1885,40,35-39,1925,0.018062490617489622
STAT,1875,35,40-44,1910,0.045425550600349716
STAT,1891,41,20-24,1932,0.0019580333886642775
STAT,1906,45,25-29,1951,4.767432557197213E-4
STAT,1876,17,45-49,1893,6.634452458851969E-4
STAT,1892,27,40-44,1919,0.037007425418578266
STAT,1891,54,na,1945,25.701174494973884
STAT,1918,37,15-19,1955,2.005756916892971E-4
STAT,1853,21,30-34,1874,0.13322648653170735
STAT,1928,37,25-29,1965,0.012382550377581503
SIM,1772,83,na,1855,2
SIM,1870,85,na,1955,4
STAT,1842,32,25-29,1874,0.09283441336858968
STAT,1875,31,25-29,1906,0.10571832245555948
STAT,1831,47,20-24,1878,1.1488684952738301E-4
STAT,1863,41,45-49,1904,0.013311175020374624
SIM,1885,84,na,1969,9
STAT,1921,25,20-24,1946,0.20322338487001793
STAT,1941,28,40-44,1969,0.0478443951528701
SIM,1882,18,na,1900,33
SIM,1875,25,40-44,1900,1
STAT,1882,36,na,1918,22.68703154171086
STAT,1920,25,na,1945,41.021064151192114
STAT,1933,18,40-44,1951,0.018598685654330697
STAT,1862,20,na,1882,21.19138515405021
SIM,1897,48,na,1945,38
STAT,1819,47,50-100,1866,0.002211586284767224
STAT,1935,30,30-34,1965,0.21725040773693413
STAT,1934,35,na,1969,51.786829947521056
STAT,1871,51,45-49,1922,1.453811007491234E-4
STAT,1875,42,30-34,1917,0.011803374746570656
STAT,1853,22,50-100,1875,0.003028157845774946
STAT,1841,45,50-100,1886,0.002477544186486904
STAT,1913,26,25-29,1939,0.6525852187376779
SIM,1905,9,na,1914,40
STAT,1859,16,30-34,1875,0.014792419792964376
SIM,1866,22,na,1888,34
STAT,1861,72,na,1933,10.620384426237344
STAT,1883,33,25-29,1916,0.09904429380296374
STAT,1873,53,na,1926,21.539612027881294
STAT,1886,30,25-29,1916,0.10709708120939786
STAT,1948,24,50-100,1972,0.007500047556456986
SIM,1829,54,na,1883,19
SIM,1870,43,35-39,1913,1
STAT,1862,43,35-39,1905,0.015510203320127655
STAT,1877,47,45-49,1924,0.0024247787033314307
SIM,1779,84,na,1863,2
SIM,1782,83,na,1865,1
STAT,1906,27,na,1933,34.671787364302546
STAT,1843,27,45-49,1870,0.0057962924485156575
STAT,1864,86,na,1950,1.990058264199393
SIM,1854,16,20-24,1870,1
STAT,1903,13,na,1916,36.659478648372044
SIM,1939,15,30-34,1954,1
STAT,1908,44,45-49,1952,0.0015129864343065788
SIM,1944,7,na,1951,36
STAT,1802,61,na,1863,8.222381520698091
STAT,1863,19,25-29,1882,0.05148757857291518
STAT,1870,46,45-49,1916,0.0023510532337008188
STAT,1939,25,50-100,1964,0.009946254047729891
STAT,1817,60,na,1877,18.162324233140023
STAT,1896,26,na,1922,31.455419367032228
STAT,1927,15,45-49,1942,0.006208186894421354
SIM,1868,7,na,1875,38
STAT,1871,5,na,1876,27.727456809195438
STAT,1825,58,na,1883,11.421369229507755
STAT,1873,28,50-100,1901,0.0064808122783442425
STAT,1934,23,40-44,1957,0.044979825620378465
STAT,1936,29,30-34,1965,0.3723479861693234
STAT,1946,16,25-29,1962,0.4773924101699801
SIM,1848,37,na,1885,31
STAT,1899,46,35-39,1945,0.0010841389559080245
STAT,1921,26,50-100,1947,0.011044460548509712
STAT,1867,42,40-44,1909,0.02149818232685777
STAT,1868,32,30-34,1900,0.16896559503493014
STAT,1914,37,30-34,1951,0.018046454524380206
STAT,1841,27,25-29,1868,0.5142732778733677
STAT,1834,30,25-29,1864,0.09466280679040127
STAT,1925,19,45-49,1944,0.005964512220409809
SIM,1954,16,25-29,1970,2
STAT,1831,58,na,1889,16.086546477305465
STAT,1833,29,40-44,1862,0.028812095813554085
SIM,1906,34,25-29,1940,1
STAT,1841,17,50-100,1858,6.18480384880229E-4
STAT,1888,52,na,1940,25.028611613764465
STAT,1918,12,na,1930,42.73667641134238
STAT,1885,46,40-44,1931,0.0016954253501232797
STAT,1817,37,45-49,1854,0.07966668647545065
STAT,1821,75,na,1896,6.393871564002155
STAT,1858,86,na,1944,1.6883550291437512
STAT,1886,20,50-100,1906,0.004255110365410805
STAT,1801,105,na,1906,1.0625800174513417E-4
STAT,1900,70,na,1970,23.20208514088692
STAT,1821,35,45-49,1856,0.04859798572436478
STAT,1936,36,20-24,1972,0.002574605431028066
SIM,1851,19,na,1870,25
STAT,1926,10,na,1936,48.44792361006124
STAT,1894,21,na,1915,30.401780451600068
STAT,1859,43,45-49,1902,0.011809618100541035
SIM,1892,60,na,1952,28
SIM,1935,31,35-39,1966,2
SIM,1929,16,15-19,1945,1
STAT,1816,42,25-29,1858,0.008848889504250404
STAT,1856,57,na,1913,14.558437138095286
STAT,1887,17,20-24,1904,0.1935082923719255
STAT,1944,27,15-19,1971,0.007574640917664659
STAT,1827,31,30-34,1858,0.15937547528293242
STAT,1908,33,40-44,1941,0.036591888224819194
SIM,1921,26,25-29,1947,1
STAT,1893,30,30-34,1923,0.22191518544230507
STAT,1893,32,40-44,1925,0.05468067646718045
STAT,1914,44,20-24,1958,1.7296602035363193E-4
STAT,1890,39,25-29,1929,0.034621696870864256
STAT,1926,41,45-49,1967,0.002042949719480587
STAT,1871,40,40-44,1911,0.02265156739898649
STAT,1901,15,40-44,1916,0.0025711966866525434
SIM,1936,30,na,1966,37
SIM,1904,35,na,1939,29
STAT,1933,29,45-49,1962,0.022823092419779135
STAT,1885,20,30-34,1905,0.1769484468698545
SIM,1867,35,na,1902,12
SIM,1923,4,na,1927,42
SIM,1919,34,na,1953,42
STAT,1927,31,35-39,1958,0.11190372004695973
SIM,1893,20,30-34,1913,2
STAT,1876,71,na,1947,13.556845722777586
SIM,1854,37,na,1891,17
STAT,1821,42,35-39,1863,0.028229615657457834
SIM,1866,18,na,1884,35
STAT,1926,41,na,1967,45.58899404055105
STAT,1823,48,25-29,1871,3.9501198658092797E-4
SIM,1850,62,na,1912,18
STAT,1843,34,35-39,1877,0.050582743778841574
STAT,1897,39,25-29,1936,0.008169512600607434
SIM,1852,31,30-34,1883,1
SIM,1873,35,na,1908,27
SIM,1899,40,na,1939,28
STAT,1921,32,45-49,1953,0.017374880762927734
STAT,1840,35,na,1875,20.266731642422116
STAT,1903,41,40-44,1944,0.0022307145850332002
STAT,1906,42,20-24,1948,1.6002366958912828E-4
STAT,1941,14,na,1955,40.15230713084672
STAT,1838,93,na,1931,0.2268319112615421
STAT,1783,86,na,1869,0.3591729707711687
SIM,1883,55,na,1938,9
STAT,1949,20,30-34,1969,0.33346082478807276
STAT,1931,31,25-29,1962,0.12064234935929473
STAT,1839,38,25-29,1877,0.018791444469529583
STAT,1883,37,40-44,1920,0.04250911837883132
STAT,1808,47,45-49,1855,0.0017037194097203113
STAT,1802,95,na,1897,0.040605260509524434
STAT,1874,21,15-19,1895,0.033569359091559135
SIM,1891,37,40-44,1928,1
STAT,1860,20,25-29,1880,0.5348527378239111
STAT,1860,34,35-39,1894,0.0816254038505039
STAT,1879,26,50-100,1905,0.0066436013052364904
STAT,1913,45,30-34,1958,8.668859147497734E-4
STAT,1839,24,15-19,1863,0.023057672200232013
STAT,1897,17,15-19,1914,0.07880818728612626
SIM,1906,64,na,1970,19
STAT,1816,46,40-44,1862,0.002190742100726231
STAT,1814,53,30-34,1867,1.602884066648156E-4
STAT,1892,23,25-29,1915,0.705031362605032
STAT,1844,31,30-34,1875,0.16478633962377612
STAT,1869,85,na,1954,2.6562019881338066
SIM,1889,1,na,1890,34
STAT,1840,48,25-29,1888,4.4935494064314026E-4
STAT,1945,14,na,1959,42.586368319066175
STAT,1872,32,20-24,1904,0.027656891667834544
STAT,1922,45,40-44,1967,0.0018064430733091652
STAT,1824,39,50-100,1863,0.01712928790248133
STAT,1891,42,50-100,1933,0.012950544108524985
SIM,1887,55,na,1942,21
STAT,1841,102,na,1943,0.0028696403216863543
STAT,1936,25,15-19,1961,0.0067210899211846906
STAT,1924,24,25-29,1948,1.076078600587488
STAT,1933,3,na,1936,54.07510024650817
SIM,1932,24,25-29,1956,3
STAT,1825,32,25-29,1857,0.12285152944163975
STAT,1834,44,35-39,1878,0.015036758728737418
STAT,1830,26,20-24,1856,0.11902122633987744
STAT,1846,26,na,1872,21.362468426170622
SIM,1902,64,na,1966,30
STAT,1861,50,50-100,1911,1.2883255554827286E-4
STAT,1856,20,na,1876,18.250522162036773
SIM,1782,76,na,1858,5
STAT,1853,43,40-44,1896,0.014034158805469845
SIM,1906,30,na,1936,27
STAT,1932,32,20-24,1964,0.03229390175201748
SIM,1798,61,na,1859,9
SIM,1927,25,na,1952,52
STAT,1827,53,na,1880,13.890854830448482
SIM,1906,5,na,1911,29
STAT,1867,43,35-39,1910,0.017203594547349724
STAT,1798,102,na,1900,0.0014898703984716328
STAT,1864,48,na,1912,19.925782670861143
SIM,1851,23,na,1874,22
STAT,1851,75,na,1926,8.691037076417134
STAT,1912,28,30-34,1940,0.3817591735742735
STAT,1814,80,na,1894,2.75660022773474
STAT,1926,40,30-34,1966,0.0015714146784783095
STAT,1848,90,na,1938,0.5098617583781029
SIM,1913,49,na,1962,40
STAT,1848,31,15-19,1879,0.001085201715329371
STAT,1926,21,40-44,1947,0.040737767577498224
STAT,1922,38,35-39,1960,0.02729308160682885
STAT,1919,47,25-29,1966,5.703616889506457E-4
SIM,1794,61,na,1855,5
STAT,1851,22,25-29,1873,0.577136730103475
STAT,1876,43,45-49,1919,0.015090756907904663
STAT,1912,20,35-39,1932,0.09006653808096866
STAT,1904,33,20-24,1937,0.022145992903214447
STAT,1904,47,30-34,1951,7.787574347310756E-4
STAT,1843,44,45-49,1887,0.006371290546505572
STAT,1875,38,45-49,1913,0.020390250665941707
STAT,1894,44,40-44,1938,0.00197475365919092
SIM,1837,80,na,1917,5
STAT,1870,21,30-34,1891,0.17747939991652123
STAT,1880,36,50-100,1916,0.012972505325768265
STAT,1840,43,30-34,1883,0.009277758202705802
STAT,1882,27,50-100,1909,0.006130452218455707
SIM,1807,76,na,1883,9
SIM,1895,74,na,1969,14
STAT,1834,25,50-100,1859,0.006013824337496142
STAT,1846,51,50-100,1897,1.229825502770255E-4
STAT,1840,32,na,1872,20.684446730257562
STAT,1852,20,na,1872,22.054067722562007
STAT,1882,67,na,1949,15.19183649509223
STAT,1916,47,na,1963,37.35924695346907
STAT,1891,15,20-24,1906,0.21860454776917876
STAT,1842,36,40-44,1878,0.03893002972242848
STAT,1837,53,na,1890,10.243925774324858
STAT,1853,39,20-24,1892,0.004795881295061658
STAT,1895,37,na,1932,30.586596849280674
SIM,1921,37,na,1958,41
STAT,1795,71,na,1866,7.3702575845857075
STAT,1907,34,35-39,1941,0.08433020555925953
STAT,1833,60,na,1893,14.119675655222746
STAT,1874,48,na,1922,22.53765145588611
SIM,1782,73,na,1855,7
STAT,1935,27,50-100,1962,0.013507777237317851
STAT,1886,38,20-24,1924,0.007956096878642824
STAT,1905,41,25-29,1946,6.464923623047217E-4
STAT,1865,28,25-29,1893,0.38126420676156053
STAT,1863,35,15-19,1898,5.019130338288125E-4
SIM,1868,88,na,1956,5
STAT,1819,47,20-24,1866,1.0805796607474163E-4
STAT,1839,15,50-100,1854,3.5787971661407333E-4
STAT,1862,40,30-34,1902,0.010019016478560369
STAT,1918,39,20-24,1957,0.00274749534031633
SIM,1849,16,na,1865,16
SIM,1868,82,na,1950,8
STAT,1930,23,20-24,1953,1.4134339134737945
STAT,1873,16,15-19,1889,0.060693625352191666
STAT,1887,43,20-24,1930,0.0017209344308444655
STAT,1937,18,50-100,1955,0.0036122913109671653
STAT,1954,0,na,1954,52.213200739879106
SIM,1887,48,na,1935,24
STAT,1884,45,45-49,1929,0.0023352663873859743
STAT,1879,15,20-24,1894,0.18434460375641482
STAT,1893,33,35-39,1926,0.12715103115576917
SIM,1889,40,na,1929,32
STAT,1929,18,15-19,1947,0.5749058813305944
STAT,1850,35,na,1885,21.756133118965053
STAT,1845,37,20-24,1882,0.00473440055055132
STAT,1895,40,50-100,1935,0.01385383565737821
STAT,1898,22,15-19,1920,0.04450386267896159
STAT,1910,25,45-49,1935,0.016834970968379465
SIM,1890,37,na,1927,24
SIM,1848,68,na,1916,17
SIM,1837,90,na,1927,1
SIM,1843,80,na,1923,8
STAT,1840,42,na,1882,18.892071398716595
STAT,1846,20,na,1866,21.690704453222974
STAT,1833,54,50-100,1887,1.1076121356601843E-4
STAT,1815,68,na,1883,6.359846194053022
STAT,1912,35,20-24,1947,0.002576985900874707
SIM,1879,29,na,1908,13
SIM,1899,43,na,1942,28
STAT,1880,31,35-39,1911,0.10692666756943763
STAT,1920,22,na,1942,40.25231468350509
STAT,1927,22,50-100,1949,0.008065464288218409
SIM,1866,0,na,1866,40
STAT,1890,30,15-19,1920,0.001743734760280665
STAT,1842,53,50-100,1895,1.1149339253332827E-4
STAT,1820,80,na,1900,3.506975988589534
SIM,1914,29,35-39,1943,1
STAT,1820,105,na,1925,1.6622616532318508E-4
STAT,1863,39,30-34,1902,0.046713028676056326
STAT,1858,45,35-39,1903,0.0010759433702016593
STAT,1906,29,35-39,1935,0.13917925865690825
SIM,1919,37,na,1956,44
STAT,1822,48,50-100,1870,0.0013314277485379986
STAT,1812,50,45-49,1862,1.6370835350228862E-4
STAT,1871,27,20-24,1898,0.1169626112231523
SIM,1868,41,na,1909,32
STAT,1842,15,25-29,1857,0.05524535240727047
STAT,1877,44,40-44,1921,0.022904993776543252
SIM,1877,55,na,1932,24
STAT,1915,19,35-39,1934,0.008659773453243045
STAT,1909,40,30-34,1949,0.0012025567071989316
STAT,1844,93,na,1937,0.22827810480993918
STAT,1900,45,50-100,1945,0.001940245799473491
SIM,1856,56,na,1912,9
STAT,1852,33,30-34,1885,0.15311734269285626
STAT,1906,46,50-100,1952,0.0020184288564425866
STAT,1925,16,40-44,1941,0.016831921478236936
STAT,1865,92,na,1957,0.48456463629297875
STAT,1889,32,15-19,1921,0.0017435422957623504
STAT,1921,47,30-34,1968,9.971155828280142E-4
STAT,1864,40,15-19,1904,1.2511334946137276E-4
STAT,1857,47,40-44,1904,0.0012756419931017554
STAT,1837,22,40-44,1859,0.014211967875677698
STAT,1847,26,15-19,1873,0.005867516738269413
SIM,1845,22,40-44,1867,1
STAT,1806,61,na,1867,13.09532170711241
SIM,1939,10,na,1949,30
STAT,1852,42,45-49,1894,0.012793198250930978
STAT,1932,19,35-39,1951,0.055041529443507
STAT,1902,40,45-49,1942,0.001480392131500036
STAT,1838,16,50-100,1854,5.052419528669271E-4
STAT,1826,42,35-39,1868,0.01916885578626872
STAT,1870,51,45-49,1921,1.4485443727177403E-4
STAT,1862,37,20-24,1899,0.006650611556555862
SIM,1899,33,na,1932,28
STAT,1817,54,45-49,1871,3.8771191004083447E-4
STAT,1876,33,na,1909,24.134188909968085
STAT,1909,62,na,1971,30.55663528956645
STAT,1930,37,30-34,1967,0.023661814831536867
SIM,1874,37,40-44,1911,1
STAT,1950,2,na,1952,46.995940689773164
STAT,1861,32,45-49,1893,0.014664768998843478
SIM,1876,70,na,1946,22
STAT,1916,46,45-49,1962,0.0022156400568614392
STAT,1831,31,20-24,1862,0.028826323029381394
STAT,1856,16,15-19,1872,0.051136265616281686
STAT,1907,33,na,1940,35.05416439673446
STAT,1820,40,50-100,1860,0.009647286211566053
STAT,1931,33,15-19,1964,0.0016753342700124233
STAT,1826,43,30-34,1869,0.011957001142255261
STAT,1854,49,30-34,1903,5.793217676854413E-4
SIM,1949,1,na,1950,40
STAT,1826,46,50-100,1872,0.0025059852959930257
STAT,1912,18,20-24,1930,0.27129185041038323
SIM,1927,2,na,1929,52
STAT,1923,42,20-24,1965,2.0498382248477457E-4
SIM,1966,0,na,1966,45
STAT,1925,22,35-39,1947,0.11200245130476259
SIM,1825,61,na,1886,14
SIM,1920,18,20-24,1938,1
STAT,1922,48,45-49,1970,0.002471634577096637
STAT,1920,15,na,1935,43.305145328845455
STAT,1853,46,45-49,1899,0.00148742679013832
STAT,1893,34,30-34,1927,0.21826082468683206
STAT,1868,43,50-100,1911,0.010149909333136808
SIM,1903,12,na,1915,39
STAT,1917,31,40-44,1948,0.0407721849141975
STAT,1923,29,na,1952,42.40674339541448
STAT,1800,66,na,1866,7.0995870507268695
STAT,1877,40,25-29,1917,0.006695623333459097
STAT,1790,65,na,1855,4.817
STAT,1867,40,15-19,1907,1.334881109380713E-4
STAT,1943,18,50-100,1961,0.003942739098361879
STAT,1903,30,35-39,1933,0.14513718799269787
STAT,1919,44,20-24,1963,1.8909155955367746E-4
STAT,1892,20,20-24,1912,0.8564298578278258
SIM,1922,2,na,1924,53
STAT,1904,1,na,1905,39.00137126450937
STAT,1823,39,na,1862,16.40312741848818
STAT,1833,87,na,1920,1.3043425105891493
STAT,1860,89,na,1949,0.8540564619118537
SIM,1938,23,15-19,1961,1
STAT,1821,105,na,1926,1.8210734413571874E-4
STAT,1816,49,45-49,1865,0.002885747754182574
STAT,1843,41,40-44,1884,0.00995050008562428
STAT,1901,18,45-49,1919,9.116427774592611E-4
STAT,1836,32,50-100,1868,0.011177099859814849
SIM,1829,61,na,1890,19
STAT,1904,36,25-29,1940,0.008947549553629223
STAT,1913,48,35-39,1961,0.001244418228524484
STAT,1852,23,50-100,1875,0.004116267659781583
STAT,1815,65,na,1880,7.112572182569794
STAT,1905,48,na,1953,32.06859915158195
STAT,1943,21,40-44,1964,0.035524224009053564
STAT,1806,54,na,1860,15.3060873421099
STAT,1895,47,na,1942,29.07790856709093
STAT,1926,0,na,1926,54.9194990178415
STAT,1830,40,35-39,1870,0.010210959273997535
STAT,1835,42,45-49,1877,0.00812351829676213
SIM,1839,16,na,1855,24
SIM,1937,25,na,1962,37
STAT,1884,21,25-29,1905,0.5625582961738274
STAT,1861,48,45-49,1909,0.00195971776981475
STAT,1820,47,45-49,1867,0.0019953243756851697
SIM,1918,48,na,1966,34
STAT,1896,7,na,1903,34.222291297750296
STAT,1842,39,45-49,1881,0.015638109748180407
STAT,1816,54,na,1870,7.958571836184844
STAT,1872,74,na,1946,11.355026015698119
STAT,1828,38,na,1866,18.60513748800033
SIM,1903,49,na,1952,35
SIM,1893,55,na,1948,33
STAT,1898,35,50-100,1933,0.01671955429451006
SIM,1848,23,20-24,1871,2
STAT,1813,48,30-34,1861,0.002955765710560491
STAT,1893,30,15-19,1923,0.0018100192937417403
STAT,1852,32,35-39,1884,0.08973883117003041
STAT,1926,43,35-39,1969,0.002464344992483973
STAT,1849,48,45-49,1897,0.0018069304151163237
STAT,1822,34,15-19,1856,9.64309891103428E-4
STAT,1875,45,35-39,1920,0.0014534664350906838
SIM,1900,38,na,1938,36
SIM,1820,62,na,1882,8
STAT,1801,55,na,1856,10.572810073099996
STAT,1880,39,30-34,1919,0.05547928882323437
SIM,1832,43,na,1875,24
SIM,1938,16,25-29,1954,2
STAT,1951,14,na,1965,46.47607732616595
STAT,1938,28,na,1966,36.850964686959216
STAT,1865,102,na,1967,0.01639564641231002
STAT,1898,27,25-29,1925,0.5706465333711991
STAT,1918,41,35-39,1959,0.0021246486097481854
SIM,1823,76,na,1899,3
STAT,1858,42,30-34,1900,0.008737568682682398
SIM,1853,42,na,1895,24
STAT,1860,27,45-49,1887,0.009123177042768948
STAT,1883,16,25-29,1899,0.05516370061064433
SIM,1943,25,na,1968,47
STAT,1886,33,na,1919,24.647945513531674
STAT,1938,18,25-29,1956,0.4245226537227894
SIM,1922,26,na,1948,49
SIM,1870,82,na,1952,5
SIM,1802,77,na,1879,2
STAT,1887,18,na,1905,27.49496035032983
STAT,1931,37,30-34,1968,0.02403067141282948
STAT,1859,42,30-34,1901,0.009126507197372217
STAT,1849,46,50-100,1895,0.0019097678632484202
STAT,1817,39,na,1856,24.600945983596265
STAT,1889,47,na,1936,27.422192795320353
STAT,1948,15,30-34,1963,0.13864202437109033
SIM,1912,23,na,1935,35
STAT,1884,42,40-44,1926,0.022010192329311812
STAT,1831,47,50-100,1878,0.002351350760564309
SIM,1770,88,na,1858,4
SIM,1820,58,na,1878,10
STAT,1891,18,25-29,1909,0.06936914886037326
STAT,1930,26,25-29,1956,0.8333936974310256
SIM,1955,10,na,1965,46
STAT,1893,33,50-100,1926,0.011503980199239325
STAT,1809,52,45-49,1861,4.7459764398426115E-4
STAT,1876,30,30-34,1906,0.17875427262011165
STAT,1879,18,25-29,1897,0.05849753991892125
SIM,1855,16,na,1871,22
STAT,1870,31,25-29,1901,0.10216467217056545
STAT,1922,35,30-34,1957,0.020622297945789587
SIM,1792,76,na,1868,2
STAT,1845,31,50-100,1876,0.006434661747487077
SIM,1851,57,na,1908,15
STAT,1834,79,na,1913,4.940545105683272
STAT,1859,17,45-49,1876,6.026757971576724E-4
SIM,1876,15,na,1891,31
SIM,1871,71,na,1942,13
STAT,1838,38,na,1876,19.85165310746185
STAT,1933,29,na,1962,49.48955804182936
STAT,1898,48,40-44,1946,0.0012863753698831798
SIM,1833,28,na,1861,13
STAT,1907,17,35-39,1924,0.008026251532833371
STAT,1852,28,50-100,1880,0.006330935345199787
STAT,1884,34,50-100,1918,0.00890007674194806
STAT,1916,29,45-49,1945,0.017583642576139244
STAT,1866,23,30-34,1889,0.1641998285713687
SIM,1892,70,na,1962,21
STAT,1935,14,na,1949,53.75195353301109
STAT,1924,44,50-100,1968,0.0013836758014132626
STAT,1875,92,na,1967,1.3874596791472642
STAT,1867,44,30-34,1911,0.01085336698108208
STAT,1850,17,25-29,1867,0.06165466932858415
STAT,1885,32,30-34,1917,0.17241729484218415
STAT,1856,19,na,1875,19.43170315249154
SIM,1819,61,na,1880,4
STAT,1830,80,na,1910,2.2225676101245107
STAT,1881,44,30-34,1925,0.010791928653407354
SIM,1884,41,na,1925,22
STAT,1871,34,na,1905,23.58783611198122
STAT,1915,16,30-34,1931,0.025352319862073976
STAT,1899,32,25-29,1931,0.14021445491478646
STAT,1905,47,30-34,1952,7.843828891449924E-4
SIM,1776,80,na,1856,2
SIM,1886,70,na,1956,11
STAT,1796,97,na,1893,0.0023350458320944767
STAT,1881,49,25-29,1930,5.366453343069982E-4
STAT,1910,2,na,1912,40.14570687345819
SIM,1945,6,na,1951,40
STAT,1825,68,na,1893,8.238564641333905
STAT,1902,23,45-49,1925,0.009803150093354494
STAT,1902,34,na,1936,33.64712680855436
STAT,1857,26,25-29,1883,0.3285358107939454
STAT,1914,15,na,1929,39.805534113635595
STAT,1907,24,25-29,1931,0.8321190493043489
STAT,1854,93,na,1947,0.17863584118051554
SIM,1881,23,na,1904,19
STAT,1904,63,na,1967,28.211234747134267
STAT,1835,45,50-100,1880,0.0013216659813326957
STAT,1864,45,50-100,1909,0.002224803992494945
STAT,1775,98,na,1873,0.008650169534727773
STAT,1928,19,50-100,1947,0.004672494767371827
STAT,1942,19,45-49,1961,0.005178901249823376
STAT,1933,24,35-39,1957,0.12430408093431917
STAT,1894,20,50-100,1914,0.00525739134059045
STAT,1817,51,40-44,1868,2.9857521046018886E-4
SIM,1841,57,na,1898,13
STAT,1913,40,20-24,1953,1.7271667859002004E-4
STAT,1929,16,25-29,1945,0.5517546156537045
STAT,1798,105,na,1903,1.4900316004935608E-4
STAT,1917,33,na,1950,39.07847468574748
STAT,1781,98,na,1879,0.008571946157259551
SIM,1893,32,30-34,1925,1
SIM,1934,11,na,1945,52
SIM,1949,10,na,1959,38
SIM,1915,24,25-29,1939,1
STAT,1818,41,30-34,1859,0.012747833616185611
STAT,1927,39,30-34,1966,0.02249633948574882
STAT,1833,94,na,1927,0.14796557402560512
SIM,1913,12,na,1925,47
STAT,1863,60,na,1923,16.886123291645735
STAT,1925,33,40-44,1958,0.04615114731670862
STAT,1793,79,na,1872,1.5231929883068656
STAT,1834,37,45-49,1871,0.01752319291385655
SIM,1863,42,na,1905,11
STAT,1843,20,25-29,1863,0.30922870269540687
STAT,1866,29,50-100,1895,0.005849341606991888
STAT,1928,42,50-100,1970,0.0014903307102247425
STAT,1878,26,45-49,1904,0.011502302196137333
STAT,1910,43,50-100,1953,0.0010968771704099052
STAT,1877,18,na,1895,26.002542916646085
STAT,1889,15,15-19,1904,0.07299616883352793
STAT,1946,20,15-19,1966,0.058859575286396834
STAT,1824,49,35-39,1873,0.0017643218116099365
STAT,1917,26,na,1943,39.063046219904216
SIM,1855,53,na,1908,13
STAT,1903,2,na,1905,37.89857176628503
STAT,1882,45,35-39,1927,0.0013550572809308708
STAT,1863,31,35-39,1894,0.09003122776718904
SIM,1859,43,na,1902,18
STAT,1780,97,na,1877,0.017593656829531235
STAT,1889,48,25-29,1937,3.928016489520316E-4
STAT,1913,12,na,1925,40.04121397877951
STAT,1784,87,na,1871,0.7931778352151754
SIM,1896,75,na,1971,18
STAT,1771,101,na,1872,0.0021068181610976724
STAT,1849,28,30-34,1877,0.22979846198337392
STAT,1841,46,30-34,1887,9.640606244061886E-4
SIM,1837,40,na,1877,29
STAT,1937,35,20-24,1972,0.002623875960804947
STAT,1840,28,40-44,1868,0.02905723476311298
STAT,1851,39,50-100,1890,0.01026066497313236
STAT,1850,20,15-19,1870,0.03576721184259148
STAT,1955,15,15-19,1970,0.5993911704789924
STAT,1839,94,na,1933,0.11029440352306526
STAT,1840,17,30-34,1857,0.016170399704490013
STAT,1815,54,35-39,1869,1.1477054384459322E-4
STAT,1836,28,20-24,1864,0.14544885527924073
STAT,1798,95,na,1893,0.06756588982941839
STAT,1809,72,na,1881,7.891864322003621
SIM,1842,27,na,1869,27
STAT,1882,8,na,1890,24.91258967688046
STAT,1850,31,25-29,1881,0.0963965117652742
STAT,1911,21,40-44,1932,0.03177859522761205
SIM,1847,58,na,1905,13
STAT,1824,41,25-29,1865,0.008849487396227694
STAT,1857,34,15-19,1891,0.0010569479799704135
STAT,1939,32,20-24,1971,0.024716428861207788
STAT,1893,48,45-49,1941,0.001657435273966921
STAT,1792,82,na,1874,3.390829861870838
STAT,1866,15,50-100,1881,4.68630692799494E-4
STAT,1905,17,na,1922,36.4505921275834
STAT,1871,55,na,1926,20.615111626177892
SIM,1832,49,35-39,1881,1
STAT,1929,11,na,1940,50.40014880343037
SIM,1806,76,na,1882,2
STAT,1915,0,na,1915,46.591367445266044
STAT,1884,42,35-39,1926,0.017719640634806515
STAT,1849,15,25-29,1864,0.05472861525661668
STAT,1842,25,40-44,1867,0.028197262806327703
STAT,1875,18,30-34,1893,0.01634112988058184
STAT,1953,18,15-19,1971,0.5456493273879899
SIM,1825,55,na,1880,15
STAT,1843,43,30-34,1886,0.004957315976235027
STAT,1892,19,45-49,1911,8.026714481242526E-4
SIM,1850,22,na,1872,22
STAT,1817,51,35-39,1868,2.441619717337807E-4
STAT,1824,30,15-19,1854,0.002484506948343876
STAT,1910,33,50-100,1943,0.007889924673151567
STAT,1909,48,20-24,1957,1.0069748886823946E-4
STAT,1834,63,na,1897,12.609597197574093
SIM,1821,65,na,1886,7
STAT,1847,18,25-29,1865,0.07510750258117146
STAT,1853,17,40-44,1870,0.0013827873511097742
STAT,1885,63,na,1948,17.620268672431553
STAT,1897,42,45-49,1939,0.001378441735321395
SIM,1814,71,na,1885,15
STAT,1882,47,30-34,1929,9.233519032891236E-4
STAT,1829,38,30-34,1867,0.04840960234197586
STAT,1801,92,na,1893,0.1509373194054685
STAT,1850,33,20-24,1883,0.024916510354697774
SIM,1872,49,na,1921,20
STAT,1833,36,25-29,1869,0.02692870932931085
STAT,1855,37,15-19,1892,3.9536732031358754E-4
STAT,1948,17,50-100,1965,0.004259278451763587
STAT,1939,30,25-29,1969,0.09376300680051748
STAT,1831,39,25-29,1870,0.02882772118082079
STAT,1851,18,45-49,1869,6.665407658302672E-4
STAT,1880,49,50-100,1929,0.002528691378098209
SIM,1897,17,na,1914,41
STAT,1896,29,30-34,1925,0.32840921904716763
SIM,1910,39,50-100,1949,1
STAT,1843,41,35-39,1884,0.008010801678414349
STAT,1895,45,45-49,1940,0.0017455150589674772
STAT,1927,28,15-19,1955,0.008508476945438317
STAT,1877,21,50-100,1898,0.004222170318976908
STAT,1932,35,50-100,1967,0.005628073343763248
STAT,1895,30,50-100,1925,0.011990821180514897
STAT,1949,17,40-44,1966,0.01616352359234814
STAT,1864,15,20-24,1879,0.18291055819238305
STAT,1817,53,30-34,1870,1.6222711017921707E-4
STAT,1829,49,40-44,1878,0.0014242083485189823
SIM,1868,20,na,1888,34
STAT,1862,18,20-24,1880,0.17414822423132043
STAT,1884,44,30-34,1928,0.011111855460253459
SIM,1818,61,na,1879,21
STAT,1830,43,20-24,1873,7.629624824820539E-4
STAT,1853,15,45-49,1868,4.997218927990357E-4
STAT,1855,41,na,1896,16.346371857249817
STAT,1900,46,35-39,1946,0.0010981949258838106
STAT,1805,82,na,1887,1.4160267130742594
SIM,1956,8,na,1964,47
STAT,1901,27,na,1928,33.3938796584071
STAT,1826,68,na,1894,10.679302562808186
SIM,1843,68,na,1911,17
SIM,1851,63,na,1914,15
STAT,1889,53,na,1942,25.939356677439324
STAT,1898,37,40-44,1935,0.059052550799785365
STAT,1861,23,25-29,1884,0.49102034347131984
STAT,1933,25,35-39,1958,0.19871012203571092
STAT,1950,22,30-34,1972,0.3388514549694563
STAT,1856,66,na,1922,11.873536072573415
STAT,1893,26,50-100,1919,0.008093415978289841
STAT,1917,42,40-44,1959,0.0025865404755480094
SIM,1936,1,na,1937,40
STAT,1841,30,45-49,1871,0.021144119040545365
SIM,1922,28,35-39,1950,1
SIM,1904,28,na,1932,31
STAT,1824,43,20-24,1867,0.002116653925664803
SIM,1898,29,30-34,1927,2
STAT,1851,35,na,1886,20.524735984431636
STAT,1868,91,na,1959,0.8974939225425433
STAT,1918,22,35-39,1940,0.1006340333385158
STAT,1805,49,25-29,1854,0.0011248739239482226
STAT,1846,88,na,1934,1.1125848075127147
STAT,1842,74,na,1916,8.326510050577497
STAT,1885,23,40-44,1908,0.020514335082481204
STAT,1914,17,25-29,1931,0.0888990482991911
SIM,1867,19,na,1886,16
STAT,1864,61,na,1925,16.760220043895515
STAT,1891,21,45-49,1912,0.008584511915886264
STAT,1834,54,45-49,1888,1.0107336128502588E-4
STAT,1855,25,na,1880,17.699080534650005
STAT,1857,36,40-44,1893,0.03292806326983782
STAT,1859,36,45-49,1895,0.015920829775188897
SIM,1926,31,na,1957,46
STAT,1874,34,20-24,1908,0.027187519938353354
SIM,1800,63,na,1863,9
STAT,1843,56,na,1899,8.651996529880646
SIM,1888,40,na,1928,36
STAT,1935,22,35-39,1957,0.12765283902559732
STAT,1933,22,30-34,1955,0.3796852771351028
SIM,1848,83,na,1931,3
STAT,1824,30,45-49,1854,0.03042348937957061
STAT,1840,26,15-19,1866,0.004464839686527742
STAT,1902,52,na,1954,30.202869555405023
STAT,1808,48,50-100,1856,0.0017477878339587775
STAT,1833,38,na,1871,19.617135695608106
STAT,1929,25,15-19,1954,0.00882630850289191
STAT,1928,32,45-49,1960,0.019579663410879557
SIM,1880,20,na,1900,32
STAT,1903,27,20-24,1930,0.16678993530817202
STAT,1859,45,35-39,1904,0.0011238372216257973
SIM,1884,34,na,1918,25
STAT,1873,38,na,1911,23.834238953547324
STAT,1860,71,na,1931,10.851564710497133
STAT,1869,52,40-44,1921,1.0146372019926924E-4
SIM,1916,13,na,1929,47
STAT,1868,28,40-44,1896,0.02888738615497784
SIM,1917,54,na,1971,33
SIM,1863,29,na,1892,14
STAT,1811,46,45-49,1857,0.009493250029054002
STAT,1879,26,20-24,1905,0.12183838124405533
STAT,1819,74,na,1893,5.696872794818591
STAT,1891,21,15-19,1912,0.040613272544188936
STAT,1930,36,50-100,1966,0.005455794672667697
STAT,1864,16,50-100,1880,5.024866758789161E-4
STAT,1810,50,40-44,1860,1.0319998541322767E-4
STAT,1905,38,35-39,1943,0.02192364275144901
SIM,1900,14,na,1914,39
STAT,1849,26,35-39,1875,0.08932986511896136
STAT,1890,17,15-19,1907,0.07208716017462176
STAT,1850,39,35-39,1889,0.06265721518019499
STAT,1891,32,25-29,1923,0.12571401743127897
STAT,1913,49,25-29,1962,5.104071621996405E-4
STAT,1892,17,na,1909,31.20153119903544
STAT,1905,27,25-29,1932,0.6105115995601759
STAT,1867,10,na,1877,25.98568815087606
STAT,1907,21,20-24,1928,1.011061873507154
SIM,1872,65,na,1937,15
STAT,1868,20,30-34,1888,0.17487979168310203
SIM,1854,12,na,1866,19
STAT,1863,34,15-19,1897,0.0012500790433471953
STAT,1818,44,35-39,1862,0.01833211809378067
STAT,1868,26,45-49,1894,0.01078178000103336
STAT,1871,44,20-24,1915,0.0015619940189872266
SIM,1810,81,na,1891,8
STAT,1871,47,50-100,1918,0.002437217219550346
STAT,1924,38,45-49,1962,0.007978335305955906
STAT,1815,40,45-49,1855,0.024108348506556087
STAT,1818,92,na,1910,0.10408307129221801
STAT,1926,32,40-44,1958,0.04704847701221071
STAT,1838,53,na,1891,16.44341381565775
STAT,1880,31,40-44,1911,0.045789238759157164
STAT,1876,34,25-29,1910,0.10313792451324827
STAT,1835,33,25-29,1868,0.05866939943105215
STAT,1924,32,30-34,1956,0.18261621430460476
STAT,1907,38,45-49,1945,0.0062626599140866625
STAT,1833,33,20-24,1866,0.02549942104084657
SIM,1898,27,35-39,1925,1
STAT,1790,99,na,1889,0.0022551673275196717
STAT,1862,1,na,1863,31.368132058847195
STAT,1924,21,20-24,1945,1.307483642948078
STAT,1896,38,15-19,1934,7.339518354150059E-4
STAT,1913,48,40-44,1961,0.0015217457159434765
STAT,1926,38,50-100,1964,0.005096696062568357
STAT,1844,22,40-44,1866,0.020322305713205965
STAT,1848,47,25-29,1895,3.707624491637307E-4
STAT,1885,24,25-29,1909,0.5617699601495133
STAT,1860,41,40-44,1901,0.018368738538241607
STAT,1809,56,na,1865,14.991512242792169
STAT,1882,31,45-49,1913,0.01678010655080134
STAT,1881,29,40-44,1910,0.02830036760911166
STAT,1879,38,15-19,1917,5.783225511350457E-4
STAT,1813,61,na,1874,15.49219005455748
STAT,1922,29,na,1951,41.77876084584299
STAT,1922,38,40-44,1960,0.016891964941330807
SIM,1846,25,20-24,1871,1
STAT,1885,35,35-39,1920,0.07050948422576336
STAT,1830,40,40-44,1870,0.012683393648852624
STAT,1887,70,na,1957,15.894213742479192
STAT,1918,9,na,1927,42.93731004734325
STAT,1812,46,50-100,1858,0.0027954115782659783
STAT,1820,36,15-19,1856,5.382353620210367E-4
STAT,1869,50,45-49,1919,1.4263751025671005E-4
STAT,1874,20,na,1894,24.1363720911164
STAT,1907,32,30-34,1939,0.14664626041826045
STAT,1937,22,45-49,1959,0.010887826992658464
SIM,1915,32,30-34,1947,2
STAT,1889,13,na,1902,31.569469251118804
STAT,1883,4,na,1887,27.24518322548767
STAT,1854,44,45-49,1898,0.009024508229881012
STAT,1859,38,40-44,1897,0.034620557697310546
STAT,1880,91,na,1971,2.2177624145738712
SIM,1930,7,na,1937,53
STAT,1838,25,20-24,1863,0.11750534656348093
STAT,1909,32,35-39,1941,0.08671557707805069
STAT,1891,34,20-24,1925,0.03289232165694087
STAT,1935,25,45-49,1960,0.02346562824918777
STAT,1855,25,20-24,1880,0.09598240481917451
STAT,1846,31,35-39,1877,0.09800169084794356
STAT,1865,45,35-39,1910,0.0012789065724001666
SIM,1859,83,na,1942,3
STAT,1936,18,15-19,1954,0.4307389012289919
STAT,1807,49,35-39,1856,0.002895321380496997
STAT,1948,24,40-44,1972,0.03832524022518856
SIM,1860,24,na,1884,23
STAT,1918,38,20-24,1956,0.00275057598542
SIM,1899,5,na,1904,31
SIM,1937,15,na,1952,41
STAT,1844,34,35-39,1878,0.09264859861901925
STAT,1940,18,35-39,1958,0.042289115180987255
SIM,1852,34,35-39,1886,1
SIM,1934,26,na,1960,46
STAT,1862,35,na,1897,20.519581314037982
SIM,1930,36,na,1966,49
STAT,1889,45,20-24,1934,1.4838453715532553E-4
STAT,1866,25,na,1891,22.128554525152722
STAT,1822,38,na,1860,10.19212164110161
STAT,1844,23,25-29,1867,0.5542782303597488
SIM,1877,40,na,1917,27
STAT,1798,79,na,1877,5.151582528352417
STAT,1861,20,20-24,1881,0.6040094050970546
STAT,1867,42,35-39,1909,0.01730743918244439
STAT,1839,41,45-49,1880,0.009689212311946867
SIM,1873,50,na,1923,27
STAT,1793,64,na,1857,4.4708482605199995
STAT,1799,104,na,1903,2.464148466606134E-4
STAT,1867,66,na,1933,15.684680706454175
STAT,1822,49,30-34,1871,5.179531090762203E-4
STAT,1942,15,35-39,1957,0.043555021195205774
STAT,1873,18,50-100,1891,4.967918027100925E-4
SIM,1878,2,na,1880,35
STAT,1847,51,45-49,1898,1.5576872228333956E-4
SIM,1891,44,na,1935,33
STAT,1915,42,50-100,1957,0.0011725416964516323
STAT,1872,35,25-29,1907,0.029738864162387517
SIM,1852,23,25-29,1875,1
STAT,1881,18,30-34,1899,0.015126624226345281
STAT,1887,41,50-100,1928,0.01158343030787075
STAT,1804,50,40-44,1854,3.0087614864502906E-4
STAT,1889,37,na,1926,28.84497534678181
STAT,1882,42,30-34,1924,0.01100420931901205
SIM,1890,22,na,1912,30
SIM,1957,4,na,1961,56
SIM,1942,21,na,1963,37
STAT,1830,33,na,1863,9.907461549506056
STAT,1805,66,na,1871,6.475368975301652
STAT,1861,22,40-44,1883,0.018002990167863893
SIM,1898,24,30-34,1922,2
STAT,1933,28,45-49,1961,0.022834738136228615
STAT,1844,41,na,1885,18.727666245336568
SIM,1865,55,na,1920,15
STAT,1868,23,35-39,1891,0.05629808398685861
STAT,1923,14,na,1937,46.054697946828654
STAT,1871,41,40-44,1912,0.022526757262618068
SIM,1786,82,na,1868,7
STAT,1885,23,na,1908,23.283037631014384
STAT,1863,47,20-24,1910,1.0575238521677166E-4
SIM,1883,49,na,1932,10
STAT,1938,17,35-39,1955,0.041119673941159465
STAT,1881,33,na,1914,22.610963551616337
STAT,1893,32,35-39,1925,0.1276898824597493
STAT,1866,26,35-39,1892,0.08916981177611585
STAT,1875,52,40-44,1927,1.0764204762745651E-4
STAT,1849,22,50-100,1871,0.003822918344473589
STAT,1838,37,15-19,1875,5.25909809602742E-4
SIM,1814,55,na,1869,22
STAT,1874,32,25-29,1906,0.10391034087197583
SIM,1935,5,na,1940,61
STAT,1801,76,na,1877,3.7348054248010683
STAT,1888,12,na,1900,30.179150819431058
STAT,1881,27,15-19,1908,0.004317176739985489
STAT,1847,15,15-19,1862,0.08006366053625162
SIM,1839,23,na,1862,24
STAT,1891,35,35-39,1926,0.08763492715540015
STAT,1908,16,40-44,1924,0.0027057238491780605
STAT,1865,44,20-24,1909,0.0014170544775017953
STAT,1867,33,50-100,1900,0.008731107181838522
STAT,1917,36,50-100,1953,0.004342057616352764
STAT,1866,15,25-29,1881,0.05420496107390014
STAT,1926,19,na,1945,44.62933073710564
STAT,1872,21,35-39,1893,0.059887153665756955
SIM,1946,11,na,1957,53
STAT,1914,28,35-39,1942,0.14956895373083948
SIM,1915,47,na,1962,31
STAT,1823,79,na,1902,4.020471063546019
STAT,1873,3,na,1876,31.565802643470786
STAT,1824,44,35-39,1868,0.023735547029563653
STAT,1842,98,na,1940,0.02437312068100029
SIM,1894,7,na,1901,32
STAT,1895,42,40-44,1937,0.0020253044896513485
SIM,1921,16,na,1937,42
STAT,1826,41,35-39,1867,0.01951912855761272
STAT,1944,28,15-19,1972,0.007571005090024182
STAT,1909,47,na,1956,33.56879055594955
STAT,1931,25,30-34,1956,0.5040620980685311
SIM,1825,71,na,1896,8
SIM,1876,55,na,1931,27
STAT,1850,20,45-49,1870,0.007560189982884985
STAT,1881,15,20-24,1896,0.1694784570848142
STAT,1866,24,15-19,1890,0.0301931973503409
STAT,1848,31,na,1879,16.51530537354471
STAT,1885,38,15-19,1923,5.517841214968761E-4
STAT,1821,48,50-100,1869,0.0034192524824884557
SIM,1894,12,na,1906,32
STAT,1861,5,na,1866,24.30516676314826
SIM,1871,24,na,1895,24
SIM,1895,32,35-39,1927,1
STAT,1850,10,na,1860,26.29885132496907
STAT,1906,42,na,1948,33.65253770621976
STAT,1927,16,20-24,1943,1.681229174986305
STAT,1948,20,25-29,1968,1.0543002157599877
STAT,1921,47,na,1968,41.092204630863264
SIM,1905,0,na,1905,40
SIM,1945,26,na,1971,39
STAT,1803,59,na,1862,11.095179548378159
SIM,1901,39,na,1940,38
SIM,1866,77,na,1943,10
STAT,1813,43,15-19,1856,4.5601632542840255E-4
STAT,1898,23,20-24,1921,0.9267575816661444
STAT,1806,54,50-100,1860,4.7003726910457806E-4
STAT,1928,26,na,1954,46.08416359442502
SIM,1904,44,na,1948,26
STAT,1855,28,30-34,1883,0.1834768671619891
SIM,1888,80,na,1968,16
STAT,1865,31,45-49,1896,0.015837108036239365
SIM,1827,38,na,1865,19
STAT,1916,25,35-39,1941,0.15495227181857188
STAT,1900,30,25-29,1930,0.14317402555250494
SIM,1927,32,na,1959,49
STAT,1834,105,na,1939,2.0720785242449337E-4
STAT,1844,27,40-44,1871,0.02864334856854683
SIM,1889,65,na,1954,22
STAT,1887,46,25-29,1933,6.304934725170815E-4
SIM,1963,0,na,1963,54
STAT,1864,27,15-19,1891,0.0040693619004014015
STAT,1868,51,na,1919,20.93687718725701
STAT,1905,35,30-34,1940,0.016759892578545668
SIM,1828,41,35-39,1869,1
STAT,1902,39,50-100,1941,0.0036993483827181322
STAT,1876,31,20-24,1907,0.027565693653327426
STAT,1924,5,na,1929,47.56930541011638
STAT,1887,35,15-19,1922,6.187524714347224E-4
STAT,1920,39,15-19,1959,2.0802142228363253E-4
STAT,1859,55,na,1914,16.434536620787863
SIM,1893,27,na,1920,36
STAT,1918,38,15-19,1956,2.003731102406909E-4
SIM,1875,14,na,1889,21
STAT,1863,20,na,1883,21.667424371629025
STAT,1860,44,45-49,1904,0.01200304081268496
STAT,1848,44,20-24,1892,0.0010131803379766406
SIM,1832,68,na,1900,18
SIM,1900,54,na,1954,28
SIM,1862,63,na,1925,19
STAT,1865,31,15-19,1896,0.0012933232104576128
STAT,1901,31,50-100,1932,0.012873133559544473
STAT,1917,45,45-49,1962,0.0022600718974429635
STAT,1880,34,15-19,1914,0.0014846713703511164
STAT,1900,49,45-49,1949,0.0018074586228880698
STAT,1854,41,35-39,1895,0.011118409549045914
STAT,1870,24,35-39,1894,0.057606096775662
STAT,1897,48,na,1945,29.506963040148122
STAT,1852,76,na,1928,8.108337228496111
STAT,1968,0,na,1968,49.147070477185075
STAT,1909,35,45-49,1944,0.006477435079872795
STAT,1835,30,20-24,1865,0.01600763400515334
STAT,1931,22,50-100,1953,0.008496259261627158
STAT,1880,34,45-49,1914,0.01818022030412852
STAT,1939,15,50-100,1954,0.0037336593799450718
STAT,1929,39,35-39,1968,0.030838451548168198
STAT,1834,23,na,1857,20.062944305348132
SIM,1843,12,na,1855,23
STAT,1873,51,50-100,1924,1.5428321137907615E-4
STAT,1937,30,15-19,1967,0.001264768396759574
SIM,1913,24,20-24,1937,1
STAT,1866,29,45-49,1895,0.01015260203887131
STAT,1818,37,40-44,1855,0.06005670106638433
STAT,1813,43,45-49,1856,0.04942076579857487
STAT,1877,29,20-24,1906,0.12023368446302399
STAT,1842,42,50-100,1884,0.008200654650569295
SIM,1822,66,na,1888,12
STAT,1944,28,20-24,1972,0.1957645586152677
STAT,1895,42,35-39,1937,0.0016305022325901768
STAT,1849,23,30-34,1872,0.16578610248044567
STAT,1852,47,45-49,1899,0.0020103853581415632
STAT,1901,70,na,1971,23.58174781626794
STAT,1831,34,25-29,1865,0.10572444700460197
STAT,1802,53,40-44,1855,1.5800371404305275E-4
STAT,1854,41,40-44,1895,0.01381056972960613
STAT,1894,16,45-49,1910,8.39224023451947E-4
SIM,1775,79,na,1854,3
STAT,1868,23,40-44,1891,0.02010364933013276
STAT,1905,24,20-24,1929,0.9883474068775887
STAT,1874,37,25-29,1911,0.029209207987183766
STAT,1887,32,35-39,1919,0.11053770927633695
STAT,1794,89,na,1883,0.4373269546805503
STAT,1876,27,na,1903,24.238621880579014
SIM,1846,17,na,1863,17
STAT,1884,78,na,1962,9.850568864678303
STAT,1855,39,40-44,1894,0.03051047964480066
STAT,1806,101,na,1907,0.002670055946664565
STAT,1831,23,15-19,1854,0.10785148973125748
STAT,1790,75,na,1865,2.4888028472297163
STAT,1885,28,40-44,1913,0.02947750975500776
STAT,1924,35,40-44,1959,0.017567739744821734
STAT,1883,26,40-44,1909,0.029189192808178503
SIM,1856,6,na,1862,23
STAT,1822,34,50-100,1856,0.006204333133590396
STAT,1840,43,50-100,1883,0.008525507518913181
STAT,1939,29,na,1968,37.36466006755952
STAT,1889,28,50-100,1917,0.00780438821484215
SIM,1895,34,na,1929,25
SIM,1826,40,na,1866,16
SIM,1874,27,25-29,1901,1
STAT,1850,34,35-39,1884,0.09238591833782549
STAT,1859,34,25-29,1893,0.08071294949731007
SIM,1908,18,na,1926,39
STAT,1857,22,20-24,1879,0.595558956726206
STAT,1881,73,na,1954,11.301982464099103
STAT,1867,100,na,1967,0.05529766093946436
STAT,1929,28,25-29,1957,0.819426955178848
STAT,1888,19,25-29,1907,0.0658661460101603
SIM,1829,45,na,1874,20
STAT,1929,20,15-19,1949,0.06739393413752959
STAT,1843,40,20-24,1883,7.116269482307508E-4
SIM,1865,22,20-24,1887,2
SIM,1850,23,20-24,1873,1
STAT,1874,37,30-34,1911,0.05406810869860766
STAT,1877,16,45-49,1893,6.759548694876258E-4
STAT,1894,25,35-39,1919,0.12449883349469368
STAT,1919,19,20-24,1938,1.477264501854799
SIM,1937,31,na,1968,40
STAT,1940,15,30-34,1955,0.12294428616766565
STAT,1856,27,50-100,1883,0.0048020352114021975
STAT,1857,51,na,1908,16.195908646356337
STAT,1871,31,50-100,1902,0.009172302702685051
STAT,1918,27,na,1945,39.506504076073384
SIM,1882,6,na,1888,34
SIM,1934,32,35-39,1966,1
STAT,1821,53,na,1874,14.64432417961808
SIM,1899,64,na,1963,25
STAT,1871,44,45-49,1915,0.014720095570946909
STAT,1907,23,40-44,1930,0.03038676009198121
STAT,1915,16,50-100,1931,7.792719684740039E-4
SIM,1852,88,na,1940,2
STAT,1892,18,30-34,1910,0.019639195102633254
STAT,1884,40,15-19,1924,1.3666732148572775E-4
STAT,1910,47,na,1957,34.06716038341577
STAT,1804,53,45-49,1857,3.907030025020903E-4
STAT,1874,48,40-44,1922,0.001714986220173478
STAT,1930,21,45-49,1951,0.014390102474566357
STAT,1867,44,25-29,1911,0.00606224104126389
STAT,1795,104,na,1899,1.6327476943518528E-4
STAT,1907,35,40-44,1942,0.013951999878810054
SIM,1927,19,20-24,1946,1
SIM,1937,25,20-24,1962,1
STAT,1842,23,20-24,1865,0.6474523142178916
STAT,1925,1,na,1926,50.13122832945807
STAT,1874,34,15-19,1908,0.001432344554614873
STAT,1808,71,na,1879,2.4412094434839244
STAT,1887,35,45-49,1922,0.021965710123672523
STAT,1844,37,15-19,1881,4.6350128810292894E-4
SIM,1826,56,na,1882,14
SIM,1895,50,na,1945,26
STAT,1882,44,20-24,1926,0.0015014310104066576
STAT,1874,22,20-24,1896,0.6991113297570023
STAT,1926,32,35-39,1958,0.10986723076122137
STAT,1845,66,na,1911,9.580814714461653
SIM,1880,28,30-34,1908,1
SIM,1925,46,na,1971,43
STAT,1846,45,25-29,1891,4.7146044924132154E-4
STAT,1855,28,25-29,1883,0.30821074886270244
STAT,1827,34,35-39,1861,0.08491444245604424
STAT,1941,21,20-24,1962,1.1411519613163796
SIM,1854,52,na,1906,17
STAT,1924,47,35-39,1971,0.0015249461875610016
STAT,1943,29,50-100,1972,0.010512919218232102
STAT,1922,32,na,1954,42.419604407564016
STAT,1870,33,na,1903,23.605304989081308
SIM,1864,73,na,1937,12
STAT,1909,20,40-44,1929,0.03126019538357248
STAT,1881,18,25-29,1899,0.053780108593881826
SIM,1824,30,na,1854,16
STAT,1846,34,15-19,1880,0.0013358402883246754
SIM,1883,65,na,1948,6
SIM,1884,10,na,1894,26
SIM,1895,53,na,1948,26
STAT,1941,24,na,1965,37.43928081691601
STAT,1953,12,na,1965,47.24373745878541
STAT,1860,43,30-34,1903,0.009278972025789338
SIM,1850,78,na,1928,2
STAT,1829,33,na,1862,19.18336537089146
STAT,1919,42,45-49,1961,0.0017879312530695302
SIM,1899,67,na,1966,22
STAT,1839,54,na,1893,11.555630951938532
STAT,1914,25,30-34,1939,0.394383485288404
STAT,1944,15,45-49,1959,0.005339672441763657
STAT,1876,33,40-44,1909,0.04385980410341636
STAT,1853,24,35-39,1877,0.04271290668999098
STAT,1888,68,na,1956,18.135432587517023
SIM,1815,44,35-39,1859,1
STAT,1882,31,15-19,1913,0.0013703323375987102
STAT,1898,35,20-24,1933,0.010497516423799778
STAT,1885,37,50-100,1922,0.012124141601193609
STAT,1925,15,35-39,1940,0.050606082771508146
STAT,1874,35,35-39,1909,0.07243563875433583
STAT,1920,46,na,1966,40.364997275697256
STAT,1781,82,na,1863,2.3614024800925497
STAT,1831,23,45-49,1854,0.022796793775648055
STAT,1899,15,na,1914,34.73450684993945
SIM,1833,27,30-34,1860,1
SIM,1862,87,na,1949,4
SIM,1874,91,na,1965,2
SIM,1831,27,na,1858,11
STAT,1819,58,na,1877,11.379216959074537
STAT,1815,44,na,1859,11.155682129829806
STAT,1877,12,na,1889,26.738307640986243
STAT,1809,54,40-44,1863,3.307977841466484E-4
STAT,1833,33,15-19,1866,0.001343408922789028
SIM,1887,79,na,1966,9
STAT,1880,33,50-100,1913,0.009594149576032506
STAT,1938,19,30-34,1957,0.11936285121289932
STAT,1859,48,45-49,1907,0.0018521987678532948
STAT,1870,28,20-24,1898,0.11612868079964107
STAT,1917,15,50-100,1932,8.026122244099749E-4
STAT,1844,25,na,1869,20.985290501040314
STAT,1896,63,na,1959,24.38986559946769
STAT,1876,45,40-44,1921,0.00175612046978389
SIM,1927,16,na,1943,42
STAT,1841,43,20-24,1884,0.0015947421826866138
STAT,1883,29,45-49,1912,0.010704887209845587
STAT,1846,34,45-49,1880,0.01635774166449353
STAT,1869,76,na,1945,9.179786242598025
STAT,1946,24,30-34,1970,0.31736289527212985
STAT,1822,49,25-29,1871,3.082034999509665E-4
SIM,1948,15,na,1963,37
STAT,1868,35,na,1903,23.016391409131284
STAT,1911,21,35-39,1932,0.08899250050222962
STAT,1852,32,40-44,1884,0.038428886449152704
STAT,1854,40,na,1894,14.269654443221176
STAT,1928,42,na,1970,47.11429083941588
SIM,1874,72,na,1946,17
STAT,1858,16,35-39,1874,0.0049062885446643865
SIM,1905,29,na,1934,37
STAT,1815,40,15-19,1855,2.224530583543495E-4
STAT,1867,50,na,1917,20.90106768097523
SIM,1871,31,35-39,1902,2
STAT,1835,32,40-44,1867,0.025117305118330928
STAT,1820,90,na,1910,0.4469667532856775
STAT,1906,40,50-100,1946,0.0010765719387573975
STAT,1840,22,50-100,1862,0.0040636106381398245
SIM,1885,35,na,1920,24
SIM,1923,42,na,1965,38
STAT,1807,49,na,1856,14.599976970422606
STAT,1907,43,na,1950,33.679389472050346
STAT,1869,17,na,1886,24.81051498017838
STAT,1882,42,25-29,1924,0.006146495320452382
SIM,1885,75,na,1960,13
STAT,1858,31,50-100,1889,0.007044895614650171
STAT,1907,21,15-19,1928,0.04840221600046192
STAT,1835,44,40-44,1879,0.011896936119689724
SIM,1840,63,na,1903,6
STAT,1861,34,40-44,1895,0.03615761646675091
STAT,1831,27,30-34,1858,0.275342866889925
STAT,1852,33,25-29,1885,0.08982507111267855
STAT,1799,80,na,1879,2.901371276605996
STAT,1847,51,50-100,1898,1.6210507682185485E-4
STAT,1809,96,na,1905,0.047510996214909396
STAT,1847,15,20-24,1862,0.23917751724208575
STAT,1898,38,25-29,1936,0.008341776540890787
SIM,1818,45,na,1863,25
STAT,1887,23,45-49,1910,0.007587799959255194
STAT,1863,22,45-49,1885,0.006297111079162098
STAT,1937,35,15-19,1972,1.9114330596178318E-4
SIM,1897,60,na,1957,37
STAT,1927,19,25-29,1946,0.5331948322350621
SIM,1836,58,na,1894,4
STAT,1844,22,na,1866,20.852050137155786
STAT,1955,15,20-24,1970,1.7905862791157483
STAT,1826,42,40-44,1868,0.023810313723849546
STAT,1962,3,na,1965,50.09869369036605
STAT,1862,101,na,1963,0.017215854086497506
STAT,1929,25,20-24,1954,0.22822311803059425
STAT,1933,13,na,1946,52.742771112124814
STAT,1862,18,15-19,1880,0.058295380220604036
STAT,1878,40,45-49,1918,0.0156074878806987
STAT,1883,24,20-24,1907,0.6650071682903688
STAT,1831,38,40-44,1869,0.04429370847243982
STAT,1900,46,40-44,1946,0.0013429355062695256
STAT,1911,47,25-29,1958,4.989447074648722E-4
STAT,1841,30,15-19,1871,0.0017267154999032017
SIM,1950,13,na,1963,60
STAT,1946,25,20-24,1971,0.20207863945621854
STAT,1870,17,40-44,1887,0.0018342462611148562
SIM,1817,60,na,1877,4
STAT,1851,51,na,1902,18.264680656652754
SIM,1842,67,na,1909,18
STAT,1850,31,50-100,1881,0.008623087683969268
STAT,1872,28,30-34,1900,0.25674675398466656
STAT,1855,65,na,1920,11.898515985418667
STAT,1891,32,na,1923,29.28871793851055
STAT,1818,89,na,1907,0.262531742799205
STAT,1833,78,na,1911,5.784543811081348
STAT,1928,21,50-100,1949,0.008199922923616387
STAT,1902,34,45-49,1936,0.013999346022305402
STAT,1857,37,25-29,1894,0.02155390145417248
STAT,1873,30,50-100,1903,0.009390279457160743
STAT,1796,69,na,1865,1.3743188999294917
SIM,1851,47,na,1898,17
STAT,1896,43,50-100,1939,9.566776156526589E-4
STAT,1890,53,na,1943,25.735355601295137
STAT,1868,35,35-39,1903,0.06909792297064443
SIM,1848,43,na,1891,31
SIM,1857,17,na,1874,23
STAT,1872,39,40-44,1911,0.04433852003311113
SIM,1894,49,na,1943,29
STAT,1846,22,45-49,1868,0.006972911233228167
STAT,1843,43,25-29,1886,0.0027689512773343005
STAT,1899,48,50-100,1947,0.0018726752966400151
STAT,1899,17,35-39,1916,0.007511463974617799
STAT,1902,46,45-49,1948,0.0018826219744851453
SIM,1812,45,na,1857,18
STAT,1907,64,na,1971,28.86372447947223
STAT,1826,43,25-29,1869,0.006678685350026939
STAT,1903,50,na,1953,31.05306207656009
STAT,1866,26,40-44,1892,0.02768326770830083
SIM,1896,16,na,1912,31
STAT,1776,92,na,1868,0.07474048800193009
STAT,1911,36,15-19,1947,1.851707175097324E-4
STAT,1929,36,30-34,1965,0.023308131599797825
STAT,1837,32,45-49,1869,0.010670588312747484
SIM,1887,39,na,1926,24
SIM,1861,22,na,1883,26
STAT,1842,15,na,1857,22.378435815946332
STAT,1859,30,30-34,1889,0.14079430100857265
STAT,1915,31,20-24,1946,0.02472802986885947
STAT,1893,34,25-29,1927,0.12804097663798636
STAT,1872,24,15-19,1896,0.03354332103111421
STAT,1841,41,25-29,1882,0.006615668086274249
SIM,1872,25,na,1897,26
STAT,1816,38,45-49,1854,0.029921159122922904
STAT,1881,40,50-100,1921,0.010154032945915242
STAT,1853,36,50-100,1889,0.007796672251205033
STAT,1926,22,50-100,1948,0.007948170225439529
STAT,1827,69,na,1896,8.893572068778314
SIM,1931,21,na,1952,59
STAT,1841,49,35-39,1890,0.0013417291179199909
STAT,1915,42,30-34,1957,0.0012760012607033043
STAT,1897,17,50-100,1914,6.505902972385332E-4
STAT,1851,17,30-34,1868,0.016359958146296306
STAT,1833,21,20-24,1854,0.6908004027112405
STAT,1930,34,20-24,1964,0.031290653637592133
STAT,1859,45,40-44,1904,0.001374292370704556
STAT,1913,21,45-49,1934,0.010844453480685665
SIM,1928,23,20-24,1951,4
STAT,1908,19,15-19,1927,0.08710633184779543
SIM,1938,16,na,1954,38
STAT,1891,37,30-34,1928,0.06541330826532013
STAT,1861,10,na,1871,23.36369430938046
STAT,1831,74,na,1905,9.005864457670521
SIM,1913,9,na,1922,47
STAT,1857,91,na,1948,0.4338020133171308
SIM,1840,60,na,1900,8
STAT,1878,50,na,1928,22.54913105786726
SIM,1916,32,na,1948,44
STAT,1876,48,45-49,1924,0.002366806539621638
STAT,1865,24,na,1889,21.341797111400723
SIM,1878,65,na,1943,19
STAT,1915,45,35-39,1960,0.0012940179484163747
STAT,1879,75,na,1954,10.655035436929719
STAT,1875,61,na,1936,19.20849299092134
SIM,1874,51,na,1925,25
STAT,1838,28,25-29,1866,0.41464114291515364
STAT,1840,19,20-24,1859,0.17775001909352964
STAT,1917,42,na,1959,38.40575362567988
STAT,1909,23,45-49,1932,0.010366671038907933
STAT,1855,24,15-19,1879,0.026747139190432846
STAT,1868,24,25-29,1892,0.5505236332369841
STAT,1888,16,20-24,1904,0.20768409523401124
STAT,1876,86,na,1962,3.837125137067003
STAT,1892,16,40-44,1908,0.0022651479766306643
STAT,1904,36,50-100,1940,0.003815400106096331
STAT,1912,17,15-19,1929,0.0910523546697907
STAT,1905,57,na,1962,30.412902520245687
STAT,1824,43,15-19,1867,1.8405687304235828E-4
STAT,1887,27,na,1914,26.049085863437785
STAT,1831,36,20-24,1867,0.007966226885009971
STAT,1891,48,40-44,1939,0.0011703851345966864
STAT,1833,40,50-100,1873,0.009723464664068645
STAT,1885,23,35-39,1908,0.05744816478056127
SIM,1841,21,20-24,1862,2
SIM,1896,16,20-24,1912,1
STAT,1850,33,15-19,1883,0.0013126989150713244
STAT,1824,46,30-34,1870,0.001269257204396191
STAT,1853,28,20-24,1881,0.07716764474325742
SIM,1829,25,20-24,1854,1
STAT,1856,8,na,1864,21.034957856480478
SIM,1861,25,na,1886,25
STAT,1889,33,20-24,1922,0.03295474670783454
STAT,1851,15,40-44,1866,0.0018996847028855915
STAT,1940,24,50-100,1964,0.006650854942683763
STAT,1896,36,25-29,1932,0.03800131766553753
STAT,1846,38,30-34,1884,0.044639060399043085
STAT,1864,21,na,1885,21.709654623384637
STAT,1845,18,15-19,1863,0.04358732040930245
STAT,1878,53,na,1931,21.872759817739404
STAT,1862,45,50-100,1907,0.002140074951278067
STAT,1885,35,40-44,1920,0.04363903470962064
STAT,1820,36,45-49,1856,0.01910735307941521
SIM,1946,15,15-19,1961,1
STAT,1803,56,na,1859,11.774371008852986
STAT,1877,48,50-100,1925,0.0025033778597905922
STAT,1865,47,30-34,1912,8.714619185274926E-4
STAT,1922,24,15-19,1946,0.06021830774460859
STAT,1899,12,na,1911,35.352835823574914
STAT,1839,29,50-100,1868,0.004383603454177743
STAT,1848,45,35-39,1893,9.144059129958934E-4
STAT,1872,24,45-49,1896,0.007090121555131845
STAT,1823,52,50-100,1875,1.0152031142175766E-4
STAT,1842,28,45-49,1870,0.010227782330311328
STAT,1860,51,50-100,1911,1.2336869326613496E-4
STAT,1870,34,50-100,1904,0.009023952060279176
STAT,1877,28,na,1905,24.548434294796817
SIM,1886,17,na,1903,30
STAT,1891,34,15-19,1925,0.001732895752197601
STAT,1895,40,45-49,1935,0.01962626723752739
STAT,1810,53,45-49,1863,1.340491694774307E-4
STAT,1856,41,15-19,1897,1.0049568191863758E-4
STAT,1890,21,50-100,1911,0.004968396784745688
SIM,1884,50,na,1934,20
SIM,1839,47,na,1886,21
SIM,1835,33,na,1868,20
STAT,1887,39,30-34,1926,0.057587271087622585
STAT,1887,48,20-24,1935,1.2933515372787397E-4
STAT,1920,27,20-24,1947,0.19853705250208403
STAT,1941,24,25-29,1965,0.9469978706216866
STAT,1829,45,25-29,1874,5.045507948408367E-4
SIM,1906,14,na,1920,29
STAT,1830,89,na,1919,0.3774490058964859
STAT,1866,28,30-34,1894,0.231104290625482
STAT,1842,26,25-29,1868,0.39532459644957174
STAT,1938,15,15-19,1953,0.4467951372190734
SIM,1862,66,na,1928,17
STAT,1863,76,na,1939,8.388289339063284
STAT,1831,36,50-100,1867,0.012687930892333728
STAT,1871,44,15-19,1915,1.3582557420451137E-4
SIM,1864,14,na,1878,23
STAT,1896,25,15-19,1921,0.005999977698758054
SIM,1911,54,na,1965,38
STAT,1892,57,na,1949,24.82713498983612
STAT,1867,41,20-24,1908,0.0015266547191822813
STAT,1865,42,25-29,1907,0.005801078207670582
STAT,1864,18,25-29,1882,0.05226887261707301
STAT,1829,34,15-19,1863,0.001323268776636953
STAT,1844,22,35-39,1866,0.056910407412141754
STAT,1897,46,30-34,1943,7.271656709590952E-4
STAT,1857,39,45-49,1896,0.01477320428464473
STAT,1852,35,45-49,1887,0.017513760783597284
SIM,1915,1,na,1916,42
STAT,1948,22,15-19,1970,0.06071665806130537
STAT,1840,24,25-29,1864,0.5622873535579479
STAT,1842,16,50-100,1858,4.748122149613248E-4
SIM,1827,41,na,1868,18
STAT,1875,16,35-39,1891,0.005654265607367023
SIM,1829,85,na,1914,5
STAT,1932,31,na,1963,50.102504600647904
SIM,1796,81,na,1877,2
SIM,1888,24,na,1912,36
STAT,1850,47,40-44,1897,0.001517198323705916
STAT,1826,40,20-24,1866,0.0017441962486586934
STAT,1887,20,40-44,1907,0.02288064397602105
STAT,1849,24,15-19,1873,0.030484882680375445
SIM,1866,40,na,1906,28
SIM,1891,27,25-29,1918,1
STAT,1832,37,na,1869,12.147294416845947
STAT,1863,42,50-100,1905,0.009342283729116397
STAT,1886,19,15-19,1905,0.06122697788884054
STAT,1868,39,20-24,1907,0.007384773788827093
STAT,1790,96,na,1886,0.00982972481432385
STAT,1931,17,25-29,1948,0.5647023760124025
SIM,1838,22,na,1860,13
STAT,1861,37,45-49,1898,0.016764336508793134
STAT,1935,4,na,1939,54.932573659083204
STAT,1894,18,40-44,1912,0.0023379292934956786
SIM,1900,33,30-34,1933,1
STAT,1931,28,35-39,1959,0.19288044884574373
STAT,1848,32,20-24,1880,0.020385575135933053
STAT,1879,29,25-29,1908,0.4346947263118771
SIM,1922,25,30-34,1947,2
STAT,1910,40,35-39,1950,0.0019128940855198814
STAT,1879,52,50-100,1931,1.5548282275135774E-4
STAT,1819,55,na,1874,12.075795770782321
STAT,1815,41,na,1856,11.588277242766225
STAT,1833,34,35-39,1867,0.09454724583843331
SIM,1876,39,na,1915,27
STAT,1849,19,40-44,1868,0.001725205347314296
STAT,1875,22,50-100,1897,0.004191849566407015
STAT,1846,44,50-100,1890,0.008446215077627118
STAT,1846,49,40-44,1895,0.0013584839661588462
STAT,1878,42,35-39,1920,0.018672142512424793
SIM,1930,4,na,1934,55
STAT,1914,19,50-100,1933,7.644577788012961E-4
STAT,1827,27,40-44,1854,0.08825251214899765
STAT,1905,23,30-34,1928,0.2562798769607806
STAT,1841,34,30-34,1875,0.20308891875297627
STAT,1930,24,na,1954,46.27164915934979
SIM,1875,54,na,1929,13
SIM,1871,40,na,1911,24
STAT,1830,43,45-49,1873,0.007190091973889038
STAT,1894,29,20-24,1923,0.1492747533662941
STAT,1866,65,na,1931,15.564243013932995
STAT,1857,34,20-24,1891,0.020062068296810308
STAT,1921,29,50-100,1950,0.010928021630319158
STAT,1852,30,20-24,1882,0.02445521248309553
STAT,1911,44,20-24,1955,1.654147441760417E-4
STAT,1908,19,45-49,1927,9.587926716710913E-4
STAT,1827,38,20-24,1865,0.006217911620126047
STAT,1851,54,45-49,1905,1.1914911331863023E-4
SIM,1873,10,na,1883,30
SIM,1815,56,na,1871,10
STAT,1837,41,35-39,1878,0.010538601706322374
STAT,1877,68,na,1945,15.774988149906644
STAT,1883,27,25-29,1910,0.41078125688067946
STAT,1899,21,50-100,1920,0.0055992337287996685
STAT,1826,45,45-49,1871,0.0024405514363567246
STAT,1845,47,50-100,1892,0.00142895885433262
STAT,1933,25,40-44,1958,0.06169067081217212
STAT,1822,78,na,1900,2.771509076813423
STAT,1856,10,na,1866,20.705170459900735
STAT,1904,44,20-24,1948,1.5589050179071206E-4
STAT,1893,31,20-24,1924,0.034221537361091736
STAT,1913,45,50-100,1958,0.0021994543400057002
STAT,1856,41,45-49,1897,0.010891218763282742
STAT,1893,36,45-49,1929,0.02525640068908965
SIM,1906,54,na,1960,22
STAT,1902,31,40-44,1933,0.06140571835077929
SIM,1902,40,na,1942,31
STAT,1850,36,30-34,1886,0.04870727584431939
STAT,1915,34,25-29,1949,0.09252071469886343
SIM,1846,28,25-29,1874,1
STAT,1908,46,na,1954,33.3012851316013
STAT,1904,32,na,1936,34.48408525325528
SIM,1899,27,na,1926,27
STAT,1859,33,35-39,1892,0.08015195623837355
STAT,1880,32,na,1912,25.0933277102507
STAT,1788,77,na,1865,3.993208359260321
STAT,1911,32,na,1943,36.59091525646677
STAT,1924,23,40-44,1947,0.03929550982338746
STAT,1872,37,20-24,1909,0.00788709613416488
STAT,1835,47,45-49,1882,0.0011264408266590217
STAT,1841,45,40-44,1886,0.0017270177729492005
STAT,1889,46,35-39,1935,0.0017189309309308706
STAT,1817,48,na,1865,22.687552715745117
STAT,1922,34,25-29,1956,0.10315894636951495
STAT,1918,25,45-49,1943,0.01834281394215459
STAT,1861,37,15-19,1898,4.722348873938799E-4
STAT,1913,46,20-24,1959,1.0722770192853367E-4
STAT,1940,7,na,1947,40.133192959932394
SIM,1836,55,na,1891,4
SIM,1873,4,na,1877,31
STAT,1859,22,25-29,1881,0.472075631023638
STAT,1881,25,25-29,1906,0.4052471972802258
STAT,1852,36,na,1888,20.48460306082642
STAT,1941,21,50-100,1962,0.006752778757678162
SIM,1915,28,na,1943,36
STAT,1849,27,25-29,1876,0.38881504829285396
STAT,1842,24,35-39,1866,0.054432330367127704
STAT,1864,42,50-100,1906,0.00946389276145666
SIM,1893,8,na,1901,39
STAT,1924,26,45-49,1950,0.02005294475762565
SIM,1957,14,na,1971,56
STAT,1817,52,40-44,1869,2.926865620805138E-4
STAT,1898,49,40-44,1947,0.0012755440892687632
STAT,1854,62,na,1916,11.171732809895724
STAT,1880,38,30-34,1918,0.055765365146435576
STAT,1896,26,15-19,1922,0.00597999777302119
STAT,1943,20,40-44,1963,0.03553701733529428
STAT,1930,37,25-29,1967,0.012782819436522814
SIM,1919,6,na,1925,47
STAT,1833,24,25-29,1857,0.5615757770442261
SIM,1872,5,na,1877,27
STAT,1878,90,na,1968,2.406983987003387
STAT,1850,72,na,1922,11.244372982106569
SIM,1874,35,na,1909,25
SIM,1879,1,na,1880,32
STAT,1889,49,30-34,1938,6.545667472420994E-4
STAT,1897,30,45-49,1927,0.023343321623800067
STAT,1911,33,40-44,1944,0.03770120812412945
STAT,1925,19,15-19,1944,0.541876044876025
STAT,1815,44,30-34,1859,0.016940994728196792
SIM,1885,13,na,1898,26
STAT,1866,24,20-24,1890,0.6306982035681086
STAT,1906,15,30-34,1921,0.023263573663871866
STAT,1848,68,na,1916,9.882849876279366
STAT,1887,67,na,1954,17.30277532281484
STAT,1820,37,20-24,1857,0.007268175453588757
STAT,1882,35,30-34,1917,0.05156074908951719
STAT,1829,73,na,1902,8.067833835898549
SIM,1824,76,na,1900,10
STAT,1836,27,15-19,1863,0.0056657741541069504
STAT,1865,49,45-49,1914,0.002090021515149438
STAT,1908,27,50-100,1935,0.00943992097306418
STAT,1829,35,15-19,1864,5.269681112549958E-4
STAT,1891,72,na,1963,17.84157052881723
STAT,1844,21,35-39,1865,0.05732197922296261
STAT,1939,31,30-34,1970,0.15974210827891955
STAT,1919,33,50-100,1952,0.008805487804624737
SIM,1902,18,na,1920,35
STAT,1809,45,50-100,1854,0.008633407427207893
STAT,1866,101,na,1967,0.030423357228544005
STAT,1849,16,na,1865,22.038543106860725
STAT,1944,15,50-100,1959,0.004004754331322744
STAT,1909,36,20-24,1945,0.00249309690201628
STAT,1900,30,30-34,1930,0.2440568770353511
STAT,1855,24,45-49,1879,0.005653598459624569
STAT,1813,47,30-34,1860,0.003000200341587084
SIM,1877,18,na,1895,29
STAT,1932,34,25-29,1966,0.12221232630520902
STAT,1838,35,25-29,1873,0.027530672861046795
SIM,1882,30,na,1912,29
STAT,1835,21,25-29,1856,0.5052991914401466
STAT,1931,16,35-39,1947,0.05481440919289175
STAT,1871,58,na,1929,19.716653940091508
STAT,1822,75,na,1897,3.651662693132058
STAT,1900,23,25-29,1923,0.7913616984401377
STAT,1813,80,na,1893,4.082460460266968
STAT,1902,31,35-39,1933,0.1433941469848788
SIM,1833,53,na,1886,11
STAT,1875,17,25-29,1892,0.05825069119780695
STAT,1840,29,30-34,1869,0.24251282000186425
SIM,1831,40,na,1871,9
STAT,1950,16,45-49,1966,0.005871698856839783
SIM,1839,44,na,1883,21
STAT,1879,36,25-29,1915,0.029943407616659548
STAT,1898,30,20-24,1928,0.03675739094633399
STAT,1886,15,35-39,1901,0.005718018982737749
STAT,1901,26,35-39,1927,0.13547779774261112
STAT,1942,16,50-100,1958,0.003887868247519274
STAT,1862,91,na,1953,0.49995326744687163
STAT,1856,17,15-19,1873,0.05083507301180181
STAT,1873,35,na,1908,24.18053104293907
STAT,1831,29,20-24,1860,0.12527606831454996
STAT,1833,37,30-34,1870,0.049331843064176935
SIM,1952,19,25-29,1971,1
STAT,1913,47,35-39,1960,0.0012478873553724197
STAT,1889,36,25-29,1925,0.03542058839468405
STAT,1880,30,35-39,1910,0.10734746965046744
STAT,1854,48,30-34,1902,5.842410775584836E-4
STAT,1857,22,15-19,1879,0.02851098831813245
SIM,1844,13,na,1857,13
STAT,1852,37,40-44,1889,0.037668065309640036
SIM,1827,59,na,1886,8
SIM,1848,80,na,1928,6
STAT,1847,19,30-34,1866,0.02100090969267534
STAT,1811,49,50-100,1860,0.009426597083002955
STAT,1844,78,na,1922,6.102951120781781
STAT,1857,11,na,1868,21.10044004641044
SIM,1800,82,na,1882,4
STAT,1898,21,50-100,1919,0.00551770443402819
STAT,1820,74,na,1894,6.291667021858143
STAT,1876,49,20-24,1925,1.1933278564183265E-4
STAT,1947,19,35-39,1966,0.04691362642413801
STAT,1869,30,na,1899,23.307813294781848
STAT,1855,25,15-19,1880,0.0037120267354770193
STAT,1907,27,50-100,1934,0.009357110371959174
SIM,1825,58,na,1883,14
STAT,1863,0,na,1863,33.997010568019846
STAT,1915,44,35-39,1959,0.0020031107139997025
SIM,1806,73,na,1879,3
STAT,1874,25,50-100,1899,0.006533652063043375
STAT,1913,15,na,1928,39.34088422684187
SIM,1855,56,na,1911,11
STAT,1929,26,20-24,1955,0.2274631350475523
SIM,1933,19,15-19,1952,1
STAT,1940,29,na,1969,37.89180095725043
STAT,1842,77,na,1919,6.485352314002294
STAT,1884,43,40-44,1927,0.02187813117533594
STAT,1875,38,50-100,1913,0.01255788796041741
SIM,1894,71,na,1965,17
STAT,1885,22,35-39,1907,0.05762622983073826
STAT,1890,41,15-19,1931,1.6850742201253378E-4
STAT,1819,71,na,1890,6.851926110309903
SIM,1907,55,na,1962,34
STAT,1877,28,15-19,1905,0.004666909084922247
SIM,1962,1,na,1963,48
STAT,1867,46,45-49,1913,0.0022648390216209197
STAT,1920,26,45-49,1946,0.018854682431982808
STAT,1967,1,na,1968,48.864306059324626
SIM,1900,17,na,1917,36
SIM,1886,20,na,1906,28
STAT,1919,12,na,1931,43.40670218940254
STAT,1920,15,20-24,1935,0.30398113933003396
SIM,1867,41,na,1908,11
STAT,1922,31,20-24,1953,0.027469505816884458
STAT,1881,46,50-100,1927,0.0023436258273884353
STAT,1891,33,15-19,1924,0.001740484263586839
STAT,1924,20,30-34,1944,0.3389473460509803
STAT,1825,89,na,1914,0.566347087858953
STAT,1859,32,35-39,1891,0.0804916309208596
STAT,1876,41,25-29,1917,0.006551551316127685
STAT,1794,86,na,1880,0.8250449773403169
STAT,1862,97,na,1959,0.08283360737989644
STAT,1807,92,na,1899,0.17577442874952476
SIM,1890,81,na,1971,10
SIM,1920,37,na,1957,43
SIM,1929,26,30-34,1955,2
STAT,1920,37,25-29,1957,0.010688578924463265
STAT,1875,49,50-100,1924,0.002471913694080151
STAT,1944,19,25-29,1963,0.4626610665442892
SIM,1856,35,25-29,1891,1
STAT,1908,18,45-49,1926,9.614366223826433E-4
STAT,1896,25,45-49,1921,0.014683175400206663
STAT,1887,30,45-49,1917,0.019186951819307463
STAT,1897,18,15-19,1915,0.0786017098354366
STAT,1866,28,na,1894,21.902071170804323
STAT,1916,15,30-34,1931,0.025758419385378935
SIM,1852,26,na,1878,28
STAT,1798,76,na,1874,6.845927229347907
STAT,1829,34,45-49,1863,0.016203799952810457
STAT,1874,44,25-29,1918,0.006426692686967279
STAT,1946,4,na,1950,43.879266232590275
STAT,1832,53,na,1885,9.869122473244746
STAT,1907,20,30-34,1927,0.2621040351570887
STAT,1905,26,35-39,1931,0.13973522001822156
STAT,1864,25,25-29,1889,0.38346645171926624
STAT,1895,49,30-34,1944,6.940886226506274E-4
STAT,1902,9,na,1911,36.58916949260602
STAT,1903,37,na,1940,33.760014839499455
STAT,1850,38,45-49,1888,0.017844122279282868
STAT,1914,29,25-29,1943,0.6533315168994424
STAT,1938,26,30-34,1964,0.38579863982144713
SIM,1856,32,na,1888,12
SIM,1861,62,na,1923,20
STAT,1918,26,45-49,1944,0.018281732371727206
SIM,1819,46,na,1865,7
STAT,1915,22,na,1937,37.42223639402205
STAT,1807,100,na,1907,0.004480496436615822
STAT,1903,15,20-24,1918,0.2532234852526165
STAT,1927,16,45-49,1943,0.006194653046991516
STAT,1948,24,35-39,1972,0.10732566797114687
STAT,1921,10,na,1931,44.94804885504616
STAT,1848,48,30-34,1896,6.181395897547884E-4
STAT,1824,42,15-19,1866,1.8715546753920984E-4
STAT,1925,18,45-49,1943,0.0059809598600248795
STAT,1887,15,50-100,1902,5.372346749211362E-4
SIM,1836,18,na,1854,14
STAT,1917,30,40-44,1947,0.040932640866393755
STAT,1933,34,30-34,1967,0.21118329761555335
SIM,1936,12,na,1948,38
SIM,1869,82,na,1951,2
STAT,1926,44,40-44,1970,0.003055693234901309
STAT,1856,45,30-34,1901,7.082426582293994E-4
STAT,1933,15,30-34,1948,0.16325500297089923
STAT,1879,25,45-49,1904,0.011569712134324677
STAT,1837,74,na,1911,5.366097349391552
SIM,1851,8,na,1859,27
STAT,1906,41,20-24,1947,1.609458895361706E-4
STAT,1820,68,na,1888,8.570237107332991
STAT,1894,37,na,1931,30.194012289066716
SIM,1898,28,25-29,1926,1
SIM,1874,29,na,1903,21
STAT,1874,2,na,1876,33.27204047399907
SIM,1895,37,na,1932,27
STAT,1899,52,na,1951,29.3193271927231
STAT,1843,42,40-44,1885,0.009823830219534285
SIM,1920,15,na,1935,45
STAT,1814,40,na,1854,14.704682371357825
SIM,1840,23,na,1863,17
STAT,1841,48,45-49,1889,0.0022909355480095995
STAT,1833,28,50-100,1861,0.006197220203773269
SIM,1956,5,na,1961,47
STAT,1862,75,na,1937,8.88183468569057
STAT,1938,19,25-29,1957,0.4243740707939865
STAT,1940,23,na,1963,36.924378437375836
SIM,1902,25,20-24,1927,1
SIM,1804,56,na,1860,12
STAT,1892,29,50-100,1921,0.00784632581621494
STAT,1782,83,na,1865,0.9932935937112743
SIM,1862,10,na,1872,26
SIM,1870,45,na,1915,21
STAT,1855,35,25-29,1890,0.020464079743943348
STAT,1907,44,30-34,1951,0.0011520293910598745
STAT,1944,16,45-49,1960,0.0053383375236532166
SIM,1846,73,na,1919,3
STAT,1923,41,20-24,1964,2.05279424856568E-4
STAT,1886,44,50-100,1930,0.010810304144739038
SIM,1915,20,30-34,1935,1
STAT,1829,95,na,1924,0.09031021180027436
STAT,1856,104,na,1960,0.001225760611650533
STAT,1937,23,20-24,1960,1.0756295792120136
STAT,1879,38,na,1917,24.263651674172692
SIM,1832,48,45-49,1880,1
STAT,1883,43,na,1926,22.281890301864202
STAT,1838,24,45-49,1862,0.006921352383080041
STAT,1918,29,25-29,1947,0.6891722450655413
STAT,1899,18,25-29,1917,0.0773705080316672
STAT,1848,35,25-29,1883,0.019590683197689918
STAT,1891,39,45-49,1930,0.024221081298556293
SIM,1844,47,na,1891,3
SIM,1865,15,na,1880,23
STAT,1878,13,na,1891,26.62095097428576
STAT,1850,32,15-19,1882,0.0013264006336165834
STAT,1903,37,25-29,1940,0.008835352532129973
STAT,1868,21,20-24,1889,0.6717203751948966
SIM,1824,70,na,1894,11
STAT,1824,48,45-49,1872,0.003013721729383818
SIM,1787,67,na,1854,3
STAT,1904,47,25-29,1951,4.633928492581629E-4
STAT,1881,17,na,1898,24.032239369683467
STAT,1913,24,50-100,1937,0.0065476353281747075
STAT,1917,42,35-39,1959,0.0020823338128243113
STAT,1876,9,na,1885,26.925715843222164
STAT,1851,18,50-100,1869,4.999055743727005E-4
SIM,1837,37,na,1874,28
STAT,1821,53,45-49,1874,1.9309148643563363E-4
STAT,1877,25,35-39,1902,0.10027786430625926
STAT,1924,45,45-49,1969,0.0025827223823216864
STAT,1933,35,na,1968,51.123462708139556
STAT,1871,40,35-39,1911,0.01823598940526338
STAT,1941,31,30-34,1972,0.16431225567663718
STAT,1858,92,na,1950,0.31692900113611616
STAT,1923,15,30-34,1938,0.1427946946448121
STAT,1851,27,40-44,1878,0.02961046299536716
STAT,1854,46,na,1900,13.790858683078797
STAT,1910,16,35-39,1926,0.00828403429233501
STAT,1926,42,45-49,1968,0.0020400078718845337
STAT,1905,39,25-29,1944,0.008878745823357438
STAT,1850,56,na,1906,18.160185402313196
STAT,1936,24,na,1960,34.6782427843939
STAT,1932,31,20-24,1963,0.03231264308500678
STAT,1869,14,na,1883,25.5371247236937
STAT,1832,99,na,1931,0.008560446038409716
STAT,1924,2,na,1926,48.38652524493835
STAT,1900,33,35-39,1933,0.13983758485860612
SIM,1870,61,na,1931,19
STAT,1909,39,25-29,1948,0.009174088446234272
STAT,1874,60,na,1934,19.348173920732272
STAT,1912,29,15-19,1941,0.006853122355223774
STAT,1837,42,50-100,1879,0.006069587956288693
SIM,1902,24,na,1926,34
STAT,1835,40,25-29,1875,0.0035768976523729915
STAT,1874,25,25-29,1899,0.432055735908447
STAT,1918,22,40-44,1940,0.035935704621611206
STAT,1947,16,30-34,1963,0.13640245878256524
STAT,1922,36,20-24,1958,0.00298028114013566
SIM,1908,6,na,1914,42
STAT,1893,33,40-44,1926,0.05444992401248896
STAT,1857,32,25-29,1889,0.07715034543666445
STAT,1862,41,na,1903,20.030785497156828
STAT,1832,44,30-34,1876,0.00616335654695271
STAT,1911,36,45-49,1947,0.006573559689838491
STAT,1801,79,na,1880,2.810453241559461
STAT,1895,41,35-39,1936,0.0016398988530179695
STAT,1879,33,20-24,1912,0.02785886565691708
STAT,1857,29,na,1886,18.138650783721864
STAT,1909,22,30-34,1931,0.2656255543805346
STAT,1925,25,50-100,1950,0.011761920284758408
STAT,1903,26,45-49,1929,0.01583971970699791
STAT,1813,64,na,1877,13.852646191412708
STAT,1893,21,na,1914,29.910392687610052
STAT,1920,23,40-44,1943,0.03694740935448312
STAT,1913,44,30-34,1957,0.001232190963089869
SIM,1831,24,na,1855,11
STAT,1838,21,35-39,1859,0.05918653261984637
STAT,1884,46,45-49,1930,0.00231877940669103
SIM,1891,47,na,1938,33
STAT,1915,41,30-34,1956,0.001277841352250545
STAT,1828,91,na,1919,0.3891827300464666
SIM,1806,57,na,1863,7
STAT,1877,65,na,1942,17.44482492071791
STAT,1875,64,na,1939,17.86931914056458
STAT,1918,48,25-29,1966,5.578216915503139E-4
STAT,1900,20,20-24,1920,0.961298777378157
STAT,1838,32,20-24,1870,0.026069434306586786
STAT,1896,20,45-49,1916,0.009214221083718246
STAT,1836,43,na,1879,23.83081823669447
SIM,1886,14,na,1900,30
STAT,1865,43,15-19,1908,1.2400585211914418E-4
STAT,1873,19,40-44,1892,0.0018495894507170852
SIM,1849,22,na,1871,14
STAT,1880,69,na,1949,15.43199789114379
STAT,1867,43,40-44,1910,0.021369193232896627
SIM,1868,57,na,1925,31
SIM,1910,3,na,1913,34
STAT,1930,21,na,1951,46.703720723603645
STAT,1924,30,50-100,1954,0.00962657389904945
STAT,1806,54,30-34,1860,1.8525898927874605E-4
STAT,1857,35,35-39,1892,0.05345131645356617
SIM,1820,80,na,1900,1
STAT,1893,47,50-100,1940,0.0017386613380484144
STAT,1873,45,30-34,1918,9.939700969781343E-4
STAT,1880,22,50-100,1902,0.0042881326650858545
STAT,1933,37,35-39,1970,0.032810835421321516
STAT,1809,50,25-29,1859,1.2055656429353081E-4
STAT,1937,20,40-44,1957,0.03255859840974714
STAT,1836,24,35-39,1860,0.07326146145063613
STAT,1895,68,na,1963,21.871609367085554
STAT,1913,34,15-19,1947,0.0012569781058862342
STAT,1945,20,na,1965,39.76332422284368
STAT,1866,19,40-44,1885,0.0017086982423577743
STAT,1835,67,na,1902,7.130196502906669
STAT,1854,40,35-39,1894,0.011180011411925627
STAT,1898,33,25-29,1931,0.13758973166898186
STAT,1901,23,30-34,1924,0.24847159743883
STAT,1888,15,50-100,1903,5.751781333835917E-4
STAT,1838,105,na,1943,2.2757140312601194E-4
STAT,1924,39,na,1963,43.98072785526435
STAT,1895,46,50-100,1941,0.0018036944338306405
STAT,1906,18,35-39,1924,0.007950847340280117
SIM,1940,8,na,1948,37
STAT,1931,29,25-29,1960,0.845166998844412
SIM,1850,25,na,1875,21
STAT,1865,46,40-44,1911,0.0015528787580634015
STAT,1945,8,na,1953,42.765317277284616
SIM,1924,27,na,1951,51
STAT,1813,44,20-24,1857,0.005078552406945323
STAT,1903,53,na,1956,30.312534193213654
STAT,1824,58,na,1882,14.84007242028894
STAT,1908,15,40-44,1923,0.002711635213944459
STAT,1864,22,20-24,1886,0.6280313567178388
STAT,1889,50,na,1939,26.74147927148936
STAT,1878,21,45-49,1899,0.007221005542914406
STAT,1879,22,40-44,1901,0.02156762984648844
STAT,1878,30,35-39,1908,0.10539402382556476
STAT,1911,37,15-19,1948,1.842837497728608E-4
SIM,1826,31,35-39,1857,1
STAT,1870,92,na,1962,0.9182744028925873
STAT,1927,41,na,1968,46.40709587158057
STAT,1867,48,40-44,1915,0.0016177309785204322
STAT,1900,48,na,1948,30.81185879897108
STAT,1924,18,50-100,1942,0.004420896148619146
STAT,1865,86,na,1951,2.006841998489306
STAT,1930,15,50-100,1945,0.004843454993623878
STAT,1906,44,25-29,1950,6.391050737992056E-4
STAT,1857,44,25-29,1901,0.004742350457154565
STAT,1853,49,50-100,1902,0.0015113217159206534
STAT,1889,40,20-24,1929,0.0019640179750372126
STAT,1907,27,na,1934,34.908905836752325
STAT,1942,15,40-44,1957,0.014518341238996563
SIM,1845,78,na,1923,8
STAT,1875,53,40-44,1928,1.064805899335563E-4
STAT,1850,35,40-44,1885,0.04042379322183823
STAT,1862,54,45-49,1916,1.2176483866514054E-4
STAT,1936,18,20-24,1954,1.2867643108684372
STAT,1883,25,35-39,1908,0.09433464002379359
STAT,1886,85,na,1971,6.233842987429146
SIM,1859,46,na,1905,18
STAT,1866,38,40-44,1904,0.04011602605634538
STAT,1877,71,na,1948,13.778626931146743
SIM,1864,11,na,1875,23
SIM,1882,86,na,1968,11
STAT,1914,26,20-24,1940,0.1831189789444113
STAT,1885,39,20-24,1924,0.007535633034806961
STAT,1890,15,25-29,1905,0.06915372701083568
STAT,1807,47,30-34,1854,0.0020558706677101476
STAT,1907,23,35-39,1930,0.08509481754552595
STAT,1862,17,15-19,1879,0.058640774381712314
STAT,1841,73,na,1914,11.625899368002303
STAT,1898,22,45-49,1920,0.00940687404726699
STAT,1818,48,20-24,1866,1.1634165948901165E-4
SIM,1857,63,na,1920,17
SIM,1907,33,na,1940,40
STAT,1874,38,30-34,1912,0.053799930879462575
STAT,1857,21,45-49,1878,0.006070009588379322
STAT,1882,18,na,1900,24.1405748088569
STAT,1804,81,na,1885,2.481155601733038
STAT,1891,36,40-44,1927,0.05398647998740018
STAT,1898,36,35-39,1934,0.09587300348100324
STAT,1844,38,20-24,1882,0.006296882052236607
STAT,1876,22,25-29,1898,0.581412622138108
STAT,1893,38,40-44,1931,0.054921174940622514
STAT,1900,26,na,1926,33.2070560416644
STAT,1904,31,45-49,1935,0.025089178707755615
SIM,1882,64,na,1946,25
STAT,1868,46,50-100,1914,0.0023835305870888164
STAT,1935,26,20-24,1961,0.24783345133770784
STAT,1769,107,na,1876,3.89647053042711E-4
STAT,1842,21,na,1863,20.37991844682367
STAT,1915,56,na,1971,35.3321302725012
STAT,1810,50,na,1860,10.153132720664361
STAT,1881,15,15-19,1896,0.05673219545343887
STAT,1939,9,na,1948,39.488220059744314
STAT,1955,16,20-24,1971,1.7901386325459696
SIM,1819,40,na,1859,7
STAT,1933,18,35-39,1951,0.05579605373246694
STAT,1807,86,na,1893,0.9363915568164493
SIM,1837,43,na,1880,28
STAT,1824,45,40-44,1869,0.002274677294964958
STAT,1855,40,50-100,1895,0.007513212578970882
STAT,1861,30,25-29,1891,0.08682811793853935
STAT,1845,26,na,1871,15.502985764811926
STAT,1826,84,na,1910,2.3247065731479126
STAT,1826,47,40-44,1873,0.0017236042686996577
STAT,1774,88,na,1862,0.18402478675076125
STAT,1918,33,50-100,1951,0.008669566310479684
STAT,1918,37,45-49,1955,0.007120436208176044
STAT,1900,34,50-100,1934,0.01259663338601446
STAT,1879,22,35-39,1901,0.060397802237583446
SIM,1872,22,20-24,1894,1
STAT,1838,21,40-44,1859,0.02113509399598039
STAT,1898,23,15-19,1921,0.044366345743283596
STAT,1926,23,45-49,1949,0.013549373232577482
STAT,1907,47,35-39,1954,0.0011497737628256113
SIM,1833,37,40-44,1870,1
STAT,1948,21,30-34,1969,0.3279331427589012
STAT,1870,70,na,1940,13.937978958230387
STAT,1843,45,45-49,1888,0.001022291559302025
STAT,1833,47,40-44,1880,0.0014847155906866799
STAT,1848,39,40-44,1887,0.02857368351263622
STAT,1892,28,40-44,1920,0.03687715928110488
STAT,1890,47,na,1937,27.20652989704407
STAT,1916,25,40-44,1941,0.04810580102527356
STAT,1911,31,45-49,1942,0.015286364861414782
STAT,1880,35,20-24,1915,0.008182867905494134
STAT,1920,34,20-24,1954,0.026263051672145276
STAT,1847,29,40-44,1876,0.03791170067891161
STAT,1882,12,na,1894,24.749315567083542
SIM,1885,69,na,1954,14
STAT,1912,41,45-49,1953,0.0016017838899359464
STAT,1825,37,40-44,1862,0.045890780417892824
SIM,1897,63,na,1960,36
SIM,1791,66,na,1857,5
STAT,1863,100,na,1963,0.031428222360842174
STAT,1907,45,45-49,1952,0.0019666817491622514
STAT,1854,49,50-100,1903,0.0014698494398346683
STAT,1865,32,15-19,1897,0.00128805938499105
SIM,1878,19,na,1897,28
STAT,1877,32,50-100,1909,0.009458046031738318
STAT,1855,9,na,1864,20.40226478007343
STAT,1892,17,25-29,1909,0.07000719642136757
SIM,1878,81,na,1959,5
SIM,1869,0,na,1869,29
STAT,1899,15,20-24,1914,0.24381940959053622
STAT,1837,48,30-34,1885,4.8288921702510824E-4
STAT,1829,31,35-39,1860,0.09835965183957288
STAT,1859,52,na,1911,17.022635220139684
STAT,1876,44,35-39,1920,0.018143203128561967
STAT,1913,34,20-24,1947,0.023858866364067217
SIM,1810,59,na,1869,15
STAT,1926,22,30-34,1948,0.3471760377949939
SIM,1833,26,25-29,1859,1
SIM,1871,46,na,1917,23
STAT,1837,19,50-100,1856,4.2636950730481806E-4
STAT,1922,39,25-29,1961,0.01109784009965982
STAT,1928,19,30-34,1947,0.15201186067073216
SIM,1924,28,45-49,1952,1
STAT,1785,75,na,1860,11.39569669544479
SIM,1956,13,na,1969,47
STAT,1864,29,40-44,1893,0.026675868200906665
STAT,1923,18,35-39,1941,0.0488032851068788
STAT,1901,18,15-19,1919,0.08282276309184543
SIM,1852,20,20-24,1872,1
STAT,1879,91,na,1970,2.097757675957044
STAT,1922,34,30-34,1956,0.17584649304959493
STAT,1896,22,35-39,1918,0.07665113131124553
SIM,1894,4,na,1898,32
STAT,1880,88,na,1968,3.6688631033018764
STAT,1821,50,40-44,1871,1.4870738758694438E-4
SIM,1833,21,30-34,1854,1
STAT,1853,61,na,1914,11.744023529952495
STAT,1859,21,35-39,1880,0.05326403519986446
STAT,1881,26,15-19,1907,0.004331992153149261
STAT,1916,28,45-49,1944,0.017647880862478676
STAT,1883,22,25-29,1905,0.5559015232387964
SIM,1909,5,na,1914,41
SIM,1909,26,20-24,1935,1
STAT,1922,47,50-100,1969,0.0025793462229148825
SIM,1822,69,na,1891,10
STAT,1789,65,na,1854,5.0
STAT,1809,53,35-39,1862,2.759714984136111E-4
SIM,1893,73,na,1966,21
STAT,1860,49,na,1909,17.90869789197891
SIM,1830,61,na,1891,8
STAT,1848,15,na,1863,18.62081180478784
STAT,1857,25,25-29,1882,0.3309117572107183
STAT,1888,28,15-19,1916,0.0052832960585556974
STAT,1913,44,25-29,1957,6.882508110283337E-4
SIM,1822,44,na,1866,15
STAT,1822,94,na,1916,0.07089373766731175
SIM,1948,18,na,1966,39
STAT,1883,34,25-29,1917,0.09861246068198282
STAT,1805,49,30-34,1854,0.0018904131404102913
STAT,1870,27,15-19,1897,0.00450702922971367
STAT,1861,2,na,1863,28.947495126246793
STAT,1833,51,50-100,1884,1.175414616979078E-4
STAT,1842,12,na,1854,23.0
SIM,1824,31,25-29,1855,1
STAT,1848,49,45-49,1897,0.0014943453047978358
SIM,1874,25,35-39,1899,1
SIM,1889,59,na,1948,22
STAT,1844,20,20-24,1864,0.6818236120544665
SIM,1911,38,na,1949,40
STAT,1892,73,na,1965,17.575589809690047
STAT,1863,103,na,1966,0.007414070567976232
STAT,1912,11,na,1923,39.68192915956044
STAT,1866,25,35-39,1891,0.08946773934814517
STAT,1816,43,25-29,1859,0.008614851333927694
STAT,1902,22,45-49,1924,0.009833535718725353
STAT,1874,36,40-44,1910,0.04462313473543555
STAT,1942,29,50-100,1971,0.010360392547807136
STAT,1873,15,25-29,1888,0.05829793727791551
STAT,1884,3,na,1887,28.98600658809964
STAT,1912,17,20-24,1929,0.2720045022061633
STAT,1924,35,35-39,1959,0.02838496031505352
STAT,1903,27,15-19,1930,0.006450439538776104
STAT,1855,21,35-39,1876,0.04834559362532793
STAT,1937,23,45-49,1960,0.010884234009750887
STAT,1918,45,20-24,1963,1.1708531863852108E-4
SIM,1929,16,20-24,1945,3
STAT,1889,20,45-49,1909,0.00858846883301585
SIM,1796,87,na,1883,2
SIM,1855,37,na,1892,18
STAT,1876,32,35-39,1908,0.1028551156359431
STAT,1922,27,25-29,1949,0.7393413425124078
STAT,1848,42,25-29,1890,0.004147715188366252
STAT,1955,13,na,1968,51.8439311103369
SIM,1857,5,na,1862,23
SIM,1942,15,na,1957,41
STAT,1857,50,50-100,1907,1.1468512192541816E-4
STAT,1909,32,40-44,1941,0.03713423744723407
SIM,1897,54,na,1951,38
SIM,1963,3,na,1966,54
STAT,1919,46,50-100,1965,0.0024380051380634665
SIM,1930,27,25-29,1957,3
STAT,1836,27,na,1863,27.014620365278933
STAT,1930,34,15-19,1964,0.0016485136360275033
STAT,1833,21,15-19,1854,0.033070449179586216
STAT,1912,33,na,1945,36.768201038163994
STAT,1855,29,30-34,1884,0.18215950325576621
STAT,1892,70,na,1962,19.231469658657353
SIM,1929,36,na,1965,48
SIM,1920,17,20-24,1937,4
STAT,1822,39,20-24,1861,0.00451863235379948
STAT,1885,31,50-100,1916,0.009085036617766704
STAT,1942,18,45-49,1960,0.005180714499898342
STAT,1888,23,20-24,1911,0.8028216398792478
STAT,1883,15,25-29,1898,0.05528422021070364
SIM,1891,60,na,1951,31
STAT,1823,57,na,1880,12.559727395092718
STAT,1909,44,40-44,1953,0.0022978064350517857
SIM,1950,10,na,1960,60
SIM,1939,20,25-29,1959,1
STAT,1877,23,45-49,1900,0.0071759366651020385
STAT,1830,36,na,1866,9.755883694595166
STAT,1835,43,35-39,1878,0.009702482525969856
STAT,1889,32,45-49,1921,0.021350167908894983
STAT,1882,43,15-19,1925,1.3138960766831162E-4
STAT,1859,77,na,1936,6.870334759545218
STAT,1903,39,15-19,1942,1.705863951036813E-4
STAT,1955,17,35-39,1972,0.05539039745763291
SIM,1858,42,na,1900,23
STAT,1884,44,na,1928,22.338759498005004
STAT,1942,24,30-34,1966,0.29895132748648695
STAT,1868,38,15-19,1906,5.407377056047816E-4
STAT,1898,26,25-29,1924,0.5726048419306017
STAT,1929,24,30-34,1953,0.3594546177577635
STAT,1930,30,na,1960,48.63544577364177
STAT,1898,45,25-29,1943,4.4267625112584194E-4
STAT,1847,27,15-19,1874,0.0058253879680886375
STAT,1893,22,25-29,1915,0.7217969560620092
STAT,1861,27,40-44,1888,0.02537438063015846
STAT,1919,43,20-24,1962,1.894230498909867E-4
STAT,1904,38,na,1942,33.8561935814105
STAT,1929,29,25-29,1958,0.8190090474317067
SIM,1929,33,na,1962,44
STAT,1901,17,45-49,1918,9.140375558556033E-4
STAT,1847,25,25-29,1872,0.5510202565390463
STAT,1847,25,50-100,1872,0.008332662517129292
STAT,1948,23,20-24,1971,1.2678766590689488
STAT,1936,3,na,1939,38.59777696695047
STAT,1791,97,na,1888,0.00927570913047151
STAT,1833,38,45-49,1871,0.018261577289222862
SIM,1848,32,30-34,1880,1
SIM,1855,31,na,1886,19
STAT,1841,42,15-19,1883,1.4046131328507777E-4
STAT,1900,23,na,1923,32.69436431287026
SIM,1846,54,na,1900,13
SIM,1889,26,25-29,1915,2
STAT,1920,18,25-29,1938,0.4807947151884255
STAT,1838,25,15-19,1863,0.004544405704638037
STAT,1916,34,30-34,1950,0.15988933695188903
SIM,1903,29,20-24,1932,1
STAT,1857,38,30-34,1895,0.03969975525957528
STAT,1883,19,40-44,1902,0.0017666126332584306
STAT,1889,43,25-29,1932,0.0078053378454070056
STAT,1811,54,na,1865,15.200508136982759
STAT,1835,31,35-39,1866,0.059308786537848
STAT,1851,16,25-29,1867,0.05850963680536992
STAT,1945,5,na,1950,43.11230784607644
STAT,1910,19,45-49,1929,9.78502398861689E-4
STAT,1859,31,20-24,1890,0.021572166108631968
STAT,1878,49,30-34,1927,9.785138961046298E-4
STAT,1916,22,30-34,1938,0.29859486956115394
STAT,1872,37,na,1909,24.105656408711084
STAT,1852,31,35-39,1883,0.09067550917985835
STAT,1861,96,na,1957,0.09651527244413621
STAT,1836,104,na,1940,6.437254858186851E-4
STAT,1842,21,25-29,1863,0.5456460124373302
STAT,1838,102,na,1940,0.0022754678286272044
STAT,1891,16,50-100,1907,6.027854071414791E-4
STAT,1924,36,na,1960,44.114701182194274
SIM,1908,34,na,1942,39
SIM,1877,34,na,1911,28
SIM,1907,21,25-29,1928,1
STAT,1888,16,15-19,1904,0.06952137095212128
STAT,1893,36,na,1929,29.848959222440772
STAT,1800,91,na,1891,0.20999244829056307
STAT,1842,33,25-29,1875,0.09187543387849215
STAT,1893,58,na,1951,24.935078894890655
STAT,1884,22,na,1906,23.171609816312053
STAT,1936,31,50-100,1967,0.007986825809061876
SIM,1896,16,15-19,1912,2
STAT,1797,60,na,1857,8.480845037099872
STAT,1872,59,na,1931,19.88494609808672
STAT,1916,16,45-49,1932,0.0010533713444911802
STAT,1898,39,30-34,1937,0.01536194776027482
STAT,1952,15,35-39,1967,0.050014511546312944
SIM,1834,54,na,1888,14
SIM,1879,44,na,1923,14
SIM,1892,23,na,1915,33
STAT,1888,15,45-49,1903,7.669041778447891E-4
STAT,1904,16,na,1920,36.27805620894003
STAT,1836,22,45-49,1858,0.00888159681511551
SIM,1900,60,na,1960,25
STAT,1807,48,45-49,1855,0.0049462704263505495
STAT,1817,54,na,1871,20.452420513073548
STAT,1930,41,20-24,1971,2.3161220959334782E-4
SIM,1850,9,na,1859,22
STAT,1827,43,50-100,1870,0.008149253054212565
STAT,1949,10,na,1959,45.4058508554114
STAT,1861,33,35-39,1894,0.08480472811662955
STAT,1901,24,45-49,1925,0.009696321487259976
STAT,1874,39,45-49,1913,0.02002020829058807
STAT,1891,29,50-100,1920,0.007795237704401223
STAT,1897,11,na,1908,34.34574445024203
STAT,1943,28,na,1971,39.587159259823196
STAT,1861,21,35-39,1882,0.05078001693887007
STAT,1822,37,30-34,1859,0.03272912537595735
STAT,1802,77,na,1879,3.0276822608636107
STAT,1847,67,na,1914,16.933883492672994
STAT,1898,73,na,1971,20.311264744493084
STAT,1937,2,na,1939,39.53637878708778
STAT,1859,71,na,1930,10.60922070450251
STAT,1860,31,na,1891,19.47933850301115
STAT,1826,31,25-29,1857,0.15949784577864493
STAT,1935,34,40-44,1969,0.05383108210989826
SIM,1895,6,na,1901,31
STAT,1877,74,na,1951,11.455915263869414
STAT,1831,39,30-34,1870,0.05336195226593175
SIM,1834,69,na,1903,11
STAT,1873,81,na,1954,5.497912829010442
STAT,1841,76,na,1917,9.273327635480868
STAT,1935,22,40-44,1957,0.04558392986101499
SIM,1860,83,na,1943,4
SIM,1910,53,na,1963,28
SIM,1935,14,na,1949,60
STAT,1852,44,40-44,1896,0.01899054295281484
STAT,1833,31,25-29,1864,0.09865166531669645
STAT,1907,26,45-49,1933,0.01629671095410806
STAT,1937,25,na,1962,36.318298605874745
STAT,1851,57,na,1908,16.965926107830324
STAT,1902,41,45-49,1943,0.001472235170855471
STAT,1914,1,na,1915,42.70035913508984
SIM,1879,66,na,1945,7
STAT,1890,19,40-44,1909,0.0022098140718749618
STAT,1926,20,40-44,1946,0.0408574799938803
SIM,1896,26,25-29,1922,1
STAT,1860,34,na,1894,19.2339620466759
STAT,1863,23,na,1886,21.20405105373318
STAT,1879,26,15-19,1905,0.004711981632854707
STAT,1862,24,50-100,1886,0.003550081721170761
STAT,1848,32,15-19,1880,0.0010739915816100193
STAT,1926,25,35-39,1951,0.18016289381116452
SIM,1955,9,na,1964,46
STAT,1842,27,30-34,1869,0.23364575174540447
STAT,1893,45,40-44,1938,0.0012297819712888244
STAT,1922,37,35-39,1959,0.027320675489072813
SIM,1879,41,na,1920,15
STAT,1892,15,35-39,1907,0.006810289968575389
STAT,1873,41,15-19,1914,1.4103881140437852E-4
SIM,1856,19,na,1875,18
SIM,1857,24,20-24,1881,1
STAT,1809,47,40-44,1856,0.005840712978411476
STAT,1853,106,na,1959,1.7633567909091345E-4
STAT,1863,38,30-34,1901,0.04695390219431316
STAT,1866,22,30-34,1888,0.165387309453243
STAT,1888,26,25-29,1914,0.49602999456995617
STAT,1911,24,45-49,1935,0.01053594314362485
SIM,1905,23,na,1928,35
SIM,1950,19,15-19,1969,1
STAT,1826,36,50-100,1862,0.014557844548350234
STAT,1928,29,na,1957,45.881099707555585
STAT,1938,16,20-24,1954,1.3318200643730007
STAT,1871,45,20-24,1916,1.2083280726776353E-4
STAT,1827,37,15-19,1864,4.5957019575918E-4
STAT,1935,29,25-29,1964,0.8923548814157285
STAT,1943,23,45-49,1966,0.011879909811170543
STAT,1889,47,40-44,1936,0.0011768378918912189
STAT,1802,55,na,1857,9.42316115233319
STAT,1864,19,30-34,1883,0.014614969688051913
STAT,1900,45,35-39,1945,0.0011060033092470953
STAT,1913,37,25-29,1950,0.009635431219058337
STAT,1928,33,20-24,1961,0.030331169732192974
STAT,1847,52,na,1899,22.87848828810713
SIM,1880,38,na,1918,32
SIM,1930,24,20-24,1954,3
STAT,1905,49,50-100,1954,0.001957703029866776
STAT,1942,19,15-19,1961,0.4705032737555489
STAT,1835,37,40-44,1872,0.024549796534714428
SIM,1918,7,na,1925,41
STAT,1934,11,na,1945,53.446271356645155
STAT,1861,38,20-24,1899,0.006450343093464478
STAT,1866,27,25-29,1893,0.38958828284535146
SIM,1876,52,na,1928,27
STAT,1918,34,40-44,1952,0.04085534303587947
STAT,1871,74,na,1945,11.064596037767734
STAT,1811,51,na,1862,16.13100606836859
STAT,1848,46,40-44,1894,0.0011102933937339958
STAT,1792,79,na,1871,5.69181519400531
SIM,1839,20,20-24,1859,2
STAT,1896,47,na,1943,29.420162304728382
SIM,1880,23,na,1903,32
STAT,1894,28,15-19,1922,0.005794147503222614
STAT,1874,22,15-19,1896,0.03346831532069355
STAT,1879,29,na,1908,24.524213258826485
STAT,1913,41,20-24,1954,1.71765009690989E-4
STAT,1776,98,na,1874,0.00393396735185117
STAT,1802,104,na,1906,2.0370536870078265E-4
STAT,1916,29,15-19,1945,0.0071851939682123014
STAT,1933,16,45-49,1949,0.0066761915551379215
STAT,1865,89,na,1954,0.9501958076525503
STAT,1942,27,35-39,1969,0.15642788422436518
SIM,1864,67,na,1931,13
STAT,1852,21,25-29,1873,0.586229629657081
SIM,1860,21,25-29,1881,1
STAT,1868,33,50-100,1901,0.008829504886564853
STAT,1922,26,na,1948,42.22391678355958
SIM,1800,66,na,1866,9
STAT,1842,18,40-44,1860,0.001751812583390854
STAT,1866,34,25-29,1900,0.09352485923039043
STAT,1883,28,30-34,1911,0.24367599117794173
STAT,1883,24,15-19,1907,0.03183565857329127
SIM,1932,22,na,1954,45
SIM,1856,16,na,1872,18
STAT,1902,18,50-100,1920,6.890668350065225E-4
STAT,1935,24,50-100,1959,0.008914469934990695
STAT,1838,56,na,1894,15.830550892362943
STAT,1871,71,na,1942,13.30796688319358
SIM,1877,19,15-19,1896,1
STAT,1838,29,30-34,1867,0.24506226632762237
STAT,1885,34,35-39,1919,0.0991500627056039
STAT,1882,53,50-100,1935,1.4241236458223245E-4
STAT,1914,16,35-39,1930,0.008629233765121406
STAT,1921,19,20-24,1940,1.525105031260621
STAT,1934,14,na,1948,53.1938683042519
SIM,1790,65,na,1855,5
STAT,1844,34,50-100,1878,0.00838237515112838
SIM,1889,23,20-24,1912,4
STAT,1805,69,na,1874,5.790078423890516
SIM,1793,76,na,1869,11
STAT,1807,95,na,1902,0.056111609810312525
STAT,1857,48,40-44,1905,0.0012655133956765271
SIM,1839,60,na,1899,19
STAT,1869,19,15-19,1888,0.0576138490872028
STAT,1842,23,15-19,1865,0.030995261105107433
SIM,1893,70,na,1963,22
STAT,1836,19,50-100,1855,6.278325972056763E-4
SIM,1902,27,na,1929,32
STAT,1849,93,na,1942,0.22661115988660374
SIM,1872,71,na,1943,12
SIM,1915,22,20-24,1937,3
STAT,1925,15,40-44,1940,0.01686869523384672
STAT,1816,47,40-44,1863,0.0021578081133462037
STAT,1903,18,25-29,1921,0.08035467616153558
STAT,1848,31,45-49,1879,0.013288601540447496
STAT,1847,22,20-24,1869,0.902446605855577
STAT,1929,16,50-100,1945,0.004770211852686228
SIM,1891,28,30-34,1919,1
SIM,1846,79,na,1925,2
STAT,1919,46,25-29,1965,5.717797026131261E-4
STAT,1822,91,na,1913,0.2055499521947327
STAT,1931,26,20-24,1957,0.23472797498236586
STAT,1924,23,35-39,1947,0.11004280247903063
SIM,1956,10,na,1966,47
STAT,1929,27,35-39,1956,0.1870005517336716
SIM,1852,42,na,1894,24
SIM,1853,27,na,1880,24
SIM,1898,25,20-24,1923,1
SIM,1893,21,20-24,1914,2
STAT,1835,42,na,1877,11.33026603558354
STAT,1899,4,na,1903,36.012369145965806
SIM,1923,26,na,1949,36
SIM,1948,22,25-29,1970,1
STAT,1830,44,20-24,1874,1.6032091869501983E-4
STAT,1907,22,20-24,1929,1.0080185772678971
STAT,1893,41,25-29,1934,0.008133448806245074
STAT,1828,94,na,1922,0.13422828890966504
STAT,1818,43,35-39,1861,0.0188884379087356
STAT,1903,34,20-24,1937,0.021877743772023256
SIM,1920,12,na,1932,49
STAT,1890,45,30-34,1935,0.0011875549498152809
STAT,1923,47,50-100,1970,0.0026275819094055963
STAT,1953,18,20-24,1971,1.6300410265451428
STAT,1857,29,40-44,1886,0.022767633932921364
STAT,1916,18,35-39,1934,0.008803516743350339
STAT,1916,37,35-39,1953,0.02455763582874444
STAT,1883,38,40-44,1921,0.04229827315167232
STAT,1889,33,15-19,1922,0.0017361845472742329
SIM,1881,85,na,1966,1
SIM,1914,12,na,1926,37
SIM,1917,48,na,1965,34
STAT,1911,40,50-100,1951,0.0011266787798563927
STAT,1917,33,45-49,1950,0.016259132384836946
STAT,1814,65,na,1879,8.98362377205593
STAT,1829,79,na,1908,4.748686488971969
STAT,1887,33,na,1920,25.93685244390507
STAT,1838,39,40-44,1877,0.04015443082221015
STAT,1872,36,15-19,1908,5.773221172552013E-4
SIM,1826,30,20-24,1856,1
SIM,1831,43,na,1874,8
STAT,1855,19,na,1874,18.99673736962395
STAT,1857,45,na,1902,17.010401230995438
SIM,1944,25,na,1969,32
STAT,1909,44,na,1953,34.118541216875194
STAT,1909,47,45-49,1956,0.001985904687617492
STAT,1922,24,20-24,1946,1.2578852804407394
STAT,1938,29,35-39,1967,0.1476133895260561
STAT,1920,16,50-100,1936,0.0041778808433943805
STAT,1926,36,15-19,1962,2.335611698661696E-4
STAT,1874,21,45-49,1895,0.007095625274141754
SIM,1840,57,na,1897,10
SIM,1846,39,40-44,1885,1
SIM,1860,86,na,1946,3
STAT,1938,15,50-100,1953,0.003688456632972965
STAT,1944,16,20-24,1960,1.448825095224453
SIM,1935,11,na,1946,60
STAT,1864,15,15-19,1879,0.06122853438932848
STAT,1907,35,35-39,1942,0.022542852332064385
STAT,1898,35,15-19,1933,7.647198356959099E-4
STAT,1799,101,na,1900,0.0021080965290027833
STAT,1872,34,na,1906,24.20698340828053
STAT,1785,72,na,1857,15.143717464560542
STAT,1895,62,na,1957,24.203147046520026
STAT,1918,26,20-24,1944,0.1931645949550198
STAT,1875,48,na,1923,22.836469674588976
STAT,1920,27,15-19,1947,0.007678228611368515
STAT,1873,17,15-19,1890,0.060336139898867255
STAT,1860,25,50-100,1885,0.005332546982020244
STAT,1903,23,40-44,1926,0.029534656656559414
STAT,1880,47,20-24,1927,1.2559808878747557E-4
SIM,1867,56,na,1923,10
SIM,1781,73,na,1854,8
SIM,1892,48,na,1940,32
STAT,1837,90,na,1927,0.3812132939870796
STAT,1926,35,45-49,1961,0.008298225088769134
STAT,1842,37,40-44,1879,0.0385278825153958
STAT,1853,2,na,1855,22.641599999999997
STAT,1921,31,45-49,1952,0.017445885516981847
STAT,1835,64,na,1899,7.81901189031132
STAT,1897,38,50-100,1935,0.016223009060808025
STAT,1933,35,45-49,1968,0.009263678015631509
STAT,1802,52,50-100,1854,2.3123075158519468E-4
STAT,1876,38,40-44,1914,0.04423940010407838
STAT,1894,30,50-100,1924,0.011836916799358891
STAT,1946,7,na,1953,43.456741599757784
STAT,1913,22,20-24,1935,1.0684724743003176
STAT,1885,21,20-24,1906,0.6825756348970021
SIM,1846,57,na,1903,11
STAT,1822,33,15-19,1855,0.0010837119925875488
STAT,1862,4,na,1866,26.33760459803863
SIM,1937,27,35-39,1964,1
STAT,1880,85,na,1965,5.373574728249103
STAT,1905,63,na,1968,28.57824616970429
STAT,1853,27,15-19,1880,0.003303260376999095
STAT,1905,36,20-24,1941,0.0024128363091036596
SIM,1833,50,na,1883,11
SIM,1812,51,na,1863,18
STAT,1833,35,40-44,1868,0.041369489218375244
STAT,1852,40,25-29,1892,0.005551344992729959
STAT,1935,37,45-49,1972,0.009490334428853045
STAT,1814,43,na,1857,14.169499251862044
SIM,1832,28,na,1860,24
STAT,1923,44,25-29,1967,8.260898486480163E-4
SIM,1906,33,35-39,1939,1
STAT,1811,43,40-44,1854,0.09589368253498363
STAT,1859,44,35-39,1903,0.014198379933919997
STAT,1887,20,35-39,1907,0.06407475553727922
STAT,1927,28,20-24,1955,0.2200049021109023
STAT,1849,24,20-24,1873,0.6367911460122411
SIM,1935,28,20-24,1963,1
STAT,1820,65,na,1885,9.58457613403345
STAT,1831,35,15-19,1866,5.864852454520159E-4
STAT,1884,24,50-100,1908,0.003970322991675206
STAT,1867,32,25-29,1899,0.09801768401393289
STAT,1901,21,40-44,1922,0.029246121732052113
STAT,1840,94,na,1934,0.15660915270127954
STAT,1899,37,50-100,1936,0.0036276397423092486
STAT,1890,42,20-24,1932,0.001926731452506182
STAT,1858,28,40-44,1886,0.02316717036470152
STAT,1878,45,50-100,1923,0.002560896524104526
STAT,1898,24,50-100,1922,0.005466658325731808
STAT,1887,18,50-100,1905,5.333491023595537E-4
STAT,1819,80,na,1899,3.1754376116963243
STAT,1873,45,25-29,1918,5.914532751461517E-4
STAT,1879,18,30-34,1897,0.016453486756622508
STAT,1837,93,na,1930,0.14131187803950962
SIM,1858,36,na,1894,25
STAT,1854,43,50-100,1897,0.006410757069872267
STAT,1844,15,35-39,1859,0.005512915617678942
STAT,1941,28,35-39,1969,0.1541102645568209
STAT,1898,48,35-39,1946,0.001051942477797659
SIM,1840,26,na,1866,17
SIM,1897,37,30-34,1934,1
STAT,1869,39,na,1908,22.598284132570978
STAT,1902,21,30-34,1923,0.2519447924079611
STAT,1782,86,na,1868,0.5265095532631445
SIM,1941,7,na,1948,49
STAT,1843,37,50-100,1880,0.006079885776430702
STAT,1805,60,na,1865,8.098874482782884
STAT,1824,38,40-44,1862,0.06238584166973987
STAT,1900,42,30-34,1942,0.0011056990374341137
STAT,1809,48,50-100,1857,0.008249580980508164
STAT,1868,31,25-29,1899,0.09952739879669546
STAT,1902,38,25-29,1940,0.008720129254447394
STAT,1904,17,25-29,1921,0.08119802404493301
SIM,1883,24,25-29,1907,1
STAT,1869,18,45-49,1887,6.379217778594044E-4
STAT,1875,42,25-29,1917,0.006592876011545714
STAT,1930,38,30-34,1968,0.02363791639855701
STAT,1833,25,30-34,1858,0.24928875201020287
SIM,1827,44,na,1871,18
STAT,1873,44,na,1917,23.181022498183538
STAT,1918,48,30-34,1966,9.374503517792887E-4
STAT,1900,24,30-34,1924,0.24545346068571317
STAT,1794,71,na,1865,6.891206002240838
STAT,1838,18,15-19,1856,0.06048282200167652
STAT,1903,28,na,1931,33.810559127239586
STAT,1934,30,35-39,1964,0.1243816677350352
STAT,1943,25,35-39,1968,0.1588690162196426
STAT,1806,54,25-29,1860,1.1023675288854344E-4
STAT,1836,39,15-19,1875,6.515281894324526E-4
STAT,1919,15,na,1934,42.64750929897603
SIM,1845,69,na,1914,19
STAT,1867,39,50-100,1906,0.011630765458606722
STAT,1891,29,40-44,1920,0.03650369002235685
STAT,1913,40,45-49,1953,0.0016276669338273597
STAT,1832,62,na,1894,8.261505994268477
STAT,1861,30,30-34,1891,0.1480086853824325
STAT,1883,19,35-39,1902,0.0052998375929210004
STAT,1927,38,50-100,1965,0.005188157093212708
STAT,1947,17,50-100,1964,0.004191523720384847
SIM,1870,36,na,1906,24
SIM,1905,21,20-24,1926,1
STAT,1924,40,20-24,1964,2.0927724005881542E-4
STAT,1831,80,na,1911,5.019869980375212
SIM,1871,18,na,1889,24
STAT,1809,50,na,1859,16.88109211258299
STAT,1946,17,30-34,1963,0.13423761706581372
STAT,1811,54,35-39,1865,3.139243587207813E-4
STAT,1872,47,50-100,1919,0.0025011907203333294
STAT,1827,75,na,1902,6.2387219755740695
STAT,1857,7,na,1864,21.77795943210631
SIM,1841,25,30-34,1866,1
STAT,1934,32,30-34,1966,0.21419979617817794
STAT,1823,85,na,1908,1.5765144694404232
STAT,1876,80,na,1956,6.660773981362916
STAT,1917,35,35-39,1952,0.02513083108280246
STAT,1872,90,na,1962,1.64823689769429
STAT,1907,43,25-29,1950,6.475685117143103E-4
STAT,1852,15,50-100,1867,5.131498660685457E-4
STAT,1909,40,25-29,1949,6.716983437062122E-4
STAT,1930,25,25-29,1955,0.8337438698563655
STAT,1856,72,na,1928,9.148831846976995
STAT,1916,32,40-44,1948,0.04005692325667139
STAT,1902,26,50-100,1928,0.009051813861993111
STAT,1932,35,30-34,1967,0.02443122089175259
STAT,1940,1,na,1941,41.9279304288643
STAT,1910,16,40-44,1926,0.002761344923990246
STAT,1872,18,50-100,1890,4.999569771539225E-4
SIM,1877,15,na,1892,31
STAT,1833,43,30-34,1876,0.010182435538675086
STAT,1835,22,30-34,1857,0.13024197749001154
STAT,1904,49,50-100,1953,0.0019436627323247083
STAT,1900,40,35-39,1940,0.0017613004043965535
STAT,1849,35,50-100,1884,0.009945700681527437
STAT,1822,104,na,1926,2.3659545780412938E-4
STAT,1869,31,45-49,1900,0.01696566543575607
STAT,1885,16,35-39,1901,0.0054318921804198065
STAT,1913,22,15-19,1935,0.05115061387117576
SIM,1913,3,na,1916,48
STAT,1877,34,na,1911,24.422062119080522
STAT,1816,46,35-39,1862,0.0017914947126691982
STAT,1915,38,35-39,1953,0.024103126796882687
STAT,1917,17,35-39,1934,0.008947686323297155
STAT,1881,79,na,1960,8.29559804046269
STAT,1907,25,25-29,1932,0.6229625950451202
STAT,1835,40,30-34,1875,0.006403800609498914
STAT,1912,27,30-34,1939,0.38310771272305855
STAT,1944,22,45-49,1966,0.012060494681071331
STAT,1825,80,na,1905,3.334873516421065
STAT,1892,11,na,1903,31.95212380463799
SIM,1906,17,na,1923,29
STAT,1917,49,25-29,1966,5.458086615116437E-4
STAT,1851,23,25-29,1874,0.5729928883813319
STAT,1927,22,45-49,1949,0.013791943407340947
SIM,1864,36,na,1900,22
SIM,1872,31,na,1903,22
STAT,1820,53,50-100,1873,1.2089723843785672E-4
SIM,1821,59,na,1880,10
SIM,1872,2,na,1874,27
STAT,1871,20,45-49,1891,0.006993779939069295
SIM,1795,65,na,1860,11
STAT,1922,30,15-19,1952,0.0014528960225685676
STAT,1839,17,20-24,1856,0.12798369280431385
STAT,1860,47,40-44,1907,0.0013853205899005757
STAT,1871,49,na,1920,21.9625800357648
STAT,1839,33,25-29,1872,0.068841297514676
STAT,1852,39,50-100,1891,0.010401860010652672
STAT,1834,23,25-29,1857,0.5371594389118689
STAT,1944,10,na,1954,42.03694866810783
STAT,1814,49,35-39,1863,0.0038882524362866574
STAT,1927,35,20-24,1962,0.0032663709095922073
STAT,1860,31,25-29,1891,0.08360987002771689
STAT,1866,37,35-39,1903,0.06514030198965728
STAT,1877,2,na,1879,33.543702239876055
SIM,1929,25,25-29,1954,1
SIM,1895,28,na,1923,25
STAT,1818,39,na,1857,7.472711188609046
STAT,1920,6,na,1926,44.5854681554028
STAT,1899,29,40-44,1928,0.04071419483241812
SIM,1920,27,30-34,1947,1
SIM,1882,61,na,1943,27
STAT,1889,24,25-29,1913,0.6964885639217117
STAT,1869,30,30-34,1899,0.17053427844801883
STAT,1910,32,45-49,1942,0.015079945712503364
SIM,1916,0,na,1916,50
STAT,1904,48,30-34,1952,7.72574100699311E-4
STAT,1822,60,na,1882,7.304771984104985
STAT,1854,20,45-49,1874,0.005080718949422617
STAT,1784,81,na,1865,2.8230159200254197
STAT,1891,40,15-19,1931,1.7120713342861455E-4
SIM,1907,58,na,1965,33
SIM,1802,52,na,1854,11
STAT,1922,43,20-24,1965,2.0090291460862018E-4
SIM,1878,56,na,1934,26
STAT,1885,69,na,1954,14.492208258332743
STAT,1885,31,30-34,1916,0.17312190097916938
SIM,1886,23,na,1909,29
SIM,1946,25,25-29,1971,4
STAT,1848,77,na,1925,5.5900219422356585
STAT,1818,40,30-34,1858,0.013152702272243117
STAT,1892,26,50-100,1918,0.007929929026449808
STAT,1848,36,30-34,1884,0.0358890022247189
STAT,1903,19,30-34,1922,0.022539046714337003
SIM,1856,41,na,1897,11
STAT,1865,23,25-29,1888,0.5203105102933621
STAT,1917,32,30-34,1949,0.16348163689357215
STAT,1834,41,25-29,1875,0.005541328072894531
STAT,1848,23,25-29,1871,0.44752871227435265
STAT,1883,74,na,1957,11.430793118980066
STAT,1908,24,30-34,1932,0.26120979627378155
SIM,1870,76,na,1946,11
STAT,1809,50,30-34,1859,2.0260200583483264E-4
STAT,1851,41,25-29,1892,0.005445818224489712
STAT,1825,33,25-29,1858,0.11751287426344738
STAT,1865,39,40-44,1904,0.03919546327357643
STAT,1925,15,na,1940,44.390453465059835
STAT,1854,77,na,1931,5.2834675164599965
STAT,1855,47,30-34,1902,6.783622109749815E-4
STAT,1932,25,na,1957,48.91069225529924
STAT,1810,75,na,1885,3.571581722986722
SIM,1961,2,na,1963,53
SIM,1816,72,na,1888,2
STAT,1828,57,na,1885,14.035209210483641
STAT,1928,33,15-19,1961,0.0015979642828590165
STAT,1936,25,20-24,1961,0.1737881808543391
STAT,1828,30,45-49,1858,0.024861176588571583
STAT,1855,18,15-19,1873,0.04940444733580485
STAT,1933,15,25-29,1948,0.5804250609318368
STAT,1878,16,50-100,1894,5.070430105760026E-4
SIM,1815,59,na,1874,10
STAT,1938,25,25-29,1963,0.6483501248658393
SIM,1941,15,25-29,1956,1
SIM,1938,10,na,1948,40
STAT,1895,21,45-49,1916,0.009080345638721721
SIM,1926,37,na,1963,46
STAT,1894,46,na,1940,28.9210175076465
STAT,1904,35,25-29,1939,0.008989259718724106
STAT,1908,40,35-39,1948,0.0018743631420965793
SIM,1874,38,na,1912,25
STAT,1771,107,na,1878,1.276028813351141E-4
STAT,1865,49,na,1914,19.924642475488604
STAT,1857,14,na,1871,20.814354819959725
STAT,1859,41,30-34,1900,0.009179103460199156
SIM,1833,44,na,1877,11
STAT,1923,46,45-49,1969,0.002531152386738934
STAT,1876,41,30-34,1917,0.011729390211528181
STAT,1790,81,na,1871,1.2539513116693095
SIM,1916,24,30-34,1940,1
STAT,1840,39,35-39,1879,0.06420430258624994
STAT,1942,22,40-44,1964,0.03499726795513451
STAT,1838,29,50-100,1867,0.0062252835613685695
STAT,1941,19,50-100,1960,0.0038284660443190528
SIM,1844,16,na,1860,13
STAT,1900,27,35-39,1927,0.13379995277538834
STAT,1870,95,na,1965,0.44301911451216996
STAT,1889,37,30-34,1926,0.06525171032703694
STAT,1871,48,25-29,1919,5.67056450291342E-4
STAT,1892,24,25-29,1916,0.7027893628719484
STAT,1803,65,na,1868,9.027477554725175
STAT,1879,69,na,1948,15.189220793093856
SIM,1912,17,na,1929,40
SIM,1841,79,na,1920,4
STAT,1818,102,na,1920,7.326526470337735E-4
STAT,1845,30,45-49,1875,0.012374442358768504
STAT,1908,42,30-34,1950,0.0011766769126066432
STAT,1839,15,25-29,1854,0.04139476224299325
STAT,1933,33,25-29,1966,0.12397206296228024
STAT,1858,37,50-100,1895,0.009342443312542451
STAT,1902,35,20-24,1937,0.0023685650117370874
SIM,1888,18,20-24,1906,1
STAT,1919,43,na,1962,39.83514654582481
STAT,1947,15,25-29,1962,0.4850767315538357
STAT,1930,40,45-49,1970,0.0021856001358430913
STAT,1943,22,30-34,1965,0.30355890195012686
SIM,1898,48,na,1946,28
STAT,1882,80,na,1962,8.08281876420064
SIM,1932,25,na,1957,47
SIM,1814,77,na,1891,13
STAT,1842,52,na,1894,16.068763834538046
STAT,1884,18,40-44,1902,0.0017873012485367917
SIM,1810,87,na,1897,3
STAT,1874,29,40-44,1903,0.030172537246147057
STAT,1775,104,na,1879,4.999637442158335E-4
STAT,1859,49,na,1908,17.50874952461663
STAT,1853,39,15-19,1892,3.493688800202049E-4
SIM,1850,16,na,1866,22
SIM,1876,21,na,1897,31
SIM,1931,12,na,1943,62
SIM,1944,10,na,1954,36
STAT,1920,15,15-19,1935,0.10175639846662121
STAT,1819,40,na,1859,15.070780895126632
STAT,1840,36,30-34,1876,0.04990992126712153
STAT,1791,101,na,1892,0.0010473832785071109
STAT,1842,33,30-34,1875,0.1566124259070285
SIM,1854,8,na,1862,21
STAT,1894,21,25-29,1915,0.7358700840166373
STAT,1820,37,na,1857,16.285451744080767
STAT,1807,55,na,1862,13.072913848430563
STAT,1879,19,15-19,1898,0.061093793951594554
STAT,1857,103,na,1960,0.002621283425337489
STAT,1901,33,na,1934,33.25000093171489
STAT,1924,43,25-29,1967,8.425322768460101E-4
STAT,1930,22,20-24,1952,1.4178149617054638
SIM,1950,19,na,1969,53
STAT,1833,28,35-39,1861,0.0934770138804401
STAT,1843,35,40-44,1878,0.022132662404260022
STAT,1883,24,50-100,1907,0.0039351869268617915
STAT,1902,24,35-39,1926,0.08177600386525782
STAT,1825,36,35-39,1861,0.07556983706950078
STAT,1829,70,na,1899,9.530409775802456
STAT,1854,48,25-29,1902,3.476475799900081E-4
STAT,1921,35,25-29,1956,0.010927090163019544
STAT,1939,24,30-34,1963,0.2864678223174164
STAT,1903,68,na,1971,25.47641220266291
STAT,1962,9,na,1971,50.046613152573016
STAT,1813,49,20-24,1862,3.609922199723368E-4
SIM,1879,23,20-24,1902,2
STAT,1901,22,25-29,1923,0.8010200922815461
STAT,1929,42,50-100,1971,0.0015141302068950562
SIM,1831,49,na,1880,9
STAT,1835,25,35-39,1860,0.05950152376130567
STAT,1925,24,30-34,1949,0.33973729368296457
STAT,1909,34,50-100,1943,0.007778414692460114
STAT,1918,32,45-49,1950,0.016570068122178924
STAT,1848,20,15-19,1868,0.026354369509262295
STAT,1922,49,35-39,1971,0.0014616932718490782
STAT,1938,22,20-24,1960,1.093240906476096
STAT,1883,34,na,1917,22.974626100990665
STAT,1893,20,50-100,1913,0.0051724154695428305
STAT,1961,4,na,1965,50.50869665479587
STAT,1914,31,na,1945,37.90893174084893
SIM,1901,31,30-34,1932,1
STAT,1843,93,na,1936,0.12397224344528908
STAT,1898,48,50-100,1946,0.0018454076554473063
SIM,1919,43,na,1962,43
STAT,1890,56,na,1946,24.77549347473056
STAT,1896,19,15-19,1915,0.07753441762773017
STAT,1905,43,20-24,1948,1.5801525326572988E-4
SIM,1843,25,35-39,1868,1
STAT,1843,17,40-44,1860,9.914995674701976E-4
SIM,1856,72,na,1928,7
SIM,1889,28,na,1917,28
STAT,1908,43,45-49,1951,0.0015226093252421098
STAT,1795,65,na,1860,9.763675313621878
STAT,1905,16,30-34,1921,0.023059879668743222
SIM,1839,69,na,1908,16
STAT,1830,67,na,1897,5.695562457536686
STAT,1921,17,25-29,1938,0.4901112755207848
STAT,1869,15,35-39,1884,0.005454355839869224
SIM,1897,21,20-24,1918,1
STAT,1841,38,40-44,1879,0.04996146350825586
SIM,1915,53,na,1968,31
STAT,1829,28,15-19,1857,0.004791368781245607
STAT,1867,44,na,1911,21.81910623308731
STAT,1881,37,30-34,1918,0.05071324760052785
STAT,1897,31,20-24,1928,0.03604210583814168
STAT,1889,21,20-24,1910,0.8462647657251663
STAT,1859,26,35-39,1885,0.07857927982113225
SIM,1897,23,na,1920,39
SIM,1891,78,na,1969,18
STAT,1899,47,40-44,1946,0.0013158304749930649
STAT,1951,17,40-44,1968,0.016555094350653284
STAT,1838,17,30-34,1855,0.016340393052109065
STAT,1816,60,na,1876,7.0674998012077035
SIM,1862,41,na,1903,23
STAT,1814,46,30-34,1860,0.0028150843589642006
SIM,1937,3,na,1940,41
STAT,1876,23,30-34,1899,0.18035068581398028
SIM,1868,66,na,1934,27
STAT,1906,45,30-34,1951,8.011935346952082E-4
STAT,1856,30,20-24,1886,0.020237554496282482
SIM,1842,20,20-24,1862,1
STAT,1947,19,40-44,1966,0.015637876380127057
SIM,1825,49,na,1874,17
SIM,1903,68,na,1971,26
STAT,1904,13,na,1917,36.94717564983493
SIM,1859,35,40-44,1894,1
STAT,1833,46,35-39,1879,0.0012297918340159755
STAT,1853,20,25-29,1873,0.43126346467130067
STAT,1788,71,na,1859,7.051884736259198
STAT,1883,34,30-34,1917,0.16809647628431165
STAT,1871,18,na,1889,25.19365595959986
STAT,1964,1,na,1965,49.28187877876296
SIM,1886,51,na,1937,27
STAT,1848,39,35-39,1887,0.0461677418007144
STAT,1816,43,30-34,1859,0.015423362808927223
STAT,1942,25,45-49,1967,0.018015842031968946
STAT,1834,35,50-100,1869,0.01101860133591941
STAT,1853,24,na,1877,15.650066697876595
STAT,1869,43,50-100,1912,0.010162454250130043
STAT,1935,30,25-29,1965,0.12744822357173113
SIM,1933,19,na,1952,44
STAT,1908,25,45-49,1933,0.016495868391385896
SIM,1879,69,na,1948,7
STAT,1920,33,15-19,1953,0.0013896990497018064
STAT,1876,26,35-39,1902,0.09833523826184112
SIM,1946,22,20-24,1968,2
SIM,1838,28,na,1866,12
STAT,1917,46,20-24,1963,1.146649435998523E-4
STAT,1862,72,na,1934,10.895810564939525
STAT,1936,15,na,1951,35.189068458073265
STAT,1923,43,40-44,1966,0.002898607697246815
STAT,1884,16,na,1900,24.805448637375363
STAT,1919,30,50-100,1949,0.00891388415810871
STAT,1916,35,45-49,1951,0.006987247826570409
SIM,1910,50,na,1960,28
STAT,1789,96,na,1885,0.010203160488191665
STAT,1808,49,40-44,1857,0.0012009895860567324
SIM,1837,34,na,1871,25
STAT,1853,52,na,1905,13.460215315776404
STAT,1812,70,na,1882,6.628145905183512
STAT,1894,74,na,1968,17.944390020947193
STAT,1921,16,50-100,1937,0.004247679234318497
SIM,1874,66,na,1940,17
STAT,1817,45,40-44,1862,0.005097822664428802
SIM,1819,49,na,1868,7
STAT,1861,59,na,1920,16.34366905340651
STAT,1892,27,35-39,1919,0.11920359957736425
STAT,1936,28,25-29,1964,0.6258021064883004
STAT,1871,50,45-49,1921,1.4676805890578306E-4
STAT,1925,27,40-44,1952,0.05470779236981188
SIM,1830,64,na,1894,7
STAT,1869,15,40-44,1884,0.001818118718556646
STAT,1838,87,na,1925,1.3674212341588683
STAT,1922,46,25-29,1968,6.064320516174578E-4
STAT,1850,87,na,1937,1.5686518621006973
STAT,1933,19,40-44,1952,0.018547539268781284
STAT,1889,21,15-19,1910,0.04051294095595228
STAT,1863,45,50-100,1908,0.0021962157289237495
STAT,1827,30,25-29,1857,0.09821285380046534
SIM,1885,38,na,1923,24
STAT,1909,36,15-19,1945,1.8161635346065682E-4
STAT,1832,44,25-29,1876,0.0034425955628337225
SIM,1861,20,25-29,1881,1
STAT,1846,18,50-100,1864,4.95829657940585E-4
STAT,1896,48,30-34,1944,7.082214314046812E-4
STAT,1890,16,na,1906,30.753958024071938
STAT,1834,39,40-44,1873,0.037688351649222074
STAT,1855,6,na,1861,20.89164480629898
STAT,1834,20,20-24,1854,0.6607656025933607
STAT,1918,21,na,1939,39.146972604620636
STAT,1907,58,na,1965,30.918324046617958
STAT,1813,55,na,1868,17.75463752432085
STAT,1812,51,45-49,1863,1.6049283784660357E-4
STAT,1851,26,35-39,1877,0.09606721004731944
STAT,1874,15,15-19,1889,0.06071096104441557
STAT,1920,33,45-49,1953,0.017017257411006622
STAT,1904,32,20-24,1936,0.022239845049322585
SIM,1891,38,na,1929,34
STAT,1884,36,40-44,1920,0.043095094629320395
STAT,1912,42,20-24,1954,1.68996221282437E-4
SIM,1866,31,na,1897,30
STAT,1848,20,20-24,1868,0.5505098818384733
STAT,1913,32,50-100,1945,0.00815718787351954
STAT,1912,24,20-24,1936,1.0949225578572994
STAT,1914,36,25-29,1950,0.009796157594762636
STAT,1857,44,30-34,1901,0.008490337074038552
STAT,1923,44,50-100,1967,0.0013590510327813033
SIM,1816,44,na,1860,12
STAT,1903,36,50-100,1939,0.0037856906858064463
STAT,1844,87,na,1931,1.3761393891829279
STAT,1934,33,45-49,1967,0.021380344440890285
STAT,1836,52,na,1888,21.02541692321132
STAT,1897,26,na,1923,31.800722627167087
STAT,1903,21,45-49,1924,0.009943983547993786
STAT,1962,0,na,1962,50.44545800976576
STAT,1912,36,na,1948,36.607757905575745
SIM,1932,25,30-34,1957,2
SIM,1814,49,na,1863,22
SIM,1835,70,na,1905,10
STAT,1855,87,na,1942,1.2404357216232702
SIM,1854,77,na,1931,6
STAT,1903,15,15-19,1918,0.08476548881704248
STAT,1815,59,na,1874,8.741673954659223
STAT,1951,17,35-39,1968,0.04966528017639921
STAT,1821,39,30-34,1860,0.09252813741520069
STAT,1933,37,40-44,1970,0.020306958723710588
STAT,1834,27,40-44,1861,0.027758703486607316
SIM,1898,20,20-24,1918,1
SIM,1917,17,na,1934,43
STAT,1860,35,40-44,1895,0.035925885820116764
STAT,1859,31,50-100,1890,0.007312235189297245
STAT,1920,31,na,1951,41.24179802768653
STAT,1897,34,25-29,1931,0.13485269182711282
STAT,1900,25,45-49,1925,0.015500827462986477
STAT,1923,23,50-100,1946,0.0075795373920010236
STAT,1868,16,35-39,1884,0.005438282382355142
STAT,1830,27,na,1857,9.91183326209344
STAT,1909,42,45-49,1951,0.0015479438022874027
STAT,1941,9,na,1950,40.47183077953279
STAT,1914,45,50-100,1959,0.0022350339216640667
STAT,1818,40,25-29,1858,0.007346554452392383
STAT,1924,21,na,1945,42.9396986624072
SIM,1827,75,na,1902,1
STAT,1912,27,25-29,1939,0.6435575059672325
STAT,1883,16,30-34,1899,0.01551578440224196
STAT,1920,37,30-34,1957,0.019785241947508445
SIM,1908,40,na,1948,38
STAT,1922,28,30-34,1950,0.43857827356488294
SIM,1866,62,na,1928,26
SIM,1881,79,na,1960,6
STAT,1836,52,45-49,1888,1.4171193303242344E-4
SIM,1786,88,na,1874,4
STAT,1868,54,50-100,1922,1.4213695122396476E-4
STAT,1935,32,45-49,1967,0.021673781908421293
STAT,1895,49,25-29,1944,4.130114078446223E-4
SIM,1906,23,30-34,1929,2
STAT,1893,41,30-34,1934,0.014561496996763696
SIM,1890,28,na,1918,26
STAT,1828,85,na,1913,1.8411113978609432
SIM,1853,36,na,1889,24
SIM,1841,48,na,1889,14
STAT,1828,88,na,1916,0.9220088941149529
SIM,1877,3,na,1880,33
STAT,1844,47,na,1891,17.491466959365994
SIM,1904,50,na,1954,26
STAT,1898,64,na,1962,25.110757888307827
STAT,1904,32,15-19,1936,0.0011716817504541053
STAT,1899,43,25-29,1942,6.060347756285408E-4
STAT,1911,25,20-24,1936,0.1780675911504119
STAT,1872,43,15-19,1915,1.4027735608152184E-4
STAT,1849,31,20-24,1880,0.02452349651048925
STAT,1858,36,na,1894,18.013969977779144
SIM,1917,8,na,1925,47
STAT,1876,24,na,1900,23.87014307500777
STAT,1892,24,30-34,1916,0.2186767292180992
STAT,1909,53,na,1962,32.854768449458426
STAT,1841,22,25-29,1863,0.7098247007518879
STAT,1857,32,30-34,1889,0.1315117899130793
STAT,1848,25,15-19,1873,0.003553599316754436
SIM,1908,43,na,1951,38
STAT,1893,39,50-100,1932,0.01532452789219272
STAT,1861,42,30-34,1903,0.009656295340138777
STAT,1885,31,25-29,1916,0.10156058610427744
STAT,1832,93,na,1925,0.13210135775864446
STAT,1841,67,na,1908,15.516347501373065
STAT,1845,17,45-49,1862,4.826148811120804E-4
STAT,1867,72,na,1939,12.085406190691156
STAT,1825,40,na,1865,15.124839353904406
STAT,1831,42,15-19,1873,1.3678789235603315E-4
STAT,1873,13,na,1886,26.550194087668483
STAT,1874,54,na,1928,21.24301385915668
STAT,1908,40,40-44,1948,0.002328212750064578
STAT,1924,25,30-34,1949,0.4563244098156615
STAT,1860,17,40-44,1877,0.0017149321961066964
STAT,1840,26,na,1866,21.28852048152099
STAT,1922,46,30-34,1968,0.0010191427632350232
STAT,1825,33,30-34,1858,0.2003144424661535
STAT,1899,25,25-29,1924,0.5830070327442084
STAT,1925,27,35-39,1952,0.17621776445272028
STAT,1903,33,15-19,1936,0.0011576522069537873
STAT,1858,46,40-44,1904,0.001306436013797035
STAT,1928,20,na,1948,45.64233021939786
STAT,1935,26,15-19,1961,0.009584719189358465
SIM,1854,74,na,1928,6
STAT,1857,26,30-34,1883,0.19557631113588866
STAT,1907,28,35-39,1935,0.14064303871574704
STAT,1842,101,na,1943,0.0042812686902619
SIM,1900,51,na,1951,32
STAT,1932,31,15-19,1963,0.0017023560248587558
STAT,1795,96,na,1891,0.021019245376553614
SIM,1837,74,na,1911,18
SIM,1828,69,na,1897,7
SIM,1902,29,30-34,1931,1
SIM,1939,26,25-29,1965,1
STAT,1860,29,40-44,1889,0.02426186403481437
SIM,1925,43,na,1968,43
STAT,1916,33,25-29,1949,0.09420855698509331
STAT,1877,50,40-44,1927,1.1023450020069144E-4
STAT,1859,41,25-29,1900,0.005127066818566085
SIM,1842,89,na,1931,3
STAT,1826,32,30-34,1858,0.24731019772160068
STAT,1845,20,50-100,1865,0.0030022090001827193
STAT,1827,47,na,1874,15.312022918358632
STAT,1912,29,20-24,1941,0.17720216233569067
STAT,1804,75,na,1879,4.924519053130217
STAT,1813,43,50-100,1856,0.03488524634608472
STAT,1912,45,25-29,1957,5.081830095658746E-4
STAT,1852,11,na,1863,24.823373489010468
STAT,1875,21,20-24,1896,0.7105192460809392
STAT,1843,62,na,1905,7.753118133860704
STAT,1920,19,30-34,1939,0.1348602852166755
SIM,1887,64,na,1951,15
STAT,1930,22,15-19,1952,0.06787456615994032
STAT,1771,86,na,1857,1.0601287607140002
STAT,1797,91,na,1888,0.16704803294560894
STAT,1833,28,40-44,1861,0.029020462735998554
STAT,1893,23,30-34,1916,0.2238970587970908
SIM,1933,10,na,1943,54
STAT,1906,18,40-44,1924,0.0026502826002082398
STAT,1813,47,25-29,1860,0.0017852431612591258
SIM,1850,56,na,1906,19
SIM,1876,61,na,1937,26
SIM,1902,55,na,1957,30
SIM,1924,21,25-29,1945,1
STAT,1898,27,30-34,1925,0.3397040453200989
STAT,1848,46,na,1894,14.591024246957799
STAT,1898,15,30-34,1913,0.021601210827336847
STAT,1905,43,50-100,1948,0.0010511449255996286
STAT,1901,26,40-44,1927,0.04205984142768258
STAT,1925,40,40-44,1965,0.0030176389113511864
STAT,1926,20,35-39,1946,0.11441693010130109
STAT,1914,33,20-24,1947,0.024246374414812633
SIM,1895,68,na,1963,18
STAT,1852,43,35-39,1895,0.015385864567420844
SIM,1810,56,na,1866,16
SIM,1878,87,na,1965,4
STAT,1880,38,25-29,1918,0.030126116637873658
SIM,1934,6,na,1940,54
STAT,1897,16,25-29,1913,0.07543644552670084
STAT,1921,47,25-29,1968,5.933249691875451E-4
STAT,1856,17,20-24,1873,0.15186173690219532
STAT,1925,22,40-44,1947,0.03999528661884499
STAT,1817,45,na,1862,23.576371084513667
STAT,1831,49,35-39,1880,0.001306425473401968
STAT,1849,38,40-44,1887,0.034373650154162626
SIM,1856,9,na,1865,21
STAT,1843,31,25-29,1874,0.05277860677822126
STAT,1786,100,na,1886,9.615737309905208E-4
STAT,1820,41,30-34,1861,0.010327029717317976
STAT,1879,60,na,1939,19.73950032681524
STAT,1905,31,20-24,1936,0.022492040031177635
STAT,1905,19,35-39,1924,0.007876728239339336
SIM,1838,25,25-29,1863,2
SIM,1848,26,30-34,1874,1
STAT,1861,28,na,1889,20.070262240731807
STAT,1834,26,na,1860,20.19114244328936
SIM,1907,15,25-29,1922,1
SIM,1841,70,na,1911,5
STAT,1889,26,15-19,1915,0.005573886715812508
SIM,1911,32,na,1943,41
STAT,1880,57,na,1937,21.13233696638885
STAT,1832,22,na,1854,13.037896283994105
STAT,1856,15,25-29,1871,0.04911782395969808
STAT,1906,17,50-100,1923,7.117617682593919E-4
SIM,1893,64,na,1957,27
STAT,1846,11,na,1857,24.414383081414922
STAT,1852,25,35-39,1877,0.09758076731337471
SIM,1920,27,25-29,1947,1
SIM,1903,27,25-29,1930,2
SIM,1822,41,na,1863,17
STAT,1861,87,na,1948,1.4816020273387773
STAT,1878,23,35-39,1901,0.060060358773625866
STAT,1942,23,25-29,1965,0.9611144926404682
STAT,1898,33,30-34,1931,0.23453779478282016
STAT,1931,21,20-24,1952,1.4401174539891342
STAT,1884,32,25-29,1916,0.10035211554258433
STAT,1916,21,25-29,1937,0.9625297226247628
SIM,1913,58,na,1971,38
SIM,1947,24,30-34,1971,1
SIM,1889,68,na,1957,22
STAT,1817,41,25-29,1858,0.02091888771477608
STAT,1934,30,40-44,1964,0.053263998688476456
STAT,1842,15,30-34,1857,0.015538750440750674
STAT,1865,40,na,1905,21.11580879162454
STAT,1839,32,na,1871,14.71830420167471
STAT,1867,33,30-34,1900,0.16637752125476105
SIM,1826,34,na,1860,14
STAT,1898,45,30-34,1943,7.439420403120458E-4
STAT,1847,27,20-24,1874,0.15062788768141233
STAT,1856,50,50-100,1906,1.1098161232427783E-4
SIM,1828,29,na,1857,19
SIM,1938,19,na,1957,39
STAT,1864,39,na,1903,20.918621227260882
SIM,1944,19,na,1963,32
STAT,1837,20,45-49,1857,0.005888912235529074
STAT,1858,34,50-100,1892,0.006912429319002526
SIM,1769,85,na,1854,1
STAT,1886,15,40-44,1901,0.0019060064379347492
STAT,1933,32,50-100,1965,0.011096720768267287
SIM,1847,33,na,1880,17
STAT,1950,15,30-34,1965,0.14330530756193458
STAT,1886,79,na,1965,10.269784584903121
STAT,1851,23,30-34,1874,0.1782898508657301
STAT,1863,14,na,1877,23.900281878482897
STAT,1910,45,20-24,1955,1.0295967006863438E-4
SIM,1933,23,25-29,1956,1
STAT,1832,29,35-39,1861,0.05689905192722443
STAT,1783,71,na,1854,3.0
STAT,1925,23,25-29,1948,1.095340359029029
STAT,1897,18,20-24,1915,0.2348101708503611
STAT,1916,15,25-29,1931,0.09157962616270582
STAT,1856,33,25-29,1889,0.07433342781347113
STAT,1848,25,50-100,1873,0.005010354220072411
STAT,1915,36,45-49,1951,0.006860134370685787
SIM,1942,24,na,1966,36
SIM,1864,76,na,1940,9
STAT,1868,30,50-100,1898,0.008938196892505726
STAT,1926,39,25-29,1965,0.011938948477090091
STAT,1863,38,25-29,1901,0.02536590104619093
SIM,1864,33,25-29,1897,1
STAT,1832,41,20-24,1873,8.847551036472465E-4
STAT,1931,33,20-24,1964,0.03179973961056904
STAT,1915,18,45-49,1933,0.0010337680823208082
STAT,1883,7,na,1890,25.300130939465564
STAT,1916,37,40-44,1953,0.015198969813556305
STAT,1941,26,45-49,1967,0.017749986590296963
STAT,1805,54,50-100,1859,2.8075760885621617E-4
STAT,1838,47,na,1885,17.96489272491613
SIM,1875,76,na,1951,5
STAT,1924,28,35-39,1952,0.17305989496000362
SIM,1835,48,na,1883,17
STAT,1834,88,na,1922,0.9701769067980542
STAT,1842,21,30-34,1863,0.16978072181270967
STAT,1915,53,na,1968,35.919066036632984
STAT,1853,40,45-49,1893,0.009501013331360735
STAT,1873,42,20-24,1915,0.0016126524915720984
STAT,1893,44,35-39,1937,0.0015641092918709178
STAT,1799,55,na,1854,12.0
STAT,1867,36,35-39,1903,0.06801084102111979
STAT,1917,30,35-39,1947,0.09558557864831874
SIM,1832,34,na,1866,25
STAT,1934,17,35-39,1951,0.056516601279147906
STAT,1860,3,na,1863,26.49076750900789
STAT,1926,36,20-24,1962,0.0032061574738685974
SIM,1940,20,na,1960,31
STAT,1892,42,na,1934,28.518078981452327
SIM,1843,74,na,1917,15
SIM,1793,67,na,1860,16
SIM,1871,21,na,1892,26
STAT,1852,14,na,1866,24.486811767536683
STAT,1899,40,20-24,1939,1.5249348797022281E-4
STAT,1843,47,40-44,1890,7.228337344051712E-4
STAT,1951,15,45-49,1966,0.005915667148373501
SIM,1929,42,na,1971,48
STAT,1863,54,na,1917,18.539845288835544
STAT,1876,38,50-100,1914,0.012407668406326578
STAT,1926,40,25-29,1966,8.777271212998209E-4
STAT,1843,29,40-44,1872,0.01541446128170569
STAT,1857,47,35-39,1904,0.0010431651836804588
STAT,1846,73,na,1919,9.62588143120498
STAT,1921,29,25-29,1950,0.7226455253437066
STAT,1887,44,50-100,1931,0.01137560383367047
STAT,1939,18,30-34,1957,0.12113089741777386
SIM,1850,21,30-34,1871,2
SIM,1902,31,45-49,1933,1
STAT,1867,13,na,1880,25.547619054985574
STAT,1843,100,na,1943,0.004503430086839214
STAT,1849,34,25-29,1883,0.08196905108130964
SIM,1923,17,na,1940,37
STAT,1862,42,45-49,1904,0.012896584726658836
STAT,1896,17,50-100,1913,6.435259624659433E-4
SIM,1816,41,na,1857,12
STAT,1827,49,50-100,1876,0.0018044754694875205
STAT,1865,25,15-19,1890,0.004131522772195213
STAT,1879,20,45-49,1899,0.0072604108154387965
SIM,1914,43,na,1957,36
STAT,1821,59,na,1880,13.004266297954183
STAT,1857,29,35-39,1886,0.07333619909969498
STAT,1911,28,25-29,1939,0.6355068512545005
STAT,1851,29,na,1880,21.077469269827088
STAT,1944,6,na,1950,42.39448220745607
SIM,1812,42,na,1854,18
STAT,1857,24,50-100,1881,0.0031611581630736478
STAT,1917,23,50-100,1940,0.0069082957644428945
SIM,1896,13,na,1909,33
STAT,1852,22,30-34,1874,0.18109884156202297
STAT,1932,22,50-100,1954,0.008598528573816542
STAT,1849,87,na,1936,1.3660904685012432
STAT,1861,45,35-39,1906,0.0011890752827526752
SIM,1901,33,na,1934,39
STAT,1901,29,45-49,1930,0.015425087685918432
STAT,1848,24,30-34,1872,0.13825116858395242
STAT,1799,58,na,1857,11.30779338279983
STAT,1827,50,45-49,1877,1.100303488553255E-4
STAT,1961,1,na,1962,50.57188644248237
STAT,1871,48,30-34,1919,9.529698770353141E-4
STAT,1919,49,50-100,1968,0.0024177041776774523
STAT,1929,17,30-34,1946,0.1548107060625899
SIM,1934,3,na,1937,54
STAT,1868,54,na,1922,20.26417051808603
SIM,1896,5,na,1901,33
STAT,1847,28,50-100,1875,0.008154462588460133
STAT,1903,37,30-34,1940,0.016354801585422272
STAT,1878,20,30-34,1898,0.18499437264940077
STAT,1908,22,40-44,1930,0.03075070315762583
STAT,1872,47,30-34,1919,9.858113288017533E-4
STAT,1944,16,15-19,1960,0.4849880621640717
STAT,1858,42,25-29,1900,0.004880443788673794
STAT,1913,38,30-34,1951,0.017747332752281676
STAT,1939,3,na,1942,40.234089738451914
STAT,1907,25,30-34,1932,0.37084762851310565
STAT,1893,26,35-39,1919,0.1220786631532215
SIM,1872,62,na,1934,18
SIM,1887,61,na,1948,18
STAT,1817,85,na,1902,2.1726201396719462
STAT,1922,26,50-100,1948,0.011218868373549974
STAT,1858,39,na,1897,17.747248905804152
STAT,1873,17,20-24,1890,0.18024467085723692
STAT,1934,35,35-39,1969,0.03329415592784425
STAT,1943,20,35-39,1963,0.09951755294428608
STAT,1899,22,20-24,1921,0.9433663021797157
STAT,1888,40,45-49,1928,0.017666185140635723
STAT,1837,22,35-39,1859,0.039799070703257056
STAT,1902,43,na,1945,32.46909918755329
STAT,1883,37,35-39,1920,0.0686838293222497
STAT,1814,42,15-19,1856,4.412865360722675E-4
STAT,1888,22,45-49,1910,0.00814888617926082
STAT,1826,35,35-39,1861,0.08583391514864666
SIM,1820,49,na,1869,14
STAT,1853,55,na,1908,12.99519132437837
STAT,1912,38,50-100,1950,0.00404562505540825
STAT,1918,44,45-49,1962,0.0017476621425858054
STAT,1905,54,na,1959,30.979452180486614
STAT,1839,17,15-19,1856,0.0428419989178542
STAT,1881,33,15-19,1914,0.0013493524749748382
STAT,1883,22,30-34,1905,0.1729717797270766
STAT,1866,34,30-34,1900,0.15942406439196866
SIM,1829,70,na,1899,16
STAT,1871,80,na,1951,6.16740722181995
STAT,1875,24,25-29,1899,0.5847679702434461
SIM,1807,67,na,1874,14
STAT,1884,48,40-44,1932,0.0016562595587366043
STAT,1923,45,30-34,1968,0.0010405009956192502
STAT,1945,23,na,1968,39.72277940856932
STAT,1901,36,na,1937,33.38650892028353
SIM,1847,36,na,1883,18
STAT,1852,40,30-34,1892,0.009938698252771765
STAT,1870,20,25-29,1890,0.5720643872028616
STAT,1914,42,50-100,1956,0.0011544411234171539
STAT,1931,36,25-29,1967,0.012993911243174653
STAT,1908,24,50-100,1932,0.005980078402076665
STAT,1920,21,45-49,1941,0.012439773214034446
STAT,1934,20,na,1954,49.02771118772766
STAT,1877,53,45-49,1930,1.474007026059032E-4
SIM,1865,21,na,1886,24
STAT,1850,28,40-44,1878,0.03116160681689678
STAT,1820,44,35-39,1864,0.015495489434806525
STAT,1875,79,na,1954,7.186397668735935
STAT,1875,46,40-44,1921,0.0017648334923907423
STAT,1917,7,na,1924,42.485003509014916
STAT,1908,45,35-39,1953,0.001177000716467704
STAT,1880,54,na,1934,22.019069640085345
STAT,1918,26,15-19,1944,0.0074704540084348965
STAT,1875,39,na,1914,23.974338533218116
SIM,1839,39,35-39,1878,1
SIM,1863,51,na,1914,9
STAT,1831,46,30-34,1877,9.387082930652524E-4
STAT,1939,20,15-19,1959,0.05312963363396336
SIM,1881,17,na,1898,26
STAT,1908,27,35-39,1935,0.1423889413017963
STAT,1861,38,50-100,1899,0.010273559689307927
STAT,1942,27,40-44,1969,0.048563913164904715
STAT,1829,31,40-44,1860,0.04212058305684147
STAT,1896,22,40-44,1918,0.027371579199727998
SIM,1878,8,na,1886,31
STAT,1927,38,25-29,1965,0.01216682166815498
STAT,1839,30,20-24,1869,0.018742301425195007
STAT,1868,51,45-49,1919,1.4111517258871443E-4
STAT,1820,34,na,1854,16.56641226798492
STAT,1905,46,25-29,1951,4.702577550668761E-4
SIM,1881,76,na,1957,6
STAT,1887,64,na,1951,18.974316616564835
STAT,1900,42,25-29,1942,6.17597663075682E-4
STAT,1834,45,40-44,1879,0.0014465609939542433
STAT,1941,16,35-39,1957,0.04291958839240944
STAT,1856,19,40-44,1875,0.001548336864479109
SIM,1920,43,na,1963,42
SIM,1933,20,20-24,1953,1
STAT,1839,49,40-44,1888,9.382543957003305E-4
SIM,1911,2,na,1913,42
STAT,1909,13,na,1922,38.45195718156336
SIM,1868,25,40-44,1893,1
SIM,1852,11,na,1863,29
STAT,1809,59,na,1868,14.126743578100658
STAT,1925,43,45-49,1968,0.0019991776773227777
SIM,1874,22,25-29,1896,4
STAT,1822,34,20-24,1856,0.018303692576382265
STAT,1822,63,na,1885,6.531705423726201
STAT,1921,19,15-19,1940,0.5105224475651261
SIM,1903,24,20-24,1927,4
STAT,1842,36,35-39,1878,0.06290094029089335
STAT,1865,20,20-24,1885,0.6400395543008601
SIM,1850,36,35-39,1886,2
SIM,1902,58,na,1960,30
STAT,1881,17,50-100,1898,4.661790063413149E-4
STAT,1938,29,40-44,1967,0.04582740389583335
STAT,1821,41,45-49,1862,0.024145592666678328
SIM,1878,28,na,1906,29
STAT,1847,21,45-49,1868,0.009197845970876811
STAT,1940,20,na,1960,36.96206693974725
SIM,1860,77,na,1937,7
STAT,1803,93,na,1896,0.1095291002090392
SIM,1812,82,na,1894,2
SIM,1799,55,na,1854,19
STAT,1875,28,40-44,1903,0.03068427429384005
STAT,1811,60,na,1871,13.499348699766148
STAT,1866,22,25-29,1888,0.5315263414326309
STAT,1869,79,na,1948,6.773920214012309
STAT,1921,32,20-24,1953,0.026932403760948395
STAT,1827,44,na,1871,15.854253063605896
SIM,1821,56,na,1877,10
STAT,1815,50,50-100,1865,2.18019346992332E-4
STAT,1855,21,40-44,1876,0.017263871024945806
STAT,1925,20,20-24,1945,1.3305538415910683
STAT,1925,25,45-49,1950,0.02041496357835228
STAT,1817,39,40-44,1856,0.15293654904791892
SIM,1859,21,na,1880,22
STAT,1950,18,35-39,1968,0.04929269058725321
STAT,1903,39,50-100,1942,0.003729638439736891
STAT,1886,18,45-49,1904,6.757931090819257E-4
SIM,1884,28,na,1912,26
STAT,1898,67,na,1965,23.825003979565665
STAT,1903,33,45-49,1936,0.014175778275432831
SIM,1873,20,20-24,1893,1
SIM,1957,7,na,1964,56
STAT,1862,69,na,1931,12.661445275079037
STAT,1916,2,na,1918,42.88032689960745
STAT,1844,30,25-29,1874,0.0976796258759944
STAT,1889,25,50-100,1914,0.00788509126834563
STAT,1916,19,40-44,1935,0.002926435860205854
STAT,1919,47,30-34,1966,9.585245142801781E-4
STAT,1926,18,20-24,1944,1.648390235671838
SIM,1800,57,na,1857,12
STAT,1842,18,35-39,1860,0.005255437445888983
STAT,1890,45,25-29,1935,7.066442608481441E-4
STAT,1922,35,na,1957,42.56909391643103
STAT,1886,33,35-39,1919,0.10460135575524569
STAT,1889,43,30-34,1932,0.013974072537021565
STAT,1857,40,15-19,1897,1.0442465082184866E-4
STAT,1872,44,50-100,1916,0.010663395664906173
SIM,1855,7,na,1862,24
STAT,1849,38,50-100,1887,0.009640656338570195
STAT,1883,50,50-100,1933,1.487675667859504E-4
STAT,1884,21,50-100,1905,0.00400739674410833
STAT,1913,29,35-39,1942,0.14728495990805573
STAT,1941,23,40-44,1964,0.03448392627904035
SIM,1876,24,na,1900,31
STAT,1878,46,20-24,1924,1.242418580775787E-4
STAT,1915,26,35-39,1941,0.15233357180371654
STAT,1870,24,40-44,1894,0.020570731485745196
STAT,1798,70,na,1868,12.089699657726403
STAT,1850,21,20-24,1871,0.7417679977769294
STAT,1904,29,25-29,1933,0.6018009722055275
SIM,1878,25,na,1903,29
STAT,1819,42,35-39,1861,0.01716551158759467
STAT,1932,23,30-34,1955,0.37442313377723635
SIM,1899,22,30-34,1921,1
STAT,1860,40,20-24,1900,0.0013041343388075755
SIM,1865,86,na,1951,1
STAT,1853,27,45-49,1880,0.008083755297635529
STAT,1923,45,na,1968,42.880164112306204
STAT,1929,39,40-44,1968,0.019086230345870835
STAT,1832,33,50-100,1865,0.005299274277420288
STAT,1828,42,45-49,1870,0.006597178607952371
STAT,1874,17,35-39,1891,0.005566607112829073
SIM,1903,65,na,1968,26
SIM,1872,34,na,1906,23
SIM,1864,39,na,1903,17
STAT,1921,37,15-19,1958,2.1274849944928091E-4
STAT,1895,33,45-49,1928,0.022543725150977682
SIM,1829,48,na,1877,19
SIM,1913,0,na,1913,49
STAT,1929,36,na,1965,48.1132629203868
STAT,1810,44,40-44,1854,0.022178227576738676
STAT,1901,20,35-39,1921,0.08214125773054569
SIM,1873,81,na,1954,1
STAT,1918,0,na,1918,48.59199203865058
STAT,1841,36,na,1877,24.9578947701665
STAT,1821,81,na,1902,3.3586266756039755
STAT,1864,27,20-24,1891,0.10522207115242113
STAT,1931,40,na,1971,49.532573640376256
STAT,1872,21,40-44,1893,0.021385280837571387
STAT,1899,17,40-44,1916,0.002503821469840876
STAT,1920,3,na,1923,45.11940149483425
STAT,1930,19,25-29,1949,0.5546450660893137
SIM,1879,72,na,1951,7
STAT,1949,16,35-39,1965,0.048504149131254955
STAT,1892,20,15-19,1912,0.04099957090067645
SIM,1924,33,na,1957,50
STAT,1886,40,40-44,1926,0.023566398577447856
STAT,1866,49,35-39,1915,0.0012624530269190757
SIM,1915,31,25-29,1946,1
STAT,1929,31,45-49,1960,0.019903880634804704
STAT,1950,18,50-100,1968,0.004401132272722423
STAT,1839,42,20-24,1881,9.237077359508708E-4
STAT,1851,48,45-49,1899,0.001967350565595685
STAT,1932,16,25-29,1948,0.5729033009292902
STAT,1937,31,na,1968,37.20327067731076
SIM,1915,50,na,1965,31
STAT,1883,46,30-34,1929,9.426757117402774E-4
STAT,1915,16,na,1931,40.17265948424147
SIM,1911,60,na,1971,38
STAT,1869,43,45-49,1912,0.014396810228940135
SIM,1857,57,na,1914,20
STAT,1833,31,30-34,1864,0.16816330517088235
STAT,1849,16,30-34,1865,0.015302741631799493
STAT,1813,100,na,1913,0.007006385199891068
STAT,1848,27,35-39,1875,0.07449332638482117
SIM,1830,39,na,1869,19
STAT,1927,16,15-19,1943,0.5627843432018899
SIM,1785,78,na,1863,4
STAT,1864,40,20-24,1904,0.0014388034410947631
STAT,1909,16,na,1925,37.755585899100865
STAT,1913,21,na,1934,36.78024686509358
STAT,1843,37,na,1880,10.606401910659393
STAT,1927,35,50-100,1962,0.0052023986973832375
STAT,1949,23,40-44,1972,0.0389708654141144
SIM,1923,26,35-39,1949,1
SIM,1940,23,30-34,1963,3
STAT,1868,35,40-44,1903,0.04276540513647474
STAT,1923,11,na,1934,46.27322588452895
STAT,1940,18,40-44,1958,0.014096372543158908
SIM,1910,13,na,1923,33
STAT,1852,73,na,1925,10.165359875741549
STAT,1822,69,na,1891,5.205605484487182
SIM,1877,71,na,1948,12
STAT,1831,27,25-29,1858,0.4625304132930411
STAT,1852,19,40-44,1871,0.001871021867943682
STAT,1935,30,na,1965,52.15138268370581
STAT,1845,32,35-39,1877,0.07038625990008232
SIM,1865,52,na,1917,19
STAT,1847,37,30-34,1884,0.05907002466649232
STAT,1812,79,na,1891,2.7783544020435134
STAT,1898,27,50-100,1925,0.00862945585524951
STAT,1809,81,na,1890,2.9921142505644713
STAT,1881,51,45-49,1932,1.3875264068636175E-4
STAT,1878,19,50-100,1897,5.030882494391077E-4
STAT,1878,1,na,1879,35.45507846635309
STAT,1879,38,20-24,1917,0.007938790384937841
STAT,1889,18,25-29,1907,0.06919777835896354
STAT,1890,49,40-44,1939,0.0011485590117587495
STAT,1847,21,na,1868,28.202440225294158
STAT,1923,18,40-44,1941,0.016267762644176988
STAT,1830,64,na,1894,6.245784468820134
STAT,1870,46,20-24,1916,1.1954508421647218E-4
STAT,1792,85,na,1877,1.797358129628578
STAT,1864,51,45-49,1915,1.3078795323794482E-4
STAT,1905,26,na,1931,34.56149063099729
STAT,1861,56,na,1917,17.15241485952356
SIM,1880,28,25-29,1908,1
STAT,1827,78,na,1905,4.735014166434017
STAT,1882,5,na,1887,25.510156854879526
STAT,1892,48,na,1940,27.450566329216528
STAT,1854,38,15-19,1892,3.41533895069882E-4
STAT,1942,18,na,1960,38.17296431326675
STAT,1956,16,50-100,1972,0.0049310377882633965
STAT,1776,103,na,1879,3.6283213080759853E-4
STAT,1823,32,15-19,1855,0.0021597730636391445
SIM,1905,60,na,1965,39
STAT,1889,22,na,1911,28.956039828211615
SIM,1888,49,na,1937,32
SIM,1880,69,na,1949,23
STAT,1839,35,15-19,1874,3.780964350097566E-4
STAT,1894,41,45-49,1935,0.01926760778444876
STAT,1910,44,45-49,1954,0.0015440886222397462
STAT,1885,32,na,1917,23.565175010828845
STAT,1909,20,35-39,1929,0.08754077810699414
STAT,1818,44,40-44,1862,0.02277097224281126
STAT,1878,84,na,1962,5.38999922471616
STAT,1950,21,25-29,1971,1.0893697355704994
STAT,1919,46,na,1965,39.600033310120004
STAT,1963,2,na,1965,49.68721235824823
SIM,1874,69,na,1943,17
SIM,1901,70,na,1971,25
SIM,1823,51,na,1874,11
STAT,1867,36,50-100,1903,0.011805562704505201
STAT,1848,42,30-34,1890,0.007425748129434591
STAT,1927,34,45-49,1961,0.01923316240712472
STAT,1872,28,25-29,1900,0.43129202355421437
SIM,1859,52,na,1911,18
STAT,1890,23,15-19,1913,0.039949513819992975
STAT,1915,31,15-19,1946,0.0013027690281911012
STAT,1840,32,15-19,1872,0.0013591511973052128
STAT,1858,21,20-24,1879,0.6060100866585539
STAT,1818,47,50-100,1865,0.00241627321788498
SIM,1779,78,na,1857,3
SIM,1873,1,na,1874,34
STAT,1929,30,na,1959,47.86487432697698
STAT,1907,31,25-29,1938,0.08638043052300085
STAT,1881,70,na,1951,13.350860510106381
SIM,1866,21,20-24,1887,2
STAT,1815,81,na,1896,1.9303602248620437
SIM,1886,54,na,1940,26
STAT,1901,29,50-100,1930,0.00888704263668466
STAT,1839,45,25-29,1884,3.3227339272804546E-4
STAT,1914,28,40-44,1942,0.04643451976075987
STAT,1811,52,45-49,1863,5.507668394524592E-4
STAT,1921,37,50-100,1958,0.00465145524096521
SIM,1875,2,na,1877,26
STAT,1823,103,na,1926,8.253377967680706E-4
STAT,1888,28,20-24,1916,0.13661093984730574
STAT,1809,87,na,1896,0.9748292067964343
STAT,1824,31,20-24,1855,0.04561305401076872
STAT,1835,36,na,1871,12.032713345564146
STAT,1890,41,45-49,1931,0.018261990578472328
STAT,1812,49,50-100,1861,0.002685935208219344
STAT,1840,88,na,1928,1.075742176729703
STAT,1870,39,15-19,1909,5.522186641868627E-4
STAT,1890,30,20-24,1920,0.03309805829162198
STAT,1911,26,na,1937,36.422116198420625
STAT,1827,34,40-44,1861,0.03636293703061087
STAT,1891,15,15-19,1906,0.07317694616989118
STAT,1879,44,15-19,1923,1.4100378858915766E-4
SIM,1811,66,na,1877,5
STAT,1869,19,20-24,1888,0.17211225781012135
STAT,1853,21,na,1874,15.992068483889538
STAT,1903,39,20-24,1942,0.002341685674529537
SIM,1791,72,na,1863,3
STAT,1824,64,na,1888,12.287409546960307
STAT,1803,96,na,1899,0.03218053735066686
STAT,1863,35,20-24,1898,0.006889896233883339
STAT,1928,15,20-24,1943,1.707835013904679
STAT,1863,28,15-19,1891,0.004002931363981438
STAT,1863,19,50-100,1882,4.4513747707147875E-4
STAT,1894,25,40-44,1919,0.038651360458831066
SIM,1912,48,na,1960,35
SIM,1916,9,na,1925,47
STAT,1925,46,na,1971,44.3489004844792
STAT,1891,22,20-24,1913,0.84580700205536
STAT,1924,31,25-29,1955,0.10719252115601585
STAT,1889,49,50-100,1938,0.0016607602552414485
STAT,1848,17,25-29,1865,0.045429035525827506
STAT,1845,42,45-49,1887,0.008908854098411101
STAT,1840,50,45-49,1890,1.1535217952158705E-4
STAT,1854,32,45-49,1886,0.010915307900526226
SIM,1785,72,na,1857,9
SIM,1912,29,25-29,1941,1
STAT,1838,37,20-24,1875,0.007219306478062278
STAT,1933,21,25-29,1954,1.223927139212647
STAT,1916,29,50-100,1945,0.010130677015536773
SIM,1854,43,na,1897,17
STAT,1858,16,40-44,1874,0.0016354296095775532
STAT,1830,29,30-34,1859,0.18867817110602197
STAT,1923,23,20-24,1946,1.2808658881231831
STAT,1900,15,35-39,1915,0.007644202686938995
STAT,1844,34,40-44,1878,0.03967493703208004
STAT,1810,44,na,1854,10.880436476450578
STAT,1936,18,na,1954,34.9345620286653
SIM,1871,86,na,1957,5
STAT,1892,49,45-49,1941,0.0016102813899874213
SIM,1899,25,35-39,1924,1
SIM,1941,21,25-29,1962,3
SIM,1892,54,na,1946,32
STAT,1912,20,40-44,1932,0.03216212648340744
STAT,1869,33,35-39,1902,0.0977112463432931
STAT,1914,20,45-49,1934,0.011004779865668236
STAT,1883,30,15-19,1913,0.0013940104263839574
STAT,1859,18,na,1877,21.05337585411329
STAT,1915,23,30-34,1938,0.29361929055931807
STAT,1878,49,25-29,1927,5.822561970290702E-4
STAT,1938,13,na,1951,38.76767693127718
STAT,1878,33,45-49,1911,0.01792755152171334
STAT,1941,30,na,1971,39.465182226993925
SIM,1883,71,na,1954,3
STAT,1843,16,50-100,1859,2.6715371206826965E-4
STAT,1892,30,25-29,1922,0.12755504660371939
STAT,1884,44,25-29,1928,0.0062066219941845835
STAT,1898,33,na,1931,32.05550919801804
STAT,1857,17,35-39,1874,0.004827940608032629
STAT,1836,42,35-39,1878,0.020789775972291112
STAT,1897,57,na,1954,26.687003311773612
STAT,1920,42,50-100,1962,0.0012864488279109934
STAT,1939,19,45-49,1958,0.004962642499391171
SIM,1841,42,na,1883,16
STAT,1831,24,20-24,1855,0.9508714403419011
STAT,1866,16,30-34,1882,0.015156321982317254
STAT,1836,89,na,1925,1.0138768784186991
STAT,1913,26,30-34,1939,0.3884818810895794
SIM,1845,32,na,1877,24
SIM,1900,23,na,1923,35
STAT,1823,50,45-49,1873,1.0148830271665558E-4
STAT,1849,26,40-44,1875,0.027732957165409074
STAT,1858,19,45-49,1877,5.738218046255263E-4
STAT,1897,36,15-19,1933,7.49296664605391E-4
STAT,1900,22,40-44,1922,0.028895801827612977
SIM,1810,50,na,1860,18
SIM,1863,57,na,1920,9
STAT,1864,43,25-29,1907,0.005718046929110208
STAT,1876,36,45-49,1912,0.0203442117995754
STAT,1894,43,na,1937,29.508245715181957
STAT,1929,29,30-34,1958,0.48755345085980256
STAT,1836,27,45-49,1863,0.01386531081606017
STAT,1852,53,45-49,1905,1.2221000369706008E-4
SIM,1867,16,na,1883,15
STAT,1921,16,na,1937,41.730796740880976
STAT,1940,23,20-24,1963,1.1243213701254964
STAT,1938,18,50-100,1956,0.0036702239311999585
STAT,1852,36,50-100,1888,0.010674901057670657
STAT,1932,26,35-39,1958,0.1959385120401775
SIM,1828,60,na,1888,9
STAT,1818,95,na,1913,0.0332259289690547
STAT,1811,91,na,1902,0.3283967868636477
STAT,1791,66,na,1857,7.153357216832001
STAT,1904,19,15-19,1923,0.084579596600432
SIM,1937,29,30-34,1966,1
STAT,1817,103,na,1920,0.0011374113933297753
STAT,1873,30,20-24,1903,0.027702701432913604
STAT,1886,43,45-49,1929,0.015412001431312147
SIM,1882,24,na,1906,29
STAT,1872,99,na,1971,0.14354983641084287
STAT,1853,92,na,1945,0.2617587417178441
STAT,1883,49,35-39,1932,0.0013311284347750612
STAT,1887,32,40-44,1919,0.04733559622680305
STAT,1822,37,25-29,1859,0.017681251542826223
STAT,1862,17,45-49,1879,6.454679418316778E-4
STAT,1920,39,20-24,1959,0.002855566437527288
STAT,1844,19,na,1863,22.52388487035101
STAT,1866,40,25-29,1906,0.005973823707909642
STAT,1859,46,na,1905,17.93288507578727
STAT,1809,45,45-49,1854,0.008295945261267474
STAT,1810,47,45-49,1857,0.002301561028996024
STAT,1802,52,35-39,1854,1.318090607500952E-4
SIM,1838,59,na,1897,4
STAT,1923,33,30-34,1956,0.17925505371421935
STAT,1895,23,35-39,1918,0.07552532865527259
STAT,1862,32,35-39,1894,0.08737274366922998
SIM,1904,13,na,1917,33
STAT,1831,77,na,1908,7.014487888127109
STAT,1829,53,50-100,1882,1.111733362628822E-4
SIM,1907,27,na,1934,40
STAT,1861,50,na,1911,18.367390403620973
STAT,1912,35,50-100,1947,0.004104404694064364
STAT,1857,21,50-100,1878,0.0035497133448327877
STAT,1887,36,20-24,1923,0.00845437170494823
STAT,1906,36,35-39,1942,0.022285841834197247
STAT,1908,15,35-39,1923,0.008134905170832046
SIM,1895,32,40-44,1927,1
SIM,1899,2,na,1901,31
SIM,1817,51,na,1868,8
STAT,1870,27,45-49,1897,0.011029624448011248
SIM,1863,26,na,1889,17
SIM,1860,15,na,1875,28
STAT,1873,27,30-34,1900,0.25602251685369504
SIM,1915,22,na,1937,31
STAT,1850,24,25-29,1874,0.6030091153728577
STAT,1923,48,35-39,1971,0.0014936433776527767
STAT,1903,49,30-34,1952,7.601038681892207E-4
STAT,1933,31,35-39,1964,0.12272085792111484
SIM,1908,20,25-29,1928,2
STAT,1837,38,15-19,1875,3.296410618783896E-4
STAT,1885,60,na,1945,18.83368169759583
STAT,1819,52,45-49,1871,1.2609111839069416E-4
STAT,1924,21,15-19,1945,0.06259271302904683
SIM,1828,41,40-44,1869,2
STAT,1847,92,na,1939,0.4449144509361751
STAT,1914,18,30-34,1932,0.024938946897369897
STAT,1856,35,15-19,1891,4.106658235058411E-4
STAT,1901,41,30-34,1942,0.001122165548312074
STAT,1867,75,na,1942,9.851546083275364
STAT,1845,63,na,1908,10.43012969799484
SIM,1877,9,na,1886,31
STAT,1835,35,45-49,1870,0.011424258459947207
STAT,1858,24,25-29,1882,0.44830855639542294
STAT,1830,31,45-49,1861,0.011877008070613669
SIM,1847,67,na,1914,12
STAT,1888,38,30-34,1926,0.0619724256651468
STAT,1950,13,na,1963,46.15140895797578
STAT,1877,28,45-49,1905,0.011420883228435241
STAT,1898,18,35-39,1916,0.007382697608497029
STAT,1927,31,40-44,1958,0.0479205634267114
SIM,1862,22,35-39,1884,2
STAT,1850,19,na,1869,24.68134581108673
SIM,1813,61,na,1874,6
STAT,1849,22,na,1871,20.04433583508883
STAT,1882,23,25-29,1905,0.5469145542924672
SIM,1890,53,na,1943,24
SIM,1931,33,30-34,1964,1
STAT,1867,21,30-34,1888,0.17239654109542413
SIM,1914,2,na,1916,38
STAT,1905,34,25-29,1939,0.08415468720136991
STAT,1879,40,35-39,1919,0.01893121829135232
SIM,1948,16,25-29,1964,3
SIM,1854,15,na,1869,19
STAT,1842,48,35-39,1890,0.0010371923370393968
STAT,1899,15,15-19,1914,0.0816175143328691
STAT,1910,48,25-29,1958,4.905238161964769E-4
STAT,1844,37,45-49,1881,0.016454293770836043
STAT,1824,34,25-29,1858,0.15702461551750743
STAT,1854,22,35-39,1876,0.04190923132438999
STAT,1854,46,50-100,1900,0.0015054553751086663
STAT,1849,22,25-29,1871,0.5366612211382771
STAT,1878,42,50-100,1920,0.010893566426107273
STAT,1874,32,30-34,1906,0.1771273328875785
STAT,1925,45,35-39,1970,0.0015598486086522755
STAT,1818,47,45-49,1865,0.0023218260600870563
STAT,1907,47,40-44,1954,0.0014060090552986152
SIM,1822,75,na,1897,9
STAT,1837,37,na,1874,12.607613743772461
STAT,1891,25,25-29,1916,0.5227146967230019
STAT,1839,63,na,1902,9.846793121339434
STAT,1874,23,na,1897,23.91907587273951
STAT,1816,69,na,1885,5.05272407873669
STAT,1916,30,20-24,1946,0.0251680173918947
STAT,1841,46,25-29,1887,5.736559032087538E-4
STAT,1870,49,25-29,1919,5.602448899785443E-4
STAT,1918,6,na,1924,43.23061920696175
STAT,1932,28,na,1960,48.84469248554334
STAT,1840,17,25-29,1857,0.05749107263465491
STAT,1882,58,na,1940,18.95218245861422
STAT,1888,74,na,1962,15.217905267476002
SIM,1869,42,na,1911,16
SIM,1919,12,na,1931,47
STAT,1851,45,40-44,1896,0.001459732572834535
STAT,1823,31,50-100,1854,0.01424743034372634
STAT,1865,29,50-100,1894,0.005744583513816596
STAT,1910,34,35-39,1944,0.08682543224700838
STAT,1909,18,20-24,1927,0.2636839406180025
STAT,1931,24,25-29,1955,1.185238211528267
STAT,1878,39,15-19,1917,5.739146310646931E-4
STAT,1885,38,45-49,1923,0.019588333983607136
STAT,1915,33,40-44,1948,0.03934479427767592
STAT,1865,35,25-29,1900,0.026289297820591882
SIM,1857,22,25-29,1879,1
STAT,1939,32,15-19,1971,0.0013021578418756295
STAT,1832,26,30-34,1858,0.15174097948447138
STAT,1873,75,na,1948,10.46646498526098
STAT,1823,42,25-29,1865,0.004551762926758997
STAT,1944,13,na,1957,41.959201964664025
STAT,1928,37,30-34,1965,0.02292089125028044
STAT,1910,30,50-100,1940,0.00798705036145059
SIM,1895,65,na,1960,18
STAT,1839,19,40-44,1858,0.0013048834661275645
SIM,1914,26,25-29,1940,2
STAT,1889,28,na,1917,29.11610983256368
STAT,1876,89,na,1965,2.528936099312757
STAT,1771,83,na,1854,2.0
SIM,1916,38,na,1954,44
STAT,1866,46,30-34,1912,8.940413070589331E-4
STAT,1826,29,40-44,1855,0.07833653701378902
SIM,1853,67,na,1920,17
STAT,1912,23,45-49,1935,0.010665774192199905
SIM,1795,62,na,1857,11
STAT,1907,41,35-39,1948,0.0018476833689480318
SIM,1816,75,na,1891,1
STAT,1828,54,na,1882,14.894160729837305
STAT,1847,47,40-44,1894,0.001820295690125256
STAT,1890,33,25-29,1923,0.12389217084959553
SIM,1814,46,na,1860,22
STAT,1892,46,40-44,1938,0.0011964335041007846
SIM,1808,46,na,1854,17
SIM,1870,39,na,1909,23
STAT,1834,54,na,1888,14.99598174531859
SIM,1830,33,na,1863,20
SIM,1900,20,25-29,1920,2
STAT,1871,32,45-49,1903,0.01738591347540087
STAT,1837,48,25-29,1885,2.8733903546048417E-4
STAT,1846,31,40-44,1877,0.0419672933145839
STAT,1882,47,25-29,1929,5.494325321990027E-4
SIM,1851,32,na,1883,19
STAT,1829,38,25-29,1867,0.026152313765324
STAT,1942,20,20-24,1962,1.1581743677342706
SIM,1890,23,25-29,1913,1
STAT,1902,43,40-44,1945,0.0021867202521716656
STAT,1844,19,15-19,1863,0.058232410526969494
STAT,1894,33,50-100,1927,0.011692975213986538
STAT,1943,7,na,1950,41.71744085772737
SIM,1834,60,na,1894,12
STAT,1835,32,50-100,1867,0.0053066920841479326
SIM,1777,77,na,1854,2
STAT,1886,30,30-34,1916,0.1825595046217496
STAT,1896,29,25-29,1925,0.5516730959144716
STAT,1921,44,20-24,1965,1.9670455768553338E-4
STAT,1862,104,na,1966,0.0036029275967335945
STAT,1928,18,25-29,1946,0.5419423452873593
STAT,1845,44,50-100,1889,0.006129514132111239
SIM,1950,20,20-24,1970,1
STAT,1906,26,25-29,1932,0.6166707517934329
STAT,1865,32,20-24,1897,0.024448824201131716
STAT,1874,28,50-100,1902,0.006466780843158618
SIM,1856,78,na,1934,4
STAT,1860,41,35-39,1901,0.01478803278692383
STAT,1872,25,20-24,1897,0.12084705548820279
STAT,1836,80,na,1916,5.9701042403739635
STAT,1823,36,30-34,1859,0.039038814184503584
STAT,1914,37,na,1951,37.25196966537806
STAT,1888,34,15-19,1922,0.001649925287759677
STAT,1920,49,30-34,1969,9.713137421150789E-4
STAT,1836,40,45-49,1876,0.01762875076762901
STAT,1836,24,40-44,1860,0.026161151963189747
STAT,1832,36,40-44,1868,0.025101533073839378
SIM,1913,27,na,1940,42
SIM,1838,53,na,1891,4
STAT,1919,18,15-19,1937,0.4958716801603698
SIM,1914,8,na,1922,37
STAT,1884,41,20-24,1925,0.0015630141878401717
SIM,1818,39,na,1857,27
STAT,1819,49,na,1868,13.496304477681582
STAT,1919,8,na,1927,43.69306124607966
STAT,1882,89,na,1971,3.0688523907557865
STAT,1905,38,40-44,1943,0.013568764790967356
SIM,1862,72,na,1934,16
SIM,1877,30,30-34,1907,2
SIM,1829,76,na,1905,15
STAT,1863,82,na,1945,4.131109698941783
STAT,1934,15,45-49,1949,0.006759425610863151
STAT,1874,54,40-44,1928,1.0386511232962087E-4
STAT,1878,42,40-44,1920,0.023193328598973398
STAT,1865,42,30-34,1907,0.01038580126478775
SIM,1939,32,na,1971,29
STAT,1896,72,na,1968,20.104043892067843
STAT,1832,90,na,1922,0.3563663184580888
STAT,1862,38,na,1900,20.225718095150665
STAT,1875,19,45-49,1894,6.678765762388317E-4
STAT,1874,47,35-39,1921,0.0014136665178643463
STAT,1852,42,na,1894,19.756350858463616
STAT,1929,19,50-100,1948,0.004733005840461888
SIM,1940,29,na,1969,32
STAT,1825,43,na,1868,14.555908076799074
STAT,1888,43,na,1931,26.813994648194264
STAT,1911,37,20-24,1948,0.0025297129740587464
STAT,1924,41,35-39,1965,0.002383041782803426
STAT,1846,28,15-19,1874,0.004416241947213786
STAT,1940,26,25-29,1966,0.6667224660953467
STAT,1947,24,20-24,1971,1.2472711361541222
STAT,1919,25,20-24,1944,0.19684853584615197
SIM,1921,22,na,1943,38
STAT,1869,70,na,1939,13.594966856214766
STAT,1900,37,45-49,1937,0.005966568000537898
STAT,1881,27,20-24,1908,0.11162985481028916
STAT,1832,48,40-44,1880,8.986878946068136E-4
SIM,1876,92,na,1968,1
STAT,1915,41,25-29,1956,7.137492266998848E-4
STAT,1866,19,35-39,1885,0.0051260944302785535
STAT,1806,50,45-49,1856,4.892333219932251E-4
STAT,1813,58,na,1871,16.730481059293734
STAT,1873,41,45-49,1914,0.015285080112816122
STAT,1890,27,30-34,1917,0.3058852656414072
STAT,1959,12,na,1971,51.08833550203362
STAT,1865,47,25-29,1912,5.185558473491715E-4
SIM,1842,58,na,1900,19
SIM,1853,9,na,1862,29
SIM,1884,26,35-39,1910,1
STAT,1883,40,25-29,1923,0.006298790079610333
STAT,1859,23,30-34,1882,0.14583423556747058
STAT,1861,25,45-49,1886,0.009541516122065509
STAT,1888,48,40-44,1936,0.0011143474889012772
SIM,1829,79,na,1908,13
STAT,1931,28,40-44,1959,0.05988081610512214
SIM,1887,30,na,1917,25
STAT,1847,40,20-24,1887,0.0017502387766474162
STAT,1907,52,na,1959,32.04430012105275
STAT,1891,44,30-34,1935,0.013920144916440499
STAT,1819,41,50-100,1860,0.010202068480445872
STAT,1910,31,30-34,1941,0.15160236386911127
SIM,1807,61,na,1868,15
STAT,1865,52,50-100,1917,1.3587525262791477E-4
SIM,1848,29,35-39,1877,1
SIM,1850,53,na,1903,20
STAT,1852,45,na,1897,19.4471883179228
STAT,1836,45,50-100,1881,0.002544898430471823
STAT,1888,41,20-24,1929,0.0018642834100885846
SIM,1845,38,na,1883,23
SIM,1958,6,na,1964,53
STAT,1878,30,40-44,1908,0.04513291427139223
STAT,1897,46,25-29,1943,4.326936182186444E-4
SIM,1874,3,na,1877,32
STAT,1891,32,30-34,1923,0.21429425047907258
STAT,1847,33,15-19,1880,0.0017676921977399934
STAT,1941,6,na,1947,40.74829799792811
STAT,1890,42,50-100,1932,0.01281695246147679
SIM,1817,48,50-100,1865,1
STAT,1849,56,na,1905,15.815144700808661
SIM,1887,33,na,1920,25
STAT,1877,41,45-49,1918,0.01551913784796648
STAT,1824,95,na,1919,0.09251196442175257
SIM,1925,12,na,1937,45
STAT,1923,36,35-39,1959,0.027856942191489285
STAT,1942,30,30-34,1972,0.16679498139176935
STAT,1841,53,50-100,1894,1.4545441810567218E-4
STAT,1870,30,na,1900,23.895888434367503
STAT,1885,34,50-100,1919,0.008970594636556764
STAT,1840,57,na,1897,15.747292309557084
STAT,1865,18,na,1883,23.401455774110286
STAT,1905,24,15-19,1929,0.04731481418169311
STAT,1840,26,20-24,1866,0.11544799668312489
STAT,1882,20,20-24,1902,0.6643590325485519
STAT,1915,48,45-49,1963,0.002165090257955206
STAT,1850,52,50-100,1902,1.3375373017575568E-4
SIM,1872,37,30-34,1909,2
STAT,1827,46,50-100,1873,0.0018756164334607693
SIM,1805,66,na,1871,9
STAT,1926,25,na,1951,44.95385194431185
STAT,1937,23,15-19,1960,0.05149324348361703
STAT,1863,34,45-49,1897,0.015307570994819877
STAT,1882,25,15-19,1907,0.00437752853462002
STAT,1801,54,40-44,1855,2.896764804202154E-4
STAT,1856,49,40-44,1905,0.0012143348372859514
STAT,1839,23,50-100,1862,0.002870757260206575
SIM,1826,65,na,1891,11
STAT,1850,43,30-34,1893,0.010162298103323537
STAT,1906,48,35-39,1954,0.0011328967398175618
STAT,1856,53,50-100,1909,1.0765266937891449E-4
STAT,1841,41,30-34,1882,0.011844179912449949
STAT,1863,85,na,1948,2.427179700118554
STAT,1903,15,50-100,1918,6.997699917246752E-4
STAT,1921,19,na,1940,41.40531087534266
STAT,1870,64,na,1934,17.26865399963587
STAT,1815,41,20-24,1856,0.0025156155764294147
SIM,1869,11,na,1880,19
STAT,1873,49,40-44,1922,0.0017042358321067022
STAT,1947,24,na,1971,40.962230790143145
STAT,1864,37,30-34,1901,0.04780220270340478
STAT,1896,26,20-24,1922,0.1546256554626141
SIM,1838,50,na,1888,5
STAT,1906,46,45-49,1952,0.0019395326176823088
STAT,1929,35,25-29,1964,0.012602082893915541
STAT,1836,83,na,1919,3.8313416667981617
STAT,1877,25,40-44,1902,0.031131824857685713
STAT,1931,20,45-49,1951,0.01461528870207576
STAT,1876,55,na,1931,21.000644976572485
STAT,1828,32,35-39,1860,0.13863104124497627
STAT,1819,43,na,1862,14.503938840913893
STAT,1828,40,50-100,1868,0.004754861583609704
STAT,1905,30,45-49,1935,0.025369863479394555
STAT,1855,56,na,1911,14.36044748269625
STAT,1830,95,na,1925,0.047769819091738906
STAT,1914,21,50-100,1935,0.006416687882308101
STAT,1841,31,20-24,1872,0.03243644758797057
STAT,1894,77,na,1971,15.742920276317045
STAT,1925,42,30-34,1967,0.0015381307450815676
STAT,1900,20,15-19,1920,0.046019924480228486
STAT,1832,34,15-19,1866,8.151327015200729E-4
STAT,1901,64,na,1965,26.64380696888996
STAT,1829,47,20-24,1876,1.0243713754147094E-4
SIM,1857,26,na,1883,23
STAT,1849,53,na,1902,16.427411189800143
STAT,1896,38,20-24,1934,0.010075155745810652
SIM,1832,65,na,1897,18
STAT,1879,50,45-49,1929,1.523634445927836E-4
STAT,1882,39,40-44,1921,0.04152930247957127
STAT,1923,20,50-100,1943,0.00764839476847705
STAT,1832,22,15-19,1854,0.02012983863105248
STAT,1859,8,na,1867,22.656194538697545
STAT,1850,31,30-34,1881,0.16431913210337679
SIM,1940,26,na,1966,35
STAT,1837,44,45-49,1881,0.0076255334802501325
STAT,1799,86,na,1885,0.8151932024220079
STAT,1829,35,20-24,1864,0.007233834071642686
STAT,1867,18,40-44,1885,0.0017788028370464548
STAT,1855,37,20-24,1892,0.005427314350553853
STAT,1932,36,45-49,1968,0.00913081285559619
STAT,1922,19,35-39,1941,0.04794835743163849
STAT,1916,40,30-34,1956,0.0013025389791400997
SIM,1818,36,na,1854,26
STAT,1832,40,45-49,1872,0.008445364516795558
STAT,1914,21,20-24,1935,1.0843559703070493
STAT,1826,28,na,1854,18.783690287191043
STAT,1826,90,na,1916,0.550951198398154
STAT,1874,40,15-19,1914,1.4151318968074603E-4
STAT,1821,50,na,1871,15.540776208481779
SIM,1922,21,20-24,1943,2
STAT,1882,32,20-24,1914,0.025904595346450544
STAT,1845,23,50-100,1868,0.0029380046203002167
STAT,1862,30,45-49,1892,0.015166015598453247
STAT,1876,35,50-100,1911,0.012587941727630487
SIM,1881,48,na,1929,22
STAT,1936,24,45-49,1960,0.010684876056419145
SIM,1906,48,na,1954,22
STAT,1877,31,35-39,1908,0.10496496606813847
STAT,1873,37,40-44,1910,0.04450574813775176
STAT,1901,42,45-49,1943,0.0014524665369170585
STAT,1911,49,20-24,1960,1.0333754400100915E-4
STAT,1945,15,20-24,1960,1.4711426992547862
SIM,1898,6,na,1904,37
STAT,1841,24,15-19,1865,0.04032138316265336
STAT,1877,21,25-29,1898,0.5927082074644587
STAT,1815,48,40-44,1863,0.002432603054067947
STAT,1941,31,25-29,1972,0.09639247776422621
SIM,1863,20,na,1883,16
STAT,1831,43,na,1874,20.532875637377707
STAT,1846,42,na,1888,18.95769502208314
STAT,1872,18,15-19,1890,0.06056146742087973
STAT,1922,30,45-49,1952,0.017791122194968912
SIM,1894,18,na,1912,32
STAT,1846,35,20-24,1881,0.006660706123865477
STAT,1884,84,na,1968,6.270072019348874
STAT,1886,48,na,1934,23.043612225781942
SIM,1953,15,20-24,1968,3
STAT,1789,93,na,1882,0.04447309013899831
STAT,1863,16,15-19,1879,0.060313314931634075
SIM,1935,2,na,1937,61
STAT,1848,22,50-100,1870,0.00321103614149489
STAT,1818,64,na,1882,4.771185579876956
STAT,1937,27,30-34,1964,0.3795381352306341
SIM,1918,33,na,1951,37
SIM,1839,38,na,1877,19
STAT,1854,22,50-100,1876,0.002928667800809616
STAT,1830,98,na,1928,0.011671751887930154
STAT,1861,15,35-39,1876,0.0053667531352025065
SIM,1936,15,20-24,1951,1
STAT,1880,23,na,1903,24.792894306817775
SIM,1953,18,25-29,1971,1
SIM,1814,40,na,1854,22
STAT,1900,34,40-44,1934,0.05962160215879207
SIM,1836,24,na,1860,13
STAT,1834,57,na,1891,14.20197113566332
STAT,1945,18,25-29,1963,0.4698348616375894
STAT,1849,19,35-39,1868,0.0051756157422808945
STAT,1913,52,na,1965,34.95962951044609
STAT,1872,96,na,1968,0.4044733538475639
STAT,1886,31,45-49,1917,0.01816199948606843
STAT,1815,50,na,1865,10.446464597770676
STAT,1906,23,20-24,1929,0.998077998588754
STAT,1856,45,25-29,1901,4.2143364381032247E-4
STAT,1941,0,na,1941,45.80181843856225
STAT,1925,28,50-100,1953,0.011641538306954904
STAT,1819,40,45-49,1859,0.014731542719121374
STAT,1895,30,40-44,1925,0.05675420948390981
STAT,1870,15,45-49,1885,6.62873443793242E-4
STAT,1846,15,50-100,1861,5.046951984153399E-4
STAT,1847,43,25-29,1890,0.006810205695957468
STAT,1892,42,25-29,1934,0.007923489943744732
STAT,1899,19,30-34,1918,0.02170200389249392
STAT,1875,16,40-44,1891,0.0018847553115807583
STAT,1823,39,35-39,1862,0.04996478276468535
STAT,1845,97,na,1942,0.03140337970374106
SIM,1914,23,20-24,1937,1
SIM,1882,44,30-34,1926,1
STAT,1923,26,25-29,1949,0.7530298504164235
STAT,1832,38,30-34,1870,0.02993280588339652
SIM,1824,39,na,1863,18
STAT,1844,25,45-49,1869,0.010770744560830874
STAT,1867,41,na,1908,22.217730164170607
STAT,1883,42,15-19,1925,1.3393959058863777E-4
SIM,1888,18,na,1906,38
STAT,1869,40,40-44,1909,0.022014075823388764
STAT,1874,51,50-100,1925,1.53949176880356E-4
STAT,1838,43,15-19,1881,1.1261612564221627E-4
STAT,1874,44,30-34,1918,0.011505852989268506
SIM,1893,33,na,1926,34
STAT,1941,25,30-34,1966,0.40274244357722894
STAT,1853,24,40-44,1877,0.015252478186765624
STAT,1803,103,na,1906,5.378566067810785E-4
STAT,1888,44,25-29,1932,0.007402941384964855
STAT,1858,18,30-34,1876,0.01408421088155376
STAT,1913,19,25-29,1932,0.08739014765956507
SIM,1890,59,na,1949,23
STAT,1836,30,35-39,1866,0.12613048938524987
STAT,1850,36,25-29,1886,0.026313125886396938
STAT,1908,37,na,1945,35.04142070784209
STAT,1895,22,na,1917,30.70436725736484
STAT,1868,38,45-49,1906,0.019196186266073743
STAT,1905,23,na,1928,34.02788746066283
STAT,1842,45,30-34,1887,7.452445346238223E-4
SIM,1903,34,na,1937,33
STAT,1915,35,30-34,1950,0.01842603533101815
STAT,1818,61,na,1879,5.335884044655571
STAT,1842,41,15-19,1883,1.0858033551185118E-4
STAT,1932,38,35-39,1970,0.032334093286107604
STAT,1840,29,25-29,1869,0.4073813719284239
STAT,1938,10,na,1948,38.9453863975779
STAT,1837,26,15-19,1863,0.002887535746245477
SIM,1854,46,na,1900,17
SIM,1900,20,na,1920,33
STAT,1890,17,20-24,1907,0.2153489845470136
STAT,1883,27,50-100,1910,0.006211934209911109
STAT,1864,33,15-19,1897,0.0012718968628310995
STAT,1891,47,35-39,1938,9.647507707776972E-4
STAT,1837,68,na,1905,7.389206374882462
STAT,1911,47,30-34,1958,8.385043081265163E-4
STAT,1946,25,15-19,1971,0.00781519606373159
STAT,1811,51,30-34,1862,2.3046796007581674E-4
STAT,1872,20,50-100,1892,0.004197284814257574
STAT,1799,89,na,1888,0.4321048797130601
STAT,1834,38,50-100,1872,0.010680650083166933
STAT,1897,43,20-24,1940,1.4539301251833867E-4
SIM,1847,64,na,1911,12
STAT,1842,83,na,1925,2.978509855389509
STAT,1857,82,na,1939,3.4928735703314984
STAT,1942,8,na,1950,41.07719944319299
STAT,1901,44,35-39,1945,0.001735783115723241
STAT,1929,32,20-24,1961,0.030834653920997636
STAT,1806,48,30-34,1854,0.0032137023386974942
SIM,1874,60,na,1934,24
STAT,1875,70,na,1945,14.42279138746682
STAT,1905,28,30-34,1933,0.3621562976805175
STAT,1868,29,na,1897,22.93039893276364
STAT,1873,39,30-34,1912,0.05364007193451376
SIM,1842,38,50-100,1880,1
STAT,1907,40,20-24,1947,1.629444134597459E-4
SIM,1869,45,na,1914,15
STAT,1867,24,35-39,1891,0.05549365449944251
STAT,1878,45,45-49,1923,0.0024607963382786984
STAT,1806,76,na,1882,5.301426154072322
STAT,1835,19,40-44,1854,0.0022006099298425793
STAT,1850,46,35-39,1896,0.0012500499401920345
SIM,1906,45,na,1951,23
SIM,1898,3,na,1901,38
STAT,1890,19,50-100,1909,5.919143395991376E-4
STAT,1832,32,25-29,1864,0.05985831796628707
STAT,1836,20,25-29,1856,0.7397059610435733
STAT,1931,18,30-34,1949,0.15841657292882472
STAT,1859,33,40-44,1892,0.03432349613653733
STAT,1894,28,45-49,1922,0.014179466717367507
SIM,1925,15,na,1940,38
STAT,1805,91,na,1896,0.15866223259466103
STAT,1902,12,na,1914,36.41819888207034
SIM,1858,21,30-34,1879,1
STAT,1824,41,30-34,1865,0.015843437047777853
STAT,1793,61,na,1854,5.0
STAT,1824,46,25-29,1870,7.55260477981452E-4
STAT,1938,34,20-24,1972,0.024332771641921176
SIM,1884,59,na,1943,20
STAT,1941,21,15-19,1962,0.05462997386044284
SIM,1909,59,na,1968,33
STAT,1906,43,40-44,1949,0.0022528236216903317
STAT,1933,30,20-24,1963,0.03277397768105561
STAT,1887,29,15-19,1916,0.004916804047598787
SIM,1881,45,na,1926,22
STAT,1871,22,35-39,1893,0.05817975709513024
STAT,1841,34,25-29,1875,0.11914049870742825
STAT,1879,0,na,1879,37.561518400371206
SIM,1849,24,25-29,1873,2
STAT,1841,44,35-39,1885,0.017952051120978134
STAT,1781,76,na,1857,5.26752278988245
STAT,1891,37,25-29,1928,0.03533822381141853
SIM,1875,45,na,1920,16
SIM,1914,33,30-34,1947,1
STAT,1847,100,na,1947,0.011340885168564692
STAT,1943,26,50-100,1969,0.010528072376085076
STAT,1922,16,30-34,1938,0.14037342905462646
STAT,1838,47,30-34,1885,7.729443066254949E-4
STAT,1845,18,20-24,1863,0.13021022282652095
STAT,1880,22,45-49,1902,0.007332706577899696
SIM,1896,44,na,1940,28
STAT,1858,30,na,1888,18.539556019962028
STAT,1844,16,na,1860,22.92661675572513
SIM,1880,60,na,1940,29
STAT,1856,42,20-24,1898,0.0011490781170415967
STAT,1858,67,na,1925,12.062630848234955
STAT,1796,75,na,1871,0.8242800708638858
STAT,1917,11,na,1928,42.175282454910736
SIM,1820,40,na,1860,14
SIM,1946,14,na,1960,53
SIM,1860,46,na,1906,23
SIM,1910,16,na,1926,32
STAT,1909,37,50-100,1946,0.003951773307456238
STAT,1915,45,40-44,1960,0.0015823990875571158
STAT,1803,62,na,1865,10.09593373414467
STAT,1812,76,na,1888,3.753261521545527
STAT,1837,41,40-44,1878,0.013090369901889488
STAT,1881,6,na,1887,25.281266414104888
STAT,1878,27,15-19,1905,0.0046841046587545706
STAT,1887,39,25-29,1926,0.031110364669663743
STAT,1936,21,40-44,1957,0.031961928437344196
STAT,1906,33,30-34,1939,0.14503552312644297
STAT,1895,20,30-34,1915,0.2326286602180163
STAT,1865,15,na,1880,23.790245045108556
SIM,1927,28,25-29,1955,2
STAT,1877,37,na,1914,24.3198348305296
STAT,1822,33,45-49,1855,0.013270359464672848
STAT,1905,22,50-100,1927,0.005885399822150181
STAT,1862,20,35-39,1882,0.05228725759720283
STAT,1807,53,30-34,1860,1.1957258707939637E-4
STAT,1879,48,30-34,1927,9.893009019862468E-4
SIM,1952,14,na,1966,35
STAT,1882,35,25-29,1917,0.027854657401202694
SIM,1823,54,na,1877,10
STAT,1919,28,25-29,1947,0.7025343150959863
STAT,1914,24,25-29,1938,0.9300129903535057
STAT,1858,6,na,1864,22.175540400882813
STAT,1934,27,50-100,1961,0.013333164412479307
SIM,1934,29,na,1963,51
SIM,1936,4,na,1940,38
STAT,1924,47,40-44,1971,0.001864791333631316
STAT,1898,36,na,1934,31.935121618999318
SIM,1825,80,na,1905,3
STAT,1900,37,50-100,1937,0.003674672454327386
SIM,1931,15,na,1946,58
STAT,1918,36,50-100,1954,0.004406420184900137
SIM,1844,20,25-29,1864,1
STAT,1827,37,45-49,1864,0.016314740009229316
STAT,1866,96,na,1962,0.20079993509004065
SIM,1903,23,45-49,1926,1
STAT,1846,38,25-29,1884,0.024115354336070653
STAT,1864,30,na,1894,21.57541320787823
STAT,1873,33,25-29,1906,0.10369634945596302
SIM,1883,74,na,1957,3
STAT,1850,29,50-100,1879,0.006606675191755788
STAT,1885,26,45-49,1911,0.011002034709950457
STAT,1843,31,na,1874,11.167528125321061
STAT,1859,15,na,1874,21.42981472334131
STAT,1863,31,40-44,1894,0.038554099531202306
SIM,1878,59,na,1937,23
STAT,1837,103,na,1940,6.939299882417886E-4
STAT,1901,67,na,1968,25.279555873546766
STAT,1860,43,25-29,1903,0.005182849260835682
STAT,1838,16,na,1854,23.67236736884796
STAT,1849,29,45-49,1878,0.010059368216407127
STAT,1825,39,50-100,1864,0.012313321642844481
STAT,1917,15,45-49,1932,0.0010701496325466332
SIM,1899,58,na,1957,25
STAT,1883,37,na,1920,22.878457574339482
STAT,1863,21,50-100,1884,0.003709152957474468
STAT,1910,41,40-44,1951,0.00236298123320728
STAT,1896,40,35-39,1936,0.001668393692656901
STAT,1851,97,na,1948,0.045354130008781114
STAT,1815,44,25-29,1859,0.00946253763464566
STAT,1886,19,20-24,1905,0.18290590839346302
STAT,1932,33,40-44,1965,0.05177936520416959
SIM,1870,46,na,1916,21
STAT,1953,16,20-24,1969,1.6310194921010577
SIM,1882,79,na,1961,12
STAT,1950,15,40-44,1965,0.01644487201513702
STAT,1837,23,35-39,1860,0.03838921177929423
STAT,1900,33,30-34,1933,0.24108904897700095
SIM,1823,68,na,1891,6
STAT,1932,39,35-39,1971,0.03229787910162715
STAT,1920,32,45-49,1952,0.017089374571699203
STAT,1803,71,na,1874,6.814527601564525
STAT,1839,31,45-49,1870,0.011966304229210344
STAT,1906,29,40-44,1935,0.043208980708805814
STAT,1897,24,45-49,1921,0.00920214950046454
STAT,1883,76,na,1959,10.515398409604732
STAT,1824,65,na,1889,11.83769035754156
STAT,1932,19,na,1951,48.2811219046446
STAT,1894,28,na,1922,30.477827334746788
STAT,1921,25,15-19,1946,0.007859467986167202
STAT,1807,85,na,1892,1.1569388003217929
STAT,1890,14,na,1904,31.268257125391806
STAT,1898,17,15-19,1915,0.08005714128010613
STAT,1902,41,40-44,1943,0.002212597957090574
SIM,1885,12,na,1897,26
STAT,1915,27,40-44,1942,0.04713106951899344
STAT,1918,28,20-24,1946,0.19182635805869183
STAT,1932,31,25-29,1963,0.12244114881046378
STAT,1942,19,50-100,1961,0.0038841759373675327
STAT,1888,31,40-44,1919,0.050885889257857815
STAT,1906,21,30-34,1927,0.2595609471009575
STAT,1930,23,15-19,1953,0.06766483375050612
STAT,1940,30,20-24,1970,0.025093476038284362
SIM,1876,22,25-29,1898,1
STAT,1831,48,40-44,1879,0.001618179095865774
STAT,1854,63,na,1917,10.906292438332603
STAT,1933,18,45-49,1951,0.006642386118426964
STAT,1858,77,na,1935,6.577546101298306
STAT,1877,20,25-29,1897,0.5944499458056692
STAT,1925,41,35-39,1966,0.002426165078945133
STAT,1941,17,40-44,1958,0.01430252446398563
STAT,1923,33,25-29,1956,0.10515855136988339
STAT,1854,20,30-34,1874,0.1297811626305969
SIM,1861,85,na,1946,2
STAT,1816,46,na,1862,9.0561758602103
SIM,1931,33,25-29,1964,3
STAT,1845,27,na,1872,15.391674327020578
STAT,1781,104,na,1885,4.954425781823576E-4
SIM,1787,68,na,1855,3
STAT,1914,35,25-29,1949,0.009841823656528931
STAT,1865,21,45-49,1886,0.006430022095832681
STAT,1922,17,30-34,1939,0.14002951415344267
STAT,1847,30,40-44,1877,0.05553452579686312
STAT,1947,25,35-39,1972,0.16883951594855517
STAT,1860,16,na,1876,21.650001195332354
STAT,1896,19,na,1915,32.996836306639196
STAT,1912,27,15-19,1939,0.006902455496799066
STAT,1931,32,20-24,1963,0.031819467680530976
SIM,1936,21,na,1957,35
STAT,1909,17,15-19,1926,0.08849894917801585
STAT,1796,84,na,1880,0.22013728202898677
STAT,1846,21,35-39,1867,0.058774251683008455
SIM,1928,34,na,1962,54
STAT,1929,34,30-34,1963,0.19891172487019793
SIM,1924,20,na,1944,53
STAT,1924,25,40-44,1949,0.05428299465129984
STAT,1841,45,na,1886,22.695765229479505
STAT,1786,74,na,1860,1.9058075787792457
STAT,1858,20,15-19,1878,0.029221119289622007
STAT,1944,18,20-24,1962,1.4479559299820466
SIM,1832,72,na,1904,16
STAT,1903,40,45-49,1943,0.0014925134992205612
STAT,1870,26,na,1896,23.788807104260286
STAT,1873,66,na,1939,16.66369522422428
SIM,1907,40,na,1947,38
SIM,1802,74,na,1876,4
STAT,1915,47,35-39,1962,0.0012879560964918733
STAT,1835,20,20-24,1855,0.7962908640183597
STAT,1914,40,20-24,1954,1.7475661202648015E-4
STAT,1857,16,15-19,1873,0.052525854872247826
STAT,1875,57,na,1932,20.6578444438007
STAT,1930,36,20-24,1966,0.0034254677590307625
STAT,1794,93,na,1887,0.08119947054092079
STAT,1860,39,20-24,1899,0.0062037186155057406
STAT,1913,39,25-29,1952,0.009538454889678324
SIM,1804,65,na,1869,9
SIM,1899,27,25-29,1926,1
STAT,1929,29,35-39,1958,0.18681546696519022
STAT,1945,17,25-29,1962,0.4699852569198038
STAT,1946,26,30-34,1972,0.433585465904588
SIM,1917,17,15-19,1934,1
STAT,1900,20,25-29,1920,0.798550935405405
STAT,1902,36,45-49,1938,0.006096907239149939
STAT,1887,58,na,1945,21.585629562583275
STAT,1883,44,na,1927,22.14106875515644
STAT,1872,49,40-44,1921,0.0017150939092179136
SIM,1856,31,na,1887,13
STAT,1873,20,40-44,1893,0.021312338049745857
STAT,1855,49,40-44,1904,0.001180200371303259
STAT,1891,63,na,1954,21.899904367799998
SIM,1823,36,na,1859,11
SIM,1870,78,na,1948,11
STAT,1879,39,na,1918,24.1391791410842
STAT,1895,77,na,1972,16.10142426752315
STAT,1933,23,40-44,1956,0.04440365320781936
STAT,1931,23,50-100,1954,0.008470005820508733
STAT,1800,104,na,1904,2.4170893210253398E-4
STAT,1916,23,40-44,1939,0.034823833668235084
STAT,1938,32,30-34,1970,0.1573742694964611
SIM,1921,36,20-24,1957,1
STAT,1920,29,15-19,1949,0.007623350874118669
STAT,1903,29,15-19,1932,0.006404337039870191
STAT,1919,27,25-29,1946,0.7050159713150151
STAT,1859,24,25-29,1883,0.46532096159389935
STAT,1910,30,35-39,1940,0.08827915832284312
SIM,1811,67,na,1878,5
STAT,1914,18,35-39,1932,0.008585538940983777
STAT,1832,52,na,1884,10.066527069069197
STAT,1865,47,na,1912,20.254654502269926
SIM,1862,59,na,1921,21
SIM,1919,41,na,1960,43
STAT,1922,34,20-24,1956,0.027224003102285704
STAT,1887,22,35-39,1909,0.0636947165838793
STAT,1903,38,na,1941,33.59256516589559
SIM,1923,47,35-39,1970,1
STAT,1910,38,45-49,1948,0.006447964290499485
SIM,1959,5,na,1964,51
SIM,1890,66,na,1956,19
SIM,1930,34,20-24,1964,1
STAT,1858,33,20-24,1891,0.02048198160165193
STAT,1875,25,na,1900,24.69851238223801
SIM,1848,12,na,1860,33
STAT,1927,26,20-24,1953,0.22153972078940598
STAT,1925,24,45-49,1949,0.013300155976824726
STAT,1782,92,na,1874,0.08464526935045273
STAT,1890,20,50-100,1910,0.004982996965855645
STAT,1932,19,40-44,1951,0.018347177543448695
STAT,1907,45,35-39,1952,0.0011666756155362633
SIM,1904,0,na,1904,40
SIM,1943,23,na,1966,41
STAT,1906,7,na,1913,37.85102698053744
STAT,1896,20,35-39,1916,0.07710847561361141
STAT,1860,54,45-49,1914,1.1473753929949244E-4
STAT,1837,83,na,1920,1.9195285591511093
SIM,1900,31,30-34,1931,1
STAT,1825,82,na,1907,2.5153616571433206
STAT,1868,22,25-29,1890,0.5539917176733796
STAT,1907,25,40-44,1932,0.04411493096141017
STAT,1829,96,na,1925,0.05832504408697118
STAT,1915,39,na,1954,37.298471824698275
STAT,1778,87,na,1865,0.6225457678323375
STAT,1864,30,40-44,1894,0.03920966228771649
STAT,1911,25,na,1936,36.54380707598367
SIM,1824,85,na,1909,3
SIM,1902,19,20-24,1921,2
STAT,1852,29,na,1881,21.33901008702695
STAT,1908,24,45-49,1932,0.010225933677913746
STAT,1895,21,30-34,1916,0.2319470582435775
SIM,1795,87,na,1882,2
SIM,1791,73,na,1864,3
SIM,1939,18,na,1957,27
STAT,1867,23,20-24,1890,0.6574276413933621
STAT,1828,30,30-34,1858,0.24891822076025175
STAT,1933,35,35-39,1968,0.03286767196796927
SIM,1925,3,na,1928,45
STAT,1927,38,15-19,1965,2.3729619641768397E-4
STAT,1817,49,20-24,1866,3.3701518890602485E-4
STAT,1913,19,30-34,1932,0.024580053095717508
STAT,1878,0,na,1878,37.5822328454029
STAT,1889,22,45-49,1911,0.008537529072430914
SIM,1799,69,na,1868,12
STAT,1898,10,na,1908,34.943520196903975
STAT,1820,51,na,1871,13.801757159776963
SIM,1882,47,na,1929,30
SIM,1884,21,20-24,1905,2
STAT,1911,57,na,1968,33.038454446934104
STAT,1938,27,35-39,1965,0.14775963539353687
STAT,1924,45,35-39,1969,0.0015321234492759043
SIM,1815,49,na,1864,11
STAT,1914,23,30-34,1937,0.290301755224793
STAT,1824,33,na,1857,20.50049828030661
SIM,1869,81,na,1950,2
SIM,1908,5,na,1913,42
STAT,1937,28,30-34,1965,0.37935595692572327
SIM,1874,28,na,1902,24
STAT,1923,46,30-34,1969,0.0010382014884189317
STAT,1849,22,15-19,1871,0.030927405846331617
STAT,1923,5,na,1928,46.88646071197567
STAT,1828,47,na,1875,16.749906370341446
STAT,1904,33,15-19,1937,0.001166737253467189
STAT,1806,68,na,1874,10.087014981775454
STAT,1802,54,na,1856,9.610777360375225
SIM,1812,52,na,1864,18
SIM,1868,20,25-29,1888,2
STAT,1836,34,na,1870,25.894503716404344
STAT,1852,15,25-29,1867,0.05935434648797851
STAT,1925,17,na,1942,44.185162754928555
STAT,1938,24,30-34,1962,0.2823853264323368
STAT,1928,38,30-34,1966,0.02289774115011766
SIM,1920,15,20-24,1935,2
STAT,1887,26,na,1913,26.138479463201918
STAT,1877,16,40-44,1893,0.0018926740948163564
STAT,1891,31,50-100,1922,0.01129162311913803
STAT,1891,31,na,1922,29.40841016789388
STAT,1950,18,45-49,1968,0.005868176363629897
STAT,1832,39,45-49,1871,0.011080474885396832
STAT,1895,45,na,1940,29.50535833471038
STAT,1915,39,35-39,1954,0.023979477756414666
SIM,1844,30,na,1874,10
STAT,1935,21,50-100,1956,0.008923479616652914
SIM,1848,44,na,1892,30
STAT,1915,31,25-29,1946,0.09370104379878152
SIM,1878,42,na,1920,28
STAT,1956,15,35-39,1971,0.05524144382187121
STAT,1814,48,40-44,1862,0.0048282732450638235
STAT,1899,34,20-24,1933,0.03668627450022357
STAT,1901,24,35-39,1925,0.08114289446161337
STAT,1912,15,20-24,1927,0.27326827479259747
STAT,1795,67,na,1862,9.062053309567869
STAT,1816,50,50-100,1866,1.901364892834181E-4
STAT,1854,23,35-39,1877,0.041608323043480874
STAT,1803,102,na,1905,0.0010987428639914166
STAT,1923,30,20-24,1953,0.02799213306232635
STAT,1831,67,na,1898,12.86394297824703
STAT,1914,0,na,1914,46.06494253807051
SIM,1932,39,na,1971,47
STAT,1901,15,45-49,1916,9.182843076435053E-4
SIM,1948,22,na,1970,34
STAT,1847,33,45-49,1880,0.021645890280218696
STAT,1922,29,25-29,1951,0.7340571315327724
STAT,1930,19,30-34,1949,0.15600391507361056
STAT,1913,23,15-19,1936,0.05313934682973796
STAT,1944,20,na,1964,39.16989708736268
STAT,1868,12,na,1880,25.8468852363397
STAT,1930,28,20-24,1958,0.23091014314927089
STAT,1906,46,30-34,1952,7.955371083402606E-4
STAT,1903,37,15-19,1940,1.7232072656833238E-4
STAT,1910,43,40-44,1953,0.002335344702636556
SIM,1930,29,25-29,1959,1
STAT,1861,65,na,1926,14.211833067214076
STAT,1865,79,na,1944,6.323318508455398
SIM,1852,17,na,1869,28
STAT,1902,44,45-49,1946,0.0014458207636703524
STAT,1848,26,15-19,1874,0.00352808447366014
SIM,1816,66,na,1882,7
STAT,1893,6,na,1899,32.93862172163887
STAT,1928,17,25-29,1945,0.5433659641133362
SIM,1865,24,na,1889,22
STAT,1908,49,45-49,1957,0.0019438820056737185
STAT,1874,51,na,1925,21.948215045832065
STAT,1907,20,na,1927,34.80119749189636
SIM,1912,16,25-29,1928,1
STAT,1844,85,na,1929,2.1412504778150616
STAT,1888,34,45-49,1922,0.02020380120196545
STAT,1848,99,na,1947,0.012247633526448861
STAT,1840,71,na,1911,10.459380579278044
STAT,1905,25,30-34,1930,0.3659012573447169
STAT,1907,33,40-44,1940,0.03627089017111611
SIM,1866,8,na,1874,36
STAT,1816,78,na,1894,2.345700120044546
STAT,1913,44,20-24,1957,1.702125683430635E-4
STAT,1923,16,35-39,1939,0.04905166217146867
SIM,1846,40,40-44,1886,1
SIM,1873,11,na,1884,30
SIM,1842,82,na,1924,8
STAT,1881,39,40-44,1920,0.041234613323215374
STAT,1931,40,20-24,1971,2.3553600228673854E-4
STAT,1889,81,na,1970,11.10902600050134
STAT,1900,41,na,1941,32.305747596958355
STAT,1922,21,15-19,1943,0.060780609259610395
STAT,1847,61,na,1908,19.96145666929657
STAT,1871,49,25-29,1920,5.62281834979889E-4
STAT,1925,46,40-44,1971,0.001903256495328649
SIM,1849,61,na,1910,7
STAT,1924,28,45-49,1952,0.019914018726377897
SIM,1878,30,35-39,1908,2
SIM,1913,25,30-34,1938,1
STAT,1874,16,15-19,1890,0.06035337348386396
STAT,1936,33,na,1969,36.490806328966414
STAT,1935,16,50-100,1951,0.0051115891514368
SIM,1920,38,na,1958,43
STAT,1897,21,40-44,1918,0.02775559626820699
STAT,1908,41,35-39,1949,0.0018640354011836284
STAT,1941,21,25-29,1962,0.9479549829807297
SIM,1852,49,na,1901,20
SIM,1871,63,na,1934,19
STAT,1846,44,na,1890,18.47810425627653
STAT,1904,16,25-29,1920,0.08139744779202344
STAT,1842,30,na,1872,20.05521486716487
SIM,1875,77,na,1952,4
STAT,1936,36,15-19,1972,1.8755406161916868E-4
SIM,1878,10,na,1888,31
STAT,1869,17,45-49,1886,6.417013991001038E-4
STAT,1916,18,45-49,1934,0.00104803751336527
STAT,1838,40,40-44,1878,0.020946223263139028
STAT,1904,55,na,1959,30.415545557051274
STAT,1941,29,35-39,1970,0.15403166832189685
SIM,1834,20,na,1854,18
STAT,1919,49,20-24,1968,1.1812887329319318E-4
STAT,1852,26,50-100,1878,0.00642283615983619
STAT,1841,30,50-100,1871,0.011109621800181749
STAT,1924,42,30-34,1966,0.0015107916047236263
STAT,1931,15,30-34,1946,0.15957067459759847
STAT,1940,25,25-29,1965,0.6670026071903669
STAT,1916,26,45-49,1942,0.017770997651804055
STAT,1839,23,45-49,1862,0.004908994727906489
SIM,1863,33,na,1896,14
STAT,1852,52,45-49,1904,1.2354303302338242E-4
STAT,1873,23,45-49,1896,0.007067710067731085
STAT,1920,24,45-49,1944,0.012324688758486245
SIM,1896,39,na,1935,31
SIM,1892,25,na,1917,35
STAT,1920,18,na,1938,40.83723608142489
STAT,1882,27,na,1909,22.87109702928203
STAT,1899,3,na,1902,36.189698669446095
STAT,1900,28,35-39,1928,0.133328976941619
STAT,1892,80,na,1972,12.480311051951535
STAT,1879,41,40-44,1920,0.023385567388619
STAT,1912,48,20-24,1960,1.0508256443984668E-4
STAT,1876,21,20-24,1897,0.702019896138046
STAT,1901,32,35-39,1933,0.14170489439213038
STAT,1956,6,na,1962,51.725717373689
STAT,1853,37,50-100,1890,0.007716132626850084
STAT,1807,53,na,1860,13.599934063032642
STAT,1913,27,30-34,1940,0.38715327305625297
STAT,1775,90,na,1865,0.4385221381720865
STAT,1887,5,na,1892,28.60447223251404
STAT,1857,105,na,1962,8.129720684125725E-4
SIM,1883,64,na,1947,6
STAT,1906,37,40-44,1943,0.013726865324404695
STAT,1880,7,na,1887,27.89201468438843
STAT,1884,23,20-24,1907,0.6730852222606823
STAT,1849,30,15-19,1879,0.0013054790115853514
STAT,1862,21,50-100,1883,0.003627661856295491
STAT,1889,30,45-49,1919,0.02152178359265615
STAT,1901,1,na,1902,38.086233658115425
SIM,1887,78,na,1965,10
STAT,1858,16,30-34,1874,0.014251600315324993
STAT,1917,19,15-19,1936,0.47976324980916824
STAT,1905,17,30-34,1922,0.023003382963554798
STAT,1866,51,50-100,1917,1.3975904662688021E-4
STAT,1836,98,na,1934,0.03135183610221917
SIM,1857,48,na,1905,22
STAT,1928,34,15-19,1962,0.001596893646789502
SIM,1892,23,20-24,1915,1
STAT,1911,43,50-100,1954,0.0011073661793179809
STAT,1832,84,na,1916,1.5036669769966644
SIM,1895,4,na,1899,31
STAT,1936,32,50-100,1968,0.007982193450092618
STAT,1923,49,35-39,1972,0.0014890280196158299
SIM,1906,55,na,1961,22
SIM,1902,41,na,1943,31
STAT,1943,17,15-19,1960,0.4777501061267942
STAT,1821,38,30-34,1859,0.09989630358899738
STAT,1912,42,na,1954,35.53944065598556
STAT,1916,43,35-39,1959,0.0020426851388886252
STAT,1935,3,na,1938,55.203068695692096
STAT,1878,20,40-44,1898,0.021641970649849837
STAT,1899,17,30-34,1916,0.02181901479594655
SIM,1937,1,na,1938,41
STAT,1908,16,45-49,1924,9.663297111477468E-4
STAT,1889,27,15-19,1916,0.00555482402324443
SIM,1832,29,na,1861,23
STAT,1877,80,na,1957,7.139640888387633
STAT,1942,16,45-49,1958,0.0051838243300256995
STAT,1916,56,na,1972,35.967116145342686
SIM,1882,5,na,1887,34
STAT,1873,17,50-100,1890,4.980968163689792E-4
STAT,1890,20,40-44,1910,0.025463112642984297
STAT,1862,50,na,1912,18.843725271915098
SIM,1898,30,na,1928,35
STAT,1904,38,20-24,1942,0.002372232354930313
STAT,1853,46,na,1899,14.179972209449087
STAT,1866,64,na,1930,16.00996030893371
STAT,1862,39,30-34,1901,0.04551892660242077
STAT,1856,11,na,1867,20.542220768381316
STAT,1868,30,25-29,1898,0.099919081596554
STAT,1925,21,40-44,1946,0.04011603588686445
STAT,1919,21,na,1940,39.76071899251587
STAT,1843,22,20-24,1865,0.3669244063352018
STAT,1861,33,na,1894,19.98312835255702
STAT,1895,24,35-39,1919,0.07528515811014885
STAT,1934,31,35-39,1965,0.12431325781778095
STAT,1867,26,25-29,1893,0.406197109285118
SIM,1840,16,na,1856,17
STAT,1806,49,45-49,1855,0.007729512188032171
STAT,1924,17,40-44,1941,0.016548038830105805
STAT,1837,41,50-100,1878,0.006148354836608506
STAT,1923,41,25-29,1964,8.300428812060775E-4
STAT,1924,43,na,1967,43.81925955533309
STAT,1890,78,na,1968,13.531709193410737
STAT,1932,27,40-44,1959,0.060802835364952006
SIM,1861,2,na,1863,35
STAT,1927,34,20-24,1961,0.029812883473353567
STAT,1824,97,na,1921,0.03738071179035143
STAT,1879,20,35-39,1899,0.06075816992239446
STAT,1922,37,25-29,1959,0.011121516348823518
STAT,1910,35,40-44,1945,0.014364822333281747
STAT,1932,34,50-100,1966,0.010932424695592757
STAT,1820,83,na,1903,2.2506178600161437
STAT,1936,19,25-29,1955,0.4101688664042872
SIM,1903,26,na,1929,38
SIM,1829,84,na,1913,5
STAT,1914,27,25-29,1941,0.6580346134659633
STAT,1905,42,20-24,1947,1.5896906767176052E-4
SIM,1922,27,25-29,1949,1
STAT,1828,33,35-39,1861,0.0741830762504078
SIM,1828,67,na,1895,7
STAT,1919,24,20-24,1943,1.1994854903949932
SIM,1914,42,na,1956,36
SIM,1824,53,na,1877,16
SIM,1868,0,na,1868,39
STAT,1840,38,40-44,1878,0.0401514584278672
STAT,1866,2,na,1868,31.110487261565815
STAT,1896,40,50-100,1936,9.733621893557495E-4
STAT,1919,16,20-24,1935,0.29871223763837484
STAT,1860,48,na,1908,18.06076957177325
SIM,1849,29,na,1878,12
SIM,1938,2,na,1940,41
STAT,1914,26,35-39,1940,0.15061239058932654
STAT,1882,52,50-100,1934,1.4396575507954077E-4
STAT,1940,17,25-29,1957,0.43687561003725756
STAT,1851,52,50-100,1903,1.2682332079295527E-4
STAT,1926,42,40-44,1968,0.003065894185341072
STAT,1894,60,na,1954,24.442259987211727
STAT,1871,46,50-100,1917,0.0024555849953153044
STAT,1834,22,50-100,1856,0.0038541401362282494
SIM,1826,33,na,1859,16
SIM,1955,0,na,1955,47
STAT,1898,74,na,1972,19.571934707793538
SIM,1834,52,na,1886,14
STAT,1870,49,30-34,1919,9.415226713993134E-4
SIM,1805,50,na,1855,14
STAT,1829,32,na,1861,19.381465621728033
SIM,1946,6,na,1952,53
STAT,1827,30,na,1857,18.13300777214339
STAT,1830,28,30-34,1858,0.20625918687832584
SIM,1845,15,na,1860,24
SIM,1877,25,na,1902,29
STAT,1906,43,50-100,1949,0.001058118228457879
SIM,1942,17,na,1959,42
STAT,1887,30,35-39,1917,0.11142622709220613
STAT,1905,61,na,1966,29.30277434299165
STAT,1888,16,50-100,1904,5.739242450528156E-4
STAT,1914,30,50-100,1944,0.008319874378903325
STAT,1826,35,50-100,1861,0.014899355047614476
STAT,1920,37,15-19,1957,2.084652173807997E-4
STAT,1855,40,40-44,1895,0.015996268013787767
STAT,1876,24,25-29,1900,0.5777728780740097
STAT,1926,34,na,1960,45.411573827278346
SIM,1872,80,na,1952,8
STAT,1901,41,25-29,1942,6.267951736937957E-4
STAT,1901,21,30-34,1922,0.2499942371138244
STAT,1913,47,25-29,1960,5.134165067437502E-4
STAT,1902,28,45-49,1930,0.0156022325324458
SIM,1889,3,na,1892,34
STAT,1842,41,50-100,1883,0.008306395059679008
SIM,1834,63,na,1897,11
SIM,1879,27,na,1906,15
SIM,1927,16,20-24,1943,7
STAT,1936,28,15-19,1964,0.006712020526194499
STAT,1823,38,40-44,1861,0.0311877072929492
STAT,1856,43,na,1899,16.622441065340567
STAT,1859,15,35-39,1874,0.005122644673028044
STAT,1924,21,25-29,1945,1.0861267180127994
SIM,1918,18,20-24,1936,2
STAT,1881,10,na,1891,24.648077079562277
STAT,1815,39,45-49,1854,0.031913572740260514
STAT,1929,43,20-24,1972,2.272547184946135E-4
STAT,1921,16,25-29,1937,0.4913149972640818
STAT,1851,98,na,1949,0.027425188875009845
SIM,1870,14,na,1884,27
STAT,1907,41,40-44,1948,0.0022950728602437616
STAT,1919,48,30-34,1967,9.558598161304796E-4
STAT,1785,89,na,1874,1.0565921601706214
STAT,1922,25,30-34,1947,0.443113492073063
STAT,1848,24,na,1872,16.595214761939495
STAT,1907,17,50-100,1924,7.16629468371432E-4
SIM,1917,39,na,1956,34
STAT,1900,24,40-44,1924,0.02871490908608176
STAT,1940,16,35-39,1956,0.042314500089661845
SIM,1913,25,na,1938,39
STAT,1781,75,na,1856,5.791223094299999
STAT,1859,62,na,1921,14.527115764232889
SIM,1839,62,na,1901,19
STAT,1834,49,50-100,1883,0.0017941004557683856
STAT,1830,29,na,1859,9.905251908317064
STAT,1929,30,15-19,1959,0.0016263270237508794
SIM,1876,83,na,1959,6
STAT,1909,54,na,1963,32.69279444100261
STAT,1939,28,40-44,1967,0.04651366095350783
SIM,1847,81,na,1928,5
STAT,1907,36,45-49,1943,0.006324170322563461
STAT,1905,40,na,1945,33.80971153002091
STAT,1841,29,45-49,1870,0.01330520587796382
STAT,1929,38,25-29,1967,0.0125675846005822
STAT,1921,46,20-24,1967,1.239166877323486E-4
SIM,1901,22,35-39,1923,3
STAT,1819,49,30-34,1868,8.485142325206479E-4
STAT,1854,49,25-29,1903,3.447203873664923E-4
SIM,1898,19,na,1917,34
STAT,1865,26,15-19,1891,0.004117764801363805
STAT,1876,36,50-100,1912,0.012529533678014283
STAT,1910,46,45-49,1956,0.0020203984642150337
STAT,1912,22,45-49,1934,0.010698833587986786
SIM,1892,14,na,1906,36
STAT,1905,29,25-29,1934,0.606148158870348
STAT,1926,37,50-100,1963,0.005101848929987643
STAT,1899,37,25-29,1936,0.008507230029470266
STAT,1876,31,na,1907,24.33551233506723
STAT,1852,29,20-24,1881,0.10489634180773552
STAT,1811,51,45-49,1862,5.618846955239246E-4
STAT,1938,16,30-34,1954,0.11973621828935894
STAT,1940,22,20-24,1962,1.1246925186566532
SIM,1843,23,25-29,1866,1
SIM,1923,35,na,1958,38
STAT,1917,27,15-19,1944,0.007336160725437283
STAT,1906,30,20-24,1936,0.022730355376630478
STAT,1884,61,na,1945,18.307993437724996
STAT,1864,39,40-44,1903,0.038867661562505436
STAT,1918,36,20-24,1954,0.0027666089326520253
STAT,1905,21,15-19,1926,0.04775662652569371
STAT,1888,75,na,1963,14.618624158042797
STAT,1903,24,50-100,1927,0.005761396984406427
SIM,1877,57,na,1934,24
SIM,1873,43,na,1916,27
SIM,1952,16,na,1968,35
STAT,1902,33,40-44,1935,0.0608977196134263
STAT,1838,52,50-100,1890,1.1659546340980486E-4
STAT,1856,19,50-100,1875,4.147329878470467E-4
STAT,1835,23,25-29,1858,0.37798814947456066
STAT,1926,38,20-24,1964,0.0032000045982981044
SIM,1903,23,20-24,1926,2
STAT,1846,33,na,1879,20.541883818952478
STAT,1866,32,na,1898,21.977484580932234
STAT,1884,23,50-100,1907,0.003982988896365648
STAT,1836,40,30-34,1876,0.013541808539054442
STAT,1845,59,na,1904,11.360497047982438
STAT,1876,42,na,1918,23.445108080353542
STAT,1830,101,na,1931,0.0020502054936795146
STAT,1858,13,na,1871,21.12344506292495
STAT,1901,16,35-39,1917,0.007696773987992863
SIM,1897,56,na,1953,38
SIM,1893,42,na,1935,35
STAT,1856,20,40-44,1876,0.017786869318027712
SIM,1885,76,na,1961,13
SIM,1881,62,na,1943,15
STAT,1898,25,15-19,1923,0.006161974337043999
STAT,1921,17,15-19,1938,0.5132750363637623
SIM,1927,17,na,1944,48
STAT,1889,27,50-100,1916,0.007831956702434717
STAT,1929,37,35-39,1966,0.03090424262608249
STAT,1946,18,30-34,1964,0.1341946610283526
STAT,1915,35,40-44,1950,0.015134411160139707
SIM,1913,36,na,1949,41
STAT,1893,16,25-29,1909,0.07162597964095711
STAT,1935,36,20-24,1971,0.003673100495538704
STAT,1925,30,30-34,1955,0.1861310886040426
SIM,1908,57,na,1965,33
STAT,1875,39,50-100,1914,0.012493465995180468
STAT,1920,40,45-49,1960,0.0018275279303820928
STAT,1941,28,45-49,1969,0.017733482936765094
STAT,1895,13,na,1908,33.47559209605855
STAT,1922,39,50-100,1961,0.004732323642343787
SIM,1904,43,na,1947,27
STAT,1936,27,25-29,1963,0.6261026357534619
STAT,1911,31,40-44,1942,0.03801570538684005
STAT,1941,23,na,1964,37.45238915311959
SIM,1825,70,na,1895,8
STAT,1843,25,25-29,1868,0.22403849623610464
STAT,1847,50,na,1897,23.33146715980648
STAT,1881,8,na,1889,24.88490512401664
STAT,1949,17,45-49,1966,0.005772685593494089
STAT,1839,20,40-44,1859,0.014990143436954373
STAT,1802,86,na,1888,0.6401414097257624
STAT,1880,79,na,1959,8.852557727437448
SIM,1845,47,na,1892,22
STAT,1926,23,na,1949,43.975096393692546
SIM,1841,33,na,1874,18
SIM,1897,45,na,1942,38
STAT,1836,49,30-34,1885,9.529304647725898E-4
SIM,1893,31,na,1924,36
STAT,1888,42,45-49,1930,0.01746817498175209
STAT,1937,32,15-19,1969,0.0012633396119323544
STAT,1950,19,35-39,1969,0.04927543814554768
STAT,1827,62,na,1889,11.223997119493973
STAT,1905,46,50-100,1951,0.0020051268308888645
STAT,1902,20,35-39,1922,0.08278215676479193
STAT,1949,19,na,1968,42.5062806081452
STAT,1949,22,40-44,1971,0.038983730045029266
SIM,1870,7,na,1877,27
STAT,1822,85,na,1907,0.9723976183894655
STAT,1808,70,na,1878,2.6839159641192256
STAT,1826,99,na,1925,0.013234662647388321
SIM,1913,57,na,1970,38
STAT,1862,30,30-34,1892,0.15184710206051058
STAT,1921,20,45-49,1941,0.012684766510919628
SIM,1880,13,na,1893,34
STAT,1894,20,25-29,1914,0.7380325192981809
STAT,1826,39,20-24,1865,0.008466695005587806
STAT,1919,6,na,1925,43.90838902208193
STAT,1931,19,25-29,1950,0.5616739929338352
STAT,1939,32,25-29,1971,0.0936570845132321
STAT,1822,42,50-100,1864,0.006037002485274226
STAT,1919,34,50-100,1953,0.008767095877796574
STAT,1847,41,45-49,1888,0.0162841279046905
STAT,1884,26,25-29,1910,0.41587127521039585
STAT,1910,32,50-100,1942,0.007923361257658884
SIM,1862,70,na,1932,16
SIM,1862,3,na,1865,28
STAT,1867,17,35-39,1884,0.005368025874568884
STAT,1813,49,na,1862,19.826663654117695
STAT,1944,26,20-24,1970,0.19594674676526214
SIM,1920,19,15-19,1939,1
SIM,1919,17,25-29,1936,1
STAT,1914,54,na,1968,35.19023458939041
STAT,1927,37,25-29,1964,0.012179122581962763
STAT,1912,19,15-19,1931,0.09056405955742931
STAT,1901,40,35-39,1941,0.0017772878430546472
STAT,1932,23,25-29,1955,1.203331495640656
STAT,1802,53,45-49,1855,2.1780885834210727E-4
STAT,1902,16,15-19,1918,0.08389378246714602
STAT,1910,40,na,1950,35.28067330417748
STAT,1863,32,50-100,1895,0.008112416250992007
STAT,1845,39,30-34,1884,0.032060431608445544
STAT,1929,18,30-34,1947,0.15440510201270594
SIM,1866,84,na,1950,1
STAT,1898,42,na,1940,31.247802782591453
SIM,1858,65,na,1923,18
STAT,1879,82,na,1961,6.776655150427424
SIM,1854,51,na,1905,17
STAT,1862,48,20-24,1910,1.022308794715098E-4
STAT,1846,29,50-100,1875,0.006181919545516389
STAT,1899,59,na,1958,27.27183924786214
STAT,1920,21,40-44,1941,0.03717382393043981
STAT,1879,37,50-100,1916,0.012707260372233324
STAT,1901,48,45-49,1949,0.0018393523898286098
STAT,1859,43,50-100,1902,0.008336200988258156
STAT,1923,17,25-29,1940,0.505334100712666
STAT,1880,25,50-100,1905,0.006772341285190435
SIM,1789,70,na,1859,9
STAT,1821,47,20-24,1868,1.695756456542628E-4
STAT,1905,26,20-24,1931,0.1698941947085909
SIM,1867,58,na,1925,9
SIM,1863,44,na,1907,11
STAT,1882,27,40-44,1909,0.028707800321859035
STAT,1872,28,na,1900,24.332242657311888
STAT,1837,20,30-34,1857,0.15042553704793382
STAT,1934,27,15-19,1961,0.009456561725026354
STAT,1919,19,25-29,1938,0.47219121456884655
STAT,1873,98,na,1971,0.22378673790282028
SIM,1801,68,na,1869,5
STAT,1905,45,25-29,1950,4.736013808154329E-4
SIM,1892,46,na,1938,36
SIM,1820,71,na,1891,6
STAT,1900,36,35-39,1936,0.021271364800291615
STAT,1856,16,20-24,1872,0.15276150214985784
STAT,1906,33,25-29,1939,0.08508393595120232
STAT,1948,18,40-44,1966,0.015896221667490565
STAT,1911,27,20-24,1938,0.17686766285071515
SIM,1935,18,20-24,1953,1
STAT,1951,20,30-34,1971,0.341539107179985
SIM,1952,7,na,1959,35
STAT,1849,84,na,1933,2.5794414495190874
STAT,1845,16,45-49,1861,4.8547432488565707E-4
STAT,1861,42,45-49,1903,0.012570582680960733
STAT,1950,16,na,1966,43.26433176829033
STAT,1879,16,15-19,1895,0.061574050372400574
STAT,1845,70,na,1915,8.201653925227708
STAT,1922,28,35-39,1950,0.16804968733647768
STAT,1825,38,50-100,1863,0.012589370561091157
STAT,1843,39,20-24,1882,0.003402353958498425
STAT,1881,30,40-44,1911,0.04159744111098076
STAT,1910,22,35-39,1932,0.08788423043016283
STAT,1904,21,50-100,1925,0.005860831886557151
SIM,1886,61,na,1947,24
STAT,1853,15,40-44,1868,0.0013992216400930085
STAT,1947,22,30-34,1969,0.322610029864322
SIM,1898,27,30-34,1925,1
STAT,1924,15,50-100,1939,0.004453103407798329
STAT,1857,24,15-19,1881,0.025573766595133784
SIM,1893,10,na,1903,39
STAT,1957,7,na,1964,51.53097924925752
STAT,1897,27,50-100,1924,0.008494829597254889
STAT,1902,21,na,1923,33.452291081246834
SIM,1897,24,na,1921,41
SIM,1892,57,na,1949,32
STAT,1872,43,50-100,1915,0.010731216956068523
STAT,1903,32,45-49,1935,0.024792498675521926
STAT,1906,35,na,1941,34.825725933150736
STAT,1873,49,35-39,1922,0.0013936508004974368
STAT,1876,20,30-34,1896,0.18198910705640436
STAT,1897,17,20-24,1914,0.2354269895630163
STAT,1919,53,na,1972,38.66160501129009
STAT,1931,35,25-29,1966,0.013004574994670278
STAT,1921,49,25-29,1970,5.898472483985649E-4
SIM,1835,26,na,1861,20
STAT,1885,20,50-100,1905,0.004051017995888384
STAT,1900,27,45-49,1927,0.015396373410334962
STAT,1806,100,na,1906,0.004967638368461859
STAT,1912,35,15-19,1947,1.8772747335166898E-4
STAT,1928,39,20-24,1967,0.0033081287530454563
STAT,1832,100,na,1932,0.004798729235751333
SIM,1838,66,na,1904,3
STAT,1889,60,na,1949,23.35020533213628
SIM,1857,80,na,1937,7
STAT,1843,28,50-100,1871,0.003315510662724112
STAT,1820,41,45-49,1861,0.013443745902289122
SIM,1933,24,na,1957,47
STAT,1848,21,45-49,1869,0.005530581165506671
STAT,1832,48,35-39,1880,7.349083267237194E-4
STAT,1908,37,15-19,1945,1.7886138691198189E-4
STAT,1836,66,na,1902,15.818170213936169
STAT,1901,58,na,1959,28.540386681058706
STAT,1916,27,35-39,1943,0.1539081086732394
STAT,1838,25,na,1863,21.667894193702633
STAT,1838,49,40-44,1887,0.0013324425274755338
STAT,1851,15,50-100,1866,5.088439931061917E-4
STAT,1847,26,50-100,1873,0.0082728340002563
SIM,1854,29,na,1883,19
SIM,1850,15,na,1865,22
STAT,1915,19,40-44,1934,0.0028865913182112082
STAT,1916,28,50-100,1944,0.01016768739766427
STAT,1925,38,na,1963,44.826804920882715
SIM,1913,26,20-24,1939,1
STAT,1926,45,45-49,1971,0.0026789224272065846
SIM,1859,22,25-29,1881,1
STAT,1936,31,45-49,1967,0.015200733085274023
STAT,1817,52,na,1869,21.27879155207432
STAT,1842,51,na,1893,16.23205834145306
STAT,1930,27,30-34,1957,0.4958933342592587
STAT,1927,18,20-24,1945,1.6727161348791986
STAT,1921,24,na,1945,40.66859966101738
SIM,1867,47,na,1914,11
STAT,1855,80,na,1935,4.355349770401164
STAT,1906,24,35-39,1930,0.0842480481955267
STAT,1941,25,40-44,1966,0.047909043304051206
STAT,1859,94,na,1953,0.15885272103443196
STAT,1811,90,na,1901,0.44679834947435054
STAT,1817,63,na,1880,16.240199140946874
SIM,1871,84,na,1955,5
SIM,1784,71,na,1855,3
STAT,1866,30,15-19,1896,0.0013220908188641975
STAT,1931,39,40-44,1970,0.01969581663506335
STAT,1832,30,45-49,1862,0.010404842286429839
STAT,1854,48,50-100,1902,0.0014823306640257652
STAT,1891,16,15-19,1907,0.07301742042724084
STAT,1877,41,30-34,1918,0.011921275432304533
STAT,1841,26,40-44,1867,0.03668149895225842
STAT,1880,30,50-100,1910,0.009712254427449767
STAT,1955,15,na,1970,48.61290207313013
STAT,1850,15,15-19,1865,0.06533599905067154
STAT,1936,24,20-24,1960,1.0559281182490579
STAT,1859,40,25-29,1899,0.0051554734774267065
STAT,1830,24,50-100,1854,0.0058651311257218956
SIM,1819,63,na,1882,4
STAT,1920,17,50-100,1937,0.004167645035328064
STAT,1850,81,na,1931,4.81477735591288
STAT,1942,17,35-39,1959,0.0435319400828238
STAT,1859,21,20-24,1880,0.6290069467486067
STAT,1896,41,40-44,1937,0.002060952049145053
STAT,1925,33,35-39,1958,0.10777179356568711
STAT,1867,25,50-100,1892,0.006163134852587936
STAT,1875,16,30-34,1891,0.01642429563188182
SIM,1855,14,na,1869,23
STAT,1904,17,15-19,1921,0.08503562522621706
SIM,1859,28,na,1887,21
STAT,1905,49,40-44,1954,0.001364652927353267
STAT,1923,37,40-44,1960,0.01722525471535594
STAT,1941,30,15-19,1971,0.0013409267914203833
STAT,1932,20,20-24,1952,1.4617350041328732
STAT,1854,95,na,1949,0.08126698658007933
SIM,1944,24,20-24,1968,2
STAT,1820,38,15-19,1858,5.20267226429632E-4
SIM,1821,34,na,1855,17
SIM,1953,8,na,1961,50
STAT,1822,37,50-100,1859,0.007539611667761275
STAT,1878,24,35-39,1902,0.059869366832725736
STAT,1889,15,20-24,1904,0.2180645040815007
SIM,1825,48,na,1873,17
STAT,1907,42,30-34,1949,0.0011663546522066495
SIM,1905,27,25-29,1932,1
STAT,1924,29,35-39,1953,0.17242995694234922
SIM,1914,10,na,1924,37
SIM,1918,24,na,1942,38
STAT,1901,45,40-44,1946,0.001364760629502194
SIM,1868,43,na,1911,31
SIM,1867,21,20-24,1888,2
SIM,1805,71,na,1876,7
SIM,1839,51,na,1890,20
STAT,1855,45,50-100,1900,0.0017464348046132528
STAT,1915,44,30-34,1959,0.001271755704648648
STAT,1938,19,35-39,1957,0.041092128365022365
STAT,1917,39,45-49,1956,0.006973810321957242
STAT,1890,46,na,1936,27.411568428892192
STAT,1795,99,na,1894,0.004635989684882359
STAT,1915,38,45-49,1953,0.006793411046388032
SIM,1940,20,20-24,1960,3
STAT,1935,16,na,1951,50.21817235588059
STAT,1917,31,35-39,1948,0.09521088318001733
STAT,1897,38,40-44,1935,0.05784295366623652
SIM,1914,21,na,1935,36
STAT,1854,107,na,1961,1.0196491289534577E-4
STAT,1868,26,40-44,1894,0.029088913027417524
SIM,1903,58,na,1961,32
SIM,1918,35,na,1953,37
STAT,1813,48,25-29,1861,0.0017588027199113541
STAT,1911,34,45-49,1945,0.015093806267119503
STAT,1924,41,40-44,1965,0.0029600604803045574
SIM,1960,0,na,1960,52
STAT,1933,32,30-34,1965,0.21145598800125745
STAT,1931,16,20-24,1947,1.771027486881407
STAT,1874,83,na,1957,4.656450089539392
SIM,1887,46,na,1933,25
STAT,1823,48,na,1871,14.795276850386081
STAT,1903,25,20-24,1928,0.1679214929951744
STAT,1829,41,50-100,1870,0.009479387120416861
STAT,1880,39,25-29,1919,0.029971569659521368
SIM,1814,86,na,1900,6
STAT,1914,32,20-24,1946,0.024349127733849476
SIM,1840,48,na,1888,17
STAT,1858,36,25-29,1894,0.02201454759314326
STAT,1918,43,45-49,1961,0.0017507259129334394
STAT,1943,29,45-49,1972,0.018247093820256792
SIM,1793,85,na,1878,2
STAT,1849,26,30-34,1875,0.23313425120044073
STAT,1873,31,45-49,1904,0.017801764759555312
STAT,1907,17,40-44,1924,0.0026754173325145964
SIM,1853,66,na,1919,17
STAT,1937,19,50-100,1956,0.003611027009008324
SIM,1911,25,20-24,1936,2
STAT,1839,95,na,1934,0.07337224899968396
STAT,1835,81,na,1916,2.4323200925989115
STAT,1890,29,40-44,1919,0.03612713533611684
STAT,1892,37,50-100,1929,0.015167627953983827
SIM,1852,81,na,1933,16
STAT,1913,28,20-24,1941,0.17972759921404455
STAT,1804,101,na,1905,0.002215341784175193
STAT,1837,51,na,1888,10.657827269706384
STAT,1908,21,40-44,1929,0.030843542219707157
STAT,1851,66,na,1917,13.837030289385442
STAT,1871,29,30-34,1900,0.24926923145311028
STAT,1904,37,30-34,1941,0.01648315112963642
STAT,1943,21,35-39,1964,0.09948172662522609
STAT,1965,0,na,1965,49.13412649879157
STAT,1839,36,15-19,1875,3.741906988361057E-4
STAT,1861,17,40-44,1878,0.0017679064247617606
STAT,1861,39,15-19,1900,4.674820533023383E-4
STAT,1869,30,40-44,1899,0.04235800627076004
STAT,1889,38,na,1927,28.701904269061767
SIM,1883,32,na,1915,14
STAT,1893,75,na,1968,16.78698258894869
STAT,1916,24,na,1940,37.70128407294365
SIM,1859,39,na,1898,18
STAT,1878,21,30-34,1899,0.18445233913753806
STAT,1869,61,na,1930,18.105983686093868
STAT,1857,28,na,1885,18.269828149837686
STAT,1856,23,45-49,1879,0.005824870727581251
STAT,1912,10,na,1922,39.7427355449442
STAT,1933,26,45-49,1959,0.022855989269355434
STAT,1868,22,50-100,1890,0.003946372528441557
STAT,1878,15,45-49,1893,6.775343723664286E-4
STAT,1885,24,na,1909,23.20899757134777
STAT,1852,31,25-29,1883,0.09171001372148119
STAT,1853,14,na,1867,17.884535397285763
STAT,1900,21,15-19,1921,0.045885086101501396
STAT,1835,27,40-44,1862,0.01797720074668399
SIM,1909,42,na,1951,34
STAT,1864,94,na,1958,0.2670579703114964
STAT,1850,23,15-19,1873,0.035002304517238764
STAT,1875,36,25-29,1911,0.029738931338312895
SIM,1897,23,20-24,1920,1
STAT,1822,38,25-29,1860,0.01725747636301049
STAT,1805,83,na,1888,1.1459904188909984
SIM,1847,59,na,1906,13
SIM,1866,30,na,1896,28
STAT,1858,27,35-39,1885,0.07516280383646928
STAT,1822,53,na,1875,8.390709141952115
STAT,1905,18,na,1923,36.35509157620913
STAT,1913,37,na,1950,36.81712752914527
STAT,1854,29,30-34,1883,0.15905016138922262
STAT,1856,37,40-44,1893,0.031712090196072434
STAT,1898,21,20-24,1919,0.9324367734832051
STAT,1814,42,45-49,1856,0.04782442498917951
SIM,1858,11,na,1869,27
STAT,1849,21,25-29,1870,0.5405423149596873
STAT,1889,23,20-24,1912,0.8411104216782026
STAT,1856,75,na,1931,7.457766592740117
SIM,1857,21,25-29,1878,1
STAT,1881,64,na,1945,16.54123538551393
STAT,1864,48,30-34,1912,8.573121201630204E-4
SIM,1848,23,25-29,1871,1
STAT,1861,37,50-100,1898,0.010324770551242089
STAT,1877,44,35-39,1921,0.01844001417117632
SIM,1848,36,30-34,1884,1
STAT,1942,29,15-19,1971,0.007348119965590599
STAT,1873,16,20-24,1889,0.18131260208350874
STAT,1817,43,25-29,1860,0.019679811654005966
STAT,1945,21,45-49,1966,0.012247253752854438
STAT,1867,25,35-39,1892,0.09296288064955524
STAT,1883,65,na,1948,16.410912722951828
STAT,1882,26,15-19,1908,0.0043629513645997335
SIM,1872,48,na,1920,21
STAT,1892,33,20-24,1925,0.03325287254107558
STAT,1871,38,20-24,1909,0.007647246739342933
STAT,1869,52,50-100,1921,1.4555776672162113E-4
STAT,1894,38,15-19,1932,7.16102733973862E-4
STAT,1871,32,na,1903,23.791529691622237
STAT,1845,48,na,1893,12.986170021684861
STAT,1864,19,50-100,1883,4.492305343241445E-4
STAT,1884,34,25-29,1918,0.09949294078987325
SIM,1926,22,na,1948,49
STAT,1856,65,na,1921,12.242652031317641
SIM,1832,83,na,1915,8
STAT,1825,42,20-24,1867,0.0015443908481749785
SIM,1910,39,na,1949,31
STAT,1865,17,25-29,1882,0.05281718016728637
STAT,1875,24,30-34,1899,0.1819537315729735
STAT,1890,25,na,1915,29.18583895274617
SIM,1879,80,na,1959,5
SIM,1889,24,25-29,1913,1
SIM,1909,52,na,1961,33
STAT,1880,19,30-34,1899,0.01667050096932764
STAT,1944,27,50-100,1971,0.010679773014481607
STAT,1916,24,30-34,1940,0.29672561378191276
STAT,1918,32,40-44,1950,0.04120815077249982
STAT,1870,15,na,1885,25.629103396467865
STAT,1930,39,50-100,1969,0.005439225797808383
STAT,1790,90,na,1880,0.18675254872197536
STAT,1837,22,45-49,1859,0.0047558641701588794
STAT,1912,39,30-34,1951,0.017471789443409963
STAT,1855,106,na,1961,2.840012741130793E-4
STAT,1861,19,20-24,1880,0.16934795351221488
STAT,1950,16,30-34,1966,0.1432694812350441
STAT,1815,48,35-39,1863,0.0019892782030075545
STAT,1830,37,20-24,1867,0.004509419553233761
STAT,1889,43,15-19,1932,1.6785673906896892E-4
STAT,1788,86,na,1874,0.8442821300860252
STAT,1858,46,50-100,1904,0.0018741862427232685
STAT,1900,62,na,1962,26.945446430258702
STAT,1835,28,na,1863,12.579252168568281
STAT,1899,28,35-39,1927,0.13162247834776927
STAT,1837,29,na,1866,13.226463625014256
STAT,1856,97,na,1953,0.03891831465546099
STAT,1925,42,25-29,1967,8.591360953625127E-4
STAT,1939,24,25-29,1963,0.9206582659692917
STAT,1863,39,25-29,1902,0.025235773973823976
STAT,1849,34,30-34,1883,0.13972583744332384
STAT,1853,37,15-19,1890,3.5292087161379395E-4
STAT,1866,43,20-24,1909,0.0014520729514992906
STAT,1876,23,35-39,1899,0.05908466785319193
STAT,1919,31,45-49,1950,0.016898631143034963
STAT,1934,15,35-39,1949,0.056779185651081865
SIM,1907,32,30-34,1939,1
STAT,1891,17,40-44,1908,0.0022448859220376457
STAT,1841,25,15-19,1866,0.00559589013410148
STAT,1886,22,40-44,1908,0.02161464709119084
STAT,1847,39,40-44,1886,0.04752056463956315
SIM,1906,20,20-24,1926,1
STAT,1850,49,40-44,1899,0.0014924783911205786
STAT,1870,15,40-44,1885,0.0018560460939650671
STAT,1915,15,25-29,1930,0.09033273457348187
SIM,1849,50,na,1899,7
STAT,1836,26,45-49,1862,0.013965583707076982
STAT,1935,27,45-49,1962,0.023445217587614708
STAT,1853,23,40-44,1876,0.015362782968479306
STAT,1843,47,na,1890,9.49918697593523
STAT,1917,23,35-39,1940,0.09885770081854424
STAT,1882,39,35-39,1921,0.06710069820689078
STAT,1859,30,na,1889,19.24309476512318
STAT,1847,26,20-24,1873,0.15171721730163798
STAT,1873,45,na,1918,23.102008787598816
SIM,1860,47,na,1907,23
SIM,1947,24,25-29,1971,2
STAT,1843,33,25-29,1876,0.051693832709256045
STAT,1848,78,na,1926,5.052876733806235
STAT,1934,20,30-34,1954,0.38586955463782424
SIM,1830,70,na,1900,2
STAT,1798,86,na,1884,1.3165399182993631
STAT,1805,51,na,1856,9.677931891367294
STAT,1900,23,50-100,1923,0.005637282954158285
STAT,1944,25,45-49,1969,0.01855283655782985
STAT,1871,64,na,1935,17.331439576217985
STAT,1927,25,45-49,1952,0.021037301790129876
SIM,1868,11,na,1879,38
STAT,1938,20,15-19,1958,0.052372475259484186
STAT,1813,70,na,1883,11.075735963607872
STAT,1880,21,35-39,1901,0.06154843203565656
SIM,1933,7,na,1940,55
STAT,1868,21,35-39,1889,0.056880989778872224
SIM,1881,4,na,1885,27
STAT,1886,17,45-49,1903,6.775683381278206E-4
SIM,1890,77,na,1967,13
SIM,1843,77,na,1920,14
STAT,1924,30,15-19,1954,0.0014962124419195216
STAT,1896,44,45-49,1940,0.0013467278391150117
STAT,1850,19,45-49,1869,7.02368921687012E-4
STAT,1839,27,25-29,1866,0.2940857612624275
STAT,1865,22,20-24,1887,0.6308815818762188
STAT,1930,39,na,1969,48.73936414632172
STAT,1820,72,na,1892,7.15966483559602
STAT,1829,53,45-49,1882,1.068277988645357E-4
STAT,1835,29,20-24,1864,0.068852101789916
STAT,1909,37,45-49,1946,0.006416496831950708
STAT,1947,23,20-24,1970,1.2477078338959857
STAT,1808,48,na,1856,4.866681367083879
STAT,1868,76,na,1944,9.168454368072977
STAT,1873,77,na,1950,8.788211181455964
STAT,1844,39,15-19,1883,4.539748112033245E-4
STAT,1915,18,na,1933,39.96924196895763
SIM,1935,25,45-49,1960,1
SIM,1856,22,20-24,1878,1
STAT,1796,73,na,1869,0.9963284788193141
STAT,1851,35,25-29,1886,0.02508290941548887
STAT,1847,29,na,1876,27.37823827767871
STAT,1917,36,40-44,1953,0.01548155687871587
STAT,1903,21,40-44,1924,0.029715645713160488
STAT,1860,27,na,1887,19.609666583106847
SIM,1932,26,30-34,1958,1
STAT,1859,39,45-49,1898,0.015685100461239346
SIM,1870,67,na,1937,15
SIM,1855,46,na,1901,14
STAT,1876,28,40-44,1904,0.030317223877675315
STAT,1828,39,30-34,1867,0.023546354260348255
SIM,1889,80,na,1969,13
STAT,1858,32,30-34,1890,0.1328587916695432
SIM,1898,22,25-29,1920,1
STAT,1834,48,45-49,1882,0.001746201903722647
STAT,1924,26,30-34,1950,0.4548048495309754
STAT,1848,22,20-24,1870,0.5426329400409051
SIM,1919,52,na,1971,42
STAT,1857,20,20-24,1877,0.6042041805837899
STAT,1899,45,25-29,1944,4.492172108669608E-4
STAT,1891,24,15-19,1915,0.04023754573001312
STAT,1929,22,15-19,1951,0.06699420853607602
SIM,1858,4,na,1862,27
STAT,1865,58,na,1923,17.887118905407647
STAT,1874,15,25-29,1889,0.05797111577131812
STAT,1876,95,na,1971,0.7011631145246326
STAT,1812,53,na,1865,11.05373094044039
STAT,1885,26,40-44,1911,0.029683153502640957
STAT,1824,33,15-19,1857,0.002252678726212619
SIM,1862,48,na,1910,23
STAT,1923,37,na,1960,43.29017814927093
SIM,1850,47,na,1897,20
SIM,1883,10,na,1893,15
SIM,1946,20,na,1966,52
STAT,1894,16,40-44,1910,0.002349827837084812
STAT,1845,81,na,1926,3.1610326174495196
STAT,1828,30,50-100,1858,0.013062652025224279
SIM,1869,60,na,1929,13
STAT,1899,25,30-34,1924,0.34706221082823224
STAT,1860,70,na,1930,11.406610371157665
STAT,1814,42,50-100,1856,0.03375841754268173
STAT,1904,20,45-49,1924,0.01005147295991755
STAT,1954,16,15-19,1970,0.5579986894398092
STAT,1868,98,na,1966,0.1367753629706364
STAT,1877,27,45-49,1904,0.011461226746583212
STAT,1880,25,na,1905,25.265815494443405
STAT,1938,33,20-24,1971,0.024349085529225756
SIM,1916,22,na,1938,47
STAT,1855,15,15-19,1870,0.050287809435013875
STAT,1915,1,na,1916,43.18833396706381
STAT,1886,4,na,1890,27.287237751264886
STAT,1805,73,na,1878,4.197584729872618
STAT,1903,59,na,1962,29.12371842262111
STAT,1800,54,50-100,1854,2.312307515851947E-4
STAT,1855,26,na,1881,17.640766794134
STAT,1875,49,45-49,1924,0.0023752916643363466
STAT,1840,32,45-49,1872,0.016643190329577867
STAT,1850,41,50-100,1891,0.009448837984858289
STAT,1953,15,45-49,1968,0.0060111533563698746
STAT,1881,33,45-49,1914,0.016523202206803565
STAT,1929,20,na,1949,46.233420529266844
STAT,1844,25,40-44,1869,0.02905913974691665
STAT,1932,20,50-100,1952,0.008649832292166072
STAT,1917,40,25-29,1957,7.404941555331805E-4
STAT,1908,30,30-34,1938,0.14913327811499474
SIM,1842,28,na,1870,28
STAT,1895,15,45-49,1910,8.519930149116743E-4
SIM,1910,1,na,1911,36
SIM,1911,28,25-29,1939,1
STAT,1890,38,30-34,1928,0.06441743258446953
STAT,1856,49,35-39,1905,9.930308271734146E-4
STAT,1949,21,15-19,1970,0.06173825282145777
STAT,1930,17,na,1947,47.363862234357
SIM,1856,10,na,1866,21
SIM,1916,25,35-39,1941,1
STAT,1834,35,25-29,1869,0.025839880149737267
STAT,1927,30,40-44,1957,0.04794693424054373
STAT,1884,31,20-24,1915,0.02659149812666629
STAT,1948,22,25-29,1970,1.0535728738619787
STAT,1869,42,35-39,1911,0.017524122747179665
STAT,1869,6,na,1875,26.93132038017539
STAT,1823,47,30-34,1870,6.720977187105627E-4
STAT,1903,28,25-29,1931,0.5992963603420489
SIM,1842,18,na,1860,30
STAT,1845,24,45-49,1869,0.004987915477532391
STAT,1855,16,na,1871,19.33640310228343
STAT,1867,22,30-34,1889,0.17115873393035907
STAT,1943,26,40-44,1969,0.04930106112512294
STAT,1910,31,25-29,1941,0.0889363208366888
STAT,1837,29,30-34,1866,0.15582994204026812
SIM,1842,35,25-29,1877,1
STAT,1908,25,35-39,1933,0.14335495463333497
STAT,1839,32,20-24,1871,0.01835708544811903
STAT,1849,46,25-29,1895,4.478934370809602E-4
STAT,1927,33,45-49,1960,0.01924605726549259
STAT,1902,25,40-44,1927,0.0425296328553337
SIM,1882,26,na,1908,27
STAT,1860,38,45-49,1898,0.016126118617977567
STAT,1892,36,25-29,1928,0.035741021518405885
STAT,1817,40,20-24,1857,0.005338282292763349
STAT,1880,47,na,1927,23.547974218373565
STAT,1886,25,45-49,1911,0.011594934005732322
STAT,1839,37,40-44,1876,0.028868537658941547
STAT,1852,27,40-44,1879,0.029861028775334843
STAT,1849,17,40-44,1866,0.0017457092398400927
SIM,1922,18,na,1940,44
SIM,1846,32,na,1878,15
SIM,1908,25,na,1933,40
STAT,1870,18,45-49,1888,6.512293240075949E-4
STAT,1966,1,na,1967,48.86297683514102
SIM,1933,25,35-39,1958,1
STAT,1920,16,45-49,1936,0.005570507791192508
STAT,1942,22,30-34,1964,0.299154718142454
STAT,1815,51,na,1866,10.241609503823282
STAT,1825,45,25-29,1870,5.460822183280324E-4
STAT,1835,31,25-29,1866,0.059985432410437925
STAT,1917,41,na,1958,38.461137663915906
STAT,1898,33,15-19,1931,0.0019129737914168755
STAT,1877,38,15-19,1915,5.76786551095138E-4
STAT,1893,43,na,1936,29.03130026442667
STAT,1868,34,40-44,1902,0.041609053793328896
STAT,1925,25,35-39,1950,0.1774132836282893
STAT,1929,2,na,1931,51.94540275297893
STAT,1873,29,40-44,1902,0.03023800475015303
STAT,1878,76,na,1954,9.781161626648217
STAT,1825,71,na,1896,7.195955240178639
STAT,1895,32,35-39,1927,0.13147516427751246
STAT,1844,39,50-100,1883,0.009925538935898868
STAT,1932,15,25-29,1947,0.5741549587393419
SIM,1892,0,na,1892,36
SIM,1948,20,25-29,1968,1
STAT,1925,29,15-19,1954,0.008226719366201231
STAT,1812,49,20-24,1861,1.312346244900268E-4
STAT,1832,31,na,1863,12.789856475591879
SIM,1814,64,na,1878,20
STAT,1863,77,na,1940,7.65330742717456
SIM,1840,15,20-24,1855,1
STAT,1908,22,30-34,1930,0.2628553162376833
STAT,1886,31,50-100,1917,0.009542745433772934
SIM,1961,1,na,1962,53
STAT,1885,2,na,1887,30.822163576925067
STAT,1838,46,na,1884,18.196534610507893
SIM,1822,73,na,1895,9
STAT,1856,36,15-19,1892,4.0876033408477415E-4
SIM,1842,71,na,1913,17
SIM,1792,68,na,1860,5
SIM,1827,29,na,1856,22
STAT,1889,39,30-34,1928,0.06459498088655609
STAT,1900,30,na,1930,33.35653204162946
STAT,1940,21,50-100,1961,0.006657576832628105
STAT,1909,42,40-44,1951,0.0023263792106270444
STAT,1884,17,35-39,1901,0.005375988525098302
STAT,1834,23,30-34,1857,0.1671400783441844
STAT,1868,44,na,1912,22.065002879160062
STAT,1855,43,45-49,1898,0.010461271997668489
STAT,1865,27,40-44,1892,0.0270944963194144
SIM,1848,76,na,1924,11
STAT,1856,6,na,1862,21.36999803410607
STAT,1843,30,20-24,1873,0.014073839823456757
STAT,1935,24,40-44,1959,0.04555293805365341
SIM,1940,15,25-29,1955,1
STAT,1935,32,40-44,1967,0.053900591482605106
STAT,1863,19,30-34,1882,0.01448180886502556
SIM,1929,19,na,1948,48
STAT,1844,19,20-24,1863,0.17396011223538954
STAT,1828,41,35-39,1869,0.008066928936914913
STAT,1826,37,40-44,1863,0.05064034690380597
SIM,1840,70,na,1910,4
STAT,1863,13,na,1876,24.009284027969876
STAT,1857,15,25-29,1872,0.05045256359365955
STAT,1793,87,na,1880,0.3150343009424568
STAT,1892,16,30-34,1908,0.01973914586659959
STAT,1857,16,50-100,1873,4.3362006805173266E-4
STAT,1840,26,25-29,1866,0.4162838999161691
STAT,1934,21,na,1955,48.88405999394763
STAT,1780,90,na,1870,0.5460119621130237
STAT,1881,27,25-29,1908,0.4025163938968152
STAT,1918,39,25-29,1957,0.010262168057419608
SIM,1865,46,na,1911,22
SIM,1876,62,na,1938,25
STAT,1842,21,15-19,1863,0.031445193001440434
STAT,1898,38,50-100,1936,0.0035570873241196114
SIM,1873,22,20-24,1895,1
STAT,1876,15,35-39,1891,0.0055988337950688355
STAT,1839,26,50-100,1865,0.0044793985865208335
SIM,1879,7,na,1886,19
STAT,1910,62,na,1972,31.01028598132512
STAT,1934,23,35-39,1957,0.12596111078672492
STAT,1882,17,25-29,1899,0.054306739613095595
STAT,1893,28,40-44,1921,0.0376374352360697
SIM,1869,27,na,1896,15
STAT,1868,41,50-100,1909,0.010270023626867669
SIM,1876,41,50-100,1917,1
STAT,1909,39,50-100,1948,0.003912000466865459
SIM,1888,28,25-29,1916,1
STAT,1946,22,15-19,1968,0.058818969171966766
STAT,1848,38,30-34,1886,0.03515136511470572
SIM,1863,65,na,1928,5
SIM,1864,29,na,1893,22
STAT,1838,78,na,1916,6.064287541791558
STAT,1860,25,25-29,1885,0.3526293546629327
STAT,1858,24,30-34,1882,0.13949364343310544
STAT,1837,49,25-29,1886,2.836790309264405E-4
STAT,1836,37,15-19,1873,6.652002436806113E-4
STAT,1951,19,15-19,1970,0.5367938316216343
STAT,1826,49,50-100,1875,0.0024074479852018945
STAT,1908,28,50-100,1936,0.00932751633828764
STAT,1884,82,na,1966,7.5227836889253155
STAT,1930,26,50-100,1956,0.01260278246069018
STAT,1951,15,35-39,1966,0.04969161325301036
STAT,1866,46,25-29,1912,5.319915164284712E-4
STAT,1876,32,25-29,1908,0.10402857564975412
SIM,1866,36,25-29,1902,1
STAT,1898,24,25-29,1922,0.7674094156036527
STAT,1929,35,20-24,1964,0.0033739618992382017
SIM,1866,24,30-34,1890,1
STAT,1780,105,na,1885,3.901108693050096E-4
STAT,1928,26,15-19,1954,0.008684449068750441
STAT,1833,47,na,1880,17.75194542684573
SIM,1931,22,20-24,1953,3
STAT,1899,42,20-24,1941,1.5078427573558776E-4
STAT,1854,31,35-39,1885,0.06405116387468542
STAT,1833,27,30-34,1860,0.2457218169647956
STAT,1883,22,15-19,1905,0.0320362108209237
STAT,1807,64,na,1871,10.199839336908987
STAT,1833,43,50-100,1876,0.009356832636628256
STAT,1858,44,25-29,1902,0.004820501787625798
STAT,1886,49,20-24,1935,1.2187308259872802E-4
STAT,1841,38,35-39,1879,0.08072490710604086
STAT,1859,36,40-44,1895,0.03496059287004383
STAT,1915,20,20-24,1935,1.0999707809962054
STAT,1843,16,35-39,1859,0.0029921221295336198
STAT,1810,52,na,1862,9.758831281253954
STAT,1830,40,na,1870,9.44654822963273
SIM,1867,9,na,1876,19
STAT,1896,38,25-29,1934,0.03763170766880416
STAT,1927,22,40-44,1949,0.041214519514283406
SIM,1804,54,na,1858,12
STAT,1910,18,15-19,1928,0.0891421017050945
SIM,1857,59,na,1916,19
STAT,1831,49,30-34,1880,9.032998983428644E-4
STAT,1845,21,40-44,1866,0.015231136435035826
STAT,1897,37,15-19,1934,7.457075335819315E-4
STAT,1818,38,45-49,1856,0.025391796494961108
STAT,1829,47,25-29,1876,4.916982372627032E-4
STAT,1932,32,15-19,1964,0.0017013686583643383
STAT,1872,3,na,1875,31.871408886705428
STAT,1888,27,20-24,1915,0.1370935089989822
STAT,1923,22,20-24,1945,1.284836031460395
STAT,1850,16,40-44,1866,0.002001797286395585
STAT,1869,93,na,1962,0.6525440173308492
STAT,1876,10,na,1886,26.713810459536003
STAT,1846,65,na,1911,13.695931284470486
SIM,1852,71,na,1923,19
STAT,1879,24,15-19,1903,0.033931473518849196
SIM,1858,33,na,1891,25
STAT,1827,33,40-44,1860,0.03720124106489774
SIM,1822,83,na,1905,6
STAT,1862,33,35-39,1895,0.08700403069094582
STAT,1869,25,45-49,1894,0.010831173695485499
STAT,1939,20,na,1959,36.44786026813995
STAT,1851,15,30-34,1866,0.016554394608066143
STAT,1866,48,40-44,1914,0.001556908870620054
STAT,1847,34,20-24,1881,0.0302176390640119
SIM,1900,39,na,1939,36
SIM,1850,69,na,1919,12
SIM,1909,20,na,1929,37
SIM,1930,27,na,1957,44
SIM,1899,57,na,1956,25
SIM,1859,50,na,1909,18
STAT,1839,24,20-24,1863,0.48164599020131454
STAT,1866,26,30-34,1892,0.23271654189139035
STAT,1894,24,40-44,1918,0.026538741305788115
STAT,1908,33,35-39,1941,0.08544908747081517
STAT,1898,16,25-29,1914,0.07663196407847456
STAT,1800,74,na,1874,4.186047648832094
SIM,1890,9,na,1899,31
SIM,1915,38,na,1953,34
STAT,1844,28,45-49,1872,0.010540404509435754
STAT,1838,23,15-19,1861,0.032981683614943164
STAT,1950,20,15-19,1970,0.06280221462986113
SIM,1891,51,na,1942,32
STAT,1865,54,50-100,1919,1.3284598013693614E-4
STAT,1861,21,25-29,1882,0.4981480690138456
STAT,1916,32,30-34,1948,0.16127006688555243
SIM,1852,28,na,1880,28
STAT,1857,23,25-29,1880,0.49117868326800096
STAT,1919,23,45-49,1942,0.012176245330305119
STAT,1879,1,na,1880,35.4355364589102
SIM,1889,21,20-24,1910,2
STAT,1922,4,na,1926,46.36927064045984
SIM,1846,10,na,1856,18
STAT,1893,65,na,1958,22.069037239776897
SIM,1924,2,na,1926,56
STAT,1850,17,na,1867,24.974681130670767
STAT,1907,21,25-29,1928,0.8398891414841239
STAT,1881,42,na,1923,21.96537394507703
STAT,1908,20,15-19,1928,0.04897407054043207
SIM,1921,15,15-19,1936,1
SIM,1837,82,na,1919,3
STAT,1873,24,20-24,1897,0.6962421868638231
STAT,1917,44,40-44,1961,0.0025779344475488496
STAT,1878,23,45-49,1901,0.007177024570953084
STAT,1836,43,35-39,1879,0.020525122124163846
STAT,1885,29,45-49,1914,0.010886043076507168
STAT,1863,99,na,1962,0.0472640384402469
SIM,1834,21,30-34,1855,1
STAT,1887,42,50-100,1929,0.011517057252206649
STAT,1913,15,15-19,1928,0.09244136374596627
STAT,1862,16,45-49,1878,6.492922733215416E-4
SIM,1941,21,na,1962,44
STAT,1851,32,20-24,1883,0.023751589791164613
SIM,1945,5,na,1950,40
STAT,1855,48,na,1903,15.641414022512185
STAT,1926,21,35-39,1947,0.11408168849610428
STAT,1815,53,50-100,1868,2.0538646714796566E-4
STAT,1909,34,40-44,1943,0.03681630893019844
STAT,1835,71,na,1906,6.003837756117107
STAT,1919,20,50-100,1939,0.007185299775756363
STAT,1858,35,35-39,1893,0.05433216478690329
STAT,1920,40,na,1960,40.78179660158871
SIM,1880,77,na,1957,17
STAT,1832,28,40-44,1860,0.017792378771053555
STAT,1858,41,20-24,1899,0.0012139474086914981
SIM,1853,34,na,1887,24
STAT,1843,79,na,1922,2.965559585994324
STAT,1886,41,na,1927,24.082186804515054
STAT,1866,17,40-44,1883,0.0017290059495967194
SIM,1824,32,na,1856,19
STAT,1945,26,15-19,1971,0.007692859131947091
STAT,1883,26,30-34,1909,0.2453759463115518
STAT,1912,49,50-100,1961,0.0021440441024402406
STAT,1888,49,30-34,1937,6.247697518511747E-4
STAT,1942,25,35-39,1967,0.15656406537062925
SIM,1887,56,na,1943,21
STAT,1878,22,na,1900,24.417176942211967
STAT,1900,42,50-100,1942,0.0010160477618990302
SIM,1826,31,25-29,1857,1
STAT,1926,30,25-29,1956,0.11124636394568699
SIM,1872,16,na,1888,26
STAT,1825,47,40-44,1872,0.0015799726905696377
STAT,1874,24,15-19,1898,0.03325879784999281
SIM,1929,8,na,1937,51
SIM,1832,51,na,1883,20
STAT,1843,38,45-49,1881,0.008890643191516523
STAT,1812,47,50-100,1859,0.0027584309047469415
STAT,1922,26,20-24,1948,0.20574515224838588
STAT,1882,21,45-49,1903,0.006702913690086573
SIM,1944,18,na,1962,34
STAT,1899,49,40-44,1948,0.001294391458005418
STAT,1911,39,15-19,1950,1.8242901580080886E-4
SIM,1958,4,na,1962,53
STAT,1816,49,40-44,1865,0.0020933898943452573
STAT,1909,45,45-49,1954,0.0020049972563470813
STAT,1783,87,na,1870,0.29067868524510687
STAT,1878,32,35-39,1910,0.10455360707361223
SIM,1874,1,na,1875,37
STAT,1916,15,40-44,1931,0.002955884309600392
STAT,1849,48,50-100,1897,0.0018804326662022486
STAT,1903,60,na,1963,28.840927116737454
STAT,1839,49,35-39,1888,7.672641104028469E-4
SIM,1911,3,na,1914,42
SIM,1893,22,25-29,1915,4
STAT,1854,31,na,1885,15.092821559173354
STAT,1889,28,40-44,1917,0.03654654020978518
STAT,1839,35,25-29,1874,0.01938603301517578
STAT,1811,69,na,1880,9.651006174901578
STAT,1905,28,35-39,1933,0.1387671397797678
SIM,1904,53,na,1957,25
STAT,1857,39,35-39,1896,0.05241555584338824
STAT,1933,27,35-39,1960,0.19853728178575294
STAT,1823,39,30-34,1862,0.037649392450616305
SIM,1796,72,na,1868,5
STAT,1854,38,20-24,1892,0.004688328333366357
STAT,1893,21,20-24,1914,0.8715253244141725
STAT,1935,35,45-49,1970,0.009506774054011683
STAT,1943,25,na,1968,39.64065009502932
STAT,1890,16,20-24,1906,0.21587788536616068
SIM,1897,28,40-44,1925,1
STAT,1867,81,na,1948,5.174903052090671
STAT,1846,25,15-19,1871,0.0045127503303772475
STAT,1855,37,25-29,1892,0.020271558298408723
STAT,1885,22,25-29,1907,0.5653088920645227
SIM,1888,16,30-34,1904,1
STAT,1837,27,15-19,1864,0.0028594652195623686
STAT,1846,39,25-29,1885,0.023866242725779047
STAT,1912,18,25-29,1930,0.08671543124949456
STAT,1897,28,25-29,1925,0.5597666624250072
STAT,1940,29,40-44,1969,0.04714581937593047
SIM,1885,66,na,1951,14
STAT,1914,39,40-44,1953,0.014673455347002132
STAT,1933,20,15-19,1953,0.07074132572903337
SIM,1868,64,na,1932,27
STAT,1911,26,45-49,1937,0.016796782129634116
STAT,1875,27,35-39,1902,0.09918540412409266
STAT,1809,45,40-44,1854,0.0060180755399732
STAT,1900,19,45-49,1919,9.009577079379693E-4
STAT,1853,29,15-19,1882,0.002962956197116178
STAT,1886,63,na,1949,18.507986867864975
STAT,1919,36,15-19,1955,2.0470083515973896E-4
STAT,1904,49,25-29,1953,4.558427222805579E-4
STAT,1861,28,45-49,1889,0.009337463997207167
STAT,1858,18,45-49,1876,5.772216400856307E-4
STAT,1952,20,25-29,1972,1.104780459493662
SIM,1921,23,na,1944,37
STAT,1886,28,15-19,1914,0.004689538119281939
STAT,1869,34,35-39,1903,0.09728522530923638
STAT,1800,84,na,1884,1.0168551571273416
STAT,1843,37,40-44,1880,0.02167776335104724
STAT,1857,48,50-100,1905,0.0018154794962100874
SIM,1861,31,na,1892,27
STAT,1838,43,45-49,1881,0.012204771759603782
STAT,1827,36,45-49,1863,0.016531301790563974
STAT,1874,28,30-34,1902,0.25456896117999617
STAT,1878,44,na,1922,23.53955757309224
STAT,1859,20,30-34,1879,0.16375951642482814
STAT,1894,27,45-49,1921,0.014229554750087811
STAT,1892,38,40-44,1930,0.05381176755237003
STAT,1863,17,15-19,1880,0.059958069506686744
SIM,1929,24,30-34,1953,1
SIM,1911,23,na,1934,37
STAT,1917,32,25-29,1949,0.09590520186233174
STAT,1919,40,35-39,1959,0.002169257150381082
STAT,1839,48,30-34,1887,5.373487774609181E-4
STAT,1865,25,25-29,1890,0.3852067561107491
STAT,1882,48,25-29,1930,5.450700378933428E-4
STAT,1857,35,50-100,1892,0.009278268854739953
STAT,1846,12,na,1858,24.3035417822253
STAT,1842,39,40-44,1881,0.034339767203290246
STAT,1890,17,25-29,1907,0.06883391460483146
STAT,1842,25,30-34,1867,0.23703738880232325
STAT,1899,49,50-100,1948,0.001856907370642306
STAT,1932,40,na,1972,50.27111335509899
STAT,1862,48,50-100,1910,0.0020923252503429347
STAT,1907,41,na,1948,34.07795225196749
SIM,1831,26,25-29,1857,1
SIM,1874,81,na,1955,13
STAT,1875,15,40-44,1890,0.0018888730548403108
STAT,1876,36,40-44,1912,0.044673909339531165
STAT,1908,46,40-44,1954,0.0014291422456277805
STAT,1923,25,25-29,1948,0.7555458179903315
STAT,1939,15,35-39,1954,0.04181699280307805
STAT,1785,101,na,1886,0.003961386336584587
STAT,1871,23,35-39,1894,0.057999981645706286
STAT,1874,29,35-39,1903,0.09718792938017351
SIM,1919,19,na,1938,43
STAT,1871,11,na,1882,26.4436578686383
STAT,1907,37,35-39,1944,0.02233077426299181
STAT,1924,34,30-34,1958,0.18238071524692723
STAT,1848,37,50-100,1885,0.008182129862204335
SIM,1836,32,na,1868,11
STAT,1848,34,15-19,1882,9.572449321464424E-4
STAT,1849,43,20-24,1892,0.0012225269107778288
STAT,1841,16,25-29,1857,0.07196143178935628
SIM,1902,63,na,1965,30
STAT,1833,69,na,1902,10.864858152600078
STAT,1841,98,na,1939,0.03179720345324031
STAT,1852,23,25-29,1875,0.5778415937195657
STAT,1827,39,15-19,1866,4.465352742849139E-4
STAT,1891,26,30-34,1917,0.3101341798231118
STAT,1832,22,45-49,1854,0.004254885872718551
STAT,1907,30,15-19,1937,0.0012057135469252392
STAT,1944,8,na,1952,42.18657866620093
STAT,1905,34,20-24,1939,0.02220871331154863
SIM,1822,51,na,1873,14
STAT,1819,40,30-34,1859,0.011316271562109887
SIM,1838,45,na,1883,8
STAT,1931,18,35-39,1949,0.0545368519919764
STAT,1861,24,50-100,1885,0.003472680355665075
STAT,1925,26,50-100,1951,0.011722753090210165
STAT,1833,79,na,1912,5.175778420403145
STAT,1941,26,30-34,1967,0.4025732917509264
STAT,1921,29,30-34,1950,0.43018855620040997
STAT,1906,25,25-29,1931,0.6187311264444935
SIM,1854,61,na,1915,15
STAT,1838,39,25-29,1877,0.026410610990251677
STAT,1885,14,na,1899,25.420098222611845
STAT,1839,15,30-34,1854,0.01164302248099028
STAT,1835,35,40-44,1870,0.025086559840165685
STAT,1936,20,40-44,1956,0.03197343887533933
STAT,1845,27,15-19,1872,0.0032280946173334902
STAT,1873,36,15-19,1909,5.736671523384271E-4
SIM,1932,18,na,1950,48
STAT,1873,38,30-34,1911,0.05391666442300379
STAT,1886,31,30-34,1917,0.18184387136363234
STAT,1862,27,15-19,1889,0.003928815301019718
STAT,1910,30,na,1940,36.53566193679291
STAT,1856,15,30-34,1871,0.013815272696170352
STAT,1926,37,45-49,1963,0.008283875351501132
STAT,1937,18,na,1955,35.48850705319478
STAT,1869,22,40-44,1891,0.02019088654541439
SIM,1807,84,na,1891,2
STAT,1915,23,25-29,1938,0.9436418537854062
STAT,1930,39,25-29,1969,0.012755606491048364
STAT,1842,26,35-39,1868,0.09017330067371492
STAT,1875,20,15-19,1895,0.03411439774567166
STAT,1900,19,na,1919,34.83430882439936
STAT,1911,19,20-24,1930,0.2681051048261313
STAT,1887,37,20-24,1924,0.008413875264481525
STAT,1841,20,45-49,1861,0.008772047498000902
STAT,1856,29,40-44,1885,0.022165308476745433
STAT,1934,36,40-44,1970,0.02058919369140438
STAT,1955,16,30-34,1971,0.16094098280134309
STAT,1899,19,45-49,1918,8.894262082071386E-4
STAT,1847,17,30-34,1864,0.021250503398116214
SIM,1872,26,na,1898,23
STAT,1817,37,50-100,1854,0.049064885926462735
STAT,1858,49,45-49,1907,0.0017583339090857675
STAT,1817,47,40-44,1864,0.004950668654561411
STAT,1870,35,50-100,1905,0.012312085762400445
STAT,1904,29,30-34,1933,0.3582501825220131
STAT,1893,48,50-100,1941,0.0017248563670243097
SIM,1853,12,na,1865,29
STAT,1826,30,20-24,1856,0.05075451459512118
STAT,1879,44,45-49,1923,0.015281284515483055
STAT,1950,9,na,1959,46.17680101334424
STAT,1884,38,40-44,1922,0.04267594132718077
STAT,1917,51,na,1968,37.539820884048005
SIM,1935,36,na,1971,57
STAT,1814,87,na,1901,0.7851000661198468
STAT,1878,31,50-100,1909,0.00949813733508905
STAT,1878,28,15-19,1906,0.004667616610355753
STAT,1920,17,20-24,1937,1.5081321200134608
STAT,1845,30,30-34,1875,0.12389695893399082
STAT,1840,17,na,1857,23.288117875689714
STAT,1851,37,40-44,1888,0.03735199019263066
STAT,1830,72,na,1902,4.537481640797636
SIM,1923,23,25-29,1946,1
STAT,1931,24,20-24,1955,1.42679445120876
STAT,1864,43,50-100,1907,0.009407109404887917
STAT,1866,22,15-19,1888,0.030631486367946777
STAT,1817,48,45-49,1865,0.006725503278789201
STAT,1916,35,35-39,1951,0.024790862671943456
STAT,1832,37,30-34,1869,0.03024523920437774
STAT,1883,27,35-39,1910,0.09369895554311436
STAT,1841,47,25-29,1888,5.663532635609063E-4
STAT,1889,35,15-19,1924,6.940475440314059E-4
STAT,1914,24,20-24,1938,1.11955331956221
STAT,1860,5,na,1865,23.576877390149356
SIM,1912,41,na,1953,37
STAT,1900,40,40-44,1940,0.0021877735248374084
STAT,1872,15,15-19,1887,0.06164431942868501
STAT,1947,17,35-39,1964,0.04694507436611497
STAT,1867,38,40-44,1905,0.041683196307203865
STAT,1828,43,50-100,1871,0.00460648589151021
STAT,1847,37,25-29,1884,0.03191139246074795
STAT,1840,49,na,1889,17.328252400329493
STAT,1951,0,na,1951,51.95433904440137
STAT,1915,36,30-34,1951,0.018340538527082235
SIM,1910,21,25-29,1931,4
SIM,1893,63,na,1956,28
STAT,1884,39,45-49,1923,0.019334651765207874
STAT,1873,5,na,1878,28.093676726946413
STAT,1897,32,45-49,1929,0.023157180912716412
STAT,1858,104,na,1962,0.0017781059640755762
STAT,1836,30,50-100,1866,0.011411646757553214
STAT,1831,25,20-24,1856,0.13382005596058738
STAT,1890,23,45-49,1913,0.00844421185336523
STAT,1855,32,50-100,1887,0.0065684574290405424
STAT,1867,39,45-49,1906,0.018884881270264567
SIM,1905,38,na,1943,40
STAT,1846,38,20-24,1884,0.006456415768842066
STAT,1834,97,na,1931,0.03796539258594024
STAT,1856,27,25-29,1883,0.3175478028369687
STAT,1783,103,na,1886,2.80317294296012E-4
STAT,1877,20,50-100,1897,0.004234577631437019
STAT,1868,37,45-49,1905,0.019291873960919918
STAT,1871,17,15-19,1888,0.05954961784958417
STAT,1888,18,30-34,1906,0.018577127042071057
STAT,1909,38,20-24,1947,0.0024688484392150593
STAT,1882,28,30-34,1910,0.2404796912236748
STAT,1919,20,40-44,1939,0.03671687918282276
SIM,1885,44,na,1929,22
STAT,1823,32,45-49,1855,0.026447031233986982
STAT,1902,21,25-29,1923,0.8097071909224496
STAT,1857,32,15-19,1889,0.001072657000118051
SIM,1889,37,na,1926,32
STAT,1878,44,50-100,1922,0.010759770771776506
STAT,1918,36,na,1954,39.484685129285374
SIM,1857,27,na,1884,23
SIM,1864,27,25-29,1891,1
STAT,1928,0,na,1928,56.48849180147731
STAT,1816,38,35-39,1854,0.10616073241040862
STAT,1849,30,na,1879,19.86762850678095
SIM,1939,22,25-29,1961,2
STAT,1856,31,45-49,1887,0.012920971041058806
STAT,1857,36,30-34,1893,0.040089677145155066
STAT,1872,29,25-29,1901,0.429722120588477
STAT,1909,30,25-29,1939,0.08840988776991192
STAT,1889,26,25-29,1915,0.5196870352928273
STAT,1933,15,40-44,1948,0.018734181415625224
STAT,1907,34,30-34,1941,0.14539073367774652
STAT,1833,23,15-19,1856,0.032597262390391644
SIM,1797,57,na,1854,2
STAT,1808,47,40-44,1855,0.001235918485924159
STAT,1923,29,40-44,1952,0.052763410920933944
SIM,1867,36,40-44,1903,1
STAT,1829,25,15-19,1854,0.011397418901567698
STAT,1917,47,45-49,1964,0.0022494845472460115
STAT,1917,20,30-34,1937,0.3044956560019678
STAT,1819,64,na,1883,9.421860968057379
STAT,1859,32,25-29,1891,0.08140994898163927
STAT,1864,27,25-29,1891,0.37941112357984386
STAT,1927,18,na,1945,45.412827412697226
STAT,1854,27,15-19,1881,0.0029072059546365403
SIM,1869,59,na,1928,13
STAT,1878,26,15-19,1904,0.004700179271864347
SIM,1930,37,na,1967,49
STAT,1846,36,20-24,1882,0.006591901029605945
STAT,1936,16,20-24,1952,1.293313106541773
STAT,1871,96,na,1967,0.3634585140889133
STAT,1875,33,20-24,1908,0.027668624210739245
SIM,1929,40,na,1969,48
SIM,1808,47,na,1855,15
SIM,1860,79,na,1939,7
STAT,1902,29,20-24,1931,0.16425296237634615
STAT,1924,37,35-39,1961,0.028335875514565862
STAT,1831,27,20-24,1858,0.12827354031816424
STAT,1832,32,50-100,1864,0.005354587162812138
STAT,1840,39,30-34,1879,0.04837913528959313
STAT,1871,20,30-34,1891,0.1786481206125576
STAT,1928,20,40-44,1948,0.04202473556638865
STAT,1903,38,50-100,1941,0.0037488701435734223
STAT,1932,36,30-34,1968,0.024411187290621354
STAT,1893,15,35-39,1908,0.006950693942481776
STAT,1840,50,na,1890,17.11449145844037
SIM,1944,16,20-24,1960,2
SIM,1859,82,na,1941,3
STAT,1876,39,45-49,1915,0.020042988360968454
STAT,1865,39,35-39,1904,0.0633298128109248
SIM,1932,5,na,1937,54
STAT,1953,19,25-29,1972,0.5208421777461657
STAT,1941,22,15-19,1963,0.054611945969068876
SIM,1863,12,na,1875,20
SIM,1814,54,na,1868,22
STAT,1937,5,na,1942,38.868632699136924
STAT,1863,67,na,1930,14.03548083742646
STAT,1841,18,40-44,1859,0.002295394023725348
STAT,1861,25,40-44,1886,0.025742718975703835
STAT,1880,15,na,1895,26.681482179224304
SIM,1846,64,na,1910,6
STAT,1833,49,40-44,1882,0.0013169121138666728
SIM,1937,26,30-34,1963,1
STAT,1850,27,na,1877,22.666348315053803
SIM,1883,6,na,1889,17
STAT,1910,19,na,1929,37.832469212539806
SIM,1873,39,35-39,1912,2
STAT,1883,29,35-39,1912,0.09302927156740329
STAT,1934,32,25-29,1966,0.12565860656699968
STAT,1851,39,40-44,1890,0.03658428386503718
STAT,1904,25,15-19,1929,0.006545166764637512
SIM,1890,45,na,1935,24
STAT,1928,32,50-100,1960,0.010287619694753577
SIM,1929,27,35-39,1956,1
STAT,1895,19,50-100,1914,6.326286781719894E-4
STAT,1849,37,35-39,1886,0.05611870611012811
SIM,1876,30,na,1906,30
STAT,1897,25,20-24,1922,0.15684536049857561
SIM,1861,53,na,1914,23
STAT,1925,20,15-19,1945,0.06369714468367756
STAT,1933,24,30-34,1957,0.37942713500030056
STAT,1875,18,45-49,1893,6.697183015681439E-4
STAT,1842,28,35-39,1870,0.08888306072610602
STAT,1926,17,15-19,1943,0.553241139184871
STAT,1898,20,45-49,1918,0.009463000815065388
STAT,1880,28,20-24,1908,0.12292820333910534
STAT,1848,24,50-100,1872,0.0031650911991226035
STAT,1904,23,na,1927,33.783845510792524
SIM,1924,41,na,1965,50
STAT,1900,16,40-44,1916,0.0025425129222356223
STAT,1809,48,45-49,1857,0.007927121802106639
STAT,1918,35,45-49,1953,0.007188059853652907
STAT,1836,23,40-44,1859,0.026350347457937743
STAT,1943,16,50-100,1959,0.003945105808365417
STAT,1867,38,50-100,1905,0.011690738949417233
STAT,1929,26,30-34,1955,0.4882562028023675
STAT,1913,36,20-24,1949,0.0025921150068310365
SIM,1841,87,na,1928,2
STAT,1894,7,na,1901,33.39003348538779
STAT,1864,26,20-24,1890,0.10558316557870029
STAT,1876,63,na,1939,18.12221027375439
STAT,1844,31,na,1875,20.45471940733806
STAT,1896,16,15-19,1912,0.07814391328171881
STAT,1801,69,na,1870,6.846121028258993
STAT,1826,33,25-29,1859,0.1354438334539261
STAT,1935,28,20-24,1963,0.24760301975998925
SIM,1786,72,na,1858,17
STAT,1903,17,20-24,1920,0.2520524129825316
STAT,1908,42,25-29,1950,6.572429628838078E-4
STAT,1875,25,50-100,1900,0.006620279291036693
SIM,1827,72,na,1899,4
STAT,1804,99,na,1903,0.007352592525143588
STAT,1887,39,20-24,1926,0.008329193352436235
STAT,1814,49,30-34,1863,0.0026884488261570065
STAT,1869,31,30-34,1900,0.16986578407650257
STAT,1893,24,25-29,1917,0.7172783816687498
STAT,1875,38,40-44,1913,0.04477500620985503
STAT,1865,38,30-34,1903,0.047966257893754104
SIM,1833,46,na,1879,11
STAT,1858,15,40-44,1873,0.0016451193626234048
STAT,1909,22,na,1931,35.26877169728086
STAT,1865,48,25-29,1913,5.144385139212187E-4
STAT,1939,21,20-24,1960,1.1094121945842255
STAT,1898,38,35-39,1936,0.020492077044884812
STAT,1928,21,45-49,1949,0.014021867665110717
STAT,1952,17,na,1969,43.84829239551795
SIM,1899,25,na,1924,26
STAT,1846,97,na,1943,0.04353816165525913
STAT,1810,84,na,1894,1.1957452654775016
STAT,1831,35,na,1866,22.318699027997138
STAT,1832,35,15-19,1867,3.2536321422738665E-4
STAT,1921,28,50-100,1949,0.010967944949936921
SIM,1878,74,na,1952,10
STAT,1844,26,50-100,1870,0.006160924203549704
STAT,1911,23,40-44,1934,0.03158504136625997
SIM,1844,20,na,1864,8
STAT,1859,23,35-39,1882,0.04777673747809066
STAT,1786,101,na,1887,6.025894099998297E-4
STAT,1837,31,35-39,1868,0.06263792934845003
STAT,1870,29,15-19,1899,0.004474816648093034
SIM,1884,81,na,1965,7
STAT,1874,26,30-34,1900,0.256344908864968
STAT,1824,38,35-39,1862,0.10079951466373151
STAT,1899,16,40-44,1915,0.0025099708985423055
STAT,1905,32,50-100,1937,0.007593011509728495
SIM,1902,31,na,1933,32
STAT,1893,11,na,1904,32.61086303272089
SIM,1929,29,na,1958,45
STAT,1917,39,50-100,1956,0.004295009910134268
STAT,1850,27,30-34,1877,0.26385129404198543
STAT,1874,17,40-44,1891,0.0018555358117096678
SIM,1914,22,20-24,1936,1
STAT,1829,64,na,1893,11.80783450644376
STAT,1863,45,na,1908,20.118630718599753
STAT,1900,25,30-34,1925,0.35156190709737467
STAT,1944,22,40-44,1966,0.036040424377057304
SIM,1887,1,na,1888,34
STAT,1837,25,15-19,1862,0.002917494833108768
STAT,1869,49,20-24,1918,1.1384528154955227E-4
SIM,1850,79,na,1929,2
SIM,1894,26,na,1920,31
SIM,1880,45,na,1925,31
STAT,1834,32,20-24,1866,0.024468383372016074
STAT,1825,49,40-44,1874,0.0015380163479807518
STAT,1905,37,25-29,1942,0.008969014969608686
STAT,1852,20,20-24,1872,0.7108091587314753
STAT,1843,90,na,1933,0.3344366230383925
SIM,1847,49,na,1896,15
SIM,1852,8,na,1860,29
STAT,1934,19,15-19,1953,0.6079759362289971
SIM,1860,90,na,1950,2
STAT,1926,34,40-44,1960,0.04698780402080231
SIM,1864,24,20-24,1888,1
STAT,1877,26,na,1903,24.719691367353704
STAT,1882,19,40-44,1901,0.0017434399610078944
STAT,1848,25,25-29,1873,0.33132347098186893
STAT,1891,29,35-39,1920,0.11758103135531288
SIM,1841,65,na,1906,11
STAT,1819,43,35-39,1862,0.01685311159441621
STAT,1881,41,50-100,1922,0.010098084224383247
STAT,1927,29,25-29,1956,0.7928919789603359
STAT,1831,28,25-29,1859,0.45657868787874434
SIM,1865,78,na,1943,3
STAT,1898,37,30-34,1935,0.071896050392062
STAT,1906,22,20-24,1928,1.0011716188911277
SIM,1871,31,na,1902,22
SIM,1879,59,na,1938,11
STAT,1819,37,15-19,1856,6.290131188330722E-4
STAT,1907,28,45-49,1935,0.016183807966411702
STAT,1865,34,15-19,1899,0.001277031534730063
SIM,1949,17,na,1966,36
STAT,1822,101,na,1923,0.002024090959347344
STAT,1880,17,15-19,1897,0.06240495232771117
SIM,1876,3,na,1879,34
SIM,1882,26,30-34,1908,1
STAT,1864,0,na,1864,34.30961446646004
STAT,1863,9,na,1872,24.614692679348217
STAT,1867,36,40-44,1903,0.04209259909557941
STAT,1914,15,30-34,1929,0.025120632940058417
STAT,1780,80,na,1860,4.530089198682613
STAT,1830,50,na,1880,8.353096449824536
STAT,1860,16,35-39,1876,0.005175278681878768
STAT,1815,83,na,1898,1.4171194626968902
STAT,1860,22,20-24,1882,0.5775271631574931
STAT,1853,26,45-49,1879,0.00814221641146988
STAT,1936,23,45-49,1959,0.010688617072394494
STAT,1909,21,35-39,1930,0.08728428362714064
SIM,1812,73,na,1885,10
STAT,1879,38,25-29,1917,0.029652170799852638
STAT,1838,36,20-24,1874,0.007294660319159192
STAT,1847,48,30-34,1895,0.001021060504807033
STAT,1848,27,40-44,1875,0.023126870582283767
STAT,1925,16,45-49,1941,0.0060113990661195
STAT,1841,13,na,1854,30.0
STAT,1862,29,15-19,1891,0.00388640819983634
STAT,1811,47,na,1858,17.0627923676178
SIM,1898,62,na,1960,20
STAT,1913,59,na,1972,33.4367407767934
STAT,1824,37,30-34,1861,0.07759984222200562
STAT,1906,49,35-39,1955,0.001123357749268298
STAT,1931,27,25-29,1958,0.8460043360352252
STAT,1877,24,40-44,1901,0.021375688629517667
STAT,1898,25,50-100,1923,0.008688000917273859
STAT,1863,21,35-39,1884,0.05307797260903747
STAT,1886,34,35-39,1920,0.10414529384415278
STAT,1906,16,35-39,1922,0.007991311995867464
STAT,1850,49,na,1899,19.613544055831966
STAT,1928,36,na,1964,47.35700600439818
STAT,1867,31,20-24,1898,0.025972915934498922
STAT,1856,18,35-39,1874,0.004672531535239312
STAT,1857,8,na,1865,21.606566891375632
STAT,1809,98,na,1907,0.01797456431404176
STAT,1845,33,35-39,1878,0.06965916983531446
STAT,1838,37,25-29,1875,0.026964826927554822
STAT,1824,87,na,1911,1.2258872090917907
STAT,1891,28,30-34,1919,0.3079855821344499
SIM,1859,60,na,1919,16
SIM,1880,67,na,1947,26
STAT,1846,53,50-100,1899,1.2043171353982746E-4
STAT,1899,21,15-19,1920,0.04529779565116537
SIM,1910,60,na,1970,27
STAT,1921,38,20-24,1959,0.0029175066459489504
SIM,1911,45,na,1956,40
STAT,1857,37,35-39,1894,0.052948458526988006
STAT,1865,26,na,1891,21.65987741100176
STAT,1930,15,15-19,1945,0.5867039669506257
STAT,1873,54,50-100,1927,1.4932605638850332E-4
STAT,1864,33,45-49,1897,0.015574736357265905
STAT,1946,22,50-100,1968,0.007270577990530347
SIM,1827,50,na,1877,14
STAT,1834,26,35-39,1860,0.09005942253947175
STAT,1915,32,15-19,1947,0.0012974667582463634
STAT,1856,24,20-24,1880,0.5715071587736211
SIM,1829,94,na,1923,2
STAT,1879,37,20-24,1916,0.007978363065743937
SIM,1895,44,na,1939,27
SIM,1869,20,40-44,1889,1
SIM,1879,37,na,1916,15
STAT,1908,29,15-19,1937,0.00659147075545044
STAT,1862,82,na,1944,4.025508182668207
SIM,1847,27,na,1874,20
STAT,1937,24,15-19,1961,0.05147522084839775
STAT,1782,103,na,1885,4.1091547917662474E-4
STAT,1821,39,20-24,1860,0.013382900986909972
STAT,1872,28,20-24,1900,0.11961019898865217
STAT,1829,42,na,1871,17.718026429568503
SIM,1904,27,30-34,1931,1
STAT,1844,21,25-29,1865,0.5623242169522206
STAT,1867,34,25-29,1901,0.09717849573206512
STAT,1909,20,30-34,1929,0.2672104277122199
STAT,1835,38,45-49,1873,0.01105992830776024
STAT,1960,5,na,1965,50.912392785753056
SIM,1907,19,na,1926,41
STAT,1903,24,45-49,1927,0.009851988467946023
SIM,1852,21,25-29,1873,1
STAT,1882,59,na,1941,18.625067789378537
STAT,1895,39,20-24,1934,0.009906864105289957
STAT,1925,22,30-34,1947,0.34187750629065466
STAT,1850,28,35-39,1878,0.1003737941554793
STAT,1872,26,20-24,1898,0.12044463479342707
STAT,1824,32,25-29,1856,0.16728850830911315
STAT,1833,91,na,1924,0.4290127403094023
STAT,1893,26,40-44,1919,0.03790000501545658
STAT,1939,23,20-24,1962,1.1086801033507885
STAT,1884,20,30-34,1904,0.1755574541393735
SIM,1783,76,na,1859,1
SIM,1855,27,25-29,1882,1
SIM,1821,67,na,1888,7
STAT,1919,25,45-49,1944,0.0186303926500801
STAT,1835,46,45-49,1881,0.0011409784370159494
STAT,1838,47,25-29,1885,4.599337978567751E-4
STAT,1829,86,na,1915,1.5070984437972808
STAT,1852,43,40-44,1895,0.01911132653652569
STAT,1855,44,20-24,1899,0.0011030616347004372
STAT,1870,48,50-100,1918,0.0024091066563348296
STAT,1878,49,20-24,1927,1.2130338003952183E-4
SIM,1902,19,na,1921,35
STAT,1868,50,40-44,1918,1.0334490394034818E-4
STAT,1931,8,na,1939,51.973131681402755
STAT,1936,22,40-44,1958,0.03195138100095988
STAT,1875,48,40-44,1923,0.0017377245755169908
STAT,1876,29,45-49,1905,0.0111961494656589
STAT,1916,30,15-19,1946,0.0013259492864179268
STAT,1881,54,50-100,1935,1.3975731283633034E-4
STAT,1841,31,15-19,1872,0.0017088785287892017
STAT,1827,33,50-100,1860,0.007859741741780064
STAT,1889,42,25-29,1931,0.007852452560771635
STAT,1885,77,na,1962,10.704714251064697
STAT,1898,35,30-34,1933,0.07257885589452778
STAT,1845,17,20-24,1862,0.13098170506937962
STAT,1891,23,25-29,1914,0.7004408419041827
STAT,1826,35,40-44,1861,0.05312348038798707
SIM,1813,48,na,1861,12
STAT,1858,33,35-39,1891,0.07673617163045564
STAT,1850,37,25-29,1887,0.026041311295990462
STAT,1893,39,45-49,1932,0.024882445682262534
STAT,1806,49,30-34,1855,0.0031704100868878106
SIM,1883,11,na,1894,15
SIM,1909,41,na,1950,36
STAT,1870,31,40-44,1901,0.043256500522115396
STAT,1842,16,40-44,1858,0.0017726327002488852
SIM,1947,23,20-24,1970,3
STAT,1849,35,35-39,1884,0.057296334348965326
STAT,1866,32,30-34,1898,0.16080077644824867
STAT,1884,28,40-44,1912,0.029245786885961852
STAT,1829,49,25-29,1878,4.791728985751305E-4
STAT,1873,34,15-19,1907,0.001435452414656678
STAT,1855,31,50-100,1886,0.006637017823153717
STAT,1912,45,30-34,1957,8.540297881958885E-4
STAT,1919,48,50-100,1967,0.0024251980396198763
STAT,1874,5,na,1879,27.936181999302967
STAT,1844,44,45-49,1888,0.011669812596746904
STAT,1911,35,na,1946,36.446618186299844
SIM,1928,24,na,1952,51
STAT,1867,44,50-100,1911,0.009973364231000688
STAT,1943,6,na,1949,41.82954403574316
STAT,1815,41,15-19,1856,2.1874919237391288E-4
STAT,1819,50,45-49,1869,1.3119758219325638E-4
STAT,1960,4,na,1964,50.923086633946184
SIM,1853,76,na,1929,5
STAT,1886,41,45-49,1927,0.015594387461191005
SIM,1880,78,na,1958,17
STAT,1847,27,25-29,1874,0.5431360120718186
STAT,1824,55,na,1879,15.748507512910903
SIM,1800,73,na,1873,8
STAT,1824,47,25-29,1871,7.453412035623276E-4
STAT,1798,85,na,1883,1.6267637690588945
STAT,1877,43,45-49,1920,0.01533763190896904
STAT,1895,8,na,1903,33.74874502058574
STAT,1817,37,40-44,1854,0.17494029083296392
STAT,1885,27,45-49,1912,0.010964407751242425
STAT,1910,45,50-100,1955,0.0021072411639735254
STAT,1883,66,na,1949,15.916123704354828
SIM,1823,46,na,1869,11
SIM,1870,68,na,1938,15
STAT,1832,31,20-24,1863,0.015961701730760617
STAT,1942,20,15-19,1962,0.05544488164588668
STAT,1835,28,45-49,1863,0.006586369459459364
STAT,1861,36,45-49,1897,0.016845024174589412
STAT,1833,30,25-29,1863,0.09968137390917829
STAT,1851,29,40-44,1880,0.02918678323718622
STAT,1849,40,30-34,1889,0.009070227115746265
STAT,1901,20,50-100,1921,0.005740130492287299
STAT,1878,50,50-100,1928,1.581641221610481E-4
SIM,1837,29,30-34,1866,1
STAT,1886,18,20-24,1904,0.18341028668183815
STAT,1835,47,50-100,1882,0.0011722621464961755
STAT,1880,53,45-49,1933,1.5015549013574296E-4
STAT,1886,19,na,1905,26.05677102842815
STAT,1873,17,25-29,1890,0.05761321005465151
SIM,1868,10,na,1878,38
STAT,1786,84,na,1870,0.46294988197631504
STAT,1849,48,40-44,1897,0.001310790198244846
STAT,1832,39,30-34,1871,0.029623599998621037
STAT,1852,25,40-44,1877,0.030294495983685825
STAT,1898,28,40-44,1926,0.04026793908403519
STAT,1807,63,na,1870,10.587335828221907
STAT,1865,29,40-44,1894,0.02690084688212984
SIM,1909,21,na,1930,37
STAT,1875,47,na,1922,23.019242459719145
STAT,1870,33,35-39,1903,0.10017658078310877
STAT,1882,25,25-29,1907,0.4081433552663822
STAT,1818,36,45-49,1854,0.029457950451860747
STAT,1882,30,20-24,1912,0.026112820165192393
STAT,1892,15,40-44,1907,0.002270096787627693
STAT,1855,39,25-29,1894,0.02006753408092437
STAT,1816,68,na,1884,5.2446793426787295
STAT,1867,49,45-49,1916,0.002211272696811035
STAT,1856,42,50-100,1898,0.007643867328520787
STAT,1858,99,na,1957,0.01990214536217104
STAT,1884,46,40-44,1930,0.0016820976019637876
STAT,1829,36,20-24,1865,0.007160688208736083
STAT,1884,36,50-100,1920,0.012086729088593108
STAT,1863,46,50-100,1909,0.002180710445877547
STAT,1796,74,na,1870,0.9062304944796835
SIM,1862,49,na,1911,23
STAT,1894,42,35-39,1936,0.0016095744384631106
STAT,1894,38,na,1932,30.044249988112924
STAT,1896,27,20-24,1923,0.1540968357209319
SIM,1910,38,na,1948,32
STAT,1925,39,50-100,1964,0.004996988289391941
STAT,1812,54,na,1866,10.836967296596544
STAT,1815,82,na,1897,1.6655534092154691
STAT,1890,24,na,1914,28.54846969229891
STAT,1849,28,45-49,1877,0.010132116815139829
SIM,1910,2,na,1912,34
STAT,1885,42,40-44,1927,0.022184585479842776
STAT,1918,37,50-100,1955,0.004385313432214468
STAT,1834,24,35-39,1858,0.05436358881970289
STAT,1843,27,40-44,1870,0.015638219932162307
SIM,1814,85,na,1899,7
STAT,1891,30,15-19,1921,0.0017619097827238888
STAT,1923,36,na,1959,43.32960809263526
STAT,1866,27,50-100,1893,0.005891448895124576
STAT,1956,15,20-24,1971,1.7848247726117235
STAT,1929,43,50-100,1972,0.001511737881168162
STAT,1801,90,na,1891,0.2857179190671138
STAT,1834,21,30-34,1855,0.16956630899110908
STAT,1840,32,50-100,1872,0.008744727068339632
STAT,1860,27,40-44,1887,0.024614052921261877
STAT,1874,30,15-19,1904,0.001456326429219307
STAT,1848,41,25-29,1889,0.004201196418777289
STAT,1852,82,na,1934,3.9932373828525494
STAT,1942,19,na,1961,38.15960377575711
SIM,1842,21,30-34,1863,2
SIM,1951,20,na,1971,46
STAT,1871,30,45-49,1901,0.017525663918658535
STAT,1864,19,25-29,1883,0.051961008957358466
STAT,1888,43,20-24,1931,0.0018424794597518834
STAT,1817,38,50-100,1855,0.04577903293396106
STAT,1820,73,na,1893,6.733664777878058
STAT,1930,38,na,1968,48.794013441376066
STAT,1821,90,na,1911,0.4896697712996375
STAT,1874,52,50-100,1926,1.524004481609396E-4
STAT,1885,47,50-100,1932,0.002414029323147463
SIM,1968,0,na,1968,54
STAT,1834,47,40-44,1881,0.001283069773318875
STAT,1915,17,na,1932,40.07423646850507
SIM,1829,31,na,1860,20
STAT,1881,29,25-29,1910,0.39963953387856577
SIM,1847,7,na,1854,25
STAT,1820,35,45-49,1855,0.019426200040337696
STAT,1856,44,na,1900,16.51738723780763
STAT,1859,47,45-49,1906,0.0018670229299168337
STAT,1903,37,50-100,1940,0.0037675572274214328
STAT,1813,71,na,1884,10.07415716041882
STAT,1818,51,40-44,1869,1.015685551906201E-4
SIM,1851,85,na,1936,3
STAT,1870,16,45-49,1886,6.589691192093E-4
STAT,1879,45,20-24,1924,1.2543943738433513E-4
STAT,1899,31,30-34,1930,0.23998869662705563
STAT,1825,39,40-44,1864,0.04390300779558622
STAT,1922,19,na,1941,42.05915994141216
STAT,1835,27,na,1862,12.667747891935186
STAT,1840,35,15-19,1875,5.313598266279701E-4
STAT,1915,2,na,1917,42.29649487064394
STAT,1900,63,na,1963,26.594616717736727
SIM,1875,12,na,1887,21
STAT,1860,41,25-29,1901,0.005244183235164536
STAT,1857,34,30-34,1891,0.12958580485245969
STAT,1894,40,40-44,1934,0.029117406875536083
SIM,1933,6,na,1939,55
SIM,1806,66,na,1872,6
STAT,1903,47,30-34,1950,7.726934751753454E-4
STAT,1848,37,40-44,1885,0.02917329064766255
SIM,1811,57,na,1868,8
STAT,1820,34,35-39,1854,0.09876899411069716
STAT,1928,30,35-39,1958,0.11383545656748485
STAT,1837,17,50-100,1854,4.7388666176242754E-4
STAT,1840,15,20-24,1855,0.18200020873269884
SIM,1791,63,na,1854,5
STAT,1882,32,15-19,1914,0.0013647550849846838
SIM,1947,15,na,1962,39
STAT,1839,39,40-44,1878,0.028275194200806007
STAT,1844,63,na,1907,13.937112238353508
STAT,1848,19,40-44,1867,0.0014490753457328312
STAT,1948,16,25-29,1964,0.49279462284707576
STAT,1843,46,na,1889,9.621670845802292
STAT,1855,29,25-29,1884,0.3059977956858684
SIM,1863,66,na,1929,5
STAT,1880,20,45-49,1900,0.007376457681333587
STAT,1850,22,25-29,1872,0.611762486859736
STAT,1834,37,40-44,1871,0.03847922639052943
STAT,1891,38,25-29,1929,0.0351629462213139
STAT,1887,36,na,1923,25.839444074760195
STAT,1937,20,35-39,1957,0.09117681460046849
SIM,1830,48,na,1878,18
SIM,1855,47,na,1902,14
STAT,1847,28,na,1875,27.57623564964315
STAT,1838,79,na,1917,5.426081920893414
STAT,1888,25,20-24,1913,0.13802359637901088
STAT,1838,29,25-29,1867,0.4116640195090229
STAT,1853,41,35-39,1894,0.01143211906102624
STAT,1839,46,30-34,1885,5.512954198282044E-4
STAT,1855,27,na,1882,17.514106088552133
STAT,1851,13,na,1864,24.392081431886126
SIM,1944,4,na,1948,36
SIM,1888,62,na,1950,26
STAT,1857,27,40-44,1884,0.023098132349299177
STAT,1928,23,45-49,1951,0.013936464688342509
SIM,1842,49,na,1891,23
STAT,1876,52,40-44,1928,1.0635441546773441E-4
STAT,1864,83,na,1947,3.5606672012051255
STAT,1864,63,na,1927,16.003833096601927
SIM,1842,29,na,1871,27
STAT,1843,45,40-44,1888,7.415945542071518E-4
SIM,1879,8,na,1887,17
SIM,1843,66,na,1909,17
STAT,1805,52,na,1857,9.488147759479055
SIM,1850,48,na,1898,20
STAT,1847,42,20-24,1889,0.0017059613286634215
STAT,1797,68,na,1865,6.29350039273244
STAT,1876,47,45-49,1923,0.002385749389776464
STAT,1840,33,20-24,1873,0.025531731531910958
STAT,1844,26,45-49,1870,0.01069341061488411
STAT,1949,4,na,1953,45.74732499197186
SIM,1863,29,25-29,1892,1
SIM,1875,3,na,1878,24
STAT,1948,23,15-19,1971,0.06069662156414514
SIM,1799,79,na,1878,6
STAT,1852,50,na,1902,18.692663080897958
STAT,1811,44,35-39,1855,0.07460031851920344
STAT,1823,33,20-24,1856,0.025034587431632446
STAT,1914,43,50-100,1957,0.0011526171064421549
STAT,1861,40,30-34,1901,0.009765754088778835
SIM,1924,42,na,1966,50
STAT,1929,21,na,1950,46.09795660711607
SIM,1916,23,na,1939,43
SIM,1792,69,na,1861,5
STAT,1845,36,50-100,1881,0.007619258809410912
STAT,1890,24,20-24,1914,0.8318417805465812
STAT,1892,59,na,1951,24.00970465879136
SIM,1919,51,na,1970,42
STAT,1948,12,na,1960,44.657192455380304
STAT,1885,44,35-39,1929,0.017640680075694377
STAT,1850,18,40-44,1868,0.0019782855609134847
STAT,1856,64,na,1920,12.59324805723095
SIM,1939,21,20-24,1960,1
STAT,1857,49,50-100,1906,0.001800193158851999
STAT,1840,28,25-29,1868,0.41032752354749485
SIM,1858,5,na,1863,27
STAT,1826,38,45-49,1864,0.022484024250147026
STAT,1829,39,25-29,1868,0.025840305533881273
STAT,1891,22,15-19,1913,0.040491026593830914
STAT,1818,46,45-49,1864,0.002356109787077082
STAT,1819,39,15-19,1858,5.523971440252622E-4
STAT,1885,50,40-44,1935,1.0545607683881807E-4
STAT,1860,19,40-44,1879,0.0016947897894357999
STAT,1876,26,40-44,1902,0.030528725717140593
SIM,1857,70,na,1927,10
SIM,1929,41,na,1970,48
STAT,1820,42,35-39,1862,0.016002614346313802
STAT,1936,25,45-49,1961,0.01644788483359584
STAT,1939,26,25-29,1965,0.6574471963780022
STAT,1868,53,45-49,1921,1.3818823892532475E-4
SIM,1835,26,45-49,1861,1
STAT,1835,43,40-44,1878,0.012051796696649856
SIM,1912,3,na,1915,40
STAT,1872,51,45-49,1923,1.4919714877635699E-4
STAT,1839,25,25-29,1864,0.298354754635338
STAT,1774,95,na,1869,0.010363133410399452
STAT,1858,48,40-44,1906,0.0012863683612668673
STAT,1917,26,50-100,1943,0.010379027034783269
STAT,1856,38,50-100,1894,0.008850062888039838
STAT,1862,17,20-24,1879,0.1751800346353225
SIM,1860,78,na,1938,7
STAT,1882,49,na,1931,21.111027528528027
STAT,1830,39,20-24,1869,0.004324484460188711
SIM,1918,34,na,1952,37
STAT,1850,25,30-34,1875,0.26768139931761614
STAT,1840,25,20-24,1865,0.11628290796229414
STAT,1891,19,40-44,1910,0.002232847059039373
STAT,1846,49,25-29,1895,4.5706002243919446E-4
STAT,1914,44,50-100,1958,0.001150600026505881
STAT,1878,39,20-24,1917,0.007878281671585042
STAT,1844,43,35-39,1887,0.014301590291859696
STAT,1898,36,40-44,1934,0.05933677394699145
SIM,1877,78,na,1955,5
STAT,1885,37,45-49,1922,0.019685976426683495
SIM,1831,33,na,1864,8
STAT,1882,22,20-24,1904,0.6604185990768293
STAT,1847,83,na,1930,4.240761986685806
STAT,1865,33,25-29,1898,0.09225210598383056
STAT,1847,44,15-19,1891,1.4553044404133267E-4
SIM,1835,47,na,1882,17
STAT,1849,34,50-100,1883,0.007332488509200556
STAT,1902,48,25-29,1950,4.524293870713819E-4
STAT,1873,35,25-29,1908,0.02955059057658585
STAT,1873,41,50-100,1914,0.01078946828401042
STAT,1886,40,35-39,1926,0.018972488181889874
STAT,1783,102,na,1885,4.473124520018701E-4
STAT,1823,41,20-24,1864,0.0011345658774973028
SIM,1904,22,na,1926,32
SIM,1871,85,na,1956,5
SIM,1895,12,na,1907,31
STAT,1894,17,45-49,1911,8.371679245944899E-4
SIM,1911,55,na,1966,38
STAT,1919,22,40-44,1941,0.03649910473764935
STAT,1893,29,45-49,1922,0.013899503203437937
STAT,1935,37,na,1972,52.374311525352304
STAT,1849,31,na,1880,19.662395904305885
STAT,1890,32,20-24,1922,0.03283413286553312
STAT,1875,25,35-39,1900,0.09985831047343367
STAT,1859,37,45-49,1896,0.01584456900056574
STAT,1894,35,45-49,1929,0.025790999825760635
STAT,1859,30,50-100,1889,0.0073885590038065664
SIM,1863,11,na,1874,20
SIM,1901,57,na,1958,31
STAT,1856,105,na,1961,6.674756834681812E-4
STAT,1880,15,15-19,1895,0.06269489483737488
STAT,1880,50,40-44,1930,1.1229468459019789E-4
STAT,1836,27,20-24,1863,0.14650073052440593
STAT,1852,28,45-49,1880,0.010988496041470288
SIM,1859,61,na,1920,14
STAT,1846,98,na,1944,0.026327090971318644
SIM,1888,47,30-34,1935,1
STAT,1842,84,na,1926,2.4959019035207475
STAT,1810,83,na,1893,1.426954742386364
STAT,1815,42,25-29,1857,0.009928256568470246
STAT,1885,19,45-49,1904,6.416100345959176E-4
SIM,1867,25,na,1892,13
SIM,1867,48,na,1915,11
STAT,1857,81,na,1938,4.048206544043367
STAT,1817,53,na,1870,20.86151463423979
STAT,1827,44,45-49,1871,0.011387402480814494
STAT,1910,47,20-24,1957,1.024773535173722E-4
STAT,1913,33,50-100,1946,0.008122764540693285
SIM,1878,64,na,1942,19
SIM,1829,29,25-29,1858,1
STAT,1807,47,25-29,1854,0.001223327988830656
SIM,1919,23,45-49,1942,1
STAT,1928,15,45-49,1943,0.0062926848582255885
STAT,1840,18,25-29,1858,0.057152450216836806
SIM,1930,38,na,1968,49
STAT,1791,75,na,1866,3.836340260833772
STAT,1831,49,50-100,1880,0.0022918435378090117
STAT,1877,40,40-44,1917,0.02345268058868676
STAT,1874,38,25-29,1912,0.02906433031556733
STAT,1821,35,na,1856,18.02940283319154
SIM,1832,24,25-29,1856,1
SIM,1947,15,20-24,1962,1
STAT,1842,24,40-44,1866,0.01943740185151072
STAT,1831,45,na,1876,20.08576512777659
STAT,1861,11,na,1872,23.179822035165635
SIM,1894,58,na,1952,26
STAT,1910,18,na,1928,37.93679539988949
STAT,1933,26,na,1959,49.560891519193206
STAT,1888,38,25-29,1926,0.03347935621003464
STAT,1824,31,15-19,1855,0.0024030735307898647
STAT,1918,21,35-39,1939,0.10093785628593648
STAT,1849,43,35-39,1892,0.013939464229008507
STAT,1849,105,na,1954,2.2734993208228923E-4
STAT,1839,43,25-29,1882,0.0036874456525349004
STAT,1832,34,25-29,1866,0.058628032532369624
SIM,1852,36,45-49,1888,2
STAT,1881,36,15-19,1917,5.369068306786206E-4
STAT,1947,25,20-24,1972,0.20528005461563342
STAT,1861,33,40-44,1894,0.0363159540263056
STAT,1856,40,20-24,1896,0.0011621034697623465
STAT,1834,29,40-44,1863,0.027361519532325268
STAT,1881,26,20-24,1907,0.11201293906188081
STAT,1916,20,15-19,1936,0.05563291020401526
STAT,1866,28,45-49,1894,0.010189692519642808
STAT,1844,36,45-49,1880,0.01827037438511228
SIM,1812,74,na,1886,8
SIM,1890,44,na,1934,24
STAT,1824,35,30-34,1859,0.08104281742254427
STAT,1852,46,45-49,1898,0.00202553637019059
STAT,1863,28,20-24,1891,0.10350436729590612
STAT,1865,57,na,1922,18.176858022282836
STAT,1896,48,25-29,1944,4.2142101297259555E-4
SIM,1865,77,na,1942,4
STAT,1845,17,na,1862,16.959156942328065
STAT,1851,65,na,1916,14.26718594564669
STAT,1855,36,20-24,1891,0.005453436310481057
STAT,1837,30,na,1867,13.411350042648776
STAT,1834,65,na,1899,11.942888451795096
STAT,1881,31,na,1912,22.79958048189667
SIM,1898,72,na,1970,16
STAT,1859,104,na,1963,0.0021640224338557684
STAT,1874,93,na,1967,1.0289360953185673
STAT,1916,34,na,1950,38.3817461393162
STAT,1866,36,25-29,1902,0.026644502043487023
STAT,1893,76,na,1969,16.075718136654938
STAT,1930,25,50-100,1955,0.012608077853388612
STAT,1829,28,20-24,1857,0.12389110606456123
STAT,1842,49,40-44,1891,0.0012576586485177886
STAT,1871,19,15-19,1890,0.05885018925261346
STAT,1892,44,25-29,1936,5.434655091808703E-4
STAT,1845,40,45-49,1885,0.009140079342097282
STAT,1857,17,40-44,1874,0.0016093136291882157
STAT,1910,46,50-100,1956,0.002102584161001144
STAT,1864,42,20-24,1906,0.0014226767167507413
STAT,1875,22,30-34,1897,0.18309996920295865
STAT,1829,29,30-34,1858,0.2525556493563751
STAT,1857,38,na,1895,17.549554731919937
STAT,1955,14,na,1969,51.83356232411483
STAT,1870,48,na,1918,22.068837110219885
STAT,1898,43,30-34,1941,0.0010691993093152686
SIM,1872,79,na,1951,8
STAT,1844,18,45-49,1862,6.447707181684258E-4
STAT,1891,15,25-29,1906,0.06987451928330962
SIM,1917,40,na,1957,34
STAT,1912,20,na,1932,36.50286485990507
STAT,1911,49,30-34,1960,8.335894907575212E-4
STAT,1808,49,na,1857,4.804738763845232
STAT,1926,20,30-34,1946,0.3492474877538831
STAT,1870,26,45-49,1896,0.01106747521324053
STAT,1854,25,15-19,1879,0.003241107056214155
SIM,1874,36,25-29,1910,1
STAT,1863,38,20-24,1901,0.006791225259358958
STAT,1881,16,20-24,1897,0.16910899404836943
STAT,1853,42,45-49,1895,0.009394521910359442
SIM,1836,64,na,1900,1
STAT,1835,25,40-44,1860,0.018472581454716603
STAT,1883,24,30-34,1907,0.17188894632348983
STAT,1863,46,na,1909,19.97659318572644
STAT,1832,26,25-29,1858,0.2548997137539845
STAT,1876,44,40-44,1920,0.022536314283090487
STAT,1815,39,30-34,1854,0.08532079384344135
STAT,1855,26,20-24,1881,0.08671685780368106
STAT,1888,46,25-29,1934,6.750235522049071E-4
STAT,1852,38,45-49,1890,0.016976596653887913
STAT,1850,48,na,1898,19.78009243412732
STAT,1868,45,45-49,1913,0.002306648207832622
STAT,1860,37,40-44,1897,0.03558790319120094
STAT,1896,19,20-24,1915,0.23162180425930998
STAT,1849,25,40-44,1874,0.027933519837844794
STAT,1880,38,50-100,1918,0.012846331604812562
SIM,1962,2,na,1964,48
STAT,1893,46,35-39,1939,9.98562849732786E-4
STAT,1965,1,na,1966,48.84374381118371
STAT,1831,50,45-49,1881,1.2718002739220343E-4
STAT,1861,43,35-39,1904,0.015118133782438113
STAT,1839,18,35-39,1857,0.003937844073320964
STAT,1850,21,15-19,1871,0.03551040326156167
SIM,1907,18,na,1925,39
STAT,1840,36,25-29,1876,0.026962830881355763
STAT,1900,43,45-49,1943,0.0014307645941475243
SIM,1897,6,na,1903,43
STAT,1809,53,40-44,1862,3.374737172818198E-4
STAT,1921,25,na,1946,41.70638869228699
STAT,1888,28,25-29,1916,0.4925935178151273
SIM,1848,65,na,1913,20
STAT,1862,29,na,1891,20.442917271449573
STAT,1804,102,na,1906,0.0011381983018735305
STAT,1832,33,15-19,1865,8.236409121425045E-4
STAT,1887,19,50-100,1906,5.318823923280648E-4
STAT,1860,22,35-39,1882,0.048904749472652324
STAT,1881,19,25-29,1900,0.05363221329524862
SIM,1859,81,na,1940,3
STAT,1829,46,20-24,1875,1.0376731183254183E-4
STAT,1822,37,20-24,1859,0.004733810239031601
SIM,1805,72,na,1877,5
STAT,1845,29,15-19,1874,0.003181905594653531
STAT,1857,35,40-44,1892,0.033081561716200976
STAT,1865,15,25-29,1880,0.05873066742385115
STAT,1813,44,50-100,1857,0.033783413193504155
SIM,1899,26,na,1925,27
STAT,1894,43,45-49,1937,0.0013223336810760308
STAT,1904,48,50-100,1952,0.0019601673413387815
STAT,1903,39,30-34,1942,0.01619019778208075
STAT,1873,27,25-29,1900,0.4300754251244307
STAT,1897,41,20-24,1938,1.471135972485912E-4
STAT,1842,23,30-34,1865,0.1673514232511623
SIM,1801,67,na,1868,5
STAT,1826,48,45-49,1874,0.0023444411410488424
SIM,1789,69,na,1858,9
STAT,1837,38,20-24,1875,0.004525072189186979
STAT,1839,96,na,1935,0.04738599957146588
STAT,1835,82,na,1917,2.098654422296193
STAT,1811,68,na,1879,10.017652247147165
STAT,1865,36,30-34,1901,0.048437371471151486
STAT,1847,45,25-29,1892,6.214388315299707E-4
STAT,1884,37,50-100,1921,0.012028833656258743
STAT,1896,37,20-24,1933,0.010125377618799896
STAT,1886,15,45-49,1901,6.807164194434474E-4
STAT,1819,42,45-49,1861,0.014187319867877302
STAT,1893,12,na,1905,32.56227284680214
STAT,1857,42,30-34,1899,0.008595912762257615
STAT,1849,32,30-34,1881,0.14265792735191032
SIM,1887,25,na,1912,25
STAT,1827,52,45-49,1879,1.0575626235743494E-4
STAT,1921,38,35-39,1959,0.02676957278053318
STAT,1938,22,15-19,1960,0.05233634447340518
STAT,1880,14,na,1894,27.068538843171716
SIM,1857,32,30-34,1889,2
STAT,1852,45,35-39,1897,0.0012101329121820918
STAT,1898,18,40-44,1916,0.002460899345315481
STAT,1874,31,25-29,1905,0.1043349842579055
STAT,1850,28,na,1878,22.5036039341517
STAT,1883,17,40-44,1900,0.0017761376956117697
STAT,1886,33,45-49,1919,0.018011748449934896
STAT,1855,19,30-34,1874,0.013190625278855592
STAT,1896,61,na,1957,25.008208120018853
STAT,1876,22,50-100,1898,0.004141705961473899
SIM,1874,2,na,1876,35
STAT,1848,14,na,1862,18.964628813737644
STAT,1885,34,40-44,1919,0.04245906093785299
STAT,1949,23,30-34,1972,0.3331208102778916
STAT,1862,31,35-39,1893,0.08772980397139356
STAT,1883,28,25-29,1911,0.4093353068564595
SIM,1839,84,na,1923,3
STAT,1841,28,40-44,1869,0.03615664364661056
STAT,1781,85,na,1866,1.2516953423837405
STAT,1888,42,na,1930,26.97584974667431
STAT,1919,49,35-39,1968,0.0013781701380399369
SIM,1891,61,na,1952,28
STAT,1860,47,35-39,1907,0.0011328556251947416
STAT,1858,105,na,1963,9.682498216777144E-4
SIM,1943,21,35-39,1964,1
STAT,1848,47,35-39,1895,9.01158739699911E-4
STAT,1868,27,45-49,1895,0.010744906313429824
SIM,1847,28,na,1875,20
SIM,1843,14,na,1857,23
SIM,1851,33,na,1884,20
STAT,1844,40,30-34,1884,0.00943572449239463
STAT,1947,20,15-19,1967,0.059792053538950674
STAT,1874,34,30-34,1908,0.1756108393726264
STAT,1924,22,15-19,1946,0.06240430896282942
SIM,1942,16,na,1958,40
STAT,1911,43,20-24,1954,1.6646681444332348E-4
STAT,1905,62,na,1967,28.955243439283777
STAT,1848,33,25-29,1881,0.06956802494304079
SIM,1798,74,na,1872,4
STAT,1888,35,20-24,1923,0.009093676185376228
STAT,1840,41,20-24,1881,0.001314875927492967
SIM,1891,0,na,1891,40
STAT,1818,48,50-100,1866,0.002381125869933435
STAT,1829,54,50-100,1883,1.0899265049377317E-4
SIM,1931,5,na,1936,63
SIM,1828,45,na,1873,16
SIM,1824,31,na,1855,18
STAT,1935,21,35-39,1956,0.1276949783684589
STAT,1852,17,40-44,1869,0.0018932587751926966
STAT,1836,34,45-49,1870,0.020835324215447985
STAT,1865,41,25-29,1906,0.00583450994968226
STAT,1892,26,25-29,1918,0.5243883953668352
STAT,1856,32,20-24,1888,0.019821606147568265
SIM,1891,28,25-29,1919,1
STAT,1857,38,45-49,1895,0.01484938161231591
STAT,1870,79,na,1949,6.94483174591003
STAT,1928,35,na,1963,47.39587061830522
STAT,1802,52,40-44,1854,1.6118365105983706E-4
STAT,1895,26,15-19,1921,0.005910430631695412
SIM,1923,1,na,1924,42
STAT,1845,32,45-49,1877,0.012120106842768565
STAT,1947,18,na,1965,41.16592655994295
STAT,1830,29,20-24,1859,0.0878991973240451
STAT,1828,35,15-19,1863,2.5362651014685327E-4
SIM,1807,52,na,1859,15
STAT,1928,1,na,1929,52.362572360297406
STAT,1883,20,15-19,1903,0.03222735709936344
STAT,1825,35,25-29,1860,0.031208186517560094
STAT,1853,27,20-24,1880,0.08541287477756335
SIM,1815,71,na,1886,5
STAT,1877,35,45-49,1912,0.020773418579545264
SIM,1954,9,na,1963,50
STAT,1843,15,50-100,1858,2.687365704683281E-4
STAT,1836,41,35-39,1877,0.021057842304831615
STAT,1951,16,50-100,1967,0.004435641173689805
STAT,1850,26,40-44,1876,0.0316139534127317
STAT,1848,48,25-29,1896,3.6781859531737055E-4
STAT,1869,36,15-19,1905,5.467236035029923E-4
STAT,1843,69,na,1912,6.225224812155322
SIM,1834,62,na,1896,11
STAT,1841,29,30-34,1870,0.30176476474881986
STAT,1859,44,40-44,1903,0.017636309875063847
STAT,1825,34,35-39,1859,0.11143510986831902
SIM,1847,80,na,1927,5
STAT,1869,40,35-39,1909,0.017722767100873747
SIM,1946,5,na,1951,53
STAT,1909,31,35-39,1940,0.08706995178180264
STAT,1871,22,45-49,1893,0.006952298566474641
SIM,1847,29,40-44,1876,1
SIM,1927,39,na,1966,46
SIM,1927,38,na,1965,50
STAT,1860,58,na,1918,16.077327812979725
SIM,1923,25,na,1948,37
STAT,1851,88,na,1939,1.1589905059675636
STAT,1924,15,25-29,1939,0.5150757314588363
STAT,1851,25,25-29,1876,0.4242096371015551
STAT,1844,33,40-44,1877,0.040089056990794944
STAT,1839,47,40-44,1886,9.626063604860301E-4
STAT,1851,43,25-29,1894,0.005382126003947008
SIM,1877,58,na,1935,23
STAT,1889,16,25-29,1905,0.06954995016517086
STAT,1857,50,na,1907,16.350420116456853
SIM,1870,6,na,1876,27
STAT,1862,35,50-100,1897,0.01069312886472628
SIM,1838,44,na,1882,8
STAT,1862,40,45-49,1902,0.013042773712826512
STAT,1892,25,35-39,1917,0.12001231593768234
STAT,1872,39,25-29,1911,0.029162595023766932
STAT,1912,37,30-34,1949,0.017649423035801946
STAT,1882,29,40-44,1911,0.028502620298858486
STAT,1892,19,35-39,1911,0.0067424414134576015
STAT,1888,17,20-24,1905,0.20717526920068793
STAT,1841,99,na,1940,0.01853745164120457
SIM,1853,8,na,1861,29
STAT,1895,24,na,1919,30.512152581914705
STAT,1860,40,15-19,1900,1.1340299210826125E-4
STAT,1915,17,25-29,1932,0.08991497647954204
SIM,1917,49,na,1966,34
STAT,1841,21,20-24,1862,0.8606693910770256
STAT,1852,2,na,1854,31.0
SIM,1913,35,na,1948,41
STAT,1827,37,20-24,1864,0.0063086446207853706
STAT,1831,38,25-29,1869,0.029133121297641992
STAT,1850,18,50-100,1868,5.298977892439055E-4
STAT,1892,18,45-49,1910,8.048848815485109E-4
STAT,1950,19,50-100,1969,0.004399591876426971
STAT,1852,35,40-44,1887,0.03845851435035643
SIM,1921,13,na,1934,42
STAT,1932,17,25-29,1949,0.571499687842013
STAT,1826,77,na,1903,6.040518312147615
STAT,1834,96,na,1930,0.06068151935737272
STAT,1814,97,na,1911,0.023939885399370676
STAT,1858,8,na,1866,21.82787087920117
SIM,1903,37,30-34,1940,1
STAT,1889,34,25-29,1923,0.12432979749682296
STAT,1853,16,45-49,1869,4.967785308504494E-4
STAT,1839,29,40-44,1868,0.02052762311300533
STAT,1872,43,45-49,1915,0.015202557397995291
STAT,1841,35,30-34,1876,0.06275239502128083
STAT,1893,18,40-44,1911,0.00230014105113512
SIM,1890,13,na,1903,31
STAT,1877,28,20-24,1905,0.12067293394257493
STAT,1803,51,45-49,1854,2.888501412982392E-4
STAT,1856,39,40-44,1895,0.03139292211378668
STAT,1891,10,na,1901,31.79272360652362
STAT,1898,31,15-19,1929,0.0019289315034100004
STAT,1844,32,na,1876,20.243422155860255
STAT,1821,49,20-24,1870,1.6459175137699817E-4
SIM,1894,27,na,1921,30
STAT,1810,46,40-44,1856,0.0016915468019141173
SIM,1880,14,na,1894,32
STAT,1811,50,40-44,1861,4.1583246287519774E-4
STAT,1870,23,40-44,1893,0.020636355094947125
STAT,1899,37,na,1936,32.50625382445428
SIM,1919,16,20-24,1935,2
SIM,1923,17,25-29,1940,2
STAT,1873,40,20-24,1913,0.0016309326826289116
STAT,1889,48,35-39,1937,9.547262397259161E-4
STAT,1861,15,40-44,1876,0.0017889178153103764
STAT,1862,24,45-49,1886,0.006070639511893257
STAT,1902,11,na,1913,36.472542971097276
STAT,1842,27,25-29,1869,0.39248616584706386
STAT,1917,15,35-39,1932,0.008989258578887332
STAT,1851,18,35-39,1869,0.0055989434703251776
STAT,1893,7,na,1900,32.85034621542488
STAT,1894,28,20-24,1922,0.14982009852492473
STAT,1861,98,na,1959,0.04984982018992212
SIM,1826,66,na,1892,11
STAT,1895,23,na,1918,30.609490762539583
STAT,1898,46,35-39,1944,0.0010683530307635115
STAT,1884,83,na,1967,6.900198110829858
SIM,1862,80,na,1942,8
STAT,1883,46,25-29,1929,5.609309966211004E-4
STAT,1889,49,25-29,1938,3.8949425906785554E-4
STAT,1851,24,35-39,1875,0.05799013760919389
STAT,1939,33,15-19,1972,0.001301350504013666
STAT,1833,29,45-49,1862,0.010679177944450446
STAT,1842,27,45-49,1869,0.010301748887322302
STAT,1904,35,30-34,1939,0.01663969361323485
STAT,1874,15,50-100,1889,5.011911014793348E-4
SIM,1881,24,20-24,1905,2
STAT,1876,64,na,1940,17.655563359205214
STAT,1872,50,na,1922,22.34715882615063
STAT,1805,101,na,1906,0.0015623783277773416
STAT,1897,33,20-24,1930,0.0357439358183281
STAT,1906,24,na,1930,34.144702167051484
SIM,1849,39,na,1888,7
STAT,1930,25,30-34,1955,0.4963250432414456
STAT,1909,21,na,1930,35.37525120340309
STAT,1847,49,40-44,1896,0.0017906373481391116
STAT,1902,10,na,1912,36.52843147124829
STAT,1877,51,45-49,1928,1.5052276336751148E-4
STAT,1833,22,25-29,1855,0.5697276959276765
STAT,1879,61,na,1940,19.340565025210303
STAT,1919,7,na,1926,43.790714539502744
STAT,1870,42,45-49,1912,0.014849148383544859
SIM,1916,54,na,1970,44
STAT,1832,42,25-29,1874,0.00353194656007041
STAT,1897,47,30-34,1944,7.217264717403213E-4
SIM,1912,40,na,1952,37
STAT,1936,5,na,1941,38.261926824987924
STAT,1832,23,20-24,1855,0.4174681035424712
STAT,1802,54,35-39,1856,1.2665953297348058E-4
SIM,1874,32,30-34,1906,1
STAT,1889,41,15-19,1930,1.69843160129442E-4
STAT,1910,39,20-24,1949,0.0024805321757024653
SIM,1873,32,na,1905,27
STAT,1851,17,45-49,1868,6.704899516454587E-4
STAT,1852,42,30-34,1894,0.009827301071973455
STAT,1883,26,50-100,1909,0.006233251931516898
STAT,1868,38,20-24,1906,0.007422853024844547
STAT,1922,10,na,1932,45.65784281973822
STAT,1833,36,35-39,1869,0.06615199814937968
STAT,1926,24,na,1950,43.83525558716062
SIM,1848,31,25-29,1879,1
STAT,1949,16,40-44,1965,0.016168050646529167
STAT,1859,61,na,1920,14.85223110307929
STAT,1867,28,na,1895,22.757696160250173
STAT,1942,6,na,1948,41.27963575111586
SIM,1846,63,na,1909,8
STAT,1833,37,25-29,1870,0.026650535761939084
SIM,1862,81,na,1943,8
SIM,1908,35,na,1943,39
SIM,1858,44,na,1902,24
SIM,1904,21,na,1925,32
STAT,1842,45,25-29,1887,4.434512890559582E-4
STAT,1867,80,na,1947,5.919722542371904
STAT,1831,42,45-49,1873,0.014824386793296014
STAT,1897,15,20-24,1912,0.23652081769123934
SIM,1893,32,na,1925,35
STAT,1790,89,na,1879,0.230758122725782
STAT,1853,34,45-49,1887,0.011054146073136553
SIM,1940,17,25-29,1957,1
STAT,1865,19,40-44,1884,0.0016847391261042984
STAT,1898,39,45-49,1937,0.005746015891263278
STAT,1892,48,40-44,1940,0.0011780555570890796
STAT,1907,10,na,1917,37.89003394325389
STAT,1848,44,30-34,1892,0.007334544496849027
STAT,1858,30,30-34,1888,0.1356467794136086
STAT,1879,27,20-24,1906,0.12142169398020063
STAT,1850,19,30-34,1869,0.017137805173454472
STAT,1866,21,25-29,1887,0.5353703001879805
SIM,1939,20,30-34,1959,1
STAT,1860,44,30-34,1904,0.009220328922586353
STAT,1855,47,na,1902,15.76660083312722
SIM,1831,34,na,1865,10
STAT,1890,79,na,1969,12.769197380362044
STAT,1920,39,na,1959,40.75427514196549
STAT,1878,75,na,1953,10.628347180397718
STAT,1885,3,na,1888,29.07762911847111
STAT,1889,38,40-44,1927,0.053329322674264865
STAT,1828,32,45-49,1860,0.023871463464581733
STAT,1856,35,25-29,1891,0.021055954183972023
STAT,1820,40,40-44,1860,0.02053989211989896
SIM,1903,36,na,1939,37
STAT,1812,85,na,1897,1.0894534115094139
STAT,1897,18,25-29,1915,0.0750544669744243
STAT,1887,18,15-19,1905,0.06460636767263112
SIM,1886,39,na,1925,27
SIM,1882,25,na,1907,31
STAT,1840,18,na,1858,23.1509508614019
SIM,1919,20,na,1939,43
STAT,1834,43,25-29,1877,0.005401143848442702
STAT,1883,25,20-24,1908,0.11469483282652217
STAT,1892,22,30-34,1914,0.2200543074280374
STAT,1860,33,25-29,1893,0.08291818023814877
STAT,1895,23,45-49,1918,0.00902503998571227
STAT,1855,58,na,1913,13.92366696774019
STAT,1936,23,na,1959,34.690384418940525
STAT,1861,29,20-24,1890,0.09795117236259815
STAT,1919,46,30-34,1965,9.609075650414813E-4
STAT,1911,46,25-29,1957,5.001851666782344E-4
STAT,1884,23,35-39,1907,0.056996564435925254
STAT,1836,31,40-44,1867,0.05345494387847891
SIM,1892,23,35-39,1915,1
SIM,1903,9,na,1912,39
STAT,1899,39,40-44,1938,0.012804130044021544
STAT,1870,30,30-34,1900,0.17483699738325698
STAT,1866,10,na,1876,25.109458038600913
STAT,1864,37,25-29,1901,0.02582417833019606
STAT,1933,30,15-19,1963,0.0017266609301242713
SIM,1903,25,na,1928,36
STAT,1819,96,na,1915,0.044077851256444936
STAT,1893,36,40-44,1929,0.05546059811719083
STAT,1874,37,35-39,1911,0.07175418060641514
STAT,1836,44,na,1880,23.52745192054135
STAT,1832,30,na,1862,12.923354729952289
STAT,1806,78,na,1884,4.385963082312809
STAT,1825,31,30-34,1856,0.22094445593682396
STAT,1925,32,30-34,1957,0.18592081984973727
SIM,1877,79,na,1956,5
STAT,1872,18,20-24,1890,0.18091780117528986
STAT,1872,36,20-24,1908,0.007925057157951467
STAT,1850,59,na,1909,17.303922660144615
STAT,1882,36,30-34,1918,0.051321507213741825
STAT,1884,49,45-49,1933,0.0022639373231365034
SIM,1860,14,na,1874,28
STAT,1839,39,50-100,1878,0.007930243921543293
STAT,1883,43,20-24,1926,0.0015310633773246553
STAT,1895,43,50-100,1938,9.455482926299025E-4
STAT,1846,43,na,1889,18.716363564452006
STAT,1886,36,15-19,1922,5.852758233057965E-4
STAT,1893,43,30-34,1936,9.993538451228646E-4
STAT,1850,29,45-49,1879,0.011467092970224833
STAT,1802,64,na,1866,7.352204023828971
STAT,1826,45,40-44,1871,0.0017704339217085073
STAT,1880,6,na,1886,28.113266088504965
SIM,1917,0,na,1917,47
SIM,1896,38,na,1934,30
STAT,1899,36,50-100,1935,0.01688787647073187
STAT,1917,20,na,1937,38.688528029619214
SIM,1939,19,na,1958,27
STAT,1866,29,35-39,1895,0.08822971729410263
STAT,1849,62,na,1911,14.172068232575
STAT,1867,46,40-44,1913,0.0016429679667282766
STAT,1877,32,40-44,1909,0.04476623558243142
STAT,1836,50,45-49,1886,1.4743774385229274E-4
SIM,1886,83,na,1969,2
STAT,1856,17,25-29,1873,0.04854091999391345
STAT,1864,44,15-19,1908,1.2219159681719325E-4
SIM,1866,30,30-34,1896,2
SIM,1920,28,na,1948,47
STAT,1846,17,15-19,1863,0.06041736969316113
STAT,1858,38,40-44,1896,0.03314515555305955
STAT,1873,76,na,1949,9.63218306128583
SIM,1852,59,na,1911,19
SIM,1842,25,25-29,1867,1
STAT,1851,47,40-44,1898,0.0014385851479510124
STAT,1907,40,50-100,1947,0.0010839345558304166
STAT,1865,16,50-100,1881,4.5933809075472773E-4
SIM,1806,67,na,1873,6
STAT,1906,57,na,1963,30.78455633001961
STAT,1844,15,40-44,1859,0.0018376386456233989
STAT,1853,24,50-100,1877,0.0029848296079141453
STAT,1873,43,25-29,1916,0.0064816008574429766
SIM,1802,53,na,1855,11
STAT,1861,41,40-44,1902,0.0190009971012867
SIM,1849,51,na,1900,7
SIM,1873,65,na,1938,16
STAT,1806,52,25-29,1858,1.1472984682131956E-4
STAT,1823,70,na,1893,8.068912701719547
STAT,1838,44,20-24,1882,0.0012785989381138554
STAT,1834,25,25-29,1859,0.39768069598593425
STAT,1850,30,25-29,1880,0.10703591493297411
STAT,1931,24,na,1955,46.858042254324246
STAT,1854,22,45-49,1876,0.005008021748564476
STAT,1802,102,na,1904,8.953715522448317E-4
STAT,1824,40,25-29,1864,0.008998973128293347
STAT,1828,44,50-100,1872,0.004555473636885608
STAT,1851,21,30-34,1872,0.18087793329629642
STAT,1846,28,20-24,1874,0.11419139800522517
STAT,1860,26,50-100,1886,0.005294259294689339
SIM,1887,24,na,1911,23
STAT,1848,23,50-100,1871,0.003187980901998957
STAT,1881,42,20-24,1923,0.0015093144774047718
STAT,1808,50,50-100,1858,1.091727922760443E-4
STAT,1899,34,35-39,1933,0.13744589323838244
STAT,1891,31,25-29,1922,0.12622776443251932
STAT,1846,53,45-49,1899,1.1572428518761206E-4
STAT,1883,18,30-34,1901,0.015437218971142674
SIM,1909,10,na,1919,41
STAT,1854,19,15-19,1873,0.042882763879686016
STAT,1900,40,na,1940,32.4847385061271
STAT,1885,41,30-34,1926,0.01140451433731756
SIM,1857,58,na,1915,20
STAT,1866,25,40-44,1891,0.027775760992405536
STAT,1831,35,20-24,1866,0.008050841901918392
STAT,1877,42,35-39,1919,0.018669312156629012
SIM,1834,85,na,1919,3
STAT,1875,24,na,1899,24.159138729258494
STAT,1883,40,30-34,1923,0.011276866064130878
STAT,1871,65,na,1936,16.84893229841608
STAT,1904,38,35-39,1942,0.021766410289354245
STAT,1943,20,30-34,1963,0.30376846610404495
STAT,1879,48,25-29,1927,5.886749112108142E-4
STAT,1894,46,50-100,1940,0.001780543686150045
STAT,1930,7,na,1937,51.43743257069745
STAT,1838,26,20-24,1864,0.11666165817515516
STAT,1889,45,30-34,1934,0.0011969685554205777
SIM,1839,29,na,1868,23
STAT,1907,15,25-29,1922,0.08327527833664103
STAT,1861,18,45-49,1879,6.276760816219504E-4
STAT,1811,53,45-49,1864,5.398689839620632E-4
STAT,1893,32,25-29,1925,0.12914667894778306
STAT,1902,27,50-100,1929,0.009020856658585093
STAT,1941,31,50-100,1972,0.00862272682501165
STAT,1810,49,45-49,1859,0.002242244699567453
STAT,1869,33,45-49,1902,0.01682531146138378
STAT,1898,36,20-24,1934,0.01044880794759335
SIM,1922,39,na,1961,48
STAT,1939,28,50-100,1967,0.009932832637260837
STAT,1871,10,na,1881,26.653420286291414
STAT,1871,25,15-19,1896,0.004554104278937481
STAT,1874,27,40-44,1901,0.030389738395418142
SIM,1867,80,na,1947,4
SIM,1879,28,25-29,1907,1
STAT,1841,24,25-29,1865,0.6996682112159939
SIM,1836,33,na,1869,9
STAT,1815,45,30-34,1860,0.0014355405623540328
SIM,1824,52,na,1876,16
STAT,1930,28,35-39,1958,0.1899198481310487
STAT,1945,15,45-49,1960,0.005420568914747879
STAT,1854,21,50-100,1875,0.002949847707348377
STAT,1848,15,25-29,1863,0.045968955056811006
STAT,1939,22,30-34,1961,0.2866627198573754
STAT,1838,19,30-34,1857,0.016148470104505014
SIM,1852,70,na,1922,19
SIM,1859,6,na,1865,26
STAT,1926,9,na,1935,48.52848088833588
STAT,1885,16,40-44,1901,0.0018106308316399673
STAT,1807,53,50-100,1860,3.033783813103033E-4
STAT,1828,29,15-19,1857,0.006583342523150572
STAT,1843,22,35-39,1865,0.03107099944722644
STAT,1866,35,35-39,1901,0.06575894733092812
STAT,1819,45,50-100,1864,0.0022726564178105163
STAT,1877,33,50-100,1910,0.009418133077484379
STAT,1920,39,30-34,1959,0.019743121763225936
SIM,1936,20,na,1956,35
STAT,1929,32,15-19,1961,0.0016244897930123613
STAT,1833,26,40-44,1859,0.029441728160638492
STAT,1850,70,na,1920,12.492480268072082
STAT,1864,34,20-24,1898,0.024036781947386555
STAT,1879,2,na,1881,33.429885095335884
STAT,1791,74,na,1865,4.21775153185986
STAT,1890,27,25-29,1917,0.5138365846751068
SIM,1909,7,na,1916,41
STAT,1795,88,na,1883,0.5779418439269824
STAT,1887,47,20-24,1934,1.3037029386113138E-4
STAT,1949,19,45-49,1968,0.005768818540687234
STAT,1875,26,25-29,1901,0.4363263785393322
STAT,1845,35,15-19,1880,3.869533270457606E-4
STAT,1844,25,50-100,1869,0.006205479546694973
STAT,1890,34,15-19,1924,0.00171502002467921
STAT,1842,42,20-24,1884,0.0012327781735856106
SIM,1868,65,na,1933,27
STAT,1842,29,na,1871,19.78432571293493
STAT,1823,36,25-29,1859,0.02108993398390407
SIM,1915,22,15-19,1937,3
STAT,1835,39,20-24,1874,0.004230916511283267
SIM,1864,51,na,1915,22
STAT,1889,82,na,1971,10.279959390083926
STAT,1917,30,30-34,1947,0.16479572552358224
STAT,1919,18,20-24,1937,1.4813381818548998
STAT,1833,33,30-34,1866,0.16470699580736708
STAT,1866,43,na,1909,21.132325868931474
STAT,1901,25,na,1926,33.620434702969476
STAT,1844,52,45-49,1896,1.1275229756456708E-4
STAT,1856,46,30-34,1902,7.032424650622998E-4
STAT,1813,47,20-24,1860,3.7192567594495013E-4
STAT,1875,44,25-29,1919,0.00651190178094183
STAT,1818,70,na,1888,3.8147506971519185
STAT,1842,24,20-24,1866,0.642803606601807
STAT,1862,21,40-44,1883,0.01853735073700736
SIM,1892,79,na,1971,12
STAT,1887,29,20-24,1916,0.12713450363997364
STAT,1907,22,15-19,1929,0.048256525330300525
STAT,1832,85,na,1917,1.239111809063871
SIM,1915,8,na,1923,40
SIM,1927,18,20-24,1945,2
STAT,1874,23,25-29,1897,0.5789572883764047
STAT,1880,38,20-24,1918,0.008065680139055988
STAT,1818,43,40-44,1861,0.02346199676052711
STAT,1843,48,45-49,1891,9.885180298428047E-4
STAT,1864,16,20-24,1880,0.18183321500462993
STAT,1895,30,35-39,1925,0.1325319803321393
STAT,1897,36,25-29,1933,0.03841847881434368
STAT,1910,21,30-34,1931,0.2690686820696301
STAT,1818,48,na,1866,6.917599968730709
STAT,1824,66,na,1890,11.404430890455542
STAT,1860,80,na,1940,5.0290190192828295
STAT,1934,33,35-39,1967,0.12416412661144717
STAT,1879,52,45-49,1931,1.494053185243655E-4
STAT,1909,49,25-29,1958,4.818543789354872E-4
STAT,1824,44,40-44,1868,0.029482762428936028
STAT,1916,42,30-34,1958,0.001298933440790534
STAT,1807,47,45-49,1854,0.005012246664494586
STAT,1834,40,20-24,1874,0.001388106589409853
STAT,1858,76,na,1934,7.209217761566787
STAT,1826,67,na,1893,11.077769947831696
STAT,1862,81,na,1943,4.665524886613902
STAT,1891,37,35-39,1928,0.08681047753116174
SIM,1851,64,na,1915,15
STAT,1915,38,na,1953,37.4907996267837
STAT,1921,31,15-19,1952,0.0014247025791873495
SIM,1857,79,na,1936,7
STAT,1885,78,na,1963,10.15748925855027
STAT,1857,35,20-24,1892,0.0058254411553927575
STAT,1841,43,30-34,1884,0.011544546475581905
STAT,1906,48,45-49,1954,0.001909740215887251
STAT,1885,38,20-24,1923,0.0075744901693758585
STAT,1923,45,40-44,1968,0.001840224897933312
STAT,1858,33,50-100,1891,0.0069426994887735825
STAT,1807,84,na,1891,1.4039497127900793
STAT,1913,47,50-100,1960,0.0021891509539204196
STAT,1850,41,30-34,1891,0.010282559006086302
STAT,1922,25,50-100,1947,0.011256352025795878
STAT,1873,46,30-34,1919,9.869526680934683E-4
STAT,1824,46,35-39,1870,0.001835702569173495
STAT,1874,38,45-49,1912,0.020123441545717605
STAT,1912,33,15-19,1945,0.00124929021132662
STAT,1884,16,25-29,1900,0.055656240201781094
STAT,1933,31,50-100,1964,0.011103160601416109
SIM,1839,30,na,1869,21
SIM,1783,75,na,1858,1
STAT,1842,17,30-34,1859,0.015356243032442799
STAT,1847,39,na,1886,25.575623853829583
STAT,1882,37,40-44,1919,0.041951525927997835
STAT,1900,0,na,1900,40.71764935514702
STAT,1846,20,45-49,1866,0.007074131066914647
STAT,1815,46,40-44,1861,0.0025029473908270406
STAT,1891,35,40-44,1926,0.05423814498010787
STAT,1892,18,50-100,1910,6.036636611613832E-4
SIM,1891,29,na,1920,37
STAT,1869,15,45-49,1884,6.493279558698732E-4
STAT,1914,21,15-19,1935,0.05191099899171593
STAT,1827,84,na,1911,2.01599768924297
STAT,1841,34,na,1875,25.209169991372455
STAT,1907,19,na,1926,36.7452234090982
SIM,1888,31,na,1919,39
STAT,1923,4,na,1927,47.066253801497396
STAT,1914,47,40-44,1961,0.0015506731820507528
STAT,1833,37,45-49,1870,0.01845218839534679
STAT,1823,40,45-49,1863,0.010776832482286296
STAT,1826,41,25-29,1867,0.006921940749101288
STAT,1847,39,50-100,1886,0.013327925042879399
STAT,1879,19,20-24,1898,0.18250804245486285
STAT,1882,44,30-34,1926,0.0108690547398192
STAT,1832,45,30-34,1877,5.280471079295939E-4
STAT,1860,30,20-24,1890,0.022151769108067303
STAT,1911,58,na,1969,32.78042411770356
STAT,1850,34,40-44,1884,0.03956244937688313
STAT,1784,72,na,1856,7.445858264100001
STAT,1792,91,na,1883,0.3819983256638061
STAT,1932,38,45-49,1970,0.009113290087043539
STAT,1937,16,15-19,1953,0.43979591826875924
STAT,1958,8,na,1966,51.32509283349341
STAT,1769,95,na,1864,0.11939973927925421
STAT,1856,47,40-44,1903,0.0012344478757676657
SIM,1828,30,45-49,1858,1
STAT,1866,43,35-39,1909,0.01655678806485889
STAT,1832,51,na,1883,10.267880199787017
STAT,1833,44,35-39,1877,0.01583393541816425
STAT,1851,17,25-29,1868,0.058165015044586287
STAT,1809,49,20-24,1858,3.968520496812903E-4
STAT,1892,26,na,1918,29.58446942188886
STAT,1911,19,50-100,1930,7.408945769716536E-4
STAT,1841,14,na,1855,29.8638
SIM,1867,89,na,1956,1
STAT,1948,20,30-34,1968,0.32805124120573514
STAT,1917,29,na,1946,38.65121453078768
STAT,1904,22,50-100,1926,0.005843190782578615
STAT,1915,46,45-49,1961,0.002176523767144928
STAT,1865,47,35-39,1912,0.0012603788083588694
STAT,1898,29,30-34,1927,0.33727611691559906
STAT,1933,19,35-39,1952,0.05564261458470267
STAT,1880,49,25-29,1929,5.930481366080416E-4
STAT,1902,37,20-24,1939,0.002346282086454933
SIM,1781,74,na,1855,8
STAT,1926,46,20-24,1972,1.359153615296765E-4
STAT,1886,32,50-100,1918,0.009503906459857476
STAT,1877,59,na,1936,20.061623567516474
SIM,1919,19,25-29,1938,1
STAT,1900,34,35-39,1934,0.1392278929886226
SIM,1848,38,25-29,1886,1
STAT,1816,47,na,1863,8.940919024152816
STAT,1794,72,na,1866,6.268034243458201
STAT,1872,40,40-44,1912,0.02324613896737636
STAT,1887,21,45-49,1908,0.007634298172262123
SIM,1800,72,na,1872,8
STAT,1822,43,50-100,1865,0.005949467443274747
STAT,1888,11,na,1899,30.224184854864806
SIM,1920,26,25-29,1946,1
STAT,1809,65,na,1874,11.49407812794731
STAT,1928,18,15-19,1946,0.5675557590240251
STAT,1860,15,25-29,1875,0.05376374381824622
STAT,1875,78,na,1953,8.03164834004195
STAT,1881,45,25-29,1926,5.535532270912962E-4
STAT,1848,38,50-100,1886,0.008097608460727759
STAT,1923,36,50-100,1959,0.0048355067053983125
SIM,1882,46,na,1928,30
STAT,1912,26,25-29,1938,0.6457660257753844
STAT,1891,42,30-34,1933,0.014093239207850456
STAT,1843,15,25-29,1858,0.031083869591106046
STAT,1830,24,15-19,1854,0.04744890534462367
SIM,1875,13,na,1888,21
STAT,1844,37,20-24,1881,0.006362607790714686
STAT,1907,26,30-34,1933,0.3696127059101571
STAT,1889,49,45-49,1938,0.0015958445475597615
STAT,1874,42,30-34,1916,0.011648926030691542
STAT,1864,62,na,1926,16.39333882713464
SIM,1842,81,na,1923,8
STAT,1854,47,50-100,1901,0.0014941945689028535
STAT,1840,47,30-34,1887,7.649031665019164E-4
SIM,1799,70,na,1869,12
SIM,1829,30,na,1859,20
SIM,1888,41,na,1929,36
STAT,1945,18,15-19,1963,0.49204031357113737
STAT,1854,35,50-100,1889,0.007619219328758773
STAT,1915,40,50-100,1955,0.001175796400596017
STAT,1794,62,na,1856,10.209535160000001
STAT,1875,41,20-24,1916,0.0016398928246267334
SIM,1791,74,na,1865,3
STAT,1867,42,25-29,1909,0.006137623828130901
STAT,1865,45,40-44,1910,0.0015639200334999104
STAT,1906,8,na,1914,37.76661919037085
STAT,1837,84,na,1921,1.608507346711855
STAT,1841,39,45-49,1880,0.02251710055309195
STAT,1846,16,50-100,1862,5.017225436966737E-4
SIM,1953,18,15-19,1971,1
STAT,1843,15,na,1858,12.59125610110631
STAT,1851,34,na,1885,20.537381179142763
STAT,1828,48,na,1876,16.536679517407027
STAT,1824,32,na,1856,20.697842255641994
STAT,1865,53,50-100,1918,1.3440915865205958E-4
SIM,1901,8,na,1909,42
SIM,1849,30,na,1879,11
STAT,1857,28,30-34,1885,0.19277791773619946
STAT,1868,16,40-44,1884,0.0018127608990750749
SIM,1874,27,na,1901,23
STAT,1915,17,50-100,1932,7.773627521512426E-4
STAT,1816,67,na,1883,5.443927073571447
STAT,1872,81,na,1953,5.532941291810882
STAT,1850,36,35-39,1886,0.06463978030490596
STAT,1920,28,25-29,1948,0.7133675826283962
STAT,1849,29,35-39,1878,0.08741948226600162
SIM,1888,2,na,1890,40
STAT,1797,69,na,1866,6.063158278358432
STAT,1898,11,na,1909,34.89005661100271
STAT,1852,51,na,1903,18.516017414783487
STAT,1899,27,25-29,1926,0.5790783749070781
STAT,1903,33,20-24,1936,0.02197354844323577
SIM,1833,27,25-29,1860,1
STAT,1849,95,na,1944,0.10309244756090717
STAT,1920,35,15-19,1955,2.088263311074073E-4
SIM,1897,14,na,1911,43
SIM,1851,54,na,1905,15
STAT,1818,47,20-24,1865,1.1805895668818695E-4
STAT,1908,43,35-39,1951,0.0018422343514648374
STAT,1859,26,40-44,1885,0.024395377721281097
STAT,1821,34,15-19,1855,0.0035860893024987814
SIM,1828,78,na,1906,6
STAT,1907,44,45-49,1951,0.0014997139380170277
STAT,1874,20,20-24,1894,0.7032826260955456
STAT,1807,51,30-34,1858,1.2442136322696564E-4
STAT,1882,15,50-100,1897,4.716920371805528E-4
STAT,1860,48,45-49,1908,0.0018945081213677685
SIM,1896,60,na,1956,23
STAT,1924,44,30-34,1968,0.001505764846018683
STAT,1838,51,45-49,1889,1.1427899733441055E-4
SIM,1860,1,na,1861,33
STAT,1851,44,na,1895,19.24882243285402
STAT,1849,36,25-29,1885,0.02308287051506754
STAT,1800,105,na,1905,1.062528294629529E-4
STAT,1918,47,25-29,1965,5.593767589401676E-4
SIM,1823,69,na,1892,6
SIM,1893,30,25-29,1923,1
STAT,1909,38,50-100,1947,0.003932172511851258
STAT,1824,39,45-49,1863,0.02781283565847865
SIM,1866,9,na,1875,36
STAT,1924,44,45-49,1968,0.001960207390952681
STAT,1864,52,na,1916,19.209444697999306
STAT,1842,18,50-100,1860,4.692353993019232E-4
STAT,1919,28,15-19,1947,0.007535009381385666
STAT,1895,20,40-44,1915,0.02721457179831954
SIM,1915,26,30-34,1941,1
STAT,1892,18,25-29,1910,0.06982377756674364
STAT,1900,35,45-49,1935,0.027905853058462302
STAT,1904,34,50-100,1938,0.007474013677966344
STAT,1885,30,25-29,1915,0.10196027036410472
STAT,1917,48,20-24,1965,1.1406259654250426E-4
SIM,1900,30,40-44,1930,1
STAT,1857,38,25-29,1895,0.021446994102959794
STAT,1848,30,20-24,1878,0.020813358144648568
STAT,1831,99,na,1930,0.01536861177241392
STAT,1849,85,na,1934,2.125614520890699
SIM,1901,32,35-39,1933,1
STAT,1858,45,50-100,1903,0.0018875120779939052
STAT,1891,34,30-34,1925,0.21245954865273559
SIM,1877,89,na,1966,3
STAT,1869,51,50-100,1920,1.4703695852437635E-4
STAT,1904,31,15-19,1935,0.0020488852560586798
SIM,1886,60,na,1946,24
SIM,1884,27,na,1911,26
STAT,1841,46,35-39,1887,0.0013943025565912282
SIM,1904,11,na,1915,33
STAT,1824,47,45-49,1871,0.0030538285689323892
STAT,1934,30,30-34,1964,0.21444204728459632
STAT,1819,65,na,1884,9.07702085662648
SIM,1860,37,na,1897,25
STAT,1873,97,na,1970,0.3158554401530257
STAT,1851,40,20-24,1891,0.0013542773452000305
STAT,1905,31,15-19,1936,0.0011849683654075965
STAT,1857,59,na,1916,14.54892880236541
STAT,1911,42,50-100,1953,0.0011140504822112485
SIM,1808,48,na,1856,15
STAT,1844,96,na,1940,0.06706995733695835
STAT,1848,48,45-49,1896,0.0015070345355874823
STAT,1897,40,45-49,1937,0.001394067034890923
STAT,1874,62,na,1936,18.542175370832634
SIM,1861,54,na,1915,23
STAT,1927,34,50-100,1961,0.010105559846446911
STAT,1881,48,30-34,1929,9.095204689733686E-4
SIM,1902,10,na,1912,37
STAT,1871,48,20-24,1919,1.1813676598811473E-4
SIM,1818,78,na,1896,8
STAT,1887,25,na,1912,26.225811415214572
STAT,1834,32,na,1866,19.618207411538364
STAT,1900,42,35-39,1942,0.001741558996155894
STAT,1816,44,35-39,1860,0.02357199573051369
STAT,1869,28,50-100,1897,0.006176426570703378
STAT,1909,46,20-24,1955,1.0122925684425187E-4
STAT,1908,40,30-34,1948,0.0011900151109395165
STAT,1918,40,40-44,1958,0.002642615860464011
STAT,1836,44,50-100,1880,0.01182218150601463
SIM,1919,10,na,1929,47
STAT,1863,49,25-29,1912,4.993408387032414E-4
STAT,1907,19,40-44,1926,0.002661069617820874
STAT,1824,43,30-34,1867,0.01532273359471431
STAT,1853,15,na,1868,17.560299814973845
SIM,1889,29,30-34,1918,1
STAT,1883,35,35-39,1918,0.06933612797197963
STAT,1924,36,45-49,1960,0.00799367581653621
STAT,1817,84,na,1901,2.636482949872517
STAT,1850,37,45-49,1887,0.01803037606402424
SIM,1881,84,na,1965,1
STAT,1920,33,20-24,1953,0.026378060013805466
SIM,1833,45,na,1878,11
SIM,1934,31,35-39,1965,1
STAT,1924,43,35-39,1967,0.0023758504185160245
STAT,1950,15,na,1965,43.27515055592932
SIM,1842,40,na,1882,23
SIM,1954,0,na,1954,52
STAT,1884,22,50-100,1906,0.003995334479908567
STAT,1920,49,na,1969,40.028883049405515
STAT,1822,48,25-29,1870,3.1225666846404444E-4
STAT,1865,44,30-34,1909,0.010258242022789523
STAT,1831,34,na,1865,22.309777490791824
STAT,1896,26,45-49,1922,0.014634280426123967
STAT,1933,16,30-34,1949,0.16289910706442276
SIM,1875,23,na,1898,18
STAT,1927,19,na,1946,45.287942137312314
STAT,1883,28,45-49,1911,0.010743995352930247
STAT,1871,32,50-100,1903,0.009134971430685122
STAT,1837,30,45-49,1867,0.010902486724009145
STAT,1897,35,na,1932,31.58345599012562
SIM,1820,72,na,1892,4
STAT,1938,30,15-19,1968,0.0012850522944035587
STAT,1805,52,45-49,1857,2.807391762883993E-4
STAT,1865,37,40-44,1902,0.039593958858090195
STAT,1887,59,na,1946,21.213061596333095
STAT,1900,31,30-34,1931,0.24310017407737247
SIM,1903,59,na,1962,31
STAT,1891,38,45-49,1929,0.02434597615623781
SIM,1867,79,na,1946,4
SIM,1898,29,25-29,1927,1
STAT,1832,38,40-44,1870,0.024585613957516482
STAT,1944,7,na,1951,42.28086499514009
SIM,1819,64,na,1883,4
STAT,1829,35,45-49,1864,0.018707365724789055
STAT,1926,31,35-39,1957,0.1099309907358482
SIM,1845,30,45-49,1875,1
SIM,1937,18,50-100,1955,1
SIM,1810,72,na,1882,10
STAT,1898,39,25-29,1937,0.008298983227236024
STAT,1814,66,na,1880,8.654823141998683
STAT,1931,21,15-19,1952,0.06894224567308259
SIM,1848,28,30-34,1876,1
STAT,1842,34,35-39,1876,0.08990069584477808
STAT,1915,43,40-44,1958,0.002492496531516666
STAT,1878,21,na,1899,24.49089453476159
STAT,1883,43,35-39,1926,0.01745745062330209
STAT,1873,47,40-44,1920,0.001732463105030609
STAT,1890,45,na,1935,27.601338279488115
STAT,1957,6,na,1963,51.53819459650103
SIM,1883,5,na,1888,20
STAT,1840,44,25-29,1884,0.005116202229299513
SIM,1892,56,na,1948,32
STAT,1850,44,35-39,1894,0.015905222127019853
STAT,1804,66,na,1870,9.182408627247176
STAT,1929,18,50-100,1947,0.004746057498582992
STAT,1816,52,35-39,1868,1.0414340979280754E-4
STAT,1948,23,35-39,1971,0.10736324510693429
STAT,1950,8,na,1958,46.182342894491576
SIM,1865,13,na,1878,25
STAT,1925,17,35-39,1942,0.050372046895364175
STAT,1857,45,35-39,1902,0.0010584998737364544
STAT,1891,45,35-39,1936,9.789327567973636E-4
SIM,1871,30,na,1901,23
STAT,1875,19,35-39,1894,0.005610164279836068
SIM,1914,11,na,1925,37
STAT,1824,36,40-44,1860,0.0651301880957201
STAT,1861,44,45-49,1905,0.012416189778826558
STAT,1910,31,50-100,1941,0.007955741124033702
SIM,1895,43,na,1938,27
STAT,1888,21,na,1909,27.72135275183778
STAT,1824,54,35-39,1878,1.033858544717106E-4
STAT,1821,99,na,1920,0.011762592132690436
SIM,1859,29,na,1888,21
STAT,1875,18,25-29,1893,0.0580980743868687
SIM,1808,68,na,1876,4
SIM,1786,73,na,1859,17
SIM,1841,64,na,1905,11
STAT,1917,19,na,1936,38.91062302873411
STAT,1847,16,20-24,1863,0.23776876166552982
STAT,1866,40,30-34,1906,0.010695071433305205
SIM,1872,70,na,1942,13
STAT,1889,31,20-24,1920,0.033229649771917044
SIM,1945,13,na,1958,40
STAT,1907,29,35-39,1936,0.1389516148618611
STAT,1882,71,na,1953,12.791978663815291
STAT,1922,49,40-44,1971,0.0017874420540248265
SIM,1898,61,na,1959,20
STAT,1890,31,45-49,1921,0.021268822794497228
STAT,1901,31,30-34,1932,0.24530681021458808
STAT,1839,17,25-29,1856,0.040908568015002
STAT,1837,39,na,1876,12.34854881311081
STAT,1883,12,na,1895,25.078267404191596
SIM,1793,75,na,1868,11
STAT,1881,15,45-49,1896,6.244599226565394E-4
STAT,1849,28,25-29,1877,0.38602335624611117
SIM,1843,45,na,1888,19
STAT,1873,39,40-44,1912,0.04405781757890203
STAT,1867,28,40-44,1895,0.028565459554368764
STAT,1826,49,20-24,1875,1.1762775637715286E-4
STAT,1859,95,na,1954,0.10567518414094554
STAT,1806,48,40-44,1854,0.0056837380099746945
STAT,1881,44,15-19,1925,1.2963278580576407E-4
SIM,1911,24,na,1935,40
STAT,1920,25,20-24,1945,0.19988399305637122
SIM,1922,40,na,1962,48
STAT,1859,18,40-44,1877,0.001677553310733768
STAT,1900,32,40-44,1932,0.06013646657916543
STAT,1911,20,35-39,1931,0.08925401476549252
STAT,1843,41,25-29,1884,0.002840818144473921
STAT,1870,27,20-24,1897,0.11653889771961412
STAT,1824,86,na,1910,1.543841331266029
STAT,1836,67,na,1903,15.299017867514786
STAT,1842,42,35-39,1884,0.01405635090851752
STAT,1885,33,50-100,1918,0.009009877703343343
STAT,1896,30,na,1926,31.597010667938562
STAT,1832,46,40-44,1878,9.220129289078399E-4
STAT,1853,31,40-44,1884,0.028360430193157794
STAT,1877,17,45-49,1894,6.742987800573813E-4
STAT,1855,25,45-49,1880,0.009084090372293806
STAT,1881,35,50-100,1916,0.011793455858620771
STAT,1852,39,20-24,1891,0.00653089755722417
STAT,1850,33,30-34,1883,0.1609418331479567
STAT,1904,22,na,1926,33.88856116479174
STAT,1892,15,20-24,1907,0.2200372293631107
STAT,1919,52,na,1971,38.83714892442849
STAT,1862,35,15-19,1897,4.890828789134472E-4
STAT,1864,41,45-49,1905,0.01348444733370574
SIM,1898,41,na,1939,32
STAT,1823,49,na,1872,14.606930168380222
STAT,1948,2,na,1950,45.7196270998733
STAT,1840,43,15-19,1883,1.114445508745373E-4
STAT,1891,27,40-44,1918,0.03676646684357047
STAT,1863,20,45-49,1883,0.006388520895638852
STAT,1850,80,na,1930,5.507764254401704
STAT,1832,46,50-100,1878,0.00132270078957003
STAT,1795,98,na,1893,0.007952091262084014
STAT,1930,21,15-19,1951,0.06807948541102753
STAT,1839,85,na,1924,1.5128277734602646
STAT,1865,48,45-49,1913,0.0021077689295361324
STAT,1837,19,15-19,1856,0.05164757010271216
SIM,1856,63,na,1919,8
STAT,1820,43,45-49,1863,0.013014032920816264
SIM,1893,62,na,1955,28
STAT,1837,50,na,1887,10.871007731169815
STAT,1846,13,na,1859,24.193203702533992
STAT,1843,19,40-44,1862,9.798540997675435E-4
SIM,1854,0,na,1854,27
STAT,1916,34,45-49,1950,0.015969248970404373
STAT,1877,47,50-100,1924,0.00252341376508537
STAT,1865,30,20-24,1895,0.02464534732452532
STAT,1816,41,30-34,1857,0.016206016375658615
STAT,1881,37,25-29,1918,0.027396811771733233
SIM,1845,16,na,1861,23
STAT,1830,28,na,1858,9.916311770242661
STAT,1856,33,na,1889,17.31812287218895
SIM,1879,26,na,1905,16
STAT,1829,31,na,1860,19.581112623422843
SIM,1883,42,na,1925,12
STAT,1799,71,na,1870,6.808918839341389
STAT,1910,32,35-39,1942,0.08757521628884718
STAT,1851,29,50-100,1880,0.006232737375902411
STAT,1879,92,na,1971,1.7139309539871836
SIM,1832,50,na,1882,21
STAT,1831,43,20-24,1874,0.0015529589073907354
STAT,1933,31,40-44,1964,0.05255278960629153
STAT,1814,46,25-29,1860,0.0016750915032393656
STAT,1951,21,na,1972,43.37956272500305
STAT,1863,46,20-24,1909,1.0654937453831823E-4
STAT,1834,32,35-39,1866,0.09167130907897006
SIM,1853,45,na,1898,24
SIM,1868,75,na,1943,16
STAT,1823,44,25-29,1867,0.004473852186671921
SIM,1853,35,na,1888,24
STAT,1886,30,na,1916,24.951363958235586
SIM,1938,3,na,1941,41
SIM,1851,10,na,1861,27
SIM,1960,1,na,1961,52
STAT,1826,98,na,1924,0.022701354478444433
SIM,1917,18,na,1935,45
STAT,1831,35,50-100,1866,0.012822698518524234
STAT,1920,41,50-100,1961,0.0012883039856503296
SIM,1867,29,45-49,1896,1
SIM,1895,5,na,1900,31
STAT,1922,45,25-29,1967,6.077752348865568E-4
STAT,1860,45,40-44,1905,0.0014056850175163103
STAT,1855,51,45-49,1906,1.0266640761585945E-4
STAT,1785,102,na,1887,0.0024824819755474635
STAT,1913,33,15-19,1946,0.0012624825297157952
SIM,1813,70,na,1883,3
STAT,1893,21,50-100,1914,0.005157260292217071
STAT,1838,25,45-49,1863,0.011121092344178513
STAT,1859,44,50-100,1903,0.00828351619801237
STAT,1881,49,40-44,1930,0.0015950292004963033
STAT,1859,29,45-49,1888,0.008848752976937786
STAT,1922,31,15-19,1953,0.0014472006701600993
STAT,1839,41,na,1880,13.611251779129628
STAT,1872,44,20-24,1916,0.0016029941501183903
STAT,1883,25,40-44,1908,0.02928671757771228
STAT,1945,25,50-100,1970,0.010851010775202315
SIM,1826,43,na,1869,16
STAT,1939,33,35-39,1972,0.09254320429981526
STAT,1842,31,30-34,1873,0.15989887401114172
STAT,1942,24,45-49,1966,0.011703452517519293
STAT,1912,22,50-100,1934,0.006256628067627471
STAT,1918,23,50-100,1941,0.007010697827927712
SIM,1835,41,40-44,1876,1
SIM,1925,37,na,1962,43
SIM,1892,15,na,1907,36
SIM,1855,13,na,1868,23
STAT,1890,34,50-100,1924,0.01103437355777052
STAT,1839,40,20-24,1879,0.0010414088616102215
SIM,1921,44,na,1965,41
STAT,1879,26,45-49,1905,0.011531184992917373
SIM,1817,73,na,1890,2
STAT,1890,35,25-29,1925,0.035305840905957696
STAT,1811,52,35-39,1863,3.2672609165609775E-4
STAT,1924,33,40-44,1957,0.045330844687555605
SIM,1885,77,na,1962,12
STAT,1873,12,na,1885,26.671281706616522
STAT,1888,65,na,1953,19.748868698469323
SIM,1890,8,na,1898,31
STAT,1907,22,35-39,1929,0.08535857554395677
STAT,1894,32,50-100,1926,0.011742528685037393
SIM,1792,80,na,1872,1
STAT,1840,48,40-44,1888,0.0013355827506422902
STAT,1855,47,25-29,1902,4.0365354313608056E-4
SIM,1839,61,na,1900,19
STAT,1875,33,35-39,1908,0.10366107818603965
STAT,1867,16,25-29,1883,0.05576611148315341
STAT,1892,30,30-34,1922,0.21743250009259632
SIM,1917,9,na,1926,47
STAT,1890,49,35-39,1939,9.392421846789966E-4
STAT,1855,18,20-24,1873,0.14758796906550234
STAT,1817,51,25-29,1868,1.0045521021391598E-4
STAT,1811,45,45-49,1856,0.009643005980561776
STAT,1949,23,50-100,1972,0.0076263930037950515
STAT,1924,40,30-34,1964,0.001514985212261913
STAT,1894,32,40-44,1926,0.05557900687772701
SIM,1858,24,25-29,1882,2
STAT,1870,37,15-19,1907,5.578330052606908E-4
SIM,1888,10,na,1898,39
STAT,1882,40,15-19,1922,1.3368105836925281E-4
STAT,1884,42,25-29,1926,0.006283800130086312
STAT,1800,73,na,1873,4.602227040065189
STAT,1827,41,40-44,1868,0.017841017302991504
STAT,1899,22,50-100,1921,0.00558238003527598
STAT,1920,36,25-29,1956,0.010698314390558676
STAT,1935,17,na,1952,50.0951378336087
STAT,1839,31,na,1870,14.87193125150273
STAT,1939,15,20-24,1954,1.3510871459429514
STAT,1790,68,na,1858,4.3072152141849696
STAT,1868,42,40-44,1910,0.02174046222935986
SIM,1842,50,na,1892,20
SIM,1807,83,na,1890,2
SIM,1954,17,na,1971,50
STAT,1869,16,40-44,1885,0.0018074099993043472
SIM,1866,53,na,1919,27
STAT,1828,40,45-49,1868,0.006736053929416775
STAT,1808,80,na,1888,1.0402319555609023
STAT,1864,45,25-29,1909,5.217781313667355E-4
SIM,1858,75,na,1933,10
STAT,1921,3,na,1924,45.87319552148245
STAT,1858,19,35-39,1877,0.00482010405190495
STAT,1797,90,na,1887,0.2728740451266114
STAT,1949,18,35-39,1967,0.04847505098774795
STAT,1927,41,45-49,1968,0.0020796107808043265
STAT,1820,36,20-24,1856,0.007388502676334952
STAT,1912,23,20-24,1935,1.0540403850237428
STAT,1921,35,30-34,1956,0.02022674147662127
SIM,1834,31,na,1865,22
STAT,1901,20,40-44,1921,0.029332064681569108
SIM,1920,23,20-24,1943,2
STAT,1835,33,50-100,1868,0.005248233223331515
STAT,1893,47,45-49,1940,0.0016707006370248988
SIM,1837,28,na,1865,26
SIM,1897,55,na,1952,38
STAT,1789,71,na,1860,3.774325419395618
SIM,1889,26,na,1915,29
STAT,1849,25,20-24,1874,0.10939533867380626
STAT,1890,42,15-19,1932,1.675418744844019E-4
STAT,1882,33,25-29,1915,0.09774512899718014
SIM,1803,70,na,1873,4
STAT,1886,30,40-44,1916,0.04534488146271424
STAT,1866,25,20-24,1891,0.10877751168938753
SIM,1822,50,na,1872,14
STAT,1878,31,45-49,1909,0.018077100200952448
STAT,1932,35,40-44,1967,0.020066831278541114
STAT,1910,5,na,1915,39.4676695939912
STAT,1866,33,na,1899,21.884739596000717
STAT,1932,21,30-34,1953,0.37671760736939525
SIM,1834,21,na,1855,21
STAT,1898,32,25-29,1930,0.1381728209734899
STAT,1934,19,50-100,1953,0.005019062849764748
STAT,1884,62,na,1946,17.907231461373197
STAT,1882,47,35-39,1929,0.0013354263070150722
SIM,1889,36,na,1925,32
STAT,1916,16,30-34,1932,0.0257022660311188
STAT,1873,22,na,1895,24.045274694820453
STAT,1857,31,25-29,1888,0.077955627064238
SIM,1923,21,30-34,1944,1
STAT,1901,16,50-100,1917,6.872118358896319E-4
STAT,1866,18,30-34,1884,0.014978306314003403
SIM,1904,42,na,1946,27
STAT,1849,18,30-34,1867,0.015123006219619862
STAT,1810,102,na,1912,0.0010538064123604663
STAT,1834,86,na,1920,1.5679889286389752
STAT,1938,17,50-100,1955,0.0036713987788091784
SIM,1866,63,na,1929,26
SIM,1874,82,na,1956,13
SIM,1929,9,na,1938,51
STAT,1934,22,na,1956,48.86792825414961
STAT,1876,48,20-24,1924,1.2034609980216687E-4
STAT,1830,102,na,1932,0.001053354578542661
STAT,1880,24,50-100,1904,0.004261288209324956
STAT,1917,40,na,1957,38.51235910152095
STAT,1922,41,na,1963,42.37721329790803
STAT,1915,21,30-34,1936,0.29541859633815803
STAT,1887,80,na,1967,10.314590353891441
SIM,1873,42,na,1915,27
STAT,1886,40,na,1926,24.215614842296105
STAT,1793,86,na,1879,0.38926763986464463
STAT,1883,32,30-34,1915,0.16954807925530238
STAT,1830,73,na,1903,4.267501483170178
SIM,1826,34,50-100,1860,1
STAT,1840,28,na,1868,20.98391480172963
STAT,1916,41,35-39,1957,0.0020488680588417216
STAT,1873,42,15-19,1915,1.4023065901503135E-4
STAT,1893,40,25-29,1933,0.00817851240962209
STAT,1821,102,na,1923,0.001820876424917584
STAT,1821,68,na,1889,9.461017872602643
STAT,1911,38,25-29,1949,0.009401863585710208
STAT,1869,41,45-49,1910,0.014567182459456611
SIM,1901,24,na,1925,37
STAT,1906,45,40-44,1951,0.0014169869099758526
STAT,1812,44,15-19,1856,1.5721463589346858E-4
STAT,1906,31,30-34,1937,0.14624538554965463
SIM,1881,30,na,1911,25
STAT,1914,22,na,1936,36.999411342924006
SIM,1912,30,na,1942,38
STAT,1892,41,20-24,1933,0.0019708658682483955
STAT,1868,45,na,1913,21.989793178997697
STAT,1847,19,25-29,1866,0.07466511939096837
STAT,1856,7,na,1863,21.201816149577656
SIM,1919,18,15-19,1937,3
STAT,1925,43,35-39,1968,0.0024188435804175052
STAT,1841,32,25-29,1873,0.1216406136493459
STAT,1875,15,20-24,1890,0.18308575910546648
STAT,1832,49,45-49,1881,0.0011129988562146242
STAT,1931,36,50-100,1967,0.005540843338018274
STAT,1864,49,40-44,1913,0.0015034712381381847
STAT,1922,42,20-24,1964,2.0122084354141562E-4
SIM,1833,35,na,1868,12
STAT,1895,44,na,1939,29.70299699689407
STAT,1817,94,na,1911,0.15839730509390343
STAT,1874,35,40-44,1909,0.04483115127736253
STAT,1881,34,20-24,1915,0.025500567034139797
SIM,1878,41,na,1919,27
STAT,1930,33,15-19,1963,0.0016496188806775576
STAT,1901,30,35-39,1931,0.1428439384711832
STAT,1810,73,na,1883,4.317062501963409
STAT,1831,46,25-29,1877,5.58570218589293E-4
STAT,1879,51,na,1930,22.39212857219427
SIM,1899,36,na,1935,28
SIM,1866,26,25-29,1892,1
STAT,1912,48,35-39,1960,0.0012259632069816662
STAT,1922,5,na,1927,46.19214002661329
STAT,1853,49,30-34,1902,5.956675182371266E-4
STAT,1847,60,na,1907,20.373199021521522
STAT,1908,59,na,1967,31.08046835398432
SIM,1782,80,na,1862,3
STAT,1865,1,na,1866,32.51458614594593
SIM,1844,31,na,1875,10
SIM,1849,23,20-24,1872,1
STAT,1861,34,na,1895,19.896001912939866
SIM,1943,22,na,1965,44
STAT,1880,48,na,1928,23.36100330307969
STAT,1815,49,45-49,1864,0.003305910981741303
STAT,1870,21,50-100,1891,0.00406317351567433
STAT,1918,44,20-24,1962,1.8544973439692323E-4
STAT,1844,41,40-44,1885,0.01822558089221616
STAT,1890,46,30-34,1936,6.651505383012753E-4
STAT,1847,50,50-100,1897,1.6365158429342778E-4
STAT,1903,23,50-100,1926,0.00577977667423048
STAT,1880,46,20-24,1926,1.2654464271498364E-4
STAT,1882,81,na,1963,7.535531105676615
SIM,1818,68,na,1886,12
STAT,1900,43,30-34,1943,0.0010990648432095097
STAT,1891,41,na,1932,28.49567550223864
STAT,1876,40,25-29,1916,0.006587850371675615
SIM,1803,69,na,1872,4
STAT,1939,30,30-34,1969,0.15983001478705244
STAT,1833,41,30-34,1874,0.010446716007604183
STAT,1897,44,25-29,1941,5.841779911086049E-4
STAT,1902,30,35-39,1932,0.1439584641644033
SIM,1940,9,na,1949,37
STAT,1911,42,45-49,1953,0.0015782381876552464
SIM,1940,21,30-34,1961,2
STAT,1912,30,45-49,1942,0.015486230202202326
STAT,1858,26,25-29,1884,0.33190081947106265
STAT,1923,48,45-49,1971,0.0025178559759617015
STAT,1814,43,20-24,1857,0.004891843928754703
STAT,1891,20,20-24,1911,0.8508535683182954
STAT,1924,22,35-39,1946,0.11038388869509848
STAT,1933,34,45-49,1967,0.02109232999714388
STAT,1863,53,45-49,1916,1.2642948143994128E-4
STAT,1903,36,25-29,1939,0.008877877565669535
STAT,1820,52,50-100,1872,1.2331824687533528E-4
STAT,1914,43,25-29,1957,7.0061040243743E-4
STAT,1875,88,na,1963,2.809304764495224
STAT,1897,48,40-44,1945,0.0012663069084032509
STAT,1904,56,na,1960,30.230923195519974
STAT,1931,24,50-100,1955,0.008443071201999514
STAT,1871,47,25-29,1918,5.715949139077695E-4
STAT,1825,42,35-39,1867,0.017609412761348617
STAT,1838,45,na,1883,18.431163319565968
STAT,1825,72,na,1897,6.808309131390216
SIM,1884,37,na,1921,24
SIM,1871,64,na,1935,19
STAT,1840,40,45-49,1880,0.01379236259424921
STAT,1882,26,na,1908,22.94958460864361
STAT,1868,11,na,1879,25.964765270668533
STAT,1920,47,30-34,1967,9.77040577330039E-4
STAT,1824,50,50-100,1874,1.963412129498393E-4
STAT,1900,9,na,1909,35.979309787718364
STAT,1926,23,50-100,1949,0.007923610379442919
STAT,1916,19,35-39,1935,0.008779307072306125
STAT,1875,30,30-34,1905,0.18091844934094758
STAT,1833,34,40-44,1867,0.04048799529738792
STAT,1848,45,na,1893,14.694769318345308
SIM,1804,55,na,1859,12
STAT,1838,18,20-24,1856,0.18068286042961956
STAT,1815,72,na,1887,4.883510797513809
STAT,1865,40,15-19,1905,1.2616852922734106E-4
SIM,1927,18,na,1945,47
SIM,1865,23,na,1888,24
SIM,1904,1,na,1905,38
STAT,1838,28,50-100,1866,0.006270304346576992
SIM,1913,56,na,1969,39
STAT,1823,48,40-44,1871,0.0011740634136999666
STAT,1842,20,25-29,1862,0.5495920835975607
STAT,1829,40,50-100,1869,0.009607048505386828
SIM,1922,19,na,1941,50
STAT,1862,32,45-49,1894,0.01504508109850087
SIM,1875,67,na,1942,10
STAT,1895,31,45-49,1926,0.02273178118960487
STAT,1863,12,na,1875,24.118783304170808
STAT,1878,11,na,1889,26.783876302832464
STAT,1885,45,45-49,1930,0.0023537693816593572
STAT,1892,41,50-100,1933,0.013110542264947955
SIM,1827,28,na,1855,22
STAT,1865,78,na,1943,7.067055420956903
STAT,1890,39,40-44,1929,0.05263848429942741
SIM,1848,34,na,1882,31
STAT,1933,36,na,1969,51.081541468718896
STAT,1782,91,na,1873,0.1382685964102923
SIM,1860,68,na,1928,13
STAT,1901,23,45-49,1924,0.00972725415547439
SIM,1912,19,na,1931,39
STAT,1820,39,25-29,1859,0.026135559680742656
STAT,1940,23,30-34,1963,0.2906110262490728
STAT,1818,54,45-49,1872,1.3188980023334668E-4
STAT,1843,29,50-100,1872,0.0032917052961657523
STAT,1949,15,30-34,1964,0.14092823922003692
STAT,1869,92,na,1961,0.8142753966044189
SIM,1813,69,na,1882,3
STAT,1897,25,na,1922,31.906972846746747
STAT,1908,15,na,1923,37.4434554710977
STAT,1867,59,na,1926,18.59818545444358
STAT,1841,36,40-44,1877,0.05100988451364215
SIM,1922,30,na,1952,49
STAT,1908,17,35-39,1925,0.008097284008419608
STAT,1885,21,50-100,1906,0.004039148513160432
SIM,1840,17,na,1857,17
STAT,1874,45,35-39,1919,0.0014344476350192578
STAT,1868,19,45-49,1887,6.360418842670613E-4
STAT,1814,50,45-49,1864,4.149090669426046E-4
STAT,1909,55,na,1964,32.51527256718796
SIM,1843,35,na,1878,22
SIM,1838,16,20-24,1854,1
STAT,1842,20,na,1862,20.52730449308404
STAT,1936,26,50-100,1962,0.009472339094074316
STAT,1911,35,20-24,1946,0.002553737964707428
STAT,1917,41,35-39,1958,0.0020853366976689553
STAT,1939,18,25-29,1957,0.43066005473027996
STAT,1889,46,40-44,1935,0.002102006962119423
SIM,1924,19,35-39,1943,1
SIM,1914,52,na,1966,35
STAT,1864,15,45-49,1879,6.739518106700676E-4
STAT,1861,37,20-24,1898,0.0064824962749884234
SIM,1812,84,na,1896,2
STAT,1869,19,45-49,1888,6.341644185878123E-4
STAT,1872,4,na,1876,30.0674871437179
STAT,1856,43,25-29,1899,0.004618394692972693
SIM,1961,10,na,1971,53
SIM,1891,21,25-29,1912,1
SIM,1915,37,na,1952,36
STAT,1842,61,na,1903,14.019979334868417
STAT,1857,60,na,1917,14.277300301625251
STAT,1892,33,35-39,1925,0.12458258112641989
STAT,1870,41,35-39,1911,0.018069810672146816
STAT,1866,74,na,1940,10.220948041853445
SIM,1835,57,na,1892,15
SIM,1861,3,na,1864,33
STAT,1872,47,25-29,1919,5.865984709888142E-4
STAT,1784,102,na,1886,0.0012205859609020224
STAT,1942,21,40-44,1963,0.03500882086602031
SIM,1839,19,25-29,1858,2
STAT,1818,79,na,1897,1.7470839325217153
SIM,1828,68,na,1896,7
STAT,1844,86,na,1930,1.7330638992291767
SIM,1861,64,na,1925,19
STAT,1876,18,40-44,1894,0.001852780104704521
STAT,1883,21,25-29,1904,0.5575798385528401
STAT,1854,30,45-49,1884,0.011144361200401624
STAT,1924,22,na,1946,42.810450169433395
STAT,1881,41,na,1922,22.091960880924724
STAT,1840,46,50-100,1886,0.001965728446340727
SIM,1852,50,na,1902,20
SIM,1822,84,na,1906,6
SIM,1785,87,na,1872,1
SIM,1939,27,30-34,1966,1
STAT,1839,18,20-24,1857,0.1272298688536964
STAT,1866,28,25-29,1894,0.3882169320897358
STAT,1870,34,45-49,1904,0.01717461854332394
SIM,1889,4,na,1893,34
STAT,1836,42,45-49,1878,0.017182779563270453
SIM,1906,23,na,1929,25
STAT,1881,41,45-49,1922,0.014305619358870859
STAT,1956,7,na,1963,51.718475773256685
SIM,1864,82,na,1946,4
SIM,1876,63,na,1939,25
STAT,1925,40,30-34,1965,0.0015424002397407097
SIM,1891,30,na,1921,37
STAT,1874,52,na,1926,21.727416002470974
STAT,1828,79,na,1907,4.695253512320786
STAT,1912,41,na,1953,35.74425523850222
STAT,1858,45,na,1903,17.290723299147565
SIM,1839,20,na,1859,21
STAT,1873,32,20-24,1905,0.02748179882844437
STAT,1906,41,25-29,1947,6.50781197200942E-4
SIM,1879,81,na,1960,5
STAT,1905,6,na,1911,37.702620871538585
STAT,1927,40,na,1967,46.46889950792614
STAT,1896,16,50-100,1912,6.451064733255911E-4
SIM,1826,87,na,1913,2
STAT,1847,27,50-100,1874,0.008213435052134465
STAT,1916,31,40-44,1947,0.040220621184893904
STAT,1807,54,35-39,1861,1.6953237378137745E-4
STAT,1896,40,na,1936,30.771203308614464
STAT,1893,44,40-44,1937,0.0019428354698412611
STAT,1848,45,40-44,1893,0.0011181877995991658
STAT,1812,48,30-34,1860,0.0010728171235508907
STAT,1851,32,35-39,1883,0.08898582696529647
SIM,1882,15,na,1897,33
STAT,1831,68,na,1899,12.401226949319488
SIM,1848,75,na,1923,11
STAT,1826,53,40-44,1879,1.0029204938278505E-4
STAT,1867,19,35-39,1886,0.005304976757856906
STAT,1929,16,30-34,1945,0.15519092382596347
SIM,1896,51,na,1947,25
STAT,1839,19,na,1858,16.376351131389846
SIM,1938,32,na,1970,39
STAT,1954,10,na,1964,48.29703320575434
STAT,1831,90,na,1921,0.6397862415781592
STAT,1908,42,45-49,1950,0.0015318001259980974
STAT,1898,15,20-24,1913,0.24026920513786795
STAT,1950,17,35-39,1967,0.049308469297428374
STAT,1909,35,15-19,1944,1.82462981695725E-4
SIM,1781,75,na,1856,8
STAT,1843,24,na,1867,11.221562266512636
STAT,1901,25,45-49,1926,0.015641529484967283
STAT,1903,22,45-49,1925,0.009914052157514328
STAT,1904,15,15-19,1919,0.08543071314262853
STAT,1913,36,na,1949,36.99433037162535
STAT,1835,80,na,1915,2.782401899607531
STAT,1923,31,30-34,1954,0.18009926480366378
STAT,1932,37,40-44,1969,0.02003213063429874
STAT,1927,19,30-34,1946,0.14997065044168664
SIM,1903,28,25-29,1931,1
STAT,1868,32,25-29,1900,0.09912232228359294
SIM,1909,43,na,1952,34
SIM,1920,25,20-24,1945,1
STAT,1911,41,35-39,1952,0.0019205455094034388
STAT,1855,105,na,1960,5.468819666732382E-4
SIM,1851,87,na,1938,3
STAT,1943,27,45-49,1970,0.01826517186909312
STAT,1900,61,na,1961,27.268855051165527
STAT,1835,29,na,1864,12.490855398542607
STAT,1801,102,na,1903,0.0010624650601261298
SIM,1859,36,40-44,1895,1
STAT,1873,46,na,1919,22.93890860555836
STAT,1866,32,15-19,1898,0.0013115484063872334
STAT,1844,65,na,1909,13.200213630521574
SIM,1910,18,15-19,1928,1
SIM,1880,76,na,1956,17
STAT,1848,79,na,1927,4.5211119863404665
STAT,1902,18,15-19,1920,0.08346897950422727
STAT,1935,22,50-100,1957,0.008920534868379423
SIM,1947,17,na,1964,40
STAT,1830,25,50-100,1855,0.007357230326623186
STAT,1906,47,40-44,1953,0.0013964587496831352
STAT,1886,16,40-44,1902,0.0019018513439000516
STAT,1912,25,20-24,1937,0.1796886282535666
STAT,1934,32,45-49,1966,0.02139360847814674
STAT,1896,39,na,1935,30.635144351950437
STAT,1841,31,50-100,1872,0.010994859406985875
STAT,1900,1,na,1901,37.74363224624708
STAT,1838,51,50-100,1889,1.1892763431879646E-4
STAT,1927,39,25-29,1966,0.012153194827886652
STAT,1929,36,25-29,1965,0.012591749185942532
STAT,1930,41,45-49,1971,0.00218269328766242
STAT,1937,22,15-19,1959,0.051510241863431956
SIM,1941,9,na,1950,48
SIM,1884,58,na,1942,20
STAT,1826,44,na,1870,18.47639093452411
STAT,1913,24,25-29,1937,0.9191569513552391
SIM,1813,46,na,1859,12
STAT,1885,79,na,1964,9.585114738830965
STAT,1922,45,50-100,1967,0.0025914860892565375
SIM,1921,24,25-29,1945,2
STAT,1829,105,na,1934,1.9916124803418973E-4
STAT,1936,33,50-100,1969,0.007977244490153561
STAT,1849,20,20-24,1869,0.6554128428820851
STAT,1930,21,20-24,1951,1.4220954690673575
SIM,1880,68,na,1948,25
STAT,1942,17,na,1959,38.18518357200981
SIM,1955,12,na,1967,46
STAT,1951,9,na,1960,46.5109502009462
SIM,1850,46,na,1896,20
STAT,1928,37,20-24,1965,0.0033151863498317984
STAT,1900,40,20-24,1940,1.5447058129090056E-4
STAT,1818,49,na,1867,6.829555771858935
STAT,1813,46,25-29,1859,0.0018120898311673674
SIM,1923,21,25-29,1944,2
STAT,1933,36,45-49,1969,0.009256081799658686
STAT,1805,50,na,1855,9.871512129455228
STAT,1914,22,20-24,1936,1.1266060693605413
SIM,1868,21,35-39,1889,1
STAT,1822,54,na,1876,8.226167340337453
SIM,1880,44,na,1924,32
SIM,1888,19,20-24,1907,1
STAT,1917,10,na,1927,42.23990951647094
STAT,1916,38,40-44,1954,0.015123582923281064
STAT,1838,20,45-49,1858,0.0071237536363233
STAT,1887,15,45-49,1902,7.163128998948479E-4
STAT,1894,22,25-29,1916,0.7336551150637476
STAT,1845,19,50-100,1864,3.577098155522227E-4
STAT,1948,16,40-44,1964,0.015905763700554472
STAT,1852,52,na,1904,18.329746279590772
STAT,1827,85,na,1912,1.661303055797562
STAT,1880,37,25-29,1917,0.030276287021500294
STAT,1917,37,45-49,1954,0.007016431246255621
STAT,1837,21,40-44,1858,0.01519892854905306
STAT,1872,80,na,1952,6.329292928013547
STAT,1934,34,40-44,1968,0.05313521652474804
STAT,1915,21,25-29,1936,0.9494245128111028
STAT,1916,30,30-34,1946,0.162566378601548
SIM,1830,26,na,1856,18
STAT,1844,31,25-29,1875,0.0966705953406954
STAT,1917,18,na,1935,41.07663246063138
STAT,1924,44,25-29,1968,8.410578453615295E-4
SIM,1901,55,na,1956,31
STAT,1812,47,20-24,1859,1.347767596397609E-4
STAT,1856,25,50-100,1881,0.004871742280544066
STAT,1838,69,na,1907,11.390288688267061
STAT,1913,26,20-24,1939,0.18098143162263927
STAT,1814,67,na,1881,8.338056615001532
STAT,1946,19,40-44,1965,0.015393998159234465
STAT,1845,18,45-49,1863,4.7977227946233023E-4
STAT,1921,23,na,1944,40.798338377056396
STAT,1935,33,45-49,1968,0.021660344163638084
STAT,1906,66,na,1972,27.581164390733676
STAT,1913,37,30-34,1950,0.01783579831190876
STAT,1896,30,35-39,1926,0.1340919125232911
STAT,1918,46,20-24,1964,1.1682656008432996E-4
SIM,1867,8,na,1875,19
STAT,1867,31,50-100,1898,0.008803940638529885
STAT,1907,15,40-44,1922,0.002687847711624791
STAT,1929,43,na,1972,47.79104242948763
STAT,1942,28,40-44,1970,0.04854060248658558
STAT,1851,11,na,1862,24.615078992980212
STAT,1942,20,30-34,1962,0.29936124183520463
SIM,1867,0,na,1867,35
SIM,1889,81,na,1970,13
STAT,1864,85,na,1949,2.458774434683016
STAT,1922,47,25-29,1969,6.049281001294464E-4
SIM,1905,61,na,1966,38
STAT,1946,23,na,1969,40.33752842759946
STAT,1889,40,45-49,1929,0.018508734312792405
STAT,1940,26,35-39,1966,0.1520789901288257
STAT,1868,75,na,1943,9.962570894036638
SIM,1850,38,na,1888,21
STAT,1875,77,na,1952,8.885451361354507
STAT,1859,39,na,1898,18.53723853334606
STAT,1924,43,40-44,1967,0.0029511278323836416
STAT,1917,29,15-19,1946,0.007283727811403296
STAT,1955,6,na,1961,51.89269065960869
SIM,1843,76,na,1919,14
STAT,1809,88,na,1897,0.7596064145199177
STAT,1948,19,45-49,1967,0.005675233616320124
STAT,1784,71,na,1855,8.186130000000002
SIM,1884,6,na,1890,28
SIM,1833,66,na,1899,4
SIM,1857,20,20-24,1877,1
STAT,1859,25,35-39,1884,0.07914755929688391
STAT,1904,31,20-24,1935,0.038890159892757965
STAT,1859,31,na,1890,19.044313596199462
STAT,1863,44,na,1907,20.187440651085534
SIM,1866,26,30-34,1892,1
SIM,1855,69,na,1924,8
SIM,1860,48,na,1908,20
STAT,1928,35,25-29,1963,0.012404000041788972
STAT,1902,23,40-44,1925,0.0292947925387336
STAT,1869,32,50-100,1901,0.008877882496051476
STAT,1794,73,na,1867,5.701215906822275
STAT,1918,33,45-49,1951,0.016500142434703328
STAT,1819,98,na,1917,0.016675722155981874
STAT,1890,44,30-34,1934,0.013776551329101362
STAT,1909,43,45-49,1952,0.0015386561394736785
STAT,1870,21,25-29,1891,0.5703882385483573
STAT,1888,17,50-100,1905,5.725181306524364E-4
STAT,1899,23,50-100,1922,0.005565130480966979
SIM,1818,77,na,1895,8
STAT,1859,42,50-100,1901,0.00838652010891163
STAT,1853,21,25-29,1874,0.4281669929949606
STAT,1851,21,15-19,1872,0.0335005144369573
STAT,1920,18,50-100,1938,0.004156725805335504
STAT,1898,3,na,1901,35.662747884138405
STAT,1801,60,na,1861,9.576014492832106
STAT,1892,49,na,1941,27.21943256072452
STAT,1885,35,50-100,1920,0.012239286043104198
SIM,1896,4,na,1900,33
STAT,1852,60,na,1912,16.32256311105215
SIM,1931,15,25-29,1946,3
STAT,1908,44,40-44,1952,0.0022738423588313556
SIM,1951,19,15-19,1970,3
STAT,1903,25,50-100,1928,0.00915642048629428
SIM,1873,74,na,1947,3
STAT,1808,47,na,1855,4.929422503632136
STAT,1907,27,35-39,1934,0.14113985099123627
STAT,1858,26,30-34,1884,0.19757948997481162
STAT,1907,43,40-44,1950,0.002268230560198038
STAT,1817,83,na,1900,3.146273673129728
STAT,1940,15,25-29,1955,0.43710724628027886
STAT,1919,45,25-29,1964,5.730461345705269E-4
STAT,1895,48,25-29,1943,4.1651849356040083E-4
STAT,1900,29,45-49,1929,0.015286332647370202
STAT,1923,28,30-34,1951,0.4451706065312963
STAT,1869,16,35-39,1885,0.005422229683972392
STAT,1922,27,30-34,1949,0.4401275224438853
STAT,1923,15,25-29,1938,0.5076819566425909
STAT,1848,55,na,1903,13.371898682672182
STAT,1922,16,20-24,1938,1.5613667442544081
STAT,1944,19,30-34,1963,0.13013175839090363
SIM,1930,16,20-24,1946,1
STAT,1826,34,50-100,1860,0.011425370485970811
STAT,1879,18,15-19,1897,0.061262265180841824
SIM,1831,67,na,1898,4
SIM,1897,25,na,1922,41
STAT,1871,31,na,1902,23.888756932336836
SIM,1893,11,na,1904,39
SIM,1898,21,20-24,1919,2
STAT,1834,21,15-19,1855,0.03140548146949954
STAT,1924,27,35-39,1951,0.17367121764611798
STAT,1923,26,35-39,1949,0.17176565214440076
STAT,1812,52,na,1864,11.274830343171711
STAT,1868,15,35-39,1883,0.005470503648846852
SIM,1930,27,30-34,1957,1
STAT,1923,38,na,1961,43.246455069340165
STAT,1934,29,15-19,1963,0.009447202043884887
SIM,1941,30,30-34,1971,3
STAT,1852,39,15-19,1891,4.757608090599677E-4
SIM,1852,80,na,1932,18
STAT,1933,17,35-39,1950,0.05594262340579011
SIM,1924,33,35-39,1957,1
SIM,1863,13,na,1876,17
STAT,1909,23,na,1932,35.15979119273623
STAT,1917,34,40-44,1951,0.04025858768656345
STAT,1867,16,30-34,1883,0.015685223310726172
STAT,1842,82,na,1924,3.5006697562285622
STAT,1910,17,40-44,1927,0.002754579628926469
SIM,1905,22,20-24,1927,1
STAT,1877,26,40-44,1903,0.031028155880909614
SIM,1901,23,na,1924,40
STAT,1872,29,na,1901,24.24367329403931
STAT,1848,36,50-100,1884,0.008267533483084592
STAT,1916,33,35-39,1949,0.0931458684508097
STAT,1876,62,na,1938,18.5632736558166
STAT,1946,16,30-34,1962,0.13427521412576887
SIM,1914,28,30-34,1942,1
STAT,1880,34,20-24,1914,0.028180742093983493
STAT,1907,48,40-44,1955,0.0013948453433995447
STAT,1936,29,25-29,1965,0.6254829474139914
STAT,1914,53,na,1967,35.36458197854464
STAT,1934,3,na,1937,54.62991711335335
SIM,1801,69,na,1870,5
STAT,1931,22,20-24,1953,1.4357827004526265
STAT,1887,40,35-39,1927,0.019964610283532788
STAT,1933,30,30-34,1963,0.2116951359741599
SIM,1954,16,30-34,1970,2
STAT,1797,78,na,1875,2.7364944367503212
STAT,1863,36,na,1899,20.96016479407476
SIM,1862,79,na,1941,8
STAT,1906,19,40-44,1925,0.002642994323057669
SIM,1928,8,na,1936,55
STAT,1920,38,na,1958,40.799971109608265
STAT,1921,15,15-19,1936,0.5156597870388295
STAT,1813,43,20-24,1856,0.005244187459183511
STAT,1907,40,30-34,1947,0.0011795758427568563
SIM,1835,49,na,1884,17
SIM,1888,3,na,1891,40
STAT,1843,15,30-34,1858,0.008742898203423725
STAT,1919,47,20-24,1966,1.1882535740759046E-4
SIM,1869,69,na,1938,10
STAT,1942,26,45-49,1968,0.018008275378315522
STAT,1906,58,na,1964,30.544128945082154
SIM,1916,45,na,1961,44
STAT,1842,50,na,1892,16.38691468522845
STAT,1927,28,na,1955,45.15036479445793
SIM,1895,10,na,1905,31
STAT,1789,94,na,1883,0.027225536321291984
STAT,1901,42,35-39,1943,0.0017573672407636802
SIM,1879,29,20-24,1908,1
SIM,1894,36,na,1930,29
STAT,1923,34,35-39,1957,0.10390268356672556
STAT,1879,23,40-44,1902,0.0215009858702628
STAT,1902,44,na,1946,32.26389448068796
STAT,1868,67,na,1935,15.340871110947775
STAT,1903,19,15-19,1922,0.08392099967390368
STAT,1851,67,na,1918,13.382898955287812
STAT,1846,40,50-100,1886,0.008890340089891209
STAT,1943,24,40-44,1967,0.035488356616134156
STAT,1896,41,50-100,1937,9.679989636923994E-4
SIM,1818,69,na,1887,12
STAT,1838,22,40-44,1860,0.020983344021089246
STAT,1933,38,40-44,1971,0.020286448695399643
STAT,1855,57,na,1912,14.149205300225786
SIM,1924,40,na,1964,50
STAT,1837,40,50-100,1877,0.006228150432920348
STAT,1939,26,40-44,1965,0.04655694885964635
STAT,1860,4,na,1864,24.991390067998044
STAT,1870,48,20-24,1918,1.1770879894385991E-4
STAT,1871,95,na,1966,0.4855500822776212
SIM,1854,28,na,1882,19
STAT,1905,32,20-24,1937,0.022400497428250746
STAT,1860,79,na,1939,5.683534898154277
STAT,1877,0,na,1877,37.689402320903135
STAT,1916,36,45-49,1952,0.006954826996655122
STAT,1906,42,50-100,1948,0.0010645052600179868
STAT,1897,24,na,1921,31.21017863365701
SIM,1875,1,na,1876,29
STAT,1884,38,na,1922,22.968241881608037
STAT,1902,21,45-49,1923,0.009863224023034687
STAT,1913,41,45-49,1954,0.0016186984890219711
STAT,1830,49,35-39,1879,1.3519230563415954E-4
SIM,1933,25,na,1958,49
STAT,1937,27,20-24,1964,0.17681482306658225
STAT,1942,18,50-100,1960,0.003885535874923757
STAT,1899,27,30-34,1926,0.3447234934578359
STAT,1880,24,na,1904,24.71405290292209
STAT,1849,23,25-29,1872,0.5328079935705042
STAT,1908,8,na,1916,38.36142415010409
STAT,1880,16,na,1896,26.623316548073586
SIM,1903,8,na,1911,39
STAT,1850,26,na,1876,22.83026965114905
STAT,1827,31,25-29,1858,0.09349635481607836
STAT,1919,35,50-100,1954,0.0044963672014153
STAT,1885,47,na,1932,22.11393164007399
SIM,1863,3,na,1866,28
STAT,1930,6,na,1936,51.575655326973745
STAT,1804,100,na,1904,0.004121642791819742
STAT,1924,12,na,1936,46.87718831977436
STAT,1798,63,na,1861,15.695278201364175
SIM,1859,59,na,1918,16
SIM,1934,10,na,1944,54
SIM,1907,5,na,1912,41
SIM,1941,12,na,1953,48
SIM,1908,58,na,1966,33
STAT,1904,34,25-29,1938,0.08355114476932536
STAT,1923,23,30-34,1946,0.33107415737669366
STAT,1921,18,25-29,1939,0.4888271839789202
SIM,1814,87,na,1901,6
STAT,1911,29,20-24,1940,0.1756035565546946
STAT,1924,41,20-24,1965,2.0899890132953722E-4
STAT,1857,9,na,1866,21.436523209940503
SIM,1852,9,na,1861,29
STAT,1862,38,20-24,1900,0.006617624523235348
STAT,1875,50,50-100,1925,1.5747850279326588E-4
STAT,1878,22,40-44,1900,0.021513608211221485
STAT,1827,93,na,1920,0.17711104656910803
STAT,1830,100,na,1930,0.0038144067679017563
STAT,1791,73,na,1864,4.637082942335235
STAT,1862,22,50-100,1884,0.003601615244167289
STAT,1897,19,20-24,1916,0.23416444288052257
STAT,1936,26,15-19,1962,0.006718267063417793
STAT,1891,27,50-100,1918,0.00785135279258306
STAT,1932,34,30-34,1966,0.20832520827834441
SIM,1876,31,na,1907,29
STAT,1905,18,40-44,1923,0.0026328164771095616
STAT,1908,23,35-39,1931,0.0858479082660312
STAT,1918,30,40-44,1948,0.041539387744571124
STAT,1940,24,15-19,1964,0.05380541029206448
STAT,1842,39,na,1881,18.481703150644577
STAT,1886,30,50-100,1916,0.009580300210598481
STAT,1855,48,30-34,1903,6.729760150198399E-4
STAT,1876,22,30-34,1898,0.18090969677702126
STAT,1901,35,na,1936,33.54214447062723
STAT,1822,62,na,1884,6.779847855227528
STAT,1830,49,na,1879,8.459935336185616
SIM,1802,54,na,1856,11
STAT,1853,38,50-100,1891,0.007677860609020908
STAT,1898,37,50-100,1935,0.016562260499638767
SIM,1883,33,na,1916,14
STAT,1836,25,40-44,1861,0.03795120782384834
STAT,1893,74,na,1967,17.47515415976004
STAT,1832,46,35-39,1878,7.539825370606022E-4
SIM,1873,66,na,1939,15
SIM,1825,79,na,1904,4
SIM,1820,48,na,1868,14
STAT,1893,34,na,1927,29.830850417069925
STAT,1918,49,25-29,1967,5.560980225234235E-4
STAT,1829,30,45-49,1859,0.017130409171522018
STAT,1877,46,50-100,1923,0.0025424311500880296
STAT,1884,16,30-34,1900,0.01565432003384482
SIM,1865,79,na,1944,2
STAT,1935,25,15-19,1960,0.00958874646287287
SIM,1821,57,na,1878,10
STAT,1827,45,50-100,1872,0.0018999522611754822
SIM,1828,36,na,1864,18
STAT,1856,18,20-24,1874,0.15096727127184129
SIM,1868,44,na,1912,32
STAT,1882,82,na,1964,6.97315441925997
SIM,1847,26,na,1873,21
STAT,1870,46,na,1916,22.413116220471462
STAT,1919,42,20-24,1961,1.897228119338422E-4
STAT,1924,24,30-34,1948,0.3348277039886509
STAT,1902,26,45-49,1928,0.015711078279460503
STAT,1873,47,35-39,1920,0.0014167338508389107
SIM,1898,24,25-29,1922,1
STAT,1926,40,40-44,1966,0.003074404397422632
STAT,1911,39,50-100,1950,0.0039885611595257995
STAT,1928,16,15-19,1944,0.5704442496883061
STAT,1854,47,25-29,1901,3.5042999414350756E-4
STAT,1804,57,na,1861,12.187654809059053
STAT,1927,33,50-100,1960,0.010112335110971262
STAT,1914,34,15-19,1948,0.0012718241050568308
STAT,1922,19,25-29,1941,0.49518096143371776
SIM,1909,51,na,1960,33
SIM,1891,20,na,1911,37
STAT,1870,36,50-100,1906,0.012254957684462902
STAT,1909,24,50-100,1933,0.006043102584063128
SIM,1805,59,na,1864,14
STAT,1903,19,20-24,1922,0.25070070756245105
STAT,1862,15,40-44,1877,0.0018287903827514274
SIM,1839,39,na,1878,20
STAT,1866,49,45-49,1915,0.0021281350995539117
SIM,1925,14,na,1939,45
STAT,1918,49,50-100,1967,0.002371140196098167
SIM,1846,41,na,1887,14
STAT,1856,42,na,1898,16.722777731730957
STAT,1874,17,25-29,1891,0.057488473217971466
STAT,1885,87,na,1972,4.561751891754697
STAT,1780,81,na,1861,3.666201188493839
STAT,1920,31,35-39,1951,0.09965034228484661
STAT,1935,15,na,1950,50.32788714986731
STAT,1877,36,na,1913,24.4368875217588
STAT,1942,23,35-39,1965,0.09797370150022598
STAT,1903,61,na,1964,28.53059874096137
SIM,1911,14,na,1925,42
STAT,1924,20,na,1944,43.06588169577582
STAT,1910,33,40-44,1943,0.03734410103954899
STAT,1867,21,20-24,1888,0.6669709604314165
STAT,1821,77,na,1898,5.368641050315038
SIM,1866,61,na,1927,27
SIM,1856,54,na,1910,9
SIM,1946,23,20-24,1969,3
STAT,1894,44,50-100,1938,9.27512843609126E-4
STAT,1814,43,50-100,1857,0.03254139594921658
SIM,1938,1,na,1939,41
STAT,1914,13,na,1927,40.45133845616454
STAT,1843,18,35-39,1861,0.002956978733847843
STAT,1912,40,45-49,1952,0.0016106586189262298
STAT,1925,26,45-49,1951,0.020346981749636377
STAT,1860,39,50-100,1899,0.009880757126957304
STAT,1938,23,20-24,1961,1.0928801369769594
STAT,1938,29,50-100,1967,0.0097862847981898
SIM,1877,24,na,1901,27
STAT,1867,32,30-34,1899,0.1670826098684057
STAT,1883,46,40-44,1929,0.001667211586269596
STAT,1829,32,40-44,1861,0.041446598547682886
STAT,1873,14,na,1887,26.42965620651047
SIM,1828,47,na,1875,13
STAT,1785,88,na,1873,1.3055630299896472
SIM,1940,27,na,1967,35
STAT,1897,48,35-39,1945,0.0010355313527178151
STAT,1860,47,na,1907,18.205319811073164
SIM,1822,42,na,1864,18
SIM,1926,3,na,1929,50
SIM,1929,26,25-29,1955,1
STAT,1781,74,na,1855,6.366989999999998
STAT,1854,24,45-49,1878,0.004936364731795479
STAT,1854,33,50-100,1887,0.005675917522036071
STAT,1871,21,40-44,1892,0.020838304843583868
STAT,1836,20,35-39,1856,0.07540384790798373
STAT,1836,106,na,1942,1.1718006606139995E-4
STAT,1839,18,15-19,1857,0.042589659544228026
STAT,1931,37,25-29,1968,0.012982086783943362
STAT,1890,47,40-44,1937,0.0011675826046696255
STAT,1882,50,na,1932,20.931278665980976
STAT,1824,96,na,1920,0.05974700198250046
SIM,1858,66,na,1924,18
STAT,1933,33,35-39,1966,0.12257363702203004
STAT,1907,24,30-34,1931,0.25891836392962625
STAT,1928,39,40-44,1967,0.018786227959354238
STAT,1886,64,na,1950,18.031406206017447
STAT,1896,21,45-49,1917,0.009187223415942953
STAT,1785,100,na,1885,0.006321327551318217
STAT,1854,44,20-24,1898,9.576179591657613E-4
STAT,1840,45,50-100,1885,0.0019910748289127867
STAT,1855,22,40-44,1877,0.0171399164309867
STAT,1837,47,25-29,1884,2.910462637095498E-4
STAT,1855,17,15-19,1872,0.0496971636295831
STAT,1926,24,40-44,1950,0.04036088901860163
STAT,1937,19,na,1956,35.47608607572619
SIM,1842,59,na,1901,19
STAT,1856,44,30-34,1900,0.008216159880495802
STAT,1902,39,20-24,1941,0.0023226678008810356
SIM,1828,44,na,1872,16
STAT,1816,41,15-19,1857,1.9466687716909232E-4
STAT,1907,43,35-39,1950,0.0018260735663844954
STAT,1937,25,25-29,1962,0.6381162475150759
STAT,1900,18,na,1918,34.93036733456945
SIM,1810,49,na,1859,18
SIM,1875,46,na,1921,15
STAT,1842,45,40-44,1887,0.001318035786066008
STAT,1864,1,na,1865,32.367690287658405
STAT,1947,16,25-29,1963,0.4849554623709473
STAT,1859,102,na,1961,0.006394362529163321
SIM,1847,18,na,1865,23
STAT,1835,41,25-29,1876,0.0035309106681329296
SIM,1879,28,na,1907,13
STAT,1856,21,45-49,1877,0.005909425431717082
SIM,1843,36,na,1879,22
STAT,1841,19,50-100,1860,6.112161423297003E-4
SIM,1818,37,na,1855,26
SIM,1862,2,na,1864,29
STAT,1866,23,25-29,1889,0.5277099823011444
STAT,1841,89,na,1930,1.0282794690079933
SIM,1902,7,na,1909,38
STAT,1800,83,na,1883,1.2564625690440399
STAT,1896,23,40-44,1919,0.027287001020000843
STAT,1938,34,30-34,1972,0.15717132206208217
STAT,1877,29,45-49,1906,0.011379311213483729
STAT,1901,33,50-100,1934,0.012766636383553989
SIM,1818,38,45-49,1856,1
STAT,1896,15,50-100,1911,6.465158779394996E-4
STAT,1841,36,35-39,1877,0.08241888647183432
STAT,1957,15,na,1972,48.28081132620386
STAT,1802,85,na,1887,0.7909816010450542
STAT,1905,47,25-29,1952,4.6674022705897573E-4
STAT,1851,99,na,1950,0.015988610862241986
STAT,1888,29,20-24,1917,0.13611367602626162
STAT,1910,31,45-49,1941,0.01514157191017779
STAT,1828,34,45-49,1862,0.007711604771423929
STAT,1883,13,na,1896,25.039396089715098
STAT,1864,44,50-100,1908,0.00934765647344903
STAT,1832,31,50-100,1863,0.0054104773942952105
STAT,1883,38,50-100,1921,0.011863247381100754
SIM,1899,56,na,1955,26
STAT,1922,32,20-24,1954,0.02735770492820974
STAT,1834,95,na,1929,0.09395896653511407
SIM,1845,48,na,1893,22
SIM,1857,25,na,1882,23
STAT,1822,33,20-24,1855,0.02057007953217565
STAT,1920,19,15-19,1939,0.5021334795181062
SIM,1853,11,na,1864,29
STAT,1845,31,40-44,1876,0.03045614101629867
SIM,1900,30,na,1930,35
STAT,1906,44,30-34,1950,0.0011442042403461041
STAT,1936,26,20-24,1962,0.17371518981838033
STAT,1939,29,45-49,1968,0.01723145495125985
STAT,1921,34,25-29,1955,0.1011802537574542
SIM,1911,22,na,1933,39
STAT,1867,45,45-49,1912,0.002280942475497936
STAT,1862,18,45-49,1880,6.416661356542892E-4
STAT,1895,25,45-49,1920,0.014512361534224008
STAT,1906,26,35-39,1932,0.1406622244544514
STAT,1861,31,25-29,1892,0.08648775171622022
STAT,1909,31,na,1940,36.03521356104327
STAT,1921,15,20-24,1936,1.5404520200482974
STAT,1886,61,na,1947,19.382727288052603
SIM,1859,20,25-29,1879,2
STAT,1952,17,45-49,1969,0.005950952154121605
STAT,1906,31,25-29,1937,0.08579369211787992
STAT,1900,43,25-29,1943,6.138920770972281E-4
SIM,1881,21,na,1902,18
STAT,1892,6,na,1898,32.273261770101975
STAT,1858,14,na,1872,21.02754462233927
STAT,1895,18,50-100,1913,6.343732044843213E-4
STAT,1908,29,50-100,1937,0.009293564178816272
STAT,1928,13,na,1941,49.604644548321325
STAT,1855,20,45-49,1875,0.005818926758232729
SIM,1881,61,na,1942,15
STAT,1911,32,45-49,1943,0.015224149356428825
STAT,1835,21,30-34,1856,0.15722658921463295
STAT,1848,47,na,1895,14.481883385590546
STAT,1867,90,na,1957,0.9548490077075045
SIM,1916,53,na,1969,44
STAT,1953,1,na,1954,48.326810695419546
SIM,1928,25,25-29,1953,4
SIM,1853,43,na,1896,23
SIM,1842,51,na,1893,20
SIM,1945,25,25-29,1970,1
SIM,1932,16,na,1948,48
STAT,1883,32,15-19,1915,0.0013828945236770958
STAT,1835,40,na,1875,11.624325778752063
STAT,1822,36,25-29,1858,0.01816012903024807
STAT,1886,72,na,1958,14.025844236715006
STAT,1925,44,40-44,1969,0.00299927322980705
SIM,1921,24,na,1945,35
STAT,1905,44,20-24,1949,1.5701659686509048E-4
SIM,1943,18,20-24,1961,3
STAT,1914,21,na,1935,37.21465340876883
SIM,1901,15,na,1916,41
STAT,1925,39,15-19,1964,2.2855250781971686E-4
STAT,1935,18,20-24,1953,1.8403479223391004
STAT,1879,30,35-39,1909,0.10565867294711255
STAT,1922,24,50-100,1946,0.007443549403847785
SIM,1853,14,na,1867,29
STAT,1857,83,na,1940,2.9718765485808527
SIM,1914,31,25-29,1945,1
STAT,1906,15,25-29,1921,0.08270963165368975
SIM,1857,28,na,1885,23
STAT,1853,77,na,1930,5.4325422567671495
STAT,1920,34,45-49,1954,0.016943062168694636
SIM,1862,28,na,1890,24
STAT,1783,78,na,1861,1.5451624621671538
STAT,1937,27,na,1964,36.28670855024606
STAT,1836,28,45-49,1864,0.013765757884400855
STAT,1926,43,45-49,1969,0.0020367846594469574
SIM,1807,85,na,1892,2
STAT,1845,49,50-100,1894,0.0014056766202341531
STAT,1836,22,30-34,1858,0.22687024654510546
STAT,1901,34,35-39,1935,0.14049167365493875
STAT,1914,41,30-34,1955,0.0012581152642206846
STAT,1935,29,30-34,1964,0.5312159898479104
STAT,1951,16,45-49,1967,0.00591418823158641
STAT,1932,16,35-39,1948,0.05547420920058959
STAT,1801,68,na,1869,7.106208250216934
STAT,1847,23,15-19,1870,0.04289232073548445
STAT,1844,54,na,1898,16.355794579773956
STAT,1911,18,50-100,1929,7.429376555243457E-4
STAT,1901,23,25-29,1924,0.7985449401963958
STAT,1872,22,40-44,1894,0.021320911142250296
STAT,1895,46,na,1941,29.29705050486732
STAT,1914,38,30-34,1952,0.01795694410993928
STAT,1884,19,35-39,1903,0.005347158200715847
STAT,1894,6,na,1900,33.479759240151395
STAT,1941,27,40-44,1968,0.04786737149118589
STAT,1837,21,35-39,1858,0.04256294675227515
SIM,1894,28,na,1922,29
STAT,1783,89,na,1872,0.19038479819280246
STAT,1948,19,50-100,1967,0.004256425212240092
SIM,1890,35,na,1925,26
STAT,1869,35,45-49,1904,0.019499161726600288
SIM,1890,46,na,1936,24
STAT,1875,24,50-100,1899,0.0041656078595778525
STAT,1828,70,na,1898,9.423172087189135
STAT,1861,36,50-100,1897,0.01037446423492739
STAT,1921,27,50-100,1948,0.011006688493433807
SIM,1807,74,na,1881,12
STAT,1815,43,30-34,1858,0.017351659894923908
STAT,1866,46,40-44,1912,0.0015811970194718882
STAT,1878,48,25-29,1926,5.872004246042378E-4
STAT,1946,19,35-39,1965,0.046181991803821
STAT,1898,30,45-49,1928,0.02371326713046363
STAT,1912,37,15-19,1949,1.859613756336945E-4
STAT,1832,29,na,1861,12.748631632866845
STAT,1901,22,35-39,1923,0.08165406308802059
SIM,1899,22,20-24,1921,1
STAT,1903,69,na,1972,24.892238070855846
STAT,1852,21,30-34,1873,0.1824085348421898
SIM,1935,35,na,1970,57
STAT,1840,59,na,1899,15.22881466922808
STAT,1842,31,15-19,1873,0.0013041921688725152
STAT,1882,34,30-34,1916,0.16589155344040438
STAT,1831,47,30-34,1878,9.267538852223158E-4
STAT,1925,42,45-49,1967,0.0020023413766979596
SIM,1854,9,na,1863,19
STAT,1925,23,40-44,1948,0.039871701183192755
STAT,1838,77,na,1915,6.708950605471293
SIM,1941,20,na,1961,45
SIM,1792,67,na,1859,7
STAT,1932,30,15-19,1962,0.0017032928359185118
STAT,1863,37,25-29,1900,0.02549234306780725
SIM,1852,18,na,1870,29
STAT,1898,18,25-29,1916,0.07624393192117414
STAT,1854,21,40-44,1875,0.015073720687879832
STAT,1821,37,na,1858,17.740309756817396
STAT,1929,19,35-39,1948,0.05300967523460401
STAT,1894,9,na,1903,33.252607276402124
STAT,1837,44,20-24,1881,8.091685023598899E-4
STAT,1931,34,20-24,1965,0.03177843378502995
STAT,1825,31,15-19,1856,0.0018021016781426856
STAT,1872,72,na,1944,12.921564378634539
SIM,1931,13,na,1944,62
STAT,1804,97,na,1901,0.02085674860437461
STAT,1942,24,25-29,1966,0.960778102568044
SIM,1935,27,na,1962,53
STAT,1795,66,na,1861,9.406324797143316
STAT,1892,22,15-19,1914,0.04075639503704207
STAT,1951,1,na,1952,48.1595941205983
STAT,1802,53,na,1855,9.80301436703342
STAT,1857,29,50-100,1886,0.004861950075874944
STAT,1774,96,na,1870,0.006344103011178336
STAT,1840,70,na,1910,10.99436645077264
STAT,1912,28,25-29,1940,0.6412921835462279
SIM,1920,50,na,1970,41
STAT,1927,36,20-24,1963,0.0032636924854463406
STAT,1920,22,45-49,1942,0.012402329496660201
STAT,1813,93,na,1906,0.1928746033408506
STAT,1841,33,30-34,1874,0.20520872488099698
STAT,1940,28,30-34,1968,0.39652870978916094
STAT,1885,32,25-29,1917,0.10114723451883299
SIM,1880,36,na,1916,32
SIM,1846,33,na,1879,15
STAT,1826,44,45-49,1870,0.015287817843871314
STAT,1867,24,25-29,1891,0.544388491730856
STAT,1886,19,45-49,1905,6.739346780319503E-4
STAT,1900,36,50-100,1936,0.003692358853234379
STAT,1845,22,50-100,1867,0.002959252050019356
STAT,1856,47,35-39,1903,0.0010094784054090076
STAT,1883,49,45-49,1932,0.002243902215492612
STAT,1865,41,50-100,1906,0.009598709856882718
STAT,1877,21,35-39,1898,0.060419250192889885
STAT,1893,35,45-49,1928,0.02537413668330016
SIM,1890,43,na,1933,24
STAT,1835,34,50-100,1869,0.0051905662597990995
STAT,1925,40,25-29,1965,8.615208581548542E-4
STAT,1940,31,30-34,1971,0.16199575107740882
STAT,1827,29,na,1856,17.708440465383912
STAT,1866,20,20-24,1886,0.649141724393969
SIM,1925,4,na,1929,45
STAT,1937,29,40-44,1966,0.045104041606251144
STAT,1818,41,25-29,1859,0.007120411598534099
STAT,1922,35,25-29,1957,0.011140781587719055
SIM,1920,39,na,1959,43
STAT,1827,47,50-100,1874,0.0018515944200096209
SIM,1817,52,na,1869,7
STAT,1874,29,50-100,1903,0.0064432417608895195
STAT,1918,29,30-34,1947,0.4102620201476106
STAT,1842,48,45-49,1890,0.0017484099371432537
STAT,1793,88,na,1881,0.25495725975273037
STAT,1923,44,30-34,1967,0.0014789673036251002
STAT,1926,27,45-49,1953,0.020591660897204205
STAT,1828,31,40-44,1859,0.06058447738008716
STAT,1896,31,na,1927,31.473150386120235
STAT,1908,39,15-19,1947,1.7706122661025766E-4
STAT,1909,26,50-100,1935,0.009572145251180135
STAT,1932,21,25-29,1953,1.2107055387760446
STAT,1857,42,15-19,1899,1.0325421467301419E-4
STAT,1874,27,50-100,1901,0.006489624320767719
STAT,1918,18,20-24,1936,1.4584722483053596
STAT,1897,56,na,1953,27.085429986880623
STAT,1918,25,15-19,1943,0.007495413736176362
STAT,1872,2,na,1874,33.78355828567461
STAT,1893,42,na,1935,29.106020410620246
STAT,1916,45,35-39,1961,0.0013172739227974945
STAT,1863,34,20-24,1897,0.023727914352743015
STAT,1912,43,na,1955,35.32620401204968
SIM,1874,20,20-24,1894,3
STAT,1877,23,30-34,1900,0.18330110612914466
STAT,1911,45,20-24,1956,1.0443605159287093E-4
SIM,1926,18,20-24,1944,3
STAT,1852,34,45-49,1886,0.015134907792171621
STAT,1928,32,15-19,1960,0.0015989556353529358
STAT,1800,103,na,1903,5.200725796164345E-4
STAT,1897,45,30-34,1942,7.323359628568646E-4
SIM,1822,74,na,1896,9
STAT,1839,62,na,1901,10.08644710454339
STAT,1921,31,20-24,1952,0.027042466600010435
STAT,1916,34,25-29,1950,0.09379780767663831
STAT,1915,37,40-44,1952,0.014992030034268269
STAT,1825,59,na,1884,11.197396178917103
SIM,1910,51,na,1961,28
STAT,1888,24,15-19,1912,0.03831098560495796
STAT,1839,21,45-49,1860,0.004980254437560999
STAT,1856,34,20-24,1890,0.019414206906347754
STAT,1938,26,25-29,1964,0.6480778178133956
SIM,1907,17,na,1924,41
STAT,1907,18,45-49,1925,9.530025322190653E-4
STAT,1946,18,50-100,1964,0.004124835053643539
STAT,1882,37,35-39,1919,0.06778290297550396
SIM,1952,15,15-19,1967,2
SIM,1822,82,na,1904,6
SIM,1859,51,na,1910,18
SIM,1807,82,na,1889,6
STAT,1815,46,35-39,1861,0.002046802777592742
SIM,1879,90,na,1969,1
STAT,1836,31,50-100,1867,0.011293764446547694
STAT,1900,26,40-44,1926,0.0416814957717316
SIM,1845,70,na,1915,18
STAT,1906,23,30-34,1929,0.25798003947405446
STAT,1893,49,50-100,1942,0.001710333076413965
STAT,1850,18,na,1868,24.827580258811125
SIM,1929,20,na,1949,46
STAT,1907,7,na,1914,38.10988810021315
STAT,1911,16,45-49,1927,9.956249683721022E-4
STAT,1845,34,45-49,1879,0.011870998758666047
SIM,1888,64,na,1952,25
SIM,1924,3,na,1927,56
STAT,1895,22,40-44,1917,0.027053157255310583
STAT,1922,18,40-44,1940,0.016026860602587564
STAT,1935,30,40-44,1965,0.05396155082129848
STAT,1923,35,na,1958,43.365167530009856
STAT,1904,19,30-34,1923,0.022715929103138625
STAT,1897,35,20-24,1932,0.010333746960454828
STAT,1881,42,50-100,1923,0.010040222201777535
STAT,1913,28,na,1941,36.884481165131874
STAT,1852,24,35-39,1876,0.05848085415296271
STAT,1839,104,na,1943,3.680882931752258E-4
STAT,1919,26,15-19,1945,0.0075875758152709515
STAT,1902,65,na,1967,26.60982724181276
STAT,1847,28,20-24,1875,0.14954637944785973
STAT,1878,45,20-24,1923,1.2512524228813296E-4
SIM,1856,62,na,1918,9
STAT,1816,39,50-100,1855,0.018066442799478857
STAT,1815,40,50-100,1855,0.017017657720567424
STAT,1913,21,15-19,1934,0.05130504204773947
STAT,1834,55,na,1889,14.702313458646618
SIM,1879,68,na,1947,7
STAT,1869,32,40-44,1901,0.04202024159723191
STAT,1943,8,na,1951,41.62441096461464
STAT,1858,26,50-100,1884,0.005019085024535832
STAT,1860,45,35-39,1905,0.0011495087786572277
SIM,1928,19,20-24,1947,2
STAT,1815,52,na,1867,10.040771616745209
SIM,1891,39,na,1930,33
STAT,1862,51,na,1913,18.665652068095504
SIM,1832,52,na,1884,20
STAT,1811,67,na,1878,10.39822736884696
STAT,1871,98,na,1969,0.18772512489477394
STAT,1857,17,25-29,1874,0.04985998269990769
STAT,1874,39,na,1913,23.660631150371316
STAT,1873,18,20-24,1891,0.17977242981959093
STAT,1896,71,na,1967,20.709805709057783
SIM,1958,5,na,1963,53
SIM,1911,25,na,1936,38
STAT,1871,24,45-49,1895,0.006908775969139018
STAT,1922,23,15-19,1945,0.06041041285749544
STAT,1838,17,15-19,1855,0.060841176531446745
STAT,1938,12,na,1950,38.82786011445459
SIM,1922,17,na,1939,50
STAT,1903,18,30-34,1921,0.02260120001437653
STAT,1923,19,40-44,1942,0.0162230262969055
STAT,1845,15,40-44,1860,0.0013673823221117573
STAT,1879,16,na,1895,26.204476966990256
STAT,1857,80,na,1937,4.630861543438842
STAT,1879,21,45-49,1900,0.007239137811749563
STAT,1923,24,15-19,1947,0.0611234577697105
STAT,1841,23,20-24,1864,0.8483545481938763
STAT,1871,47,30-34,1918,9.605970173530971E-4
STAT,1913,29,25-29,1942,0.6457051799559541
STAT,1859,42,25-29,1901,0.005097688725695704
STAT,1872,25,45-49,1897,0.01143736266400707
STAT,1909,40,40-44,1949,0.002352749837072052
STAT,1914,44,35-39,1958,0.001972188613843588
STAT,1945,16,15-19,1961,0.4923356708603775
STAT,1863,47,na,1910,19.82716826869721
SIM,1843,44,na,1887,19
STAT,1849,32,na,1881,19.49780634133564
SIM,1895,13,na,1908,31
STAT,1910,15,45-49,1925,9.883489766620598E-4
STAT,1858,29,35-39,1887,0.07408734079630609
SIM,1832,41,na,1873,25
STAT,1925,27,50-100,1952,0.011682661274641645
SIM,1866,29,35-39,1895,1
STAT,1872,48,30-34,1920,9.779839868510674E-4
STAT,1871,87,na,1958,2.340098486225643
STAT,1901,27,40-44,1928,0.041915996769999915
STAT,1930,38,50-100,1968,0.005445324561317061
STAT,1794,70,na,1864,7.576333874513054
STAT,1944,15,15-19,1959,0.4851093394989464
STAT,1843,48,50-100,1891,0.0010287289310621478
STAT,1811,78,na,1889,4.355803278454331
STAT,1800,75,na,1875,3.8075033599482064
STAT,1908,23,40-44,1931,0.03065568348486877
SIM,1879,82,na,1961,4
STAT,1790,80,na,1870,1.5494270501288887
STAT,1820,52,na,1872,13.531104712787663
STAT,1887,35,20-24,1922,0.00849378285740659
STAT,1856,17,30-34,1873,0.013653008064631371
STAT,1930,17,15-19,1947,0.5839906611695319
STAT,1937,34,15-19,1971,0.001261710428624236
STAT,1823,101,na,1924,0.003281588338482096
SIM,1840,25,na,1865,16
STAT,1850,54,50-100,1904,1.3077175599318134E-4
STAT,1840,16,25-29,1856,0.05783170135563962
STAT,1866,95,na,1961,0.26825186706304266
STAT,1784,74,na,1858,6.160089476562919
STAT,1911,24,na,1935,35.733897560562994
STAT,1828,56,na,1884,14.315944889772075
STAT,1868,33,30-34,1901,0.1682525602238827
STAT,1906,35,40-44,1941,0.01385723102772219
SIM,1853,65,na,1918,17
STAT,1824,33,30-34,1857,0.27618689977386324
STAT,1871,28,20-24,1899,0.11655090283164682
STAT,1886,10,na,1896,26.86857901847135
SIM,1832,26,25-29,1858,2
STAT,1905,45,50-100,1950,0.002019383679667315
STAT,1808,100,na,1908,0.0015502445936524225
STAT,1921,39,25-29,1960,0.010884972336001492
STAT,1836,43,50-100,1879,0.01197461839822403
STAT,1890,15,na,1905,30.821148126988778
STAT,1888,32,45-49,1920,0.02037827183037098
STAT,1916,31,20-24,1947,0.02506935876371848
SIM,1828,76,na,1904,6
STAT,1825,37,50-100,1862,0.012870825214473625
STAT,1855,38,20-24,1893,0.005400394871375105
STAT,1863,32,40-44,1895,0.038397184346110315
STAT,1849,49,45-49,1898,0.0017917160610210455
STAT,1923,47,35-39,1970,0.0014978072818964488
STAT,1942,21,20-24,1963,1.1577574249618863
SIM,1931,27,25-29,1958,1
STAT,1843,20,20-24,1863,0.3722507364923642
SIM,1870,69,na,1939,13
STAT,1844,38,45-49,1882,0.016284320916183318
STAT,1891,24,30-34,1915,0.21725290595928615
STAT,1915,28,45-49,1943,0.017407598223893154
STAT,1846,35,45-49,1881,0.01722520370393262
STAT,1923,27,25-29,1950,0.7504544883279992
STAT,1843,13,na,1856,12.882227950799999
SIM,1919,50,na,1969,43
STAT,1833,39,40-44,1872,0.039686406944228085
STAT,1876,16,45-49,1892,6.650746788483752E-4
STAT,1931,21,45-49,1952,0.014572465906178682
STAT,1899,50,na,1949,29.899830396584147
STAT,1828,31,35-39,1859,0.14147639157668174
STAT,1925,35,35-39,1960,0.02889861184163174
STAT,1871,3,na,1874,31.154321235743645
STAT,1876,49,50-100,1925,0.0024423442494373743
STAT,1895,22,35-39,1917,0.0757594252793859
STAT,1952,0,na,1952,52.05028420012719
SIM,1910,37,na,1947,32
STAT,1873,28,30-34,1901,0.25512131759437
STAT,1839,25,50-100,1864,0.004511793262143023
STAT,1887,28,15-19,1915,0.004934766598015564
STAT,1932,25,40-44,1957,0.06085576838170386
STAT,1922,18,35-39,1940,0.048080579023954365
STAT,1900,47,40-44,1947,0.0013328903486826294
STAT,1958,11,na,1969,51.307131144984176
STAT,1866,97,na,1963,0.1463811446812887
STAT,1903,34,45-49,1937,0.014113971882151946
SIM,1845,56,na,1901,22
STAT,1943,20,25-29,1963,0.9762595568224786
STAT,1882,46,25-29,1928,5.53573260185188E-4
STAT,1884,21,20-24,1905,0.6772099040135685
STAT,1856,37,25-29,1893,0.02085786451723247
STAT,1831,23,20-24,1854,2.252882993356794
STAT,1952,2,na,1954,47.252199267869486
STAT,1896,39,20-24,1935,0.010023470196834642
STAT,1851,28,35-39,1879,0.09469263740627919
STAT,1883,67,na,1950,15.393756524377904
STAT,1898,47,30-34,1945,7.331644097323272E-4
STAT,1850,19,50-100,1869,5.267766912652591E-4
STAT,1896,28,25-29,1924,0.5536885221350432
STAT,1835,34,45-49,1869,0.009878819716728333
STAT,1859,30,25-29,1889,0.08259585673272629
STAT,1929,28,30-34,1957,0.48780222999710093
STAT,1870,50,45-49,1920,1.462363709775115E-4
STAT,1912,44,25-29,1956,6.780438860145064E-4
STAT,1881,86,na,1967,4.483001073120742
STAT,1890,43,25-29,1933,0.007743952463343275
SIM,1886,30,na,1916,29
STAT,1903,15,na,1918,36.07421122807094
STAT,1880,38,15-19,1918,5.875661767702226E-4
STAT,1869,20,40-44,1889,0.020398304423413425
STAT,1881,47,20-24,1928,1.1365287939555921E-4
STAT,1919,38,15-19,1957,2.043079976967699E-4
STAT,1917,16,45-49,1933,0.0010678167063476812
STAT,1837,42,40-44,1879,0.012922668520494764
STAT,1905,33,50-100,1938,0.0075609690011574394
SIM,1951,20,25-29,1971,3
STAT,1921,34,na,1955,41.402618144533015
STAT,1927,32,35-39,1959,0.11183881588933252
STAT,1829,48,20-24,1877,1.011240043684425E-4
STAT,1928,36,30-34,1964,0.022941768259396488
SIM,1873,27,25-29,1900,2
SIM,1787,69,na,1856,3
STAT,1841,45,25-29,1886,5.810527041323586E-4
STAT,1939,31,15-19,1970,0.0013029135317240293
STAT,1926,28,20-24,1954,0.2168054249478141
STAT,1854,106,na,1960,2.0641506315102992E-4
STAT,1866,36,30-34,1902,0.04932067426612987
STAT,1887,43,50-100,1930,0.01144795490869341
STAT,1874,92,na,1966,1.2839552962621563
STAT,1900,45,45-49,1945,0.001864405575845951
STAT,1912,46,20-24,1958,1.0563748932659815E-4
SIM,1933,5,na,1938,55
SIM,1848,13,na,1861,33
STAT,1885,39,45-49,1924,0.019487845830271234
STAT,1814,56,na,1870,11.717173336063524
STAT,1803,80,na,1883,2.903761245115753
STAT,1833,26,35-39,1859,0.09483394034659078
STAT,1929,15,25-29,1944,0.5529600686032596
STAT,1884,29,45-49,1913,0.010800467830999297
STAT,1823,92,na,1915,0.23952082011959008
STAT,1849,27,40-44,1876,0.027533834532961446
STAT,1905,31,45-49,1936,0.01451027235167765
STAT,1870,47,45-49,1917,0.0023334673555127374
STAT,1928,16,20-24,1944,1.7041119335743664
STAT,1852,54,45-49,1906,1.2078870135406335E-4
STAT,1850,23,30-34,1873,0.18898648597172998
STAT,1818,48,45-49,1866,0.0022880525497849897
STAT,1914,34,20-24,1948,0.024140660222364052
STAT,1845,38,20-24,1883,0.004685494192864128
STAT,1858,34,25-29,1892,0.07727325739880858
SIM,1896,62,na,1958,22
STAT,1781,105,na,1886,3.10479000469538E-4
STAT,1845,28,na,1873,15.281162105352575
SIM,1925,2,na,1927,45
STAT,1839,47,35-39,1886,7.871781003436188E-4
STAT,1907,16,50-100,1923,7.183895227020519E-4
STAT,1865,24,15-19,1889,0.029769832763517898
STAT,1834,38,45-49,1872,0.017342178331056408
STAT,1918,22,50-100,1940,0.007032428030542086
SIM,1959,6,na,1965,51
STAT,1840,49,25-29,1889,4.436346522487531E-4
STAT,1864,31,45-49,1895,0.015704658240290773
STAT,1923,42,50-100,1965,0.0013635880105355384
STAT,1937,30,50-100,1967,0.008137471722243056
SIM,1875,4,na,1879,22
STAT,1840,27,20-24,1867,0.11461908006694002
STAT,1911,56,na,1967,33.26800367227279
SIM,1901,24,35-39,1925,1
STAT,1819,48,20-24,1867,1.0661307615317233E-4
STAT,1890,18,20-24,1908,0.21478477020750053
STAT,1943,15,50-100,1958,0.003946092331448279
SIM,1886,52,na,1938,27
STAT,1858,68,na,1926,11.62873801662394
STAT,1835,26,na,1861,12.756168364054618
STAT,1879,24,50-100,1903,0.004194249372700443
STAT,1900,64,na,1964,26.21484559100746
STAT,1778,88,na,1866,0.5038262899067107
STAT,1900,17,45-49,1917,9.058154102912021E-4
STAT,1879,30,na,1909,24.897088522697196
STAT,1844,32,30-34,1876,0.16308409673546248
SIM,1873,12,na,1885,30
SIM,1815,58,na,1873,10
STAT,1879,49,30-34,1928,9.809709883915228E-4
SIM,1919,42,na,1961,43
STAT,1927,1,na,1928,51.65944947337681
STAT,1947,24,30-34,1971,0.3223906923054729
STAT,1881,34,15-19,1915,0.0013434692981839477
STAT,1910,24,35-39,1934,0.0873340598733908
SIM,1811,68,na,1879,5
STAT,1823,49,25-29,1872,3.901520162385749E-4
SIM,1868,22,25-29,1890,1
STAT,1889,26,50-100,1915,0.007858833914422037
SIM,1795,64,na,1859,11
STAT,1887,36,45-49,1923,0.02186378922869868
STAT,1833,70,na,1903,10.387564933956353
STAT,1886,18,na,1904,26.128624746480977
STAT,1922,48,30-34,1970,0.0010137890986782736
STAT,1814,43,15-19,1857,4.253777559102126E-4
STAT,1937,29,35-39,1966,0.1452833871618971
STAT,1886,39,20-24,1925,0.00791528210165539
SIM,1943,24,na,1967,47
STAT,1933,17,40-44,1950,0.018647542214933817
STAT,1857,22,50-100,1879,0.003524226403016888
STAT,1897,38,25-29,1935,0.0380448114074909
STAT,1918,45,45-49,1963,0.0023026778458369733
STAT,1849,41,20-24,1890,0.0012369943263611045
STAT,1885,36,40-44,1921,0.04343654958856799
STAT,1829,37,25-29,1866,0.02645589547919816
STAT,1891,62,na,1953,22.43291031693025
STAT,1883,21,na,1904,23.035886638297942
STAT,1891,64,na,1955,21.33598183032915
STAT,1916,17,40-44,1933,0.0029422143526250397
SIM,1936,22,na,1958,32
STAT,1894,23,30-34,1917,0.22757538814018294
STAT,1928,19,25-29,1947,0.5404520038378192
STAT,1964,0,na,1964,49.5748662382309
STAT,1860,40,35-39,1900,0.014869966301243683
STAT,1907,20,15-19,1927,0.048544451242602725
STAT,1824,34,na,1858,20.304201355131852
STAT,1889,38,35-39,1927,0.0861665034731565
STAT,1870,22,30-34,1892,0.17694518692277253
STAT,1850,16,25-29,1866,0.06201996693382436
STAT,1827,32,30-34,1859,0.15390966522666322
STAT,1825,45,40-44,1870,0.0016230777171105095
STAT,1943,28,20-24,1971,0.19289698183956072
SIM,1912,18,na,1930,38
SIM,1869,80,na,1949,2
STAT,1820,50,na,1870,14.077823262824996
STAT,1865,46,25-29,1911,5.224638771502549E-4
STAT,1834,28,35-39,1862,0.08877081201117945
STAT,1870,28,45-49,1898,0.010990800169954244
STAT,1893,22,50-100,1915,0.005141736938737499
STAT,1873,21,45-49,1894,0.007111021157897574
STAT,1871,42,na,1913,23.014698867747715
STAT,1871,21,35-39,1892,0.05835540686980838
STAT,1876,35,45-49,1911,0.020439048986874493
STAT,1913,25,30-34,1938,0.389779847983364
SIM,1831,56,na,1887,6
STAT,1848,37,35-39,1885,0.047136553097987956
STAT,1881,28,20-24,1909,0.11123691772135695
STAT,1903,35,15-19,1938,1.7395727738924867E-4
STAT,1873,99,na,1972,0.15377281908254392
STAT,1924,20,15-19,1944,0.06277664860947262
SIM,1795,86,na,1881,3
STAT,1875,36,40-44,1911,0.045214776045564065
STAT,1923,27,na,1950,42.71201415627847
STAT,1831,24,45-49,1855,0.009621813559136216
STAT,1871,43,15-19,1914,1.36689451538233E-4
STAT,1865,48,na,1913,20.0938325455219
SIM,1882,48,na,1930,30
STAT,1853,22,30-34,1875,0.13226992035840968
STAT,1830,27,20-24,1857,0.10628721690187373
STAT,1892,29,35-39,1921,0.11835162913627098
SIM,1861,22,30-34,1883,2
STAT,1841,26,25-29,1867,0.5179924637631872
STAT,1870,19,15-19,1889,0.058815718943528376
SIM,1848,11,na,1859,33
SIM,1824,86,na,1910,1
STAT,1875,29,35-39,1904,0.0984765074733101
STAT,1952,18,20-24,1970,1.614571910966427
STAT,1869,39,20-24,1908,0.007393901099343282
STAT,1934,38,50-100,1972,0.005763496602767524
SIM,1870,77,na,1947,11
STAT,1842,85,na,1927,2.056772922615307
STAT,1934,25,50-100,1959,0.013344771841819812
STAT,1914,17,30-34,1931,0.02500445857884648
STAT,1891,17,25-29,1908,0.06955137345883541
STAT,1860,20,20-24,1880,0.6438578431900059
STAT,1940,27,25-29,1967,0.6664224409856039
STAT,1854,21,35-39,1875,0.04221231575148565
STAT,1929,21,45-49,1950,0.014203457651057337
SIM,1951,11,na,1962,51
STAT,1838,48,30-34,1886,7.631047256021522E-4
SIM,1928,25,na,1953,46
STAT,1899,32,20-24,1931,0.03700308010041373
STAT,1825,38,35-39,1863,0.072526291310078
STAT,1859,46,40-44,1905,0.001364589866567382
STAT,1904,27,15-19,1931,0.006501061429262424
SIM,1873,63,na,1936,16
SIM,1882,24,30-34,1906,1
STAT,1844,62,na,1906,14.276317543179452
STAT,1781,103,na,1884,7.905956535056049E-4
STAT,1860,28,45-49,1888,0.00905767263160186
STAT,1782,93,na,1875,0.051818140990960146
STAT,1906,55,na,1961,31.18775527923695
SIM,1834,20,20-24,1854,3
STAT,1803,101,na,1904,0.0021385473626677125
STAT,1844,35,40-44,1879,0.040538729263640313
STAT,1905,18,35-39,1923,0.007898448974017883
STAT,1866,12,na,1878,24.798746820255698
STAT,1843,23,25-29,1866,0.3026156264248274
STAT,1876,25,35-39,1901,0.09866378867813932
STAT,1942,7,na,1949,41.169006327302874
SIM,1886,84,na,1970,1
STAT,1839,17,30-34,1856,0.011506271597064428
STAT,1908,26,45-49,1934,0.01644093714964258
STAT,1818,39,15-19,1857,6.677716283640039E-4
STAT,1887,16,20-24,1903,0.19398355207450804
STAT,1870,44,40-44,1914,0.022042446670433542
STAT,1860,18,35-39,1878,0.005114493440291797
SIM,1820,70,na,1890,6
SIM,1903,35,na,1938,38
STAT,1836,65,na,1901,16.309914124798855
SIM,1924,0,na,1924,56
STAT,1917,38,20-24,1955,0.0026996826749638814
STAT,1883,17,35-39,1900,0.005328412778326545
STAT,1845,31,35-39,1876,0.07112093920203938
STAT,1910,36,45-49,1946,0.00651129471603646
STAT,1946,15,25-29,1961,0.4775117881170094
SIM,1914,27,25-29,1941,2
SIM,1851,23,25-29,1874,1
STAT,1909,19,15-19,1928,0.08802434745585873
SIM,1939,17,na,1956,28
STAT,1914,37,25-29,1951,0.009749233999883727
STAT,1832,75,na,1907,4.65325940768155
SIM,1862,26,na,1888,23
STAT,1904,39,25-29,1943,0.0088150690392597
STAT,1906,47,35-39,1953,0.001141963933449148
STAT,1824,36,35-39,1860,0.10523367440902087
STAT,1932,28,45-49,1960,0.022525699863211783
STAT,1940,19,40-44,1959,0.014091438812768803
STAT,1866,39,35-39,1905,0.0644846938245377
STAT,1888,39,30-34,1927,0.061654507121484604
STAT,1844,94,na,1938,0.15611026475532502
STAT,1929,0,na,1929,57.220045163509056
STAT,1803,53,40-44,1856,2.0137850364294936E-4
SIM,1906,24,na,1930,27
SIM,1868,33,na,1901,33
SIM,1917,19,15-19,1936,1
STAT,1864,47,20-24,1911,1.071289699584451E-4
STAT,1849,49,50-100,1898,0.0018645994231528255
STAT,1857,30,15-19,1887,0.001095166271294876
STAT,1866,27,40-44,1893,0.02758859093273844
STAT,1933,37,na,1970,51.03505726598235
STAT,1810,74,na,1884,3.9266705399108606
STAT,1843,28,45-49,1871,0.0057546750687353125
STAT,1911,29,15-19,1940,0.0067912978217613655
STAT,1879,39,20-24,1918,0.007898064390263113
STAT,1921,36,20-24,1957,0.002923116342690686
SIM,1842,73,na,1915,13
STAT,1851,25,30-34,1876,0.252530632116239
STAT,1859,93,na,1952,0.2322883646278945
STAT,1912,24,45-49,1936,0.011079458553942252
STAT,1949,20,na,1969,42.36877673719568
STAT,1900,32,na,1932,33.09054553407162
SIM,1899,59,na,1958,25
STAT,1839,34,15-19,1873,9.47245278592621E-4
STAT,1934,16,45-49,1950,0.00674469006303147
STAT,1849,20,15-19,1869,0.03137635274546927
STAT,1812,48,50-100,1860,0.002721940959333202
STAT,1808,58,na,1866,4.0541960687735425
STAT,1873,17,30-34,1890,0.016204753053796452
STAT,1790,88,na,1878,0.2851329824858297
STAT,1918,20,30-34,1938,0.30900921253746716
SIM,1886,38,na,1924,28
STAT,1898,17,35-39,1915,0.007402091087145347
STAT,1912,41,20-24,1953,1.699701502433313E-4
STAT,1840,33,15-19,1873,0.0013451111654370492
STAT,1858,31,20-24,1889,0.02078347515950346
STAT,1858,46,na,1904,17.16865079265558
STAT,1855,28,50-100,1883,0.004660838007218708
SIM,1837,59,na,1896,28
STAT,1819,41,35-39,1860,0.017486878873007795
STAT,1892,36,40-44,1928,0.054340294384165516
STAT,1915,25,40-44,1940,0.047450822170208976
STAT,1838,41,45-49,1879,0.013759933980955171
STAT,1818,45,40-44,1863,0.00173442405744769
STAT,1890,69,na,1959,18.927074382647156
STAT,1849,40,na,1889,18.23436444576629
SIM,1926,20,30-34,1946,3
SIM,1932,23,25-29,1955,2
STAT,1964,8,na,1972,49.188807334541835
STAT,1912,49,25-29,1961,5.0283770125951E-4
STAT,1891,27,35-39,1918,0.11842745454254798
STAT,1885,20,25-29,1905,0.5686818468590534
STAT,1861,74,na,1935,9.332828280145428
STAT,1893,45,na,1938,28.655873969775666
STAT,1872,24,20-24,1896,0.7006781054207637
STAT,1928,39,35-39,1967,0.0303537246590301
STAT,1906,27,25-29,1933,0.6145617378222995
STAT,1850,26,35-39,1876,0.10183083532681736
SIM,1893,20,25-29,1913,1
STAT,1834,30,20-24,1864,0.024981842452149457
STAT,1899,68,na,1967,23.856452947424344
STAT,1868,78,na,1946,7.561310553997879
STAT,1877,22,25-29,1899,0.5909241557599906
STAT,1884,24,25-29,1908,0.5573538833509116
STAT,1778,86,na,1864,0.7692397971485697
STAT,1924,23,25-29,1947,1.079511446988913
STAT,1855,51,50-100,1906,1.0684266808916878E-4
SIM,1906,46,na,1952,22
STAT,1832,27,30-34,1859,0.15065147925177286
STAT,1899,18,40-44,1917,0.0024972614575898937
STAT,1854,42,40-44,1896,0.013731435165055487
STAT,1868,24,40-44,1892,0.020039719725262937
STAT,1949,21,30-34,1970,0.3333407788911489
STAT,1822,37,15-19,1859,3.4484714689281856E-4
SIM,1805,81,na,1886,2
SIM,1941,23,na,1964,48
STAT,1870,25,35-39,1895,0.09650164054876564
STAT,1878,38,15-19,1916,5.768739946572851E-4
STAT,1909,28,20-24,1937,0.1728620526583625
STAT,1838,38,20-24,1876,0.0071447310421438965
SIM,1901,26,na,1927,39
STAT,1908,38,na,1946,34.8676152611312
STAT,1846,32,40-44,1878,0.04153377117464425
STAT,1842,49,35-39,1891,0.0010284591775615254
STAT,1823,47,na,1870,14.986052246453733
STAT,1828,42,50-100,1870,0.004656831945209862
SIM,1906,28,45-49,1934,1
SIM,1888,19,na,1907,37
STAT,1819,52,50-100,1871,1.3122024841480818E-4
STAT,1886,32,35-39,1918,0.10504464415357376
STAT,1878,22,35-39,1900,0.06024652052203896
STAT,1894,59,na,1953,24.90727888397555
SIM,1888,0,na,1888,41
STAT,1784,101,na,1885,0.0019477331943479382
SIM,1801,58,na,1859,9
STAT,1844,29,15-19,1873,0.0042761944431388785
STAT,1881,7,na,1888,25.082302847425883
STAT,1890,40,20-24,1930,0.0019485718795362176
STAT,1837,45,45-49,1882,0.001223450382841618
STAT,1876,73,na,1949,12.063359406291912
SIM,1959,4,na,1963,51
STAT,1926,20,25-29,1946,1.122421303267166
SIM,1947,6,na,1953,43
STAT,1906,38,45-49,1944,0.006220120845138318
STAT,1900,10,na,1910,35.91958413347075
STAT,1849,5,na,1854,24.0
STAT,1865,37,35-39,1902,0.06397367943898559
STAT,1912,36,50-100,1948,0.0040853602562839035
STAT,1896,18,15-19,1914,0.07774822524715988
SIM,1863,27,25-29,1890,1
STAT,1792,69,na,1861,13.864972066577387
STAT,1931,38,50-100,1969,0.0055302100113983925
STAT,1858,17,40-44,1875,0.0016257969291771407
STAT,1890,21,45-49,1911,0.008495958178194799
STAT,1864,31,na,1895,21.490837588103357
STAT,1902,27,20-24,1929,0.1654353598627848
STAT,1817,86,na,1903,1.7584535624462836
SIM,1855,15,na,1870,23
STAT,1892,26,30-34,1918,0.3121667245968413
STAT,1944,11,na,1955,41.97263213664563
STAT,1887,33,40-44,1920,0.047135840010725946
STAT,1817,38,45-49,1855,0.07433144488230008
STAT,1863,27,15-19,1890,0.004017071455504814
SIM,1875,44,na,1919,18
STAT,1900,42,40-44,1942,0.002163252023460294
STAT,1890,37,20-24,1927,0.00936352376480486
STAT,1934,30,25-29,1964,0.1258007212515838
STAT,1864,28,20-24,1892,0.10485168946196456
STAT,1930,29,25-29,1959,0.8321941857065879
STAT,1862,49,50-100,1911,0.002074707871735048
STAT,1840,19,35-39,1859,0.005501474343458054
STAT,1851,35,40-44,1886,0.03813580652548217
STAT,1818,36,50-100,1854,0.01814247639122441
STAT,1878,43,50-100,1921,0.01082820502755063
STAT,1829,27,15-19,1856,0.005212118073186451
STAT,1869,53,50-100,1922,1.4398719841869482E-4
STAT,1924,18,45-49,1942,0.0058945281981588596
STAT,1825,35,30-34,1860,0.05776834557302044
STAT,1897,22,45-49,1919,0.009260119457678366
STAT,1828,78,na,1906,5.247500460817184
STAT,1855,27,25-29,1882,0.3104397059514339
STAT,1924,23,na,1947,42.678165878409864
STAT,1846,15,20-24,1861,0.18263240585383153
STAT,1886,32,na,1918,24.752400644250418
STAT,1806,77,na,1883,4.822018186959561
STAT,1846,34,20-24,1880,0.025355759796949134
SIM,1952,15,na,1967,28
STAT,1807,49,40-44,1856,0.003540564422842809
STAT,1849,39,35-39,1888,0.054965282007291304
STAT,1905,23,15-19,1928,0.047465755283494615
STAT,1921,19,30-34,1940,0.13711334873393072
STAT,1927,15,15-19,1942,0.5640138934896971
STAT,1833,25,na,1858,21.411810945336033
STAT,1839,44,30-34,1883,0.006517677329800256
STAT,1939,17,35-39,1956,0.041714148525874885
STAT,1914,29,40-44,1943,0.046265498108830704
SIM,1808,70,na,1878,2
STAT,1875,31,20-24,1906,0.027899431312426694
STAT,1820,103,na,1923,8.136222916258344E-4
STAT,1867,20,30-34,1887,0.17364329998934766
SIM,1915,9,na,1924,40
STAT,1884,60,na,1944,18.685630020438044
STAT,1861,24,45-49,1885,0.005938283181921687
SIM,1935,15,15-19,1950,1
STAT,1812,55,na,1867,10.62505718730684
STAT,1895,43,40-44,1938,0.0020131526627134395
SIM,1891,31,na,1922,36
STAT,1901,20,20-24,1921,0.9700245490847154
STAT,1940,24,20-24,1964,1.1239278576459524
SIM,1887,42,45-49,1929,1
STAT,1861,25,50-100,1886,0.005497269274703726
STAT,1870,25,40-44,1895,0.02995947503297583
STAT,1899,35,25-29,1934,0.0397886207138732
SIM,1883,73,na,1956,3
STAT,1877,89,na,1966,2.7107503766519274
STAT,1858,22,15-19,1880,0.0288030104354531
STAT,1863,38,15-19,1901,4.947250811379103E-4
SIM,1884,29,na,1913,25
STAT,1892,24,50-100,1916,0.0050063359188232
SIM,1840,47,na,1887,17
STAT,1852,25,50-100,1877,0.00646928563066436
SIM,1846,30,na,1876,15
STAT,1838,53,50-100,1891,1.1533739835961309E-4
STAT,1859,49,45-49,1908,0.0018366032542279692
STAT,1908,40,25-29,1948,6.646931277488679E-4
STAT,1847,27,30-34,1874,0.32332712050281426
STAT,1848,44,na,1892,14.745028508388232
STAT,1862,59,na,1921,16.767521286898674
STAT,1837,37,15-19,1874,3.3315906702514387E-4
STAT,1869,38,na,1907,22.71481111358367
SIM,1812,83,na,1895,2
STAT,1865,34,30-34,1899,0.1565688779258553
STAT,1863,35,45-49,1898,0.01781791058193752
SIM,1865,68,na,1933,9
STAT,1870,15,50-100,1885,4.971550828449314E-4
SIM,1819,62,na,1881,4
STAT,1844,35,35-39,1879,0.06550018602764796
STAT,1889,46,20-24,1935,1.473369423230089E-4
SIM,1892,16,na,1908,36
STAT,1908,36,na,1944,35.210076976559854
STAT,1879,42,45-49,1921,0.015471304312756673
STAT,1835,24,35-39,1859,0.036517159500550074
STAT,1913,28,35-39,1941,0.1478230357582156
SIM,1843,24,35-39,1867,1
SIM,1860,45,na,1905,23
STAT,1881,17,25-29,1898,0.05392138261633662
STAT,1804,68,na,1872,8.522556703033397
STAT,1865,43,20-24,1908,0.0014260672223470286
STAT,1791,84,na,1875,1.0245565164194994
STAT,1857,16,35-39,1873,0.004856545661981699
STAT,1865,16,na,1881,23.679579728969635
STAT,1912,21,35-39,1933,0.08980264312439144
STAT,1876,24,50-100,1900,0.004115778162326577
STAT,1819,95,na,1914,0.06824992839670646
STAT,1827,35,40-44,1862,0.03678695035031043
SIM,1873,24,20-24,1897,2
SIM,1927,29,25-29,1956,1
STAT,1924,48,40-44,1972,0.0018596072137238206
STAT,1915,30,15-19,1945,0.0013078959804344041
STAT,1814,47,30-34,1861,0.002772213392887896
SIM,1865,8,na,1873,25
STAT,1860,23,25-29,1883,0.47630722088461763
STAT,1885,36,35-39,1921,0.07018232021895583
SIM,1960,2,na,1962,52
STAT,1826,97,na,1923,0.03754213643097196
STAT,1835,39,15-19,1874,3.0821249986485E-4
STAT,1889,39,50-100,1928,0.014880357051302627
STAT,1842,46,30-34,1888,7.357575716980613E-4
STAT,1839,22,20-24,1861,0.4886376362144772
STAT,1848,27,25-29,1875,0.32658274645867463
STAT,1843,27,50-100,1870,0.003339488187913328
STAT,1920,30,na,1950,41.40410210794969
STAT,1887,30,50-100,1917,0.010081279707235184
STAT,1822,34,45-49,1856,0.011808247004564006
STAT,1931,25,25-29,1956,0.8467408405324695
SIM,1862,71,na,1933,16
STAT,1845,79,na,1924,4.086611604134659
SIM,1946,7,na,1953,53
STAT,1887,19,25-29,1906,0.06152107579597008
SIM,1862,4,na,1866,26
STAT,1888,41,na,1929,27.131312165381935
STAT,1905,27,30-34,1932,0.3634355909606993
SIM,1840,79,na,1919,2
STAT,1865,24,20-24,1889,0.6218546458201378
STAT,1894,48,45-49,1942,0.0016846647196562172
STAT,1891,33,20-24,1924,0.03303636018735775
STAT,1822,84,na,1906,1.1800082741420108
STAT,1859,35,45-49,1894,0.015995046792305196
STAT,1932,33,50-100,1965,0.010939754330994526
STAT,1833,34,20-24,1867,0.02523601202149463
STAT,1907,51,na,1958,32.17751503329058
STAT,1818,45,35-39,1863,0.00141833743342667
STAT,1843,25,40-44,1868,0.01586522669701873
SIM,1925,36,na,1961,43
STAT,1874,24,30-34,1898,0.1795728429886283
STAT,1900,26,35-39,1926,0.13425911896223916
STAT,1931,17,30-34,1948,0.15883271464118462
STAT,1881,38,30-34,1919,0.050461709892429235
SIM,1855,24,na,1879,20
STAT,1874,36,25-29,1910,0.02934979349803938
STAT,1918,14,na,1932,42.598321528493486
STAT,1835,42,30-34,1877,0.006240211282597528
STAT,1821,37,20-24,1858,0.015756793322026827
STAT,1867,46,35-39,1913,0.0013435485740210336
STAT,1908,32,30-34,1940,0.14794408255482833
STAT,1906,24,20-24,1930,0.994904110553242
SIM,1851,31,na,1882,20
SIM,1915,23,25-29,1938,1
SIM,1826,35,na,1861,16
SIM,1839,82,na,1921,5
STAT,1855,89,na,1944,0.7396501387318034
SIM,1938,4,na,1942,41
STAT,1888,44,na,1932,26.64453020201765
STAT,1825,48,45-49,1873,0.002148885953162877
STAT,1898,51,na,1949,29.186025898960402
STAT,1927,36,15-19,1963,2.377524626276407E-4
STAT,1876,43,30-34,1919,0.011592207720782424
SIM,1946,4,na,1950,55
STAT,1840,37,30-34,1877,0.04939435178043217
STAT,1861,29,15-19,1890,0.0037881669173248926
STAT,1897,35,15-19,1932,7.527896083883128E-4
STAT,1823,33,15-19,1856,0.0013189196758672962
STAT,1824,42,20-24,1866,0.0021522877604539807
STAT,1837,52,na,1889,10.448827277089409
STAT,1836,21,25-29,1857,0.7343948722432806
STAT,1904,36,20-24,1940,0.0023955318767238305
SIM,1883,41,na,1924,12
STAT,1933,34,25-29,1967,0.12388900168009553
STAT,1859,34,40-44,1893,0.03417384569338204
STAT,1890,24,15-19,1914,0.039822474366045406
STAT,1809,52,30-34,1861,1.946654744953523E-4
STAT,1839,34,20-24,1873,0.01797978692715627
STAT,1924,27,40-44,1951,0.05391720264471645
STAT,1929,24,15-19,1953,0.06657481314704673
STAT,1927,35,45-49,1962,0.00844713807275335
SIM,1841,24,na,1865,19
SIM,1877,27,na,1904,27
STAT,1884,51,na,1935,21.19663734860141
SIM,1798,75,na,1873,4
SIM,1881,63,na,1944,14
SIM,1836,42,na,1878,5
STAT,1859,46,35-39,1905,0.0011159029308411188
STAT,1889,28,25-29,1917,0.5160866634683008
SIM,1873,34,na,1907,27
STAT,1892,39,45-49,1931,0.024379820436033924
STAT,1899,23,15-19,1922,0.04502190040796083
STAT,1860,15,30-34,1875,0.01512202133843634
STAT,1851,64,na,1915,14.675759078389044
STAT,1874,53,50-100,1927,1.5075604732528311E-4
STAT,1919,29,25-29,1948,0.6999770901890372
STAT,1868,20,25-29,1888,0.5620335452043788
STAT,1812,43,40-44,1855,0.026048592767990607
STAT,1856,34,na,1890,17.139226662919242
STAT,1907,23,25-29,1930,0.8347736294459868
STAT,1823,33,50-100,1856,0.008485878990792282
SIM,1854,1,na,1855,24
SIM,1835,23,40-44,1858,1
STAT,1921,4,na,1925,45.64841686342719
STAT,1894,26,40-44,1920,0.03852265142850319
STAT,1925,47,45-49,1972,0.0026171413279474955
SIM,1826,32,na,1858,17
SIM,1851,34,na,1885,20
STAT,1927,23,45-49,1950,0.013749326302212268
STAT,1905,20,50-100,1925,0.005920515469235362
SIM,1876,93,na,1969,1
STAT,1855,24,20-24,1879,0.5587143501978825
SIM,1859,37,na,1896,15
STAT,1823,41,50-100,1864,0.007547329389044669
STAT,1929,19,40-44,1948,0.017669892767933716
STAT,1965,2,na,1967,48.814926002335106
SIM,1903,0,na,1903,40
STAT,1944,20,40-44,1964,0.03606530515305467
STAT,1874,35,20-24,1909,0.007894465078016196
STAT,1905,35,25-29,1940,0.009054194791581545
STAT,1894,15,45-49,1909,8.410575288648723E-4
SIM,1914,24,20-24,1938,3
STAT,1924,46,50-100,1970,0.002681842272605769
STAT,1907,44,25-29,1951,6.434758787202759E-4
STAT,1884,26,40-44,1910,0.029449814066944788
STAT,1891,19,na,1910,30.83213737562291
STAT,1821,69,na,1890,9.114744618465386
STAT,1789,72,na,1861,3.433013171719672
STAT,1922,11,na,1933,45.58798632022402
STAT,1952,15,50-100,1967,0.004465580560697732
STAT,1840,27,na,1867,21.135668904463675
STAT,1930,26,20-24,1956,0.23112503951300936
STAT,1867,29,na,1896,22.674858146226857
STAT,1896,49,30-34,1945,7.022582069522538E-4
STAT,1908,20,30-34,1928,0.26442366075095264
STAT,1941,15,40-44,1956,0.01431010781942238
STAT,1851,38,45-49,1889,0.01683414495827546
SIM,1868,42,na,1910,32
STAT,1849,36,30-34,1885,0.04272786693265245
STAT,1878,25,45-49,1903,0.011540732836482822
STAT,1881,18,50-100,1899,4.649576173447007E-4
STAT,1925,20,30-34,1945,0.34391734219306547
STAT,1836,48,20-24,1884,1.196550894590546E-4
SIM,1858,74,na,1932,13
SIM,1847,82,na,1929,3
SIM,1905,16,na,1921,40
STAT,1839,30,na,1869,15.027161833240099
SIM,1817,50,na,1867,8
STAT,1915,37,35-39,1952,0.024223274237098698
SIM,1874,24,30-34,1898,3
STAT,1944,28,50-100,1972,0.010674646723434654
STAT,1850,32,20-24,1882,0.025176584472296593
STAT,1841,49,40-44,1890,0.001640743031844133
STAT,1893,36,35-39,1929,0.08961009779699279
SIM,1816,57,na,1873,10
SIM,1848,67,na,1915,17
STAT,1921,15,50-100,1936,0.004256959405823193
STAT,1880,56,na,1936,21.447834613554228
SIM,1849,60,na,1909,7
STAT,1771,99,na,1870,0.005491727909286434
STAT,1805,102,na,1907,8.027187372454424E-4
STAT,1899,39,na,1938,32.17909283849283
SIM,1885,22,na,1907,21
STAT,1945,19,25-29,1964,0.4696704194360163
SIM,1866,64,na,1930,26
STAT,1872,19,50-100,1891,4.985820954667493E-4
STAT,1881,21,50-100,1902,0.003892017845535183
SIM,1826,64,na,1890,13
STAT,1868,36,40-44,1904,0.04256697365664149
SIM,1897,28,25-29,1925,1
STAT,1904,15,20-24,1919,0.25521073766572183
STAT,1934,22,30-34,1956,0.38461199298697724
STAT,1836,29,20-24,1865,0.1444045324983358
STAT,1893,28,50-100,1921,0.008037345103179428
STAT,1813,79,na,1892,4.613783803023109
STAT,1924,15,40-44,1939,0.01662492343187936
STAT,1905,48,30-34,1953,7.781548890051812E-4
SIM,1888,11,na,1899,39
STAT,1829,42,50-100,1871,0.009352469616596774
STAT,1853,79,na,1932,4.393745170801267
STAT,1931,25,na,1956,48.19213867065977
STAT,1946,24,15-19,1970,0.05877897906652077
STAT,1888,76,na,1964,13.99923305246652
STAT,1843,45,35-39,1888,6.064441461940978E-4
STAT,1915,16,35-39,1931,0.008727847663971238
STAT,1921,27,15-19,1948,0.007806506085597681
STAT,1941,27,35-39,1968,0.15418427300786475
STAT,1821,46,50-100,1867,0.003522843914207374
SIM,1838,35,na,1873,10
SIM,1908,56,na,1964,34
STAT,1819,42,na,1861,14.690504246164481
STAT,1931,41,30-34,1972,0.0017028080630468348
STAT,1918,38,50-100,1956,0.004380884265647931
SIM,1917,19,na,1936,43
STAT,1846,18,25-29,1864,0.05735097534350755
STAT,1867,23,35-39,1890,0.05567068728500884
STAT,1878,46,45-49,1924,0.002443423116130451
STAT,1858,12,na,1870,21.21978287718738
STAT,1862,19,20-24,1881,0.1575414661010264
STAT,1856,34,15-19,1890,0.0010228161159063737
STAT,1931,38,30-34,1969,0.024006400434702525
STAT,1884,46,35-39,1930,0.0013755471075818089
SIM,1815,72,na,1887,4
STAT,1900,23,30-34,1923,0.24623649273260292
STAT,1831,26,25-29,1857,0.4705219256636666
SIM,1837,27,na,1864,29
SIM,1877,56,na,1933,24
STAT,1873,11,na,1884,26.792921570546806
STAT,1866,24,30-34,1890,0.1630208738022263
STAT,1880,70,na,1950,14.754070223785847
STAT,1912,25,15-19,1937,0.0069492840213270166
STAT,1883,47,30-34,1930,9.3562449741646E-4
STAT,1826,45,35-39,1871,0.0014477847523994536
SIM,1913,26,na,1939,38
STAT,1861,32,30-34,1893,0.14682845737599695
STAT,1950,17,40-44,1967,0.016436157384110032
STAT,1834,87,na,1921,1.2450616087857784
SIM,1867,49,na,1916,11
SIM,1860,13,na,1873,28
STAT,1905,15,30-34,1920,0.02311026003562087
STAT,1926,19,15-19,1945,0.5502742203698561
STAT,1802,87,na,1889,0.5180664428910596
STAT,1932,37,35-39,1969,0.03236678373768267
STAT,1853,28,45-49,1881,0.007303399617726337
STAT,1845,19,20-24,1864,0.12944328461407276
STAT,1941,20,15-19,1961,0.05464964773362695
STAT,1880,78,na,1958,9.38118765160541
STAT,1877,49,20-24,1926,1.2128499266246999E-4
STAT,1853,90,na,1943,0.49549815298057337
STAT,1865,27,25-29,1892,0.38261099747266414
SIM,1893,33,30-34,1926,1
SIM,1814,95,na,1909,2
STAT,1904,45,na,1949,32.56520911939948
SIM,1912,2,na,1914,41
STAT,1849,32,15-19,1881,0.0011635688670764588
STAT,1850,39,40-44,1889,0.03877918578019631
STAT,1808,46,50-100,1854,0.001798626547334976
STAT,1831,98,na,1929,0.02636170735761148
STAT,1897,58,na,1955,26.261612478983942
STAT,1922,15,30-34,1937,0.1406801116981284
STAT,1827,38,45-49,1865,0.01608009605557611
STAT,1927,20,40-44,1947,0.04146042880945175
STAT,1835,45,35-39,1880,7.533926626564214E-4
SIM,1904,12,na,1916,33
STAT,1859,16,45-49,1875,6.062465895702408E-4
STAT,1891,30,na,1921,29.52414481557092
STAT,1912,29,30-34,1941,0.38036957018246303
STAT,1901,41,45-49,1942,0.00146083713369312
STAT,1885,33,30-34,1918,0.1716896938579501
SIM,1848,45,na,1893,31
STAT,1894,45,40-44,1939,0.0012499856449543051
STAT,1887,38,25-29,1925,0.03127078379050906
STAT,1934,37,45-49,1971,0.00936765442945933
STAT,1837,24,45-49,1861,0.004484230023040691
STAT,1930,9,na,1939,51.22572714185324
SIM,1887,15,na,1902,26
STAT,1919,44,na,1963,39.765435039369635
STAT,1920,19,20-24,1939,1.5000443166209132
STAT,1860,25,40-44,1885,0.024971354234832006
SIM,1937,2,na,1939,41
STAT,1943,19,15-19,1962,0.47743006706370117
STAT,1875,39,45-49,1914,0.020285648680025428
STAT,1895,46,45-49,1941,0.0017331917226511672
SIM,1815,40,na,1855,15
STAT,1901,29,20-24,1930,0.16298131678177458
STAT,1879,62,na,1941,18.91720005680845
STAT,1874,33,20-24,1907,0.027306576612383348
STAT,1894,29,45-49,1923,0.01412785345851629
STAT,1850,42,50-100,1892,0.009394696143205048
STAT,1844,23,40-44,1867,0.020176391558185146
STAT,1890,40,50-100,1930,0.012962238777646178
STAT,1853,47,45-49,1900,0.0014763008377480856
SIM,1875,78,na,1953,3
SIM,1927,40,na,1967,50
SIM,1932,20,15-19,1952,1
STAT,1914,25,25-29,1939,0.6624989363509455
STAT,1885,25,45-49,1910,0.0110387938936162
SIM,1897,47,na,1944,38
SIM,1897,22,na,1919,38
STAT,1888,20,35-39,1908,0.06860018537029897
STAT,1899,36,na,1935,32.40699320530274
STAT,1808,48,45-49,1856,0.001679470396953169
STAT,1948,24,25-29,1972,1.0528565659954192
STAT,1833,23,30-34,1856,0.17600104211494166
STAT,1891,35,20-24,1926,0.009550973580686323
STAT,1804,65,na,1869,9.531252467559863
STAT,1914,55,na,1969,34.999151615570014
SIM,1917,30,na,1947,41
STAT,1822,32,45-49,1854,0.016238866077065702
SIM,1900,33,25-29,1933,1
STAT,1867,43,30-34,1910,0.010922396527133569
STAT,1890,28,30-34,1918,0.30480854950634956
STAT,1905,39,40-44,1944,0.013499157027589696
STAT,1923,24,20-24,1947,1.2767927345989516
STAT,1908,35,35-39,1943,0.022742356995152892
STAT,1868,18,50-100,1886,4.7985777549797897E-4
STAT,1853,44,40-44,1897,0.013945462921819278
STAT,1889,29,na,1918,29.010127192773155
STAT,1870,49,na,1919,21.88301750175183
STAT,1919,26,20-24,1945,0.1961930302217843
STAT,1812,46,45-49,1858,0.0026861446805954673
SIM,1931,24,20-24,1955,1
STAT,1944,23,45-49,1967,0.012056514717826573
STAT,1823,37,30-34,1860,0.03840656263592576
STAT,1918,42,35-39,1960,0.0021215891157501483
STAT,1922,31,45-49,1953,0.017721380995964632
STAT,1824,44,20-24,1868,0.0020816685999515126
SIM,1879,28,30-34,1907,1
SIM,1883,34,25-29,1917,2
STAT,1872,17,15-19,1889,0.06092028791670916
STAT,1824,49,40-44,1873,0.002157513524650393
STAT,1818,42,30-34,1860,0.01236136805192405
STAT,1866,41,na,1907,21.382406368503055
STAT,1933,31,20-24,1964,0.03275595199333102
STAT,1818,49,50-100,1867,0.002346501362152275
SIM,1869,29,25-29,1898,1
STAT,1848,24,20-24,1872,0.534868705052296
STAT,1824,45,25-29,1869,7.653119811331233E-4
SIM,1884,26,na,1910,24
SIM,1866,7,na,1873,36
SIM,1871,53,na,1924,22
STAT,1867,26,na,1893,22.91646051873187
STAT,1875,34,25-29,1909,0.10438661463961676
STAT,1846,37,25-29,1883,0.024367066129185128
STAT,1814,54,50-100,1868,3.986426301875145E-4
STAT,1891,36,25-29,1927,0.03550830860965881
STAT,1923,19,50-100,1942,0.004345452415679799
SIM,1846,86,na,1932,2
STAT,1914,31,50-100,1945,0.008287260471338025
STAT,1869,23,45-49,1892,0.006735759405071802
STAT,1885,24,40-44,1909,0.02044909949691891
STAT,1876,46,35-39,1922,0.001425941103156434
STAT,1875,26,na,1901,24.616266336005165
SIM,1848,34,30-34,1882,1
STAT,1890,1,na,1891,33.062591001068725
SIM,1947,14,na,1961,40
SIM,1856,24,20-24,1880,2
STAT,1806,91,na,1897,0.27114881851511746
STAT,1907,27,40-44,1934,0.043817657584723405
STAT,1847,31,45-49,1878,0.022100120489994633
STAT,1834,35,40-44,1869,0.03928669731684003
STAT,1893,5,na,1898,33.043037720836715
STAT,1839,37,25-29,1876,0.018987586235340664
STAT,1833,32,20-24,1865,0.02576557947684236
SIM,1888,23,20-24,1911,2
STAT,1889,35,30-34,1924,0.06587141372678763
STAT,1932,21,50-100,1953,0.008624488283550029
STAT,1934,25,35-39,1959,0.2012885425516396
STAT,1775,91,na,1866,0.2684544825461879
STAT,1878,44,45-49,1922,0.01524300863703085
STAT,1915,34,30-34,1949,0.15771238255924178
STAT,1917,30,25-29,1947,0.09667610150415612
SIM,1860,16,na,1876,28
STAT,1941,18,45-49,1959,0.005106408635447814
STAT,1916,33,na,1949,38.54982336920592
STAT,1841,23,15-19,1864,0.04061298439057769
STAT,1843,16,na,1859,12.517093602670792
STAT,1854,45,45-49,1899,0.0014568959013056696
STAT,1880,8,na,1888,27.67250452882229
STAT,1855,71,na,1926,9.39792824189736
STAT,1872,42,50-100,1914,0.010795992913549823
STAT,1945,16,20-24,1961,1.470774913579973
STAT,1836,68,na,1904,14.748712194820275
STAT,1931,29,40-44,1960,0.059850276888908545
SIM,1945,26,30-34,1971,1
STAT,1905,41,na,1946,33.62342001949052
STAT,1904,18,25-29,1922,0.08098528522193527
STAT,1906,26,na,1932,34.790771803871756
STAT,1868,39,45-49,1907,0.019097709830528786
STAT,1838,44,15-19,1882,1.1118252236279087E-4
STAT,1875,17,40-44,1892,0.0018801376610673856
STAT,1919,22,na,1941,39.641039228348426
STAT,1844,24,45-49,1868,0.006703309011967369
SIM,1870,23,na,1893,24
STAT,1829,34,20-24,1863,0.025117138284015
STAT,1849,36,50-100,1885,0.009842961593487262
STAT,1869,52,na,1921,20.751869093006174
STAT,1891,44,50-100,1935,0.012791484489740554
STAT,1850,100,na,1950,0.009452514808681246
STAT,1853,23,na,1876,15.763246809972188
STAT,1872,27,25-29,1899,0.4328155342347207
STAT,1854,53,na,1907,12.9496023839982
SIM,1903,67,na,1970,26
STAT,1846,75,na,1921,8.343050062070176
STAT,1861,35,35-39,1896,0.06004501351631856
SIM,1953,16,20-24,1969,2
STAT,1859,22,30-34,1881,0.1468888978540627
STAT,1868,22,na,1890,22.887646798711412
STAT,1939,22,25-29,1961,0.9212846331114323
STAT,1925,23,35-39,1948,0.11165636373023094
STAT,1908,47,45-49,1955,0.001955343072722537
STAT,1849,44,25-29,1893,0.004912019514860251
STAT,1869,32,35-39,1901,0.09812533525808227
SIM,1885,22,25-29,1907,1
STAT,1866,63,na,1929,16.433112967856008
STAT,1950,14,na,1964,46.14217867618419
STAT,1826,46,na,1872,18.084586723413288
STAT,1907,41,20-24,1948,1.6204658974158266E-4
STAT,1876,37,50-100,1913,0.012469517211696599
STAT,1850,35,25-29,1885,0.026587777629307682
STAT,1877,81,na,1958,6.656215803834906
SIM,1834,61,na,1895,12
SIM,1895,66,na,1961,18
STAT,1923,22,50-100,1945,0.007603030757040279
SIM,1896,29,na,1925,32
STAT,1937,26,30-34,1963,0.37970900428256127
STAT,1864,34,15-19,1898,0.0012663513925091558
STAT,1866,34,50-100,1900,0.008366205861663374
STAT,1840,72,na,1912,9.895933747472334
STAT,1916,27,50-100,1943,0.010203604084040092
STAT,1935,29,50-100,1964,0.013494407844556779
STAT,1897,18,30-34,1915,0.021110420713429272
STAT,1786,83,na,1869,0.5720374174920488
SIM,1824,54,na,1878,16
STAT,1875,26,30-34,1901,0.25974368930979447
SIM,1914,41,na,1955,36
STAT,1834,33,25-29,1867,0.09175940615282731
STAT,1863,31,50-100,1894,0.008145568715664764
STAT,1875,22,15-19,1897,0.03391205908817041
STAT,1807,54,na,1861,13.333239437758248
STAT,1929,33,20-24,1962,0.03081553643556662
STAT,1859,43,30-34,1902,0.009071748154187985
STAT,1889,25,20-24,1914,0.14460632298022413
STAT,1817,61,na,1878,17.497583166207107
STAT,1911,17,20-24,1928,0.2695506497026033
STAT,1941,24,30-34,1965,0.29466353343453683
STAT,1857,104,na,1961,0.001492951974900967
STAT,1868,19,15-19,1887,0.05778441687867795
SIM,1864,38,na,1902,22
STAT,1811,101,na,1912,0.003233787993001827
STAT,1818,46,na,1864,7.097107859205447
STAT,1849,46,40-44,1895,0.001331238837243104
SIM,1835,46,na,1881,17
STAT,1903,31,35-39,1934,0.1445682502157665
STAT,1874,27,35-39,1901,0.09788755002474976
STAT,1904,20,50-100,1924,0.005878054586495583
STAT,1831,76,na,1907,7.6881210549629655
STAT,1896,25,20-24,1921,0.15514227925252497
STAT,1853,25,40-44,1878,0.02212631807303939
STAT,1853,45,na,1898,14.28079461946249
SIM,1948,21,20-24,1969,1
STAT,1882,15,25-29,1897,0.05455905664544243
STAT,1907,9,na,1916,37.95303598298565
STAT,1918,23,35-39,1941,0.1003230741754998
STAT,1834,25,30-34,1859,0.23673803882421457
STAT,1885,15,35-39,1900,0.00544375957629613
STAT,1946,21,na,1967,40.364164380433074
STAT,1866,20,15-19,1886,0.031076137655196533
STAT,1850,34,20-24,1884,0.024659122802733746
STAT,1921,48,50-100,1969,0.0025228387179694867
SIM,1837,72,na,1909,19
SIM,1942,25,35-39,1967,1
STAT,1902,39,15-19,1941,1.692009869152459E-4
STAT,1934,17,50-100,1951,0.00504612417928278
SIM,1902,9,na,1911,38
STAT,1842,53,na,1895,15.895381872763377
STAT,1848,34,30-34,1882,0.11736183551493912
STAT,1878,66,na,1944,16.92142842887224
SIM,1839,31,na,1870,22
SIM,1872,89,na,1961,3
STAT,1846,27,15-19,1873,0.0044481798787431625
STAT,1826,42,30-34,1868,0.012170121964500706
STAT,1839,64,na,1903,9.593238198464944
STAT,1882,24,15-19,1906,0.03141806998136652
STAT,1858,47,50-100,1905,0.0018601673296276984
STAT,1864,38,30-34,1902,0.04756510377799591
STAT,1931,34,15-19,1965,0.0016742117960515154
STAT,1852,38,50-100,1890,0.010455496708768653
STAT,1893,33,30-34,1926,0.21921660910251908
SIM,1926,44,na,1970,46
SIM,1907,23,25-29,1930,1
STAT,1878,43,40-44,1921,0.023054168627379554
STAT,1888,73,na,1961,15.79276179688253
SIM,1897,5,na,1902,43
STAT,1931,22,na,1953,47.15322966727269
SIM,1886,43,40-44,1929,1
STAT,1845,25,na,1870,15.61510219859786
STAT,1892,27,na,1919,29.483290536465994
STAT,1796,82,na,1878,0.3361046486958238
STAT,1870,44,45-49,1914,0.014666769955166288
SIM,1872,47,na,1919,21
STAT,1826,40,35-39,1866,0.01988762865030063
STAT,1889,31,15-19,1920,0.0017506675125383815
STAT,1898,37,25-29,1935,0.03884039482618081
STAT,1896,17,na,1913,33.174745666827555
SIM,1874,44,25-29,1918,1
STAT,1884,22,25-29,1906,0.5608649957023444
STAT,1805,50,45-49,1855,2.921399010398518E-4
SIM,1832,29,25-29,1861,2
SIM,1898,40,na,1938,32
STAT,1876,19,45-49,1895,6.598873250377897E-4
STAT,1866,44,25-29,1910,0.005834317929432848
STAT,1850,35,30-34,1885,0.049215673754200266
STAT,1877,45,40-44,1922,0.0017848494623382654
STAT,1887,34,15-19,1921,0.0015410827084112832
STAT,1813,45,50-100,1858,0.007842778460570079
STAT,1830,37,50-100,1867,0.0071822212048253484
STAT,1871,25,20-24,1896,0.11775612398264154
STAT,1833,38,35-39,1871,0.06479235687456887
STAT,1850,9,na,1859,26.50746507511019
STAT,1871,27,15-19,1898,0.004523415939926645
STAT,1845,19,15-19,1864,0.043330591092091655
STAT,1859,19,50-100,1878,4.4669788826713316E-4
STAT,1881,63,na,1944,16.97842995690422
SIM,1858,12,na,1870,27
STAT,1854,28,25-29,1882,0.26911013958836255
STAT,1809,74,na,1883,6.529078131238513
STAT,1820,41,na,1861,15.721874445920276
STAT,1864,47,25-29,1911,5.142190318136467E-4
STAT,1854,61,na,1915,11.42175502744653
STAT,1872,27,na,1899,24.418194702665268
STAT,1872,41,45-49,1913,0.015382464861680864
STAT,1822,76,na,1898,3.360588659862503
STAT,1837,43,45-49,1880,0.008488434881424419
STAT,1908,17,40-44,1925,0.002699094825747573
STAT,1893,31,35-39,1924,0.12821170409541766
STAT,1879,28,30-34,1907,0.25971774457872804
SIM,1957,13,na,1970,56
STAT,1910,37,20-24,1947,0.0025057514494832697
STAT,1801,104,na,1905,2.4172069825322259E-4
STAT,1816,39,45-49,1855,0.029334494660599533
STAT,1788,87,na,1875,0.6832775278786203
STAT,1792,92,na,1884,0.23385173500486878
STAT,1905,19,na,1924,36.25511507437454
SIM,1928,18,15-19,1946,2
STAT,1877,58,na,1935,20.413968666703784
STAT,1841,43,50-100,1884,0.010608502143471641
STAT,1886,38,45-49,1924,0.02057520432132684
STAT,1849,46,45-49,1895,0.00183511895955552
STAT,1841,44,20-24,1885,0.0015744411147010139
STAT,1886,3,na,1889,28.924356318915503
STAT,1915,49,na,1964,36.48457165142773
STAT,1845,37,15-19,1882,3.4489014972416903E-4
STAT,1856,25,25-29,1881,0.32215737475256934
STAT,1873,22,20-24,1895,0.7006282414243278
SIM,1892,22,25-29,1914,1
STAT,1948,21,20-24,1969,1.268713872061569
STAT,1888,10,na,1898,30.270498717903198
STAT,1833,36,40-44,1869,0.0409421423947494
STAT,1883,41,20-24,1924,0.001549182021559648
STAT,1891,18,30-34,1909,0.019511322590219694
STAT,1877,32,35-39,1909,0.10453775865624111
SIM,1821,43,na,1864,12
STAT,1845,35,20-24,1880,0.0053118131847728215
STAT,1831,40,45-49,1871,0.01521072777672106
SIM,1837,18,20-24,1855,1
STAT,1863,15,15-19,1878,0.06067066514936381
STAT,1846,66,na,1912,13.282998956243699
STAT,1882,43,25-29,1925,0.006109616348529665
SIM,1855,55,na,1910,11
STAT,1906,19,50-100,1925,7.079447358073795E-4
STAT,1913,14,na,1927,39.911585333448286
SIM,1851,21,25-29,1872,1
STAT,1890,32,50-100,1922,0.011129661274643236
SIM,1888,42,na,1930,34
STAT,1882,27,20-24,1909,0.11242763378981593
STAT,1821,33,40-44,1854,0.11657377971708707
STAT,1847,32,20-24,1879,0.033903015707910794
STAT,1931,35,50-100,1966,0.005545390558276063
STAT,1871,42,40-44,1913,0.022397678943503276
STAT,1850,71,na,1921,11.884596178227692
STAT,1876,21,50-100,1897,0.004154210133977169
SIM,1885,14,na,1899,26
STAT,1841,42,25-29,1883,0.006531450631535979
STAT,1881,44,20-24,1925,0.0014907769562481285
STAT,1843,21,25-29,1864,0.307008440610054
STAT,1850,17,30-34,1867,0.017341486269129004
STAT,1895,29,25-29,1924,0.5452553142219337
STAT,1827,39,20-24,1866,0.006129710721242241
STAT,1867,41,35-39,1908,0.017407182337236756
STAT,1892,34,25-29,1926,0.12545454971549558
STAT,1858,43,na,1901,17.46020972116916
STAT,1920,29,30-34,1949,0.42311964459941986
STAT,1835,33,40-44,1868,0.024840611272011447
STAT,1857,36,25-29,1893,0.021657641557231624
STAT,1927,42,na,1969,46.340269653525496
STAT,1871,33,na,1904,23.69112943632359
STAT,1803,53,45-49,1856,2.776012085460294E-4
STAT,1825,43,25-29,1868,0.006130259222884234
STAT,1867,26,40-44,1893,0.028764740572488928
STAT,1863,33,45-49,1896,0.01537460426943461
STAT,1824,31,na,1855,20.896171909323172
STAT,1866,42,30-34,1908,0.010575196498398663
SIM,1831,65,na,1896,4
SIM,1869,83,na,1952,2
STAT,1935,5,na,1940,54.7227312277055
SIM,1894,50,na,1944,29
STAT,1828,38,25-29,1866,0.012802099960697784
STAT,1841,35,na,1876,25.218400850956893
STAT,1877,34,50-100,1911,0.00937707001726655
STAT,1884,26,45-49,1910,0.01091554765356337
SIM,1926,21,na,1947,43
STAT,1802,54,40-44,1856,1.548865142503845E-4
STAT,1851,16,35-39,1867,0.005665486351931865
STAT,1852,48,45-49,1900,0.0019944228983979203
STAT,1910,39,15-19,1949,1.8070104215707258E-4
SIM,1861,63,na,1924,19
STAT,1840,46,25-29,1886,4.61017743120771E-4
STAT,1876,34,40-44,1910,0.043668575357525455
SIM,1916,8,na,1924,48
STAT,1882,45,20-24,1927,1.1614777118285162E-4
SIM,1810,71,na,1881,12
STAT,1864,17,30-34,1881,0.014788667137006661
STAT,1829,94,na,1923,0.13575583518771328
STAT,1906,30,50-100,1936,0.007704822205300997
STAT,1949,22,50-100,1971,0.007628910544274665
STAT,1823,46,25-29,1869,4.0489280004531874E-4
STAT,1842,40,20-24,1882,0.0012647743686573392
STAT,1819,45,20-24,1864,1.1104184891486636E-4
STAT,1824,100,na,1924,0.00738705462803908
STAT,1834,41,na,1875,18.142603718113957
STAT,1901,49,na,1950,30.829749283877398
STAT,1888,40,50-100,1928,0.01247024829883129
STAT,1856,96,na,1952,0.06220461065365777
STAT,1880,48,20-24,1928,1.2460083996250297E-4
STAT,1886,23,45-49,1909,0.007210731539911613
STAT,1886,38,15-19,1924,5.795832892456852E-4
STAT,1897,26,25-29,1923,0.5636717587244545
STAT,1917,22,30-34,1939,0.30268963724385517
SIM,1833,26,35-39,1859,1
STAT,1834,35,45-49,1869,0.017890909995028258
SIM,1925,22,30-34,1947,1
STAT,1854,20,50-100,1874,0.0029711807853874577
STAT,1870,29,20-24,1899,0.11570597240153035
STAT,1804,51,40-44,1855,2.949617662139198E-4
STAT,1830,44,45-49,1874,0.0015108503723611246
STAT,1947,22,15-19,1969,0.059750804125304736
STAT,1862,34,40-44,1896,0.037095318181531514
STAT,1851,34,35-39,1885,0.08715687535990455
STAT,1899,33,25-29,1932,0.13962274991504606
STAT,1865,46,30-34,1911,8.780295797842786E-4
STAT,1886,36,20-24,1922,0.008034239836363645
STAT,1813,44,45-49,1857,0.047859835494612715
STAT,1831,37,15-19,1868,5.742252825415807E-4
STAT,1855,107,na,1962,1.402909493863789E-4
STAT,1892,17,35-39,1909,0.006778794699779604
STAT,1848,47,40-44,1895,0.0011019883991488654
SIM,1880,22,na,1902,32
SIM,1882,57,na,1939,29
STAT,1834,34,35-39,1868,0.08978716197795195
STAT,1899,35,50-100,1934,0.016966601501699752
STAT,1825,42,40-44,1867,0.02187327438922145
STAT,1868,22,40-44,1890,0.02016596215318611
STAT,1902,42,na,1944,32.66508972590873
STAT,1890,37,25-29,1927,0.03497369151971215
STAT,1917,25,50-100,1942,0.010413704671338833
STAT,1949,20,25-29,1969,1.071685686142809
STAT,1926,30,30-34,1956,0.18963244248633496
STAT,1865,45,20-24,1910,1.0962056735589593E-4
SIM,1892,55,na,1947,32
STAT,1881,28,15-19,1909,0.004301980277860744
STAT,1878,12,na,1890,26.662277504417606
STAT,1850,19,25-29,1869,0.06093051625384727
SIM,1900,16,na,1916,38
STAT,1819,47,45-49,1866,0.002125139918820259
STAT,1909,16,45-49,1925,9.765138819026238E-4
STAT,1874,20,15-19,1894,0.033668006350165126
STAT,1871,40,45-49,1911,0.01507207131459263
STAT,1880,35,45-49,1915,0.021161655225934082
STAT,1894,31,50-100,1925,0.011790516085505402
STAT,1880,18,25-29,1898,0.05943253607033891
STAT,1833,48,na,1881,17.52670260620011
STAT,1889,44,20-24,1933,0.0019181525678965228
STAT,1869,38,15-19,1907,5.414060376468994E-4
STAT,1925,47,na,1972,44.2389152112777
STAT,1838,27,30-34,1865,0.248619627236264
STAT,1892,35,35-39,1927,0.08820926537664185
STAT,1824,45,30-34,1869,0.0012861493140222207
STAT,1875,35,35-39,1910,0.07339603556345065
SIM,1785,79,na,1864,4
STAT,1895,55,na,1950,26.84419954376798
STAT,1802,56,na,1858,9.238372962135934
STAT,1875,33,40-44,1908,0.04439081444308395
STAT,1851,33,na,1884,20.751746722789157
STAT,1828,37,15-19,1865,2.5114710204094596E-4
STAT,1865,43,25-29,1908,0.005766271738424558
STAT,1891,36,30-34,1927,0.06572814608506758
SIM,1862,57,na,1919,21
STAT,1865,15,50-100,1880,5.077578291384188E-4
STAT,1929,29,na,1958,46.613787474256426
STAT,1928,31,50-100,1959,0.0102935899769402
STAT,1963,9,na,1972,49.61669806685401
STAT,1895,28,15-19,1923,0.005869483395239562
SIM,1861,29,20-24,1890,1
STAT,1890,19,25-29,1909,0.06846477243175823
STAT,1918,20,25-29,1938,0.9931024136737207
STAT,1798,77,na,1875,6.226850029997976
STAT,1809,66,na,1875,11.073394868464435
STAT,1871,73,na,1944,11.841898238117782
STAT,1848,30,15-19,1878,0.001096528858437026
STAT,1830,24,20-24,1854,0.9911484038900411
STAT,1933,34,na,1967,50.694961105397645
STAT,1861,26,45-49,1887,0.009473008036309075
STAT,1853,29,20-24,1882,0.07661358105400085
STAT,1847,20,na,1867,28.406398164112485
STAT,1865,30,15-19,1895,0.0012984129893759658
SIM,1920,36,na,1956,46
STAT,1805,84,na,1889,0.9274500460084851
STAT,1869,36,20-24,1905,0.007505023067472606
STAT,1874,36,30-34,1910,0.05432834145417315
SIM,1926,20,25-29,1946,3
SIM,1851,65,na,1916,15
STAT,1952,20,30-34,1972,0.3437584433533346
STAT,1848,43,20-24,1891,0.0010196243639568475
STAT,1873,40,50-100,1913,0.010849247638498549
STAT,1830,26,45-49,1856,0.0112645601902724
SIM,1837,50,na,1887,29
STAT,1841,29,25-29,1870,0.5069148256248364
SIM,1779,79,na,1858,3
STAT,1824,51,50-100,1875,1.9248591825044654E-4
STAT,1872,38,15-19,1910,5.717069428617536E-4
STAT,1889,48,40-44,1937,0.0011674937990296026
STAT,1938,26,na,1964,36.88526001155379
STAT,1825,44,35-39,1869,0.016968871783327996
STAT,1876,96,na,1972,0.5248556493774138
STAT,1860,25,45-49,1885,0.009255610460042476
STAT,1848,49,35-39,1897,8.864760295057315E-4
STAT,1873,68,na,1941,15.5370717118569
STAT,1856,22,20-24,1878,0.5798032430957669
STAT,1893,30,25-29,1923,0.1301847783064244
STAT,1912,40,na,1952,35.94229729660649
STAT,1885,25,na,1910,23.727158501765782
SIM,1810,63,na,1873,13
STAT,1957,15,35-39,1972,0.05504117537732721
STAT,1889,83,na,1972,9.429189950960579
STAT,1851,15,25-29,1866,0.05885630041481316
STAT,1858,32,25-29,1890,0.07794055330231414
STAT,1883,42,30-34,1925,0.011150470126168476
STAT,1898,34,20-24,1932,0.03615209317601634
SIM,1814,53,na,1867,22
STAT,1871,28,25-29,1899,0.4202607733651592
STAT,1847,17,25-29,1864,0.07555250684649735
STAT,1907,20,20-24,1927,1.0140329901683465
STAT,1901,57,na,1958,28.76504165639516
STAT,1859,19,45-49,1878,5.955971843561776E-4
STAT,1812,86,na,1898,0.8817709076733743
STAT,1820,53,45-49,1873,1.1617161367342365E-4
STAT,1876,16,40-44,1892,0.00186220955361824
STAT,1844,54,45-49,1898,1.1023854007966057E-4
STAT,1850,36,40-44,1886,0.04000621543785664
STAT,1861,35,na,1896,20.00088387382214
STAT,1789,80,na,1869,1.608290481761354
STAT,1872,40,35-39,1912,0.018714658304013126
STAT,1841,27,30-34,1868,0.30614522769731695
STAT,1855,30,50-100,1885,0.006706293838505479
STAT,1914,2,na,1916,41.81859671895023
SIM,1863,27,30-34,1890,1
STAT,1833,39,45-49,1872,0.018072935195825195
STAT,1860,22,40-44,1882,0.01746354164034592
SIM,1943,20,25-29,1963,2
SIM,1840,61,na,1901,8
STAT,1799,79,na,1878,3.1898273652451112
STAT,1875,36,45-49,1911,0.020590519028684084
SIM,1929,17,20-24,1946,5
STAT,1849,86,na,1935,1.7204086247733053
STAT,1909,15,35-39,1924,0.008220639121034283
STAT,1861,63,na,1924,15.005205075812096
STAT,1874,19,40-44,1893,0.0018455849535363106
STAT,1835,36,45-49,1871,0.0113012513380736
SIM,1915,20,20-24,1935,2
STAT,1848,46,25-29,1894,3.7355665292762943E-4
SIM,1829,63,na,1892,18
STAT,1833,35,30-34,1868,0.050367051740447095
STAT,1823,49,30-34,1872,6.556721447202118E-4
STAT,1832,86,na,1918,1.0028999249020258
STAT,1782,90,na,1872,0.22586264891092867
STAT,1844,39,20-24,1883,0.006231835260637
STAT,1855,27,30-34,1882,0.18480375814547376
STAT,1846,51,45-49,1897,1.1817541495539467E-4
STAT,1854,25,20-24,1879,0.08380576749586718
SIM,1845,45,na,1890,22
STAT,1867,29,45-49,1896,0.010549222976891856
STAT,1873,29,50-100,1902,0.006457222121651069
STAT,1839,33,na,1872,14.566264119271406
STAT,1853,48,na,1901,13.962159203544866
STAT,1885,48,50-100,1933,0.0023948619303216724
STAT,1938,32,15-19,1970,0.0012836005952425642
SIM,1819,53,na,1872,5
STAT,1893,49,45-49,1942,0.0016434796689601197
STAT,1935,20,25-29,1955,1.2531290641957564
STAT,1862,35,20-24,1897,0.006713773220386017
STAT,1872,30,50-100,1902,0.009450107079911545
STAT,1845,22,45-49,1867,0.005060320812720389
STAT,1815,39,25-29,1854,0.04609284239803422
SIM,1908,36,na,1944,39
STAT,1842,22,20-24,1864,0.6521346409398395
STAT,1948,22,30-34,1970,0.3278249248217906
STAT,1882,25,na,1907,23.02626206130778
STAT,1895,26,20-24,1921,0.15282684796561324
STAT,1838,24,20-24,1862,0.6839995671464664
SIM,1874,50,na,1924,25
SIM,1834,21,25-29,1855,1
STAT,1795,89,na,1884,0.4677283342901068
STAT,1868,53,na,1921,20.50261594148548
STAT,1818,49,20-24,1867,1.1464990822751153E-4
STAT,1846,33,45-49,1879,0.016528480871900265
STAT,1865,25,na,1890,21.732245789480718
STAT,1812,43,45-49,1855,0.01733240975904843
STAT,1828,35,20-24,1863,0.003481599837612079
STAT,1872,23,15-19,1895,0.03365032907758091
STAT,1897,39,30-34,1936,0.01512228936498718
STAT,1925,17,40-44,1942,0.016790683270615253
STAT,1868,42,35-39,1910,0.01750249030881077
STAT,1883,27,40-44,1910,0.029089365768774522
STAT,1847,35,25-29,1882,0.03258104006147215
STAT,1851,28,50-100,1879,0.00627781206654017
STAT,1881,47,25-29,1928,5.455337956510478E-4
SIM,1909,29,na,1938,40
STAT,1821,51,40-44,1872,1.457717306507888E-4
STAT,1866,66,na,1932,15.094981087062918
STAT,1891,37,40-44,1928,0.05372788474826054
STAT,1849,94,na,1943,0.1549703078000528
STAT,1864,32,20-24,1896,0.02424435241441328
SIM,1916,31,na,1947,45
STAT,1848,29,40-44,1877,0.022795960966405193
STAT,1836,76,na,1912,9.14344082420079
STAT,1889,47,30-34,1936,6.654083419751924E-4
STAT,1894,30,na,1924,30.828597508606297
STAT,1914,48,45-49,1962,0.0021316676731047476
STAT,1824,42,25-29,1866,0.008702728659338597
SIM,1890,0,na,1890,35
STAT,1873,37,25-29,1910,0.029272585287054568
SIM,1914,44,na,1958,36
STAT,1861,43,na,1904,19.29609344330921
SIM,1930,5,na,1935,55
STAT,1889,15,na,1904,31.065463670294825
STAT,1891,33,25-29,1924,0.12518350427771893
SIM,1878,19,20-24,1897,1
SIM,1833,68,na,1901,3
STAT,1856,37,20-24,1893,0.0055842864051142
STAT,1834,32,40-44,1866,0.039256432040730906
STAT,1807,49,45-49,1856,0.004880684606033672
STAT,1824,46,40-44,1870,0.002244801993698247
SIM,1882,39,35-39,1921,2
SIM,1865,22,na,1887,21
SIM,1898,32,na,1930,34
STAT,1858,36,40-44,1894,0.03347069966451768
STAT,1874,53,na,1927,21.492977183804307
STAT,1909,33,35-39,1942,0.08634963734278132
STAT,1917,25,35-39,1942,0.15707720302029116
STAT,1885,45,na,1930,22.439009866346442
SIM,1854,30,na,1884,19
STAT,1840,43,20-24,1883,0.0012816122658361872
STAT,1866,27,35-39,1893,0.08886485101984158
STAT,1910,19,20-24,1929,0.26556560444645183
STAT,1883,23,20-24,1906,0.6671286373571645
STAT,1859,84,na,1943,2.6440632326405336
STAT,1876,37,45-49,1913,0.020246763025055445
SIM,1857,50,na,1907,22
STAT,1853,32,45-49,1885,0.011286112835634798
STAT,1845,37,45-49,1882,0.01224359885914467
STAT,1912,29,na,1941,36.36620000308037
STAT,1863,48,20-24,1911,1.0491271127815046E-4
STAT,1881,17,30-34,1898,0.01516636008978051
STAT,1833,35,25-29,1868,0.027209786423061082
SIM,1896,6,na,1902,33
STAT,1841,43,na,1884,23.208621472267
SIM,1795,89,na,1884,2
SIM,1897,29,30-34,1926,1
STAT,1880,32,40-44,1912,0.0456028765574074
STAT,1883,25,50-100,1908,0.006254078011294509
SIM,1850,71,na,1921,10
STAT,1809,46,45-49,1855,0.008177754177140064
SIM,1813,68,na,1881,3
SIM,1821,35,na,1856,18
STAT,1868,25,45-49,1893,0.01081780328597566
SIM,1953,9,na,1962,50
SIM,1907,62,na,1969,31
STAT,1937,21,45-49,1958,0.010891421161641804
STAT,1869,39,25-29,1908,0.027616955183867316
SIM,1859,5,na,1864,26
STAT,1816,99,na,1915,0.00568572655672356
STAT,1889,29,30-34,1918,0.30610643228928164
SIM,1922,31,na,1953,49
STAT,1900,32,35-39,1932,0.14043020030388853
STAT,1897,38,20-24,1935,0.010185756214518473
STAT,1838,42,20-24,1880,0.0014415211790193443
STAT,1850,32,25-29,1882,0.0954007357987389
STAT,1887,16,15-19,1903,0.06493517217669677
STAT,1892,16,25-29,1908,0.07017913530285959
STAT,1916,15,50-100,1931,7.917545332508718E-4
SIM,1846,24,20-24,1870,1
STAT,1840,33,50-100,1873,0.00865439403772368
STAT,1861,54,45-49,1915,1.1868684651913629E-4
STAT,1853,31,35-39,1884,0.06622705189182845
STAT,1884,43,30-34,1927,0.011182529043810343
SIM,1832,27,na,1859,25
STAT,1897,23,20-24,1920,0.9122994388375949
STAT,1818,71,na,1889,3.4697827916084694
STAT,1889,47,50-100,1936,0.0016882674418072458
STAT,1875,32,30-34,1907,0.17947579737602157
STAT,1836,44,40-44,1880,0.025170429012905483
STAT,1851,19,45-49,1870,6.626148407195267E-4
STAT,1834,36,50-100,1870,0.010904779184119362
STAT,1782,104,na,1886,2.575084033356154E-4
STAT,1864,29,25-29,1893,0.3766994012538565
STAT,1817,52,30-34,1869,1.6549100036151472E-4
STAT,1927,32,40-44,1959,0.047892769499923916
STAT,1817,39,50-100,1856,0.042893574129174064
STAT,1837,18,50-100,1855,4.481880428722228E-4
STAT,1846,15,15-19,1861,0.06113542407248957
STAT,1925,39,na,1964,44.776598899371336
SIM,1871,22,na,1893,24
SIM,1895,34,45-49,1929,1
SIM,1871,18,20-24,1889,1
SIM,1867,88,na,1955,1
SIM,1825,39,50-100,1864,1
STAT,1849,43,40-44,1892,0.01731470152082966
STAT,1865,47,40-44,1912,0.0015412632249530876
SIM,1932,6,na,1938,54
SIM,1949,18,na,1967,35
STAT,1912,16,50-100,1928,7.535164751175857E-4
STAT,1807,48,35-39,1855,0.002934228223112096
STAT,1834,31,30-34,1865,0.15969694078585306
STAT,1935,23,35-39,1958,0.1276107135887189
STAT,1852,100,na,1952,0.00908607007193846
STAT,1894,32,35-39,1926,0.12978765651712687
STAT,1889,47,25-29,1936,3.959454558716525E-4
STAT,1848,46,30-34,1894,6.277827144427452E-4
STAT,1899,5,na,1904,35.87480189582821
STAT,1882,40,20-24,1922,0.0015373320882137657
SIM,1892,47,na,1939,32
STAT,1851,33,25-29,1884,0.08907134326313462
STAT,1920,16,na,1936,41.04507112371056
STAT,1943,15,35-39,1958,0.04419624230073227
STAT,1795,80,na,1875,3.1405652147812737
STAT,1863,18,20-24,1881,0.1620348325875075
SIM,1864,83,na,1947,3
STAT,1843,42,30-34,1885,0.005021236314518852
STAT,1811,47,45-49,1858,0.009345877204251528
STAT,1880,15,20-24,1895,0.1872910780061996
STAT,1825,29,45-49,1854,0.022995824746418068
STAT,1827,41,35-39,1868,0.014363182767256573
STAT,1852,30,35-39,1882,0.0916219640686879
STAT,1842,41,30-34,1883,0.009039312290663024
STAT,1874,39,35-39,1913,0.0710320066948711
STAT,1871,27,45-49,1898,0.011069726087112224
STAT,1841,26,20-24,1867,0.14365482847272934
STAT,1920,29,50-100,1949,0.010748451026301403
SIM,1891,62,na,1953,28
STAT,1923,21,15-19,1944,0.06169421131947516
SIM,1802,76,na,1878,2
SIM,1878,40,na,1918,28
STAT,1873,25,25-29,1898,0.4329931980247629
SIM,1875,75,na,1950,5
STAT,1837,61,na,1898,9.035306928158194
SIM,1860,30,35-39,1890,1
SIM,1933,23,na,1956,47
STAT,1856,38,30-34,1894,0.03841773696201117
STAT,1861,23,40-44,1884,0.017873728698458633
STAT,1899,37,40-44,1936,0.012934308101886791
SIM,1874,28,50-100,1902,1
STAT,1819,56,na,1875,11.838989415717275
STAT,1877,30,40-44,1907,0.045126072945850554
SIM,1880,90,na,1970,3
STAT,1887,34,45-49,1921,0.018870993073150103
STAT,1830,51,na,1881,8.18929741573019
STAT,1846,33,15-19,1879,0.0013497835524211867
SIM,1804,63,na,1867,9
STAT,1867,40,25-29,1907,0.00620719674405633
SIM,1878,12,na,1890,31
STAT,1937,18,15-19,1955,0.4375689760131361
STAT,1879,25,20-24,1904,0.1222454586212641
SIM,1842,31,30-34,1873,1
STAT,1914,47,35-39,1961,0.0012680738667508738
STAT,1848,28,30-34,1876,0.19301776815485705
STAT,1869,18,20-24,1887,0.17313200532146483
SIM,1803,61,na,1864,7
STAT,1785,99,na,1884,0.010325929549018618
STAT,1832,24,25-29,1856,0.34430081369534005
SIM,1895,75,na,1970,14
STAT,1863,36,20-24,1899,0.0068579271153581195
STAT,1876,30,25-29,1906,0.10486477212450854
SIM,1889,2,na,1891,34
STAT,1945,16,na,1961,39.930294160853315
STAT,1837,28,20-24,1865,0.07325097499957897
STAT,1820,37,45-49,1857,0.018796175723082804
STAT,1922,25,15-19,1947,0.007983580224281537
STAT,1846,37,30-34,1883,0.04510499499736587
STAT,1869,53,40-44,1922,1.003689266583191E-4
STAT,1888,48,25-29,1936,3.749206475527317E-4
STAT,1954,18,15-19,1972,0.5576639402228278
SIM,1860,70,na,1930,13
STAT,1856,40,15-19,1896,1.010524810894404E-4
SIM,1921,46,na,1967,41
STAT,1843,24,35-39,1867,0.030626421679756186
SIM,1929,7,na,1936,51
STAT,1820,51,50-100,1871,1.257877377227804E-4
STAT,1860,21,30-34,1881,0.15035695464055446
STAT,1841,66,na,1907,16.042874647297364
STAT,1912,21,40-44,1933,0.03206789145281107
SIM,1951,8,na,1959,51
STAT,1849,33,50-100,1882,0.007409023724272285
STAT,1848,13,na,1861,19.05112090263561
STAT,1896,24,45-49,1920,0.009102229374119856
SIM,1868,73,na,1941,22
STAT,1885,42,35-39,1927,0.017860038497321557
STAT,1869,83,na,1952,3.8465713509597275
SIM,1796,74,na,1870,3
STAT,1891,30,20-24,1921,0.03344304077747927
STAT,1854,33,na,1887,14.782614404147317
STAT,1936,20,50-100,1956,0.006257033503234505
SIM,1870,91,na,1961,1
STAT,1871,24,40-44,1895,0.020645522794730625
STAT,1864,17,25-29,1881,0.05257856033746064
SIM,1876,17,na,1893,31
STAT,1872,58,na,1930,20.234188186180187
SIM,1917,16,na,1933,45
STAT,1953,11,na,1964,47.25082508254779
STAT,1784,104,na,1888,4.7934276826292187E-4
SIM,1887,57,na,1944,21
STAT,1893,16,45-49,1909,8.256595410352916E-4
STAT,1883,10,na,1893,25.154175670742962
STAT,1821,34,20-24,1855,0.06806803160473918
SIM,1858,43,na,1901,24
STAT,1838,27,50-100,1865,0.006315650718737529
STAT,1875,17,35-39,1892,0.0056404126566289734
SIM,1902,62,na,1964,30
SIM,1837,19,na,1856,30
STAT,1851,30,20-24,1881,0.024250007249337346
SIM,1889,35,na,1924,32
STAT,1869,94,na,1963,0.5120904430405573
STAT,1855,7,na,1862,20.727227561673406
STAT,1893,19,45-49,1912,8.192196805163918E-4
STAT,1922,39,40-44,1961,0.016873045940596517
SIM,1837,81,na,1918,3
STAT,1872,27,30-34,1899,0.25765369499103496
STAT,1838,91,na,1929,0.4497600331670437
STAT,1869,51,45-49,1920,1.4128958578478427E-4
STAT,1894,50,na,1944,27.992138805598135
SIM,1932,20,20-24,1952,4
STAT,1825,45,45-49,1870,0.0022374202195527292
STAT,1876,49,45-49,1925,0.002346878028558025
STAT,1813,41,40-44,1854,0.07813938120781187
STAT,1821,54,45-49,1875,1.892796538208238E-4
STAT,1879,39,15-19,1918,5.753557564477233E-4
STAT,1913,20,45-49,1933,0.010876321101513094
STAT,1849,42,30-34,1891,0.008903452331859069
SIM,1956,11,na,1967,47
STAT,1867,22,25-29,1889,0.5500747061609628
STAT,1899,36,35-39,1935,0.09728961766447143
STAT,1841,48,35-39,1889,0.0013590295642731882
STAT,1826,28,45-49,1854,0.037881217614234734
SIM,1834,30,na,1864,21
STAT,1831,101,na,1932,0.004630574550101352
STAT,1923,38,45-49,1961,0.007836347810925138
STAT,1935,35,50-100,1970,0.005855004207216214
STAT,1956,8,na,1964,51.71175237140616
SIM,1894,5,na,1899,32
SIM,1898,25,30-34,1923,1
SIM,1770,89,na,1859,4
SIM,1923,24,na,1947,42
STAT,1857,19,40-44,1876,0.0015904117451057344
STAT,1872,38,20-24,1910,0.007847976137339422
STAT,1866,28,50-100,1894,0.00587071099501374
STAT,1872,5,na,1877,28.36566737138347
SIM,1877,47,na,1924,25
STAT,1821,36,15-19,1857,0.0012513977702651197
STAT,1799,70,na,1869,7.485865672066348
STAT,1838,27,25-29,1865,0.4176397966551376
STAT,1890,18,15-19,1908,0.07189829181496427
STAT,1845,34,40-44,1879,0.02952202145822817
SIM,1856,65,na,1921,8
STAT,1840,49,30-34,1889,7.455526866591284E-4
STAT,1894,61,na,1955,23.948281912870183
SIM,1847,29,na,1876,19
STAT,1909,30,30-34,1939,0.15070499711735652
STAT,1837,25,20-24,1862,0.07543808007980586
SIM,1823,78,na,1901,2
STAT,1880,30,45-49,1910,0.01848461337925131
STAT,1948,4,na,1952,45.1198072634262
STAT,1934,38,20-24,1972,0.0036186610707638644
STAT,1855,41,45-49,1896,0.010585070965352286
STAT,1892,36,45-49,1928,0.024746221554075964
STAT,1912,48,40-44,1960,0.0014991778610803047
STAT,1847,47,25-29,1894,6.124359283584918E-4
SIM,1881,32,na,1913,24
STAT,1821,66,na,1887,10.19352937892513
STAT,1775,89,na,1864,0.5418536243322458
STAT,1924,20,20-24,1944,1.311325827623014
STAT,1846,46,50-100,1892,0.00199606258505631
SIM,1845,25,20-24,1870,1
SIM,1850,60,na,1910,18
STAT,1914,24,na,1938,36.76778859741959
STAT,1857,37,40-44,1894,0.03277033784677529
SIM,1885,42,na,1927,24
STAT,1826,46,45-49,1872,0.0024080314773031403
STAT,1884,20,na,1904,23.309864836751387
STAT,1830,82,na,1912,1.6763938180526754
STAT,1855,23,45-49,1878,0.005694484860926016
STAT,1793,85,na,1878,0.48099300613449236
STAT,1939,31,20-24,1970,0.024730772709379224
STAT,1932,15,30-34,1947,0.16149142379252912
SIM,1862,17,na,1879,26
STAT,1898,38,40-44,1936,0.012682754259989297
SIM,1857,24,30-34,1881,2
STAT,1893,34,40-44,1927,0.054212522343794485
STAT,1907,42,na,1949,33.882685585563735
SIM,1895,38,30-34,1933,1
STAT,1812,42,35-39,1854,0.021291262082958413
STAT,1851,35,45-49,1886,0.017366801709818344
SIM,1803,78,na,1881,1
SIM,1925,39,na,1964,43
SIM,1861,32,na,1893,25
STAT,1836,45,20-24,1881,1.243435764445119E-4
STAT,1858,39,45-49,1897,0.015016658576055551
STAT,1888,18,25-29,1906,0.06604777739800481
STAT,1878,43,na,1921,23.689273783403344
STAT,1826,43,40-44,1869,0.023393352114627335
STAT,1827,51,na,1878,14.452108950628723
SIM,1864,80,na,1944,6
STAT,1873,37,20-24,1910,0.007837163767460041
STAT,1851,16,40-44,1867,0.0018884955599855959
STAT,1835,48,45-49,1883,0.0011120884677907894
SIM,1884,80,na,1964,8
STAT,1840,16,30-34,1856,0.016266207667652483
STAT,1904,14,na,1918,36.88473492298671
SIM,1863,10,na,1873,20
STAT,1884,38,50-100,1922,0.011969170641323698
STAT,1841,46,40-44,1887,0.001705032836699557
SIM,1874,73,na,1947,17
STAT,1821,36,45-49,1857,0.04442461556123853
STAT,1936,22,35-39,1958,0.08947636827269904
SIM,1892,24,na,1916,32
STAT,1825,73,na,1898,6.403214738072498
STAT,1911,39,30-34,1950,0.017314170014615014
STAT,1880,51,45-49,1931,1.5333589942555643E-4
STAT,1878,29,20-24,1907,0.1202519124567932
SIM,1872,24,na,1896,23
STAT,1890,36,15-19,1926,6.853941264200052E-4
STAT,1857,33,20-24,1890,0.020149921956540827
STAT,1887,38,30-34,1925,0.057884217121455646
STAT,1849,24,30-34,1873,0.16459575826463604
STAT,1945,7,na,1952,42.86089707776804
STAT,1836,96,na,1932,0.0828702682500822
STAT,1872,23,45-49,1895,0.007112740068549833
STAT,1878,26,20-24,1904,0.12153320591232289
STAT,1928,9,na,1937,49.91488895243478
SIM,1889,27,na,1916,32
STAT,1888,36,25-29,1924,0.03380818276365085
STAT,1826,47,50-100,1873,0.002472647243478286
STAT,1907,65,na,1972,28.411141279634105
SIM,1943,20,30-34,1963,1
STAT,1846,19,30-34,1865,0.016035983258452617
STAT,1882,27,25-29,1909,0.4053930357997499
SIM,1792,81,na,1873,1
STAT,1840,41,na,1881,19.135668458189354
STAT,1870,31,35-39,1901,0.10101223730478488
STAT,1832,39,25-29,1871,0.016003553934394243
STAT,1831,37,20-24,1868,0.007882546068594874
STAT,1873,4,na,1877,29.77917821385034
STAT,1910,17,na,1927,38.036450901250774
STAT,1892,17,40-44,1909,0.0022595983640879176
STAT,1813,42,15-19,1855,4.711270849482353E-4
STAT,1879,28,25-29,1907,0.4362827956881821
STAT,1842,26,40-44,1868,0.027994806459378282
SIM,1905,39,na,1944,40
SIM,1899,34,na,1933,27
STAT,1829,66,na,1895,11.133009396311769
STAT,1863,18,25-29,1881,0.05179263720605888
STAT,1915,43,35-39,1958,0.002006622303030005
STAT,1836,29,15-19,1865,0.005584705721509478
STAT,1852,36,45-49,1888,0.017332843634702725
STAT,1832,36,25-29,1868,0.016509929581803966
STAT,1879,93,na,1972,1.3735099879062491
SIM,1909,20,25-29,1929,1
SIM,1919,28,na,1947,40
STAT,1865,0,na,1865,34.46532345340887
STAT,1842,29,40-44,1871,0.027396117564452704
STAT,1884,35,50-100,1919,0.0121430729470675
STAT,1914,44,30-34,1958,0.0012521235610040602
STAT,1922,42,na,1964,42.31619011075901
SIM,1845,14,na,1859,24
STAT,1813,48,na,1861,20.082249877302466
STAT,1797,92,na,1889,0.10226346480864287
STAT,1939,15,15-19,1954,0.4522706977436395
STAT,1896,28,30-34,1924,0.32960899579184977
STAT,1909,20,na,1929,35.47920527485839
SIM,1840,24,25-29,1864,2
STAT,1919,47,50-100,1966,0.0024319588853210687
STAT,1939,26,50-100,1965,0.009942076621029843
STAT,1876,65,na,1941,17.164032475284944
STAT,1878,47,20-24,1925,1.2331252897915848E-4
STAT,1935,20,30-34,1955,0.3899179178333627
STAT,1884,25,35-39,1909,0.09517692479644334
STAT,1863,47,50-100,1910,0.002164398731742384
SIM,1954,16,na,1970,44
STAT,1852,15,45-49,1867,6.841998214247273E-4
STAT,1877,48,45-49,1925,0.0024055259604269805
STAT,1880,33,15-19,1913,0.0014911728841259058
SIM,1925,28,na,1953,42
STAT,1847,51,na,1898,23.1109847951463
SIM,1845,25,na,1870,23
STAT,1785,103,na,1888,0.001555696979616329
STAT,1861,38,45-49,1899,0.016681185399709513
STAT,1906,25,30-34,1931,0.3683286488694617
STAT,1867,44,40-44,1911,0.021234139931664717
SIM,1834,22,na,1856,23
STAT,1853,99,na,1952,0.011902598480896365
STAT,1866,43,40-44,1909,0.02056577202516035
STAT,1877,46,20-24,1923,1.2422302528092177E-4
STAT,1852,18,45-49,1870,6.721810797590516E-4
SIM,1881,40,50-100,1921,1
SIM,1861,55,na,1916,23
STAT,1843,21,30-34,1864,0.09552734458103648
SIM,1865,14,na,1879,25
STAT,1894,44,35-39,1938,0.0015898055164439517
STAT,1874,61,na,1935,18.957147325794274
STAT,1830,74,na,1904,3.987382685814886
STAT,1902,49,30-34,1951,7.539307257037911E-4
STAT,1868,13,na,1881,25.729540377366718
STAT,1949,3,na,1952,45.9725906863349
STAT,1850,38,35-39,1888,0.06331122008365918
SIM,1895,35,na,1930,27
STAT,1837,28,25-29,1865,0.26412932594389266
STAT,1913,17,15-19,1930,0.09201385396114622
SIM,1902,11,na,1913,37
STAT,1829,37,30-34,1866,0.048971551474997856
STAT,1854,28,20-24,1882,0.07463230384083806
STAT,1870,41,40-44,1911,0.02244515091728018
STAT,1873,19,25-29,1892,0.057304242219836474
STAT,1843,40,35-39,1883,0.008114094096259739
STAT,1834,33,na,1867,19.415551328977173
SIM,1871,62,na,1933,19
STAT,1868,36,35-39,1904,0.06877730860806064
STAT,1793,77,na,1870,1.8411224614438453
STAT,1878,20,na,1898,24.562863725477243
STAT,1883,44,25-29,1927,0.006151695411859345
STAT,1877,33,45-49,1910,0.0179248340323133
STAT,1840,81,na,1921,4.237383249271901
STAT,1865,28,30-34,1893,0.22696535560728864
STAT,1854,40,45-49,1894,0.009240295415496749
STAT,1910,44,50-100,1954,0.0010899449066929144
SIM,1879,9,na,1888,17
STAT,1815,74,na,1889,4.0402143588321975
STAT,1898,20,na,1918,32.09488672551161
STAT,1822,35,20-24,1857,0.004999786197501669
STAT,1938,18,30-34,1956,0.11940464283789257
SIM,1881,83,na,1964,1
STAT,1893,20,na,1913,29.998287670484583
STAT,1832,36,20-24,1868,0.004420211629857385
SIM,1845,28,25-29,1873,2
STAT,1867,68,na,1935,14.624247841468858
SIM,1891,8,na,1899,38
STAT,1925,16,na,1941,44.293682276506004
STAT,1776,85,na,1861,0.5744469833413008
STAT,1846,52,50-100,1898,1.2174534582123865E-4
STAT,1867,47,45-49,1914,0.002247898025739195
STAT,1888,13,na,1901,30.132373135660938
SIM,1840,21,20-24,1861,2
STAT,1949,18,40-44,1967,0.016158351264798584
STAT,1887,71,na,1958,15.469361409142723
SIM,1921,17,15-19,1938,1
SIM,1883,4,na,1887,21
SIM,1918,9,na,1927,41
STAT,1842,47,40-44,1889,0.001284692186474204
STAT,1896,39,15-19,1935,7.301866624993271E-4
SIM,1940,7,na,1947,37
STAT,1911,35,15-19,1946,1.8603391487475126E-4
SIM,1812,75,na,1887,8
STAT,1889,20,50-100,1909,0.0050224965849480115
STAT,1911,22,35-39,1933,0.08872463307571793
STAT,1852,33,40-44,1885,0.03803191605213296
STAT,1835,46,50-100,1881,0.0011873911172495563
STAT,1872,83,na,1955,4.061852647810762
SIM,1915,46,na,1961,31
STAT,1899,33,30-34,1932,0.2380033122338774
STAT,1828,38,20-24,1866,0.003427512567663537
STAT,1895,41,50-100,1936,9.56737935968575E-4
STAT,1901,28,15-19,1929,0.006326172165133736
STAT,1836,47,45-49,1883,0.0023835593809759946
STAT,1956,16,25-29,1972,0.5703568192899136
STAT,1892,33,40-44,1925,0.053350035890019736
STAT,1847,29,25-29,1876,0.5353645789034159
STAT,1833,50,50-100,1883,1.198925546954863E-4
STAT,1845,42,50-100,1887,0.006288602874975273
STAT,1871,45,45-49,1916,0.0023763784527484496
STAT,1838,45,25-29,1883,4.718711697470511E-4
STAT,1877,15,45-49,1892,6.774316705293798E-4
STAT,1817,50,35-39,1867,2.4907434784462377E-4
STAT,1862,37,15-19,1899,4.8448169752572694E-4
STAT,1865,3,na,1868,28.93809742181855
STAT,1830,26,15-19,1856,0.004603030889830613
STAT,1878,29,25-29,1907,0.4336059223902391
SIM,1866,35,35-39,1901,1
SIM,1878,43,na,1921,28
STAT,1857,58,na,1915,14.804453672757202
STAT,1948,21,15-19,1969,0.06073670117269238
STAT,1895,29,20-24,1924,0.15121563365872792
STAT,1927,21,50-100,1948,0.00808981463025548
STAT,1867,26,45-49,1893,0.010661625766045598
SIM,1841,63,na,1904,13
STAT,1861,32,na,1893,20.06781452987308
STAT,1898,12,na,1910,34.83807042665232
STAT,1882,47,40-44,1929,0.0016330355945267491
SIM,1841,55,na,1896,14
SIM,1898,28,35-39,1926,1
STAT,1856,106,na,1962,3.4662679718186127E-4
STAT,1920,40,50-100,1960,0.0012900197118671129
SIM,1882,17,na,1899,33
STAT,1830,71,na,1901,4.79583317387424
STAT,1883,26,25-29,1909,0.41219094992943817
STAT,1919,32,50-100,1951,0.008842804439358828
STAT,1892,31,20-24,1923,0.03353026252170964
STAT,1893,16,40-44,1909,0.002311847277082255
SIM,1908,25,35-39,1933,1
SIM,1860,3,na,1863,33
STAT,1879,15,45-49,1894,6.792356915679988E-4
STAT,1905,8,na,1913,37.517726329002706
SIM,1881,22,20-24,1903,4
STAT,1860,24,35-39,1884,0.04820499842743175
SIM,1905,36,na,1941,40
STAT,1881,31,45-49,1912,0.016661036035580196
STAT,1903,31,40-44,1934,0.0619085049276835
SIM,1912,32,na,1944,38
STAT,1816,39,40-44,1855,0.06441569562384994
STAT,1893,37,45-49,1930,0.0251354225297889
STAT,1913,49,40-44,1962,0.001517043521681212
STAT,1840,27,15-19,1867,0.004432782137578471
STAT,1804,54,45-49,1858,3.8298610520086764E-4
STAT,1862,19,15-19,1881,0.05273633829691966
STAT,1836,32,45-49,1868,0.021272545025801136
STAT,1922,50,na,1972,41.51819736156178
SIM,1878,32,na,1910,29
STAT,1814,40,45-49,1854,0.0514007253167261
STAT,1806,49,25-29,1855,0.0018865249921974673
STAT,1892,35,na,1927,29.38234451248638
STAT,1906,45,50-100,1951,0.0020327802852564965
STAT,1926,24,50-100,1950,0.00789841329843629
STAT,1882,28,na,1910,22.79059076773898
STAT,1926,33,35-39,1959,0.10979911307814938
STAT,1855,38,15-19,1893,3.934062984048321E-4
STAT,1938,16,50-100,1954,0.0036804157975130845
STAT,1825,40,20-24,1865,0.0016017436512480484
STAT,1863,98,na,1961,0.06878370992846713
SIM,1847,40,na,1887,18
STAT,1847,47,20-24,1894,1.275908243597764E-4
STAT,1883,48,40-44,1931,0.0016416022013060812
STAT,1862,73,na,1935,10.247509836325627
STAT,1876,50,40-44,1926,1.0846016225100683E-4
STAT,1886,86,na,1972,5.549865734848422
SIM,1827,37,na,1864,19
STAT,1829,33,15-19,1862,0.0013406465901471952
STAT,1849,27,35-39,1876,0.08868847668740719
SIM,1886,29,25-29,1915,2
STAT,1840,30,45-49,1870,0.01699244091418669
STAT,1851,32,40-44,1883,0.038106427233870234
SIM,1846,55,na,1901,13
SIM,1906,21,na,1927,28
STAT,1884,41,35-39,1925,0.01782175931568539
STAT,1938,34,na,1972,37.729281381551665
STAT,1956,5,na,1961,51.73399481285906
SIM,1850,25,25-29,1875,1
STAT,1864,35,25-29,1899,0.026069433681002688
STAT,1888,15,20-24,1903,0.20813783571587186
STAT,1881,32,na,1913,22.706786189335336
STAT,1822,103,na,1925,5.090701820383196E-4
STAT,1928,28,15-19,1956,0.008650593973773905
STAT,1842,43,25-29,1885,0.004921256301971637
STAT,1928,31,45-49,1959,0.019591026206079082
SIM,1939,3,na,1942,31
STAT,1928,27,na,1955,45.926555754932096
SIM,1819,38,25-29,1857,1
STAT,1853,25,35-39,1878,0.07127047423233887
STAT,1824,48,35-39,1872,0.0017878010283980134
STAT,1839,38,30-34,1877,0.03478416335794443
STAT,1833,31,15-19,1864,0.0013715998130187069
STAT,1904,54,na,1958,30.581603664951963
STAT,1862,37,45-49,1899,0.017199098216769904
STAT,1940,16,na,1956,37.11727413497698
STAT,1850,40,na,1890,20.786111796914227
STAT,1854,41,50-100,1895,0.0064866221374757695
STAT,1886,20,40-44,1906,0.021743612385318918
STAT,1830,41,40-44,1871,0.012476431154074801
STAT,1891,39,35-39,1930,0.08593676868811094
SIM,1830,71,na,1901,1
STAT,1897,27,na,1924,31.69196415578217
SIM,1940,13,na,1953,37
SIM,1906,32,na,1938,27
STAT,1862,22,45-49,1884,0.006158761832859605
STAT,1823,78,na,1901,4.493351360751508
STAT,1855,23,15-19,1878,0.02694057250098995
STAT,1809,63,na,1872,12.383997647883158
STAT,1849,45,35-39,1894,0.0010963702668634549
STAT,1844,41,35-39,1885,0.014672781543148113
STAT,1888,4,na,1892,30.74216521822512
STAT,1842,25,25-29,1867,0.3981835543699478
STAT,1918,24,40-44,1942,0.035710740865054456
STAT,1854,84,na,1938,2.033353932530531
STAT,1894,26,35-39,1920,0.1240842523791563
STAT,1829,33,45-49,1862,0.01641659618794332
SIM,1855,0,na,1855,37
STAT,1888,33,20-24,1921,0.031454590398489905
SIM,1833,37,na,1870,10
STAT,1906,21,15-19,1927,0.0480734443232605
STAT,1852,15,40-44,1867,0.0019157599658541475
STAT,1874,32,15-19,1906,0.0014447136158642273
STAT,1922,3,na,1925,46.59759887494708
STAT,1819,44,40-44,1863,0.020556504598088374
STAT,1880,18,20-24,1898,0.1859364873446105
STAT,1902,30,50-100,1932,0.013024631465484255
STAT,1891,20,15-19,1911,0.04073261911820527
SIM,1782,82,na,1864,1
STAT,1853,43,35-39,1896,0.01129841334069372
STAT,1886,35,40-44,1921,0.045837591715932983
SIM,1824,63,na,1887,15
STAT,1896,42,45-49,1938,0.0013634741375503363
STAT,1896,24,15-19,1920,0.04306259062285745
STAT,1828,92,na,1920,0.2797211953935974
STAT,1865,49,35-39,1914,0.001239843273427275
STAT,1866,46,45-49,1912,0.002179687482101041
STAT,1827,35,35-39,1862,0.0594382738458538
STAT,1863,15,20-24,1878,0.18124401211059282
STAT,1866,41,20-24,1907,0.0014692568209596424
STAT,1905,39,na,1944,33.925821257573546
SIM,1872,58,na,1930,19
SIM,1898,49,na,1947,28
STAT,1939,19,30-34,1958,0.12108850160367762
STAT,1884,22,30-34,1906,0.17451619115564085
STAT,1826,66,na,1892,11.453679716114575
SIM,1937,16,na,1953,41
STAT,1905,10,na,1915,37.38465610864934
STAT,1829,51,45-49,1880,1.2213761357083336E-4
STAT,1810,82,na,1892,1.6771129029974658
STAT,1842,29,45-49,1871,0.010154346853179692
STAT,1895,41,45-49,1936,0.0013553787465061602
STAT,1947,15,50-100,1962,0.004193746112262118
SIM,1793,74,na,1867,11
STAT,1926,15,35-39,1941,0.05139039270399043
SIM,1962,3,na,1965,48
STAT,1836,99,na,1935,0.018277806929232757
STAT,1916,39,15-19,1955,1.9300992216225878E-4
STAT,1918,42,40-44,1960,0.0026353008756684216
STAT,1844,40,na,1884,18.96914344134489
STAT,1865,40,20-24,1905,0.001450938007748
SIM,1884,83,na,1967,7
STAT,1799,62,na,1861,10.087624179169445
STAT,1827,32,50-100,1859,0.008076822958296278
STAT,1786,75,na,1861,1.7334653994302385
STAT,1898,34,25-29,1932,0.13698984043890505
STAT,1871,56,na,1927,20.335158410294405
STAT,1904,38,40-44,1942,0.013471452025937585
STAT,1877,42,40-44,1919,0.023189812913937263
STAT,1910,49,20-24,1959,1.0187669175318739E-4
STAT,1822,36,30-34,1858,0.033615558176689285
STAT,1842,29,50-100,1871,0.005850346867997041
STAT,1875,46,na,1921,23.192724035504714
STAT,1958,6,na,1964,51.33895341654692
STAT,1894,49,25-29,1943,4.0771033094773806E-4
STAT,1900,72,na,1972,21.921373022972684
SIM,1806,75,na,1881,2
STAT,1837,92,na,1929,0.20138503354640103
STAT,1894,41,30-34,1935,0.014800722924832201
STAT,1853,35,50-100,1888,0.007878052533880015
STAT,1896,46,25-29,1942,4.2799528105309825E-4
STAT,1856,99,na,1955,0.013719804311536351
STAT,1861,41,35-39,1902,0.015297042174839003
STAT,1819,46,50-100,1865,0.0022415635737441275
STAT,1858,16,25-29,1874,0.050669111701729615
STAT,1844,45,50-100,1889,0.0019486220168813235
STAT,1861,35,40-44,1896,0.03716246768432373
STAT,1957,15,30-34,1972,0.15988151231269107
STAT,1914,41,25-29,1955,7.027310513588461E-4
STAT,1847,37,na,1884,26.11231792544702
STAT,1921,37,30-34,1958,0.02019176430706121
SIM,1821,66,na,1887,7
STAT,1884,47,45-49,1931,0.0023014349367289806
STAT,1935,2,na,1937,55.66284378535917
SIM,1898,63,na,1961,20
STAT,1846,17,45-49,1863,6.650231972190672E-4
STAT,1811,48,20-24,1859,4.678398409640607E-4
STAT,1837,40,45-49,1877,0.008823213138587879
STAT,1856,19,25-29,1875,0.04797079194283566
SIM,1926,24,na,1950,43
STAT,1941,23,25-29,1964,0.94732943592426
SIM,1885,26,35-39,1911,3
STAT,1886,35,45-49,1921,0.02087414529057623
SIM,1789,78,na,1867,2
STAT,1894,39,na,1933,29.890122985673905
STAT,1903,16,45-49,1919,9.309926575236206E-4
STAT,1889,41,20-24,1930,0.001953196235994758
STAT,1873,40,15-19,1913,1.4182024093191328E-4
STAT,1906,17,40-44,1923,0.0026572445810104884
SIM,1834,84,na,1918,3
STAT,1831,29,35-39,1860,0.10303753461957582
STAT,1826,69,na,1895,10.25544104409033
STAT,1914,16,20-24,1930,0.27880643819357204
STAT,1858,54,na,1912,15.933854514357883
STAT,1879,18,50-100,1897,5.057423179752071E-4
STAT,1878,48,30-34,1926,9.8682294530409E-4
SIM,1847,57,na,1904,14
STAT,1849,23,20-24,1872,0.6413963719629349
SIM,1844,29,na,1873,10
STAT,1905,16,na,1921,36.54011541033871
STAT,1842,17,50-100,1859,4.720155710152026E-4
STAT,1863,30,45-49,1893,0.015563867042382919
SIM,1890,24,20-24,1914,4
STAT,1812,100,na,1912,0.00421914463130564
STAT,1867,37,na,1904,22.545772373677266
STAT,1854,64,na,1918,10.62545540804554
STAT,1880,36,20-24,1916,0.008144899398412644
STAT,1805,81,na,1886,1.7496932078021248
STAT,1882,24,20-24,1906,0.656284263865856
STAT,1912,28,20-24,1940,0.17784953464178677
STAT,1901,46,45-49,1947,0.001868046724788202
STAT,1925,30,na,1955,44.68112963395793
STAT,1813,45,20-24,1858,3.8319765982505895E-4
SIM,1841,66,na,1907,9
SIM,1867,71,na,1938,6
STAT,1920,31,40-44,1951,0.04267329581135076
SIM,1916,14,na,1930,47
STAT,1852,83,na,1935,3.3976060948262625
STAT,1877,9,na,1886,27.28807738966382
SIM,1829,32,na,1861,20
STAT,1807,62,na,1869,10.98955348580227
STAT,1940,22,50-100,1962,0.006655379832273338
STAT,1881,32,20-24,1913,0.025720778068225335
STAT,1857,33,25-29,1890,0.07635338236830372
STAT,1895,40,35-39,1935,0.023746198776401602
SIM,1938,23,na,1961,38
STAT,1889,25,15-19,1914,0.005592509773357788
STAT,1903,1,na,1904,38.6976788342115
STAT,1870,32,45-49,1902,0.017322930559460173
STAT,1893,34,50-100,1927,0.011453822845570645
SIM,1823,67,na,1890,6
STAT,1960,3,na,1963,50.93734909169186
STAT,1862,38,25-29,1900,0.024717485049682953
STAT,1932,30,20-24,1962,0.03233042481865704
STAT,1829,97,na,1926,0.03649106383301353
STAT,1902,42,45-49,1944,0.001463799263326469
STAT,1867,23,40-44,1890,0.019879610386146426
SIM,1840,39,na,1879,17
STAT,1782,101,na,1883,0.001046344491266443
STAT,1835,45,40-44,1880,9.212915967809625E-4
STAT,1837,24,40-44,1861,0.013400242470018805
STAT,1862,28,na,1890,20.517601340328348
STAT,1873,18,15-19,1891,0.06017805921233222
STAT,1887,18,45-49,1905,7.111321364794048E-4
STAT,1930,42,20-24,1972,2.312786880115334E-4
STAT,1876,53,45-49,1929,1.4502813630435814E-4
SIM,1850,49,na,1899,20
STAT,1859,53,45-49,1912,1.1349509597431393E-4
STAT,1848,24,15-19,1872,0.025605584853106822
SIM,1854,39,na,1893,17
STAT,1884,29,na,1913,23.21489236858948
STAT,1814,41,20-24,1855,0.005266351015970467
STAT,1843,46,45-49,1889,0.0010092777877521101
STAT,1788,84,na,1872,1.2890462992786471
SIM,1924,43,na,1967,50
STAT,1886,6,na,1892,27.097102221465395
STAT,1852,49,20-24,1901,1.0055745420228923E-4
STAT,1915,33,25-29,1948,0.09292587149859731
STAT,1859,45,50-100,1904,0.001971531577094274
STAT,1947,25,15-19,1972,0.007939007700723784
SIM,1917,41,na,1958,34
STAT,1913,42,20-24,1955,1.7078079618545973E-4
SIM,1910,29,na,1939,31
SIM,1800,64,na,1864,9
STAT,1904,30,45-49,1934,0.02518791533587222
STAT,1819,87,na,1906,0.9043880406811495
STAT,1899,15,30-34,1914,0.021920389120777456
SIM,1865,76,na,1941,6
STAT,1890,25,25-29,1915,0.5173226207850068
STAT,1862,31,40-44,1893,0.03756856013240592
SIM,1793,77,na,1870,11
SIM,1882,88,na,1970,8
SIM,1834,39,na,1873,20
STAT,1838,20,40-44,1858,0.02128794141534255
STAT,1834,30,na,1864,20.02988752044636
STAT,1899,2,na,1901,36.49111528167271
STAT,1909,22,45-49,1931,0.010398803341232339
SIM,1823,47,na,1870,11
STAT,1879,41,50-100,1920,0.010983858167361327
STAT,1918,27,45-49,1945,0.018219208847015906
SIM,1877,16,na,1893,31
STAT,1913,43,30-34,1956,0.0012343510774754508
STAT,1892,58,na,1950,24.431390458098136
STAT,1930,35,15-19,1965,2.49742206424467E-4
STAT,1823,34,25-29,1857,0.08153066393294839
STAT,1946,20,50-100,1966,0.00727559728831833
SIM,1908,4,na,1912,42
STAT,1820,40,35-39,1860,0.01653595305287746
STAT,1831,43,15-19,1874,1.3503991228412126E-4
STAT,1890,23,na,1913,28.639543440439507
STAT,1819,44,45-49,1863,0.01367804257532316
SIM,1858,6,na,1864,27
SIM,1898,24,20-24,1922,1
STAT,1907,24,35-39,1931,0.08482421602573119
STAT,1805,53,na,1858,9.302085292192807
STAT,1869,31,25-29,1900,0.09965041102424134
STAT,1910,42,35-39,1952,0.0018914535504645736
SIM,1799,68,na,1867,13
SIM,1924,29,na,1953,50
SIM,1953,6,na,1959,50
SIM,1877,87,na,1964,4
STAT,1853,23,50-100,1876,0.003006415672442281
SIM,1909,12,na,1921,41
SIM,1843,67,na,1910,17
STAT,1924,24,35-39,1948,0.10969286636714728
SIM,1883,7,na,1890,17
STAT,1899,30,25-29,1929,0.14134151862951147
STAT,1881,66,na,1947,15.595893461500927
STAT,1840,34,25-29,1874,0.09574709075798386
STAT,1879,21,40-44,1900,0.02163274440715398
STAT,1885,43,45-49,1928,0.014672779267589068
STAT,1876,46,40-44,1922,0.0017437222592672163
STAT,1923,25,30-34,1948,0.4497739945596813
SIM,1829,52,na,1881,18
STAT,1848,40,20-24,1888,0.001052402665136485
STAT,1883,75,na,1958,10.980648485954632
STAT,1930,37,na,1967,48.84334522004827
STAT,1837,47,30-34,1884,4.891194201148336E-4
STAT,1874,17,20-24,1891,0.17985442788952447
STAT,1913,35,15-19,1948,1.8970984748411387E-4
SIM,1915,24,35-39,1939,1
SIM,1877,31,25-29,1908,1
STAT,1812,63,na,1875,8.604894818425295
SIM,1874,59,na,1933,25
SIM,1930,33,30-34,1963,1
STAT,1887,57,na,1944,21.935277892184704
STAT,1860,42,30-34,1902,0.009334981917293098
STAT,1872,44,15-19,1916,1.3939080319108667E-4
STAT,1865,9,na,1874,24.953763014034433
SIM,1814,84,na,1898,7
STAT,1825,81,na,1906,2.9152797305849667
STAT,1868,35,50-100,1903,0.011994262240158109
STAT,1818,52,45-49,1870,1.3725096497369435E-4
SIM,1863,67,na,1930,5
STAT,1801,91,na,1892,0.2100026705143286
STAT,1846,89,na,1935,0.8513832722529546
STAT,1861,66,na,1927,13.783346300237577
STAT,1879,46,25-29,1925,5.978583799022953E-4
STAT,1898,29,na,1927,31.96412103343033
STAT,1875,54,40-44,1929,1.05242220672629E-4
STAT,1909,32,50-100,1941,0.007845585463238651
SIM,1932,24,35-39,1956,1
STAT,1816,45,na,1861,9.172918461384503
STAT,1780,107,na,1887,1.5320250274214697E-4
STAT,1853,40,30-34,1893,0.007298356256561633
STAT,1922,33,30-34,1955,0.17596438919035245
STAT,1923,49,50-100,1972,0.0026121805750515046
STAT,1952,18,na,1970,43.83426094195133
STAT,1862,15,35-39,1877,0.005486370830599939
STAT,1813,62,na,1875,14.925175898560683
STAT,1840,19,na,1859,23.014591760828242
STAT,1931,26,35-39,1957,0.19305995290099182
SIM,1938,29,30-34,1967,1
STAT,1797,67,na,1864,6.532593307797841
STAT,1882,30,15-19,1912,0.0013757251803055079
STAT,1919,30,na,1949,40.77533550010635
STAT,1921,38,40-44,1959,0.016567960020682677
STAT,1919,41,45-49,1960,0.0017905095868746296
STAT,1927,17,na,1944,45.53212157121379
SIM,1917,1,na,1918,47
STAT,1822,39,35-39,1861,0.04146069652710697
STAT,1854,24,40-44,1878,0.014751358424217154
SIM,1869,58,na,1927,13
STAT,1820,34,40-44,1854,0.04229587581974884
STAT,1877,49,25-29,1926,5.821679376233386E-4
STAT,1944,17,45-49,1961,0.005336842789146594
STAT,1815,52,50-100,1867,2.0951392332550507E-4
STAT,1894,42,40-44,1936,0.001999309336405397
SIM,1932,38,na,1970,48
STAT,1900,20,30-34,1920,0.2484734628806911
STAT,1941,20,20-24,1961,1.1415629239690084
STAT,1832,33,20-24,1865,0.015633636228636914
STAT,1836,45,na,1881,23.312769808864402
STAT,1908,26,50-100,1934,0.009472316294792369
STAT,1856,18,15-19,1874,0.050535654431762285
STAT,1887,15,40-44,1902,0.0020056766074359636
STAT,1907,11,na,1918,37.83206219132071
STAT,1831,34,50-100,1865,0.009457512104584936
STAT,1874,30,20-24,1904,0.02764272304703726
STAT,1929,27,20-24,1956,0.22736077663678098
STAT,1940,25,30-34,1965,0.3970645060490195
SIM,1901,46,na,1947,37
STAT,1926,36,50-100,1962,0.005106495841203138
STAT,1900,22,25-29,1922,0.7938145855093613
STAT,1885,4,na,1889,27.43183531036565
SIM,1867,57,na,1924,9
STAT,1878,74,na,1952,11.457652034666907
STAT,1859,31,35-39,1890,0.08082057064337815
STAT,1864,28,15-19,1892,0.004055037746511987
STAT,1937,22,20-24,1959,1.0759846541478828
STAT,1927,39,20-24,1966,0.0032537808748350503
STAT,1895,21,25-29,1916,0.7454379158947777
STAT,1914,19,25-29,1933,0.08842230092746742
STAT,1884,44,40-44,1928,0.021739861386307822
STAT,1872,42,20-24,1914,0.0016229270702291096
STAT,1828,30,25-29,1858,0.14602589417896286
SIM,1849,52,na,1901,7
STAT,1875,27,50-100,1902,0.0065756678015349256
STAT,1895,48,30-34,1943,6.999824750908927E-4
SIM,1827,51,na,1878,14
STAT,1849,63,na,1912,13.835339891369022
STAT,1836,44,45-49,1880,0.016748090514847866
STAT,1860,43,40-44,1903,0.018153904752418983
STAT,1913,28,40-44,1941,0.04589248974331142
STAT,1857,52,50-100,1909,1.1245851796713934E-4
STAT,1809,97,na,1906,0.029725254781858078
STAT,1936,22,na,1958,34.701836024828744
STAT,1852,45,40-44,1897,0.0014798196720557527
SIM,1895,21,na,1916,24
STAT,1837,27,45-49,1864,0.006997697571161883
STAT,1933,30,50-100,1963,0.011109270700301273
STAT,1837,21,na,1858,13.487977750420013
STAT,1864,18,50-100,1882,4.5189217925998567E-4
STAT,1915,40,na,1955,37.17081933932986
STAT,1883,23,25-29,1906,0.5541837875319884
SIM,1830,49,na,1879,17
SIM,1857,81,na,1938,7
STAT,1931,41,25-29,1972,9.511180210888253E-4
SIM,1874,23,20-24,1897,2
STAT,1947,18,40-44,1965,0.015643351553170662
STAT,1802,103,na,1905,4.3830228225489004E-4
STAT,1878,40,35-39,1918,0.01888380022191335
STAT,1955,17,20-24,1972,1.7896373937288568
STAT,1853,41,40-44,1894,0.014200239409512531
STAT,1855,18,na,1873,19.1092910941686
STAT,1918,34,na,1952,39.484829418528484
STAT,1885,18,40-44,1903,0.0018014625557628615
STAT,1923,35,40-44,1958,0.017255093150756247
SIM,1862,20,25-29,1882,3
STAT,1848,27,20-24,1875,0.09057117951839969
STAT,1923,31,25-29,1954,0.10565380109019476
SIM,1903,28,20-24,1931,1
SIM,1795,78,na,1873,5
STAT,1839,87,na,1926,0.9722645293851447
STAT,1836,48,25-29,1884,5.743444026118906E-4
STAT,1901,43,40-44,1944,0.002169790675164321
STAT,1864,41,50-100,1905,0.009518433384751286
STAT,1866,23,20-24,1889,0.6352593658146578
STAT,1853,37,na,1890,14.806873915907383
STAT,1831,26,30-34,1857,0.28010018849230006
STAT,1913,45,25-29,1958,5.15832936036606E-4
SIM,1953,0,na,1953,55
STAT,1842,28,na,1870,19.927404477080387
STAT,1769,100,na,1869,0.010265948083869051
STAT,1838,23,45-49,1861,0.006971407085957213
STAT,1899,18,35-39,1917,0.0074917839390043015
SIM,1892,78,na,1970,12
STAT,1895,25,40-44,1920,0.039153908023630765
STAT,1932,33,25-29,1965,0.12229426346172843
SIM,1933,34,na,1967,49
STAT,1838,38,15-19,1876,5.204771612695461E-4
STAT,1831,36,na,1867,22.08819145620624
STAT,1847,44,20-24,1891,0.0016736000160827347
SIM,1831,42,na,1873,9
STAT,1951,17,50-100,1968,0.0044343991941611744
STAT,1824,88,na,1912,0.9552358310685048
STAT,1886,45,50-100,1931,0.002572923800699533
STAT,1831,41,20-24,1872,0.001593425354251538
STAT,1911,48,25-29,1959,4.9755764117812E-4
STAT,1867,51,na,1918,20.703552591390025
STAT,1854,20,25-29,1874,0.4170943150835678
STAT,1925,20,35-39,1945,0.11267072171485282
STAT,1816,90,na,1906,0.2366934423378914
SIM,1865,48,na,1913,22
STAT,1877,27,na,1904,24.635150022877337
STAT,1878,41,45-49,1919,0.015521490622476054
STAT,1915,18,50-100,1933,7.753260617406065E-4
STAT,1850,31,15-19,1881,0.0013402453682708217
STAT,1900,29,40-44,1929,0.041242058439785165
SIM,1886,40,35-39,1926,1
STAT,1924,40,50-100,1964,0.0013921485703749352
STAT,1876,93,na,1969,1.1646825663902571
STAT,1888,19,na,1907,29.355905031914336
STAT,1899,17,25-29,1916,0.07757375125996833
STAT,1915,30,20-24,1945,0.024825345222130226
STAT,1915,40,30-34,1955,0.0012795431446329072
SIM,1777,81,na,1858,1
STAT,1828,34,40-44,1862,0.019178012412237377
STAT,1932,32,na,1964,50.07344514797954
STAT,1844,20,35-39,1864,0.05773652749034327
STAT,1849,18,na,1867,21.77969363240323
STAT,1919,23,15-19,1942,0.05760574101475116
STAT,1841,49,45-49,1890,0.0022617719384834378
STAT,1804,88,na,1892,0.5329784434877766
STAT,1858,32,50-100,1890,0.006972121842950833
STAT,1880,23,50-100,1903,0.004274882335150738
STAT,1877,26,35-39,1903,0.09994393901811939
SIM,1947,16,25-29,1963,3
STAT,1862,34,45-49,1896,0.01491627112013188
STAT,1882,16,50-100,1898,4.7066374853949923E-4
STAT,1930,20,45-49,1950,0.014432389375436384
STAT,1857,27,na,1884,18.40195418085624
STAT,1868,52,40-44,1920,1.013384695544549E-4
STAT,1913,9,na,1922,40.22919336849918
STAT,1915,31,30-34,1946,0.15972439160130308
STAT,1923,40,20-24,1963,2.05552810093993E-4
STAT,1871,33,50-100,1904,0.009096421851247637
SIM,1945,22,20-24,1967,1
STAT,1827,82,na,1909,2.827571920757129
STAT,1854,47,30-34,1901,5.889170791670701E-4
STAT,1824,41,15-19,1865,1.9031156961858106E-4
STAT,1882,51,50-100,1933,1.4542876849055566E-4
STAT,1842,22,25-29,1864,0.5417282740680303
STAT,1813,46,30-34,1859,0.0030453176622843798
STAT,1885,21,35-39,1906,0.05780020845819743
STAT,1869,35,40-44,1904,0.042818261614302355
STAT,1822,44,50-100,1866,0.005863602507043298
STAT,1889,28,20-24,1917,0.1431262929560615
SIM,1907,31,na,1938,39
STAT,1814,64,na,1878,9.324915686169744
SIM,1838,43,na,1881,7
STAT,1941,21,30-34,1962,0.29496134414600583
STAT,1901,26,na,1927,33.50847865540858
SIM,1852,58,na,1910,19
STAT,1844,17,40-44,1861,0.0018160550139216137
STAT,1933,39,15-19,1972,2.5994289606856883E-4
STAT,1803,72,na,1875,6.1982898705550475
SIM,1841,86,na,1927,2
STAT,1836,25,35-39,1861,0.12224359111023905
STAT,1886,32,40-44,1918,0.04498329931020396
STAT,1821,37,25-29,1858,0.05885318848185904
STAT,1846,35,na,1881,20.35739016363589
STAT,1819,41,40-44,1860,0.021721070712813796
STAT,1845,50,na,1895,12.767187329700942
STAT,1890,40,15-19,1930,1.694410421548068E-4
SIM,1894,25,na,1919,27
STAT,1880,37,30-34,1917,0.05604334011339802
STAT,1885,76,na,1961,11.224521858323666
STAT,1906,24,15-19,1930,0.04762870099305029
STAT,1798,94,na,1892,0.10156618638298719
STAT,1885,56,na,1941,20.14168794620459
STAT,1904,23,50-100,1927,0.005825135323060449
STAT,1876,42,25-29,1918,0.006514010927086271
SIM,1878,31,45-49,1909,1
STAT,1941,30,30-34,1971,0.16440267714906914
STAT,1858,17,35-39,1875,0.004877390505136313
STAT,1888,45,20-24,1933,1.416298197971179E-4
STAT,1863,17,45-49,1880,6.599676100585574E-4
STAT,1931,31,15-19,1962,0.0016773464826177688
STAT,1829,63,na,1892,12.119922511104706
STAT,1874,84,na,1958,4.231223067362653
STAT,1891,32,15-19,1923,0.0017478602337733632
STAT,1879,24,45-49,1903,0.007172166154037692
STAT,1913,46,35-39,1959,0.0012509898101014712
SIM,1810,74,na,1884,10
STAT,1809,51,25-29,1860,1.1817169107547316E-4
STAT,1833,39,50-100,1872,0.011130706484356765
STAT,1843,78,na,1921,3.3143631655352546
SIM,1836,34,na,1870,9
STAT,1915,41,50-100,1956,0.0011742325913832242
SIM,1796,71,na,1867,5
STAT,1905,36,35-39,1941,0.022138971739361607
SIM,1934,19,na,1953,48
STAT,1870,57,na,1927,19.96344490084604
STAT,1882,49,35-39,1931,0.001313668012290976
STAT,1912,18,na,1930,38.64823006600357
STAT,1897,19,15-19,1916,0.07838555513338914
STAT,1910,18,45-49,1928,9.812007007888581E-4
STAT,1885,40,40-44,1925,0.022436058418499504
STAT,1882,28,50-100,1910,0.006108873026646745
SIM,1864,60,na,1924,16
STAT,1879,43,20-24,1922,0.0016318568162731878
SIM,1882,33,25-29,1915,1
STAT,1816,54,35-39,1870,1.0006873743523209E-4
STAT,1904,47,50-100,1951,0.0019758556350813264
STAT,1845,15,35-39,1860,0.004102146728825855
STAT,1865,70,na,1935,12.690628591390189
STAT,1883,45,35-39,1928,0.0013730678227068908
STAT,1875,15,na,1890,26.082392556257048
STAT,1872,45,25-29,1917,5.952215595280594E-4
STAT,1916,17,35-39,1933,0.008826642546823011
SIM,1847,16,20-24,1863,1
STAT,1931,23,30-34,1954,0.36996981411556834
STAT,1865,27,20-24,1892,0.10610949204628499
STAT,1859,28,40-44,1887,0.02404631773747394
SIM,1946,17,20-24,1963,2
STAT,1827,31,na,1858,17.962923649129813
STAT,1905,17,25-29,1922,0.0817845684070072
STAT,1894,33,45-49,1927,0.02225437231883384
SIM,1915,15,na,1930,40
STAT,1926,32,na,1958,45.47021151180272
STAT,1830,27,25-29,1857,0.3832518400868465
STAT,1942,23,40-44,1965,0.034985718856709314
STAT,1870,40,30-34,1910,0.011535911677437363
SIM,1909,6,na,1915,41
STAT,1820,49,50-100,1869,0.0020225176593391993
STAT,1874,33,25-29,1907,0.10347183923349607
STAT,1859,53,na,1912,16.83896098611438
SIM,1805,73,na,1878,5
STAT,1869,60,na,1929,18.47945344011866
SIM,1895,52,na,1947,26
STAT,1843,22,40-44,1865,0.011095235094849696
STAT,1880,17,45-49,1897,6.869008222311864E-4
STAT,1865,42,15-19,1907,1.2475437838948108E-4
STAT,1920,35,20-24,1955,0.00286661563908167
STAT,1858,40,15-19,1898,1.061455117049598E-4
STAT,1900,23,35-39,1923,0.08066950963217775
SIM,1885,45,na,1930,22
STAT,1894,45,45-49,1939,0.001723111054195442
STAT,1916,25,na,1941,38.663352582845725
STAT,1854,27,45-49,1881,0.00711452893654745
STAT,1907,21,30-34,1928,0.2613360703340786
STAT,1895,15,na,1910,32.941155324138386
SIM,1881,52,na,1933,20
STAT,1896,62,na,1958,24.711610771715428
STAT,1918,37,na,1955,39.29555348751609
STAT,1825,29,40-44,1854,0.06204203257515723
STAT,1874,18,30-34,1892,0.01612730404006933
STAT,1811,44,40-44,1855,0.09266369404864165
STAT,1853,44,45-49,1897,0.009279137640694653
STAT,1860,46,45-49,1906,0.0019240628988638092
STAT,1939,16,25-29,1955,0.43091856726033245
STAT,1826,100,na,1926,0.007418954840246472
STAT,1928,44,na,1972,46.9575305219348
STAT,1827,42,45-49,1869,0.011705927217994712
STAT,1949,21,35-39,1970,0.10920573500353772
SIM,1900,61,na,1961,24
STAT,1890,22,20-24,1912,0.8370820597253237
STAT,1938,17,20-24,1955,1.3285571052152874
STAT,1893,46,40-44,1939,0.001221099710571526
STAT,1839,37,20-24,1876,0.005083555873725429
STAT,1901,71,na,1972,22.951407697139093
STAT,1924,46,45-49,1970,0.0025770145658567554
STAT,1904,35,50-100,1939,0.0038331860895518518
SIM,1841,32,25-29,1873,1
STAT,1874,30,na,1904,24.403515331268334
STAT,1903,38,25-29,1941,0.008791529183570611
SIM,1893,40,na,1933,35
STAT,1886,39,25-29,1925,0.029564365026264614
STAT,1866,26,25-29,1892,0.39092524719074384
SIM,1963,2,na,1965,54
STAT,1823,31,20-24,1854,0.04203200882349713
STAT,1917,43,35-39,1960,0.002079043725400049
SIM,1902,42,na,1944,31
STAT,1859,16,40-44,1875,0.0016974908635839982
STAT,1936,29,20-24,1965,0.17346515984150088
SIM,1878,18,na,1896,29
STAT,1804,103,na,1907,5.571708327331306E-4
STAT,1839,16,20-24,1855,0.12874198308468265
SIM,1887,23,na,1910,25
STAT,1922,44,20-24,1966,2.0055133450805508E-4
SIM,1829,86,na,1915,4
STAT,1925,29,45-49,1954,0.0201324687335443
STAT,1898,40,na,1938,31.602011645292254
STAT,1828,37,45-49,1865,0.008915721062156308
SIM,1855,38,na,1893,18
STAT,1837,20,25-29,1857,0.48344178056618786
SIM,1872,27,na,1899,26
STAT,1871,46,20-24,1917,1.1997972764845313E-4
SIM,1908,33,na,1941,38
SIM,1870,34,45-49,1904,1
STAT,1843,43,40-44,1886,0.009698772860839613
STAT,1943,22,45-49,1965,0.011883831475557475
STAT,1823,43,20-24,1866,0.0011161473780702496
SIM,1854,53,na,1907,17
SIM,1807,51,na,1858,15
STAT,1869,63,na,1932,17.288862568817112
STAT,1912,12,na,1924,39.62280308511269
STAT,1927,17,45-49,1944,0.006179476147026389
SIM,1870,15,na,1885,25
STAT,1913,0,na,1913,45.52722659449417
STAT,1867,82,na,1949,4.46500985140487
STAT,1933,28,50-100,1961,0.013156054315299015
STAT,1902,28,50-100,1930,0.008989103243146876
STAT,1822,32,15-19,1854,0.0013261324201946229
STAT,1895,28,45-49,1923,0.01436382908868846
STAT,1910,31,na,1941,36.392442142000704
STAT,1921,18,20-24,1939,1.5293106355082684
STAT,1904,18,20-24,1922,0.25336491518629844
STAT,1911,41,40-44,1952,0.002385577501844602
STAT,1858,36,45-49,1894,0.015242341964739984
STAT,1861,97,na,1958,0.07035866845905087
STAT,1851,19,40-44,1870,0.001855322005182585
STAT,1873,34,20-24,1907,0.027246510637609307
STAT,1769,109,na,1878,1.5302035500470187E-4
STAT,1857,30,20-24,1887,0.020787494699309534
STAT,1878,28,45-49,1906,0.011422614688210897
STAT,1884,23,40-44,1907,0.020353071779665267
SIM,1805,70,na,1875,8
STAT,1880,44,50-100,1924,0.010959199814601785
STAT,1915,18,30-34,1933,0.025223946336914452
STAT,1936,4,na,1940,38.40864785981241
STAT,1921,33,15-19,1954,0.0014129162646425652
STAT,1863,51,45-49,1914,1.291073555350836E-4
SIM,1869,38,na,1907,16
STAT,1915,34,35-39,1949,0.09147706531243072
STAT,1926,22,45-49,1948,0.013591370567631463
STAT,1939,29,50-100,1968,0.009927766892615838
STAT,1849,21,50-100,1870,0.0038505654040748467
STAT,1919,22,35-39,1941,0.10221177410239694
SIM,1836,31,na,1867,11
STAT,1831,44,25-29,1875,0.006199123334324683
SIM,1912,18,20-24,1930,1
STAT,1806,53,30-34,1859,1.889967256498558E-4
STAT,1813,49,35-39,1862,0.0042115757457180944
SIM,1849,38,na,1887,8
STAT,1821,33,45-49,1854,0.046875082598005956
SIM,1807,54,na,1861,15
STAT,1932,18,30-34,1950,0.16032343022377588
SIM,1928,28,25-29,1956,1
STAT,1814,98,na,1912,0.014476209302145455
SIM,1854,50,na,1904,17
STAT,1821,46,na,1867,16.34506560243349
STAT,1901,3,na,1904,36.99165697384814
STAT,1863,75,na,1938,9.114832649559686
STAT,1905,45,30-34,1950,7.95913439319057E-4
SIM,1847,71,na,1918,10
STAT,1898,15,15-19,1913,0.08042909843404104
STAT,1898,43,na,1941,31.06031596589587
SIM,1904,20,na,1924,30
STAT,1895,44,50-100,1939,9.395724274204814E-4
STAT,1914,44,na,1958,36.37427848511747
STAT,1916,33,40-44,1949,0.03988788304052824
SIM,1930,29,na,1959,46
SIM,1931,22,na,1953,50
STAT,1913,34,50-100,1947,0.008087349287295861
STAT,1859,70,na,1929,11.151870734440381
SIM,1816,68,na,1884,6
STAT,1872,20,45-49,1892,0.0071773567589026145
SIM,1931,4,na,1935,63
STAT,1899,28,na,1927,32.55492102600815
STAT,1841,45,30-34,1886,9.764913594114969E-4
STAT,1941,24,35-39,1965,0.09653468697859499
STAT,1906,43,25-29,1949,6.431699076153344E-4
STAT,1817,53,40-44,1870,2.8691406209937787E-4
STAT,1848,16,na,1864,18.511135223257643
STAT,1905,33,30-34,1938,0.14407969739660986
STAT,1858,103,na,1961,0.0031219488439567663
STAT,1868,43,45-49,1911,0.014379038263148793
STAT,1930,24,25-29,1954,1.1704058482944844
STAT,1873,44,30-34,1917,0.011530818058348442
STAT,1917,32,45-49,1949,0.016328036699709718
SIM,1896,37,na,1933,31
STAT,1951,19,45-49,1970,0.005908571524471728
STAT,1812,83,na,1895,1.5776888578649564
STAT,1842,44,35-39,1886,0.013700754086814811
SIM,1850,44,35-39,1894,1
STAT,1860,27,50-100,1887,0.0052562465129534705
STAT,1869,38,45-49,1907,0.019219912050747356
SIM,1890,15,na,1905,31
SIM,1830,40,na,1870,19
STAT,1931,35,30-34,1966,0.024072298526531217
STAT,1902,2,na,1904,37.5907805639262
STAT,1853,68,na,1921,9.604434495064142
STAT,1832,43,30-34,1875,0.006242827744135554
STAT,1841,97,na,1938,0.05258430510383884
STAT,1882,46,30-34,1928,9.303106267774185E-4
STAT,1899,37,45-49,1936,0.0058902009561295
STAT,1914,35,30-34,1949,0.01821784388974939
STAT,1926,37,15-19,1963,2.3334862920159144E-4
STAT,1956,15,15-19,1971,0.5974625305874395
STAT,1906,28,30-34,1934,0.3645588451164084
SIM,1831,25,na,1856,10
STAT,1877,45,45-49,1922,0.002460423326495309
SIM,1838,46,na,1884,8
SIM,1834,53,na,1887,14
STAT,1870,43,35-39,1913,0.017858473033053438
SIM,1818,46,na,1864,25
STAT,1902,32,35-39,1934,0.14281053280665038
STAT,1854,30,na,1884,15.250357754780245
SIM,1939,28,na,1967,30
STAT,1858,23,na,1881,18.65539209845655
SIM,1889,58,na,1947,22
STAT,1844,23,na,1867,20.70233241717099
STAT,1898,31,20-24,1929,0.03661330197382436
STAT,1900,41,30-34,1941,0.0011120712054412919
SIM,1841,32,na,1873,17
STAT,1803,52,35-39,1855,1.6798759835008698E-4
SIM,1910,32,35-39,1942,1
STAT,1924,29,50-100,1953,0.01143154202877763
SIM,1859,8,na,1867,26
STAT,1811,50,35-39,1861,3.4004991201391186E-4
STAT,1911,26,15-19,1937,0.0068636596268736305
SIM,1894,59,na,1953,26
STAT,1946,18,25-29,1964,0.47710601749823817
STAT,1855,45,25-29,1900,4.09587312850439E-4
STAT,1850,57,na,1907,17.893049075045173
STAT,1863,78,na,1941,6.917901116497356
STAT,1936,27,30-34,1963,0.3727168846440276
STAT,1887,19,20-24,1906,0.19247054706913472
STAT,1896,43,20-24,1939,1.4381428483305892E-4
STAT,1898,19,30-34,1917,0.021386005461604667
SIM,1806,58,na,1864,6
SIM,1878,66,na,1944,18
STAT,1816,76,na,1892,2.8442747270102102
STAT,1849,60,na,1909,14.788105251753578
STAT,1901,22,40-44,1923,0.02915809090563864
STAT,1908,29,45-49,1937,0.016130680163635436
STAT,1866,45,35-39,1911,0.0013022286833159118
STAT,1936,25,na,1961,35.66556784531671
STAT,1838,23,na,1861,21.375732127981912
STAT,1876,31,35-39,1907,0.10327544670402845
SIM,1865,45,na,1910,22
STAT,1785,90,na,1875,0.8551000352260839
STAT,1791,76,na,1867,3.4894200110465743
STAT,1839,19,25-29,1858,0.04042808428791771
STAT,1824,30,50-100,1854,0.01598522313465739
STAT,1868,40,40-44,1908,0.0219869008175201
SIM,1946,21,na,1967,47
STAT,1806,69,na,1875,9.717830233442472
STAT,1913,46,50-100,1959,0.0021945935459142868
STAT,1843,25,45-49,1868,0.005880432306031859
STAT,1920,38,25-29,1958,0.010677783459749561
STAT,1882,42,15-19,1924,1.321827038916616E-4
STAT,1891,17,20-24,1908,0.2175935762798971
STAT,1894,30,40-44,1924,0.056025758833439465
SIM,1867,26,na,1893,14
STAT,1881,48,50-100,1929,0.002307626307880346
STAT,1893,42,25-29,1935,0.008086844144585287
STAT,1848,43,25-29,1891,0.004122828897236055
STAT,1875,16,25-29,1891,0.05839375589976137
STAT,1931,38,35-39,1969,0.03185906875536645
STAT,1934,19,45-49,1953,0.006692083799686332
STAT,1884,30,15-19,1914,0.0014064571135686647
STAT,1870,71,na,1941,13.259756902122895
STAT,1864,44,20-24,1908,0.0014052032875014712
SIM,1888,73,na,1961,20
STAT,1865,56,na,1921,18.448231507762017
STAT,1844,24,50-100,1868,0.003920063899054172
SIM,1846,72,na,1918,3
STAT,1868,18,40-44,1886,0.0017914694641663574
STAT,1917,40,30-34,1957,0.0013257234020626323
STAT,1851,51,50-100,1902,1.281121288087714E-4
STAT,1828,45,50-100,1873,0.0010791658450196066
STAT,1846,30,45-49,1876,0.017051465968618063
STAT,1878,44,15-19,1922,1.406506086017116E-4
SIM,1836,65,na,1901,1
STAT,1924,4,na,1928,47.75171696893772
SIM,1887,26,na,1913,24
SIM,1881,6,na,1887,27
STAT,1923,47,40-44,1970,0.001831604329066625
STAT,1890,77,na,1967,14.260717048953229
SIM,1910,20,na,1930,29
STAT,1933,33,40-44,1966,0.052489745156747133
STAT,1861,39,20-24,1900,0.0064172528333950075
STAT,1845,38,25-29,1883,0.0175007863102324
SIM,1916,20,35-39,1936,1
STAT,1881,35,25-29,1916,0.02765700261289555
SIM,1852,27,na,1879,26
SIM,1878,63,na,1941,20
STAT,1852,41,25-29,1893,0.005520757081820016
STAT,1878,21,25-29,1899,0.5927980648248222
SIM,1873,27,20-24,1900,1
STAT,1923,43,25-29,1966,8.275380402183987E-4
STAT,1847,82,na,1929,4.984206180581315
STAT,1855,42,20-24,1897,0.001116777991332219
STAT,1913,21,20-24,1934,1.0716982861416036
SIM,1920,6,na,1926,51
STAT,1842,40,50-100,1882,0.008413498900684723
STAT,1835,49,na,1884,10.396476504805712
STAT,1921,30,45-49,1951,0.01751454252367465
STAT,1814,44,25-29,1858,0.01907379438580436
STAT,1911,44,45-49,1955,0.0015588541399754097
STAT,1852,38,na,1890,20.063577051049286
STAT,1885,22,na,1907,23.355205215129136
SIM,1908,7,na,1915,42
STAT,1849,26,25-29,1875,0.39162692964772444
STAT,1903,35,20-24,1938,0.002387958689173177
STAT,1844,42,45-49,1886,0.011972697258640303
STAT,1939,32,30-34,1971,0.15964945785611784
STAT,1832,83,na,1915,1.7944162404342214
STAT,1905,48,35-39,1953,0.0011254306251042884
SIM,1852,72,na,1924,19
STAT,1784,94,na,1878,0.05904943397315917
STAT,1890,34,20-24,1924,0.03255302012732427
STAT,1821,91,na,1912,0.35990728190523347
STAT,1876,11,na,1887,26.503572771219453
SIM,1870,5,na,1875,27
STAT,1825,50,na,1875,13.381643189775469
SIM,1863,64,na,1927,5
STAT,1789,100,na,1889,0.001433016747520233
SIM,1868,23,30-34,1891,2
STAT,1888,29,15-19,1917,0.005264064860902557
STAT,1928,32,20-24,1960,0.03034998672396182
STAT,1861,20,35-39,1881,0.051147254224199815
SIM,1914,19,na,1933,36
STAT,1819,48,25-29,1867,5.117427416638494E-4
STAT,1800,54,40-44,1854,1.6118365105983708E-4
SIM,1928,33,na,1961,51
SIM,1890,12,na,1902,31
STAT,1833,32,25-29,1865,0.097632593613975
STAT,1878,25,40-44,1903,0.031136544589199105
STAT,1936,23,15-19,1959,0.05056778096822199
STAT,1824,49,45-49,1873,0.002974142478281952
STAT,1825,41,30-34,1866,0.011387185079069514
SIM,1845,79,na,1924,5
SIM,1876,85,na,1961,6
STAT,1883,20,20-24,1903,0.6731892615568574
STAT,1850,16,20-24,1866,0.1940313430888469
STAT,1900,44,35-39,1944,0.0017201690292403887
STAT,1836,42,na,1878,24.138096201337486
STAT,1940,31,25-29,1971,0.09503351876781826
STAT,1874,37,40-44,1911,0.04440938992005281
STAT,1897,28,50-100,1925,0.008464927797072556
STAT,1921,16,30-34,1937,0.13819119251884707
SIM,1918,26,na,1944,38
STAT,1940,21,15-19,1961,0.05385979037545379
STAT,1834,64,na,1898,12.284900069736562
SIM,1954,8,na,1962,50
STAT,1836,41,40-44,1877,0.02615669068701311
STAT,1775,80,na,1855,3.63828
STAT,1914,45,40-44,1959,0.0015579715295941897
SIM,1913,34,na,1947,41
STAT,1803,58,na,1861,11.31710803698341
SIM,1929,18,na,1947,50
STAT,1888,29,50-100,1917,0.007422004350970725
STAT,1907,46,45-49,1953,0.0019527969760131663
STAT,1840,21,50-100,1861,0.004092998366410653
STAT,1863,33,15-19,1896,0.0012555532555413548
STAT,1932,40,30-34,1972,0.0017304988055111404
SIM,1870,12,na,1882,27
STAT,1905,30,na,1935,34.717063391373
STAT,1908,20,35-39,1928,0.08662780569689446
STAT,1851,31,30-34,1882,0.1550186692263256
SIM,1829,83,na,1912,6
SIM,1903,27,na,1930,33
STAT,1858,33,40-44,1891,0.032860753674651126
STAT,1780,104,na,1884,6.225140333907951E-4
STAT,1858,20,50-100,1878,0.0036120052723916784
STAT,1846,18,20-24,1864,0.17942426162899477
SIM,1841,35,na,1876,16
STAT,1890,47,50-100,1937,0.0016749899970644698
STAT,1878,77,na,1955,8.924136244921296
STAT,1848,39,50-100,1887,0.008013960165328442
SIM,1898,18,na,1916,34
STAT,1836,90,na,1926,0.7608943197156655
STAT,1871,45,50-100,1916,0.0024730446908325827
STAT,1840,31,20-24,1871,0.026067504540992558
STAT,1861,12,na,1873,23.07458564312598
STAT,1841,41,15-19,1882,1.422724414649262E-4
STAT,1889,69,na,1958,18.828033798852086
STAT,1857,18,30-34,1875,0.013941416742321723
STAT,1855,49,na,1904,15.509713316442635
STAT,1906,40,20-24,1946,1.6183761479368375E-4
STAT,1922,36,35-39,1958,0.027345559948626065
SIM,1898,27,25-29,1925,1
STAT,1892,32,30-34,1924,0.2156986834219359
STAT,1924,21,30-34,1945,0.33795423032705085
STAT,1890,47,35-39,1937,9.547988611606818E-4
SIM,1872,78,na,1950,8
STAT,1799,93,na,1892,0.1079695123924877
STAT,1884,40,25-29,1924,0.0063550300246489186
SIM,1922,48,na,1970,48
SIM,1801,66,na,1867,7
SIM,1941,0,na,1941,49
STAT,1810,51,na,1861,9.954029796878475
STAT,1889,44,25-29,1933,0.007756008110224032
SIM,1885,11,na,1896,26
STAT,1847,28,15-19,1875,0.005783561682477762
STAT,1886,33,50-100,1919,0.009463799974596879
SIM,1800,81,na,1881,4
STAT,1932,18,na,1950,48.41426112273211
STAT,1931,33,na,1964,49.30721996174971
STAT,1930,28,40-44,1958,0.05896168102420407
STAT,1862,34,50-100,1896,0.007837362743553889
STAT,1921,26,na,1947,41.56750641794167
STAT,1887,31,45-49,1918,0.019111738968175775
STAT,1818,57,na,1875,5.877641901403364
STAT,1914,31,15-19,1945,0.0012880493472208366
STAT,1886,16,35-39,1902,0.005705553701355381
STAT,1919,49,40-44,1968,0.0016853051934880442
STAT,1850,39,45-49,1889,0.017659792496137874
STAT,1899,34,40-44,1933,0.058858495874014996
SIM,1843,13,na,1856,23
STAT,1863,37,30-34,1900,0.047187954448377104
SIM,1887,77,na,1964,10
STAT,1901,0,na,1901,41.08724611430421
STAT,1826,35,na,1861,20.293747828484154
STAT,1860,50,50-100,1910,1.2454564965537826E-4
STAT,1835,30,35-39,1865,0.05997293495849511
SIM,1911,56,na,1967,38
STAT,1912,47,30-34,1959,8.500290692557126E-4
SIM,1918,0,na,1918,43
SIM,1861,86,na,1947,2
STAT,1823,72,na,1895,7.262758237855818
SIM,1883,19,na,1902,15
STAT,1947,17,na,1964,41.17910387318236
SIM,1816,65,na,1881,9
STAT,1869,15,50-100,1884,4.869959669024048E-4
STAT,1820,38,20-24,1858,0.007141849209704021
STAT,1851,16,50-100,1867,5.058469019867965E-4
STAT,1838,17,50-100,1855,5.02266077764541E-4
STAT,1887,66,na,1953,17.88992258195459
STAT,1906,18,30-34,1924,0.02309531888112546
STAT,1846,68,na,1914,12.384942508529706
STAT,1860,52,50-100,1912,1.221276042118776E-4
STAT,1898,20,15-19,1918,0.044769398068737504
STAT,1842,38,45-49,1880,0.01736410712935829
STAT,1824,47,40-44,1871,0.002215319705611887
STAT,1850,73,na,1923,10.575332789671226
STAT,1891,71,na,1962,18.379160987707674
STAT,1845,48,50-100,1893,0.0014176129210292192
STAT,1849,23,50-100,1872,0.003795469790760269
STAT,1838,27,15-19,1865,0.004479382313740084
STAT,1951,19,20-24,1970,1.6035866341634
STAT,1902,30,30-34,1932,0.24819371167400184
STAT,1822,35,50-100,1857,0.007963235627862214
STAT,1824,41,na,1865,19.394681757087245
STAT,1857,5,na,1862,22.124833975247263
STAT,1948,23,30-34,1971,0.32771674259659933
STAT,1900,22,20-24,1922,0.9555971406228383
STAT,1887,40,50-100,1927,0.011647608631429931
SIM,1827,58,na,1885,9
STAT,1821,47,50-100,1868,0.003470648076978541
SIM,1874,36,na,1910,24
STAT,1803,95,na,1898,0.049828185978766655
STAT,1930,34,25-29,1964,0.11856856055810619
STAT,1911,49,na,1960,34.35311865771273
STAT,1857,32,20-24,1889,0.020360243269514914
STAT,1828,55,na,1883,14.602295912618523
STAT,1920,21,35-39,1941,0.1041012518364881
STAT,1878,28,50-100,1906,0.0065810493803041496
STAT,1915,43,50-100,1958,0.0011706890805712386
STAT,1847,25,15-19,1872,0.005909950180565876
STAT,1836,23,50-100,1859,0.005156624143840605
STAT,1846,32,45-49,1878,0.016701002224883313
STAT,1854,31,40-44,1885,0.027428649018312413
STAT,1923,44,35-39,1967,0.002329484539143591
STAT,1889,35,20-24,1924,0.0095273787239184
STAT,1898,28,25-29,1926,0.5686378575737324
SIM,1840,24,na,1864,15
STAT,1844,24,35-39,1868,0.05609610782979047
STAT,1861,21,30-34,1882,0.15500147861245867
STAT,1940,19,45-49,1959,0.005032655495029754
STAT,1914,24,15-19,1938,0.05359598954069436
STAT,1941,26,25-29,1967,0.6762564547885486
STAT,1862,46,50-100,1908,0.0021249660221220453
STAT,1891,38,40-44,1929,0.053461394439909174
SIM,1962,0,na,1962,48
STAT,1837,34,45-49,1871,0.010443836607347762
STAT,1918,39,30-34,1957,0.01899592821056289
SIM,1886,21,na,1907,30
STAT,1876,34,50-100,1910,0.009226136406117635
STAT,1832,60,na,1892,8.62062037638364
STAT,1967,0,na,1967,49.15481099228906
STAT,1822,39,30-34,1861,0.031241405415020317
STAT,1919,13,na,1932,43.33942180100896
STAT,1831,37,30-34,1868,0.054499193151768245
STAT,1900,44,40-44,1944,0.002136682789047993
STAT,1829,72,na,1901,8.578239059966556
SIM,1915,34,25-29,1949,1
SIM,1824,77,na,1901,7
STAT,1922,28,40-44,1950,0.05217196706114442
STAT,1879,16,20-24,1895,0.18394273252022586
STAT,1850,37,40-44,1887,0.0395929512323836
SIM,1903,66,na,1969,26
STAT,1837,91,na,1928,0.28019177108050347
STAT,1833,45,40-44,1878,0.0015232507064792287
STAT,1843,49,50-100,1892,0.0010200670334626044
STAT,1909,42,35-39,1951,0.001872887023240517
STAT,1883,39,45-49,1922,0.01916354639695659
STAT,1782,84,na,1866,0.8038725053905345
STAT,1907,28,na,1935,34.78602648820697
STAT,1903,14,na,1917,36.597524129456296
SIM,1795,63,na,1858,11
STAT,1917,19,45-49,1936,0.005280827217680382
STAT,1863,24,45-49,1887,0.006207009195254531
STAT,1879,28,15-19,1907,0.004679337205042384
STAT,1816,48,45-49,1864,0.0029298178233183184
STAT,1853,22,na,1875,15.877245432175199
SIM,1920,30,na,1950,44
STAT,1808,94,na,1902,0.029184245021201784
STAT,1882,19,na,1901,24.074188228132552
STAT,1918,48,50-100,1966,0.002378489729361895
STAT,1858,53,na,1911,16.12134576561196
SIM,1879,83,na,1962,4
STAT,1929,23,20-24,1952,1.395101165406972
STAT,1935,15,45-49,1950,0.006830342348234886
STAT,1833,23,20-24,1856,0.6809161213469879
STAT,1875,40,15-19,1915,1.4338945967924734E-4
STAT,1889,34,50-100,1923,0.011121841713067694
STAT,1900,31,35-39,1931,0.14100408693772506
SIM,1865,27,25-29,1892,1
SIM,1866,33,na,1899,29
SIM,1924,44,na,1968,50
STAT,1894,39,20-24,1933,0.009779707694034408
STAT,1946,15,20-24,1961,1.4939100771846692
SIM,1836,19,na,1855,14
SIM,1882,87,na,1969,11
STAT,1778,79,na,1857,3.010013022789972
STAT,1849,17,na,1866,21.908736087961316
STAT,1847,52,50-100,1899,1.6047429974902703E-4
STAT,1928,19,20-24,1947,1.690820446447541
STAT,1873,15,15-19,1888,0.061053228870237355
STAT,1835,31,30-34,1866,0.10225218747053995
STAT,1908,61,na,1969,30.44749844167969
STAT,1811,98,na,1909,0.01840984780737545
SIM,1899,30,25-29,1929,1
STAT,1915,36,25-29,1951,0.00990810696598857
STAT,1913,42,25-29,1955,6.905484279269272E-4
STAT,1859,35,35-39,1894,0.05675067183841103
STAT,1879,31,na,1910,24.799491935688216
STAT,1910,41,45-49,1951,0.0015722983330300443
SIM,1874,68,na,1942,17
STAT,1858,25,50-100,1883,0.005055382672121665
STAT,1847,19,50-100,1866,6.455196339029272E-4
STAT,1914,29,45-49,1943,0.017148266137599393
STAT,1776,104,na,1880,2.2737601141319775E-4
STAT,1869,42,40-44,1911,0.02176733264613999
STAT,1856,103,na,1959,0.0021521562841726504
SIM,1856,39,na,1895,12
STAT,1861,57,na,1918,16.90010283693997
STAT,1872,38,30-34,1910,0.05426017985018536
SIM,1852,25,na,1877,28
STAT,1839,39,na,1878,13.834364225643535
STAT,1885,22,30-34,1907,0.175898933656885
SIM,1837,20,na,1857,29
STAT,1938,29,30-34,1967,0.3852433560544057
STAT,1887,33,45-49,1920,0.018953630903891083
STAT,1912,18,30-34,1930,0.02439027695243083
STAT,1830,49,50-100,1879,2.371659297352174E-4
SIM,1920,14,na,1934,49
STAT,1918,23,45-49,1941,0.011988292828968105
STAT,1900,65,na,1965,25.803796812140455
STAT,1904,33,45-49,1937,0.014287027236236753
SIM,1924,28,na,1952,46
STAT,1866,88,na,1954,1.26435654195875
SIM,1845,55,na,1900,22
STAT,1920,4,na,1924,44.89831642750956
SIM,1827,42,na,1869,18
STAT,1904,19,35-39,1923,0.007820237746935153
STAT,1865,48,40-44,1913,0.0015290255949469596
STAT,1860,43,35-39,1903,0.014615077574900426
STAT,1917,41,30-34,1958,0.0013239601899378887
STAT,1857,49,45-49,1906,0.0017298273053208886
STAT,1858,69,na,1927,11.167193404744134
STAT,1839,28,50-100,1867,0.004415305346566086
STAT,1862,74,na,1936,9.574863290669207
STAT,1894,20,30-34,1914,0.2296428288515888
STAT,1907,34,25-29,1941,0.08529231739558783
STAT,1909,25,45-49,1934,0.016669718722706364
STAT,1820,36,50-100,1856,0.011767780745933824
SIM,1894,72,na,1966,17
STAT,1835,25,na,1860,12.844273841379648
STAT,1839,19,30-34,1858,0.011371126894375886
STAT,1887,50,na,1937,23.84037884918403
STAT,1878,14,na,1892,26.575961567139217
STAT,1851,3,na,1854,29.0
STAT,1881,17,15-19,1898,0.05646982839514537
STAT,1844,61,na,1905,14.595820043941329
STAT,1878,32,40-44,1910,0.044773022354931274
STAT,1848,75,na,1923,6.657528786826102
STAT,1919,45,na,1964,39.68774322264203
SIM,1861,61,na,1922,20
STAT,1895,32,40-44,1927,0.056301648829493144
SIM,1936,13,na,1949,38
SIM,1927,16,15-19,1943,1
STAT,1878,73,na,1951,12.262566927808244
STAT,1913,31,45-49,1944,0.015588415415532951
STAT,1876,32,30-34,1908,0.17732887789904406
STAT,1859,23,40-44,1882,0.01706073650075813
STAT,1938,16,25-29,1954,0.4257015131642682
STAT,1923,19,45-49,1942,0.005793936554239734
STAT,1924,34,25-29,1958,0.1069921958448456
SIM,1857,56,na,1913,21
STAT,1848,34,20-24,1882,0.01816959166338068
STAT,1853,38,20-24,1891,0.004820611029643729
STAT,1901,32,50-100,1933,0.012820739905957132
STAT,1919,16,15-19,1935,0.09999265594891248
STAT,1924,45,50-100,1969,0.0026877822714256186
STAT,1904,37,50-100,1941,0.003797124339588131
STAT,1895,31,50-100,1926,0.011943817161487284
STAT,1874,38,40-44,1912,0.04418911934604935
SIM,1900,20,20-24,1920,1
STAT,1831,42,50-100,1873,0.01046427300057517
STAT,1898,36,50-100,1934,0.01664197556258354
STAT,1828,41,40-44,1869,0.0100202177384805
STAT,1933,24,25-29,1957,1.2194134941411017
SIM,1886,53,na,1939,27
SIM,1901,18,20-24,1919,2
STAT,1899,51,na,1950,29.617276999336426
STAT,1858,19,40-44,1877,0.001606701443661081
STAT,1892,15,25-29,1907,0.07033246006580303
STAT,1904,44,25-29,1948,6.303398470130884E-4
STAT,1864,17,15-19,1881,0.05506354131617997
STAT,1833,41,50-100,1874,0.009599684958895053
STAT,1952,15,na,1967,43.87154124136796
SIM,1941,24,25-29,1965,1
STAT,1836,46,50-100,1882,0.0025125018734519157
STAT,1922,46,50-100,1968,0.0025857589049992804
STAT,1930,31,45-49,1961,0.020224311061305594
STAT,1841,37,na,1878,24.7000797171907
STAT,1815,80,na,1895,2.2081953657851288
STAT,1894,36,na,1930,30.339337716729815
SIM,1877,17,na,1894,29
SIM,1865,75,na,1940,6
STAT,1803,79,na,1882,3.192454945870854
STAT,1807,47,40-44,1854,0.0036360026617748703
STAT,1883,36,na,1919,22.988572838234646
STAT,1921,27,na,1948,41.425345545992315
STAT,1841,47,40-44,1888,0.0016833277686883722
STAT,1887,25,45-49,1912,0.012201264086631186
STAT,1915,42,35-39,1957,0.002009797783527979
STAT,1855,27,15-19,1882,0.003329611161241376
STAT,1839,44,20-24,1883,9.00339826510925E-4
SIM,1863,68,na,1931,5
STAT,1868,33,35-39,1901,0.09759062789380128
STAT,1825,38,45-49,1863,0.020441368984673077
STAT,1939,16,50-100,1955,0.0037255200024967922
STAT,1888,18,15-19,1906,0.06916934385907418
STAT,1865,23,na,1888,21.49613939223698
STAT,1926,16,50-100,1942,0.004578424298860363
STAT,1854,34,45-49,1888,0.010690962399800576
STAT,1890,54,na,1944,25.436053415652072
STAT,1791,77,na,1868,3.1738717594476333
SIM,1804,57,na,1861,11
STAT,1892,29,45-49,1921,0.013618733326180119
STAT,1847,85,na,1932,2.9284054271933972
STAT,1877,39,20-24,1916,0.007877087467964596
STAT,1849,16,35-39,1865,0.005268156860203428
STAT,1853,105,na,1958,3.3955764204601004E-4
STAT,1904,41,45-49,1945,0.0014959381890996438
STAT,1937,26,na,1963,36.303044920460266
STAT,1842,35,40-44,1877,0.039336374470710915
STAT,1883,22,20-24,1905,0.6691964544012643
STAT,1902,33,35-39,1935,0.14220787235820623
STAT,1880,49,20-24,1929,1.2355170089001875E-4
STAT,1875,19,40-44,1894,0.001870054868219302
SIM,1918,32,na,1950,37
SIM,1879,67,na,1946,7
STAT,1912,40,40-44,1952,0.002420632274214532
STAT,1931,18,40-44,1949,0.018178951716531753
STAT,1894,15,35-39,1909,0.007064884551419845
STAT,1919,29,20-24,1948,0.19412461736493047
SIM,1875,53,na,1928,13
STAT,1895,21,na,1916,30.79706642731104
STAT,1899,35,na,1934,32.55806261584026
STAT,1933,12,na,1945,52.824649318568596
STAT,1840,95,na,1935,0.1041826727429992
STAT,1778,95,na,1873,0.028372368473608547
STAT,1920,24,15-19,1944,0.05830802595129569
STAT,1882,31,50-100,1913,0.008816666099385853
SIM,1865,16,na,1881,25
STAT,1894,38,50-100,1932,0.015656607795752404
SIM,1910,52,na,1962,28
STAT,1910,18,20-24,1928,0.26629792373672784
STAT,1913,34,25-29,1947,0.09040755345350328
STAT,1930,31,20-24,1961,0.03134924024643003
SIM,1837,36,na,1873,29
STAT,1883,36,40-44,1919,0.042713717083662055
STAT,1836,38,20-24,1874,0.00903705681751133
STAT,1812,50,50-100,1862,1.7036767607681833E-4
STAT,1917,16,40-44,1933,0.0029898875048393722
STAT,1842,54,na,1896,15.710518581583134
STAT,1856,54,50-100,1910,1.0640066883403766E-4
STAT,1848,37,25-29,1885,0.019188030183079918
SIM,1906,15,na,1921,28
STAT,1922,32,25-29,1954,0.10366557794159424
STAT,1908,45,na,1953,33.53806386247031
STAT,1905,28,40-44,1933,0.04308103609418479
STAT,1923,41,30-34,1964,0.0014860445070468665
STAT,1799,57,na,1856,11.533974625200003
STAT,1852,80,na,1932,5.294245284784013
STAT,1840,44,50-100,1884,0.008416977808197411
STAT,1856,19,30-34,1875,0.013492649281151091
STAT,1905,36,40-44,1941,0.013702034084888412
STAT,1825,50,50-100,1875,1.3993175098483523E-4
STAT,1869,53,na,1922,20.527956425492622
STAT,1833,37,40-44,1870,0.04051921006381165
STAT,1928,42,45-49,1970,0.002111301845535258
STAT,1881,28,30-34,1909,0.23877326339811022
SIM,1870,22,na,1892,24
STAT,1881,20,50-100,1901,0.003903454968593161
STAT,1792,78,na,1870,6.257698906082335
STAT,1864,22,na,1886,21.553779303188747
STAT,1846,24,45-49,1870,0.006873139698228072
SIM,1851,9,na,1860,27
STAT,1891,42,25-29,1933,0.007871899409565751
STAT,1913,39,50-100,1952,0.004067373036599985
STAT,1907,22,30-34,1929,0.26054944876237285
SIM,1840,56,na,1896,10
STAT,1803,63,na,1866,9.726422559474974
STAT,1874,24,20-24,1898,0.6947347713271746
STAT,1896,28,15-19,1924,0.005938568578081613
STAT,1816,45,40-44,1861,0.0022241672796650485
STAT,1924,17,50-100,1941,0.004432509323045525
SIM,1935,12,na,1947,60
STAT,1856,9,na,1865,20.869412738149975
STAT,1911,39,20-24,1950,0.0025042525381911754
STAT,1853,21,50-100,1874,0.0030500572568793395
STAT,1921,33,45-49,1954,0.01730155876610818
STAT,1921,19,35-39,1940,0.0472029552702564
STAT,1827,44,50-100,1871,0.008038166434011122
STAT,1829,37,15-19,1866,5.159838404198063E-4
SIM,1816,42,na,1858,12
STAT,1866,39,45-49,1905,0.018174863163696323
STAT,1850,89,na,1939,0.9353596862772874
STAT,1888,26,15-19,1914,0.005320153880344817
STAT,1917,44,35-39,1961,0.0020754053988805993
STAT,1863,1,na,1864,32.072779769869925
STAT,1850,49,35-39,1899,0.0012204846684505648
STAT,1835,41,na,1876,11.476354163578414
STAT,1918,20,40-44,1938,0.03615011750083488
STAT,1829,48,30-34,1877,8.157336050489855E-4
STAT,1887,34,na,1921,25.82376776724963
STAT,1868,16,45-49,1884,6.474144493774862E-4
STAT,1898,66,na,1964,24.28892239735515
SIM,1811,43,na,1854,10
SIM,1899,28,na,1927,28
STAT,1896,42,50-100,1938,9.624523296304419E-4
STAT,1822,47,30-34,1869,5.316702627253245E-4
STAT,1904,16,30-34,1920,0.022894498317795695
SIM,1815,57,na,1872,10
SIM,1961,4,na,1965,53
STAT,1903,37,20-24,1940,0.002365493312548916
SIM,1881,22,na,1903,20
STAT,1889,49,40-44,1938,0.0011576635012417737
STAT,1932,33,20-24,1965,0.032273879532931246
SIM,1923,27,na,1950,38
STAT,1900,39,45-49,1939,0.00590651714754193
SIM,1915,51,na,1966,31
SIM,1885,36,na,1921,24
STAT,1883,20,na,1903,23.103580128073187
STAT,1857,46,40-44,1903,0.0012852557057809974
SIM,1852,41,na,1893,25
STAT,1925,18,40-44,1943,0.016746691680446246
SIM,1918,18,15-19,1936,1
STAT,1952,20,40-44,1972,0.0402153321484562
SIM,1801,65,na,1866,7
STAT,1839,55,na,1894,11.41080493909118
STAT,1935,35,15-19,1970,2.677964840732286E-4
STAT,1885,49,20-24,1934,1.1602755473398247E-4
SIM,1770,87,na,1857,4
SIM,1960,11,na,1971,52
STAT,1880,44,15-19,1924,1.4325752438469538E-4
STAT,1896,39,30-34,1935,0.06930134420459673
STAT,1926,22,40-44,1948,0.04061514689708996
STAT,1833,26,25-29,1859,0.415757091258022
STAT,1851,28,45-49,1879,0.010896290876604126
STAT,1869,45,45-49,1914,0.0023094991407178436
STAT,1893,19,na,1912,31.674018763263113
STAT,1906,41,50-100,1947,0.0010706400273748449
STAT,1852,49,45-49,1901,0.00197762985759341
STAT,1945,19,20-24,1964,1.4693781180101129
SIM,1892,49,na,1941,32
SIM,1796,80,na,1876,2
STAT,1871,48,50-100,1919,0.0024178657148271167
STAT,1837,104,na,1941,3.225109013352537E-4
STAT,1849,33,na,1882,19.296394001829643
SIM,1895,14,na,1909,31
STAT,1840,16,15-19,1856,0.06056495758999396
STAT,1853,22,35-39,1875,0.04333293370120901
SIM,1848,27,25-29,1875,1
STAT,1904,30,40-44,1934,0.06263990015926958
STAT,1898,33,20-24,1931,0.03631040654856808
STAT,1913,38,40-44,1951,0.014576951907646393
STAT,1823,46,50-100,1869,0.0017264179234835425
STAT,1857,68,na,1925,11.440209645981401
SIM,1876,25,35-39,1901,1
STAT,1891,28,50-100,1919,0.007823716030753165
STAT,1868,30,30-34,1898,0.17032376449981537
STAT,1924,31,20-24,1955,0.028288477453425963
STAT,1928,20,50-100,1948,0.008224019300165872
STAT,1853,54,na,1907,13.160126379858184
SIM,1947,13,na,1960,40
STAT,1850,41,25-29,1891,0.005743411360232028
STAT,1852,37,na,1889,20.272997111208074
STAT,1817,49,50-100,1866,0.006897577259850172
STAT,1916,15,35-39,1931,0.008867652415374648
STAT,1873,42,na,1915,23.46927399898094
STAT,1946,23,20-24,1969,1.2282493883035268
STAT,1828,44,45-49,1872,0.006453587670748198
SIM,1902,17,na,1919,37
STAT,1904,41,20-24,1945,1.5873854166817175E-4
STAT,1925,29,20-24,1954,0.21271945619190094
STAT,1833,48,45-49,1881,0.0018387771373745698
STAT,1902,43,50-100,1945,0.001027070444877863
STAT,1879,15,na,1894,26.26172753301221
STAT,1806,53,50-100,1859,4.795206167324001E-4
STAT,1914,38,35-39,1952,0.02383079123381777
STAT,1906,43,20-24,1949,1.590635275715935E-4
SIM,1874,25,25-29,1899,2
STAT,1878,40,40-44,1918,0.023456236125702457
SIM,1925,45,na,1970,43
STAT,1911,47,20-24,1958,1.0394681890401193E-4
STAT,1880,32,50-100,1912,0.00963480846776648
STAT,1889,30,15-19,1919,0.0017575571365135143
SIM,1807,81,na,1888,6
STAT,1921,35,50-100,1956,0.004659512721044226
STAT,1902,36,15-19,1938,1.717438863160934E-4
STAT,1929,35,15-19,1964,2.45785334841683E-4
SIM,1845,71,na,1916,14
SIM,1846,56,na,1902,11
SIM,1931,14,na,1945,62
SIM,1860,76,na,1936,10
STAT,1841,69,na,1910,14.364532552068072
STAT,1820,75,na,1895,5.83627616281605
SIM,1935,28,na,1963,52
STAT,1893,27,50-100,1920,0.00806573649564409
STAT,1933,28,40-44,1961,0.06160742582254003
STAT,1849,92,na,1941,0.32294593114807435
STAT,1840,27,30-34,1867,0.24603317276219383
STAT,1869,69,na,1938,14.219635441144236
STAT,1935,32,35-39,1967,0.12586823418425977
STAT,1821,92,na,1913,0.25867975979656743
STAT,1914,16,15-19,1930,0.09332927392275708
STAT,1931,26,40-44,1957,0.05993654414488334
STAT,1922,26,15-19,1948,0.007956994902134674
STAT,1894,23,35-39,1917,0.0745559472598447
STAT,1889,38,25-29,1927,0.03507607919434318
STAT,1871,35,na,1906,23.712179611505366
SIM,1840,40,na,1880,17
STAT,1872,22,45-49,1894,0.007134786559017196
STAT,1950,21,20-24,1971,1.3113876003226324
STAT,1864,17,50-100,1881,4.5456959416964485E-4
STAT,1827,32,35-39,1859,0.08927139562339198
STAT,1875,49,na,1924,22.644186599928947
STAT,1895,35,45-49,1930,0.026126336124465837
SIM,1889,28,25-29,1917,2
STAT,1796,76,na,1872,0.7497404240556645
STAT,1866,25,25-29,1891,0.39223137767841293
STAT,1923,16,40-44,1939,0.016350555003833856
SIM,1928,25,20-24,1953,1
STAT,1848,48,40-44,1896,0.0010932386112596228
STAT,1792,62,na,1854,18.0
STAT,1842,21,20-24,1863,0.656850829898511
STAT,1923,34,na,1957,43.001693641398916
SIM,1894,56,na,1950,27
STAT,1831,49,25-29,1880,5.375007607757301E-4
SIM,1897,21,na,1918,37
SIM,1890,42,na,1932,21
STAT,1867,32,50-100,1899,0.008768108600131068
STAT,1943,27,na,1970,39.606170221529524
STAT,1804,104,na,1908,2.5895071622104973E-4
STAT,1814,49,25-29,1863,0.0015997381290720736
STAT,1891,39,na,1930,28.625380033519306
STAT,1902,29,na,1931,33.413897573255866
SIM,1805,74,na,1879,5
STAT,1870,38,20-24,1908,0.007619543512863437
STAT,1875,29,45-49,1904,0.011331701168459721
STAT,1890,18,30-34,1908,0.01931005307605308
SIM,1818,38,na,1856,26
STAT,1914,15,25-29,1929,0.0893120862426419
STAT,1883,25,25-29,1908,0.4135681318083601
STAT,1944,22,35-39,1966,0.10092728962698239
STAT,1783,85,na,1868,0.44380695758206934
STAT,1913,31,20-24,1944,0.024163244841386884
STAT,1839,47,25-29,1886,3.238675580160738E-4
STAT,1847,69,na,1916,15.67684151453195
STAT,1880,87,na,1967,4.213113046670812
STAT,1917,19,20-24,1936,1.4332167950451755
STAT,1931,22,25-29,1953,1.1927047505588506
STAT,1872,57,na,1929,20.561945599028704
STAT,1869,50,40-44,1919,1.0347263446473553E-4
STAT,1926,31,30-34,1957,0.18952814464296752
STAT,1937,32,45-49,1969,0.015469950402849545
STAT,1863,48,30-34,1911,8.462958396562078E-4
SIM,1937,30,na,1967,40
STAT,1921,41,45-49,1962,0.0018625971309835312
STAT,1838,92,na,1930,0.32326052623848095
STAT,1878,46,na,1924,23.293698965468586
STAT,1902,31,45-49,1933,0.024691642723331558
SIM,1904,51,na,1955,26
STAT,1865,44,25-29,1909,0.005729828901037714
STAT,1882,41,20-24,1923,0.0015288613884077082
SIM,1891,25,25-29,1916,2
STAT,1920,29,20-24,1949,0.19711807102171544
SIM,1940,1,na,1941,37
STAT,1839,15,15-19,1854,0.04335117177821513
STAT,1866,16,35-39,1882,0.005217750096536612
STAT,1874,42,25-29,1916,0.0065066073590800905
STAT,1781,99,na,1880,0.0052475739985511525
STAT,1838,22,45-49,1860,0.007021823780702659
STAT,1876,35,35-39,1911,0.07251805992223381
SIM,1853,10,na,1863,29
STAT,1838,17,na,1855,23.53293712504545
STAT,1919,27,30-34,1946,0.41969373940838356
STAT,1808,47,50-100,1855,0.0017730232472038159
STAT,1913,36,15-19,1949,1.888295937917876E-4
STAT,1919,41,40-44,1960,0.0026909273277093914
SIM,1857,24,na,1881,19
STAT,1907,38,40-44,1945,0.013752191728168238
STAT,1883,28,40-44,1911,0.028986971201268443
SIM,1885,68,na,1953,14
SIM,1898,5,na,1903,37
STAT,1846,37,15-19,1883,4.7524425589699987E-4
STAT,1906,41,30-34,1947,0.0011651082676411037
STAT,1891,24,20-24,1915,0.8405121032212363
STAT,1851,17,50-100,1868,5.02867463734094E-4
STAT,1924,32,35-39,1956,0.105921900943803
STAT,1822,93,na,1915,0.10366703370179826
STAT,1929,27,15-19,1956,0.00879295828297427
SIM,1876,16,na,1892,31
SIM,1827,74,na,1901,3
SIM,1934,31,30-34,1965,1
STAT,1819,38,20-24,1857,0.007972712175792162
STAT,1918,48,20-24,1966,1.162128578273222E-4
STAT,1901,50,na,1951,30.562406161742317
STAT,1836,105,na,1941,2.829752863110358E-4
STAT,1930,20,40-44,1950,0.04312836675613505
STAT,1866,17,25-29,1883,0.05356830711637968
SIM,1857,6,na,1863,23
STAT,1879,23,45-49,1902,0.007195046401594762
STAT,1914,14,na,1928,40.38297569417362
STAT,1833,41,25-29,1874,0.0058351026587523044
STAT,1886,29,20-24,1915,0.12081667678779327
STAT,1937,28,25-29,1965,0.6372551776043563
STAT,1830,26,na,1856,9.887576547402059
STAT,1872,6,na,1878,28.14242956917068
STAT,1874,27,25-29,1901,0.42914428020101913
STAT,1879,36,15-19,1915,5.840027025147573E-4
STAT,1905,64,na,1969,28.170148814400918
STAT,1918,28,na,1946,39.367441181725624
STAT,1824,33,20-24,1857,0.042758390490811364
STAT,1896,20,40-44,1916,0.02753489362939924
STAT,1874,49,45-49,1923,0.00234421065951595
SIM,1830,41,na,1871,18
STAT,1879,90,na,1969,2.522283153527208
STAT,1890,15,15-19,1905,0.07242208763399713
STAT,1797,98,na,1895,0.006958692525318415
STAT,1851,74,na,1925,9.369178194106567
STAT,1940,28,35-39,1968,0.1519375895170677
STAT,1793,84,na,1877,0.5943321464654543
STAT,1910,40,30-34,1950,0.001214478035909966
STAT,1855,88,na,1943,0.9665723230032846
STAT,1829,40,na,1869,18.17779359143049
SIM,1856,55,na,1911,9
STAT,1848,91,na,1939,0.3747483924079056
STAT,1907,25,35-39,1932,0.14209739008396627
STAT,1951,19,50-100,1970,0.004431428643353797
SIM,1913,28,na,1941,41
STAT,1855,15,20-24,1870,0.1502268735609932
STAT,1913,23,45-49,1936,0.011232174298832009
SIM,1834,55,na,1889,12
STAT,1905,32,25-29,1937,0.0848814079314207
STAT,1811,48,45-49,1859,0.00920084985645168
STAT,1899,40,25-29,1939,6.166040956535652E-4
STAT,1851,95,na,1946,0.11224504459101561
STAT,1855,38,30-34,1893,0.037337829760804034
STAT,1914,18,40-44,1932,0.002861846479358758
STAT,1926,30,40-44,1956,0.04710168689296165
STAT,1891,46,40-44,1937,0.0011886434211923148
STAT,1905,21,45-49,1926,0.010094417509110753
SIM,1855,16,25-29,1871,1
SIM,1777,82,na,1859,1
SIM,1908,41,30-34,1949,1
STAT,1872,36,na,1908,24.221678247516678
STAT,1862,28,20-24,1890,0.10085853629069604
STAT,1938,27,40-44,1965,0.04587280674484766
SIM,1843,34,35-39,1877,2
STAT,1950,22,35-39,1972,0.11101108697247428
STAT,1955,17,15-19,1972,0.5990735351160204
STAT,1845,28,20-24,1873,0.08286999341191385
STAT,1817,55,na,1872,20.052894108168694
SIM,1937,26,25-29,1963,2
STAT,1805,59,na,1864,8.260870146352858
STAT,1926,25,45-49,1951,0.020731361486051626
STAT,1946,26,25-29,1972,0.728351771040715
STAT,1813,41,na,1854,21.700561198105905
STAT,1836,51,40-44,1887,1.0485745344607857E-4
STAT,1841,40,20-24,1881,0.0016572295202707346
STAT,1835,34,35-39,1869,0.05737021802762135
STAT,1930,31,na,1961,48.60869627846627
STAT,1922,49,na,1971,41.650239980939524
STAT,1892,40,15-19,1932,1.7232918377622211E-4
STAT,1811,53,40-44,1864,3.916337710593686E-4
STAT,1850,23,20-24,1873,0.7311544492493813
STAT,1928,42,20-24,1970,2.2403664698425767E-4
STAT,1866,22,20-24,1888,0.6398535140455047
SIM,1851,40,na,1891,18
STAT,1937,3,na,1940,39.20980829830643
STAT,1842,24,25-29,1866,0.5339769834450893
STAT,1900,40,25-29,1940,6.245984294132944E-4
SIM,1919,19,20-24,1938,2
STAT,1846,21,40-44,1867,0.02098787137679458
SIM,1895,7,na,1902,31
STAT,1929,26,25-29,1955,0.8201895543034065
SIM,1820,63,na,1883,8
STAT,1823,56,na,1879,12.810950127084853
STAT,1841,48,30-34,1889,9.396718697287677E-4
STAT,1936,16,15-19,1952,0.43293108283434134
STAT,1861,4,na,1865,25.763373715442295
SIM,1906,47,na,1953,22
STAT,1862,23,50-100,1885,0.0035757556467141682
STAT,1841,96,na,1937,0.08404747878820243
STAT,1911,20,30-34,1931,0.2724399300103385
STAT,1865,28,50-100,1893,0.0057655701893056695
SIM,1944,16,15-19,1960,2
STAT,1871,94,na,1965,0.6329354254472732
SIM,1790,64,na,1854,5
STAT,1850,45,40-44,1895,0.0015395013744705331
STAT,1906,46,25-29,1952,4.733774483343401E-4
STAT,1949,11,na,1960,45.400402153308754
STAT,1955,12,na,1967,51.85274607717002
STAT,1901,27,45-49,1928,0.015536127296066444
STAT,1866,21,50-100,1887,0.003813722439892137
SIM,1836,62,na,1898,2
STAT,1847,17,15-19,1864,0.07912328819165224
STAT,1945,17,30-34,1962,0.13219181885692563
STAT,1922,39,45-49,1961,0.007683876907000594
STAT,1929,29,40-44,1958,0.05799790849658182
STAT,1882,49,30-34,1931,9.083075966581375E-4
STAT,1819,53,50-100,1872,1.2864131667251872E-4
STAT,1837,31,40-44,1868,0.026823459175446943
STAT,1832,92,na,1924,0.18825902488049653
STAT,1833,77,na,1910,6.399468764679389
STAT,1950,22,50-100,1972,0.0077575890961272195
SIM,1889,24,30-34,1913,1
STAT,1906,19,45-49,1925,9.439263144098397E-4
STAT,1861,24,35-39,1885,0.04969405007321059
SIM,1955,8,na,1963,46
SIM,1911,21,na,1932,40
STAT,1884,21,na,1905,23.241566932779694
STAT,1863,49,20-24,1912,1.0402934624918848E-4
STAT,1949,19,40-44,1968,0.016152695841855906
STAT,1888,35,na,1923,27.79337666079666
STAT,1905,34,15-19,1939,0.0011700416091253876
STAT,1808,78,na,1886,1.2573550647864418
SIM,1950,12,na,1962,60
SIM,1917,7,na,1924,47
STAT,1893,42,35-39,1935,0.022804030864325444
STAT,1955,16,25-29,1971,0.5721979605461196
SIM,1888,17,na,1905,39
SIM,1876,91,na,1967,1
STAT,1878,8,na,1886,27.426329198567057
STAT,1872,27,15-19,1899,0.004642149202950302
STAT,1932,34,35-39,1966,0.12083375049353173
SIM,1857,40,na,1897,21
STAT,1857,84,na,1941,2.490343391414297
STAT,1892,72,na,1964,18.16992815979702
STAT,1804,64,na,1868,9.893349042515947
STAT,1902,41,35-39,1943,0.0017812856917537832
STAT,1922,21,45-49,1943,0.012847323836714785
SIM,1868,40,na,1908,32
STAT,1847,16,25-29,1863,0.0760001477165478
STAT,1887,22,40-44,1909,0.022744934742066906
STAT,1883,16,35-39,1899,0.005341499451983906
STAT,1882,48,40-44,1930,0.0016200692919062071
SIM,1875,0,na,1875,33
STAT,1903,21,35-39,1924,0.08321543470098904
STAT,1864,28,30-34,1892,0.22506718613286222
SIM,1930,17,25-29,1947,1
STAT,1922,28,na,1950,41.9313911094815
SIM,1928,9,na,1937,55
STAT,1911,38,30-34,1949,0.017403449711635707
STAT,1820,47,20-24,1867,1.0145717549533693E-4
SIM,1888,4,na,1892,40
STAT,1919,44,45-49,1963,0.0017819823856267234
STAT,1894,20,na,1914,30.49111943153444
STAT,1838,50,50-100,1888,1.213064538793709E-4
STAT,1869,32,na,1901,23.12195572873297
STAT,1927,26,15-19,1953,0.008567834574364669
STAT,1898,34,na,1932,31.915747177914668
STAT,1920,15,50-100,1935,8.400361409654724E-4
SIM,1934,27,na,1961,48
STAT,1857,102,na,1959,0.00441144972288369
STAT,1844,21,30-34,1865,0.17497023577695453
SIM,1864,69,na,1933,13
STAT,1900,47,45-49,1947,0.0018373955757943247
SIM,1841,41,na,1882,16
SIM,1849,21,na,1870,13
STAT,1861,39,45-49,1900,0.01659561091860901
STAT,1849,39,45-49,1888,0.01549183876029143
STAT,1909,46,50-100,1955,0.0020718253747167
STAT,1821,40,40-44,1861,0.03758233345091619
SIM,1853,1,na,1854,31
STAT,1884,25,50-100,1909,0.006309918736128442
STAT,1906,44,35-39,1950,0.001802207581584532
STAT,1922,17,25-29,1939,0.49785083339378783
STAT,1898,39,40-44,1937,0.012617691730635561
SIM,1932,3,na,1935,57
STAT,1864,25,15-19,1889,0.004112857192970804
STAT,1947,19,30-34,1966,0.1362729173086209
STAT,1917,40,40-44,1957,0.0025937201127676163
STAT,1854,39,na,1893,14.255622333355918
STAT,1865,37,25-29,1902,0.02604197403756135
STAT,1814,63,na,1877,9.679173433848607
STAT,1906,16,40-44,1922,0.002663770819518308
SIM,1930,13,na,1943,51
STAT,1802,78,na,1880,2.7538889540137146
STAT,1900,25,25-29,1925,0.5905657772236564
SIM,1860,44,na,1904,23
STAT,1859,91,na,1950,0.4605790340447265
SIM,1876,54,na,1930,27
STAT,1937,22,50-100,1959,0.00636715053071102
STAT,1909,46,na,1955,33.65224813131521
STAT,1950,20,30-34,1970,0.3390853836007973
STAT,1886,49,na,1935,22.84958501084084
STAT,1882,35,na,1917,22.792790087717854
STAT,1847,41,15-19,1888,1.502572461173235E-4
STAT,1811,93,na,1904,0.16562358885446832
SIM,1871,87,na,1958,5
STAT,1923,28,35-39,1951,0.17057566630214532
STAT,1952,15,45-49,1967,0.005954107414263646
STAT,1857,35,25-29,1892,0.021758601468043346
STAT,1937,25,20-24,1962,0.17696875243410568
SIM,1917,10,na,1927,47
STAT,1927,29,30-34,1956,0.47200604402774277
STAT,1885,16,45-49,1901,6.466537111927975E-4
STAT,1888,17,25-29,1905,0.06622127714412239
STAT,1838,38,30-34,1876,0.04939800842199774
STAT,1852,41,35-39,1893,0.015567941292965678
STAT,1912,50,na,1962,34.714876941122114
SIM,1946,12,na,1958,53
STAT,1797,77,na,1874,3.008558370164277
STAT,1913,20,40-44,1933,0.03250175374438747
STAT,1916,38,45-49,1954,0.0068871826689994526
STAT,1831,29,30-34,1860,0.2689087064788976
STAT,1792,99,na,1891,0.007175902413205767
STAT,1865,34,20-24,1899,0.024239503128292244
STAT,1793,63,na,1856,4.640697800000001
SIM,1797,59,na,1856,2
STAT,1830,96,na,1926,0.03085118226401773
STAT,1877,72,na,1949,13.036372298365869
STAT,1891,27,25-29,1918,0.5191923255087165
STAT,1908,29,20-24,1937,0.17043659959579807
STAT,1843,92,na,1935,0.17667413915532146
STAT,1865,41,20-24,1906,0.0014429433393253087
SIM,1904,27,25-29,1931,1
STAT,1869,31,50-100,1900,0.008914163140031404
STAT,1855,15,50-100,1870,4.151441876085377E-4
STAT,1820,49,25-29,1869,4.74336385814729E-4
SIM,1829,26,25-29,1855,2
STAT,1860,18,45-49,1878,6.088681538926097E-4
SIM,1850,18,na,1868,22
STAT,1896,23,45-49,1919,0.00913126680255197
STAT,1891,49,45-49,1940,0.001599796707394555
SIM,1852,21,30-34,1873,2
STAT,1827,92,na,1919,0.25240280257817876
STAT,1941,23,20-24,1964,1.140398925293359
STAT,1829,32,45-49,1861,0.016665949538944718
STAT,1953,16,15-19,1969,0.5459768645872154
STAT,1880,48,30-34,1928,0.0010051134051655805
STAT,1842,27,40-44,1869,0.027793803748999944
STAT,1863,21,40-44,1884,0.018953770233735834
STAT,1898,36,25-29,1934,0.03902733576449273
SIM,1883,72,na,1955,3
STAT,1867,31,15-19,1898,0.0013683544799453521
STAT,1910,29,50-100,1939,0.009484610293377752
STAT,1877,52,40-44,1929,1.080943047650065E-4
STAT,1931,24,15-19,1955,0.06830443816075545
STAT,1941,31,na,1972,39.443476376769084
STAT,1931,28,30-34,1959,0.5033819199544789
STAT,1897,49,na,1946,29.25851441135007
STAT,1905,37,30-34,1942,0.016602219290198474
STAT,1849,17,25-29,1866,0.054085810819487073
STAT,1813,78,na,1891,5.156448436478057
STAT,1824,36,25-29,1860,0.042837814564826326
STAT,1926,34,35-39,1960,0.10972554767238703
STAT,1789,95,na,1884,0.016666928825168525
STAT,1893,35,na,1928,29.988104025117316
STAT,1868,68,na,1936,14.789059977086987
STAT,1885,25,35-39,1910,0.09593103923237199
STAT,1911,34,15-19,1945,0.0012326221387608638
STAT,1932,31,30-34,1963,0.20871526300937815
STAT,1862,41,40-44,1903,0.01949376375200888
STAT,1934,26,50-100,1960,0.013339167037646251
SIM,1867,32,30-34,1899,1
STAT,1926,39,50-100,1965,0.005090987762978282
STAT,1930,38,40-44,1968,0.019415242580293205
STAT,1917,42,45-49,1959,0.0017210518733147026
STAT,1899,15,35-39,1914,0.007546363331717096
STAT,1953,19,30-34,1972,0.14649624387136095
STAT,1932,36,25-29,1968,0.01318765283173698
STAT,1879,39,50-100,1918,0.01257936744877621
STAT,1932,27,na,1959,48.86814919715794
STAT,1942,28,45-49,1970,0.01799153157200117
SIM,1837,25,20-24,1862,1
STAT,1769,108,na,1877,2.441801187302757E-4
STAT,1861,73,na,1934,9.988471552876225
STAT,1907,31,20-24,1938,0.022796094680062474
STAT,1863,30,50-100,1893,0.008177625005687056
STAT,1865,87,na,1952,1.5935328889004334
STAT,1833,49,35-39,1882,0.001076914114290346
SIM,1826,34,35-39,1860,1
STAT,1890,41,50-100,1931,0.012890816841981349
STAT,1862,58,na,1920,17.062011607239633
SIM,1941,21,20-24,1962,1
SIM,1963,1,na,1964,54
STAT,1888,42,15-19,1930,1.6118271010985918E-4
SIM,1816,74,na,1890,1
STAT,1850,26,25-29,1876,0.44643185489417647
STAT,1901,9,na,1910,36.30589632954613
STAT,1918,32,35-39,1950,0.09622894719823592
SIM,1903,15,15-19,1918,1
STAT,1887,38,15-19,1925,6.098912480906627E-4
STAT,1930,23,45-49,1953,0.014302456690375604
STAT,1781,78,na,1859,4.357914232931258
STAT,1931,27,30-34,1958,0.5036236593109482
STAT,1851,36,na,1887,20.312715461712465
STAT,1844,18,na,1862,22.65733658282383
STAT,1863,44,15-19,1907,1.2062146048708086E-4
SIM,1945,25,20-24,1970,1
STAT,1874,46,40-44,1920,0.001741740413293225
STAT,1844,15,45-49,1859,6.562993566984428E-4
STAT,1869,52,45-49,1921,1.3986821255178926E-4
STAT,1922,36,40-44,1958,0.01692444431916684
SIM,1846,40,na,1886,13
STAT,1859,32,30-34,1891,0.13877278250292593
STAT,1842,59,na,1901,14.581402395028448
STAT,1829,25,20-24,1854,0.294704686377589
STAT,1877,23,35-39,1900,0.060051254720117374
STAT,1885,86,na,1971,5.179865206893271
STAT,1841,43,25-29,1884,0.0064483052649965235
STAT,1851,50,50-100,1901,1.2933433830576087E-4
STAT,1896,16,20-24,1912,0.23344257608406113
STAT,1915,33,20-24,1948,0.02452345921505084
STAT,1840,74,na,1914,8.6962059592391
SIM,1866,17,na,1883,35
STAT,1881,72,na,1953,12.016993582242533
STAT,1844,88,na,1932,1.0723153348391208
STAT,1840,39,25-29,1879,0.026135854553207594
STAT,1871,20,25-29,1891,0.5741443056720951
STAT,1859,26,45-49,1885,0.009042125272438013
STAT,1897,71,na,1968,21.118879065133857
SIM,1846,18,na,1864,17
SIM,1910,4,na,1914,34
STAT,1880,31,45-49,1911,0.018412153694804645
STAT,1895,40,40-44,1935,0.029495993340407544
STAT,1850,48,45-49,1898,0.0020748587488999284
STAT,1849,15,20-24,1864,0.17122012875248208
SIM,1925,13,na,1938,45
STAT,1859,54,na,1913,16.643123869845862
STAT,1952,16,50-100,1968,0.004464464165557561
STAT,1863,21,na,1884,21.511852264640734
STAT,1877,20,30-34,1897,0.18496633088105713
STAT,1855,22,45-49,1877,0.00573566694962432
STAT,1878,35,45-49,1913,0.020776567927800905
STAT,1911,23,35-39,1934,0.08845047395951397
STAT,1842,22,na,1864,20.233590632375478
STAT,1933,21,20-24,1954,1.4733683355185763
STAT,1905,48,50-100,1953,0.0019743268620451963
STAT,1868,15,30-34,1883,0.015890510885601686
STAT,1904,48,40-44,1952,0.0013663707210190461
STAT,1924,38,40-44,1962,0.017519647929839857
STAT,1857,38,40-44,1895,0.032607796971055286
STAT,1924,30,30-34,1954,0.18344128300603085
SIM,1897,53,na,1950,38
STAT,1832,30,15-19,1862,8.497021046644313E-4
STAT,1834,52,50-100,1886,1.0943476811187103E-4
STAT,1836,22,35-39,1858,0.07432493590135403
STAT,1905,38,30-34,1943,0.016519872282519096
STAT,1831,26,15-19,1857,0.005046567901155084
STAT,1842,81,na,1923,4.057242247778866
STAT,1909,22,40-44,1931,0.031074785516035198
STAT,1882,44,25-29,1926,0.006071003573206961
STAT,1935,23,50-100,1958,0.008917591091872857
STAT,1854,18,50-100,1872,3.5611032859802404E-4
SIM,1907,32,na,1939,39
STAT,1879,16,45-49,1895,6.777549577603807E-4
STAT,1944,12,na,1956,41.96633624182513
STAT,1879,39,30-34,1918,0.054606485389914285
STAT,1912,27,20-24,1939,0.17847777641476673
SIM,1867,35,35-39,1902,1
STAT,1933,15,35-39,1948,0.056202540992815395
SIM,1831,63,na,1894,5
STAT,1838,35,15-19,1873,5.369458132065014E-4
STAT,1934,19,20-24,1953,1.8162319084117182
STAT,1812,56,na,1868,10.41669981586375
STAT,1861,20,40-44,1881,0.018264324294988133
STAT,1807,93,na,1900,0.12334091665354159
SIM,1910,36,na,1946,32
SIM,1825,78,na,1903,4
STAT,1834,28,45-49,1862,0.010214865859909121
STAT,1925,42,40-44,1967,0.003009285830948786
STAT,1908,18,40-44,1926,0.0026920231973041153
SIM,1920,27,20-24,1947,1
STAT,1809,73,na,1882,7.178203031364835
STAT,1843,40,30-34,1883,0.0051515602122508405
STAT,1889,30,na,1919,29.451207961308505
STAT,1843,22,50-100,1865,0.002171279041501006
SIM,1842,26,na,1868,26
STAT,1822,77,na,1899,3.0661338814853494
STAT,1852,46,40-44,1898,0.001469372145171039
SIM,1850,45,na,1895,20
STAT,1910,17,45-49,1927,9.837781996719986E-4
STAT,1938,19,40-44,1957,0.013697376914735902
STAT,1928,43,20-24,1971,2.2368266908202254E-4
STAT,1889,45,25-29,1934,7.122457451212767E-4
SIM,1835,40,na,1875,19
SIM,1837,41,na,1878,29
STAT,1829,44,15-19,1873,1.1897988148202175E-4
STAT,1868,29,15-19,1897,0.00435930397088047
STAT,1921,49,50-100,1970,0.0025150431463309615
STAT,1827,48,50-100,1875,0.0018278821153856332
STAT,1941,25,35-39,1966,0.15431850093748356
STAT,1861,31,35-39,1892,0.08551215517758169
STAT,1909,38,15-19,1947,1.7984990892838757E-4
STAT,1887,37,15-19,1924,6.129313877740222E-4
STAT,1835,30,40-44,1865,0.02568222783262767
STAT,1894,5,na,1899,33.585890654619995
SIM,1791,70,na,1861,4
STAT,1839,93,na,1932,0.16128213892180454
SIM,1857,18,25-29,1875,1
SIM,1871,17,na,1888,27
STAT,1895,42,45-49,1937,0.0013476124262886801
STAT,1834,62,na,1896,12.916493072988297
SIM,1858,35,na,1893,24
STAT,1842,28,40-44,1870,0.027594244238082124
STAT,1870,34,40-44,1904,0.0427116089792152
STAT,1901,19,45-49,1920,9.091357598212484E-4
STAT,1841,41,20-24,1882,0.0016361329884776873
STAT,1780,98,na,1878,0.010770484837902428
STAT,1873,31,15-19,1904,0.0014537651380514512
SIM,1810,80,na,1890,10
SIM,1898,65,na,1963,20
STAT,1893,34,35-39,1927,0.12659665265992998
STAT,1843,23,na,1866,11.302715765710428
STAT,1913,49,45-49,1962,0.0020912515855332388
STAT,1849,18,25-29,1867,0.053767245393760314
STAT,1903,17,50-100,1920,6.965337941345157E-4
STAT,1894,34,50-100,1928,0.011641993842053557
STAT,1827,86,na,1913,1.3446088542708734
SIM,1851,62,na,1913,15
STAT,1921,48,40-44,1969,0.0017585911597386198
STAT,1880,47,30-34,1927,0.0010131578787226383
STAT,1900,21,30-34,1921,0.24774543563445067
SIM,1884,67,na,1951,17
STAT,1947,17,40-44,1964,0.015648359028059645
SIM,1913,2,na,1915,48
STAT,1944,26,15-19,1970,0.007578051040632946
STAT,1835,41,35-39,1876,0.009956788385638973
STAT,1942,26,na,1968,39.04911627120408
SIM,1905,52,na,1957,40
STAT,1935,28,15-19,1963,0.009575807470811713
STAT,1826,43,35-39,1869,0.01883317449083137
STAT,1877,35,na,1912,24.55080324883339
STAT,1844,47,45-49,1891,0.0018347903768699324
STAT,1855,29,50-100,1884,0.004627373190326881
STAT,1921,17,20-24,1938,1.5333279547497125
STAT,1917,43,45-49,1960,0.0017183326113548653
STAT,1856,73,na,1929,8.604476352081864
STAT,1831,38,na,1869,21.634288533882916
SIM,1922,27,30-34,1949,1
STAT,1854,60,na,1914,11.657350072409933
STAT,1855,34,15-19,1889,9.999210557516613E-4
STAT,1857,42,25-29,1899,0.0048013206616263114
STAT,1913,27,25-29,1940,0.6503533772895951
STAT,1934,35,45-49,1969,0.009383881542275055
STAT,1923,48,50-100,1971,0.0026202772316974497
STAT,1833,33,25-29,1866,0.09662404892194265
STAT,1817,50,30-34,1867,1.7221712043166652E-4
STAT,1845,21,50-100,1866,0.002980653139561407
STAT,1822,55,na,1877,8.065147235632727
STAT,1850,30,20-24,1880,0.028247148528965513
STAT,1879,20,40-44,1899,0.02169631460895823
STAT,1864,60,na,1924,17.105930907536838
SIM,1884,57,na,1941,20
STAT,1831,25,15-19,1856,0.005175361321739839
STAT,1914,27,30-34,1941,0.39172588823846777
STAT,1826,30,15-19,1856,0.002673945720951476
SIM,1867,1,na,1868,30
STAT,1938,19,50-100,1957,0.003668939352824038
STAT,1881,34,50-100,1915,0.00864383032631373
STAT,1917,49,na,1966,37.801343905761975
STAT,1930,24,20-24,1954,1.408939193628948
STAT,1864,29,30-34,1893,0.22424794157533864
STAT,1914,23,50-100,1937,0.0066461031755683155
SIM,1896,52,na,1948,23
SIM,1866,38,na,1904,28
STAT,1932,18,35-39,1950,0.05519331104889146
STAT,1878,20,35-39,1898,0.06060598557397982
STAT,1881,40,na,1921,22.21436201563086
STAT,1845,30,25-29,1875,0.07268316541526272
STAT,1954,11,na,1965,48.29123756176965
SIM,1821,58,na,1879,10
SIM,1907,6,na,1913,41
STAT,1943,9,na,1952,41.54574082789152
STAT,1820,35,40-44,1855,0.04265804485144788
STAT,1884,41,30-34,1925,0.011314863386328757
STAT,1879,36,na,1915,24.50196369272254
STAT,1900,35,50-100,1935,0.01718657518680663
STAT,1902,48,30-34,1950,7.60332727267383E-4
STAT,1890,49,na,1939,26.7632499550434
STAT,1833,46,30-34,1879,8.503132105628473E-4
STAT,1935,30,45-49,1965,0.021698294058952114
SIM,1876,38,na,1914,29
STAT,1939,22,15-19,1961,0.053092980498556375
STAT,1932,32,30-34,1964,0.20859420815683272
STAT,1919,19,30-34,1938,0.13281228417930502
STAT,1849,36,40-44,1885,0.035094967231823246
STAT,1815,41,50-100,1856,0.016734311993769086
STAT,1816,43,na,1859,9.308714605908918
STAT,1831,47,35-39,1878,0.001340346528821506
STAT,1912,15,15-19,1927,0.09147539718867786
STAT,1915,35,35-39,1950,0.02445332560774611
STAT,1838,54,50-100,1892,1.139960244166908E-4
STAT,1927,38,20-24,1965,0.0032574291955340478
SIM,1876,18,35-39,1894,1
STAT,1829,28,25-29,1857,0.4467281744094731
SIM,1833,43,na,1876,11
STAT,1874,31,20-24,1905,0.027534363572692875
STAT,1841,51,50-100,1892,1.4853525505788411E-4
STAT,1882,42,20-24,1924,0.0015201010126521318
STAT,1809,51,35-39,1860,2.8722286315126125E-4
STAT,1918,50,na,1968,38.39185958162461
STAT,1809,89,na,1898,0.5812736165830766
STAT,1857,39,40-44,1896,0.03244051897259378
STAT,1784,70,na,1854,9.0
STAT,1839,61,na,1900,10.31218074096307
STAT,1807,88,na,1895,0.5793825757000409
STAT,1834,25,40-44,1859,0.028161653023219442
STAT,1908,39,50-100,1947,0.0038712017834201277
SIM,1814,88,na,1902,6
STAT,1844,33,50-100,1877,0.008469868896832659
SIM,1930,22,20-24,1952,1
STAT,1867,44,35-39,1911,0.017094867829810467
STAT,1876,42,35-39,1918,0.018368810326496825
STAT,1872,48,35-39,1920,0.0014144396510454263
SIM,1889,82,na,1971,11
STAT,1907,37,40-44,1944,0.01382074261152138
STAT,1848,44,25-29,1892,0.004096772618605525
STAT,1896,19,25-29,1915,0.07403534095384443
STAT,1840,23,15-19,1863,0.03263856660484817
STAT,1854,104,na,1958,7.299362199314982E-4
STAT,1884,15,na,1899,24.859642658370618
STAT,1920,17,15-19,1937,0.5048408374369086
SIM,1830,25,na,1855,21
SIM,1837,28,25-29,1865,2
STAT,1807,102,na,1909,0.0012372963144278142
STAT,1891,43,15-19,1934,1.6827244162794452E-4
STAT,1907,33,35-39,1940,0.08469949535902485
STAT,1850,47,45-49,1897,0.0020914649808478616
STAT,1928,38,25-29,1966,0.012370044001700154
STAT,1892,18,na,1910,31.11978318729397
STAT,1885,32,50-100,1917,0.009048060518732396
STAT,1898,4,na,1902,35.48800041950613
STAT,1904,34,20-24,1938,0.02204943637415644
STAT,1897,65,na,1962,24.132044843259553
SIM,1900,37,na,1937,36
STAT,1879,68,na,1947,15.816997420722325
STAT,1876,31,40-44,1907,0.044225675358473535
STAT,1846,32,50-100,1878,0.008775102809753283
STAT,1938,17,15-19,1955,0.44472886206657697
STAT,1859,42,35-39,1901,0.014374934023592485
STAT,1885,45,40-44,1930,0.0017074801600532555
STAT,1935,6,na,1941,54.54980739702595
SIM,1919,17,30-34,1936,1
STAT,1820,46,20-24,1866,1.0280226370407862E-4
STAT,1897,39,50-100,1936,0.0034836308037511834
SIM,1920,19,20-24,1939,1
STAT,1830,45,50-100,1875,2.5042742867088867E-4
STAT,1899,20,50-100,1919,0.005615687693742333
STAT,1874,26,50-100,1900,0.0065118950016734385
STAT,1913,32,20-24,1945,0.024064900434882425
STAT,1912,19,20-24,1931,0.2705457978217546
STAT,1860,15,40-44,1875,0.0017353139932607218
STAT,1925,19,50-100,1944,0.004473384165307357
STAT,1886,31,25-29,1917,0.106677260651057
SIM,1905,30,na,1935,40
SIM,1957,12,na,1969,56
STAT,1854,41,45-49,1895,0.00918938138775736
STAT,1951,8,na,1959,46.516532184808376
STAT,1936,28,20-24,1964,0.17355367221433018
STAT,1784,80,na,1864,3.488219350087013
STAT,1846,45,50-100,1891,0.002010254985252191
STAT,1906,65,na,1971,28.06728985095217
STAT,1839,71,na,1910,7.366179577081506
STAT,1818,41,35-39,1859,0.020078795010337058
STAT,1909,40,45-49,1949,0.001565490489251213
STAT,1929,17,50-100,1946,0.004758524833647148
STAT,1929,28,na,1957,46.63757263630092
SIM,1867,7,na,1874,20
STAT,1827,76,na,1903,5.741433446901059
SIM,1905,62,na,1967,38
SIM,1873,73,na,1946,5
STAT,1857,28,50-100,1885,0.004897111335262124
STAT,1885,32,35-39,1917,0.10000627652268555
STAT,1877,29,na,1906,24.459077993963753
SIM,1842,20,na,1862,25
SIM,1884,5,na,1889,28
STAT,1882,7,na,1889,25.110207006017824
STAT,1918,36,15-19,1954,2.0154107343103172E-4
STAT,1896,35,15-19,1931,7.446155580995917E-4
STAT,1830,41,45-49,1871,0.008301662167282712
STAT,1879,35,15-19,1914,5.8672510701129E-4
STAT,1823,32,50-100,1855,0.013895897681231138
STAT,1854,17,na,1871,16.783881881757313
STAT,1919,48,25-29,1967,5.687760834553627E-4
SIM,1855,60,na,1915,11
STAT,1868,18,35-39,1886,0.005374408081327237
STAT,1928,17,30-34,1945,0.15283146448431126
STAT,1840,36,20-24,1876,0.007218772075624091
STAT,1819,40,25-29,1859,0.006320800357850829
STAT,1900,24,35-39,1924,0.08041298059154742
STAT,1826,37,50-100,1863,0.014202919363408058
STAT,1922,22,20-24,1944,1.2658094677062666
STAT,1834,40,na,1874,18.376537034563956
STAT,1861,47,20-24,1908,1.004441969673065E-4
SIM,1860,23,na,1883,26
STAT,1842,75,na,1917,7.723837253116698
STAT,1819,73,na,1892,6.097085486128035
STAT,1891,48,45-49,1939,0.0016133813786023867
STAT,1908,45,45-49,1953,0.001984086919279559
STAT,1911,41,50-100,1952,0.001120470779779384
STAT,1824,40,20-24,1864,0.002225552522529414
SIM,1869,68,na,1937,11
STAT,1838,39,30-34,1877,0.04888772699499851
SIM,1878,29,25-29,1907,1
STAT,1929,40,50-100,1969,0.0015183330816196247
SIM,1900,15,na,1915,39
STAT,1860,88,na,1948,1.1160781228021035
STAT,1891,31,20-24,1922,0.033311944057631555
SIM,1825,56,na,1881,14
STAT,1924,33,35-39,1957,0.10585622936521787
SIM,1898,15,20-24,1913,1
STAT,1847,90,na,1937,0.8422041121777455
SIM,1786,81,na,1867,14
STAT,1908,42,40-44,1950,0.0023021171457852613
STAT,1943,28,50-100,1971,0.01051828354283895
STAT,1811,61,na,1872,13.00527253735471
STAT,1831,44,30-34,1875,0.011098430440236636
STAT,1881,37,20-24,1918,0.007334961994501548
STAT,1913,46,40-44,1959,0.0015297818213962319
STAT,1903,40,50-100,1943,0.0010535389376072277
SIM,1826,73,na,1899,5
STAT,1860,41,30-34,1901,0.009388779624541724
STAT,1861,40,25-29,1901,0.005454745549383716
STAT,1930,36,15-19,1966,2.495374178151989E-4
STAT,1875,26,40-44,1901,0.030898336784587546
SIM,1867,20,25-29,1887,1
STAT,1903,29,20-24,1932,0.16559785641744879
STAT,1846,41,na,1887,19.202138241902542
SIM,1806,59,na,1865,6
STAT,1893,31,30-34,1924,0.22104527791537124
STAT,1843,43,35-39,1886,0.007808144841325235
STAT,1922,6,na,1928,46.04617286412919
STAT,1925,45,45-49,1970,0.0026294590794909848
STAT,1900,37,40-44,1937,0.013102002699841178
SIM,1886,16,na,1902,30
STAT,1826,40,30-34,1866,0.012626463934912317
STAT,1926,33,45-49,1959,0.018906772197265765
STAT,1872,73,na,1945,12.152731298105783
STAT,1811,45,40-44,1856,0.0069952653490107375
STAT,1941,22,30-34,1963,0.2948640069024376
STAT,1951,18,45-49,1969,0.005910640248558723
STAT,1852,59,na,1911,16.633103146802966
STAT,1891,45,40-44,1936,0.0011970949112658522
STAT,1877,15,35-39,1892,0.005690427086747461
STAT,1963,0,na,1963,50.01211672974173
STAT,1820,43,40-44,1863,0.01955857543966685
STAT,1874,47,30-34,1921,9.774494204803914E-4
STAT,1931,15,25-29,1946,0.5673260656076496
SIM,1896,36,na,1932,29
STAT,1879,52,na,1931,22.16686375875799
STAT,1814,46,20-24,1860,3.4897741278702737E-4
STAT,1824,54,40-44,1878,1.264261303195672E-4
SIM,1908,8,na,1916,42
STAT,1836,40,25-29,1876,0.0075638930887978574
STAT,1901,16,40-44,1917,0.0025655914778756404
STAT,1859,20,25-29,1879,0.5262948948611664
STAT,1924,25,35-39,1949,0.1748494602119863
STAT,1892,56,na,1948,25.19779454763178
STAT,1911,49,25-29,1960,4.960201880668796E-4
STAT,1929,38,30-34,1967,0.023263401409629972
STAT,1938,27,na,1965,36.8686616445486
STAT,1852,30,40-44,1882,0.03923530101225369
SIM,1920,5,na,1925,51
STAT,1858,39,50-100,1897,0.009248415776120495
SIM,1843,75,na,1918,15
STAT,1880,49,na,1929,23.164303655267748
SIM,1855,17,na,1872,22
STAT,1848,70,na,1918,9.073677525813011
STAT,1850,33,25-29,1883,0.09441524619793794
SIM,1920,51,na,1971,41
STAT,1883,32,25-29,1915,0.09946403201808005
STAT,1932,35,35-39,1967,0.03242285107611285
STAT,1855,18,25-29,1873,0.04717485750269436
STAT,1877,31,50-100,1908,0.00949669759093342
STAT,1851,18,40-44,1869,0.0018663145981657814
STAT,1933,27,40-44,1960,0.06163701158810233
STAT,1871,42,45-49,1913,0.014903137092973782
SIM,1921,24,20-24,1945,3
STAT,1834,56,na,1890,14.414001091722561
STAT,1811,49,20-24,1860,4.6058293760064834E-4
SIM,1857,18,na,1875,22
STAT,1809,100,na,1909,0.0058742081247003764
STAT,1923,46,25-29,1969,6.177727805432102E-4
STAT,1848,16,50-100,1864,3.9508520479832385E-4
STAT,1858,41,15-19,1899,1.0556064993546547E-4
STAT,1915,32,30-34,1947,0.15907431332748576
STAT,1844,44,40-44,1888,0.01753836888449585
SIM,1841,62,na,1903,13
STAT,1897,55,na,1952,27.458313889500037
STAT,1876,34,35-39,1910,0.10197451119563027
STAT,1864,41,15-19,1905,1.2442397490584068E-4
STAT,1878,42,45-49,1920,0.015432552481209264
STAT,1899,33,50-100,1932,0.012489862891782307
STAT,1817,53,35-39,1870,2.3462598590271504E-4
STAT,1926,26,na,1952,44.80415561733724
STAT,1804,51,45-49,1855,4.0660617342273305E-4
STAT,1826,40,40-44,1866,0.024703126919358574
STAT,1862,30,25-29,1892,0.08907989454989337
STAT,1829,93,na,1922,0.19851407479266697
STAT,1868,22,30-34,1890,0.1723775333475054
STAT,1926,38,15-19,1964,2.3311294708609786E-4
SIM,1945,7,na,1952,40
STAT,1885,48,45-49,1933,0.0023012516957823348
STAT,1918,34,50-100,1952,0.008631767001365991
STAT,1816,41,25-29,1857,0.009052009183800518
STAT,1914,20,na,1934,37.3240127661737
SIM,1818,44,na,1862,25
STAT,1835,39,50-100,1874,0.006738645168066743
STAT,1861,44,40-44,1905,0.018660086841640475
STAT,1843,101,na,1944,0.0024205486373752093
STAT,1870,72,na,1942,12.545453797805537
STAT,1905,44,50-100,1949,0.001044501689669839
STAT,1842,23,25-29,1865,0.5378386650602218
SIM,1893,34,na,1927,34
SIM,1926,34,50-100,1960,1
STAT,1913,24,20-24,1937,1.1064847768387511
SIM,1856,61,na,1917,9
STAT,1931,21,50-100,1952,0.008521910211363365
STAT,1818,56,na,1874,5.995207928888874
STAT,1860,72,na,1932,10.266990919542655
STAT,1859,38,na,1897,18.632824925212386
STAT,1928,35,20-24,1963,0.003320929079061296
STAT,1936,19,30-34,1955,0.1153673816149473
SIM,1835,56,na,1891,16
STAT,1861,23,35-39,1884,0.050053433727373114
STAT,1910,43,35-39,1953,0.001880104829161787
STAT,1812,50,40-44,1862,1.1875792412724862E-4
STAT,1843,35,50-100,1878,0.00620746970834066
STAT,1925,28,45-49,1953,0.020206018641398996
STAT,1877,67,na,1944,16.36358635095033
STAT,1850,44,40-44,1894,0.019756438929606733
STAT,1902,13,na,1915,36.36175067380313
STAT,1884,44,35-39,1928,0.01750200659095857
SIM,1913,25,25-29,1938,1
SIM,1800,80,na,1880,5
STAT,1824,62,na,1886,13.238752097755976
STAT,1824,43,25-29,1867,0.008558644024858078
STAT,1898,13,na,1911,34.784071417491006
STAT,1843,30,15-19,1873,7.414647558644205E-4
SIM,1943,26,na,1969,46
SIM,1847,41,na,1888,18
STAT,1824,53,50-100,1877,1.8500094714712557E-4
STAT,1891,34,25-29,1925,0.12463770419906808
STAT,1842,31,25-29,1873,0.09380340251658599
STAT,1863,36,15-19,1899,4.995841573518468E-4
STAT,1867,41,30-34,1908,0.011051652454614806
STAT,1895,48,na,1943,28.847029973068214
SIM,1901,32,na,1933,37
SIM,1867,18,na,1885,16
STAT,1842,91,na,1933,0.4347702708478549
STAT,1947,4,na,1951,44.49551390946877
STAT,1889,52,na,1941,26.22229524311251
STAT,1939,22,na,1961,36.422715574560755
STAT,1901,66,na,1967,25.771797200068068
STAT,1907,30,30-34,1937,0.1478250238996574
STAT,1901,46,50-100,1947,0.0019440350629427636
STAT,1850,30,50-100,1880,0.00957482862085685
SIM,1832,42,na,1874,25
STAT,1919,45,50-100,1964,0.002443405063253256
STAT,1915,48,40-44,1963,0.001570607846711346
STAT,1922,38,30-34,1960,0.020565844255575803
STAT,1959,10,na,1969,51.102132157877875
STAT,1821,51,35-39,1872,1.1920585477905199E-4
STAT,1835,33,35-39,1868,0.058007598634139936
STAT,1883,24,25-29,1907,0.5524214830876368
STAT,1859,16,na,1875,21.303593114620845
SIM,1874,90,na,1964,2
STAT,1934,32,40-44,1966,0.05320382736117408
STAT,1902,35,na,1937,33.80385373332555
SIM,1877,2,na,1879,34
STAT,1836,18,15-19,1854,0.07650206784390906
STAT,1841,44,15-19,1885,1.3690793041199538E-4
STAT,1892,19,40-44,1911,0.0022474806012789798
STAT,1913,35,25-29,1948,0.009726940076904167
STAT,1913,51,na,1964,35.104964061661384
SIM,1820,57,na,1877,10
STAT,1855,52,50-100,1907,1.0576783084819172E-4
STAT,1870,37,45-49,1907,0.01980306933168528
STAT,1931,32,na,1963,49.33780940357995
SIM,1900,21,na,1921,36
SIM,1817,53,na,1870,7
SIM,1955,11,na,1966,46
STAT,1944,5,na,1949,42.52887344755033
STAT,1860,94,na,1954,0.1624813574678594
STAT,1938,11,na,1949,38.885799956389604
STAT,1892,34,na,1926,29.228267426332135
STAT,1906,28,35-39,1934,0.13968772196486035
STAT,1888,3,na,1891,30.893543581775823
STAT,1890,31,15-19,1921,0.0017368993200203649
STAT,1875,37,50-100,1912,0.012620485568838855
STAT,1857,0,na,1857,29.60742657256072
SIM,1796,58,na,1854,12
STAT,1905,25,25-29,1930,0.614653510714527
STAT,1893,47,40-44,1940,0.00121196588473645
STAT,1950,15,35-39,1965,0.04933461318899563
STAT,1881,5,na,1886,25.481808244992983
STAT,1872,45,30-34,1917,0.0010003029082920971
STAT,1926,1,na,1927,50.90817880957836
STAT,1940,17,30-34,1957,0.12287913430209679
STAT,1857,90,na,1947,0.5902068208396339
SIM,1776,81,na,1857,1
STAT,1857,51,50-100,1908,1.1360134752322294E-4
STAT,1911,22,45-49,1933,0.010602315481219721
SIM,1910,15,na,1925,33
STAT,1942,17,50-100,1959,0.0038867796444099685
SIM,1883,3,na,1886,25
STAT,1882,51,na,1933,20.733478082587467
STAT,1812,77,na,1889,3.413854082152165
STAT,1833,45,na,1878,18.212689071525947
STAT,1898,43,25-29,1941,5.97210427466426E-4
STAT,1907,15,50-100,1922,7.19959033394853E-4
SIM,1850,23,na,1873,21
STAT,1858,15,25-29,1873,0.05096932100243395
STAT,1805,54,30-34,1859,1.1065690801094293E-4
SIM,1820,79,na,1899,1
STAT,1896,30,45-49,1926,0.02308985175289253
STAT,1825,42,na,1867,14.74312107772876
STAT,1953,10,na,1963,47.25649586205124
SIM,1861,39,na,1900,24
SIM,1826,57,na,1883,14
STAT,1907,15,30-34,1922,0.023422671981848407
SIM,1953,18,20-24,1971,4
STAT,1869,45,50-100,1914,0.002403444864528598
STAT,1933,20,30-34,1953,0.38195069572996804
STAT,1894,22,35-39,1916,0.07478703921100673
SIM,1895,51,na,1946,26
STAT,1912,43,45-49,1955,0.001583050034237133
STAT,1915,44,25-29,1959,7.103500361335662E-4
STAT,1890,17,50-100,1907,5.951057698461398E-4
SIM,1882,7,na,1889,34
STAT,1840,40,15-19,1880,1.272651770480465E-4
STAT,1869,17,15-19,1886,0.05829858390530459
STAT,1919,9,na,1928,43.61048136032457
SIM,1929,17,25-29,1946,1
STAT,1890,70,na,1960,18.458250750188988
STAT,1913,48,30-34,1961,8.60426317618433E-4
STAT,1882,88,na,1970,3.570965906929086
SIM,1852,89,na,1941,1
STAT,1831,46,20-24,1877,1.1636880096771715E-4
STAT,1909,51,na,1960,33.141150650366725
STAT,1830,41,35-39,1871,0.01004434096473986
STAT,1802,94,na,1896,0.061038513182497166
SIM,1845,39,na,1884,23
STAT,1872,34,15-19,1906,0.0014445980110079472
STAT,1896,18,50-100,1914,6.41839924444283E-4
STAT,1862,52,45-49,1914,1.24541429087798E-4
STAT,1910,48,na,1958,33.972453677549844
SIM,1915,29,na,1944,35
STAT,1899,29,na,1928,32.43642111347345
STAT,1857,89,na,1946,0.7864391067578533
STAT,1828,87,na,1915,1.1832459306934535
STAT,1827,31,35-39,1858,0.09244170004330574
SIM,1883,66,na,1949,6
SIM,1921,20,na,1941,36
STAT,1825,35,40-44,1860,0.04744861703761956
STAT,1834,21,25-29,1855,0.5449569265395164
STAT,1941,25,na,1966,38.505215456202365
STAT,1942,17,40-44,1959,0.014510647534423781
STAT,1892,26,40-44,1918,0.03713442515260017
STAT,1916,27,40-44,1943,0.0477816347260785
SIM,1854,54,na,1908,16
SIM,1842,21,25-29,1863,1
SIM,1906,53,na,1959,22
STAT,1870,56,na,1926,20.261491439927372
STAT,1833,61,na,1894,13.834317010230693
SIM,1898,23,20-24,1921,1
STAT,1844,24,na,1868,20.55368967041569
SIM,1870,16,na,1886,27
SIM,1894,19,na,1913,32
STAT,1922,34,15-19,1956,0.0014342666299388491
STAT,1887,32,45-49,1919,0.0190339541905753
STAT,1804,51,35-39,1855,2.412070523666997E-4
SIM,1874,4,na,1878,32
SIM,1927,14,na,1941,52
STAT,1941,7,na,1948,40.639092559293665
SIM,1895,73,na,1968,14
STAT,1824,94,na,1918,0.13906554690300124
SIM,1835,72,na,1907,8
STAT,1866,36,40-44,1902,0.040510036458162264
STAT,1872,47,20-24,1919,1.2220802049000076E-4
STAT,1938,28,30-34,1966,0.38543993041891933
STAT,1896,15,45-49,1911,8.620211705859991E-4
STAT,1899,16,25-29,1915,0.07776427373060833
STAT,1902,19,na,1921,35.42476043186364
STAT,1900,30,50-100,1930,0.01280753995966542
STAT,1946,19,50-100,1965,0.004123391361374764
STAT,1884,31,15-19,1915,0.0014009438016834757
STAT,1831,33,15-19,1864,0.001485965921782357
SIM,1887,22,na,1909,25
STAT,1843,76,na,1919,4.018825470191156
STAT,1869,30,35-39,1899,0.09891408064764871
STAT,1902,21,40-44,1923,0.029474311702493105
STAT,1901,39,15-19,1940,1.67891033740003E-4
SIM,1914,9,na,1923,37
STAT,1870,30,25-29,1900,0.10256673376693183
STAT,1880,43,15-19,1923,1.4416867038150648E-4
SIM,1954,10,na,1964,50
STAT,1868,25,35-39,1893,0.09401055236978006
STAT,1919,28,20-24,1947,0.1948338124422202
SIM,1899,66,na,1965,22
STAT,1941,20,50-100,1961,0.006755210633506225
STAT,1851,106,na,1957,1.5923694002299677E-4
STAT,1853,40,25-29,1893,0.004076559367191125
STAT,1896,70,na,1966,21.278582211573127
STAT,1842,20,20-24,1862,0.6616011259830693
STAT,1891,47,30-34,1938,6.670562469211426E-4
STAT,1853,21,35-39,1874,0.043646314237433786
STAT,1920,25,15-19,1945,0.007730320235432653
STAT,1898,32,20-24,1930,0.036464285834790916
STAT,1817,40,15-19,1857,4.6419848531205343E-4
STAT,1873,19,50-100,1892,4.954256252526398E-4
STAT,1924,22,30-34,1946,0.3369369880937665
STAT,1863,16,na,1879,23.32876398857271
STAT,1873,19,30-34,1892,0.016117850285143315
STAT,1821,76,na,1897,5.884216061635543
SIM,1851,24,na,1875,25
STAT,1939,26,30-34,1965,0.3913762007359577
SIM,1901,16,na,1917,39
STAT,1843,40,40-44,1883,0.010078803251009637
STAT,1838,18,25-29,1856,0.05775327249176754
STAT,1846,17,50-100,1863,4.987673979143004E-4
STAT,1919,15,15-19,1934,0.10021111618218966
STAT,1909,33,45-49,1942,0.014868908106702857
STAT,1833,42,15-19,1875,1.2388864917544179E-4
STAT,1943,25,45-49,1968,0.018281072947434602
STAT,1876,31,30-34,1907,0.17805355587144078
STAT,1813,57,na,1870,17.065128223761704
SIM,1775,80,na,1855,1
STAT,1922,33,na,1955,42.24059367696412
SIM,1906,31,na,1937,27
STAT,1808,72,na,1880,2.2204508735096726
SIM,1864,74,na,1938,10
STAT,1920,39,25-29,1959,0.010665824342274637
STAT,1888,30,45-49,1918,0.02054207527533513
STAT,1822,35,15-19,1857,3.642228814045699E-4
STAT,1852,42,25-29,1894,0.005489123143741188
SIM,1812,44,na,1856,18
STAT,1863,40,35-39,1903,0.01619467974549334
STAT,1921,37,25-29,1958,0.010908194450832203
SIM,1911,0,na,1911,42
STAT,1832,29,50-100,1861,0.003772220993601121
STAT,1882,56,na,1938,19.54670572845355
STAT,1915,15,30-34,1930,0.025407708666967965
STAT,1850,46,30-34,1896,8.643202439696604E-4
STAT,1876,20,50-100,1896,0.004166417737949361
STAT,1930,42,25-29,1972,9.351703352286186E-4
STAT,1866,32,25-29,1898,0.09433249640709544
STAT,1809,95,na,1904,0.07356579318846974
STAT,1900,30,20-24,1930,0.037784121038289126
STAT,1893,31,40-44,1924,0.054904136301929314
STAT,1883,14,na,1897,24.99707951032348
STAT,1857,24,20-24,1881,0.5342040613608242
STAT,1846,31,45-49,1877,0.01687532432516223
STAT,1829,35,na,1864,19.006171433590275
STAT,1820,39,20-24,1859,0.006997286347058279
STAT,1874,37,na,1911,23.901185955768607
STAT,1877,41,25-29,1918,0.006658730448891737
STAT,1876,66,na,1942,16.6465368961551
STAT,1849,22,20-24,1871,0.6460349025633397
STAT,1947,25,na,1972,42.12846742046666
SIM,1958,7,na,1965,53
STAT,1847,29,30-34,1876,0.31870081134144085
STAT,1920,28,50-100,1948,0.010787718320989804
STAT,1935,23,45-49,1958,0.01524908018606897
STAT,1845,89,na,1934,0.6140891382524302
STAT,1861,20,30-34,1881,0.15612243771525416
STAT,1921,44,25-29,1965,7.95370592653155E-4
STAT,1821,51,45-49,1872,2.0094701206169202E-4
STAT,1810,101,na,1911,0.0020510849242097134
STAT,1835,30,30-34,1865,0.10339722234278326
STAT,1898,21,15-19,1919,0.04463822373239609
STAT,1817,50,40-44,1867,3.0458234466188087E-4
STAT,1905,22,20-24,1927,0.9945736105364403
STAT,1884,85,na,1969,5.642437810212053
STAT,1863,31,45-49,1894,0.015502856683576781
STAT,1914,36,50-100,1950,0.004177262221613909
SIM,1907,16,na,1923,41
STAT,1867,89,na,1956,1.1290234563128947
STAT,1926,40,45-49,1966,0.0020456704611939744
STAT,1917,35,45-49,1952,0.007083067144006483
STAT,1935,36,15-19,1971,2.6757689095628856E-4
SIM,1854,7,na,1861,21
STAT,1867,41,40-44,1908,0.021622076827076918
STAT,1939,33,30-34,1972,0.15955047519224697
STAT,1883,21,20-24,1904,0.6712168170204958
STAT,1930,27,25-29,1957,0.8330186702671816
STAT,1912,37,50-100,1949,0.004065791380656304
SIM,1829,87,na,1916,4
STAT,1908,29,na,1937,34.97774173321887
SIM,1954,16,20-24,1970,2
SIM,1857,29,40-44,1886,1
SIM,1925,29,na,1954,45
STAT,1911,31,35-39,1942,0.08877397402688655
STAT,1874,43,15-19,1917,1.3908748702965923E-4
STAT,1832,39,na,1871,11.897627538619098
STAT,1857,20,15-19,1877,0.028924858135095904
STAT,1868,32,35-39,1900,0.09800420564160887
SIM,1860,30,30-34,1890,2
STAT,1826,91,na,1917,0.40494913082264306
SIM,1848,42,na,1890,30
STAT,1907,44,na,1951,33.466535730586976
STAT,1857,74,na,1931,8.307966450424248
SIM,1889,0,na,1889,37
STAT,1877,19,15-19,1896,0.060931531439500516
STAT,1837,41,45-49,1878,0.00871016937682216
STAT,1849,29,40-44,1878,0.02713986810431949
STAT,1870,51,50-100,1921,1.5074682091321866E-4
SIM,1894,29,na,1923,31
STAT,1860,78,na,1938,6.352021657376588
STAT,1842,15,50-100,1857,4.7762542873658326E-4
SIM,1915,45,na,1960,31
STAT,1876,20,25-29,1896,0.5848816609573622
STAT,1946,16,20-24,1962,1.493536599665373
STAT,1857,52,na,1909,16.032977805373985
STAT,1898,47,40-44,1945,0.0012966709371239435
SIM,1875,37,na,1912,17
STAT,1859,7,na,1866,22.835913175387848
STAT,1851,25,40-44,1876,0.030040292952973426
STAT,1929,16,20-24,1945,1.7261810094963437
STAT,1870,54,45-49,1924,1.4020023095723152E-4
STAT,1893,43,25-29,1936,5.581976455056429E-4
STAT,1880,36,15-19,1916,5.9333711691963E-4
STAT,1928,43,na,1971,47.03985025988963
STAT,1894,41,25-29,1935,0.008267070496343561
STAT,1916,23,35-39,1939,0.09752035963242432
STAT,1897,20,45-49,1917,0.009315370604018264
STAT,1852,30,30-34,1882,0.1579621973953555
STAT,1945,18,20-24,1963,1.4698925804132577
STAT,1888,27,50-100,1915,0.007475432667647396
STAT,1844,46,50-100,1890,0.001923816058606424
STAT,1934,15,40-44,1949,0.018926396312843055
STAT,1866,29,40-44,1895,0.027391410108757938
STAT,1898,25,20-24,1923,0.15933104943747595
STAT,1911,27,15-19,1938,0.006840185910949725
STAT,1809,57,na,1866,14.697528687711008
SIM,1805,58,na,1863,14
STAT,1806,102,na,1908,0.0013718213442773196
STAT,1867,67,na,1934,15.169909485668349
STAT,1916,20,30-34,1936,0.3003764566032938
STAT,1891,55,na,1946,25.378367743317018
SIM,1885,15,na,1900,26
STAT,1879,30,45-49,1909,0.018193812354883303
STAT,1912,37,25-29,1949,0.009534745725622297
STAT,1816,38,50-100,1854,0.01842775599316714
STAT,1924,29,na,1953,43.024346418830085
STAT,1932,11,na,1943,52.33198019123594
STAT,1859,48,na,1907,17.657425043482743
STAT,1872,22,50-100,1894,0.004172389959574849
SIM,1874,52,na,1926,25
SIM,1848,20,na,1868,33
STAT,1850,42,15-19,1892,1.2280649450599552E-4
SIM,1852,31,35-39,1883,1
SIM,1907,26,na,1933,40
STAT,1791,100,na,1891,0.0019486563071073153
STAT,1812,62,na,1874,8.931798648977884
SIM,1901,17,45-49,1918,1
STAT,1851,90,na,1941,0.665596437927512
STAT,1794,79,na,1873,3.2283770748566347
STAT,1907,28,50-100,1935,0.009324173343449874
STAT,1903,25,15-19,1928,0.006494201438624315
STAT,1833,30,20-24,1863,0.026306259690003185
STAT,1933,23,35-39,1956,0.12434760259522745
STAT,1893,40,20-24,1933,0.002022642879835392
SIM,1836,35,na,1871,9
SIM,1825,72,na,1897,7
STAT,1905,47,35-39,1952,0.001134438063327105
SIM,1795,79,na,1874,5
SIM,1890,1,na,1891,35
STAT,1889,14,na,1903,31.516116848084415
SIM,1930,6,na,1936,55
STAT,1853,38,na,1891,14.733431821284476
STAT,1880,92,na,1972,1.8119784255792903
STAT,1884,41,40-44,1925,0.022137037554499094
STAT,1875,41,15-19,1916,1.4259938375641473E-4
STAT,1846,44,15-19,1890,1.1040804829832506E-4
STAT,1885,41,25-29,1926,0.006370089115375698
STAT,1948,16,30-34,1964,0.1386073638649976
STAT,1851,42,40-44,1893,0.018965703261084176
SIM,1905,27,30-34,1932,1
STAT,1838,49,na,1887,17.51041781910402
STAT,1863,43,50-100,1906,0.009286230026741702
STAT,1920,36,20-24,1956,0.0028642650142576215
STAT,1868,15,na,1883,25.179710823737103
STAT,1799,78,na,1877,3.506961932831021
SIM,1871,60,na,1931,19
STAT,1932,33,na,1965,50.0423996119878
STAT,1901,34,na,1935,33.10503092765262
STAT,1881,24,15-19,1905,0.031195129455416342
SIM,1874,74,na,1948,17
STAT,1895,20,35-39,1915,0.07621144915573741
STAT,1891,33,na,1924,29.165119548810043
STAT,1914,30,na,1944,38.05811956956161
STAT,1918,21,50-100,1939,0.0070536595457748675
STAT,1886,43,50-100,1929,0.010879059802692053
STAT,1909,30,40-44,1939,0.03743272772504596
SIM,1820,73,na,1893,4
STAT,1856,15,15-19,1871,0.05143924275611522
STAT,1934,4,na,1938,54.36223051949792
STAT,1790,98,na,1888,0.0036838304543102877
SIM,1856,71,na,1927,7
SIM,1868,67,na,1935,27
STAT,1902,24,45-49,1926,0.009771976076057625
STAT,1915,41,20-24,1956,1.7651862821337302E-4
SIM,1922,15,na,1937,52
STAT,1871,19,na,1890,25.045265325997793
SIM,1785,80,na,1865,4
SIM,1874,89,na,1963,3
STAT,1889,42,20-24,1931,0.001942004421562508
SIM,1937,14,na,1951,41
STAT,1844,31,35-39,1875,0.09558013459531767
STAT,1844,40,25-29,1884,0.005270404692991463
STAT,1938,17,25-29,1955,0.4246585444570157
STAT,1834,40,15-19,1874,1.2070492733762573E-4
STAT,1828,49,na,1877,16.32616705906162
STAT,1800,77,na,1877,3.1500144842509865
STAT,1874,22,na,1896,23.993214906801533
STAT,1889,36,na,1925,28.983807786077108
SIM,1872,23,na,1895,25
STAT,1916,0,na,1916,47.23448297223689
SIM,1957,5,na,1962,56
STAT,1879,19,25-29,1898,0.05833667168414425
SIM,1836,57,na,1893,4
SIM,1873,2,na,1875,32
STAT,1918,7,na,1925,43.11476114748709
STAT,1937,33,20-24,1970,0.023964747583797096
SIM,1919,11,na,1930,47
SIM,1946,17,25-29,1963,1
STAT,1853,16,na,1869,17.45686964906366
STAT,1861,89,na,1950,0.8834533913876362
SIM,1800,59,na,1859,12
SIM,1892,8,na,1900,36
STAT,1878,2,na,1880,33.44832102515751
STAT,1861,47,45-49,1908,0.0019754024653899464
STAT,1818,72,na,1890,3.1560103337633163
STAT,1857,27,25-29,1884,0.3261769236724449
SIM,1870,38,na,1908,23
STAT,1919,51,na,1970,38.998603141434025
STAT,1848,41,20-24,1889,0.0010390055792092977
SIM,1893,66,na,1959,25
STAT,1931,37,35-39,1968,0.03189127894710302
STAT,1904,37,25-29,1941,0.008904690791267341
SIM,1891,37,na,1928,33
STAT,1899,14,na,1913,35.23838524225997
STAT,1892,22,25-29,1914,0.707216662090893
STAT,1939,29,35-39,1968,0.14974746307349002
STAT,1883,17,25-29,1900,0.055028549544148236
SIM,1880,21,45-49,1901,1
STAT,1846,48,30-34,1894,7.746372126661638E-4
SIM,1889,66,na,1955,22
SIM,1853,68,na,1921,14
STAT,1921,30,40-44,1951,0.04355696691801153
STAT,1852,106,na,1958,1.9782557366291892E-4
STAT,1849,23,na,1872,19.900417503792877
STAT,1857,23,50-100,1880,0.0034989224574432276
SIM,1890,52,na,1942,24
STAT,1943,22,40-44,1965,0.03551250101513058
STAT,1825,31,25-29,1856,0.1296153075637409
STAT,1855,23,na,1878,17.460432520028284
STAT,1875,15,25-29,1890,0.05852133240440297
SIM,1896,3,na,1899,33
STAT,1923,17,30-34,1940,0.14213431787507075
STAT,1868,49,20-24,1917,1.1370474663820517E-4
STAT,1849,25,25-29,1874,0.3944591463182898
STAT,1926,42,35-39,1968,0.0024682448192984634
STAT,1904,52,na,1956,30.872662370292026
STAT,1834,24,na,1858,19.918892365235735
STAT,1887,29,na,1916,25.862908170382887
STAT,1931,34,50-100,1965,0.010771814968116085
STAT,1915,18,35-39,1933,0.008683653500369058
STAT,1935,20,40-44,1955,0.04561539906726199
STAT,1819,57,na,1876,11.606826833275065
STAT,1870,28,50-100,1898,0.006332262850656761
STAT,1957,5,na,1962,51.54644202722538
STAT,1852,53,na,1905,18.13196831723396
STAT,1948,18,50-100,1966,0.004257915482659023
STAT,1795,97,na,1892,0.013150690869840768
STAT,1871,42,35-39,1913,0.018031592636476523
STAT,1899,30,20-24,1929,0.03730051611683291
STAT,1881,41,15-19,1922,1.3200111061811634E-4
STAT,1888,51,na,1939,25.282958172984692
STAT,1870,21,35-39,1891,0.058144006203932105
STAT,1873,2,na,1875,33.459616963611175
STAT,1946,19,25-29,1965,0.47693903039211366
SIM,1845,49,na,1894,22
SIM,1900,31,na,1931,34
SIM,1850,61,na,1911,18
STAT,1908,28,45-49,1936,0.0161896103452923
STAT,1885,36,50-100,1921,0.012182495755864196
STAT,1852,33,35-39,1885,0.08881182904404403
STAT,1859,22,50-100,1881,0.0033628414327969624
STAT,1917,44,na,1961,38.27796865801513
STAT,1923,43,20-24,1966,2.046599480452486E-4
STAT,1939,28,na,1967,37.383725767701016
STAT,1802,84,na,1886,0.9773651316508767
STAT,1921,41,20-24,1962,1.976458348627346E-4
SIM,1855,9,na,1864,24
STAT,1792,83,na,1875,2.744198607212069
STAT,1843,38,na,1881,10.507294738932687
STAT,1882,41,na,1923,22.249844289778768
STAT,1870,51,40-44,1921,1.0508084592504398E-4
STAT,1771,84,na,1855,1.6186000000000003
SIM,1915,30,na,1945,38
SIM,1860,38,na,1898,24
STAT,1813,47,50-100,1860,0.007612078532957873
STAT,1867,52,na,1919,20.495274852320644
STAT,1913,49,35-39,1962,0.0012405729761983432
STAT,1915,15,na,1930,40.26042721557144
SIM,1857,34,na,1891,23
STAT,1822,39,na,1861,10.088497549897042
STAT,1804,58,na,1862,11.948654898253402
STAT,1919,45,20-24,1964,1.1938461693782034E-4
SIM,1882,23,na,1905,31
STAT,1934,18,45-49,1952,0.006710537778577417
STAT,1932,18,50-100,1950,0.0049279732877575795
STAT,1941,31,20-24,1972,0.025438308610582987
STAT,1956,16,30-34,1972,0.1604231286605015
SIM,1884,52,na,1936,20
STAT,1851,21,25-29,1872,0.5813105397790886
SIM,1858,19,na,1877,25
STAT,1922,25,25-29,1947,0.7443572769444993
STAT,1860,30,15-19,1890,0.001167041566460286
SIM,1875,15,na,1890,18
STAT,1873,74,na,1947,11.283138553783855
SIM,1838,42,na,1880,8
STAT,1842,16,25-29,1858,0.05491995728159167
STAT,1900,33,25-29,1933,0.14143297282978193
STAT,1819,35,na,1854,15.665869107796333
STAT,1841,54,40-44,1895,1.0021249391600096E-4
STAT,1858,37,na,1895,17.92768306158556
STAT,1892,43,40-44,1935,0.0275869933427245
STAT,1904,17,20-24,1921,0.2540304750308793
STAT,1900,71,na,1971,22.58189340507101
STAT,1813,49,30-34,1862,0.0029120038000054337
STAT,1920,48,na,1968,40.1529556824643
STAT,1837,38,na,1875,12.477409378876853
STAT,1874,34,25-29,1908,0.10302070201443803
STAT,1918,16,45-49,1934,0.001083645014498061
SIM,1900,53,na,1953,30
STAT,1897,16,15-19,1913,0.0790017415529309
STAT,1917,32,40-44,1949,0.04060624212159671
SIM,1929,15,25-29,1944,2
SIM,1820,47,na,1867,14
STAT,1820,46,45-49,1866,0.0020217777761198413
STAT,1887,49,30-34,1936,5.835548242451662E-4
STAT,1852,75,na,1927,8.8106327662977
SIM,1817,43,na,1860,10
STAT,1902,45,na,1947,32.04921604461413
SIM,1865,85,na,1950,1
STAT,1865,40,45-49,1905,0.01367351339502442
STAT,1868,41,25-29,1909,0.006242563420277308
STAT,1893,28,35-39,1921,0.12123290686271664
SIM,1825,57,na,1882,14
STAT,1921,45,25-29,1966,5.961174930290962E-4
STAT,1923,44,na,1967,42.96410533901633
SIM,1933,21,25-29,1954,2
STAT,1889,67,na,1956,19.683642599772522
STAT,1896,29,15-19,1925,0.0059169521884573995
SIM,1806,74,na,1880,2
SIM,1802,60,na,1862,11
STAT,1840,89,na,1929,0.8231901858988705
STAT,1941,15,30-34,1956,0.12470236316945171
STAT,1866,21,20-24,1887,0.6444808868128205
STAT,1829,38,15-19,1867,5.10062919741496E-4
STAT,1882,49,40-44,1931,0.0016064283084683577
STAT,1871,100,na,1971,0.08577418947081364
STAT,1848,69,na,1917,9.490599564689841
SIM,1791,71,na,1862,3
STAT,1849,24,25-29,1873,0.5289824321766677
STAT,1871,57,na,1928,20.036028230078962
STAT,1845,48,25-29,1893,3.324694775050598E-4
STAT,1897,50,na,1947,29.004796402820727
STAT,1925,21,25-29,1946,1.1020526299906657
SIM,1842,25,na,1867,25
STAT,1882,17,20-24,1899,0.16990027803704696
STAT,1813,42,20-24,1855,0.005417961184275915
STAT,1850,48,35-39,1898,0.0012308484120802806
STAT,1826,37,35-39,1863,0.08182180850150464
STAT,1843,34,30-34,1877,0.0872079248552447
STAT,1923,31,15-19,1954,0.0014689537511081473
SIM,1855,8,na,1863,24
STAT,1847,38,35-39,1885,0.07758246765282925
STAT,1858,75,na,1933,7.8336369639643895
STAT,1852,74,na,1926,9.498105653497877
STAT,1873,19,20-24,1892,0.17927805563758706
SIM,1910,14,na,1924,33
STAT,1894,14,na,1908,32.99007913767868
STAT,1871,35,20-24,1906,0.007758355009114947
SIM,1877,70,na,1947,15
STAT,1852,32,30-34,1884,0.15471555436949308
STAT,1840,26,30-34,1866,0.2478124662700125
STAT,1898,28,na,1926,32.08089549302497
STAT,1835,35,35-39,1870,0.04053344458920567
STAT,1893,20,25-29,1913,0.7261036077665945
STAT,1845,42,40-44,1887,0.013388969893110565
STAT,1855,21,45-49,1876,0.005777146864108619
STAT,1781,106,na,1887,1.9456787522424538E-4
SIM,1856,33,na,1889,13
SIM,1874,58,na,1932,25
STAT,1880,33,20-24,1913,0.028304148180048505
SIM,1870,44,na,1914,21
SIM,1866,22,25-29,1888,1
STAT,1864,35,30-34,1899,0.04825618601483682
STAT,1887,56,na,1943,22.262763137943853
STAT,1879,21,na,1900,24.552392269540853
STAT,1867,38,35-39,1905,0.06734935114992917
STAT,1898,17,30-34,1915,0.021501312593273297
STAT,1817,53,45-49,1870,3.9551237568462516E-4
STAT,1886,43,40-44,1929,0.023162442765026086
STAT,1861,32,25-29,1893,0.08613574656673523
STAT,1932,17,na,1949,48.54143969473229
STAT,1894,31,25-29,1925,0.13180483188962627
STAT,1847,29,20-24,1876,0.1484726364434241
STAT,1883,42,na,1925,22.416388633666205
STAT,1891,61,na,1952,22.93495651504458
STAT,1871,17,45-49,1888,6.55471720411337E-4
STAT,1912,47,25-29,1959,5.058024165004493E-4
SIM,1837,42,na,1879,29
STAT,1880,28,25-29,1908,0.44325612713876233
STAT,1884,44,45-49,1928,0.014465433469228758
STAT,1803,73,na,1876,5.637778517560752
STAT,1861,25,35-39,1886,0.0829191636571379
STAT,1879,40,45-49,1919,0.01564667898288141
STAT,1851,45,45-49,1896,0.0020122481746678695
STAT,1858,22,25-29,1880,0.49979810235465477
SIM,1889,25,30-34,1914,1
STAT,1876,40,20-24,1916,0.0016292533385428136
STAT,1933,16,35-39,1949,0.05608001945345107
STAT,1922,20,45-49,1942,0.012885077112654861
STAT,1824,63,na,1887,12.754213770978106
STAT,1807,87,na,1894,0.7435417156901016
STAT,1798,93,na,1891,0.14851897520397037
STAT,1829,47,30-34,1876,8.263262122527227E-4
SIM,1846,19,na,1865,17
STAT,1866,98,na,1964,0.10371250481813984
STAT,1827,40,25-29,1867,0.0051663285294975166
STAT,1859,43,25-29,1902,0.0050671025933415265
STAT,1817,44,30-34,1861,0.0342006430366243
SIM,1924,34,na,1958,50
STAT,1853,26,40-44,1879,0.02196745110927497
STAT,1862,39,15-19,1901,4.7960560473758973E-4
STAT,1866,94,na,1960,0.3496778515825569
STAT,1780,83,na,1863,2.4012389240616376
STAT,1830,34,20-24,1864,0.016654427201521955
STAT,1886,25,40-44,1911,0.0312827776878277
STAT,1840,19,40-44,1859,0.0018338248873289579
STAT,1896,38,30-34,1934,0.069658693301232
STAT,1836,29,45-49,1865,0.013666919742790858
STAT,1859,49,50-100,1908,0.0019113125360067026
STAT,1858,40,25-29,1898,0.004935765964632498
SIM,1920,29,25-29,1949,2
STAT,1911,59,na,1970,32.49425101515601
STAT,1884,35,30-34,1919,0.05271254998892761
STAT,1917,20,35-39,1937,0.09975578754478702
STAT,1855,28,15-19,1883,0.0033057045531036592
STAT,1912,29,25-29,1941,0.6389578799981196
STAT,1886,49,25-29,1935,5.849907691856998E-4
STAT,1896,22,45-49,1918,0.009159569873460966
STAT,1830,31,40-44,1861,0.02953696603364877
STAT,1928,41,45-49,1969,0.0021143465045017416
STAT,1833,71,na,1904,9.88210602427004
SIM,1911,29,30-34,1940,1
STAT,1831,40,15-19,1871,1.4035274597125108E-4
STAT,1818,42,25-29,1860,0.006904547949144438
STAT,1912,15,50-100,1927,7.551627298686993E-4
STAT,1807,101,na,1908,0.002408222029716638
STAT,1876,36,35-39,1912,0.07218157612419467
STAT,1843,43,45-49,1886,0.006453442874295353
STAT,1869,49,25-29,1918,5.464573259471345E-4
STAT,1892,19,na,1911,31.03420378352891
STAT,1838,55,na,1893,16.048489378117782
SIM,1936,23,na,1959,30
STAT,1907,23,30-34,1930,0.2597443509656971
STAT,1878,83,na,1961,5.931680266668309
STAT,1873,36,na,1909,24.06833337889985
STAT,1778,89,na,1867,0.40774661642150095
STAT,1911,27,na,1938,36.29755256102209
STAT,1947,18,30-34,1965,0.13632062952895596
STAT,1881,31,15-19,1912,0.0013606085508654083
STAT,1879,46,30-34,1925,0.00100473423146373
STAT,1899,20,20-24,1919,0.9489949627873978
SIM,1817,58,na,1875,6
SIM,1876,69,na,1945,23
STAT,1835,42,25-29,1877,0.00348552343336953
STAT,1839,32,15-19,1871,9.671228357655678E-4
STAT,1814,40,15-19,1854,4.7428584936990196E-4
STAT,1829,31,45-49,1860,0.01693696313748511
SIM,1905,31,na,1936,39
STAT,1853,30,25-29,1883,0.06768178010057728
STAT,1933,20,20-24,1953,1.4776979906311254
STAT,1857,16,30-34,1873,0.014107109082069514
STAT,1903,36,na,1939,33.92250363189626
STAT,1903,29,30-34,1932,0.35546059166770994
SIM,1959,7,na,1966,51
STAT,1862,33,50-100,1895,0.007871683282666311
STAT,1828,27,45-49,1855,0.01740313906168989
STAT,1848,26,30-34,1874,0.19581964325948614
STAT,1895,44,20-24,1939,1.4124291661842033E-4
STAT,1905,15,na,1920,36.619946894568855
SIM,1932,23,30-34,1955,1
STAT,1849,17,35-39,1866,0.00523712741629683
STAT,1854,17,45-49,1871,4.7762699446140985E-4
STAT,1885,21,na,1906,23.425716622161836
STAT,1781,102,na,1883,0.0012615820982424643
STAT,1913,46,30-34,1959,8.649700968781762E-4
STAT,1819,72,na,1891,6.48281285074751
SIM,1865,53,na,1918,15
STAT,1933,29,50-100,1962,0.013149344727598213
STAT,1841,90,na,1931,0.7717031759011189
STAT,1860,21,25-29,1881,0.4832213685152181
SIM,1898,25,25-29,1923,1
STAT,1782,94,na,1876,0.03172202955184598
STAT,1847,91,na,1938,0.6190200224506431
STAT,1924,23,30-34,1947,0.33589585280055684
STAT,1834,45,45-49,1879,0.001994091091615394
STAT,1879,22,45-49,1901,0.007217348006936194
SIM,1941,20,20-24,1961,1
STAT,1840,17,15-19,1857,0.06020822998978891
SIM,1793,78,na,1871,8
SIM,1859,85,na,1944,1
STAT,1891,49,35-39,1940,9.490319463876042E-4
STAT,1890,17,30-34,1907,0.019360778315239
STAT,1869,44,50-100,1913,0.010098227539269223
STAT,1963,1,na,1964,49.71654511986895
SIM,1866,39,na,1905,28
STAT,1865,8,na,1873,25.151706947712935
SIM,1912,49,na,1961,35
SIM,1859,53,na,1912,18
STAT,1891,30,45-49,1921,0.0215750829749914
STAT,1913,39,40-44,1952,0.014502172144360167
STAT,1879,37,na,1916,24.384599286634412
STAT,1862,37,na,1899,20.326537722253065
STAT,1903,36,20-24,1939,0.002376878560855414
STAT,1882,6,na,1888,25.309391920431622
STAT,1895,18,45-49,1913,8.458309393124284E-4
STAT,1839,92,na,1931,0.2298448609402944
STAT,1895,39,25-29,1934,0.037003121671827226
SIM,1831,57,na,1888,6
STAT,1907,47,45-49,1954,0.0019381900546325873
STAT,1875,46,45-49,1921,0.0024328312183649146
STAT,1939,19,35-39,1958,0.04168620471834719
STAT,1819,88,na,1907,0.7047172490595655
STAT,1851,27,50-100,1878,0.006323212733970074
STAT,1885,26,35-39,1911,0.09561158887172819
STAT,1845,27,45-49,1872,0.007899809275054763
STAT,1924,18,35-39,1942,0.049514046038308404
STAT,1838,21,45-49,1859,0.007072605085214498
STAT,1860,34,30-34,1894,0.14072748043081282
STAT,1809,45,35-39,1854,0.0049213234669347045
STAT,1872,41,15-19,1913,1.419374019990905E-4
STAT,1892,46,45-49,1938,0.0016492891777178875
STAT,1907,30,20-24,1937,0.022885807043673666
SIM,1913,50,na,1963,40
STAT,1871,41,na,1912,23.1473330863324
STAT,1823,102,na,1925,0.0016860144565453317
STAT,1899,46,30-34,1945,7.496046491738459E-4
SIM,1857,24,25-29,1881,1
STAT,1867,36,na,1903,22.654286405559894
STAT,1924,30,20-24,1954,0.028399804687802153
STAT,1849,42,25-29,1891,0.0049730995210254475
STAT,1881,27,30-34,1908,0.23961671423220762
STAT,1862,50,45-49,1912,1.2700726666052528E-4
STAT,1934,12,na,1946,53.36663641232376
STAT,1937,31,45-49,1968,0.015478928181194633
STAT,1811,92,na,1903,0.23603190659037807
STAT,1838,45,30-34,1883,7.930057234677801E-4
STAT,1791,67,na,1858,6.891544342695949
STAT,1885,33,25-29,1918,0.10072039318916355
STAT,1899,15,25-29,1914,0.0779341702216916
STAT,1874,16,30-34,1890,0.01620938155654077
SIM,1950,21,25-29,1971,2
STAT,1821,44,20-24,1865,0.002316784799532161
STAT,1841,16,20-24,1857,0.2251335166879982
SIM,1857,21,20-24,1878,2
STAT,1879,29,15-19,1908,0.004662304417616028
STAT,1866,24,25-29,1890,0.5239210246282225
STAT,1901,44,45-49,1945,0.0014346272267133195
STAT,1888,14,na,1902,30.08144942506167
SIM,1929,20,20-24,1949,2
STAT,1846,38,15-19,1884,4.7033498273358406E-4
SIM,1836,25,na,1861,13
SIM,1860,54,na,1914,17
STAT,1869,31,na,1900,23.21644666666631
STAT,1893,41,35-39,1934,0.022935450998547137
STAT,1926,26,50-100,1952,0.011904436223563953
SIM,1864,68,na,1932,13
SIM,1842,31,25-29,1873,1
STAT,1856,19,20-24,1875,0.15007807404405019
STAT,1870,22,25-29,1892,0.5686713699503263
STAT,1835,32,30-34,1867,0.10112283088900063
STAT,1922,27,na,1949,42.07951098815983
STAT,1942,21,25-29,1963,0.961749142339931
STAT,1918,47,20-24,1965,1.1653683021532083E-4
STAT,1845,19,45-49,1864,4.76946420736297E-4
STAT,1836,34,40-44,1870,0.05181542859892572
STAT,1822,32,20-24,1854,0.02517149347814034
STAT,1941,18,35-39,1959,0.04289384048496913
STAT,1924,3,na,1927,47.98685254641516
STAT,1890,43,30-34,1933,0.013864172901840999
STAT,1867,44,45-49,1911,0.014128932701072575
STAT,1871,32,40-44,1903,0.04323707896245786
STAT,1867,30,25-29,1897,0.09880556408750041
STAT,1896,40,45-49,1936,0.0013789297722054787
STAT,1903,39,25-29,1942,0.008746428638858892
SIM,1852,19,na,1871,29
STAT,1880,5,na,1885,28.33627255350102
STAT,1863,22,na,1885,21.3573971653806
STAT,1844,32,25-29,1876,0.09567198809082599
STAT,1924,32,50-100,1956,0.009583276203482144
STAT,1933,37,45-49,1970,0.009247658765221
STAT,1862,16,40-44,1878,0.0018180188073970219
STAT,1876,43,25-29,1919,0.006474926861523753
SIM,1890,20,na,1910,30
SIM,1957,6,na,1963,56
STAT,1865,22,15-19,1887,0.030201976156773547
STAT,1809,52,25-29,1861,1.1583400023621495E-4
STAT,1875,22,25-29,1897,0.5884517806633177
SIM,1841,31,na,1872,18
SIM,1874,24,25-29,1898,1
SIM,1816,64,na,1880,9
STAT,1887,44,15-19,1931,1.48700714574196E-4
STAT,1853,31,50-100,1884,0.005991887652757129
STAT,1903,20,na,1923,33.82530470668748
STAT,1861,22,30-34,1883,0.15388856799602119
STAT,1880,25,20-24,1905,0.12419937041819758
STAT,1854,43,20-24,1897,9.637085975019735E-4
SIM,1848,10,na,1858,33
STAT,1897,28,20-24,1925,0.15524006525349657
STAT,1864,29,20-24,1893,0.10447002931232302
SIM,1812,50,na,1862,18
STAT,1874,49,35-39,1923,0.0013906334440244035
STAT,1803,57,na,1860,11.54347559336938
STAT,1887,28,na,1915,25.95739308119845
STAT,1877,35,40-44,1912,0.045616405660606915
STAT,1891,65,na,1956,21.001433635229585
STAT,1890,25,30-34,1915,0.30796049172167256
SIM,1781,81,na,1862,3
STAT,1840,29,35-39,1869,0.09292344384763881
STAT,1928,28,na,1956,45.904511008169706
SIM,1934,28,na,1962,51
STAT,1873,28,35-39,1901,0.09775463181548025
STAT,1823,34,30-34,1857,0.13897855526033984
STAT,1858,18,40-44,1876,0.0016162209852642877
STAT,1872,21,45-49,1893,0.007156327103599028
SIM,1811,65,na,1876,6
STAT,1916,16,35-39,1932,0.00884832093310913
STAT,1895,47,25-29,1942,4.198521193883442E-4
SIM,1930,34,na,1964,48
STAT,1908,25,40-44,1933,0.04450534892223362
SIM,1800,65,na,1865,9
STAT,1944,19,15-19,1963,0.48452746879223013
STAT,1825,40,50-100,1865,0.010655077129101164
STAT,1832,54,na,1886,9.675588981544417
SIM,1804,79,na,1883,5
SIM,1895,36,na,1931,25
STAT,1836,26,40-44,1862,0.03767871815167309
STAT,1809,58,na,1867,14.409310150145002
STAT,1916,31,25-29,1947,0.09499442923614104
STAT,1866,17,35-39,1883,0.005187017548468013
STAT,1939,27,na,1966,37.40167857341631
STAT,1836,52,40-44,1888,1.02801198784001E-4
STAT,1911,55,na,1966,33.47117369661123
SIM,1839,37,na,1876,21
STAT,1814,73,na,1887,5.610391253250464
STAT,1852,35,35-39,1887,0.062139092419817764
STAT,1950,20,20-24,1970,1.311859869875788
STAT,1834,31,25-29,1865,0.09368493999625639
STAT,1890,76,na,1966,14.953199728374235
STAT,1908,21,25-29,1929,0.847322176032514
STAT,1834,89,na,1923,0.7424084743890749
STAT,1898,44,na,1942,30.864014768991424
STAT,1843,36,50-100,1879,0.006143346546253498
STAT,1844,25,35-39,1869,0.0936015953359232
STAT,1901,26,45-49,1927,0.015589443191782331
STAT,1881,71,na,1952,12.701207637684604
STAT,1856,40,na,1896,16.912338454536577
STAT,1838,39,20-24,1877,0.0070709259704785496
STAT,1870,15,35-39,1885,0.005568137959506638
STAT,1781,77,na,1858,4.791180703993379
STAT,1906,18,50-100,1924,7.098969524265525E-4
STAT,1934,28,na,1962,50.157304305030635
STAT,1900,3,na,1903,36.65890173161668
STAT,1931,34,30-34,1965,0.20526467451207087
SIM,1818,75,na,1893,8
SIM,1906,25,30-34,1931,1
STAT,1873,25,30-34,1898,0.25775945767363234
STAT,1899,19,40-44,1918,0.002490393988581521
STAT,1853,29,45-49,1882,0.0072509612084710635
STAT,1874,19,35-39,1893,0.005536754540037429
STAT,1889,18,20-24,1907,0.21648734331123112
STAT,1858,101,na,1959,0.00849631639992114
STAT,1869,46,20-24,1915,1.1660309307517316E-4
SIM,1898,22,20-24,1920,2
STAT,1856,27,20-24,1883,0.08806551897884729
STAT,1849,32,25-29,1881,0.08368913830275433
STAT,1855,37,30-34,1892,0.037523948545590165
STAT,1924,26,35-39,1950,0.17426721150948035
STAT,1858,45,30-34,1903,7.43937987059441E-4
STAT,1871,29,15-19,1900,0.004491086239420525
STAT,1876,33,30-34,1909,0.17658055003431009
STAT,1882,29,na,1911,22.70763301734442
SIM,1903,29,25-29,1932,1
STAT,1831,25,25-29,1856,0.4825301121090484
STAT,1872,33,15-19,1905,0.0014509240398215691
STAT,1895,15,40-44,1910,0.0023855810218663294
STAT,1906,17,30-34,1923,0.023155987568555077
STAT,1880,9,na,1889,27.454721918180457
STAT,1864,18,15-19,1882,0.05473921705782768
STAT,1793,62,na,1855,4.817
STAT,1852,27,35-39,1879,0.09618453801750348
SIM,1847,56,na,1903,14
STAT,1792,84,na,1876,2.220879932816728
STAT,1858,7,na,1865,22.001018897927864
STAT,1803,104,na,1907,2.4997423656757404E-4
STAT,1875,71,na,1946,13.720978358552683
STAT,1918,29,15-19,1947,0.0073916949256065505
SIM,1775,81,na,1856,1
STAT,1875,43,40-44,1918,0.022954232027959414
SIM,1873,22,15-19,1895,2
STAT,1869,47,na,1916,21.698007680191406
STAT,1916,23,25-29,1939,0.956667243709449
SIM,1853,7,na,1860,29
STAT,1938,15,25-29,1953,0.42663156998683943
STAT,1888,20,45-49,1908,0.008197507075012243
STAT,1832,27,35-39,1859,0.05772500716749007
STAT,1923,12,na,1935,46.204278777961
SIM,1936,3,na,1939,38
STAT,1846,74,na,1920,8.99403857406069
STAT,1905,44,30-34,1949,0.0011366636059585314
SIM,1875,16,na,1891,20
STAT,1910,33,na,1943,36.09137385139423
STAT,1780,99,na,1879,0.0065934754080671076
STAT,1799,94,na,1893,0.07383603074472664
STAT,1898,25,30-34,1923,0.3420087091061811
STAT,1851,37,na,1888,20.102885110992965
STAT,1877,27,40-44,1904,0.030922039587796907
STAT,1813,45,25-29,1858,0.001839348681359776
STAT,1848,29,35-39,1877,0.07342744252769431
STAT,1880,36,25-29,1916,0.030422008441937175
STAT,1834,42,40-44,1876,0.019162460745594793
STAT,1875,32,25-29,1907,0.10528804888316533
STAT,1857,24,30-34,1881,0.1380793735879657
STAT,1823,77,na,1900,4.971016318827657
SIM,1946,13,na,1959,53
STAT,1929,19,25-29,1948,0.5474511193711888
STAT,1836,91,na,1927,0.559257324991014
SIM,1843,32,30-34,1875,1
STAT,1866,47,35-39,1913,0.0012833630473945898
STAT,1921,6,na,1927,45.33034194489011
STAT,1939,16,30-34,1955,0.12120360872316442
STAT,1899,13,na,1912,35.29803892804837
STAT,1848,17,20-24,1865,0.14212611218758844
STAT,1859,36,35-39,1895,0.056487348721080806
STAT,1880,22,na,1902,24.869741809007582
STAT,1932,25,30-34,1957,0.5115777559629284
SIM,1866,70,na,1936,20
STAT,1882,41,50-100,1923,0.010170251650753142
SIM,1884,20,na,1904,26
STAT,1909,45,na,1954,33.89152227860213
STAT,1841,48,40-44,1889,0.0016618990061929685
STAT,1905,31,na,1936,34.875127242776536
STAT,1834,93,na,1927,0.20653453179185943
STAT,1849,21,20-24,1870,0.6507069786701918
SIM,1881,16,na,1897,26
STAT,1917,12,na,1929,42.11244128405292
STAT,1815,42,na,1857,11.442282469976018
STAT,1862,24,40-44,1886,0.018140916275362105
STAT,1818,46,40-44,1864,0.0017091779456767683
STAT,1857,31,20-24,1888,0.020572759879065667
STAT,1924,15,30-34,1939,0.1448743269881407
SIM,1876,53,na,1929,27
STAT,1895,36,20-24,1931,0.01005575306425471
STAT,1896,19,50-100,1915,6.400748646520611E-4
STAT,1831,32,15-19,1863,0.001502222735204333
STAT,1830,28,15-19,1858,0.0037161738355885538
STAT,1918,22,45-49,1940,0.012025451474022836
STAT,1901,8,na,1909,36.37464440747626
STAT,1888,39,35-39,1927,0.08182214517350853
STAT,1921,27,25-29,1948,0.727847588310429
STAT,1937,21,15-19,1958,0.05152724585456396
STAT,1852,43,na,1895,19.637812753312826
SIM,1940,28,na,1968,31
STAT,1867,83,na,1950,3.7990089819693207
STAT,1908,22,50-100,1930,0.006017750566508055
STAT,1900,17,35-39,1917,0.00760885085618502
STAT,1924,33,25-29,1957,0.10706392867705926
STAT,1863,44,50-100,1907,0.009227541052972698
STAT,1814,44,30-34,1858,0.03414824464777109
STAT,1843,35,45-49,1878,0.010079072512293619
SIM,1921,21,na,1942,42
STAT,1825,46,35-39,1871,0.0013095394609389439
STAT,1916,37,45-49,1953,0.006921513375341142
SIM,1887,32,na,1919,22
STAT,1860,32,40-44,1892,0.035256321598344055
STAT,1907,50,na,1957,32.298959119580196
SIM,1891,39,35-39,1930,1
STAT,1874,50,50-100,1924,1.5541787580672958E-4
STAT,1863,33,20-24,1896,0.023831821092707216
STAT,1903,18,15-19,1921,0.08415241882567427
STAT,1951,15,40-44,1966,0.016563872043365218
STAT,1907,29,50-100,1936,0.009212037475547072
STAT,1851,31,25-29,1882,0.09094046919935966
STAT,1860,37,35-39,1897,0.05750092125971753
STAT,1872,28,15-19,1900,0.004625808837755913
STAT,1879,42,15-19,1921,1.4275714324304007E-4
STAT,1919,38,25-29,1957,0.01047542695955817
STAT,1834,37,50-100,1871,0.01079213281514741
STAT,1946,21,45-49,1967,0.01243679203145627
STAT,1858,38,50-100,1896,0.009296104793712245
STAT,1852,37,50-100,1889,0.010564629329744918
STAT,1883,39,35-39,1922,0.06799255713068852
STAT,1892,37,35-39,1929,0.08737941250798867
SIM,1952,13,na,1965,35
SIM,1835,71,na,1906,9
STAT,1853,34,40-44,1887,0.027490588130614647
STAT,1825,41,na,1866,14.932751079329972
STAT,1922,32,50-100,1954,0.009273337302665156
STAT,1915,21,15-19,1936,0.054714661823122235
STAT,1916,27,na,1943,38.40281527436877
STAT,1951,20,35-39,1971,0.11189158841025519
SIM,1838,52,na,1890,4
SIM,1875,47,na,1922,15
SIM,1835,19,na,1854,22
SIM,1820,42,na,1862,13
STAT,1881,35,30-34,1916,0.05119487745808918
SIM,1929,23,25-29,1952,1
STAT,1918,35,50-100,1953,0.004426961285263759
SIM,1900,52,na,1952,31
STAT,1809,50,35-39,1859,2.930194300591999E-4
STAT,1912,13,na,1925,39.561387740330765
SIM,1837,73,na,1910,19
STAT,1857,27,35-39,1884,0.0744007584534261
STAT,1937,17,30-34,1954,0.11782861217369342
STAT,1825,41,25-29,1866,0.006360409709828173
STAT,1898,49,50-100,1947,0.00182986932298844
STAT,1913,1,na,1914,42.20191796403231
STAT,1851,96,na,1947,0.07249121714821562
STAT,1892,71,na,1963,18.71741247468144
STAT,1922,48,25-29,1970,6.032464000110864E-4
STAT,1911,26,50-100,1937,0.009677333574021325
STAT,1876,41,35-39,1917,0.018474670186666427
STAT,1840,58,na,1898,15.496280470142747
STAT,1837,43,20-24,1880,9.007335890886865E-4
SIM,1893,72,na,1965,21
STAT,1813,56,na,1869,17.406469082468917
STAT,1849,55,na,1904,16.032871090213764
STAT,1840,25,na,1865,21.442477469753808
SIM,1878,17,na,1895,28
STAT,1861,95,na,1956,0.12893630678529985
SIM,1945,17,30-34,1962,1
STAT,1851,36,35-39,1887,0.06098116873964828
STAT,1844,22,30-34,1866,0.17371394948407612
SIM,1805,64,na,1869,9
STAT,1881,47,50-100,1928,0.00232609550619957
SIM,1826,67,na,1893,11
STAT,1923,43,50-100,1966,0.0013614335414788917
STAT,1840,34,30-34,1874,0.16321211801818353
STAT,1899,47,45-49,1946,0.0018138784601727763
STAT,1942,27,45-49,1969,0.018000171654395283
STAT,1869,20,30-34,1889,0.17436358227142532
SIM,1862,73,na,1935,16
SIM,1956,12,na,1968,47
STAT,1859,47,40-44,1906,0.001354382734365458
STAT,1909,20,25-29,1929,0.8587683148366237
STAT,1848,22,15-19,1870,0.02597727939410797
STAT,1920,32,na,1952,41.07394390971381
SIM,1889,67,na,1956,22
SIM,1900,22,25-29,1922,1
STAT,1922,47,35-39,1969,0.0014703113693182517
STAT,1862,42,40-44,1904,0.019382064485709876
STAT,1852,105,na,1957,3.809392726173556E-4
STAT,1890,21,15-19,1911,0.04019432536129613
STAT,1836,30,25-29,1866,0.12756949496995887
SIM,1909,4,na,1913,41
SIM,1872,94,na,1966,3
STAT,1880,86,na,1966,4.7839861090656095
SIM,1851,30,na,1881,20
STAT,1888,28,30-34,1916,0.29323933628701604
STAT,1928,33,50-100,1961,0.010281241370542826
SIM,1893,65,na,1958,27
STAT,1897,29,50-100,1926,0.008434115459891211
SIM,1843,11,na,1854,23
STAT,1841,19,25-29,1860,0.07069734806485684
SIM,1847,25,na,1872,21
STAT,1858,43,40-44,1901,0.016992104648782348
STAT,1827,44,40-44,1871,0.01711393937897692
STAT,1838,70,na,1908,10.889913306191488
STAT,1837,105,na,1942,1.4177256711796419E-4
STAT,1845,16,40-44,1861,0.0013593284402345191
STAT,1908,49,50-100,1957,0.0020229551686838415
STAT,1904,42,20-24,1946,1.5782896982441315E-4
STAT,1925,30,35-39,1955,0.10796061458592228
STAT,1826,43,45-49,1869,0.015565645641582198
STAT,1912,19,30-34,1931,0.024323203690811653
STAT,1910,34,45-49,1944,0.014950837237227236
STAT,1947,19,na,1966,41.151518485646974
SIM,1820,41,na,1861,14
STAT,1857,49,35-39,1906,0.0010261687418751681
SIM,1885,46,na,1931,22
STAT,1839,36,30-34,1875,0.03551409488833747
STAT,1894,35,40-44,1929,0.056634525797452685
STAT,1889,41,45-49,1930,0.01840675118672892
STAT,1918,38,na,1956,39.25586497849369
STAT,1821,47,25-29,1868,8.139630611713453E-4
STAT,1904,49,40-44,1953,0.001354865879548065
STAT,1842,16,35-39,1858,0.005317897792846698
STAT,1893,34,45-49,1927,0.021799211356780993
STAT,1837,69,na,1906,7.095928773863377
STAT,1921,34,20-24,1955,0.02670181927136273
STAT,1908,39,na,1947,34.688744394841635
STAT,1834,25,na,1859,20.337163275608223
STAT,1835,40,35-39,1875,0.010086466735959322
STAT,1896,46,30-34,1942,7.192698542575647E-4
SIM,1871,54,na,1925,21
STAT,1855,55,na,1910,14.558147120593917
SIM,1831,26,na,1857,10
STAT,1932,28,35-39,1960,0.19575633154669878
SIM,1855,39,na,1894,18
STAT,1877,53,40-44,1930,1.069279672165921E-4
STAT,1842,38,35-39,1880,0.06160811895463091
STAT,1882,45,25-29,1927,5.575092756714286E-4
STAT,1863,20,50-100,1883,0.00373597727430397
STAT,1912,26,20-24,1938,0.1790902651214823
STAT,1892,25,50-100,1917,0.007956423918097073
STAT,1915,28,35-39,1943,0.15127821066786953
STAT,1898,26,50-100,1924,0.00865906987421934
STAT,1883,20,45-49,1903,0.006811963520939959
STAT,1921,49,40-44,1970,0.0017531571130550278
SIM,1850,55,na,1905,19
STAT,1856,25,30-34,1881,0.19177924868241095
STAT,1916,20,20-24,1936,1.1621020496043017
STAT,1797,99,na,1896,0.0040568481553353835
SIM,1862,18,na,1880,25
STAT,1868,45,40-44,1913,0.001673297342460969
STAT,1896,64,na,1960,24.04157831870729
STAT,1892,50,na,1942,26.98339664565677
STAT,1925,25,40-44,1950,0.05507894799668234
STAT,1869,25,40-44,1894,0.029222175705925474
STAT,1848,17,na,1865,18.402104636792657
STAT,1888,45,na,1933,26.55371094681815
STAT,1904,24,20-24,1928,0.9812591552603677
STAT,1879,40,50-100,1919,0.011044714544501533
SIM,1867,24,na,1891,16
STAT,1890,47,25-29,1937,3.928315274848908E-4
STAT,1910,16,45-49,1926,9.861943758929367E-4
STAT,1865,26,30-34,1891,0.22854873244942694
SIM,1883,35,na,1918,14
STAT,1833,40,na,1873,19.347702609414753
STAT,1887,34,20-24,1921,0.029251493103800645
STAT,1888,19,15-19,1907,0.06897912816346173
SIM,1810,79,na,1889,10
SIM,1935,34,na,1969,55
STAT,1858,48,35-39,1906,0.0010519367464525307
STAT,1852,40,35-39,1892,0.015654195912443238
SIM,1931,20,na,1951,56
STAT,1904,24,50-100,1928,0.0058066113927331174
SIM,1903,29,na,1932,36
STAT,1812,53,45-49,1865,1.5425004194471006E-4
STAT,1889,23,15-19,1912,0.040266188822933494
STAT,1898,35,25-29,1933,0.03920926676226966
STAT,1832,82,na,1914,2.108993747865899
SIM,1862,40,na,1902,23
STAT,1831,27,15-19,1858,0.004960855190202459
STAT,1858,46,45-49,1904,0.0018009281515028864
STAT,1859,40,20-24,1899,0.0012750095859766723
STAT,1880,40,35-39,1920,0.019233805652608797
SIM,1889,28,35-39,1917,1
STAT,1950,16,35-39,1966,0.04932227953569839
STAT,1865,72,na,1937,11.422724566848487
SIM,1852,74,na,1926,19
STAT,1898,28,35-39,1926,0.12970595041635388
STAT,1849,37,50-100,1886,0.009741283800226541
STAT,1929,22,20-24,1951,1.3994253898616447
STAT,1903,51,na,1954,30.759610639936593
STAT,1817,45,45-49,1862,0.007027372370925461
STAT,1861,30,35-39,1891,0.08584868201106506
STAT,1886,71,na,1957,14.448461742688647
STAT,1874,30,45-49,1904,0.017833128493392
STAT,1841,44,25-29,1885,0.006366218338973119
SIM,1871,5,na,1876,30
STAT,1916,31,na,1947,38.87139964038738
STAT,1821,41,40-44,1862,0.036288012991830834
SIM,1937,22,20-24,1959,1
STAT,1857,34,25-29,1891,0.0760204816211779
STAT,1930,39,40-44,1969,0.019393497508603273
SIM,1915,14,na,1929,40
STAT,1844,55,na,1899,16.150808411057525
STAT,1940,31,15-19,1971,0.0013212950450861613
STAT,1929,15,30-34,1944,0.15552997918057715
STAT,1816,48,35-39,1864,0.0017380275247304473
SIM,1895,20,na,1915,30
STAT,1822,46,30-34,1868,5.386719945369648E-4
SIM,1870,20,25-29,1890,2
STAT,1928,12,na,1940,49.68165110753801
STAT,1852,33,45-49,1885,0.01529288327641701
STAT,1930,32,20-24,1962,0.03133105768708711
STAT,1820,97,na,1917,0.030456575610954717
STAT,1869,16,na,1885,24.95751474200881
STAT,1884,36,45-49,1920,0.019625229706186256
STAT,1878,44,20-24,1922,0.0016174819115580793
STAT,1872,51,na,1923,22.135978175243476
SIM,1841,19,na,1860,21
STAT,1853,91,na,1944,0.36419114244072137
STAT,1856,36,na,1892,17.14963102335504
STAT,1859,33,30-34,1892,0.13818716136076353
STAT,1846,10,na,1856,24.608048422499998
STAT,1875,16,na,1891,26.025532940484407
SIM,1921,14,na,1935,42
STAT,1853,37,45-49,1890,0.012528689452322115
STAT,1822,39,40-44,1861,0.025660445466290472
STAT,1837,17,45-49,1854,6.318488823499034E-4
STAT,1862,20,25-29,1882,0.5129339841975977
STAT,1897,26,30-34,1923,0.33555198441350276
STAT,1852,24,30-34,1876,0.17850759827711205
STAT,1849,54,na,1903,16.236360397662768
STAT,1833,48,35-39,1881,0.0010907999982683017
STAT,1887,39,15-19,1926,6.067625059879584E-4
STAT,1808,46,35-39,1854,0.0010252757222780629
STAT,1860,35,45-49,1895,0.016360417993799163
STAT,1863,36,25-29,1899,0.025615039105120786
STAT,1839,39,35-39,1878,0.04568545965208078
STAT,1835,46,40-44,1881,8.276928315211022E-4
STAT,1919,35,20-24,1954,0.0028230829430537104
STAT,1889,27,30-34,1916,0.30830998144227817
STAT,1904,45,25-29,1949,4.702047960415742E-4
STAT,1907,33,25-29,1940,0.08566582037241152
STAT,1807,56,na,1863,12.816554007862834
SIM,1894,6,na,1900,32
STAT,1843,70,na,1913,5.951750686157339
STAT,1895,20,na,1915,30.887566998616986
STAT,1831,44,na,1875,20.271496083967367
STAT,1801,78,na,1879,3.0898702041178363
STAT,1908,35,na,1943,35.37421332639428
STAT,1792,77,na,1869,6.879843119366662
STAT,1878,21,35-39,1899,0.06042841003624807
STAT,1879,38,30-34,1917,0.054888061143580844
STAT,1920,18,15-19,1938,0.5035181544428238
SIM,1888,26,30-34,1914,1
SIM,1811,64,na,1875,6
STAT,1847,84,na,1931,3.5536313219831044
STAT,1871,38,25-29,1909,0.028563226318941065
STAT,1888,82,na,1970,9.674756160472393
STAT,1778,85,na,1863,0.9505001818220309
SIM,1859,84,na,1943,2
SIM,1856,40,na,1896,11
STAT,1906,43,30-34,1949,0.001151481604083915
STAT,1934,20,35-39,1954,0.12641468130567884
STAT,1826,34,30-34,1860,0.21771864452966744
SIM,1897,27,30-34,1924,1
STAT,1902,32,45-49,1934,0.024591147737447597
STAT,1893,25,30-34,1918,0.3196669840066167
STAT,1853,34,50-100,1887,0.005808110612743872
STAT,1819,41,na,1860,14.879451856044042
STAT,1875,37,35-39,1912,0.07270554221901533
STAT,1809,49,50-100,1858,0.008122238295229737
STAT,1897,29,35-39,1926,0.12721767211587198
STAT,1887,29,25-29,1916,0.4584232599065148
SIM,1896,46,na,1942,26
STAT,1838,104,na,1942,5.176901274506061E-4
STAT,1905,20,45-49,1925,0.010124081066635995
STAT,1913,20,15-19,1933,0.051455807563901675
STAT,1843,32,40-44,1875,0.022115612074646095
SIM,1935,13,na,1948,60
STAT,1851,40,50-100,1891,0.009008888255032045
SIM,1939,27,na,1966,28
SIM,1959,3,na,1962,51
STAT,1883,36,30-34,1919,0.052003639373532494
STAT,1835,33,45-49,1868,0.00998857297058044
STAT,1922,44,30-34,1966,0.0014518172448838985
SIM,1937,4,na,1941,41
STAT,1882,15,30-34,1897,0.01534571739621556
STAT,1912,44,20-24,1956,1.6768827502782165E-4
STAT,1921,17,na,1938,41.628556288865774
STAT,1830,37,25-29,1867,0.01684313003834646
STAT,1869,16,50-100,1885,4.841275606573498E-4
SIM,1826,63,na,1889,13
STAT,1835,26,50-100,1861,0.0038884386196266166
STAT,1816,45,30-34,1861,0.0012575899127950543
STAT,1867,35,30-34,1902,0.0514863293160057
SIM,1863,58,na,1921,8
STAT,1850,53,50-100,1903,1.3231052742715922E-4
STAT,1883,51,50-100,1934,1.4736171327982327E-4
STAT,1933,23,25-29,1956,1.2198404382945047
STAT,1837,46,25-29,1883,2.94801325020925E-4
SIM,1930,35,na,1965,49
STAT,1899,6,na,1905,35.761437521837394
STAT,1817,47,35-39,1864,0.004048444002552283
STAT,1827,47,45-49,1874,0.0017792193967423918
STAT,1850,18,35-39,1868,0.005934856339119333
STAT,1945,25,20-24,1970,0.1989989355126407
SIM,1827,52,na,1879,13
STAT,1909,36,50-100,1945,0.003970793407879982
SIM,1923,28,na,1951,39
SIM,1845,77,na,1922,8
STAT,1857,46,30-34,1903,7.267100032133751E-4
STAT,1894,38,45-49,1932,0.025421644032816913
STAT,1884,38,35-39,1922,0.06895337240732047
STAT,1910,31,40-44,1941,0.037655619373833084
STAT,1859,17,na,1876,21.178114951175708
STAT,1813,63,na,1876,14.378914460673359
STAT,1882,57,na,1939,19.259173687187992
SIM,1864,28,35-39,1892,1
STAT,1817,77,na,1894,6.85063815034716
STAT,1883,35,na,1918,23.09573705818458
STAT,1936,2,na,1938,38.91924997171685
STAT,1861,36,40-44,1897,0.03699003383426849
STAT,1840,96,na,1936,0.06728429553761119
STAT,1847,18,15-19,1865,0.07865725202420343
SIM,1916,46,na,1962,44
STAT,1901,65,na,1966,26.22603207561777
STAT,1863,47,30-34,1910,8.530692091770735E-4
STAT,1899,44,40-44,1943,0.0021093350492043888
SIM,1832,26,na,1858,21
STAT,1840,30,15-19,1870,0.001387672432767324
STAT,1856,28,35-39,1884,0.07191239615308591
STAT,1864,32,na,1896,21.40336987911975
STAT,1834,36,35-39,1870,0.06282150389820339
STAT,1846,28,25-29,1874,0.4117528399299021
STAT,1863,43,15-19,1906,1.213886366708406E-4
STAT,1782,105,na,1887,1.6137279111833012E-4
STAT,1936,33,15-19,1969,0.0012398650427002133
SIM,1898,16,na,1914,35
STAT,1812,78,na,1890,3.1051392575031445
STAT,1896,49,na,1945,28.94081532848987
STAT,1870,40,25-29,1910,0.0064434822245717305
SIM,1839,92,na,1931,1
STAT,1885,30,20-24,1915,0.0269076683544197
STAT,1955,15,25-29,1970,0.5723410458075715
SIM,1876,32,na,1908,30
STAT,1884,30,25-29,1914,0.10115876010852921
STAT,1923,21,50-100,1944,0.007625984971805412
STAT,1821,38,15-19,1859,0.0010525473834724166
STAT,1842,35,30-34,1877,0.047891749346711227
STAT,1882,18,35-39,1900,0.005244742622406016
STAT,1842,44,na,1886,17.487014925749893
STAT,1803,105,na,1908,1.0988617465273986E-4
STAT,1893,21,15-19,1914,0.04172223096084235
STAT,1935,29,15-19,1964,0.009570923809001595
STAT,1911,28,na,1939,36.16978517600725
STAT,1866,42,25-29,1908,0.0059068665367869875
STAT,1881,19,50-100,1900,4.636789838970027E-4
SIM,1813,60,na,1873,6
SIM,1897,31,na,1928,40
STAT,1883,29,40-44,1912,0.028881458626095823
STAT,1921,40,45-49,1961,0.0018650776843036551
SIM,1825,41,na,1866,18
STAT,1876,34,45-49,1910,0.017559421010359625
STAT,1816,38,40-44,1854,0.0657039536925702
STAT,1839,27,20-24,1866,0.08155879196292752
SIM,1936,2,na,1938,40
STAT,1930,17,25-29,1947,0.5576355512353005
STAT,1929,18,35-39,1947,0.053155853832643776
SIM,1828,37,na,1865,18
SIM,1898,71,na,1969,17
STAT,1868,34,50-100,1902,0.00879100824525943
SIM,1849,36,na,1885,8
SIM,1944,27,na,1971,34
STAT,1860,73,na,1933,9.656104959829868
SIM,1893,30,20-24,1923,2
STAT,1855,45,30-34,1900,6.883342407299431E-4
STAT,1798,62,na,1860,16.291548890766215
STAT,1890,44,20-24,1934,0.0019030671826679856
SIM,1831,41,na,1872,9
SIM,1875,43,na,1918,18
STAT,1908,30,35-39,1938,0.08650097348734054
STAT,1864,54,50-100,1918,1.3173495513657231E-4
STAT,1964,2,na,1966,49.25280247028349
STAT,1876,47,40-44,1923,0.0017306792167678968
STAT,1928,31,15-19,1959,0.0015998835678222724
SIM,1796,70,na,1866,6
SIM,1908,32,na,1940,39
STAT,1886,17,40-44,1903,0.0018971918081074966
STAT,1940,0,na,1940,45.23165015627891
SIM,1923,25,30-34,1948,1
STAT,1869,28,45-49,1897,0.010720317808025912
STAT,1838,37,30-34,1875,0.04991361607606348
SIM,1848,14,na,1862,33
STAT,1886,46,20-24,1932,1.2482536122880393E-4
STAT,1877,31,25-29,1908,0.10616249707834087
STAT,1907,26,35-39,1933,0.14162420577498663
STAT,1868,48,45-49,1916,0.002255181897262149
STAT,1899,49,35-39,1948,0.0010584976900622706
STAT,1899,23,25-29,1922,0.7812329353115792
STAT,1878,15,50-100,1893,5.081507792748215E-4
SIM,1954,6,na,1960,50
STAT,1865,17,na,1882,23.540107004366
STAT,1892,32,25-29,1924,0.12653791684559113
STAT,1878,47,25-29,1925,5.919001114894643E-4
STAT,1915,25,30-34,1940,0.3988904547581002
STAT,1872,18,25-29,1890,0.057828368695535044
STAT,1889,20,na,1909,29.12880805234571
STAT,1865,29,35-39,1894,0.08664957758503225
STAT,1829,62,na,1891,12.414900548128232
STAT,1947,20,45-49,1967,0.012638370757292596
STAT,1909,39,15-19,1948,1.789272788955849E-4
STAT,1929,25,25-29,1954,0.8229299109067256
STAT,1959,6,na,1965,51.127691223446696
SIM,1867,17,na,1884,16
STAT,1930,35,25-29,1965,0.012804962466526912
STAT,1904,27,25-29,1931,0.6061331190756812
SIM,1860,20,15-19,1880,1
STAT,1839,24,50-100,1863,0.002850145223078291
STAT,1848,40,45-49,1888,0.009917751042332886
SIM,1904,14,na,1918,33
STAT,1913,50,na,1963,35.23745689960389
STAT,1927,36,50-100,1963,0.005198132730451383
STAT,1902,14,na,1916,36.3002993151644
STAT,1862,19,45-49,1881,5.804769138735554E-4
SIM,1807,60,na,1867,15
STAT,1899,41,25-29,1940,6.132066070865139E-4
SIM,1928,31,na,1959,53
SIM,1953,1,na,1954,55
STAT,1841,17,35-39,1858,0.006926981594063348
SIM,1820,78,na,1898,1
STAT,1865,51,50-100,1916,1.3725604847557912E-4
STAT,1948,24,30-34,1972,0.3276020417366905
STAT,1865,17,20-24,1882,0.16524014624127503
STAT,1914,22,50-100,1936,0.006666703288730492
STAT,1830,59,na,1889,6.989408216671878
STAT,1909,24,na,1933,35.04798305674334
SIM,1814,78,na,1892,12
STAT,1873,43,na,1916,23.328458354987035
STAT,1843,37,35-39,1880,0.03502570401066932
STAT,1817,42,40-44,1859,0.07105029562939344
SIM,1915,33,25-29,1948,1
STAT,1864,27,30-34,1891,0.22586222115131488
STAT,1867,37,50-100,1904,0.011749014059150619
STAT,1852,20,15-19,1872,0.034028321448503374
STAT,1885,23,30-34,1908,0.17535540595188528
STAT,1927,37,20-24,1964,0.003260722525284585
SIM,1890,21,na,1911,30
SIM,1937,25,25-29,1962,1
STAT,1884,33,40-44,1917,0.04230976057847771
STAT,1937,32,50-100,1969,0.0081282789750504
STAT,1821,82,na,1903,2.8978902682446224
STAT,1822,35,25-29,1857,0.018674698172198426
STAT,1923,13,na,1936,46.13266214585515
STAT,1880,45,50-100,1925,0.002608361953750702
STAT,1959,11,na,1970,51.095999902018924
STAT,1864,37,20-24,1901,0.006913920063744524
SIM,1961,9,na,1970,53
STAT,1788,88,na,1876,0.5529765033121673
STAT,1872,26,na,1898,24.501991513641933
STAT,1873,21,15-19,1894,0.03364219692196351
SIM,1920,45,na,1965,42
SIM,1905,22,25-29,1927,4
STAT,1815,46,25-29,1861,8.421131342832234E-4
STAT,1832,43,20-24,1875,8.623726158387234E-4
STAT,1901,28,na,1929,33.2763332020095
STAT,1893,23,40-44,1916,0.026193086339213228
SIM,1843,69,na,1912,17
STAT,1914,45,30-34,1959,8.809091375243124E-4
STAT,1875,34,30-34,1909,0.17793919724562637
STAT,1927,33,na,1960,46.257484338549546
STAT,1882,37,25-29,1919,0.027592607068382895
SIM,1869,74,na,1943,6
STAT,1900,32,25-29,1932,0.14203234934401368
STAT,1857,6,na,1863,21.950711531862066
STAT,1838,33,15-19,1871,0.0013592518146548255
STAT,1807,60,na,1867,11.8404106013995
STAT,1932,36,35-39,1968,0.03239626433823045
STAT,1826,32,40-44,1858,0.06142792523151035
STAT,1850,34,25-29,1884,0.09343993670471323
STAT,1870,20,35-39,1890,0.058314868769426494
STAT,1937,32,20-24,1969,0.02397961494506304
STAT,1876,26,45-49,1902,0.011315445306734485
STAT,1803,94,na,1897,0.07490257046895356
STAT,1820,76,na,1896,5.371066589877984
SIM,1812,81,na,1893,2
SIM,1857,55,na,1912,21
SIM,1941,8,na,1949,48
STAT,1811,99,na,1910,0.010732757173221813
STAT,1828,41,50-100,1869,0.004706349374234592
STAT,1851,17,40-44,1868,0.00187737232113728
STAT,1946,25,25-29,1971,0.7286578073197894
STAT,1824,44,25-29,1868,0.008417181622694373
STAT,1952,10,na,1962,46.808030955689595
SIM,1912,16,na,1928,38
STAT,1835,49,45-49,1884,0.0010979189994386478
SIM,1918,22,35-39,1940,2
STAT,1914,38,25-29,1952,0.009700877799244306
STAT,1883,28,50-100,1911,0.006190068201492225
STAT,1923,36,25-29,1959,0.011339816181879984
SIM,1799,60,na,1859,16
SIM,1894,51,na,1945,29
SIM,1858,8,na,1866,27
STAT,1837,20,35-39,1857,0.04928089323864509
STAT,1820,42,na,1862,15.522001048563904
SIM,1895,29,na,1924,27
STAT,1884,15,50-100,1899,4.8222903135272904E-4
SIM,1924,35,40-44,1959,2
SIM,1867,25,30-34,1892,2
STAT,1786,77,na,1863,1.4341264077643388
SIM,1920,35,na,1955,46
STAT,1866,48,50-100,1914,0.002233509452949949
SIM,1882,56,na,1938,29
STAT,1841,36,25-29,1877,0.033550524536443034
STAT,1931,35,20-24,1966,0.003481721308862978
STAT,1943,27,50-100,1970,0.010523334743515836
SIM,1866,32,na,1898,29
STAT,1929,33,25-29,1962,0.11676821584837217
STAT,1861,58,na,1919,16.630715197719137
STAT,1821,43,45-49,1864,0.022562061356118546
STAT,1837,43,50-100,1880,0.005991836369717444
STAT,1918,21,30-34,1939,0.30810381554473226
STAT,1845,34,na,1879,14.753483953266146
STAT,1907,29,na,1936,34.67090359055987
SIM,1919,28,25-29,1947,2
STAT,1904,16,20-24,1920,0.2546543782576105
STAT,1942,16,na,1958,38.19587841796683
STAT,1834,33,30-34,1867,0.15641464307410202
STAT,1885,24,45-49,1909,0.006843045274247296
SIM,1912,16,20-24,1928,1
STAT,1827,29,15-19,1856,0.004901129527282559
STAT,1890,17,na,1907,30.678610826912973
STAT,1929,17,20-24,1946,1.7219518660230775
SIM,1874,37,na,1911,24
SIM,1870,37,na,1907,24
STAT,1852,22,40-44,1874,0.02118624343906388
STAT,1884,39,50-100,1923,0.011907768795933709
STAT,1886,20,30-34,1906,0.18586320060376407
SIM,1836,20,25-29,1856,1
STAT,1883,73,na,1956,11.862591447675452
SIM,1916,7,na,1923,48
SIM,1941,13,na,1954,48
STAT,1801,93,na,1894,0.1059127170268173
STAT,1877,16,35-39,1893,0.005678021955698351
STAT,1917,25,45-49,1942,0.018074888830575515
SIM,1887,27,25-29,1914,1
STAT,1776,105,na,1881,1.4248972507230866E-4
STAT,1905,17,35-39,1922,0.007919197270867553
STAT,1916,35,40-44,1951,0.015343316271587247
SIM,1937,17,20-24,1954,2
STAT,1835,25,45-49,1860,0.006846846051215446
SIM,1878,9,na,1887,31
SIM,1857,89,na,1946,3
STAT,1892,40,25-29,1932,0.008013306510404543
STAT,1928,25,20-24,1953,0.22530530507166416
STAT,1845,24,na,1869,15.29394909953215
STAT,1940,15,na,1955,37.12655577392046
STAT,1915,48,na,1963,36.59765841593292
STAT,1829,33,20-24,1862,0.025446988842508386
STAT,1881,29,20-24,1910,0.11083201534085124
STAT,1943,5,na,1948,41.96214441208535
STAT,1832,61,na,1893,8.446397638576927
STAT,1874,42,15-19,1916,1.3992704932561293E-4
SIM,1897,3,na,1900,43
STAT,1879,27,25-29,1906,0.43782393594270025
STAT,1896,24,20-24,1920,0.89952376463099
STAT,1910,36,15-19,1946,1.834167743771448E-4
STAT,1903,29,na,1932,33.68748869201642
STAT,1924,37,40-44,1961,0.017537360664110598
STAT,1892,18,40-44,1910,0.0022536782163740084
SIM,1880,6,na,1886,35
STAT,1895,19,20-24,1914,0.22892727703661855
STAT,1942,10,na,1952,40.931504260775185
STAT,1954,18,25-29,1972,0.5324969376863569
SIM,1880,21,na,1901,29
STAT,1918,17,45-49,1935,0.0010809900842125406
STAT,1870,52,40-44,1922,1.0402373261503806E-4
STAT,1863,25,20-24,1888,0.10537778213336704
STAT,1865,42,20-24,1907,0.0014346752739909745
STAT,1934,17,45-49,1951,0.006728165572377042
STAT,1937,18,25-29,1955,0.41782177929677067
STAT,1818,46,50-100,1864,0.00245195153710075
SIM,1876,2,na,1878,37
SIM,1899,29,na,1928,28
STAT,1852,81,na,1933,4.628123343052489
STAT,1856,102,na,1958,0.003621939219408701
STAT,1864,16,25-29,1880,0.05812097057378127
SIM,1817,59,na,1876,6
STAT,1881,16,25-29,1897,0.05405381446176797
STAT,1862,44,45-49,1906,0.012738187841319236
SIM,1853,69,na,1922,13
SIM,1914,35,na,1949,37
STAT,1853,19,15-19,1872,0.044339538221059974
STAT,1885,15,30-34,1900,0.01581282572107718
STAT,1890,21,na,1911,28.815047222624788
SIM,1821,64,na,1885,7
STAT,1868,90,na,1958,1.079120733136798
STAT,1887,35,na,1922,25.95989800148709
STAT,1918,30,45-49,1948,0.016703260684546185
STAT,1802,57,na,1859,9.057208468348447
STAT,1810,76,na,1886,3.2486035877770316
STAT,1879,48,20-24,1927,1.2264061222309666E-4
STAT,1885,6,na,1891,25.797415180554466
STAT,1874,21,na,1895,24.065652520889405
STAT,1905,24,25-29,1929,0.8210202330852753
STAT,1907,13,na,1920,37.71714009540673
STAT,1927,43,na,1970,46.26705202747293
STAT,1880,32,45-49,1912,0.01833721622926679
STAT,1853,48,50-100,1901,0.0015241551018784695
STAT,1859,28,35-39,1887,0.07745493231336589
STAT,1828,28,20-24,1856,0.17680878927152074
STAT,1909,19,45-49,1928,9.688974093958845E-4
STAT,1933,35,40-44,1968,0.020342135438718108
STAT,1820,38,45-49,1858,0.018469484341778565
STAT,1884,16,40-44,1900,0.001796397452545952
SIM,1926,20,na,1946,40
STAT,1918,8,na,1926,43.01861523012819
STAT,1813,41,45-49,1854,0.05199297272889713
SIM,1912,10,na,1922,40
SIM,1945,18,25-29,1963,1
STAT,1925,27,45-49,1952,0.020277395072052607
STAT,1844,30,35-39,1874,0.09657778309468573
STAT,1932,40,20-24,1972,2.390478870759026E-4
STAT,1923,38,35-39,1961,0.027803482465797197
STAT,1914,3,na,1917,41.4731751100517
STAT,1790,82,na,1872,1.0148227965339722
STAT,1843,15,40-44,1858,0.0010032834403885325
STAT,1908,27,45-49,1935,0.0163847091445908
STAT,1833,41,15-19,1874,1.2548608706376357E-4
SIM,1916,1,na,1917,50
STAT,1891,35,25-29,1926,0.03567383520501004
STAT,1858,29,45-49,1887,0.008525237417636016
STAT,1863,43,na,1906,20.31583673927779
STAT,1838,26,25-29,1864,0.42066013643473915
STAT,1902,51,na,1953,30.50979812453788
STAT,1862,36,na,1898,20.424370456740835
STAT,1845,22,35-39,1867,0.042346891879356134
SIM,1856,18,na,1874,18
STAT,1925,14,na,1939,47.41056553512555
STAT,1868,23,30-34,1891,0.1718448867694616
SIM,1926,30,na,1956,46
SIM,1894,41,na,1935,29
STAT,1854,18,20-24,1872,0.1288644834852046
STAT,1798,78,na,1876,5.663755981785259
STAT,1833,39,na,1872,19.414490683872454
STAT,1886,16,na,1902,26.261602497918982
STAT,1861,23,45-49,1884,0.005981228401846951
STAT,1860,33,40-44,1893,0.03510753992119904
STAT,1837,18,20-24,1855,0.16218434572328266
STAT,1905,21,50-100,1926,0.0059031683589105014
SIM,1932,30,na,1962,48
STAT,1856,47,25-29,1903,4.153282540343297E-4
SIM,1925,22,25-29,1947,1
SIM,1906,16,na,1922,29
STAT,1844,23,45-49,1867,0.006751786841489265
STAT,1937,25,30-34,1962,0.379868549073172
STAT,1899,20,na,1919,32.56911899217023
STAT,1960,1,na,1961,50.98679485145836
STAT,1874,90,na,1964,1.889515330889047
STAT,1913,13,na,1926,39.9791500971124
STAT,1942,25,40-44,1967,0.04860619136482194
STAT,1943,15,45-49,1958,0.005261456441931039
STAT,1823,36,20-24,1859,0.005646418478448247
STAT,1890,27,20-24,1917,0.14250227869774945
STAT,1868,30,20-24,1898,0.026368991571689662
STAT,1913,16,30-34,1929,0.02477327613130643
SIM,1865,54,na,1919,15
STAT,1850,41,15-19,1891,1.2351423104991149E-4
STAT,1877,54,50-100,1931,1.5161265994564923E-4
STAT,1902,41,na,1943,32.853339360444124
SIM,1886,22,na,1908,27
STAT,1829,52,50-100,1881,1.1339765236539171E-4
STAT,1855,26,25-29,1881,0.3126847826911563
STAT,1917,22,25-29,1939,0.9727923865844211
STAT,1919,14,na,1933,43.266178178165255
STAT,1869,53,45-49,1922,1.383590345383555E-4
STAT,1948,20,15-19,1968,0.060758574259425775
STAT,1864,23,15-19,1887,0.02984965781853022
STAT,1903,17,15-19,1920,0.0843734773362953
STAT,1833,49,na,1882,17.303587682023178
STAT,1848,76,na,1924,6.126857167228193
STAT,1914,46,50-100,1960,0.0022300944966971888
STAT,1855,48,35-39,1903,9.733124188582055E-4
STAT,1871,72,na,1943,12.591066707195942
SIM,1807,59,na,1866,15
STAT,1827,39,na,1866,16.742992265688528
STAT,1892,34,30-34,1926,0.21385195740139165
STAT,1879,24,20-24,1903,0.7087861263727806
STAT,1899,27,40-44,1926,0.04100728155022065
STAT,1904,46,na,1950,32.335298743016565
STAT,1914,48,35-39,1962,0.0012645486214013068
STAT,1835,20,15-19,1855,0.03812055761307311
STAT,1856,21,15-19,1877,0.02795745500611952
STAT,1806,52,50-100,1858,4.891953225364284E-4
STAT,1845,20,25-29,1865,0.42145005542153147
STAT,1944,21,50-100,1965,0.007055249367151224
SIM,1846,87,na,1933,2
STAT,1825,43,30-34,1868,0.010975141467033168
STAT,1814,47,35-39,1861,0.004009399536985406
STAT,1846,33,20-24,1879,0.025620418722351032
STAT,1905,48,25-29,1953,4.630343096561276E-4
STAT,1873,73,na,1946,12.075793648897488
STAT,1906,36,25-29,1942,0.009071970215577244
STAT,1899,43,50-100,1942,9.970249471862116E-4
SIM,1850,17,na,1867,21
STAT,1881,38,35-39,1919,0.06696810250037719
STAT,1876,87,na,1963,3.3792409944607966
STAT,1840,34,50-100,1874,0.008564994147313999
STAT,1911,21,45-49,1932,0.0106343247988643
STAT,1839,24,na,1863,14.943889165914683
STAT,1871,18,20-24,1889,0.17684725878028226
STAT,1909,31,30-34,1940,0.15011423352865655
STAT,1904,22,15-19,1926,0.04727140798902863
STAT,1824,41,20-24,1865,0.0021885829324064174
STAT,1944,20,45-49,1964,0.012068820733601611
STAT,1851,58,na,1909,16.69548924567151
STAT,1917,43,na,1960,38.34507253495132
STAT,1877,20,20-24,1897,0.7156011980943875
STAT,1836,22,25-29,1858,0.7291219170605736
SIM,1917,24,40-44,1941,1
STAT,1831,75,na,1906,8.354019988224328
STAT,1932,33,30-34,1965,0.20846487974777553
STAT,1861,88,na,1949,1.1544939317429221
SIM,1892,22,na,1914,34
STAT,1838,48,na,1886,17.73619964052794
STAT,1818,93,na,1911,0.07303509112574941
STAT,1937,19,20-24,1956,1.3067105697241574
STAT,1897,15,50-100,1912,6.536130346417058E-4
STAT,1839,65,na,1904,9.326162447019684
STAT,1929,30,20-24,1959,0.030869526638720387
STAT,1931,31,50-100,1962,0.010791983422163752
STAT,1877,73,na,1950,12.2607081466131
STAT,1786,102,na,1888,3.776247055645933E-4
STAT,1952,16,na,1968,43.860573356057614
STAT,1872,39,20-24,1911,0.0078077160197548715
SIM,1930,21,20-24,1951,2
STAT,1858,90,na,1948,0.5999331050353164
STAT,1812,51,40-44,1863,1.1642531277237061E-4
STAT,1872,15,20-24,1887,0.18415265020708263
SIM,1812,77,na,1889,6
SIM,1873,3,na,1876,31
STAT,1888,72,na,1960,16.326811811227785
STAT,1903,35,45-49,1938,0.006175482612902419
STAT,1834,43,40-44,1877,0.018918522620303385
SIM,1945,19,20-24,1964,2
STAT,1914,22,25-29,1936,0.9358717099120581
SIM,1853,20,25-29,1873,1
STAT,1928,28,25-29,1956,0.8065469868626908
STAT,1840,37,35-39,1877,0.06555160378082919
SIM,1908,11,na,1919,42
STAT,1875,44,40-44,1919,0.022809161281542718
STAT,1943,16,40-44,1959,0.014728398599475744
STAT,1918,28,15-19,1946,0.007418698989929892
STAT,1900,19,40-44,1919,0.002522682195679532
STAT,1898,31,45-49,1929,0.023620311123312202
STAT,1895,54,na,1949,27.185651324402475
STAT,1864,31,15-19,1895,0.00128250681677458
STAT,1906,38,35-39,1944,0.02206908435225845
SIM,1877,21,25-29,1898,1
STAT,1891,32,20-24,1923,0.03317636444531698
STAT,1872,20,na,1892,24.34285452018881
STAT,1897,59,na,1956,26.03234860204241
STAT,1848,26,50-100,1874,0.004974379876772293
STAT,1816,92,na,1908,0.12503896788826302
STAT,1926,19,45-49,1945,0.0060569522181468625
STAT,1865,88,na,1953,1.2417126976889956
SIM,1832,36,na,1868,25
STAT,1909,24,40-44,1933,0.03088025195790709
STAT,1861,53,45-49,1914,1.2008341665483192E-4
STAT,1886,23,35-39,1909,0.06034243286001178
SIM,1824,62,na,1886,15
STAT,1875,40,25-29,1915,0.006667609429771142
STAT,1891,42,15-19,1933,1.6928817065185563E-4
STAT,1889,48,50-100,1937,0.001674862598319296
STAT,1848,49,40-44,1897,0.0010840335421528173
STAT,1895,43,45-49,1938,0.001339526751730948
STAT,1842,41,25-29,1883,0.005048985264091298
SIM,1839,22,15-19,1861,1
SIM,1936,28,25-29,1964,1
SIM,1812,43,na,1855,18
STAT,1921,16,20-24,1937,1.5370938346445921
STAT,1832,23,na,1855,12.944284188675027
STAT,1865,45,25-29,1910,5.261786987635254E-4
STAT,1903,16,50-100,1919,6.982444931427151E-4
STAT,1885,31,35-39,1916,0.10041496543199378
STAT,1869,21,25-29,1890,0.5563510478440389
STAT,1853,1,na,1854,24.0
STAT,1935,21,30-34,1956,0.38977754738294257
SIM,1847,35,na,1882,18
SIM,1943,21,30-34,1964,1
SIM,1946,23,25-29,1969,4
SIM,1880,37,na,1917,30
STAT,1874,86,na,1960,3.3898992478432204
STAT,1851,33,30-34,1884,0.1518325253917823
STAT,1886,21,25-29,1907,0.5955821469708688
STAT,1931,38,25-29,1969,0.012968974876291577
STAT,1885,21,40-44,1906,0.020640047400608035
STAT,1924,41,25-29,1965,8.450825032741866E-4
SIM,1830,31,na,1861,19
STAT,1938,23,25-29,1961,0.907855576441273
STAT,1868,21,na,1889,23.053168548892472
STAT,1879,54,50-100,1933,1.520164090470889E-4
SIM,1852,56,na,1908,19
STAT,1814,42,na,1856,14.345728249738324
STAT,1866,28,40-44,1894,0.0274914790926552
STAT,1896,49,35-39,1945,0.0010156626964655995
STAT,1818,40,35-39,1858,0.020716493539816437
STAT,1855,24,na,1879,17.33506661453447
SIM,1859,20,na,1879,20
STAT,1880,55,na,1935,21.743105992938332
SIM,1884,51,na,1935,20
SIM,1895,67,na,1962,18
STAT,1897,48,25-29,1945,4.260471808189312E-4
SIM,1838,21,na,1859,12
STAT,1944,18,15-19,1962,0.4846971127817036
STAT,1928,27,30-34,1955,0.4803654016912609
STAT,1900,22,30-34,1922,0.24699972187319102
STAT,1879,8,na,1887,27.411212449358953
STAT,1838,41,15-19,1879,1.269659510681546E-4
STAT,1879,34,15-19,1913,0.0014613144330709146
STAT,1883,69,na,1952,14.251041791469868
STAT,1824,43,50-100,1867,0.014080349758839553
STAT,1917,26,40-44,1943,0.04860310871565563
STAT,1913,29,na,1942,36.750221653690744
SIM,1917,25,na,1942,44
STAT,1909,33,50-100,1942,0.00781247709258378
STAT,1771,85,na,1856,1.3099329800000004
STAT,1831,38,20-24,1869,0.007799825004451192
STAT,1951,17,45-49,1968,0.005912532258881566
STAT,1891,34,na,1925,29.03795962757724
STAT,1863,28,25-29,1891,0.373217404495625
STAT,1922,2,na,1924,46.98570076325154
STAT,1846,25,20-24,1871,0.11668682903558625
STAT,1936,27,20-24,1963,0.17363701798296205
STAT,1946,18,35-39,1964,0.04619816116022709
STAT,1828,93,na,1921,0.1962803628076873
STAT,1882,20,na,1902,22.800530279995076
SIM,1882,22,na,1904,33
STAT,1859,25,30-34,1884,0.20656033619270345
STAT,1861,15,45-49,1876,6.388990643893946E-4
STAT,1954,15,20-24,1969,1.667349629021526
STAT,1838,23,20-24,1861,0.6889462008687036
STAT,1843,18,45-49,1861,3.520212126178665E-4
SIM,1911,1,na,1912,43
STAT,1822,92,na,1914,0.1477369726404421
STAT,1858,26,40-44,1884,0.02350346851232842
STAT,1847,59,na,1906,20.760803217594
STAT,1911,28,15-19,1939,0.006816108456543179
STAT,1844,32,50-100,1876,0.008558275886742711
STAT,1895,45,50-100,1940,0.001816519058382823
STAT,1807,48,40-44,1855,0.0035881419331309826
STAT,1914,28,30-34,1942,0.3903470131118683
STAT,1844,17,35-39,1861,0.005448164726322584
SIM,1864,37,na,1901,22
SIM,1867,55,na,1922,10
STAT,1854,42,45-49,1896,0.009136726232405513
STAT,1829,41,na,1870,17.946433828054367
STAT,1933,39,20-24,1972,0.003568306578901097
STAT,1807,94,na,1901,0.08434791926269093
SIM,1844,21,na,1865,9
STAT,1922,21,20-24,1943,1.269631057188404
STAT,1867,33,40-44,1900,0.04132553380328654
STAT,1916,1,na,1917,43.78447633594471
STAT,1908,60,na,1968,30.778677006267124
STAT,1871,88,na,1959,2.0378045637750146
SIM,1836,56,na,1892,4
SIM,1922,28,30-34,1950,1
STAT,1910,28,15-19,1938,0.006751546052837547
STAT,1922,34,na,1956,42.212292479200535
SIM,1800,58,na,1858,12
SIM,1849,54,na,1903,7
STAT,1947,15,15-19,1962,0.508002548529311
STAT,1878,3,na,1881,31.555146055133594
STAT,1878,18,50-100,1896,5.044755572214669E-4
STAT,1933,38,45-49,1971,0.009238318629868125
STAT,1926,39,15-19,1965,2.3285186058536134E-4
STAT,1867,73,na,1940,11.366324522345035
STAT,1926,32,45-49,1958,0.018918501668300107
STAT,1909,16,40-44,1925,0.002734239534226018
SIM,1929,10,na,1939,51
SIM,1899,50,na,1949,28
STAT,1813,94,na,1907,0.13189922624067404
STAT,1843,60,na,1903,8.090133713107253
STAT,1872,45,50-100,1917,0.0025379586120031048
STAT,1844,20,40-44,1864,0.020617307375440538
STAT,1788,78,na,1866,3.63210252733241
STAT,1928,17,20-24,1945,1.6999368593371096
STAT,1820,52,45-49,1872,1.184979898630951E-4
SIM,1879,36,na,1915,15
STAT,1860,19,50-100,1879,4.539614403496365E-4
SIM,1835,22,30-34,1857,1
SIM,1858,72,na,1930,15
STAT,1871,31,40-44,1902,0.04341377301864374
STAT,1918,46,45-49,1964,0.0022975889277976735
STAT,1954,17,30-34,1971,0.1498222981648383
STAT,1878,19,20-24,1897,0.18205090446738065
STAT,1885,18,35-39,1903,0.005404387354380986
STAT,1914,35,20-24,1949,0.0026349563255279097
SIM,1954,11,na,1965,50
STAT,1884,19,45-49,1903,6.36566334525563E-4
SIM,1936,17,20-24,1953,4
STAT,1913,19,35-39,1932,0.008461985339364403
STAT,1833,45,30-34,1878,8.612772702126545E-4
SIM,1855,54,na,1909,13
SIM,1910,5,na,1915,34
STAT,1915,14,na,1929,40.84446773260427
STAT,1909,14,na,1923,38.386973373926516
STAT,1838,76,na,1914,7.353241637772961
STAT,1857,30,45-49,1887,0.013410620342926893
STAT,1883,40,15-19,1923,1.354578602213252E-4
SIM,1860,17,na,1877,28
STAT,1908,24,40-44,1932,0.030558198411386885
SIM,1904,24,30-34,1928,2
STAT,1859,41,35-39,1900,0.014457777086296959
STAT,1843,39,na,1882,10.398754384279508
STAT,1883,42,25-29,1925,0.006228190546405541
STAT,1894,20,20-24,1914,0.8884464684854222
STAT,1823,39,25-29,1862,0.02033932684443014
STAT,1897,22,15-19,1919,0.04380956762730656
STAT,1873,44,20-24,1917,0.0015928457646584102
STAT,1885,37,40-44,1922,0.04322848851603878
SIM,1918,8,na,1926,41
STAT,1887,26,20-24,1913,0.1284891316384634
STAT,1906,46,35-39,1952,0.0011505701985341837
SIM,1830,72,na,1902,1
STAT,1904,40,45-49,1944,0.001504226476987847
STAT,1927,22,35-39,1949,0.11541678045564219
SIM,1921,17,25-29,1938,2
STAT,1833,38,40-44,1871,0.0401006466238525
STAT,1872,23,20-24,1895,0.7029133699371639
STAT,1822,49,35-39,1871,7.491057366067375E-4
SIM,1880,45,50-100,1925,1
STAT,1850,31,20-24,1881,0.025439373197426004
STAT,1836,54,45-49,1890,1.3620848664033444E-4
STAT,1913,17,25-29,1930,0.08786132996057094
STAT,1825,75,na,1900,5.549864861698897
STAT,1901,24,40-44,1925,0.02897555618889313
SIM,1832,43,50-100,1875,1
SIM,1889,33,na,1922,32
STAT,1907,48,45-49,1955,0.001922800825598805
SIM,1830,62,na,1892,7
STAT,1846,36,25-29,1882,0.024621405245369807
SIM,1892,18,na,1910,36
SIM,1946,20,20-24,1966,1
STAT,1871,20,35-39,1891,0.05852689065944053
SIM,1822,43,na,1865,18
STAT,1842,43,30-34,1885,0.008810636246513447
STAT,1945,23,15-19,1968,0.05790344622081528
SIM,1792,83,na,1875,1
STAT,1940,18,30-34,1958,0.12283981297912015
SIM,1911,4,na,1915,42
STAT,1797,83,na,1880,1.20003923721462
STAT,1864,38,na,1902,21.026487106115248
STAT,1924,45,40-44,1969,0.0018735680993652998
SIM,1904,52,na,1956,25
SIM,1950,11,na,1961,60
STAT,1889,24,50-100,1913,0.0049614520350191715
STAT,1842,23,na,1865,20.08831345163503
STAT,1845,43,50-100,1888,0.006208548960376836
STAT,1909,52,na,1961,33.0039462866742
STAT,1888,38,20-24,1926,0.008963444631698023
STAT,1881,23,15-19,1904,0.031294646431067136
STAT,1851,43,40-44,1894,0.01885190904151766
SIM,1897,52,na,1949,38
SIM,1944,17,na,1961,29
STAT,1841,65,na,1906,16.541604008142873
STAT,1884,52,na,1936,20.98397424048113
STAT,1929,41,50-100,1970,0.001516313698621071
STAT,1897,18,na,1915,33.451050929597095
STAT,1873,15,na,1888,25.982827506303362
SIM,1877,48,na,1925,25
STAT,1815,58,na,1873,8.916527050111911
STAT,1894,16,35-39,1910,0.007049483103097752
STAT,1823,40,na,1863,16.337663181155094
STAT,1864,38,35-39,1902,0.06312399544201341
STAT,1934,37,15-19,1971,2.6387762094373337E-4
STAT,1872,37,30-34,1909,0.05453065188352765
STAT,1836,32,35-39,1868,0.12353809272032935
STAT,1884,4,na,1888,27.345398615213202
STAT,1935,24,35-39,1959,0.12756604983896283
SIM,1866,60,na,1926,27
SIM,1810,48,na,1858,18
STAT,1836,37,45-49,1873,0.02361460584230755
SIM,1858,68,na,1926,18
STAT,1930,19,35-39,1949,0.0537062648764717
SIM,1810,58,na,1868,16
STAT,1933,31,25-29,1964,0.12412096348456325
STAT,1901,41,40-44,1942,0.0021954680350241102
STAT,1837,38,25-29,1875,0.016901594188707868
STAT,1930,30,45-49,1960,0.020235440553610082
STAT,1868,24,45-49,1892,0.006706051255893335
STAT,1870,38,50-100,1908,0.012135763005226046
STAT,1890,19,20-24,1909,0.21419411208942984
STAT,1850,42,na,1892,20.553132165674413
STAT,1941,30,20-24,1971,0.025452307379641787
STAT,1808,73,na,1881,2.0196555010181934
STAT,1815,51,50-100,1866,2.1372432759644117E-4
STAT,1876,21,15-19,1897,0.033607556114868306
STAT,1848,38,na,1886,15.538907027227584
STAT,1905,39,45-49,1944,0.006147429534267253
STAT,1854,35,20-24,1889,0.004783792595861284
STAT,1871,25,50-100,1896,0.006421004046529371
STAT,1823,37,35-39,1860,0.050969628828921504
STAT,1874,39,40-44,1913,0.04396242916380412
STAT,1879,38,50-100,1917,0.012644232360787043
STAT,1797,93,na,1890,0.06260364788655498
STAT,1892,44,40-44,1936,0.001903590205574222
STAT,1904,27,50-100,1931,0.00916609264682213
STAT,1898,72,na,1970,20.99811302142386
STAT,1827,39,45-49,1866,0.015852000351923946
STAT,1848,45,25-29,1893,3.7621271469336445E-4
STAT,1921,19,25-29,1940,0.4874829092229782
STAT,1837,60,na,1897,9.221677020747507
STAT,1919,33,15-19,1952,0.0013685949485882055
STAT,1868,31,35-39,1899,0.09840471282279768
STAT,1922,24,25-29,1946,1.0449253561606235
SIM,1861,30,na,1891,27
STAT,1859,31,40-44,1890,0.0346098170827006
STAT,1890,28,35-39,1918,0.11679324884398186
STAT,1902,38,15-19,1940,1.7007346378446021E-4
STAT,1909,34,35-39,1943,0.0859731529239668
STAT,1829,34,na,1863,18.986382533937284
STAT,1860,40,30-34,1900,0.009440798423857177
STAT,1844,36,40-44,1880,0.0401199641903469
STAT,1830,25,na,1855,9.838461392500623
STAT,1841,68,na,1909,14.958224481748674
SIM,1930,24,25-29,1954,2
STAT,1930,37,50-100,1967,0.0054508298995155705
STAT,1910,49,na,1959,33.86747879568623
STAT,1861,17,35-39,1878,0.005303718967206262
STAT,1875,23,50-100,1898,0.004178896751246817
STAT,1802,54,50-100,1856,2.2219700859879248E-4
STAT,1900,49,na,1949,30.55242294788374
STAT,1912,25,45-49,1937,0.017006322575518734
STAT,1855,8,na,1863,20.564104280763036
STAT,1887,37,25-29,1924,0.03142666002422924
SIM,1826,36,na,1862,14
STAT,1938,20,20-24,1958,1.0939956334965282
STAT,1905,46,35-39,1951,0.0011429876106548032
STAT,1810,80,na,1890,2.2235209749544267
STAT,1898,65,na,1963,24.717021204619154
STAT,1836,19,15-19,1855,0.07605147066430847
SIM,1938,0,na,1938,41
STAT,1906,35,30-34,1941,0.01687107782424837
STAT,1943,19,45-49,1962,0.005255145519569939
STAT,1874,32,20-24,1906,0.027422298712952008
SIM,1855,23,na,1878,20
STAT,1875,18,40-44,1893,0.001875211700395389
STAT,1940,25,20-24,1965,0.18497980536373404
STAT,1876,25,30-34,1901,0.25749404707423085
STAT,1830,30,40-44,1860,0.030625910578063506
SIM,1899,34,40-44,1933,1
STAT,1877,38,45-49,1915,0.020475920128789727
STAT,1897,28,na,1925,31.580408441953825
STAT,1900,36,40-44,1936,0.013165063353303499
STAT,1909,27,45-49,1936,0.01641802446222204
STAT,1908,25,50-100,1933,0.00950396449656594
STAT,1874,46,30-34,1920,9.848158429859263E-4
STAT,1927,20,45-49,1947,0.013874233996246772
STAT,1928,30,50-100,1958,0.010299254566952023
SIM,1885,67,na,1952,14
STAT,1853,22,25-29,1875,0.42509275398525664
SIM,1831,37,35-39,1868,1
STAT,1872,67,na,1939,16.21947652765753
STAT,1880,24,45-49,1904,0.007286802560297638
STAT,1912,44,na,1956,35.264383155028554
STAT,1935,17,45-49,1952,0.00679875434402104
STAT,1923,28,25-29,1951,0.7478128885290849
STAT,1931,29,45-49,1960,0.022183452431135117
STAT,1910,15,na,1925,38.21317379938066
STAT,1940,23,50-100,1963,0.006653183556928691
STAT,1831,36,30-34,1867,0.055077754562918614
STAT,1863,15,na,1878,23.466984527439326
SIM,1896,15,na,1911,33
STAT,1905,47,50-100,1952,0.001990128482193815
SIM,1917,6,na,1923,47
STAT,1907,41,25-29,1948,6.552318544963957E-4
STAT,1864,40,50-100,1904,0.009571170534395802
SIM,1934,5,na,1939,54
STAT,1941,23,30-34,1964,0.29476670178015973
STAT,1909,15,45-49,1924,9.786473330887571E-4
STAT,1947,16,50-100,1963,0.0041926976757340525
STAT,1823,46,na,1869,15.179287700862886
SIM,1848,41,na,1889,31
SIM,1876,60,na,1936,26
STAT,1835,24,30-34,1859,0.11146537670765502
STAT,1846,43,15-19,1889,1.1183166539885245E-4
STAT,1873,47,25-29,1920,5.828847784632431E-4
SIM,1927,15,na,1942,52
STAT,1838,28,15-19,1866,0.004447220348727426
STAT,1892,40,na,1932,28.84134511292126
STAT,1889,46,25-29,1935,7.072172901607203E-4
STAT,1870,26,40-44,1896,0.02985970998111603
STAT,1917,29,45-49,1946,0.017824775089469974
STAT,1904,26,30-34,1930,0.3620673660073296
STAT,1939,30,15-19,1969,0.0013036305285147125
STAT,1915,26,25-29,1941,0.6678385658403683
STAT,1866,44,30-34,1910,0.010445311088989615
STAT,1941,16,25-29,1957,0.4432469469844463
STAT,1862,27,45-49,1889,0.009614616432962585
SIM,1827,73,na,1900,4
STAT,1912,49,30-34,1961,8.450467005388926E-4
STAT,1802,88,na,1890,0.41927117223173466
STAT,1876,23,40-44,1899,0.021098718805158703
STAT,1873,27,20-24,1900,0.11927279979662332
STAT,1917,17,45-49,1934,0.0010652005554171301
STAT,1868,33,25-29,1901,0.09870402608355618
STAT,1878,9,na,1887,27.21048398777433
SIM,1864,75,na,1939,10
STAT,1841,75,na,1916,10.076527654848872
STAT,1877,30,30-34,1907,0.18167857665023196
SIM,1912,26,30-34,1938,1
STAT,1946,15,30-34,1961,0.1343087913235998
STAT,1822,36,50-100,1858,0.007743813858021891
STAT,1886,42,40-44,1928,0.023302256302843143
STAT,1926,15,45-49,1941,0.006117902759830249
STAT,1912,34,na,1946,36.60789168163758
SIM,1928,25,30-34,1953,2
STAT,1877,23,25-29,1900,0.5890982001186922
SIM,1923,26,25-29,1949,1
STAT,1847,35,30-34,1882,0.06030958512570109
STAT,1854,42,50-100,1896,0.006449453792628034
STAT,1854,38,na,1892,14.329130774227718
SIM,1913,16,20-24,1929,1
STAT,1946,22,20-24,1968,1.2286548444021792
SIM,1840,62,na,1902,6
STAT,1901,20,25-29,1921,0.8057994343345417
STAT,1915,47,40-44,1962,0.0015749863086493916
STAT,1904,15,na,1919,36.35731515598007
STAT,1894,23,25-29,1917,0.7313881207582003
STAT,1905,16,20-24,1921,0.2564939068865565
STAT,1929,39,30-34,1968,0.023237346400051182
STAT,1845,41,40-44,1886,0.013561609177945811
STAT,1857,53,na,1910,15.859981974854005
STAT,1832,26,20-24,1858,0.07069132703408804
STAT,1878,43,45-49,1921,0.01533995716632201
STAT,1791,98,na,1889,0.005678403615492049
STAT,1872,26,25-29,1898,0.4343008431181847
STAT,1846,19,na,1865,23.09453539801718
STAT,1829,29,50-100,1858,0.006415636955577243
SIM,1944,11,na,1955,36
STAT,1840,80,na,1920,4.847266294438104
STAT,1868,48,50-100,1916,0.0023469181061777115
STAT,1827,32,25-29,1859,0.09028988082457483
STAT,1903,30,na,1933,34.19968580523699
STAT,1898,23,50-100,1921,0.005484097756597789
STAT,1848,48,na,1896,14.366897231508961
STAT,1853,60,na,1913,11.986265965107313
STAT,1915,40,20-24,1955,1.7675371064853566E-4
STAT,1915,33,50-100,1948,0.008312623801085795
STAT,1919,31,50-100,1950,0.00887894173220892
SIM,1911,31,na,1942,41
STAT,1860,42,50-100,1902,0.008578091472742863
STAT,1833,34,25-29,1867,0.09562592249657896
SIM,1843,38,na,1881,20
STAT,1901,28,20-24,1929,0.16357673610118287
STAT,1785,98,na,1883,0.016867472882189257
STAT,1867,36,45-49,1903,0.019168699669570275
STAT,1862,22,35-39,1884,0.05153910811172555
STAT,1915,33,30-34,1948,0.15840301972524384
STAT,1931,36,35-39,1967,0.03192032644416722
STAT,1811,53,50-100,1864,5.618297552683161E-4
STAT,1861,3,na,1864,27.309066902101225
STAT,1883,44,30-34,1927,0.011013519160041266
STAT,1853,20,35-39,1873,0.04396196111826292
SIM,1940,6,na,1946,37
STAT,1878,52,na,1930,22.111341189170542
STAT,1867,19,45-49,1886,6.315447351155962E-4
STAT,1932,26,25-29,1958,0.859004967351625
STAT,1945,6,na,1951,42.97607295328284
STAT,1828,86,na,1914,1.4901403320867117
STAT,1878,39,25-29,1917,0.02942616474399045
STAT,1783,79,na,1862,1.405433420713378
STAT,1949,21,na,1970,42.35352397757026
STAT,1854,20,35-39,1874,0.04251759206249437
STAT,1832,46,25-29,1878,3.10209954974595E-4
STAT,1927,36,45-49,1963,0.008440211419533694
STAT,1882,34,20-24,1916,0.025682810542208695
STAT,1893,26,45-49,1919,0.014047603488296841
STAT,1933,15,50-100,1948,0.005018083087484156
SIM,1866,21,30-34,1887,2
STAT,1876,28,35-39,1904,0.09765397550723624
SIM,1868,34,na,1902,33
STAT,1924,48,45-49,1972,0.002563477236209571
STAT,1866,67,na,1933,14.59956380778551
STAT,1886,28,45-49,1914,0.011476261114374612
STAT,1863,53,na,1916,18.75800083858831
SIM,1961,0,na,1961,53
STAT,1775,105,na,1880,3.1331227958773637E-4
SIM,1849,20,na,1869,14
STAT,1961,3,na,1964,50.522843050850106
STAT,1815,43,20-24,1858,0.00239692603192296
STAT,1935,22,45-49,1957,0.015254114043703394
STAT,1944,4,na,1948,42.69195672222925
STAT,1896,33,na,1929,31.212778533366446
STAT,1896,27,25-29,1923,0.5556443903892127
STAT,1890,55,na,1945,25.11657658475149
SIM,1886,15,na,1901,30
STAT,1868,37,40-44,1905,0.04236307785282618
STAT,1907,45,40-44,1952,0.0014266776065656914
SIM,1804,58,na,1862,11
SIM,1876,22,na,1898,30
STAT,1818,49,45-49,1867,0.002254781442904801
STAT,1829,36,25-29,1865,0.026745881867946006
STAT,1828,48,25-29,1876,2.4365104864484534E-4
SIM,1889,29,na,1918,29
STAT,1838,48,35-39,1886,0.0011036638598421091
STAT,1830,33,45-49,1863,0.011094822877748496
STAT,1878,36,20-24,1914,0.007996683331691297
STAT,1932,21,15-19,1953,0.06977210218153702
STAT,1805,49,35-39,1854,0.002734068592741501
STAT,1840,28,20-24,1868,0.11379611507205939
STAT,1819,37,45-49,1856,0.022329963062995364
STAT,1880,21,40-44,1901,0.021978511644431393
SIM,1819,54,na,1873,5
STAT,1846,47,30-34,1893,7.808370589139403E-4
STAT,1913,30,45-49,1943,0.015649762484472078
SIM,1856,49,na,1905,11
STAT,1888,36,30-34,1924,0.06258110460816062
STAT,1940,16,40-44,1956,0.014104834179873694
STAT,1891,46,30-34,1937,6.720834309849096E-4
STAT,1930,16,30-34,1946,0.15723025701505788
STAT,1915,36,35-39,1951,0.02433986217692617
STAT,1855,33,15-19,1888,0.0010103580544541732
STAT,1910,42,45-49,1952,0.001563289063581782
STAT,1913,26,50-100,1939,0.009868552611046773
STAT,1866,40,15-19,1906,1.2846933563198266E-4
STAT,1843,102,na,1945,0.001243629478910635
SIM,1861,23,na,1884,27
SIM,1845,61,na,1906,21
STAT,1888,37,50-100,1925,0.01434737777976683
STAT,1921,42,20-24,1963,1.9736122486053228E-4
STAT,1833,46,na,1879,17.98084153964541
SIM,1914,45,na,1959,36
STAT,1881,34,na,1915,22.5123797505313
STAT,1826,35,45-49,1861,0.02419209226418555
STAT,1914,36,35-39,1950,0.024064851796458307
SIM,1786,80,na,1866,14
STAT,1866,20,45-49,1886,0.0065686278718489356
STAT,1831,29,40-44,1860,0.03198857996962881
SIM,1816,43,na,1859,12
STAT,1856,33,15-19,1889,0.0010334920891876818
STAT,1868,26,35-39,1894,0.09369749723038868
STAT,1844,39,45-49,1883,0.016116103881119125
STAT,1856,26,50-100,1882,0.0048367631709697574
STAT,1919,37,30-34,1956,0.019410288444187303
SIM,1875,74,na,1949,6
STAT,1929,37,40-44,1966,0.019126949111072593
SIM,1807,69,na,1876,13
STAT,1859,34,45-49,1893,0.013741527841479004
STAT,1874,35,25-29,1909,0.029486611374818537
STAT,1945,17,20-24,1962,1.470363096604171
STAT,1808,79,na,1887,1.1436524462778044
STAT,1933,33,na,1966,50.72894950156367
STAT,1848,42,20-24,1890,0.001025779038185963
STAT,1887,48,30-34,1935,0.0010433035347928471
SIM,1936,29,na,1965,35
SIM,1878,88,na,1966,3
STAT,1871,34,45-49,1905,0.017237062224681153
STAT,1850,79,na,1929,6.2245877835560135
SIM,1923,23,20-24,1946,3
SIM,1961,3,na,1964,53
STAT,1842,25,50-100,1867,0.006021428684447399
STAT,1966,0,na,1966,49.15347386568723
SIM,1885,74,na,1959,13
STAT,1894,21,35-39,1915,0.0750128278227532
STAT,1852,25,45-49,1877,0.011228628262267074
STAT,1893,66,na,1959,21.686801514783966
STAT,1805,58,na,1863,8.426106086713306
STAT,1840,15,25-29,1855,0.058174348266931845
STAT,1795,64,na,1859,10.134601737203525
STAT,1827,30,35-39,1857,0.09710499611754236
STAT,1861,39,50-100,1900,0.01022085632810178
STAT,1877,1,na,1878,35.55618214954002
STAT,1922,17,35-39,1939,0.048206881052311405
STAT,1832,24,30-34,1856,0.1071310691134428
STAT,1839,34,na,1873,14.41579461091934
SIM,1877,42,40-44,1919,1
STAT,1906,31,15-19,1937,0.0011928294539104202
STAT,1851,68,na,1919,12.901516079866107
STAT,1918,24,35-39,1942,0.10000404679962172
STAT,1868,21,40-44,1889,0.020311800883529848
STAT,1858,21,30-34,1879,0.15663956754773262
SIM,1858,41,na,1899,25
STAT,1854,38,25-29,1892,0.01751137210657769
STAT,1870,93,na,1963,0.7358867409900616
STAT,1837,42,45-49,1879,0.008598582962715996
SIM,1835,30,35-39,1865,1
SIM,1870,75,na,1945,11
STAT,1829,43,15-19,1872,1.2060908159732778E-4
STAT,1941,26,35-39,1967,0.15425368716708987
STAT,1859,21,15-19,1880,0.030112232396528698
SIM,1843,42,na,1885,22
STAT,1903,67,na,1970,26.023424587491995
STAT,1824,35,na,1859,20.45724042903725
STAT,1865,49,40-44,1914,0.001516151199437506
STAT,1904,19,25-29,1923,0.08076257568757494
SIM,1834,24,na,1858,22
STAT,1841,33,20-24,1874,0.03176977183844513
STAT,1913,18,20-24,1931,0.274156651906908
SIM,1926,29,na,1955,46
STAT,1923,18,30-34,1941,0.14176192596223797
SIM,1921,18,20-24,1939,3
STAT,1842,46,35-39,1888,0.0010641121909546328
STAT,1887,17,50-100,1904,5.347501477466502E-4
STAT,1928,23,15-19,1951,0.06593332786255267
SIM,1837,35,na,1872,28
STAT,1877,33,35-39,1910,0.10409660931471178
STAT,1945,27,30-34,1972,0.42678542883140697
STAT,1900,25,35-39,1925,0.13470769558854906
SIM,1830,24,20-24,1854,3
STAT,1896,34,15-19,1930,0.0018545609334545661
STAT,1869,29,20-24,1898,0.11285846137226647
SIM,1945,15,20-24,1960,2
STAT,1879,49,35-39,1928,0.0014187596945976298
STAT,1849,28,40-44,1877,0.02733614160101478
STAT,1940,28,25-29,1968,0.6661025582139307
STAT,1904,29,35-39,1933,0.13727043674942518
STAT,1927,18,15-19,1945,0.559934639094555
STAT,1822,61,na,1883,7.0374173294867415
STAT,1917,24,50-100,1941,0.006886327383911967
STAT,1853,15,35-39,1868,0.004197664677239232
STAT,1877,66,na,1943,16.918863449358263
STAT,1915,23,20-24,1938,1.1359597993160513
SIM,1905,28,30-34,1933,1
STAT,1859,85,na,1944,2.178866747489758
SIM,1877,1,na,1878,34
STAT,1819,54,45-49,1873,1.2118361318805585E-4
STAT,1801,62,na,1863,8.887877877930814
STAT,1868,52,na,1920,20.726252202753205
STAT,1855,39,20-24,1894,0.005372690845684951
STAT,1916,39,20-24,1955,0.002649499507242174
STAT,1845,24,40-44,1869,0.014905407723391256
STAT,1897,34,15-19,1931,0.0018749194582915226
SIM,1896,7,na,1903,33
SIM,1860,75,na,1935,10
STAT,1921,48,na,1969,40.97796830198943
STAT,1923,25,20-24,1948,0.2095354903393146
STAT,1892,30,15-19,1922,0.0017734569153962719
STAT,1816,98,na,1914,0.009752699972081103
STAT,1928,29,20-24,1957,0.22356556576792747
SIM,1912,29,35-39,1941,1
STAT,1883,47,35-39,1930,0.0013531759266287682
STAT,1870,29,45-49,1899,0.010950793657335612
STAT,1855,23,20-24,1878,0.5627549305995876
SIM,1925,44,na,1969,43
STAT,1823,87,na,1910,1.0131947109838169
SIM,1871,23,na,1894,22
STAT,1867,16,40-44,1883,0.0017999437303622334
STAT,1850,38,40-44,1888,0.03918395604615307
SIM,1953,17,20-24,1970,2
SIM,1902,16,na,1918,37
STAT,1914,26,40-44,1940,0.046758460580134165
STAT,1937,15,20-24,1952,1.3166911027714843
STAT,1833,26,50-100,1859,0.00628717998920051
STAT,1831,39,35-39,1870,0.07081703526461935
STAT,1905,26,15-19,1931,0.006570493770694124
STAT,1956,15,50-100,1971,0.004932270855977391
STAT,1835,22,40-44,1857,0.015236642141321713
STAT,1931,16,15-19,1947,0.5928439476463196
STAT,1827,36,40-44,1863,0.03630113000846249
STAT,1869,31,35-39,1900,0.09852633745150993
SIM,1904,45,na,1949,26
STAT,1856,44,20-24,1900,0.001134965047681842
STAT,1847,53,na,1900,22.631629399478456
STAT,1847,37,20-24,1884,0.008543652919961694
STAT,1801,99,na,1900,0.006863366995409226
STAT,1842,102,na,1944,0.002199630227682759
STAT,1835,72,na,1907,5.6804110161950785
STAT,1890,48,na,1938,26.990510049661538
SIM,1850,24,na,1874,22
STAT,1946,17,20-24,1963,1.493118409417467
STAT,1887,30,40-44,1917,0.04771608647621794
STAT,1804,80,na,1884,3.0658045245681906
STAT,1888,32,15-19,1920,0.0016641732750022756
SIM,1840,29,25-29,1869,1
STAT,1856,67,na,1923,11.483846618671558
STAT,1926,16,40-44,1942,0.017092788205617295
SIM,1935,18,15-19,1953,1
STAT,1832,29,25-29,1861,0.24944850164556517
STAT,1923,35,30-34,1958,0.021007950205107883
STAT,1905,19,25-29,1924,0.08134597453247694
STAT,1909,32,45-49,1941,0.014931920812531741
STAT,1847,31,15-19,1878,0.0018047865000488477
SIM,1863,23,20-24,1886,2
SIM,1913,21,20-24,1934,1
STAT,1837,35,20-24,1872,0.004671591423462974
STAT,1900,15,25-29,1915,0.07894459453192808
STAT,1845,44,45-49,1889,0.008683478378707879
STAT,1894,27,40-44,1921,0.038390903960617694
STAT,1828,30,35-39,1858,0.14437869727436495
STAT,1840,22,15-19,1862,0.032874606277923664
SIM,1916,30,na,1946,45
SIM,1796,79,na,1875,3
STAT,1937,28,35-39,1965,0.14535751949684053
SIM,1843,27,35-39,1870,1
SIM,1854,75,na,1929,6
SIM,1917,15,na,1932,45
STAT,1836,20,na,1856,27.6280717114721
STAT,1824,48,40-44,1872,0.0021862252525421707
SIM,1907,63,na,1970,31
STAT,1833,31,20-24,1864,0.02603451602740545
SIM,1919,44,na,1963,43
STAT,1869,37,na,1906,22.828038182971213
STAT,1881,18,15-19,1899,0.05632187744475011
STAT,1891,39,40-44,1930,0.05318713748643242
STAT,1863,32,45-49,1895,0.015439760056874627
STAT,1886,45,45-49,1931,0.00247235349333197
STAT,1905,21,20-24,1926,0.997576315245329
STAT,1835,27,35-39,1862,0.05790586659545957
STAT,1817,87,na,1904,1.396300051260472
STAT,1808,101,na,1909,8.332409666422405E-4
STAT,1901,38,15-19,1939,1.687567558977585E-4
STAT,1838,86,na,1924,1.7220845465132781
STAT,1889,43,20-24,1932,0.001930352395033132
STAT,1938,3,na,1941,39.746982803130166
STAT,1938,25,15-19,1963,0.006953858577881978
STAT,1895,21,35-39,1916,0.0759881496097111
SIM,1933,3,na,1936,55
SIM,1851,61,na,1912,15
STAT,1889,51,na,1940,26.488772292373785
SIM,1901,31,na,1932,38
STAT,1939,21,na,1960,36.43473903844344
STAT,1920,37,20-24,1957,0.002861658533094647
STAT,1850,45,30-34,1895,8.704657320378475E-4
STAT,1857,19,35-39,1876,0.0047712349590683725
STAT,1859,32,50-100,1891,0.007282474392076806
STAT,1915,43,25-29,1958,7.115953279574922E-4
STAT,1853,53,na,1906,13.314979592519176
STAT,1937,35,25-29,1972,0.0098004373934638
STAT,1942,29,20-24,1971,0.19000138615826562
STAT,1919,27,20-24,1946,0.1955220500584257
SIM,1871,16,na,1887,26
STAT,1906,50,na,1956,31.908054610363315
STAT,1880,31,50-100,1911,0.009674182390094158
STAT,1847,38,na,1885,25.842577681277174
STAT,1904,26,25-29,1930,0.6082132082478892
STAT,1906,34,35-39,1940,0.08375739329132136
STAT,1851,43,na,1894,19.37124872479472
STAT,1862,46,20-24,1908,1.0382570551734575E-4
STAT,1923,20,20-24,1943,1.2925020949406165
STAT,1930,18,20-24,1948,1.7400088956033328
SIM,1826,88,na,1914,1
STAT,1921,23,20-24,1944,1.2422807273718213
SIM,1793,84,na,1877,3
STAT,1877,30,25-29,1907,0.10658029182228416
SIM,1912,26,25-29,1938,1
STAT,1932,26,30-34,1958,0.5113628933054237
STAT,1869,27,45-49,1896,0.010758186624945718
STAT,1927,33,40-44,1960,0.04786307598283395
STAT,1875,21,30-34,1896,0.18365276402266684
STAT,1893,17,40-44,1910,0.0023061832512534033
SIM,1914,14,na,1928,37
STAT,1858,49,50-100,1907,0.0018298593532297778
SIM,1918,28,na,1946,38
STAT,1852,27,50-100,1879,0.006376720196208565
SIM,1884,42,na,1926,22
SIM,1839,55,na,1894,20
STAT,1859,23,na,1882,19.3633265890833
SIM,1834,83,na,1917,3
STAT,1943,16,35-39,1959,0.04418519324015709
STAT,1924,16,50-100,1940,0.004443395642369329
STAT,1843,48,na,1891,9.423763431346298
STAT,1838,61,na,1899,14.50335221484888
STAT,1902,29,25-29,1931,0.5922654850259841
STAT,1875,33,25-29,1908,0.10484373331687837
STAT,1934,21,35-39,1955,0.12604428628945322
SIM,1928,0,na,1928,59
SIM,1941,28,na,1969,48
STAT,1892,30,20-24,1922,0.03366221841790784
STAT,1810,47,40-44,1857,0.0016696069822235485
STAT,1910,23,45-49,1933,0.010469439159824108
STAT,1864,93,na,1957,0.34030527844372355
SIM,1800,71,na,1871,8
STAT,1892,38,50-100,1930,0.015092396519332066
STAT,1911,16,15-19,1927,0.09045254668020845
STAT,1930,29,30-34,1959,0.4954025212530304
STAT,1904,39,30-34,1943,0.01631725554522225
STAT,1796,80,na,1876,0.5131631218199021
STAT,1892,25,na,1917,29.68331486037391
STAT,1913,20,50-100,1933,0.006360421939141559
SIM,1858,34,na,1892,24
SIM,1854,20,na,1874,16
STAT,1911,16,50-100,1927,7.467187262790763E-4
STAT,1939,27,25-29,1966,0.6571513451396322
STAT,1932,24,35-39,1956,0.1226217880053742
STAT,1916,41,40-44,1957,0.0025449714789310372
STAT,1876,17,35-39,1893,0.005572941097968968
STAT,1937,19,15-19,1956,0.4374158268715313
STAT,1896,15,na,1911,33.32888037340633
STAT,1866,46,35-39,1912,0.0012930349488117017
SIM,1858,10,na,1868,27
STAT,1894,37,50-100,1931,0.01573465166802581
STAT,1914,44,40-44,1958,0.0024497252283497127
STAT,1849,31,30-34,1880,0.15840326062560026
STAT,1866,40,20-24,1906,0.0014773972799722898
STAT,1881,65,na,1946,16.08072739238122
STAT,1856,98,na,1954,0.0235335156890107
STAT,1870,40,40-44,1910,0.022569508911381892
STAT,1818,43,50-100,1861,0.011019755922883304
STAT,1843,25,50-100,1868,0.0033879647033417427
SIM,1829,37,na,1866,20
STAT,1883,43,30-34,1926,0.011083567305411473
SIM,1825,47,na,1872,17
SIM,1821,33,na,1854,17
SIM,1953,7,na,1960,50
STAT,1914,33,30-34,1947,0.1566132612457076
STAT,1852,84,na,1936,2.8470919792815637
SIM,1945,19,15-19,1964,1
STAT,1863,33,50-100,1896,0.00807818185441282
STAT,1940,32,15-19,1972,0.0013205286939600104
STAT,1794,97,na,1891,0.011655262454382132
STAT,1870,22,na,1892,23.494122826644993
SIM,1922,33,30-34,1955,1
STAT,1809,64,na,1873,11.930743333970634
STAT,1866,50,50-100,1916,1.4109236951883317E-4
STAT,1864,49,35-39,1913,0.001229474146172609
STAT,1840,20,50-100,1860,0.0041225986245348135
STAT,1865,27,30-34,1892,0.22776709578444992
STAT,1868,99,na,1967,0.09398382291164308
STAT,1934,23,30-34,1957,0.3844850710292916
STAT,1863,19,20-24,1882,0.16108044742356709
STAT,1915,29,35-39,1944,0.1507275579810385
STAT,1917,26,35-39,1943,0.15655413593423367
STAT,1958,7,na,1965,51.331765963068605
STAT,1864,43,20-24,1907,0.001414140656450237
STAT,1881,46,30-34,1927,9.237092047119071E-4
SIM,1888,32,na,1920,38
STAT,1930,16,25-29,1946,0.5590051137640223
SIM,1906,23,20-24,1929,1
STAT,1866,17,na,1883,23.874877029943235
STAT,1835,19,45-49,1854,7.859319266818868E-4
STAT,1818,104,na,1922,1.6668530200612111E-4
STAT,1844,89,na,1933,0.8205678636789404
SIM,1934,34,na,1968,51
SIM,1804,61,na,1865,11
SIM,1892,77,na,1969,12
STAT,1876,94,na,1970,0.9139962908004181
SIM,1916,33,30-34,1949,1
STAT,1830,27,15-19,1857,0.004110555382754722
STAT,1890,9,na,1899,31.517083365244005
STAT,1938,34,25-29,1972,0.09220330586209237
SIM,1847,24,25-29,1871,2
STAT,1849,40,15-19,1889,1.089516847884212E-4
SIM,1859,75,na,1934,7
STAT,1896,41,45-49,1937,0.0013713318691606267
STAT,1831,82,na,1913,3.78628706915142
STAT,1869,7,na,1876,26.71937088878341
STAT,1869,21,30-34,1890,0.17311165175071647
STAT,1852,16,40-44,1868,0.001904476139655266
STAT,1910,25,40-44,1935,0.045420237314372384
STAT,1894,33,35-39,1927,0.12923995260662463
STAT,1865,16,20-24,1881,0.16621917719495333
STAT,1909,39,na,1948,35.05432985921668
STAT,1908,33,30-34,1941,0.147319758526447
STAT,1861,29,50-100,1890,0.005341079961117366
STAT,1899,38,40-44,1937,0.012870153933701433
STAT,1894,44,45-49,1938,0.0013139765322116306
SIM,1926,39,na,1965,46
STAT,1830,38,25-29,1868,0.016490848166673382
STAT,1839,37,30-34,1876,0.03514723428814094
SIM,1905,21,na,1926,38
STAT,1934,29,45-49,1963,0.02311924003988638
STAT,1851,32,25-29,1883,0.09000105415253026
SIM,1846,25,na,1871,12
STAT,1945,24,15-19,1969,0.057883180014638005
STAT,1867,58,na,1925,18.924827985472845
STAT,1944,24,50-100,1968,0.007048125963100748
STAT,1805,74,na,1879,3.8179971427502375
SIM,1881,5,na,1886,27
STAT,1907,16,25-29,1923,0.08309373822986713
STAT,1928,24,15-19,1952,0.06572365987994977
STAT,1792,90,na,1882,0.623996742238894
STAT,1848,27,30-34,1875,0.194413658220883
STAT,1904,28,20-24,1932,0.16750716471959456
STAT,1871,63,na,1934,17.789519708717464
STAT,1886,5,na,1891,27.18300050305505
SIM,1851,55,na,1906,15
STAT,1844,42,35-39,1886,0.014485997034103838
STAT,1788,85,na,1873,1.0432251700062092
SIM,1842,19,na,1861,29
STAT,1912,36,30-34,1948,0.017734370671317556
STAT,1784,79,na,1863,3.835020229434802
STAT,1862,27,na,1889,20.665983098979027
SIM,1896,67,na,1963,21
STAT,1889,15,25-29,1904,0.06970190030784196
STAT,1848,16,20-24,1864,0.14296819485528608
STAT,1780,106,na,1886,2.4447077846737037E-4
STAT,1844,53,45-49,1897,1.1153570027384539E-4
STAT,1798,87,na,1885,1.0654757558796748
STAT,1936,34,20-24,1970,0.023518273258703114
STAT,1899,31,15-19,1930,0.0019574332883489764
STAT,1927,31,45-49,1958,0.019269173344311028
STAT,1823,42,20-24,1865,0.0011257048242264887
STAT,1930,16,na,1946,47.48018869666378
SIM,1898,34,na,1932,32
STAT,1899,22,30-34,1921,0.2438383334959109
SIM,1821,73,na,1894,3
STAT,1885,40,30-34,1925,0.011467701371876603
STAT,1889,17,20-24,1906,0.21705603011011967
SIM,1916,20,25-29,1936,2
STAT,1823,48,35-39,1871,9.600985881836961E-4
STAT,1852,68,na,1920,13.079051361617873
STAT,1840,48,35-39,1888,0.0010921821584177667
STAT,1840,42,20-24,1882,0.0012981375569359821
STAT,1914,47,45-49,1961,0.0021376102295428763
SIM,1814,63,na,1877,20
SIM,1772,82,na,1854,3
STAT,1834,20,30-34,1854,0.17079259985809012
STAT,1821,48,25-29,1869,8.019093713433956E-4
STAT,1829,39,50-100,1868,0.011018782727561712
STAT,1889,45,na,1934,27.820130776443246
STAT,1839,26,20-24,1865,0.08214861904768991
SIM,1876,47,na,1923,28
STAT,1890,33,20-24,1923,0.032695572824840584
STAT,1890,39,35-39,1929,0.0850502858982885
STAT,1923,39,40-44,1962,0.017188584408020367
STAT,1858,30,15-19,1888,0.0011063834472760502
STAT,1856,74,na,1930,8.03967852433121
STAT,1881,30,45-49,1911,0.01672660432453236
SIM,1850,30,na,1880,21
STAT,1853,32,35-39,1885,0.06554292644578584
SIM,1894,20,na,1914,28
STAT,1821,37,15-19,1858,0.0011478460155581454
STAT,1927,12,na,1939,49.01452754238252
STAT,1810,45,45-49,1855,0.0023624468244207272
STAT,1924,16,25-29,1940,0.513952866364256
STAT,1825,42,25-29,1867,0.006244710741094234
STAT,1839,24,25-29,1863,0.40010334462146124
SIM,1897,17,20-24,1914,2
STAT,1908,20,25-29,1928,0.8498121255604059
STAT,1834,32,25-29,1866,0.09271717456609506
SIM,1893,19,na,1912,37
STAT,1858,37,40-44,1895,0.033310375013124637
STAT,1822,46,na,1868,9.367564150014534
SIM,1875,22,na,1897,17
SIM,1868,12,na,1880,38
SIM,1880,52,na,1932,30
SIM,1959,10,na,1969,51
STAT,1889,28,30-34,1917,0.3072247303076015
STAT,1901,19,na,1920,35.15050211779611
STAT,1947,24,25-29,1971,1.0361081860486179
STAT,1871,39,25-29,1910,0.028416696967924895
STAT,1845,21,45-49,1866,0.005096916674442889
STAT,1908,31,35-39,1939,0.08616188967127016
STAT,1913,44,na,1957,35.795235098312034
SIM,1817,68,na,1885,3
STAT,1919,34,15-19,1953,0.0013626278746123608
STAT,1911,3,na,1914,40.194830088608406
SIM,1932,16,25-29,1948,2
STAT,1835,96,na,1931,0.038622171827534295
SIM,1931,20,20-24,1951,2
STAT,1906,34,na,1940,34.6642612382824
STAT,1908,39,45-49,1947,0.00628567279714393
STAT,1923,37,45-49,1960,0.007844270524154534
STAT,1900,18,35-39,1918,0.007588915666941816
STAT,1849,47,50-100,1896,0.001895482799631321
STAT,1893,50,na,1943,27.53969837965401
STAT,1815,39,40-44,1854,0.07007910010692497
STAT,1895,17,45-49,1912,8.480528377473263E-4
STAT,1906,20,20-24,1926,1.0071451789385462
STAT,1921,26,25-29,1947,0.7303453694740306
SIM,1932,4,na,1936,55
STAT,1851,46,45-49,1897,0.001998041702554714
STAT,1905,7,na,1912,37.60157784760286
STAT,1846,96,na,1942,0.0695886864145435
SIM,1905,37,na,1942,40
SIM,1867,27,na,1894,15
STAT,1920,14,na,1934,43.93335424805581
STAT,1851,100,na,1951,0.008962735591046992
STAT,1887,15,15-19,1902,0.06507704012416746
STAT,1918,24,50-100,1942,0.006988403808834902
STAT,1853,43,45-49,1896,0.009338154778897283
STAT,1874,17,30-34,1891,0.016169668571727247
STAT,1865,2,na,1867,30.674260570085384
STAT,1875,24,35-39,1899,0.05960984149362528
STAT,1850,16,30-34,1866,0.017444232800322902
STAT,1932,6,na,1938,52.85794790937793
STAT,1875,47,50-100,1922,0.0025128560221151677
STAT,1845,38,15-19,1883,3.413274344775184E-4
STAT,1875,30,20-24,1905,0.028009227484164623
STAT,1917,23,30-34,1940,0.3017543262647715
STAT,1910,20,40-44,1930,0.03157008768429129
SIM,1836,66,na,1902,1
SIM,1914,20,20-24,1934,3
STAT,1916,44,45-49,1960,0.0016853276937946603
SIM,1859,7,na,1866,26
STAT,1902,26,20-24,1928,0.16600309043206252
STAT,1923,23,25-29,1946,1.0640153479434595
STAT,1847,46,25-29,1893,6.170514733793691E-4
STAT,1939,15,30-34,1954,0.1214684098566519
SIM,1879,12,na,1891,17
STAT,1828,26,45-49,1854,0.018120998909294965
SIM,1797,58,na,1855,2
STAT,1826,29,45-49,1855,0.029035368469402818
SIM,1831,35,na,1866,10
STAT,1838,21,na,1859,21.686025487319498
STAT,1862,49,25-29,1911,4.8657643554108726E-4
STAT,1864,53,na,1917,19.002174789707897
SIM,1839,15,na,1854,24
STAT,1806,99,na,1905,0.008861762792268331
STAT,1862,38,15-19,1900,4.8207866830599934E-4
STAT,1931,33,30-34,1964,0.2054022940490837
SIM,1912,31,na,1943,38
STAT,1894,30,25-29,1924,0.1323235401670812
STAT,1823,71,na,1894,7.676279409653871
SIM,1894,20,25-29,1914,4
STAT,1886,46,50-100,1932,0.0025547589586665947
SIM,1884,82,na,1966,7
STAT,1902,18,45-49,1920,9.187557800086964E-4
STAT,1886,39,15-19,1925,5.76610026971855E-4
STAT,1930,32,na,1962,48.58050323462477
SIM,1939,2,na,1941,31
STAT,1921,35,15-19,1956,2.1311703288824752E-4
STAT,1885,71,na,1956,13.485206282404867
STAT,1888,47,25-29,1935,6.699743760344145E-4
STAT,1883,40,20-24,1923,0.0015577653084089824
STAT,1901,59,na,1960,28.291229105333073
SIM,1860,2,na,1862,33
STAT,1841,29,40-44,1870,0.035897038945227916
STAT,1878,17,45-49,1895,6.744010069334549E-4
STAT,1928,44,50-100,1972,0.0014853720297241075
STAT,1842,42,30-34,1884,0.008924241845202883
STAT,1937,4,na,1941,39.017680237644726
SIM,1847,10,na,1857,25
STAT,1897,22,20-24,1919,0.9151271818294481
STAT,1913,16,25-29,1929,0.08807711890188057
STAT,1814,94,na,1908,0.08906232911054368
STAT,1891,17,30-34,1908,0.01956257654075647
STAT,1881,49,35-39,1930,0.0013043463118250426
STAT,1896,6,na,1902,34.314253497122586
STAT,1843,26,40-44,1869,0.015751314369334125
STAT,1847,81,na,1928,5.776646554995612
STAT,1825,45,35-39,1870,0.001327283182940957
STAT,1908,36,50-100,1944,0.003929381566381735
SIM,1850,14,na,1864,22
STAT,1833,42,50-100,1875,0.009477480969368315
STAT,1841,41,na,1882,23.810990654236456
STAT,1872,88,na,1960,2.2677626591361615
STAT,1949,2,na,1951,46.35548700902948
SIM,1802,78,na,1880,2
STAT,1827,53,45-49,1880,1.036818883139466E-4
STAT,1893,10,na,1903,32.66083410890752
STAT,1928,24,45-49,1952,0.01389214673063358
STAT,1827,42,35-39,1869,0.014163226823340267
SIM,1843,60,na,1903,18
STAT,1943,27,15-19,1970,0.007463686899565284
SIM,1909,11,na,1920,41
STAT,1918,41,45-49,1959,0.0017560251134677743
STAT,1868,40,25-29,1908,0.00627715051964053
STAT,1927,44,20-24,1971,2.1962286529464154E-4
STAT,1939,24,20-24,1963,1.1082920653146155
STAT,1905,43,30-34,1948,0.0011438930097803428
STAT,1776,84,na,1860,0.7098072202413207
STAT,1875,53,na,1928,21.7779444604195
SIM,1853,19,na,1872,27
STAT,1859,17,35-39,1876,0.005062477634081034
SIM,1832,26,30-34,1858,1
STAT,1854,16,45-49,1870,4.8045688551710564E-4
STAT,1900,43,50-100,1943,0.0010099514753276358
STAT,1849,34,35-39,1883,0.0810444262538219
STAT,1832,35,25-29,1867,0.016682257299709964
STAT,1873,16,50-100,1889,5.010479890243327E-4
STAT,1917,34,na,1951,38.90809253611766
SIM,1882,16,na,1898,31
SIM,1938,24,na,1962,35
STAT,1840,43,na,1883,18.651575329810946
STAT,1834,71,na,1905,9.43297540705919
STAT,1822,102,na,1924,0.0010399374530934786
SIM,1855,45,na,1900,14
STAT,1921,29,35-39,1950,0.16483500602433437
STAT,1902,26,15-19,1928,0.006420009073710195
STAT,1848,19,25-29,1867,0.04489545751597665
STAT,1908,34,45-49,1942,0.014649686291087934
SIM,1796,89,na,1885,1
STAT,1862,49,30-34,1911,8.177187398320491E-4
STAT,1846,50,45-49,1896,1.1930282666740166E-4
STAT,1843,91,na,1934,0.2458109179332185
STAT,1852,19,45-49,1871,6.68221933199271E-4
STAT,1914,45,25-29,1959,5.241773329790503E-4
STAT,1869,24,35-39,1893,0.056188417182146275
SIM,1864,22,na,1886,23
STAT,1909,27,15-19,1936,0.0067088880944383466
STAT,1904,23,15-19,1927,0.04712533933834252
SIM,1860,91,na,1951,1
STAT,1882,16,20-24,1898,0.17031755604936788
SIM,1864,81,na,1945,4
STAT,1923,34,40-44,1957,0.044494277187347823
STAT,1837,29,20-24,1866,0.0725962454697276
SIM,1849,21,25-29,1870,1
SIM,1867,70,na,1937,6
STAT,1875,49,40-44,1924,0.0017230929345911378
STAT,1938,31,20-24,1969,0.024378330759689638
STAT,1905,49,na,1954,31.79858154672563
STAT,1933,18,50-100,1951,0.004981789588820223
STAT,1845,74,na,1919,6.487256183385596
STAT,1892,36,35-39,1928,0.0877999743852942
STAT,1872,35,50-100,1907,0.012681200009038763
STAT,1912,22,40-44,1934,0.031971367099538114
SIM,1887,47,na,1934,24
SIM,1806,68,na,1874,5
STAT,1925,47,20-24,1972,1.3307498782722449E-4
STAT,1782,102,na,1884,6.557127023419419E-4
STAT,1915,24,35-39,1939,0.09588669027498774
STAT,1948,17,25-29,1965,0.49265664035267853
STAT,1826,36,na,1862,20.087735929660347
STAT,1871,28,15-19,1899,0.004507493515818103
STAT,1864,51,50-100,1915,1.3610814094273298E-4
STAT,1906,36,30-34,1942,0.016792796023143857
STAT,1910,55,na,1965,32.99800162924091
STAT,1938,32,50-100,1970,0.008258637370448399
STAT,1892,47,45-49,1939,0.001636952494668558
SIM,1847,50,na,1897,15
STAT,1912,33,20-24,1945,0.02371294142865273
STAT,1858,34,30-34,1892,0.13172130773249816
SIM,1872,57,na,1929,20
STAT,1920,42,45-49,1962,0.0018224691780964269
STAT,1934,24,45-49,1958,0.015046689637861882
SIM,1931,8,na,1939,63
STAT,1868,54,45-49,1922,1.3658110970662325E-4
STAT,1878,45,na,1923,23.459321777215738
STAT,1949,21,25-29,1970,1.0712998792957973
STAT,1834,48,40-44,1882,0.0012667362951045262
STAT,1922,22,50-100,1944,0.007490440865504466
STAT,1886,20,25-29,1906,0.5973323306998191
STAT,1901,31,25-29,1932,0.14390728890946033
STAT,1840,45,30-34,1885,7.8475587922086E-4
STAT,1863,68,na,1931,13.530624591704228
STAT,1845,49,25-29,1894,3.296700845044673E-4
STAT,1942,30,50-100,1972,0.00875301452348465
SIM,1966,1,na,1967,45
STAT,1941,19,35-39,1960,0.042878827640799366
SIM,1898,10,na,1908,37
STAT,1889,61,na,1950,22.878297682373802
STAT,1919,39,20-24,1958,0.002801450109682637
SIM,1818,53,na,1871,24
STAT,1868,43,35-39,1911,0.0173974753669579
SIM,1825,36,40-44,1861,1
STAT,1858,23,20-24,1881,0.5435785086638419
SIM,1922,49,na,1971,48
STAT,1902,15,35-39,1917,0.007773774132924579
STAT,1874,31,na,1905,24.30785355116977
STAT,1892,65,na,1957,21.387945628918985
STAT,1917,37,15-19,1954,1.976459741036869E-4
SIM,1869,53,na,1922,15
STAT,1926,30,na,1956,45.52163643957743
STAT,1925,36,40-44,1961,0.01787097765474403
STAT,1873,36,25-29,1909,0.02941347583631049
SIM,1929,28,na,1957,47
STAT,1855,33,na,1888,16.930468181615275
STAT,1784,95,na,1879,0.036148882489688575
STAT,1839,27,50-100,1866,0.0044472365046696145
SIM,1835,25,na,1860,21
STAT,1860,63,na,1923,14.505906573272586
STAT,1834,23,35-39,1857,0.054756742228906426
STAT,1781,90,na,1871,0.4345565878317502
STAT,1844,38,50-100,1882,0.010029139951598888
SIM,1866,23,20-24,1889,1
STAT,1939,18,40-44,1957,0.013900267470924444
STAT,1856,21,20-24,1877,0.5839963367939472
STAT,1928,27,25-29,1955,0.8069343153340512
STAT,1839,33,15-19,1872,9.571324568721096E-4
STAT,1857,36,50-100,1893,0.009235217687253959
SIM,1851,71,na,1922,14
SIM,1920,33,20-24,1953,2
STAT,1903,30,45-49,1933,0.024991784303180862
SIM,1912,23,20-24,1935,3
STAT,1859,35,50-100,1894,0.009850982650002935
STAT,1851,35,35-39,1886,0.06161767936751471
STAT,1869,24,40-44,1893,0.02006448808646401
STAT,1904,23,20-24,1927,0.984389513914616
SIM,1926,23,na,1949,41
STAT,1876,19,na,1895,25.513649161494047
STAT,1812,42,45-49,1854,0.017597258550688246
STAT,1821,45,20-24,1866,1.747159497250422E-4
STAT,1875,30,15-19,1905,0.0014756353119696245
STAT,1884,27,40-44,1911,0.029349095702835844
STAT,1875,93,na,1968,1.1118824376750345
SIM,1927,24,na,1951,52
STAT,1853,40,40-44,1893,0.01427891623798382
STAT,1938,31,15-19,1969,0.0012843455156416367
STAT,1939,18,35-39,1957,0.04170079999834661
STAT,1897,37,25-29,1934,0.03823445430082298
STAT,1830,32,50-100,1862,0.0060273701297554536
STAT,1854,32,na,1886,14.936912712467098
STAT,1826,102,na,1928,0.0020487563399730568
STAT,1928,34,na,1962,46.99861257967744
SIM,1874,80,na,1954,13
STAT,1865,94,na,1959,0.304738323564511
STAT,1847,23,45-49,1870,0.009066239073769652
SIM,1796,73,na,1869,5
STAT,1850,19,35-39,1869,0.005899900035281921
STAT,1889,19,40-44,1908,0.0022273310028909977
STAT,1910,22,30-34,1932,0.26825878533660036
STAT,1955,11,na,1966,51.86052515594341
SIM,1900,62,na,1962,24
STAT,1825,30,30-34,1855,0.2556759497498868
SIM,1872,17,na,1889,26
STAT,1842,39,50-100,1881,0.009631153306927294
STAT,1862,20,50-100,1882,0.0036538968355749194
STAT,1839,21,15-19,1860,0.02356155280508914
STAT,1888,32,20-24,1920,0.031587891299774955
STAT,1828,31,50-100,1859,0.012800066130522536
STAT,1834,35,35-39,1869,0.06347722361817917
STAT,1838,40,45-49,1878,0.01393735652957668
STAT,1845,55,na,1900,12.086795569545963
STAT,1862,23,40-44,1885,0.018272110025344065
STAT,1946,21,50-100,1967,0.007272978073294535
STAT,1834,46,45-49,1880,0.001968706312019131
STAT,1936,34,15-19,1970,0.0012390343331216045
STAT,1928,28,30-34,1956,0.48013482629844906
STAT,1940,23,25-29,1963,0.9339738101599736
SIM,1915,39,na,1954,36
STAT,1811,46,na,1857,17.28269320383007
STAT,1932,27,45-49,1959,0.02253651739155974
STAT,1899,35,30-34,1934,0.07365127704487233
STAT,1868,42,50-100,1910,0.010211176391485721
STAT,1880,40,na,1920,24.549148491748188
STAT,1846,19,15-19,1865,0.05970774908360685
STAT,1874,68,na,1942,15.50343280899472
STAT,1820,82,na,1902,2.645171665667039
STAT,1895,17,na,1912,32.78881371369823
STAT,1814,44,15-19,1858,4.101891539719992E-4
STAT,1899,24,20-24,1923,0.9374606651710081
SIM,1889,57,na,1946,22
STAT,1948,15,50-100,1963,0.004261536767943023
SIM,1885,43,na,1928,23
STAT,1864,20,40-44,1884,0.019266383557842156
STAT,1832,39,40-44,1871,0.024331644565335347
STAT,1917,37,20-24,1954,0.0027131398486130017
STAT,1947,16,na,1963,41.190637251612806
STAT,1931,40,25-29,1971,9.523846927301564E-4
STAT,1903,27,50-100,1930,0.009094718926822142
STAT,1883,43,25-29,1926,0.006190821403127112
SIM,1871,32,na,1903,24
STAT,1891,30,50-100,1921,0.011336060476204751
STAT,1910,39,25-29,1949,0.009265034115022233
STAT,1841,25,25-29,1866,0.5217385465272528
STAT,1904,35,15-19,1939,1.7532246284558242E-4
STAT,1890,36,30-34,1926,0.06505012582434756
STAT,1855,73,na,1928,8.36260796757972
SIM,1873,58,na,1931,18
STAT,1866,38,50-100,1904,0.01125120024041202
SIM,1906,62,na,1968,20
SIM,1836,63,na,1899,1
STAT,1919,34,20-24,1953,0.02586421848724843
STAT,1823,45,30-34,1868,6.888799176240491E-4
STAT,1886,56,na,1942,21.156436541074925
STAT,1892,21,30-34,1913,0.2207186706266235
STAT,1931,17,na,1948,47.964096768248346
STAT,1854,29,20-24,1883,0.07409644389926082
SIM,1863,37,na,1900,12
STAT,1886,47,20-24,1933,1.238916675268125E-4
STAT,1876,35,na,1911,24.155632754837956
STAT,1899,22,25-29,1921,0.7836544274925311
STAT,1894,41,40-44,1935,0.028956969963651873
STAT,1954,18,30-34,1972,0.1497743550294256
STAT,1825,51,na,1876,13.119229188983262
STAT,1830,81,na,1911,1.9429241534186446
STAT,1843,29,45-49,1872,0.005713356501741796
STAT,1905,65,na,1970,27.728440880991112
STAT,1928,2,na,1930,51.28128524105726
STAT,1843,23,30-34,1866,0.09416049657673158
STAT,1922,43,30-34,1965,0.0014543623790472318
STAT,1875,47,45-49,1922,0.0024146336408515457
STAT,1829,65,na,1894,11.479104393784365
SIM,1895,42,na,1937,27
STAT,1845,20,30-34,1865,0.13113647490586658
STAT,1865,23,15-19,1888,0.029985125967967912
SIM,1940,0,na,1940,37
SIM,1923,2,na,1925,42
STAT,1901,2,na,1903,37.29975293307534
SIM,1895,8,na,1903,31
SIM,1848,51,na,1899,29
STAT,1877,32,45-49,1909,0.018000797397330032
STAT,1943,26,na,1969,39.62400102198939
STAT,1797,62,na,1859,7.871407781162058
STAT,1950,0,na,1950,51.76800460202804
SIM,1841,34,na,1875,15
STAT,1902,15,40-44,1917,0.002591258194338952
STAT,1910,39,na,1949,35.40183462676324
SIM,1923,31,na,1954,39
STAT,1875,36,35-39,1911,0.07305547795843623
STAT,1910,20,35-39,1930,0.0884085977991432
STAT,1894,21,50-100,1915,0.0052419871839625215
STAT,1882,23,20-24,1905,0.6583779056056817
STAT,1865,19,25-29,1884,0.05219682612381185
STAT,1879,41,45-49,1920,0.01556046578168573
STAT,1912,48,25-29,1960,5.043962857825781E-4
STAT,1901,33,45-49,1934,0.024297791976753604
STAT,1930,25,15-19,1955,0.0089422932745743
SIM,1937,23,na,1960,40
STAT,1898,41,na,1939,31.42788456112669
STAT,1894,30,30-34,1924,0.22556095525578854
SIM,1837,88,na,1925,1
STAT,1837,33,50-100,1870,0.005546674574787141
SIM,1942,13,na,1955,43
STAT,1906,37,45-49,1943,0.006251126432242236
STAT,1878,42,na,1920,23.83226738772974
SIM,1869,29,30-34,1898,1
STAT,1877,34,40-44,1911,0.044382964944055886
STAT,1817,56,na,1873,19.659656854707517
STAT,1890,46,50-100,1936,0.0016876133448842038
STAT,1910,28,45-49,1938,0.016522417231135136
STAT,1844,33,na,1877,20.034307604990225
SIM,1861,33,na,1894,22
STAT,1888,24,45-49,1912,0.008097872735502228
STAT,1906,39,35-39,1945,0.02195586994953138
SIM,1915,36,na,1951,36
STAT,1871,22,50-100,1893,0.004065671831214692
STAT,1906,20,15-19,1926,0.04821471343362099
STAT,1844,92,na,1936,0.32532151177132557
STAT,1790,67,na,1857,4.4708482605199995
STAT,1822,86,na,1908,0.7870294603958816
STAT,1862,21,45-49,1883,0.006203301537901741
STAT,1864,46,30-34,1910,8.706863932370171E-4
STAT,1918,35,na,1953,39.668748120564764
STAT,1810,50,50-100,1860,1.4804857709683588E-4
STAT,1857,43,na,1900,17.177139891484863
STAT,1866,36,na,1902,21.802549330323057
STAT,1879,83,na,1962,6.215819170178052
STAT,1862,43,na,1905,19.796513041680573
STAT,1915,17,40-44,1932,0.0029021549804294803
STAT,1873,24,25-29,1897,0.5783684143500126
STAT,1925,33,30-34,1958,0.18580554894143045
STAT,1880,19,20-24,1899,0.18542516200441278
STAT,1884,24,30-34,1908,0.17342368946809253
SIM,1890,7,na,1897,31
SIM,1938,24,25-29,1962,2
SIM,1883,57,na,1940,9
SIM,1881,21,20-24,1902,3
STAT,1917,38,50-100,1955,0.004299825714934997
STAT,1881,25,na,1906,22.86286924380945
SIM,1828,52,na,1880,12
SIM,1908,23,30-34,1931,3
STAT,1866,57,na,1923,18.50833078819401
SIM,1825,33,30-34,1858,1
STAT,1916,43,30-34,1959,0.0012968811259540854
SIM,1807,53,na,1860,15
STAT,1941,16,30-34,1957,0.12467118757865929
STAT,1868,40,30-34,1908,0.01123812427144022
STAT,1845,58,na,1903,11.560023045752121
SIM,1803,79,na,1882,1
SIM,1925,38,na,1963,43
SIM,1890,14,na,1904,31
STAT,1806,49,40-44,1855,0.005607171548238281
STAT,1862,47,50-100,1909,0.0021090712762765708
STAT,1847,34,25-29,1881,0.11450262461056078
STAT,1836,31,45-49,1867,0.021494584079340715
STAT,1914,30,20-24,1944,0.024544849482871032
SIM,1786,71,na,1857,17
STAT,1867,98,na,1965,0.12102428912816564
STAT,1817,39,45-49,1856,0.06964632358632224
STAT,1833,30,na,1863,21.08836986176865
STAT,1867,27,40-44,1894,0.028666365159731012
STAT,1916,49,na,1965,37.14026909725536
SIM,1869,18,20-24,1887,1
SIM,1890,23,20-24,1913,2
STAT,1868,51,40-44,1919,1.0236829459811197E-4
STAT,1921,26,30-34,1947,0.43477224863774544
STAT,1890,20,45-49,1910,0.00852092448694154
STAT,1914,49,40-44,1963,0.0015415840510648836
SIM,1803,60,na,1863,9
STAT,1842,42,25-29,1884,0.0049847116816794145
STAT,1935,15,50-100,1950,0.005122756761176165
SIM,1874,83,na,1957,10
STAT,1925,20,25-29,1945,1.105291133010386
STAT,1851,20,30-34,1871,0.18218602898440442
STAT,1829,25,na,1854,18.6334189014576
SIM,1859,35,na,1894,17
STAT,1846,42,50-100,1888,0.008665432736596139
STAT,1836,33,40-44,1869,0.05235626885621039
STAT,1901,45,45-49,1946,0.0018813289068707092
STAT,1917,50,na,1967,37.68150333659361
SIM,1888,72,na,1960,20
STAT,1856,36,25-29,1892,0.02095825455655839
SIM,1933,20,25-29,1953,2
STAT,1945,24,20-24,1969,1.209107377017474
SIM,1874,21,na,1895,25
STAT,1892,17,50-100,1909,6.052494146277077E-4
STAT,1928,29,15-19,1957,0.00864618217084728
STAT,1869,68,na,1937,14.807338714731946
SIM,1904,36,na,1940,29
SIM,1901,47,na,1948,37
STAT,1865,54,na,1919,18.939576028300642
SIM,1948,23,na,1971,36
STAT,1868,43,na,1911,22.20534063195402
STAT,1849,44,30-34,1893,0.008794099418042992
STAT,1914,49,50-100,1963,0.002211524781921903
STAT,1915,26,30-34,1941,0.3975621495437555
STAT,1892,33,25-29,1925,0.12600392683650272
STAT,1928,24,20-24,1952,1.372885214415282
SIM,1922,3,na,1925,53
STAT,1915,8,na,1923,41.24745714436203
STAT,1925,39,45-49,1964,0.00811361306269293
STAT,1847,20,40-44,1867,0.02768473622042077
STAT,1877,20,na,1897,24.559140443927745
SIM,1862,55,na,1917,21
STAT,1920,25,50-100,1945,0.010899271178801732
STAT,1925,31,35-39,1956,0.10790123624790005
STAT,1841,81,na,1922,5.293083265790978
SIM,1903,11,na,1914,39
STAT,1864,23,45-49,1887,0.00630938427701179
STAT,1926,16,35-39,1942,0.05127836164789573
STAT,1855,40,45-49,1895,0.010643717850709694
STAT,1881,43,20-24,1924,0.0015002585905403427
STAT,1932,29,35-39,1961,0.19565649581760994
SIM,1913,32,na,1945,41
SIM,1840,71,na,1911,4
STAT,1875,3,na,1878,31.68676140811112
SIM,1917,46,na,1963,34
STAT,1854,91,na,1945,0.35419734995546515
SIM,1885,83,na,1968,11
STAT,1783,104,na,1887,1.7566643881648187E-4
SIM,1840,55,na,1895,10
STAT,1855,17,na,1872,19.22251168801098
STAT,1940,20,20-24,1960,1.1254689585323279
STAT,1929,30,50-100,1959,0.010463726165833541
STAT,1821,103,na,1924,8.913554275256554E-4
STAT,1875,23,20-24,1898,0.706191687148301
SIM,1853,59,na,1912,20
STAT,1886,22,45-49,1908,0.00723308176255792
STAT,1841,22,20-24,1863,0.8544897848490925
SIM,1894,57,na,1951,27
SIM,1936,24,20-24,1960,2
STAT,1906,10,na,1916,37.632666181236075
SIM,1897,49,na,1946,38
STAT,1922,46,35-39,1968,0.001473966806999611
STAT,1873,53,50-100,1926,1.510831534632812E-4
STAT,1848,23,15-19,1871,0.025790762528058276
STAT,1825,33,35-39,1858,0.11618730906951036
STAT,1952,17,15-19,1969,0.5406441126044529
STAT,1866,43,25-29,1909,0.005871425337566265
STAT,1929,41,20-24,1970,2.2794258649084305E-4
SIM,1872,73,na,1945,10
STAT,1831,66,na,1897,13.300464213742044
STAT,1905,31,50-100,1936,0.007624041358055779
SIM,1835,22,na,1857,15
STAT,1918,43,40-44,1961,0.0026311371002848646
SIM,1852,40,na,1892,25
STAT,1818,41,na,1859,7.4817190288139885
STAT,1899,46,50-100,1945,0.0019018894768751305
STAT,1885,43,35-39,1928,0.01775287826633763
SIM,1850,70,na,1920,10
SIM,1876,87,na,1963,2
STAT,1816,74,na,1890,3.331783213181358
STAT,1853,69,na,1922,9.22323448995505
STAT,1905,19,30-34,1924,0.022880020536414768
SIM,1812,53,na,1865,18
SIM,1916,21,na,1937,47
STAT,1951,21,35-39,1972,0.11185130743842749
STAT,1866,31,30-34,1897,0.1614579101425288
STAT,1888,35,25-29,1923,0.03396578400141744
STAT,1921,23,15-19,1944,0.0594712763630251
STAT,1849,46,35-39,1895,0.0010886298927793995
STAT,1825,53,50-100,1878,1.3184359223538552E-4
STAT,1864,9,na,1873,24.841025782227266
STAT,1937,18,30-34,1955,0.1175199012097984
STAT,1829,50,45-49,1879,1.245813640534417E-4
SIM,1863,40,na,1903,11
STAT,1921,28,20-24,1949,0.20114341557807525
STAT,1783,101,na,1884,7.13792669190914E-4
STAT,1821,45,na,1866,16.55579157054598
SIM,1930,28,na,1958,47
SIM,1874,43,na,1917,25
SIM,1883,17,na,1900,15
STAT,1835,36,50-100,1871,0.006960181629993275
STAT,1907,35,na,1942,35.06389718312001
SIM,1845,40,na,1885,23
STAT,1921,39,30-34,1960,0.020148778690010947
STAT,1897,34,20-24,1931,0.035588092258160176
STAT,1789,70,na,1859,4.149571137345799
SIM,1816,67,na,1883,6
STAT,1828,62,na,1890,12.275206109959814
SIM,1837,29,na,1866,27
SIM,1922,33,25-29,1955,2
STAT,1845,23,35-39,1868,0.04204284119566236
STAT,1858,21,25-29,1879,0.5034126048575318
STAT,1780,89,na,1869,0.6746718918979661
STAT,1879,17,50-100,1896,5.070708435854006E-4
SIM,1786,74,na,1860,17
STAT,1882,26,25-29,1908,0.4067842378933452
STAT,1912,45,20-24,1957,1.0587146526483347E-4
STAT,1902,40,50-100,1942,0.0010449826780643168
SIM,1898,31,na,1929,33
SIM,1866,21,25-29,1887,1
STAT,1927,26,50-100,1953,0.012080114354523545
STAT,1841,44,na,1885,22.91317572092502
STAT,1856,33,20-24,1889,0.019616848956063887
STAT,1919,37,25-29,1956,0.010486017837574121
STAT,1847,31,20-24,1878,0.034256889375156155
STAT,1860,23,30-34,1883,0.14820558003378445
STAT,1801,53,30-34,1854,1.6708367597987852E-4
SIM,1905,8,na,1913,40
SIM,1824,78,na,1902,5
STAT,1900,15,30-34,1915,0.022204589157737775
STAT,1830,35,20-24,1865,0.0047099785918521065
STAT,1906,34,40-44,1940,0.03586745352154915
SIM,1932,7,na,1939,54
SIM,1814,60,na,1874,20
STAT,1848,18,40-44,1866,0.0014576609688392941
STAT,1832,23,25-29,1855,0.34679077143423787
STAT,1870,43,45-49,1913,0.014760053493243587
STAT,1926,27,15-19,1953,0.008414358801562404
STAT,1876,31,50-100,1907,0.009343838450631657
STAT,1883,41,50-100,1924,0.010305428033926185
STAT,1891,24,na,1915,28.846031620406432
STAT,1870,32,35-39,1902,0.10060111749895438
STAT,1903,43,20-24,1946,1.5566040114630762E-4
STAT,1890,61,na,1951,22.69837042336007
STAT,1893,24,50-100,1917,0.005109548771867121
STAT,1934,26,40-44,1960,0.06246490962344316
STAT,1860,16,50-100,1876,4.6207836812703877E-4
STAT,1819,103,na,1922,7.367050230595761E-4
STAT,1851,48,40-44,1899,0.0014271627818762814
STAT,1860,36,45-49,1896,0.016284505654307935
STAT,1888,21,40-44,1909,0.02442486793618975
SIM,1877,32,na,1909,27
STAT,1858,44,40-44,1902,0.01688471454740205
SIM,1886,46,na,1932,27
SIM,1882,32,na,1914,31
STAT,1860,25,35-39,1885,0.08043454191814972
STAT,1919,42,50-100,1961,0.0012620691161971645
STAT,1839,29,25-29,1868,0.2898778505574978
STAT,1917,24,45-49,1941,0.011775619377804651
STAT,1912,20,45-49,1932,0.010762668922178495
STAT,1934,37,20-24,1971,0.0036223196135735736
STAT,1803,52,45-49,1855,2.8317909396679744E-4
SIM,1870,3,na,1873,30
SIM,1949,3,na,1952,40
STAT,1812,43,35-39,1855,0.020970816428374468
STAT,1892,24,35-39,1916,0.07164065861329941
SIM,1908,26,35-39,1934,1
SIM,1919,28,30-34,1947,1
STAT,1947,21,15-19,1968,0.059770528399676635
STAT,1877,18,50-100,1895,5.043990879402231E-4
STAT,1884,20,15-19,1904,0.03251510518575772
SIM,1802,75,na,1877,4
STAT,1919,20,na,1939,39.877560244030924
STAT,1916,46,35-39,1962,0.001314362747428112
STAT,1831,44,15-19,1875,1.333144892118166E-4
SIM,1881,24,25-29,1905,3
STAT,1889,24,15-19,1913,0.04013814234247656
STAT,1941,16,na,1957,37.648043217947624
STAT,1819,66,na,1885,8.744801893273952
STAT,1888,20,na,1908,27.802814999787156
SIM,1825,63,na,1888,12
STAT,1830,41,na,1871,9.32646719628608
STAT,1920,17,na,1937,40.944510699457474
SIM,1828,74,na,1902,6
STAT,1871,36,20-24,1907,0.00772235624187265
STAT,1913,18,15-19,1931,0.091772777663768
STAT,1925,24,40-44,1949,0.0397449091734302
STAT,1908,36,40-44,1944,0.01401016513208198
STAT,1912,39,35-39,1951,0.02318693894450909
STAT,1812,54,45-49,1866,1.5122030494657977E-4
STAT,1856,58,na,1914,14.326375650114048
SIM,1865,47,na,1912,22
SIM,1921,18,15-19,1939,1
STAT,1808,63,na,1871,3.4843551881797388
STAT,1923,35,25-29,1958,0.011349122462299075
STAT,1892,49,40-44,1941,0.0011681363292983889
STAT,1903,32,40-44,1935,0.06165653731262786
STAT,1952,19,na,1971,43.81891895062166
STAT,1867,23,25-29,1890,0.546125169770727
STAT,1873,21,20-24,1894,0.7027434993573934
STAT,1849,33,20-24,1882,0.02185770648032964
STAT,1945,27,25-29,1972,0.7169288349995796
STAT,1854,31,50-100,1885,0.0057950243443163916
STAT,1851,23,35-39,1874,0.05840951794806095
STAT,1932,24,40-44,1956,0.04378737697128997
SIM,1865,0,na,1865,36
STAT,1901,30,40-44,1931,0.06117010239478243
STAT,1923,1,na,1924,48.697554065373126
STAT,1804,89,na,1893,0.40785109431015093
STAT,1879,86,na,1965,4.525121138321996
STAT,1828,39,20-24,1867,0.0034056508265687636
STAT,1798,84,na,1882,2.0100874447780734
STAT,1849,20,50-100,1869,0.0038784124051437787
STAT,1914,33,25-29,1947,0.09187592392328349
SIM,1849,14,na,1863,17
STAT,1895,7,na,1902,33.82417292621118
STAT,1868,83,na,1951,3.8418229981387815
STAT,1831,45,50-100,1876,0.002412403257389341
STAT,1890,45,20-24,1935,1.4721756121065339E-4
STAT,1867,37,45-49,1904,0.01907688159815303
STAT,1870,25,na,1895,23.86828850498188
SIM,1869,50,na,1919,15
STAT,1861,52,45-49,1913,1.2139324982039401E-4
SIM,1886,68,na,1954,15
SIM,1950,1,na,1951,68
STAT,1838,44,25-29,1882,0.005169986944578579
STAT,1929,22,na,1951,45.95920175772862
STAT,1842,51,50-100,1893,1.1385490872594475E-4
STAT,1874,4,na,1878,29.612234470323262
STAT,1932,25,25-29,1957,0.8593659010300573
STAT,1792,93,na,1885,0.14315935513528052
STAT,1914,9,na,1923,40.704334954964146
STAT,1934,22,25-29,1956,1.2360767351456066
STAT,1874,15,na,1889,25.83716631779873
STAT,1920,35,45-49,1955,0.007413333872686262
STAT,1936,30,35-39,1966,0.0883252552837536
STAT,1884,34,40-44,1918,0.04212529002235555
STAT,1803,70,na,1873,7.492032060824927
STAT,1898,45,35-39,1943,0.001075949232343859
STAT,1849,47,35-39,1896,0.001080486941181409
STAT,1925,32,na,1957,44.63065421075192
STAT,1921,22,15-19,1943,0.05965561220473772
STAT,1930,27,50-100,1957,0.012597111208582873
STAT,1885,52,na,1937,21.150236366849946
STAT,1840,41,45-49,1881,0.012391276202954663
STAT,1820,39,50-100,1859,0.01114468453972921
SIM,1848,29,na,1877,29
SIM,1865,60,na,1925,13
STAT,1880,19,15-19,1899,0.06207028736139287
SIM,1922,46,na,1968,47
STAT,1886,24,35-39,1910,0.060150543923516944
STAT,1796,83,na,1879,0.2720094921895302
SIM,1854,23,na,1877,15
STAT,1912,48,30-34,1960,8.47665988443182E-4
STAT,1915,24,na,1939,37.18796669021076
STAT,1854,88,na,1942,0.8391253817760468
STAT,1860,17,na,1877,21.522482688291852
STAT,1896,18,na,1914,33.08782783318045
STAT,1923,30,25-29,1953,0.10606959389827599
SIM,1823,43,na,1866,11
STAT,1847,39,25-29,1886,0.03125550832209586
STAT,1844,41,45-49,1885,0.012127074922402482
STAT,1892,42,20-24,1934,0.0019595728068233327
SIM,1815,48,na,1863,11
STAT,1784,98,na,1882,0.008293393788430407
STAT,1882,26,30-34,1908,0.24215734803199837
STAT,1855,41,20-24,1896,0.001123214007595742
SIM,1894,24,35-39,1918,1
STAT,1873,48,25-29,1921,5.782566733222448E-4
SIM,1842,22,20-24,1864,1
STAT,1914,30,15-19,1944,0.0012931183712360822
STAT,1856,39,35-39,1895,0.05072290808702682
STAT,1814,51,45-49,1865,4.067068896558079E-4
SIM,1857,65,na,1922,14
STAT,1866,1,na,1867,32.976984589321404
SIM,1840,25,20-24,1865,1
STAT,1824,56,na,1880,15.439679280582727
STAT,1908,15,50-100,1923,7.263306842524804E-4
SIM,1891,15,na,1906,38
STAT,1919,21,50-100,1940,0.007164246847413396
STAT,1867,18,45-49,1885,6.352865730307471E-4
SIM,1910,22,35-39,1932,1
STAT,1863,29,25-29,1892,0.37185889314326087
STAT,1834,22,20-24,1856,0.6513110725927712
SIM,1840,15,na,1855,16
STAT,1882,19,25-29,1901,0.054015503701432176
STAT,1914,49,35-39,1963,0.0012606411661611767
STAT,1858,78,na,1936,5.945509696424552
STAT,1907,40,25-29,1947,6.588621851364976E-4
STAT,1847,46,30-34,1893,0.0010369892916457931
STAT,1853,36,45-49,1889,0.012659461691596305
STAT,1848,18,35-39,1866,0.004372982653327389
STAT,1896,42,20-24,1938,1.4468237910770517E-4
STAT,1940,20,15-19,1960,0.053879186882731585
STAT,1958,4,na,1962,51.35795413394923
STAT,1884,15,40-44,1899,0.0018003221548435104
STAT,1879,34,45-49,1913,0.01789420800951321
STAT,1866,73,na,1939,10.938982877962934
STAT,1924,19,40-44,1943,0.01645929509020791
STAT,1899,60,na,1959,27.007029688765396
STAT,1903,39,na,1942,33.420235306594535
STAT,1884,27,35-39,1911,0.0945355644859931
STAT,1880,50,45-49,1930,1.547987475902846E-4
STAT,1892,48,35-39,1940,9.63363191429985E-4
SIM,1861,70,na,1931,16
STAT,1833,92,na,1925,0.3083486169699797
SIM,1808,54,na,1862,15
SIM,1858,13,na,1871,27
SIM,1870,47,na,1917,21
STAT,1829,100,na,1929,0.007211245293603809
STAT,1846,59,na,1905,15.750379787951003
STAT,1832,25,20-24,1857,0.07120256142512042
STAT,1902,22,35-39,1924,0.08229116083428419
STAT,1929,40,45-49,1969,0.002150971871791688
STAT,1817,43,40-44,1860,0.06893224331489893
STAT,1833,40,30-34,1873,0.010581417451765154
STAT,1886,2,na,1888,30.659695059270195
STAT,1849,48,na,1897,17.22587171391145
STAT,1879,46,na,1925,23.352190488470054
STAT,1865,15,30-34,1880,0.016519058066463647
STAT,1904,27,30-34,1931,0.36082909561558424
STAT,1902,19,20-24,1921,0.24866465531518644
STAT,1918,45,50-100,1963,0.002396346093257452
STAT,1816,43,35-39,1859,0.024292954358716284
STAT,1818,51,45-49,1869,1.4001272807738144E-4
STAT,1913,25,15-19,1938,0.007022667424602707
STAT,1911,34,na,1945,36.27763844713425
STAT,1844,101,na,1945,0.004457112658319734
SIM,1853,75,na,1928,9
SIM,1811,58,na,1869,8
STAT,1819,40,40-44,1859,0.022139792589101443
SIM,1795,70,na,1865,10
STAT,1878,37,20-24,1915,0.007958379218532494
STAT,1882,10,na,1892,24.824228144286387
STAT,1886,31,40-44,1917,0.04516712952738041
STAT,1884,28,50-100,1912,0.006245337402566878
STAT,1889,16,30-34,1905,0.01956217621377703
STAT,1933,30,25-29,1963,0.12418926758173322
SIM,1832,73,na,1905,16
SIM,1859,4,na,1863,26
STAT,1871,23,45-49,1894,0.006930815963904233
STAT,1832,45,50-100,1877,0.0013397558819472181
STAT,1837,36,20-24,1873,0.004622202320022436
STAT,1856,95,na,1951,0.09631731361760489
SIM,1910,21,na,1931,29
SIM,1877,20,25-29,1897,1
SIM,1944,5,na,1949,36
STAT,1859,17,40-44,1876,0.0016874926423974886
STAT,1862,20,30-34,1882,0.1596021964686113
SIM,1863,18,na,1881,17
STAT,1942,30,35-39,1972,0.09674519628050887
STAT,1841,28,na,1869,26.11080978566218
SIM,1795,88,na,1883,2
STAT,1840,30,20-24,1870,0.026339592531846534
STAT,1866,34,35-39,1900,0.09246988292297975
STAT,1821,39,50-100,1860,0.021315150235097297
STAT,1860,26,35-39,1886,0.07985702190717743
STAT,1915,22,15-19,1937,0.054549970691034635
STAT,1908,32,25-29,1940,0.08679021920361117
SIM,1856,30,na,1886,15
STAT,1829,43,45-49,1872,0.013071008300422345
STAT,1923,27,40-44,1950,0.05314323557399499
STAT,1939,19,50-100,1958,0.00372198187454338
STAT,1820,51,45-49,1871,1.2087095338489566E-4
STAT,1841,28,35-39,1869,0.11646316982505714
SIM,1896,30,na,1926,33
STAT,1843,26,35-39,1869,0.05073612524141439
STAT,1867,21,na,1888,22.890170576679203
STAT,1849,43,30-34,1892,0.008850031617867916
STAT,1888,37,20-24,1925,0.009008124931357555
STAT,1894,35,na,1929,30.480768482488592
STAT,1899,26,40-44,1925,0.04114800773668009
STAT,1899,45,40-44,1944,0.0013351733871376802
STAT,1855,33,45-49,1888,0.012372119771989338
STAT,1948,11,na,1959,44.66389203918618
STAT,1887,27,50-100,1914,0.00698229193010722
STAT,1908,20,na,1928,35.10918873800948
STAT,1840,49,40-44,1889,0.0013185807822266137
STAT,1839,25,30-34,1864,0.1776096255090739
STAT,1862,36,50-100,1898,0.010643512746793952
STAT,1771,91,na,1862,0.278404285068778
STAT,1879,42,20-24,1921,0.0016417070586249366
SIM,1789,76,na,1865,2
STAT,1881,42,45-49,1923,0.014223648159944532
SIM,1916,24,na,1940,39
SIM,1860,69,na,1929,13
SIM,1878,33,na,1911,28
STAT,1854,29,15-19,1883,0.0028656083505722157
STAT,1828,40,na,1868,18.28738107499006
STAT,1873,67,na,1940,16.11679274696524
STAT,1830,39,15-19,1869,3.150287089208463E-4
STAT,1878,18,20-24,1896,0.18255292501116138
STAT,1948,15,35-39,1963,0.04772922064405016
STAT,1828,46,na,1874,16.96588261811673
SIM,1835,62,na,1897,13
SIM,1890,67,na,1957,19
STAT,1891,19,35-39,1910,0.006698540789280571
SIM,1871,26,20-24,1897,2
STAT,1845,33,45-49,1878,0.01199490613908277
STAT,1896,34,45-49,1930,0.022709622486800245
STAT,1927,3,na,1930,50.17478628973871
STAT,1939,25,35-39,1964,0.15002631778550338
STAT,1924,40,25-29,1964,8.462079598608014E-4
STAT,1809,67,na,1876,10.668108616278648
STAT,1906,32,20-24,1938,0.022549102486353032
STAT,1860,22,30-34,1882,0.14927739170623536
STAT,1864,34,25-29,1898,0.0910817226434267
STAT,1816,77,na,1893,2.5950593754295745
STAT,1847,16,50-100,1863,6.570616632066709E-4
STAT,1869,29,50-100,1898,0.006153944377986017
STAT,1928,36,15-19,1964,2.4172364027609425E-4
STAT,1851,44,25-29,1895,0.005348110967602063
STAT,1878,15,40-44,1893,0.0018970967039524723
STAT,1923,49,45-49,1972,0.00251007580099598
STAT,1893,35,50-100,1928,0.01562734910824032
SIM,1798,59,na,1857,9
STAT,1881,20,40-44,1901,0.01994665343831633
STAT,1898,33,50-100,1931,0.012308000557991548
SIM,1942,22,25-29,1964,1
SIM,1941,30,25-29,1971,1
STAT,1920,46,25-29,1966,5.828249172805527E-4
SIM,1830,47,na,1877,18
STAT,1853,47,na,1900,14.073906017322402
STAT,1899,38,35-39,1937,0.020794866839055164
SIM,1872,54,na,1926,20
STAT,1843,45,na,1888,9.745734040133199
STAT,1843,33,40-44,1876,0.021887157801914994
SIM,1810,70,na,1880,12
STAT,1914,37,40-44,1951,0.014822638611517397
STAT,1892,28,na,1920,29.37950935377763
SIM,1867,73,na,1940,6
STAT,1823,49,40-44,1872,0.0011596185017366313
STAT,1869,28,20-24,1897,0.1132707669640155
STAT,1902,38,20-24,1940,0.0023346445273061157
STAT,1869,20,25-29,1889,0.5603745370198412
STAT,1940,30,25-29,1970,0.09508581596659994
SIM,1931,29,na,1960,56
STAT,1944,27,na,1971,40.19494943838846
STAT,1957,8,na,1965,51.52428022195512
SIM,1952,8,na,1960,35
STAT,1890,21,20-24,1911,0.8396092836691678
STAT,1895,34,50-100,1929,0.011793363821927062
STAT,1854,36,20-24,1890,0.004734376018346036
STAT,1890,32,45-49,1922,0.021182258685723623
STAT,1875,26,50-100,1901,0.006598233760997538
SIM,1911,52,na,1963,38
STAT,1810,46,35-39,1856,0.0013832742570917202
STAT,1838,33,45-49,1871,0.016644422417445195
STAT,1858,25,40-44,1883,0.023673443839093113
STAT,1839,89,na,1928,0.5797443442717468
STAT,1916,34,40-44,1950,0.03971397187047155
SIM,1847,87,na,1934,2
STAT,1790,64,na,1854,5.0
STAT,1845,71,na,1916,7.802561445226128
STAT,1917,33,35-39,1950,0.09442322024345799
STAT,1863,19,15-19,1882,0.053920997300488306
STAT,1895,21,50-100,1916,0.005310143850706954
STAT,1834,32,30-34,1866,0.15804727138753522
STAT,1867,34,40-44,1901,0.0411453544759042
STAT,1819,43,45-49,1862,0.013929120826891617
STAT,1826,39,na,1865,19.48371931921351
STAT,1827,40,30-34,1867,0.009249394587546861
STAT,1873,45,20-24,1918,1.232194380699592E-4
STAT,1919,30,35-39,1949,0.09852325392402372
STAT,1924,42,50-100,1966,0.0013882949850779385
SIM,1909,14,na,1923,41
STAT,1796,67,na,1863,1.4807244073612071
STAT,1921,27,30-34,1948,0.4332853275474042
STAT,1856,48,25-29,1904,4.1203054769729726E-4
STAT,1932,22,20-24,1954,1.453065189687846
SIM,1842,32,30-34,1874,1
STAT,1858,28,45-49,1886,0.008586891297149549
STAT,1837,23,na,1860,13.390461078631247
STAT,1849,61,na,1910,14.489237644615635
SIM,1940,22,20-24,1962,1
STAT,1887,81,na,1968,9.616189441029452
SIM,1865,44,na,1909,22
STAT,1825,32,20-24,1857,0.03242094395438785
STAT,1864,30,50-100,1894,0.008284073609970369
SIM,1946,22,na,1968,47
STAT,1922,45,20-24,1967,1.2661984650782997E-4
STAT,1931,30,15-19,1961,0.0016782695308597423
STAT,1863,26,20-24,1889,0.10462116965764948
STAT,1814,40,20-24,1854,0.005454286973163094
STAT,1832,35,30-34,1867,0.030879923256208242
STAT,1837,76,na,1913,4.580926818157923
STAT,1906,30,25-29,1936,0.08613132691940403
STAT,1856,18,na,1874,19.546834004779683
STAT,1892,45,25-29,1937,4.054004996049622E-4
SIM,1901,21,25-29,1922,1
STAT,1869,47,20-24,1916,1.1573090193897085E-4
STAT,1892,23,20-24,1915,0.8487195454118384
STAT,1840,40,na,1880,19.375292217294216
SIM,1927,1,na,1928,52
SIM,1863,43,na,1906,11
STAT,1834,34,na,1868,19.214988683748846
STAT,1857,44,35-39,1901,0.013372918317810185
STAT,1898,59,na,1957,26.66338955450943
STAT,1920,48,20-24,1968,1.2078402156002358E-4
STAT,1842,28,50-100,1870,0.0058926561390756005
SIM,1949,11,na,1960,38
STAT,1911,18,na,1929,38.29957018965437
STAT,1817,46,45-49,1863,0.006925038108525663
STAT,1881,31,20-24,1912,0.02582588943823897
STAT,1862,45,45-49,1907,0.0020564238164946956
SIM,1849,25,40-44,1874,1
SIM,1811,74,na,1885,3
SIM,1881,37,na,1918,24
STAT,1920,32,40-44,1952,0.042499615497398564
STAT,1874,41,30-34,1915,0.011716059049042556
STAT,1884,37,45-49,1921,0.01953122485589362
STAT,1851,22,20-24,1873,0.6947594804917974
STAT,1853,30,30-34,1883,0.11537151253376396
STAT,1863,50,45-49,1913,1.3033905964876435E-4
STAT,1873,36,30-34,1909,0.054446221527790176
STAT,1775,81,na,1856,2.944460004
STAT,1945,20,35-39,1965,0.10252707779969562
STAT,1837,29,15-19,1866,0.002807589626312917
STAT,1949,5,na,1954,45.57257021050253
STAT,1865,18,35-39,1883,0.005084162804598824
STAT,1912,32,15-19,1944,0.0012545845581620643
STAT,1851,53,50-100,1904,1.254548971615993E-4
STAT,1861,42,35-39,1903,0.015209390123177175
SIM,1886,62,na,1948,22
STAT,1858,47,45-49,1905,0.0017874572089296447
STAT,1912,2,na,1914,40.89856560241441
STAT,1943,23,35-39,1966,0.0994160795192135
SIM,1878,67,na,1945,18
STAT,1838,24,na,1862,21.222254371303006
STAT,1875,33,30-34,1908,0.1787184095110948
STAT,1936,26,na,1962,35.65058830682164
STAT,1882,29,50-100,1911,0.0060866367288297495
STAT,1895,37,20-24,1932,0.010007586007076925
STAT,1856,29,25-29,1885,0.3130041867395807
STAT,1811,83,na,1894,2.249769893981353
STAT,1913,17,30-34,1930,0.02471258160478473
STAT,1914,40,25-29,1954,7.066245526439138E-4
STAT,1836,33,35-39,1869,0.1222619442225284
STAT,1864,42,45-49,1906,0.013407181450483606
STAT,1960,11,na,1971,50.8726939827258
STAT,1883,45,na,1928,22.065599780533166
STAT,1803,88,na,1891,0.5145028423250243
STAT,1886,34,45-49,1920,0.01793321722669318
SIM,1891,34,35-39,1925,2
STAT,1879,31,40-44,1910,0.04506887976311018
SIM,1866,48,na,1914,27
STAT,1901,32,30-34,1933,0.24430841149701465
STAT,1850,58,na,1908,17.607833872788955
STAT,1875,48,35-39,1923,0.0014210364552185376
STAT,1923,20,15-19,1943,0.061875506553677434
STAT,1940,27,40-44,1967,0.04719252842634157
STAT,1833,86,na,1919,1.6426453127500151
STAT,1928,17,15-19,1945,0.5690466612765697
STAT,1859,46,50-100,1905,0.0019576125641599883
SIM,1899,35,na,1934,28
SIM,1846,71,na,1917,3
STAT,1838,41,20-24,1879,0.0014601083584220567
STAT,1862,26,45-49,1888,0.009684148620054577
STAT,1891,40,na,1931,28.65355659909968
STAT,1806,53,na,1859,15.61224311726811
STAT,1941,19,40-44,1960,0.014292943374477497
STAT,1887,41,40-44,1928,0.0246621074242402
STAT,1892,45,30-34,1937,6.812980684023697E-4
STAT,1885,42,45-49,1927,0.014761347351699261
SIM,1791,64,na,1855,5
STAT,1858,22,50-100,1880,0.003560323084220739
SIM,1931,23,na,1954,57
STAT,1923,24,30-34,1947,0.3300213415562358
SIM,1844,45,na,1889,4
SIM,1918,25,na,1943,38
STAT,1862,23,35-39,1885,0.05116905731548338
STAT,1839,28,35-39,1867,0.06659914374448775
STAT,1837,39,25-29,1876,0.016723226982935668
STAT,1883,34,35-39,1917,0.09750009536551994
STAT,1803,53,35-39,1856,1.6467868326535743E-4
STAT,1858,44,na,1902,17.34986119573138
STAT,1939,15,25-29,1954,0.431860022108529
STAT,1826,48,50-100,1874,0.002439808234304864
STAT,1854,17,20-24,1871,0.12962799236020622
STAT,1844,22,50-100,1866,0.003976968139281958
STAT,1775,99,na,1874,0.005295460785769647
STAT,1846,40,40-44,1886,0.018928289505566114
STAT,1862,48,25-29,1910,4.907081985730723E-4
STAT,1854,94,na,1948,0.12216190634970736
STAT,1880,26,20-24,1906,0.12378578651470498
STAT,1938,33,na,1971,37.75457694810691
STAT,1899,48,45-49,1947,0.0017994762651990044
STAT,1901,42,40-44,1943,0.0021828880031834223
SIM,1876,84,na,1960,6
STAT,1836,41,na,1877,24.44933625182319
SIM,1853,41,na,1894,24
SIM,1861,17,na,1878,29
STAT,1886,34,na,1920,24.540480471092685
SIM,1914,51,na,1965,36
STAT,1879,45,25-29,1924,6.021092713580834E-4
STAT,1868,41,30-34,1909,0.011176202206704585
STAT,1867,17,30-34,1884,0.015592837345425997
STAT,1908,14,na,1922,37.98663140352739
STAT,1841,37,25-29,1878,0.03320394761798157
STAT,1914,46,30-34,1960,8.789623283303837E-4
STAT,1871,20,40-44,1891,0.020899540497240784
STAT,1847,35,na,1882,26.660274304023474
STAT,1899,29,45-49,1928,0.015090680466079712
STAT,1870,44,35-39,1914,0.017745607483484537
STAT,1824,101,na,1925,0.0039704679920247255
STAT,1841,18,25-29,1859,0.07111622261606546
STAT,1845,30,40-44,1875,0.030774036816614288
STAT,1818,39,20-24,1857,0.00916668210877448
SIM,1831,72,na,1903,4
STAT,1877,37,45-49,1914,0.020577986944032137
STAT,1942,24,40-44,1966,0.034973473855109474
STAT,1807,50,30-34,1857,1.269189947679046E-4
STAT,1882,18,50-100,1900,4.682805045250057E-4
STAT,1863,90,na,1953,0.6980524982817524
STAT,1938,30,45-49,1968,0.015735828332877063
STAT,1922,19,30-34,1941,0.13927856457508822
STAT,1853,13,na,1866,17.966101498087077
SIM,1848,35,na,1883,32
STAT,1869,62,na,1931,17.709643703205277
STAT,1801,54,45-49,1855,3.993203822518696E-4
STAT,1850,15,30-34,1865,0.01754758809419773
STAT,1814,41,50-100,1855,0.03503268217755262
SIM,1936,28,30-34,1964,1
SIM,1841,56,na,1897,13
STAT,1836,36,45-49,1872,0.02386109091142254
STAT,1851,41,20-24,1892,0.0013468152770279782
SIM,1893,56,na,1949,32
STAT,1828,27,20-24,1855,0.1838813871379089
STAT,1876,27,45-49,1903,0.011276746483785457
STAT,1906,35,25-29,1941,0.009114260383757882
SIM,1831,33,25-29,1864,2
SIM,1851,36,45-49,1887,1
SIM,1851,58,na,1909,15
STAT,1895,30,na,1925,31.229432988139855
SIM,1827,27,na,1854,20
STAT,1881,46,25-29,1927,5.496451413080317E-4
SIM,1829,56,na,1885,19
SIM,1782,81,na,1863,1
STAT,1842,33,35-39,1875,0.09083906336938383
SIM,1832,25,30-34,1857,1
SIM,1890,11,na,1901,31
STAT,1886,21,30-34,1907,0.1853186214259951
STAT,1859,52,45-49,1911,1.147330657537974E-4
STAT,1890,24,25-29,1914,0.6910110026109595
STAT,1843,36,45-49,1879,0.009974955693241623
STAT,1835,26,45-49,1861,0.006749096310336568
STAT,1870,31,45-49,1901,0.017393723012119496
SIM,1906,22,na,1928,28
STAT,1895,18,20-24,1913,0.2295585630851026
STAT,1881,62,na,1943,17.391655696247042
STAT,1838,30,40-44,1868,0.04270279919880281
SIM,1927,30,35-39,1957,2
STAT,1814,47,50-100,1861,0.007033632309240152
STAT,1790,100,na,1890,0.0013805683345609928
STAT,1815,73,na,1888,4.441894916094634
STAT,1838,49,25-29,1887,4.4829841696909214E-4
SIM,1903,57,na,1960,33
STAT,1820,41,35-39,1861,0.016265847123735137
STAT,1878,18,45-49,1896,6.726340762952892E-4
STAT,1904,22,45-49,1926,0.009991855857491119
STAT,1927,40,35-39,1967,0.002519512092724274
STAT,1917,27,50-100,1944,0.010343530762324317
STAT,1935,36,50-100,1971,0.005850203103766297
STAT,1823,33,25-29,1856,0.09486267146457514
STAT,1888,47,30-34,1935,0.001125929170576045
STAT,1821,44,45-49,1865,0.021833178137610626
STAT,1866,33,20-24,1899,0.024789616880878093
STAT,1937,35,50-100,1972,0.0041790872066917355
STAT,1864,31,20-24,1895,0.02434343017522645
STAT,1887,19,na,1906,27.41934920936642
SIM,1785,86,na,1871,1
STAT,1894,31,30-34,1925,0.22467675631118578
STAT,1920,43,20-24,1963,1.930821833639707E-4
STAT,1891,16,30-34,1907,0.019610622566043276
SIM,1892,40,na,1932,36
STAT,1815,47,25-29,1862,8.301939584466349E-4
STAT,1890,48,25-29,1938,3.897124451566607E-4
STAT,1784,103,na,1887,7.649046041184705E-4
SIM,1834,86,na,1920,3
SIM,1812,59,na,1871,18
STAT,1818,78,na,1896,1.9525726815254543
STAT,1882,38,25-29,1920,0.027455747737323708
SIM,1870,13,na,1883,27
STAT,1780,103,na,1883,9.933681736652386E-4
SIM,1868,74,na,1942,22
STAT,1881,34,25-29,1915,0.09662839139355603
STAT,1851,32,30-34,1883,0.15341732637321764
STAT,1869,84,na,1953,3.2233113949637233
STAT,1920,46,30-34,1966,9.794696620920274E-4
SIM,1923,22,20-24,1945,1
STAT,1933,34,40-44,1967,0.05245457702749212
SIM,1870,90,na,1960,1
STAT,1836,21,40-44,1857,0.02673285308551027
STAT,1832,38,35-39,1870,0.03972404456361739
STAT,1795,82,na,1877,2.056964975341387
STAT,1897,26,50-100,1923,0.008523981614376062
STAT,1864,3,na,1867,28.807359584993407
SIM,1933,30,na,1963,49
STAT,1871,26,na,1897,23.87529873066465
STAT,1846,37,na,1883,19.938978797566406
STAT,1845,26,45-49,1871,0.007956940105008727
STAT,1799,72,na,1871,6.193188308699748
SIM,1921,45,na,1966,41
SIM,1850,76,na,1926,4
STAT,1853,45,50-100,1898,0.0015589383891716493
SIM,1906,25,25-29,1931,1
STAT,1814,43,25-29,1857,0.01978006432876118
STAT,1899,23,30-34,1922,0.2430848730454085
STAT,1844,29,20-24,1873,0.11057016971460908
SIM,1919,29,na,1948,41
STAT,1873,42,50-100,1915,0.010727644630743043
STAT,1926,33,na,1959,45.442019980665386
STAT,1887,44,45-49,1931,0.016115438810547365
STAT,1888,66,na,1954,19.15344030721047
STAT,1900,18,40-44,1918,0.0025296387021103354
STAT,1813,47,na,1860,20.34113059058212
STAT,1910,21,25-29,1931,0.8647404244459452
STAT,1857,99,na,1956,0.01671044798427797
STAT,1947,21,20-24,1968,1.2485317288719358
STAT,1827,43,35-39,1870,0.0139682458844146
SIM,1908,33,35-39,1941,1
STAT,1840,45,25-29,1885,4.669621715647908E-4
STAT,1867,20,15-19,1887,0.03216058350603212
STAT,1903,49,35-39,1952,0.0010993237768049116
STAT,1906,32,15-19,1938,0.0011879746380330056
STAT,1881,19,na,1900,23.903359396552922
STAT,1914,23,na,1937,36.885083161874356
STAT,1954,17,25-29,1971,0.532667391251557
SIM,1881,31,na,1912,25
STAT,1842,32,20-24,1874,0.024499323097896843
STAT,1851,44,30-34,1895,0.009574843789918592
STAT,1942,20,25-29,1962,0.9620954967187497
STAT,1858,22,na,1880,18.6674956541261
STAT,1828,49,25-29,1877,2.4058106933366348E-4
STAT,1901,35,40-44,1936,0.01334649121132232
SIM,1807,50,na,1857,17
STAT,1894,34,35-39,1928,0.12867646641325975
STAT,1836,43,45-49,1879,0.016964042779430016
STAT,1914,48,na,1962,36.03269890016208
SIM,1868,9,na,1877,38
STAT,1939,19,40-44,1958,0.013895402377309619
STAT,1834,47,35-39,1881,0.0010492393030308964
STAT,1923,35,50-100,1958,0.00483947507495978
STAT,1870,19,20-24,1889,0.17570265383197067
STAT,1825,42,30-34,1867,0.01118004660363528
STAT,1906,31,50-100,1937,0.007674619302256214
STAT,1932,17,40-44,1949,0.018446100197356572
STAT,1907,44,40-44,1951,0.0022538953430575864
STAT,1807,53,35-39,1860,1.7293555990394345E-4
STAT,1888,44,20-24,1932,0.0018308349895662516
SIM,1882,4,na,1886,34
STAT,1874,44,35-39,1918,0.0181225822791781
STAT,1940,24,30-34,1964,0.29050931238988564
STAT,1852,8,na,1860,25.418800678099956
STAT,1873,39,35-39,1912,0.07118612990117991
STAT,1868,37,na,1905,22.79985839125208
SIM,1921,48,na,1969,40
STAT,1889,21,50-100,1910,0.005007780669954115
STAT,1847,43,20-24,1890,0.001684244440949536
STAT,1876,24,40-44,1900,0.021031624879358293
STAT,1831,32,45-49,1863,0.018395141724479043
STAT,1806,48,35-39,1854,0.0046479166076605506
STAT,1870,41,na,1911,23.06347861782314
STAT,1900,22,50-100,1922,0.005654756150663834
SIM,1906,56,na,1962,22
STAT,1868,21,50-100,1889,0.003974912399469751
STAT,1872,52,45-49,1924,1.4769622545966686E-4
STAT,1909,16,35-39,1925,0.008202718127750428
STAT,1910,29,20-24,1939,0.17394023388565077
STAT,1894,51,na,1945,27.727613093885232
STAT,1851,89,na,1940,0.8868943048815585
STAT,1892,33,30-34,1925,0.21478843497789532
STAT,1890,46,35-39,1936,9.619945806237476E-4
SIM,1826,42,na,1868,16
STAT,1845,39,15-19,1884,3.3780152207936573E-4
STAT,1853,33,35-39,1886,0.0648658680156009
STAT,1949,22,25-29,1971,1.0709463503356298
STAT,1898,44,20-24,1942,1.4676375804711515E-4
STAT,1932,22,15-19,1954,0.06956208815397064
STAT,1923,39,35-39,1962,0.027772342565435502
STAT,1857,17,30-34,1874,0.014024018209576128
SIM,1881,53,na,1934,20
STAT,1855,44,50-100,1899,0.007337757690956163
STAT,1914,45,na,1959,36.30321214886671
SIM,1861,33,35-39,1894,3
STAT,1935,17,15-19,1952,0.6176669571428406
STAT,1927,9,na,1936,49.24463347722501
STAT,1932,29,40-44,1961,0.06074265544247481
STAT,1867,27,35-39,1894,0.09233643992223327
STAT,1919,33,45-49,1952,0.016758831731608536
STAT,1914,29,na,1943,37.18427357363669
STAT,1827,31,50-100,1858,0.008363656017696081
STAT,1915,29,40-44,1944,0.04679421494220497
STAT,1937,26,15-19,1963,0.006841220932789945
STAT,1941,22,na,1963,37.46475252145165
STAT,1815,54,50-100,1869,2.0134032487601714E-4
STAT,1868,44,35-39,1912,0.017287523322638738
SIM,1899,32,na,1931,28
STAT,1839,38,50-100,1877,0.008013018401632153
STAT,1832,32,20-24,1864,0.01579681735188186
STAT,1893,17,35-39,1910,0.0069185493531844335
STAT,1872,40,45-49,1912,0.015467691843739872
SIM,1834,23,30-34,1857,1
STAT,1831,32,50-100,1863,0.009665243897266402
STAT,1915,30,50-100,1945,0.00841495295398616
SIM,1918,41,na,1959,34
SIM,1919,26,na,1945,44
STAT,1882,22,15-19,1904,0.03161599158353882
STAT,1883,29,na,1912,23.00944813530935
STAT,1857,41,30-34,1898,0.008645451197619981
STAT,1916,30,25-29,1946,0.09536827286577483
STAT,1922,40,na,1962,42.43365005247781
SIM,1893,41,na,1934,33
STAT,1858,25,35-39,1883,0.07625387846072128
STAT,1871,16,45-49,1887,6.593553232653699E-4
STAT,1815,44,20-24,1859,0.002340197509436177
SIM,1924,30,25-29,1954,1
STAT,1916,42,25-29,1958,7.255303933199734E-4
STAT,1893,24,40-44,1917,0.026109792324654536
STAT,1800,99,na,1899,0.006863032909785265
STAT,1841,15,20-24,1856,0.2264674097313156
STAT,1901,23,40-44,1924,0.029067992404740204
SIM,1900,68,na,1968,18
STAT,1898,18,30-34,1916,0.021444979154278936
STAT,1877,41,40-44,1918,0.023323456318643094
STAT,1901,41,na,1942,32.598988975158775
STAT,1841,34,20-24,1875,0.031441590095353994
STAT,1876,17,40-44,1893,0.001857647140211876
STAT,1867,15,40-44,1882,0.0018106082127352437
SIM,1818,47,na,1865,25
STAT,1826,33,40-44,1859,0.057346890349099
STAT,1909,22,50-100,1931,0.006081171776290362
SIM,1848,29,30-34,1877,1
STAT,1834,49,na,1883,16.43501777458076
STAT,1821,61,na,1882,12.282629989379144
STAT,1877,44,50-100,1921,0.010758139787033067
SIM,1868,89,na,1957,5
STAT,1912,38,20-24,1950,0.0025400805975808152
SIM,1845,24,na,1869,24
STAT,1856,26,20-24,1882,0.08870240222683594
STAT,1926,23,35-39,1949,0.1133868512586546
STAT,1880,29,25-29,1909,0.44164267483597713
STAT,1919,21,45-49,1940,0.012250861642284007
SIM,1889,51,na,1940,26
STAT,1886,24,40-44,1910,0.021479335643774314
STAT,1897,5,na,1902,34.80091061315515
STAT,1916,49,45-49,1965,0.002197190702378233
STAT,1911,45,45-49,1956,0.00205390893671337
STAT,1831,51,45-49,1882,1.2468599102617164E-4
STAT,1831,69,na,1900,11.909022251700998
STAT,1945,23,45-49,1968,0.012239171899103484
STAT,1882,66,na,1948,15.707351780529196
STAT,1895,14,na,1909,33.41901834541621
SIM,1823,77,na,1900,3
STAT,1806,62,na,1868,12.616032932632091
SIM,1868,71,na,1939,25
STAT,1887,1,na,1888,32.421839450129795
STAT,1852,23,40-44,1875,0.0210341262111714
STAT,1812,84,na,1896,1.3220559322250975
SIM,1950,20,25-29,1970,4
STAT,1847,24,20-24,1871,0.8895339958838946
STAT,1917,21,35-39,1938,0.09946350308728079
STAT,1902,1,na,1903,38.38339772698852
STAT,1910,36,20-24,1946,0.002517811767851278
SIM,1869,37,na,1906,17
STAT,1862,33,45-49,1895,0.014981590856265194
STAT,1882,35,20-24,1917,0.007457541231804338
STAT,1853,31,45-49,1884,0.011403915280482185
STAT,1846,43,45-49,1889,0.012119755886698017
STAT,1781,84,na,1865,1.5466394938635124
STAT,1925,32,25-29,1957,0.10906897005017907
STAT,1841,21,15-19,1862,0.04120252861221305
STAT,1849,64,na,1913,13.479079889166266
STAT,1883,33,20-24,1916,0.0261381320442839
STAT,1862,45,20-24,1907,1.0456392684084207E-4
STAT,1948,6,na,1954,44.80541565894492
STAT,1897,27,20-24,1924,0.1557884405642828
STAT,1910,48,20-24,1958,1.021924664745939E-4
STAT,1857,15,50-100,1872,4.361892225726857E-4
STAT,1906,27,40-44,1933,0.043520026485043384
STAT,1852,16,35-39,1868,0.005713428088165109
SIM,1943,6,na,1949,49
STAT,1940,20,50-100,1960,0.006659974423420537
STAT,1936,21,45-49,1957,0.01069567505317057
STAT,1908,11,na,1919,38.16687664648561
STAT,1816,42,20-24,1858,0.0021884350666467023
STAT,1841,103,na,1944,0.0014047463302719041
SIM,1847,72,na,1919,10
STAT,1880,18,na,1898,26.48850722824378
STAT,1863,74,na,1937,9.826041535930326
SIM,1939,15,35-39,1954,1
STAT,1877,34,35-39,1911,0.10364274809809966
STAT,1850,24,na,1874,22.522434534242322
STAT,1915,22,20-24,1937,1.1394807949725163
STAT,1906,39,40-44,1945,0.013588710530624265
STAT,1827,61,na,1888,11.650401826337943
STAT,1832,44,20-24,1876,8.513946124390966E-4
STAT,1898,42,30-34,1940,0.0010756532286873928
SIM,1845,46,na,1891,22
STAT,1835,23,40-44,1858,0.013759221435059223
STAT,1855,44,25-29,1899,0.004460205683323466
STAT,1848,60,na,1908,12.333726381411617
STAT,1913,36,50-100,1949,0.0041285010515504815
STAT,1847,36,20-24,1883,0.008632830054423894
STAT,1902,20,na,1922,33.55059432261206
STAT,1842,19,45-49,1861,6.219621370667132E-4
STAT,1840,22,45-49,1862,0.0069487739264509196
STAT,1903,46,30-34,1949,7.785167806949433E-4
STAT,1913,29,30-34,1942,0.3843862161386271
STAT,1920,49,35-39,1969,0.0014047926028691701
STAT,1894,69,na,1963,20.894280564370955
SIM,1900,46,na,1946,35
SIM,1923,25,25-29,1948,1
STAT,1845,45,45-49,1890,0.0013932886260858788
STAT,1901,56,na,1957,28.964899462687704
STAT,1882,29,35-39,1911,0.0918090058571091
STAT,1866,19,30-34,1885,0.014890084089813923
SIM,1828,39,30-34,1867,1
SIM,1869,8,na,1877,19
SIM,1869,34,na,1903,17
STAT,1856,36,30-34,1892,0.03879506715807889
STAT,1836,40,40-44,1876,0.026493958782311946
STAT,1915,25,25-29,1940,0.6700698986027156
STAT,1845,23,40-44,1868,0.015013202517466665
STAT,1897,33,15-19,1930,0.0018831299046759096
STAT,1827,41,45-49,1868,0.011871191091509211
STAT,1922,15,15-19,1937,0.5238027924416875
STAT,1923,32,15-19,1955,0.0014629751093411367
SIM,1877,88,na,1965,4
STAT,1916,46,40-44,1962,0.0016072778702912382
STAT,1898,47,25-29,1945,4.362631156360826E-4
STAT,1836,24,45-49,1860,0.008754514952482109
STAT,1873,33,20-24,1906,0.02736582563738833
SIM,1878,11,na,1889,31
STAT,1836,75,na,1911,9.935390827022776
STAT,1861,42,na,1903,19.41256885644791
STAT,1912,19,na,1931,38.54194743332209
STAT,1873,29,25-29,1902,0.42700159555094686
STAT,1852,21,50-100,1873,0.004176020023463866
STAT,1842,30,30-34,1872,0.1615678701093716
SIM,1930,15,15-19,1945,1
STAT,1853,19,20-24,1872,0.13245735451443547
STAT,1840,31,50-100,1871,0.008836002979113874
STAT,1918,17,15-19,1935,0.09820796902366749
STAT,1873,26,20-24,1899,0.11968211262178981
STAT,1832,28,25-29,1860,0.25125249455648074
SIM,1810,73,na,1883,10
STAT,1858,37,35-39,1895,0.05382102003792449
STAT,1810,44,45-49,1854,0.014757116882023216
STAT,1834,31,na,1865,19.82297878236014
STAT,1944,21,na,1965,39.15579592441127
STAT,1894,32,45-49,1926,0.022348683764319272
STAT,1846,19,20-24,1865,0.17836745272800003
SIM,1888,26,na,1914,37
STAT,1864,46,25-29,1910,5.180943777592863E-4
STAT,1923,36,30-34,1959,0.020990723685939686
STAT,1901,38,45-49,1939,0.00599086412191017
SIM,1829,53,na,1882,19
SIM,1832,76,na,1908,16
SIM,1808,69,na,1877,4
STAT,1834,44,30-34,1878,0.009546693330052253
STAT,1938,24,15-19,1962,0.05230076180401105
SIM,1832,57,na,1889,18
STAT,1871,35,50-100,1906,0.012356850189525887
STAT,1904,30,na,1934,34.468078794442185
STAT,1815,76,na,1891,3.381934861168526
STAT,1848,15,30-34,1863,0.01292959659998233
STAT,1816,40,30-34,1856,0.016522316122581177
STAT,1842,35,25-29,1877,0.025872554102751216
STAT,1848,29,50-100,1877,0.004867999216642126
SIM,1864,39,35-39,1903,1
STAT,1847,49,35-39,1896,0.0014643062460139823
STAT,1855,52,45-49,1907,1.0163358355524386E-4
STAT,1861,64,na,1925,14.618821045109938
STAT,1941,15,25-29,1956,0.44335778643105406
SIM,1868,6,na,1874,38
STAT,1870,41,30-34,1911,0.011472348804094683
STAT,1886,46,45-49,1932,0.002454898677669047
SIM,1889,73,na,1962,18
STAT,1896,45,25-29,1941,4.310384122435376E-4
STAT,1836,97,na,1933,0.05184778333066393
SIM,1833,21,na,1854,16
STAT,1883,46,35-39,1929,0.0013633739638785798
STAT,1887,4,na,1891,28.714160324955373
STAT,1884,49,50-100,1933,0.002356029684954024
SIM,1877,85,na,1962,4
STAT,1883,31,30-34,1914,0.1702409599623491
STAT,1783,94,na,1877,0.02164005481460441
SIM,1913,19,na,1932,44
STAT,1833,43,35-39,1876,0.016038100436723747
STAT,1856,32,15-19,1888,0.0010442794963853423
STAT,1868,42,45-49,1910,0.014465833262725143
SIM,1883,63,na,1946,6
STAT,1829,40,40-44,1869,0.02045422262425545
STAT,1867,24,30-34,1891,0.16938943741151707
STAT,1873,52,na,1925,21.77455952515774
STAT,1815,98,na,1913,0.011596276447166131
SIM,1833,39,na,1872,12
STAT,1876,41,na,1917,23.58022275674974
STAT,1818,87,na,1905,0.44028079598079867
STAT,1877,25,45-49,1902,0.011538983472153071
STAT,1877,44,45-49,1921,0.015240698075304357
SIM,1871,78,na,1949,10
STAT,1846,34,na,1880,20.32968615910271
STAT,1828,39,15-19,1867,2.4809380003699977E-4
STAT,1856,12,na,1868,20.448959086092866
STAT,1854,39,25-29,1893,0.017421538767670948
STAT,1883,36,25-29,1919,0.02809391996711596
STAT,1896,31,40-44,1927,0.057197124610326146
STAT,1866,43,30-34,1909,0.01051174531940827
SIM,1926,17,15-19,1943,1
SIM,1891,6,na,1897,38
SIM,1908,63,na,1971,29
STAT,1842,45,35-39,1887,0.0010778330051096784
STAT,1852,26,45-49,1878,0.011148006711344
SIM,1870,93,na,1963,1
STAT,1897,37,30-34,1934,0.07077441579641272
SIM,1921,30,na,1951,41
STAT,1811,51,35-39,1862,3.333214300127717E-4
STAT,1837,17,20-24,1854,0.17148382114879754
STAT,1846,29,30-34,1875,0.2433552141271815
STAT,1881,23,45-49,1904,0.006614814526424626
SIM,1934,18,na,1952,52
STAT,1889,19,35-39,1908,0.006681992621793569
STAT,1914,34,30-34,1948,0.15593042742667634
STAT,1923,46,40-44,1969,0.001836158000908879
STAT,1875,45,30-34,1920,0.0010049682203787024
SIM,1882,19,na,1901,33
STAT,1830,34,45-49,1864,0.010744257711630059
STAT,1858,22,30-34,1880,0.15551489545273994
STAT,1897,40,na,1937,31.108995556645137
STAT,1906,44,50-100,1950,0.0010514309212540246
SIM,1791,80,na,1871,1
SIM,1854,38,na,1892,17
STAT,1824,72,na,1896,8.787375545879339
STAT,1836,30,30-34,1866,0.21745712902322153
STAT,1839,86,na,1925,1.2244374150055346
STAT,1840,33,25-29,1873,0.09674648191617795
STAT,1947,10,na,1957,43.958673497180556
STAT,1825,35,na,1860,15.764994673225408
STAT,1916,40,35-39,1956,0.002051596682429351
SIM,1881,56,na,1937,18
SIM,1944,8,na,1952,36
STAT,1893,27,45-49,1920,0.013999560684366868
STAT,1864,56,na,1920,18.293944216596007
STAT,1930,17,30-34,1947,0.15684504288537104
SIM,1792,65,na,1857,8
STAT,1855,30,40-44,1885,0.03174181314534873
SIM,1856,64,na,1920,8
STAT,1912,29,50-100,1941,0.009662476675768895
STAT,1948,3,na,1951,45.34198298002834
STAT,1851,47,35-39,1898,0.0011764130909906404
STAT,1870,78,na,1948,7.761669884561258
STAT,1832,47,25-29,1879,3.0626098224776835E-4
STAT,1911,42,40-44,1953,0.0023719081427590323
STAT,1834,23,50-100,1857,0.0038264674100501315
STAT,1872,19,30-34,1891,0.01622054080365372
STAT,1824,40,50-100,1864,0.014804762150260132
STAT,1937,17,25-29,1954,0.4189193479885004
STAT,1837,20,na,1857,13.413836803560784
STAT,1885,55,na,1940,20.418977662866318
SIM,1821,36,na,1857,16
STAT,1927,20,50-100,1947,0.008113587441458951
SIM,1842,35,na,1877,24
STAT,1826,36,45-49,1862,0.0236375814493895
STAT,1812,87,na,1899,0.700170189238043
STAT,1816,45,25-29,1861,7.483179574261988E-4
STAT,1841,25,30-34,1866,0.3105892781082505
SIM,1933,33,na,1966,49
STAT,1877,31,30-34,1908,0.1809663966297631
SIM,1860,5,na,1865,30
SIM,1863,34,na,1897,14
STAT,1904,8,na,1912,37.248655876168584
STAT,1805,80,na,1885,2.161983452121741
STAT,1890,36,25-29,1926,0.03514202180415405
STAT,1916,55,na,1971,36.186769838260915
STAT,1810,58,na,1868,8.665942194243593
STAT,1877,22,40-44,1899,0.021510347141119424
STAT,1883,11,na,1894,25.115689781966726
SIM,1914,23,25-29,1937,2
STAT,1886,27,45-49,1913,0.011516800251259047
SIM,1912,34,na,1946,35
STAT,1901,49,25-29,1950,4.451467184162135E-4
STAT,1919,38,30-34,1957,0.019390684052858674
STAT,1906,23,25-29,1929,0.8291034360351346
STAT,1825,57,na,1882,11.649822243706845
STAT,1827,83,na,1910,2.405811293056995
STAT,1871,35,45-49,1906,0.02006382550952041
STAT,1823,45,25-29,1868,4.0991201314793496E-4
STAT,1862,30,40-44,1892,0.03771640845354379
STAT,1819,36,45-49,1855,0.024370252792596612
SIM,1789,79,na,1868,2
STAT,1827,29,20-24,1856,0.12672920533218948
SIM,1857,49,na,1906,22
STAT,1774,80,na,1854,1.0
STAT,1852,50,50-100,1902,1.3111408326357436E-4
STAT,1837,46,50-100,1883,0.0012570001030540838
SIM,1864,1,na,1865,27
STAT,1886,30,35-39,1916,0.10588900793135719
STAT,1895,42,50-100,1937,9.512558275954754E-4
STAT,1895,36,45-49,1931,0.026005109924848314
STAT,1851,27,45-49,1878,0.01097509203743289
STAT,1898,46,40-44,1944,0.0013064431317494293
STAT,1866,70,na,1936,12.922054603255535
STAT,1890,44,15-19,1934,1.654841117786345E-4
STAT,1826,42,na,1868,18.95502893916105
STAT,1849,39,na,1888,18.308834624892633
STAT,1904,61,na,1965,28.926458286610604
STAT,1917,15,40-44,1932,0.0029964196997849047
STAT,1836,37,20-24,1873,0.00913138401437987
STAT,1941,26,40-44,1967,0.04788892150586352
STAT,1853,44,na,1897,14.3296379292957
STAT,1855,103,na,1958,0.0017633233545842186
SIM,1928,29,25-29,1957,2
STAT,1873,43,30-34,1916,0.011604156326330854
STAT,1850,40,25-29,1890,0.005775232893475076
STAT,1881,87,na,1968,3.9480445550652457
STAT,1815,47,30-34,1862,0.0013951870825027626
STAT,1892,41,15-19,1933,1.7137964997361512E-4
STAT,1924,29,45-49,1953,0.019841531698213878
SIM,1886,31,na,1917,30
SIM,1943,17,na,1960,46
STAT,1853,24,45-49,1877,0.005104058435053949
STAT,1870,21,40-44,1891,0.02076281515452225
STAT,1908,51,na,1959,32.631132677365514
STAT,1857,34,na,1891,17.711170872170523
SIM,1919,18,20-24,1937,1
STAT,1850,24,20-24,1874,0.7259047603037707
STAT,1806,52,30-34,1858,1.928098833218803E-4
STAT,1880,40,40-44,1920,0.02389099024993555
STAT,1884,17,30-34,1901,0.015615966949761893
SIM,1904,6,na,1910,33
SIM,1795,85,na,1880,3
STAT,1863,43,45-49,1906,0.013155492575582831
SIM,1828,77,na,1905,6
STAT,1852,21,20-24,1873,0.705705548971783
STAT,1840,37,40-44,1877,0.04057055223242821
SIM,1921,4,na,1925,44
STAT,1833,27,25-29,1860,0.4127719553427896
STAT,1884,33,35-39,1917,0.09880141768927403
STAT,1909,39,20-24,1948,0.002456183246721886
STAT,1831,29,na,1860,22.93629038056452
STAT,1854,17,15-19,1871,0.04339242122752985
STAT,1784,73,na,1857,6.772529301277437
STAT,1828,45,45-49,1873,0.001036983468415725
STAT,1864,24,20-24,1888,0.6190452029590847
SIM,1851,89,na,1940,2
STAT,1872,30,35-39,1902,0.10445001112072842
STAT,1814,57,na,1871,11.48739956694332
SIM,1951,12,na,1963,51
SIM,1924,10,na,1934,55
STAT,1864,36,15-19,1900,5.060872724048329E-4
STAT,1893,72,na,1965,18.74854313545862
STAT,1845,100,na,1945,0.0062058337111832755
SIM,1872,24,20-24,1896,1
STAT,1835,24,25-29,1859,0.35823053215929884
STAT,1910,16,50-100,1926,7.396457819197024E-4
STAT,1862,27,20-24,1889,0.10158793768326184
SIM,1859,69,na,1928,10
STAT,1921,22,50-100,1943,0.007373994940973849
STAT,1857,46,25-29,1903,4.3242247708330837E-4
STAT,1815,45,35-39,1860,0.0020761950291388618
STAT,1950,19,45-49,1969,0.005866122501902627
STAT,1917,28,na,1945,38.7924189357137
SIM,1935,19,15-19,1954,4
STAT,1903,0,na,1903,41.746870236268556
SIM,1901,53,na,1954,31
STAT,1941,30,50-100,1971,0.008627471934575661
STAT,1892,23,15-19,1915,0.04063045777637761
STAT,1776,78,na,1854,2.0
STAT,1929,16,15-19,1945,0.5778317793497058
STAT,1901,23,35-39,1924,0.08140175203307856
STAT,1810,67,na,1877,6.415936059898911
STAT,1909,6,na,1915,38.95676094481756
SIM,1867,64,na,1931,7
STAT,1903,20,35-39,1923,0.08345997242018018
STAT,1939,21,25-29,1960,0.9215887574013746
STAT,1817,42,35-39,1859,0.05720012286639477
STAT,1889,39,25-29,1928,0.03489613890807622
SIM,1841,27,25-29,1868,1
STAT,1831,48,25-29,1879,5.444340840902974E-4
STAT,1952,16,45-49,1968,0.005952618887410079
STAT,1877,22,35-39,1899,0.06023738824980929
SIM,1912,25,na,1937,38
STAT,1849,37,30-34,1886,0.04228648806723816
STAT,1869,46,45-49,1915,0.002293194076784376
STAT,1876,39,15-19,1915,5.645912885794347E-4
STAT,1882,38,30-34,1920,0.05082234183530483
SIM,1916,15,na,1931,46
STAT,1836,60,na,1896,18.406287960086384
STAT,1842,54,50-100,1896,1.1019672437816567E-4
STAT,1835,23,50-100,1858,0.00269260713035123
SIM,1938,30,na,1968,39
SIM,1882,41,na,1923,29
STAT,1896,49,40-44,1945,0.0012420103802422862
STAT,1849,19,30-34,1868,0.015033931712986306
STAT,1947,16,35-39,1963,0.04695822266846214
STAT,1870,16,na,1886,25.478147977462665
STAT,1828,27,15-19,1855,0.007111434918706681
STAT,1927,19,15-19,1946,0.558394818837045
STAT,1860,29,50-100,1889,0.005181037785150192
STAT,1897,33,45-49,1930,0.023059457609264755
STAT,1879,28,50-100,1907,0.006597574690508102
STAT,1862,80,na,1942,5.337030001388618
STAT,1939,27,50-100,1966,0.009937602686550386
STAT,1919,30,40-44,1949,0.04219064242628316
STAT,1821,98,na,1919,0.020176318860855996
STAT,1882,36,35-39,1918,0.0681091457838084
STAT,1920,18,20-24,1938,1.5041808138590254
STAT,1832,42,30-34,1874,0.006323323654254212
STAT,1868,32,40-44,1900,0.041968370225425586
STAT,1925,23,na,1948,43.30395723579392
STAT,1854,85,na,1939,1.6756056416411091
STAT,1871,4,na,1875,29.390986653800553
SIM,1878,36,na,1914,29
STAT,1845,49,na,1894,12.876826470102273
SIM,1848,38,na,1886,30
SIM,1832,82,na,1914,8
STAT,1958,10,na,1968,51.31328873963293
STAT,1825,32,15-19,1857,0.0017080617369233256
SIM,1920,20,na,1940,48
STAT,1895,18,15-19,1913,0.07684375638631862
STAT,1864,38,40-44,1902,0.03906808081709716
STAT,1915,33,na,1948,38.02495279985321
STAT,1879,35,20-24,1914,0.008054134546545072
STAT,1906,9,na,1915,37.695240280101046
STAT,1881,38,40-44,1919,0.04144723765237204
STAT,1867,32,20-24,1899,0.025867206166645517
STAT,1843,16,30-34,1859,0.008691402533005557
STAT,1837,85,na,1922,1.3255065641313715
SIM,1898,56,na,1954,22
STAT,1914,37,35-39,1951,0.023949581156353282
STAT,1848,38,25-29,1886,0.018989817831288697
STAT,1820,45,45-49,1865,0.0020485854977006766
STAT,1881,31,50-100,1912,0.008754103625672804
STAT,1870,49,20-24,1919,1.1671769085675258E-4
STAT,1933,31,30-34,1964,0.21157870364937406
STAT,1929,34,15-19,1963,0.0016223948759924358
STAT,1878,21,40-44,1899,0.021578559675845772
STAT,1869,28,15-19,1897,0.0043806374315224095
STAT,1859,27,45-49,1886,0.008977202812981911
STAT,1925,16,50-100,1941,0.0045085492995896245
STAT,1823,35,15-19,1858,4.1930613908491615E-4
STAT,1843,32,35-39,1875,0.05164420209819297
SIM,1897,15,na,1912,43
SIM,1813,44,na,1857,12
STAT,1820,57,na,1877,12.255840017912279
STAT,1897,15,15-19,1912,0.07917434161765739
STAT,1919,23,na,1942,39.518548417132834
STAT,1876,25,25-29,1901,0.4325473521758396
STAT,1935,28,50-100,1963,0.013501293504243941
STAT,1860,16,30-34,1876,0.015032952632752951
STAT,1910,47,45-49,1957,0.0020153878760237804
STAT,1917,33,40-44,1950,0.040434883779843576
STAT,1854,35,15-19,1889,3.484882461928239E-4
SIM,1890,76,na,1966,13
STAT,1866,38,45-49,1904,0.01826858098414498
SIM,1909,45,na,1954,33
STAT,1841,21,45-49,1862,0.008709064196965254
STAT,1872,11,na,1883,27.052318874614684
STAT,1918,31,35-39,1949,0.09662219955040603
SIM,1844,36,na,1880,7
SIM,1866,23,na,1889,30
STAT,1905,18,25-29,1923,0.08157029283778088
STAT,1890,26,15-19,1916,0.0055300506676609976
STAT,1905,37,50-100,1942,0.0038245533552529374
SIM,1884,36,na,1920,22
STAT,1860,32,35-39,1892,0.08233028286615501
STAT,1892,28,45-49,1920,0.013668486617467706
STAT,1906,56,na,1962,30.99844560469198
STAT,1814,48,25-29,1862,0.0016244657520480385
STAT,1818,41,40-44,1859,0.024940581416208314
STAT,1903,18,20-24,1921,0.25139203566051754
STAT,1856,48,30-34,1904,6.924402326649302E-4
SIM,1880,74,na,1954,21
STAT,1861,67,na,1928,13.330976874663778
SIM,1841,59,na,1900,13
SIM,1888,1,na,1889,41
STAT,1874,43,20-24,1917,0.0015995060144503724
STAT,1885,32,40-44,1917,0.042825717636227896
STAT,1881,39,25-29,1920,0.027121075047352602
STAT,1891,41,25-29,1932,0.007917265339963737
STAT,1823,93,na,1916,0.1680717594779163
SIM,1801,59,na,1860,9
SIM,1896,61,na,1957,22
STAT,1850,42,20-24,1892,0.0014122746105407695
STAT,1885,15,25-29,1900,0.056219779888134765
STAT,1839,48,25-29,1887,3.1974472400252916E-4
STAT,1921,33,na,1954,41.583924053405866
STAT,1869,43,40-44,1912,0.021636728650263136
STAT,1827,31,40-44,1858,0.039586336793265633
STAT,1825,37,45-49,1862,0.020898367084325922
STAT,1899,28,30-34,1927,0.34351006676086426
STAT,1891,43,20-24,1934,0.0019351329742031491
STAT,1859,29,40-44,1888,0.02387366517611888
STAT,1864,28,50-100,1892,0.005717351247226512
STAT,1844,31,40-44,1875,0.04093030955795265
STAT,1930,24,50-100,1954,0.0083374125270946
STAT,1850,95,na,1945,0.11837880694120984
SIM,1829,90,na,1919,2
STAT,1843,14,na,1857,12.823742635903367
STAT,1899,44,35-39,1943,0.0016981523146677715
STAT,1841,15,50-100,1856,6.258309622249141E-4
STAT,1833,42,20-24,1875,0.0014247193885672488
STAT,1794,63,na,1857,9.835866173144
STAT,1825,29,na,1854,15.049652903210017
STAT,1910,61,na,1971,31.382482220459767
STAT,1924,41,30-34,1965,0.0015129702819296046
STAT,1899,69,na,1968,23.309424481339907
STAT,1938,23,30-34,1961,0.2824841959009023
STAT,1868,77,na,1945,8.365114396342424
STAT,1948,15,40-44,1963,0.015909741135838422
STAT,1855,49,25-29,1904,3.9707675734726997E-4
STAT,1946,25,na,1971,41.47145904965667
STAT,1856,46,35-39,1902,0.0010170862102617656
STAT,1875,87,na,1962,3.226045295807657
STAT,1924,47,45-49,1971,0.0025706235697334316
SIM,1933,27,na,1960,51
STAT,1868,17,45-49,1885,6.436011782706531E-4
STAT,1854,35,45-49,1889,0.012371331268591404
SIM,1833,37,45-49,1870,1
SIM,1887,5,na,1892,26
STAT,1937,26,20-24,1963,0.17689442555808332
STAT,1880,37,50-100,1917,0.012910367025257836
STAT,1954,8,na,1962,48.30814344107831
STAT,1838,34,20-24,1872,0.02553362163447119
STAT,1894,22,40-44,1916,0.02670592503801587
STAT,1909,23,35-39,1932,0.08675266131940869
STAT,1891,25,20-24,1916,0.14496444514344708
STAT,1838,16,20-24,1854,0.1828302581044933
STAT,1814,47,40-44,1861,0.004902922851064021
STAT,1880,22,40-44,1902,0.02191235632438165
SIM,1846,16,20-24,1862,1
STAT,1824,34,20-24,1858,0.041439339683359964
STAT,1943,23,40-44,1966,0.03550078188979558
STAT,1872,49,25-29,1921,5.770409369268954E-4
STAT,1882,22,45-49,1904,0.006682737919879413
SIM,1822,80,na,1902,9
STAT,1821,36,50-100,1857,0.02736010233726491
STAT,1907,41,30-34,1948,0.0011730763798632657
STAT,1922,47,40-44,1969,0.001797980756048541
STAT,1875,28,45-49,1903,0.011373099249728737
SIM,1918,10,na,1928,40
STAT,1808,57,na,1865,4.135289087785006
STAT,1861,46,45-49,1907,0.001990289833343355
STAT,1872,82,na,1954,4.773932405400265
STAT,1907,29,45-49,1936,0.015989175661172465
STAT,1831,48,50-100,1879,0.002321406458261625
SIM,1852,31,40-44,1883,1
STAT,1875,40,30-34,1915,0.011937171672201008
STAT,1885,49,na,1934,21.753626140919405
STAT,1897,30,40-44,1927,0.05805257467330293
SIM,1902,35,na,1937,32
SIM,1928,26,20-24,1954,1
STAT,1833,24,20-24,1857,0.6760271435957166
STAT,1895,4,na,1899,34.15304126102876
STAT,1930,37,20-24,1967,0.0034223505833700435
STAT,1833,40,25-29,1873,0.005910341303546451
STAT,1899,26,35-39,1925,0.13254071533404005
STAT,1902,37,15-19,1939,1.709212331006393E-4
STAT,1866,42,na,1908,21.259885180011548
STAT,1937,29,25-29,1966,0.6369301774637779
SIM,1846,62,na,1908,8
STAT,1878,51,50-100,1929,1.566694712066262E-4
STAT,1873,44,15-19,1917,1.3850833484255602E-4
STAT,1894,8,na,1902,33.31557371071538
STAT,1867,33,35-39,1900,0.09650305912172176
STAT,1862,52,na,1914,18.477875608290454
STAT,1871,97,na,1968,0.2649576221856769
STAT,1922,29,40-44,1951,0.05198206110104187
STAT,1859,42,40-44,1901,0.017855613954097186
STAT,1910,29,15-19,1939,0.006726970425205215
STAT,1882,40,45-49,1922,0.014487683683617913
STAT,1848,85,na,1933,1.7728267040777554
STAT,1909,26,45-49,1935,0.01661420855935974
STAT,1926,23,40-44,1949,0.04048964609317796
STAT,1923,28,na,1951,42.56166786644835
STAT,1895,33,40-44,1928,0.056064055871432684
STAT,1804,98,na,1902,0.012611867313579286
STAT,1867,45,50-100,1912,0.002373726572297704
STAT,1943,26,45-49,1969,0.018273394896796687
STAT,1926,39,20-24,1965,0.0031964205931480105
STAT,1928,18,20-24,1946,1.6954830247656467
SIM,1833,36,na,1869,12
STAT,1873,46,35-39,1919,0.0014274108842531241
SIM,1851,49,na,1900,15
STAT,1880,46,na,1926,23.72544051341391
SIM,1914,20,na,1934,33
STAT,1863,40,40-44,1903,0.02011598447486297
STAT,1855,16,20-24,1871,0.14934203727571893
STAT,1935,16,45-49,1951,0.006815452201915735
STAT,1919,15,45-49,1934,0.001103039030312415
STAT,1793,78,na,1871,1.6746297572554785
STAT,1846,40,35-39,1886,0.015238507817287113
STAT,1854,57,na,1911,12.283568458166256
STAT,1941,29,45-49,1970,0.017724438860467335
STAT,1899,43,20-24,1942,1.4987957008117425E-4
STAT,1865,36,35-39,1901,0.06428158824668719
STAT,1889,39,na,1928,28.554663500161478
STAT,1841,19,na,1860,28.637631892792598
STAT,1928,36,20-24,1964,0.0033182059172164654
STAT,1827,34,50-100,1861,0.007682627940681533
SIM,1873,64,na,1937,16
STAT,1851,9,na,1860,25.00714255185896
STAT,1847,42,45-49,1889,0.016076830956463787
STAT,1853,21,40-44,1874,0.015585791448727961
STAT,1931,23,na,1954,47.007526187600796
STAT,1824,53,35-39,1877,1.0545656628355625E-4
STAT,1832,45,35-39,1877,7.637044952855879E-4
STAT,1843,54,na,1897,8.8824311428075
STAT,1889,36,20-24,1925,0.009483171686639414
STAT,1882,33,30-34,1915,0.1666180079550886
STAT,1933,19,45-49,1952,0.006624119556601289
STAT,1866,33,15-19,1899,0.0013060136721122792
STAT,1868,35,45-49,1903,0.019475091225589672
SIM,1896,21,na,1917,32
STAT,1857,43,20-24,1900,0.0011802988641782578
STAT,1894,54,na,1948,26.836718521517863
STAT,1865,35,20-24,1900,0.007038446735438317
SIM,1892,31,na,1923,34
SIM,1937,17,na,1954,39
STAT,1871,50,40-44,1921,1.0646903246505907E-4
STAT,1850,17,50-100,1867,5.330373794086223E-4
STAT,1935,31,35-39,1966,0.12594128012673333
STAT,1950,16,40-44,1966,0.016440760797133237
SIM,1906,20,25-29,1926,1
SIM,1905,15,na,1920,40
STAT,1852,24,25-29,1876,0.5736926910766591
SIM,1834,77,na,1911,5
SIM,1868,18,na,1886,37
SIM,1860,24,25-29,1884,1
SIM,1927,30,na,1957,49
STAT,1942,24,35-39,1966,0.09793941070470089
STAT,1914,51,na,1965,35.672841244982536
STAT,1895,36,15-19,1931,7.325383948589256E-4
STAT,1844,18,40-44,1862,0.0018053584498896153
STAT,1900,49,50-100,1949,0.0018809823603909252
STAT,1952,7,na,1959,46.824885896540124
STAT,1857,45,40-44,1902,0.0012943941283269861
STAT,1828,42,40-44,1870,0.00991479092435703
STAT,1830,75,na,1905,3.6987759270156033
STAT,1874,41,25-29,1915,0.006544105081195338
SIM,1885,4,na,1889,28
STAT,1845,80,na,1925,3.615997411802513
STAT,1790,73,na,1863,3.0082798826650645
STAT,1835,59,na,1894,8.741562829558365
STAT,1891,44,35-39,1935,0.021925273321462265
STAT,1893,23,35-39,1916,0.0733508901983184
STAT,1893,39,15-19,1932,7.009140462364464E-4
STAT,1830,38,50-100,1868,0.007032001719311339
SIM,1861,4,na,1865,33
SIM,1910,30,na,1940,32
STAT,1894,48,50-100,1942,0.001753193451135784
SIM,1840,18,na,1858,17
STAT,1856,50,45-49,1906,1.0664356902094881E-4
STAT,1834,42,35-39,1876,0.01542703094140309
STAT,1847,24,15-19,1871,0.04258435387260366
STAT,1935,13,na,1948,53.842948115325996
STAT,1936,27,15-19,1963,0.0067152438432392545
SIM,1858,34,40-44,1892,1
STAT,1936,22,50-100,1958,0.006252716893452852
STAT,1826,32,35-39,1858,0.14344600431682034
STAT,1887,72,na,1959,15.016882587925297
SIM,1925,9,na,1934,45
STAT,1886,40,50-100,1926,0.011068791925748486
STAT,1931,4,na,1935,52.59574866256827
SIM,1906,7,na,1913,29
STAT,1850,43,35-39,1893,0.016006382464193555
SIM,1814,57,na,1871,22
STAT,1855,79,na,1934,4.922189062882741
STAT,1910,44,40-44,1954,0.0023205853241158926
STAT,1905,15,20-24,1920,0.2570542852283544
STAT,1897,49,30-34,1946,7.099672775415729E-4
STAT,1860,26,na,1886,19.75148222548586
STAT,1841,19,30-34,1860,0.01988490253993068
SIM,1862,9,na,1871,26
STAT,1891,26,35-39,1917,0.11883386636551804
STAT,1833,95,na,1928,0.09843261846479356
STAT,1816,44,40-44,1860,0.029279609576009235
STAT,1877,82,na,1959,6.159462418394707
STAT,1878,67,na,1945,16.36606714783665
STAT,1901,41,35-39,1942,0.001767494987039416
STAT,1854,32,40-44,1886,0.027145311073953245
SIM,1839,21,na,1860,21
SIM,1880,46,na,1926,32
SIM,1862,0,na,1862,32
STAT,1849,21,15-19,1870,0.03115107053275681
STAT,1824,35,35-39,1859,0.10755251289823119
STAT,1900,21,25-29,1921,0.7962111811646669
STAT,1855,70,na,1925,9.87862198782492
STAT,1887,26,15-19,1913,0.0049691929761372326
SIM,1857,74,na,1931,10
STAT,1906,46,40-44,1952,0.0014069829823914232
STAT,1887,41,35-39,1928,0.019854605280870522
STAT,1865,22,45-49,1887,0.006383854537184602
STAT,1845,35,50-100,1880,0.008460205762931938
STAT,1883,35,40-44,1918,0.04291283262705158
STAT,1916,43,50-100,1959,0.001191728599612949
STAT,1880,25,15-19,1905,0.004803290607172436
SIM,1843,82,na,1925,4
STAT,1851,80,na,1931,5.222381102718378
STAT,1916,34,35-39,1950,0.09273975246436422
STAT,1851,22,15-19,1873,0.03325998074329994
SIM,1840,77,na,1917,3
STAT,1880,25,45-49,1905,0.011754636771046103
STAT,1860,19,35-39,1879,0.005084369073928478
STAT,1848,35,20-24,1883,0.005245023322371962
STAT,1938,26,35-39,1964,0.14782615716426079
STAT,1796,98,na,1894,0.001411978864209209
STAT,1852,38,15-19,1890,4.782140471217021E-4
STAT,1820,42,40-44,1862,0.019877413249696947
STAT,1929,13,na,1942,50.2470487502116
STAT,1815,42,30-34,1857,0.017774781848245488
SIM,1952,19,20-24,1971,2
STAT,1917,36,45-49,1953,0.007050201712458294
STAT,1849,70,na,1919,10.879315311747362
STAT,1864,16,na,1880,23.543272924704862
STAT,1799,63,na,1862,9.718417134211844
STAT,1817,41,20-24,1858,0.005173488425668721
STAT,1851,40,15-19,1891,1.1776325376919364E-4
SIM,1884,22,20-24,1906,1
SIM,1926,45,na,1971,46
STAT,1833,45,25-29,1878,5.124955608070148E-4
STAT,1877,38,20-24,1915,0.007917705296133759
STAT,1884,15,35-39,1899,0.005400966151821015
STAT,1839,32,45-49,1871,0.011842692306522603
STAT,1944,19,20-24,1963,1.447449145406553
STAT,1859,25,25-29,1884,0.34698715368339345
STAT,1921,16,15-19,1937,0.5145356487030851
STAT,1930,8,na,1938,51.3227270960648
STAT,1841,37,30-34,1878,0.06146262677918628
STAT,1883,82,na,1965,7.267106359460205
SIM,1934,12,na,1946,52
STAT,1842,60,na,1902,14.309167612313267
STAT,1885,19,40-44,1904,0.0017965085337345139
SIM,1908,51,na,1959,37
STAT,1842,34,40-44,1876,0.03849820180711878
STAT,1814,45,20-24,1859,3.543754204595149E-4
STAT,1836,19,20-24,1855,0.2271917348553223
STAT,1847,44,na,1891,24.356256259433934
STAT,1940,27,35-39,1967,0.15201055458326776
STAT,1895,39,na,1934,30.27875635691095
STAT,1858,16,na,1874,20.524721350477737
STAT,1881,36,20-24,1917,0.007370265566565396
SIM,1827,36,na,1863,19
STAT,1913,25,20-24,1938,0.18158611338019534
STAT,1823,40,50-100,1863,0.0076071758480498065
SIM,1868,22,35-39,1890,2
STAT,1918,29,20-24,1947,0.19112811011535827
STAT,1875,43,35-39,1918,0.018479654175567323
STAT,1867,0,na,1867,36.17528427704347
STAT,1924,44,40-44,1968,0.00294596335867697
STAT,1874,46,25-29,1920,5.860061157983284E-4
STAT,1861,43,40-44,1904,0.018778768659568963
STAT,1837,20,40-44,1857,0.017597859930307592
SIM,1819,69,na,1888,2
STAT,1875,25,40-44,1900,0.031001572019412192
STAT,1818,47,na,1865,7.0067791215613155
STAT,1827,34,45-49,1861,0.014621775848331107
SIM,1803,54,na,1857,9
STAT,1835,21,20-24,1856,0.6082811670554041
STAT,1945,20,40-44,1965,0.03661169746752746
STAT,1913,38,na,1951,36.63451457660065
SIM,1895,76,na,1971,14
STAT,1879,50,40-44,1929,1.1052805801057106E-4
STAT,1894,25,45-49,1919,0.01432609272182053
STAT,1863,29,30-34,1892,0.22136640267093166
STAT,1917,18,45-49,1935,0.001062409729961937
STAT,1835,19,na,1854,13.61703507932262
STAT,1843,31,20-24,1874,0.013928457058080452
STAT,1872,33,45-49,1905,0.017766974709207194
STAT,1884,36,na,1920,23.193830682455076
STAT,1880,43,45-49,1923,0.015624278555647967
SIM,1892,71,na,1963,21
STAT,1874,28,25-29,1902,0.4276336923347115
STAT,1902,66,na,1968,26.148945033984567
STAT,1932,36,40-44,1968,0.02005037647689272
STAT,1813,52,45-49,1865,4.320243968724134E-4
SIM,1845,21,na,1866,21
SIM,1879,89,na,1968,1
SIM,1940,12,na,1952,37
STAT,1924,26,40-44,1950,0.054102232279111005
STAT,1850,25,35-39,1875,0.10256726831330686
STAT,1816,40,25-29,1856,0.00922868111523687
STAT,1873,32,45-49,1905,0.01772931157698393
SIM,1849,27,30-34,1876,1
SIM,1807,75,na,1882,11
STAT,1923,15,35-39,1938,0.04915882841741866
STAT,1857,16,25-29,1873,0.05015539799409289
STAT,1827,55,na,1882,13.351802470204351
STAT,1888,37,15-19,1925,6.562211040525793E-4
STAT,1860,44,35-39,1904,0.014522710284627057
SIM,1790,70,na,1860,1
SIM,1925,35,na,1960,43
STAT,1831,60,na,1891,15.476643063637974
STAT,1840,35,20-24,1875,0.007294120338723099
STAT,1885,49,50-100,1934,0.0023746971928683648
STAT,1945,15,na,1960,39.940279230660984
STAT,1900,28,45-49,1928,0.01534217817593059
STAT,1878,33,40-44,1911,0.04458408020059345
SIM,1921,25,20-24,1946,1
SIM,1794,60,na,1854,5
STAT,1831,100,na,1931,0.00861518270126207
STAT,1911,46,20-24,1957,1.042052479188507E-4
STAT,1868,19,50-100,1887,4.770314132002959E-4
STAT,1858,42,20-24,1900,0.0012069914900396965
STAT,1956,9,na,1965,51.70554696112159
SIM,1864,84,na,1948,3
STAT,1823,38,25-29,1861,0.02051296427631893
SIM,1836,41,na,1877,7
STAT,1922,43,na,1965,42.24933053038402
STAT,1947,15,20-24,1962,1.5175772316190588
SIM,1873,36,na,1909,27
STAT,1836,33,50-100,1869,0.011061640418262965
STAT,1919,27,15-19,1946,0.007561626305982723
STAT,1910,1,na,1911,40.99219571497237
SIM,1815,70,na,1885,6
STAT,1805,100,na,1905,0.0029068044573430977
STAT,1870,22,50-100,1892,0.004050943363392149
STAT,1945,17,15-19,1962,0.49219781687253655
STAT,1883,31,25-29,1914,0.09987050497332145
SIM,1899,41,na,1940,28
STAT,1812,48,20-24,1860,1.3299386321345114E-4
STAT,1874,45,40-44,1919,0.0017541245324926226
STAT,1881,24,20-24,1905,0.6516273145673833
STAT,1943,17,50-100,1960,0.003944001178739076
STAT,1876,32,na,1908,24.236466799863514
STAT,1933,5,na,1938,53.60457755008503
STAT,1950,3,na,1953,46.607754219675634
STAT,1909,23,40-44,1932,0.030978764428790644
STAT,1893,0,na,1893,37.02360210941069
STAT,1884,18,45-49,1902,6.383217192535101E-4
STAT,1931,23,15-19,1954,0.06852233919940957
SIM,1824,56,na,1880,16
SIM,1877,28,20-24,1905,2
STAT,1931,37,40-44,1968,0.01973783589808631
SIM,1903,1,na,1904,39
STAT,1884,32,20-24,1916,0.026483270729290753
STAT,1915,32,25-29,1947,0.09331968055052049
STAT,1924,44,35-39,1968,0.0023716926802836206
STAT,1834,24,40-44,1858,0.019412854729016077
STAT,1856,43,30-34,1899,0.008268416271330606
SIM,1885,21,na,1906,25
SIM,1881,68,na,1949,9
STAT,1802,60,na,1862,8.534753498752428
STAT,1847,42,15-19,1889,1.4834447137424998E-4
SIM,1873,33,na,1906,26
STAT,1923,27,35-39,1950,0.17117821361406685
STAT,1844,39,na,1883,19.046614499585036
STAT,1886,31,na,1917,24.853554611519304
SIM,1926,2,na,1928,50
STAT,1878,51,40-44,1929,1.0920933831499462E-4
STAT,1892,43,35-39,1935,0.022209329246836346
STAT,1911,28,20-24,1939,0.17624508867748054
STAT,1870,25,50-100,1895,0.006397743056608434
SIM,1931,27,35-39,1958,1
STAT,1807,54,40-44,1861,2.073138737459948E-4
STAT,1867,9,na,1876,26.191817756620672
STAT,1872,16,20-24,1888,0.18306799109736296
STAT,1891,41,30-34,1932,0.014174458857101646
STAT,1931,37,50-100,1968,0.005535801170580677
STAT,1783,88,na,1871,0.235246259968865
STAT,1827,52,na,1879,14.168703096156525
STAT,1832,27,40-44,1859,0.01792105192386692
STAT,1851,42,35-39,1893,0.015268628331122688
STAT,1889,23,45-49,1912,0.008511148107597104
SIM,1819,60,na,1879,4
STAT,1878,18,15-19,1896,0.06110881819715458
STAT,1914,22,30-34,1936,0.29120156807012976
STAT,1839,18,30-34,1857,0.011438499657357716
STAT,1840,17,20-24,1857,0.17986256024326913
STAT,1837,39,30-34,1876,0.03095576075536149
STAT,1798,103,na,1901,7.293213574598338E-4
STAT,1882,34,15-19,1916,0.001353070596757274
STAT,1855,30,35-39,1885,0.07412323057161871
STAT,1897,49,25-29,1946,4.224598635564359E-4
STAT,1922,18,25-29,1940,0.4965464642102962
STAT,1850,43,50-100,1893,0.00933832796634582
STAT,1847,36,15-19,1883,6.288817387170263E-4
STAT,1905,15,15-19,1920,0.08604783287837549
SIM,1951,9,na,1960,51
STAT,1876,44,50-100,1920,0.010584976433841533
SIM,1805,89,na,1894,1
STAT,1903,36,15-19,1939,1.7315011562216254E-4
STAT,1890,29,25-29,1919,0.5101640984142252
STAT,1815,43,15-19,1858,2.0842836185939288E-4
STAT,1843,17,45-49,1860,3.541069022722501E-4
STAT,1820,104,na,1924,3.7813909625602273E-4
SIM,1918,50,na,1968,34
SIM,1967,0,na,1967,50
STAT,1918,13,na,1931,42.670434562904795
STAT,1840,23,20-24,1863,0.6817789148284219
STAT,1839,40,na,1879,13.786757198263519
STAT,1838,52,45-49,1890,1.1203798619668275E-4
STAT,1894,24,50-100,1918,0.005193491827119811
STAT,1942,21,30-34,1963,0.29925347178814404
STAT,1859,45,45-49,1904,0.001894468456670995
STAT,1861,16,45-49,1877,6.351359489001411E-4
STAT,1887,27,20-24,1914,0.12804969880825987
STAT,1936,33,45-49,1969,0.015182497671755316
STAT,1941,22,25-29,1963,0.9476421578363458
STAT,1899,38,na,1937,32.34502280548493
STAT,1842,49,45-49,1891,0.0017336883254725072
SIM,1854,69,na,1923,9
SIM,1900,1,na,1901,42
STAT,1815,67,na,1882,6.60145961599857
STAT,1916,31,30-34,1947,0.16192911839742996
SIM,1932,17,na,1949,51
STAT,1873,48,30-34,1921,9.717924742547687E-4
SIM,1935,21,35-39,1956,1
STAT,1838,39,na,1877,19.646585530861767
STAT,1910,4,na,1914,39.619014228343474
SIM,1875,68,na,1943,7
STAT,1906,45,35-39,1951,0.001158750980456204
STAT,1872,30,40-44,1902,0.04472865942911579
SIM,1897,71,na,1968,36
STAT,1859,69,na,1928,11.664282672231511
STAT,1871,17,20-24,1888,0.177895060687733
SIM,1879,21,na,1900,14
STAT,1915,20,25-29,1935,0.9137457747307571
STAT,1945,21,50-100,1966,0.007162136970473608
STAT,1846,44,20-24,1890,0.0012696924868535436
STAT,1841,32,30-34,1873,0.2073506571695585
STAT,1833,47,45-49,1880,0.002046687381551536
STAT,1888,43,45-49,1931,0.017363365931861576
SIM,1889,29,25-29,1918,1
SIM,1890,36,na,1926,25
STAT,1828,77,na,1905,5.805335111700485
STAT,1898,42,25-29,1940,6.008153193827225E-4
STAT,1869,87,na,1956,1.8933085783956567
STAT,1836,36,50-100,1872,0.014695498902300501
STAT,1789,73,na,1862,3.122565790601062
STAT,1927,21,35-39,1948,0.1157652338094085
SIM,1858,20,20-24,1878,2
SIM,1866,54,na,1920,27
STAT,1931,19,40-44,1950,0.01812895959931129
STAT,1832,31,45-49,1863,0.010297360265611028
STAT,1861,18,40-44,1879,0.0017574934559199142
STAT,1832,31,15-19,1863,8.409246819232483E-4
SIM,1822,52,na,1874,14
STAT,1925,42,50-100,1967,0.0014134174383247016
SIM,1887,53,na,1940,21
STAT,1856,15,50-100,1871,4.246496891613892E-4
STAT,1877,41,50-100,1918,0.010954685508348985
STAT,1896,29,20-24,1925,0.15299547678910685
STAT,1873,50,45-49,1923,1.4966695017615462E-4
STAT,1909,61,na,1970,30.923386655298284
STAT,1850,40,30-34,1890,0.010339529815368982
STAT,1829,44,20-24,1873,0.0013682685631418766
STAT,1837,54,na,1891,10.124788917707
STAT,1879,53,45-49,1932,1.4779323513748748E-4
SIM,1866,2,na,1868,40
STAT,1843,85,na,1928,1.1628606507577437
STAT,1784,100,na,1884,0.0031080683523193034
STAT,1829,38,20-24,1867,0.0070017719264271775
STAT,1868,46,na,1914,21.834545239153993
STAT,1796,58,na,1854,2.0
STAT,1861,23,50-100,1884,0.0034977945203209806
STAT,1863,25,45-49,1888,0.00997329977233662
STAT,1896,35,20-24,1931,0.010221539556972576
SIM,1902,66,na,1968,30
STAT,1906,49,45-49,1955,0.0018936602032694802
STAT,1951,15,na,1966,43.58830253017367
SIM,1853,44,na,1897,23
STAT,1852,22,35-39,1874,0.059329771073487705
STAT,1891,49,na,1940,27.042204461007533
STAT,1832,25,15-19,1857,0.0027536902429401424
STAT,1900,43,40-44,1943,0.0021502725113195327
STAT,1916,19,45-49,1935,0.0010451554102035151
STAT,1849,35,40-44,1884,0.0354612822777524
STAT,1821,67,na,1888,9.820446203656466
SIM,1940,20,25-29,1960,1
STAT,1837,30,50-100,1867,0.005728425192507811
SIM,1901,25,na,1926,40
SIM,1848,28,25-29,1876,1
STAT,1885,25,50-100,1910,0.006359914056093111
STAT,1859,22,20-24,1881,0.5682865134991784
STAT,1892,40,30-34,1932,0.0143464035325099
STAT,1888,25,15-19,1913,0.005337929184529301
STAT,1896,17,20-24,1913,0.23287064177265507
STAT,1905,47,40-44,1952,0.0013872556856694038
STAT,1898,17,25-29,1915,0.07644421576648228
SIM,1891,9,na,1900,38
STAT,1801,54,50-100,1855,4.1556392254233195E-4
STAT,1841,33,15-19,1874,0.0016737554509324575
STAT,1897,44,30-34,1941,0.001045867044318504
STAT,1841,44,50-100,1885,0.01047345591118525
SIM,1837,26,na,1863,29
STAT,1842,30,25-29,1872,0.09478250580151566
SIM,1848,69,na,1917,16
STAT,1837,35,45-49,1872,0.012081168632012067
STAT,1864,39,25-29,1903,0.025564269461897146
STAT,1932,39,45-49,1971,0.009103083202146055
STAT,1855,34,20-24,1889,0.018979632765342
STAT,1905,29,40-44,1934,0.04292422112280198
STAT,1808,88,na,1896,0.20046544358236673
STAT,1846,26,20-24,1872,0.11584901760311071
STAT,1852,22,na,1874,21.738508250186875
SIM,1842,41,na,1883,23
STAT,1817,93,na,1910,0.23162241554397597
STAT,1929,33,30-34,1962,0.19904508507719962
STAT,1907,17,45-49,1924,9.555059578285763E-4
SIM,1838,36,na,1874,8
STAT,1945,24,50-100,1969,0.007154905646270801
STAT,1915,39,45-49,1954,0.006758560847720061
STAT,1857,43,15-19,1900,1.0263468938497606E-4
STAT,1823,41,45-49,1864,0.010692049998452727
STAT,1885,22,50-100,1907,0.004026990676135817
STAT,1876,22,20-24,1898,0.6999068162506704
STAT,1873,28,40-44,1901,0.030348473192574
STAT,1795,73,na,1868,6.097543704970353
STAT,1936,15,45-49,1951,0.004775749551503833
SIM,1829,62,na,1891,19
STAT,1877,40,35-39,1917,0.018880937782674325
SIM,1782,75,na,1857,5
STAT,1821,33,50-100,1854,0.024629280535052034
STAT,1888,43,15-19,1931,1.6021561384920002E-4
STAT,1806,93,na,1899,0.13675115662678203
STAT,1874,46,na,1920,22.889244181485584
STAT,1898,48,30-34,1946,7.273430843190527E-4
STAT,1873,21,na,1894,24.11786948196115
SIM,1897,46,na,1943,37
STAT,1928,8,na,1936,50.00940673115666
STAT,1932,20,25-29,1952,1.2142633303339225
SIM,1861,48,na,1909,23
SIM,1865,69,na,1934,8
SIM,1869,28,na,1897,16
SIM,1825,29,35-39,1854,1
STAT,1905,46,na,1951,32.5688769291459
STAT,1840,38,25-29,1878,0.026408655969371194
STAT,1904,21,na,1925,33.9908736946125
SIM,1891,21,na,1912,36
STAT,1834,27,45-49,1861,0.010288739005972002
STAT,1827,28,15-19,1855,0.006442014112978649
STAT,1844,95,na,1939,0.10385079252583242
STAT,1883,33,15-19,1916,0.0013770587087871791
STAT,1819,37,20-24,1856,0.008634633544880886
STAT,1890,33,50-100,1923,0.011082694104064242
SIM,1906,25,na,1931,26
STAT,1876,29,40-44,1905,0.030206869182760575
STAT,1874,48,45-49,1922,0.002364116520619567
STAT,1817,46,50-100,1863,0.007206734562121351
STAT,1890,26,20-24,1916,0.14299130897444198
STAT,1878,36,45-49,1914,0.020680164652615914
STAT,1869,31,40-44,1900,0.04219196288617866
SIM,1901,22,na,1923,35
STAT,1912,23,50-100,1935,0.0062372950868985
STAT,1934,18,50-100,1952,0.005032903333933062
STAT,1837,17,15-19,1854,0.05740348257741989
STAT,1863,25,15-19,1888,0.004075383872088477
STAT,1775,96,na,1871,0.023081623103509925
STAT,1936,15,15-19,1951,0.433876934551664
STAT,1868,47,45-49,1915,0.002273231354214615
STAT,1855,28,20-24,1883,0.08547607418776043
STAT,1897,34,na,1931,31.41783656967497
SIM,1908,18,15-19,1926,1
STAT,1829,26,20-24,1855,0.18231685079925142
STAT,1940,15,35-39,1955,0.042325081360001855
SIM,1855,70,na,1925,8
SIM,1853,27,20-24,1880,1
STAT,1856,80,na,1936,4.481317819721737
STAT,1823,37,40-44,1860,0.03154562008254011
STAT,1850,22,30-34,1872,0.1903532221064544
STAT,1866,18,25-29,1884,0.05325278978746422
STAT,1838,40,50-100,1878,0.009838133992685221
SIM,1851,18,na,1869,26
STAT,1816,42,15-19,1858,1.9029871172573766E-4
STAT,1844,16,45-49,1860,6.524337534874892E-4
STAT,1890,28,40-44,1918,0.036259118527557144
STAT,1832,47,30-34,1879,5.14688600126883E-4
STAT,1894,19,15-19,1913,0.07564884473501457
SIM,1919,35,na,1954,44
STAT,1845,40,na,1885,14.114892211846117
STAT,1940,31,na,1971,38.88739494474152
STAT,1823,35,20-24,1858,0.005755929003251729
STAT,1804,67,na,1871,8.846332471489935
STAT,1862,21,na,1883,21.039231008644144
STAT,1876,72,na,1948,12.82653844369156
STAT,1904,16,15-19,1920,0.08524447418797755
STAT,1913,28,25-29,1941,0.6480641334015359
STAT,1842,36,30-34,1878,0.047397027575959726
STAT,1900,25,40-44,1925,0.04182075889886481
SIM,1833,67,na,1900,4
STAT,1845,27,20-24,1872,0.08346930300750775
STAT,1854,39,30-34,1893,0.03224838044909478
STAT,1883,47,40-44,1930,0.0016547408436042997
STAT,1921,22,45-49,1943,0.012609530868606056
SIM,1823,74,na,1897,6
STAT,1838,34,15-19,1872,0.0013452107434094409
STAT,1946,16,15-19,1962,0.49995504883949415
STAT,1873,32,15-19,1905,0.0014478483139395823
STAT,1835,22,35-39,1857,0.04266855956665129
SIM,1882,72,na,1954,21
SIM,1842,44,na,1886,23
STAT,1938,25,20-24,1963,0.17980691321496794
SIM,1830,56,na,1886,14
SIM,1864,28,na,1892,21
STAT,1911,15,45-49,1926,9.978001727486937E-4
SIM,1945,12,na,1957,40
STAT,1895,21,40-44,1916,0.027134833102950468
STAT,1867,15,35-39,1882,0.0054318243237095635
STAT,1939,12,na,1951,39.303703024069435
STAT,1878,54,45-49,1932,1.457085191850322E-4
SIM,1889,9,na,1898,34
STAT,1828,49,30-34,1877,4.0430985652686457E-4
STAT,1842,32,15-19,1874,0.0012907198637680624
STAT,1925,43,40-44,1968,0.0030045311593358865
STAT,1866,35,50-100,1901,0.011414671020704653
STAT,1861,36,na,1897,19.908079772647607
STAT,1897,31,na,1928,31.818648289302928
SIM,1848,66,na,1914,17
STAT,1914,23,15-19,1937,0.05376696850052604
STAT,1845,18,na,1863,16.859267507937748
STAT,1849,6,na,1855,23.811119999999995
STAT,1858,47,na,1905,17.04022928472651
STAT,1926,29,50-100,1955,0.011778930802140054
SIM,1901,9,na,1910,42
STAT,1881,20,35-39,1901,0.055858434062711515
STAT,1933,34,35-39,1967,0.1224915126852253
STAT,1837,35,15-19,1872,3.403146498241823E-4
STAT,1836,21,35-39,1857,0.07486244828000446
STAT,1850,27,25-29,1877,0.44322647417603617
STAT,1901,20,30-34,1921,0.2507288727108672
STAT,1870,24,45-49,1894,0.006883747956850039
STAT,1879,49,40-44,1928,0.0017349404225355583
STAT,1851,18,na,1869,23.4223392161624
STAT,1914,25,35-39,1939,0.15111560555582748
STAT,1879,47,20-24,1926,1.2362217227092785E-4
SIM,1913,10,na,1923,47
STAT,1869,90,na,1959,1.198317301177799
STAT,1872,19,25-29,1891,0.05766934068162233
STAT,1858,27,30-34,1885,0.1961608692367925
STAT,1875,42,20-24,1917,0.0016304962387416217
STAT,1782,78,na,1860,2.2650445993413064
STAT,1891,23,30-34,1914,0.2179459741571057
STAT,1891,43,50-100,1934,0.01287284084387384
STAT,1881,18,20-24,1899,0.16825269695917694
STAT,1944,21,35-39,1965,0.10096060662716937
STAT,1812,93,na,1905,0.11614631853432875
SIM,1877,54,na,1931,24
STAT,1923,45,35-39,1968,0.0015048568125279873
STAT,1824,32,30-34,1856,0.28516283414027555
STAT,1927,19,20-24,1946,1.6681161655082803
SIM,1939,12,na,1951,30
STAT,1882,44,50-100,1926,0.009987780009268024
STAT,1922,15,20-24,1937,1.564777960207661
STAT,1846,47,25-29,1893,4.6463031156992443E-4
STAT,1882,72,na,1954,12.102874773195563
SIM,1858,28,na,1886,25
STAT,1841,35,35-39,1876,0.0832791601966659
STAT,1864,24,15-19,1888,0.029635337275393168
STAT,1827,46,45-49,1873,0.0018023024390216337
STAT,1822,42,45-49,1864,0.00855242021197988
STAT,1816,46,30-34,1862,0.0012386906293413574
STAT,1956,15,na,1971,48.45648204761079
STAT,1927,0,na,1927,55.72996620498923
STAT,1917,49,20-24,1966,1.1371014311918788E-4
STAT,1850,45,25-29,1895,5.179630752288145E-4
STAT,1870,47,na,1917,22.245466111142346
SIM,1817,74,na,1891,2
SIM,1794,63,na,1857,4
SIM,1946,25,20-24,1971,1
STAT,1912,28,na,1940,36.49905656899154
STAT,1864,87,na,1951,1.5802057646875276
STAT,1842,46,40-44,1888,0.001301257190509388
STAT,1839,20,45-49,1859,0.00501627126524546
STAT,1883,37,30-34,1920,0.05175454194093327
STAT,1901,35,35-39,1936,0.021564505672407922
SIM,1930,15,20-24,1945,1
STAT,1859,24,40-44,1883,0.01693824041268269
STAT,1924,13,na,1937,46.804528677878714
STAT,1919,19,50-100,1938,0.004082343970610868
STAT,1864,47,na,1911,20.085259632341945
STAT,1824,37,25-29,1861,0.04192175361394833
STAT,1920,36,15-19,1956,2.0865509351589918E-4
STAT,1818,44,45-49,1862,0.015151521813082873
STAT,1828,30,40-44,1858,0.06182733261502632
STAT,1844,34,45-49,1878,0.015953552805467088
STAT,1873,26,15-19,1899,0.004628590028010056
STAT,1945,12,na,1957,42.602129658567435
STAT,1870,87,na,1957,2.1351213748661233
SIM,1861,1,na,1862,35
STAT,1933,27,na,1960,49.538589118009554
SIM,1907,10,na,1917,41
STAT,1906,42,30-34,1948,0.0011584321972675198
STAT,1901,39,20-24,1940,0.0023046857186469504
STAT,1860,31,20-24,1891,0.02206493417316368
SIM,1888,35,na,1923,38
SIM,1923,5,na,1928,42
STAT,1936,30,40-44,1966,0.03782355042557484
STAT,1891,28,25-29,1919,0.5173647685229259
STAT,1835,28,40-44,1863,0.017769823568491445
STAT,1888,40,40-44,1928,0.026550218284108442
STAT,1837,32,40-44,1869,0.026536717216896474
SIM,1945,4,na,1949,40
SIM,1804,64,na,1868,9
STAT,1860,17,45-49,1877,6.124756353850276E-4
STAT,1885,46,na,1931,22.280590456690064
STAT,1900,46,45-49,1946,0.0018512428724804784
STAT,1838,48,40-44,1886,0.0013496232312088222
STAT,1885,35,45-49,1920,0.01987293653022536
STAT,1896,31,35-39,1927,0.13356627222619977
STAT,1878,36,15-19,1914,5.825399186476967E-4
STAT,1901,43,50-100,1944,0.0010191188707470349
STAT,1865,38,25-29,1903,0.025912805846335037
SIM,1871,69,na,1940,15
SIM,1926,17,20-24,1943,1
STAT,1875,15,30-34,1890,0.016460178821713148
STAT,1893,13,na,1906,32.51180132388959
SIM,1870,84,na,1954,5
STAT,1833,55,na,1888,15.479313177371406
STAT,1891,46,25-29,1937,3.999174096242775E-4
STAT,1915,36,40-44,1951,0.015064187492356657
STAT,1897,47,35-39,1944,0.001043819277783416
STAT,1827,28,45-49,1855,0.015764929121495123
STAT,1853,18,15-19,1871,0.044602245446741295
STAT,1817,37,na,1854,25.015401022675697
SIM,1845,18,na,1863,23
STAT,1769,96,na,1865,0.07309413239197383
STAT,1894,19,45-49,1913,8.326783646343142E-4
STAT,1846,29,25-29,1875,0.4087964545392054
STAT,1870,49,50-100,1919,0.0023888219782884895
STAT,1864,36,20-24,1900,0.0069471971380357135
STAT,1929,36,35-39,1965,0.0309323911019853
STAT,1834,41,20-24,1875,0.0013704359925266645
STAT,1906,28,na,1934,34.549742672780205
STAT,1816,52,na,1868,8.280134355438697
STAT,1863,22,40-44,1885,0.01881768216345761
SIM,1894,28,20-24,1922,1
STAT,1832,29,30-34,1861,0.14849589045503642
STAT,1928,39,25-29,1967,0.012356189552418247
SIM,1873,33,30-34,1906,1
STAT,1928,20,35-39,1948,0.11768570241104818
STAT,1926,26,45-49,1952,0.02066232605230309
STAT,1949,15,25-29,1964,0.501046095664751
SIM,1935,19,20-24,1954,4
STAT,1918,17,20-24,1935,0.29338076784327055
SIM,1805,49,na,1854,14
STAT,1841,59,na,1900,19.022915639592863
STAT,1854,20,40-44,1874,0.015182732708728502
STAT,1930,13,na,1943,50.907335264681144
STAT,1843,19,35-39,1862,0.0029395621291054795
STAT,1894,37,45-49,1931,0.025548363917849443
SIM,1877,94,na,1971,3
STAT,1829,40,35-39,1869,0.01646698352033293
STAT,1848,22,45-49,1870,0.005490871592738333
STAT,1849,38,45-49,1887,0.015653539826701247
STAT,1907,44,35-39,1951,0.0018145327814449459
STAT,1822,52,na,1874,8.558542148730046
SIM,1810,64,na,1874,12
STAT,1883,18,50-100,1901,4.7450458501837787E-4
STAT,1851,40,na,1891,19.709085653120088
STAT,1865,38,50-100,1903,0.011049698197565
STAT,1886,28,20-24,1914,0.12125805611204107
STAT,1857,47,30-34,1904,7.212742123893387E-4
STAT,1816,49,50-100,1865,0.003003134098573105
STAT,1927,27,na,1954,45.30985548576786
STAT,1910,32,40-44,1942,0.03750236100298158
STAT,1877,57,na,1934,20.744638199605493
STAT,1948,18,45-49,1966,0.005677220643545365
SIM,1894,35,na,1929,28
STAT,1921,47,20-24,1968,1.2360937434677236E-4
STAT,1834,29,50-100,1863,0.005842958576994879
STAT,1811,52,40-44,1863,3.99539334018073E-4
STAT,1875,34,50-100,1909,0.009337837174668278
STAT,1885,17,45-49,1902,6.450694096003753E-4
STAT,1833,44,40-44,1877,0.01966789118731487
STAT,1838,28,20-24,1866,0.1149924109522268
STAT,1826,54,45-49,1880,1.3553739400483296E-4
STAT,1825,97,na,1922,0.02896193978410969
SIM,1890,73,na,1963,14
STAT,1823,43,50-100,1866,0.007424806329974237
STAT,1898,39,50-100,1937,0.0035388394661468796
STAT,1817,54,35-39,1871,2.299985910228291E-4
STAT,1855,15,45-49,1870,5.535255834780503E-4
STAT,1878,30,50-100,1908,0.009535516560004268
STAT,1826,38,40-44,1864,0.04937272924772888
STAT,1835,20,50-100,1855,0.004712059579929663
SIM,1907,41,na,1948,38
STAT,1907,39,50-100,1946,0.003837242119181569
STAT,1953,15,15-19,1968,0.546113392935449
STAT,1849,25,30-34,1874,0.23482026067206618
STAT,1906,17,25-29,1923,0.08232712781127581
STAT,1847,28,30-34,1875,0.321005631777604
STAT,1801,103,na,1904,5.200978962329433E-4
STAT,1921,28,15-19,1949,0.007779027184176378
STAT,1853,18,45-49,1871,4.909437140475014E-4
STAT,1893,29,40-44,1922,0.0375004349718104
STAT,1902,40,35-39,1942,0.0017911549555589127
STAT,1915,24,40-44,1939,0.03424046184529781
SIM,1844,39,na,1883,6
SIM,1903,51,na,1954,35
STAT,1887,41,na,1928,25.34150870028299
STAT,1890,39,na,1929,28.33009424212609
STAT,1863,37,na,1900,20.859765604711146
STAT,1893,45,45-49,1938,0.0016952601956124861
STAT,1915,17,35-39,1932,0.008706464437194509
STAT,1786,99,na,1885,0.0015707369253986096
STAT,1856,28,40-44,1884,0.022325606330196247
SIM,1840,49,na,1889,17
STAT,1888,21,35-39,1909,0.06839918682716398
STAT,1894,29,na,1923,30.366888043248306
STAT,1897,21,45-49,1918,0.009288076568148493
STAT,1906,6,na,1912,37.95274032460739
STAT,1887,48,25-29,1935,6.208087089347932E-4
STAT,1839,18,na,1857,16.473379335676988
STAT,1924,17,45-49,1941,0.005910012430727366
SIM,1938,33,na,1971,39
STAT,1911,24,40-44,1935,0.03148460093471526
SIM,1882,78,na,1960,12
STAT,1892,40,50-100,1932,0.013183181595539377
STAT,1906,24,30-34,1930,0.25715966294852693
STAT,1788,100,na,1888,0.002677423858767302
STAT,1901,40,50-100,1941,0.0010368924275157793
STAT,1833,22,30-34,1855,0.17727386849070495
STAT,1883,51,na,1934,21.00905401463376
STAT,1930,35,30-34,1965,0.02370280299368435
STAT,1794,94,na,1888,0.04970869187574087
STAT,1866,15,20-24,1881,0.16958186079766366
SIM,1837,51,na,1888,29
STAT,1864,42,15-19,1906,1.237110255296302E-4
STAT,1884,45,35-39,1929,0.001385327519872106
SIM,1852,34,na,1886,24
STAT,1909,27,20-24,1936,0.17347267647957057
STAT,1917,21,40-44,1938,0.03551771651198683
SIM,1872,18,20-24,1890,1
SIM,1917,27,20-24,1944,2
SIM,1893,16,na,1909,39
SIM,1825,32,na,1857,20
STAT,1852,99,na,1951,0.01620862706163094
STAT,1871,29,20-24,1900,0.11612665754533963
STAT,1866,47,40-44,1913,0.0015693696657662374
STAT,1915,46,50-100,1961,0.002265060323444397
SIM,1897,27,25-29,1924,3
STAT,1895,70,na,1965,20.840756151664607
STAT,1927,25,15-19,1952,0.008596460788791343
STAT,1843,44,35-39,1887,0.007708747157495162
STAT,1864,18,20-24,1882,0.1635247494803066
SIM,1880,43,na,1923,32
STAT,1852,28,40-44,1880,0.029646626588727944
STAT,1837,82,na,1919,2.2560393953635334
STAT,1845,49,30-34,1894,5.540288973541027E-4
STAT,1862,83,na,1945,3.425063382141418
STAT,1936,25,50-100,1961,0.009476319148116525
STAT,1851,39,45-49,1890,0.01666024824085647
STAT,1868,74,na,1942,10.739926795494533
SIM,1824,84,na,1908,3
SIM,1926,14,na,1940,49
SIM,1808,60,na,1868,8
STAT,1948,17,30-34,1965,0.1385685538031154
STAT,1875,45,25-29,1920,5.979976129743256E-4
STAT,1883,15,50-100,1898,4.7796146155146957E-4
STAT,1857,31,15-19,1888,0.0010838532037124
STAT,1913,35,na,1948,37.16678425054788
SIM,1948,4,na,1952,43
STAT,1890,32,15-19,1922,0.0017298301397878813
STAT,1913,38,35-39,1951,0.023552614475345242
STAT,1856,26,15-19,1882,0.0034304796716374164
STAT,1927,43,45-49,1970,0.0020733350877767463
SIM,1904,9,na,1913,33
STAT,1831,36,25-29,1867,0.029754648853415114
STAT,1930,28,25-29,1958,0.8326188213054537
STAT,1863,54,50-100,1917,1.3004218865840693E-4
STAT,1939,33,25-29,1972,0.09359901712083385
STAT,1868,44,40-44,1912,0.021473444133021883
SIM,1863,71,na,1934,4
STAT,1831,91,na,1922,0.47024288755994686
STAT,1829,87,na,1916,1.1967115192972309
STAT,1869,34,45-49,1903,0.01675195310341215
STAT,1921,30,na,1951,42.0958259299352
STAT,1931,7,na,1938,52.0892907998865
SIM,1907,21,20-24,1928,1
STAT,1920,17,45-49,1937,0.0055568600471040865
SIM,1849,30,20-24,1879,1
STAT,1858,23,15-19,1881,0.026022546274335496
STAT,1845,41,35-39,1886,0.01091798006430266
STAT,1847,20,35-39,1867,0.07752809349669365
STAT,1925,28,15-19,1953,0.008256774023647303
STAT,1933,22,35-39,1955,0.12438865085000794
SIM,1924,13,na,1937,55
STAT,1823,96,na,1919,0.04938084511923183
STAT,1916,17,50-100,1933,7.880929385228824E-4
STAT,1844,64,na,1908,13.578231598215906
STAT,1889,37,50-100,1926,0.015031643860685234
STAT,1955,7,na,1962,51.88542568291634
STAT,1860,34,25-29,1894,0.08255665697231045
SIM,1837,57,na,1894,28
STAT,1872,37,25-29,1909,0.029459087637435537
STAT,1844,43,40-44,1887,0.017764511110938096
SIM,1799,78,na,1877,7
STAT,1827,43,40-44,1870,0.017350452232940593
STAT,1924,22,25-29,1946,1.0828574765915808
STAT,1825,49,45-49,1874,0.0021201627246173822
STAT,1852,24,50-100,1876,0.004086712857984351
STAT,1865,33,30-34,1898,0.1572545075788993
STAT,1922,33,15-19,1955,0.0014352282328548625
STAT,1858,84,na,1942,2.5313828825121405
STAT,1854,54,na,1908,12.798998508272307
STAT,1840,47,50-100,1887,0.0019407047232188096
STAT,1841,18,50-100,1859,6.148375354132845E-4
STAT,1907,22,25-29,1929,0.8373610751682572
SIM,1953,16,na,1969,48
STAT,1851,20,25-29,1871,0.585514534134172
SIM,1929,28,25-29,1957,1
STAT,1854,23,45-49,1877,0.004972064152409784
STAT,1808,49,45-49,1857,0.0016555697579899926
STAT,1917,45,40-44,1962,0.0016395097817345407
STAT,1910,42,50-100,1952,0.0011034981593661007
SIM,1843,51,na,1894,19
STAT,1830,30,35-39,1860,0.07151738373761501
STAT,1839,36,25-29,1875,0.019185775294129008
SIM,1932,22,25-29,1954,3
STAT,1864,20,35-39,1884,0.053953412231313884
STAT,1894,34,40-44,1928,0.05510316160797947
SIM,1842,20,25-29,1862,3
SIM,1924,4,na,1928,56
SIM,1868,49,na,1917,31
STAT,1904,45,30-34,1949,7.902052898524192E-4
STAT,1879,29,20-24,1908,0.12055387040318305
STAT,1889,27,25-29,1916,0.5179097056321259
STAT,1811,43,45-49,1854,0.0638064640882576
STAT,1834,20,25-29,1854,0.5488980142820618
STAT,1938,28,25-29,1966,0.6474752454276381
STAT,1895,76,na,1971,16.883289399619525
STAT,1910,35,45-49,1945,0.006541647962582846
SIM,1901,0,na,1901,43
STAT,1914,19,40-44,1933,0.002853976401540521
STAT,1922,40,20-24,1962,2.017793859927354E-4
STAT,1896,24,na,1920,30.87128770473245
SIM,1915,22,25-29,1937,2
STAT,1848,54,na,1902,13.541614910470958
STAT,1865,32,na,1897,21.583881414597077
STAT,1910,19,50-100,1929,7.338767991462665E-4
STAT,1868,8,na,1876,26.58757051538383
STAT,1906,0,na,1906,42.65956142958299
STAT,1878,54,50-100,1932,1.5163564514013262E-4
STAT,1850,64,na,1914,15.47773317732176
STAT,1897,27,15-19,1924,0.0060249673629490545
SIM,1831,66,na,1897,4
STAT,1848,33,30-34,1881,0.11858683754679757
STAT,1840,41,15-19,1881,1.1433704334874422E-4
STAT,1858,30,20-24,1888,0.021000409388486525
STAT,1807,78,na,1885,3.8205176014687883
SIM,1846,34,na,1880,15
SIM,1918,19,na,1937,38
STAT,1813,72,na,1885,9.16315112840214
STAT,1901,10,na,1911,36.245628541639086
STAT,1828,33,45-49,1861,0.012773896657622217
STAT,1926,35,40-44,1961,0.01822209476321084
SIM,1851,86,na,1937,3
STAT,1848,26,25-29,1874,0.3289445684602192
STAT,1923,32,20-24,1955,0.027768922516846106
STAT,1875,56,na,1931,20.96625810045844
STAT,1922,18,na,1940,42.175141580759245
STAT,1870,5,na,1875,27.71121601169769
STAT,1884,39,na,1923,22.85041480075538
STAT,1859,32,na,1891,18.966803239862926
STAT,1788,94,na,1882,0.050867724079640395
STAT,1908,21,30-34,1929,0.26364889942495257
STAT,1904,38,25-29,1942,0.00886052352494266
STAT,1867,20,20-24,1887,0.6717944445432369
STAT,1839,43,30-34,1882,0.006601717189624172
STAT,1865,26,25-29,1891,0.38392401761290035
STAT,1829,25,45-49,1854,0.027891820477264306
SIM,1793,81,na,1874,7
STAT,1867,48,50-100,1915,0.0023207635983320957
STAT,1826,73,na,1899,8.30021618322061
STAT,1851,12,na,1863,24.503326534352087
STAT,1853,33,40-44,1886,0.027777530015676594
STAT,1819,63,na,1882,9.77980171066782
SIM,1907,47,na,1954,38
STAT,1780,74,na,1854,7.999999999999999
STAT,1873,18,30-34,1891,0.016162296600795503
STAT,1895,24,45-49,1919,0.008996340358557708
STAT,1898,19,na,1917,33.88773571062427
STAT,1864,84,na,1948,2.98373229459386
STAT,1870,37,20-24,1907,0.007657524836050249
SIM,1862,58,na,1920,21
SIM,1817,37,na,1854,10
STAT,1886,42,35-39,1928,0.018759836419814054
STAT,1880,29,30-34,1909,0.2629084633905576
SIM,1848,60,na,1908,24
SIM,1823,37,na,1860,11
STAT,1896,16,45-49,1912,8.601419644341217E-4
SIM,1901,56,na,1957,31
STAT,1852,48,50-100,1900,0.0020755519620426453
STAT,1846,99,na,1945,0.015348430765369056
STAT,1889,76,na,1965,14.874953423596127
STAT,1903,46,25-29,1949,4.6324965016366265E-4
STAT,1891,8,na,1899,31.905889412400196
STAT,1889,34,30-34,1923,0.21193468565556683
STAT,1778,103,na,1881,6.003548043677266E-4
SIM,1806,65,na,1871,6
STAT,1947,18,25-29,1965,0.484664532545534
STAT,1841,15,15-19,1856,0.07580900589790793
STAT,1820,39,15-19,1859,5.097361556403979E-4
STAT,1868,29,45-49,1897,0.01066811045656129
STAT,1825,30,25-29,1855,0.1499902621361042
STAT,1910,17,15-19,1927,0.08937626752601265
SIM,1821,42,na,1863,14
STAT,1881,56,na,1937,19.408003610268725
SIM,1947,16,na,1963,36
STAT,1830,38,30-34,1868,0.030525612731408344
SIM,1800,74,na,1874,8
SIM,1876,78,na,1954,11
STAT,1834,44,25-29,1878,0.005332387287252024
STAT,1892,21,25-29,1913,0.7093518110421299
SIM,1924,19,na,1943,51
SIM,1887,16,na,1903,26
SIM,1920,29,na,1949,45
SIM,1829,93,na,1922,2
STAT,1893,42,40-44,1935,0.028325693254830867
STAT,1901,17,50-100,1918,6.855281668917024E-4
STAT,1904,28,15-19,1932,0.006478177693031422
SIM,1851,80,na,1931,7
STAT,1866,25,30-34,1891,0.23349407716836088
STAT,1830,44,na,1874,9.011930198664526
STAT,1911,40,na,1951,35.618048633479084
STAT,1845,39,20-24,1884,0.004637093037851841
STAT,1817,51,30-34,1868,1.6882056323656595E-4
STAT,1852,28,na,1880,21.409548828999178
STAT,1888,19,20-24,1907,0.20606423070289484
STAT,1876,45,45-49,1921,0.0024208202759753565
SIM,1794,69,na,1863,1
STAT,1884,42,30-34,1926,0.011250029219125095
STAT,1850,15,25-29,1865,0.0623874288899864
SIM,1882,16,25-29,1898,2
STAT,1911,27,45-49,1938,0.01673933713475077
STAT,1951,2,na,1953,47.16509850200794
STAT,1874,16,25-29,1890,0.057629665899425066
STAT,1809,54,45-49,1863,4.5600629164608094E-4
SIM,1815,42,na,1857,13
STAT,1798,56,na,1854,19.000000000000004
STAT,1826,51,40-44,1877,1.043512768184909E-4
SIM,1862,24,na,1886,21
SIM,1917,31,na,1948,41
SIM,1932,14,na,1946,53
STAT,1860,29,45-49,1889,0.008992638542106964
STAT,1932,17,35-39,1949,0.05533829738804812
STAT,1835,87,na,1922,0.792448572475437
STAT,1883,39,50-100,1922,0.011802388922035709
SIM,1855,48,na,1903,14
STAT,1910,25,35-39,1935,0.14630187645567116
STAT,1817,62,na,1879,16.85717162232392
STAT,1831,33,20-24,1864,0.028205314144566344
STAT,1851,36,40-44,1887,0.03774186364407396
STAT,1849,31,25-29,1880,0.09292601282087518
STAT,1905,34,50-100,1939,0.007528003176312393
STAT,1836,18,45-49,1854,8.420699214448787E-4
SIM,1872,88,na,1960,3
SIM,1784,70,na,1854,3
STAT,1834,39,45-49,1873,0.0171630336288966
STAT,1832,45,na,1877,11.161189683429107
STAT,1857,41,25-29,1898,0.004828990778788771
STAT,1861,26,50-100,1887,0.005457798881311355
STAT,1833,21,na,1854,21.429627650847458
STAT,1896,29,50-100,1925,0.008342534913159661
STAT,1947,25,30-34,1972,0.4406395786145229
STAT,1838,30,35-39,1868,0.09971923836147394
SIM,1850,39,na,1889,21
STAT,1867,52,40-44,1919,1.0020913411234977E-4
STAT,1953,0,na,1953,52.13473148293298
STAT,1885,48,20-24,1933,1.1701280253129593E-4
STAT,1927,40,40-44,1967,0.003129575078851123
STAT,1860,54,na,1914,17.02329894803719
STAT,1835,56,na,1891,9.174128017596152
STAT,1867,27,na,1894,22.838086223757802
STAT,1906,27,35-39,1933,0.14018115964681704
STAT,1891,16,25-29,1907,0.06972219283127201
SIM,1842,75,na,1917,11
STAT,1908,24,35-39,1932,0.08557491191774524
STAT,1822,49,50-100,1871,0.001314145488228371
STAT,1937,11,na,1948,38.36026420843835
STAT,1878,24,45-49,1902,0.007154201632817453
STAT,1906,25,na,1931,34.90701215434574
SIM,1888,63,na,1951,26
STAT,1912,38,15-19,1950,1.850390072105514E-4
STAT,1857,26,35-39,1883,0.07493881917510332
STAT,1838,43,50-100,1881,0.008615132982091371
STAT,1848,20,na,1868,17.080508976097516
STAT,1887,23,40-44,1910,0.022674652893713912
STAT,1893,41,na,1934,29.273759049976615
STAT,1946,22,na,1968,40.35084420618752
STAT,1911,30,35-39,1941,0.08912333750992542
STAT,1859,39,15-19,1898,4.418338683544051E-4
STAT,1922,12,na,1934,45.520060220606894
SIM,1902,32,na,1934,33
STAT,1877,51,na,1928,22.33265603336103
STAT,1883,21,15-19,1904,0.03213293094306231
SIM,1814,94,na,1908,2
SIM,1874,25,30-34,1899,1
STAT,1843,41,30-34,1884,0.005085980850748885
STAT,1887,45,20-24,1932,1.3228675740894273E-4
STAT,1904,24,na,1928,33.676412882068206
STAT,1811,100,na,1911,0.0060164616885929525
STAT,1913,35,30-34,1948,0.01800518704970216
STAT,1871,31,35-39,1902,0.10137949879263257
STAT,1889,20,40-44,1909,0.025664955681861442
STAT,1879,25,50-100,1904,0.006665798413954959
SIM,1867,33,na,1900,15
STAT,1863,37,15-19,1900,4.971911492381315E-4
SIM,1846,65,na,1911,6
STAT,1858,45,25-29,1903,4.426738392730754E-4
STAT,1921,45,30-34,1966,0.0010018085743291843
STAT,1816,49,35-39,1865,0.0017118842633422886
STAT,1871,38,50-100,1909,0.012179886355984212
STAT,1819,97,na,1916,0.027577307638594787
STAT,1925,36,35-39,1961,0.02887491497992159
SIM,1858,50,na,1908,24
STAT,1875,21,25-29,1896,0.5902283680511516
STAT,1866,37,30-34,1903,0.04908442823639513
STAT,1856,20,45-49,1876,0.005952161954550752
SIM,1879,58,na,1937,11
STAT,1899,66,na,1965,24.843187538864097
STAT,1838,30,na,1868,21.34051232333517
STAT,1848,7,na,1855,19.842599999999997
SIM,1858,59,na,1917,23
SIM,1907,22,35-39,1929,1
STAT,1839,33,20-24,1872,0.018167456755439963
STAT,1867,30,30-34,1897,0.1684256436309281
STAT,1912,32,45-49,1944,0.015362742296397863
SIM,1887,2,na,1889,30
STAT,1905,33,15-19,1938,0.0011751653299640302
STAT,1836,69,na,1905,14.163335807807856
STAT,1890,48,30-34,1938,6.549334210893199E-4
STAT,1919,49,25-29,1968,5.670185653574861E-4
STAT,1921,25,50-100,1946,0.011081361482245592
STAT,1844,46,45-49,1890,0.001848618039807694
STAT,1931,33,25-29,1964,0.12049762192305247
STAT,1823,62,na,1885,10.984748438556343
SIM,1911,46,na,1957,40
STAT,1907,8,na,1915,38.024903049749675
STAT,1923,42,30-34,1965,0.0014839046029567187
SIM,1910,61,na,1971,27
STAT,1830,28,20-24,1858,0.09608963697834146
STAT,1850,101,na,1951,0.005080632184518085
STAT,1888,39,40-44,1927,0.05064055527352283
STAT,1928,37,na,1965,47.3139111289342
STAT,1939,23,15-19,1962,0.05307545981499185
SIM,1839,36,35-39,1875,1
STAT,1861,34,45-49,1895,0.014539215100851165
STAT,1865,18,40-44,1883,0.001694721032988601
STAT,1821,44,15-19,1865,2.0145955866641033E-4
SIM,1924,21,20-24,1945,3
STAT,1843,17,na,1860,12.443367921351065
STAT,1898,27,35-39,1925,0.13016412814743286
SIM,1905,46,na,1951,40
SIM,1908,29,na,1937,39
STAT,1946,22,45-49,1968,0.01243268789008589
SIM,1896,29,30-34,1925,1
STAT,1802,63,na,1865,7.6315175667728585
STAT,1856,39,50-100,1895,0.008804662065424192
STAT,1871,7,na,1878,27.29274399173834
STAT,1905,43,25-29,1948,6.389312333023032E-4
STAT,1888,29,30-34,1917,0.2921719451029315
STAT,1919,39,15-19,1958,2.040791727393495E-4
STAT,1922,27,20-24,1949,0.20504150382769637
SIM,1878,73,na,1951,12
STAT,1867,39,40-44,1906,0.0414693615101479
SIM,1832,25,25-29,1857,1
SIM,1899,72,na,1971,10
STAT,1806,90,na,1896,0.368909957163425
STAT,1830,40,45-49,1870,0.008439372438090585
SIM,1827,67,na,1894,5
STAT,1916,21,20-24,1937,1.158697090598961
STAT,1811,77,na,1888,4.788859877144508
STAT,1890,0,na,1890,35.667764521736345
STAT,1842,20,15-19,1862,0.031672602285852856
STAT,1918,10,na,1928,42.866034112664664
SIM,1925,0,na,1925,47
STAT,1870,18,15-19,1888,0.05916419605831185
STAT,1840,104,na,1944,5.226556731083561E-4
STAT,1871,66,na,1937,16.340936989618836
STAT,1925,46,45-49,1971,0.00262364797492531
STAT,1823,31,na,1854,17.2646247317024
SIM,1895,45,na,1940,27
STAT,1880,44,20-24,1924,0.0016474614414431735
STAT,1879,31,35-39,1910,0.10524449094915986
STAT,1898,32,15-19,1930,0.0019210807521911222
SIM,1866,33,25-29,1899,1
STAT,1842,39,35-39,1881,0.05548425372028191
STAT,1846,22,40-44,1868,0.020837178460309195
STAT,1884,67,na,1951,15.531202606867765
STAT,1927,23,50-100,1950,0.008040542003567816
STAT,1939,28,45-49,1967,0.017240247477473356
SIM,1837,29,25-29,1866,1
SIM,1902,8,na,1910,38
STAT,1865,23,20-24,1888,0.6263518521183474
STAT,1819,49,20-24,1868,1.0518771866821762E-4
SIM,1839,52,na,1891,20
STAT,1909,49,50-100,1958,0.002054573546899685
SIM,1943,17,20-24,1960,1
STAT,1847,38,40-44,1885,0.04801657586828249
SIM,1838,39,na,1877,8
STAT,1907,32,35-39,1939,0.0850584419841982
STAT,1831,97,na,1928,0.04359540815560283
STAT,1858,33,25-29,1891,0.07761164416737838
STAT,1842,69,na,1911,11.01066909649988
STAT,1926,38,45-49,1964,0.008275508637396112
STAT,1826,45,na,1871,18.317765981437482
STAT,1899,24,15-19,1923,0.044878730764663526
STAT,1805,77,na,1882,2.8730552801632787
STAT,1844,30,na,1874,20.66822214206558
STAT,1949,22,30-34,1971,0.3332307764341149
STAT,1822,36,15-19,1858,3.541869571912376E-4
STAT,1935,17,20-24,1952,1.8451822999650078
STAT,1862,39,50-100,1901,0.010485921214616082
SIM,1946,3,na,1949,55
SIM,1884,73,na,1957,11
STAT,1839,28,40-44,1867,0.020676077348366607
STAT,1951,18,15-19,1969,0.5369817752429696
STAT,1934,37,na,1971,51.69727737504438
STAT,1921,35,20-24,1956,0.0029255152652081563
SIM,1819,38,na,1857,7
STAT,1911,40,45-49,1951,0.0015961282760371342
STAT,1825,46,40-44,1871,0.0016013796799695136
SIM,1856,24,na,1880,14
STAT,1842,15,35-39,1857,0.005349405792967272
SIM,1772,85,na,1857,2
STAT,1930,18,15-19,1948,0.5824606056372678
STAT,1839,103,na,1942,7.919964996454641E-4
STAT,1854,34,50-100,1888,0.00561728529403344
STAT,1834,26,50-100,1860,0.0059706450787529175
SIM,1914,29,na,1943,36
STAT,1916,16,40-44,1932,0.002949440481805462
STAT,1886,65,na,1951,17.52941185724193
SIM,1864,59,na,1923,17
STAT,1922,38,50-100,1960,0.004737629787706019
STAT,1864,30,45-49,1894,0.015766462774366292
SIM,1951,15,na,1966,51
STAT,1829,29,25-29,1858,0.42425166192155583
STAT,1835,44,45-49,1879,0.007916073376411892
STAT,1902,34,40-44,1936,0.03481501447971703
STAT,1892,37,40-44,1929,0.05408000437406538
STAT,1882,16,15-19,1898,0.05701308027668228
STAT,1872,34,20-24,1906,0.02742010440200569
STAT,1867,42,30-34,1909,0.010988326486049868
STAT,1844,28,15-19,1872,0.004307119561591105
STAT,1877,19,45-49,1896,6.706826539311833E-4
SIM,1828,46,na,1874,13
STAT,1804,95,na,1899,0.051617497164389944
STAT,1865,40,50-100,1905,0.009651891780593794
STAT,1913,37,20-24,1950,0.0025796987759483165
STAT,1943,27,20-24,1970,0.19298961685565144
STAT,1924,44,na,1968,43.742575851111255
STAT,1829,56,na,1885,14.261112724613692
SIM,1929,25,na,1954,46
SIM,1866,85,na,1951,1
STAT,1860,38,40-44,1898,0.03541138719137258
STAT,1892,15,30-34,1907,0.019782271217854516
STAT,1822,83,na,1905,1.4081748441376314
STAT,1891,15,na,1906,31.14239828021954
STAT,1857,48,45-49,1905,0.0017445161311451301
SIM,1811,80,na,1891,1
STAT,1859,100,na,1959,0.016106196908100723
STAT,1922,37,30-34,1959,0.02058663675870209
STAT,1871,41,45-49,1912,0.014989024201649229
STAT,1907,26,40-44,1933,0.043968028241308674
SIM,1841,25,na,1866,15
STAT,1848,16,15-19,1864,0.04785799749224992
STAT,1834,29,35-39,1863,0.08813343758093922
STAT,1834,36,40-44,1870,0.03888086573355706
STAT,1855,19,25-29,1874,0.04689699759200349
STAT,1804,50,45-49,1854,4.147591772487543E-4
STAT,1926,41,35-39,1967,0.00247180421737148
SIM,1852,65,na,1917,19
SIM,1911,15,na,1926,42
SIM,1865,9,na,1874,25
STAT,1853,75,na,1928,6.469975759274365
STAT,1876,23,50-100,1899,0.004128908090052946
STAT,1865,17,50-100,1882,4.5663258940018236E-4
SIM,1839,83,na,1922,3
STAT,1821,48,30-34,1869,0.0013476532620516942
STAT,1867,35,25-29,1902,0.027814453615733276
STAT,1893,9,na,1902,32.71514124337152
STAT,1810,98,na,1908,0.011676758456775469
STAT,1862,41,35-39,1903,0.015693751473738943
STAT,1939,25,40-44,1964,0.04657651099426392
SIM,1880,12,na,1892,34
SIM,1938,18,25-29,1956,2
STAT,1874,25,20-24,1899,0.11982199930414862
STAT,1912,59,na,1971,32.94086587138561
STAT,1885,47,45-49,1932,0.002319669874586551
SIM,1859,38,na,1897,18
STAT,1839,46,35-39,1885,7.973280868897246E-4
STAT,1835,50,na,1885,10.268253474193353
STAT,1878,36,na,1914,24.440592269188585
SIM,1923,34,na,1957,38
STAT,1897,25,25-29,1922,0.5655550570644794
STAT,1902,25,45-49,1927,0.015763570970793245
STAT,1909,25,50-100,1934,0.009604126994070386
STAT,1880,77,na,1957,9.886590139538624
STAT,1821,40,35-39,1861,0.030256230068505006
STAT,1842,38,na,1880,18.656026739490553
STAT,1924,16,30-34,1940,0.14455850095530653
STAT,1849,33,15-19,1882,0.001151549200679559
STAT,1884,30,na,1914,23.56786023044545
SIM,1822,58,na,1880,12
STAT,1900,16,45-49,1916,9.080401085571669E-4
STAT,1872,42,na,1914,23.618802122978966
SIM,1784,79,na,1863,1
SIM,1864,50,na,1914,22
STAT,1949,15,50-100,1964,0.004331809751061944
SIM,1889,11,na,1900,34
STAT,1899,46,25-29,1945,4.4604573735823995E-4
STAT,1868,48,20-24,1916,1.1467027031425116E-4
STAT,1953,9,na,1962,47.26169464846258
STAT,1893,32,30-34,1925,0.2201456236342557
STAT,1876,54,40-44,1930,1.0398329564392969E-4
STAT,1903,24,15-19,1927,0.046609696237993936
STAT,1892,7,na,1899,32.1867694285581
SIM,1877,23,na,1900,27
SIM,1877,26,na,1903,26
STAT,1857,35,30-34,1892,0.040276560385343066
STAT,1892,27,30-34,1919,0.31109911439871984
STAT,1907,19,35-39,1926,0.00798320839124435
SIM,1878,70,na,1948,17
STAT,1814,88,na,1902,0.6117656735219069
STAT,1858,49,40-44,1907,0.0012755371396650002
STAT,1826,76,na,1902,6.620616751953804
STAT,1885,29,15-19,1914,0.0044483576546966285
STAT,1917,18,15-19,1935,0.09651994349841826
SIM,1882,26,35-39,1908,1
STAT,1830,35,50-100,1865,0.007501654640321747
STAT,1885,40,25-29,1925,0.006405382774462989
STAT,1849,40,20-24,1889,0.001252944307394233
STAT,1825,36,30-34,1861,0.056943276760720724
STAT,1859,63,na,1922,14.181951493674713
STAT,1898,50,na,1948,29.464465094099637
STAT,1850,40,50-100,1890,0.009501189539219383
SIM,1860,60,na,1920,16
STAT,1857,23,30-34,1880,0.15283291636596627
STAT,1956,15,30-34,1971,0.16046324447161947
STAT,1876,42,40-44,1918,0.02281654896277521
STAT,1908,43,40-44,1951,0.002288304442910551
STAT,1899,34,25-29,1933,0.13901399472541648
STAT,1809,51,40-44,1860,3.5123252898641694E-4
STAT,1874,26,35-39,1900,0.09822347430687925
STAT,1925,24,35-39,1949,0.11130129649356878
SIM,1839,86,na,1925,2
STAT,1818,38,15-19,1856,7.152619581596253E-4
STAT,1860,26,40-44,1886,0.024792059911425923
SIM,1880,15,na,1895,32
STAT,1919,46,20-24,1965,1.1912077693438777E-4
STAT,1937,17,na,1954,35.58173118890973
STAT,1805,103,na,1908,3.9294687625638904E-4
STAT,1899,30,50-100,1929,0.01264361423674163
STAT,1888,24,50-100,1912,0.004735598271376821
STAT,1914,42,20-24,1956,1.7354344016175857E-4
STAT,1880,71,na,1951,14.036137166696427
STAT,1870,36,45-49,1906,0.019898382584263907
STAT,1893,25,25-29,1918,0.5369875889606
STAT,1856,41,50-100,1897,0.007687919104992389
STAT,1916,18,na,1934,40.520950182752564
STAT,1936,32,na,1968,36.51344466465851
STAT,1825,103,na,1928,7.736943285443143E-4
STAT,1807,52,50-100,1859,3.094683885246184E-4
STAT,1843,34,25-29,1877,0.05115983541736943
STAT,1898,29,25-29,1927,0.5665680157721643
STAT,1921,48,35-39,1969,0.0014381002507662297
STAT,1874,77,na,1951,8.769184057957542
STAT,1891,18,na,1909,30.917159564425084
STAT,1893,20,30-34,1913,0.2259310832067779
STAT,1901,17,40-44,1918,0.002559305778754846
STAT,1908,31,40-44,1939,0.03689713172381339
SIM,1854,60,na,1914,15
STAT,1875,23,15-19,1898,0.033807270825587966
STAT,1898,24,30-34,1922,0.23878360977122026
STAT,1835,41,40-44,1876,0.01236767899907045
STAT,1948,20,20-24,1968,1.2691707735400437
STAT,1859,60,na,1919,15.158586128741149
STAT,1911,16,20-24,1927,0.27021267074593064
STAT,1930,31,15-19,1961,0.0016516002070105357
STAT,1943,11,na,1954,41.4133154325231
SIM,1815,73,na,1888,4
SIM,1816,58,na,1874,9
STAT,1909,30,na,1939,36.17702750887807
STAT,1911,20,25-29,1931,0.8755750349726589
STAT,1889,17,15-19,1906,0.07265858644436643
SIM,1828,43,na,1871,16
STAT,1934,33,40-44,1967,0.053170840988210157
STAT,1826,41,30-34,1867,0.012392506774300037
STAT,1905,40,20-24,1945,1.6077105845672512E-4
STAT,1930,5,na,1935,51.739151044273655
STAT,1873,92,na,1965,1.1997644506759262
STAT,1886,62,na,1948,18.958439387717135
STAT,1896,31,50-100,1927,0.01208439866361788
SIM,1847,19,na,1866,22
STAT,1887,26,45-49,1913,0.012160633877222703
STAT,1934,15,50-100,1949,0.005069569208147363
STAT,1846,90,na,1936,0.6389461181603975
STAT,1822,46,25-29,1868,3.2053209283357996E-4
STAT,1861,31,40-44,1892,0.03661889572770662
STAT,1920,20,35-39,1940,0.10440716482943832
STAT,1843,22,25-29,1865,0.3048041200064737
STAT,1852,34,35-39,1886,0.08789440285001905
STAT,1849,47,40-44,1896,0.0013212811707405256
STAT,1856,18,30-34,1874,0.013572591847130682
STAT,1847,42,50-100,1889,0.011348351230866041
STAT,1789,79,na,1868,1.7681876950222126
STAT,1925,31,40-44,1956,0.04620657859513711
STAT,1940,32,20-24,1972,0.02506512841517995
STAT,1811,43,na,1854,17.63430874256086
STAT,1914,33,50-100,1947,0.00821870141904413
STAT,1785,80,na,1865,7.094495546178082
STAT,1896,55,na,1951,27.160162007386784
STAT,1817,44,25-29,1861,0.019103061954472755
STAT,1867,24,50-100,1891,0.0038779637312791135
SIM,1865,28,25-29,1893,1
STAT,1898,36,30-34,1934,0.07224209000317718
STAT,1902,37,45-49,1939,0.006067703053474413
STAT,1951,21,40-44,1972,0.03994131420855993
SIM,1843,20,na,1863,23
STAT,1847,18,20-24,1865,0.23497609435076655
SIM,1891,55,na,1946,31
STAT,1862,39,20-24,1901,0.00658367610943115
STAT,1894,40,35-39,1934,0.02344141197552525
STAT,1934,21,40-44,1955,0.04500952700666534
STAT,1880,47,25-29,1927,6.028707980576344E-4
SIM,1916,55,na,1971,44
STAT,1912,36,25-29,1948,0.009580636976740891
STAT,1924,47,na,1971,43.45260109844196
STAT,1846,25,45-49,1871,0.011043625154137695
STAT,1863,47,25-29,1910,5.076114253618407E-4
STAT,1866,48,na,1914,20.460263214862835
STAT,1902,19,15-19,1921,0.08323943981059063
STAT,1857,28,25-29,1885,0.32383497336047673
STAT,1884,35,25-29,1919,0.028476894665284594
SIM,1911,49,na,1960,38
STAT,1907,5,na,1912,38.33343069732766
STAT,1920,28,30-34,1948,0.42466542675279995
STAT,1836,35,na,1871,25.903985525123005
STAT,1852,41,40-44,1893,0.019337490476897097
SIM,1874,12,na,1886,28
STAT,1841,41,50-100,1882,0.010883840976746183
SIM,1907,31,30-34,1938,1
STAT,1916,24,25-29,1940,0.9536250418744529
STAT,1887,10,na,1897,28.27360880836521
SIM,1796,64,na,1860,10
STAT,1860,57,na,1917,16.33775157305421
STAT,1884,23,25-29,1907,0.5591319228656244
STAT,1885,18,na,1903,24.87538981743662
STAT,1909,49,30-34,1958,8.097830612933774E-4
STAT,1851,26,30-34,1877,0.25071746217764446
STAT,1866,11,na,1877,24.91184660383712
STAT,1856,24,25-29,1880,0.47475102119060525
STAT,1839,35,50-100,1874,0.008266561920619643
STAT,1931,26,na,1957,48.17189797241811
STAT,1816,47,45-49,1863,0.002974548570176081
STAT,1837,23,45-49,1860,0.004587390448964561
STAT,1816,51,50-100,1867,1.863797810215428E-4
STAT,1915,27,45-49,1942,0.017469089418646798
SIM,1853,13,na,1866,29
STAT,1841,50,na,1891,21.378389211492472
STAT,1883,38,45-49,1921,0.019262362315635804
STAT,1826,34,25-29,1860,0.1277229109615797
STAT,1890,30,50-100,1920,0.01121912307362433
STAT,1853,78,na,1931,4.9105292713143935
STAT,1791,80,na,1871,2.3883488321506743
STAT,1931,30,20-24,1961,0.03185545418186657
STAT,1909,41,35-39,1950,0.0018836805125775878
STAT,1821,50,45-49,1871,2.049938288698964E-4
STAT,1903,45,na,1948,32.31163322757879
STAT,1843,38,40-44,1881,0.01952298726639381
SIM,1928,40,na,1968,54
STAT,1849,43,25-29,1892,0.004943260923899296
STAT,1828,71,na,1899,8.964640533426511
SIM,1849,45,na,1894,7
STAT,1872,15,45-49,1887,6.785284199735351E-4
STAT,1906,15,35-39,1921,0.008008771116902309
STAT,1898,49,45-49,1947,0.001758343489147038
STAT,1902,22,40-44,1924,0.029385594024268602
SIM,1905,12,na,1917,40
SIM,1942,18,15-19,1960,2
STAT,1861,28,15-19,1889,0.0038155626572036134
STAT,1907,18,50-100,1925,7.147518991642988E-4
STAT,1926,27,20-24,1953,0.2175712758387665
STAT,1897,19,30-34,1916,0.021052367056467344
SIM,1846,31,na,1877,15
SIM,1934,27,20-24,1961,1
SIM,1883,26,na,1909,14
SIM,1908,26,na,1934,37
STAT,1821,36,na,1857,17.886820467326718
STAT,1916,40,50-100,1956,0.0011969277079346343
SIM,1887,84,na,1971,9
SIM,1902,2,na,1904,38
SIM,1924,28,40-44,1952,1
STAT,1851,24,40-44,1875,0.020707869762912487
SIM,1861,79,na,1940,7
STAT,1890,30,na,1920,29.219587794603346
STAT,1893,44,na,1937,28.847822446755483
STAT,1929,1,na,1930,53.04069306476636
STAT,1899,31,20-24,1930,0.0371542980936549
SIM,1898,25,na,1923,32
STAT,1930,38,35-39,1968,0.03137005090886562
STAT,1915,30,na,1945,38.49304341747231
STAT,1838,19,25-29,1857,0.05741310571679103
STAT,1833,25,35-39,1858,0.09551977231178946
STAT,1939,27,30-34,1966,0.3912000814456266
STAT,1882,18,40-44,1900,0.0017482476420234584
STAT,1884,30,30-34,1914,0.17243694155824446
SIM,1857,71,na,1928,10
STAT,1930,25,20-24,1955,0.2312221528171926
STAT,1860,23,na,1883,19.67818487443568
SIM,1842,26,30-34,1868,2
STAT,1921,38,25-29,1959,0.010897177174436858
STAT,1874,16,50-100,1890,4.982390858916214E-4
STAT,1865,16,15-19,1881,0.055641165319405286
SIM,1947,5,na,1952,43
STAT,1912,26,15-19,1938,0.006926142905535998
STAT,1862,89,na,1951,0.9063646294885951
STAT,1814,44,50-100,1858,0.03137946798584946
STAT,1853,37,20-24,1890,0.004844640446257165
STAT,1883,18,25-29,1901,0.05488437474434256
SIM,1903,7,na,1910,39
STAT,1839,49,na,1888,12.330157699522557
STAT,1819,94,na,1913,0.1025944447067321
SIM,1845,86,na,1931,1
STAT,1924,19,35-39,1943,0.04937788241170307
STAT,1834,26,30-34,1860,0.23503825970545653
STAT,1934,18,15-19,1952,0.6096524805505109
SIM,1863,2,na,1865,30
SIM,1862,27,na,1889,22
SIM,1947,2,na,1949,43
STAT,1826,44,35-39,1870,0.018497025286797402
STAT,1842,17,25-29,1859,0.054596478733203085
STAT,1842,37,45-49,1879,0.01754535060106732
STAT,1885,15,na,1900,25.056612831979407
STAT,1925,21,30-34,1946,0.3429096643804398
STAT,1944,25,15-19,1969,0.007581235159399892
STAT,1870,19,na,1889,25.03059556795846
STAT,1893,35,35-39,1928,0.09002782691387316
STAT,1913,47,30-34,1960,8.628249710379188E-4
STAT,1875,27,30-34,1902,0.2588553658923548
STAT,1900,34,na,1934,32.80723749295471
STAT,1907,16,30-34,1923,0.02337161055692798
SIM,1805,80,na,1885,3
SIM,1913,41,na,1954,40
STAT,1825,39,35-39,1864,0.07093599700875153
SIM,1879,52,na,1931,13
STAT,1903,28,30-34,1931,0.3567591951380123
STAT,1832,42,50-100,1874,0.005810621723590878
STAT,1871,39,30-34,1910,0.05260112020809691
STAT,1835,38,15-19,1873,3.115473133255266E-4
STAT,1856,18,50-100,1874,4.171902383509334E-4
STAT,1871,35,15-19,1906,5.6517825058028E-4
STAT,1934,26,35-39,1960,0.20120400136376806
STAT,1874,23,30-34,1897,0.18014570633477278
STAT,1885,44,40-44,1929,0.021912112626212506
STAT,1894,45,50-100,1939,0.0017932037043024201
STAT,1908,28,15-19,1936,0.006615551362409612
STAT,1908,46,45-49,1954,0.001970079265629445
STAT,1821,39,na,1860,17.438736868940076
STAT,1883,15,20-24,1898,0.17295835566226644
STAT,1832,76,na,1908,4.282348100295255
STAT,1918,44,na,1962,38.999569222632616
SIM,1864,53,na,1917,21
STAT,1911,19,25-29,1930,0.08569682336576048
STAT,1792,68,na,1860,14.391708601388194
STAT,1865,63,na,1928,16.138806070582444
STAT,1821,38,20-24,1859,0.014448603173440967
STAT,1847,75,na,1922,10.99709485771754
STAT,1923,32,50-100,1955,0.009412726166395513
STAT,1941,17,45-49,1958,0.00510804320927478
STAT,1881,42,15-19,1923,1.312447442542746E-4
STAT,1860,22,25-29,1882,0.4797518390892787
STAT,1889,24,20-24,1913,0.8384356905372654
STAT,1825,100,na,1925,0.005723364298654661
STAT,1852,90,na,1942,0.6747555825124534
SIM,1842,72,na,1914,17
STAT,1839,26,15-19,1865,0.003177018441682387
STAT,1904,48,35-39,1952,0.0011173592370549504
SIM,1895,11,na,1906,31
STAT,1866,21,15-19,1887,0.030853010986832234
STAT,1900,31,na,1931,33.22577443602625
STAT,1913,31,15-19,1944,0.0012730139508444847
STAT,1857,38,35-39,1895,0.052685834172694145
STAT,1888,31,45-49,1919,0.020461550340255805
SIM,1916,52,na,1968,44
SIM,1839,35,20-24,1874,1
SIM,1948,22,20-24,1970,1
STAT,1841,17,40-44,1858,0.0023089939983757806
STAT,1836,38,na,1874,25.10948501706316
STAT,1816,83,na,1899,1.1918257560733652
STAT,1870,101,na,1971,0.05024430557536233
STAT,1876,47,50-100,1923,0.0024827968185033474
STAT,1875,37,40-44,1912,0.04499819726830581
STAT,1898,26,20-24,1924,0.1588004770428492
STAT,1848,36,35-39,1884,0.04762855608231829
SIM,1886,3,na,1889,31
STAT,1873,20,45-49,1893,0.007131917676690275
STAT,1870,33,40-44,1903,0.04289864708048613
STAT,1893,22,20-24,1915,0.868902033187686
SIM,1871,38,na,1909,24
SIM,1840,46,na,1886,17
STAT,1894,38,20-24,1932,0.009830136293218618
STAT,1927,37,15-19,1964,2.3753610788664948E-4
SIM,1939,20,20-24,1959,1
STAT,1920,30,45-49,1950,0.017226741393107245
STAT,1929,22,45-49,1951,0.014160705243527654
SIM,1885,52,na,1937,22
STAT,1925,34,45-49,1959,0.018545245857908153
STAT,1857,37,na,1894,17.637034422656324
STAT,1883,28,35-39,1911,0.0933691352196026
STAT,1916,22,35-39,1938,0.09782263156395697
SIM,1870,53,na,1923,21
STAT,1852,31,30-34,1883,0.1563304478962615
STAT,1808,46,40-44,1854,0.0012537657374944173
STAT,1786,68,na,1854,3.0
STAT,1952,17,20-24,1969,1.6150887393630233
SIM,1886,37,na,1923,28
STAT,1875,22,na,1897,24.31133189221321
STAT,1862,51,45-49,1913,1.2580704799058332E-4
SIM,1891,52,na,1943,32
STAT,1834,22,15-19,1856,0.03117999011254853
STAT,1942,18,40-44,1960,0.014506004127212768
STAT,1850,19,40-44,1869,0.001966633458959705
SIM,1938,28,35-39,1966,1
STAT,1869,22,45-49,1891,0.006756637414683174
STAT,1866,35,40-44,1901,0.040698879257919006
STAT,1859,103,na,1962,0.0037995302148288446
STAT,1884,20,20-24,1904,0.6791999598960644
STAT,1918,35,15-19,1953,2.024805833377187E-4
STAT,1880,37,15-19,1917,5.904950321295854E-4
STAT,1948,23,25-29,1971,1.0532251948136035
STAT,1908,7,na,1915,38.44716131984735
SIM,1865,38,na,1903,24
STAT,1839,21,20-24,1860,0.4921714270607737
SIM,1892,20,20-24,1912,2
STAT,1933,16,40-44,1949,0.018693340900139164
STAT,1791,83,na,1874,1.265978643790312
STAT,1908,36,35-39,1944,0.022636832458695362
STAT,1917,48,45-49,1965,0.002243230980204668
SIM,1847,21,20-24,1868,4
STAT,1926,31,25-29,1957,0.11118517844551688
STAT,1808,54,na,1862,4.38803691098977
STAT,1899,41,30-34,1940,0.0010978376307759939
STAT,1919,29,na,1948,39.839099972385775
STAT,1817,48,40-44,1865,0.004878839662197468
STAT,1836,49,20-24,1885,1.1813188017024081E-4
STAT,1871,53,45-49,1924,1.4236568553899963E-4
STAT,1831,45,20-24,1876,1.1786987066299829E-4
SIM,1833,61,na,1894,9
SIM,1834,46,na,1880,19
STAT,1898,39,35-39,1937,0.02038695268964457
SIM,1831,32,na,1863,10
SIM,1941,22,na,1963,47
STAT,1922,43,25-29,1965,8.123465573861294E-4
STAT,1863,44,20-24,1907,0.0013871467206804308
STAT,1892,25,40-44,1917,0.037258495944094
STAT,1858,43,35-39,1901,0.013679752702772621
STAT,1801,84,na,1885,1.0966060902456827
STAT,1866,31,25-29,1897,0.09471799866164836
STAT,1856,32,45-49,1888,0.012787497410204665
STAT,1897,29,40-44,1926,0.03949543914315896
SIM,1860,21,20-24,1881,2
SIM,1842,36,40-44,1878,1
STAT,1830,34,15-19,1864,8.774201606626788E-4
STAT,1847,30,45-49,1877,0.022330797629507446
STAT,1852,44,45-49,1896,0.012636071166557178
SIM,1898,31,50-100,1929,1
SIM,1924,1,na,1925,56
STAT,1858,40,30-34,1898,0.008836613223106454
STAT,1849,26,50-100,1875,0.005922277808570513
SIM,1813,47,na,1860,12
STAT,1872,32,50-100,1904,0.009374751495131445
SIM,1888,66,na,1954,24
STAT,1903,42,45-49,1945,0.0014757847695732744
STAT,1848,23,20-24,1871,0.5387368355314113
STAT,1822,43,20-24,1865,8.943644039464749E-4
STAT,1872,46,20-24,1918,1.2312902560149998E-4
STAT,1904,35,20-24,1939,0.0024066989598977564
SIM,1799,75,na,1874,10
SIM,1894,66,na,1960,22
STAT,1826,31,20-24,1857,0.042092033712055214
SIM,1879,29,30-34,1908,1
STAT,1860,104,na,1964,0.002565507205930458
STAT,1888,29,na,1917,27.689536695478182
STAT,1907,41,50-100,1948,0.001077962076427791
STAT,1952,1,na,1953,48.24853144214989
STAT,1848,23,na,1871,16.715230114159173
STAT,1889,37,35-39,1926,0.0865960197310224
STAT,1867,45,35-39,1912,0.0013531014704020723
STAT,1916,28,40-44,1944,0.047613443371842715
STAT,1854,23,na,1877,15.245345757980497
STAT,1884,39,40-44,1923,0.04245701374817231
STAT,1877,88,na,1965,3.154272654617726
STAT,1935,29,20-24,1964,0.24747674221991173
SIM,1904,67,na,1971,24
STAT,1851,29,35-39,1880,0.09401274426970209
STAT,1825,34,40-44,1859,0.0477198903500833
STAT,1833,24,na,1857,20.971339785361785
STAT,1856,89,na,1945,0.7610427455412341
STAT,1885,46,50-100,1931,0.002432222346297771
STAT,1906,59,na,1965,30.27747869939159
STAT,1934,36,45-49,1970,0.009376186759410394
STAT,1869,22,na,1891,22.915935093693815
SIM,1875,45,35-39,1920,1
STAT,1785,83,na,1868,3.760539385630381
STAT,1879,17,20-24,1896,0.1834920728255513
SIM,1873,67,na,1940,15
STAT,1857,25,20-24,1882,0.09177174389055964
STAT,1932,31,50-100,1963,0.010952893864971853
