Source,YOB,Age,NPA,Date,freq
SIM,1896,0,na,1896,4125
STAT,1868,71,na,1939,1479.9837072056816
SIM,1875,18,na,1893,3371
STAT,1955,49,15-19,2004,5.835669043587524E-4
STAT,1959,26,40-44,1985,7.069794279952717
STAT,1906,62,na,1968,3395.0213747678777
STAT,1900,115,na,2015,3.2219498583515265E-4
STAT,1890,48,20-24,1938,0.009425168531232056
STAT,1810,57,na,1867,1400.202255399365
SIM,1905,65,na,1970,3307
SIM,1863,60,na,1923,1946
STAT,1871,18,50-100,1889,0.05627869798429654
SIM,1867,74,na,1941,960
SIM,1952,32,30-34,1984,45
STAT,1933,46,15-19,1979,5.863187831075946E-4
SIM,1901,51,na,1952,3723
SIM,1839,40,25-29,1879,1
STAT,1953,30,30-34,1983,22.445438399912092
STAT,1929,47,na,1976,5495.689035737531
STAT,1934,25,25-29,1959,102.32395343093201
STAT,1925,27,25-29,1952,89.6882708494184
STAT,1925,33,na,1958,5178.142537947994
STAT,1949,41,20-24,1990,0.024668739938506493
SIM,1961,38,40-44,1999,1
SIM,1909,25,40-44,1934,8
SIM,1933,27,25-29,1960,204
SIM,1909,79,na,1988,2798
STAT,1962,36,40-44,1998,2.282593672968596
STAT,1953,38,40-44,1991,2.150914958202675
SIM,1915,89,na,2004,1404
STAT,1982,18,50-100,2000,0.6082175062859606
SIM,1897,41,50-100,1938,1
SIM,1872,47,50-100,1919,2
SIM,1858,41,50-100,1899,2
STAT,1927,48,40-44,1975,0.22770849918576314
SIM,1876,35,na,1911,2615
STAT,1964,47,15-19,2011,5.569319060773448E-4
SIM,1869,23,20-24,1892,67
SIM,1914,26,na,1940,3809
STAT,1897,84,na,1981,1176.6057321011306
STAT,1965,24,15-19,1989,7.689542685020991
SIM,1973,24,15-19,1997,1
STAT,1893,70,na,1963,2295.754510486715
STAT,1815,88,na,1903,76.17614343668379
STAT,1918,42,30-34,1960,0.15683367470085627
STAT,1900,19,20-24,1919,28.237436110655445
SIM,1964,26,15-19,1990,1
STAT,1942,44,15-19,1986,0.0019186580858854127
STAT,1909,44,30-34,1953,0.13645711694081153
STAT,1951,26,50-100,1977,1.3743779858117147
STAT,1896,23,15-19,1919,5.013117923931625
STAT,1852,88,na,1940,129.43281297323276
SIM,1970,1,na,1971,6060
STAT,1907,23,15-19,1930,5.584350169350545
STAT,1940,30,50-100,1970,0.9889490354593329
STAT,1826,40,na,1866,1532.9572444357773
STAT,1978,30,na,2008,6078.588595391648
SIM,1860,6,na,1866,3053
STAT,1924,48,15-19,1972,5.045626381816858E-4
STAT,1960,47,30-34,2007,0.1393729815052558
STAT,1801,96,na,1897,3.6040298237179162
STAT,1957,38,25-29,1995,1.5419015475439592
STAT,1964,31,45-49,1995,2.3327719283258928
SIM,1825,43,na,1868,1699
SIM,1829,57,na,1886,1334
STAT,1867,15,45-49,1882,0.07280897603052748
STAT,1929,7,na,1936,5887.546913392118
STAT,1943,23,25-29,1966,113.38721091187024
SIM,1915,23,15-19,1938,1
STAT,1920,18,35-39,1938,5.4164961382750425
STAT,1939,34,15-19,1973,0.1511806663242702
STAT,1944,32,30-34,1976,19.94579604512702
SIM,1953,3,na,1956,5701
STAT,1950,32,na,1982,5260.505187918124
STAT,1841,48,25-29,1889,0.05078887577518299
SIM,1934,36,30-34,1970,6
STAT,1838,41,na,1879,2157.272654161566
STAT,1903,26,35-39,1929,15.91511831908361
SIM,1951,23,25-29,1974,4
SIM,1884,22,na,1906,2888
SIM,1926,17,40-44,1943,4
STAT,1929,43,45-49,1972,0.24835280859131872
STAT,1941,36,50-100,1977,0.5147685276396622
SIM,1887,46,50-100,1933,1
STAT,1827,89,na,1916,85.31610720605181
STAT,1922,31,40-44,1953,5.121333901610457
STAT,1960,15,25-29,1975,65.17070701196629
STAT,1857,30,25-29,1887,9.457379176578156
SIM,1888,36,na,1924,2770
SIM,1912,35,40-44,1947,2
STAT,1904,35,40-44,1939,1.5806868843813173
SIM,1892,73,na,1965,2383
SIM,1896,87,na,1983,1093
SIM,1850,42,na,1892,1558
STAT,1910,33,15-19,1943,0.14253711342715983
SIM,1911,26,35-39,1937,28
SIM,1847,22,30-34,1869,2
STAT,1878,15,20-24,1893,21.461343875185275
STAT,1765,96,na,1861,0.12779257386321585
SIM,1882,42,50-100,1924,7
STAT,1912,21,30-34,1933,31.914044761568665
STAT,1926,36,30-34,1962,2.572361970324111
SIM,1822,78,na,1900,383
SIM,1916,35,25-29,1951,2
STAT,1917,46,na,1963,4439.548075131191
STAT,1938,18,20-24,1956,154.3654000850703
SIM,1902,20,25-29,1922,211
SIM,1950,19,25-29,1969,2
STAT,1913,32,na,1945,4344.814522295634
STAT,1947,28,15-19,1975,0.9212331550754681
STAT,1942,19,25-29,1961,52.237104360140485
SIM,1856,90,na,1946,107
SIM,1909,29,50-100,1938,3
SIM,1925,38,30-34,1963,1
STAT,1932,20,45-49,1952,1.714331839746759
SIM,1979,10,na,1989,6472
SIM,1863,17,na,1880,2813
STAT,1970,34,na,2004,5562.06807102768
STAT,1822,58,na,1880,1760.3667479217868
STAT,1976,18,40-44,1994,2.15585102881761
STAT,1858,17,45-49,1875,0.06869665164648105
STAT,1894,2,na,1896,3954.611022637013
STAT,1944,18,50-100,1962,0.46516840526656045
STAT,1917,30,20-24,1947,2.9714216574051435
SIM,1959,22,na,1981,5556
STAT,1877,4,na,1881,3471.805876622535
SIM,1905,32,45-49,1937,4
SIM,1936,31,35-39,1967,1
SIM,1945,37,45-49,1982,1
STAT,1908,35,25-29,1943,1.0753375107002368
SIM,1887,19,na,1906,3819
SIM,1911,23,30-34,1934,1
STAT,1958,49,40-44,2007,0.24711329113490874
SIM,1866,17,45-49,1883,1
STAT,1982,16,15-19,1998,73.71965402389421
SIM,1920,21,30-34,1941,86
STAT,1912,102,na,2014,15.315918899800119
STAT,1899,23,40-44,1922,3.2844680799275734
SIM,1793,80,na,1873,431
STAT,1917,38,30-34,1955,2.1738838800508313
SIM,1907,37,25-29,1944,3
SIM,1880,72,na,1952,1676
SIM,1884,86,na,1970,386
STAT,1848,20,30-34,1868,23.37891248289738
STAT,1904,71,na,1975,2770.4837535993997
STAT,1927,40,30-34,1967,0.18550961000091015
STAT,1954,42,40-44,1996,0.37084498223119966
STAT,1839,22,30-34,1861,18.150269700867153
STAT,1908,85,na,1993,1263.6187596269906
SIM,1888,18,35-39,1906,1
SIM,1901,38,50-100,1939,1
SIM,1935,48,40-44,1983,1
STAT,1966,33,20-24,1999,3.58158843970688
SIM,1955,28,15-19,1983,5
STAT,1813,97,na,1910,2.4598008517381804
SIM,1804,81,na,1885,172
STAT,1889,33,na,1922,3380.367165253434
SIM,1961,44,35-39,2005,1
STAT,1927,24,na,1951,5158.660897290326
SIM,1898,25,40-44,1923,6
STAT,1885,83,na,1968,829.3914443844377
STAT,1923,22,45-49,1945,1.5103049911070787
STAT,1865,49,25-29,1914,0.05872408876965589
SIM,1868,48,na,1916,2946
SIM,1981,18,15-19,1999,125
STAT,1937,37,45-49,1974,0.7871252112182099
STAT,1889,97,na,1986,79.53092533194653
SIM,1921,33,40-44,1954,2
STAT,1912,29,40-44,1941,5.267997915814712
SIM,1942,25,25-29,1967,137
STAT,1973,18,15-19,1991,67.71495377105616
STAT,1916,86,na,2002,1274.3815976691458
STAT,1837,24,na,1861,1997.8025687727488
STAT,1989,14,na,2003,6490.781225308558
STAT,1970,25,35-39,1995,21.801757039856263
SIM,1893,20,35-39,1913,20
STAT,1913,33,40-44,1946,4.476650977918848
SIM,1901,16,25-29,1917,23
STAT,1859,21,45-49,1880,0.7361782386241827
STAT,1927,15,40-44,1942,2.015923949317015
STAT,1920,43,25-29,1963,0.09083354527873375
STAT,1930,40,50-100,1970,0.17890370993455126
SIM,1873,49,25-29,1922,1
SIM,1922,13,na,1935,5452
STAT,1940,19,15-19,1959,53.15925816329704
STAT,1928,87,na,2015,1395.9799596772468
SIM,1839,35,na,1874,2209
SIM,1925,30,20-24,1955,7
STAT,1930,20,35-39,1950,14.005481384530194
STAT,1818,53,na,1871,1126.3804636017258
SIM,1835,21,na,1856,2604
STAT,1961,21,50-100,1982,0.9846386588074819
SIM,1902,28,35-39,1930,1
STAT,1800,79,na,1879,388.0426877135199
SIM,1961,30,30-34,1991,26
SIM,1960,26,30-34,1986,4
STAT,1876,15,na,1891,3026.993519251651
STAT,1952,26,30-34,1978,54.44704714267479
STAT,1939,25,na,1964,4351.7311567178795
SIM,1926,27,na,1953,5599
STAT,1930,28,45-49,1958,2.5342481840082383
STAT,1810,49,35-39,1859,0.521783144135483
STAT,1938,41,45-49,1979,0.1972778793946457
SIM,1930,64,na,1994,5448
SIM,1946,18,20-24,1964,171
STAT,1877,32,na,1909,2864.634987648466
STAT,1935,11,na,1946,6263.802783538409
STAT,1949,44,25-29,1993,0.09927247046983376
STAT,1924,36,20-24,1960,0.35895535633625447
SIM,1938,28,na,1966,3773
STAT,1987,27,50-100,2014,1.6469248199676478
STAT,1907,3,na,1910,4488.836500951695
STAT,1954,21,35-39,1975,13.482210477857665
SIM,1934,14,na,1948,5971
STAT,1910,21,20-24,1931,120.99714378292943
SIM,1904,48,na,1952,3899
STAT,1835,103,na,1938,0.08944629920223685
SIM,1864,33,50-100,1897,2
SIM,1952,35,35-39,1987,1
STAT,1972,17,50-100,1989,0.5535939022771464
STAT,1835,76,na,1911,590.473041579714
STAT,1989,23,30-34,2012,47.65021764567383
SIM,1958,32,25-29,1990,31
STAT,1875,22,40-44,1897,2.485140871656861
SIM,1904,20,35-39,1924,18
STAT,1891,39,25-29,1930,4.065319657818169
STAT,1855,30,15-19,1885,0.12596927005828457
SIM,1889,31,25-29,1920,26
STAT,1959,29,45-49,1988,2.616641438787903
STAT,1914,24,45-49,1938,1.3189421043134366
SIM,1881,9,na,1890,2173
SIM,1918,35,35-39,1953,1
STAT,1904,38,45-49,1942,0.7095258366918591
STAT,1936,74,na,2010,2902.3217524488327
STAT,1809,103,na,1912,0.06670287331953724
STAT,1922,43,35-39,1965,0.2661954258882493
SIM,1991,4,na,1995,6714
SIM,1943,37,35-39,1980,7
STAT,1846,32,15-19,1878,0.17397555745536036
STAT,1939,39,20-24,1978,0.3131862351493307
SIM,1892,32,50-100,1924,3
SIM,1906,82,na,1988,1616
STAT,1885,20,35-39,1905,6.757354237090291
SIM,1826,60,na,1886,1320
STAT,1861,49,40-44,1910,0.16082109102902808
SIM,1962,21,35-39,1983,16
SIM,1891,56,na,1947,2794
SIM,1855,20,15-19,1875,4
STAT,1953,29,na,1982,5247.238305004531
STAT,2003,7,na,2010,6884.6153218609115
STAT,1947,49,20-24,1996,0.014855223989187035
STAT,1954,29,45-49,1983,2.4729281229778692
SIM,1944,41,50-100,1985,1
SIM,1962,29,45-49,1991,10
STAT,1913,45,35-39,1958,0.14598722195449537
STAT,1944,35,35-39,1979,3.100275796149861
SIM,1944,70,na,2014,3895
STAT,1928,31,35-39,1959,13.194175687333058
STAT,1957,35,20-24,1992,0.4139472491435417
STAT,1935,37,35-39,1972,3.905305322380254
STAT,1921,22,35-39,1943,12.268906733060875
STAT,1812,49,45-49,1861,0.5292953797689794
STAT,1907,19,30-34,1926,2.691836373279023
STAT,1933,22,50-100,1955,1.0076966925821387
STAT,1910,29,30-34,1939,43.39806722071807
SIM,1820,49,45-49,1869,1
STAT,1962,31,35-39,1993,13.781824583030863
STAT,1950,26,20-24,1976,25.027210268777225
STAT,1802,108,na,1910,8.743872762736833E-4
STAT,1904,30,35-39,1934,16.917670455829164
STAT,1948,28,30-34,1976,51.946034705374956
SIM,1937,28,50-100,1965,1
SIM,1922,24,45-49,1946,3
STAT,1829,37,na,1866,2003.9958851788854
STAT,1862,113,na,1975,2.505043442606383E-4
SIM,1846,22,15-19,1868,2
SIM,1915,19,30-34,1934,2
STAT,1903,23,30-34,1926,29.18895153347269
STAT,1850,27,50-100,1877,0.774956770339186
STAT,1926,50,na,1976,5183.102289746119
STAT,1953,42,25-29,1995,0.1036027159687576
SIM,1904,28,45-49,1932,1
STAT,1918,45,35-39,1963,0.1590481108671819
SIM,1901,37,30-34,1938,2
STAT,1922,34,45-49,1956,2.040917262825264
SIM,1951,28,30-34,1979,109
STAT,1972,28,50-100,2000,1.476383339621442
SIM,1869,26,25-29,1895,7
STAT,1773,83,na,1856,235.78793639999998
SIM,1912,38,45-49,1950,4
STAT,1777,97,na,1874,0.7072502544856343
STAT,1976,31,50-100,2007,1.300138659334747
SIM,1957,31,na,1988,6147
STAT,1841,45,20-24,1886,0.010995615920975177
SIM,1854,38,50-100,1892,4
SIM,1951,20,20-24,1971,306
STAT,1925,24,20-24,1949,152.5919751035326
STAT,1928,39,45-49,1967,0.9921335466654063
STAT,1830,45,45-49,1875,0.22349715908161766
SIM,1912,30,35-39,1942,2
STAT,1918,17,40-44,1935,0.3524188634819262
SIM,1869,37,50-100,1906,6
SIM,1959,40,50-100,1999,1
STAT,1829,40,15-19,1869,0.015263418126419187
STAT,1943,28,30-34,1971,48.13977004534454
STAT,1951,38,30-34,1989,2.577798357621999
SIM,1941,48,na,1989,3885
STAT,1933,34,20-24,1967,3.790238160767097
SIM,1900,34,na,1934,3478
STAT,1814,51,50-100,1865,0.04095873035863482
STAT,1943,20,20-24,1963,136.6352940389303
STAT,1911,42,20-24,1953,0.019468981305625264
SIM,1933,24,20-24,1957,6
STAT,1980,19,45-49,1999,0.7997706818988609
SIM,1930,34,45-49,1964,3
STAT,1934,7,na,1941,6242.771765456116
STAT,1935,46,25-29,1981,0.0866853500672362
SIM,1870,94,na,1964,257
SIM,1887,27,30-34,1914,3
STAT,1839,15,na,1854,2409.649728420649
SIM,1955,37,50-100,1992,1
SIM,1971,14,na,1985,5810
STAT,1961,27,35-39,1988,22.481973900159293
STAT,1900,42,45-49,1942,0.16622361599646815
STAT,1952,17,40-44,1969,1.9343812411472348
SIM,1960,17,40-44,1977,5
STAT,1798,59,na,1857,896.1426255868863
SIM,1943,46,25-29,1989,1
STAT,1879,27,30-34,1906,30.34466462580206
STAT,1918,63,na,1981,4052.5531810136754
STAT,1851,104,na,1955,0.05289278759218213
STAT,1856,70,na,1926,1235.3356717602132
STAT,1907,44,20-24,1951,0.01847301605246591
SIM,1854,56,na,1910,2149
SIM,1917,23,25-29,1940,146
STAT,1955,33,45-49,1988,2.455797727454235
SIM,1953,44,40-44,1997,2
STAT,1860,22,50-100,1882,0.3909931720974179
SIM,1897,16,35-39,1913,1
SIM,1926,45,35-39,1971,1
STAT,1797,74,na,1871,555.7313012090772
STAT,1872,22,15-19,1894,3.8229163236742254
STAT,1956,26,15-19,1982,1.0831900505982435
SIM,2005,5,na,2010,6474
STAT,1858,30,40-44,1888,3.9862149805338696
STAT,1848,23,35-39,1871,7.495366224776955
SIM,1838,24,30-34,1862,1
SIM,1916,49,na,1965,4312
SIM,1853,39,na,1892,2240
SIM,1877,17,20-24,1894,39
SIM,1900,25,20-24,1925,20
SIM,1945,34,40-44,1979,1
SIM,1912,35,na,1947,3812
STAT,1869,17,20-24,1886,20.087922612265917
SIM,1898,20,35-39,1918,2
SIM,1879,32,50-100,1911,5
SIM,1925,33,25-29,1958,3
STAT,1889,16,35-39,1905,0.7824938748368898
STAT,1808,75,na,1883,583.4510380171278
STAT,1785,84,na,1869,72.08063348188422
STAT,1789,98,na,1887,0.49250297126340553
STAT,1917,33,25-29,1950,11.122582370296067
STAT,1804,61,na,1865,1239.141544583217
SIM,1866,30,40-44,1896,10
STAT,1945,44,40-44,1989,0.3266029810130549
SIM,1856,23,35-39,1879,1
SIM,1934,46,50-100,1980,1
SIM,1907,34,20-24,1941,7
STAT,1889,41,25-29,1930,0.9176462914551801
SIM,1867,30,35-39,1897,15
STAT,1916,29,25-29,1945,77.98623410351293
STAT,1898,7,na,1905,4063.5227801636784
STAT,1893,30,50-100,1923,1.3472877080293209
SIM,1878,21,20-24,1899,163
SIM,1818,73,na,1891,989
SIM,1963,33,45-49,1996,1
SIM,1963,27,na,1990,6111
STAT,1868,50,50-100,1918,0.01698607870946037
SIM,1843,42,50-100,1885,1
SIM,1924,29,25-29,1953,162
STAT,1930,25,40-44,1955,6.8465628790354165
SIM,1951,26,na,1977,5970
STAT,1862,53,40-44,1915,0.010088592627832713
STAT,1849,68,na,1917,1184.457351979244
STAT,1908,44,15-19,1952,0.0016215961524411885
STAT,1816,62,na,1878,1079.0399310125927
STAT,1970,22,30-34,1992,41.6576975491081
SIM,1849,25,45-49,1874,2
SIM,1886,15,20-24,1901,35
STAT,1915,17,15-19,1932,10.963658135510794
STAT,1951,49,30-34,2000,0.1266793917430517
STAT,1901,35,15-19,1936,0.019778601248292095
STAT,1923,27,15-19,1950,0.9350232952393204
STAT,1956,51,na,2007,5761.07208143873
SIM,1862,43,na,1905,2810
SIM,1923,17,15-19,1940,115
SIM,1931,27,15-19,1958,2
STAT,1831,38,15-19,1869,0.05495601741983286
STAT,1914,21,40-44,1935,3.817487292157973
STAT,1922,68,na,1990,4004.755536745629
STAT,1919,30,30-34,1949,19.76947232968286
STAT,1830,42,40-44,1872,2.1605278243498236
STAT,1856,48,20-24,1904,0.010432637231780038
STAT,1964,42,45-49,2006,0.25140008622718385
SIM,1859,37,20-24,1896,3
STAT,1887,16,25-29,1903,7.346910241969645
STAT,1949,28,25-29,1977,88.68123665307827
STAT,1840,23,na,1863,2165.5747019282103
STAT,1844,37,na,1881,2082.3746210972263
SIM,1918,32,30-34,1950,22
STAT,1914,40,45-49,1954,0.19173910510466696
STAT,1957,11,na,1968,5977.835985111662
STAT,1944,19,35-39,1963,5.2080636437670424
SIM,1899,52,na,1951,3592
STAT,1929,48,15-19,1977,5.495199455043647E-4
STAT,1881,20,15-19,1901,3.694150327003987
SIM,1786,78,na,1864,49
STAT,1861,92,na,1953,39.95874848053151
STAT,1855,26,30-34,1881,22.495766898802156
STAT,1859,30,35-39,1889,9.445477258395437
SIM,1960,30,na,1990,6104
STAT,1989,26,35-39,2015,24.93572619217143
STAT,1905,18,50-100,1923,0.08161782817393687
SIM,1860,95,na,1955,6
STAT,1910,24,25-29,1934,99.58245968067399
SIM,1927,30,30-34,1957,4
STAT,1913,42,30-34,1955,0.14395463330974625
STAT,1807,48,25-29,1855,0.23487252437958048
SIM,1984,29,40-44,2013,15
STAT,1906,35,15-19,1941,0.020590900006319086
SIM,1900,98,na,1998,68
STAT,1866,27,45-49,1893,1.1876489128745624
STAT,1881,29,15-19,1910,0.5014199602911893
SIM,1831,82,na,1913,248
STAT,1809,92,na,1901,19.357803537402177
SIM,1875,49,35-39,1924,1
STAT,1919,38,40-44,1957,1.8536576189799743
STAT,1953,49,40-44,2002,0.22760145810601118
SIM,1890,38,20-24,1928,4
STAT,1925,49,50-100,1974,0.3143406602110227
SIM,1875,40,35-39,1915,5
SIM,1927,38,40-44,1965,4
STAT,1955,38,15-19,1993,0.0302790047778218
STAT,1867,49,35-39,1916,0.1476987810719651
STAT,1886,22,50-100,1908,0.4964078108361742
STAT,1943,32,15-19,1975,0.16031612868413728
STAT,1958,38,40-44,1996,2.335308739653149
STAT,1937,34,40-44,1971,4.464732217132135
STAT,1831,62,na,1893,1433.9776775434366
STAT,1990,22,na,2012,6055.303308048108
STAT,1832,23,50-100,1855,0.48448171763470865
STAT,1940,30,45-49,1970,1.8821933371703585
SIM,1896,25,30-34,1921,93
STAT,1917,42,15-19,1959,0.0018495451943857043
STAT,1982,10,na,1992,6380.732868536245
SIM,1883,69,na,1952,1421
SIM,1841,38,25-29,1879,4
STAT,1952,42,30-34,1994,0.1837437577142761
SIM,1925,17,25-29,1942,136
SIM,1944,22,30-34,1966,49
STAT,1863,112,na,1975,8.542452464115258E-4
STAT,1961,15,40-44,1976,2.0865907023364754
STAT,1934,46,30-34,1980,0.14376141287241304
STAT,1924,43,45-49,1967,0.22803457695726503
STAT,1909,35,40-44,1944,1.6526051277818692
STAT,1933,37,25-29,1970,1.5483834435563555
STAT,1888,25,30-34,1913,34.39288581148665
STAT,1967,24,25-29,1991,133.50593790423048
SIM,1895,16,25-29,1911,15
STAT,1833,38,25-29,1871,2.526247554303572
STAT,1972,22,40-44,1994,4.984659772052231
SIM,1957,28,25-29,1985,186
SIM,1903,16,35-39,1919,1
STAT,1828,34,50-100,1862,0.9920438234861763
SIM,1899,31,na,1930,4149
SIM,1863,26,30-34,1889,35
SIM,1934,71,na,2005,3988
SIM,1917,35,40-44,1952,3
SIM,1922,21,40-44,1943,7
STAT,1932,25,15-19,1957,1.068280946868651
STAT,1900,14,na,1914,4122.127374356382
STAT,1950,4,na,1954,5385.692380062694
SIM,1846,69,na,1915,867
STAT,1900,47,15-19,1947,3.596343902038497E-4
STAT,1904,28,na,1932,3941.0705495461557
STAT,1913,4,na,1917,4749.3578330259525
STAT,1856,1,na,1857,3304.899978600929
SIM,1857,21,na,1878,2456
STAT,1926,27,40-44,1953,6.446917027065608
STAT,1850,22,na,1872,2641.8603337140325
SIM,1881,57,na,1938,1577
STAT,1956,21,45-49,1977,1.7244698212595788
SIM,1954,32,40-44,1986,10
STAT,1874,42,50-100,1916,1.2466054960887178
STAT,1957,49,25-29,2006,0.08346073212921701
SIM,1930,18,45-49,1948,1
STAT,1823,49,20-24,1872,0.011529082270516959
STAT,1893,39,35-39,1932,10.213561612897633
SIM,1932,0,na,1932,6057
STAT,1824,92,na,1916,25.77062477466371
STAT,1932,67,na,1999,4833.644621033795
STAT,1947,12,na,1959,5106.426410141411
STAT,1907,47,25-29,1954,0.054912027638710045
STAT,1854,36,na,1890,1928.6457049714024
SIM,1856,58,na,1914,1758
STAT,1916,38,15-19,1954,0.022584423459408868
STAT,2004,8,na,2012,6930.999806491083
SIM,1949,44,na,1993,5787
STAT,1902,19,30-34,1921,2.5850702177617464
SIM,1892,20,40-44,1912,7
SIM,1948,27,na,1975,4417
STAT,1836,102,na,1938,0.2668091154990711
SIM,1945,30,na,1975,4672
STAT,1951,30,20-24,1981,3.4206268321932245
SIM,1910,19,30-34,1929,1
STAT,1806,63,na,1869,891.5224966024456
STAT,1783,82,na,1865,120.28777748911908
STAT,1945,28,40-44,1973,5.89854930251464
STAT,1795,62,na,1857,781.6373804331957
STAT,1901,30,45-49,1931,2.841516857670076
STAT,1936,41,35-39,1977,0.2305981085376748
STAT,1787,96,na,1883,1.2752032858401519
SIM,1944,13,na,1957,4656
STAT,1799,76,na,1875,515.3983691133596
STAT,1936,49,45-49,1985,0.2472916778991705
SIM,1980,18,20-24,1998,436
STAT,1945,47,45-49,1992,0.28499109415753593
STAT,1921,31,25-29,1952,11.914193820236475
STAT,1976,22,25-29,1998,142.885914122273
STAT,1893,30,35-39,1923,14.89128270150781
STAT,1884,20,40-44,1904,2.390179152889139
STAT,1938,26,50-100,1964,1.1390744693129427
STAT,1838,22,15-19,1860,3.7082053479160657
SIM,1841,81,na,1922,415
SIM,1975,7,na,1982,6127
STAT,1972,18,20-24,1990,200.2631156718721
SIM,1975,24,25-29,1999,2
STAT,1911,17,30-34,1928,2.817230040049762
STAT,1903,17,45-49,1920,0.10737564451088295
STAT,1865,31,50-100,1896,0.9579450813201125
STAT,1950,33,45-49,1983,2.1873479344754276
SIM,1878,90,na,1968,118
STAT,1925,48,30-34,1973,0.12427724137875366
STAT,1965,29,20-24,1994,26.38705402106899
SIM,1922,91,na,2013,410
SIM,1937,68,na,2005,3285
STAT,1929,33,50-100,1962,1.2112980873339398
STAT,1867,40,35-39,1907,1.9708185089322163
STAT,1935,43,20-24,1978,0.02871770948769383
STAT,1882,54,na,1936,2360.4044280096414
SIM,1944,41,35-39,1985,1
STAT,1846,92,na,1938,43.056418424096755
STAT,1888,28,35-39,1916,13.0434162141615
STAT,1982,27,15-19,2009,1.1513683559835015
STAT,1944,41,20-24,1985,0.022827378584364087
STAT,1946,32,40-44,1978,5.1057970533252925
STAT,1882,38,20-24,1920,0.8646026232993843
STAT,1976,29,40-44,2005,7.210320449098464
SIM,1949,34,25-29,1983,6
STAT,1880,53,50-100,1933,0.018177681189177525
SIM,1933,48,30-34,1981,1
STAT,1893,38,na,1931,3419.661504095138
STAT,1886,68,na,1954,1860.291909757894
SIM,1847,22,na,1869,2933
STAT,1975,18,25-29,1993,65.95538442020836
SIM,1947,18,15-19,1965,112
STAT,1853,51,50-100,1904,0.015108528547385938
STAT,1858,18,50-100,1876,0.05121902127621247
SIM,1953,28,40-44,1981,7
STAT,1830,45,na,1875,1554.0187529628722
STAT,1925,40,20-24,1965,0.024735505137083696
STAT,1834,59,na,1893,1773.6065326345874
STAT,1844,40,50-100,1884,0.9284837886668624
STAT,1901,26,25-29,1927,68.61417712614882
SIM,1908,37,40-44,1945,1
SIM,1958,9,na,1967,6233
STAT,1912,33,25-29,1945,10.46140635085969
SIM,1917,20,20-24,1937,8
STAT,1863,15,25-29,1878,6.602730035524022
SIM,1832,56,na,1888,1676
STAT,1939,18,15-19,1957,52.43038961691582
STAT,1847,20,15-19,1867,3.1570629012083327
STAT,1945,20,30-34,1965,36.37773232656002
SIM,1833,49,30-34,1882,1
STAT,1955,42,35-39,1997,0.3205999392593545
STAT,1784,107,na,1891,0.005475600805400171
SIM,1920,33,25-29,1953,5
STAT,1820,43,50-100,1863,1.2637163136902467
STAT,1867,31,45-49,1898,1.8866268042021037
STAT,1932,46,na,1978,5766.976571454918
SIM,1953,20,30-34,1973,91
SIM,1861,69,na,1930,966
SIM,1954,28,20-24,1982,25
STAT,1922,18,45-49,1940,0.6651460554526717
STAT,1935,25,40-44,1960,7.342723888932928
STAT,1946,28,20-24,1974,23.454487862029957
STAT,1881,16,30-34,1897,1.7785398860522035
STAT,1960,36,30-34,1996,2.8248978192738443
SIM,1910,38,35-39,1948,3
STAT,1940,68,na,2008,3684.3724875549065
STAT,1908,42,50-100,1950,0.12559466026173383
STAT,1911,21,15-19,1932,5.848765943373677
STAT,1912,31,50-100,1943,0.9436247889977756
SIM,1932,36,20-24,1968,1
STAT,1902,38,35-39,1940,2.4770150818448404
SIM,1841,60,na,1901,1500
SIM,1811,94,na,1905,4
SIM,1914,19,15-19,1933,20
SIM,1942,49,35-39,1991,1
STAT,1974,38,20-24,2012,0.40884228955881524
SIM,1893,90,na,1983,216
SIM,1853,18,na,1871,2651
STAT,1909,47,35-39,1956,0.1368760208598214
SIM,1885,27,20-24,1912,15
STAT,1908,10,na,1918,4440.055020203209
SIM,1845,74,na,1919,1143
STAT,1980,33,na,2013,6172.4249531439345
STAT,1919,33,35-39,1952,11.327340159775375
SIM,1864,30,30-34,1894,23
STAT,1852,54,50-100,1906,0.013847509921829317
STAT,1959,49,35-39,2008,0.20125738686042127
SIM,1896,20,25-29,1916,158
STAT,1841,40,na,1881,2190.7195104613197
STAT,1935,28,45-49,1963,2.7179016697826373
STAT,1837,88,na,1925,99.41090838210542
SIM,1874,24,40-44,1898,1
STAT,1863,40,na,1903,2355.829232363044
STAT,1967,29,30-34,1996,56.672321573666856
STAT,1895,3,na,1898,3971.2571776423542
STAT,1833,74,na,1907,780.9290316622127
STAT,1856,30,30-34,1886,15.88713788766638
SIM,1953,23,35-39,1976,17
SIM,1842,55,na,1897,1826
STAT,1888,20,25-29,1908,78.12129409244238
SIM,1948,27,20-24,1975,1
STAT,1845,54,na,1899,1411.0232008067776
SIM,1815,43,50-100,1858,4
SIM,1931,31,35-39,1962,17
SIM,1949,23,na,1972,5263
STAT,1867,54,na,1921,2256.214437222498
SIM,1849,22,40-44,1871,4
SIM,1933,75,na,2008,4243
SIM,1848,34,40-44,1882,3
STAT,1950,17,30-34,1967,16.632162109265415
SIM,1963,17,45-49,1980,2
STAT,1881,50,50-100,1931,0.017052895581709405
STAT,1906,15,50-100,1921,0.08283007266654348
SIM,1967,17,50-100,1984,1
SIM,1870,37,40-44,1907,9
STAT,1865,15,35-39,1880,0.6546810716217576
SIM,1974,6,na,1980,6402
SIM,1938,60,na,1998,3778
STAT,1827,37,50-100,1864,1.795542565513344
STAT,1959,48,na,2007,5752.506753573548
STAT,1945,23,35-39,1968,11.905552857705917
STAT,1855,39,15-19,1894,0.04730076508492954
STAT,1934,49,35-39,1983,0.2061880803432294
STAT,1901,23,20-24,1924,111.05164365541457
STAT,1972,25,45-49,1997,2.5659958129168237
STAT,1923,31,35-39,1954,12.135011358862956
STAT,1888,16,na,1904,3434.5878611244048
STAT,1849,20,25-29,1869,54.42246217794981
SIM,1874,27,45-49,1901,3
STAT,1896,67,na,1963,2647.040871896246
STAT,1952,6,na,1958,5436.6955010289885
STAT,1862,87,na,1949,171.58817546742307
STAT,1974,29,30-34,2003,59.24181928204989
STAT,1892,53,na,1945,3064.4943829212943
SIM,1921,17,40-44,1938,2
SIM,1988,16,40-44,2004,2
SIM,1873,15,35-39,1888,3
SIM,1896,28,35-39,1924,1
STAT,1866,24,40-44,1890,2.215017111528665
STAT,1942,28,15-19,1970,0.8548101657931256
STAT,1971,18,40-44,1989,2.0437992085563703
STAT,1912,79,na,1991,2211.474700122539
STAT,1887,41,15-19,1928,0.0179413852881288
SIM,1973,26,na,1999,5191
STAT,1913,17,40-44,1930,0.33020721469582726
STAT,1959,17,50-100,1976,0.5655715381624407
SIM,1868,91,na,1959,84
STAT,1993,0,na,1993,6576.739353896899
SIM,1817,56,na,1873,1191
SIM,1882,37,50-100,1919,3
SIM,1813,42,na,1855,1431
STAT,1908,32,20-24,1940,2.6604348257825157
STAT,1874,37,50-100,1911,1.4505132958420361
SIM,1997,10,na,2007,6607
STAT,1923,48,20-24,1971,0.014872430918514494
SIM,1902,36,na,1938,4015
SIM,1857,20,25-29,1877,97
STAT,1906,19,15-19,1925,9.933524705891296
SIM,1915,28,20-24,1943,42
STAT,1930,41,40-44,1971,0.38039460214688975
SIM,1982,29,30-34,2011,145
STAT,1877,27,20-24,1904,14.082961150436283
SIM,1849,41,45-49,1890,5
STAT,1961,18,45-49,1979,0.7445775332729936
STAT,1914,29,50-100,1943,1.1502590363572882
STAT,1841,18,na,1859,2616.663712864098
STAT,1961,24,30-34,1985,42.96558746731619
STAT,1891,30,25-29,1921,14.726643685691345
STAT,1897,20,na,1917,3671.3620010701716
SIM,1949,39,30-34,1988,2
SIM,1792,63,na,1855,933
SIM,1796,77,na,1873,351
SIM,1906,20,45-49,1926,4
STAT,1859,26,15-19,1885,0.4273587189623425
STAT,1914,17,na,1931,4612.922408701594
SIM,1855,73,na,1928,572
STAT,1907,28,20-24,1935,19.84958998286117
STAT,1925,90,na,2015,838.8491384033232
SIM,1910,35,30-34,1945,1
SIM,1983,29,na,2012,6950
STAT,1966,17,20-24,1983,195.4219087126766
SIM,1920,65,na,1985,3498
SIM,1966,37,25-29,2003,4
SIM,1837,36,30-34,1873,12
STAT,1921,42,50-100,1963,0.1526472079525291
STAT,1829,49,15-19,1878,3.974584136446538E-4
STAT,1960,39,35-39,1999,3.7375571763529116
STAT,1858,48,30-34,1906,0.08605267105317725
STAT,1946,35,45-49,1981,0.9005403765794847
SIM,1974,17,20-24,1991,200
STAT,1820,56,na,1876,1294.1440164117826
STAT,1911,45,25-29,1956,0.05827651933706771
SIM,1916,32,20-24,1948,1
STAT,1839,25,35-39,1864,9.779837513475965
STAT,1902,35,30-34,1937,1.8935952915221261
STAT,1951,5,na,1956,5403.232659748569
STAT,1872,76,na,1948,1097.8534455022007
STAT,1951,29,40-44,1980,6.426700491275136
STAT,1899,26,45-49,1925,1.7614917409605315
STAT,1871,91,na,1962,141.85361851733254
SIM,1929,30,40-44,1959,7
SIM,1926,29,35-39,1955,1
SIM,1910,87,na,1997,317
STAT,1812,50,25-29,1862,0.008167230702209365
STAT,1840,44,na,1884,1885.1476619289172
SIM,1975,21,20-24,1996,160
SIM,1838,18,na,1856,2218
SIM,1917,38,45-49,1955,1
STAT,1783,108,na,1891,0.0024124144945954886
STAT,1840,37,50-100,1877,1.1648923233118138
SIM,1847,25,35-39,1872,20
STAT,1917,17,25-29,1934,10.762199117304329
STAT,1906,2,na,1908,4485.961802424215
STAT,1918,21,25-29,1939,115.29195030006788
STAT,1967,21,20-24,1988,160.87740808411755
SIM,1926,21,25-29,1947,284
STAT,1909,38,45-49,1947,0.7418079112294462
SIM,1869,65,na,1934,1264
SIM,1838,40,30-34,1878,3
STAT,1829,36,30-34,1865,6.240927529117018
SIM,1889,53,na,1942,3368
STAT,1942,45,na,1987,4631.052086003579
SIM,1950,33,50-100,1983,2
STAT,1936,46,40-44,1982,0.18089756203879312
STAT,1924,27,30-34,1951,52.63507605480022
STAT,1920,45,50-100,1965,0.2897702549329614
SIM,1890,39,na,1929,3299
STAT,1918,29,35-39,1947,18.30337629702421
STAT,1909,19,40-44,1928,0.3152019304755318
SIM,1927,33,35-39,1960,1
STAT,1804,52,40-44,1856,0.04845814190790726
SIM,1971,38,45-49,2009,3
SIM,1941,18,20-24,1959,269
STAT,1963,38,45-49,2001,1.028701327286459
SIM,1772,86,na,1858,102
STAT,1933,18,20-24,1951,208.98865291719986
STAT,1937,23,na,1960,4104.814618167774
STAT,1913,36,45-49,1949,0.7805461383899066
STAT,1935,34,30-34,1969,25.136063912590743
SIM,1932,27,30-34,1959,7
STAT,1860,41,15-19,1901,0.012902760968749235
SIM,1943,34,30-34,1977,1
STAT,1944,44,25-29,1988,0.09186242475574115
SIM,2001,0,na,2001,7342
SIM,1816,40,50-100,1856,1
STAT,1972,11,na,1983,5805.128395543243
SIM,1977,33,na,2010,6041
SIM,1922,40,45-49,1962,1
SIM,1858,16,20-24,1874,32
SIM,1866,36,na,1902,2507
SIM,1959,28,35-39,1987,27
SIM,1807,78,na,1885,266
SIM,1870,73,na,1943,1756
SIM,1874,87,na,1961,271
SIM,1942,22,20-24,1964,136
SIM,1803,64,na,1867,1228
STAT,1978,29,50-100,2007,1.5728624900124633
SIM,1872,21,na,1893,3014
SIM,1821,37,45-49,1858,2
SIM,1836,24,20-24,1860,110
SIM,1920,24,35-39,1944,12
STAT,1839,50,25-29,1889,0.0028788874928145957
STAT,1950,42,20-24,1992,0.025043847986993058
STAT,1966,30,50-100,1996,1.2161644743770532
SIM,1866,48,30-34,1914,1
STAT,1892,17,45-49,1909,0.09448471419066097
STAT,1852,17,15-19,1869,6.767151123138992
STAT,1861,53,25-29,1914,0.0033436704780968572
SIM,1939,45,na,1984,4880
SIM,1947,67,na,2014,4950
STAT,1912,24,35-39,1936,10.794729330257772
SIM,1935,31,na,1966,6183
STAT,1903,47,40-44,1950,0.15800124244532612
STAT,1934,22,20-24,1956,172.53753383050207
STAT,1912,30,20-24,1942,2.794787070390806
STAT,1870,10,na,1880,3050.8181449448916
STAT,1925,39,40-44,1964,2.068414037878481
STAT,1816,41,na,1857,1570.2506127551537
STAT,1860,49,25-29,1909,0.05245566829804695
STAT,1893,21,45-49,1914,1.020266909124409
STAT,1831,25,30-34,1856,26.63225568576309
STAT,1909,32,15-19,1941,0.1416771485270436
SIM,1922,34,na,1956,5064
STAT,1957,32,50-100,1989,1.2823314715537057
STAT,1895,39,45-49,1934,2.9644604173027607
SIM,1961,26,25-29,1987,182
SIM,1827,36,50-100,1863,2
SIM,1958,16,25-29,1974,2
SIM,1969,36,25-29,2005,5
SIM,1835,36,20-24,1871,2
SIM,1983,29,25-29,2012,14
STAT,1856,33,35-39,1889,8.932300242362084
SIM,1916,3,na,1919,4947
STAT,1904,23,25-29,1927,94.57538266587207
STAT,1836,34,20-24,1870,3.04662307716123
SIM,1823,31,na,1854,2535
SIM,1932,66,na,1998,4713
STAT,1871,22,20-24,1893,79.12025110970212
STAT,1975,29,25-29,2004,100.54280744809346
SIM,1989,20,40-44,2009,10
STAT,1895,72,na,1967,2278.3454008963436
SIM,1977,21,30-34,1998,1
STAT,1937,43,30-34,1980,0.14866560897601194
STAT,1933,63,na,1996,5240.386008728129
SIM,1973,5,na,1978,5502
SIM,1896,16,40-44,1912,2
STAT,1850,27,20-24,1877,14.212092823485072
STAT,1841,29,20-24,1870,12.76959230224682
STAT,1920,80,na,2000,2382.8675392076984
STAT,1835,38,35-39,1873,5.401685637549169
STAT,1953,26,25-29,1979,92.32740525713055
SIM,1903,25,25-29,1928,135
STAT,1944,20,15-19,1964,6.637747792231201
STAT,1957,42,45-49,1999,0.2631696041271805
STAT,1984,27,25-29,2011,108.3498317963497
SIM,1894,22,50-100,1916,2
STAT,1908,64,na,1972,3399.9205512808207
STAT,1929,24,40-44,1953,4.876489085391848
SIM,1865,72,na,1937,1476
STAT,1840,23,30-34,1863,18.04093755291837
SIM,1979,35,na,2014,6382
SIM,1970,24,25-29,1994,161
SIM,1907,77,na,1984,2463
STAT,1918,88,na,2006,1013.6728196797753
STAT,1962,24,25-29,1986,136.94284048467247
SIM,1864,33,35-39,1897,28
SIM,1881,22,30-34,1903,19
SIM,1916,28,na,1944,4506
STAT,1938,22,40-44,1960,3.8422402319034323
SIM,1937,24,40-44,1961,6
SIM,1855,35,35-39,1890,22
STAT,1923,31,na,1954,5022.257586384748
SIM,1804,60,na,1864,987
SIM,1908,0,na,1908,4575
SIM,1919,20,30-34,1939,78
STAT,1885,40,na,1925,2687.3347921292257
STAT,1849,14,na,1863,2256.9044933375753
STAT,1914,30,30-34,1944,18.458139145837016
SIM,1890,71,na,1961,1876
SIM,1968,23,30-34,1991,55
STAT,1884,38,30-34,1922,6.046755029710118
SIM,1921,21,25-29,1942,138
STAT,1878,31,20-24,1909,3.270376091748271
STAT,1862,24,20-24,1886,67.72293887352103
STAT,1890,17,35-39,1907,0.773745846871967
STAT,1847,35,35-39,1882,5.765110209454388
STAT,1845,32,20-24,1877,2.165735064142445
STAT,1950,11,na,1961,5360.9355978554795
SIM,1891,26,20-24,1917,31
STAT,1991,15,35-39,2006,6.943611647925943
STAT,1861,28,35-39,1889,9.25755759934354
STAT,1880,32,15-19,1912,0.17419893917873716
SIM,1824,36,45-49,1860,8
SIM,1827,55,na,1882,1271
SIM,1935,36,25-29,1971,1
STAT,1857,39,25-29,1896,2.561807574516059
STAT,1913,21,25-29,1934,103.66138048529261
STAT,1827,36,20-24,1863,1.1583299862289387
SIM,1870,24,20-24,1894,83
SIM,1990,3,na,1993,6341
SIM,1874,33,na,1907,2654
SIM,1829,36,na,1865,1759
SIM,1882,20,na,1902,3491
STAT,1949,37,15-19,1986,0.02655374654804494
STAT,1869,49,45-49,1918,0.2582485464088076
STAT,1890,24,50-100,1914,0.5714336835368896
STAT,1863,36,30-34,1899,5.40401633565783
STAT,1945,15,50-100,1960,0.4725635034156206
SIM,1870,100,na,1970,50
STAT,1946,41,30-34,1987,0.17030632917934094
SIM,1922,30,30-34,1952,47
STAT,1857,2,na,1859,3163.7790265889525
SIM,1920,40,35-39,1960,1
STAT,1844,58,na,1902,1654.1072688864592
STAT,1980,27,40-44,2007,7.499659111842984
SIM,1878,48,50-100,1926,1
SIM,1892,38,30-34,1930,5
STAT,1861,15,15-19,1876,6.621970316044278
SIM,1841,20,35-39,1861,5
STAT,1895,26,25-29,1921,63.76292415428394
SIM,1870,49,35-39,1919,1
SIM,1925,88,na,2013,1305
SIM,1854,35,na,1889,2619
SIM,1933,1,na,1934,6785
STAT,1855,17,40-44,1872,0.1851080228429575
STAT,1874,34,40-44,1908,5.0797354934604035
STAT,1968,28,50-100,1996,1.44022017045609
STAT,1888,16,40-44,1904,0.248731033833136
SIM,1853,32,20-24,1885,3
STAT,1927,36,25-29,1963,1.4137174356039601
STAT,1896,35,30-34,1931,8.20095406298791
SIM,1892,52,na,1944,3433
STAT,1848,47,45-49,1895,0.24958749893859583
STAT,1851,24,45-49,1875,0.650908219264453
SIM,1898,99,na,1997,81
STAT,1932,38,50-100,1970,0.650519536740181
STAT,1987,26,25-29,2013,108.95646965223301
SIM,1823,39,20-24,1862,1
STAT,1815,39,20-24,1854,2.2986133162416382
STAT,1922,39,15-19,1961,0.0251523631579334
SIM,1978,34,25-29,2012,27
SIM,1890,61,na,1951,2600
STAT,1958,39,na,1997,5862.479574248181
SIM,1863,36,50-100,1899,4
SIM,1886,31,20-24,1917,7
SIM,1879,24,40-44,1903,6
STAT,2005,9,na,2014,6976.141625444404
SIM,1888,43,50-100,1931,4
STAT,1819,42,20-24,1861,0.3339147529529187
STAT,1873,25,35-39,1898,11.44830996692328
STAT,1885,16,15-19,1901,6.8480941856906155
STAT,1858,72,na,1930,1136.9666005957029
STAT,1864,15,40-44,1879,0.21679798971479916
SIM,1929,42,35-39,1971,1
STAT,1912,40,35-39,1952,0.22688700520569435
SIM,1887,43,30-34,1930,4
STAT,1935,32,na,1967,6041.752354239975
SIM,1915,64,na,1979,3707
STAT,1872,22,na,1894,2740.6235433643765
STAT,1884,23,45-49,1907,0.7926438302135022
STAT,1857,42,40-44,1899,2.019184130858385
SIM,1868,38,25-29,1906,8
SIM,1882,28,20-24,1910,15
STAT,1869,24,30-34,1893,19.782533403327335
SIM,1959,25,30-34,1984,143
STAT,1835,25,15-19,1860,0.37604894962306157
SIM,1822,33,30-34,1855,44
STAT,1834,32,45-49,1866,2.038452263416647
STAT,1945,32,25-29,1977,11.876960858515641
SIM,1997,17,45-49,2014,2
STAT,1879,43,30-34,1922,1.3753643090272083
STAT,1940,23,35-39,1963,11.069443257413438
SIM,1842,32,45-49,1874,5
STAT,1872,51,35-39,1923,0.010023929094348658
STAT,1862,37,40-44,1899,4.2633918680396885
SIM,1857,75,na,1932,901
STAT,1838,37,35-39,1875,7.394120728003389
STAT,1807,80,na,1887,366.2351969390336
STAT,1874,28,20-24,1902,13.811303197539004
SIM,1838,43,35-39,1881,4
SIM,1834,44,50-100,1878,1
STAT,1839,54,50-100,1893,0.011647866209572873
STAT,1829,31,25-29,1860,13.803022336714433
STAT,1971,29,na,2000,5493.841239659052
STAT,1905,35,35-39,1940,2.5741780474317104
STAT,1991,16,50-100,2007,0.6198102195401471
SIM,1921,29,20-24,1950,37
STAT,1864,27,35-39,1891,9.94265704194682
SIM,1872,42,na,1914,2869
STAT,1848,44,40-44,1892,2.3576584956132933
SIM,1872,27,35-39,1899,25
SIM,1867,53,na,1920,2062
STAT,1816,41,50-100,1857,2.484230573577255
STAT,1955,17,45-49,1972,0.7653031791349639
STAT,1771,110,na,1881,0.0024337664357787564
STAT,1893,91,na,1984,397.8732637794829
SIM,1914,47,na,1961,3870
STAT,1940,33,na,1973,4515.899111007901
STAT,1963,33,30-34,1996,23.531358756376225
SIM,1837,31,25-29,1868,7
SIM,1867,39,35-39,1906,9
SIM,1809,91,na,1900,51
SIM,1944,31,20-24,1975,6
STAT,1889,32,35-39,1921,14.406452894320479
STAT,1827,49,40-44,1876,0.21110437803323723
STAT,1913,29,20-24,1942,20.851210671773494
SIM,1901,28,40-44,1929,15
STAT,1833,47,15-19,1880,3.3198460405392316E-4
SIM,1897,32,35-39,1929,18
SIM,1888,34,35-39,1922,4
STAT,1947,20,40-44,1967,4.388394203919623
STAT,1853,39,40-44,1892,4.314460327059536
SIM,1901,20,45-49,1921,2
SIM,1894,28,25-29,1922,129
STAT,1948,44,45-49,1992,0.22766282007716437
SIM,1839,56,na,1895,1695
STAT,1839,16,45-49,1855,0.068168668221043
STAT,1979,32,25-29,2011,14.970169914978863
STAT,1825,34,45-49,1859,3.1812158992628334
SIM,1846,37,35-39,1883,4
SIM,1837,27,40-44,1864,7
STAT,1936,31,20-24,1967,2.7373709690044397
SIM,1895,49,na,1944,3349
SIM,1893,29,35-39,1922,1
SIM,1843,38,35-39,1881,8
STAT,1960,48,50-100,2008,0.35263269377764056
STAT,1871,38,na,1909,2691.542903237343
STAT,1928,15,35-39,1943,6.129978984799307
SIM,1907,67,na,1974,3407
STAT,1885,29,35-39,1914,11.027587286162511
STAT,1801,109,na,1910,2.986170344370071E-4
SIM,1833,34,45-49,1867,1
SIM,1899,26,50-100,1925,2
STAT,1963,28,na,1991,5513.552132200143
STAT,1861,50,20-24,1911,7.181389466685817E-4
SIM,1894,21,na,1915,4000
SIM,1943,44,50-100,1987,1
SIM,1970,21,20-24,1991,305
STAT,1829,27,40-44,1856,6.174284056526451
STAT,1809,48,35-39,1857,0.3544310076556554
SIM,1902,22,50-100,1924,1
STAT,1886,28,25-29,1914,51.31273234716224
STAT,1884,32,50-100,1916,1.044722408071319
STAT,1969,24,35-39,1993,13.60984739393142
STAT,1989,17,45-49,2006,0.8257356383726792
STAT,1918,30,15-19,1948,0.15882239855745445
STAT,1958,35,15-19,1993,0.030039550364171188
SIM,1893,16,15-19,1909,13
SIM,1861,26,20-24,1887,13
SIM,1834,31,50-100,1865,2
STAT,1869,33,20-24,1902,3.0082124611637377
SIM,1832,22,35-39,1854,1
SIM,1832,37,20-24,1869,1
STAT,1947,32,35-39,1979,12.109056166259212
STAT,1939,23,50-100,1962,0.7626729424352466
STAT,1944,16,30-34,1960,15.142566044316684
STAT,1875,25,45-49,1900,1.3331258326930133
STAT,1853,26,20-24,1879,13.628676812190518
STAT,1919,42,25-29,1961,0.08928477765712292
SIM,1883,25,45-49,1908,2
STAT,1959,20,45-49,1979,1.7053232346763139
STAT,1800,58,na,1858,1375.5937340620408
STAT,1830,29,45-49,1859,1.2760503517413422
SIM,1816,61,na,1877,1339
SIM,1955,32,35-39,1987,7
STAT,1860,22,45-49,1882,0.6685982988110754
STAT,1824,37,20-24,1861,1.1817745474952772
SIM,1877,33,20-24,1910,4
SIM,1834,37,30-34,1871,10
SIM,1907,13,na,1920,4796
STAT,1847,23,40-44,1870,1.9514938349550497
SIM,1968,37,35-39,2005,7
STAT,1850,50,45-49,1900,0.015154437612129718
SIM,1993,21,45-49,2014,4
STAT,1907,47,na,1954,3803.0698076221406
STAT,1952,23,50-100,1975,0.9126940348044827
STAT,1937,13,na,1950,4443.9423205322
SIM,1917,45,na,1962,5301
STAT,1929,27,45-49,1956,2.4953430932376963
SIM,1879,54,na,1933,2466
SIM,1965,29,na,1994,5561
STAT,1826,31,50-100,1857,0.9130597654898425
SIM,1886,34,25-29,1920,2
SIM,1937,27,45-49,1964,3
STAT,1944,3,na,1947,4987.499520739347
SIM,1865,39,25-29,1904,6
SIM,1847,21,50-100,1868,1
SIM,1845,25,25-29,1870,2
SIM,1854,44,30-34,1898,4
STAT,1915,29,30-34,1944,45.800484213235926
SIM,1978,31,20-24,2009,4
STAT,1985,21,45-49,2006,1.8535605274516258
STAT,1865,42,na,1907,2403.629523911005
STAT,1851,21,40-44,1872,1.9876182623703482
STAT,1830,26,40-44,1856,3.958589973712693
SIM,1928,21,35-39,1949,26
SIM,1961,23,20-24,1984,330
STAT,1825,49,30-34,1874,0.13147715620737116
SIM,1867,17,25-29,1884,8
STAT,1958,23,20-24,1981,169.04295316725265
SIM,1787,95,na,1882,13
SIM,1978,20,20-24,1998,323
STAT,1826,37,30-34,1863,4.270546009899283
STAT,1846,44,30-34,1890,1.1724638327545682
SIM,1932,12,na,1944,5676
STAT,1927,33,20-24,1960,3.4597624605710173
STAT,1962,12,na,1974,5808.467155379904
STAT,1877,22,15-19,1899,3.960296647671949
SIM,1813,96,na,1909,8
STAT,1909,20,20-24,1929,120.11153482285708
SIM,1868,48,40-44,1916,1
SIM,1886,49,50-100,1935,1
STAT,1953,23,20-24,1976,155.69548058994596
STAT,1897,26,35-39,1923,14.940684947266623
STAT,1789,104,na,1893,0.013520178059096095
STAT,1949,25,20-24,1974,24.627195456939138
SIM,1781,90,na,1871,56
STAT,1918,26,30-34,1944,48.27736693955185
SIM,1834,25,na,1859,1942
STAT,1929,28,50-100,1957,1.4369821636199076
STAT,1914,33,35-39,1947,10.575983887411914
SIM,1861,7,na,1868,2300
SIM,1927,65,na,1992,4040
STAT,1837,25,25-29,1862,39.88640629418315
SIM,1935,33,20-24,1968,1
SIM,1983,26,20-24,2009,37
STAT,1836,37,25-29,1873,3.2173917654611035
SIM,1918,27,50-100,1945,4
SIM,1959,47,na,2006,5825
STAT,1878,5,na,1883,3277.763302630602
STAT,1941,19,30-34,1960,14.482589082657109
SIM,1889,43,40-44,1932,1
SIM,1922,33,35-39,1955,33
STAT,1975,26,20-24,2001,27.92372350506022
SIM,1829,42,30-34,1871,4
SIM,1966,23,20-24,1989,1
SIM,1957,25,20-24,1982,32
STAT,1878,49,50-100,1927,0.28975814436705505
STAT,1859,17,25-29,1876,6.047080108756568
STAT,1807,90,na,1897,38.55335347955364
STAT,1820,46,na,1866,1533.0302626687985
STAT,1990,16,45-49,2006,0.8258272615299647
SIM,1983,15,20-24,1998,242
STAT,1851,39,30-34,1890,4.183791513930594
STAT,1864,68,na,1932,1574.7182900555465
SIM,1982,20,30-34,2002,2
STAT,1867,33,na,1900,2560.3719849244494
STAT,1845,35,25-29,1880,2.2871283992356903
SIM,1891,29,25-29,1920,126
SIM,1882,84,na,1966,1026
SIM,1926,26,30-34,1952,68
STAT,1855,21,25-29,1876,57.31694425487966
STAT,1878,34,25-29,1912,12.236216752700871
STAT,1854,42,15-19,1896,0.011236974906278768
STAT,1940,43,na,1983,4516.833159162941
SIM,1846,34,30-34,1880,15
SIM,1923,29,30-34,1952,65
SIM,1986,16,30-34,2002,53
STAT,1868,24,15-19,1892,3.6349522545562127
STAT,1862,27,25-29,1889,41.350602628424824
STAT,1961,33,20-24,1994,3.7047702770979085
STAT,1942,20,50-100,1962,0.796865239818553
STAT,1980,20,50-100,2000,1.058378085149761
STAT,1858,38,15-19,1896,0.050304412090943613
STAT,1872,15,50-100,1887,0.057635588909469765
SIM,1900,32,45-49,1932,6
SIM,1989,23,45-49,2012,2
STAT,1782,109,na,1891,0.0027264456812603295
STAT,1986,27,35-39,2013,24.794894179444114
STAT,1898,79,na,1977,1777.6078419541836
SIM,1928,61,na,1989,5036
STAT,1852,24,na,1876,2360.477076410172
STAT,1844,23,15-19,1867,3.420526679957927
SIM,1870,27,25-29,1897,59
STAT,1938,34,35-39,1972,10.595671128767748
STAT,1950,29,50-100,1979,1.3627191194547759
SIM,1968,26,35-39,1994,33
STAT,1837,27,50-100,1864,0.594541495839012
STAT,1883,29,25-29,1912,47.420842537261876
SIM,1903,22,20-24,1925,246
STAT,1903,32,20-24,1935,4.443226343575992
SIM,1911,32,20-24,1943,6
SIM,1857,85,na,1942,219
STAT,1946,44,35-39,1990,0.266967751544646
SIM,1986,15,na,2001,5900
STAT,1915,91,na,2006,580.4450343939516
SIM,1952,2,na,1954,4902
SIM,1902,46,na,1948,3780
SIM,1928,30,25-29,1958,26
SIM,1946,34,35-39,1980,36
STAT,1859,15,50-100,1874,0.05290156611863734
STAT,1976,38,30-34,2014,2.8921142718332113
SIM,1877,73,na,1950,1396
STAT,1898,38,45-49,1936,0.66776530958029
STAT,1925,31,45-49,1956,2.1570244813792905
SIM,1868,35,20-24,1903,2
STAT,1862,49,35-39,1911,0.13350364252584665
SIM,1868,26,30-34,1894,4
STAT,1925,12,na,1937,5521.962935650538
STAT,1968,34,15-19,2002,0.18856408621581594
STAT,1867,53,50-100,1920,0.016011756746432057
STAT,1875,19,na,1894,2995.873418286913
STAT,1879,46,35-39,1925,0.16918162159398156
SIM,1867,36,30-34,1903,21
STAT,1887,21,na,1908,3068.006489816713
STAT,1965,19,na,1984,5299.537790817783
STAT,1926,24,15-19,1950,7.415014467833794
SIM,1857,35,45-49,1892,2
STAT,1991,17,na,2008,6087.5434829999085
STAT,1819,45,25-29,1864,0.11417376522949675
SIM,1955,23,45-49,1978,4
STAT,1821,73,na,1894,726.4196508691851
STAT,1936,22,30-34,1958,31.729789297518835
STAT,1890,51,na,1941,3050.8360489153793
SIM,1882,34,40-44,1916,12
STAT,1967,10,na,1977,5664.219251706163
SIM,1843,20,45-49,1863,2
SIM,1946,1,na,1947,4814
SIM,1829,33,40-44,1862,5
STAT,1857,55,na,1912,1858.4830310520504
STAT,1932,25,50-100,1957,1.506209753342365
SIM,1863,21,25-29,1884,141
SIM,1863,49,50-100,1912,1
SIM,1849,24,na,1873,2786
SIM,1819,58,na,1877,783
STAT,1915,34,na,1949,4407.973971841124
SIM,1933,31,45-49,1964,4
SIM,1897,83,na,1980,1097
SIM,1934,24,15-19,1958,8
SIM,1861,39,40-44,1900,2
STAT,1813,54,50-100,1867,0.04607661386271404
SIM,1818,36,35-39,1854,10
SIM,1878,24,25-29,1902,3
STAT,1975,15,20-24,1990,206.5189073627683
STAT,1931,25,35-39,1956,22.393460361003918
STAT,1948,16,15-19,1964,59.95323635054105
STAT,1785,106,na,1891,0.005991933172696695
STAT,1891,36,na,1927,3376.5467251705863
SIM,1819,35,25-29,1854,2
STAT,1857,48,15-19,1905,3.550065372520797E-4
STAT,1838,34,30-34,1872,18.410077485434808
SIM,1812,79,na,1891,184
SIM,1871,68,na,1939,1071
STAT,1923,0,na,1923,6102.783605450686
STAT,1948,64,na,2012,4469.280621572126
SIM,1827,45,25-29,1872,1
SIM,1956,16,15-19,1972,51
STAT,1914,17,20-24,1931,32.38048039765209
STAT,1973,29,15-19,2002,1.0571732001831897
STAT,1971,22,25-29,1993,135.4593217682211
SIM,1922,17,20-24,1939,154
SIM,1919,14,na,1933,5645
STAT,1840,48,45-49,1888,0.18848333572618303
STAT,1910,13,na,1923,4513.735848207248
SIM,1879,36,35-39,1915,3
STAT,1842,26,45-49,1868,1.0642423743869374
SIM,1800,78,na,1878,524
STAT,1926,85,na,2011,1721.4757904165742
STAT,1951,21,45-49,1972,1.5518764890573964
STAT,1952,49,25-29,2001,0.07585844313680541
STAT,1887,37,30-34,1924,6.892865599029812
STAT,1926,46,50-100,1972,0.3228043063748523
SIM,1956,41,40-44,1997,2
STAT,1864,24,30-34,1888,18.38282507724221
STAT,1835,20,45-49,1855,0.9079875993885198
SIM,1878,37,45-49,1915,4
SIM,1981,25,50-100,2006,2
STAT,1835,42,50-100,1877,0.7900033532713593
SIM,1893,26,30-34,1919,50
SIM,1904,70,na,1974,3088
STAT,1950,57,na,2007,4985.39019231825
SIM,1894,25,20-24,1919,1
SIM,1888,25,45-49,1913,4
SIM,1924,25,na,1949,4859
SIM,1932,39,25-29,1971,4
SIM,1989,13,na,2002,6749
STAT,1886,38,40-44,1924,5.302352210091716
STAT,1947,23,45-49,1970,1.467025970878289
STAT,1876,69,na,1945,1750.7482264973435
STAT,1960,31,na,1991,5797.934131655486
SIM,1888,31,30-34,1919,29
SIM,1907,31,50-100,1938,2
SIM,1865,30,50-100,1895,2
STAT,1898,15,na,1913,3957.4400047138233
SIM,1972,24,35-39,1996,17
STAT,1969,21,30-34,1990,41.58483345811386
STAT,1883,71,na,1954,1507.1130765624537
SIM,1958,48,30-34,2006,1
STAT,1948,49,15-19,1997,5.030638721407953E-4
STAT,1840,15,45-49,1855,0.0686524230757244
SIM,1895,37,30-34,1932,14
SIM,1826,38,na,1864,1958
STAT,1948,41,40-44,1989,0.3437879683830702
SIM,1901,25,15-19,1926,1
STAT,1885,26,30-34,1911,29.08659414703504
STAT,1922,14,na,1936,5272.556812032837
SIM,1850,26,45-49,1876,3
STAT,1803,98,na,1901,1.1322451673246006
SIM,1894,38,40-44,1932,10
STAT,1825,31,40-44,1856,9.799106245936214
STAT,1922,15,40-44,1937,1.8759774949199812
SIM,1969,21,na,1990,5087
STAT,1886,25,20-24,1911,14.377712256552627
STAT,1864,18,45-49,1882,0.06922163153186502
STAT,1894,35,20-24,1929,1.15444530538889
STAT,1964,24,35-39,1988,13.722104590623138
STAT,1849,35,45-49,1884,1.6142111836765456
STAT,1980,23,na,2003,5867.883337279193
SIM,1833,31,40-44,1864,14
SIM,1856,44,40-44,1900,10
SIM,1960,23,50-100,1983,3
STAT,1940,20,30-34,1960,33.82297728085715
SIM,1855,23,40-44,1878,8
STAT,1930,65,na,1995,4867.630525539314
SIM,1901,19,na,1920,4302
SIM,1843,47,25-29,1890,1
SIM,1846,28,45-49,1874,1
SIM,1902,49,40-44,1951,1
SIM,1929,20,25-29,1949,4
STAT,1996,15,35-39,2011,7.041397344270213
STAT,1992,13,na,2005,6505.812334444661
STAT,1928,36,40-44,1964,2.185265221052412
STAT,1968,21,15-19,1989,7.700806626745594
STAT,1834,91,na,1925,52.88321189421236
SIM,1845,22,20-24,1867,80
STAT,1847,26,45-49,1873,1.034284293571982
STAT,1862,15,30-34,1877,1.799004264425541
STAT,1887,28,40-44,1915,3.8605944351961194
STAT,1864,47,50-100,1911,0.25189659551543797
STAT,1895,29,na,1924,3559.3932776418733
STAT,1846,20,20-24,1866,89.17692207042847
STAT,1984,12,na,1996,6438.482255599011
SIM,1844,57,na,1901,1848
STAT,1855,74,na,1929,944.3141505405426
STAT,1902,16,na,1918,4128.438781359813
SIM,1918,20,15-19,1938,5
STAT,1924,39,25-29,1963,1.3366622007193694
STAT,1985,15,25-29,2000,71.16762904838036
STAT,1819,36,50-100,1855,3.94118002855936
STAT,1963,24,40-44,1987,4.942686162574614
STAT,1851,15,20-24,1866,17.295870489137208
STAT,1874,100,na,1974,12.743491625175341
SIM,1946,31,30-34,1977,8
STAT,1948,54,na,2002,4914.985228135852
STAT,1852,103,na,1955,0.1353078892184906
STAT,1942,20,40-44,1962,4.071981079220733
SIM,1991,16,na,2007,6708
STAT,1884,66,na,1950,1868.8337639010992
STAT,1896,27,45-49,1923,1.6924196166431105
SIM,1934,15,25-29,1949,70
STAT,1838,28,45-49,1866,1.2148438813877533
SIM,1872,49,45-49,1921,2
SIM,1984,17,25-29,2001,82
SIM,1845,49,35-39,1894,1
SIM,1861,17,30-34,1878,3
STAT,1857,21,35-39,1878,6.098831070785801
STAT,1934,34,15-19,1968,0.2023192476991702
STAT,1846,49,na,1895,2277.283245138657
STAT,1987,17,35-39,2004,6.913142808985448
SIM,1844,26,35-39,1870,24
STAT,1846,47,35-39,1893,0.14405475763665312
STAT,1889,41,50-100,1930,1.5096761474204687
STAT,1903,35,25-29,1938,1.0312259240960175
STAT,1853,17,30-34,1870,1.90892140035418
STAT,1901,85,na,1986,1143.9668409015326
SIM,1895,29,45-49,1924,2
SIM,1908,25,25-29,1933,75
SIM,1835,28,35-39,1863,1
STAT,1961,36,25-29,1997,1.5138317717847616
STAT,1827,28,35-39,1855,26.42589163347577
SIM,1962,32,na,1994,5460
STAT,1819,38,na,1857,1944.2847003214017
STAT,1810,48,50-100,1858,0.935257406580761
SIM,1870,15,30-34,1885,3
STAT,1864,49,45-49,1913,0.2381067113820905
SIM,1936,36,40-44,1972,3
SIM,1995,17,35-39,2012,12
SIM,1909,34,30-34,1943,39
STAT,1836,26,35-39,1862,11.448848213892367
STAT,1941,28,na,1969,4471.218418776028
STAT,1950,29,25-29,1979,90.1135546110325
SIM,1900,28,25-29,1928,7
STAT,1954,26,40-44,1980,6.6815012708282175
STAT,1916,30,40-44,1946,4.700567151912276
STAT,1837,49,35-39,1886,0.10257389086987326
STAT,1909,23,25-29,1932,98.87838249301788
STAT,1842,17,20-24,1859,17.518829972911206
STAT,1937,22,25-29,1959,103.86240958821922
STAT,1873,16,45-49,1889,0.07743801912888713
STAT,1938,31,30-34,1969,18.301826082275053
SIM,1822,57,na,1879,1287
SIM,1926,70,na,1996,4588
SIM,1957,32,45-49,1989,1
STAT,1896,26,40-44,1922,4.581766057177663
SIM,1840,36,50-100,1876,6
SIM,1958,37,30-34,1995,6
SIM,1879,33,30-34,1912,2
STAT,1959,23,na,1982,5529.059295538079
SIM,1945,22,25-29,1967,240
STAT,1859,67,na,1926,1457.2982226817553
STAT,1817,57,na,1874,1681.3530319244576
SIM,1835,27,30-34,1862,2
STAT,1803,107,na,1910,0.0016436965242763164
STAT,1953,17,35-39,1970,5.858050832253044
SIM,1899,32,45-49,1931,1
STAT,1955,38,50-100,1993,0.6620090662429627
STAT,1890,39,45-49,1929,2.7827638459797095
SIM,1820,76,na,1896,1003
SIM,1962,26,40-44,1988,12
STAT,1835,47,25-29,1882,0.03788886423430683
STAT,1852,34,na,1886,2281.5692019323187
STAT,1837,22,20-24,1859,65.3249160131583
STAT,1884,28,15-19,1912,0.5155001869401756
STAT,1928,6,na,1934,5828.145277664689
SIM,1869,38,40-44,1907,4
STAT,1827,27,30-34,1854,97.08213148737998
SIM,1792,84,na,1876,58
STAT,1825,104,na,1929,0.04717882408936256
SIM,1950,20,40-44,1970,6
STAT,1867,36,15-19,1903,0.06079710865244595
STAT,1942,16,20-24,1958,163.5807142021219
STAT,1835,46,20-24,1881,0.007995309364892102
SIM,1833,25,20-24,1858,2
SIM,1910,23,15-19,1933,8
STAT,1873,22,30-34,1895,20.991594915149758
STAT,1876,28,30-34,1904,29.935727902371244
SIM,1988,20,25-29,2008,192
STAT,1919,38,50-100,1957,0.5198888099986709
STAT,1855,36,50-100,1891,1.0497089507325679
SIM,1884,28,30-34,1912,26
SIM,1940,38,50-100,1978,2
STAT,1975,38,15-19,2013,0.030090386102621512
STAT,1843,29,30-34,1872,30.65067345530137
SIM,1882,37,45-49,1919,6
STAT,1997,9,na,2006,6622.159848887301
STAT,1870,51,25-29,1921,0.004049114957619011
SIM,1794,75,na,1869,297
SIM,1838,61,na,1899,1308
SIM,1879,27,45-49,1906,5
STAT,1836,72,na,1908,1149.3199800293644
STAT,1858,33,45-49,1891,1.5633135622028902
STAT,1893,48,na,1941,3241.2499786940593
STAT,1905,66,na,1971,3153.543952063472
STAT,1851,93,na,1944,23.17558606065978
STAT,1987,23,20-24,2010,183.7377521727562
SIM,1851,29,30-34,1880,46
SIM,1871,37,35-39,1908,10
STAT,1894,38,25-29,1932,4.25021573412423
STAT,1873,93,na,1966,111.44758556673393
STAT,1969,30,20-24,1999,3.588368389666695
STAT,1898,35,40-44,1933,6.892346658544946
STAT,1842,56,na,1898,1569.5498460783638
SIM,1911,8,na,1919,5201
SIM,1874,7,na,1881,2999
STAT,1910,67,na,1977,3327.165797749989
SIM,1970,15,35-39,1985,18
SIM,1956,28,30-34,1984,133
STAT,1846,38,50-100,1884,1.3117290397178407
STAT,1851,48,20-24,1899,0.009396370211678442
STAT,1957,20,35-39,1977,14.3842133368058
STAT,1960,24,15-19,1984,8.022142528276301
SIM,1837,87,na,1924,294
SIM,1866,33,45-49,1899,3
STAT,1873,19,15-19,1892,6.956301507861208
STAT,1965,47,45-49,2012,0.32570571144465277
STAT,1830,24,na,1854,1651.3590479963318
SIM,1954,20,25-29,1974,247
STAT,1831,47,40-44,1878,0.1586165637757619
STAT,1883,38,15-19,1921,0.06308920024359006
SIM,1950,16,20-24,1966,1
STAT,1992,18,20-24,2010,224.50688068239862
STAT,1891,49,50-100,1940,0.19347473742986604
SIM,1839,27,15-19,1866,1
SIM,1887,51,na,1938,3500
STAT,1936,25,35-39,1961,16.605938347285075
STAT,1863,28,45-49,1891,1.1164742909708196
STAT,1949,32,45-49,1981,2.1528178677870744
SIM,1853,35,25-29,1888,6
SIM,1924,30,40-44,1954,15
SIM,1857,32,40-44,1889,11
STAT,1955,42,na,1997,5913.020383078013
STAT,1886,16,30-34,1902,1.945000294019842
STAT,1916,29,na,1945,4438.575805503402
SIM,1960,5,na,1965,6329
SIM,1887,41,na,1928,3679
STAT,1925,36,15-19,1961,0.02661442051677034
STAT,1951,26,15-19,1977,0.9747791187650325
STAT,1965,39,50-100,2004,0.6218799147363634
STAT,1914,100,na,2014,39.791745363063164
STAT,1878,43,15-19,1921,0.016520025641495475
STAT,1927,27,35-39,1954,21.05922282255463
SIM,1829,36,45-49,1865,4
STAT,1861,37,25-29,1898,2.7623225696909577
SIM,1889,22,35-39,1911,2
STAT,1826,44,50-100,1870,0.768455369370563
SIM,1965,20,35-39,1985,31
STAT,1964,21,30-34,1985,41.927834866857175
STAT,1919,80,na,1999,2338.5374507974448
SIM,1894,16,30-34,1910,3
SIM,1972,21,30-34,1993,98
STAT,1853,19,na,1872,2716.8806916047483
SIM,1869,22,na,1891,2144
STAT,1852,39,25-29,1891,2.68722507743627
STAT,1887,29,45-49,1916,1.4257173578012017
SIM,1824,41,50-100,1865,2
SIM,1860,39,25-29,1899,8
SIM,1913,19,20-24,1932,34
SIM,1944,25,35-39,1969,5
SIM,1935,27,35-39,1962,57
SIM,1845,38,45-49,1883,5
SIM,1852,54,na,1906,1722
STAT,1857,17,15-19,1874,6.2693325895007375
STAT,1959,35,30-34,1994,2.8394396249606433
SIM,1874,23,na,1897,2430
SIM,1887,22,25-29,1909,100
SIM,1964,36,na,2000,5847
STAT,1847,32,30-34,1879,15.773762540277309
STAT,1836,25,30-34,1861,30.095439172564863
STAT,1893,26,15-19,1919,0.6640955126729077
STAT,1926,15,25-29,1941,61.58795969537653
STAT,1977,28,30-34,2005,61.33184081354076
STAT,1842,23,40-44,1865,2.0080189222843403
STAT,1849,32,40-44,1881,3.5419199250771687
STAT,1874,88,na,1962,302.7571062160531
SIM,1937,33,na,1970,4362
STAT,1905,19,20-24,1924,29.453556722482542
STAT,1862,16,35-39,1878,0.6156814760356112
SIM,1825,39,30-34,1864,1
STAT,1826,49,25-29,1875,0.040379159430656696
STAT,1879,22,25-29,1901,68.9820428142486
STAT,1817,39,30-34,1856,17.74305394753915
SIM,1909,37,35-39,1946,5
SIM,1855,32,30-34,1887,16
SIM,1844,37,25-29,1881,5
STAT,1884,16,20-24,1900,20.264090584940934
STAT,1962,15,35-39,1977,6.208039404623269
SIM,1985,28,30-34,2013,109
STAT,1977,34,na,2011,6003.545811114106
SIM,1855,26,45-49,1881,5
SIM,1801,62,na,1863,1287
SIM,1898,14,na,1912,4139
STAT,1837,38,45-49,1875,1.7393782950006729
SIM,1834,49,25-29,1883,1
SIM,1839,31,35-39,1870,3
SIM,1850,23,40-44,1873,1
SIM,1856,47,45-49,1903,1
SIM,1805,55,na,1860,1417
STAT,1935,44,50-100,1979,0.19070088266481328
STAT,1859,36,30-34,1895,4.923087559038452
SIM,1865,17,15-19,1882,12
STAT,1863,37,35-39,1900,7.137356925866994
SIM,1844,25,30-34,1869,48
STAT,1799,97,na,1896,2.413129364209299
STAT,1920,39,40-44,1959,1.8866807134221975
STAT,1946,20,25-29,1966,118.70412749499823
SIM,1967,20,45-49,1987,2
STAT,1861,36,20-24,1897,0.7431175236289809
SIM,1922,81,na,2003,2034
STAT,1897,17,45-49,1914,0.10080136656748244
STAT,1916,26,20-24,1942,21.858366221988256
SIM,1939,30,35-39,1969,1
STAT,1827,102,na,1929,0.23809338677547665
STAT,1837,37,40-44,1874,3.8593727912626576
STAT,1897,23,30-34,1920,27.40180249113984
SIM,1860,27,30-34,1887,24
SIM,1937,43,na,1980,4332
SIM,1984,16,20-24,2000,205
STAT,1852,27,30-34,1879,27.653090975594157
STAT,1866,37,na,1903,2520.098941972164
STAT,1870,53,na,1923,2410.37822579661
SIM,1854,20,20-24,1874,4
STAT,1980,16,40-44,1996,2.2414871952289768
SIM,1913,23,40-44,1936,9
STAT,1977,29,35-39,2006,23.488487294296345
STAT,1975,22,45-49,1997,1.7187012510696582
STAT,1905,23,40-44,1928,3.469877263494847
SIM,1985,29,35-39,2014,57
SIM,1899,25,20-24,1924,21
STAT,1974,18,30-34,1992,18.361765780695666
STAT,1853,48,30-34,1901,0.0951649515729759
SIM,1924,26,20-24,1950,6
SIM,1877,27,35-39,1904,3
SIM,1919,32,25-29,1951,29
STAT,1849,44,50-100,1893,0.8077697202230324
STAT,1928,62,na,1990,4924.137226668334
SIM,1880,19,na,1899,3557
STAT,1851,18,25-29,1869,5.4313200186438735
STAT,1846,25,50-100,1871,0.8116256993180359
STAT,1825,37,15-19,1862,0.09326593584456246
SIM,1869,36,40-44,1905,3
STAT,1937,46,35-39,1983,0.15066958285635682
STAT,1967,33,50-100,2000,1.214157137436913
STAT,1871,25,25-29,1896,48.89687359285864
STAT,1896,38,35-39,1934,10.727681353288999
SIM,1888,30,50-100,1918,3
STAT,1948,37,20-24,1985,0.35867172250509227
STAT,1985,26,15-19,2011,1.164275707678512
STAT,1862,18,35-39,1880,0.6084501075312466
SIM,1924,17,30-34,1941,42
SIM,1969,33,20-24,2002,7
SIM,2006,6,na,2012,7588
STAT,1916,17,30-34,1933,2.9847076253351017
SIM,1770,84,na,1854,153
STAT,1957,46,na,2003,5828.817563178508
SIM,1913,26,45-49,1939,5
SIM,1972,10,na,1982,5837
STAT,1962,21,20-24,1983,165.01894656292106
STAT,1956,0,na,1956,6048.680035922865
SIM,1881,25,35-39,1906,34
STAT,1909,59,na,1968,3667.549004599816
STAT,1886,17,35-39,1903,0.6679497569589009
STAT,1901,31,na,1932,3873.194524730668
SIM,1849,34,na,1883,2718
STAT,1905,26,45-49,1931,1.8609284648391775
STAT,1846,23,25-29,1869,72.4950349038041
SIM,1934,21,45-49,1955,7
STAT,1850,39,15-19,1889,0.057516552968876096
STAT,1964,15,45-49,1979,0.7264773885804726
SIM,1843,72,na,1915,837
STAT,1847,29,15-19,1876,0.41360057217313406
STAT,1885,38,25-29,1923,3.2978317524908864
SIM,1935,66,na,2001,5101
SIM,1893,38,25-29,1931,1
STAT,1780,100,na,1880,0.3082795745893411
STAT,1868,15,25-29,1883,6.472871434827292
STAT,1915,6,na,1921,4826.143282296701
STAT,1942,23,45-49,1965,1.3612500879720955
STAT,1824,49,15-19,1873,5.29161589203389E-4
STAT,1920,15,30-34,1935,3.179622631691732
STAT,1808,47,15-19,1855,0.001999787151683541
SIM,1923,21,35-39,1944,1
SIM,1942,44,na,1986,4958
SIM,1971,27,45-49,1998,8
STAT,1865,52,na,1917,2230.063620506511
SIM,1880,93,na,1973,146
SIM,1909,28,45-49,1937,2
SIM,1972,15,45-49,1987,1
STAT,1968,15,50-100,1983,0.5403202668084728
STAT,1963,27,45-49,1990,2.5439051244590436
STAT,1895,23,20-24,1918,103.19991914484692
STAT,1896,29,45-49,1925,1.6803235768220106
STAT,1923,27,50-100,1950,1.318324745021351
STAT,1926,21,45-49,1947,1.5819622917038068
SIM,1974,28,20-24,2002,50
STAT,1963,36,35-39,1999,3.656865940352394
STAT,1835,49,25-29,1884,0.03693021060809513
SIM,1966,32,45-49,1998,8
SIM,1954,4,na,1958,5548
STAT,1840,26,35-39,1866,9.720926507768581
STAT,1863,39,35-39,1902,7.065522603104503
STAT,1924,15,15-19,1939,62.641844492694915
STAT,1980,33,50-100,2013,1.3493520122428189
SIM,1895,26,40-44,1921,1
STAT,1838,25,40-44,1863,3.3492375068082816
STAT,1914,29,15-19,1943,0.8158225039887101
STAT,1885,37,20-24,1922,0.8873312928320792
SIM,1931,27,50-100,1958,2
SIM,1946,25,na,1971,4649
STAT,1916,33,45-49,1949,1.867144215205166
STAT,1985,17,25-29,2002,71.12991518671875
SIM,1862,27,40-44,1889,9
STAT,1943,19,40-44,1962,1.7107427717287471
STAT,1863,27,40-44,1890,3.022853971416291
STAT,1847,111,na,1958,1.031879223094972E-4
SIM,1856,20,30-34,1876,30
STAT,1901,39,50-100,1940,0.42405257547688785
STAT,1973,22,35-39,1995,14.100118550545425
SIM,1893,37,20-24,1930,1
SIM,1794,65,na,1859,829
STAT,1887,26,40-44,1913,3.8875270734801504
STAT,1860,75,na,1935,957.5115852714413
SIM,1984,23,45-49,2007,2
STAT,1855,48,40-44,1903,0.1438429264690799
SIM,1871,39,35-39,1910,23
STAT,1854,27,40-44,1881,2.5584153740832343
SIM,1819,68,na,1887,401
STAT,1915,44,na,1959,4301.489784690084
STAT,1931,3,na,1934,6128.165500371614
SIM,1913,52,na,1965,4356
SIM,1870,18,35-39,1888,1
STAT,1938,25,45-49,1963,1.9779027653126382
SIM,1833,28,25-29,1861,47
STAT,1895,17,35-39,1912,0.8242664714140732
SIM,1842,76,na,1918,854
STAT,1898,69,na,1967,2634.8496969423327
STAT,1948,20,35-39,1968,12.485039154107229
STAT,1958,32,45-49,1990,2.431214380850682
STAT,1902,23,15-19,1925,5.362858400919786
STAT,1915,38,20-24,1953,0.30585233528023875
SIM,1891,20,25-29,1911,90
STAT,1883,20,25-29,1903,65.02123115477977
STAT,1931,16,45-49,1947,0.7565923424193822
STAT,1874,37,45-49,1911,2.3551993607305035
SIM,1824,33,40-44,1857,2
SIM,1861,15,30-34,1876,2
STAT,1851,6,na,1857,2405.2899079211475
STAT,1931,22,30-34,1953,43.028569632445965
SIM,1971,24,na,1995,5778
SIM,1846,25,40-44,1871,2
STAT,1932,70,na,2002,4509.010722215926
STAT,1890,41,na,1931,3273.872647424946
SIM,1956,20,35-39,1976,14
STAT,1859,47,20-24,1906,0.010980226812736388
STAT,1838,26,45-49,1864,1.2324787388405682
SIM,1836,37,40-44,1873,5
STAT,1861,52,50-100,1913,0.014412550924718492
SIM,1831,39,na,1870,1675
STAT,1859,38,30-34,1897,4.875204420021289
STAT,1971,29,40-44,2000,6.835559150572456
STAT,1921,27,40-44,1948,5.992768857625352
SIM,1882,74,na,1956,1768
SIM,1899,28,25-29,1927,141
STAT,1998,15,45-49,2013,0.846903271725376
STAT,1827,35,na,1862,2328.703694344305
STAT,1950,38,15-19,1988,0.026969126088164083
STAT,1849,89,na,1938,81.42364613139212
STAT,1941,28,20-24,1969,21.786977248521097
SIM,1993,17,25-29,2010,173
STAT,1841,61,na,1902,1661.3854864261693
STAT,1905,32,30-34,1937,16.745599835638476
STAT,1878,70,na,1948,1690.6420636909265
STAT,1834,37,15-19,1871,0.06374314595227798
SIM,1951,19,40-44,1970,1
SIM,1944,34,25-29,1978,16
SIM,1935,24,30-34,1959,56
STAT,1786,79,na,1865,464.703881810888
SIM,1985,20,na,2005,6423
STAT,1785,94,na,1879,2.844411234487076
STAT,1981,15,50-100,1996,0.6049081580190784
SIM,1919,92,na,2011,575
SIM,1938,7,na,1945,4203
SIM,1960,29,35-39,1989,1
STAT,1919,20,15-19,1939,6.7654412207441395
SIM,1878,48,35-39,1926,1
STAT,1826,46,20-24,1872,0.008747799985320662
SIM,1846,26,45-49,1872,1
STAT,1869,36,25-29,1905,3.2333022109166687
SIM,1955,54,na,2009,6209
STAT,1828,37,40-44,1865,4.50533817201109
STAT,1927,24,30-34,1951,40.6009200662674
STAT,1869,27,35-39,1896,10.78372261588083
SIM,1893,37,na,1930,3363
STAT,1826,94,na,1920,11.004445372057381
SIM,1883,15,na,1898,2705
STAT,1869,99,na,1968,12.037796832349096
STAT,1847,23,na,1870,2002.3637013978177
STAT,1988,26,40-44,2014,7.7299780762580586
STAT,1945,10,na,1955,4953.391120314121
STAT,1879,31,15-19,1910,0.17230521791980985
SIM,1885,24,50-100,1909,1
SIM,1934,39,35-39,1973,3
STAT,1811,95,na,1906,6.8457872948987655
STAT,1926,39,35-39,1965,3.4034328168491497
SIM,1833,27,20-24,1860,1
STAT,1837,46,30-34,1883,0.07370150051828799
SIM,1828,33,25-29,1861,3
STAT,1915,21,35-39,1936,11.268414979477196
STAT,1848,38,20-24,1886,0.8353263937644084
SIM,1989,8,na,1997,6751
SIM,1856,38,20-24,1894,2
STAT,1874,110,na,1984,0.02081732068040934
STAT,1877,24,50-100,1901,0.48646538385977206
SIM,1923,30,na,1953,5419
STAT,1813,76,na,1889,435.13001474339205
STAT,1946,22,25-29,1968,118.62223574907703
STAT,1972,8,na,1980,5807.160664852984
STAT,1843,42,na,1885,2387.72825012653
STAT,1860,27,15-19,1887,0.4265141757211033
SIM,1854,23,25-29,1877,160
SIM,1877,36,25-29,1913,8
STAT,1851,17,20-24,1868,17.092725164843767
SIM,1896,33,na,1929,3780
STAT,1964,24,na,1988,5321.876967201919
STAT,1903,33,50-100,1936,0.8611552351987743
STAT,1949,49,30-34,1998,0.12372336858308153
STAT,1935,22,15-19,1957,8.370036482324986
STAT,1927,18,45-49,1945,0.7147654311481918
STAT,1830,106,na,1936,0.0076166869260394995
SIM,1845,46,30-34,1891,1
STAT,1875,49,20-24,1924,0.014012339754755857
STAT,1830,38,35-39,1868,7.040694648318562
STAT,1952,29,35-39,1981,20.832404132204502
STAT,1859,48,25-29,1907,0.05228660785782262
STAT,1948,21,50-100,1969,0.8721555556097922
STAT,1858,26,20-24,1884,10.890116328862325
STAT,1852,36,20-24,1888,0.7383371815534093
SIM,1883,22,40-44,1905,4
STAT,1926,33,50-100,1959,1.1527914505227868
SIM,1956,21,50-100,1977,2
SIM,1966,26,25-29,1992,197
SIM,1913,32,30-34,1945,24
SIM,1902,25,30-34,1927,53
STAT,1988,27,45-49,2015,2.863820268469387
STAT,1884,26,15-19,1910,0.5190964673325511
STAT,1876,109,na,1985,0.05676438645540475
STAT,1977,26,30-34,2003,61.38891924843522
SIM,1822,36,35-39,1858,10
SIM,1844,34,20-24,1878,6
SIM,1835,25,30-34,1860,4
SIM,1892,26,15-19,1918,3
STAT,1837,47,35-39,1884,0.10523614941067215
SIM,1903,37,40-44,1940,2
STAT,1936,34,25-29,1970,10.353237684775008
STAT,1843,19,50-100,1862,0.06208208703474855
SIM,1814,80,na,1894,274
STAT,1904,20,20-24,1924,114.88450844408847
STAT,1836,28,35-39,1864,11.285032969143536
STAT,1951,17,25-29,1968,59.552866718994366
STAT,1958,26,25-29,1984,100.24245523246685
STAT,1959,38,35-39,1997,3.7579254070246244
SIM,1924,15,na,1939,5283
SIM,1925,29,40-44,1954,1
SIM,1808,95,na,1903,4
SIM,1976,21,15-19,1997,8
STAT,1917,29,40-44,1946,5.600943007092168
STAT,1859,39,35-39,1898,6.4367285857241034
SIM,1866,26,20-24,1892,25
STAT,1856,60,na,1916,1679.174967519313
SIM,1844,28,35-39,1872,21
SIM,1945,46,35-39,1991,1
SIM,1876,24,15-19,1900,11
SIM,1912,20,20-24,1932,243
STAT,1934,58,na,1992,5606.259730744433
STAT,1987,15,35-39,2002,6.9168082331724525
STAT,1828,34,35-39,1862,10.964848072002052
SIM,1892,19,25-29,1911,8
STAT,1826,30,na,1856,1657.34570639168
SIM,1853,33,25-29,1886,16
STAT,2009,3,na,2012,7139.398603189828
SIM,1859,29,35-39,1888,15
SIM,1997,0,na,1997,6626
STAT,1919,27,na,1946,4670.113220700889
SIM,1939,8,na,1947,5064
SIM,1958,52,na,2010,5921
STAT,1864,50,25-29,1914,0.0037022870432657155
STAT,1986,29,35-39,2015,24.770353303996554
STAT,1915,26,50-100,1941,1.1758602912720715
SIM,1876,36,30-34,1912,14
STAT,1908,20,40-44,1928,3.593150023394152
SIM,1963,20,25-29,1983,162
STAT,1966,21,40-44,1987,4.864208109429018
SIM,1966,41,45-49,2007,1
STAT,1854,39,35-39,1893,5.704292919916441
STAT,1868,36,30-34,1904,5.937704908813748
STAT,1892,38,15-19,1930,0.08082101590722675
SIM,1832,41,40-44,1873,4
STAT,1854,31,25-29,1885,8.63458879537925
STAT,1807,105,na,1912,0.014337925722988736
STAT,1916,82,na,1998,1908.4670561232672
STAT,1894,33,20-24,1927,3.993171021073119
STAT,1845,33,25-29,1878,8.121769237821615
SIM,1827,36,35-39,1863,13
SIM,1852,3,na,1855,2724
STAT,1893,60,na,1953,2782.03834625338
SIM,1846,15,na,1861,1968
SIM,1952,42,50-100,1994,2
SIM,1823,43,40-44,1866,3
SIM,1882,53,na,1935,2931
SIM,1969,40,30-34,2009,1
STAT,1875,28,15-19,1903,0.5391789558373178
STAT,1861,27,30-34,1888,24.335221885419468
STAT,1940,47,30-34,1987,0.10868531147464908
SIM,1882,35,45-49,1917,6
STAT,1884,19,25-29,1903,6.426671949659506
STAT,1874,35,45-49,1909,2.3775669744469923
SIM,1928,32,25-29,1960,33
STAT,1832,36,50-100,1868,1.090550838714312
STAT,1955,20,25-29,1975,142.07675948311922
SIM,1916,20,40-44,1936,4
SIM,1945,0,na,1945,5121
STAT,1824,41,40-44,1865,3.255174927252876
STAT,1848,47,50-100,1895,0.2597402103332467
STAT,1887,52,na,1939,2769.9926316561405
STAT,1859,45,20-24,1904,0.01114163785055859
STAT,1871,46,30-34,1917,0.11145417543289206
STAT,1940,12,na,1952,4625.2494816053995
STAT,1880,44,30-34,1924,1.3873388906064261
STAT,1815,43,40-44,1858,4.873457715195191
STAT,1966,49,50-100,2015,0.33712362845554317
STAT,1883,33,45-49,1916,1.9606272744233977
SIM,1841,16,15-19,1857,8
STAT,1969,41,20-24,2010,0.026496744883565654
SIM,1961,20,50-100,1981,2
SIM,1819,37,na,1856,1387
SIM,1977,17,25-29,1994,153
SIM,1818,38,35-39,1856,19
STAT,1931,49,30-34,1980,0.13678253340192545
STAT,1828,49,35-39,1877,0.12557662885703155
STAT,1890,40,25-29,1930,0.9146556145651078
STAT,1981,27,35-39,2008,24.33231816523541
SIM,1852,23,na,1875,2254
STAT,1856,101,na,1957,0.7118436377417752
STAT,1906,48,50-100,1954,0.23021356799389836
STAT,1831,26,35-39,1857,10.131390713109438
STAT,1929,30,25-29,1959,13.564687264968518
SIM,1892,83,na,1975,1307
STAT,1896,25,50-100,1921,0.9816894403144173
STAT,1969,17,25-29,1986,62.47323515013631
SIM,1974,21,40-44,1995,9
SIM,1896,97,na,1993,140
STAT,1886,32,30-34,1918,21.253908629615406
STAT,1879,33,50-100,1912,1.0994339169394065
SIM,1900,38,40-44,1938,2
STAT,1965,44,40-44,2009,0.37326238774324394
SIM,1917,76,na,1993,2971
STAT,1815,44,50-100,1859,2.2206669399612546
STAT,1889,28,15-19,1917,0.6431514005872048
SIM,1853,26,35-39,1879,23
STAT,1856,29,15-19,1885,0.40801141135186436
SIM,1836,34,35-39,1870,4
STAT,1870,102,na,1972,3.55850133528899
STAT,1859,13,na,1872,2535.9035895522857
STAT,1967,46,15-19,2013,5.537257679013725E-4
STAT,1835,37,30-34,1872,4.11300953226707
SIM,1872,43,35-39,1915,6
SIM,1831,61,na,1892,1243
STAT,1813,48,35-39,1861,0.4570291238169988
STAT,1850,31,40-44,1881,4.718973193078911
STAT,1950,39,40-44,1989,2.1000110633512805
STAT,1788,105,na,1893,0.01330831710563913
STAT,1835,19,30-34,1854,2.2307052867352457
STAT,1877,19,35-39,1896,0.6551626585857769
STAT,1952,13,na,1965,5431.587058610825
STAT,1956,27,na,1983,5745.378209055364
SIM,1836,49,35-39,1885,1
STAT,1853,15,30-34,1868,1.9316087397448134
SIM,1949,40,45-49,1989,1
SIM,1894,54,na,1948,3400
SIM,1962,26,50-100,1988,3
STAT,1875,46,15-19,1921,4.7839216439738385E-4
SIM,1986,17,35-39,2003,8
STAT,1857,22,na,1879,2218.575370041038
SIM,1911,71,na,1982,3753
STAT,1919,16,30-34,1935,3.1256170032412394
SIM,1919,16,25-29,1935,78
SIM,1844,24,na,1868,2582
STAT,1981,28,na,2009,6068.432661401703
STAT,1831,44,35-39,1875,1.6915862154548846
SIM,1868,27,35-39,1895,26
STAT,1864,43,35-39,1907,1.8524586893003905
STAT,1828,41,25-29,1869,0.6277233563755898
SIM,1799,63,na,1862,733
STAT,1897,48,45-49,1945,0.2028464074655362
SIM,1984,11,na,1995,6303
SIM,1858,16,na,1874,3080
STAT,1839,19,15-19,1858,6.084335538597597
STAT,2001,14,na,2015,6784.595094403867
STAT,1881,42,25-29,1923,0.7139236417280278
STAT,1852,78,na,1930,736.6509694831891
STAT,1995,2,na,1997,6573.934102579313
SIM,1859,44,30-34,1903,3
STAT,1885,28,30-34,1913,28.885083339709585
STAT,1887,47,50-100,1934,0.31615927698099067
SIM,1816,40,45-49,1856,1
SIM,1903,84,na,1987,1288
STAT,1850,5,na,1855,3163.2202
SIM,1976,19,30-34,1995,25
STAT,1853,27,50-100,1880,0.7378084955309107
SIM,1880,62,na,1942,2512
STAT,1831,51,25-29,1882,0.002945035086435532
STAT,1844,35,30-34,1879,5.28516297490682
STAT,1913,20,20-24,1933,125.1546834296904
STAT,1892,31,45-49,1923,2.5326321110482355
SIM,1976,23,15-19,1999,15
STAT,1904,81,na,1985,1722.2104981114796
SIM,1949,22,45-49,1971,2
SIM,1903,32,na,1935,3940
SIM,1843,37,30-34,1880,14
SIM,1907,46,na,1953,4324
SIM,1922,67,na,1989,3873
SIM,1977,37,35-39,2014,11
SIM,1942,47,50-100,1989,1
STAT,1977,17,30-34,1994,19.0059466522086
STAT,1814,52,35-39,1866,0.02288493285224739
STAT,1961,45,50-100,2006,0.35242532203348126
SIM,1847,19,15-19,1866,12
STAT,1868,18,na,1886,2834.2198154429207
STAT,1846,54,25-29,1900,0.003560976018562077
STAT,1844,53,50-100,1897,0.012429456499228098
STAT,1950,42,na,1992,5266.652369959011
SIM,1865,43,45-49,1908,8
SIM,1937,30,25-29,1967,4
STAT,1943,2,na,1945,4962.461263003736
SIM,1877,34,25-29,1911,26
SIM,1894,32,30-34,1926,48
STAT,1857,43,45-49,1900,1.3354787755499562
STAT,1858,42,50-100,1900,0.9499378715529131
STAT,1845,21,na,1866,1801.5805501352188
SIM,1921,20,20-24,1941,9
STAT,1870,25,30-34,1895,28.844427813530057
STAT,1978,32,30-34,2010,25.29336622513604
SIM,1846,23,40-44,1869,8
SIM,1979,20,na,1999,6047
SIM,1893,28,30-34,1921,79
STAT,1838,23,40-44,1861,2.3254483080798636
SIM,1895,16,na,1911,3915
STAT,1894,26,30-34,1920,37.48653945200187
STAT,1841,36,45-49,1877,2.1100196618082228
STAT,1855,52,25-29,1907,0.002997838531382906
STAT,1869,38,50-100,1907,1.3653297236861928
STAT,1889,17,50-100,1906,0.06969434109118279
STAT,1951,53,na,2004,5139.675404408506
SIM,1868,42,30-34,1910,3
STAT,1866,41,45-49,1907,1.608142618710738
STAT,1835,86,na,1921,138.2852012932197
STAT,1851,27,15-19,1878,0.4212568012530165
STAT,1858,36,15-19,1894,0.05079849048228967
SIM,1862,31,25-29,1893,20
STAT,1805,49,50-100,1854,0.8973743316869268
STAT,1831,72,na,1903,990.8257643254202
SIM,1863,70,na,1933,1576
STAT,1967,30,45-49,1997,2.3148638633053684
STAT,1819,36,35-39,1855,22.704802394186025
STAT,1866,48,15-19,1914,4.2248825663565923E-4
STAT,1809,47,30-34,1856,0.2485001370452029
STAT,1984,31,45-49,2015,2.630554127900495
SIM,1852,35,30-34,1887,11
STAT,1822,52,50-100,1874,0.027472968577609964
STAT,1924,49,40-44,1973,0.21528569596748928
STAT,1968,19,30-34,1987,17.557338252707485
STAT,1805,54,35-39,1859,0.02952366505964492
STAT,1910,22,50-100,1932,0.7138467078838024
STAT,1890,33,35-39,1923,14.220117145942089
STAT,1815,46,45-49,1861,0.4889810818644856
STAT,1978,15,25-29,1993,68.28777753456141
SIM,1932,49,40-44,1981,1
STAT,1869,34,25-29,1903,11.34921319346664
STAT,1880,26,30-34,1906,30.909247824479642
STAT,1917,48,50-100,1965,0.2718882381812255
STAT,1901,21,na,1922,3834.602400486079
SIM,1867,38,30-34,1905,21
STAT,1885,35,20-24,1920,0.8957583856410991
SIM,1875,71,na,1946,1768
SIM,1882,32,40-44,1914,13
SIM,1803,97,na,1900,1
STAT,1896,13,na,1909,3930.381215061868
STAT,1896,24,40-44,1920,3.1564365277596225
SIM,1969,20,20-24,1989,168
SIM,1827,43,25-29,1870,4
STAT,1969,37,35-39,2006,3.5924038824400117
STAT,1905,35,na,1940,4003.9615686878037
STAT,1865,27,15-19,1892,0.47242052414485286
STAT,1854,24,35-39,1878,5.506030448833131
STAT,1830,55,na,1885,1320.9434159340283
SIM,1862,24,35-39,1886,16
STAT,1988,24,40-44,2012,5.564266008573879
STAT,1958,48,15-19,2006,5.791566111462295E-4
STAT,1960,21,45-49,1981,1.697370724285
STAT,1947,68,na,2015,4086.194581590501
STAT,1840,42,35-39,1882,1.5153127713881624
STAT,1844,17,30-34,1861,1.6946603165647556
SIM,1852,17,30-34,1869,4
SIM,1856,80,na,1936,572
STAT,1855,45,35-39,1900,0.12031300500300762
STAT,1819,43,25-29,1862,1.309127834807737
SIM,1866,29,25-29,1895,47
SIM,1940,32,na,1972,4958
STAT,1934,48,na,1982,5893.439953602258
STAT,1864,46,40-44,1910,0.17691246313851647
SIM,1982,9,na,1991,6829
STAT,1874,32,40-44,1906,5.1236017260974425
STAT,1928,21,20-24,1949,160.69944123615633
STAT,1945,31,na,1976,4862.832716926658
STAT,1919,79,na,1998,2492.897674822451
STAT,1899,40,45-49,1939,0.16597832858037379
STAT,1964,5,na,1969,5714.950357034968
STAT,1964,14,na,1978,5707.52519378316
STAT,1868,39,35-39,1907,7.763297821097569
STAT,1968,28,na,1996,5420.487575263295
STAT,1800,89,na,1889,52.56558418329914
STAT,1862,31,30-34,1893,17.074076150969645
STAT,1868,40,15-19,1908,0.015466394492054066
STAT,1830,53,30-34,1883,0.0047341089174064875
STAT,1935,24,15-19,1959,8.364345824256215
SIM,1859,26,30-34,1885,31
SIM,1876,89,na,1965,177
SIM,1858,38,30-34,1896,17
SIM,1880,37,35-39,1917,20
SIM,1828,93,na,1921,37
SIM,1910,66,na,1976,2743
STAT,1825,32,45-49,1857,3.652335642179655
STAT,1854,36,30-34,1890,4.362889180916517
STAT,1828,101,na,1929,0.37872254536927796
STAT,1858,29,25-29,1887,38.42795594529829
STAT,1762,98,na,1860,0.7368903307735175
STAT,1842,19,20-24,1861,17.31306592083162
STAT,1897,109,na,2006,0.11872203289129803
STAT,1894,36,25-29,1930,4.291960377695322
SIM,1830,43,30-34,1873,1
STAT,1865,44,50-100,1909,1.085188508369634
SIM,1852,42,20-24,1894,2
STAT,1986,26,30-34,2012,64.73917199016499
STAT,1891,21,50-100,1912,0.5833948922897791
STAT,1919,41,20-24,1960,0.022113024608678988
SIM,1950,56,na,2006,4427
SIM,1968,25,30-34,1993,119
SIM,1978,32,25-29,2010,2
STAT,1822,50,20-24,1872,0.001396825192980933
STAT,1941,45,25-29,1986,0.06591126075765613
SIM,1850,19,20-24,1869,18
SIM,1931,73,na,2004,4073
SIM,1936,21,20-24,1957,6
SIM,1927,23,20-24,1950,165
STAT,1994,18,30-34,2012,20.292056529796497
STAT,1835,44,20-24,1879,0.11574962920046994
STAT,1989,24,na,2013,6052.209658179323
STAT,1844,42,20-24,1886,0.13604501084601425
SIM,1947,11,na,1958,6081
SIM,1862,36,30-34,1898,17
SIM,1939,21,45-49,1960,4
SIM,1839,29,50-100,1868,1
SIM,1883,18,20-24,1901,17
SIM,1860,10,na,1870,2978
STAT,1803,77,na,1880,358.8686078779242
STAT,1828,39,40-44,1867,4.323544735864634
STAT,1897,45,40-44,1942,0.15050775059515342
STAT,1947,22,na,1969,4762.870101976527
SIM,1844,32,20-24,1876,3
SIM,1823,62,na,1885,1506
STAT,1898,48,na,1946,3465.5855057076606
STAT,1883,30,40-44,1913,4.935912335130067
STAT,1925,89,na,2014,991.8639972607373
STAT,1919,23,20-24,1942,140.04932420611615
SIM,1919,47,na,1966,5276
SIM,1811,61,na,1872,1401
SIM,1862,39,35-39,1901,21
SIM,1990,21,na,2011,5917
SIM,1815,75,na,1890,598
STAT,1831,105,na,1936,0.023004033162052025
SIM,1976,28,30-34,2004,74
STAT,1945,31,20-24,1976,3.136190081046625
SIM,1864,24,na,1888,2643
STAT,1818,52,20-24,1870,8.765098628878516E-4
SIM,1923,29,na,1952,5213
STAT,1988,21,35-39,2009,15.597870476857365
STAT,1968,23,15-19,1991,7.695724932989785
SIM,1889,63,na,1952,2844
STAT,1850,12,na,1862,3003.0649912525705
STAT,1978,35,35-39,2013,3.931475631934061
SIM,1836,39,40-44,1875,4
STAT,1828,46,30-34,1874,0.09031523627480441
STAT,1818,45,30-34,1863,0.12295587522624801
STAT,1828,31,30-34,1859,20.81738692396293
STAT,1900,35,na,1935,3808.587715983462
STAT,1904,49,na,1953,3651.3102635131563
STAT,1813,45,30-34,1858,0.33152862690444995
SIM,1844,41,30-34,1885,1
SIM,1905,11,na,1916,4563
STAT,1990,19,50-100,2009,0.6187822297675959
STAT,1792,64,na,1856,1238.1381730399999
STAT,1881,26,50-100,1907,0.7145038170556716
STAT,1821,37,30-34,1858,11.858828501246625
STAT,1852,33,15-19,1885,0.13757818643199388
STAT,1890,36,40-44,1926,6.202515190335406
STAT,1894,34,na,1928,3509.8763374152004
STAT,1915,65,na,1980,3724.760793734803
SIM,1999,7,na,2006,6974
STAT,1807,52,45-49,1859,0.05699792967721416
STAT,1893,42,15-19,1935,0.020119853092948118
SIM,1836,31,30-34,1867,40
SIM,1891,30,40-44,1921,9
STAT,1836,41,30-34,1877,1.2611820775092313
SIM,1876,39,35-39,1915,5
STAT,1786,80,na,1866,422.6807097787294
STAT,1877,41,20-24,1918,0.19150892722335475
STAT,1968,46,30-34,2014,0.1339874468675794
STAT,1975,33,45-49,2008,2.440499691164364
STAT,1770,85,na,1855,38.84640000000001
SIM,1906,29,na,1935,3625
STAT,1841,33,40-44,1874,4.629828414619425
STAT,1976,26,15-19,2002,1.093635812486908
STAT,1855,49,50-100,1904,0.20461660308262486
STAT,1839,17,50-100,1856,0.05082536607391578
STAT,1854,29,40-44,1883,2.521808421764129
STAT,1845,26,35-39,1871,7.971301016691716
SIM,1836,41,25-29,1877,2
SIM,1898,68,na,1966,3022
SIM,1936,59,na,1995,3729
SIM,1835,75,na,1910,886
STAT,1971,21,20-24,1992,163.1202975048387
STAT,1922,47,na,1969,4868.523525389589
STAT,1887,38,35-39,1925,9.10220015080138
SIM,1863,42,30-34,1905,1
SIM,1895,38,35-39,1933,26
SIM,1978,21,25-29,1999,285
SIM,1865,41,na,1906,2816
STAT,1853,18,35-39,1871,0.6532989213237477
SIM,1865,40,40-44,1905,4
STAT,1927,43,50-100,1970,0.1697278248725255
SIM,1862,29,40-44,1891,4
STAT,1774,99,na,1873,0.014554846756625786
STAT,1861,34,20-24,1895,2.5711309930960344
SIM,1861,18,35-39,1879,2
SIM,1978,25,35-39,2003,27
STAT,1863,52,30-34,1915,0.0059748010169726855
STAT,1871,23,25-29,1894,65.52210511887294
STAT,1903,64,na,1967,3171.1452975521697
SIM,1956,22,35-39,1978,1
STAT,1880,54,25-29,1934,0.004213588838353659
STAT,1952,19,50-100,1971,0.5177906122200903
STAT,1851,22,45-49,1873,0.6603569013852215
STAT,1887,30,25-29,1917,13.353477130539613
SIM,1918,22,15-19,1940,2
STAT,1811,50,45-49,1861,0.044960734199718314
SIM,1940,25,50-100,1965,3
STAT,1868,18,30-34,1886,1.7886305821680386
STAT,1834,69,na,1903,1339.280962775451
STAT,1880,42,na,1922,2823.7230340748274
STAT,1914,16,50-100,1930,0.0897015499889031
SIM,1880,44,25-29,1924,2
SIM,1841,42,45-49,1883,2
SIM,1829,67,na,1896,946
SIM,1940,3,na,1943,5183
SIM,1877,31,20-24,1908,7
STAT,1908,18,50-100,1926,0.0837565298262092
STAT,1877,49,30-34,1926,0.11377683728803534
SIM,1845,41,na,1886,2106
STAT,1837,35,40-44,1872,3.94036016068404
STAT,1872,44,25-29,1916,0.734088589306856
SIM,1968,36,30-34,2004,4
STAT,1864,99,na,1963,6.252908045511578
SIM,1830,44,na,1874,1782
SIM,1834,58,na,1892,1417
SIM,1862,21,30-34,1883,1
SIM,1895,30,25-29,1925,34
SIM,1984,19,25-29,2003,170
STAT,1894,29,35-39,1923,14.21225475122408
STAT,2012,2,na,2014,7232.658173588425
STAT,1873,41,35-39,1914,2.1436816249130715
STAT,1879,65,na,1944,2036.4367369960714
STAT,1871,16,35-39,1887,0.6378128424245462
STAT,1875,51,na,1926,2580.1441472353404
STAT,1851,17,na,1868,2213.119828369315
STAT,1833,49,15-19,1882,2.944588791025116E-4
STAT,1826,43,15-19,1869,0.010198030483758046
SIM,1889,44,45-49,1933,4
SIM,1901,41,na,1942,4042
STAT,1917,21,45-49,1938,1.3842684779894945
SIM,1877,42,na,1919,3076
STAT,1833,42,45-49,1875,1.2852458569379819
SIM,1961,6,na,1967,5671
STAT,1865,50,40-44,1915,0.01111950720215091
STAT,1862,33,na,1895,2314.297949703439
STAT,1975,34,50-100,2009,1.281437301369552
STAT,1948,22,35-39,1970,12.476425960313543
SIM,1831,29,na,1860,1825
SIM,1885,34,30-34,1919,29
STAT,1863,25,40-44,1888,3.066734176686539
STAT,1805,105,na,1910,0.012049263450760276
STAT,1880,47,35-39,1927,0.17045537957165036
STAT,1854,21,30-34,1875,17.17394455869547
STAT,1877,34,30-34,1911,20.77998285238628
STAT,1903,20,50-100,1923,0.6743160685656663
STAT,1933,30,na,1963,5891.213544855853
SIM,1856,42,40-44,1898,2
SIM,1991,17,15-19,2008,74
STAT,1863,18,na,1881,2630.882666454349
SIM,1881,41,35-39,1922,2
STAT,1975,32,na,2007,5869.327455470218
STAT,1880,29,35-39,1909,11.718609150697803
STAT,1947,22,40-44,1969,4.38536673326015
STAT,1880,21,25-29,1901,70.23660497627074
SIM,1847,76,na,1923,1301
STAT,1902,20,45-49,1922,1.1438565103520344
STAT,1900,36,25-29,1936,0.9999513084595779
STAT,1872,37,35-39,1909,8.196117005104409
SIM,1843,62,na,1905,1453
SIM,1871,25,40-44,1896,6
STAT,1948,34,50-100,1982,1.1115875481269497
SIM,1948,31,40-44,1979,11
STAT,1848,42,40-44,1890,2.386975519906831
STAT,1983,17,15-19,2000,74.09038963096087
STAT,1895,47,30-34,1942,0.08164217838739227
SIM,1955,22,40-44,1977,9
SIM,1939,24,na,1963,4988
STAT,1870,30,50-100,1900,1.050813965840582
STAT,1869,39,30-34,1908,5.8964321029169255
STAT,1884,47,20-24,1931,0.01361886312594493
SIM,1840,32,35-39,1872,15
STAT,1944,42,50-100,1986,0.15163302299460163
SIM,1859,34,50-100,1893,1
SIM,1819,45,40-44,1864,1
SIM,1923,26,50-100,1949,3
SIM,1929,13,na,1942,5459
STAT,1837,101,na,1938,0.4132045898526867
STAT,1829,37,35-39,1866,8.116950249885665
STAT,1904,18,na,1922,4174.516992467609
SIM,1877,24,30-34,1901,5
STAT,1961,41,15-19,2002,0.002382973465328506
SIM,1846,59,na,1905,1163
SIM,1928,86,na,2014,1862
STAT,1867,48,30-34,1915,0.10299033577931217
STAT,1769,105,na,1874,0.029765613719861778
STAT,1844,45,25-29,1889,0.048937705681327305
STAT,1828,73,na,1901,788.3107469255565
SIM,1863,27,35-39,1890,15
SIM,1886,22,30-34,1908,1
SIM,1929,32,40-44,1961,9
STAT,1823,41,25-29,1864,0.6874234370753268
STAT,1895,15,50-100,1910,0.0739371410915116
SIM,1826,48,35-39,1874,1
STAT,1878,22,30-34,1900,21.463009585234317
SIM,1877,39,30-34,1916,12
STAT,1884,21,45-49,1905,0.7975011698710849
STAT,1941,42,20-24,1983,0.02182175042227459
SIM,1911,48,45-49,1959,1
STAT,1789,77,na,1866,275.27829611694875
SIM,1968,28,35-39,1996,50
STAT,1880,19,40-44,1899,0.22253472075013542
STAT,1954,32,25-29,1986,13.44095660314239
SIM,1854,33,40-44,1887,14
STAT,1818,48,35-39,1866,0.17034160457977285
STAT,1863,94,na,1957,26.431562128705046
STAT,1895,40,25-29,1935,0.9743767401460497
SIM,1820,42,50-100,1862,4
SIM,1914,48,50-100,1962,1
SIM,1959,22,25-29,1981,160
STAT,1903,87,na,1990,924.0665654707401
SIM,1828,43,40-44,1871,6
STAT,1878,37,30-34,1915,6.421904379490976
SIM,1880,34,30-34,1914,37
STAT,1872,34,30-34,1906,20.05913766554753
STAT,1869,31,20-24,1900,3.03330647357769
STAT,1881,32,30-34,1913,19.434919546544023
STAT,1900,29,35-39,1929,15.340932399165064
STAT,1893,38,30-34,1931,7.735793121647805
STAT,1821,42,na,1863,1679.02536039372
SIM,1864,40,25-29,1904,1
STAT,1880,73,na,1953,1452.9080312670505
STAT,1876,36,na,1912,2824.1586625852633
SIM,1993,18,na,2011,6497
SIM,1857,44,50-100,1901,2
STAT,1872,41,20-24,1913,0.18486559698548802
SIM,1983,19,na,2002,6988
STAT,1897,38,15-19,1935,0.0862241995502161
SIM,1845,35,40-44,1880,10
STAT,1956,20,40-44,1976,5.155095882056168
STAT,1869,50,25-29,1919,0.0040154695420460485
STAT,1823,34,35-39,1857,22.929567618023157
STAT,1873,47,45-49,1920,0.27682697860568434
STAT,1860,39,30-34,1899,4.907195541610045
SIM,1857,28,20-24,1885,2
STAT,1922,21,25-29,1943,122.55991962742999
SIM,1831,41,25-29,1872,2
STAT,1977,32,15-19,2009,0.20424865501096218
SIM,1930,21,25-29,1951,154
STAT,1894,86,na,1980,881.8159565307205
STAT,1855,27,35-39,1882,8.557795724551989
STAT,1890,72,na,1962,2024.4979643227202
SIM,1814,42,35-39,1856,9
STAT,1944,18,30-34,1962,15.133481861464013
STAT,1879,53,25-29,1932,0.004199661996045954
STAT,1849,28,20-24,1877,10.701123476270444
STAT,1872,53,35-39,1925,0.009816018244172466
STAT,1956,22,50-100,1978,1.0081291297684898
STAT,1840,45,40-44,1885,0.1420878343725911
STAT,1899,29,15-19,1928,0.7122087392161981
STAT,1779,78,na,1857,256.60361019284505
STAT,1948,8,na,1956,5190.387712713829
STAT,1942,29,40-44,1971,5.640992333443192
STAT,1975,30,40-44,2005,6.079919465693748
SIM,1790,82,na,1872,96
STAT,1857,40,40-44,1897,2.042072553431678
SIM,1820,45,na,1865,1929
SIM,1870,31,30-34,1901,7
SIM,1831,34,35-39,1865,6
SIM,1954,45,na,1999,5414
SIM,1890,30,25-29,1920,20
STAT,1848,18,na,1866,3005.6575783111825
SIM,1851,17,15-19,1868,13
SIM,1987,20,30-34,2007,57
STAT,1860,43,15-19,1903,0.012751855179507915
SIM,1918,87,na,2005,1173
SIM,1924,39,40-44,1963,2
STAT,1863,73,na,1936,1198.573276776728
SIM,1895,71,na,1966,2120
SIM,1851,37,na,1888,2735
SIM,1933,50,na,1983,6256
STAT,1847,54,40-44,1901,0.007877786055983943
STAT,1899,47,15-19,1946,3.5507870889589076E-4
STAT,1815,55,na,1870,1470.8530441904666
STAT,1881,17,35-39,1898,0.6107841157057224
STAT,1924,49,na,1973,5016.498790167196
SIM,1896,26,35-39,1922,38
STAT,1843,17,15-19,1860,7.6095886259725
STAT,1866,47,na,1913,2395.349340117369
STAT,1871,20,20-24,1891,79.59232758695391
STAT,1920,35,na,1955,4759.916423077626
SIM,1948,34,45-49,1982,7
STAT,1835,51,45-49,1886,0.009414128161202946
SIM,1864,88,na,1952,128
STAT,1868,46,25-29,1914,0.06404633929982298
STAT,1894,42,30-34,1936,0.11829301045618884
SIM,1964,11,na,1975,5973
STAT,1882,30,25-29,1912,11.638422554898286
SIM,1978,22,30-34,2000,102
SIM,1840,28,15-19,1868,1
STAT,1916,39,40-44,1955,1.751526589792363
STAT,1979,35,30-34,2014,2.988797341152118
SIM,1918,5,na,1923,4363
STAT,1852,15,15-19,1867,6.847578035535635
STAT,1877,44,25-29,1921,0.7604687974263692
SIM,1885,44,25-29,1929,3
SIM,1959,37,25-29,1996,2
STAT,1871,28,30-34,1899,28.810232756917422
SIM,1970,35,25-29,2005,1
STAT,1831,26,50-100,1857,0.6716780587354707
STAT,1973,35,35-39,2008,3.7257263268144523
SIM,1886,37,30-34,1923,4
STAT,1832,28,15-19,1860,0.4244164336482392
SIM,1976,26,na,2002,5751
STAT,1859,57,na,1916,1847.4632473648082
SIM,1903,15,30-34,1918,6
STAT,1877,16,30-34,1893,1.9180517102249428
SIM,1968,20,25-29,1988,152
STAT,1914,48,20-24,1962,0.01261927995478616
STAT,1829,52,30-34,1881,0.005336438211268452
STAT,1867,87,na,1954,189.8327557466779
STAT,1872,26,45-49,1898,1.2910370546206966
STAT,1888,44,35-39,1932,2.42334578428274
STAT,1982,33,35-39,2015,15.117402126231124
SIM,1828,41,na,1869,2309
STAT,1857,36,20-24,1893,0.696181922053462
SIM,1892,21,45-49,1913,4
SIM,1955,45,35-39,2000,1
STAT,1828,96,na,1924,5.698959597318662
STAT,1846,33,40-44,1879,5.243319016736401
SIM,1896,44,35-39,1940,1
STAT,1921,30,20-24,1951,3.1565707556673686
SIM,1877,38,50-100,1915,2
SIM,1941,72,na,2013,2927
STAT,1979,28,40-44,2007,7.434754257627491
SIM,1979,35,45-49,2014,2
STAT,1843,35,15-19,1878,0.0671574250512376
SIM,1820,34,25-29,1854,16
STAT,1776,81,na,1857,283.218855377398
STAT,1814,60,na,1874,1514.6113595521929
STAT,1959,48,30-34,2007,0.13958642949041208
SIM,1924,23,50-100,1947,2
SIM,1938,30,40-44,1968,9
STAT,1846,39,na,1885,2491.1405631978973
STAT,1843,73,na,1916,1191.7684092449172
STAT,1847,87,na,1934,135.563070752777
SIM,1889,41,40-44,1930,6
SIM,1990,15,35-39,2005,15
STAT,1822,43,30-34,1865,2.2871571493048
STAT,1940,38,20-24,1978,0.31800738450500504
SIM,1813,49,50-100,1862,2
STAT,1951,27,na,1978,5170.352796816846
STAT,1893,45,20-24,1938,0.009972505410899755
SIM,1937,12,na,1949,4478
SIM,1864,55,na,1919,2383
STAT,1815,78,na,1893,433.5471711159399
SIM,1878,16,na,1894,3025
STAT,1875,18,20-24,1893,21.087570747389247
SIM,1980,22,na,2002,5980
SIM,1860,41,na,1901,2340
STAT,1907,20,45-49,1927,1.1910990035093136
SIM,1894,9,na,1903,4153
STAT,1868,52,30-34,1920,0.006564859009321539
STAT,1976,21,20-24,1997,172.06341000847962
STAT,1877,37,35-39,1914,8.490652672210592
STAT,1979,15,40-44,1994,2.223711569508193
SIM,1830,25,30-34,1855,55
SIM,1938,30,50-100,1968,2
SIM,1904,31,25-29,1935,18
SIM,1971,32,35-39,2003,40
SIM,1885,37,35-39,1922,20
STAT,1832,32,35-39,1864,9.197151114529076
STAT,1856,91,na,1947,51.02011348312713
STAT,1824,44,45-49,1868,2.0595791125937057
STAT,1984,24,20-24,2008,182.733033640146
SIM,1887,72,na,1959,2366
SIM,1851,43,50-100,1894,1
STAT,1868,50,45-49,1918,0.01632212777693932
STAT,1843,43,50-100,1886,1.0775205492266995
SIM,1853,30,20-24,1883,8
STAT,1908,23,45-49,1931,1.191579381667787
STAT,1855,42,30-34,1897,0.9770431918146955
STAT,1838,49,15-19,1887,3.4750881326706747E-4
SIM,1851,92,na,1943,10
SIM,1835,39,25-29,1874,1
STAT,1934,31,45-49,1965,2.482094967086512
STAT,1895,36,40-44,1931,6.607499517442878
STAT,1817,45,15-19,1862,0.0011751443141080034
STAT,1978,29,na,2007,5919.707111177546
SIM,1802,57,na,1859,1122
STAT,1871,49,35-39,1920,0.15738161092454908
STAT,1993,18,15-19,2011,75.32993412528671
STAT,1834,30,45-49,1864,2.0812283556560187
STAT,1814,93,na,1907,18.22257348908879
SIM,1890,23,35-39,1913,9
STAT,1882,23,35-39,1905,6.5575151412601755
STAT,1877,86,na,1963,478.31095686521076
STAT,1888,19,45-49,1907,0.08813962760051457
STAT,1809,54,20-24,1863,0.0017112954612200156
STAT,1872,102,na,1974,4.29197686137077
STAT,1881,35,35-39,1916,7.947846267106338
STAT,1850,105,na,1955,0.03018404867358885
SIM,1861,36,na,1897,1857
SIM,1944,60,na,2004,4227
STAT,1894,18,50-100,1912,0.07249094751880247
STAT,1956,23,45-49,1979,1.7233318589723108
STAT,1923,49,25-29,1972,0.07116707719373969
SIM,1899,39,50-100,1938,2
STAT,1816,39,15-19,1855,0.17356866841178475
STAT,1860,21,na,1881,2284.029556983415
STAT,1875,20,na,1895,2837.375114848548
STAT,1872,50,30-34,1922,0.0069969521686597345
SIM,1842,30,45-49,1872,2
STAT,1827,31,15-19,1858,0.25918727745009207
STAT,1848,73,na,1921,1262.0201081958096
SIM,1832,23,na,1855,2417
SIM,1834,89,na,1923,108
STAT,1880,21,na,1901,2901.7592786202536
STAT,1874,51,45-49,1925,0.017227686897787853
SIM,1854,36,45-49,1890,1
STAT,1839,37,15-19,1876,0.053217925275561496
SIM,1830,75,na,1905,677
STAT,1864,35,na,1899,2450.75296057968
SIM,1959,27,30-34,1986,148
STAT,1845,30,20-24,1875,2.211182134222232
STAT,1961,52,na,2013,5601.6887753888195
STAT,1979,30,25-29,2009,14.987100557724014
SIM,1853,38,30-34,1891,13
STAT,1827,39,25-29,1866,3.987782110136757
STAT,1969,44,25-29,2013,0.10662876703704637
SIM,1863,24,30-34,1887,22
SIM,1938,38,na,1976,4064
STAT,1956,30,35-39,1986,14.240731551275958
SIM,1934,24,na,1958,5495
STAT,1850,34,45-49,1884,1.8393310198832955
SIM,1878,34,40-44,1912,12
SIM,1831,31,30-34,1862,44
SIM,1853,4,na,1857,3005
SIM,1881,44,40-44,1925,1
SIM,1948,37,na,1985,4395
STAT,1855,24,30-34,1879,17.453075624148628
STAT,1860,20,45-49,1880,0.745388764537838
SIM,1874,54,na,1928,2368
SIM,1878,68,na,1946,1783
STAT,1908,41,45-49,1949,0.1789511593571083
STAT,1932,13,na,1945,6046.9589234781215
STAT,1936,27,na,1963,4139.873441159253
STAT,1854,69,na,1923,1195.6031692742963
SIM,1970,32,20-24,2002,3
STAT,1846,36,45-49,1882,2.174549423124032
STAT,1948,18,15-19,1966,59.917269780540714
STAT,1888,26,35-39,1914,13.134410908574726
STAT,1865,21,na,1886,2510.582446598976
STAT,1965,33,50-100,1998,1.2134769973018908
SIM,1942,31,45-49,1973,1
SIM,1964,30,35-39,1994,37
SIM,1876,50,45-49,1926,1
STAT,1873,44,40-44,1917,2.6149686210254486
STAT,1966,24,45-49,1990,1.6261052853479383
STAT,1823,31,30-34,1854,53.55198203614335
STAT,1831,41,na,1872,2036.6730849596827
STAT,1835,55,na,1890,1288.7105854346644
STAT,1849,38,15-19,1887,0.04407611092747378
STAT,1870,28,35-39,1898,10.93917734886773
SIM,1773,82,na,1855,20
STAT,1842,47,15-19,1889,3.0786126776323957E-4
STAT,1878,25,35-39,1903,11.705408166840801
SIM,1937,20,50-100,1957,6
STAT,1871,8,na,1879,3118.2444623694055
SIM,1898,42,45-49,1940,3
SIM,1855,40,na,1895,1840
STAT,1883,39,na,1922,2633.342766175705
STAT,1992,15,15-19,2007,75.21664323178506
STAT,1929,20,50-100,1949,0.9660447417086568
SIM,1886,25,35-39,1911,27
STAT,1982,29,15-19,2011,1.1502287831660511
SIM,1881,36,na,1917,1955
STAT,1936,17,50-100,1953,0.41419564154626165
STAT,1775,85,na,1860,112.41747532872847
SIM,1974,24,45-49,1998,4
SIM,1844,88,na,1932,78
STAT,1902,47,na,1949,3652.2288625504943
STAT,1879,50,20-24,1929,9.019850675958713E-4
STAT,1899,19,20-24,1918,27.87973739390847
STAT,1923,64,na,1987,4390.669738225439
STAT,1979,23,35-39,2002,15.006208350331665
STAT,1921,15,25-29,1936,57.24944268983866
STAT,1926,75,na,2001,3468.000770253511
STAT,1979,25,na,2004,5983.49741153935
SIM,1977,34,30-34,2011,50
SIM,1929,3,na,1932,5632
STAT,1878,32,25-29,1910,12.341883028309548
SIM,1837,31,50-100,1868,1
STAT,1872,23,40-44,1895,2.407260787719131
STAT,1891,17,15-19,1908,8.464557656640974
STAT,1901,24,25-29,1925,91.9572482009942
SIM,1950,31,na,1981,4658
SIM,1886,32,25-29,1918,4
SIM,1847,55,na,1902,2174
SIM,1903,18,35-39,1921,1
STAT,1953,30,na,1983,5388.071118903392
STAT,1861,41,45-49,1902,1.4423844481491244
SIM,1853,23,30-34,1876,2
SIM,1983,30,40-44,2013,2
STAT,1845,23,30-34,1868,14.793830993653007
STAT,1842,29,15-19,1871,0.4255805272428202
SIM,1806,54,45-49,1860,1
STAT,1834,49,30-34,1883,0.09131503825415965
STAT,1829,31,50-100,1860,1.234740445827546
SIM,1969,23,25-29,1992,145
STAT,1883,26,20-24,1909,13.291347564736641
STAT,1969,34,30-34,2003,23.12210855099409
STAT,1963,4,na,1967,5765.868037072856
SIM,1787,85,na,1872,286
SIM,1830,28,35-39,1858,15
SIM,1987,23,35-39,2010,42
STAT,1868,43,20-24,1911,0.17481473682921642
STAT,1805,89,na,1894,43.171507215204194
STAT,1942,33,50-100,1975,1.015942912955697
SIM,1952,18,30-34,1970,41
STAT,1928,42,25-29,1970,0.10505526141979615
STAT,1845,38,30-34,1883,3.734431992904735
SIM,1980,21,25-29,2001,285
STAT,1944,71,na,2015,3620.5339399595414
SIM,1817,89,na,1906,24
STAT,1996,17,na,2013,6173.273317658645
SIM,1951,16,na,1967,5637
STAT,1836,47,40-44,1883,0.16311087355820883
STAT,1930,42,45-49,1972,0.25274536055803287
STAT,1895,82,na,1977,1350.0759644848413
STAT,1983,21,35-39,2004,15.427814232379424
SIM,1938,33,45-49,1971,2
SIM,1903,5,na,1908,4306
STAT,1910,91,na,2001,537.8984640403014
SIM,1861,29,25-29,1890,4
SIM,1877,83,na,1960,767
STAT,1832,26,na,1858,1957.92928193186
SIM,1913,87,na,2000,1831
STAT,1893,48,25-29,1941,0.04679998459594413
STAT,1894,40,45-49,1934,2.2427282524679093
STAT,1886,8,na,1894,3164.4566142197614
STAT,1928,23,50-100,1951,0.945148743841983
SIM,1916,50,na,1966,4314
SIM,1828,46,45-49,1874,1
STAT,1903,48,45-49,1951,0.21607607595029782
STAT,1823,50,35-39,1873,0.008525628891252033
SIM,1893,68,na,1961,2137
SIM,1936,24,25-29,1960,4
SIM,1962,32,25-29,1994,20
STAT,1936,9,na,1945,4401.001437772874
SIM,1926,20,20-24,1946,178
STAT,1951,39,50-100,1990,0.593166804210442
SIM,1915,10,na,1925,5022
SIM,1919,24,na,1943,5498
SIM,1992,17,30-34,2009,31
STAT,1884,35,na,1919,2711.84705637263
STAT,1973,32,30-34,2005,23.969666675102868
STAT,1928,17,35-39,1945,6.101629922317443
STAT,1822,53,25-29,1875,0.0063162299113958655
STAT,1984,17,30-34,2001,19.97821909061562
SIM,2001,11,na,2012,7316
SIM,1827,33,30-34,1860,5
STAT,1794,99,na,1893,0.47400714307297165
STAT,1853,29,25-29,1882,43.76327821965398
SIM,1920,32,na,1952,4255
STAT,1819,40,20-24,1859,0.3564956142553208
STAT,1790,85,na,1875,91.55422514224287
SIM,1981,32,30-34,2013,4
STAT,1959,25,15-19,1984,1.0712278150651993
STAT,1849,58,na,1907,1532.7729593568242
SIM,1926,28,30-34,1954,108
STAT,1822,46,35-39,1868,0.2684194552129885
STAT,1921,33,25-29,1954,11.815629784511257
SIM,1837,37,35-39,1874,25
STAT,1819,48,30-34,1867,0.18370116283234011
STAT,1928,24,25-29,1952,132.25804450653567
STAT,1853,21,15-19,1874,3.908924971550701
STAT,1876,34,15-19,1910,0.16843481880368116
STAT,1918,20,20-24,1938,139.19675267920834
SIM,1839,40,50-100,1879,4
STAT,1844,38,35-39,1882,6.186955985432015
SIM,1979,32,40-44,2011,4
SIM,1852,38,35-39,1890,8
STAT,1918,28,30-34,1946,47.94290319524552
SIM,1861,21,15-19,1882,4
STAT,1835,53,30-34,1888,0.003711428504064351
STAT,1838,37,50-100,1875,1.2834976687322315
SIM,1878,27,30-34,1905,40
STAT,1905,47,15-19,1952,3.751230058463915E-4
STAT,1851,24,50-100,1875,0.38064809594498217
SIM,1865,36,20-24,1901,1
STAT,1859,34,na,1893,2174.965008101205
SIM,1910,36,50-100,1946,2
STAT,1930,31,25-29,1961,13.775210577477583
SIM,1980,32,50-100,2012,2
SIM,1880,41,na,1921,3263
STAT,1820,44,25-29,1864,0.7391388256096348
SIM,1982,0,na,1982,6839
STAT,1927,21,25-29,1948,131.7027938087516
SIM,1890,20,30-34,1910,42
STAT,1907,42,20-24,1949,0.01870272440988608
STAT,1860,46,20-24,1906,0.011192993272212634
STAT,1945,66,na,2011,4126.565716253219
STAT,1880,29,50-100,1909,0.7769054484529583
SIM,1905,31,40-44,1936,10
SIM,1941,32,20-24,1973,1
SIM,1951,47,na,1998,6218
STAT,1899,27,50-100,1926,1.0113987224708865
STAT,1914,80,na,1994,2139.814044207796
STAT,1876,91,na,1967,208.9399860853826
SIM,1930,32,45-49,1962,6
STAT,1865,31,35-39,1896,10.587961972370522
STAT,1997,18,35-39,2015,7.069005848980376
SIM,1859,54,na,1913,1889
SIM,1871,18,30-34,1889,4
STAT,1834,32,50-100,1866,1.0710511826412468
STAT,1854,43,40-44,1897,1.8192408275201848
STAT,1913,34,45-49,1947,1.792242369627735
STAT,1845,45,40-44,1890,0.1165140892371329
STAT,1863,18,30-34,1881,1.6603077748860693
STAT,1904,50,na,1954,3619.6475770364304
SIM,1903,63,na,1966,3044
SIM,1887,25,30-34,1912,4
STAT,1879,25,30-34,1904,30.550532794366244
STAT,1957,43,15-19,2000,0.0024244873319497298
STAT,1864,39,15-19,1903,0.05728161982121618
STAT,1922,32,45-49,1954,2.0509405633506987
SIM,1878,37,na,1915,2801
STAT,1828,42,na,1870,1756.9496672222824
STAT,1882,20,30-34,1902,20.19807114820432
STAT,1873,37,15-19,1910,0.0661775812067935
SIM,1921,34,45-49,1955,1
STAT,1875,50,35-39,1925,0.010414667435459355
STAT,1945,45,45-49,1990,0.2863324238948539
SIM,1971,35,40-44,2006,6
STAT,1929,42,40-44,1971,0.373836000895645
STAT,1952,44,na,1996,5320.00921494083
SIM,1920,55,na,1975,3947
SIM,1907,18,20-24,1925,62
SIM,1949,18,25-29,1967,91
SIM,1894,85,na,1979,1070
STAT,1953,44,25-29,1997,0.10325800538609124
STAT,1960,24,50-100,1984,0.9916122931780527
SIM,1988,19,45-49,2007,2
STAT,1822,32,40-44,1854,18.751952464299556
SIM,1850,11,na,1861,2254
STAT,1855,102,na,1957,0.35864091503230766
STAT,1845,50,50-100,1895,0.010323310526339209
STAT,1889,64,na,1953,2472.9352573708597
SIM,1878,47,na,1925,2676
SIM,1934,45,na,1979,5710
SIM,1830,32,40-44,1862,2
STAT,1956,38,30-34,1994,2.8644905083340255
SIM,1944,69,na,2013,3895
STAT,1811,46,25-29,1857,0.18260174665759388
STAT,1925,36,50-100,1961,0.5818879386620365
STAT,1940,35,15-19,1975,0.023229695231838925
SIM,1906,37,30-34,1943,3
STAT,1911,103,na,2014,8.963950272285599
STAT,1923,43,15-19,1966,0.0020673635697440545
SIM,1867,5,na,1872,2869
SIM,1946,26,50-100,1972,3
SIM,1859,0,na,1859,3590
STAT,1865,7,na,1872,2918.461276035978
SIM,1941,27,na,1968,3684
SIM,1870,41,25-29,1911,2
STAT,1862,41,25-29,1903,0.6282474142741439
SIM,1935,21,25-29,1956,6
SIM,1838,25,35-39,1863,12
SIM,1899,19,15-19,1918,20
SIM,1848,17,na,1865,2231
STAT,1842,46,50-100,1888,0.19146431796467683
SIM,1896,66,na,1962,2888
STAT,1780,109,na,1889,0.004595099211390202
STAT,1933,53,na,1986,5708.839144474116
SIM,1953,45,45-49,1998,1
STAT,1894,45,35-39,1939,0.11832556292077094
STAT,1954,25,na,1979,5372.278972134085
STAT,1870,45,50-100,1915,0.2822108079481365
SIM,1829,26,na,1855,2055
STAT,1964,49,na,2013,5521.7749474970515
STAT,1964,30,40-44,1994,5.804569830114164
SIM,1846,36,na,1882,1660
SIM,1895,39,na,1934,3515
STAT,1885,47,35-39,1932,0.16040398245643395
SIM,1828,72,na,1900,1104
STAT,1968,30,25-29,1998,13.595253093276366
SIM,1916,16,20-24,1932,68
SIM,1919,78,na,1997,2849
STAT,1792,97,na,1889,1.490114380897401
STAT,1939,58,na,1997,4189.211314887384
STAT,1916,61,na,1977,4006.315780365438
SIM,1896,56,na,1952,3261
STAT,1881,68,na,1949,1701.0811624951245
STAT,1946,16,40-44,1962,1.7908369684387468
STAT,1878,44,40-44,1922,2.67369377148424
SIM,1849,18,20-24,1867,36
SIM,1979,25,30-34,2004,4
STAT,1960,48,35-39,2008,0.201012122470577
STAT,1852,52,20-24,1904,6.920166327819383E-4
STAT,1974,35,15-19,2009,0.029864972472640947
STAT,1810,48,30-34,1858,0.36861936966973463
STAT,1961,47,25-29,2008,0.08226630325319789
STAT,1839,41,35-39,1880,1.6846877145480383
STAT,1964,39,na,2003,5621.838990724704
SIM,1847,41,35-39,1888,4
SIM,1954,16,40-44,1970,3
SIM,1886,44,40-44,1930,1
STAT,1808,104,na,1912,0.03400962601372521
STAT,1942,41,45-49,1983,0.2089295707944051
STAT,1959,32,25-29,1991,14.222072893239133
SIM,1848,72,na,1920,817
STAT,1828,53,40-44,1881,0.00835353593649765
STAT,1921,52,na,1973,4697.3515729580895
SIM,1953,28,na,1981,5445
STAT,1912,93,na,2005,362.74775205937055
STAT,1938,40,40-44,1978,0.2968805223847185
SIM,1963,23,50-100,1986,3
STAT,1840,38,15-19,1878,0.052729523677987375
STAT,1970,45,25-29,2015,0.08008300496803279
SIM,1975,32,20-24,2007,6
STAT,1845,44,na,1889,1545.8484808149663
STAT,1826,61,na,1887,1070.4342207495315
STAT,1890,29,15-19,1919,0.6352025238340353
SIM,1965,19,20-24,1984,185
SIM,1919,28,40-44,1947,10
SIM,1966,34,20-24,2000,1
STAT,1820,37,35-39,1857,15.520794728777313
STAT,1943,22,20-24,1965,136.54103191831638
STAT,1880,40,50-100,1920,1.3053352421783684
SIM,1967,32,25-29,1999,15
SIM,1858,19,25-29,1877,17
STAT,1923,21,40-44,1944,4.526876328821763
SIM,1931,21,40-44,1952,6
SIM,1981,24,45-49,2005,5
STAT,1889,47,20-24,1936,0.009584478204078576
SIM,1862,22,na,1884,3109
STAT,1957,19,20-24,1976,206.14893914351305
SIM,1951,22,20-24,1973,298
STAT,1937,18,40-44,1955,1.5670675723474623
STAT,1869,46,40-44,1915,0.191877776909064
SIM,1924,6,na,1930,5408
STAT,1792,87,na,1879,87.24429260063059
STAT,1904,41,25-29,1945,0.07423426086781436
SIM,1879,64,na,1943,1995
SIM,1981,8,na,1989,6472
STAT,1922,8,na,1930,5324.578167337324
STAT,1993,22,20-24,2015,185.2367456561775
SIM,1848,15,35-39,1863,1
STAT,1933,32,20-24,1965,3.795132304942512
SIM,1975,31,na,2006,6092
STAT,1903,42,35-39,1945,0.20644495284734474
STAT,1863,37,50-100,1900,1.2389276984031325
STAT,1988,24,50-100,2012,1.088897536867973
STAT,1900,6,na,1906,4183.313155289383
SIM,1903,53,na,1956,3281
STAT,1914,45,15-19,1959,4.238002410495044E-4
STAT,1911,47,50-100,1958,0.24732057413420022
STAT,1877,108,na,1985,0.1358179068621428
STAT,1772,97,na,1869,0.11859333387829206
SIM,1821,34,40-44,1855,1
STAT,1908,16,20-24,1924,30.46295398875437
STAT,1892,20,na,1912,3441.2984781247123
STAT,1828,34,15-19,1862,0.15418863732776142
STAT,1918,28,50-100,1946,1.2178870766935603
STAT,1970,38,35-39,2008,3.5962504959922703
SIM,1894,20,15-19,1914,10
SIM,1911,42,35-39,1953,2
STAT,1905,14,na,1919,4299.657800450551
STAT,1916,51,na,1967,4293.640806877262
STAT,1954,43,45-49,1997,0.24636576645496922
STAT,1886,20,15-19,1906,4.0399001048691465
STAT,1971,27,na,1998,5499.284184777209
SIM,1894,31,na,1925,3898
STAT,1877,53,na,1930,2543.258143527795
STAT,1910,48,35-39,1958,0.13857958127877967
STAT,1993,20,na,2013,6087.648738716961
SIM,1915,20,45-49,1935,1
STAT,1838,19,35-39,1857,0.6205578983780509
STAT,1862,77,na,1939,841.8595272158382
STAT,1869,23,50-100,1892,0.45434168266805436
SIM,1828,62,na,1890,1595
STAT,1936,44,40-44,1980,0.2850699401220873
STAT,1904,19,40-44,1923,0.3014849397829705
STAT,1794,78,na,1872,409.4652626059137
SIM,1862,24,15-19,1886,6
SIM,1941,35,25-29,1976,2
STAT,1870,35,25-29,1905,3.3068422956288126
STAT,1907,45,50-100,1952,0.23758066265207547
SIM,1875,40,na,1915,3127
SIM,1828,36,30-34,1864,12
STAT,1883,49,na,1932,2487.238798944726
STAT,1826,71,na,1897,734.9486299167154
SIM,1925,32,20-24,1957,6
STAT,1887,0,na,1887,4072.133102706621
STAT,1965,21,45-49,1986,1.6269973502326884
SIM,1873,44,50-100,1917,4
STAT,1801,65,na,1866,920.4379142877195
STAT,1823,46,15-19,1869,4.007930653042757E-4
SIM,1944,44,40-44,1988,1
STAT,1845,48,45-49,1893,0.15703154374052788
SIM,1832,77,na,1909,500
STAT,1903,33,na,1936,3939.2360288820823
STAT,1775,95,na,1870,3.3556543111705404
SIM,1921,31,40-44,1952,5
STAT,1921,41,40-44,1962,0.32546755015739426
STAT,1852,45,30-34,1897,0.09217420665082307
STAT,1910,30,45-49,1940,1.7668933374147096
STAT,1856,33,50-100,1889,0.8081492079754301
SIM,1836,27,25-29,1863,74
SIM,1936,26,na,1962,4014
STAT,1843,54,20-24,1897,7.20053362129987E-4
STAT,1933,35,25-29,1968,1.551065629690547
STAT,1966,26,na,1992,5425.576278599743
SIM,1940,22,45-49,1962,4
STAT,1824,105,na,1929,0.018142200372085072
STAT,2000,15,40-44,2015,2.401820687058311
STAT,1911,43,25-29,1954,0.07825006725476555
SIM,1949,13,na,1962,5902
STAT,1860,11,na,1871,2572.5006604869745
STAT,1817,51,50-100,1868,0.042325042606603
STAT,1880,33,40-44,1913,5.28246398747072
STAT,1845,85,na,1930,184.72683110559117
STAT,1943,47,35-39,1990,0.16413311710866382
STAT,1828,27,25-29,1855,68.63920499055658
SIM,1880,23,40-44,1903,3
SIM,1933,28,na,1961,5973
STAT,1859,54,30-34,1913,0.005321724720490493
STAT,1822,35,45-49,1857,5.262100333185686
STAT,1811,43,20-24,1854,0.5940618529341721
STAT,1952,45,35-39,1997,0.18633815476067045
STAT,1852,48,35-39,1900,0.13033537302533627
STAT,1903,45,40-44,1948,0.1603238852245003
STAT,1913,31,40-44,1944,4.513994462351252
SIM,1949,15,20-24,1964,208
STAT,1788,82,na,1870,249.07529321392013
STAT,1876,16,15-19,1892,7.097181676149728
STAT,1846,61,na,1907,1931.7620025585647
SIM,1921,27,na,1948,5029
SIM,1851,47,30-34,1898,1
SIM,1958,31,20-24,1989,11
SIM,1876,66,na,1942,2036
SIM,1813,63,na,1876,1157
SIM,1911,45,40-44,1956,1
STAT,1891,21,35-39,1912,8.348379931544628
STAT,1879,98,na,1977,37.22039555576234
STAT,1843,47,30-34,1890,0.09667446521464737
STAT,1983,29,30-34,2012,64.18029677717874
SIM,1928,29,45-49,1957,3
STAT,1830,41,15-19,1871,0.013461732337615618
SIM,1883,38,na,1921,2448
STAT,1854,24,15-19,1878,3.1127733344928474
SIM,1830,35,45-49,1865,2
STAT,1875,10,na,1885,3145.118132630515
STAT,1953,41,20-24,1994,0.025659126537124186
STAT,1917,32,20-24,1949,2.9477274056121665
STAT,1894,65,na,1959,2623.2540336322486
SIM,1971,19,50-100,1990,5
SIM,1841,35,20-24,1876,2
SIM,1884,49,35-39,1933,1
STAT,1836,51,25-29,1887,0.00332799915075426
STAT,1833,43,na,1876,1769.5503560449565
STAT,1876,49,35-39,1925,0.16352985139778003
STAT,1906,32,45-49,1938,1.6850633783122033
STAT,1888,44,50-100,1932,1.4138108820101793
STAT,1863,40,15-19,1903,0.014076255013064712
STAT,1963,19,50-100,1982,0.5489378246544131
SIM,1914,32,45-49,1946,5
STAT,1833,35,20-24,1868,0.6981913558655597
STAT,1911,36,35-39,1947,2.7113653821595944
SIM,1931,39,30-34,1970,1
STAT,1981,31,40-44,2012,6.440761078571011
SIM,1890,45,45-49,1935,1
STAT,1878,47,45-49,1925,0.2830437667686321
STAT,1854,17,25-29,1871,5.522634659890081
STAT,1946,19,45-49,1965,0.6389770624014806
STAT,1841,52,45-49,1893,0.012834155954994417
SIM,1828,29,40-44,1857,9
SIM,1895,19,30-34,1914,4
SIM,1873,31,35-39,1904,17
STAT,1841,26,15-19,1867,0.504643807566926
STAT,1971,33,25-29,2004,13.762152240117436
STAT,1846,26,30-34,1872,31.720762229539886
SIM,1916,19,25-29,1935,61
STAT,1901,21,20-24,1922,111.73217068685804
SIM,1845,19,na,1864,2503
SIM,1947,42,na,1989,5952
STAT,1900,48,40-44,1948,0.1527014946533226
SIM,1935,43,50-100,1978,2
SIM,1980,28,50-100,2008,5
SIM,1862,17,25-29,1879,14
STAT,1888,41,30-34,1929,1.566667590055635
STAT,1957,46,20-24,2003,0.01753365385572008
STAT,1961,42,na,2003,5754.727755954377
STAT,1982,30,30-34,2012,26.10904413412625
SIM,1862,43,40-44,1905,12
STAT,1828,52,na,1880,1531.3152104470378
STAT,1901,47,30-34,1948,0.08785373260615768
STAT,1885,44,30-34,1929,1.3055304187476224
SIM,1909,31,25-29,1940,23
STAT,1919,48,na,1967,4584.699809661462
STAT,1923,39,30-34,1962,2.431018695577042
STAT,1947,41,45-49,1988,0.22516443462380864
STAT,1960,45,30-34,2005,0.14002894980919284
SIM,1845,10,na,1855,2570
STAT,1882,45,45-49,1927,0.2686748726999984
STAT,1965,37,15-19,2002,0.028504257403054387
SIM,1815,44,na,1859,1958
SIM,1901,72,na,1973,2574
SIM,1870,34,35-39,1904,25
SIM,1846,16,30-34,1862,1
SIM,1939,29,20-24,1968,27
STAT,1961,44,20-24,2005,0.027273682440843314
SIM,1978,28,na,2006,5543
STAT,1850,76,na,1926,975.3009405153587
STAT,1804,51,15-19,1855,1.1551904600642346E-4
SIM,1776,79,na,1855,356
STAT,1803,52,25-29,1855,0.012851814469016946
STAT,1898,30,35-39,1928,15.921947961734759
SIM,1893,14,na,1907,3781
STAT,1887,19,30-34,1906,2.0503332317018916
STAT,1922,33,40-44,1955,5.078966004524401
STAT,1931,76,na,2007,3600.416233974899
STAT,1939,31,45-49,1970,1.854716124499486
STAT,1866,16,na,1882,2789.3453250533125
SIM,1854,26,30-34,1880,47
STAT,1947,37,50-100,1984,0.5623021060688749
STAT,1879,18,40-44,1897,0.21982418620033983
STAT,1906,31,na,1937,4066.564473768984
STAT,1844,80,na,1924,517.4079307164565
STAT,1908,19,25-29,1927,9.661199010272119
STAT,1938,46,15-19,1984,4.3748948653939064E-4
STAT,1895,29,30-34,1924,37.5576835666143
SIM,1887,28,35-39,1915,2
STAT,1838,16,30-34,1854,1.8348033662689982
STAT,1979,18,45-49,1997,0.793507645405022
STAT,1923,46,20-24,1969,0.01495096994244458
SIM,1864,15,35-39,1879,1
STAT,1953,16,50-100,1969,0.5231866482343347
STAT,1872,16,30-34,1888,1.8640339964376746
SIM,1921,19,50-100,1940,1
SIM,1975,35,25-29,2010,2
STAT,1882,3,na,1885,3371.37309135716
SIM,1973,21,45-49,1994,6
STAT,1932,22,45-49,1954,1.7041638278254578
SIM,1884,1,na,1885,3619
STAT,1954,40,40-44,1994,0.37187436200016194
STAT,1873,32,50-100,1905,1.0797860864096036
STAT,1879,34,na,1913,2850.9305606977086
STAT,1969,29,40-44,1998,6.741854643629954
STAT,1879,28,35-39,1907,11.586213410106536
STAT,1924,37,50-100,1961,0.5711934038061253
SIM,1916,71,na,1987,3226
STAT,1917,40,50-100,1957,0.1418829410438009
STAT,1833,33,50-100,1866,0.8289462837118096
STAT,1856,15,35-39,1871,0.5780359125825756
SIM,1881,32,50-100,1913,1
SIM,1858,92,na,1950,37
STAT,1907,45,25-29,1952,0.055719242965064184
STAT,1894,48,40-44,1942,0.14146679526622633
STAT,1931,37,15-19,1968,0.029356529536416848
STAT,1913,19,50-100,1932,0.08797400925760149
STAT,1967,35,25-29,2002,1.4648430710571567
STAT,1955,32,40-44,1987,6.1111194296549
STAT,1918,32,na,1950,4637.071898618766
STAT,1871,38,45-49,1909,2.2774223224818804
STAT,1878,17,na,1895,3043.2431476847396
SIM,1965,39,30-34,2004,3
STAT,1979,5,na,1984,6247.563505712693
SIM,1963,32,40-44,1995,3
STAT,1846,19,40-44,1865,0.23473525806483522
STAT,1864,90,na,1954,81.2405982453461
STAT,1902,36,50-100,1938,0.434192109789243
SIM,1828,39,35-39,1867,17
STAT,1943,44,30-34,1987,0.1620685895841209
STAT,1879,108,na,1987,0.14959814872375762
STAT,1911,40,20-24,1951,0.019689671565807365
SIM,1911,20,25-29,1931,2
STAT,1830,30,25-29,1860,11.527796905475265
SIM,1927,26,25-29,1953,6
STAT,1847,56,na,1903,1569.4052696182614
STAT,1912,46,45-49,1958,0.24187921037925847
STAT,1829,68,na,1897,1119.5259210814916
STAT,1870,32,20-24,1902,3.075335313192302
STAT,1932,44,20-24,1976,0.027537517084038673
SIM,1886,18,25-29,1904,11
SIM,1960,23,25-29,1983,281
STAT,1818,50,50-100,1868,0.018667574564971118
SIM,1801,85,na,1886,125
SIM,1850,75,na,1925,168
STAT,1922,40,30-34,1962,0.16974222394200783
STAT,1985,6,na,1991,6452.585894786664
STAT,1973,9,na,1982,5865.165240067806
STAT,1915,33,15-19,1948,0.15042763955635977
SIM,1918,62,na,1980,3424
STAT,1859,88,na,1947,126.20545145670462
STAT,1961,21,25-29,1982,138.22356048474293
SIM,1904,43,40-44,1947,1
STAT,1892,84,na,1976,1050.6891446102302
STAT,1929,73,na,2002,3936.6885230398684
STAT,1827,46,35-39,1873,0.17970662847904587
SIM,1887,33,50-100,1920,5
STAT,1847,22,50-100,1869,0.3846589110466043
SIM,1981,13,na,1994,6461
STAT,1903,20,25-29,1923,94.66047981713899
STAT,1827,56,na,1883,1754.1789986335768
STAT,1836,19,na,1855,2770.220030755898
STAT,1878,48,na,1926,2676.8948659697303
STAT,1880,52,na,1932,2619.8222105503187
STAT,1891,36,20-24,1927,1.1047676184953965
STAT,1920,66,na,1986,4012.875446172424
STAT,1897,42,35-39,1939,0.19380496818217144
STAT,1913,88,na,2001,930.43091243887
STAT,1823,53,40-44,1876,0.00982192917416442
STAT,1952,30,15-19,1982,0.1813570490724767
STAT,1921,44,45-49,1965,0.21553069661203186
SIM,1930,33,40-44,1963,16
STAT,1834,28,na,1862,2570.1020270996614
STAT,1900,40,45-49,1940,0.1681078405733374
STAT,1931,31,40-44,1962,5.922389855395356
SIM,1863,38,na,1901,2377
STAT,1886,42,25-29,1928,0.7807425090425971
STAT,1853,43,25-29,1896,0.6347252608505097
STAT,1963,30,25-29,1993,13.828670509699208
STAT,1935,31,25-29,1966,14.773481171413188
SIM,1950,21,na,1971,4789
STAT,1890,30,30-34,1920,24.81820166748889
STAT,1925,80,na,2005,2612.395745309773
STAT,1924,59,na,1983,4745.053062840976
STAT,1952,23,25-29,1975,128.12397522219132
STAT,1883,35,50-100,1918,1.3994001239420402
STAT,1994,15,na,2009,6132.980425890849
STAT,1836,44,35-39,1880,1.9115553204750257
SIM,1831,53,40-44,1884,2
SIM,1816,39,na,1855,1830
STAT,1800,80,na,1880,352.95198746358636
STAT,1813,43,na,1856,1456.6826971326202
STAT,1846,16,na,1862,2998.612954460947
STAT,1953,20,50-100,1973,0.9222700431776615
SIM,1981,21,40-44,2002,10
SIM,1959,34,40-44,1993,1
STAT,1876,46,30-34,1922,0.11580822333138265
SIM,1881,67,na,1948,1166
SIM,1978,17,40-44,1995,5
STAT,1880,36,45-49,1916,2.450251850905168
STAT,1965,31,na,1996,5557.550471480401
SIM,1943,31,25-29,1974,20
SIM,1952,33,na,1985,4637
STAT,1812,46,40-44,1858,0.403587503677707
SIM,1844,44,35-39,1888,5
SIM,1859,23,na,1882,2118
SIM,1859,33,na,1892,2301
SIM,1909,93,na,2002,361
SIM,1861,36,35-39,1897,5
STAT,1930,49,15-19,1979,5.566302462459747E-4
SIM,1933,36,50-100,1969,1
STAT,1893,1,na,1894,3970.4370973577843
STAT,1954,44,40-44,1998,0.3696110938267454
STAT,1853,36,35-39,1889,7.115437398113238
STAT,1841,21,50-100,1862,0.4626160007991243
STAT,1885,32,15-19,1917,0.1639267921855769
STAT,1841,30,35-39,1871,11.153631388620527
STAT,1891,40,40-44,1931,3.2405547460858686
STAT,1906,47,30-34,1953,0.09146184811382935
SIM,1902,67,na,1969,2986
STAT,1883,18,na,1901,2844.171095522372
SIM,1853,48,45-49,1901,2
STAT,1919,26,25-29,1945,82.33595931919334
SIM,1771,91,na,1862,2
SIM,1906,34,50-100,1940,1
STAT,1864,40,30-34,1904,1.1966196542290206
SIM,1917,12,na,1929,5787
SIM,1862,46,45-49,1908,2
SIM,1850,40,45-49,1890,1
STAT,1827,53,25-29,1880,0.004244496639669749
STAT,1901,52,na,1953,3462.1244870026235
STAT,1919,19,35-39,1938,5.321455803404979
STAT,1937,40,25-29,1977,0.08340071722830525
SIM,1909,1,na,1910,5175
SIM,1833,73,na,1906,756
STAT,1900,33,20-24,1933,4.310291911092539
SIM,1966,3,na,1969,5952
STAT,1947,44,15-19,1991,0.0020677473346743538
SIM,1889,7,na,1896,4149
SIM,1983,23,15-19,2006,8
STAT,1834,38,na,1872,2406.1283341516996
STAT,1934,47,50-100,1981,0.36384544999006535
STAT,1838,53,35-39,1891,0.007338905530691424
SIM,1927,19,35-39,1946,15
STAT,1926,40,15-19,1966,0.002190434494650458
SIM,1861,27,50-100,1888,1
SIM,1923,7,na,1930,5711
STAT,1985,18,50-100,2003,0.6147591290699758
SIM,1872,40,30-34,1912,4
STAT,1842,40,45-49,1882,1.2224874905110197
STAT,1911,33,30-34,1944,17.645476420146633
STAT,1945,16,25-29,1961,54.6461912962444
STAT,1958,41,20-24,1999,0.027858833853702674
STAT,1971,30,20-24,2001,3.6382428394220714
SIM,1968,27,na,1995,4920
STAT,1856,52,40-44,1908,0.009219717434938516
STAT,1972,36,45-49,2008,1.0387251855062551
SIM,1953,16,25-29,1969,129
SIM,1829,45,50-100,1874,1
STAT,1872,19,35-39,1891,0.6324354574907189
STAT,1966,44,20-24,2010,0.026366845561846798
SIM,1889,40,50-100,1929,1
STAT,1942,34,20-24,1976,2.995172464831269
STAT,1981,34,45-49,2015,2.5850322907638046
SIM,1835,46,35-39,1881,1
SIM,1929,17,45-49,1946,1
STAT,1915,30,45-49,1945,1.8647044808507292
STAT,1845,16,20-24,1861,15.188741577835826
STAT,1941,23,15-19,1964,6.348002202467267
STAT,1962,47,40-44,2009,0.2424930130927766
STAT,1949,43,20-24,1992,0.024594296470209307
STAT,1847,51,35-39,1898,0.006655972711057373
STAT,1859,42,15-19,1901,0.012679811260002487
STAT,1832,51,40-44,1883,0.007754400049572907
STAT,1878,25,15-19,1903,0.5504003316674956
STAT,1980,21,30-34,2001,46.21330696366681
STAT,1920,31,30-34,1951,19.988551389089196
STAT,1821,44,40-44,1865,4.151602039485343
SIM,1854,29,35-39,1883,17
STAT,1825,47,50-100,1872,0.3429622723079177
SIM,1886,25,15-19,1911,1
STAT,1861,37,na,1898,2260.341514120109
STAT,1900,26,30-34,1926,40.46356314871601
SIM,1926,28,50-100,1954,3
STAT,1920,12,na,1932,5128.042037017187
STAT,1816,95,na,1911,6.565999437312007
STAT,1955,23,50-100,1978,1.0110550309053443
SIM,1918,52,na,1970,3717
SIM,1945,65,na,2010,3888
STAT,1905,41,40-44,1946,0.26207536149684635
SIM,1923,30,45-49,1953,1
SIM,1945,9,na,1954,4787
SIM,1810,47,50-100,1857,1
STAT,1846,29,35-39,1875,11.894488248340549
STAT,1882,42,40-44,1924,2.5322959530967353
STAT,1926,33,25-29,1959,12.886923883403636
STAT,1816,50,45-49,1866,0.029570595616891977
STAT,1958,53,na,2011,5668.882106228173
SIM,1879,33,na,1912,2836
SIM,1934,33,25-29,1967,15
STAT,1851,45,15-19,1896,3.2035998914226125E-4
STAT,1854,46,45-49,1900,0.19281437399099874
STAT,1832,47,20-24,1879,0.009850044694971642
SIM,1945,55,na,2000,4478
STAT,1862,34,35-39,1896,9.778634080575351
SIM,1890,42,40-44,1932,15
STAT,1894,30,15-19,1924,0.21296556419101628
STAT,1870,47,40-44,1917,0.19387031391078016
STAT,1916,44,20-24,1960,0.02081846966136942
STAT,1932,47,25-29,1979,0.08306211440971802
SIM,1928,35,50-100,1963,2
SIM,1878,22,50-100,1900,2
STAT,1926,30,20-24,1956,3.40686236592384
STAT,1927,5,na,1932,5768.213154277878
STAT,1997,15,30-34,2012,20.551242897810276
STAT,1846,71,na,1917,1379.8929798140873
SIM,1959,15,15-19,1974,125
STAT,1960,49,30-34,2009,0.13855605934560566
STAT,1912,43,40-44,1955,0.27699357205142233
SIM,1920,43,40-44,1963,2
SIM,1862,12,na,1874,3156
STAT,1831,41,30-34,1872,1.1160536107127759
STAT,1931,34,45-49,1965,2.3769813579369203
STAT,1941,20,45-49,1961,1.3431599907530518
STAT,1965,41,35-39,2006,0.30193853678499155
STAT,1832,57,na,1889,1374.2674382137286
STAT,1882,23,na,1905,2657.6805783632153
STAT,1877,63,na,1940,2141.9589758030106
STAT,1893,69,na,1962,2354.064692930606
SIM,1845,20,na,1865,2487
STAT,1871,35,40-44,1906,5.073658222410514
STAT,1905,45,na,1950,3796.1301797581536
SIM,1960,20,20-24,1980,2
STAT,1970,35,30-34,2005,2.7172801622184823
SIM,1861,33,30-34,1894,12
SIM,1847,86,na,1933,470
STAT,1976,27,na,2003,5800.7838626606335
STAT,1953,33,35-39,1986,12.996137141133843
STAT,1847,47,15-19,1894,3.0634658861113123E-4
STAT,1860,1,na,1861,3405.340277899406
STAT,1853,40,20-24,1893,0.15971273072492875
STAT,1865,53,45-49,1918,0.014868513679877553
STAT,1852,57,na,1909,1894.7071002960784
STAT,1862,23,na,1885,2341.0321750626867
SIM,1874,41,45-49,1915,4
SIM,1832,46,na,1878,1982
STAT,1952,20,20-24,1972,154.39357655183355
STAT,1818,39,50-100,1857,1.7910003120441014
SIM,1902,44,35-39,1946,1
STAT,1934,25,na,1959,5823.753759146239
STAT,1947,43,na,1990,5009.444415097261
STAT,1877,22,na,1899,2839.110593162348
SIM,1889,84,na,1973,1237
STAT,1964,33,45-49,1997,2.3299734408766866
STAT,1840,41,50-100,1881,0.8954519277474856
STAT,1864,89,na,1953,108.25151668977999
STAT,1853,33,30-34,1886,17.716204063505415
SIM,1815,54,na,1869,1694
STAT,1811,62,na,1873,1138.3655723078061
SIM,1888,16,35-39,1904,2
STAT,1886,35,35-39,1921,8.691715854998042
SIM,1890,92,na,1982,52
SIM,1917,66,na,1983,4282
SIM,1901,31,20-24,1932,2
STAT,1814,48,15-19,1862,0.0010939560000234815
STAT,1786,105,na,1891,0.025533045850196456
STAT,1896,36,na,1932,3608.467812911495
STAT,1945,42,40-44,1987,0.3276932936088154
SIM,1952,43,na,1995,4682
SIM,1849,28,15-19,1877,1
SIM,1974,37,30-34,2011,1
STAT,1894,55,na,1949,3067.534136933488
STAT,1904,59,na,1963,3415.0580931667187
STAT,1919,58,na,1977,4361.29291598979
STAT,1879,88,na,1967,404.0369767848548
STAT,1880,51,20-24,1931,9.069722763331242E-4
STAT,1966,47,25-29,2013,0.07953098806975972
SIM,1813,73,na,1886,588
SIM,1864,78,na,1942,662
SIM,1894,35,35-39,1929,3
STAT,1814,83,na,1897,247.52873373996243
STAT,1881,37,na,1918,2622.5067500574664
SIM,1800,55,na,1855,1460
STAT,1984,7,na,1991,6442.540036095432
SIM,1873,6,na,1879,3753
STAT,1966,37,30-34,2003,2.7065622544273564
STAT,1922,37,na,1959,4938.208789523177
STAT,1962,31,50-100,1993,1.246909566296374
STAT,1917,77,na,1994,2681.7770246120263
STAT,1838,50,30-34,1888,0.005336940673814202
STAT,1867,18,15-19,1885,6.498502199793469
SIM,1979,28,35-39,2007,74
STAT,1953,40,25-29,1993,0.10389029310998288
SIM,1845,28,30-34,1873,50
STAT,1892,46,50-100,1938,0.20095629126183107
SIM,1932,33,na,1965,5509
STAT,1847,17,35-39,1864,0.5269554689488015
STAT,1970,42,20-24,2012,0.026513699288860833
SIM,1823,40,35-39,1863,7
STAT,1881,54,40-44,1935,0.011396378350596717
STAT,1875,41,na,1916,2768.8458874337616
STAT,1872,52,50-100,1924,0.01740793211212192
STAT,1845,75,na,1920,693.7080725125953
STAT,1853,102,na,1955,0.2918905865414391
STAT,1953,39,na,1992,5399.583701417101
STAT,1854,54,30-34,1908,0.0047161653999464445
STAT,1927,43,35-39,1970,0.2909223674212407
STAT,1891,43,45-49,1934,2.119264605526732
STAT,1827,50,20-24,1877,9.385042222355605E-4
STAT,1878,18,25-29,1896,6.810266177963238
STAT,1932,37,30-34,1969,2.82673193293006
STAT,1844,90,na,1934,65.94403373990795
STAT,1964,49,15-19,2013,5.536674999451308E-4
STAT,1820,34,30-34,1854,59.43633244177156
SIM,1980,33,40-44,2013,17
STAT,1949,24,na,1973,4914.188404275101
STAT,1895,51,na,1946,3250.036009974788
STAT,1986,17,50-100,2003,0.6160812725929051
STAT,1835,41,15-19,1876,0.010460212567851358
SIM,1814,58,na,1872,1131
SIM,1901,82,na,1983,1827
SIM,1916,81,na,1997,1789
SIM,1842,19,15-19,1861,15
STAT,1876,53,20-24,1929,8.661877057850792E-4
STAT,1837,28,30-34,1865,23.23646163613438
STAT,1980,31,25-29,2011,15.102369352173753
STAT,1899,109,na,2008,0.12361783290202094
STAT,1832,54,45-49,1886,0.01007281699844738
STAT,1896,17,30-34,1913,2.4295130406522776
SIM,1884,46,30-34,1930,1
SIM,1940,37,30-34,1977,1
SIM,1827,29,25-29,1856,6
SIM,1947,32,na,1979,6018
STAT,1931,41,35-39,1972,0.31096644434460075
SIM,1883,2,na,1885,3101
STAT,1982,22,45-49,2004,1.8332317114741958
STAT,1844,16,50-100,1860,0.05239858582696395
STAT,1951,42,15-19,1993,0.0021931965217588567
STAT,1880,96,na,1976,76.12104310834687
STAT,1938,43,45-49,1981,0.19668254904550508
SIM,1864,34,na,1898,2696
SIM,1990,22,45-49,2012,2
SIM,1832,87,na,1919,160
SIM,1946,43,45-49,1989,1
STAT,1980,24,35-39,2004,15.12465009575971
STAT,1830,76,na,1906,594.3222983695425
STAT,1805,51,30-34,1856,0.02171414997747102
STAT,1920,41,25-29,1961,0.09110848561526536
STAT,1910,45,30-34,1955,0.09653722866542842
SIM,1905,34,na,1939,4228
STAT,1876,27,50-100,1903,0.7631394925548333
SIM,1868,45,35-39,1913,1
SIM,1961,33,35-39,1994,14
STAT,1860,42,na,1902,2147.0574624364153
SIM,1819,38,30-34,1857,2
STAT,1865,46,20-24,1911,0.012530549163550524
STAT,1980,18,50-100,1998,0.600038024732802
SIM,1974,35,na,2009,6318
STAT,1972,33,40-44,2005,5.890442787263256
STAT,1845,19,25-29,1864,4.769630776405255
SIM,1938,38,50-100,1976,1
SIM,1862,53,na,1915,2655
SIM,1903,22,40-44,1925,10
STAT,1914,70,na,1984,3297.3351942150716
SIM,1934,30,20-24,1964,2
STAT,1867,16,50-100,1883,0.05428509837128076
STAT,1815,40,35-39,1855,4.889074208469363
STAT,1821,47,45-49,1868,0.42707415010361804
SIM,1875,18,15-19,1893,10
STAT,1920,34,35-39,1954,11.447807079364527
SIM,1813,51,30-34,1864,1
SIM,1800,99,na,1899,4
SIM,1862,8,na,1870,3199
SIM,1875,16,50-100,1891,1
STAT,1820,41,20-24,1861,0.20244171499410135
SIM,1829,27,35-39,1856,1
SIM,1849,39,50-100,1888,3
SIM,1877,52,na,1929,2894
SIM,1865,19,na,1884,3277
STAT,1905,44,45-49,1949,0.17125298253316742
STAT,1884,44,15-19,1928,0.015533712616106582
STAT,1860,35,50-100,1895,1.152779254861776
SIM,1835,43,30-34,1878,2
STAT,1827,43,30-34,1870,1.5052305482880768
SIM,1918,18,30-34,1936,34
STAT,1861,31,15-19,1892,0.1371852951315967
SIM,1812,80,na,1892,184
STAT,1927,22,30-34,1949,40.85669004685343
SIM,1910,21,50-100,1931,4
STAT,1930,43,40-44,1973,0.3792466759222051
SIM,1907,19,25-29,1926,35
STAT,1839,15,40-44,1854,0.19200321637876516
STAT,1950,31,45-49,1981,2.1899751171008965
STAT,1908,28,35-39,1936,16.34220567204156
STAT,1907,41,15-19,1948,0.0016356964904587178
STAT,1800,108,na,1908,9.883738298346882E-4
STAT,1955,40,35-39,1995,0.3214898504276777
STAT,1776,108,na,1884,0.007416698661041395
STAT,1903,19,45-49,1922,0.10679981094137819
STAT,1893,20,40-44,1913,3.057827108850509
SIM,1852,21,na,1873,1982
STAT,1916,47,25-29,1963,0.06279528047393224
STAT,1887,54,na,1941,2708.2369968587736
STAT,1951,35,25-29,1986,1.3964264302770542
SIM,1950,26,15-19,1976,1
SIM,1841,69,na,1910,1133
STAT,1882,25,50-100,1907,0.7259628376162817
STAT,1906,45,45-49,1951,0.22626341866556365
SIM,1867,28,15-19,1895,1
SIM,1897,20,20-24,1917,2
SIM,1972,29,15-19,2001,1
STAT,1836,62,na,1898,1663.359245445989
STAT,1937,16,50-100,1953,0.42188639646159065
STAT,1943,64,na,2007,4141.801055862585
STAT,1936,28,40-44,1964,5.148449935329325
STAT,1921,34,30-34,1955,20.053308026079026
STAT,1935,69,na,2004,4813.251474597452
SIM,1895,18,na,1913,3930
STAT,1902,21,15-19,1923,5.395722120784701
SIM,1989,20,50-100,2009,1
STAT,1859,28,15-19,1887,0.42124387912566685
SIM,1881,25,50-100,1906,3
SIM,1944,28,40-44,1972,10
SIM,1996,16,na,2012,6922
STAT,1867,22,35-39,1889,6.313564766120132
SIM,1935,22,30-34,1957,61
STAT,1920,36,35-39,1956,3.057677951831578
STAT,1921,45,40-44,1966,0.20600444599386342
STAT,1911,27,25-29,1938,74.14017282570441
SIM,1970,18,40-44,1988,6
STAT,1849,37,na,1886,1868.524931218841
STAT,1911,30,25-29,1941,10.479007248915748
SIM,1900,30,45-49,1930,7
SIM,2000,8,na,2008,6484
STAT,1782,96,na,1878,2.1012545260751327
SIM,1942,18,35-39,1960,9
STAT,1925,45,25-29,1970,0.07450526906286617
SIM,1848,31,35-39,1879,1
SIM,1940,35,45-49,1975,3
STAT,1914,19,20-24,1933,32.206830519277965
STAT,1917,15,25-29,1932,10.81220186396433
STAT,1962,18,40-44,1980,2.0675881391897275
STAT,1900,37,20-24,1937,0.2664350927954348
STAT,1942,37,25-29,1979,1.2235841808426118
SIM,1857,44,na,1901,2453
SIM,1958,50,na,2008,5997
STAT,1950,19,30-34,1969,16.621020423454357
SIM,1903,86,na,1989,1073
STAT,1960,22,15-19,1982,8.027600369339607
SIM,1932,43,na,1975,5432
SIM,1936,57,na,1993,3759
SIM,1888,33,30-34,1921,26
STAT,1934,18,35-39,1952,6.5361058782760635
STAT,1961,31,20-24,1992,3.7092200072711186
STAT,1947,46,15-19,1993,4.993315682060995E-4
SIM,1965,30,na,1995,5571
SIM,1911,81,na,1992,2690
STAT,1782,88,na,1870,60.95155065873159
STAT,1921,15,45-49,1936,0.6599358055940551
STAT,1942,26,15-19,1968,0.8556056942779743
SIM,1949,37,30-34,1986,1
SIM,1912,17,40-44,1929,1
STAT,1841,49,na,1890,1958.5463048469667
STAT,1978,6,na,1984,6191.477164516675
STAT,1904,17,40-44,1921,0.3031104590371426
SIM,1811,46,40-44,1857,1
SIM,1903,30,na,1933,3973
SIM,1887,7,na,1894,3987
SIM,1922,19,20-24,1941,362
STAT,1879,20,50-100,1899,0.49432708516774704
SIM,1799,73,na,1872,319
STAT,1835,22,45-49,1857,0.6003575475776504
STAT,1881,113,na,1994,0.0014009203597418894
SIM,1833,42,na,1875,1627
SIM,1837,56,na,1893,1887
STAT,1975,16,25-29,1991,65.99497549235394
STAT,1932,35,45-49,1967,1.059148411881476
STAT,1974,36,20-24,2010,0.4096283995965783
SIM,1950,37,25-29,1987,3
STAT,1790,83,na,1873,139.78459438778748
STAT,1857,32,na,1889,2158.083623952889
STAT,1932,15,20-24,1947,208.19034731917597
SIM,1831,51,na,1882,1495
SIM,1971,36,45-49,2007,4
STAT,1911,21,50-100,1932,0.7229624989742781
STAT,1840,75,na,1915,825.8360467992223
SIM,1829,32,50-100,1861,3
STAT,1934,34,50-100,1968,1.3017143385584236
STAT,1934,32,15-19,1966,0.20258049238240697
STAT,1948,47,15-19,1995,5.060299208781237E-4
STAT,1964,26,20-24,1990,26.659103614200202
STAT,1913,40,30-34,1953,0.14558642826505624
SIM,1951,35,20-24,1986,1
STAT,1951,51,na,2002,5184.475950074595
SIM,1852,13,na,1865,2454
SIM,1923,39,50-100,1962,3
STAT,1896,16,25-29,1912,8.658929786346945
STAT,1803,75,na,1878,433.77369758350005
STAT,1894,24,na,1918,3486.6776147950263
STAT,1898,38,na,1936,3685.1966189360264
SIM,1943,19,35-39,1962,11
STAT,1932,15,na,1947,5652.1917345396
STAT,1854,67,na,1921,1291.4721854650322
STAT,1990,19,15-19,2009,74.95516926679929
STAT,1935,19,35-39,1954,6.588118471316495
STAT,1830,52,35-39,1882,0.006983893287425076
STAT,1952,44,30-34,1996,0.18313239905257758
STAT,1870,54,30-34,1924,0.00658612411531987
STAT,1943,35,20-24,1978,0.3329663949507697
STAT,1954,24,40-44,1978,4.809541507200451
SIM,1882,51,na,1933,2972
STAT,1860,47,25-29,1907,0.053324491988735664
STAT,1949,26,25-29,1975,88.76376778414367
STAT,1868,16,na,1884,2867.9042336953876
STAT,1902,92,na,1994,391.76088457969206
STAT,1924,29,30-34,1953,52.25888331295034
SIM,1849,40,40-44,1889,1
STAT,1819,49,50-100,1868,0.4593866734003934
SIM,1921,17,50-100,1938,4
STAT,1959,47,35-39,2006,0.20244399407122146
SIM,1957,19,na,1976,6313
STAT,1836,52,50-100,1888,0.013911948512507844
STAT,1986,7,na,1993,6463.488989108646
STAT,1885,48,40-44,1933,0.19459371506465137
STAT,1903,30,20-24,1933,4.478941628360275
STAT,1954,48,na,2002,5436.562884642609
STAT,1908,41,na,1949,3993.345141923082
STAT,1933,78,na,2011,3351.6500984643476
STAT,1937,44,35-39,1981,0.23374971633842018
STAT,1852,53,25-29,1905,0.00328583875863301
SIM,1972,26,20-24,1998,3
STAT,1942,48,50-100,1990,0.2829895964945156
SIM,1903,25,45-49,1928,4
STAT,2001,12,na,2013,6787.106092896632
SIM,1957,26,25-29,1983,5
STAT,1953,45,30-34,1998,0.13005856153022927
SIM,1997,16,40-44,2013,4
STAT,1933,31,15-19,1964,0.2000584009348257
SIM,1850,44,50-100,1894,4
SIM,1906,27,na,1933,3806
SIM,1898,66,na,1964,3022
STAT,1924,41,45-49,1965,0.22872480547512247
STAT,1909,29,35-39,1938,16.458726578907335
STAT,1938,36,20-24,1974,0.3096032865708036
STAT,1913,43,50-100,1956,0.13207362915963627
SIM,1911,30,20-24,1941,6
STAT,1854,103,na,1957,0.17082087291720752
STAT,1938,23,45-49,1961,1.2853351952997032
SIM,1936,34,40-44,1970,9
STAT,1866,92,na,1958,64.57855901934771
STAT,1915,11,na,1926,4778.120313755286
STAT,1919,25,na,1944,4701.796802232904
SIM,1932,29,30-34,1961,7
SIM,1922,65,na,1987,4217
STAT,1989,16,40-44,2005,2.3127079078929644
STAT,1890,39,50-100,1929,1.713840460847493
STAT,1963,34,35-39,1997,13.639622828468733
STAT,1849,8,na,1857,2342.804200492576
SIM,1828,35,25-29,1863,2
STAT,1840,39,20-24,1879,0.7163552719127938
SIM,1916,28,35-39,1944,18
SIM,1969,24,50-100,1993,1
SIM,1856,25,35-39,1881,16
STAT,1924,71,na,1995,3849.4491343712025
SIM,1942,32,15-19,1974,1
STAT,1786,107,na,1893,0.004106749929245237
SIM,1844,26,na,1870,2540
STAT,1857,43,50-100,1900,0.942690897686802
STAT,1889,20,20-24,1909,98.61771558893672
STAT,1935,63,na,1998,5380.372256830447
STAT,1928,34,40-44,1962,5.6395865921207555
SIM,1939,27,20-24,1966,3
SIM,1878,26,25-29,1904,101
SIM,1911,73,na,1984,3595
SIM,1976,14,na,1990,6041
STAT,1857,24,na,1881,2201.2178561401065
STAT,1967,27,30-34,1994,56.728468870719695
SIM,1932,41,45-49,1973,2
STAT,1917,45,20-24,1962,0.013384174255003146
SIM,1917,29,35-39,1946,58
SIM,1911,16,40-44,1927,1
STAT,1863,5,na,1868,2895.478354596556
STAT,1893,23,45-49,1916,1.0140527703792455
STAT,1891,67,na,1958,2352.4960479983356
STAT,1939,43,50-100,1982,0.14086924432798129
STAT,1946,30,40-44,1976,5.1115714985273195
STAT,1936,37,na,1973,4264.931276911811
STAT,1966,26,30-34,1992,56.74841245190166
SIM,1878,78,na,1956,942
STAT,1967,48,50-100,2015,0.3382019147164341
SIM,1815,77,na,1892,551
SIM,1965,17,20-24,1982,204
STAT,1936,43,35-39,1979,0.2299022269067075
SIM,1935,34,25-29,1969,20
STAT,1805,107,na,1912,0.0019380105340423477
STAT,1957,17,20-24,1974,206.28712841539286
SIM,1881,26,na,1907,1839
STAT,1867,30,40-44,1897,4.710322168357401
SIM,1941,16,20-24,1957,151
SIM,1919,45,na,1964,5318
STAT,1924,28,na,1952,5014.596560278789
SIM,1858,18,20-24,1876,26
STAT,1911,24,20-24,1935,121.04315304719616
STAT,1874,109,na,1983,0.049720128688073136
SIM,1944,43,35-39,1987,1
STAT,1930,46,45-49,1976,0.3311697301552975
STAT,1839,59,na,1898,1541.2638188988626
STAT,1865,112,na,1977,0.0011338141344222074
STAT,1883,48,30-34,1931,0.10792282366315692
STAT,1921,37,35-39,1958,3.115614713501314
STAT,1973,0,na,1973,5911.907483852714
SIM,1910,37,30-34,1947,1
STAT,1878,34,50-100,1912,1.0945828645285438
SIM,1971,33,40-44,2004,16
STAT,1907,26,20-24,1933,19.988066540310694
STAT,1940,32,45-49,1972,1.8800670591190312
STAT,1878,33,20-24,1911,3.243320843965203
STAT,1971,43,40-44,2014,0.37934223982959303
SIM,1866,13,na,1879,2763
STAT,1910,47,30-34,1957,0.09608499816423045
SIM,1878,23,20-24,1901,166
SIM,1911,33,25-29,1944,2
STAT,1941,25,15-19,1966,0.8437288092485808
STAT,1920,8,na,1928,5161.872326033692
SIM,1830,77,na,1907,513
SIM,1887,74,na,1961,2140
SIM,1950,34,20-24,1984,5
SIM,1921,51,na,1972,5079
SIM,1925,65,na,1990,4333
SIM,1959,37,45-49,1996,2
STAT,1907,25,50-100,1932,1.0935504960094828
STAT,1875,29,na,1904,2825.814665242959
STAT,1945,33,na,1978,4856.99906634099
STAT,1854,59,na,1913,1583.334378970819
STAT,1869,30,15-19,1899,0.16043531835158278
STAT,1922,16,45-49,1938,0.6685312174231224
STAT,1951,32,20-24,1983,3.4167626150528054
SIM,1940,30,na,1970,4907
SIM,1907,16,20-24,1923,39
STAT,1865,11,na,1876,2827.6669985885687
SIM,1866,4,na,1870,2973
STAT,1965,27,20-24,1992,26.413196619772023
STAT,1900,24,45-49,1924,1.109669364843098
STAT,1956,19,25-29,1975,66.13176150342842
STAT,1903,33,25-29,1936,9.626755960732035
STAT,1972,20,40-44,1992,4.988100969134539
SIM,1959,26,35-39,1985,2
SIM,1858,18,na,1876,3020
STAT,1875,38,30-34,1913,6.324504133499976
SIM,1945,41,30-34,1986,1
SIM,1846,60,na,1906,1163
STAT,1878,20,45-49,1898,0.8452548651282344
SIM,1928,30,na,1958,5623
STAT,1933,16,20-24,1949,210.05226959854582
SIM,1883,38,30-34,1921,11
SIM,1921,27,35-39,1948,36
SIM,1887,82,na,1969,1573
STAT,1913,27,35-39,1940,17.273237702327883
STAT,1953,47,40-44,2000,0.22894338913070708
SIM,1964,19,25-29,1983,82
SIM,1891,48,30-34,1939,1
STAT,1914,42,45-49,1956,0.1904080396589451
STAT,1903,16,40-44,1919,0.3013902839371356
SIM,1877,21,na,1898,3035
SIM,1879,87,na,1966,241
STAT,1961,34,25-29,1995,14.028948503960876
SIM,1921,38,45-49,1959,1
STAT,1937,46,na,1983,4293.256598121124
STAT,1899,41,40-44,1940,0.24807164461629938
STAT,1817,67,na,1884,1220.399507155036
STAT,1921,48,45-49,1969,0.28186203001755356
STAT,1925,42,20-24,1967,0.02466703516129341
STAT,1904,43,50-100,1947,0.12069897676542474
SIM,1961,24,25-29,1985,289
STAT,1870,97,na,1967,27.687432015693627
SIM,1979,25,50-100,2004,1
STAT,1899,30,30-34,1929,27.826936222680832
SIM,1838,42,30-34,1880,5
SIM,1874,64,na,1938,1804
STAT,1860,44,20-24,1904,0.14571952185945636
SIM,1948,36,30-34,1984,4
STAT,1873,62,na,1935,2153.9626002594064
STAT,1911,26,40-44,1937,5.268234037439957
SIM,1879,31,na,1910,2758
SIM,1912,43,50-100,1955,1
SIM,1928,40,40-44,1968,1
SIM,1901,19,30-34,1920,10
STAT,1879,67,na,1946,1910.217416656732
STAT,1932,23,na,1955,5513.849263866284
STAT,1813,53,na,1866,1281.3905026740558
STAT,1911,15,30-34,1926,2.830319301681155
STAT,1953,24,25-29,1977,129.2909746878008
STAT,2012,0,na,2012,7279.9524802437045
STAT,1943,41,25-29,1984,0.09095798042436588
SIM,1951,38,25-29,1989,3
SIM,1854,25,25-29,1879,8
STAT,1943,38,25-29,1981,1.2402580297778374
STAT,1846,25,25-29,1871,53.670984530161995
STAT,1969,24,na,1993,5278.339987467444
SIM,1823,64,na,1887,1405
SIM,1914,25,20-24,1939,3
SIM,1834,56,na,1890,1435
SIM,1956,42,45-49,1998,2
SIM,1874,21,35-39,1895,16
SIM,1971,40,na,2011,5720
STAT,1909,38,25-29,1947,1.0713947767677854
STAT,1965,10,na,1975,5661.046299270382
SIM,1909,32,30-34,1941,40
SIM,1917,38,25-29,1955,3
SIM,1989,22,40-44,2011,9
STAT,1895,110,na,2005,0.047538460526792864
STAT,1959,33,30-34,1992,24.228156365624308
SIM,1903,23,25-29,1926,192
STAT,1937,41,30-34,1978,0.14911559881662775
STAT,1834,30,50-100,1864,1.093526756390989
STAT,1909,41,25-29,1950,0.07761177838535932
SIM,1844,34,na,1878,2362
SIM,1848,48,na,1896,1643
STAT,1878,109,na,1987,0.0634752934768144
STAT,1901,20,15-19,1921,5.3646340093151315
SIM,1920,88,na,2008,244
STAT,1952,49,50-100,2001,0.3234519751012602
STAT,1959,44,30-34,2003,0.1998975780565806
STAT,1924,38,20-24,1962,0.3582664919679568
STAT,1926,20,50-100,1946,0.9278427617369766
STAT,1906,25,20-24,1931,19.876458881559532
STAT,1932,48,20-24,1980,0.017256501165730104
STAT,1903,66,na,1969,3067.3587147621083
STAT,1943,0,na,1943,5466.359726606492
STAT,1948,38,na,1986,5113.7463630980255
STAT,1948,42,45-49,1990,0.22842283653367842
STAT,1869,89,na,1958,163.43015896943797
SIM,1842,30,50-100,1872,3
SIM,1849,43,45-49,1892,1
STAT,1871,45,35-39,1916,0.16234017710153575
STAT,1872,49,15-19,1921,4.538425382282142E-4
STAT,1781,108,na,1889,0.0038968987457967813
SIM,1839,87,na,1926,201
SIM,1849,32,35-39,1881,24
STAT,1882,31,na,1913,2700.8781872826626
STAT,1940,10,na,1950,4639.249438813671
STAT,1856,32,30-34,1888,15.56060491791534
SIM,1915,26,20-24,1941,24
SIM,1904,4,na,1908,4461
STAT,1917,48,25-29,1965,0.06376531925390101
SIM,1910,21,15-19,1931,5
STAT,1888,22,25-29,1910,77.6579425806623
STAT,1955,25,50-100,1980,1.5328125537519046
STAT,1927,68,na,1995,4376.75800703828
SIM,1896,22,25-29,1918,174
STAT,1964,3,na,1967,5717.751719173562
STAT,1953,20,na,1973,5118.489187072328
STAT,1872,15,25-29,1887,6.666517796020238
STAT,1923,45,15-19,1968,4.994690529761966E-4
SIM,1886,33,20-24,1919,4
SIM,1857,52,na,1909,2257
SIM,1875,22,35-39,1897,12
SIM,1946,20,40-44,1966,7
SIM,1963,25,50-100,1988,2
STAT,1828,103,na,1931,0.09525083555302286
SIM,1880,15,25-29,1895,15
SIM,1954,30,40-44,1984,17
SIM,1791,77,na,1868,456
STAT,1922,45,na,1967,4891.437558548212
SIM,1799,65,na,1864,631
STAT,1895,41,na,1936,3499.680185805317
STAT,1866,21,35-39,1887,6.338467212164816
STAT,1916,36,15-19,1952,0.02280624248379443
STAT,1965,49,30-34,2014,0.13281149379369903
STAT,1915,35,15-19,1950,0.022604356009628533
STAT,1938,39,25-29,1977,1.152887129479179
STAT,1968,43,50-100,2011,0.17570289229737274
SIM,1938,29,25-29,1967,1
SIM,1864,32,30-34,1896,34
SIM,1925,7,na,1932,5632
SIM,1897,23,25-29,1920,3
STAT,1889,23,25-29,1912,81.18421113319172
STAT,1963,31,30-34,1994,23.55962183053285
STAT,1898,46,na,1944,3519.6494642409953
STAT,1911,53,na,1964,3931.7319079921763
STAT,1938,28,15-19,1966,0.8071386742980338
STAT,1956,25,na,1981,5750.379952792481
STAT,1938,20,40-44,1958,3.844892751128452
SIM,1946,39,25-29,1985,4
SIM,1863,21,50-100,1884,1
SIM,1928,76,na,2004,3506
SIM,1938,18,15-19,1956,37
SIM,1954,22,na,1976,5509
SIM,1956,26,na,1982,5008
STAT,1872,32,na,1904,2765.262511859385
SIM,1952,12,na,1964,4842
STAT,1880,75,na,1955,1259.2804645555884
SIM,1968,29,50-100,1997,5
SIM,1861,37,40-44,1898,2
SIM,1944,40,30-34,1984,2
SIM,1920,26,35-39,1946,1
STAT,1972,32,50-100,2004,1.245283218970103
SIM,1941,19,25-29,1960,59
STAT,1802,82,na,1884,233.24120384413868
STAT,1843,32,45-49,1875,2.103497011178212
STAT,1829,29,40-44,1858,4.5967796473817035
SIM,1965,33,20-24,1998,2
STAT,1888,43,30-34,1931,1.5483444412560297
STAT,1903,21,30-34,1924,29.367822101112893
STAT,1940,45,45-49,1985,0.2662237156849245
STAT,1970,27,35-39,1997,21.78279363176367
SIM,1922,40,50-100,1962,2
SIM,1868,20,20-24,1888,86
STAT,1959,25,na,1984,5684.487004938612
SIM,1851,32,45-49,1883,2
STAT,1961,22,30-34,1983,42.99481897831986
STAT,1966,27,15-19,1993,1.0219766189361954
STAT,1849,20,45-49,1869,0.6629321591361071
SIM,1847,32,25-29,1879,26
SIM,1964,38,na,2002,5830
SIM,1918,60,na,1978,3477
STAT,1813,45,na,1858,1446.711556701175
STAT,1843,21,35-39,1864,7.4026373438380935
STAT,1926,45,40-44,1971,0.22551507109104743
SIM,1837,29,40-44,1866,9
STAT,1893,19,50-100,1912,0.07108210764021737
SIM,1907,32,20-24,1939,6
STAT,1912,26,35-39,1938,17.14940489463794
STAT,1839,32,25-29,1871,9.99615973169628
STAT,1882,87,na,1969,482.3282951986102
SIM,1897,22,40-44,1919,1
STAT,1823,52,na,1875,1365.4344136868433
SIM,1810,46,na,1856,1481
SIM,1851,21,35-39,1872,16
SIM,1867,23,45-49,1890,1
SIM,1929,40,35-39,1969,1
STAT,1853,37,40-44,1890,4.3583249288858426
STAT,1866,43,50-100,1909,1.121883098246153
SIM,1862,32,20-24,1894,5
SIM,1960,35,40-44,1995,5
SIM,1908,53,na,1961,3511
STAT,1921,9,na,1930,5234.748472888157
STAT,1988,21,15-19,2009,8.818083326350726
STAT,1869,97,na,1966,24.72610985243975
SIM,1951,63,na,2014,5462
STAT,1890,82,na,1972,1199.6539421570108
STAT,1832,31,30-34,1863,16.03610760662269
STAT,1889,22,40-44,1911,2.964362416149021
STAT,1894,96,na,1990,120.6179287783324
SIM,1902,22,25-29,1924,111
SIM,1972,33,na,2005,5710
STAT,1901,83,na,1984,1398.9693993887538
SIM,1922,22,45-49,1944,2
STAT,1905,76,na,1981,2337.619204490159
STAT,1952,35,40-44,1987,2.1366034237729865
STAT,1901,44,25-29,1945,0.07111034309369707
STAT,1933,19,25-29,1952,66.61720264883166
STAT,1884,89,na,1973,385.2992691698891
STAT,1919,45,30-34,1964,0.11208441439057983
STAT,1854,50,30-34,1904,0.004919213815191644
SIM,1896,31,50-100,1927,2
STAT,1854,32,20-24,1886,2.2551589285694833
STAT,1844,14,na,1858,2515.2036029301644
STAT,1951,45,20-24,1996,0.01587099602204466
STAT,1812,44,50-100,1856,2.6064896780598388
STAT,1901,62,na,1963,3163.76501534589
STAT,1884,48,25-29,1932,0.06485149786793733
STAT,1838,29,na,1867,2349.495595742877
STAT,1881,4,na,1885,3159.7395809474137
STAT,1956,16,20-24,1972,207.0918920695342
STAT,1899,44,45-49,1943,0.16210226241721873
STAT,1914,22,45-49,1936,1.3272509257850624
SIM,1861,23,15-19,1884,4
STAT,1847,54,na,1901,1611.204326585154
STAT,1907,29,25-29,1936,70.71313813080991
SIM,1974,31,35-39,2005,23
STAT,1972,23,45-49,1995,1.66750600038336
SIM,1915,29,25-29,1944,140
SIM,1955,30,35-39,1985,6
STAT,1911,29,45-49,1940,1.932079846691158
STAT,1960,19,na,1979,5528.7614925062
STAT,1835,27,15-19,1862,0.3699429430061449
STAT,1964,18,15-19,1982,65.94439950886643
STAT,1983,28,50-100,2011,1.6311952963356011
STAT,1899,33,35-39,1932,15.944035679971899
STAT,1911,18,35-39,1929,0.9673250127886734
STAT,1848,28,na,1876,2724.314129645885
STAT,1881,39,50-100,1920,1.3528816142552254
STAT,1884,8,na,1892,2964.0571743023415
STAT,1853,23,15-19,1876,3.852994323422938
SIM,1835,47,40-44,1882,1
STAT,1971,25,30-34,1996,57.569429349584674
SIM,1931,50,na,1981,6000
SIM,1814,90,na,1904,46
STAT,1852,34,50-100,1886,0.8760289795120629
STAT,1936,40,30-34,1976,0.14659949604373448
SIM,1930,29,20-24,1959,3
STAT,1922,29,20-24,1951,23.65665553948256
STAT,1964,29,25-29,1993,95.98938769521817
STAT,1768,92,na,1860,10.128309991772005
STAT,1910,17,35-39,1927,0.9605282685494576
STAT,1834,54,20-24,1888,6.636735677384286E-4
STAT,1827,47,40-44,1874,0.2168328663787717
STAT,1865,22,25-29,1887,60.33191832186658
STAT,1851,70,na,1921,1112.630588955207
STAT,1910,23,20-24,1933,120.26018658818818
SIM,1859,19,20-24,1878,31
STAT,1841,50,45-49,1891,0.013088263718168998
STAT,1930,23,40-44,1953,4.9562331739030885
SIM,1846,15,25-29,1861,16
STAT,1859,98,na,1957,4.077098306589569
STAT,1925,22,20-24,1947,153.55324510544665
SIM,1876,39,50-100,1915,2
STAT,1861,17,15-19,1878,6.544193235777677
STAT,1860,48,50-100,1908,0.22556439499904482
STAT,1906,28,25-29,1934,70.93725318741261
SIM,1928,24,40-44,1952,10
STAT,1802,90,na,1892,37.63514792297703
STAT,1918,44,30-34,1962,0.1563118522092129
STAT,1913,38,45-49,1951,0.7729543580679793
STAT,1851,37,50-100,1888,0.9840197191430164
STAT,1909,71,na,1980,2975.3183271185426
SIM,1946,27,na,1973,4291
STAT,1826,92,na,1918,22.932398521350663
STAT,1829,46,50-100,1875,0.253923654881818
SIM,1868,79,na,1947,653
SIM,1949,16,25-29,1965,129
STAT,1900,29,15-19,1929,0.7213464204100418
SIM,1809,60,na,1869,1251
SIM,1945,53,na,1998,4533
STAT,1823,44,na,1867,1525.528710742586
SIM,1933,22,20-24,1955,3
STAT,1935,32,30-34,1967,25.16852084948301
STAT,1913,17,50-100,1930,0.08844833957081012
SIM,1943,32,30-34,1975,4
SIM,1814,41,30-34,1855,5
SIM,1914,17,15-19,1931,21
STAT,1855,19,40-44,1874,0.1829338721199067
STAT,1906,17,15-19,1923,9.987083386742306
STAT,1939,36,15-19,1975,0.022884392505874426
SIM,1914,28,25-29,1942,70
SIM,1870,18,na,1888,3305
SIM,1876,90,na,1966,107
STAT,1929,34,35-39,1963,13.37924842091911
STAT,1956,36,45-49,1992,1.073500307937912
SIM,1937,45,45-49,1982,1
STAT,1882,22,30-34,1904,20.078272738432872
SIM,1858,37,50-100,1895,4
SIM,1869,21,20-24,1890,61
SIM,1927,23,40-44,1950,10
STAT,1842,44,50-100,1886,0.8198237749320343
STAT,1902,37,30-34,1939,1.8757807742145838
SIM,1933,60,na,1993,5897
STAT,1929,45,45-49,1974,0.32665108002908866
SIM,1895,61,na,1956,2738
STAT,1892,34,15-19,1926,0.20421980226931416
SIM,1929,23,na,1952,5296
STAT,1912,46,na,1958,4088.61140400496
STAT,1944,34,30-34,1978,19.92007425371249
SIM,1973,26,15-19,1999,1
SIM,1840,31,30-34,1871,3
STAT,1965,26,15-19,1991,1.02196473396937
STAT,1972,39,15-19,2011,0.029171007644920963
SIM,1824,30,35-39,1854,27
SIM,1891,87,na,1978,582
SIM,1902,4,na,1906,4366
SIM,1936,71,na,2007,2696
SIM,1963,24,35-39,1987,24
SIM,1942,34,na,1976,5021
STAT,1817,42,45-49,1859,4.614717483320634
STAT,1956,2,na,1958,6009.384706831784
SIM,1952,34,30-34,1986,43
STAT,1874,36,na,1910,2796.859674662242
STAT,1828,49,50-100,1877,0.2202972853831332
STAT,1885,28,na,1913,2737.479037575159
STAT,1935,44,25-29,1979,0.11591622352489622
SIM,1890,22,30-34,1912,37
SIM,1874,5,na,1879,3113
STAT,1919,23,40-44,1942,4.234878220453245
STAT,1945,46,40-44,1991,0.20725329017349517
SIM,1938,26,20-24,1964,27
STAT,1905,49,15-19,1954,3.690110722442758E-4
STAT,1862,54,na,1916,2039.37258995958
SIM,1875,33,45-49,1908,8
STAT,1946,33,45-49,1979,2.0518016289377043
STAT,1909,35,20-24,1944,0.29101267973932776
STAT,1867,33,45-49,1900,1.8710190715652812
STAT,1851,62,na,1913,1449.3813417924284
SIM,1868,28,30-34,1896,36
SIM,1883,36,na,1919,2529
STAT,1837,55,na,1892,1497.289540757579
STAT,1912,40,15-19,1952,0.0017303109327595732
SIM,1918,31,na,1949,3980
STAT,1992,21,35-39,2013,15.654033659677424
STAT,1940,26,50-100,1966,1.1722439703980958
STAT,1792,66,na,1858,1149.1650191445497
STAT,1827,33,15-19,1860,0.23496345967774698
STAT,1898,16,35-39,1914,0.8579127418471338
STAT,1965,4,na,1969,5665.973928572857
SIM,1953,35,30-34,1988,1
SIM,1954,33,45-49,1987,5
STAT,1982,2,na,1984,6390.503998085374
STAT,1945,35,30-34,1980,2.37123755017509
STAT,1887,34,50-100,1921,1.1748559502523048
SIM,1825,31,35-39,1856,19
STAT,1915,39,50-100,1954,0.4846366667970091
STAT,1919,82,na,2001,2017.487121183255
STAT,1813,74,na,1887,525.9528174975123
SIM,1906,39,30-34,1945,3
STAT,1848,25,35-39,1873,12.416920379631451
STAT,1888,46,35-39,1934,0.1904596634058361
STAT,1955,35,45-49,1990,1.0778551781488157
SIM,1872,21,25-29,1893,68
SIM,1892,21,na,1913,4000
SIM,1866,69,na,1935,1435
STAT,1803,67,na,1870,779.2245912363824
STAT,1814,49,20-24,1863,0.032285311008322236
STAT,1945,49,45-49,1994,0.2833206445653281
STAT,1813,44,35-39,1857,6.27075413493679
STAT,1961,17,40-44,1978,2.0854849553255863
SIM,1920,42,35-39,1962,2
SIM,1821,44,35-39,1865,3
STAT,1858,17,na,1875,2414.0103056924772
SIM,1878,17,35-39,1895,3
SIM,1822,49,20-24,1871,1
STAT,1833,35,50-100,1868,1.1120200065499297
SIM,1889,86,na,1975,1067
STAT,1867,40,50-100,1907,1.149800689801331
STAT,1955,24,35-39,1979,14.463131930320205
STAT,1816,93,na,1909,14.432955890633902
SIM,1875,40,50-100,1915,3
SIM,1986,25,na,2011,6223
SIM,1959,35,25-29,1994,4
STAT,1901,41,20-24,1942,0.0179077242438434
STAT,1945,38,35-39,1983,3.1382719877402927
SIM,1967,18,na,1985,5770
SIM,1920,23,30-34,1943,84
STAT,1977,16,35-39,1993,6.5448632584097375
STAT,1838,31,25-29,1869,11.141857141689714
STAT,1950,15,45-49,1965,0.6820072656092988
SIM,1855,18,na,1873,2127
STAT,1960,38,30-34,1998,2.8194766118244257
SIM,1821,38,na,1859,1669
SIM,1938,9,na,1947,4194
STAT,1880,3,na,1883,3703.6665981948604
STAT,1885,18,15-19,1903,6.813418306085741
STAT,1963,49,20-24,2012,0.016754508529804438
SIM,1898,23,40-44,1921,6
STAT,1940,42,40-44,1982,0.30467987188766893
STAT,1912,23,30-34,1935,31.71966591786203
STAT,1961,25,35-39,1986,22.501545992380457
STAT,1908,25,30-34,1933,43.45691210454126
STAT,1880,114,na,1994,5.158553954638465E-4
STAT,1931,39,15-19,1970,0.029294033336610487
STAT,1970,24,30-34,1994,41.62937512623878
SIM,1989,6,na,1995,6752
STAT,1882,48,15-19,1930,4.4522022725295324E-4
STAT,1977,34,15-19,2011,0.2039852590908894
SIM,1921,72,na,1993,3815
SIM,1893,18,15-19,1911,11
STAT,1987,20,15-19,2007,8.804992015427018
SIM,1893,35,na,1928,3468
SIM,1916,25,30-34,1941,49
SIM,1821,60,na,1881,1163
STAT,1832,34,35-39,1866,8.99108795074472
STAT,1901,54,na,1955,3384.9381100430105
SIM,1966,15,na,1981,5566
STAT,1962,34,40-44,1996,5.890765363086612
STAT,1880,22,20-24,1902,84.29660430566004
SIM,1917,35,na,1952,5420
STAT,1883,16,na,1899,2858.6460815064115
SIM,1976,22,na,1998,5222
STAT,1842,20,35-39,1862,5.746123600608178
STAT,1958,44,15-19,2002,0.002410970367058029
SIM,1868,17,na,1885,3263
SIM,1926,47,35-39,1973,1
STAT,1903,10,na,1913,4257.91883542188
STAT,1932,18,25-29,1950,66.0644407531988
SIM,1867,43,na,1910,2206
STAT,1911,61,na,1972,3700.6033447732257
STAT,1945,41,na,1986,4872.70815832116
STAT,1827,104,na,1931,0.054168463378937416
STAT,1908,42,15-19,1950,0.0016417603848284824
SIM,1919,94,na,2013,322
SIM,1931,24,45-49,1955,2
STAT,1846,40,na,1886,2481.0079857962746
STAT,1864,21,25-29,1885,60.370297069110045
STAT,1873,45,45-49,1918,0.28089637814323265
SIM,1960,49,45-49,2009,2
STAT,1953,33,50-100,1986,1.1758245527324533
STAT,1796,88,na,1884,55.33875415989975
STAT,1971,20,25-29,1991,135.55283712215837
STAT,1952,49,45-49,2001,0.31080890166638636
STAT,1923,24,45-49,1947,1.5008502193717408
STAT,1898,32,35-39,1930,15.794985622647054
STAT,1924,25,45-49,1949,2.3364945482628983
STAT,1875,54,50-100,1929,0.017516166309156946
STAT,1974,39,25-29,2013,1.5253562550798323
STAT,1839,18,45-49,1857,0.06736800622365385
STAT,1874,15,35-39,1889,0.6537134377947296
STAT,1971,28,35-39,1999,22.02906629022433
SIM,1923,39,na,1962,5353
SIM,1961,33,50-100,1994,1
SIM,1970,33,25-29,2003,4
STAT,1946,17,45-49,1963,0.6394053924009854
STAT,1872,28,50-100,1900,0.7386676565596114
SIM,1953,16,45-49,1969,1
SIM,1943,35,35-39,1978,6
STAT,1860,44,na,1904,2120.6871309181747
SIM,1948,39,35-39,1987,6
STAT,1868,39,50-100,1907,1.3475807363160726
SIM,1888,8,na,1896,3117
STAT,1913,35,40-44,1948,1.7219934114309825
STAT,1871,36,na,1907,2717.9786199586956
SIM,1932,68,na,2000,4325
STAT,1910,15,15-19,1925,10.436837611199522
STAT,1963,45,35-39,2008,0.19754715305839038
STAT,1945,16,45-49,1961,0.6299271500530226
SIM,1845,51,na,1896,1917
SIM,1928,27,45-49,1955,7
STAT,1926,38,na,1964,5299.7475473519435
STAT,1977,36,na,2013,6049.326552834201
STAT,1884,97,na,1981,58.29372078956983
SIM,1985,29,na,2014,5947
STAT,1958,29,na,1987,5697.073901498811
SIM,1958,23,15-19,1981,9
STAT,1884,45,20-24,1929,0.013819062526978012
STAT,1934,15,30-34,1949,19.124147913621492
SIM,1840,34,35-39,1874,20
SIM,1854,25,na,1879,2915
STAT,1839,34,50-100,1873,0.8758212577555471
STAT,1825,47,30-34,1872,0.13517405555849799
STAT,1904,33,40-44,1937,4.10929765455304
STAT,1910,26,25-29,1936,73.67833704997092
STAT,1962,42,50-100,2004,0.18053056549634272
SIM,1960,7,na,1967,6326
STAT,1849,80,na,1929,479.45432565135025
STAT,1859,28,50-100,1887,0.5939276939597645
STAT,1851,37,30-34,1888,4.271586678390433
STAT,1989,19,45-49,2008,0.8251824879773615
STAT,1918,47,35-39,1965,0.15830304693810088
STAT,1935,27,40-44,1962,7.33633710692437
SIM,1958,34,25-29,1992,3
STAT,1913,24,30-34,1937,33.30176755083012
SIM,1877,36,50-100,1913,6
SIM,1908,61,na,1969,3193
STAT,1861,46,35-39,1907,0.13469836241415478
SIM,1921,24,30-34,1945,50
SIM,1974,37,na,2011,6312
STAT,1952,36,50-100,1988,0.5987542398157648
SIM,1942,42,na,1984,4988
SIM,1875,30,40-44,1905,7
STAT,1924,45,30-34,1969,0.12302095148496088
STAT,1919,40,25-29,1959,0.08953261151817068
SIM,1943,27,40-44,1970,1
SIM,1800,90,na,1890,35
STAT,1925,64,na,1989,4548.270861192777
STAT,1935,16,30-34,1951,19.287350607480825
SIM,1847,34,50-100,1881,2
SIM,1906,35,45-49,1941,2
SIM,1880,17,na,1897,3486
STAT,1919,15,35-39,1934,1.0783829384837218
SIM,1917,26,30-34,1943,117
STAT,1895,48,50-100,1943,0.2054970195000248
STAT,1852,50,20-24,1902,7.057181024580484E-4
STAT,1857,54,20-24,1911,6.450108905295991E-4
SIM,1932,35,na,1967,5491
STAT,1919,48,35-39,1967,0.16089762912042518
SIM,1806,60,na,1866,1161
SIM,1846,31,25-29,1877,25
STAT,1944,37,35-39,1981,3.094914632448321
STAT,1919,26,45-49,1945,2.1611064315413997
SIM,1917,37,40-44,1954,4
STAT,1945,30,25-29,1975,11.89039320980729
STAT,1838,20,15-19,1858,3.7620342173849246
SIM,1904,22,35-39,1926,17
SIM,1912,33,40-44,1945,10
SIM,1869,24,25-29,1893,132
STAT,1912,42,35-39,1954,0.22434395861177675
STAT,1950,35,30-34,1985,2.566641138200649
STAT,1907,94,na,2001,264.07384995792404
STAT,1853,104,na,1957,0.0987835416941309
STAT,1876,100,na,1976,14.548966434517515
STAT,1864,80,na,1944,637.4273371580707
STAT,1923,79,na,2002,2688.3359636957994
SIM,1814,44,35-39,1858,4
SIM,1952,37,35-39,1989,1
SIM,1823,37,50-100,1860,1
SIM,1882,43,na,1925,3162
STAT,1841,49,50-100,1890,0.21380133969822054
SIM,1927,15,35-39,1942,16
STAT,1824,37,na,1861,1776.82443924037
SIM,1939,71,na,2010,3726
SIM,1953,38,35-39,1991,2
STAT,1909,26,30-34,1935,43.78037975818516
STAT,1966,29,35-39,1995,21.712947241402304
STAT,1957,33,20-24,1990,3.780720387288763
STAT,1913,43,35-39,1956,0.22638110691570001
SIM,1888,13,na,1901,3101
SIM,1867,3,na,1870,3318
STAT,1934,48,30-34,1982,0.14300621898938912
STAT,1935,35,35-39,1970,3.9120702847860893
SIM,1892,50,na,1942,3490
SIM,1927,26,45-49,1953,1
SIM,1943,27,na,1970,5401
SIM,1953,30,25-29,1983,6
SIM,1886,20,45-49,1906,1
SIM,1846,20,15-19,1866,2
SIM,1905,23,35-39,1928,12
SIM,1868,23,25-29,1891,85
STAT,1868,44,25-29,1912,0.7023922264778035
STAT,1909,37,40-44,1946,1.6370577915674134
STAT,1935,41,20-24,1976,0.02880463394590729
SIM,1986,18,30-34,2004,31
STAT,1875,72,na,1947,1506.1226768801605
STAT,1813,41,50-100,1854,4.128323184726961
STAT,1828,42,20-24,1870,0.15277528437521296
SIM,1918,38,40-44,1956,1
SIM,1876,44,25-29,1920,2
STAT,1836,70,na,1906,1276.8926462209877
STAT,1897,22,50-100,1919,0.6292751714276364
STAT,1879,36,40-44,1915,5.3003622718176455
STAT,1955,21,30-34,1976,44.192040894836
SIM,1894,87,na,1981,943
SIM,1905,20,30-34,1925,77
STAT,1951,36,30-34,1987,2.5827548731684784
STAT,1863,29,40-44,1892,3.001249068204315
SIM,1884,55,na,1939,2334
STAT,1892,39,20-24,1931,1.1037604991694292
STAT,1902,44,40-44,1946,0.25125694576366875
SIM,1901,35,30-34,1936,5
STAT,1822,50,40-44,1872,0.019928038645411778
SIM,1818,37,30-34,1855,6
STAT,1936,27,35-39,1963,16.591494319445278
STAT,1879,20,25-29,1899,69.39362896708111
STAT,1942,14,na,1956,4736.4885548332895
SIM,1833,63,na,1896,1136
SIM,1797,61,na,1858,1015
SIM,1827,37,40-44,1864,2
SIM,1924,8,na,1932,5379
STAT,1977,24,30-34,2001,44.93362135574347
STAT,1855,20,na,1875,2156.274105399371
STAT,1952,46,na,1998,5297.880984156875
STAT,1936,47,45-49,1983,0.2487497018392784
STAT,1931,18,45-49,1949,0.7527612758095619
SIM,1789,66,na,1855,1139
SIM,1883,15,15-19,1898,5
STAT,1930,20,15-19,1950,7.9178437888480335
STAT,1875,15,15-19,1890,7.110401241112794
SIM,1823,31,25-29,1854,3
SIM,1808,64,na,1872,1144
STAT,1843,37,15-19,1880,0.06577711894463308
STAT,1916,28,20-24,1944,21.70693230016358
SIM,1972,19,na,1991,5128
STAT,1872,44,45-49,1916,1.7109000127747294
STAT,1965,45,45-49,2010,0.32723866726443546
SIM,1871,35,35-39,1906,5
SIM,1974,22,45-49,1996,11
STAT,1848,48,15-19,1896,4.196704504939666E-4
STAT,1914,27,15-19,1941,0.8216953142208089
STAT,1966,38,15-19,2004,0.02848861913792449
SIM,1861,60,na,1921,1429
STAT,1974,24,50-100,1998,0.9941519588579897
SIM,1901,74,na,1975,2465
SIM,1887,36,40-44,1923,11
STAT,1787,106,na,1893,0.003729017856199803
SIM,1916,29,40-44,1945,9
SIM,1955,49,45-49,2004,1
STAT,1847,42,25-29,1889,0.4968662878224921
SIM,1859,56,na,1915,1866
SIM,1924,28,20-24,1952,6
STAT,1831,45,40-44,1876,0.1627333843237891
STAT,1917,13,na,1930,4897.075585798752
STAT,1917,15,na,1932,4818.893928535955
STAT,1848,32,50-100,1880,1.1353164429647253
SIM,1948,32,45-49,1980,5
SIM,1953,26,na,1979,5442
SIM,1950,18,20-24,1968,153
STAT,1908,29,40-44,1937,5.055061673925885
STAT,1885,42,na,1927,2657.213994405951
STAT,1786,89,na,1875,62.95037065012329
STAT,1966,22,45-49,1988,1.6272116012938787
STAT,1942,18,20-24,1960,163.48258043043262
STAT,1920,37,40-44,1957,1.890705777962883
STAT,1962,37,45-49,1999,1.0385325939289676
SIM,1994,14,na,2008,6222
STAT,1946,26,na,1972,4817.911831240036
SIM,1889,42,50-100,1931,1
SIM,1912,36,45-49,1948,1
SIM,1880,44,45-49,1924,4
SIM,1978,27,35-39,2005,28
STAT,1934,19,40-44,1953,2.17271065483429
STAT,1844,16,25-29,1860,6.060770983886917
STAT,1848,9,na,1857,3209.0265122211767
STAT,1905,28,45-49,1933,1.8480360238944253
STAT,1941,29,25-29,1970,78.51970269933214
STAT,1872,24,na,1896,2723.466763662543
SIM,1905,42,na,1947,4049
SIM,1970,17,35-39,1987,6
STAT,1792,95,na,1887,3.9761369280580503
STAT,1880,25,25-29,1905,52.095896401112974
SIM,1924,69,na,1993,3684
STAT,1894,34,25-29,1928,15.065208930954212
STAT,1945,68,na,2013,3962.6646415740315
SIM,1930,31,na,1961,5994
STAT,1929,31,30-34,1960,23.109879000150865
STAT,1899,49,15-19,1948,3.4929335993442144E-4
STAT,1826,47,25-29,1873,0.04144561574168549
STAT,1866,49,20-24,1915,0.012567938220620566
STAT,1821,38,35-39,1859,15.063551515343
STAT,1851,31,35-39,1882,8.44577564355195
STAT,1920,17,30-34,1937,15.77496232478344
SIM,1896,9,na,1905,4063
STAT,1837,39,40-44,1876,3.7800499788204176
STAT,1885,50,na,1935,2514.1488064835994
STAT,1989,21,30-34,2010,47.681682363498524
STAT,1920,82,na,2002,2055.731273492256
SIM,1888,67,na,1955,1521
STAT,1924,22,40-44,1946,4.57746440656083
STAT,1869,17,40-44,1886,0.2072446045799178
SIM,1942,19,40-44,1961,4
SIM,1913,28,45-49,1941,2
STAT,1914,72,na,1986,3115.3283998078477
STAT,1844,68,na,1912,1278.218997559165
SIM,1937,31,30-34,1968,4
STAT,1963,29,45-49,1992,2.5413872811338036
STAT,1842,87,na,1929,135.5755590687458
STAT,1877,37,50-100,1914,1.473837567937583
STAT,1857,19,15-19,1876,6.195697347909547
STAT,1884,18,20-24,1902,20.161481720872747
SIM,1781,78,na,1859,558
SIM,1889,20,35-39,1909,12
STAT,1895,46,35-39,1941,0.11896740698331236
STAT,1878,15,na,1893,3057.3824991759952
SIM,1940,65,na,2005,4066
STAT,1909,15,50-100,1924,0.08527866977609867
SIM,1916,22,50-100,1938,1
STAT,1962,17,35-39,1979,6.204749578301576
STAT,1819,37,40-44,1856,12.93929070949582
SIM,1875,94,na,1969,123
STAT,1971,25,na,1996,5504.071686875245
STAT,1877,55,na,1932,2482.176253653124
SIM,1842,22,na,1864,2221
SIM,1884,38,25-29,1922,2
SIM,1849,38,30-34,1887,2
SIM,1942,24,20-24,1966,241
STAT,1969,38,40-44,2007,2.2211295786426684
SIM,1891,25,na,1916,3265
SIM,1994,12,na,2006,6222
STAT,1969,17,45-49,1986,0.7201524212250501
STAT,1973,39,45-49,2012,1.0460399260324413
SIM,1983,20,na,2003,6133
STAT,1846,54,45-49,1900,0.014590110202942265
SIM,1870,17,30-34,1887,3
STAT,1937,36,40-44,1973,1.7300246881646215
SIM,1851,41,50-100,1892,2
SIM,1923,19,15-19,1942,67
STAT,1915,19,15-19,1934,10.904862284479968
SIM,1934,47,na,1981,5682
STAT,1886,35,15-19,1921,0.06900677421840849
STAT,1960,33,na,1993,5790.9786956346115
STAT,1977,22,20-24,1999,173.95830570529753
SIM,1990,1,na,1991,6348
STAT,1897,53,na,1950,3269.3671593639956
SIM,1886,24,30-34,1910,3
SIM,1795,80,na,1875,271
SIM,1989,11,na,2000,6751
STAT,1948,39,20-24,1987,0.3579081574656089
STAT,1866,111,na,1977,0.0035445247060430576
STAT,1915,39,25-29,1954,1.1365284035986898
SIM,1904,17,na,1921,4378
SIM,1932,22,40-44,1954,7
STAT,1859,20,40-44,1879,2.215834056371094
SIM,1977,17,45-49,1994,6
STAT,1990,17,50-100,2007,0.6191970224225524
STAT,1928,40,50-100,1968,0.17331259229854884
STAT,1934,24,20-24,1958,172.42022823558247
STAT,1966,24,na,1990,5277.597379747256
STAT,1904,16,35-39,1920,0.9115646578740174
STAT,1979,27,45-49,2006,2.7570084834139554
STAT,1878,24,30-34,1902,21.32864741495968
STAT,1893,93,na,1986,260.50811682653466
SIM,1966,28,25-29,1994,174
STAT,1860,23,15-19,1883,3.1404230931396944
STAT,1871,29,35-39,1900,10.999011244838576
SIM,1902,47,40-44,1949,1
STAT,1904,40,na,1944,3882.2406758799716
SIM,1923,39,25-29,1962,5
SIM,1939,46,25-29,1985,1
STAT,1904,36,45-49,1940,0.7164946366328541
SIM,1902,27,30-34,1929,4
STAT,1855,46,40-44,1901,0.14608691034976332
STAT,1826,63,na,1889,993.5123466554137
STAT,1917,44,15-19,1961,0.0018433913228808627
SIM,1987,27,45-49,2014,4
SIM,1862,20,na,1882,3119
STAT,1958,49,20-24,2007,0.017321025752684644
STAT,1958,28,25-29,1986,100.14925140147099
SIM,1867,20,40-44,1887,3
STAT,1989,24,35-39,2013,15.605218693655909
SIM,1867,51,na,1918,2113
SIM,1833,41,35-39,1874,5
SIM,1897,25,45-49,1922,1
SIM,1916,21,45-49,1937,4
STAT,1813,49,40-44,1862,0.5500200924704888
STAT,1826,49,na,1875,1371.2469375406702
STAT,1958,16,30-34,1974,18.480187288622478
STAT,1881,39,45-49,1920,2.1966747372613913
STAT,1918,23,25-29,1941,114.589741722138
SIM,1954,27,50-100,1981,1
STAT,1935,31,50-100,1966,1.3215522139303895
SIM,1883,32,35-39,1915,33
STAT,1875,32,35-39,1907,12.077492518538026
STAT,1909,18,na,1927,4364.449566787366
SIM,1916,34,20-24,1950,4
SIM,1976,24,20-24,2000,185
STAT,1831,93,na,1924,22.929281698820443
STAT,1908,21,45-49,1929,1.198881407577929
STAT,1829,102,na,1931,0.21477393444846404
STAT,1850,103,na,1953,0.14774096968791534
STAT,1899,16,15-19,1915,9.405987437985804
SIM,1821,52,na,1873,1293
STAT,1917,69,na,1986,3559.3016149375044
STAT,1825,41,35-39,1866,2.750484468706881
SIM,1926,23,25-29,1949,143
STAT,1867,28,30-34,1895,27.03769668895004
STAT,1889,25,45-49,1914,1.5901988331944326
STAT,1943,34,15-19,1977,0.16010938747345463
SIM,1906,32,40-44,1938,7
STAT,1839,23,35-39,1862,5.9035140390012035
STAT,1853,46,30-34,1899,0.09664954746224041
SIM,1854,33,na,1887,2535
SIM,1959,18,40-44,1977,3
STAT,1834,33,15-19,1867,0.16474875582352988
STAT,1896,34,na,1930,3606.2786229694275
SIM,1925,39,35-39,1964,1
SIM,1945,39,na,1984,4701
SIM,1857,25,15-19,1882,1
SIM,1880,20,15-19,1900,5
STAT,1834,50,na,1884,2096.176528295257
STAT,1861,43,30-34,1904,1.095032181411783
SIM,1793,89,na,1882,58
STAT,1839,81,na,1920,428.85317280191987
SIM,1945,36,40-44,1981,4
STAT,1999,2,na,2001,6709.151311758563
STAT,1908,34,20-24,1942,2.6376572448497484
SIM,1848,19,na,1867,2185
STAT,1947,47,20-24,1994,0.014942809921701638
STAT,1848,50,na,1898,2320.6769826338054
STAT,1917,39,35-39,1956,2.881745946168487
SIM,1994,15,50-100,2009,1
STAT,1891,23,50-100,1914,0.579841609544365
STAT,1904,30,15-19,1934,0.23789773804573497
STAT,1849,25,15-19,1874,0.42289961719128305
STAT,1958,37,na,1995,5874.986650027838
STAT,1860,17,20-24,1877,19.017633141442467
STAT,1864,66,na,1930,1688.9041986896455
SIM,1944,24,30-34,1968,3
SIM,1858,37,25-29,1895,7
SIM,1895,47,na,1942,3433
SIM,1947,43,50-100,1990,2
STAT,1911,23,15-19,1934,5.813142869906261
STAT,1829,34,30-34,1863,21.08084681881889
STAT,1894,28,30-34,1922,37.22683414616153
SIM,1892,24,15-19,1916,6
STAT,1903,24,35-39,1927,9.532180088747593
SIM,1907,35,25-29,1942,1
STAT,1852,34,20-24,1886,2.5844139545278755
STAT,1839,20,30-34,1859,18.413741759959457
STAT,1971,42,35-39,2013,0.3058785371083904
SIM,1901,38,35-39,1939,4
STAT,1837,45,35-39,1882,0.10796750565730973
STAT,1853,29,50-100,1882,0.6617989515268765
SIM,1965,16,15-19,1981,115
STAT,1971,39,35-39,2010,3.634580369083309
STAT,1947,45,na,1992,4990.907800622017
STAT,1898,39,15-19,1937,0.018713795846433165
STAT,1897,46,45-49,1943,0.20601085968978275
STAT,1872,41,40-44,1913,2.6182594469328735
SIM,1853,49,na,1902,2153
STAT,1957,36,25-29,1993,1.5448662708974923
STAT,1840,24,50-100,1864,0.41005965118658083
STAT,1828,45,25-29,1873,0.054451569401278266
SIM,1858,21,45-49,1879,3
SIM,1961,41,na,2002,5590
STAT,1858,31,45-49,1889,1.5863254453825955
SIM,1837,34,30-34,1871,10
SIM,1911,24,35-39,1935,16
SIM,1936,28,na,1964,4009
STAT,1960,17,25-29,1977,65.1361710991994
STAT,1884,24,15-19,1908,3.7380680587142994
SIM,1813,94,na,1907,12
SIM,1969,21,25-29,1990,275
STAT,1953,55,na,2008,5167.319897137299
SIM,1912,66,na,1978,2999
SIM,1941,15,15-19,1956,47
STAT,1891,36,50-100,1927,1.7595802125512972
STAT,1951,39,35-39,1990,3.417183426993019
SIM,1843,41,na,1884,1797
SIM,1938,43,40-44,1981,2
SIM,1943,31,50-100,1974,1
STAT,1956,20,50-100,1976,1.008825099238543
SIM,1958,39,30-34,1997,1
STAT,1839,67,na,1906,1257.1566556050761
SIM,1860,34,20-24,1894,5
STAT,1873,20,30-34,1893,21.116842725166208
STAT,1974,37,50-100,2011,0.6518276875691624
STAT,1931,74,na,2005,3913.842491711296
SIM,1857,42,35-39,1899,7
STAT,1841,71,na,1912,1186.7580822317066
SIM,1921,43,50-100,1964,1
STAT,1901,29,30-34,1930,40.415172090478656
STAT,1943,29,35-39,1972,18.436270003668017
SIM,1877,75,na,1952,1172
STAT,1794,76,na,1870,494.93117284024225
STAT,1826,44,20-24,1870,0.11551943681336883
SIM,1978,24,30-34,2002,1
STAT,1762,101,na,1863,0.173061329831445
STAT,1975,19,50-100,1994,0.5700197699884242
SIM,1934,17,25-29,1951,148
STAT,1817,53,50-100,1870,0.04067353344373769
STAT,1842,27,15-19,1869,0.4317583185192165
STAT,1862,34,15-19,1896,0.13750799408344402
STAT,1920,32,50-100,1952,1.0446836687175296
STAT,1867,23,na,1890,2540.4382196847837
SIM,1850,27,15-19,1877,1
SIM,1866,28,20-24,1894,18
STAT,1858,28,20-24,1886,10.73429567001289
SIM,1851,39,na,1890,2624
SIM,1842,27,20-24,1869,3
STAT,1833,53,20-24,1886,5.282625968474546E-4
STAT,1834,36,na,1870,2456.6199592972043
STAT,1979,13,na,1992,6240.694482419155
STAT,1933,15,15-19,1948,70.46772693174829
STAT,1941,26,20-24,1967,21.80725328370825
STAT,1923,87,na,2010,1279.433997631749
STAT,1834,27,20-24,1861,14.038505753188359
STAT,1876,38,25-29,1914,3.4177846346958063
STAT,1994,17,25-29,2011,72.1680077522767
SIM,1872,52,na,1924,2724
STAT,1928,20,15-19,1948,7.715715916318647
SIM,1862,35,25-29,1897,7
STAT,1805,79,na,1884,356.7519452327956
SIM,1918,34,30-34,1952,5
STAT,1822,53,45-49,1875,0.02587899777870392
SIM,1974,10,na,1984,6402
SIM,1864,57,na,1921,2270
STAT,1878,41,15-19,1919,0.016715524058990287
STAT,1819,93,na,1912,19.45570750654886
STAT,1854,35,25-29,1889,2.381564670836532
STAT,1922,16,na,1938,4925.92639596303
SIM,1936,20,15-19,1956,11
STAT,1888,92,na,1980,284.0511122956593
STAT,1951,48,25-29,1999,0.07561311657644972
SIM,1800,76,na,1876,645
STAT,1926,17,25-29,1943,61.30313638327971
SIM,1947,20,35-39,1967,38
SIM,1908,27,25-29,1935,132
STAT,1850,37,15-19,1887,0.05872351445590335
STAT,1806,94,na,1900,6.859635840521094
SIM,1984,18,20-24,2002,430
SIM,1886,27,35-39,1913,9
STAT,1934,27,25-29,1961,102.23495093067432
STAT,1801,107,na,1908,0.0019794009425538432
STAT,1815,44,45-49,1859,3.1459448406268864
STAT,1775,109,na,1884,0.004300540495883584
SIM,1855,30,30-34,1885,21
SIM,1942,27,25-29,1969,96
STAT,1879,96,na,1975,72.06318104772548
SIM,1862,76,na,1938,1280
STAT,1973,20,35-39,1993,14.109852672639049
SIM,1890,25,35-39,1915,32
SIM,1904,15,na,1919,4399
STAT,1925,25,25-29,1950,90.29674552821773
STAT,1831,95,na,1926,10.431241657859122
STAT,1896,21,15-19,1917,5.0438384260939815
STAT,1866,22,40-44,1888,2.247170634805031
STAT,1878,27,35-39,1905,11.626529969926075
SIM,1872,27,50-100,1899,2
STAT,1914,58,na,1972,3990.6805124530188
SIM,1874,22,40-44,1896,3
SIM,1837,21,na,1858,2504
STAT,1967,46,50-100,2013,0.33998790709512783
STAT,1897,19,45-49,1916,0.10026078950286117
SIM,1886,36,na,1922,2088
STAT,1880,51,40-44,1931,0.012939470639494913
STAT,1774,90,na,1864,1.2053006865114457
STAT,1929,81,na,2010,2606.139036082582
SIM,1914,28,50-100,1942,1
SIM,1911,46,50-100,1957,2
STAT,1930,26,45-49,1956,2.536606680313888
STAT,1939,20,35-39,1959,10.924988231771598
STAT,1912,95,na,2007,218.3816869596145
SIM,1810,54,na,1864,1303
SIM,1876,38,30-34,1914,6
SIM,1933,25,25-29,1958,117
SIM,1960,49,50-100,2009,1
STAT,1845,27,40-44,1872,2.4569664681988823
SIM,1871,37,na,1908,2071
SIM,1887,20,25-29,1907,95
SIM,1831,27,45-49,1858,3
STAT,1818,97,na,1915,2.377008667589194
STAT,1803,51,50-100,1854,0.05591159573330013
SIM,1853,27,40-44,1880,6
STAT,1882,25,35-39,1907,10.950206062909114
STAT,1947,30,35-39,1977,12.122751007740383
STAT,1915,36,20-24,1951,0.30885634672821066
SIM,1930,28,50-100,1958,1
STAT,1849,42,35-39,1891,1.4017762695083595
SIM,1937,8,na,1945,4520
STAT,1868,38,30-34,1906,5.879953356321117
SIM,1986,13,na,1999,6745
SIM,1897,28,na,1925,3686
STAT,1841,21,25-29,1862,64.9420274084223
STAT,1903,46,50-100,1949,0.2283735679108251
SIM,1875,6,na,1881,3650
STAT,1859,23,45-49,1882,0.660336647643254
STAT,1854,24,50-100,1878,0.38476807080903
STAT,1859,36,na,1895,2176.285319707125
STAT,1946,38,15-19,1984,0.025297894297731847
SIM,1866,31,45-49,1897,3
SIM,1964,33,40-44,1997,11
STAT,1871,17,40-44,1888,0.21135205383125366
SIM,1828,35,50-100,1863,3
SIM,1851,82,na,1933,772
STAT,1925,10,na,1935,5538.677114012639
SIM,1976,27,25-29,2003,188
SIM,1894,18,30-34,1912,5
SIM,1880,41,40-44,1921,4
STAT,1841,34,45-49,1875,1.842453218838319
SIM,1862,74,na,1936,1396
SIM,1944,15,na,1959,4066
STAT,1801,63,na,1864,991.7020607199631
STAT,1933,37,50-100,1970,0.6602592496876971
SIM,1818,43,25-29,1861,3
SIM,1847,20,30-34,1867,43
SIM,1916,5,na,1921,4897
STAT,1908,37,25-29,1945,1.0652209779957114
SIM,1959,36,50-100,1995,1
STAT,1956,33,40-44,1989,6.087646890872161
STAT,1847,30,30-34,1877,16.10476853609784
STAT,1886,18,30-34,1904,1.9351516274860485
SIM,1907,15,15-19,1922,14
STAT,1921,60,na,1981,4449.104192135611
STAT,1817,47,15-19,1864,0.0011419379914010448
STAT,1906,28,50-100,1934,1.0727304190512594
STAT,1851,48,na,1899,1761.6946692978786
SIM,1939,20,40-44,1959,5
SIM,1921,29,na,1950,5079
SIM,1848,32,40-44,1880,10
STAT,1893,18,30-34,1911,2.3189153893786076
SIM,1963,21,30-34,1984,103
SIM,1887,39,45-49,1926,4
STAT,1824,47,15-19,1871,5.433545250109011E-4
STAT,1924,46,15-19,1970,5.072271559953172E-4
STAT,1907,25,15-19,1932,0.7756019085212723
SIM,1879,29,45-49,1908,4
SIM,1986,17,na,2003,6269
STAT,1964,47,na,2011,5554.33115858241
STAT,1879,39,45-49,1918,2.3780121528104505
STAT,1897,33,25-29,1930,15.739009048610026
STAT,1848,22,30-34,1870,23.044396538690854
STAT,1922,15,50-100,1937,0.5024938496595996
STAT,1908,19,na,1927,4305.903074945723
STAT,1902,21,50-100,1923,0.6669620200194203
STAT,1992,22,40-44,2014,5.58810049934554
STAT,1853,74,na,1927,1104.9265789853396
STAT,1928,16,50-100,1944,0.546126294406177
STAT,1921,7,na,1928,5256.382615186919
STAT,1967,38,30-34,2005,2.704095239729832
STAT,1853,49,35-39,1902,0.13647637170753374
STAT,1881,2,na,1883,3550.2549910557823
SIM,1826,69,na,1895,996
SIM,1900,27,20-24,1927,2
STAT,1881,51,35-39,1932,0.009628845308491004
SIM,1927,11,na,1938,5252
STAT,1919,70,na,1989,3603.5569821484946
STAT,1981,22,30-34,2003,46.533441391005624
STAT,1941,41,15-19,1982,0.0019002800206981785
STAT,1865,29,15-19,1894,0.46904404622166734
STAT,1916,31,45-49,1947,1.8827196244290447
STAT,1895,21,20-24,1916,103.83233062755103
SIM,1885,37,50-100,1922,4
STAT,1917,36,30-34,1953,2.195235268642489
STAT,1912,27,40-44,1939,5.305920321621626
SIM,1906,41,na,1947,3573
STAT,1804,94,na,1898,8.689926435209864
STAT,1961,34,50-100,1995,1.254950525161257
STAT,1941,40,50-100,1981,0.14556501242713663
SIM,1831,35,40-44,1866,7
STAT,1789,75,na,1864,332.73594220800027
SIM,1925,36,30-34,1961,5
SIM,1875,49,na,1924,2882
STAT,1969,40,50-100,2009,0.17649569100405652
STAT,1931,20,30-34,1951,43.28530258372421
STAT,1976,24,15-19,2000,8.228815518244433
STAT,1886,66,na,1952,1995.1853210948996
STAT,1912,38,na,1950,4220.638267787065
STAT,1858,34,15-19,1892,0.12710997226611215
STAT,1873,15,40-44,1888,0.21811118114460926
STAT,1950,28,20-24,1978,25.003940369104683
STAT,1970,28,40-44,1998,6.759344294462275
SIM,1965,35,45-49,2000,1
STAT,1950,16,50-100,1966,0.5113775728446724
STAT,1875,41,50-100,1916,1.265620518085624
STAT,1951,15,25-29,1966,59.58444230250374
STAT,1984,28,20-24,2012,30.034231000212664
STAT,1857,86,na,1943,199.4246830543284
SIM,1959,23,30-34,1982,46
SIM,1838,45,35-39,1883,1
SIM,1991,19,15-19,2010,78
STAT,1900,21,40-44,1921,3.3469935345245023
STAT,1942,21,45-49,1963,1.3621489579463184
STAT,1840,21,na,1861,2197.0105117116887
SIM,1984,24,15-19,2008,8
STAT,1795,60,na,1855,842.1550100000001
STAT,1853,24,20-24,1877,79.9063650057278
STAT,1985,8,na,1993,6450.843814032133
SIM,1861,24,20-24,1885,121
SIM,1873,37,na,1910,3289
STAT,1783,84,na,1867,78.78446341194935
STAT,1847,25,40-44,1872,2.8106478753481356
STAT,1849,48,30-34,1897,0.07408389187331574
STAT,1950,36,15-19,1986,0.02702098153773241
STAT,1949,47,30-34,1996,0.1244528376654114
STAT,1983,19,15-19,2002,74.04075736803178
STAT,1873,23,35-39,1896,6.855803947308997
SIM,1845,23,25-29,1868,67
STAT,1973,36,40-44,2009,2.3039989705759196
STAT,1973,15,45-49,1988,0.7459827240800049
STAT,1837,23,25-29,1860,53.87578487327949
STAT,1836,33,25-29,1869,11.6649594636273
SIM,1879,34,35-39,1913,4
SIM,1860,19,na,1879,2883
STAT,1854,46,25-29,1900,0.04705977900547617
SIM,1969,31,20-24,2000,11
STAT,1887,36,35-39,1923,9.191599871845476
STAT,1864,37,na,1901,2427.6968296164137
SIM,1975,38,30-34,2013,7
SIM,1876,17,25-29,1893,3
SIM,1899,31,40-44,1930,13
STAT,1868,17,25-29,1885,6.396845566828132
STAT,1984,15,20-24,1999,222.33456966865828
SIM,1895,36,35-39,1931,15
STAT,1827,34,20-24,1861,4.256171436045494
STAT,1977,5,na,1982,6130.842490309866
STAT,1877,24,15-19,1901,3.935504502357964
SIM,1974,29,25-29,2003,117
STAT,1939,37,20-24,1976,0.31385438996787657
STAT,1969,25,30-34,1994,56.78024519166362
STAT,1900,44,30-34,1944,0.12611907888702031
STAT,1836,44,15-19,1880,0.01457811595068669
SIM,1989,25,45-49,2014,6
SIM,1844,33,25-29,1877,26
SIM,1850,24,45-49,1874,1
SIM,1984,21,45-49,2005,4
SIM,1830,24,25-29,1854,71
SIM,1895,35,30-34,1930,4
SIM,1903,20,20-24,1923,109
SIM,1908,24,20-24,1932,213
SIM,1974,26,20-24,2000,3
SIM,1840,29,20-24,1869,24
STAT,1865,35,45-49,1900,2.0954435960430846
SIM,1864,35,35-39,1899,15
SIM,1919,24,30-34,1943,3
STAT,1888,47,na,1935,3037.8479051795084
STAT,1897,24,35-39,1921,8.948554243282949
SIM,1969,34,25-29,2003,28
SIM,1936,40,50-100,1976,1
STAT,1871,93,na,1964,92.87886970324632
STAT,1932,32,40-44,1964,6.005057608809276
SIM,1925,30,na,1955,5225
STAT,1882,85,na,1967,615.1810096448229
STAT,1947,25,45-49,1972,2.2574926254229344
STAT,1879,11,na,1890,3116.6160109706675
SIM,1913,30,30-34,1943,35
SIM,1940,32,40-44,1972,9
SIM,1817,87,na,1904,40
STAT,1880,54,45-49,1934,0.01726400997395419
SIM,1841,91,na,1932,21
STAT,1897,16,40-44,1913,0.28293709089630303
SIM,1827,49,50-100,1876,1
STAT,1842,24,45-49,1866,0.6671347202562113
STAT,1959,36,35-39,1995,3.7651510364643177
SIM,1869,20,15-19,1889,5
SIM,1835,34,20-24,1869,1
SIM,1885,38,40-44,1923,14
STAT,1980,16,50-100,1996,0.6003982098630404
SIM,1903,3,na,1906,4334
STAT,1916,19,30-34,1935,2.968701250205494
STAT,1909,34,15-19,1943,0.14046416533887265
STAT,1887,35,30-34,1922,6.958327978856098
SIM,1802,59,na,1861,1082
STAT,1815,57,na,1872,1413.731807424251
SIM,1824,31,40-44,1855,11
STAT,1798,57,na,1855,932.35089
SIM,1856,32,50-100,1888,6
STAT,1863,35,35-39,1898,7.205141269450109
SIM,1949,46,na,1995,5740
STAT,1867,77,na,1944,931.3725352439527
SIM,1934,22,15-19,1956,4
SIM,1854,79,na,1933,800
STAT,1811,49,30-34,1860,0.2917518718993565
SIM,1879,26,40-44,1905,3
SIM,1829,35,40-44,1864,7
SIM,1881,32,25-29,1913,15
STAT,1811,52,30-34,1863,0.017716363364159823
SIM,1886,36,25-29,1922,1
SIM,1955,25,45-49,1980,3
STAT,1877,84,na,1961,597.0207979921603
SIM,1864,86,na,1950,252
STAT,1897,30,20-24,1927,4.204709913233078
STAT,1924,26,na,1950,5049.579855614619
STAT,1905,30,30-34,1935,29.397774909698803
STAT,1910,18,40-44,1928,0.31933724665119856
STAT,1920,33,na,1953,4758.595199440758
STAT,1955,32,na,1987,5906.1187669938345
STAT,1894,45,15-19,1939,3.380727518948393E-4
STAT,1828,75,na,1903,683.2533802823438
STAT,1927,34,25-29,1961,13.101171129376633
STAT,1980,17,45-49,1997,0.8003067978190382
SIM,1870,23,25-29,1893,1
STAT,1856,35,35-39,1891,6.286490490051845
STAT,1987,24,25-29,2011,152.5775377380817
SIM,1914,78,na,1992,2143
STAT,1852,46,15-19,1898,3.781957836033483E-4
STAT,1957,16,15-19,1973,69.07308269148871
STAT,1831,48,45-49,1879,0.2158702132860115
SIM,1865,43,50-100,1908,4
SIM,1825,84,na,1909,368
STAT,1832,29,20-24,1861,10.824518102249767
STAT,1959,28,40-44,1987,7.063220898347928
STAT,1862,23,25-29,1885,56.664297872013776
STAT,1916,30,na,1946,4542.88419511245
SIM,1943,24,15-19,1967,9
STAT,1992,19,25-29,2011,71.73601814271922
SIM,1924,31,45-49,1955,1
SIM,1834,23,15-19,1857,1
STAT,1838,82,na,1920,404.15838241710134
STAT,1936,24,30-34,1960,31.708216705587198
SIM,1839,24,45-49,1863,2
SIM,1974,32,40-44,2006,13
SIM,1899,54,na,1953,3425
STAT,1986,15,50-100,2001,0.6164079256449422
SIM,1869,43,30-34,1912,1
SIM,1824,57,na,1881,1116
STAT,1878,36,25-29,1914,3.4860025981835125
STAT,1926,22,15-19,1948,7.461726170509191
SIM,1855,33,35-39,1888,2
SIM,1849,15,15-19,1864,10
STAT,1906,42,40-44,1948,0.26253128858040214
STAT,1919,18,50-100,1937,0.47644010470453607
SIM,1952,10,na,1962,4844
STAT,1847,33,35-39,1880,9.054659745217466
STAT,1898,36,45-49,1934,3.124166755261397
STAT,1820,87,na,1907,103.40044714915537
STAT,1877,47,30-34,1924,0.11566132403455455
STAT,1992,16,20-24,2008,224.64164554183222
SIM,1853,2,na,1855,3415
STAT,1931,23,35-39,1954,14.053026400594412
SIM,1823,72,na,1895,1111
SIM,1982,24,na,2006,5945
STAT,1927,17,40-44,1944,2.006600988481491
STAT,1866,19,50-100,1885,0.05315744299628595
SIM,1832,24,35-39,1856,8
SIM,1934,38,30-34,1972,2
SIM,1945,20,25-29,1965,1
STAT,1841,43,35-39,1884,1.6516704077798845
STAT,1916,30,50-100,1946,0.9931185841212676
STAT,1981,25,35-39,2006,24.35350110838799
STAT,1887,33,30-34,1920,22.48576227087583
SIM,1955,24,40-44,1979,12
STAT,1842,48,20-24,1890,0.0091182738354757
SIM,1813,65,na,1878,1041
SIM,1838,21,25-29,1859,61
STAT,1888,47,40-44,1935,0.2311628301894372
SIM,1924,30,50-100,1954,6
STAT,1848,45,45-49,1893,0.25325647389860273
STAT,1947,24,40-44,1971,4.38238519039139
STAT,1873,18,45-49,1891,0.07678021659412394
STAT,1931,15,40-44,1946,2.123087404472284
STAT,1833,76,na,1909,666.6630348450834
SIM,1977,24,15-19,2001,8
STAT,1874,38,15-19,1912,0.06601458734092487
SIM,1931,29,15-19,1960,1
STAT,1898,33,40-44,1931,6.735347784524667
SIM,1935,17,40-44,1952,4
SIM,1910,16,25-29,1926,14
SIM,1851,27,30-34,1878,4
SIM,1896,47,40-44,1943,1
STAT,1859,107,na,1966,0.034963910263321976
STAT,1866,78,na,1944,835.761801676987
STAT,1977,27,35-39,2004,23.511758179215363
SIM,1834,20,45-49,1854,1
STAT,1843,27,30-34,1870,31.09560326521204
SIM,1854,16,35-39,1870,1
SIM,1879,31,30-34,1910,50
STAT,1881,36,40-44,1917,4.896178468673828
STAT,1820,109,na,1929,4.175555140232604E-4
STAT,1946,27,50-100,1973,1.2795401185445132
STAT,1863,34,30-34,1897,17.467933297554392
STAT,1961,50,na,2011,5646.205910985916
STAT,1902,16,25-29,1918,9.263020549747326
STAT,1895,24,25-29,1919,85.45556163555729
STAT,1893,28,15-19,1921,0.6594946844623772
SIM,1959,1,na,1960,6033
STAT,1842,106,na,1948,0.009343336755716693
STAT,1873,32,25-29,1905,12.070805261097664
STAT,1846,16,35-39,1862,0.7167970827536493
STAT,1923,29,15-19,1952,0.9283405087118841
STAT,1872,20,15-19,1892,3.8457260196192804
STAT,1918,40,na,1958,4568.675884705307
STAT,1908,33,na,1941,4107.740279194463
SIM,1919,30,25-29,1949,22
STAT,1963,26,40-44,1989,6.866468212636417
SIM,1868,40,45-49,1908,2
SIM,1888,36,35-39,1924,4
SIM,1913,25,40-44,1938,8
STAT,1877,38,40-44,1915,5.228886471663264
SIM,1906,18,25-29,1924,9
STAT,1905,25,40-44,1930,5.037503026327468
SIM,1985,27,35-39,2012,3
STAT,1862,17,30-34,1879,1.7778744054264497
SIM,1824,34,45-49,1858,1
SIM,1901,47,25-29,1948,1
SIM,1941,58,na,1999,3649
STAT,1953,15,35-39,1968,5.861156835094666
SIM,1885,70,na,1955,2018
STAT,1832,35,40-44,1867,3.93018907845782
SIM,1870,71,na,1941,1887
SIM,1863,49,45-49,1912,1
STAT,1842,21,40-44,1863,2.0371676285498626
SIM,1885,47,30-34,1932,1
SIM,1873,35,45-49,1908,8
SIM,1968,38,30-34,2006,1
SIM,1895,33,30-34,1928,37
SIM,1840,35,40-44,1875,8
SIM,1898,22,35-39,1920,21
STAT,1862,56,na,1918,1986.465674518812
STAT,1930,11,na,1941,5921.3119143022905
STAT,1875,74,na,1949,1323.5287676997466
SIM,1860,64,na,1924,1747
STAT,1899,39,30-34,1938,1.8004674454594816
SIM,1804,69,na,1873,670
STAT,1847,28,45-49,1875,1.0194852909539047
STAT,1831,23,30-34,1854,40.73952400280443
SIM,1991,22,40-44,2013,4
STAT,1855,49,45-49,1904,0.1966185602883021
SIM,1899,34,45-49,1933,6
STAT,1953,21,20-24,1974,155.79829049523894
SIM,1840,76,na,1916,310
STAT,1846,30,15-19,1876,0.1776263638179451
STAT,1832,24,na,1856,1916.4700509790346
STAT,1837,20,20-24,1857,68.49196058386751
SIM,1854,22,20-24,1876,144
SIM,1981,15,45-49,1996,1
STAT,1954,27,45-49,1981,2.475378141365252
SIM,1952,38,40-44,1990,6
SIM,1851,68,na,1919,1732
SIM,1894,24,25-29,1918,204
SIM,1894,30,45-49,1924,8
SIM,1909,35,35-39,1944,3
SIM,1962,27,45-49,1989,3
STAT,1886,24,25-29,1910,69.24947647977606
STAT,1979,24,40-44,2003,5.35673581143037
STAT,1839,45,45-49,1884,0.19564089225557152
STAT,1887,62,na,1949,2363.846744801734
STAT,1867,38,15-19,1905,0.06020578128511083
SIM,1870,34,15-19,1904,5
SIM,1974,35,45-49,2009,1
STAT,1958,25,20-24,1983,27.811916953512068
STAT,1846,22,20-24,1868,87.90093875385448
SIM,1811,84,na,1895,265
SIM,1841,18,15-19,1859,7
STAT,1824,37,50-100,1861,1.8822303212520506
STAT,1962,31,15-19,1993,0.19380120348167965
STAT,1900,27,50-100,1927,1.0243750292429303
SIM,1938,20,25-29,1958,193
SIM,1832,37,50-100,1869,1
STAT,1940,17,15-19,1957,53.194892783634074
STAT,1937,39,45-49,1976,0.7854495249143542
STAT,1899,65,na,1964,2919.87343114686
SIM,1845,20,20-24,1865,3
SIM,1862,43,20-24,1905,1
STAT,1944,38,40-44,1982,1.9135394177438394
STAT,1876,35,20-24,1911,0.9283400357012389
SIM,1845,39,40-44,1884,9
SIM,1961,21,20-24,1982,147
STAT,1831,24,35-39,1855,7.543439933678339
STAT,1952,28,30-34,1980,54.39642314939428
SIM,1988,22,25-29,2010,10
SIM,1884,35,20-24,1919,2
SIM,1904,23,40-44,1927,12
SIM,1960,28,30-34,1988,130
SIM,1814,45,40-44,1859,1
SIM,1866,19,30-34,1885,2
STAT,1858,19,30-34,1877,1.6565111718228285
SIM,1825,37,30-34,1862,8
SIM,1906,32,50-100,1938,2
SIM,1912,12,na,1924,4197
STAT,1981,24,30-34,2005,46.501804025472225
STAT,1897,21,30-34,1918,27.569721368264787
STAT,1958,33,15-19,1991,0.1984198432345812
STAT,1836,27,30-34,1863,29.664820158165234
STAT,1783,106,na,1889,0.00991111743076828
STAT,1943,26,30-34,1969,48.18457128877569
STAT,1936,41,15-19,1977,0.001758612962054309
SIM,1844,27,30-34,1871,57
STAT,1927,31,20-24,1958,3.4639179164458693
STAT,1891,25,45-49,1916,1.594389499072006
STAT,1986,28,30-34,2014,64.67897854387526
STAT,1942,1,na,1943,5000.828850049367
SIM,1903,44,30-34,1947,1
STAT,1830,45,25-29,1875,0.054548458691278286
STAT,1821,35,30-34,1856,13.165465995664633
STAT,1823,98,na,1921,1.8396093596518637
SIM,1846,38,na,1884,1626
SIM,1934,33,50-100,1967,1
SIM,1866,67,na,1933,1589
SIM,1951,26,30-34,1977,90
STAT,1826,39,30-34,1865,4.094060402306941
STAT,1866,54,50-100,1920,0.015710587945234656
SIM,1935,25,35-39,1960,55
SIM,1957,23,20-24,1980,191
SIM,1888,6,na,1894,3149
SIM,1916,59,na,1975,4172
SIM,1855,75,na,1930,572
SIM,1949,21,na,1970,5470
SIM,1968,3,na,1971,5403
SIM,2001,9,na,2010,7320
SIM,1901,20,na,1921,3875
STAT,1817,37,30-34,1854,23.98146334078739
STAT,1778,83,na,1861,171.60671304031933
STAT,1872,100,na,1972,10.81068271293258
STAT,1966,35,45-49,2001,1.0141220255235317
SIM,1940,22,na,1962,4418
SIM,1897,73,na,1970,2035
STAT,1928,37,45-49,1965,0.9942501748420219
STAT,1958,19,35-39,1977,6.355989550661633
SIM,1987,24,40-44,2011,2
SIM,1939,14,na,1953,5015
STAT,1937,20,25-29,1957,103.93411177797358
SIM,1913,33,35-39,1946,1
SIM,1935,31,20-24,1966,6
STAT,1996,17,35-39,2013,7.037665896575562
SIM,1828,26,35-39,1854,23
STAT,1926,38,30-34,1964,2.5674253995989758
SIM,1868,34,25-29,1902,2
SIM,1944,27,35-39,1971,42
SIM,1828,32,20-24,1860,5
SIM,1966,25,20-24,1991,38
STAT,1999,15,na,2014,6278.639650458793
SIM,1858,71,na,1929,1701
SIM,1936,37,45-49,1973,1
SIM,1966,19,35-39,1985,2
STAT,1971,36,30-34,2007,2.7470665127370077
SIM,1860,37,25-29,1897,4
STAT,1957,13,na,1970,5975.923230031244
SIM,1909,27,40-44,1936,12
STAT,1984,16,na,2000,6034.686351972106
SIM,1890,25,50-100,1915,3
STAT,1788,90,na,1878,45.83602771857499
STAT,1967,20,na,1987,5285.355000399966
STAT,1927,25,35-39,1952,21.20209550502871
STAT,1856,3,na,1859,2941.37274639875
STAT,1987,21,20-24,2008,183.85907914273676
STAT,1949,23,20-24,1972,149.68597293119822
STAT,1852,37,25-29,1889,2.7292750373140198
STAT,1868,22,15-19,1890,3.6578510377872724
STAT,1893,43,50-100,1936,0.1062417304728478
STAT,1886,30,45-49,1916,2.1398373554199472
STAT,1905,33,35-39,1938,9.671871969441208
STAT,1918,48,40-44,1966,0.19304385324664253
STAT,1891,34,35-39,1925,14.320751010811662
STAT,1854,42,35-39,1896,1.4734482316372117
STAT,1984,19,30-34,2003,19.964835921385458
SIM,1969,37,30-34,2006,6
STAT,1896,43,25-29,1939,0.06748102076322204
SIM,1838,71,na,1909,702
SIM,1860,29,30-34,1889,4
SIM,1955,24,50-100,1979,1
STAT,1898,9,na,1907,4046.7981928388663
STAT,1857,38,20-24,1895,0.6894106884820175
STAT,1852,29,30-34,1881,24.80425032373301
STAT,1801,94,na,1895,8.388644816636264
SIM,1821,40,25-29,1861,1
STAT,1837,29,35-39,1866,8.839569370449667
STAT,1867,110,na,1977,0.01017095493404206
STAT,1838,51,na,1889,1892.2740821236202
STAT,1946,40,25-29,1986,0.09525274427891077
STAT,1894,44,30-34,1938,0.11684012623832515
SIM,1878,33,50-100,1911,2
SIM,1825,45,na,1870,1661
SIM,1955,38,na,1993,6506
STAT,1875,16,20-24,1891,21.194892803888052
STAT,1852,86,na,1938,209.18784638405398
SIM,1883,16,20-24,1899,18
STAT,1888,35,45-49,1923,2.7299966189055467
STAT,1877,6,na,1883,3249.525039909974
SIM,1992,19,30-34,2011,49
SIM,1886,67,na,1953,1207
SIM,1884,32,na,1916,2706
SIM,1848,39,30-34,1887,3
SIM,1914,16,na,1930,4173
SIM,1988,7,na,1995,6634
STAT,1973,30,30-34,2003,23.996775376306747
SIM,1954,22,25-29,1976,3
STAT,1940,36,20-24,1976,0.31861883983491224
SIM,1876,37,na,1913,2646
STAT,1929,57,na,1986,5254.394016539074
STAT,1811,45,20-24,1856,0.038690225331011054
SIM,1985,23,25-29,2008,153
SIM,1972,16,50-100,1988,1
SIM,1851,23,20-24,1874,5
STAT,1893,17,25-29,1910,8.266161841174105
SIM,1864,39,45-49,1903,4
STAT,1979,26,50-100,2005,1.58914381221773
STAT,1843,23,20-24,1866,86.1685699211903
STAT,1813,99,na,1912,0.8671492234431277
SIM,1869,63,na,1932,1359
STAT,1944,26,na,1970,4674.880306773885
SIM,1870,32,na,1902,3063
SIM,1926,22,20-24,1948,7
SIM,1938,32,50-100,1970,3
SIM,1981,30,30-34,2011,2
STAT,1876,51,50-100,1927,0.018103466536227915
STAT,1977,23,25-29,2000,144.45948460883275
STAT,1845,51,25-29,1896,0.002398222710815366
STAT,1918,22,20-24,1940,138.37115158621475
SIM,1837,32,30-34,1869,7
STAT,1906,52,na,1958,3666.9319783781616
STAT,1906,60,na,1966,3473.1405950533435
SIM,1851,38,20-24,1889,2
STAT,1864,16,45-49,1880,0.07697178469501781
STAT,1914,46,20-24,1960,0.012685920434461588
STAT,1865,44,35-39,1909,1.8600698511886922
STAT,1882,47,45-49,1929,0.2647825284485581
STAT,1982,21,40-44,2003,5.480062058508364
STAT,1883,30,na,1913,2716.0230916259798
STAT,1889,46,15-19,1935,5.706428027857882E-4
SIM,1880,25,40-44,1905,7
SIM,1887,44,35-39,1931,5
STAT,1849,26,20-24,1875,10.856462602540253
STAT,1875,43,na,1918,2736.4625180957723
STAT,1979,33,30-34,2012,25.50258462621806
STAT,1865,32,40-44,1897,4.515632384287874
STAT,1779,90,na,1869,25.587651181401803
STAT,1975,28,20-24,2003,27.897760473724794
STAT,1968,32,15-19,2000,0.18880756954987088
SIM,1825,33,20-24,1858,5
STAT,1846,38,45-49,1884,2.129855275819227
STAT,1868,26,50-100,1894,0.7117042391167283
STAT,1829,32,30-34,1861,22.647639545667232
SIM,1990,21,40-44,2011,5
STAT,1843,38,20-24,1881,0.813187800936183
SIM,1856,37,na,1893,2137
STAT,1971,35,25-29,2006,1.4852653358500656
STAT,1879,26,35-39,1905,11.66704223066617
STAT,1976,23,20-24,1999,171.94986689557942
SIM,1915,87,na,2002,1754
SIM,1835,37,25-29,1872,3
SIM,1854,38,45-49,1892,6
STAT,1907,22,45-49,1929,1.1840343800879094
SIM,1909,77,na,1986,3070
STAT,1841,28,15-19,1869,0.49742313808969
STAT,1965,23,45-49,1988,1.6259237091615457
SIM,1873,44,35-39,1917,6
STAT,1879,44,35-39,1923,2.152611015563363
STAT,1881,15,35-39,1896,0.6136219077841535
SIM,1890,47,45-49,1937,1
SIM,1818,71,na,1889,1171
SIM,1913,62,na,1975,3984
STAT,1821,94,na,1915,12.223318973392063
STAT,1961,18,na,1979,5486.257080301934
STAT,1928,85,na,2013,1780.489284139062
SIM,1802,88,na,1890,49
SIM,1938,21,30-34,1959,70
STAT,1820,36,30-34,1856,13.50656871438795
SIM,1922,11,na,1933,5495
SIM,1887,26,35-39,1913,1
STAT,1997,11,na,2008,6620.636839534567
SIM,1919,27,35-39,1946,45
STAT,1903,46,45-49,1949,0.21944691415093762
SIM,1836,52,35-39,1888,1
STAT,1877,30,na,1907,2887.661330777443
SIM,1890,40,na,1930,3301
STAT,1829,50,30-34,1879,0.006101480624857435
STAT,1863,19,35-39,1882,0.5682147406369117
STAT,1828,52,35-39,1880,0.007657069715342376
SIM,1983,28,20-24,2011,34
STAT,1832,53,40-44,1885,0.007453230195807233
STAT,1870,12,na,1882,3013.066496888281
STAT,1975,18,na,1993,5602.049106038143
STAT,1912,60,na,1972,3797.9315668983654
SIM,1894,21,20-24,1915,3
STAT,1977,21,15-19,1998,8.330595006133153
SIM,1969,36,na,2005,5743
STAT,1885,73,na,1958,1476.0280893287452
SIM,1842,18,30-34,1860,3
SIM,1863,25,35-39,1888,30
STAT,1838,43,na,1881,2103.470305874163
SIM,1947,15,45-49,1962,1
SIM,1944,54,na,1998,4416
STAT,1840,17,45-49,1857,0.06784607922861892
STAT,1960,0,na,1960,5953.628348244183
STAT,1930,47,15-19,1977,5.599121206370154E-4
SIM,1911,43,40-44,1954,1
STAT,1897,40,35-39,1937,0.19600184064207504
STAT,1970,37,30-34,2007,2.712581295172302
STAT,1839,42,40-44,1881,1.880034019677469
STAT,1859,50,45-49,1909,0.013533051141765059
STAT,1890,21,40-44,1911,2.94729228596941
STAT,1874,9,na,1883,3152.1533480082103
STAT,1814,41,25-29,1855,2.232200674571695
STAT,1853,45,25-29,1898,0.05791938482557693
STAT,1855,25,35-39,1880,9.540683577731746
SIM,1972,28,45-49,2000,2
SIM,1838,63,na,1901,1237
STAT,1864,34,45-49,1898,1.7815224905911395
SIM,1875,27,25-29,1902,3
STAT,1989,16,na,2005,6085.956936231136
SIM,1819,36,30-34,1855,2
SIM,1845,44,30-34,1889,2
STAT,1927,14,na,1941,5665.885427887261
STAT,1844,36,15-19,1880,0.05511134712889667
STAT,1869,35,na,1904,2658.066150269751
STAT,1978,4,na,1982,6193.768650806846
STAT,1873,48,na,1921,2618.0994065034924
STAT,1903,43,40-44,1946,0.2548939818795355
SIM,1852,21,15-19,1873,6
SIM,1931,28,na,1959,5634
STAT,1975,32,50-100,2007,1.28309195699768
SIM,1878,39,45-49,1917,1
STAT,1849,31,45-49,1880,1.5814232285465855
STAT,1935,67,na,2002,5031.981713065578
STAT,1886,21,20-24,1907,84.14121211089311
STAT,1821,40,50-100,1861,2.131752054638917
STAT,1895,27,30-34,1922,37.828047704972256
STAT,1849,44,20-24,1893,0.12142943738097547
STAT,1980,26,35-39,2006,24.16782109523313
SIM,1906,31,35-39,1937,11
STAT,1899,17,20-24,1916,28.030056842593652
SIM,1847,42,40-44,1889,3
STAT,1830,28,40-44,1858,3.594500874564478
STAT,1849,35,na,1884,1907.735167457297
SIM,1828,48,45-49,1876,1
SIM,1857,31,45-49,1888,1
STAT,1862,25,na,1887,2366.7452885943794
STAT,1784,77,na,1861,347.14649983355383
STAT,1853,27,25-29,1880,48.78961864210851
STAT,1829,35,35-39,1864,8.444280202766087
SIM,1857,26,20-24,1883,3
STAT,1869,52,25-29,1921,0.003937509469923683
SIM,1916,15,15-19,1931,20
SIM,1861,27,25-29,1888,69
STAT,1939,15,45-49,1954,0.5787173155540483
STAT,1844,21,15-19,1865,3.4701795623889593
STAT,1987,27,30-34,2014,64.83224818176085
STAT,1825,34,50-100,1859,1.6714863096336217
STAT,1889,35,na,1924,3383.3707080435124
SIM,1870,36,35-39,1906,20
STAT,1838,41,40-44,1879,2.3083578765015416
STAT,1855,43,35-39,1898,1.529682881971859
SIM,1942,69,na,2011,3897
SIM,1840,38,50-100,1878,1
STAT,1965,39,15-19,2004,0.02844357557880185
SIM,1822,88,na,1910,3
STAT,1818,46,15-19,1864,5.00817838927241E-4
STAT,1861,39,25-29,1900,2.734521021708096
STAT,1913,34,na,1947,4307.615954805694
STAT,1924,21,35-39,1945,12.857392092029912
STAT,1853,6,na,1859,2987.8870926993245
SIM,1976,15,50-100,1991,1
STAT,1840,31,25-29,1871,10.11226133710961
STAT,1992,1,na,1993,6522.491060353761
STAT,1908,15,15-19,1923,10.219623559967555
SIM,1945,17,35-39,1962,13
STAT,1929,49,na,1978,5463.476550165709
STAT,1881,30,30-34,1911,19.591140191789343
STAT,1937,17,35-39,1954,4.7135519509598724
STAT,1939,33,45-49,1972,1.852491132106006
SIM,1877,106,na,1983,1
SIM,1893,40,45-49,1933,5
SIM,1804,91,na,1895,61
SIM,2006,8,na,2014,7580
STAT,1943,52,na,1995,4598.197858011868
STAT,1885,40,45-49,1925,1.740180006349975
STAT,1993,21,15-19,2014,8.870702103353022
SIM,1930,54,na,1984,5791
STAT,1934,9,na,1943,6217.077857192597
STAT,1895,42,25-29,1937,0.06690432709469725
STAT,1837,44,30-34,1881,0.8713342825340337
SIM,1845,26,30-34,1871,38
STAT,1954,30,50-100,1984,1.2037119000026775
SIM,1846,41,40-44,1887,8
STAT,1977,35,20-24,2012,0.42421145577021824
STAT,1990,18,45-49,2008,0.8253318391671696
SIM,1879,85,na,1964,337
STAT,1847,35,50-100,1882,1.000728252352617
SIM,1929,34,40-44,1963,11
SIM,1887,29,na,1916,3831
STAT,1818,43,na,1861,1296.4147015411297
STAT,1874,50,40-44,1924,0.012616599724221769
STAT,1980,22,15-19,2002,8.55637076871499
STAT,1822,56,na,1878,1831.493623100905
SIM,1957,33,na,1990,6273
STAT,1875,51,40-44,1926,0.012615298537956668
SIM,1946,46,50-100,1992,1
STAT,1880,17,40-44,1897,0.2237345633477842
STAT,1885,7,na,1892,2999.049627988882
SIM,1883,51,40-44,1934,1
SIM,1932,21,35-39,1953,36
SIM,1867,18,30-34,1885,2
STAT,1842,31,50-100,1873,0.8606373312037057
SIM,1900,36,na,1936,3591
STAT,1859,18,30-34,1877,1.6908321925778689
STAT,1899,35,20-24,1934,1.2303411568748646
SIM,1850,40,na,1890,1597
SIM,1892,75,na,1967,2285
STAT,1881,35,na,1916,2647.413014440951
STAT,1909,49,na,1958,3877.354984401039
SIM,1985,20,20-24,2005,6
SIM,1872,75,na,1947,1640
STAT,1856,54,40-44,1910,0.009014168331182749
STAT,1980,29,40-44,2009,7.492236285238811
SIM,1815,43,35-39,1858,3
STAT,1880,32,35-39,1912,12.387844756280721
STAT,1930,34,na,1964,5626.23544676834
SIM,1944,46,na,1990,4536
STAT,1862,20,20-24,1882,69.70336219871194
STAT,1802,106,na,1908,0.005795928561397317
STAT,1830,25,35-39,1855,13.45082011818796
SIM,1858,40,na,1898,2528
STAT,1858,18,15-19,1876,6.204332032741487
STAT,1896,40,20-24,1936,0.016979910463557468
STAT,1990,15,40-44,2005,2.312895118361129
STAT,1846,52,25-29,1898,0.0036421765688756467
SIM,1798,58,na,1856,1222
STAT,1829,53,35-39,1882,0.00756645374123322
STAT,1883,28,20-24,1911,13.199265619195893
SIM,1791,79,na,1870,349
STAT,1839,21,50-100,1860,0.4185332664103876
STAT,1820,39,35-39,1859,9.603586902573618
SIM,1898,12,na,1910,4166
SIM,1891,28,20-24,1919,25
STAT,1860,25,15-19,1885,0.43270551997996737
SIM,1866,18,15-19,1884,11
SIM,1842,17,15-19,1859,9
SIM,1897,59,na,1956,2902
SIM,1933,23,50-100,1956,1
SIM,1872,31,40-44,1903,11
STAT,1844,53,30-34,1897,0.004898906320168457
STAT,1856,48,na,1904,1955.980978176301
SIM,1837,35,35-39,1872,14
SIM,1830,34,40-44,1864,3
STAT,1867,27,25-29,1894,45.5792914819213
STAT,1875,54,45-49,1929,0.01683149534100221
SIM,1847,21,35-39,1868,7
STAT,1830,42,20-24,1872,0.1525468633446804
STAT,1871,42,50-100,1913,1.2114469369298322
STAT,1834,35,15-19,1869,0.06508076996232583
STAT,1894,47,35-39,1941,0.1166113578668901
SIM,1880,70,na,1950,1851
STAT,1875,19,25-29,1894,6.721871997552783
STAT,1944,15,25-29,1959,53.85024954589818
STAT,1822,34,40-44,1856,12.4402641833716
STAT,1969,25,50-100,1994,1.4423808785379633
SIM,1870,20,20-24,1890,3
SIM,1894,37,35-39,1931,24
STAT,1876,32,15-19,1908,0.16988934354327276
STAT,1979,17,40-44,1996,2.222533158036163
STAT,1890,20,na,1910,3354.9013403546105
SIM,1926,25,25-29,1951,175
SIM,1867,29,na,1896,2288
STAT,1839,21,35-39,1860,5.989210341335579
SIM,1890,44,40-44,1934,8
SIM,1967,4,na,1971,5784
STAT,1890,26,50-100,1916,0.9051387336460399
SIM,1950,20,50-100,1970,1
STAT,1964,42,25-29,2006,0.10786716539374691
SIM,1963,51,na,2014,6350
STAT,1888,112,na,2000,0.005773399257341823
SIM,1902,20,50-100,1922,1
STAT,1891,22,40-44,1913,2.972174428186006
STAT,1965,20,40-44,1985,4.863713610351613
STAT,1971,35,50-100,2006,0.6333445247794124
STAT,1868,37,15-19,1905,0.062262360103692994
SIM,1956,49,na,2005,5301
SIM,1883,21,45-49,1904,1
STAT,1876,47,15-19,1923,4.749664502809869E-4
STAT,1918,65,na,1983,3932.0460965142884
STAT,1886,33,15-19,1919,0.1726228931800981
STAT,1982,24,45-49,2006,1.8319853256486562
STAT,1984,24,na,2008,6001.223374759262
STAT,1836,48,na,1884,2115.4402749486626
STAT,1897,30,na,1927,3711.996920727284
STAT,1882,44,40-44,1926,2.5011940916171245
STAT,1803,51,20-24,1854,0.0027318370332403796
STAT,1955,18,na,1973,5637.165009077211
STAT,1943,48,40-44,1991,0.2001533766082735
SIM,1979,26,35-39,2005,26
STAT,1918,25,25-29,1943,81.36893918879272
STAT,1806,48,45-49,1854,0.855791296651069
STAT,1849,29,25-29,1878,38.30920203363693
SIM,1829,43,35-39,1872,7
SIM,1862,42,35-39,1904,10
STAT,1891,19,15-19,1910,8.419163969162728
STAT,1989,22,35-39,2011,15.615835658274522
STAT,1957,45,15-19,2002,5.857491199729508E-4
SIM,1928,20,30-34,1948,48
SIM,1849,19,25-29,1868,15
STAT,1854,81,na,1935,440.55921102015424
SIM,1990,24,45-49,2014,4
STAT,1917,93,na,2010,393.88338124671355
STAT,1836,30,20-24,1866,3.175828961291374
STAT,1836,49,40-44,1885,0.15898450330749847
STAT,1839,54,35-39,1893,0.006639663168940172
STAT,1854,50,50-100,1904,0.012480980474071184
STAT,1907,14,na,1921,4370.839098574763
STAT,1818,51,na,1869,1171.8913771954026
STAT,1870,26,15-19,1896,0.5179597759334456
SIM,1962,39,40-44,2001,4
STAT,1804,52,20-24,1856,0.0033965988638623157
SIM,1938,24,35-39,1962,23
STAT,1979,36,35-39,2015,3.9632022135271376
SIM,1862,45,na,1907,2796
STAT,1807,99,na,1906,0.9261085713415103
STAT,1986,17,40-44,2003,2.3000373103250626
STAT,1971,32,20-24,2003,3.6341327856129904
STAT,1833,48,50-100,1881,0.18313050577009513
SIM,1844,49,40-44,1893,1
SIM,1862,50,50-100,1912,1
STAT,1847,49,15-19,1896,3.013552391613654E-4
STAT,1853,42,20-24,1895,0.15792260212982887
SIM,1894,19,35-39,1913,4
SIM,1843,19,na,1862,2271
STAT,1902,49,50-100,1951,0.22118860381598024
STAT,1833,34,15-19,1867,0.12746604155719843
SIM,1890,26,40-44,1916,1
STAT,1937,70,na,2007,3356.7571836465095
SIM,1881,23,35-39,1904,14
SIM,1863,22,30-34,1885,2
STAT,1827,37,25-29,1864,4.210752642930174
STAT,1838,100,na,1938,0.9196075842052385
SIM,1818,38,50-100,1856,8
STAT,1864,27,50-100,1891,0.6591656337926148
STAT,1878,28,40-44,1906,3.5968158604911786
SIM,1886,28,40-44,1914,8
STAT,1900,47,35-39,1947,0.12587214269127345
SIM,1869,55,na,1924,1663
STAT,1851,47,15-19,1898,3.157188727267275E-4
SIM,1857,29,25-29,1886,92
SIM,1832,46,45-49,1878,1
STAT,1888,61,na,1949,2534.943549781685
STAT,1820,35,15-19,1855,0.15531819121912577
SIM,1931,1,na,1932,6602
STAT,1984,18,15-19,2002,74.36231130595709
STAT,1870,20,na,1890,2706.8276879757173
SIM,1914,20,30-34,1934,79
STAT,1926,52,na,1978,5142.236463900606
SIM,1857,42,50-100,1899,4
STAT,1824,46,45-49,1870,0.32485042110181606
STAT,1848,81,na,1929,574.5772696233812
STAT,1956,32,35-39,1988,14.224644067416378
STAT,2003,9,na,2012,6882.894275430446
STAT,1849,47,25-29,1896,0.044435796784069004
STAT,1876,48,30-34,1924,0.11402933851696624
STAT,1906,20,30-34,1926,30.154627237449052
STAT,1817,48,20-24,1865,0.0337712199394454
STAT,1969,28,35-39,1997,21.727083270304686
STAT,1824,51,na,1875,1515.8121031159856
STAT,1888,17,45-49,1905,0.08861485087973815
SIM,1825,53,na,1878,1586
SIM,1964,32,35-39,1996,30
SIM,1973,20,40-44,1993,6
SIM,1873,32,40-44,1905,2
STAT,1963,41,25-29,2004,0.10896226586713527
STAT,1812,43,15-19,1855,0.037274647447077244
SIM,1840,38,45-49,1878,2
STAT,1832,38,45-49,1870,1.7326404699728037
SIM,1883,41,50-100,1924,2
STAT,1901,48,35-39,1949,0.12605231778126716
STAT,1958,30,45-49,1988,2.433963983717773
SIM,1904,46,na,1950,3936
SIM,2014,0,na,2014,7282
SIM,1864,36,40-44,1900,16
SIM,1947,30,40-44,1977,12
STAT,1837,47,50-100,1884,0.18461427297701155
STAT,1881,33,35-39,1914,11.225160963808325
STAT,1938,47,20-24,1985,0.013092146894671548
STAT,1975,25,15-19,2000,1.0803767753874944
STAT,1886,37,35-39,1923,8.609946153085321
SIM,1833,24,15-19,1857,5
SIM,1874,43,45-49,1917,1
STAT,1855,40,30-34,1895,0.9881184459754476
SIM,1885,93,na,1978,424
STAT,1869,110,na,1979,0.01307592419216871
STAT,1949,0,na,1949,5930.662219093072
STAT,1961,43,15-19,2004,0.0023757823072044415
STAT,1977,38,25-29,2015,1.580134428943046
SIM,1870,33,30-34,1903,38
STAT,1950,49,50-100,1999,0.3191425178980898
STAT,1949,46,50-100,1995,0.3165455375992213
SIM,1845,47,50-100,1892,1
STAT,1894,4,na,1898,3902.7284005056395
STAT,1895,48,35-39,1943,0.11713999518469133
STAT,1967,34,20-24,2001,3.5795417042177653
STAT,1878,23,50-100,1901,0.48985098915169945
STAT,1832,23,45-49,1855,0.8284637055885127
STAT,1865,110,na,1975,0.0077663282160344215
STAT,1809,105,na,1914,0.013627653718519147
STAT,1825,39,15-19,1864,0.0877240094828268
STAT,1937,44,na,1981,4311.188705901961
STAT,1874,53,45-49,1927,0.01687035964658974
STAT,1855,22,30-34,1877,17.706427108615475
SIM,1966,30,45-49,1996,6
STAT,1777,95,na,1872,1.887186574593839
STAT,1886,19,35-39,1905,0.6643676793420303
SIM,1842,45,na,1887,2072
SIM,1886,46,40-44,1932,2
SIM,1871,34,30-34,1905,6
SIM,1909,95,na,2004,185
STAT,1947,40,40-44,1987,0.33884658117117983
STAT,1969,46,25-29,2015,0.0797399338657622
STAT,1872,86,na,1958,334.9017614047257
STAT,1850,36,45-49,1886,2.1064440826382502
STAT,1839,39,15-19,1878,0.052124121765634863
STAT,1878,46,40-44,1924,0.20687408265775378
SIM,1881,38,50-100,1919,1
STAT,1939,30,40-44,1969,4.615037213441633
STAT,1873,1,na,1874,4111.130550593842
SIM,1878,36,40-44,1914,1
SIM,1833,40,na,1873,1674
STAT,1851,50,40-44,1901,0.008468341220899466
STAT,1941,23,50-100,1964,0.7846727976846899
STAT,1910,0,na,1910,5140.126147000442
STAT,1842,48,na,1890,1709.555290743112
STAT,1921,44,50-100,1965,0.15213931481957713
STAT,1883,42,35-39,1925,2.042058662469371
STAT,1797,95,na,1892,3.9587675087286414
STAT,1819,36,na,1855,1972.655148562809
STAT,1969,32,30-34,2001,23.151964968477163
SIM,1887,20,na,1907,3608
SIM,1959,19,25-29,1978,4
STAT,1867,24,20-24,1891,73.78758171986935
SIM,1826,29,30-34,1855,57
STAT,1924,57,na,1981,4824.52170975833
STAT,1924,19,15-19,1943,62.01776553888328
STAT,1862,39,40-44,1901,4.220482725244569
SIM,1930,19,15-19,1949,132
STAT,1866,43,45-49,1909,1.5893343937364919
SIM,1880,42,25-29,1922,2
STAT,1872,42,25-29,1914,0.7432168379681279
STAT,1822,37,45-49,1859,4.850118019607494
STAT,1846,51,40-44,1897,0.010935368021843543
SIM,1958,26,na,1984,6174
SIM,1955,40,40-44,1995,1
STAT,1870,43,na,1913,2610.5580726095736
SIM,1932,19,15-19,1951,128
STAT,1955,19,45-49,1974,0.7647905117188997
SIM,1891,42,35-39,1933,4
SIM,1981,15,na,1996,5690
STAT,1958,46,15-19,2004,5.822150482767364E-4
SIM,1837,19,35-39,1856,3
SIM,1889,32,na,1921,3878
SIM,1962,30,50-100,1992,2
STAT,1841,31,40-44,1872,4.726983482153005
STAT,1963,44,30-34,2007,0.19414855809887807
STAT,1861,52,20-24,1913,7.041963271343207E-4
STAT,1922,19,15-19,1941,60.26235290468641
STAT,1900,20,35-39,1920,9.400434733216043
STAT,1975,31,45-49,2006,2.4434309296221493
STAT,1833,37,20-24,1870,0.6835609623171564
STAT,1898,60,na,1958,3052.819431373004
STAT,1880,50,na,1930,2671.6929501745303
STAT,1967,37,25-29,2004,1.4623099856101274
STAT,1857,41,45-49,1898,1.351282866468684
STAT,1893,17,na,1910,3684.1484842685213
SIM,1867,20,na,1887,2410
STAT,1916,39,na,1955,4401.902866359426
SIM,1979,23,30-34,2002,107
STAT,1964,16,50-100,1980,0.5447218269249955
STAT,1821,63,na,1884,1122.5680324158623
SIM,1832,28,45-49,1860,2
STAT,1923,26,45-49,1949,2.296046157331242
SIM,1931,26,45-49,1957,6
STAT,1844,37,30-34,1881,4.710647311521082
SIM,1849,16,20-24,1865,47
SIM,1822,40,40-44,1862,5
STAT,1978,37,35-39,2015,3.924677112757931
SIM,1975,37,25-29,2012,3
STAT,1969,38,50-100,2007,0.622952373550415
STAT,1922,37,15-19,1959,0.025206023474881132
STAT,1825,56,na,1881,1559.083522944301
STAT,1828,32,15-19,1860,0.16419761047891598
SIM,1852,19,30-34,1871,1
STAT,1953,37,45-49,1990,0.9805031854086219
SIM,1897,30,35-39,1927,33
STAT,1861,45,50-100,1906,0.23797954781087047
STAT,1856,24,45-49,1880,0.7028501088661538
SIM,1937,41,na,1978,4350
SIM,1953,52,na,2005,5481
SIM,1941,64,na,2005,3426
STAT,1959,23,15-19,1982,8.05964719331352
STAT,1834,81,na,1915,493.5020075706237
SIM,1889,18,15-19,1907,10
STAT,1814,40,40-44,1854,10.053220786711899
SIM,1909,22,15-19,1931,5
STAT,1895,35,50-100,1930,1.8618209178599372
STAT,1873,17,na,1890,2976.401195312884
STAT,1865,45,15-19,1910,4.206544249488799E-4
SIM,1897,50,na,1947,3366
STAT,1872,52,30-34,1924,0.006861106811101001
SIM,1833,71,na,1904,756
SIM,1870,39,40-44,1909,5
SIM,1961,37,45-49,1998,2
SIM,1927,34,na,1961,5032
STAT,1841,63,na,1904,1586.4073361951719
SIM,1864,24,45-49,1888,2
STAT,1942,47,40-44,1989,0.19781302670954198
STAT,1981,21,25-29,2002,149.5998379227101
SIM,1945,57,na,2002,4415
STAT,1889,30,35-39,1919,14.522254010011093
STAT,1851,29,15-19,1880,0.4152292703861442
STAT,1870,27,30-34,1897,28.65005642343932
STAT,1849,66,na,1915,1270.3446753361848
SIM,1875,24,20-24,1899,9
STAT,1815,41,40-44,1856,5.1924061793502245
STAT,1821,50,25-29,1871,0.0064268103143989355
SIM,1902,21,20-24,1923,196
SIM,1977,32,30-34,2009,70
STAT,1807,47,20-24,1854,0.04995433749425265
SIM,1963,19,45-49,1982,1
SIM,1816,42,50-100,1858,1
SIM,1838,40,na,1878,1689
STAT,1799,99,na,1898,0.8506962068751366
SIM,1972,20,25-29,1992,258
STAT,1856,39,45-49,1895,1.7374989879564708
STAT,1978,33,15-19,2011,0.2061737968126881
SIM,1974,19,20-24,1993,2
STAT,1850,43,na,1893,2362.1091116757684
STAT,1966,19,20-24,1985,195.2909979210929
STAT,1902,43,25-29,1945,0.07218883828267664
SIM,1833,30,45-49,1863,2
STAT,1882,26,40-44,1908,3.3882323182546825
SIM,1967,23,15-19,1990,20
STAT,1955,37,45-49,1992,1.0759912929861517
STAT,1892,33,45-49,1925,2.5116800898172076
STAT,1857,52,35-39,1909,0.00769672143171779
SIM,1917,90,na,2007,667
SIM,1891,5,na,1896,3670
SIM,1881,20,30-34,1901,21
STAT,1927,47,45-49,1974,0.3147722974592
STAT,1825,30,45-49,1855,4.288408686759341
STAT,1932,31,35-39,1963,14.031100989537173
STAT,1906,23,35-39,1929,9.79001525629383
SIM,1868,29,35-39,1897,1
STAT,1811,47,50-100,1858,0.7655694485072869
STAT,1877,25,20-24,1902,14.17850458305461
SIM,1978,30,25-29,2008,22
STAT,1812,45,35-39,1857,0.33556802979171596
SIM,1844,30,20-24,1874,1
STAT,1846,18,na,1864,2963.3933220378754
SIM,1926,72,na,1998,4346
STAT,1892,15,45-49,1907,0.09492370395245803
SIM,1899,85,na,1984,868
SIM,1849,34,20-24,1883,5
STAT,1873,101,na,1974,7.609332024813506
SIM,1838,31,40-44,1869,12
STAT,1819,46,30-34,1865,0.18910647414491696
STAT,1845,54,30-34,1899,0.003900850579677479
STAT,1889,45,35-39,1934,0.2011452347158274
STAT,1865,73,na,1938,1236.7546665656266
SIM,1851,14,na,1865,3120
SIM,1968,25,na,1993,4941
SIM,1929,46,na,1975,5161
SIM,1890,41,35-39,1931,9
SIM,1938,75,na,2013,2648
STAT,1978,21,30-34,1999,45.43115124351143
STAT,1840,30,40-44,1870,4.32621914855453
SIM,1905,36,45-49,1941,1
STAT,1850,52,45-49,1902,0.014860215221237533
SIM,1963,34,40-44,1997,3
STAT,1916,36,50-100,1952,0.4986273294644742
STAT,1920,64,na,1984,4148.654358405934
SIM,1958,18,25-29,1976,150
SIM,1987,17,30-34,2004,21
STAT,1878,40,30-34,1918,1.3992772971853547
SIM,1906,72,na,1978,2549
STAT,1894,31,20-24,1925,4.026481395412531
SIM,1886,40,30-34,1926,1
SIM,1914,23,35-39,1937,15
STAT,1882,41,35-39,1923,2.0504122961285005
STAT,1813,46,35-39,1859,0.4718776056285572
SIM,1889,42,45-49,1931,2
SIM,1848,38,15-19,1886,1
SIM,1904,29,15-19,1933,1
STAT,1852,17,50-100,1869,0.0558652979122149
SIM,1971,29,35-39,2000,65
STAT,1851,20,45-49,1871,0.6699427420041887
STAT,1818,74,na,1892,491.0383634581264
STAT,1928,64,na,1992,4790.62380354864
STAT,1902,39,na,1941,3833.0660589434956
SIM,1859,38,25-29,1897,4
STAT,1957,48,20-24,2005,0.01744154772046214
STAT,1847,52,40-44,1899,0.008057422357847259
SIM,1891,24,35-39,1915,18
SIM,1841,33,35-39,1874,3
SIM,1911,6,na,1917,5201
SIM,1934,16,na,1950,5195
STAT,1821,71,na,1892,816.3529581727523
STAT,1962,46,35-39,2008,0.19879336918688645
SIM,1909,3,na,1912,5152
STAT,1833,51,na,1884,1592.5109174654142
SIM,1830,37,45-49,1867,2
STAT,1940,49,30-34,1989,0.1080482623248555
SIM,1850,31,50-100,1881,1
STAT,1842,25,na,1867,2088.5231283404573
STAT,1872,25,40-44,1897,3.4948162665214024
STAT,1878,49,45-49,1927,0.27843209357871573
STAT,1985,30,20-24,2015,4.085595032853645
SIM,1885,25,20-24,1910,1
STAT,1938,46,50-100,1984,0.26861877038589027
SIM,1820,53,na,1873,1741
STAT,1866,28,15-19,1894,0.4836000215111953
SIM,1911,28,na,1939,4634
STAT,1864,111,na,1975,0.002677738192900871
STAT,1875,101,na,1976,8.807632708194301
STAT,1824,82,na,1906,288.69843856284837
STAT,1832,50,35-39,1882,0.006468064060688632
SIM,1948,29,20-24,1977,20
STAT,1929,26,40-44,1955,6.73539035107767
STAT,1969,43,20-24,2012,0.026416784999411247
STAT,1811,48,25-29,1859,0.17654846852049358
STAT,1833,33,35-39,1866,9.162165869658647
STAT,1811,64,na,1875,1056.562121400915
SIM,1874,29,30-34,1903,77
SIM,1958,36,25-29,1994,1
SIM,1952,41,na,1993,4709
STAT,1773,85,na,1858,154.43319708825123
STAT,1896,42,40-44,1938,0.237791722938438
STAT,1925,49,35-39,1974,0.1791844159738163
STAT,1880,30,15-19,1910,0.17559917500756994
SIM,1853,36,30-34,1889,12
STAT,1986,28,na,2014,6183.798216542917
SIM,1859,25,na,1884,2337
SIM,1937,26,40-44,1963,8
STAT,1883,24,35-39,1907,6.547548524545168
STAT,1878,47,50-100,1925,0.2945574110347807
STAT,1929,44,40-44,1973,0.37259216066920486
STAT,1963,47,35-39,2010,0.1966217396269829
SIM,1975,15,na,1990,6123
STAT,1972,30,15-19,2002,0.19376732334148905
STAT,1845,36,30-34,1881,3.8127975304535062
STAT,1833,51,35-39,1884,0.006412085529897103
SIM,1838,46,40-44,1884,1
STAT,1897,43,40-44,1940,0.239287613316073
SIM,1940,31,35-39,1971,15
STAT,1877,43,20-24,1920,0.18926911158394277
STAT,1870,46,35-39,1916,0.15973361591727991
STAT,1832,38,50-100,1870,1.0670935465225457
SIM,1931,23,40-44,1954,9
SIM,1988,23,50-100,2011,1
STAT,1909,41,50-100,1950,0.1276838926700804
STAT,1955,16,40-44,1971,2.1434495885500797
STAT,1973,33,35-39,2006,13.894377030153604
STAT,1965,42,40-44,2007,0.3745084654171762
STAT,1856,17,na,1873,2389.724797239421
STAT,1887,32,25-29,1919,13.246995894982133
STAT,1940,39,25-29,1979,1.1864588510149834
STAT,1843,26,25-29,1869,52.61322630668255
STAT,1874,98,na,1972,27.890366224277358
STAT,1879,41,30-34,1920,1.391640406397074
SIM,1917,41,50-100,1958,2
STAT,1877,46,25-29,1923,0.06934194427397572
SIM,1988,17,45-49,2005,5
STAT,1851,53,45-49,1904,0.011323491679960324
STAT,1805,56,na,1861,1315.7679066806988
STAT,1854,26,35-39,1880,9.121361070388783
STAT,1969,35,35-39,2004,3.5986268215459516
SIM,1906,80,na,1986,1990
STAT,1835,35,30-34,1870,4.199845634688591
SIM,1851,26,25-29,1877,68
SIM,1848,35,45-49,1883,2
SIM,1895,32,25-29,1927,35
STAT,1850,33,40-44,1883,4.621982763348465
STAT,1871,26,30-34,1897,29.011221384639303
SIM,1957,41,na,1998,6204
STAT,1976,29,na,2005,5795.042506668486
STAT,1866,46,15-19,1912,4.290791739712589E-4
STAT,1961,26,na,1987,5612.178526779262
STAT,1862,53,20-24,1915,7.071443705536459E-4
SIM,1887,41,30-34,1928,5
SIM,1839,25,na,1864,2350
SIM,1828,27,40-44,1855,5
SIM,1811,53,na,1864,1492
SIM,1861,5,na,1866,2363
SIM,1944,23,na,1967,4633
SIM,1948,16,45-49,1964,3
STAT,1951,19,na,1970,5054.850334737847
SIM,1836,37,na,1873,1679
SIM,1899,93,na,1992,47
STAT,1962,43,30-34,2005,0.19614932709236446
STAT,1919,25,40-44,1944,5.850079890118924
SIM,1816,42,45-49,1858,2
SIM,1947,34,na,1981,5990
SIM,1849,32,na,1881,2731
STAT,1869,43,na,1912,2564.401310345731
STAT,1872,28,45-49,1900,1.2820927994821085
SIM,1917,4,na,1921,5872
STAT,1892,19,30-34,1911,2.2930639599262754
STAT,1958,45,30-34,2003,0.1412082305950666
SIM,1880,28,45-49,1908,4
STAT,1861,25,30-34,1886,24.688475645517222
STAT,1879,23,30-34,1902,21.397813285594392
STAT,1880,16,35-39,1896,0.6728521389218177
SIM,1838,43,50-100,1881,2
STAT,1893,29,20-24,1922,16.99057649373773
SIM,1864,21,40-44,1885,7
SIM,1961,34,40-44,1995,2
SIM,1877,37,30-34,1914,12
STAT,1895,45,30-34,1940,0.0828423310771608
SIM,1953,15,40-44,1968,4
STAT,1871,41,25-29,1912,0.7406134263228429
STAT,1870,32,50-100,1902,1.0424347273598522
STAT,1779,99,na,1878,0.3089887411291715
STAT,1901,42,25-29,1943,0.07199458636297403
STAT,1863,17,50-100,1880,0.05641363937732699
SIM,1770,86,na,1856,120
STAT,1846,17,40-44,1863,0.23752506306449458
STAT,1945,15,40-44,1960,1.7642375084367556
SIM,1870,40,na,1910,3023
STAT,1943,45,50-100,1988,0.2892915736417386
STAT,1886,35,na,1921,2895.1946098376525
STAT,1955,34,40-44,1989,6.1032386241496575
STAT,1909,57,na,1966,3728.971954572926
STAT,1930,57,na,1987,5338.878349243413
STAT,1832,55,na,1887,1429.794133804832
STAT,1846,35,40-44,1881,4.8249405554744795
STAT,1923,23,40-44,1946,4.499304487239997
SIM,1880,28,50-100,1908,1
STAT,1856,36,40-44,1892,3.8727195200418705
STAT,1926,60,na,1986,4870.4776411030925
SIM,1887,23,30-34,1910,55
SIM,1902,24,25-29,1926,9
STAT,1958,55,na,2013,5610.304243014744
STAT,1811,110,na,1921,1.4228470596981116E-4
STAT,1843,41,50-100,1884,1.1054871034905351
SIM,1877,50,na,1927,2967
SIM,1992,15,45-49,2007,5
SIM,1977,35,35-39,2012,8
STAT,1824,43,40-44,1867,3.1475860834665124
SIM,1899,29,30-34,1928,55
STAT,1914,49,25-29,1963,0.06038537180587431
SIM,1865,17,na,1882,3229
STAT,1897,42,50-100,1939,0.1130682937535016
STAT,1856,21,40-44,1877,2.1462284093908153
SIM,1825,36,25-29,1861,3
STAT,1863,50,30-34,1913,0.006093098108511866
STAT,1953,34,40-44,1987,5.561610908281475
SIM,1832,43,40-44,1875,1
SIM,1922,49,25-29,1971,1
SIM,1849,55,na,1904,2317
STAT,1870,51,na,1921,2461.431898854834
STAT,1964,20,25-29,1984,134.79737050846416
SIM,1854,35,40-44,1889,2
SIM,1956,47,50-100,2003,3
SIM,1874,25,45-49,1899,4
STAT,1869,37,30-34,1906,5.956380422471088
SIM,1933,47,50-100,1980,1
STAT,1866,25,45-49,1891,1.195706313066847
STAT,1925,47,50-100,1972,0.31619400283795845
SIM,1993,18,30-34,2011,28
STAT,1812,42,30-34,1854,3.2824086179992076
STAT,1949,22,15-19,1971,7.168230418967854
SIM,1831,32,35-39,1863,17
SIM,1836,36,35-39,1872,15
STAT,1781,89,na,1870,27.384636079845855
SIM,1853,39,35-39,1892,8
STAT,1867,39,20-24,1906,0.8222213301602092
STAT,1893,47,20-24,1940,0.00982803181826902
STAT,1996,18,40-44,2014,2.3451380836102502
SIM,1805,53,na,1858,1460
STAT,1856,51,35-39,1907,0.0076161066064564745
SIM,1828,70,na,1898,1283
SIM,1886,43,35-39,1929,1
SIM,1823,41,40-44,1864,4
SIM,1995,0,na,1995,6784
STAT,1927,44,40-44,1971,0.3607325730455086
SIM,1890,29,45-49,1919,2
STAT,1878,43,35-39,1921,2.1661882108913413
SIM,1982,30,45-49,2012,8
SIM,1828,45,40-44,1873,1
STAT,1854,22,15-19,1876,3.1579588228323017
SIM,1875,39,20-24,1914,2
SIM,1935,44,40-44,1979,2
STAT,1882,29,45-49,1911,1.2426052699034333
STAT,1845,39,35-39,1884,4.904796483952895
STAT,1892,36,15-19,1928,0.0816148213780909
SIM,1980,32,35-39,2012,23
STAT,1883,61,na,1944,2109.8620091934486
STAT,1929,47,45-49,1976,0.32512087677299156
STAT,1844,19,30-34,1863,1.674756009360791
STAT,1883,21,30-34,1904,20.1724304909257
STAT,1911,39,na,1950,4154.903777919157
SIM,1838,34,45-49,1872,1
SIM,1970,42,50-100,2012,1
STAT,1823,32,35-39,1855,27.981363233047464
SIM,1940,53,na,1993,4820
STAT,1949,26,na,1975,5051.977655044575
STAT,1900,4,na,1904,4212.6667170317905
STAT,1906,83,na,1989,1501.2274902002298
SIM,1955,56,na,2011,6131
STAT,1877,28,25-29,1905,50.60177848681869
SIM,1950,64,na,2014,4125
STAT,1974,30,45-49,2004,2.41981875533763
SIM,1991,18,na,2009,6277
STAT,1927,30,15-19,1957,0.18259312789023088
STAT,1852,55,na,1907,1949.468124270134
STAT,1918,86,na,2004,1321.7709551825722
STAT,1929,29,45-49,1958,2.4928733144353807
SIM,1864,32,na,1896,2671
STAT,1892,18,15-19,1910,8.56144810361609
STAT,1809,45,30-34,1854,0.24823936364758903
STAT,1819,49,35-39,1868,0.2618653683686489
STAT,1868,54,30-34,1922,0.006418498679390455
STAT,1899,96,na,1995,134.25656876706063
STAT,1972,6,na,1978,5808.728915941422
SIM,1869,24,na,1893,1786
SIM,1885,28,25-29,1913,67
SIM,1891,21,30-34,1912,2
SIM,1869,32,na,1901,2003
STAT,1866,29,30-34,1895,26.743600466594195
SIM,1830,31,35-39,1861,16
SIM,1986,19,35-39,2005,18
STAT,1813,43,30-34,1856,4.148180834544761
STAT,1938,30,25-29,1968,10.742529079545783
STAT,1902,29,45-49,1931,1.7975514533989272
SIM,1958,15,20-24,1973,388
STAT,1875,48,15-19,1923,4.7104376950709025E-4
SIM,1905,33,40-44,1938,2
SIM,1983,31,45-49,2014,2
SIM,1901,29,na,1930,3876
SIM,1871,1,na,1872,3551
STAT,1899,38,25-29,1937,0.9776818235256638
STAT,1925,46,30-34,1971,0.1249335304069623
SIM,1968,22,25-29,1990,2
STAT,1821,34,25-29,1855,28.91873738421652
STAT,1964,41,40-44,2005,0.3783698959654117
SIM,1841,19,20-24,1860,2
SIM,1885,17,na,1902,3388
SIM,1987,26,50-100,2013,4
STAT,1869,36,50-100,1905,1.3787396789067468
SIM,1923,61,na,1984,4878
STAT,1910,25,20-24,1935,20.67550577810685
STAT,1943,30,50-100,1973,1.0326344171154669
STAT,1870,44,15-19,1914,0.015499697671605734
STAT,1818,47,30-34,1865,0.11947500067988459
STAT,1892,86,na,1978,841.7732377440699
STAT,1910,65,na,1975,3451.7361526908467
STAT,1972,32,35-39,2004,13.76384891409095
SIM,1853,40,na,1893,2242
SIM,1946,30,25-29,1976,14
STAT,1839,36,na,1875,2050.9852359725674
STAT,1934,27,na,1961,5818.688194065244
STAT,1855,43,na,1898,1952.4171603407592
STAT,1950,34,na,1984,5253.721321439561
SIM,1913,54,na,1967,4273
STAT,1891,35,15-19,1926,0.08085493732254406
STAT,1985,18,30-34,2003,20.00016773198222
SIM,1924,46,na,1970,4871
STAT,1977,30,50-100,2007,1.3156142962347626
SIM,1820,42,30-34,1862,2
SIM,1958,33,20-24,1991,6
SIM,1981,33,35-39,2014,2
SIM,1821,43,30-34,1864,1
SIM,1951,49,na,2000,6220
SIM,1966,48,na,2014,5733
STAT,1889,49,20-24,1938,0.009428316909033289
SIM,1951,30,50-100,1981,2
STAT,1945,19,na,1964,4637.07273303686
SIM,1836,18,35-39,1854,1
SIM,1856,14,na,1870,2565
SIM,1908,39,na,1947,3828
STAT,1953,20,15-19,1973,7.461163790354763
SIM,1978,28,40-44,2006,15
SIM,1818,63,na,1881,1722
SIM,1859,35,20-24,1894,2
SIM,1972,41,40-44,2013,1
SIM,1841,15,na,1856,2406
STAT,1809,52,50-100,1861,0.03650516041491825
STAT,1828,36,35-39,1864,7.43795551826947
STAT,1919,21,20-24,1940,140.9075496922097
STAT,1958,43,45-49,2001,0.26174695235198514
STAT,1854,40,15-19,1894,0.011364351417499205
STAT,1929,35,50-100,1964,0.623165225690749
SIM,1927,21,20-24,1948,271
SIM,1961,20,15-19,1981,15
STAT,1914,40,50-100,1954,0.13534525027426858
SIM,1975,18,50-100,1993,1
SIM,1970,30,20-24,2000,1
SIM,1842,14,na,1856,2696
SIM,1881,0,na,1881,3352
STAT,1854,23,30-34,1877,16.92821207289207
STAT,1897,61,na,1958,2963.4493912024545
SIM,1935,30,50-100,1965,3
STAT,1954,28,50-100,1982,1.425485035302772
SIM,1935,18,25-29,1953,166
SIM,1835,52,na,1887,1909
STAT,1988,23,35-39,2011,15.587577580950729
SIM,1841,40,45-49,1881,2
SIM,1918,19,35-39,1937,8
STAT,1850,38,30-34,1888,5.515821550948487
STAT,1935,40,15-19,1975,0.002508086668457798
SIM,1867,29,20-24,1896,13
SIM,1839,41,30-34,1880,1
SIM,1924,23,na,1947,4430
SIM,1827,57,na,1884,1193
STAT,1896,45,50-100,1941,0.21327815094002012
STAT,1889,66,na,1955,2331.6054643005145
SIM,1832,40,35-39,1872,1
STAT,1942,36,20-24,1978,0.32788917834206427
SIM,1849,26,50-100,1875,1
SIM,1872,42,30-34,1914,3
STAT,2011,1,na,2012,7209.335639606219
STAT,1807,50,45-49,1857,0.05935962657473158
SIM,1862,23,30-34,1885,30
STAT,1850,74,na,1924,1142.4674524407849
STAT,1864,42,30-34,1906,1.1832074293501953
SIM,1952,40,25-29,1992,2
SIM,1881,42,40-44,1923,3
SIM,1862,48,45-49,1910,1
STAT,1841,47,20-24,1888,0.010717449411074427
SIM,1869,86,na,1955,117
STAT,1780,84,na,1864,148.42126825244048
SIM,1952,31,25-29,1983,29
STAT,1927,45,na,1972,5345.804083137837
STAT,1948,24,20-24,1972,147.236742405506
SIM,1878,30,30-34,1908,5
STAT,1883,44,20-24,1927,0.17689415912966722
SIM,1919,31,40-44,1950,8
STAT,1984,30,40-44,2014,6.545532780931316
STAT,1873,42,40-44,1915,2.647485246623296
STAT,1944,40,25-29,1984,0.09242493304013799
STAT,1858,74,na,1932,999.1271142131109
SIM,1820,44,50-100,1864,6
STAT,1894,29,50-100,1923,0.942225993634231
SIM,1865,31,30-34,1896,2
STAT,1949,9,na,1958,5274.248114574953
SIM,1856,29,45-49,1885,1
STAT,1888,31,50-100,1919,1.2480349449822812
STAT,1931,36,45-49,1967,1.0431059009747696
SIM,1812,89,na,1901,33
STAT,1959,29,25-29,1988,99.6913802636236
SIM,1978,23,15-19,2001,8
STAT,1887,31,na,1918,3098.883455737142
SIM,1910,26,40-44,1936,1
STAT,1958,48,35-39,2006,0.20270498479711924
STAT,1930,44,45-49,1974,0.25190441734829644
STAT,1909,45,35-39,1954,0.13819195251152325
STAT,1944,31,25-29,1975,11.707833133451091
STAT,1969,40,15-19,2009,0.0023071333843296686
STAT,1950,30,40-44,1980,5.449252599051651
SIM,1852,44,na,1896,1872
STAT,1896,20,30-34,1916,27.31301401875889
STAT,1772,89,na,1861,4.547752051174131
STAT,1951,18,30-34,1969,16.744956326373664
SIM,1889,35,35-39,1924,25
STAT,1825,87,na,1912,124.61764758802688
STAT,1870,49,40-44,1919,0.19071155673626225
STAT,1854,48,45-49,1902,0.18985262782110612
STAT,1873,31,na,1904,2823.735963805164
SIM,1778,80,na,1858,95
STAT,1880,52,25-29,1932,0.004309670848085247
STAT,1962,49,40-44,2011,0.24107166216940307
STAT,1927,18,25-29,1945,62.00591366665017
STAT,1865,24,50-100,1889,0.42362636017929156
STAT,1848,29,45-49,1877,1.388220459983144
STAT,1844,40,20-24,1884,0.1395759970354468
STAT,1859,44,15-19,1903,0.01252407680372224
SIM,1942,37,40-44,1979,2
STAT,1948,49,50-100,1997,0.3088814769674656
STAT,1902,31,20-24,1933,4.4256958914733655
SIM,1969,15,30-34,1984,41
STAT,1960,32,20-24,1992,3.737096911716659
STAT,1934,37,40-44,1971,2.385208442282187
STAT,1843,19,15-19,1862,7.520211664568116
SIM,1966,48,35-39,2014,1
SIM,1898,27,50-100,1925,2
STAT,1959,46,30-34,2005,0.14032356399022108
SIM,2007,7,na,2014,6952
SIM,1920,20,25-29,1940,245
STAT,1825,46,25-29,1871,0.08155707511384135
SIM,1911,50,na,1961,4575
SIM,1936,30,30-34,1966,1
STAT,1859,29,20-24,1888,10.81395734205231
STAT,1833,40,45-49,1873,1.3188028449800777
STAT,1914,5,na,1919,4786.495405736335
STAT,1840,41,30-34,1881,0.9744623940988595
STAT,1919,24,25-29,1943,115.96902164153974
SIM,1909,46,na,1955,4556
STAT,1974,41,35-39,2015,0.31580520106401055
STAT,1942,22,na,1964,4419.456420007101
STAT,1995,15,20-24,2010,226.6037132416726
STAT,1861,33,15-19,1894,0.1360503852472737
STAT,1877,40,15-19,1917,0.016745217239766616
SIM,1959,36,40-44,1995,3
SIM,1846,22,35-39,1868,6
SIM,1916,47,40-44,1963,2
STAT,1838,109,na,1947,6.162735855259698E-4
STAT,1905,46,45-49,1951,0.222990730396351
STAT,1971,7,na,1978,5745.255608617841
STAT,1830,47,45-49,1877,0.21774841928392624
SIM,1876,68,na,1944,1909
SIM,1882,39,30-34,1921,2
STAT,1806,106,na,1912,0.004167279450606033
STAT,1804,54,40-44,1858,0.04654841517470667
STAT,1857,31,30-34,1888,15.95467717004676
STAT,1850,30,35-39,1880,12.235967811205827
STAT,1970,38,50-100,2008,0.6242499003704522
STAT,1928,33,35-39,1961,13.178347421133832
STAT,1900,45,15-19,1945,3.6492107154016093E-4
SIM,1967,29,25-29,1996,9
STAT,1964,44,45-49,2008,0.2505636190612857
STAT,1841,34,50-100,1875,0.9680686344307148
STAT,1943,42,30-34,1985,0.16260963003651557
STAT,1948,26,45-49,1974,2.292500609341691
SIM,1872,44,na,1916,2811
STAT,1937,21,40-44,1958,3.7819641745685098
SIM,1823,41,na,1864,2264
SIM,1836,33,30-34,1869,34
SIM,1901,17,30-34,1918,3
STAT,1950,38,35-39,1988,3.396883617165306
STAT,1865,48,20-24,1913,0.012338072299800057
STAT,1934,42,20-24,1976,0.028384436224683944
SIM,1932,9,na,1941,5726
SIM,1956,26,45-49,1982,3
SIM,1924,36,50-100,1960,1
STAT,1895,80,na,1975,1564.9186412241304
STAT,1890,29,na,1919,3341.232309540205
STAT,1924,40,40-44,1964,0.34420452987513417
SIM,1848,70,na,1918,817
STAT,1920,90,na,2010,765.1468525709926
SIM,1914,49,30-34,1963,1
STAT,1856,46,50-100,1902,0.21685228331461362
STAT,1902,26,40-44,1928,4.901413244935967
STAT,1880,38,45-49,1918,2.4264201094224163
STAT,1896,23,35-39,1919,8.867455791558884
STAT,1968,37,40-44,2005,2.223044299877728
STAT,1807,82,na,1889,239.87178145361779
STAT,1835,43,15-19,1878,0.010195173441974277
SIM,1915,66,na,1981,3707
STAT,1903,39,35-39,1942,2.4841798812754807
STAT,1814,51,30-34,1865,0.01614334327751602
STAT,1824,48,30-34,1872,0.12976316770728125
SIM,1900,34,30-34,1934,61
SIM,1942,60,na,2002,4490
STAT,1886,17,15-19,1903,7.224194816210218
STAT,1828,33,30-34,1861,19.495039390639576
STAT,1939,56,na,1995,4251.522094625161
STAT,1889,111,na,2000,0.016581099342227016
STAT,1860,98,na,1958,4.781101695842222
SIM,1956,24,20-24,1980,154
STAT,1865,40,25-29,1905,0.6753968289758812
STAT,1871,47,35-39,1918,0.159988323916424
SIM,1859,2,na,1861,3400
STAT,1871,101,na,1972,6.341511608954502
STAT,1808,106,na,1914,0.006190915709890552
STAT,1917,26,15-19,1943,0.8573472080676305
STAT,1885,34,15-19,1919,0.16252331643045936
STAT,1908,47,40-44,1955,0.164759883133894
SIM,1926,58,na,1984,5362
SIM,1888,37,40-44,1925,4
STAT,1924,48,35-39,1972,0.17659707224854473
SIM,1927,24,25-29,1951,139
SIM,1911,39,35-39,1950,3
STAT,1867,31,na,1898,2581.7301859170675
STAT,1818,50,20-24,1868,9.120965132281386E-4
STAT,1874,39,30-34,1913,6.23324231793904
STAT,1838,22,35-39,1860,6.559260621357853
STAT,1874,19,45-49,1893,0.07676121877654617
STAT,1824,40,35-39,1864,2.665202618598777
STAT,1954,23,35-39,1977,13.473313687155004
STAT,1854,98,na,1952,2.6465767044595108
STAT,1913,65,na,1978,3609.149980451504
STAT,1960,9,na,1969,5906.556240228544
STAT,1881,49,15-19,1930,4.359547592446679E-4
STAT,1918,41,25-29,1959,0.08772711868367479
SIM,1909,25,20-24,1934,26
STAT,1850,15,40-44,1865,0.23282049552153206
STAT,1890,32,30-34,1922,24.62030019568232
SIM,1832,48,30-34,1880,1
STAT,1890,43,na,1933,3235.5826770122717
STAT,1940,41,35-39,1981,0.24564089520146326
STAT,1782,107,na,1889,0.011201277133809126
SIM,1898,26,45-49,1924,2
SIM,1977,25,20-24,2002,27
STAT,1883,47,25-29,1930,0.06473251525256726
STAT,1812,48,40-44,1860,0.39039376086676286
SIM,1940,39,30-34,1979,6
STAT,1818,53,25-29,1871,0.004124355029329812
STAT,1974,17,25-29,1991,65.30299446292855
STAT,1968,17,30-34,1985,17.569107587050762
SIM,1891,31,45-49,1922,3
SIM,1954,2,na,1956,5553
SIM,1869,18,30-34,1887,1
SIM,1882,82,na,1964,1130
SIM,1918,16,30-34,1934,4
SIM,1961,15,na,1976,5663
STAT,1845,17,25-29,1862,4.82631735981945
SIM,1913,31,na,1944,4753
STAT,1874,44,50-100,1918,1.2312945876573165
STAT,1868,41,20-24,1909,0.17688349901800127
STAT,1988,20,30-34,2008,47.62825646457018
STAT,1940,41,na,1981,4530.504976386709
STAT,1932,39,30-34,1971,2.820714191512083
SIM,1886,23,15-19,1909,7
STAT,1807,68,na,1875,1018.088468311312
STAT,1878,23,15-19,1901,3.9628940460164865
STAT,1869,18,25-29,1887,6.383062686889347
SIM,1882,44,50-100,1926,2
STAT,1883,31,45-49,1914,1.97698250391556
SIM,1783,81,na,1864,247
SIM,1870,63,na,1933,2399
SIM,1954,48,45-49,2002,2
STAT,1925,43,25-29,1968,0.09958302898215918
SIM,1898,35,na,1933,3847
STAT,1881,15,50-100,1896,0.054787660187019825
STAT,1864,45,35-39,1909,0.14570004945493203
SIM,1976,17,30-34,1993,18
SIM,1951,16,15-19,1967,116
STAT,1836,26,15-19,1862,0.5383366187936942
STAT,1936,41,50-100,1977,0.13453388176628897
SIM,1889,32,30-34,1921,5
SIM,1869,27,30-34,1896,33
STAT,1984,25,50-100,2009,1.639918963943246
SIM,1982,17,25-29,1999,92
SIM,1897,81,na,1978,1366
SIM,1930,23,na,1953,5746
STAT,1853,17,na,1870,2749.170546138759
STAT,1955,40,na,1995,5929.433557982474
STAT,1961,15,20-24,1976,202.25024741643062
STAT,1952,25,25-29,1977,91.50045171197884
STAT,1943,16,15-19,1959,55.56025648076283
STAT,1935,8,na,1943,6295.731180666186
SIM,1820,48,40-44,1868,1
STAT,1814,43,45-49,1857,4.7197439484923045
STAT,1972,38,45-49,2010,1.0367317878424016
STAT,1903,35,na,1938,3940.329757500383
STAT,1891,41,45-49,1932,2.1443440385508894
STAT,1891,38,20-24,1929,1.094022381726053
STAT,1892,30,40-44,1922,6.323197121123038
STAT,1867,46,30-34,1913,0.1045970095242643
SIM,1883,37,25-29,1920,5
SIM,1987,24,na,2011,6508
STAT,1884,42,15-19,1926,0.015726871307656928
STAT,1906,41,35-39,1947,0.2125728556985745
SIM,1818,40,na,1858,2165
SIM,1960,25,25-29,1985,191
STAT,1927,15,20-24,1942,195.4006202872109
STAT,1927,19,50-100,1946,0.5345998696594004
SIM,1957,31,50-100,1988,4
SIM,1936,33,35-39,1969,2
STAT,1907,45,na,1952,3858.975523872605
STAT,1912,48,45-49,1960,0.24060859334469162
STAT,1925,23,50-100,1948,0.9058452086037304
STAT,1875,37,25-29,1912,3.4337173604385423
SIM,1845,76,na,1921,1143
STAT,1948,27,25-29,1975,87.30264011976756
STAT,1949,31,50-100,1980,1.131798027422542
STAT,1810,88,na,1898,78.1675329967213
SIM,1866,44,na,1910,2386
STAT,1935,25,20-24,1960,28.756124229277958
SIM,1870,2,na,1872,3983
SIM,1839,44,35-39,1883,2
STAT,1822,51,25-29,1873,0.006572664879422831
SIM,1910,7,na,1917,4048
SIM,1827,27,25-29,1854,3
STAT,1951,33,25-29,1984,12.938989863785894
STAT,1862,16,15-19,1878,6.658888458712013
STAT,1992,20,50-100,2012,1.0943167696819147
SIM,1822,43,45-49,1865,7
STAT,1838,74,na,1912,961.3099971037138
SIM,1858,94,na,1952,37
SIM,1980,20,na,2000,5212
STAT,1838,52,30-34,1890,0.005129678192330899
STAT,1978,34,30-34,2012,25.26074828956995
SIM,1877,18,25-29,1895,1
STAT,1912,20,25-29,1932,102.86764812298631
STAT,1909,42,30-34,1951,0.138153934618106
STAT,1844,43,25-29,1887,0.5430923270083778
SIM,1935,19,50-100,1954,1
SIM,1853,71,na,1924,1050
STAT,1920,38,50-100,1958,0.5297439940167341
SIM,1852,43,25-29,1895,1
SIM,1870,16,15-19,1886,9
SIM,1890,49,na,1939,3126
STAT,1865,51,45-49,1916,0.015183440286893078
SIM,1857,24,35-39,1881,8
SIM,1874,25,na,1899,2476
STAT,1941,44,20-24,1985,0.02174914433050834
STAT,1929,26,na,1955,5413.334075655428
STAT,1840,33,45-49,1873,1.6862458745093323
STAT,1870,29,na,1899,2695.7991338328065
STAT,1928,30,30-34,1958,22.760131109842487
SIM,1962,11,na,1973,5587
STAT,1912,69,na,1981,3277.946522224946
STAT,1911,84,na,1995,1469.2847870521741
SIM,1879,62,na,1941,2114
STAT,1900,28,30-34,1928,40.183233137022555
SIM,1956,23,40-44,1979,7
STAT,1959,43,25-29,2002,0.11185024143798088
STAT,1970,21,25-29,1991,133.92486382458733
SIM,1934,35,25-29,1969,3
STAT,1825,43,20-24,1868,0.23120394745599473
STAT,1962,30,30-34,1992,23.773833384966572
STAT,1834,45,50-100,1879,0.26798464161269253
STAT,1926,35,25-29,1961,1.3908072658840465
STAT,1830,51,50-100,1881,0.01249696607304737
STAT,1856,79,na,1935,615.5267141531594
STAT,1902,40,20-24,1942,0.018164514950196674
STAT,1890,35,35-39,1925,10.068390586164655
SIM,1956,27,25-29,1983,108
STAT,1829,110,na,1939,2.0243956806202548E-4
SIM,1969,18,35-39,1987,9
STAT,1863,31,25-29,1894,10.378155198901515
STAT,1923,25,50-100,1948,1.3272686929666393
SIM,1962,20,30-34,1982,60
STAT,1830,44,40-44,1874,2.097595007588196
STAT,1863,53,35-39,1916,0.008548002152220206
STAT,1867,29,50-100,1896,0.6843348679155337
SIM,1887,20,50-100,1907,1
SIM,1977,10,na,1987,6242
STAT,1910,31,15-19,1941,0.1437261345285505
STAT,1860,13,na,1873,2549.1953778443667
STAT,1849,42,50-100,1891,0.8178141793995519
SIM,1798,80,na,1878,396
STAT,1916,46,20-24,1962,0.013114875600480375
SIM,1885,62,na,1947,2438
STAT,1842,45,15-19,1887,3.1585166651416165E-4
STAT,1972,36,na,2008,5732.413000066299
STAT,1948,62,na,2010,4593.8382948811
SIM,1909,28,25-29,1937,133
STAT,1850,18,45-49,1868,0.0816895304521754
STAT,1914,27,na,1941,4360.3389213925975
SIM,1908,84,na,1992,676
STAT,1954,20,30-34,1974,41.16806709617559
STAT,1983,28,na,2011,6139.2514963979465
SIM,1807,57,na,1864,1015
STAT,1896,45,45-49,1941,0.2049415460281328
STAT,1838,24,50-100,1862,0.451810519999665
STAT,1855,21,50-100,1876,0.40829854852637326
SIM,1919,76,na,1995,3177
SIM,1928,39,na,1967,5679
SIM,1865,34,35-39,1899,18
STAT,1883,47,na,1930,2528.4349568250323
STAT,1862,79,na,1941,680.8812628360142
STAT,1861,94,na,1955,19.174787337678417
SIM,1890,18,na,1908,3683
STAT,1960,27,40-44,1987,7.036191848567296
STAT,1857,34,35-39,1891,9.024384673343377
STAT,1872,55,na,1927,2396.071042785454
STAT,1948,23,40-44,1971,4.453773618646512
STAT,1869,12,na,1881,2972.463154357639
STAT,1871,44,30-34,1915,1.3021473676569644
STAT,1924,28,15-19,1952,0.9449885824409446
STAT,1849,24,35-39,1873,5.390072981531252
SIM,1931,25,50-100,1956,1
STAT,1887,85,na,1972,790.8367071104115
STAT,1898,77,na,1975,1985.2432148237533
SIM,1865,41,45-49,1906,4
STAT,1854,13,na,1867,2315.9721395986057
STAT,1893,36,30-34,1929,7.811772306424274
STAT,1888,39,na,1927,3163.891870840031
SIM,1794,73,na,1867,334
STAT,1841,107,na,1948,0.004192908052194222
SIM,1952,4,na,1956,4846
STAT,1910,36,40-44,1946,1.6619349947979893
SIM,1883,67,na,1950,1542
STAT,1927,30,50-100,1957,1.1747972345684057
STAT,1990,24,na,2014,6051.186401186165
SIM,1962,28,50-100,1990,1
STAT,1816,38,30-34,1854,19.44613858931195
STAT,1941,26,na,1967,4475.379555080272
STAT,1947,24,50-100,1971,0.8576096886940393
STAT,1967,18,50-100,1985,0.5399187490386134
STAT,1896,2,na,1898,4063.2283938521177
STAT,1936,7,na,1943,4419.189874496234
STAT,1887,17,30-34,1904,2.0613880331390693
SIM,1856,41,35-39,1897,4
SIM,1877,15,20-24,1892,46
SIM,1977,28,25-29,2005,138
SIM,1835,83,na,1918,307
SIM,1843,28,20-24,1871,1
SIM,1862,39,50-100,1901,6
STAT,1909,40,na,1949,4058.8752343281085
SIM,1807,88,na,1895,97
STAT,1898,17,40-44,1915,0.2852703017266796
SIM,1911,17,25-29,1928,20
STAT,1847,15,35-39,1862,0.5332182818470033
SIM,1852,75,na,1927,422
STAT,1910,34,na,1944,4176.758259727159
STAT,1881,52,40-44,1933,0.011656248731308745
STAT,1837,41,25-29,1878,0.555781724272208
SIM,1957,29,30-34,1986,73
STAT,1864,4,na,1868,3122.249430340608
STAT,1835,28,20-24,1863,9.490609860869553
STAT,1953,28,45-49,1981,2.4211029027960493
SIM,1872,34,45-49,1906,4
STAT,1895,20,15-19,1915,4.985336351444664
STAT,1826,103,na,1929,0.07902016726883657
STAT,1957,32,15-19,1989,0.19930666117808268
SIM,1908,30,na,1938,3981
STAT,1893,44,15-19,1937,0.0013800037967405564
SIM,1961,28,45-49,1989,6
SIM,1868,44,30-34,1912,4
STAT,1926,69,na,1995,4203.647423343758
STAT,1903,17,25-29,1920,9.314839041316688
STAT,1848,41,35-39,1889,1.9464493047916387
STAT,1949,29,30-34,1978,52.76473111295961
STAT,1821,40,na,1861,1722.2725349376908
STAT,1942,28,35-39,1970,18.17931661752358
SIM,1845,41,25-29,1886,1
SIM,1950,28,35-39,1978,68
STAT,1934,45,25-29,1979,0.08573345131628518
STAT,1851,33,20-24,1884,2.2079650519353797
SIM,1894,34,30-34,1928,35
STAT,1912,45,40-44,1957,0.1758535549121288
STAT,1954,45,45-49,1999,0.3240375824665545
STAT,1981,29,20-24,2010,29.554667972160473
STAT,1957,1,na,1958,5991.243497583357
SIM,1850,28,30-34,1878,27
SIM,1932,23,20-24,1955,160
SIM,1977,19,na,1996,5489
SIM,1960,22,20-24,1982,177
STAT,1967,35,na,2002,5597.18739423131
STAT,1979,23,na,2002,5819.894029902348
STAT,1928,18,40-44,1946,2.0285480014241677
SIM,1833,34,50-100,1867,1
SIM,1929,15,na,1944,5424
STAT,1969,15,25-29,1984,62.506359145038026
STAT,1870,33,25-29,1903,11.604081935167272
SIM,1916,18,20-24,1934,32
SIM,1899,62,na,1961,3201
STAT,1842,28,30-34,1870,23.79186632216222
STAT,1908,18,20-24,1926,30.30870235373305
STAT,1886,34,30-34,1920,21.071941148488968
STAT,1957,21,na,1978,5576.6558823523
STAT,1970,40,20-24,2010,0.02658729517651206
SIM,1975,5,na,1980,6132
SIM,1936,18,40-44,1954,2
SIM,1828,42,35-39,1870,2
STAT,1852,7,na,1859,2822.380011845202
STAT,1924,23,20-24,1947,150.91104269962736
STAT,1950,46,20-24,1996,0.01572421681520089
SIM,1882,8,na,1890,3572
STAT,1836,93,na,1929,26.59708955198377
STAT,1952,22,20-24,1974,154.28706332596965
STAT,1948,46,30-34,1994,0.12276379825936716
SIM,1937,10,na,1947,4493
STAT,1995,18,25-29,2013,72.36981450636716
STAT,1858,15,45-49,1873,0.06951310446146582
SIM,1943,28,25-29,1971,12
STAT,1935,28,25-29,1963,103.549292182329
STAT,1823,54,45-49,1877,0.013273024444804679
STAT,1869,15,20-24,1884,20.326665557822874
SIM,1823,95,na,1918,82
STAT,1803,54,25-29,1857,0.012345292840105368
STAT,1892,33,50-100,1925,1.3196963102320853
SIM,1841,38,na,1879,1882
SIM,1798,89,na,1887,29
STAT,1950,18,15-19,1968,61.9077211462409
SIM,1825,76,na,1901,733
SIM,1939,22,na,1961,4408
STAT,1972,35,40-44,2007,2.2828113303790145
STAT,1873,39,15-19,1912,0.06551153328773526
STAT,1896,65,na,1961,2746.147090521738
STAT,1936,21,25-29,1957,102.00774312703322
STAT,1873,50,25-29,1923,0.004234211630758026
STAT,1974,13,na,1987,5918.427542821211
SIM,1982,32,na,2014,6621
STAT,1861,18,20-24,1879,19.43459381383468
STAT,1891,59,na,1950,2771.9982464291948
SIM,1935,38,45-49,1973,2
STAT,1960,35,25-29,1995,1.5273466400729874
SIM,1900,67,na,1967,2564
SIM,1934,32,20-24,1966,5
SIM,1851,48,35-39,1899,1
STAT,1925,21,15-19,1946,7.373194804911262
STAT,1890,74,na,1964,1886.9953663626106
SIM,1868,70,na,1938,1852
STAT,1843,75,na,1918,1032.9426527622832
STAT,1926,32,20-24,1958,3.403013698239439
STAT,1854,39,50-100,1893,0.9901713717968346
SIM,1855,35,50-100,1890,4
SIM,1911,31,50-100,1942,2
STAT,1927,38,45-49,1965,0.9769454243415395
STAT,1912,15,na,1927,4532.437330627143
SIM,1838,27,35-39,1865,20
STAT,1778,91,na,1869,23.888022128496516
STAT,1809,94,na,1903,9.289123915757552
STAT,1836,43,30-34,1879,1.2292767600289343
SIM,1944,21,25-29,1965,273
STAT,1966,39,30-34,2005,2.7008003384886488
SIM,1818,94,na,1912,39
STAT,1814,103,na,1917,0.0894842697050777
STAT,1941,22,45-49,1963,1.3422333699268387
STAT,1823,48,15-19,1871,3.897257554305125E-4
SIM,1844,43,30-34,1887,1
STAT,1843,48,35-39,1891,0.13870828306407856
STAT,1852,31,15-19,1883,0.1404652087569987
STAT,1872,22,35-39,1894,6.762167180065794
STAT,1849,21,30-34,1870,16.81225983262729
STAT,1947,14,na,1961,5104.5372059881565
SIM,1857,21,30-34,1878,45
STAT,1823,75,na,1898,582.9718520344226
STAT,1943,21,na,1964,4485.689925152674
SIM,1911,59,na,1970,4272
STAT,1997,16,35-39,2013,7.073249164716076
SIM,1904,44,45-49,1948,1
STAT,1975,19,30-34,1994,18.54464695394012
STAT,1812,54,35-39,1866,0.01832126970926599
SIM,1856,68,na,1924,1396
SIM,1805,76,na,1881,418
STAT,1773,117,na,1890,1.4052096161944105E-4
STAT,1840,54,50-100,1894,0.011782281817753986
STAT,1827,52,20-24,1879,9.019906986785686E-4
STAT,1901,45,30-34,1946,0.08914519610671716
SIM,1862,45,40-44,1907,1
STAT,1846,32,35-39,1878,12.37195936614213
STAT,1942,42,15-19,1984,0.001925063223620255
STAT,1976,28,35-39,2004,23.236815547656843
SIM,1854,32,35-39,1886,15
STAT,1966,36,50-100,2002,0.6240623567583363
STAT,1911,34,35-39,1945,10.190187041601392
STAT,1916,38,35-39,1954,2.844610455733616
STAT,1862,33,30-34,1895,16.932825313765626
STAT,1769,103,na,1872,0.07579438479015063
STAT,1804,106,na,1910,0.005279194508666112
SIM,1844,26,15-19,1870,2
STAT,1826,41,15-19,1867,0.010514937400769187
STAT,1876,51,20-24,1927,8.845342306021918E-4
SIM,1968,29,40-44,1997,10
STAT,1960,37,50-100,1997,0.650162525223907
SIM,1860,47,30-34,1907,1
SIM,1984,28,35-39,2012,69
STAT,1959,18,35-39,1977,6.3323753922649715
STAT,1961,18,25-29,1979,64.59211404794502
SIM,1918,31,25-29,1949,7
STAT,1888,32,40-44,1920,5.883079441797018
STAT,1913,6,na,1919,4716.264645799704
STAT,1910,35,50-100,1945,0.468289907440783
STAT,1795,83,na,1878,119.16490059609252
STAT,1970,8,na,1978,5677.56178760202
SIM,1809,69,na,1878,950
SIM,1874,40,40-44,1914,1
STAT,1951,44,15-19,1995,0.0021858992415297825
STAT,1857,35,15-19,1892,0.05095166144476878
SIM,1896,32,40-44,1928,3
STAT,1870,74,na,1944,1262.6333033985488
SIM,1824,38,30-34,1862,3
STAT,1779,76,na,1855,310.16337
STAT,1874,67,na,1941,1872.8512277627592
STAT,1962,33,35-39,1995,13.76529134947535
STAT,1866,40,40-44,1906,2.430241650480549
STAT,1894,27,15-19,1921,0.6730855045991644
STAT,1953,25,40-44,1978,6.540887891410417
STAT,1816,52,45-49,1868,0.028414009749351838
SIM,1960,39,na,1999,6172
STAT,1837,26,30-34,1863,23.57376562633345
STAT,1892,55,na,1947,2990.8119030735247
STAT,1841,94,na,1935,17.769424901501353
SIM,1878,18,40-44,1896,1
STAT,1916,15,45-49,1931,0.12289239354965857
SIM,1847,20,na,1867,2696
STAT,1874,31,35-39,1905,12.01348905775614
STAT,1947,43,45-49,1990,0.22448495032536636
SIM,1838,49,na,1887,1593
SIM,1871,31,25-29,1902,16
STAT,1985,23,na,2008,6011.843751929436
SIM,1950,25,30-34,1975,123
STAT,1894,40,50-100,1934,1.583102291323117
STAT,1899,8,na,1907,4110.065697402246
STAT,1805,52,35-39,1857,0.030764747369128494
STAT,1942,25,30-34,1967,47.508726418453996
STAT,1885,18,50-100,1903,0.05624725036337875
STAT,1883,92,na,1975,213.70428429695
STAT,1909,16,15-19,1925,10.307572022828817
SIM,1929,16,40-44,1945,5
STAT,1910,39,45-49,1949,0.7456285838845701
SIM,1836,68,na,1904,875
STAT,1956,35,50-100,1991,0.6616868139975162
SIM,1917,16,15-19,1933,20
STAT,1921,39,20-24,1960,0.33883527611379616
STAT,1997,15,50-100,2012,0.6316979114610259
SIM,1900,15,25-29,1915,11
SIM,1864,17,35-39,1881,1
SIM,1858,49,na,1907,2480
STAT,1898,91,na,1989,445.3302628594035
STAT,1906,49,30-34,1955,0.08997164694225042
STAT,1959,26,20-24,1985,27.68725689061738
STAT,1945,17,50-100,1962,0.47231307783825566
STAT,1874,16,40-44,1890,0.2166210344241391
STAT,1859,59,na,1918,1786.6357497697497
SIM,1882,31,35-39,1913,4
SIM,1928,15,50-100,1943,1
STAT,1838,44,45-49,1882,1.345014834810986
STAT,1856,17,35-39,1873,0.5712467028120359
STAT,1970,43,25-29,2013,0.10703817736677024
STAT,1883,22,50-100,1905,0.46043300495235656
STAT,1856,93,na,1949,25.731476789224217
SIM,1891,22,50-100,1913,1
STAT,1869,66,na,1935,1831.7713591677407
SIM,1840,20,40-44,1860,5
SIM,1851,90,na,1941,181
SIM,1999,12,na,2011,6971
STAT,1836,100,na,1936,0.9661689583250999
STAT,1838,20,na,1858,2437.7147005916077
STAT,1931,33,40-44,1964,5.915285117260276
SIM,1810,77,na,1887,201
SIM,1932,26,25-29,1958,114
SIM,1856,26,40-44,1882,5
SIM,1942,11,na,1953,5057
SIM,1964,35,50-100,1999,1
STAT,1948,49,35-39,1997,0.1760725036919812
STAT,1921,18,50-100,1939,0.4913720939273702
STAT,1924,26,25-29,1950,88.72163820117117
STAT,1863,16,30-34,1879,1.8461982150357927
SIM,1849,86,na,1935,132
STAT,1980,31,na,2011,6179.838537118541
SIM,1871,16,30-34,1887,3
SIM,1841,83,na,1924,353
SIM,1861,38,na,1899,1858
SIM,1982,16,45-49,1998,2
STAT,1811,87,na,1898,90.71435390476063
STAT,1974,16,45-49,1990,0.7529829537623849
STAT,1823,51,40-44,1874,0.010220380074367924
STAT,1842,42,45-49,1884,1.19156106664566
SIM,1931,59,na,1990,5648
SIM,1878,33,35-39,1911,12
STAT,1901,23,na,1924,3811.2469910965833
STAT,1870,30,20-24,1900,3.1000552954809892
STAT,1808,98,na,1906,1.6563958460088246
STAT,1902,34,25-29,1936,9.508111027395334
SIM,1961,25,40-44,1986,19
SIM,1888,15,30-34,1903,7
SIM,1901,32,25-29,1933,36
STAT,1885,19,20-24,1904,20.298035565598205
STAT,1827,41,50-100,1868,1.4354743115429602
STAT,1981,3,na,1984,6347.918902590088
SIM,1909,15,na,1924,4966
SIM,1850,42,45-49,1892,3
STAT,1848,26,40-44,1874,3.827224307194883
STAT,1940,43,50-100,1983,0.14287756538681323
SIM,1835,41,50-100,1876,5
STAT,1909,26,na,1935,4149.1267459959645
STAT,1937,21,na,1958,4107.525137449006
STAT,1854,45,40-44,1899,0.14086664050379263
STAT,1864,31,40-44,1895,4.486995059018142
STAT,1861,47,40-44,1908,0.1634847721598169
SIM,1863,40,30-34,1903,1
STAT,1911,30,na,1941,4287.974377892765
SIM,1945,24,45-49,1969,3
SIM,1884,63,na,1947,1992
STAT,1810,53,20-24,1863,0.0026476407966968016
SIM,1910,34,25-29,1944,10
STAT,1874,0,na,1874,4353.651377259116
STAT,1905,43,40-44,1948,0.2590102276574165
SIM,1957,10,na,1967,6328
STAT,1890,24,45-49,1914,0.9771515616158095
STAT,1883,25,15-19,1908,0.5157474594773421
STAT,1855,12,na,1867,2416.0164058994987
STAT,1821,53,30-34,1874,0.010175503707548687
SIM,1930,31,40-44,1961,12
SIM,1935,35,40-44,1970,1
STAT,1980,23,30-34,2003,46.18281121369991
STAT,1904,32,35-39,1936,9.636666056350222
SIM,1977,31,na,2008,6019
STAT,1880,35,40-44,1915,5.405596589471036
STAT,1941,47,25-29,1988,0.0656024981911407
SIM,1874,56,na,1930,2269
SIM,1929,69,na,1998,3855
STAT,1820,42,25-29,1862,0.7941777427271219
SIM,1937,26,50-100,1963,3
STAT,1976,25,30-34,2001,60.72568820466964
STAT,1915,32,45-49,1947,1.849835242289901
STAT,1848,49,30-34,1897,0.10070519657940737
SIM,1892,4,na,1896,4162
STAT,1805,87,na,1892,72.40109465520395
STAT,1862,36,35-39,1898,6.92170241369041
STAT,1972,41,35-39,2013,0.30966048345256086
STAT,1937,24,45-49,1961,1.2643110234821568
STAT,1831,42,35-39,1873,1.735490563933832
STAT,1861,30,45-49,1891,1.6864837056557636
STAT,1840,44,35-39,1884,1.4769784690576302
SIM,1909,45,40-44,1954,1
STAT,1927,35,40-44,1962,2.15116591388613
SIM,1834,87,na,1921,245
SIM,1812,58,na,1870,1113
STAT,1875,34,20-24,1909,3.1960558204986023
STAT,1906,30,45-49,1936,1.6986081572143623
SIM,1923,32,45-49,1955,4
STAT,1849,12,na,1861,2277.5375909697705
STAT,1950,49,25-29,1999,0.07484775611257294
SIM,1984,25,30-34,2009,7
SIM,1819,39,35-39,1858,4
SIM,1889,55,na,1944,3293
STAT,1846,40,20-24,1886,0.17047837568722238
STAT,1930,22,35-39,1952,13.922412343648062
SIM,1924,35,30-34,1959,8
SIM,1977,15,25-29,1992,88
STAT,1916,35,30-34,1951,2.174609676247904
SIM,1890,63,na,1953,2543
STAT,1852,47,30-34,1899,0.09083886129536428
STAT,1961,30,15-19,1991,0.19552371028917884
STAT,1911,31,30-34,1942,17.792672075391668
SIM,1853,28,50-100,1881,1
STAT,1857,78,na,1935,702.2701779774483
STAT,1940,27,20-24,1967,21.488351013084632
STAT,1867,85,na,1952,295.37667633281563
STAT,1845,28,50-100,1873,0.5209095765762529
SIM,1904,41,40-44,1945,1
STAT,1943,45,35-39,1988,0.16490562065480927
SIM,1925,18,30-34,1943,28
SIM,1975,17,15-19,1992,124
STAT,1851,36,25-29,1887,2.331725491944208
SIM,1845,29,35-39,1874,1
SIM,1914,30,45-49,1944,9
SIM,1912,32,35-39,1944,29
STAT,1920,33,30-34,1953,19.82318960943917
SIM,1859,16,15-19,1875,11
SIM,1803,95,na,1898,4
STAT,1960,10,na,1970,5905.906519042119
SIM,1870,49,na,1919,2854
STAT,1843,45,30-34,1888,0.09918360685402776
STAT,1950,16,25-29,1966,59.14935119704335
STAT,1913,101,na,2014,25.143169081997478
STAT,1814,54,35-39,1868,0.021986551014320472
STAT,1952,47,35-39,1999,0.18546525009700152
STAT,1797,64,na,1861,1015.5013286877779
STAT,1781,80,na,1861,183.8743329978913
STAT,1836,46,35-39,1882,0.13510494642837534
STAT,1901,24,50-100,1925,0.6550595370190014
STAT,1812,51,30-34,1863,0.013453071772484438
STAT,1842,79,na,1921,537.9791329849064
SIM,1891,25,15-19,1916,1
SIM,1885,48,na,1933,2990
STAT,1876,54,25-29,1930,0.004109346733591021
SIM,1913,85,na,1998,2101
STAT,1917,18,30-34,1935,3.0191314465153414
STAT,1850,20,na,1870,2680.2099777374874
STAT,1967,17,15-19,1984,65.42310642878054
STAT,1938,38,45-49,1976,0.7991262728250871
STAT,1904,24,30-34,1928,29.334064330850257
SIM,1859,79,na,1938,212
STAT,1956,48,50-100,2004,0.3582625938509511
SIM,1972,20,35-39,1992,29
STAT,1840,44,45-49,1884,1.220724816243275
STAT,1917,38,na,1955,4487.388713739006
STAT,1953,27,30-34,1980,54.937474302478215
STAT,1841,37,15-19,1878,0.05882319456457878
SIM,1958,17,30-34,1975,45
STAT,1884,10,na,1894,2953.5440707665466
STAT,1934,36,35-39,1970,3.8573951322805775
STAT,1886,1,na,1887,3814.022800782068
STAT,1913,24,na,1937,4231.247119393484
SIM,1908,35,20-24,1943,1
SIM,1961,27,30-34,1988,67
STAT,1929,32,35-39,1961,13.396524372443334
SIM,1855,65,na,1920,1224
STAT,1839,108,na,1947,0.0014526480018808277
STAT,1836,33,15-19,1869,0.16218333636658955
STAT,1827,97,na,1924,4.362907504049344
STAT,1869,3,na,1872,3517.9481184125198
SIM,1851,51,na,1902,2532
STAT,1835,40,45-49,1875,1.1482662723722155
STAT,1825,54,20-24,1879,9.543046177229954E-4
STAT,1900,97,na,1997,99.88209135244549
STAT,1865,23,40-44,1888,2.180385712439132
STAT,1958,36,20-24,1994,0.4120229125122687
SIM,1864,25,40-44,1889,4
STAT,1822,66,na,1888,1352.822300993805
STAT,1871,67,na,1938,1820.0303867720163
STAT,1856,25,40-44,1881,2.7726663926225603
STAT,1788,89,na,1877,56.6366337805202
STAT,1805,70,na,1875,837.2230953181588
STAT,1846,36,50-100,1882,1.3392551404772401
SIM,1870,42,30-34,1912,1
STAT,1845,31,15-19,1876,0.11529031635774721
SIM,1942,36,35-39,1978,3
SIM,1957,38,20-24,1995,1
STAT,1924,81,na,2005,2392.9256768054083
STAT,1964,20,35-39,1984,13.740919986472335
STAT,1973,26,45-49,1999,2.59084857087575
STAT,1846,18,35-39,1864,0.7083780803148858
STAT,1925,38,35-39,1963,3.3457736872926427
STAT,1943,4,na,1947,4897.356123439766
SIM,1974,19,na,1993,6381
STAT,1918,71,na,1989,3441.0845218535774
SIM,1899,29,20-24,1928,26
STAT,1806,49,15-19,1855,0.0014260981857003258
STAT,1926,6,na,1932,5669.920839090047
SIM,1889,30,40-44,1919,2
STAT,1784,75,na,1859,419.60488471366705
STAT,1809,84,na,1893,154.61511045676514
STAT,1915,25,45-49,1940,2.0477395399206264
SIM,1844,33,15-19,1877,2
SIM,1843,40,45-49,1883,5
SIM,1963,22,35-39,1985,35
SIM,1806,64,na,1870,956
STAT,1798,83,na,1881,124.3175167613303
STAT,1974,19,15-19,1993,68.34354759578993
STAT,1941,40,35-39,1981,0.2495060433421013
STAT,1927,37,30-34,1964,2.614499863036356
SIM,1987,24,30-34,2011,1
STAT,1814,54,45-49,1868,0.03706304308675661
STAT,1844,42,50-100,1886,0.9049950548979606
SIM,1810,49,30-34,1859,1
STAT,1810,46,50-100,1856,0.9768078569028406
SIM,1858,14,na,1872,3194
SIM,1910,25,35-39,1935,37
STAT,1877,24,na,1901,2821.3372674117286
STAT,1963,43,35-39,2006,0.3063346406532982
SIM,1970,25,30-34,1995,140
STAT,1905,25,50-100,1930,1.0757414799110157
STAT,1964,28,45-49,1992,2.520759275557377
STAT,1897,48,50-100,1945,0.21109778640557678
STAT,1928,38,50-100,1966,0.6117174313115379
STAT,1949,57,na,2006,4903.647325542408
STAT,1892,29,na,1921,3427.2774354271996
STAT,1903,37,45-49,1940,0.7072788531714269
STAT,1960,26,35-39,1986,22.67428735785881
STAT,1897,76,na,1973,2042.684155980834
SIM,1884,78,na,1962,890
STAT,1875,48,25-29,1923,0.06783035931076863
SIM,1934,25,20-24,1959,31
STAT,1944,43,40-44,1987,0.32232950437598507
STAT,1881,61,na,1942,2080.032635858824
STAT,1831,46,45-49,1877,0.2214730261865559
STAT,1885,75,na,1960,1366.290466615556
STAT,1874,35,50-100,1909,1.464288996376348
SIM,1854,18,35-39,1872,2
STAT,1879,42,25-29,1921,0.7728586610526151
STAT,1867,112,na,1979,0.0014848680282374858
STAT,1942,37,na,1979,4675.333548084815
STAT,1871,21,15-19,1892,3.7991318519170627
STAT,1962,25,30-34,1987,58.239512377147115
SIM,1911,37,45-49,1948,2
SIM,1912,24,30-34,1936,2
STAT,1979,24,30-34,2003,45.78908256171283
STAT,1902,25,35-39,1927,15.8405563698677
SIM,1950,26,50-100,1976,2
STAT,1929,26,50-100,1955,1.4383194900686613
SIM,1873,23,40-44,1896,7
SIM,1937,32,35-39,1969,5
SIM,1922,37,20-24,1959,2
STAT,1873,47,50-100,1920,0.2880877365843045
STAT,1921,59,na,1980,4492.728586712592
STAT,1980,9,na,1989,6295.615480647076
STAT,1818,45,na,1863,1273.267731663116
SIM,1846,9,na,1855,2074
STAT,1842,46,20-24,1888,0.00935493447289496
STAT,1947,36,45-49,1983,0.913841883263218
SIM,1837,52,na,1889,1982
STAT,1914,37,20-24,1951,0.3038884211875243
SIM,1959,33,25-29,1992,32
STAT,1882,15,40-44,1897,0.20712897183134968
STAT,1803,53,30-34,1856,0.021168290609320278
STAT,1840,79,na,1919,560.8232978765664
STAT,1857,41,35-39,1898,1.6349431688648344
STAT,1843,44,na,1887,2327.3236271656538
STAT,1869,23,25-29,1892,63.78047875051654
SIM,1828,28,35-39,1856,19
SIM,1925,27,20-24,1952,40
SIM,1920,32,40-44,1952,3
SIM,1812,44,35-39,1856,2
SIM,1847,33,40-44,1880,1
STAT,1844,15,20-24,1859,19.07364919743859
SIM,1901,27,35-39,1928,33
SIM,1785,69,na,1854,792
SIM,1937,19,na,1956,3814
STAT,1912,32,40-44,1944,4.448128331055405
SIM,1900,26,na,1926,3745
STAT,1926,25,20-24,1951,25.41918846025429
STAT,1889,24,40-44,1913,2.94580499221774
STAT,1882,49,50-100,1931,0.2710637120893977
STAT,1883,42,50-100,1925,1.1913631052684728
STAT,1917,27,20-24,1944,22.092732621646277
STAT,1819,41,15-19,1860,0.02997701495986645
STAT,1858,20,45-49,1878,0.7307551370201306
STAT,1947,39,25-29,1986,1.3158554800507982
STAT,1855,38,50-100,1893,1.0394992278680608
SIM,1963,35,na,1998,6513
SIM,1928,4,na,1932,6082
SIM,1888,29,45-49,1917,1
STAT,1868,19,25-29,1887,6.3217126460569855
STAT,1935,65,na,2000,5220.381025319984
SIM,1916,24,15-19,1940,6
SIM,1879,23,35-39,1902,12
SIM,1935,37,30-34,1972,5
SIM,1925,49,40-44,1974,1
SIM,1822,54,45-49,1876,1
SIM,1876,27,na,1903,2527
STAT,1935,48,45-49,1983,0.3533034046971197
SIM,1888,21,35-39,1909,9
SIM,1916,46,35-39,1962,1
STAT,1902,40,na,1942,3819.9475480483284
SIM,1945,2,na,1947,4846
STAT,1908,35,50-100,1943,0.45854374181709806
STAT,1834,67,na,1901,1446.6707318927383
SIM,1893,39,na,1932,3306
SIM,1936,20,25-29,1956,270
STAT,1839,33,40-44,1872,4.188651507822989
SIM,1817,48,na,1865,1429
STAT,1903,31,50-100,1934,1.512258444935419
STAT,1921,75,na,1996,3167.9637814269636
SIM,1966,38,30-34,2004,8
STAT,1908,24,15-19,1932,5.619427864385359
SIM,1909,87,na,1996,1544
STAT,1869,32,15-19,1901,0.1591559998071968
STAT,1828,27,50-100,1855,1.037978774542267
STAT,1906,54,na,1960,3632.3611836279224
SIM,1977,25,na,2002,5963
SIM,1905,73,na,1978,2688
SIM,1876,19,25-29,1895,19
STAT,1917,49,40-44,1966,0.18893906904483296
STAT,1895,18,30-34,1913,2.388024828246585
STAT,1923,35,20-24,1958,0.35297336942029767
SIM,1984,13,na,1997,6303
STAT,1815,47,15-19,1862,8.166405490467258E-4
STAT,1888,46,50-100,1934,0.3341206656459911
SIM,1866,20,45-49,1886,2
SIM,1863,47,45-49,1910,1
STAT,1914,27,50-100,1941,1.158539333854912
STAT,1801,88,na,1889,54.483539068692984
STAT,1851,47,25-29,1898,0.04546355554315936
STAT,1948,29,15-19,1977,0.9354349122690949
STAT,1832,25,50-100,1857,0.633006024097447
STAT,1908,46,35-39,1954,0.13574895176162374
STAT,1988,22,30-34,2010,47.59539862584651
STAT,1895,22,15-19,1917,4.955767420693968
SIM,1873,94,na,1967,31
STAT,1819,62,na,1881,1316.478566226059
STAT,1855,47,45-49,1902,0.19987515521407756
STAT,1881,45,na,1926,2529.3306675279855
STAT,1938,16,na,1954,4202.527677022861
STAT,1885,59,na,1944,2237.139579506314
SIM,1869,57,na,1926,1640
STAT,1984,28,30-34,2012,64.46934611706337
STAT,1835,40,50-100,1875,0.8105408958223838
SIM,1865,43,na,1908,2798
SIM,1946,30,35-39,1976,14
SIM,1904,97,na,2001,160
STAT,1928,16,40-44,1944,2.038871994919071
STAT,1938,33,50-100,1971,0.9592852878214309
STAT,1865,38,15-19,1903,0.05818126083331159
STAT,1914,34,40-44,1948,4.509210484510609
STAT,1938,30,35-39,1968,10.621351525750454
SIM,1946,38,45-49,1984,1
STAT,1915,20,50-100,1935,0.7578586129844797
SIM,1960,15,20-24,1975,394
STAT,1901,101,na,2002,21.106563833670403
STAT,1920,32,15-19,1952,0.16237019726817248
STAT,1956,29,na,1985,5739.691691096979
STAT,1927,41,15-19,1968,0.0022253801243349034
STAT,1890,35,45-49,1925,2.837752811234698
STAT,1886,92,na,1978,246.6930502643428
STAT,1952,15,20-24,1967,187.59621526910115
STAT,1798,67,na,1865,676.7410205037072
STAT,1930,17,35-39,1947,6.261473738307514
SIM,1902,17,25-29,1919,12
STAT,1862,45,35-39,1907,0.13770989408499834
STAT,1809,50,45-49,1859,0.03656118512976131
SIM,1796,69,na,1865,780
SIM,1860,12,na,1872,2946
STAT,1878,105,na,1983,1.1903082747591205
STAT,1915,28,25-29,1943,77.2183024906306
STAT,1963,48,40-44,2011,0.23977187416040402
SIM,1830,46,na,1876,1746
STAT,1917,54,na,1971,4312.9728529533595
STAT,1891,28,15-19,1919,0.6448463034963837
STAT,1943,39,40-44,1982,1.883564041698127
STAT,1879,63,na,1942,2150.1203059468353
STAT,1913,40,na,1953,4229.296093686048
SIM,1945,22,na,1967,4151
STAT,1981,17,50-100,1998,0.6045875990388992
SIM,1889,42,35-39,1931,2
SIM,1864,26,na,1890,2798
STAT,1953,31,15-19,1984,0.18297230001315534
SIM,1934,0,na,1934,6216
STAT,1978,27,50-100,2005,1.574420781167612
STAT,1886,24,15-19,1910,3.990798252933938
SIM,1918,46,45-49,1964,1
STAT,1975,34,15-19,2009,0.1991676845734512
SIM,1926,19,na,1945,5416
SIM,1907,1,na,1908,4936
STAT,1938,35,40-44,1973,1.7596205030089944
STAT,1892,44,50-100,1936,0.10468125134993057
STAT,1855,41,25-29,1896,0.5488809268129834
SIM,1968,38,40-44,2006,3
SIM,1894,24,15-19,1918,12
STAT,1944,46,45-49,1990,0.28146792513267155
STAT,1843,71,na,1914,1339.3135292799584
STAT,1903,40,15-19,1943,0.0015922602112185588
STAT,1897,107,na,2004,0.5711130856709049
SIM,1968,27,40-44,1995,16
STAT,1963,40,30-34,2003,0.19533740296798227
STAT,1868,15,50-100,1883,0.05596141321399737
STAT,1847,22,35-39,1869,5.504468372815651
STAT,1910,32,30-34,1942,17.549646685328824
STAT,1954,18,35-39,1972,5.984583504891278
STAT,1886,46,35-39,1932,0.1709074251005749
SIM,1952,46,45-49,1998,1
STAT,1973,39,na,2012,5772.780860853253
STAT,1825,30,35-39,1855,24.904487419111216
STAT,1914,49,15-19,1963,4.193425104562356E-4
SIM,1872,77,na,1949,1342
SIM,1780,81,na,1861,86
STAT,1879,44,50-100,1923,1.2558607600603904
STAT,1869,20,45-49,1889,0.7873383467832935
STAT,1930,36,na,1966,5669.13896411439
STAT,1975,23,15-19,1998,8.128481657230834
SIM,1861,47,35-39,1908,1
SIM,1869,15,15-19,1884,11
STAT,1937,8,na,1945,4480.203840203019
STAT,1945,41,50-100,1986,0.15413468994068608
STAT,1962,28,35-39,1990,22.28547500576831
SIM,1833,30,35-39,1863,20
STAT,1903,34,40-44,1937,4.0581952177539495
STAT,1959,40,20-24,1999,0.02778256747109883
SIM,1970,28,35-39,1998,11
STAT,1778,108,na,1886,0.006861256621841492
STAT,1925,35,30-34,1960,2.528023139067902
SIM,1880,48,na,1928,3148
SIM,1912,27,35-39,1939,2
STAT,1928,20,25-29,1948,133.88531667290638
SIM,1932,22,50-100,1954,5
STAT,1894,34,15-19,1928,0.20945858021199906
STAT,1814,51,40-44,1865,0.028551036818075432
SIM,1986,15,25-29,2001,175
STAT,1928,28,35-39,1956,21.335235456691077
SIM,1911,34,40-44,1945,1
STAT,1841,27,50-100,1868,0.7064077228581177
STAT,1877,50,50-100,1927,0.018390554966629013
SIM,1877,20,45-49,1897,2
STAT,1943,17,20-24,1960,165.93100114889717
STAT,1875,45,20-24,1920,0.014453821536269007
SIM,1933,35,30-34,1968,1
STAT,1853,47,35-39,1900,0.13873683104026066
STAT,1904,27,35-39,1931,15.99038942540533
SIM,1887,27,na,1914,3827
SIM,1959,30,20-24,1989,1
STAT,1928,79,na,2007,2933.2213597149657
STAT,1933,45,30-34,1978,0.14220353488342535
STAT,1974,41,45-49,2015,0.2610134501713528
STAT,1979,27,35-39,2006,23.95938283976102
STAT,1876,98,na,1974,31.841822789115625
STAT,1868,47,na,1915,2482.9208896292694
SIM,1951,17,20-24,1968,232
SIM,1863,7,na,1870,3051
STAT,1924,22,50-100,1946,0.8957856633246054
SIM,1951,39,40-44,1990,3
STAT,1951,27,20-24,1978,25.19366047474648
STAT,1829,51,25-29,1880,0.003559340356644858
STAT,1958,39,25-29,1997,1.5342728371757388
STAT,1830,34,35-39,1864,10.532626906671409
SIM,1987,27,35-39,2014,55
STAT,1941,18,25-29,1959,51.50838043555273
STAT,1872,84,na,1956,418.0195205086509
SIM,1958,29,25-29,1987,106
STAT,1941,15,45-49,1956,0.5942614067947379
SIM,1970,20,25-29,1990,3
STAT,1879,30,30-34,1909,21.208405902445904
SIM,1893,82,na,1975,953
SIM,1877,20,20-24,1897,98
STAT,1901,46,25-29,1947,0.05267057662954767
SIM,1905,57,na,1962,3611
STAT,1843,28,na,1871,2652.111836383476
STAT,1932,2,na,1934,6251.346586986725
STAT,1804,54,50-100,1858,0.06677739929064731
STAT,1907,71,na,1978,2886.197607337102
STAT,1858,53,50-100,1911,0.013378482804801004
STAT,1940,39,15-19,1979,0.02314015773641606
SIM,1990,23,na,2013,5473
SIM,1908,22,na,1930,4220
SIM,1841,40,35-39,1881,3
STAT,1816,97,na,1913,2.6530809729952987
STAT,1959,21,na,1980,5532.7102818119265
SIM,1975,31,50-100,2006,1
STAT,1961,38,45-49,1999,1.0461291524187417
STAT,1917,22,15-19,1939,6.529253183462775
STAT,1962,20,25-29,1982,137.13061297506687
STAT,1964,25,40-44,1989,6.810121041783198
STAT,1961,49,45-49,2010,0.3350876624620767
STAT,1869,20,20-24,1889,77.80836151531621
STAT,1937,17,45-49,1954,0.5611370330536798
SIM,1878,46,50-100,1924,1
SIM,1971,43,35-39,2014,3
STAT,1885,115,na,2000,1.942128779869901E-4
STAT,1868,16,20-24,1884,20.13129825169888
SIM,1901,26,20-24,1927,38
STAT,1880,44,na,1924,2789.0418418724794
SIM,1898,31,45-49,1929,4
STAT,1833,40,35-39,1873,1.5956449652280529
STAT,1929,55,na,1984,5323.213138813591
SIM,1897,27,45-49,1924,2
SIM,1931,71,na,2002,4539
STAT,1867,62,na,1929,1969.3591524514882
STAT,1889,27,45-49,1916,1.5794831012088022
STAT,1922,76,na,1998,3091.379585599042
STAT,1946,48,20-24,1994,0.01467233098204365
STAT,1962,39,35-39,2001,3.6768852980212943
SIM,1838,35,40-44,1873,9
STAT,1860,83,na,1943,369.24103912596127
STAT,1878,51,20-24,1929,8.934143596164121E-4
SIM,1970,39,35-39,2009,2
SIM,1972,25,40-44,1997,14
STAT,1862,42,30-34,1904,1.1183206209329322
STAT,1830,31,50-100,1861,1.0111143302393133
STAT,1896,59,na,1955,2962.3953890883918
STAT,1892,45,na,1937,3287.3014808291427
STAT,1869,28,30-34,1897,28.044435306470735
SIM,1881,21,25-29,1902,122
STAT,1886,76,na,1962,1411.377513954354
SIM,1847,30,na,1877,2760
STAT,1946,45,40-44,1991,0.21089674349946355
STAT,1955,22,35-39,1977,14.47297187957006
SIM,1925,22,15-19,1947,1
SIM,1818,49,na,1867,2039
SIM,1914,18,na,1932,4224
STAT,1762,96,na,1858,1.9662764776170785
SIM,1922,69,na,1991,3676
STAT,1881,29,na,1910,2637.5219069674554
STAT,1977,20,20-24,1997,174.07839912017667
STAT,1878,17,40-44,1895,0.2203900569547298
STAT,1882,62,na,1944,2060.2459570701867
SIM,1857,13,na,1870,2899
SIM,1888,30,25-29,1918,16
STAT,1916,18,15-19,1934,11.08402649596905
STAT,1851,20,35-39,1871,5.606362503676775
SIM,1850,34,na,1884,1677
STAT,1889,41,na,1930,3302.7756206613694
SIM,1923,28,25-29,1951,170
SIM,1887,30,30-34,1917,34
SIM,1840,39,15-19,1879,1
SIM,2002,10,na,2012,6942
STAT,1869,49,50-100,1918,0.2687535715840539
STAT,1863,54,40-44,1917,0.010331417243938192
SIM,1952,35,na,1987,4758
SIM,1859,31,na,1890,2300
STAT,1923,38,25-29,1961,1.3147814985533004
STAT,1920,58,na,1978,4443.967025178382
STAT,1840,41,40-44,1881,1.9064932449540386
STAT,1910,75,na,1985,2625.589601726176
SIM,1886,26,30-34,1912,27
STAT,1832,39,15-19,1871,0.04827344366952602
SIM,1863,44,40-44,1907,7
SIM,1806,48,na,1854,1498
STAT,1902,24,na,1926,3832.3720587089747
STAT,1956,37,50-100,1993,0.6605425895600012
STAT,1878,26,30-34,1904,30.447199514166602
STAT,1839,48,15-19,1887,3.1909138482942616E-4
SIM,1817,64,na,1881,800
STAT,1848,59,na,1907,2064.9845051775947
SIM,1820,68,na,1888,1324
SIM,1948,19,15-19,1967,51
STAT,1969,28,45-49,1997,2.5001375576612705
SIM,1856,66,na,1922,1456
STAT,1860,29,25-29,1889,39.197489219964616
SIM,1938,20,35-39,1958,20
STAT,1810,47,15-19,1857,0.0015565882517980956
SIM,1926,30,50-100,1956,2
STAT,1881,31,25-29,1912,11.447934047701844
SIM,1922,37,45-49,1959,4
STAT,1890,32,40-44,1922,6.115291538847932
SIM,1919,27,45-49,1946,5
STAT,1859,2,na,1861,3195.8471747095737
STAT,1910,35,35-39,1945,2.6977782630044356
STAT,1866,30,45-49,1896,1.8802936528513183
SIM,1972,39,45-49,2011,2
STAT,1964,39,45-49,2003,1.0186889445089324
SIM,1934,16,30-34,1950,45
STAT,1830,31,30-34,1861,19.267510118340002
STAT,1839,50,na,1889,1750.0578724479928
STAT,1874,32,na,1906,2819.300598459411
SIM,1879,20,30-34,1899,1
SIM,1918,40,25-29,1958,1
SIM,1801,60,na,1861,1387
SIM,1875,38,25-29,1913,13
SIM,1984,18,30-34,2002,47
STAT,1891,16,45-49,1907,0.09339950510879472
STAT,1903,62,na,1965,3259.524281427399
STAT,1907,76,na,1983,2402.3502090039538
SIM,1807,86,na,1893,136
SIM,1879,32,25-29,1911,17
SIM,1887,43,na,1930,3655
STAT,1916,5,na,1921,4907.45323642004
SIM,1840,24,40-44,1864,3
STAT,1823,67,na,1890,897.6895761639038
STAT,1933,48,35-39,1981,0.20413374811913004
STAT,1867,38,25-29,1905,3.0869142251169164
STAT,1990,21,35-39,2011,15.618349518720963
STAT,1953,5,na,1958,5489.013978017884
STAT,1822,82,na,1904,383.35657890615687
STAT,1826,96,na,1922,4.727861315061932
STAT,1837,21,15-19,1858,3.1498933853233964
SIM,1845,21,15-19,1866,1
STAT,1908,45,20-24,1953,0.011718356458662869
STAT,1783,74,na,1857,324.32890320561955
STAT,1914,37,45-49,1951,0.7858836376921197
STAT,1923,80,na,2003,2521.874200823756
SIM,1985,14,na,1999,6442
STAT,1787,88,na,1875,36.99010125263039
STAT,1963,32,35-39,1995,13.65723498838834
SIM,1944,30,25-29,1974,13
SIM,1866,25,15-19,1891,1
STAT,1840,108,na,1948,0.0014694114640577368
STAT,1914,25,na,1939,4389.920892362971
STAT,1918,39,na,1957,4565.59272899933
SIM,1828,48,na,1876,2096
STAT,1920,30,25-29,1950,11.77227197882699
SIM,1847,14,na,1861,3034
SIM,1945,17,45-49,1962,1
STAT,1864,42,40-44,1906,2.314893817448569
STAT,1904,15,40-44,1919,0.3045187544355115
STAT,1843,50,45-49,1893,0.014770734604616136
STAT,1890,97,na,1987,79.87783655766943
SIM,1882,35,50-100,1917,3
STAT,1847,58,na,1905,1521.6709881716283
SIM,2003,11,na,2014,6666
SIM,1883,21,35-39,1904,13
STAT,1929,41,25-29,1970,0.1068822240817272
STAT,1937,42,35-39,1979,0.23453005293911117
SIM,1878,19,35-39,1897,1
STAT,1881,0,na,1881,3989.0345956096876
SIM,1929,22,35-39,1951,33
STAT,1876,26,20-24,1902,14.043401751018223
SIM,1884,26,20-24,1910,28
SIM,1947,59,na,2006,5459
STAT,1832,24,40-44,1856,2.1630021278444636
STAT,1807,50,35-39,1857,0.03521333784766022
SIM,1913,25,50-100,1938,2
STAT,1853,44,30-34,1897,1.1291811484350374
STAT,1886,43,30-34,1929,1.38939425226217
STAT,1963,19,15-19,1982,66.49468194872655
SIM,1863,41,25-29,1904,1
STAT,1962,16,40-44,1978,2.0688292513734514
SIM,1872,42,40-44,1914,4
STAT,1830,39,40-44,1869,4.289016462256864
STAT,1934,35,20-24,1969,0.4207467881713891
STAT,1922,47,20-24,1969,0.014644995379828265
STAT,1940,27,45-49,1967,2.033728191351133
SIM,1872,13,na,1885,3295
SIM,1896,36,40-44,1932,3
STAT,1926,16,30-34,1942,17.28495944711576
SIM,1888,41,50-100,1929,4
SIM,1922,83,na,2005,1344
SIM,1940,39,na,1979,4967
SIM,1895,78,na,1973,1142
SIM,1848,40,45-49,1888,4
SIM,1971,19,15-19,1990,130
STAT,1869,80,na,1949,691.3483551421235
STAT,1953,37,na,1990,5411.103230257574
STAT,1833,27,15-19,1860,0.4274600430708964
SIM,1926,76,na,2002,3978
SIM,1956,22,na,1978,5477
STAT,1880,18,50-100,1898,0.0597718726413504
SIM,1908,30,50-100,1938,1
SIM,1914,61,na,1975,3642
STAT,1905,18,15-19,1923,9.88664158675609
STAT,1949,39,35-39,1988,3.3374445427667143
STAT,1873,10,na,1883,3130.312287096549
SIM,1904,72,na,1976,2930
SIM,1970,16,40-44,1986,3
STAT,1946,40,35-39,1986,0.26860249580825507
STAT,1936,38,35-39,1974,2.739188126382071
SIM,1908,86,na,1994,471
SIM,1866,65,na,1931,1724
STAT,1892,49,15-19,1941,3.195492743371195E-4
SIM,1964,18,45-49,1982,5
SIM,1920,22,15-19,1942,14
STAT,1772,90,na,1862,3.6804957350152234
STAT,1901,43,20-24,1944,0.017698282306022616
STAT,1921,20,15-19,1941,6.97747520864388
SIM,1898,0,na,1898,4358
STAT,1832,71,na,1903,909.3867597878714
STAT,1916,41,15-19,1957,0.0018189645237453277
SIM,1919,49,na,1968,5250
SIM,1939,53,na,1992,4694
SIM,1963,31,25-29,1994,5
STAT,1976,19,25-29,1995,66.7695042832493
SIM,1861,44,50-100,1905,1
STAT,1956,18,45-49,1974,0.7625925345475674
STAT,1951,41,na,1992,5311.7153607893915
SIM,1935,23,na,1958,5871
SIM,1862,51,na,1913,2685
SIM,1915,35,na,1950,4704
STAT,1911,28,40-44,1939,5.231735914328759
SIM,1978,26,na,2004,5510
STAT,1848,18,45-49,1866,0.08553344247907808
STAT,1867,51,45-49,1918,0.01571177509691987
STAT,1884,112,na,1996,0.004500538719387607
SIM,1954,40,35-39,1994,2
STAT,1808,49,25-29,1857,0.27818028332853817
STAT,1936,30,25-29,1966,10.378330503395949
SIM,1944,38,35-39,1982,3
STAT,1893,41,45-49,1934,2.1930551317657185
STAT,1828,38,35-39,1866,7.1289217486601855
STAT,1935,47,30-34,1982,0.14531826276565926
STAT,1902,22,30-34,1924,29.0452078523012
STAT,1785,104,na,1889,0.023089941147224936
STAT,1937,29,15-19,1966,0.7938092678599356
SIM,1896,39,45-49,1935,1
SIM,1899,24,15-19,1923,1
STAT,1888,39,45-49,1927,2.677095714841984
STAT,1986,28,40-44,2014,7.694018927821592
STAT,1853,41,15-19,1894,0.013811541057158889
STAT,1869,64,na,1933,1942.803809171467
STAT,1873,21,25-29,1894,67.66705021029296
STAT,1836,52,30-34,1888,0.005483210991407011
STAT,1827,54,30-34,1881,0.006363615323409037
STAT,1900,16,50-100,1916,0.07864610537576122
SIM,1910,22,30-34,1932,41
STAT,1966,48,30-34,2014,0.13328468076616207
STAT,1888,24,na,1912,3188.279940490904
SIM,1836,30,na,1866,1689
STAT,1961,37,30-34,1998,2.79964925119599
SIM,1949,7,na,1956,5903
STAT,1896,75,na,1971,2088.87786514726
STAT,1901,37,35-39,1938,2.4677677468614823
STAT,1892,61,na,1953,2702.8586564528837
SIM,1869,25,40-44,1894,7
STAT,1897,22,25-29,1919,88.33763933737796
STAT,1775,110,na,1885,0.0026950197125553653
STAT,1931,30,50-100,1961,1.251949374889672
SIM,1908,26,30-34,1934,82
SIM,1849,41,50-100,1890,3
STAT,1912,44,35-39,1956,0.2226076485441009
STAT,1975,39,20-24,2014,0.412596258579625
STAT,1852,25,20-24,1877,13.069708432756833
STAT,1892,111,na,2003,0.017499590432684738
STAT,1965,40,40-44,2005,0.37554801416686157
STAT,1954,43,50-100,1997,0.17390524641104216
SIM,1947,29,25-29,1976,15
STAT,1853,100,na,1953,1.0569939614549142
STAT,1948,56,na,2004,4858.624896416906
STAT,1977,27,25-29,2004,103.07681147938301
SIM,1816,90,na,1906,21
SIM,1985,27,25-29,2012,12
STAT,1925,37,20-24,1962,0.3650109004857901
SIM,1855,31,25-29,1886,2
SIM,1929,21,50-100,1950,3
SIM,1917,17,20-24,1934,31
STAT,1804,53,na,1857,1477.2156812018047
SIM,1918,48,35-39,1966,1
SIM,1966,5,na,1971,5943
STAT,1871,83,na,1954,455.7912354939383
STAT,1777,89,na,1866,27.12124442703785
STAT,1912,22,15-19,1934,5.893028495684691
STAT,1896,108,na,2004,0.26212479439523934
STAT,1875,97,na,1972,42.37768199192074
STAT,1852,32,na,1884,2329.4470043140072
SIM,1874,30,50-100,1904,2
STAT,1847,31,25-29,1878,9.350139259776071
STAT,1837,17,30-34,1854,3.0764974696828435
STAT,1960,25,20-24,1985,27.579649619353287
STAT,1817,37,20-24,1854,3.4685832696578625
SIM,1910,27,25-29,1937,69
SIM,1949,23,15-19,1972,12
STAT,1936,26,40-44,1962,5.153241336672299
STAT,1946,48,45-49,1994,0.2885558316960831
SIM,1938,28,45-49,1966,3
STAT,1955,31,25-29,1986,14.441825696328069
STAT,1791,88,na,1879,51.25848171998993
STAT,1893,28,25-29,1921,61.488662191023984
SIM,1845,17,30-34,1862,2
SIM,1977,25,50-100,2002,4
STAT,1853,70,na,1923,1396.9273229616936
STAT,1902,27,25-29,1929,68.97788186462873
SIM,1890,6,na,1896,3820
SIM,1944,26,40-44,1970,14
STAT,1871,16,50-100,1887,0.05694756466544736
SIM,1906,58,na,1964,3272
STAT,1873,48,15-19,1921,4.654724427881425E-4
STAT,1805,53,40-44,1858,0.036854228943598334
STAT,1842,70,na,1912,1079.701007864819
STAT,1854,28,na,1882,2023.6185555418538
SIM,1825,31,50-100,1856,1
SIM,1855,81,na,1936,247
STAT,1851,8,na,1859,2367.5796209709665
STAT,1948,40,45-49,1988,0.2290568854165353
STAT,1877,30,20-24,1907,3.270955898638197
STAT,1934,38,25-29,1972,1.5672289769961785
SIM,1937,35,50-100,1972,1
STAT,1911,76,na,1987,2550.7990257497627
SIM,1924,16,25-29,1940,75
STAT,1934,33,30-34,1967,24.821732653958467
SIM,1907,33,50-100,1940,6
SIM,1916,57,na,1973,4231
STAT,1939,29,25-29,1968,76.31824739374277
STAT,1969,25,40-44,1994,6.754409099622059
STAT,1880,15,30-34,1895,1.9587453608113459
STAT,1858,80,na,1938,556.9135790118955
STAT,1892,20,45-49,1912,1.0146479276243128
SIM,1942,38,25-29,1980,3
STAT,1875,21,35-39,1896,6.980377727246591
SIM,1946,23,na,1969,4668
SIM,1955,35,50-100,1990,1
STAT,1766,89,na,1855,85.7858
SIM,1896,31,35-39,1927,4
STAT,1865,26,45-49,1891,1.1600773313669914
STAT,1957,21,50-100,1978,1.0048243677829884
SIM,1820,90,na,1910,64
STAT,1932,27,50-100,1959,1.5048996355306015
STAT,1865,51,35-39,1916,0.00900712560647638
STAT,1947,33,40-44,1980,5.182249747168064
STAT,1973,23,40-44,1996,5.033391471240639
STAT,1976,33,50-100,2009,1.298578960473407
STAT,1880,40,20-24,1920,0.19622687021186394
STAT,1967,18,20-24,1985,195.37863726883427
STAT,1780,102,na,1882,0.12106610219682222
STAT,1923,20,25-29,1943,124.72608910292779
STAT,1967,29,na,1996,5418.301416693809
STAT,1805,50,25-29,1855,0.01318962732328164
SIM,1869,44,50-100,1913,7
STAT,1930,33,50-100,1963,1.2307743029150946
STAT,1858,58,na,1916,1780.403322982637
STAT,1915,37,15-19,1952,0.02239169932783267
STAT,1908,43,30-34,1951,0.13585648309536014
SIM,1925,61,na,1986,4852
SIM,1835,39,50-100,1874,2
STAT,1831,43,40-44,1874,2.128271967290104
STAT,1827,39,50-100,1866,1.7004638191619135
STAT,1921,38,15-19,1959,0.024711043959902684
STAT,1888,31,35-39,1919,13.794263152801989
SIM,1807,49,na,1856,1224
SIM,1878,16,30-34,1894,2
STAT,1915,22,40-44,1937,4.01175978127694
SIM,1955,33,40-44,1988,10
STAT,1962,29,50-100,1991,1.476700582830427
SIM,1868,13,na,1881,3383
STAT,1942,31,15-19,1973,0.15809281328033795
SIM,1898,30,30-34,1928,40
SIM,1966,41,na,2007,5850
STAT,1802,89,na,1891,50.14810244507121
SIM,1869,28,45-49,1897,1
SIM,1935,60,na,1995,5580
SIM,1839,16,40-44,1855,1
STAT,1893,46,na,1939,3291.8142496248092
STAT,1838,52,40-44,1890,0.00907232339772518
STAT,1882,46,na,1928,2543.2545988901607
STAT,1960,23,30-34,1983,43.32878534340521
SIM,1916,43,30-34,1959,1
STAT,1932,38,na,1970,5829.121600035687
STAT,1908,48,25-29,1956,0.05527912689410653
STAT,1864,45,45-49,1909,0.24560865445305585
STAT,1879,42,na,1921,2781.6586496456653
STAT,1916,16,25-29,1932,10.637676492410284
STAT,1996,1,na,1997,6603.954157125843
STAT,1883,113,na,1996,0.0015072240019021461
SIM,1885,30,20-24,1915,3
STAT,1839,36,45-49,1875,1.908955634308462
STAT,1797,66,na,1863,942.5269563876897
STAT,1940,24,40-44,1964,3.951436747062924
SIM,1872,45,45-49,1917,1
STAT,1947,35,50-100,1982,0.5632761534977601
STAT,1873,27,45-49,1900,1.3084809624120217
STAT,1916,53,na,1969,4256.538223531395
SIM,1816,63,na,1879,1206
SIM,1862,25,30-34,1887,36
STAT,1961,35,40-44,1996,2.303503673936085
STAT,1891,41,35-39,1932,2.594483157095558
STAT,1978,19,35-39,1997,6.604372207936977
STAT,1854,25,30-34,1879,23.97720383189171
STAT,1877,38,30-34,1915,6.366131186028961
SIM,1840,27,45-49,1867,1
STAT,1832,27,45-49,1859,1.0550025470462063
SIM,1885,38,30-34,1923,17
STAT,1918,43,15-19,1961,0.0018809115746966916
STAT,1979,20,30-34,1999,45.85186737057948
SIM,1923,22,40-44,1945,6
STAT,1876,17,30-34,1893,1.9014525431185498
STAT,1849,31,35-39,1880,9.183950918957478
SIM,1924,17,na,1941,4567
SIM,1874,30,45-49,1904,3
STAT,1931,42,40-44,1973,0.3857062006982643
SIM,1857,31,35-39,1888,3
STAT,1939,74,na,2013,3048.194191326314
STAT,1812,47,25-29,1859,0.13354819745657362
STAT,1924,24,na,1948,4940.381545612514
STAT,1928,38,na,1966,5481.426906630491
SIM,1877,38,35-39,1915,16
SIM,1896,31,na,1927,3860
SIM,1847,36,45-49,1883,2
STAT,1902,24,20-24,1926,111.66718326388613
STAT,1844,29,na,1873,2183.3277582849705
STAT,1884,15,15-19,1899,6.7981384090206225
STAT,1970,23,15-19,1993,7.712901954439076
SIM,1905,30,25-29,1935,14
STAT,1912,35,45-49,1947,0.7759002061721454
SIM,1867,18,20-24,1885,16
SIM,1785,85,na,1870,125
STAT,1941,27,15-19,1968,0.8429949246492795
SIM,1892,27,20-24,1919,19
STAT,1966,25,15-19,1991,1.022866319312263
SIM,1907,21,na,1928,4151
STAT,1972,15,50-100,1987,0.5538874238396615
SIM,1877,28,na,1905,3092
SIM,1842,39,25-29,1881,2
STAT,1961,32,25-29,1993,14.047063380571682
SIM,1858,27,30-34,1885,56
STAT,1888,36,40-44,1924,5.966991004744533
STAT,1920,10,na,1930,5143.563874134509
STAT,1865,28,na,1893,2476.2346764902304
STAT,1869,38,35-39,1907,7.865548225295114
SIM,1847,51,na,1898,2211
SIM,1910,24,20-24,1934,235
SIM,1938,5,na,1943,4225
STAT,1935,45,40-44,1980,0.2582187893411653
STAT,1889,39,15-19,1928,0.07907975945749614
STAT,1828,35,30-34,1863,5.730502402905504
SIM,1932,16,20-24,1948,390
SIM,1966,27,30-34,1993,121
STAT,1863,32,na,1895,2408.0507304334797
SIM,1826,52,na,1878,1566
STAT,1889,40,40-44,1929,3.232037327847267
SIM,1925,28,35-39,1953,31
STAT,1886,97,na,1983,64.9455332086545
STAT,1924,16,20-24,1940,186.72464943099433
STAT,1834,39,25-29,1873,3.2011105332150342
STAT,1882,83,na,1965,752.3114978577108
SIM,1985,24,20-24,2009,2
STAT,1901,34,30-34,1935,27.981694891718682
STAT,1918,18,25-29,1936,54.27965884418997
SIM,1975,18,20-24,1993,404
STAT,1936,35,30-34,1971,2.0696949683280375
STAT,1861,84,na,1945,319.15946962134495
STAT,1865,98,na,1963,10.405072847197905
STAT,1999,16,20-24,2015,231.2068384893587
SIM,1844,81,na,1925,414
STAT,1840,53,35-39,1893,0.006795313945379398
STAT,1859,18,20-24,1877,18.80704328009603
STAT,1917,28,35-39,1945,18.106952690885226
STAT,1977,24,20-24,2001,173.84003414960222
STAT,1943,18,35-39,1961,5.134024926760711
SIM,1927,22,25-29,1949,123
STAT,1965,43,45-49,2008,0.24879955115276314
SIM,1911,36,30-34,1947,6
STAT,1944,33,15-19,1977,0.162584152084455
STAT,1936,29,45-49,1965,1.907295218454601
STAT,1927,7,na,1934,5734.575639300456
SIM,1836,35,30-34,1871,1
STAT,1958,27,30-34,1985,59.647157775244146
STAT,1858,25,15-19,1883,0.42421055506301064
STAT,1935,42,25-29,1977,0.11630319157451462
SIM,1972,31,35-39,2003,4
STAT,1853,44,50-100,1897,1.0376259179065817
STAT,1849,48,20-24,1897,0.009183953877906652
STAT,1931,53,na,1984,5549.583187962548
SIM,1931,20,25-29,1951,10
SIM,1874,9,na,1883,2925
SIM,1810,47,40-44,1857,1
STAT,1812,67,na,1879,818.8881108904638
STAT,1893,110,na,2003,0.045257622066134276
SIM,1951,18,35-39,1969,16
STAT,1919,22,25-29,1941,116.69958130288303
STAT,1862,23,15-19,1885,3.2655233287922782
STAT,1960,28,25-29,1988,99.31286893707998
SIM,1936,75,na,2011,1982
STAT,1927,16,na,1943,5293.396653789968
STAT,1946,38,50-100,1984,0.5531038917838369
STAT,1988,25,35-39,2013,24.909281551928476
SIM,1876,43,na,1919,2558
STAT,1903,36,30-34,1939,1.900007885223755
STAT,1896,38,na,1934,3573.370983157295
STAT,1970,37,40-44,2007,2.2280061819556622
STAT,1965,33,na,1998,5550.883409409773
STAT,1912,41,30-34,1953,0.14325466839627943
SIM,1941,24,50-100,1965,2
STAT,1833,66,na,1899,1153.3283326564904
STAT,1892,2,na,1894,3855.7020690084687
STAT,1892,24,na,1916,3399.472164614117
STAT,1831,40,25-29,1871,0.631419265879004
SIM,2010,2,na,2012,7250
SIM,1988,25,na,2013,6580
SIM,1942,33,30-34,1975,37
STAT,1786,103,na,1889,0.0926863790758308
STAT,1829,29,na,1858,2055.795646840888
STAT,1918,30,50-100,1948,1.0218572668572001
STAT,1911,36,50-100,1947,0.470648407714438
STAT,1852,28,25-29,1880,46.11908309379295
STAT,1851,44,20-24,1895,0.12423798762451363
STAT,1933,24,50-100,1957,1.0070115752201507
SIM,1860,28,25-29,1888,6
STAT,1979,34,35-39,2013,14.78221632052866
STAT,1864,51,30-34,1915,0.0061631021721147775
STAT,1782,73,na,1855,643.06599
SIM,1949,16,15-19,1965,105
STAT,1898,18,20-24,1916,27.578396447798802
STAT,1854,50,na,1904,1779.3875159244167
STAT,1890,47,15-19,1937,3.166864988186188E-4
SIM,1859,40,45-49,1899,3
STAT,1925,28,30-34,1953,53.20320226444984
STAT,1939,54,na,1993,4300.8399984913785
STAT,1845,34,30-34,1879,13.701492117390702
STAT,1933,47,20-24,1980,0.017545956809772514
STAT,1945,27,45-49,1972,2.1873420295209356
SIM,1953,36,na,1989,5647
SIM,1933,28,30-34,1961,136
STAT,1995,19,40-44,2014,2.3350382314120983
SIM,1853,34,30-34,1887,9
SIM,1948,23,45-49,1971,3
SIM,1918,39,45-49,1957,1
STAT,1906,4,na,1910,4427.108109922304
STAT,1887,77,na,1964,1455.0236641169006
SIM,1973,7,na,1980,5500
STAT,1853,40,50-100,1893,1.0624368406564364
STAT,1851,51,20-24,1902,5.879660553049936E-4
STAT,1960,16,30-34,1976,18.32585258945529
SIM,1886,42,na,1928,1960
SIM,1846,40,35-39,1886,4
STAT,2002,8,na,2010,6836.75161682356
STAT,1910,34,20-24,1944,2.6937196049311387
SIM,1968,21,20-24,1989,145
SIM,1959,23,20-24,1982,153
SIM,1928,15,30-34,1943,43
STAT,1879,45,40-44,1924,0.20835594691447035
STAT,1828,44,na,1872,1712.5522780989031
SIM,1974,29,15-19,2003,1
STAT,1902,61,na,1963,3251.6488941595394
STAT,1894,41,15-19,1935,0.020580124349586754
STAT,1902,15,30-34,1917,2.61108353673595
STAT,1819,44,30-34,1863,2.2752482697974434
STAT,1882,45,50-100,1927,0.279604019604863
STAT,1841,50,35-39,1891,0.007764224250415819
STAT,1843,46,15-19,1889,4.04631888546261E-4
SIM,1963,42,25-29,2005,1
SIM,1942,26,30-34,1968,57
SIM,1906,26,20-24,1932,3
STAT,1769,91,na,1860,25.503987393502637
STAT,1867,18,50-100,1885,0.05364750317652829
STAT,1929,19,15-19,1948,66.48531028068719
STAT,1956,27,20-24,1983,27.995595965339554
STAT,1942,45,20-24,1987,0.013930658042335169
SIM,1991,23,45-49,2014,6
STAT,1944,48,35-39,1992,0.1660953740275317
STAT,1919,37,45-49,1956,0.8449972385637974
STAT,1949,40,15-19,1989,0.00214796472968932
STAT,1937,36,50-100,1973,0.4852139182494538
STAT,1899,22,35-39,1921,9.226305004994469
STAT,1895,74,na,1969,2123.601648521902
STAT,1975,36,50-100,2011,0.6591501390803577
STAT,1866,113,na,1979,4.5546281153149723E-4
STAT,1983,23,45-49,2006,1.8423588721437134
STAT,1837,96,na,1933,6.217840188787758
STAT,1900,18,15-19,1918,9.478427776495835
SIM,1976,6,na,1982,6053
STAT,1977,31,20-24,2008,3.879120411390929
STAT,1934,26,30-34,1960,60.88753675026341
SIM,1870,30,15-19,1900,1
SIM,1907,38,30-34,1945,3
SIM,1820,44,20-24,1864,2
STAT,1902,34,50-100,1936,0.8505419293365017
STAT,1895,22,50-100,1917,0.6125794797549344
SIM,1964,27,20-24,1991,51
SIM,1837,31,na,1868,2601
SIM,1840,35,na,1875,2080
SIM,1795,74,na,1869,597
STAT,1823,33,40-44,1856,10.819032971430355
STAT,1903,25,na,1928,3949.5268239696975
STAT,1853,33,na,1886,2421.3664276904024
SIM,1838,45,45-49,1883,2
STAT,1993,22,na,2015,6083.448984299915
SIM,1949,29,35-39,1978,3
STAT,1881,43,30-34,1924,1.2704846897440807
SIM,1920,37,35-39,1957,5
STAT,1862,85,na,1947,266.98840654883304
STAT,1913,16,45-49,1929,0.11822076029045848
STAT,1900,76,na,1976,2170.6086749441088
SIM,1888,19,40-44,1907,1
SIM,1911,31,25-29,1942,23
SIM,1839,42,50-100,1881,2
SIM,1947,30,50-100,1977,3
SIM,1927,15,25-29,1942,152
SIM,1970,34,40-44,2004,1
STAT,1812,44,20-24,1856,0.391825253190645
STAT,1908,36,30-34,1944,1.9812823765057865
SIM,1827,53,na,1880,1320
SIM,1877,35,30-34,1912,3
SIM,1903,55,na,1958,3259
SIM,1873,19,20-24,1892,45
STAT,1865,19,20-24,1884,18.799206075649895
SIM,1847,21,25-29,1868,88
SIM,1975,19,35-39,1994,17
SIM,1840,45,na,1885,1910
STAT,1881,46,35-39,1927,0.15628052771942189
SIM,1886,33,30-34,1919,7
STAT,1847,80,na,1927,475.9816077413001
STAT,1878,33,30-34,1911,20.949402411655218
SIM,1832,24,45-49,1856,2
SIM,1864,35,50-100,1899,3
STAT,1879,26,na,1905,2885.674568616538
SIM,1932,10,na,1942,5711
SIM,1827,44,30-34,1871,3
STAT,1866,54,45-49,1920,0.015096493327217665
SIM,1925,37,25-29,1962,4
SIM,1874,79,na,1953,735
SIM,1861,50,na,1911,1654
SIM,1849,29,30-34,1878,64
STAT,1957,39,30-34,1996,2.85096154223574
SIM,1860,33,na,1893,2422
STAT,1878,19,30-34,1897,1.9102423761077776
STAT,1864,30,35-39,1894,10.519230696391977
STAT,1811,43,50-100,1854,3.951802685491101
STAT,1970,34,15-19,2004,0.18898496525992126
SIM,1893,12,na,1905,3797
SIM,1831,68,na,1899,979
SIM,1840,19,na,1859,2309
STAT,1921,31,50-100,1952,1.065776511144606
SIM,1937,19,15-19,1956,94
SIM,1836,42,30-34,1878,2
STAT,1944,44,50-100,1988,0.1511285042933382
STAT,1919,15,25-29,1934,11.136871602607462
STAT,1918,16,35-39,1934,1.059853169497151
STAT,1828,42,30-34,1870,1.1059601921475481
STAT,1871,36,25-29,1907,3.3215926172873154
SIM,1862,32,30-34,1894,32
STAT,1890,41,30-34,1931,1.6285058110192803
STAT,1917,37,25-29,1954,1.1802510775460888
STAT,1968,33,20-24,2001,3.58155930791407
STAT,1959,15,50-100,1974,0.5658714103989534
STAT,1952,36,na,1988,5365.267413662658
STAT,1839,29,20-24,1868,11.552776315034931
SIM,1833,65,na,1898,1032
SIM,1991,20,40-44,2011,7
SIM,1894,93,na,1987,462
STAT,1871,27,35-39,1898,11.078189136433677
SIM,1806,85,na,1891,79
STAT,1823,45,35-39,1868,0.142253781047837
STAT,1871,62,na,1933,2098.466308606863
STAT,1808,46,na,1854,1741.0408601375298
STAT,1855,53,30-34,1908,0.004983673857603368
STAT,1868,111,na,1979,0.004611249720942222
STAT,1821,45,25-29,1866,0.10717577849384427
STAT,1869,35,30-34,1904,6.012948889098452
STAT,1838,40,35-39,1878,1.882340872981432
STAT,1899,40,na,1939,3703.8527969426086
STAT,1967,19,35-39,1986,6.044974627726127
STAT,1854,32,30-34,1886,14.566622967550668
STAT,1903,18,40-44,1921,0.29986416982180686
SIM,1921,16,45-49,1937,1
STAT,1839,21,25-29,1860,58.75369380135664
STAT,1907,15,20-24,1922,30.242458645684035
STAT,1919,56,na,1975,4426.163255973457
STAT,1949,32,na,1981,5174.251402725493
STAT,1910,37,25-29,1947,1.087861827996694
SIM,1936,34,na,1970,3892
STAT,1886,15,50-100,1901,0.059915448626202496
STAT,1903,31,25-29,1934,16.90536433374761
STAT,1982,17,20-24,1999,220.16413838497007
STAT,1934,80,na,2014,3006.0921363884277
STAT,1960,19,35-39,1979,6.302908392993113
SIM,1921,82,na,2003,2405
SIM,1890,25,45-49,1915,4
STAT,1934,70,na,2004,4632.221863015387
STAT,1850,84,na,1934,342.4588059026823
SIM,1781,76,na,1857,611
STAT,1854,50,20-24,1904,6.09819917014293E-4
STAT,1839,52,45-49,1891,0.011447798116526775
SIM,1932,26,50-100,1958,5
SIM,1898,97,na,1995,81
SIM,1916,36,30-34,1952,4
STAT,1922,44,40-44,1966,0.330072114305922
STAT,1899,30,na,1929,3803.2531638015816
STAT,1950,34,15-19,1984,0.17850812480871217
STAT,1845,39,50-100,1884,0.8513919483242579
SIM,1847,29,20-24,1876,1
STAT,1882,25,45-49,1907,1.2600412628521815
STAT,2005,7,na,2012,6977.885988086404
SIM,1875,19,30-34,1894,4
STAT,1794,74,na,1868,598.236012232311
STAT,1943,27,25-29,1970,80.90567535239062
SIM,1909,27,50-100,1936,4
SIM,1814,41,40-44,1855,8
STAT,1860,26,20-24,1886,11.108194721894106
STAT,1845,37,35-39,1882,5.007721644663433
STAT,1830,52,25-29,1882,0.0028733732092595886
STAT,1925,32,15-19,1957,0.17604930001193306
SIM,1968,24,25-29,1992,256
SIM,1865,27,na,1892,3114
STAT,1863,11,na,1874,2761.415859445381
STAT,1847,33,50-100,1880,0.8192196750038307
SIM,1876,64,na,1940,2285
STAT,1900,8,na,1908,4162.798088849653
SIM,1910,41,na,1951,3551
STAT,1932,48,30-34,1980,0.13920243758509554
SIM,1918,36,40-44,1954,2
STAT,1891,32,45-49,1923,2.4872452945693033
SIM,1885,30,45-49,1915,6
STAT,1829,54,40-44,1883,0.009071024162831953
SIM,1968,43,na,2011,5318
SIM,1829,44,40-44,1873,10
SIM,1911,42,na,1953,4674
STAT,1964,36,40-44,2000,2.243755922766624
SIM,1967,42,na,2009,5636
STAT,1883,46,45-49,1929,0.2672223252929819
SIM,1925,40,na,1965,5303
STAT,1880,22,30-34,1902,21.788719255461167
STAT,1962,14,na,1976,5806.318220020298
SIM,1973,19,25-29,1992,75
STAT,1877,30,45-49,1907,2.1101892435624365
SIM,1781,92,na,1873,30
STAT,1875,32,50-100,1907,1.0927102480160942
STAT,1902,100,na,2002,33.388249386227976
STAT,1909,17,20-24,1926,30.716799444385526
STAT,1972,38,na,2010,5721.412035766962
STAT,2000,1,na,2001,6757.826046635686
STAT,1864,54,35-39,1918,0.008627182234070649
SIM,1951,27,25-29,1978,115
SIM,1917,39,40-44,1956,7
STAT,1909,39,40-44,1948,1.620581533058593
STAT,1921,23,40-44,1944,4.3676024712529085
SIM,1853,37,35-39,1890,15
SIM,1834,66,na,1900,1305
STAT,1856,44,35-39,1900,1.5728092291643632
STAT,1953,46,50-100,1999,0.3292540285506031
STAT,1965,19,25-29,1984,62.39378584990734
SIM,1972,36,40-44,2008,3
SIM,1848,44,50-100,1892,4
SIM,1836,38,35-39,1874,2
SIM,1864,44,35-39,1908,1
STAT,1876,29,25-29,1905,50.10401991814427
STAT,1907,49,na,1956,3761.2152544405712
STAT,1836,40,15-19,1876,0.015344673025764753
STAT,1809,47,na,1856,1471.2789515727136
STAT,1961,39,40-44,2000,2.294624954366019
STAT,1834,36,20-24,1870,0.8841527366597174
STAT,1934,29,35-39,1963,23.29664947434333
SIM,1879,56,na,1935,2336
STAT,1918,46,40-44,1964,0.19406328819260155
SIM,1943,29,40-44,1972,16
STAT,1840,51,45-49,1891,0.011697582633395447
SIM,1974,31,45-49,2005,4
STAT,1937,15,na,1952,4153.825810749069
STAT,1972,34,25-29,2006,13.902926641928254
SIM,1980,34,25-29,2014,39
STAT,1768,104,na,1872,0.030812412252728225
STAT,1843,27,20-24,1870,14.486458880201948
STAT,1900,37,30-34,1937,1.8421075447334612
STAT,1920,44,30-34,1964,0.16233675917078463
SIM,1903,33,40-44,1936,9
SIM,1851,27,20-24,1878,1
STAT,1935,29,40-44,1964,7.329075929123839
SIM,1842,36,20-24,1878,2
STAT,1912,37,35-39,1949,2.7270071386570223
STAT,1980,20,25-29,2000,148.57510007336393
STAT,1901,49,40-44,1950,0.1528460845322478
STAT,1906,91,na,1997,506.6446440453721
SIM,1854,80,na,1934,800
STAT,1911,47,45-49,1958,0.23765332081242047
STAT,1948,31,na,1979,5094.324616432566
STAT,1928,17,na,1945,5352.20480017361
STAT,1835,30,na,1865,1755.6056431664008
STAT,1863,51,25-29,1914,0.003591382774145638
STAT,1960,35,50-100,1995,0.651288768802256
STAT,1870,21,45-49,1891,0.7957548418229912
STAT,1819,47,35-39,1866,0.2695613825336274
SIM,2000,1,na,2001,6500
SIM,1870,11,na,1881,3382
SIM,1885,25,na,1910,3314
SIM,1830,24,35-39,1854,7
STAT,1911,16,25-29,1927,10.040776361599153
STAT,1898,32,50-100,1930,1.4290501634044916
STAT,1951,22,15-19,1973,7.339495196003431
SIM,1875,35,20-24,1910,3
STAT,1799,68,na,1867,980.6476445655243
STAT,1867,35,20-24,1902,0.8384688821116296
STAT,1829,61,na,1890,1368.9237785243463
SIM,1884,29,25-29,1913,103
SIM,1942,29,35-39,1971,21
STAT,1851,54,25-29,1905,0.002731557813409948
STAT,1853,53,20-24,1906,7.228903731812794E-4
STAT,1832,65,na,1897,1151.3551305941382
SIM,1871,51,25-29,1922,2
STAT,1877,106,na,1983,0.5866394246769632
STAT,1893,25,20-24,1918,17.228984924085847
STAT,1908,39,35-39,1947,2.590442838221026
SIM,1931,28,20-24,1959,61
STAT,1823,36,45-49,1859,4.074823187838646
SIM,1866,81,na,1947,492
STAT,1808,46,20-24,1854,0.061041263446409595
STAT,1846,63,na,1909,1844.5817889225734
STAT,1923,28,20-24,1951,24.091927577752564
STAT,1876,53,50-100,1929,0.017727974343171065
STAT,1848,15,40-44,1863,0.24377589577773265
STAT,1917,18,50-100,1935,0.09280115264431307
STAT,1911,49,50-100,1960,0.2458709268972283
SIM,1935,19,40-44,1954,5
STAT,1864,27,na,1891,2459.1727708852104
STAT,1926,40,50-100,1966,0.16756822659595833
STAT,1931,45,45-49,1976,0.33702304414275613
STAT,1981,20,30-34,2001,46.565566099625116
SIM,1862,28,35-39,1890,20
SIM,1890,34,35-39,1924,33
STAT,1854,28,35-39,1882,8.1816721133546
STAT,1882,34,35-39,1916,11.317646785278932
STAT,1965,28,15-19,1993,1.021014527511161
STAT,1818,41,45-49,1859,2.05634650002101
STAT,1831,52,30-34,1883,0.004852239446143714
SIM,1831,36,45-49,1867,5
SIM,1926,56,na,1982,5461
SIM,1925,18,50-100,1943,1
STAT,1901,36,20-24,1937,0.2702464304817818
SIM,1975,16,30-34,1991,19
SIM,1916,39,35-39,1955,5
STAT,1888,43,40-44,1931,3.0292684827992273
STAT,1871,105,na,1976,0.7226858317793279
SIM,1906,29,15-19,1935,1
STAT,1992,21,45-49,2013,1.8706079434771397
STAT,1898,41,45-49,1939,0.1628306603148154
STAT,1966,23,50-100,1989,0.951271744705504
SIM,1815,46,na,1861,1945
STAT,1780,88,na,1868,63.66991936699264
STAT,1850,78,na,1928,804.3398591286025
SIM,1897,42,30-34,1939,1
STAT,1899,39,20-24,1938,0.26041243481013276
SIM,1886,36,35-39,1922,2
SIM,1955,3,na,1958,6584
SIM,1865,70,na,1935,1844
STAT,1890,20,35-39,1910,8.277825603240265
STAT,1889,42,30-34,1931,1.6334691510710366
STAT,1906,39,15-19,1945,0.020191896865335936
STAT,1844,31,45-49,1875,1.7624145877416506
SIM,1840,51,na,1891,1708
SIM,1845,82,na,1927,642
STAT,1878,36,35-39,1914,8.563575572957847
SIM,1960,22,na,1982,5879
SIM,1935,17,na,1952,5647
STAT,1866,51,40-44,1917,0.011314904964812335
STAT,1967,16,30-34,1983,17.575904174310832
STAT,1805,51,50-100,1856,0.05509292583357869
STAT,1982,25,50-100,2007,1.624771080997537
STAT,1856,35,45-49,1891,1.7718329367812518
SIM,1896,30,20-24,1926,1
STAT,1966,34,50-100,2000,1.2132240212320329
STAT,1869,58,na,1927,2210.179380106884
STAT,1977,19,50-100,1996,0.5838077131691333
SIM,1826,41,45-49,1867,5
SIM,1840,31,40-44,1871,1
STAT,1899,24,na,1923,3715.899705436048
SIM,1915,62,na,1977,3898
STAT,1968,36,25-29,2004,1.4634856866480068
STAT,1879,48,45-49,1927,0.2808111551634685
SIM,1796,91,na,1887,85
STAT,1993,20,35-39,2013,15.696595997702941
SIM,1841,30,30-34,1871,48
STAT,1819,67,na,1886,1092.5642922692064
SIM,1872,30,35-39,1902,2
STAT,1878,25,na,1903,2895.163829401876
STAT,1908,31,50-100,1939,0.9054828004219792
STAT,1871,33,20-24,1904,3.0903564376063506
SIM,1915,18,25-29,1933,13
STAT,1907,18,25-29,1925,9.596751929933648
STAT,1870,9,na,1879,3075.0185408614716
STAT,1992,19,15-19,2011,75.12642365077409
STAT,1959,56,na,2015,5553.5880383598105
STAT,1890,44,35-39,1934,2.5189981058287993
STAT,1932,29,15-19,1961,1.0662953274107747
STAT,1896,41,25-29,1937,0.06827959293595567
STAT,1857,57,na,1914,1806.2778000191402
SIM,1864,35,45-49,1899,2
SIM,1887,48,45-49,1935,1
STAT,1842,53,45-49,1895,0.010988359928952354
STAT,1815,102,na,1917,0.16267741812506625
STAT,1961,19,40-44,1980,2.0840879139798325
STAT,1888,30,20-24,1918,3.6963758988749986
STAT,1880,18,35-39,1898,0.6694450976153642
SIM,1877,49,50-100,1926,3
STAT,1865,42,45-49,1907,1.5564670440144055
SIM,1905,38,20-24,1943,1
STAT,1840,49,15-19,1889,3.153962478621834E-4
STAT,1931,48,25-29,1979,0.08164353729073855
SIM,1823,33,na,1856,2415
STAT,1887,40,30-34,1927,1.5018956644815151
STAT,1971,17,45-49,1988,0.7301617630339987
STAT,1939,38,15-19,1977,0.022840475505308305
STAT,1833,30,30-34,1863,16.31161303761886
SIM,1907,11,na,1918,4819
SIM,1846,67,na,1913,905
STAT,1871,24,30-34,1895,20.322726617349698
SIM,1976,36,25-29,2012,1
STAT,1832,31,40-44,1863,3.9831144374117926
STAT,1978,17,45-49,1995,0.7867616831990101
SIM,1841,36,na,1877,1975
SIM,1873,42,45-49,1915,1
SIM,1981,25,na,2006,5937
STAT,1841,41,45-49,1882,1.400538707479443
STAT,1890,20,25-29,1910,81.20483387887711
STAT,1924,26,50-100,1950,1.3416702205117905
SIM,1928,16,45-49,1944,3
STAT,1846,50,35-39,1896,0.009027786452234397
STAT,1975,16,15-19,1991,69.11404641664294
STAT,1882,18,45-49,1900,0.07343959027049332
STAT,1969,20,na,1989,5285.5775111020275
STAT,1826,51,20-24,1877,5.23267230075686E-4
STAT,1866,20,40-44,1886,2.279790903486524
STAT,1883,43,40-44,1926,2.5212942071454036
STAT,1944,39,45-49,1983,0.8704375952534307
STAT,1834,43,45-49,1877,1.625587881397545
STAT,1879,54,30-34,1933,0.006975683555714861
STAT,1910,25,30-34,1935,44.38057155998688
SIM,1826,28,25-29,1854,92
SIM,1913,31,35-39,1944,7
STAT,1875,52,20-24,1927,8.753543775695601E-4
SIM,1842,43,45-49,1885,2
STAT,1870,43,30-34,1913,1.2985566175250702
STAT,1821,33,30-34,1854,70.55541564927506
SIM,1911,26,na,1937,4778
STAT,1885,11,na,1896,2977.186176526666
SIM,1929,48,na,1977,5142
STAT,1901,27,30-34,1928,40.70610625204509
STAT,1864,52,45-49,1916,0.01487458595672884
SIM,1809,50,na,1859,1619
STAT,1949,16,na,1965,4941.590046294218
STAT,1972,31,20-24,2003,3.675900132166224
STAT,1952,41,25-29,1993,0.10277965157119846
STAT,1929,49,20-24,1978,0.016434672322667706
STAT,1909,15,30-34,1924,2.7743999541130133
STAT,1912,23,na,1935,4211.619089812534
STAT,1969,18,40-44,1987,2.0157820130484922
STAT,1823,42,30-34,1865,1.207954416924586
STAT,1923,35,45-49,1958,0.912821865619196
SIM,1854,64,na,1918,1860
STAT,1933,30,35-39,1963,14.234622986706432
STAT,1905,31,35-39,1936,9.752553130895283
STAT,1928,33,na,1961,5454.057961261336
STAT,1855,54,45-49,1909,0.012008971480755398
STAT,1886,31,15-19,1917,0.17406288489621452
STAT,1829,45,na,1874,1845.7280235211006
SIM,1941,30,35-39,1971,15
STAT,1898,17,50-100,1915,0.07641166938109203
SIM,1814,44,45-49,1858,2
SIM,1839,23,40-44,1862,5
STAT,1917,70,na,1987,3471.137713935502
STAT,1860,48,40-44,1908,0.1572338129154667
SIM,1939,16,20-24,1955,175
STAT,1970,29,45-49,1999,2.504067285232644
STAT,1892,41,40-44,1933,3.268150809968586
STAT,1839,51,30-34,1890,0.004743254679030647
STAT,1988,26,50-100,2014,1.6507102848324913
SIM,1852,42,50-100,1894,2
STAT,1808,53,45-49,1861,0.0677974175660788
STAT,1817,44,20-24,1861,0.46463993496492073
STAT,1919,37,35-39,1956,2.998063188734596
STAT,1920,47,35-39,1967,0.16440470280139935
STAT,1970,44,40-44,2014,0.3742652443921798
STAT,1852,41,20-24,1893,0.15040855724311986
STAT,1899,49,25-29,1948,0.05029828572833041
SIM,1805,84,na,1889,64
SIM,1810,69,na,1879,645
STAT,1927,19,40-44,1946,1.9958399987334667
STAT,1837,52,35-39,1889,0.006256700914146632
STAT,1797,72,na,1869,671.7266879758753
SIM,1915,40,35-39,1955,1
STAT,1912,28,45-49,1940,1.9597121412565774
SIM,1864,41,30-34,1905,2
SIM,1975,30,35-39,2005,27
STAT,1917,15,15-19,1932,11.323210834114512
STAT,1873,103,na,1976,2.7960287964758734
STAT,1933,17,15-19,1950,70.14183772418384
STAT,1949,26,15-19,1975,0.9520329592573413
SIM,1831,42,30-34,1873,3
STAT,1881,34,40-44,1915,4.785995709446021
SIM,1920,81,na,2001,1620
STAT,1966,40,35-39,2006,0.3024802820550724
SIM,1941,17,15-19,1958,89
STAT,1897,39,na,1936,3627.39620634361
STAT,1880,25,35-39,1905,11.883042371342825
SIM,1919,17,40-44,1936,2
SIM,1963,6,na,1969,6582
STAT,1870,48,25-29,1918,0.06470948931175444
STAT,1885,43,25-29,1928,0.7338531437017993
STAT,1866,30,50-100,1896,0.9879508962470156
STAT,1844,18,50-100,1862,0.051783148302901684
SIM,1822,32,na,1854,1816
SIM,1858,39,25-29,1897,7
STAT,1811,66,na,1877,980.6371024697119
STAT,1872,78,na,1950,905.4100626956025
SIM,1882,40,45-49,1922,4
STAT,1890,42,45-49,1932,2.1078442474360095
STAT,1906,36,20-24,1942,0.28134533667265993
STAT,1912,34,30-34,1946,17.75494051233482
STAT,1907,40,35-39,1947,0.21566902364610366
SIM,1935,33,na,1968,6259
STAT,1847,79,na,1926,537.9295779364634
STAT,1820,54,20-24,1874,6.963098159239839E-4
STAT,1983,32,35-39,2015,15.207111192338305
STAT,1874,40,45-49,1914,1.7860431938605843
STAT,1951,35,na,1986,5335.766381362212
STAT,1831,64,na,1895,1363.8587789509359
STAT,1862,30,15-19,1892,0.13981030288239296
STAT,1892,51,na,1943,3129.4027415514943
STAT,1924,40,na,1964,5110.855405588262
STAT,1843,37,25-29,1880,3.372571866409945
SIM,1890,31,30-34,1921,50
STAT,1922,1,na,1923,5575.123317780896
SIM,1840,40,30-34,1880,2
SIM,1848,30,40-44,1878,2
SIM,1847,24,na,1871,2582
STAT,1942,24,15-19,1966,6.437811686655219
SIM,1839,19,20-24,1858,31
SIM,1827,37,30-34,1864,2
STAT,1931,45,20-24,1976,0.017136765606756407
SIM,1970,36,30-34,2006,2
STAT,1850,34,50-100,1884,0.9664281570237951
SIM,1950,46,35-39,1996,1
STAT,1831,50,40-44,1881,0.008928384415662682
STAT,1842,27,na,1869,2058.6396045972087
SIM,1855,20,50-100,1875,1
STAT,1888,46,45-49,1934,0.3210605750079642
STAT,1911,44,40-44,1955,0.2723533633724112
SIM,1902,6,na,1908,4365
SIM,1926,46,40-44,1972,1
SIM,1851,37,25-29,1888,6
SIM,1920,34,30-34,1954,6
STAT,1945,27,35-39,1972,19.00877904513983
STAT,1961,46,40-44,2007,0.24512163823557034
STAT,1806,50,30-34,1856,0.021811077842698656
STAT,1981,23,35-39,2004,15.239784700469531
SIM,1953,27,35-39,1980,2
STAT,1842,53,20-24,1895,5.587301870829007E-4
SIM,1974,39,na,2013,6301
SIM,1836,27,50-100,1863,2
STAT,1863,26,na,1889,2425.6812430550067
STAT,1851,79,na,1930,554.3868489687941
STAT,1920,74,na,1994,3233.5619892114614
STAT,1898,43,35-39,1941,0.19470777546619517
STAT,1859,53,25-29,1912,0.0032039075287112625
STAT,1877,17,50-100,1894,0.05881205208598549
STAT,1819,37,30-34,1856,15.75349217414045
STAT,1955,43,40-44,1998,0.39759932225901495
STAT,1907,27,15-19,1934,0.7703754286586492
STAT,1856,32,40-44,1888,3.8650071216666584
STAT,1832,49,na,1881,1598.2820310579768
STAT,1959,28,50-100,1987,1.5083265781512771
STAT,1860,33,50-100,1893,0.8486115994574474
STAT,1893,18,20-24,1911,25.7931817730728
SIM,1816,47,na,1863,1631
STAT,1934,48,40-44,1982,0.2529200893142411
STAT,1903,41,na,1944,3829.5335122573642
STAT,1910,38,na,1948,4136.1189851311265
SIM,1909,29,40-44,1938,14
STAT,1939,30,50-100,1969,0.975048132482386
SIM,1915,27,15-19,1942,1
SIM,1905,45,45-49,1950,1
STAT,1857,53,40-44,1910,0.00931043537737755
STAT,1878,29,35-39,1907,11.5434329837446
STAT,1914,19,na,1933,4588.18425147282
SIM,1980,31,20-24,2011,9
STAT,1860,46,na,1906,2098.5376413369036
SIM,1796,75,na,1871,437
SIM,1940,29,25-29,1969,170
SIM,1840,34,45-49,1874,1
STAT,1941,29,50-100,1970,1.1873940672315326
STAT,1817,47,25-29,1864,0.16443920773732762
STAT,1932,29,25-29,1961,99.41713667711721
STAT,1779,107,na,1886,0.007179498751480391
STAT,1947,9,na,1956,5108.367346073911
STAT,1900,15,20-24,1915,28.52158677995378
STAT,1899,22,45-49,1921,1.1025145215920786
STAT,1931,37,na,1968,5751.350360008107
SIM,1947,40,na,1987,5948
SIM,1891,43,40-44,1934,10
SIM,1838,38,45-49,1876,5
STAT,1942,46,35-39,1988,0.16216515909924503
STAT,1921,26,45-49,1947,2.2288371234511124
STAT,1832,34,45-49,1866,1.548213340933997
SIM,1965,42,35-39,2007,2
STAT,1960,38,40-44,1998,2.3158057353725163
STAT,1920,42,40-44,1962,0.318665074596741
STAT,1877,45,30-34,1922,0.11736156344369425
SIM,1886,29,35-39,1915,32
STAT,1832,40,30-34,1872,1.0026972632837183
SIM,1959,44,25-29,2003,1
SIM,1939,19,25-29,1958,147
STAT,1853,51,30-34,1904,0.005954827227870425
STAT,1888,21,30-34,1909,24.236643123376382
SIM,1830,26,50-100,1856,1
STAT,1878,41,na,1919,2797.54239859167
SIM,1910,9,na,1919,4030
STAT,1966,20,45-49,1986,1.6283349589693743
STAT,1955,39,20-24,1994,0.415182578323761
STAT,1886,114,na,2000,6.037414066188812E-4
STAT,1853,110,na,1963,0.0012010255127969003
SIM,1874,20,40-44,1894,6
STAT,1904,26,na,1930,3968.5646127906916
SIM,1903,21,25-29,1924,4
STAT,1911,49,35-39,1960,0.14015443758196913
STAT,1845,27,30-34,1872,20.654235838311063
SIM,1950,24,15-19,1974,5
STAT,1931,21,35-39,1952,14.139143670221406
SIM,1853,27,30-34,1880,42
SIM,1952,36,40-44,1988,4
STAT,1882,31,30-34,1913,19.76128378149309
STAT,1833,52,40-44,1885,0.0076872976094799
STAT,1944,36,40-44,1980,1.917218715561997
STAT,1864,30,25-29,1894,10.639243167545683
STAT,1885,81,na,1966,977.1498048272375
STAT,1898,45,50-100,1943,0.21823051196087007
SIM,1842,40,40-44,1882,3
SIM,1896,21,30-34,1917,37
STAT,1929,18,na,1947,5407.080831345579
STAT,1834,43,50-100,1877,1.1474737953453278
STAT,1906,39,25-29,1945,1.0352934940006135
STAT,1846,15,30-34,1861,2.094461273879574
STAT,1949,33,15-19,1982,0.1756989376187603
STAT,1876,42,45-49,1918,1.783261890529294
SIM,1855,49,na,1904,1762
STAT,1831,30,20-24,1861,2.8103756328788294
STAT,1909,27,25-29,1936,72.67536633177278
STAT,1867,19,30-34,1886,1.735052450008303
SIM,1917,27,25-29,1944,115
SIM,1871,42,35-39,1913,4
SIM,1917,2,na,1919,5949
STAT,1819,83,na,1902,264.27917253261336
SIM,1884,42,45-49,1926,2
STAT,1907,96,na,2003,151.64246660331915
STAT,1864,12,na,1876,2796.396647245499
STAT,1968,40,45-49,2008,0.24999835211647575
STAT,1834,40,40-44,1874,2.5387968473526468
SIM,1971,0,na,1971,5827
SIM,1838,42,40-44,1880,9
STAT,1913,16,35-39,1929,0.993054570429222
STAT,1910,9,na,1919,4541.966295200744
STAT,1948,21,na,1969,4840.359733959003
STAT,1850,68,na,1918,1573.1969125808685
STAT,1919,34,40-44,1953,4.82956115987205
SIM,1849,38,20-24,1887,1
SIM,1849,8,na,1857,3250
STAT,1896,41,35-39,1937,0.1925411095943609
STAT,1952,43,15-19,1995,0.0022036451120733672
STAT,1910,28,35-39,1938,16.689552781185114
STAT,1973,20,na,1993,5472.258242401301
STAT,1846,104,na,1950,0.06895330834514947
STAT,1899,46,20-24,1945,0.010732650865530814
SIM,1864,28,45-49,1892,2
SIM,1973,30,25-29,2003,31
STAT,1857,16,45-49,1873,0.06941636177497726
STAT,1909,18,35-39,1927,0.9482133233162675
STAT,1854,35,35-39,1889,5.850457211713614
SIM,1910,31,na,1941,3763
STAT,1856,28,45-49,1884,1.0057085516807416
SIM,1960,30,50-100,1990,3
STAT,1891,31,30-34,1922,25.004882203679646
STAT,1971,17,35-39,1988,6.133359945851174
STAT,1816,41,35-39,1857,4.258101111165013
STAT,1855,44,40-44,1899,1.8880647458566446
SIM,1864,32,40-44,1896,10
STAT,1942,43,na,1985,4648.252168746511
STAT,1983,20,40-44,2003,5.511147830065332
SIM,1921,74,na,1995,3425
STAT,1966,42,na,2008,5563.385814175762
STAT,1887,42,20-24,1929,0.20514367214993193
STAT,1966,36,15-19,2002,0.02854339622443995
SIM,1893,92,na,1985,78
STAT,1865,41,30-34,1906,1.2025156170436693
STAT,1942,48,25-29,1990,0.06636889512659862
SIM,1858,30,na,1888,2586
STAT,1916,34,15-19,1950,0.15181384921725571
STAT,1842,31,35-39,1873,9.512440235331441
SIM,1839,26,45-49,1865,2
STAT,1885,40,20-24,1925,0.1846557822114033
STAT,1863,42,35-39,1905,1.8250608675421218
STAT,1870,82,na,1952,530.8421165128722
STAT,1870,45,20-24,1915,0.01378880223721177
STAT,1952,30,50-100,1982,1.166844350505435
STAT,1970,26,40-44,1996,6.765634873517512
STAT,1842,49,25-29,1891,0.04339918823049716
SIM,1861,34,na,1895,1881
SIM,1888,26,40-44,1914,11
STAT,1960,22,50-100,1982,0.9922869336838168
STAT,1892,37,20-24,1929,1.1149823000755619
STAT,1933,22,na,1955,5592.596943796253
STAT,1855,51,40-44,1906,0.009000790321611206
STAT,1805,54,na,1859,1368.728589765137
SIM,1877,28,30-34,1905,66
STAT,1808,50,40-44,1858,0.0522372320125405
SIM,1875,63,na,1938,2203
SIM,1854,15,30-34,1869,4
SIM,1980,24,na,2004,5968
STAT,1948,45,15-19,1993,5.084115847081918E-4
STAT,1871,17,30-34,1888,1.8417821099644485
STAT,1959,1,na,1960,5944.030831240049
STAT,1835,20,na,1855,1724.8676885345071
STAT,1945,24,40-44,1969,4.249901098190531
SIM,1948,30,45-49,1978,6
SIM,1850,31,35-39,1881,12
STAT,1923,32,40-44,1955,5.175429456469264
STAT,1847,20,50-100,1867,0.39024267795541295
SIM,1914,39,25-29,1953,1
STAT,1881,37,45-49,1918,2.219008066435275
STAT,1918,55,na,1973,4369.203156271473
STAT,1977,34,25-29,2011,14.67154290804761
SIM,1953,24,40-44,1977,6
SIM,1849,21,35-39,1870,10
SIM,1842,43,50-100,1885,3
STAT,1909,17,30-34,1926,2.7615693003956254
SIM,1840,43,35-39,1883,5
STAT,1828,45,35-39,1873,0.13234756585251928
SIM,1831,33,40-44,1864,8
SIM,1871,12,na,1883,2403
STAT,1879,104,na,1983,2.284988188777513
STAT,1977,16,25-29,1993,67.59129726961328
SIM,1904,56,na,1960,3730
STAT,1817,98,na,1915,2.2459118107752305
STAT,1927,32,25-29,1959,13.118088013660493
STAT,1898,40,30-34,1938,0.1257740063515548
STAT,1822,87,na,1909,144.75483456245564
STAT,1847,64,na,1911,1337.5874459486554
SIM,1868,31,20-24,1899,3
STAT,1848,50,45-49,1898,0.01564143162316227
STAT,1911,46,30-34,1957,0.09772048866055584
SIM,1925,55,na,1980,5096
STAT,1907,48,30-34,1955,0.09154998925526642
SIM,1949,38,25-29,1987,1
STAT,1889,62,na,1951,2600.0741512311065
STAT,1838,97,na,1935,4.653490165744512
STAT,1961,48,30-34,2009,0.13786875069749013
SIM,1850,13,na,1863,2218
SIM,1915,19,na,1934,4897
STAT,1981,32,25-29,2013,15.203185315541884
STAT,1853,54,35-39,1907,0.008335636540261331
STAT,1950,41,15-19,1991,0.002180866477260563
SIM,1936,18,na,1954,3788
STAT,1773,91,na,1864,32.822185930642235
STAT,1837,86,na,1923,160.66678420900695
STAT,1931,30,25-29,1961,13.995398988048844
SIM,1950,48,25-29,1998,1
STAT,1950,36,50-100,1986,0.5907768398605009
STAT,1912,25,40-44,1937,5.341917427295055
STAT,1918,49,45-49,1967,0.2652895683883641
STAT,1932,26,20-24,1958,27.61109130227739
STAT,1822,72,na,1894,1037.6281634623754
STAT,1875,21,45-49,1896,0.8341332533794646
SIM,1957,17,na,1974,5593
STAT,1905,40,25-29,1945,0.07523575758196634
STAT,1835,52,25-29,1887,0.0022526276049994838
SIM,1852,79,na,1931,186
SIM,1862,35,35-39,1897,18
SIM,1926,49,45-49,1975,3
SIM,1830,73,na,1903,836
STAT,1868,63,na,1931,1978.3787831006466
SIM,1935,32,25-29,1967,24
STAT,1877,48,35-39,1925,0.16595058103637034
STAT,1832,43,35-39,1875,1.5188217939026287
STAT,1837,34,50-100,1871,0.8147659706501643
STAT,1877,54,20-24,1931,8.614717966587591E-4
STAT,1831,53,45-49,1884,0.011597856799239683
SIM,1940,26,20-24,1966,43
SIM,1885,41,na,1926,3170
SIM,1845,34,50-100,1879,1
SIM,1920,25,40-44,1945,2
STAT,1892,44,45-49,1936,0.14829843983736987
STAT,1794,90,na,1884,40.83050235570437
STAT,1802,99,na,1901,0.9040519158381193
SIM,1836,23,15-19,1859,9
SIM,1894,77,na,1971,2443
STAT,1944,45,30-34,1989,0.11570526447550317
SIM,1890,22,40-44,1912,1
STAT,1815,51,45-49,1866,0.02904799995756858
STAT,1838,40,25-29,1878,0.6675222182143686
STAT,1854,34,na,1888,1949.9771991181594
STAT,1897,49,15-19,1946,3.4091232444044106E-4
STAT,1991,20,25-29,2011,153.37881406354916
STAT,1867,28,20-24,1895,12.596008443998782
SIM,1806,69,na,1875,837
STAT,1922,47,45-49,1969,0.2880182315395826
SIM,1946,58,na,2004,4300
SIM,1879,4,na,1883,3158
STAT,1953,22,25-29,1975,129.37893742198045
SIM,1952,39,45-49,1991,2
SIM,1824,41,35-39,1865,1
STAT,1933,38,30-34,1971,2.863261784573174
STAT,1907,92,na,1999,419.90402638760895
SIM,1930,47,45-49,1977,2
SIM,1921,16,35-39,1937,8
STAT,1882,22,40-44,1904,2.348900580496937
STAT,1951,3,na,1954,5430.979375881547
STAT,1879,48,50-100,1927,0.2922339813342401
SIM,1873,78,na,1951,842
SIM,1961,22,25-29,1983,144
SIM,1917,17,30-34,1934,3
SIM,1950,43,30-34,1993,1
STAT,1821,42,20-24,1863,0.30637620273883875
STAT,1859,50,20-24,1909,6.881212706109237E-4
SIM,1959,26,25-29,1985,7
STAT,1844,18,25-29,1862,5.989585362569779
STAT,1806,53,35-39,1859,0.029701675994454852
STAT,1883,43,15-19,1926,0.015479934812701004
STAT,1843,34,20-24,1877,3.1935667231735745
STAT,1866,47,20-24,1913,0.012776101090782562
STAT,1836,31,na,1867,2519.0214447604867
SIM,1851,34,20-24,1885,5
STAT,1967,28,25-29,1995,95.24869084226827
STAT,1849,51,50-100,1900,0.01176166831137539
SIM,1968,31,25-29,1999,3
STAT,1821,36,35-39,1857,16.524860476905996
SIM,1986,7,na,1993,6755
STAT,1820,52,30-34,1872,0.005845385475752282
STAT,1920,45,45-49,1965,0.2784437307674724
STAT,1942,43,30-34,1985,0.16000828883401905
SIM,1988,15,35-39,2003,17
STAT,1859,96,na,1955,7.8937547285591005
STAT,1902,37,40-44,1939,1.540691579781099
SIM,1852,18,25-29,1870,18
SIM,1846,40,25-29,1886,1
SIM,1886,26,na,1912,2144
STAT,1979,31,30-34,2010,25.533215302837245
SIM,1939,20,50-100,1959,1
SIM,1858,24,na,1882,2921
SIM,1853,49,40-44,1902,1
STAT,1859,37,15-19,1896,0.051623153243582305
STAT,1956,24,50-100,1980,1.0074437183991616
STAT,1824,30,30-34,1854,54.35256185159165
SIM,1855,36,40-44,1891,4
STAT,1788,101,na,1889,0.2123426575227168
STAT,1874,22,50-100,1896,0.4817828519416053
STAT,1892,39,na,1931,3373.468624939352
STAT,1834,43,20-24,1877,0.1724960640264203
STAT,1952,21,na,1973,5068.688260366473
STAT,1845,13,na,1858,2023.9645079881889
STAT,1945,17,40-44,1962,1.7633025860539102
SIM,1894,62,na,1956,2960
SIM,1823,32,30-34,1855,6
SIM,1977,35,na,2012,6148
STAT,1942,46,25-29,1988,0.066719379070422
SIM,1888,42,30-34,1930,4
STAT,1770,89,na,1859,16.664371520469565
STAT,1899,61,na,1960,3085.6546399494136
SIM,1827,32,na,1859,1604
STAT,1788,99,na,1887,0.5535020155901784
STAT,1790,93,na,1883,7.292282831792848
STAT,1887,45,25-29,1932,0.07523809215108948
STAT,1968,43,25-29,2011,0.10679979795012746
STAT,1927,22,na,1949,5191.158451419553
STAT,1951,44,25-29,1995,0.10164430794255203
SIM,1961,48,na,2009,5508
STAT,1921,69,na,1990,3839.9653487009846
STAT,1854,20,15-19,1874,3.2038002305520235
STAT,1820,54,30-34,1874,0.005616898973908935
SIM,1913,38,50-100,1951,2
STAT,1908,87,na,1995,990.7313011234759
STAT,1958,18,50-100,1976,0.5676976560589136
SIM,1864,42,45-49,1906,2
SIM,1976,36,35-39,2012,1
STAT,1852,18,20-24,1870,20.096722180516828
STAT,1881,51,na,1932,2408.2211742934583
STAT,1986,18,25-29,2004,71.2372783527711
STAT,1889,31,na,1920,3408.565630855089
STAT,1902,49,35-39,1951,0.12608470939847083
STAT,1807,49,50-100,1856,0.9810147936475464
SIM,1872,32,25-29,1904,20
STAT,1914,97,na,2011,122.91723534855034
STAT,1843,41,20-24,1884,0.16618433898675414
SIM,1812,70,na,1882,538
STAT,1847,43,30-34,1890,0.8782269476585909
STAT,1850,20,30-34,1870,22.328253462703074
SIM,1945,16,na,1961,4211
SIM,1823,66,na,1889,1281
STAT,1832,50,na,1882,1578.5812865083533
STAT,1958,14,na,1972,5951.83354117143
SIM,1824,34,50-100,1858,1
STAT,1879,57,na,1936,2421.643296356463
STAT,1891,81,na,1972,1327.6983480482504
STAT,1978,28,45-49,2006,2.7313834892737874
SIM,1861,0,na,1861,3704
SIM,1842,36,30-34,1878,17
SIM,1952,30,20-24,1982,7
STAT,1834,36,30-34,1870,6.112950099062585
STAT,1933,30,45-49,1963,2.451119745676522
STAT,1870,48,35-39,1918,0.15728001033096514
SIM,1855,43,30-34,1898,3
SIM,1841,67,na,1908,1271
STAT,1964,43,40-44,2007,0.37722807974678363
STAT,1890,18,40-44,1908,0.2572395591449178
STAT,1909,42,20-24,1951,0.01908432762652261
STAT,1841,18,45-49,1859,0.07446365706672002
SIM,1885,10,na,1895,3408
STAT,1847,36,40-44,1883,3.5312268435250265
STAT,1961,22,20-24,1983,166.33915927392135
SIM,1872,20,30-34,1892,2
SIM,1894,37,50-100,1931,5
SIM,1920,24,na,1944,4109
STAT,1870,106,na,1976,0.3405556653211782
STAT,1897,37,35-39,1934,10.914464323877352
SIM,1950,39,35-39,1989,6
SIM,1807,48,30-34,1855,1
STAT,1996,18,50-100,2014,0.6281618339280323
SIM,1882,45,na,1927,3135
STAT,1950,22,45-49,1972,1.5404212691024508
STAT,1882,50,45-49,1932,0.016593690915405426
STAT,1831,33,25-29,1864,10.322633313907145
SIM,1890,32,45-49,1922,4
SIM,1836,23,25-29,1859,90
SIM,1876,29,40-44,1905,1
SIM,1869,25,30-34,1894,58
STAT,1870,18,40-44,1888,0.20883818585184621
STAT,1871,39,40-44,1910,4.975342676883335
STAT,1975,40,35-39,2015,0.31948717596321125
STAT,1919,27,40-44,1946,5.8106584750804595
SIM,1837,62,na,1899,1648
STAT,1837,81,na,1918,391.5827854345444
STAT,1815,50,30-34,1865,0.012154430564956449
SIM,1840,14,na,1854,2459
STAT,1983,22,40-44,2005,5.507345792786946
SIM,1853,15,25-29,1868,12
SIM,1901,5,na,1906,4548
SIM,1983,22,35-39,2005,34
STAT,1828,30,15-19,1858,0.17584114391017444
SIM,1927,27,40-44,1954,8
STAT,1950,28,30-34,1978,53.67168168663315
STAT,1854,47,40-44,1901,0.1388258785491126
SIM,1941,30,45-49,1971,3
STAT,1860,33,20-24,1893,2.503528662754525
STAT,1942,39,35-39,1981,2.999409345403008
STAT,1935,1,na,1936,6591.9734117387525
STAT,1874,45,15-19,1919,4.7728990191005054E-4
SIM,1862,47,40-44,1909,1
STAT,1944,30,20-24,1974,3.0914379894978086
STAT,1845,15,25-29,1860,4.883677657592222
STAT,1861,47,na,1908,2148.450389828903
SIM,1906,42,45-49,1948,2
STAT,1818,38,40-44,1856,6.785975665848697
STAT,1949,16,50-100,1965,0.5029927790378399
STAT,1949,17,25-29,1966,58.16321958822004
SIM,1837,17,35-39,1854,1
STAT,1955,48,45-49,2003,0.34537196273198906
SIM,1889,29,50-100,1918,2
STAT,1965,26,50-100,1991,1.4409067711902783
STAT,1864,20,30-34,1884,18.920394417430845
STAT,1860,29,35-39,1889,8.940923516600476
STAT,1848,65,na,1913,1795.6319953658633
STAT,1858,44,20-24,1902,0.14104722587989757
SIM,1806,54,na,1860,1395
STAT,1828,105,na,1933,0.019460112266798106
SIM,1957,17,25-29,1974,155
STAT,1929,5,na,1934,5922.081717697823
STAT,1894,25,50-100,1919,0.9554471236093277
SIM,1925,71,na,1996,3842
SIM,1967,38,35-39,2005,1
STAT,1918,40,20-24,1958,0.02172484840864697
STAT,1841,25,35-39,1866,10.809915679470143
STAT,1954,22,30-34,1976,41.13966602064558
SIM,1914,24,na,1938,3556
STAT,1808,53,20-24,1861,0.003447326447746269
SIM,1988,21,50-100,2009,2
SIM,1826,38,40-44,1864,12
STAT,1858,79,na,1937,629.3946691061612
STAT,1958,15,25-29,1973,65.71955468015022
STAT,1963,26,50-100,1989,1.4663107174763361
STAT,1890,22,25-29,1912,80.72319333542804
STAT,1809,78,na,1887,375.382105572484
SIM,1859,33,20-24,1892,5
STAT,1854,65,na,1919,1376.807362531869
SIM,1886,63,na,1949,1330
STAT,1861,42,25-29,1903,0.6153315888602812
SIM,1919,71,na,1990,4017
SIM,1968,42,50-100,2010,1
STAT,1853,16,15-19,1869,7.149714649476506
STAT,1935,17,25-29,1952,68.40485153465757
STAT,1867,45,25-29,1912,0.06268207772630546
SIM,1966,42,50-100,2008,2
SIM,1856,29,na,1885,2135
SIM,1956,57,na,2013,5045
STAT,1903,21,20-24,1924,113.61877905494791
STAT,1956,40,40-44,1996,0.39804687867014465
STAT,1807,49,20-24,1856,0.04793232080562651
SIM,1932,32,45-49,1964,5
SIM,1855,71,na,1926,706
STAT,1891,102,na,1993,10.514039273226803
STAT,1880,37,40-44,1917,5.3547419562598835
STAT,1809,101,na,1910,0.2652142820622003
STAT,1833,39,20-24,1872,0.6692210735231463
STAT,1842,64,na,1906,1337.7106669303587
STAT,1878,115,na,1993,1.6211076544323755E-4
STAT,1984,20,35-39,2004,15.494971176846013
SIM,1846,38,40-44,1884,2
SIM,1852,18,15-19,1870,14
SIM,1851,21,50-100,1872,1
SIM,1906,36,50-100,1942,2
STAT,1894,19,40-44,1913,0.26988869597251713
SIM,1962,22,30-34,1984,4
STAT,1844,28,40-44,1872,3.045202565307057
STAT,1962,45,na,2007,5677.066838340967
STAT,1870,45,30-34,1915,0.11122966726363545
SIM,1814,89,na,1903,46
STAT,1848,34,35-39,1882,11.184353557080001
STAT,1838,30,30-34,1868,19.19084040823997
STAT,1968,36,35-39,2004,3.5951408309571677
STAT,1891,16,35-39,1907,0.7845559882734228
STAT,1809,90,na,1899,36.64349788509746
STAT,1838,38,40-44,1876,4.529023149665247
STAT,1951,7,na,1958,5401.611810983056
SIM,1832,30,30-34,1862,9
STAT,1910,81,na,1991,1877.7810645480097
STAT,1924,32,45-49,1956,2.11807983950916
SIM,1799,71,na,1870,428
SIM,1842,43,20-24,1885,1
STAT,1924,38,30-34,1962,2.477021329866917
STAT,1823,40,40-44,1863,2.4507964527684307
STAT,1894,0,na,1894,4356.170312038324
SIM,1932,38,30-34,1970,9
SIM,1841,39,20-24,1880,1
SIM,1953,5,na,1958,5701
SIM,1982,24,40-44,2006,14
STAT,1881,41,40-44,1922,2.5150632007388545
STAT,1920,34,50-100,1954,1.0357395041836908
SIM,1992,20,35-39,2012,42
SIM,1831,40,40-44,1871,2
STAT,1850,44,15-19,1894,0.01402457868394454
STAT,1884,34,20-24,1918,3.055696731300791
STAT,1827,87,na,1914,143.08000697421718
STAT,1830,46,40-44,1876,0.16003143785399018
SIM,1856,34,35-39,1890,17
SIM,1846,30,30-34,1876,24
STAT,1817,44,50-100,1861,3.090865595411743
STAT,1808,46,30-34,1854,0.49239950691097706
STAT,1970,23,25-29,1993,133.83648799888078
SIM,1820,40,50-100,1860,4
SIM,1892,34,20-24,1926,6
STAT,1873,26,40-44,1899,3.5423565179029657
STAT,1870,52,20-24,1922,8.350793850260831E-4
SIM,1823,35,35-39,1858,13
SIM,1891,39,30-34,1930,18
STAT,1908,97,na,2005,112.17553932697447
STAT,1935,35,25-29,1970,1.5924991915883158
SIM,1866,6,na,1872,2870
SIM,1936,32,30-34,1968,36
STAT,1923,60,na,1983,4616.8812233676745
SIM,1820,47,35-39,1867,1
SIM,1855,39,45-49,1894,2
SIM,1898,92,na,1990,621
STAT,1951,41,20-24,1992,0.02525813034567553
SIM,1954,21,40-44,1975,6
SIM,1918,15,25-29,1933,13
STAT,1956,19,na,1975,5617.030037315619
SIM,1994,15,20-24,2009,399
SIM,1979,15,35-39,1994,16
STAT,1902,46,30-34,1948,0.08929040208795061
SIM,1985,17,20-24,2002,4
STAT,1928,32,30-34,1960,22.734419422170195
STAT,1962,20,15-19,1982,7.902740042294493
STAT,1900,43,15-19,1943,0.001524579339337293
STAT,1963,43,50-100,2006,0.17871954192476044
SIM,1944,23,25-29,1967,3
STAT,1808,49,35-39,1857,0.6761326399130734
STAT,1839,36,35-39,1875,6.773003928243725
SIM,1943,35,25-29,1978,2
STAT,1986,15,20-24,2001,223.057526208642
SIM,1893,45,na,1938,3326
SIM,1859,9,na,1868,2658
STAT,1866,23,45-49,1889,0.7465893553996806
STAT,1980,32,40-44,2012,6.390631262455942
STAT,1979,20,40-44,1999,5.364080829396528
STAT,1846,30,na,1876,2703.2335089475505
STAT,1883,39,30-34,1922,5.95702084347478
STAT,1942,43,20-24,1985,0.02210324747904415
STAT,1860,36,25-29,1896,2.690855404955676
STAT,1983,23,na,2006,5979.458060797884
SIM,1927,34,30-34,1961,2
STAT,1834,46,25-29,1880,0.06204973960460015
SIM,1866,37,30-34,1903,2
SIM,1788,71,na,1859,406
STAT,1936,23,25-29,1959,101.9404291252126
SIM,1923,76,na,1999,3535
SIM,1943,17,25-29,1960,74
STAT,1861,47,30-34,1908,0.09243765171958902
SIM,1834,36,25-29,1870,2
STAT,1815,53,35-39,1868,0.01655855804464918
STAT,1841,15,40-44,1856,0.21222628457595097
STAT,1964,40,na,2004,5625.635432061284
STAT,1844,18,15-19,1862,6.272666633735683
STAT,1847,39,45-49,1886,1.558776120933296
SIM,1936,65,na,2001,3504
SIM,1944,19,50-100,1963,1
STAT,1876,29,15-19,1905,0.5373890670048895
SIM,1946,33,na,1979,4548
STAT,1888,8,na,1896,3526.4783917491695
STAT,1846,94,na,1940,20.661249368367912
SIM,1812,54,na,1866,1341
STAT,1806,51,45-49,1857,0.05211916815325372
STAT,1843,50,na,1893,2191.494016619639
SIM,1846,42,25-29,1888,1
STAT,1834,39,35-39,1873,7.863721037632814
STAT,1964,46,45-49,2010,0.32940703059021564
SIM,1966,31,50-100,1997,1
STAT,1832,34,na,1866,1867.4292837622502
SIM,1928,31,40-44,1959,17
SIM,1952,33,25-29,1985,29
STAT,1848,52,35-39,1900,0.00909866780363535
SIM,1823,70,na,1893,1175
SIM,1896,25,na,1921,3578
SIM,1866,59,na,1925,1967
STAT,1835,101,na,1936,0.3556433905388257
STAT,1886,39,na,1925,2839.0925578278707
STAT,1802,68,na,1870,989.9462893457588
STAT,1847,46,35-39,1893,0.10802945674626624
STAT,1858,39,20-24,1897,0.6869998152913567
STAT,1826,36,25-29,1862,2.3627729811644165
STAT,1838,42,25-29,1880,0.6506352764499065
STAT,1857,49,30-34,1906,0.08518827827612174
SIM,1986,25,40-44,2011,18
STAT,1944,33,25-29,1977,11.69378794382774
SIM,1966,15,25-29,1981,79
STAT,1861,99,na,1960,3.9078580926276105
STAT,1919,34,30-34,1953,19.443920999367148
STAT,1851,102,na,1953,0.2324862502692907
STAT,1911,32,50-100,1943,0.9299180104744486
STAT,1950,46,30-34,1996,0.12684201094827802
SIM,1911,24,25-29,1935,144
SIM,1968,25,50-100,1993,5
SIM,1842,39,35-39,1881,9
SIM,1799,67,na,1866,585
STAT,1811,72,na,1883,698.8872928078747
SIM,1966,22,15-19,1988,8
SIM,1869,28,35-39,1897,22
SIM,1908,19,30-34,1927,8
STAT,1978,25,40-44,2003,7.379146574545345
STAT,1915,69,na,1984,3434.272382803303
STAT,1903,24,25-29,1927,93.50995511518042
SIM,1847,36,35-39,1883,16
SIM,1836,20,20-24,1856,3
SIM,1870,42,50-100,1912,3
STAT,1971,43,30-34,2014,0.1938925029949847
STAT,1968,16,25-29,1984,62.481432543649184
STAT,1958,22,15-19,1980,8.095206352853273
SIM,1911,75,na,1986,3396
SIM,1925,5,na,1930,5683
STAT,1961,25,25-29,1986,98.647986959207
SIM,1834,29,35-39,1863,26
STAT,1897,27,40-44,1924,4.622555964343391
STAT,1983,22,50-100,2005,1.0777585505806748
SIM,1976,16,25-29,1992,78
STAT,1812,47,35-39,1859,0.3245963165380169
STAT,1936,30,15-19,1966,0.14429473777463966
SIM,1964,36,45-49,2000,2
STAT,1821,48,40-44,1869,0.3055349765399727
SIM,1872,83,na,1955,744
STAT,1983,25,45-49,2008,2.835063352530114
SIM,1806,70,na,1876,837
SIM,1887,80,na,1967,1722
SIM,1922,8,na,1930,5523
STAT,1879,47,40-44,1926,0.20533745447386328
STAT,1910,32,20-24,1942,2.7169813143254533
STAT,1848,17,50-100,1865,0.06453016452838072
STAT,1829,82,na,1911,341.8086400558367
SIM,1962,42,40-44,2004,1
STAT,1874,42,35-39,1916,2.1367470091297096
STAT,1817,51,20-24,1868,0.0020679989063043425
SIM,1929,21,na,1950,4629
STAT,1864,8,na,1872,2876.5320218581046
SIM,1854,49,50-100,1903,1
SIM,1967,35,30-34,2002,2
SIM,1900,27,30-34,1927,5
STAT,1849,18,15-19,1867,5.628494446491068
SIM,1857,18,15-19,1875,12
STAT,1871,43,25-29,1914,0.7319514931216731
STAT,1825,42,15-19,1867,0.020542274158874496
STAT,1967,19,na,1986,5302.508121822505
STAT,1956,43,45-49,1999,0.2637049884835448
STAT,1840,69,na,1909,1177.265540596242
STAT,1893,35,25-29,1928,4.239825622919123
STAT,1804,90,na,1894,34.2797990249758
STAT,1864,32,25-29,1896,10.554405357378187
STAT,1925,43,50-100,1968,0.1638301434247009
SIM,1926,82,na,2008,3183
SIM,1876,33,na,1909,2676
STAT,1860,26,30-34,1886,23.84406147293923
SIM,1840,41,45-49,1881,4
STAT,1944,22,na,1966,4550.46992339048
STAT,1839,29,45-49,1868,1.0933927347870271
SIM,1845,17,40-44,1862,2
SIM,1883,62,na,1945,1809
STAT,1812,54,25-29,1866,0.0075378937471757375
SIM,1883,29,30-34,1912,30
STAT,1837,24,30-34,1861,16.64337954822072
SIM,1929,25,50-100,1954,5
STAT,1875,29,30-34,1904,29.817175214031383
STAT,1884,29,20-24,1913,13.280842992515147
STAT,1897,34,30-34,1931,26.712007927902192
SIM,1887,76,na,1963,1959
STAT,1945,24,30-34,1969,36.32792041916996
STAT,1968,35,20-24,2003,0.39214130411232667
STAT,1875,27,na,1902,2846.156679834266
SIM,1817,41,20-24,1858,1
SIM,1953,24,30-34,1977,48
STAT,1918,43,25-29,1961,0.08746238238199054
STAT,1872,110,na,1982,0.01765995187415353
STAT,1832,41,45-49,1873,1.2884564451096165
STAT,1823,73,na,1896,672.6098829162371
SIM,1884,19,20-24,1903,35
STAT,1974,39,15-19,2013,0.029749859690945547
SIM,1918,33,25-29,1951,1
SIM,1873,68,na,1941,2190
STAT,1901,37,50-100,1938,0.42836386726465847
STAT,1823,35,40-44,1858,9.279148752811393
STAT,1970,32,25-29,2002,13.610205407681294
SIM,1882,24,35-39,1906,13
STAT,1962,40,25-29,2002,0.11003886289526633
STAT,1940,41,45-49,1981,0.20302255106532605
STAT,1980,17,na,1997,5896.886005474808
STAT,1828,51,50-100,1879,0.013701648881244992
STAT,1848,30,50-100,1878,1.1591405970823876
STAT,1877,23,20-24,1900,82.4700312049999
STAT,1900,18,25-29,1918,9.050672638163753
STAT,1967,45,30-34,2012,0.13429854853748485
SIM,1872,28,40-44,1900,7
SIM,1885,23,20-24,1908,162
STAT,1863,32,30-34,1895,17.618778243458625
SIM,1942,65,na,2007,4325
STAT,1916,49,35-39,1965,0.15173280750717533
STAT,1868,73,na,1941,1316.9416942970504
SIM,1976,35,20-24,2011,1
SIM,1856,31,30-34,1887,24
SIM,1879,37,40-44,1916,20
SIM,1830,83,na,1913,259
SIM,1856,30,50-100,1886,2
STAT,1951,20,50-100,1971,0.9078569736498909
STAT,1970,20,20-24,1990,161.27734110223577
STAT,1865,19,45-49,1884,0.0692675103014999
STAT,1873,34,45-49,1907,2.037482010974537
STAT,1881,44,45-49,1925,1.6434664896613191
STAT,1907,1,na,1908,4621.660390860257
STAT,1948,33,45-49,1981,2.1170205245364753
STAT,1868,29,40-44,1897,3.2976457171793805
STAT,1961,32,50-100,1993,1.2565709797455435
SIM,1956,33,45-49,1989,6
STAT,1837,17,40-44,1854,0.35304070731617404
STAT,1946,21,40-44,1967,4.319416887099792
STAT,1987,16,50-100,2003,0.6174176562423785
SIM,1887,9,na,1896,3977
STAT,1841,40,30-34,1881,1.0897184580181074
STAT,1938,22,na,1960,4172.9899089966475
STAT,1856,41,30-34,1897,1.0168046428427913
SIM,1907,42,na,1949,4427
STAT,1900,25,15-19,1925,0.7314682116212212
STAT,1841,22,30-34,1863,20.06197799867954
STAT,1966,48,20-24,2014,0.01652289492135666
STAT,1848,31,30-34,1879,21.860085305341485
STAT,1865,26,35-39,1891,10.08148399729706
SIM,1900,32,na,1932,3611
STAT,1873,52,45-49,1925,0.01701168605369289
SIM,1882,42,35-39,1924,8
SIM,1780,75,na,1855,341
STAT,1842,34,15-19,1876,0.12966205783482193
STAT,1972,41,25-29,2013,0.1098128695894424
STAT,1959,33,20-24,1992,3.7509272583240683
SIM,1974,22,20-24,1996,311
STAT,1957,36,na,1993,5902.957243740945
SIM,1988,22,35-39,2010,1
SIM,1881,29,45-49,1910,1
SIM,1884,27,25-29,1911,67
SIM,1888,43,45-49,1931,6
STAT,1851,85,na,1936,217.38718554435445
SIM,1817,70,na,1887,425
SIM,1981,28,45-49,2009,2
STAT,1931,40,40-44,1971,0.3867768317672714
SIM,1820,44,30-34,1864,4
SIM,1977,29,30-34,2006,4
STAT,1973,28,45-49,2001,2.588439641328127
SIM,1854,22,30-34,1876,49
SIM,1900,63,na,1963,2927
STAT,1900,31,45-49,1931,2.8038913812799677
SIM,1954,37,na,1991,5435
STAT,1859,65,na,1924,1553.5905031283182
STAT,1837,42,30-34,1879,0.9823618531478765
STAT,1921,16,40-44,1937,1.8437924558702203
STAT,1855,99,na,1954,1.6114830107723335
STAT,1846,48,40-44,1894,0.1747596913241719
SIM,1909,32,20-24,1941,9
SIM,1924,22,45-49,1946,3
SIM,1876,80,na,1956,879
STAT,1938,53,na,1991,4259.7255588750795
SIM,1891,1,na,1892,3797
STAT,1878,48,40-44,1926,0.20369637080318923
STAT,1970,19,40-44,1989,2.019273625273354
STAT,1886,37,50-100,1923,1.494544952930336
SIM,1991,14,na,2005,6707
STAT,1876,27,25-29,1903,50.46470058018278
STAT,1812,44,30-34,1856,2.8364740676424183
SIM,1871,33,na,1904,2098
STAT,1824,31,45-49,1855,4.140474610807625
STAT,1895,109,na,2004,0.1135409504091162
STAT,1873,29,45-49,1902,1.2991290040260268
SIM,1880,10,na,1890,3628
STAT,1881,21,20-24,1902,76.9400921224104
STAT,1907,61,na,1968,3485.2393814693373
STAT,1846,22,30-34,1868,22.720356206218177
STAT,1896,60,na,1956,2933.6305298603443
SIM,1862,84,na,1946,479
SIM,1896,33,25-29,1929,14
STAT,1974,23,45-49,1997,1.700594993119895
SIM,1866,50,na,1916,2256
STAT,1920,43,na,1963,4724.161680546994
STAT,1855,34,25-29,1889,8.69167020125555
STAT,1911,31,20-24,1942,2.7546057437824505
SIM,1830,52,na,1882,1574
SIM,1828,32,30-34,1860,37
SIM,1956,16,na,1972,5183
SIM,1845,24,30-34,1869,2
STAT,1928,48,na,1976,5394.501164408168
STAT,1878,21,15-19,1899,3.987178752053158
SIM,1832,31,45-49,1863,1
SIM,1949,19,40-44,1968,5
STAT,1860,40,45-49,1900,1.4060841454553794
SIM,1893,76,na,1969,1525
SIM,1886,48,40-44,1934,1
SIM,1992,3,na,1995,7040
SIM,1962,25,35-39,1987,31
SIM,1822,53,na,1875,1451
STAT,1851,32,15-19,1883,0.11753837925936499
SIM,1821,38,40-44,1859,5
SIM,1963,22,45-49,1985,1
STAT,1873,36,35-39,1909,8.375484749187851
SIM,1986,15,15-19,2001,146
SIM,1892,29,20-24,1921,2
STAT,1944,29,40-44,1973,5.80821791458423
STAT,1816,44,15-19,1860,0.02913394169820134
SIM,1857,39,30-34,1896,2
SIM,1952,29,40-44,1981,7
STAT,1848,102,na,1950,0.311506548837431
SIM,1822,37,40-44,1859,9
STAT,1891,13,na,1904,3677.770319276127
STAT,1967,48,35-39,2015,0.19278610832276183
STAT,1912,18,40-44,1930,0.32586272503064234
STAT,1918,49,na,1967,4484.328987908879
SIM,1869,3,na,1872,2921
STAT,1954,25,35-39,1979,21.53064273957093
SIM,1900,48,35-39,1948,1
STAT,1869,28,40-44,1897,3.3360826179665555
SIM,1926,6,na,1932,6261
STAT,1787,73,na,1860,390.2620331254098
STAT,1866,54,20-24,1920,7.676183339051111E-4
STAT,1953,15,25-29,1968,60.53040045957639
STAT,1955,22,45-49,1977,1.729474763643948
SIM,1897,75,na,1972,2035
STAT,1817,54,25-29,1871,0.009351112372933517
SIM,1929,21,30-34,1950,90
STAT,1955,34,na,1989,5898.502327186148
SIM,1831,23,25-29,1854,61
SIM,1843,15,na,1858,2345
STAT,1900,39,na,1939,3764.256465203441
SIM,1897,27,35-39,1924,33
SIM,1813,41,35-39,1854,1
STAT,1915,24,50-100,1939,0.7801655103416589
STAT,1950,49,35-39,1999,0.18192163127605837
STAT,1826,29,35-39,1855,16.707071508179713
STAT,1846,49,50-100,1895,0.24859570972512654
STAT,1967,36,20-24,2003,0.3918615712512017
STAT,1835,51,na,1886,1394.915779359702
SIM,1845,42,30-34,1887,5
SIM,1855,44,na,1899,1759
SIM,1777,92,na,1869,18
SIM,1878,41,30-34,1919,5
STAT,1912,46,50-100,1958,0.251718364286365
STAT,1942,18,30-34,1960,14.697770712848854
STAT,1966,22,20-24,1988,160.80846189273552
STAT,1981,28,15-19,2009,1.1435814445693933
STAT,1857,32,50-100,1889,0.8286155831661811
STAT,1889,27,35-39,1916,13.726269084211813
SIM,1950,18,30-34,1968,19
STAT,1871,40,20-24,1911,0.18417727942323703
STAT,1889,19,na,1908,3573.581951025857
SIM,1837,41,20-24,1878,4
STAT,1852,26,25-29,1878,46.78855467666372
STAT,1930,42,na,1972,5640.083368858744
SIM,1830,36,40-44,1866,7
SIM,1858,29,20-24,1887,2
SIM,1943,53,na,1996,5207
SIM,1978,26,40-44,2004,17
STAT,1856,42,45-49,1898,1.3160934414111394
SIM,1898,21,40-44,1919,6
SIM,1889,20,25-29,1909,102
SIM,1987,18,na,2005,6535
STAT,1930,46,50-100,1976,0.3446410406464463
SIM,1924,28,30-34,1952,12
SIM,1950,36,30-34,1986,6
STAT,1849,39,30-34,1888,4.140010433440872
STAT,1856,35,50-100,1891,1.0912312883843935
STAT,1916,28,30-34,1944,46.59455844196575
STAT,1942,36,30-34,1978,2.2669953981029085
STAT,1873,51,30-34,1924,0.007048583373940601
SIM,1790,74,na,1864,144
STAT,1932,42,45-49,1974,0.2603774993590471
STAT,1856,13,na,1869,2474.0070190237543
SIM,1910,62,na,1972,2989
SIM,1881,36,35-39,1917,4
SIM,1979,20,35-39,1999,21
STAT,1995,19,30-34,2014,20.348189491129872
SIM,1854,58,na,1912,2085
STAT,1816,101,na,1917,0.28180236755809024
SIM,1860,26,25-29,1886,75
STAT,1884,31,na,1915,2732.041348739017
SIM,1949,26,30-34,1975,32
SIM,1911,11,na,1922,5189
STAT,1961,34,na,1995,5740.598351049473
SIM,1841,15,35-39,1856,1
STAT,1972,34,35-39,2006,13.746099266494614
SIM,1976,28,50-100,2004,2
STAT,1962,42,15-19,2004,0.0023598768455993253
SIM,1831,37,na,1868,1721
SIM,1882,3,na,1885,3856
STAT,1866,47,30-34,1913,0.10306054498477386
STAT,1927,25,25-29,1952,92.951126184671
STAT,1872,15,35-39,1887,0.6455187153853119
STAT,1860,54,25-29,1914,0.0032038614445733457
SIM,1784,74,na,1858,156
STAT,1931,27,na,1958,5582.707213852163
STAT,1829,41,20-24,1870,0.17261704114962695
SIM,1849,21,45-49,1870,1
SIM,1904,24,35-39,1928,26
STAT,1804,63,na,1867,1150.0962879671872
STAT,1872,47,na,1919,2594.9659243361143
SIM,1903,26,40-44,1929,11
STAT,1840,27,40-44,1867,2.9962474656772535
STAT,1980,15,35-39,1995,6.726142732031631
STAT,1932,79,na,2011,3119.2797563200547
SIM,1960,37,na,1997,6215
STAT,1811,51,25-29,1862,0.010755553431960026
SIM,1909,17,25-29,1926,25
STAT,1898,46,15-19,1944,3.529146946549962E-4
STAT,1977,7,na,1984,6129.003374893645
STAT,1812,51,20-24,1863,0.0016677362318645575
STAT,1825,52,na,1877,1687.5375896614185
STAT,1877,26,25-29,1903,50.95479132445051
STAT,1857,94,na,1951,17.963700059879393
STAT,1970,18,na,1988,5315.636710625873
STAT,1888,33,25-29,1921,13.836220552662105
STAT,1916,46,30-34,1962,0.10579332592853108
STAT,1959,45,50-100,2004,0.3568161176175644
SIM,1930,80,na,2010,3065
STAT,1896,31,30-34,1927,26.72236457591535
SIM,1823,97,na,1920,20
SIM,1904,62,na,1966,3496
SIM,1838,47,na,1885,1638
SIM,1863,31,20-24,1894,4
STAT,1910,69,na,1979,3182.540516923703
STAT,1916,22,45-49,1938,1.3607914140018686
STAT,1944,63,na,2007,4263.890131779607
SIM,1980,34,35-39,2014,36
STAT,1853,80,na,1933,615.8862139706113
SIM,1860,19,35-39,1879,1
SIM,1979,24,35-39,2003,37
SIM,1935,25,25-29,1960,205
SIM,1967,15,20-24,1982,373
STAT,1917,60,na,1977,4123.918394589298
STAT,1852,19,35-39,1871,0.6183425137820274
STAT,1822,36,40-44,1858,11.145423734216868
SIM,1968,45,40-44,2013,1
STAT,1985,27,20-24,2012,30.09129587778753
SIM,1885,26,25-29,1911,1
SIM,1924,46,30-34,1970,1
STAT,1921,23,30-34,1944,37.334025270799955
SIM,1853,39,50-100,1892,2
SIM,1840,21,25-29,1861,124
STAT,1823,38,45-49,1861,2.276156386165033
STAT,1888,40,15-19,1928,0.018923097511730123
STAT,1903,44,50-100,1947,0.11896333632573478
STAT,1878,31,na,1909,2887.149466360055
STAT,1846,40,30-34,1886,1.2341151770923002
SIM,1794,67,na,1861,829
SIM,1831,38,45-49,1869,7
STAT,1996,16,40-44,2012,2.3465458008402518
SIM,1948,32,20-24,1980,7
STAT,1831,31,35-39,1862,10.420365051994752
STAT,1982,26,45-49,2008,2.818902899287953
STAT,1876,19,20-24,1895,21.03634123184465
STAT,1959,15,20-24,1974,204.7700422146924
SIM,1847,101,na,1948,7
STAT,1969,2,na,1971,5673.131974628446
STAT,1832,81,na,1913,368.41763179256634
STAT,1892,44,20-24,1936,0.01573639756173185
STAT,1962,19,na,1981,5439.012940505403
SIM,1825,44,50-100,1869,4
SIM,1939,20,na,1959,4643
SIM,1803,89,na,1892,44
STAT,1983,30,45-49,2013,2.6215380916164617
STAT,1930,4,na,1934,6022.791021569145
STAT,1908,2,na,1910,4569.184255491223
STAT,1777,99,na,1876,0.26505218360704386
STAT,1843,21,50-100,1864,0.5173052557838819
STAT,1896,39,40-44,1935,6.605410276557388
SIM,1854,40,30-34,1894,3
SIM,1862,29,na,1891,2838
STAT,1873,31,40-44,1904,5.1316622520143245
STAT,1836,95,na,1931,12.099841249136698
STAT,1938,63,na,2001,3910.183078351017
SIM,1981,25,40-44,2006,25
STAT,1968,40,20-24,2008,0.026528083929925065
SIM,1858,1,na,1859,4064
SIM,1854,25,35-39,1879,3
STAT,1926,47,30-34,1973,0.1269135311262213
SIM,1883,83,na,1966,605
SIM,1999,10,na,2009,6972
STAT,1819,52,na,1871,1661.8084705285728
SIM,1985,18,35-39,2003,5
SIM,1877,28,40-44,1905,9
SIM,1918,83,na,2001,1720
STAT,1892,37,30-34,1929,7.708884312737404
SIM,1840,41,na,1881,2020
STAT,1899,34,na,1933,3740.6235646724203
STAT,1941,42,na,1983,4589.054111725002
SIM,1810,75,na,1885,233
SIM,1933,38,na,1971,6404
SIM,1848,24,35-39,1872,1
STAT,1968,45,15-19,2013,5.5489298277518E-4
SIM,1835,67,na,1902,1347
STAT,1855,25,50-100,1880,0.6325161081990762
STAT,1887,43,35-39,1930,2.3250492871805055
SIM,1881,26,40-44,1907,12
SIM,1888,40,40-44,1928,1
SIM,1930,20,40-44,1950,6
SIM,1871,32,30-34,1903,6
SIM,1977,27,40-44,2004,1
STAT,1975,21,50-100,1996,1.005420277906385
STAT,1976,31,15-19,2007,0.20207434739677174
STAT,1906,21,na,1927,3992.0878934357465
SIM,1886,8,na,1894,2402
SIM,1908,21,15-19,1929,5
STAT,1879,52,40-44,1931,0.012618482230915384
SIM,1863,25,50-100,1888,5
SIM,1939,16,na,1955,4687
STAT,1855,31,20-24,1886,2.3663398088275205
SIM,2001,7,na,2008,7322
STAT,1829,48,50-100,1877,0.24729060321581642
STAT,1883,50,40-44,1933,0.01205750453735245
STAT,1996,19,45-49,2015,0.8372559697148768
STAT,1920,32,25-29,1952,11.678399345252217
SIM,1848,62,na,1910,1251
STAT,1862,19,40-44,1881,0.18347613163605928
SIM,1899,24,50-100,1923,1
STAT,1969,33,15-19,2002,0.1887185943831251
STAT,1846,25,35-39,1871,12.242319018239884
STAT,1906,29,20-24,1935,19.601415668990075
STAT,1931,43,45-49,1974,0.25623861266705716
STAT,1824,33,35-39,1857,18.96103090368981
STAT,1838,66,na,1904,1419.7270317454504
STAT,1924,44,15-19,1968,0.002100443205807627
STAT,1922,20,40-44,1942,4.474437992992803
SIM,1827,63,na,1890,859
SIM,1832,33,35-39,1865,23
SIM,1851,29,na,1880,2782
STAT,1843,81,na,1924,542.5928114459966
SIM,1959,38,40-44,1997,6
STAT,1869,27,na,1896,2667.198206060281
STAT,1921,19,45-49,1940,0.6533610942254269
SIM,1909,35,25-29,1944,1
STAT,1842,50,40-44,1892,0.008217710929315862
STAT,1843,18,30-34,1861,2.0317043809677435
SIM,1914,29,20-24,1943,3
STAT,1902,47,45-49,1949,0.21606314371982793
SIM,1851,18,30-34,1869,3
SIM,1931,24,na,1955,5759
SIM,1960,37,30-34,1997,1
SIM,1942,3,na,1945,5154
STAT,1967,39,25-29,2006,1.4591969195058336
STAT,1834,50,45-49,1884,0.014128295523841835
STAT,1910,39,50-100,1949,0.4592155520749542
SIM,1901,99,na,2000,33
STAT,1873,33,30-34,1906,20.48926863651341
STAT,1952,37,30-34,1989,2.5968007966089317
SIM,1976,33,30-34,2009,6
STAT,1901,39,25-29,1940,0.9944517814425395
STAT,1868,32,45-49,1900,1.933493591044031
STAT,1930,18,50-100,1948,0.5575953142902316
STAT,1969,14,na,1983,5660.833319802016
SIM,1906,29,25-29,1935,74
STAT,1939,48,na,1987,4403.80334179801
STAT,1814,52,na,1866,1774.4829815447954
STAT,1870,19,50-100,1889,0.05560930672823416
STAT,1995,17,40-44,2012,2.3366034940535236
STAT,1850,23,35-39,1873,7.158521038351685
SIM,1878,23,30-34,1901,56
STAT,1849,101,na,1950,0.4422722116263259
STAT,1881,24,25-29,1905,63.32284698680826
SIM,1880,15,35-39,1895,1
STAT,1917,33,50-100,1950,0.9949634203027733
STAT,1913,47,20-24,1960,0.012454572627602701
STAT,1968,38,25-29,2006,1.4606771392193372
STAT,1821,34,na,1855,1716.8131580592833
STAT,1973,29,na,2002,5609.905973217229
SIM,1975,39,25-29,2014,7
STAT,1849,27,50-100,1876,0.5877305955632519
STAT,1901,31,15-19,1932,0.23114028758985436
STAT,1850,41,35-39,1891,1.8725698447218442
SIM,1901,58,na,1959,3447
STAT,1808,48,20-24,1856,0.05896476820443352
STAT,1873,54,35-39,1927,0.009866689138168265
STAT,1895,43,30-34,1938,0.11906164508812328
STAT,1956,37,15-19,1993,0.03021193099174517
STAT,1856,18,40-44,1874,0.1892940308707229
STAT,1893,32,20-24,1925,3.943001901595468
STAT,1895,25,30-34,1920,38.084685601532165
STAT,1810,45,25-29,1855,0.23415223959363918
STAT,1921,79,na,2000,2590.6420865693117
SIM,1881,33,30-34,1914,5
SIM,1885,0,na,1885,3893
STAT,1910,47,40-44,1957,0.16993545098384158
SIM,1947,0,na,1947,6459
STAT,1976,17,35-39,1993,6.46962299134645
SIM,1937,32,45-49,1969,1
STAT,1892,47,25-29,1939,0.04677728289681208
STAT,1821,52,25-29,1873,0.006176377706257871
SIM,1831,30,na,1861,1839
SIM,1944,38,na,1982,4588
STAT,1982,19,20-24,2001,220.0166530706356
STAT,1870,76,na,1946,1077.8840532390973
STAT,1949,63,na,2012,4607.835122131938
STAT,1822,39,45-49,1861,4.3893005802939
SIM,1978,29,45-49,2007,1
STAT,1972,31,30-34,2003,23.74353781159032
SIM,1990,19,20-24,2009,418
STAT,1918,39,40-44,1957,1.8166591371469074
SIM,1957,19,15-19,1976,1
STAT,1934,21,50-100,1955,1.0213297136187398
SIM,1844,29,40-44,1873,1
SIM,1830,39,45-49,1869,3
SIM,1903,29,45-49,1932,4
STAT,1941,48,30-34,1989,0.10994215262608557
STAT,1829,51,na,1880,1698.1169819043253
STAT,1829,44,25-29,1873,0.6637330979790058
STAT,1882,32,45-49,1914,1.965662533412553
STAT,1836,29,40-44,1865,3.478346576003712
STAT,1860,51,20-24,1911,6.896291069007068E-4
STAT,1844,99,na,1943,1.5840732222620018
STAT,1921,26,35-39,1947,19.369386147883976
SIM,1886,21,15-19,1907,6
STAT,1834,38,20-24,1872,0.8659804880862887
STAT,1912,17,na,1929,4511.4763535341235
SIM,1898,24,45-49,1922,2
SIM,1831,43,45-49,1874,7
STAT,1845,49,40-44,1894,0.11295524858321197
SIM,1837,44,25-29,1881,3
STAT,1824,51,35-39,1875,0.011517844768980847
STAT,1895,18,40-44,1913,0.27403564695265975
STAT,1867,42,20-24,1909,0.17090852831487638
STAT,1974,27,45-49,2001,2.614637680148648
STAT,1893,37,15-19,1930,0.08191370030340808
STAT,1867,47,15-19,1914,4.2898568767079677E-4
SIM,1965,4,na,1969,5623
SIM,1982,27,45-49,2009,8
STAT,1968,33,30-34,2001,23.134167358838774
STAT,1860,28,20-24,1888,10.949253699785288
STAT,1808,52,na,1860,1594.0052615991003
STAT,1843,44,25-29,1887,0.6466257901761189
SIM,1950,38,na,1988,4716
STAT,1769,85,na,1854,120.0
STAT,1842,33,na,1875,1993.87827350948
STAT,1929,32,45-49,1961,2.306804011837776
STAT,1823,43,45-49,1866,1.5413326256189077
STAT,1907,40,45-49,1947,0.17825075637543622
STAT,1870,52,50-100,1922,0.017091290736844914
SIM,1942,21,50-100,1963,1
STAT,1949,19,15-19,1968,60.87133980522879
STAT,1822,50,50-100,1872,0.028588354484455323
STAT,1850,99,na,1949,1.949633910404512
SIM,1979,21,30-34,2000,2
SIM,1767,93,na,1860,11
SIM,1909,72,na,1981,3576
STAT,1959,18,25-29,1977,65.39685409185523
SIM,1818,39,40-44,1857,9
SIM,1863,34,25-29,1897,1
STAT,1843,18,na,1861,2925.9988607080754
SIM,2006,4,na,2010,7592
SIM,1835,24,25-29,1859,6
STAT,1846,43,35-39,1889,1.8705304134267609
SIM,1842,38,20-24,1880,2
STAT,1948,39,30-34,1987,2.4745438383195837
STAT,1998,8,na,2006,6659.435412532387
SIM,1828,35,35-39,1863,12
SIM,1854,43,35-39,1897,4
STAT,1833,48,30-34,1881,0.07217847314470102
STAT,1928,60,na,1988,5037.441302920952
STAT,1905,38,50-100,1943,0.4404357709738635
SIM,1875,42,20-24,1917,1
SIM,1891,10,na,1901,3656
SIM,1900,11,na,1911,3928
SIM,1904,21,30-34,1925,2
SIM,1965,21,50-100,1986,2
SIM,1861,44,na,1905,1769
SIM,1866,28,na,1894,2463
STAT,1844,66,na,1910,1370.9051615488602
SIM,1850,44,na,1894,1514
STAT,1894,22,45-49,1916,1.03450389061845
SIM,1958,27,35-39,1985,39
SIM,1925,24,na,1949,5088
SIM,1921,10,na,1931,5566
SIM,1904,25,na,1929,4260
SIM,1883,33,15-19,1916,1
STAT,1927,22,20-24,1949,158.0671261003729
SIM,1959,23,50-100,1982,1
SIM,1936,35,35-39,1971,5
STAT,1959,36,25-29,1995,1.5326922946899952
STAT,1966,47,50-100,2013,0.33911129874529966
STAT,1913,61,na,1974,3814.0661388460658
SIM,1935,22,20-24,1957,178
STAT,1904,98,na,2002,75.18270387223447
STAT,1875,33,15-19,1908,0.16911803669988476
SIM,1897,42,na,1939,3666
SIM,1926,39,40-44,1965,5
STAT,1846,50,25-29,1896,0.0037142892457239984
SIM,1845,29,na,1874,2330
STAT,1930,0,na,1930,6722.554262390201
STAT,1943,42,20-24,1985,0.02246259191548055
SIM,1980,31,30-34,2011,54
STAT,1928,35,35-39,1963,3.5337256088755264
SIM,1912,34,35-39,1946,12
STAT,1833,29,na,1862,1976.3132333747205
SIM,1821,41,30-34,1862,1
STAT,1962,35,35-39,1997,3.691112474183707
SIM,1915,72,na,1987,3329
STAT,1859,32,20-24,1891,2.484934640381889
SIM,1834,82,na,1916,389
SIM,1985,15,30-34,2000,23
SIM,1858,34,20-24,1892,7
STAT,1852,47,50-100,1899,0.23047545740195347
STAT,1874,22,45-49,1896,0.823848645429153
STAT,1964,39,20-24,2003,0.3939104470187255
STAT,1853,43,na,1896,2284.491461334897
STAT,1839,34,45-49,1873,1.6668856298889039
STAT,1886,39,35-39,1925,8.523290874758564
STAT,1898,17,na,1915,3939.1381941790632
SIM,1892,41,45-49,1933,4
SIM,1910,25,na,1935,3514
STAT,1829,104,na,1933,0.04886307074917974
STAT,1834,48,15-19,1882,3.8219995631128104E-4
SIM,1795,84,na,1879,19
SIM,1886,32,na,1918,2144
STAT,1920,28,40-44,1948,5.877409628784046
SIM,1915,33,20-24,1948,4
STAT,1836,45,30-34,1881,0.09461993179127454
STAT,1949,21,45-49,1970,1.5156639466703
SIM,1990,5,na,1995,6337
STAT,1907,33,20-24,1940,2.62429896433402
STAT,1931,15,50-100,1946,0.5686839879081763
STAT,1847,24,25-29,1871,53.225778839354184
SIM,1905,88,na,1993,339
STAT,1904,34,35-39,1938,9.554160768532846
SIM,1867,99,na,1966,7
STAT,1908,18,30-34,1926,2.724879657675291
STAT,1925,68,na,1993,4224.674961614739
STAT,1813,41,30-34,1854,4.492587005002579
STAT,1922,23,45-49,1945,1.4838367511203583
STAT,1925,58,na,1983,4872.029333503384
SIM,1944,29,45-49,1973,5
SIM,1864,22,25-29,1886,135
SIM,1872,46,na,1918,2783
STAT,1895,28,35-39,1923,14.443522082126648
SIM,1961,37,35-39,1998,7
STAT,1917,18,40-44,1935,0.3464577207886216
STAT,1812,57,na,1869,1128.1879417193677
SIM,1802,71,na,1873,513
STAT,1984,16,15-19,2000,74.40694880837954
SIM,1925,18,40-44,1943,3
STAT,1872,33,35-39,1905,11.685743613997133
STAT,1825,54,50-100,1879,0.019531433736096723
STAT,1948,15,na,1963,4863.651249233777
SIM,1865,74,na,1939,1476
SIM,1903,36,35-39,1939,2
STAT,1951,46,50-100,1997,0.3241085061074717
STAT,1856,22,25-29,1878,58.53704306455354
STAT,1923,33,na,1956,4998.715871469397
STAT,1975,27,15-19,2002,1.0794370517841179
SIM,1980,14,na,1994,6001
STAT,1999,0,na,1999,6753.022410311748
SIM,1855,24,25-29,1879,134
STAT,1951,47,40-44,1998,0.2253655032285531
STAT,1848,32,45-49,1880,2.1607635660776463
SIM,1981,31,35-39,2012,4
STAT,1849,21,40-44,1870,1.9668189288380906
STAT,1857,28,15-19,1885,0.4170169839169074
STAT,1973,37,20-24,2010,0.4053495627783963
STAT,1827,47,30-34,1874,0.12260176112358183
STAT,1851,42,45-49,1893,1.1853667422643621
STAT,1865,24,45-49,1889,0.7244010483048348
STAT,1822,51,na,1873,2022.0296951102669
STAT,1845,52,30-34,1897,0.003989801252782187
STAT,1889,30,25-29,1919,14.687936429264532
STAT,1913,39,na,1952,4243.820394395956
STAT,1966,19,30-34,1985,17.557481061103594
SIM,1835,21,20-24,1856,90
SIM,1882,76,na,1958,1605
STAT,1901,15,25-29,1916,9.202728197859743
SIM,1967,32,na,1999,5648
STAT,1884,41,45-49,1925,1.7142220506552597
STAT,1906,85,na,1991,1227.585442676051
SIM,1908,94,na,2002,92
SIM,1897,30,25-29,1927,32
SIM,1905,28,50-100,1933,1
STAT,1903,19,na,1922,4129.269957891937
STAT,2011,3,na,2014,7202.344200368851
STAT,1913,41,35-39,1954,0.22804605901490835
SIM,1957,21,45-49,1978,5
SIM,1968,1,na,1969,5404
STAT,1843,22,15-19,1865,4.154950744412163
STAT,1903,5,na,1908,4307.745853089985
STAT,1930,24,35-39,1954,13.83525562266156
STAT,1962,20,na,1982,5421.418238669248
STAT,1955,16,50-100,1971,0.5741381430312716
STAT,1831,28,50-100,1859,0.6620673884279844
SIM,1854,31,na,1885,2685
STAT,1849,53,45-49,1902,0.0110675104303962
SIM,1867,32,20-24,1899,7
STAT,1830,31,20-24,1861,2.982935548717889
STAT,1930,39,20-24,1969,0.39601831269602156
SIM,1929,31,25-29,1960,2
STAT,1884,49,40-44,1933,0.1911300838040473
SIM,1892,49,40-44,1941,1
STAT,1949,29,40-44,1978,6.276735487236163
STAT,1972,1,na,1973,5818.1485472430995
STAT,1987,12,na,1999,6471.617015272728
SIM,1856,32,45-49,1888,4
SIM,1954,23,30-34,1977,3
STAT,1920,26,30-34,1946,49.752522935559554
STAT,1946,23,30-34,1969,36.897772962505194
SIM,1857,21,40-44,1878,2
STAT,1878,51,30-34,1929,0.007206875567517161
STAT,1927,47,35-39,1974,0.18672932926153818
SIM,1947,18,na,1965,5404
STAT,1862,35,30-34,1897,5.239944758042171
SIM,1932,19,25-29,1951,146
STAT,1879,32,20-24,1911,3.2572368204608115
SIM,2004,6,na,2010,7407
STAT,1907,39,na,1946,3991.375772987354
SIM,1946,64,na,2010,3974
STAT,1914,15,35-39,1929,1.0068524844309001
SIM,1884,47,na,1931,2554
SIM,1971,33,30-34,2004,47
STAT,1845,50,20-24,1895,5.043962997589293E-4
STAT,1950,16,15-19,1966,61.944882525494705
SIM,1888,23,25-29,1911,146
SIM,1838,32,25-29,1870,14
STAT,1886,46,25-29,1932,0.07031619704610213
SIM,1970,19,45-49,1989,1
STAT,1825,52,45-49,1877,0.019528945964383485
SIM,1884,17,30-34,1901,3
STAT,1962,19,45-49,1981,0.7381657074040215
SIM,1865,64,na,1929,2272
SIM,1887,32,20-24,1919,4
SIM,1885,19,na,1904,3372
SIM,1981,31,na,2012,6399
STAT,1849,43,15-19,1892,0.010626239917975948
STAT,1927,53,na,1980,5207.586754696262
STAT,1874,11,na,1885,3102.733688917261
STAT,1990,21,25-29,2011,153.2148101348644
STAT,1829,42,35-39,1871,1.935456615895534
STAT,1910,60,na,1970,3687.391179265891
STAT,1917,25,30-34,1942,47.744421098475236
STAT,1889,43,50-100,1932,1.492019548877175
SIM,1850,50,40-44,1900,1
STAT,1947,29,20-24,1976,23.80830867140671
STAT,1875,108,na,1983,0.12067808694583662
STAT,1899,34,15-19,1933,0.223228862114508
STAT,1973,31,35-39,2004,13.911065306101838
SIM,1837,42,35-39,1879,6
SIM,1826,41,50-100,1867,3
STAT,1958,17,15-19,1975,68.7891358428366
STAT,1878,72,na,1950,1521.7322369493663
STAT,1962,10,na,1972,5810.0357604545825
STAT,1880,11,na,1891,3163.7456377565627
STAT,1895,41,20-24,1936,0.016641587942338817
STAT,1940,35,na,1975,4551.018739077511
SIM,1947,49,50-100,1996,1
SIM,1951,39,30-34,1990,4
STAT,1903,36,40-44,1939,1.5605907633356806
STAT,1777,90,na,1867,21.949223114801732
STAT,1943,39,30-34,1982,2.29322549872133
SIM,1911,36,40-44,1947,5
SIM,1880,33,35-39,1913,32
STAT,1787,102,na,1889,0.07033537065924633
STAT,1931,43,50-100,1974,0.1808743143054864
STAT,1933,23,20-24,1956,170.23445011821065
SIM,1955,21,25-29,1976,275
STAT,1860,38,15-19,1898,0.051970783768233636
SIM,1992,16,15-19,2008,80
STAT,1870,33,15-19,1903,0.16133692788088624
SIM,1840,82,na,1922,107
SIM,1880,40,25-29,1920,2
SIM,1916,18,30-34,1934,4
SIM,1983,20,45-49,2003,5
STAT,1834,102,na,1936,0.267551668591822
STAT,1924,26,15-19,1950,0.9515810997593633
SIM,1834,72,na,1906,896
SIM,1941,23,20-24,1964,234
STAT,1881,22,35-39,1903,6.495642688027141
SIM,1951,15,30-34,1966,36
SIM,1972,39,20-24,2011,1
SIM,1894,39,35-39,1933,3
STAT,1830,27,35-39,1857,12.129394205200725
STAT,1904,49,20-24,1953,0.010983498726175022
STAT,1936,42,30-34,1978,0.14619369620704822
STAT,1953,37,35-39,1990,3.478840370658394
SIM,1966,17,15-19,1983,115
SIM,1902,36,30-34,1938,3
STAT,1943,45,25-29,1988,0.06784688324190503
SIM,1883,43,45-49,1926,7
STAT,1873,25,50-100,1898,0.7589854968711351
STAT,1974,20,40-44,1994,5.087081864375005
SIM,1854,23,50-100,1877,1
STAT,1924,19,25-29,1943,59.2189450485362
STAT,1872,40,25-29,1912,0.7516415580275954
STAT,1869,51,20-24,1920,8.286507375862773E-4
SIM,1836,49,50-100,1885,1
STAT,1869,53,30-34,1922,0.006545803852975407
STAT,1878,62,na,1940,2202.334797449762
STAT,1931,68,na,1999,4664.191649181045
SIM,1884,24,20-24,1908,6
STAT,1910,20,15-19,1930,5.809476255384732
SIM,1859,64,na,1923,1440
STAT,1977,18,na,1995,5737.5544671437165
SIM,1955,29,20-24,1984,2
STAT,1876,24,20-24,1900,81.6964919146658
STAT,1875,43,45-49,1918,1.7719925987872192
SIM,1861,37,30-34,1898,2
SIM,1847,34,45-49,1881,2
SIM,1842,24,15-19,1866,6
STAT,1820,42,15-19,1862,0.017079092382115586
STAT,1834,24,15-19,1858,3.9688579985984065
STAT,1943,15,30-34,1958,14.925803651512147
STAT,1851,4,na,1855,2569.8216
STAT,1798,88,na,1886,43.159860121104394
STAT,1893,79,na,1972,1588.175546968401
SIM,1972,31,25-29,2003,3
STAT,1947,21,25-29,1968,120.51291260694644
STAT,1853,37,30-34,1890,5.306228849868672
STAT,1830,86,na,1916,139.18667386271514
STAT,1839,31,40-44,1870,4.276548657279368
STAT,1907,36,25-29,1943,1.0602841394168534
STAT,1858,48,na,1906,2000.049668406255
STAT,1836,48,35-39,1884,0.13168706864068194
STAT,1860,52,na,1912,1992.0186078949798
SIM,1954,26,35-39,1980,51
STAT,1873,6,na,1879,3230.824278937718
STAT,1818,76,na,1894,419.18934030609114
STAT,1863,33,25-29,1896,10.292298541269426
STAT,1889,24,30-34,1913,25.18057876058413
STAT,1970,32,50-100,2002,1.2174921320083172
SIM,1840,72,na,1912,789
SIM,1957,36,30-34,1993,2
STAT,1903,43,30-34,1946,0.13028349325712488
STAT,1957,25,15-19,1982,1.0797364387325816
STAT,1806,98,na,1904,1.1149666211921019
STAT,1958,34,30-34,1992,24.310721309354232
SIM,1989,21,25-29,2010,305
STAT,1867,25,na,1892,2588.8967435293575
STAT,1809,99,na,1908,0.8802310152687695
STAT,1897,15,25-29,1912,8.785148631304363
STAT,1862,42,50-100,1904,1.0276459737373576
STAT,1892,25,15-19,1917,0.6607031546697263
SIM,1974,25,25-29,1999,5
SIM,1960,38,45-49,1998,1
SIM,1847,31,40-44,1878,12
STAT,1859,35,25-29,1894,2.671997077989579
STAT,1934,74,na,2008,4079.2805761771874
SIM,1861,13,na,1874,2195
STAT,1927,44,30-34,1971,0.18438057815822081
STAT,1911,34,25-29,1945,10.306445498486507
SIM,1837,25,na,1862,2718
STAT,1878,54,35-39,1932,0.010088268395185052
SIM,1965,27,25-29,1992,14
SIM,1914,55,na,1969,3763
SIM,1907,24,15-19,1931,11
SIM,1816,53,na,1869,1462
STAT,1966,25,25-29,1991,95.36798863820985
SIM,1909,47,40-44,1956,1
SIM,1918,21,na,1939,4147
SIM,1844,21,45-49,1865,1
STAT,1952,38,45-49,1990,0.9703319139696907
SIM,1996,1,na,1997,6953
SIM,1844,48,35-39,1892,1
STAT,1940,29,20-24,1969,21.467082805930005
SIM,1961,34,30-34,1995,4
STAT,1915,18,20-24,1933,32.666383133487535
STAT,1971,40,15-19,2011,0.002339200049610483
STAT,1986,16,35-39,2002,6.902044103816005
STAT,1884,39,15-19,1923,0.06338419032642065
SIM,1897,24,30-34,1921,3
STAT,1946,26,35-39,1972,19.308889007298568
SIM,1929,54,na,1983,4996
SIM,1958,24,30-34,1982,63
STAT,1912,19,35-39,1931,0.9748997511648883
STAT,1868,42,na,1910,2559.4728067385863
STAT,1898,116,na,2014,1.0721935971072632E-4
SIM,1812,44,25-29,1856,2
SIM,1920,19,35-39,1939,9
STAT,1967,42,15-19,2009,0.00230065018729824
STAT,2008,4,na,2012,7101.798842573403
STAT,1852,16,30-34,1868,1.8282531392474926
STAT,1982,23,40-44,2005,5.476445814328507
SIM,1873,21,40-44,1894,5
SIM,1860,16,30-34,1876,4
SIM,1990,23,40-44,2013,9
STAT,1773,112,na,1885,0.001453940352371712
STAT,1922,41,50-100,1963,0.1557718880544338
STAT,1963,36,na,1999,5688.0100821397555
SIM,1845,27,35-39,1872,13
STAT,1827,54,50-100,1881,0.016145701646610406
SIM,1929,24,35-39,1953,23
STAT,1820,45,50-100,1865,0.2717280113890906
STAT,1847,70,na,1917,1079.6015530115205
STAT,1956,58,na,2014,5535.626144081112
STAT,1848,96,na,1944,9.12356153415581
STAT,1836,21,45-49,1857,0.8438897613792664
STAT,1883,18,15-19,1901,6.683099781920004
STAT,1953,34,30-34,1987,22.391169621860342
SIM,1923,18,20-24,1941,2
STAT,1900,66,na,1966,2928.2399143616885
SIM,1903,33,30-34,1936,35
SIM,1861,9,na,1870,2259
SIM,1890,47,na,1937,3124
STAT,1941,52,na,1993,4467.014600421991
STAT,1855,32,35-39,1887,8.773960447341166
STAT,1918,15,20-24,1933,34.31816535553224
SIM,1935,37,40-44,1972,5
SIM,1830,42,35-39,1872,4
STAT,1973,19,20-24,1992,202.21690903965157
SIM,1829,31,20-24,1860,2
STAT,1830,34,25-29,1864,10.652792213364725
STAT,1837,43,25-29,1880,0.5417215876124227
SIM,1928,28,50-100,1956,2
STAT,1826,48,40-44,1874,0.1215903051245581
STAT,1865,21,40-44,1886,2.2120365210904396
STAT,1890,103,na,1993,6.100190493789768
STAT,1983,15,15-19,1998,74.12967316866313
STAT,1898,23,45-49,1921,1.0842380582027689
SIM,1941,26,25-29,1967,5
SIM,1965,45,50-100,2010,1
STAT,1881,82,na,1963,785.3639060695918
SIM,1891,18,15-19,1909,7
STAT,1933,26,25-29,1959,100.94901281163943
STAT,1914,56,na,1970,4050.038323679115
STAT,1949,36,30-34,1985,2.5224871128282826
SIM,1917,39,30-34,1956,5
STAT,1866,35,15-19,1901,0.060636851318614945
STAT,1887,83,na,1970,967.1227465727416
SIM,1926,15,20-24,1941,366
STAT,1921,38,na,1959,4841.235453211863
STAT,1966,32,15-19,1998,0.18880910527845282
STAT,1839,44,na,1883,1882.9546941209749
STAT,1822,42,35-39,1864,3.700257986875162
STAT,1926,48,45-49,1974,0.3085571062828857
STAT,1927,37,40-44,1964,2.147446002055111
STAT,1845,105,na,1950,0.019757878059674872
STAT,1904,18,45-49,1922,0.10797008432810708
SIM,1925,25,30-34,1950,108
SIM,1819,37,35-39,1856,2
STAT,1917,49,30-34,1966,0.10683003456442049
STAT,1930,20,50-100,1950,0.9787199876854118
SIM,1845,43,25-29,1888,3
SIM,1863,79,na,1942,491
SIM,1957,29,40-44,1986,10
STAT,1783,90,na,1873,22.135932601158157
SIM,1953,42,na,1995,5596
SIM,1991,22,50-100,2013,3
STAT,1850,19,15-19,1869,7.377782735790807
STAT,1957,45,50-100,2002,0.3596502617842553
SIM,1911,43,30-34,1954,1
STAT,1861,68,na,1929,1466.1637650279347
SIM,1974,14,na,1988,6402
SIM,1876,12,na,1888,2947
STAT,1889,17,40-44,1906,0.2601922700126686
STAT,1974,8,na,1982,5922.394491307
SIM,1881,23,50-100,1904,1
STAT,1935,47,40-44,1982,0.2570091584646959
SIM,1801,54,na,1855,1489
STAT,1909,39,30-34,1948,1.9730462103196595
STAT,1949,7,na,1956,5275.566924007111
SIM,1933,16,25-29,1949,76
STAT,1793,73,na,1866,505.7035643094474
SIM,1894,43,20-24,1937,1
STAT,1978,16,50-100,1994,0.590236528627273
STAT,1852,23,20-24,1875,76.62907462976581
SIM,1960,16,35-39,1976,8
STAT,1826,47,na,1873,1406.836719108511
STAT,1880,40,30-34,1920,1.4205118843112778
STAT,1942,68,na,2010,3791.57073158771
STAT,1920,84,na,2004,1713.4060568828609
STAT,1875,82,na,1957,636.4538081145947
STAT,1843,45,50-100,1888,0.2516476630208941
STAT,1925,16,25-29,1941,60.54178547090035
STAT,1934,16,15-19,1950,71.05087055045968
SIM,1888,20,20-24,1908,83
STAT,1952,16,35-39,1968,5.8047687226889595
SIM,1855,41,40-44,1896,1
STAT,1858,49,15-19,1907,3.5259518869174054E-4
SIM,1961,27,40-44,1988,10
STAT,1876,67,na,1943,1891.1313522579187
STAT,1923,23,na,1946,4886.615903622068
STAT,1953,27,40-44,1980,6.535198555172703
SIM,1865,33,na,1898,3026
SIM,1871,33,25-29,1904,11
SIM,1932,82,na,2014,1774
SIM,1878,26,35-39,1904,27
SIM,1948,35,25-29,1983,1
STAT,1886,43,20-24,1929,0.19192833838482384
SIM,1961,39,45-49,2000,1
SIM,1863,32,35-39,1895,3
SIM,1933,43,50-100,1976,1
SIM,1814,68,na,1882,744
SIM,1887,35,25-29,1922,7
STAT,1908,56,na,1964,3696.106831278305
STAT,1938,16,35-39,1954,4.7909729879279155
SIM,1910,35,na,1945,3655
STAT,1879,35,25-29,1914,3.502437096395347
STAT,1896,81,na,1977,1493.933133627664
STAT,1956,15,40-44,1971,2.137075618254993
SIM,1879,25,25-29,1904,50
STAT,1830,24,30-34,1854,30.66753786550726
STAT,1907,15,45-49,1922,0.11143129169140645
STAT,1976,16,20-24,1992,209.08898629361502
SIM,1938,25,40-44,1963,1
STAT,1933,42,15-19,1975,0.002436069434307467
STAT,1895,10,na,1905,3891.1669354499063
STAT,1847,41,40-44,1888,1.7628082131071425
STAT,1929,24,na,1953,5296.26949811813
STAT,1891,47,50-100,1938,0.19667926119026774
SIM,1880,30,30-34,1910,3
STAT,1936,19,50-100,1955,0.4119743952307555
STAT,1908,26,15-19,1934,0.780356351734229
SIM,1969,39,50-100,2008,1
STAT,1913,71,na,1984,3158.5057321147533
STAT,1975,19,40-44,1994,2.128074325451236
STAT,1845,15,50-100,1860,0.04222198851811076
STAT,1961,37,40-44,1998,2.299520331454618
STAT,1872,30,30-34,1902,20.394989624224873
STAT,1852,26,na,1878,2392.7399179634517
STAT,1928,4,na,1932,5869.040332828165
SIM,1848,21,30-34,1869,43
SIM,1995,16,50-100,2011,1
STAT,1848,33,40-44,1881,4.839470794358428
STAT,1947,48,15-19,1995,4.967085267488996E-4
SIM,1832,29,15-19,1861,2
STAT,1874,42,na,1916,2727.246004448905
STAT,1986,24,na,2010,6020.737315812831
STAT,1894,46,30-34,1940,0.08123607035194341
SIM,1908,16,15-19,1924,7
SIM,1872,50,na,1922,2724
SIM,1967,36,na,2003,5712
SIM,1894,36,30-34,1930,13
STAT,1858,29,50-100,1887,0.5811169087076787
STAT,1917,23,na,1940,4465.34149736261
STAT,1858,51,45-49,1909,0.013127835770667853
STAT,1896,32,50-100,1928,1.3966203612540358
STAT,1837,59,na,1896,1407.3170436182393
STAT,1972,16,35-39,1988,6.201989411298449
SIM,1856,33,40-44,1889,9
STAT,1873,25,na,1898,2831.5742989560995
STAT,1809,46,15-19,1855,0.001029297903300124
STAT,1886,36,30-34,1922,6.518980365375999
STAT,1906,22,50-100,1928,0.686258652594289
STAT,1928,70,na,1998,4240.057832193525
SIM,1900,15,15-19,1915,10
STAT,1882,52,35-39,1934,0.009652599897051597
SIM,1866,29,50-100,1895,1
SIM,1907,26,25-29,1933,132
STAT,1925,20,45-49,1945,1.5630673134933433
STAT,1912,16,30-34,1928,2.854112807735468
SIM,1953,50,na,2003,5507
STAT,1903,46,35-39,1949,0.13018037298288707
STAT,1862,38,35-39,1900,6.854380263731555
SIM,1925,47,40-44,1972,1
STAT,1969,31,25-29,2000,13.589798168454582
STAT,1896,16,35-39,1912,0.8384439077971263
STAT,1857,31,40-44,1888,3.962888410278104
SIM,1947,26,45-49,1973,2
SIM,1977,31,25-29,2008,35
STAT,1835,36,15-19,1871,0.04379139367819349
SIM,1847,33,30-34,1880,4
STAT,1941,49,25-29,1990,0.06521797506533868
SIM,1954,24,45-49,1978,4
SIM,1968,33,25-29,2001,7
SIM,1916,21,20-24,1937,258
STAT,1801,53,20-24,1854,0.002877127690311924
STAT,1812,88,na,1900,60.27207437912157
STAT,1872,7,na,1879,3162.216488692588
SIM,1837,83,na,1920,469
STAT,1946,24,45-49,1970,1.4439815221143155
STAT,1951,18,40-44,1969,1.921552441923782
STAT,1850,21,45-49,1871,0.8678382384987173
SIM,1973,27,20-24,2000,51
SIM,1834,38,15-19,1872,3
STAT,1869,95,na,1964,45.31201848137141
SIM,1895,18,35-39,1913,1
SIM,1964,21,na,1985,5941
SIM,1925,34,na,1959,5282
SIM,1870,38,35-39,1908,16
STAT,1909,45,50-100,1954,0.2424281673840998
STAT,1885,25,25-29,1910,49.02391038273886
STAT,1968,31,20-24,1999,3.5858610517004768
SIM,1834,33,20-24,1867,4
STAT,1904,15,50-100,1919,0.08156750367433034
STAT,1882,77,na,1959,1131.8429186463848
SIM,1815,49,50-100,1864,1
STAT,1863,30,20-24,1893,2.7496095575503716
STAT,1874,21,30-34,1895,21.10780719014186
SIM,1908,36,35-39,1944,4
SIM,1908,55,na,1963,3445
STAT,1835,31,20-24,1866,2.171734335596803
STAT,1970,17,30-34,1987,17.608322208219718
SIM,1902,39,35-39,1941,4
STAT,1910,59,na,1969,3723.5468188771897
SIM,1875,23,15-19,1898,7
SIM,1823,33,45-49,1856,4
STAT,1821,65,na,1886,1041.899799676524
SIM,1850,65,na,1915,955
STAT,1800,70,na,1870,910.6560019205904
STAT,1888,55,na,1943,2805.007699609497
STAT,1821,51,30-34,1872,0.010588087926602022
SIM,1877,16,25-29,1893,14
STAT,1825,31,na,1856,2083.5890024708247
STAT,1838,44,50-100,1882,0.9494222336164752
STAT,1893,15,na,1908,3701.2655754232937
STAT,1877,42,15-19,1919,0.0165575296830139
SIM,1882,12,na,1894,3557
STAT,1867,23,15-19,1890,3.543676315133962
STAT,1793,83,na,1876,138.06307121649002
STAT,1962,46,50-100,2008,0.34874036660035646
SIM,1958,26,20-24,1984,4
STAT,1887,18,35-39,1905,0.7077988581590761
STAT,1898,20,40-44,1918,3.269467451462051
STAT,1936,20,20-24,1956,122.84154796614716
STAT,1961,43,25-29,2004,0.11047386990671812
STAT,1957,29,15-19,1986,1.0777295268912632
STAT,1841,23,45-49,1864,0.7797542999167627
STAT,1985,25,30-34,2010,64.64806913005397
STAT,1799,74,na,1873,622.9752377083307
SIM,1845,40,20-24,1885,4
STAT,1870,45,na,1915,2585.2173605407033
STAT,1939,49,50-100,1988,0.27028561618660724
SIM,1893,25,25-29,1918,77
SIM,1946,8,na,1954,4700
STAT,1908,21,20-24,1929,118.47892123624685
SIM,1786,76,na,1862,116
SIM,1869,30,na,1899,2006
SIM,1902,34,40-44,1936,1
STAT,1928,69,na,1997,4347.751640324359
STAT,1808,83,na,1891,202.41935435085412
STAT,1874,102,na,1976,5.059326283149041
SIM,1995,2,na,1997,6767
STAT,1844,35,na,1879,2123.9565186099508
SIM,1932,19,na,1951,4806
STAT,1867,5,na,1872,3043.756362944279
STAT,1855,78,na,1933,664.8325159690222
SIM,1939,34,20-24,1973,1
STAT,1957,31,45-49,1988,2.441982714125824
SIM,1933,20,45-49,1953,4
SIM,1826,46,na,1872,1812
SIM,1847,26,40-44,1873,5
SIM,1995,9,na,2004,6763
STAT,1942,26,50-100,1968,1.2063508625837205
SIM,1851,20,na,1871,2712
SIM,1963,16,50-100,1979,2
STAT,1945,17,na,1962,4640.181134696819
STAT,1876,39,40-44,1915,5.169708480070294
STAT,1826,40,45-49,1866,1.1573750338985955
SIM,1887,58,na,1945,3180
STAT,1784,105,na,1889,0.022495853307095266
STAT,1944,40,15-19,1984,0.0019876331013544213
SIM,1837,24,50-100,1861,3
SIM,1935,54,na,1989,5915
SIM,1939,47,na,1986,4852
STAT,1889,10,na,1899,3684.9181706116156
STAT,1867,51,50-100,1918,0.01635089812485619
STAT,1837,40,20-24,1877,0.13922371380780454
STAT,1839,33,30-34,1872,16.86360443857554
SIM,1899,77,na,1976,2041
SIM,1860,23,20-24,1883,1
SIM,1944,20,20-24,1964,9
SIM,1879,45,45-49,1924,1
SIM,1884,39,40-44,1923,3
STAT,1939,26,45-49,1965,2.006044343893619
SIM,1965,31,45-49,1996,1
SIM,1838,30,35-39,1868,27
STAT,1852,28,15-19,1880,0.4946487542393647
STAT,1839,26,40-44,1865,3.0144054006652587
STAT,1986,23,25-29,2009,152.34324914329213
SIM,1850,37,50-100,1887,5
STAT,1916,16,15-19,1932,11.140437001099514
STAT,1905,37,20-24,1942,0.2779098317481092
STAT,1951,25,30-34,1976,54.126000775287
SIM,1891,42,50-100,1933,3
SIM,1834,26,30-34,1860,47
SIM,1933,28,40-44,1961,15
SIM,1956,17,20-24,1973,195
SIM,1901,29,25-29,1930,143
STAT,1863,17,35-39,1880,0.631832878089653
STAT,1897,35,45-49,1932,3.1054319583943166
STAT,1906,24,40-44,1930,3.4848283982092894
STAT,1845,53,25-29,1898,0.002348480088134746
STAT,1910,15,50-100,1925,0.08615989680168626
STAT,1905,3,na,1908,4415.733556185488
SIM,1906,20,na,1926,3424
SIM,1839,41,40-44,1880,1
SIM,1942,36,na,1978,5011
STAT,1948,17,20-24,1965,179.05065886810945
STAT,1865,23,30-34,1888,18.637816931388947
SIM,1979,19,na,1998,6444
STAT,1953,47,na,2000,5334.744742002763
STAT,1846,23,50-100,1869,0.5164200204910963
STAT,1956,4,na,1960,6005.419152323809
STAT,1861,26,15-19,1887,0.4416187591073296
STAT,1965,16,45-49,1981,0.7199202879403273
STAT,1879,33,35-39,1912,12.151807792203549
SIM,1873,37,50-100,1910,2
STAT,1941,21,na,1962,4357.716437475473
SIM,1829,32,35-39,1861,21
SIM,1928,34,45-49,1962,6
SIM,1933,59,na,1992,6010
STAT,1920,29,35-39,1949,18.862651522732932
SIM,1974,8,na,1982,6403
SIM,1927,69,na,1996,3770
STAT,1849,50,40-44,1899,0.008276904106913015
SIM,1973,26,50-100,1999,2
SIM,1924,16,15-19,1940,57
STAT,1914,39,20-24,1953,0.3008299193978415
STAT,1926,26,35-39,1952,20.83725041417384
SIM,1867,35,25-29,1902,6
STAT,1859,37,50-100,1896,1.1286697078080041
STAT,1812,98,na,1910,1.426217915699054
STAT,1880,43,35-39,1923,2.1990609748444507
STAT,1868,44,15-19,1912,0.015105210180406852
STAT,1994,3,na,1997,6551.014242512749
STAT,1925,28,40-44,1953,6.328894711373896
SIM,1907,23,20-24,1930,228
SIM,1875,26,na,1901,3349
SIM,1907,15,na,1922,4716
STAT,1884,27,30-34,1911,28.712930558137753
STAT,1898,25,35-39,1923,15.151342876936226
SIM,1873,23,30-34,1896,61
SIM,1876,44,15-19,1920,1
SIM,1860,30,45-49,1890,2
STAT,1826,33,20-24,1859,2.4191670204589215
STAT,1781,95,na,1876,1.905514243605361
STAT,1837,27,35-39,1864,8.967885895873557
SIM,1887,33,35-39,1920,46
SIM,1868,22,45-49,1890,1
STAT,1863,63,na,1926,1800.5595471955958
STAT,1909,45,25-29,1954,0.05685611703100411
SIM,1994,16,35-39,2010,9
STAT,1851,31,50-100,1882,0.7641309306537313
STAT,1931,27,20-24,1958,27.20294641446914
SIM,1843,40,50-100,1883,2
SIM,1947,19,20-24,1966,240
SIM,1895,40,na,1935,3548
STAT,1939,19,20-24,1958,156.57267320780727
SIM,1973,16,45-49,1989,1
STAT,1854,54,50-100,1908,0.011965808049945178
STAT,1957,27,25-29,1984,100.58276829159969
SIM,1879,23,na,1902,2597
SIM,1934,26,35-39,1960,4
STAT,1847,21,20-24,1868,65.47360295768175
SIM,1910,97,na,2007,75
SIM,1946,33,50-100,1979,7
SIM,1918,30,20-24,1948,3
STAT,1854,53,35-39,1907,0.006901160875901171
STAT,1919,49,15-19,1968,4.5828662918995916E-4
STAT,1826,38,15-19,1864,0.0440202441678089
STAT,1957,47,15-19,2004,5.830051669740539E-4
STAT,1991,17,20-24,2008,224.22590237016627
STAT,1847,44,45-49,1891,1.1360519103029703
STAT,1917,95,na,2012,237.12598292803747
STAT,1852,30,45-49,1882,1.7379895908209408
STAT,1894,49,35-39,1943,0.1147113920811957
STAT,1925,18,15-19,1943,63.0820795078238
SIM,1828,46,50-100,1874,2
SIM,1914,24,40-44,1938,13
STAT,1841,49,20-24,1890,0.010446319942826143
STAT,1892,30,na,1922,3479.3870368486887
STAT,1900,29,50-100,1929,1.0170536291459256
STAT,1880,50,25-29,1930,0.0043949994682972735
STAT,1862,42,20-24,1904,0.1544827310230166
SIM,1855,44,45-49,1899,5
STAT,1861,21,20-24,1882,68.41387288294455
SIM,1896,29,40-44,1925,1
STAT,1933,48,50-100,1981,0.35810891704161685
STAT,1888,29,40-44,1917,4.034661827446839
SIM,1889,32,40-44,1921,1
STAT,1852,38,40-44,1890,4.106697695996641
SIM,1844,65,na,1909,1552
SIM,1967,2,na,1969,5785
SIM,1860,38,40-44,1898,8
STAT,1857,63,na,1920,1603.751709364241
STAT,1952,62,na,2014,4810.537958971248
STAT,1865,16,40-44,1881,0.1974169270244419
STAT,1920,24,40-44,1944,4.284988813037994
SIM,1916,24,25-29,1940,133
SIM,1897,11,na,1908,4198
STAT,1835,34,25-29,1869,7.974511848852003
STAT,1885,27,15-19,1912,0.5222611952110365
SIM,1816,84,na,1900,69
STAT,1934,21,15-19,1955,8.262556431964262
SIM,1989,4,na,1993,6752
SIM,1870,35,30-34,1905,18
SIM,1944,1,na,1945,4804
STAT,1926,35,15-19,1961,0.027125676955402436
STAT,1869,54,25-29,1923,0.0038497246166151033
STAT,1962,32,30-34,1994,23.7469765370944
STAT,1885,22,20-24,1907,79.32580991084728
SIM,1817,79,na,1896,122
SIM,1908,33,30-34,1941,2
STAT,1836,64,na,1900,1582.0240056575065
STAT,1924,73,na,1997,3614.620293830232
SIM,1855,21,20-24,1876,59
SIM,1901,32,50-100,1933,3
SIM,1857,50,40-44,1907,1
STAT,1867,56,na,1923,2197.6820498431334
STAT,1945,39,15-19,1984,0.024888006077636093
STAT,1948,30,40-44,1978,5.274048729857279
SIM,1904,93,na,1997,676
SIM,1920,22,25-29,1942,225
STAT,1848,54,50-100,1902,0.015605805408663787
SIM,1843,34,25-29,1877,4
STAT,1857,34,45-49,1891,1.5539468439782376
SIM,1856,54,50-100,1910,1
SIM,1942,21,15-19,1963,12
STAT,1810,105,na,1915,0.01669481774723666
STAT,1931,58,na,1989,5378.893935832183
SIM,1865,41,35-39,1906,3
SIM,1847,45,na,1892,2378
SIM,1892,27,30-34,1919,47
SIM,1939,37,25-29,1976,3
STAT,1851,28,30-34,1879,23.213184489617085
STAT,1898,22,30-34,1920,27.78146757137998
STAT,1941,46,20-24,1987,0.013701166653992531
STAT,1923,47,15-19,1970,4.971292806077237E-4
STAT,1923,29,50-100,1952,1.3089024312782918
STAT,1881,28,50-100,1909,0.7095537620480566
STAT,1989,23,50-100,2012,1.0908933794293076
STAT,1856,20,35-39,1876,6.05374518162508
SIM,1869,26,na,1895,2103
SIM,1848,31,na,1879,1943
SIM,1902,37,45-49,1939,2
STAT,1907,38,50-100,1945,0.44772723261412967
STAT,1985,28,35-39,2013,24.737723067446687
SIM,1956,30,40-44,1986,21
SIM,1785,91,na,1876,17
SIM,1931,29,50-100,1960,6
SIM,1934,28,25-29,1962,2
SIM,1969,15,40-44,1984,4
STAT,1887,15,30-34,1902,2.0709655425742253
STAT,1783,80,na,1863,183.6548576540444
STAT,1861,78,na,1939,749.6162411654936
STAT,1939,23,40-44,1962,3.8972584523037717
STAT,1871,42,30-34,1913,1.318339316610723
STAT,1896,91,na,1987,427.94357293759435
SIM,1913,37,20-24,1950,1
SIM,1865,34,45-49,1899,1
SIM,1879,42,40-44,1921,7
SIM,1844,37,50-100,1881,1
STAT,1908,31,15-19,1939,0.14073487059287743
STAT,1932,17,45-49,1949,0.7635500968679594
SIM,1833,32,na,1865,1848
STAT,1908,24,25-29,1932,97.50992484735706
STAT,1895,44,25-29,1939,0.06608260279697402
STAT,1841,20,40-44,1861,2.3810636289517872
STAT,1865,37,50-100,1902,1.278394606509247
SIM,1891,31,35-39,1922,22
STAT,1874,24,35-39,1898,6.851152214224592
SIM,1874,85,na,1959,308
STAT,1948,27,15-19,1975,0.9363616811120564
STAT,1961,40,20-24,2001,0.027440689488172795
STAT,1898,106,na,2004,1.1781972819568214
STAT,1835,24,na,1859,1744.7362633897342
SIM,1905,3,na,1908,4721
STAT,1932,44,na,1976,5791.0641243615255
SIM,1898,40,35-39,1938,1
SIM,1970,21,na,1991,5267
STAT,1836,37,50-100,1873,1.371955171605015
STAT,1872,52,40-44,1924,0.012134519461611466
STAT,1891,44,na,1935,3252.0658730349137
STAT,1937,48,20-24,1985,0.012846694723360867
STAT,1809,68,na,1877,863.3189226032812
STAT,1881,92,na,1973,198.63184401113523
SIM,1921,28,15-19,1949,6
SIM,1871,30,20-24,1901,7
STAT,1886,29,na,1915,2884.3777554645812
STAT,1924,18,na,1942,5043.74680410552
SIM,1770,92,na,1862,4
STAT,1876,77,na,1953,1031.2015520981638
SIM,1834,40,45-49,1874,2
SIM,1895,15,30-34,1910,3
STAT,1853,12,na,1865,2859.1102729612053
STAT,1885,48,30-34,1933,0.11002728769370008
STAT,1999,16,45-49,2015,0.8519041709736259
SIM,1893,22,20-24,1915,192
STAT,1864,28,40-44,1892,3.075888217413333
STAT,1825,38,30-34,1863,8.594603694885445
STAT,1883,31,35-39,1914,11.48112026929375
STAT,1955,45,40-44,2000,0.25242193792468515
STAT,1865,20,50-100,1885,0.43601447473574345
SIM,1873,20,50-100,1893,1
SIM,1901,24,30-34,1925,40
STAT,1913,28,15-19,1941,0.8093464402286857
SIM,1952,27,30-34,1979,60
STAT,1788,68,na,1856,1057.1509588399997
STAT,1858,47,25-29,1905,0.05161471551986084
SIM,1901,27,na,1928,3938
SIM,1971,36,35-39,2007,11
SIM,1921,41,na,1962,5212
STAT,1930,21,30-34,1951,42.625225506322856
STAT,1986,25,15-19,2011,1.1668964065740057
SIM,1834,28,20-24,1862,20
STAT,1920,27,45-49,1947,2.1861519587867826
STAT,1972,13,na,1985,5803.270902487444
SIM,1960,18,25-29,1978,160
STAT,1939,17,na,1956,4253.6650465379
STAT,1773,102,na,1875,0.15565301733076004
SIM,1900,42,na,1942,3503
STAT,1951,28,35-39,1979,20.71143092044793
SIM,1960,39,40-44,1999,6
SIM,1854,27,na,1881,2901
SIM,1957,43,na,2000,6204
STAT,1850,22,40-44,1872,2.5747441138970935
SIM,1791,91,na,1882,16
SIM,1994,20,20-24,2014,173
STAT,1952,39,40-44,1991,2.128368011411039
SIM,1921,0,na,1921,5767
STAT,1862,45,25-29,1907,0.05665778442323523
STAT,1943,37,40-44,1980,1.887582457098471
STAT,1906,27,45-49,1933,1.8684969236338582
STAT,1969,32,20-24,2001,3.5843146780758866
STAT,1897,32,40-44,1929,6.69213389709372
STAT,1887,113,na,2000,0.0018807935263427645
SIM,1833,38,30-34,1871,12
STAT,1918,18,na,1936,4610.348601212642
STAT,1944,27,30-34,1971,48.87456019038745
STAT,1959,31,na,1990,5823.001539840254
STAT,1869,16,25-29,1885,6.458924746742769
SIM,1883,40,40-44,1923,4
SIM,1846,15,35-39,1861,1
SIM,1942,40,na,1982,4998
STAT,1875,40,40-44,1915,2.709543211854732
SIM,1916,26,na,1942,4662
STAT,1928,19,45-49,1947,0.7224889294588086
STAT,1844,43,15-19,1887,0.011679405661940423
STAT,1885,44,na,1929,2624.5778795495357
SIM,1951,37,40-44,1988,2
STAT,1926,28,25-29,1954,90.71874514310554
SIM,1839,44,45-49,1883,1
STAT,1830,49,45-49,1879,0.2121473918242901
SIM,1858,49,40-44,1907,1
STAT,1858,37,30-34,1895,4.798144255876375
STAT,1952,25,15-19,1977,0.9813851754082467
SIM,1934,23,30-34,1957,114
STAT,1957,24,20-24,1981,169.6338063209353
STAT,2004,6,na,2010,6932.8715556328425
STAT,1794,68,na,1862,941.704743270316
SIM,1929,22,45-49,1951,4
STAT,1884,37,25-29,1921,3.2829210451230373
STAT,1977,37,40-44,2014,2.404849600904797
SIM,1911,39,45-49,1950,1
SIM,1914,27,45-49,1941,3
STAT,1913,30,na,1943,4379.738758874989
STAT,1861,24,25-29,1885,55.6160269653233
STAT,1813,42,25-29,1855,2.4126793107636106
SIM,1926,37,30-34,1963,5
SIM,1889,29,15-19,1918,1
STAT,1904,31,30-34,1935,29.05282380335823
STAT,1826,28,20-24,1854,34.009960731476546
STAT,1837,49,na,1886,1648.3816252821914
SIM,1892,37,25-29,1929,10
SIM,1986,27,30-34,2013,8
STAT,1938,32,na,1970,4390.840761834859
STAT,1949,38,20-24,1987,0.364142319355038
STAT,1821,54,35-39,1875,0.014427058535881755
STAT,1912,22,25-29,1934,102.25752151378485
SIM,1829,34,25-29,1863,19
STAT,1903,39,45-49,1942,0.7001604061118902
STAT,1965,35,na,2000,5594.051991347545
STAT,1926,23,30-34,1949,40.16329828923049
STAT,1952,18,25-29,1970,59.912095467924935
STAT,1911,28,30-34,1939,43.98004971452517
SIM,1960,25,15-19,1985,2
SIM,1948,29,30-34,1977,44
STAT,1917,47,40-44,1964,0.19005304784197374
STAT,1850,90,na,1940,81.1621095296308
STAT,1978,27,30-34,2005,61.9780803529244
SIM,1860,27,na,1887,2564
SIM,1975,20,15-19,1995,13
SIM,1982,17,15-19,1999,79
STAT,1986,20,20-24,2006,183.5785929836344
STAT,1930,81,na,2011,2648.0426155829214
SIM,1936,40,na,1976,3944
STAT,1974,17,15-19,1991,68.38936080792286
SIM,1915,41,na,1956,4543
SIM,1837,20,25-29,1857,126
SIM,1963,43,na,2006,6463
STAT,1843,49,na,1892,2210.313629269787
STAT,1936,45,35-39,1981,0.1482578996301154
STAT,1918,37,30-34,1955,2.216487876728816
STAT,1836,52,20-24,1888,6.797369249178317E-4
STAT,1935,32,20-24,1967,3.896511541421647
SIM,1912,31,30-34,1943,3
STAT,1926,49,40-44,1975,0.223142997330173
STAT,1958,37,35-39,1995,3.777074630716865
STAT,1967,20,15-19,1987,7.7044021989447
SIM,1965,24,20-24,1989,173
SIM,1912,39,na,1951,3722
STAT,1911,38,35-39,1949,2.6849939873868345
SIM,1837,30,20-24,1867,1
STAT,1859,31,15-19,1890,0.13145105140586968
SIM,1881,50,35-39,1931,1
SIM,1926,24,30-34,1950,90
SIM,1818,36,25-29,1854,4
STAT,1981,18,20-24,1999,218.71013351496757
STAT,1883,40,na,1923,2635.934821025629
SIM,1915,49,25-29,1964,1
SIM,1931,17,20-24,1948,1
STAT,1868,26,15-19,1894,0.504777025090232
STAT,1902,43,35-39,1945,0.20356476108918234
SIM,1868,18,35-39,1886,2
STAT,1923,17,20-24,1940,183.65416502751333
STAT,1908,17,25-29,1925,9.713289390046619
SIM,1856,35,na,1891,2141
SIM,1961,8,na,1969,5671
STAT,1941,22,35-39,1963,11.232373103751748
STAT,1873,50,35-39,1923,0.010291486706388589
STAT,1944,16,na,1960,4572.73241668106
STAT,1877,8,na,1885,3198.5787812892354
STAT,1859,47,30-34,1906,0.08857382634467899
STAT,1894,24,20-24,1918,101.59438129411853
STAT,1912,17,45-49,1929,0.11668523166015586
SIM,1926,35,40-44,1961,4
STAT,1910,28,50-100,1938,1.1064627483692335
STAT,1936,17,30-34,1953,13.475167611278016
STAT,1866,84,na,1950,355.8371319947403
SIM,1988,5,na,1993,6636
SIM,1907,52,na,1959,4167
STAT,1930,32,30-34,1962,23.467838798626165
STAT,1868,34,20-24,1902,2.9714043586735026
STAT,1904,75,na,1979,2408.0645295640898
SIM,1890,32,50-100,1922,3
STAT,1845,23,na,1868,1775.8027292364297
STAT,1765,92,na,1857,0.9098903711919597
SIM,1828,39,50-100,1867,3
STAT,1824,32,40-44,1856,10.28166526862278
SIM,1864,30,na,1894,2726
SIM,1832,32,40-44,1864,1
STAT,1902,32,25-29,1934,16.701877545293268
STAT,1864,21,50-100,1885,0.43004917634500556
STAT,1970,18,45-49,1988,0.7214214740289492
SIM,1871,20,25-29,1891,51
STAT,1937,33,25-29,1970,10.552026055646753
STAT,1829,76,na,1905,694.0483260743596
STAT,1893,100,na,1993,27.704820261422444
STAT,1918,35,40-44,1953,1.8378246566747118
SIM,1944,17,30-34,1961,1
SIM,1961,44,50-100,2005,1
STAT,1876,20,35-39,1896,7.003141220069753
SIM,1826,30,45-49,1856,4
SIM,1929,77,na,2006,2703
STAT,1912,70,na,1982,3196.7517868694345
SIM,1937,25,45-49,1962,5
SIM,1977,32,20-24,2009,8
SIM,1945,23,50-100,1968,1
SIM,1848,20,25-29,1868,65
STAT,1915,59,na,1974,4018.0710781667613
SIM,1905,27,20-24,1932,40
STAT,1904,42,30-34,1946,0.13214173719140146
SIM,1945,33,25-29,1978,2
STAT,1918,24,30-34,1942,35.5418372158031
STAT,1851,44,50-100,1895,0.8264526845304215
SIM,1835,20,15-19,1855,7
STAT,1900,48,30-34,1948,0.08634056489387185
STAT,1960,33,25-29,1993,14.152068641719238
STAT,1807,103,na,1910,0.07017942067795498
STAT,1829,30,20-24,1859,3.7924659362047395
SIM,1878,22,na,1900,2604
STAT,1863,20,25-29,1883,59.77363280926451
SIM,1920,34,na,1954,4213
STAT,1907,49,25-29,1956,0.054307695218488355
SIM,1924,48,na,1972,4875
STAT,1915,43,45-49,1958,0.19309776442107734
SIM,1869,31,25-29,1900,18
STAT,1987,19,na,2006,6059.982393024495
STAT,1837,71,na,1908,966.5666615965007
STAT,1932,40,50-100,1972,0.1843060561664354
SIM,1953,21,na,1974,5655
STAT,1846,36,35-39,1882,7.71533477273014
SIM,1887,24,25-29,1911,10
STAT,1820,38,40-44,1858,6.298022570494127
STAT,1907,38,15-19,1945,0.02047817123173466
STAT,1865,30,30-34,1895,18.326170462612666
STAT,1915,32,35-39,1947,10.742725771747962
STAT,1943,49,35-39,1992,0.16317106564753872
STAT,1821,108,na,1929,0.0011202669254937736
SIM,1880,23,30-34,1903,34
SIM,1900,29,40-44,1929,2
SIM,1987,17,40-44,2004,2
SIM,1888,44,40-44,1932,9
SIM,1923,32,35-39,1955,17
STAT,1926,43,20-24,1969,0.02508057726245745
STAT,1879,24,25-29,1903,68.55020323715239
SIM,1942,59,na,2001,4561
STAT,1891,75,na,1966,1856.4416494974087
STAT,1968,28,30-34,1996,56.695187536988705
STAT,1890,10,na,1900,3652.671023515905
STAT,1947,40,30-34,1987,0.17319403128975783
STAT,1830,41,25-29,1871,0.6259705118920366
STAT,1895,47,40-44,1942,0.1443919515911443
STAT,1896,27,35-39,1923,14.70772751140117
STAT,1963,23,25-29,1986,135.8311537225215
STAT,1925,37,na,1962,5209.388397594343
SIM,1823,48,na,1871,2135
STAT,1914,16,40-44,1930,0.33488586806110593
SIM,1948,33,50-100,1981,5
STAT,1924,33,15-19,1957,0.17286384657147444
STAT,1807,89,na,1896,51.371593486240336
STAT,1850,53,na,1903,2180.980545683709
STAT,1810,53,na,1863,1515.4255663122863
STAT,1835,46,30-34,1881,0.06449549315652563
STAT,1944,28,45-49,1972,2.1539093497148527
STAT,1842,37,50-100,1879,1.108297095474997
STAT,1984,22,45-49,2006,1.8503230911168742
STAT,1969,46,35-39,2015,0.19381234121282737
STAT,1883,96,na,1979,77.17631353354123
STAT,1989,20,25-29,2009,153.2959053199303
SIM,1951,46,30-34,1997,1
STAT,1875,17,50-100,1892,0.058427490048229586
STAT,1944,17,35-39,1961,5.2115548017901
STAT,1899,71,na,1970,2555.293356961908
STAT,1853,109,na,1962,0.0028685316410635565
SIM,1922,16,40-44,1938,3
STAT,1891,46,15-19,1937,3.2273834334844233E-4
STAT,1885,37,30-34,1922,6.134926341925469
STAT,1952,33,20-24,1985,3.4363413212248344
SIM,1858,41,45-49,1899,2
STAT,1892,20,50-100,1912,0.5933613837925753
SIM,1959,15,25-29,1974,157
STAT,1939,49,15-19,1988,4.402042168333624E-4
STAT,1963,22,40-44,1985,4.946048904561067
STAT,1851,18,15-19,1869,5.688016414456968
SIM,1866,15,20-24,1881,39
SIM,1832,25,na,1857,2362
SIM,1836,39,na,1875,1662
STAT,1924,39,50-100,1963,0.5699774079899967
STAT,1882,15,na,1897,2860.128233199824
STAT,1920,25,25-29,1945,83.85523631190279
SIM,1844,24,50-100,1868,1
SIM,1858,30,35-39,1888,29
STAT,1928,46,35-39,1974,0.1903169368269391
STAT,1901,26,50-100,1927,1.0376002970813032
SIM,1910,0,na,1910,4362
STAT,1878,93,na,1971,152.97724446299384
STAT,1866,6,na,1872,3009.945235993831
SIM,1865,95,na,1960,42
SIM,1893,37,30-34,1930,16
SIM,1845,46,40-44,1891,1
SIM,1863,23,25-29,1886,1
SIM,1960,33,20-24,1993,5
STAT,1956,41,na,1997,5902.462537057909
SIM,1939,38,30-34,1977,7
STAT,1840,15,35-39,1855,0.5766804606812455
SIM,1828,46,35-39,1874,1
STAT,1973,32,40-44,2005,5.953684505965849
STAT,1869,33,na,1902,2655.7064870492177
SIM,1931,40,45-49,1971,1
STAT,1858,15,20-24,1873,18.86586034406634
SIM,1952,28,45-49,1980,11
SIM,1838,65,na,1903,1072
SIM,1902,35,25-29,1937,1
STAT,1933,28,15-19,1961,1.0817187152470948
STAT,1949,15,15-19,1964,60.94444040693366
SIM,1928,14,na,1942,6011
SIM,1941,39,25-29,1980,1
STAT,1839,40,30-34,1879,1.0833834800478224
SIM,1931,18,na,1949,6275
SIM,1981,32,40-44,2013,2
STAT,1821,96,na,1917,5.251528356231773
SIM,1955,40,30-34,1995,1
SIM,1878,37,35-39,1915,11
STAT,1899,115,na,2014,3.1570994660309485E-4
STAT,1933,39,25-29,1972,1.5450871383529319
SIM,1897,31,30-34,1928,50
STAT,1804,51,25-29,1855,0.016634756481446192
STAT,1889,31,30-34,1920,24.939159802293602
STAT,1960,30,45-49,1990,2.413637073966045
STAT,1848,49,20-24,1897,0.012484115740468127
STAT,1844,20,45-49,1864,0.7388036844623385
STAT,1875,45,na,1920,2709.8996503756907
SIM,1894,52,na,1946,3494
SIM,1957,15,15-19,1972,72
STAT,1884,19,50-100,1903,0.0555619941144865
SIM,1862,47,na,1909,2760
STAT,1923,40,45-49,1963,0.2250279676501453
SIM,1907,36,na,1943,4514
STAT,1855,23,25-29,1878,56.496827761416604
STAT,1934,43,25-29,1977,0.1145905098331541
STAT,1895,40,15-19,1935,0.02095433989725521
SIM,1962,38,45-49,2000,1
STAT,1837,46,40-44,1883,0.13034810811313108
SIM,1971,23,25-29,1994,1
SIM,1903,22,na,1925,3565
STAT,1816,66,na,1882,929.5314415141075
SIM,1935,23,15-19,1958,8
STAT,1945,40,20-24,1985,0.023201432651928856
STAT,1836,46,na,1882,2170.345562169135
SIM,1897,34,35-39,1931,23
SIM,1926,27,35-39,1953,34
SIM,1986,22,15-19,2008,9
SIM,1874,47,50-100,1921,1
SIM,1862,42,25-29,1904,1
STAT,1894,27,25-29,1921,62.75581622270676
SIM,1785,81,na,1866,263
STAT,1940,19,50-100,1959,0.4388490429791653
STAT,1911,35,30-34,1946,2.0525882177892245
STAT,1946,27,40-44,1973,5.991855236453818
STAT,1907,37,30-34,1944,1.9532525196550279
SIM,1954,27,40-44,1981,8
SIM,1777,86,na,1863,160
SIM,1915,31,na,1946,4661
STAT,1921,40,35-39,1961,0.2623715635594408
SIM,1811,63,na,1874,1401
STAT,1772,103,na,1875,0.006695983934721872
STAT,1917,40,15-19,1957,0.0018546791034207612
SIM,1965,28,30-34,1993,6
STAT,1941,36,25-29,1977,1.207191062962229
STAT,1853,29,35-39,1882,9.982377218139252
SIM,1953,59,na,2012,5287
STAT,1878,44,30-34,1922,1.3666001915000505
STAT,1909,19,50-100,1928,0.08442906798918895
SIM,1939,31,50-100,1970,1
STAT,1829,33,25-29,1862,12.809274965529301
STAT,1966,15,20-24,1981,195.52552355337312
SIM,1941,27,30-34,1968,84
SIM,1882,27,na,1909,3328
SIM,1920,18,na,1938,4555
STAT,1833,22,35-39,1855,6.308067584100366
STAT,1902,40,30-34,1942,0.1314952907909358
SIM,1831,47,50-100,1878,1
SIM,1886,44,30-34,1930,1
STAT,1930,35,35-39,1965,3.6477246859797616
SIM,1886,73,na,1959,952
STAT,1915,37,50-100,1952,0.48956390979102876
SIM,1930,25,35-39,1955,48
SIM,1907,27,30-34,1934,7
SIM,1921,30,35-39,1951,30
STAT,1978,22,15-19,2000,8.41155502666514
STAT,1862,52,25-29,1914,0.0034313167278163066
STAT,1971,32,30-34,2003,23.47375230694658
STAT,1958,48,50-100,2006,0.35560245796432866
SIM,1790,68,na,1858,487
SIM,1931,75,na,2006,3739
STAT,1949,47,na,1996,5128.83517248248
STAT,1901,28,25-29,1929,68.13882074180327
SIM,1824,73,na,1897,401
STAT,1894,16,15-19,1910,8.82576184634129
SIM,1915,37,30-34,1952,4
STAT,1813,54,30-34,1867,0.018160489549806903
SIM,1980,17,40-44,1997,3
STAT,1952,43,50-100,1995,0.1685788387549618
STAT,1781,79,na,1860,202.15523049121154
SIM,1902,21,na,1923,3707
STAT,1878,10,na,1888,3150.7975471815753
SIM,1850,39,30-34,1889,2
SIM,1977,15,na,1992,5801
STAT,1868,37,25-29,1905,3.1923606170521266
STAT,1965,20,50-100,1985,0.9518031241106132
SIM,1944,44,na,1988,4544
STAT,1842,39,30-34,1881,4.288089316817184
STAT,1968,18,35-39,1986,6.046445709402016
STAT,1833,97,na,1930,3.7803056037421223
SIM,1849,65,na,1914,1995
SIM,1962,36,35-39,1998,8
STAT,1808,53,50-100,1861,0.07055527850373888
STAT,1933,27,30-34,1960,60.067579953696054
SIM,1899,83,na,1982,1216
SIM,1973,20,50-100,1993,1
SIM,1988,21,40-44,2009,5
STAT,1954,36,35-39,1990,3.558358339553376
STAT,1823,47,50-100,1870,0.24266670519178166
STAT,1822,32,30-34,1854,75.49577906357611
SIM,1876,37,25-29,1913,1
STAT,1842,28,20-24,1870,11.083878650614569
STAT,1913,30,35-39,1943,10.582527613056751
SIM,1860,41,50-100,1901,2
SIM,1850,28,20-24,1878,11
SIM,1990,22,35-39,2012,18
SIM,1909,97,na,2006,117
STAT,1933,32,na,1965,5884.558352847285
SIM,1830,32,30-34,1862,5
SIM,1875,73,na,1948,1446
STAT,1946,1,na,1947,5276.535296495682
STAT,1957,28,30-34,1985,59.84785758220247
STAT,1831,31,na,1862,2225.2265038510227
STAT,1980,28,45-49,2008,2.7784077702263557
SIM,1994,19,50-100,2013,1
STAT,1937,30,20-24,1967,2.7895951569581183
SIM,1837,33,25-29,1870,24
STAT,1943,30,15-19,1973,0.16049743959219334
SIM,1847,41,50-100,1888,4
STAT,1835,45,na,1880,1516.2734999347333
STAT,1918,38,45-49,1956,0.8282225292465429
SIM,1842,86,na,1928,264
STAT,1943,46,30-34,1989,0.11376847244680068
SIM,1837,22,15-19,1859,2
SIM,1926,38,45-49,1964,1
SIM,1835,39,35-39,1874,6
STAT,1827,39,35-39,1866,9.796227199153597
SIM,1967,22,20-24,1989,299
SIM,1928,37,40-44,1965,4
STAT,1891,20,30-34,1911,25.557569811096045
STAT,1852,42,15-19,1894,0.013004062981501295
SIM,1904,46,45-49,1950,1
STAT,1918,27,35-39,1945,18.435135662662663
STAT,1904,45,35-39,1949,0.1321781006181428
SIM,1918,17,35-39,1935,11
SIM,1945,30,20-24,1975,4
SIM,1854,36,35-39,1890,3
STAT,1982,22,35-39,2004,15.341253637606943
STAT,1959,22,20-24,1981,168.41154511097133
SIM,1830,42,na,1872,1867
STAT,1806,88,na,1894,47.1185717014288
SIM,1809,49,50-100,1858,1
SIM,1971,20,20-24,1991,12
STAT,1891,91,na,1982,380.3249034763817
SIM,1863,48,na,1911,2223
SIM,1948,25,20-24,1973,18
STAT,1816,49,30-34,1865,0.19155380291173307
STAT,1812,51,50-100,1863,0.034133000194079825
SIM,1943,20,15-19,1963,8
SIM,1877,104,na,1981,30
STAT,1905,21,40-44,1926,3.4911407513269292
STAT,1944,25,40-44,1969,5.819033783518769
STAT,1847,15,45-49,1862,0.06347835512551782
STAT,1802,74,na,1876,628.8823802731797
SIM,1912,45,35-39,1957,1
STAT,1876,31,45-49,1907,2.088844597735134
STAT,1965,38,20-24,2003,0.39089046750751044
SIM,1895,21,25-29,1916,3
STAT,1887,21,25-29,1908,74.26059131698624
SIM,1884,31,45-49,1915,2
STAT,1976,16,50-100,1992,0.5778065887626507
STAT,1795,87,na,1882,51.11949049932841
STAT,1855,20,20-24,1875,69.49735541463812
STAT,1929,25,45-49,1954,2.504807512179679
SIM,1889,35,45-49,1924,6
SIM,1909,21,20-24,1930,256
STAT,1909,30,15-19,1939,0.1428159695808898
STAT,1909,49,35-39,1958,0.13607373440976864
SIM,1918,36,na,1954,3833
SIM,1935,48,na,1983,6144
STAT,1972,17,40-44,1989,2.0667510710835177
SIM,1950,54,na,2004,4543
STAT,1911,29,na,1940,4189.518929144135
STAT,1968,29,45-49,1997,2.498490601161852
STAT,1886,17,25-29,1903,6.898171711343735
SIM,1835,73,na,1908,1130
STAT,1929,48,50-100,1977,0.3374055299740631
SIM,1840,20,na,1860,2015
STAT,1886,45,na,1931,2766.06048061997
STAT,1811,44,25-29,1855,2.1187980881590858
STAT,1849,111,na,1960,1.5951110339432678E-4
STAT,1816,38,20-24,1854,2.8126119750005616
STAT,1831,28,45-49,1859,1.1491390261067171
SIM,1911,57,na,1968,4343
SIM,1824,49,30-34,1873,1
STAT,1896,24,30-34,1920,26.981045520667315
SIM,1905,19,15-19,1924,16
SIM,1978,23,25-29,2001,163
STAT,1861,36,30-34,1897,5.137845703950179
SIM,1824,38,20-24,1862,4
STAT,1881,14,na,1895,2865.3596744683136
SIM,1952,25,40-44,1977,1
STAT,1967,4,na,1971,5669.149642889141
SIM,1946,17,40-44,1963,2
STAT,1908,25,na,1933,4118.471272000278
SIM,1918,93,na,2011,648
STAT,1923,54,na,1977,4828.534776008329
STAT,1874,20,25-29,1894,68.03620471504992
SIM,1971,25,45-49,1996,5
SIM,1894,17,25-29,1911,1
STAT,1907,40,na,1947,3977.7154536086996
SIM,1863,20,20-24,1883,152
SIM,1841,22,35-39,1863,12
STAT,1765,107,na,1872,6.812311491642069E-4
STAT,1976,39,35-39,2015,3.833847177944254
STAT,1901,17,15-19,1918,9.59309888733367
STAT,1970,15,40-44,1985,2.0216985779273684
SIM,1809,49,35-39,1858,1
STAT,1926,59,na,1985,4918.233690235274
STAT,1895,31,25-29,1926,15.44923641568078
SIM,1873,90,na,1963,194
STAT,1902,6,na,1908,4259.782992391019
STAT,1976,28,25-29,2004,101.87144820604613
STAT,1837,28,na,1865,1996.1326248026035
STAT,1988,7,na,1995,6487.659336158718
SIM,1873,30,30-34,1903,6
SIM,1878,34,30-34,1912,47
STAT,1962,46,25-29,2008,0.08178927106869513
STAT,1963,25,45-49,1988,2.546119767440081
STAT,1955,16,na,1971,5640.548832983825
STAT,1899,55,na,1954,3269.2007851480894
STAT,1923,9,na,1932,5392.598673679655
STAT,1938,17,40-44,1955,1.5930784602731745
STAT,1858,108,na,1966,0.013772960625273297
STAT,1889,34,35-39,1923,14.283110595695307
STAT,1963,20,20-24,1983,163.68097847427464
SIM,1984,28,25-29,2012,225
STAT,1800,54,20-24,1854,0.0028037671233077815
STAT,1854,83,na,1937,323.4241072552481
SIM,1889,24,35-39,1913,16
SIM,1923,46,25-29,1969,1
STAT,1872,26,35-39,1898,11.219570501165677
STAT,1941,33,45-49,1974,1.9059275849937642
STAT,1960,44,25-29,2004,0.11117384264046029
SIM,1858,61,na,1919,2232
SIM,1924,34,50-100,1958,3
SIM,1871,36,40-44,1907,1
STAT,1952,11,na,1963,5433.325584247982
STAT,1856,43,40-44,1899,1.9660675163505545
STAT,1915,46,25-29,1961,0.06185031164498699
STAT,1955,15,45-49,1970,0.7657089512795154
STAT,1815,84,na,1899,184.5886969765503
SIM,1853,30,na,1883,2311
SIM,1890,2,na,1892,3884
SIM,1958,36,na,1994,6165
STAT,1842,58,na,1900,1521.811167263141
SIM,1861,65,na,1926,1341
STAT,1876,46,na,1922,2691.6328783044523
STAT,1849,17,45-49,1866,0.062320765594793374
STAT,1937,24,35-39,1961,10.58028615076966
STAT,1833,45,15-19,1878,3.4060671459234024E-4
SIM,1934,9,na,1943,6025
SIM,1867,37,50-100,1904,4
STAT,1994,13,na,2007,6540.605500626449
STAT,1945,28,50-100,1973,1.2596149566268673
STAT,1970,16,25-29,1986,62.62089242771858
SIM,1834,51,na,1885,1682
STAT,1937,35,45-49,1972,0.7884887083133181
STAT,1945,43,25-29,1988,0.09340698430859085
STAT,1897,40,25-29,1937,0.06950684932653413
SIM,1847,43,35-39,1890,7
STAT,1838,26,35-39,1864,10.71067794074439
SIM,1970,31,na,2001,5978
STAT,1932,43,15-19,1975,0.0023987646704658285
SIM,1971,18,na,1989,5408
STAT,1864,17,40-44,1881,0.19496898272982696
STAT,1887,9,na,1896,3355.698693033581
STAT,1840,48,na,1888,1796.8537882076157
STAT,1865,83,na,1948,413.3651188243509
SIM,1927,13,na,1940,5252
STAT,1952,24,30-34,1976,39.85251785173958
STAT,1827,66,na,1893,1331.0735598197896
STAT,1857,109,na,1966,0.005205166516128067
SIM,1978,4,na,1982,6040
STAT,1900,29,na,1929,3794.3582964650373
STAT,1926,34,30-34,1960,21.952551379627003
SIM,1906,51,na,1957,3400
SIM,1861,26,30-34,1887,26
STAT,1902,42,20-24,1944,0.017960919297671827
STAT,1931,26,15-19,1957,1.0525212944061264
SIM,1920,15,25-29,1935,80
STAT,1912,15,25-29,1927,10.16947624937594
STAT,1839,43,35-39,1882,1.4942825358556007
STAT,1853,26,30-34,1879,29.25434922960023
SIM,1873,47,na,1920,3163
SIM,1844,17,35-39,1861,2
STAT,1832,42,40-44,1874,1.9113444291363964
STAT,1966,42,45-49,2008,0.24930836329318704
STAT,1824,48,20-24,1872,0.016086343699553786
STAT,1863,45,30-34,1908,0.09865570999235589
STAT,1987,26,35-39,2013,24.85290464225034
SIM,1827,78,na,1905,303
SIM,1934,34,30-34,1968,61
SIM,1955,41,45-49,1996,2
SIM,1976,15,30-34,1991,27
STAT,1827,36,30-34,1863,8.008586198371445
STAT,1830,92,na,1922,26.127380057700442
SIM,1922,19,45-49,1941,1
SIM,1846,26,35-39,1872,12
SIM,1898,9,na,1907,4203
SIM,1902,33,35-39,1935,12
STAT,1854,28,50-100,1882,0.5424180942106357
STAT,1883,29,15-19,1912,0.5086107336161381
SIM,1837,21,30-34,1858,40
STAT,1879,94,na,1973,125.49256211499294
SIM,1917,14,na,1931,5775
STAT,1882,32,50-100,1914,1.0328057315192518
STAT,1852,47,20-24,1899,0.011261016279824749
SIM,1902,77,na,1979,2205
STAT,1918,24,na,1942,4515.865294770828
SIM,1884,20,35-39,1904,3
STAT,1854,43,30-34,1897,0.9298652260739838
STAT,1909,50,na,1959,3865.0627116882793
STAT,1939,70,na,2009,3461.373031862017
STAT,1835,30,15-19,1865,0.11562121597587723
STAT,1917,20,50-100,1937,0.8118926059987853
STAT,1968,15,30-34,1983,17.578422920709134
STAT,1852,3,na,1855,3221.7110000000002
STAT,1991,15,45-49,2006,0.8266202811238105
STAT,1887,34,25-29,1921,13.133580404330061
SIM,1859,22,20-24,1881,136
SIM,1935,64,na,1999,5101
SIM,1895,34,25-29,1929,20
SIM,1847,39,na,1886,2516
SIM,1848,22,45-49,1870,3
STAT,1822,97,na,1919,4.413977657086386
STAT,1875,50,45-49,1925,0.017556153652442306
STAT,1918,33,20-24,1951,2.9779697099203855
STAT,1900,39,40-44,1939,1.4978057194284542
SIM,1945,24,35-39,1969,30
STAT,1841,47,45-49,1888,0.2107764970854362
SIM,1910,72,na,1982,2108
SIM,1926,33,20-24,1959,5
STAT,1855,84,na,1939,283.06162744525255
STAT,1835,49,35-39,1884,0.08976092946712272
STAT,1865,33,35-39,1898,10.500369620101626
STAT,1836,23,20-24,1859,82.20374784811132
SIM,1943,21,20-24,1964,160
STAT,1885,42,50-100,1927,1.2145943432703532
SIM,1805,78,na,1883,358
SIM,1947,47,25-29,1994,1
SIM,1849,28,50-100,1877,6
STAT,1843,59,na,1902,1950.0349343633986
SIM,1933,19,20-24,1952,361
STAT,1850,49,30-34,1899,0.0975697529195442
STAT,1852,30,50-100,1882,0.9131809658112515
SIM,1822,63,na,1885,1103
STAT,1901,19,35-39,1920,0.8822221725216308
STAT,1968,26,40-44,1994,6.750567463607865
STAT,1850,38,20-24,1888,0.7977864435611223
SIM,1918,25,40-44,1943,1
STAT,1962,29,na,1991,5557.787153530527
SIM,1937,23,25-29,1960,212
STAT,1831,25,40-44,1856,3.1680939302070854
STAT,1952,52,na,2004,5195.818679097346
SIM,1801,64,na,1865,1246
STAT,1900,32,15-19,1932,0.22804533503774563
SIM,1919,34,35-39,1953,2
SIM,1891,29,15-19,1920,2
SIM,1835,36,30-34,1871,12
SIM,1895,31,20-24,1926,5
SIM,1844,23,20-24,1867,76
STAT,1939,47,25-29,1986,0.06376320228529878
SIM,1831,86,na,1917,148
SIM,1969,36,35-39,2005,11
STAT,1818,41,50-100,1859,1.4515387017376127
SIM,1952,23,20-24,1975,1
SIM,1871,43,na,1914,1990
SIM,1875,57,na,1932,2543
STAT,1920,23,35-39,1943,12.037925848586058
SIM,1864,43,40-44,1907,3
STAT,1929,23,25-29,1952,134.39243960242914
STAT,1935,21,20-24,1956,174.8973302197394
SIM,1928,36,35-39,1964,9
STAT,1902,48,40-44,1950,0.15549283682347584
STAT,1979,16,45-49,1995,0.7939839646428444
SIM,1920,1,na,1921,4818
STAT,1861,20,15-19,1881,3.2988393833516105
STAT,1967,31,15-19,1998,0.1889373065887749
STAT,1925,19,20-24,1944,187.92949968417628
SIM,1871,37,50-100,1908,3
SIM,1918,18,40-44,1936,4
SIM,1871,39,45-49,1910,7
STAT,1922,36,45-49,1958,0.8956287491047304
STAT,1941,30,40-44,1971,4.74816131555324
SIM,1907,29,20-24,1936,25
SIM,1890,33,40-44,1923,8
SIM,1840,42,40-44,1882,4
SIM,1895,37,40-44,1932,12
SIM,1869,41,20-24,1910,1
SIM,1849,81,na,1930,884
STAT,1909,46,30-34,1955,0.09487528222295805
SIM,1946,48,na,1994,4550
STAT,1887,37,40-44,1924,5.661525128614608
STAT,1944,23,20-24,1967,138.5128864055068
STAT,1922,25,35-39,1947,19.730235372248732
STAT,1882,33,40-44,1915,4.867782792914871
SIM,1888,83,na,1971,518
SIM,1897,57,na,1954,3031
SIM,1930,36,45-49,1966,3
STAT,1893,46,25-29,1939,0.04753007549180826
STAT,1806,52,40-44,1858,0.03705722967136231
STAT,1901,25,20-24,1926,19.09234440096322
STAT,1845,52,50-100,1897,0.010122884144132132
STAT,1976,36,30-34,2012,2.897675144858113
STAT,1857,46,15-19,1903,3.605447237078603E-4
STAT,1986,18,na,2004,6050.67706027133
STAT,1866,68,na,1934,1634.654643965666
STAT,1916,20,na,1936,4442.860762525917
SIM,1868,17,20-24,1885,24
SIM,1877,6,na,1883,3558
SIM,1803,68,na,1871,1028
STAT,1833,41,na,1874,1815.47709094428
STAT,1852,49,40-44,1901,0.1580395489239716
SIM,1960,53,na,2013,5945
SIM,1984,25,20-24,2009,3
SIM,1925,49,na,1974,5206
SIM,1868,4,na,1872,3491
SIM,1917,46,30-34,1963,1
STAT,1974,22,50-100,1996,0.9948283272178262
STAT,1973,30,na,2003,5760.4725756836515
STAT,1815,54,40-44,1869,0.019849221996160772
STAT,1976,25,20-24,2001,28.29017908564162
STAT,1952,20,45-49,1972,1.5622997445120599
STAT,1885,105,na,1990,1.4260200123084494
SIM,1816,78,na,1894,546
STAT,1841,44,40-44,1885,2.0254813832652827
SIM,1842,30,na,1872,2407
STAT,1860,46,50-100,1906,0.22908325323461312
SIM,1934,30,45-49,1964,1
SIM,1852,48,na,1900,1814
SIM,1862,43,30-34,1905,1
STAT,1902,34,15-19,1936,0.13219567318474196
STAT,1838,23,30-34,1861,19.87780400602428
STAT,1843,40,na,1883,2449.7006475182848
STAT,1915,40,40-44,1955,0.29146950479774103
SIM,1882,39,20-24,1921,1
SIM,1870,98,na,1968,138
SIM,1896,35,na,1931,3790
STAT,1968,41,50-100,2009,0.17623472018309028
STAT,1960,35,15-19,1995,0.02978867926118044
SIM,1857,24,45-49,1881,1
SIM,1885,72,na,1957,1908
STAT,1925,30,50-100,1955,1.1339755256914228
STAT,1937,21,30-34,1958,32.32802137922061
SIM,1868,15,30-34,1883,6
SIM,1945,32,40-44,1977,11
STAT,1987,23,30-34,2010,47.49195215747117
SIM,1841,85,na,1926,149
STAT,1863,48,35-39,1911,0.13950029221996324
STAT,1945,41,35-39,1986,0.26419491873510664
STAT,1874,39,20-24,1913,0.9015513237240542
STAT,1902,45,25-29,1947,0.0535092537477529
STAT,1937,47,15-19,1984,4.2941655879947616E-4
STAT,1802,54,30-34,1856,0.022758237198292234
STAT,1926,30,45-49,1956,2.197866477460983
STAT,1963,52,na,2015,5508.368316631673
SIM,1873,33,35-39,1906,2
STAT,1863,39,45-49,1902,1.9914013524022243
SIM,1900,24,50-100,1924,1
STAT,1868,32,na,1900,2645.8644376075667
SIM,1825,74,na,1899,733
STAT,1806,67,na,1873,767.9958522308447
SIM,1893,21,15-19,1914,2
STAT,1885,21,15-19,1906,3.809002207204351
STAT,1849,24,45-49,1873,0.6440968222232403
SIM,1979,3,na,1982,6478
STAT,1960,30,20-24,1990,3.7413234136919615
STAT,1841,92,na,1933,37.03008371245669
STAT,1853,58,na,1911,1968.9336070382478
STAT,1888,18,40-44,1906,0.24747156409610815
STAT,1844,84,na,1928,278.247019229218
STAT,1886,104,na,1990,2.824868568247692
SIM,1839,66,na,1905,1482
STAT,1857,39,15-19,1896,0.04996433826081204
SIM,1963,27,50-100,1990,8
STAT,1862,16,25-29,1878,6.3583772535881495
STAT,1916,23,15-19,1939,6.4180026281567075
STAT,1958,41,45-49,1999,0.26253922347764624
STAT,1887,31,20-24,1918,3.5102146538793524
STAT,1955,27,50-100,1982,1.5314792965317126
SIM,1937,38,20-24,1975,2
SIM,1913,21,na,1934,4948
STAT,1993,4,na,1997,6529.701726850908
STAT,1915,75,na,1990,2833.267890804327
SIM,1819,40,25-29,1859,1
STAT,1806,104,na,1910,0.022892835608045947
STAT,1948,22,45-49,1970,1.4908937859053926
SIM,1849,19,15-19,1868,11
STAT,1832,45,45-49,1877,0.1987563310776561
STAT,1863,36,40-44,1899,4.4386436729706364
STAT,1907,24,na,1931,3990.6531098033824
SIM,1837,48,50-100,1885,1
SIM,1846,23,30-34,1869,46
STAT,1831,41,50-100,1872,1.0255627751612446
STAT,1921,28,na,1949,4799.524059153398
SIM,1924,23,15-19,1947,14
STAT,1876,83,na,1959,619.1054313905661
STAT,1888,71,na,1959,1952.416717034288
STAT,1929,38,20-24,1967,0.3901885875889599
STAT,1937,32,40-44,1969,4.47049730160663
SIM,1863,69,na,1932,1695
STAT,1962,44,35-39,2006,0.30840925405424696
STAT,1898,21,25-29,1919,89.55441302420837
SIM,1982,28,15-19,2010,1
STAT,1934,45,15-19,1979,5.953706937604894E-4
STAT,1907,32,50-100,1939,0.8933184536300327
STAT,1907,46,20-24,1953,0.011526222435526829
SIM,1935,8,na,1943,6502
SIM,1915,32,50-100,1947,2
STAT,1821,53,50-100,1874,0.02581718702601394
STAT,1897,45,na,1942,3507.0697353036917
STAT,1880,33,30-34,1913,21.26731788962454
STAT,1878,27,50-100,1905,0.7708009000111852
SIM,1895,3,na,1898,4119
STAT,1856,5,na,1861,2617.832215581865
STAT,1974,28,15-19,2002,1.0679050828796546
STAT,1941,45,15-19,1986,4.577167073228539E-4
STAT,1913,8,na,1921,4693.135972672857
STAT,1864,58,na,1922,2037.798667523533
STAT,1933,36,20-24,1969,0.41492705039429867
SIM,1866,18,25-29,1884,12
STAT,1847,46,50-100,1893,0.18951453211657446
SIM,1845,30,25-29,1875,26
STAT,1935,24,25-29,1959,145.1405289655298
SIM,1918,27,30-34,1945,112
STAT,1891,23,35-39,1914,8.297532461409112
STAT,1985,15,15-19,2000,74.53117120987575
SIM,1948,28,25-29,1976,160
STAT,1786,70,na,1856,1090.5639830000002
STAT,1936,78,na,2014,2416.091880180963
SIM,1972,41,na,2013,5719
STAT,1887,23,15-19,1910,4.253519583633577
STAT,1804,108,na,1912,7.964315740701053E-4
STAT,1954,15,na,1969,5253.999104193207
STAT,1905,36,15-19,1941,0.020342530348508758
SIM,1943,24,25-29,1967,167
STAT,1921,50,na,1971,4734.68185768211
SIM,1895,36,50-100,1931,3
STAT,1887,36,50-100,1923,1.5955104658696524
STAT,1933,16,na,1949,5702.741348646712
SIM,1870,16,25-29,1886,12
STAT,1906,35,50-100,1941,0.4501918932378507
STAT,1914,19,45-49,1933,0.11866921165688776
STAT,1924,34,20-24,1958,3.278952982950943
STAT,1918,36,25-29,1954,1.2031761982932785
SIM,1933,79,na,2012,3349
SIM,1858,39,na,1897,2500
STAT,1955,28,20-24,1983,28.07263488722228
SIM,1969,33,30-34,2002,51
STAT,1980,25,40-44,2005,7.506188076800256
STAT,1811,97,na,1908,2.7661330450409265
STAT,1957,3,na,1960,5985.433334627493
STAT,1947,43,35-39,1990,0.27160866547990464
SIM,1862,28,50-100,1890,1
SIM,1963,28,20-24,1991,4
SIM,1920,17,45-49,1937,1
SIM,1928,33,30-34,1961,38
SIM,1845,49,45-49,1894,1
STAT,1829,92,na,1921,30.51149930518052
SIM,1844,15,15-19,1859,13
SIM,1898,82,na,1980,1343
STAT,1889,93,na,1982,242.09296150555178
SIM,1936,49,na,1985,3885
SIM,1869,44,25-29,1913,1
SIM,1904,87,na,1991,1014
STAT,1848,43,50-100,1891,1.1144006439179004
SIM,1844,26,25-29,1870,98
STAT,1913,32,25-29,1945,10.6179139290251
STAT,1833,103,na,1936,0.10098774555785445
SIM,1921,32,25-29,1953,5
SIM,1914,35,50-100,1949,1
STAT,1832,96,na,1928,5.850006799138888
STAT,1837,49,45-49,1886,0.17291027293959063
STAT,1868,94,na,1962,52.8353200281788
STAT,1840,17,50-100,1857,0.05088455942146421
STAT,1903,29,40-44,1932,4.888846618875463
STAT,1934,40,20-24,1974,0.02846322484473564
SIM,1929,38,50-100,1967,1
STAT,1858,18,25-29,1876,5.924334656646624
SIM,1988,23,30-34,2011,111
STAT,1944,26,25-29,1970,82.13812853166355
SIM,1986,21,30-34,2007,102
SIM,1919,31,30-34,1950,26
STAT,1837,30,25-29,1867,9.494449216924652
SIM,1856,43,50-100,1899,1
SIM,1886,57,na,1943,1658
SIM,1985,17,50-100,2002,3
STAT,1950,24,20-24,1974,152.12794616154667
SIM,1802,86,na,1888,64
SIM,1911,29,40-44,1940,12
STAT,1901,16,30-34,1917,2.582790280594013
STAT,1861,43,50-100,1904,1.0062457861162348
SIM,1908,9,na,1917,4371
SIM,1775,82,na,1857,10
STAT,1966,18,25-29,1984,62.4444571908971
STAT,1836,26,25-29,1862,50.19236587941278
SIM,1974,18,25-29,1992,1
STAT,1965,34,20-24,1999,3.5775365354443367
STAT,1830,30,na,1860,1785.5358796133598
SIM,1919,42,40-44,1961,3
STAT,1828,53,30-34,1881,0.004723260982192173
SIM,1952,26,25-29,1978,1
STAT,1868,33,15-19,1901,0.1572306929551523
STAT,1940,64,na,2004,3966.5830340049
SIM,1892,30,35-39,1922,2
SIM,1862,34,40-44,1896,9
STAT,1913,49,na,1962,4116.079893721722
STAT,1879,17,25-29,1896,6.8285147674074835
STAT,1980,34,30-34,2014,25.695644571730853
STAT,1814,46,na,1860,1940.717176957318
STAT,1921,42,25-29,1963,0.09278555835830696
SIM,1970,41,30-34,2011,1
STAT,1971,24,35-39,1995,13.79900959143089
STAT,1940,16,45-49,1956,0.5856882857231477
SIM,1885,15,25-29,1900,13
STAT,1884,30,35-39,1914,11.639910369655452
STAT,1900,47,25-29,1947,0.0517873953275357
STAT,1921,44,na,1965,4809.627740569121
SIM,1901,76,na,1977,2270
SIM,1863,85,na,1948,81
STAT,1822,47,40-44,1869,0.32358472528844195
SIM,1888,21,na,1909,2861
SIM,1874,17,15-19,1891,12
SIM,1937,15,40-44,1952,3
SIM,1878,38,40-44,1916,2
STAT,1908,62,na,1970,3494.6754411972965
STAT,1956,47,45-49,2003,0.34521855239521815
STAT,1834,60,na,1894,1740.4932986702997
SIM,1871,27,na,1898,2204
SIM,1869,88,na,1957,89
SIM,1909,39,35-39,1948,6
STAT,1822,107,na,1929,0.003874753490559721
STAT,1805,85,na,1890,112.65492416203293
STAT,1927,47,na,1974,5320.76156127094
SIM,1913,29,15-19,1942,1
STAT,1854,34,40-44,1888,3.543753563813638
STAT,1951,16,20-24,1967,186.36512765551362
STAT,1872,27,40-44,1899,3.471266057786916
STAT,1913,23,35-39,1936,10.944792755030821
SIM,1964,47,45-49,2011,1
STAT,1804,52,30-34,1856,0.02739922982112789
STAT,1817,88,na,1905,94.91239888235694
STAT,1864,53,40-44,1917,0.010673949425148937
STAT,1909,34,25-29,1943,10.102818399706646
STAT,1946,34,40-44,1980,5.0992126960745985
STAT,1870,27,na,1897,2715.2052137821233
STAT,1826,65,na,1891,930.5027444814892
STAT,1861,35,25-29,1896,2.7885566818554675
STAT,1962,41,30-34,2003,0.1967430434538225
STAT,1920,20,30-34,1940,37.0785087840184
STAT,1872,39,50-100,1911,1.40839206985532
STAT,1843,40,15-19,1883,0.014637143705678913
STAT,1927,29,35-39,1956,20.97439196009654
SIM,1938,59,na,1997,3855
STAT,1856,40,25-29,1896,0.5710916529735476
STAT,1902,71,na,1973,2692.7565745188595
STAT,1939,44,20-24,1983,0.021139364013818038
STAT,1877,51,25-29,1928,0.004272335552915714
STAT,1878,40,20-24,1918,0.19329356383267712
SIM,1917,34,25-29,1951,25
STAT,1899,15,45-49,1914,0.1037593327656726
STAT,1887,103,na,1990,5.361496464911013
STAT,1859,46,25-29,1905,0.05310229138212708
STAT,1825,83,na,1908,280.8001213346849
STAT,1867,40,45-49,1907,1.6288843152196635
SIM,1935,29,35-39,1964,46
SIM,1845,21,50-100,1866,3
SIM,1941,17,na,1958,3474
SIM,2007,3,na,2010,6953
STAT,1872,26,50-100,1898,0.7438208186283488
STAT,1930,42,35-39,1972,0.3058014801789925
STAT,1825,35,15-19,1860,0.09830399459339421
STAT,1922,48,15-19,1970,4.868089815419779E-4
STAT,1945,34,35-39,1979,11.727843146613875
STAT,1848,21,35-39,1869,7.604170094110017
SIM,1953,34,35-39,1987,5
SIM,1965,47,na,2012,5479
STAT,1840,16,40-44,1856,0.19109461532009467
STAT,1950,23,50-100,1973,0.9005339115548174
SIM,1856,21,35-39,1877,8
SIM,1954,34,40-44,1988,18
SIM,1875,40,45-49,1915,3
SIM,1913,83,na,1996,2345
SIM,1890,65,na,1955,2306
SIM,1905,32,na,1937,4228
STAT,1870,22,15-19,1892,3.7533794324168026
SIM,1922,26,45-49,1948,5
STAT,1890,43,40-44,1933,3.1488372892177536
STAT,1946,36,na,1982,4965.737206418305
STAT,1953,19,35-39,1972,5.854126594297128
STAT,1835,45,25-29,1880,0.04271691046360231
STAT,1990,20,40-44,2010,5.579211141825217
STAT,1871,52,na,1923,2458.948291794932
STAT,1871,49,45-49,1920,0.26530042947438665
STAT,2014,0,na,2014,7331.318025440385
STAT,1820,48,45-49,1868,0.23767798782242341
STAT,1972,24,40-44,1996,4.981270779135437
STAT,1835,27,50-100,1862,0.5215965618120731
STAT,1973,42,45-49,2015,0.2581499770063783
SIM,1892,42,na,1934,3681
STAT,1994,16,30-34,2010,20.30423725288857
STAT,1860,19,30-34,1879,1.6896833881225661
STAT,1900,20,45-49,1920,1.123322478179385
SIM,1942,32,50-100,1974,2
STAT,1933,20,40-44,1953,5.180053558150524
STAT,1870,38,30-34,1908,6.0335141489349375
STAT,1957,37,20-24,1994,0.41323142928996076
STAT,1839,50,35-39,1889,0.006997296060089858
SIM,1812,85,na,1897,59
STAT,1964,42,35-39,2006,0.30417380685311174
STAT,1919,44,35-39,1963,0.25093576219639
SIM,1948,53,na,2001,4262
SIM,1896,72,na,1968,2548
SIM,1821,62,na,1883,983
STAT,1841,30,na,1871,2386.9437032398546
STAT,1876,36,15-19,1912,0.06731363706045033
STAT,1885,16,50-100,1901,0.05653351238254225
STAT,1903,25,30-34,1928,41.67425938130172
STAT,1950,27,25-29,1977,90.20283333437993
STAT,1960,41,na,2001,5809.7085771401225
STAT,1928,80,na,2008,2751.5962931214144
SIM,1880,22,25-29,1902,8
STAT,1843,34,50-100,1877,1.082511179218776
STAT,1978,36,40-44,2014,2.4312348826128627
SIM,1836,44,40-44,1880,4
STAT,1840,52,40-44,1892,0.008400337822000213
STAT,1889,41,35-39,1930,2.5876638622854102
STAT,1827,29,30-34,1856,55.59323975461214
SIM,1868,23,na,1891,2997
SIM,1835,29,30-34,1864,45
SIM,1789,74,na,1863,773
SIM,1876,58,na,1934,2396
STAT,1967,47,20-24,2014,0.016570590415952418
STAT,1928,44,45-49,1972,0.24403187389495956
SIM,1967,21,15-19,1988,7
STAT,1868,88,na,1956,170.1090695087117
STAT,1943,31,20-24,1974,3.044747428179809
STAT,1959,21,15-19,1980,8.064969194706885
STAT,1830,45,35-39,1875,0.13258306065697903
STAT,1954,34,45-49,1988,2.2853965216327845
SIM,1922,44,na,1966,4998
STAT,1876,35,30-34,1911,6.418456990409953
STAT,1941,16,50-100,1957,0.4455846310822796
STAT,1935,42,na,1977,6048.812465434771
SIM,1967,45,50-100,2012,1
STAT,1980,0,na,1980,6345.7881836362685
SIM,1993,19,25-29,2012,180
SIM,1932,37,25-29,1969,1
STAT,1871,30,25-29,1901,11.854331048665301
SIM,1861,19,30-34,1880,1
STAT,1788,74,na,1862,671.575436423673
SIM,1887,31,50-100,1918,2
SIM,1888,41,25-29,1929,2
STAT,1916,23,50-100,1939,0.7933255089020087
SIM,1902,30,30-34,1932,65
STAT,1798,98,na,1896,0.8262983149181895
STAT,1813,52,40-44,1865,0.033429864567632896
SIM,1928,35,na,1963,5700
SIM,1893,36,25-29,1929,7
STAT,1791,78,na,1869,336.67987678908145
STAT,1924,37,25-29,1961,1.3395138499617205
SIM,1884,35,30-34,1919,12
STAT,1884,45,50-100,1929,0.2828301351874981
STAT,1969,36,30-34,2005,2.709408655136182
SIM,1844,96,na,1940,15
SIM,1941,4,na,1945,4102
STAT,1853,19,30-34,1872,1.8865005307501213
SIM,1871,22,15-19,1893,6
STAT,1828,44,40-44,1872,2.0959573273738945
SIM,1961,19,35-39,1980,16
SIM,1919,40,na,1959,5355
SIM,1962,34,45-49,1996,5
SIM,1909,36,30-34,1945,4
SIM,1843,45,25-29,1888,1
SIM,1898,45,na,1943,3825
STAT,1830,29,50-100,1859,0.7351863479411099
STAT,1914,74,na,1988,2903.737301164388
SIM,1900,23,20-24,1923,216
STAT,1885,36,25-29,1921,3.3302222991541663
SIM,1901,15,20-24,1916,55
SIM,1977,36,30-34,2013,6
STAT,1969,27,50-100,1996,1.441126279783622
SIM,1855,50,na,1905,1724
STAT,1914,26,45-49,1940,2.0177576091629725
STAT,1917,79,na,1996,2401.291606855394
SIM,1976,26,30-34,2002,69
STAT,1909,28,na,1937,4121.748689619997
STAT,1985,19,25-29,2004,71.08226611009417
STAT,1929,18,45-49,1947,0.733831982111456
STAT,1964,29,50-100,1993,1.4515748983784547
STAT,1866,47,50-100,1913,0.2614841919718397
STAT,1917,41,20-24,1958,0.0213004412219966
STAT,1918,30,na,1948,4674.345341522216
SIM,1976,29,35-39,2005,45
STAT,1883,20,35-39,1903,6.6281080361552736
STAT,1978,23,20-24,2001,175.6489013939898
SIM,1842,29,30-34,1871,64
SIM,1890,41,25-29,1931,1
STAT,1878,43,25-29,1921,0.7681811410245385
STAT,1951,19,25-29,1970,59.5129729682137
SIM,1897,35,40-44,1932,16
STAT,1883,36,15-19,1919,0.06370884789022807
SIM,1835,36,na,1871,2346
STAT,1872,38,40-44,1910,5.04749952479233
STAT,1814,62,na,1876,1405.7707208257755
STAT,1935,36,30-34,1971,2.9454004582078483
SIM,1921,20,30-34,1941,1
SIM,1880,38,40-44,1918,17
SIM,1954,37,45-49,1991,5
SIM,1822,32,35-39,1854,18
STAT,1900,44,20-24,1944,0.017421855035026315
SIM,1886,43,25-29,1929,1
STAT,1863,22,15-19,1885,3.395423615116697
STAT,1932,31,45-49,1963,2.416074434929131
STAT,1825,29,20-24,1854,48.55643150560526
STAT,1903,18,50-100,1921,0.08032074024169832
SIM,1833,29,20-24,1862,2
STAT,1952,27,35-39,1979,20.853043540484528
STAT,1889,35,40-44,1924,6.2864424089937465
STAT,1899,16,50-100,1915,0.07764985306518259
STAT,1986,19,50-100,2005,0.6156685671413704
SIM,1867,43,20-24,1910,1
STAT,1818,42,15-19,1860,0.01845041526922874
STAT,1834,29,30-34,1863,29.70288731012141
STAT,1956,44,40-44,2000,0.39562432168832856
SIM,1891,20,35-39,1911,16
STAT,1880,24,40-44,1904,2.533043712672434
SIM,1820,37,30-34,1857,13
SIM,1940,19,20-24,1959,3
SIM,1951,31,20-24,1982,1
STAT,1983,18,20-24,2001,221.26248891241949
STAT,1932,19,20-24,1951,206.11621915132187
STAT,1936,15,40-44,1951,1.553515249414857
SIM,1991,18,20-24,2009,223
SIM,1940,31,45-49,1971,1
STAT,1946,37,45-49,1983,0.8989831137112311
SIM,1904,30,40-44,1934,19
SIM,1901,18,25-29,1919,18
STAT,1878,7,na,1885,3226.3743227450955
SIM,1972,30,40-44,2002,1
SIM,1911,25,30-34,1936,104
STAT,1875,26,15-19,1901,0.5429404262615454
STAT,1879,114,na,1993,4.883561659138767E-4
SIM,1922,60,na,1982,4504
STAT,1944,53,na,1997,4645.051500308892
SIM,1987,6,na,1993,6564
SIM,1868,24,20-24,1892,82
SIM,1878,5,na,1883,3286
SIM,1816,39,30-34,1855,8
STAT,1861,44,15-19,1905,0.013070410272068006
STAT,1859,43,20-24,1902,0.14494291468459577
STAT,1921,30,30-34,1951,20.389062378574778
SIM,1809,81,na,1890,233
SIM,1878,44,35-39,1922,4
STAT,1839,41,50-100,1880,0.9828683298375628
SIM,1995,19,35-39,2014,16
STAT,1832,104,na,1936,0.04544209338690726
STAT,1953,53,na,2006,5221.272507370766
STAT,1987,19,35-39,2006,6.908511777575424
STAT,1891,49,30-34,1940,0.07625551560094081
STAT,1903,31,na,1934,3938.593784018992
STAT,1897,100,na,1997,30.428988657001824
STAT,1958,31,50-100,1989,1.278159049895191
SIM,1898,18,15-19,1916,16
STAT,1909,31,20-24,1940,2.700182288482451
STAT,1843,96,na,1939,8.615688724447772
STAT,1856,51,25-29,1907,0.003133483829322008
STAT,1913,20,30-34,1933,32.34958612173351
SIM,1917,31,20-24,1948,4
SIM,1872,28,na,1900,2913
SIM,1859,25,25-29,1884,41
SIM,1943,36,30-34,1979,8
STAT,1861,39,35-39,1900,6.717515769334618
SIM,1931,42,35-39,1973,1
SIM,1815,50,na,1865,1818
STAT,1975,25,50-100,2000,1.5232641199331407
STAT,1994,19,35-39,2013,6.983344800459223
SIM,1934,37,35-39,1971,10
SIM,1983,25,50-100,2008,7
STAT,1859,24,15-19,1883,3.1016179089789997
SIM,1837,24,35-39,1861,7
SIM,1935,26,30-34,1961,128
SIM,1938,13,na,1951,4178
SIM,1914,41,45-49,1955,1
STAT,1837,32,15-19,1869,0.12929257457578008
STAT,1911,45,35-39,1956,0.14164431926248802
SIM,1828,47,40-44,1875,1
STAT,1829,35,50-100,1864,1.4657880704226234
SIM,1905,26,na,1931,4179
STAT,1858,70,na,1928,1263.1680615718826
STAT,1967,32,20-24,1999,3.5841637866408944
STAT,1844,48,30-34,1892,0.07994837285390984
STAT,1877,17,15-19,1894,7.124101350952707
SIM,1867,24,15-19,1891,6
STAT,1906,41,45-49,1947,0.17569176914035667
STAT,1822,40,15-19,1862,0.02979371657059331
STAT,1926,37,35-39,1963,3.4106937363307797
STAT,1927,26,30-34,1953,55.14924578099963
STAT,1844,32,15-19,1876,0.14243924951620482
STAT,1930,67,na,1997,4691.961692388585
SIM,1986,23,20-24,2009,340
STAT,1949,18,30-34,1967,16.354218116848237
STAT,1851,19,20-24,1870,16.89196584493261
STAT,1885,33,20-24,1918,3.0983853550518323
STAT,1923,42,35-39,1965,0.2715120181309922
STAT,1944,57,na,2001,4537.621873812578
STAT,1933,23,45-49,1956,1.7225926354361218
STAT,1972,27,45-49,1999,2.563763881532794
STAT,1938,27,45-49,1965,1.9761823637304392
SIM,1856,17,50-100,1873,1
SIM,1909,62,na,1971,4243
SIM,1929,17,na,1946,4727
SIM,1806,79,na,1885,352
SIM,1860,34,30-34,1894,30
SIM,1983,19,30-34,2002,2
STAT,1863,57,na,1920,2027.939062338522
STAT,1958,2,na,1960,5964.764419395873
STAT,1928,41,40-44,1969,0.3685064698690201
STAT,1830,42,30-34,1872,1.104306622541369
STAT,1846,37,40-44,1883,4.7257721476976196
STAT,1954,31,na,1985,5503.185898746902
STAT,1852,34,30-34,1886,16.693361692057916
STAT,1953,16,30-34,1969,17.02100908310256
SIM,1909,20,15-19,1929,7
STAT,1931,19,15-19,1950,68.20030771278562
STAT,1924,21,45-49,1945,1.5364180442325002
SIM,1893,33,20-24,1926,1
STAT,1997,18,na,2015,6200.763979307053
SIM,1898,39,na,1937,3872
SIM,1854,37,40-44,1891,4
STAT,1914,23,40-44,1937,3.953973588937694
SIM,1900,94,na,1994,229
STAT,1898,70,na,1968,2569.5844699490713
STAT,1934,17,na,1951,5748.377535235672
STAT,1954,47,35-39,2001,0.1913251998709434
STAT,1985,22,15-19,2007,8.766289509931244
STAT,1988,19,40-44,2007,2.3070918169744385
STAT,1860,15,na,1875,2491.616510496664
SIM,1946,27,45-49,1973,7
STAT,1847,33,na,1880,1937.751240898707
STAT,1851,54,na,1905,1660.4970730312475
STAT,1891,30,35-39,1921,14.56052464200681
STAT,1965,48,25-29,2013,0.07927328056077602
STAT,1890,46,45-49,1936,0.18825332644925613
STAT,1905,29,15-19,1934,0.7524131308114624
SIM,1860,80,na,1940,1009
SIM,1966,25,na,1991,5564
STAT,1840,22,35-39,1862,5.953133013454114
STAT,1895,19,na,1914,3773.599109975454
SIM,1914,49,na,1963,3869
STAT,1910,42,25-29,1952,0.07796446864141969
SIM,1922,23,40-44,1945,6
SIM,1944,15,40-44,1959,4
STAT,1961,26,30-34,1987,58.700164818910416
SIM,1846,27,40-44,1873,1
STAT,1831,48,20-24,1879,0.010976451939576968
SIM,1840,66,na,1906,1200
STAT,1849,99,na,1948,1.467876144670454
STAT,1964,17,45-49,1981,0.7260924064179421
STAT,1880,48,40-44,1928,0.20678754389786827
SIM,1866,40,35-39,1906,1
SIM,1932,21,45-49,1953,4
SIM,1962,31,40-44,1993,3
STAT,1914,7,na,1921,4758.582808439127
SIM,1820,37,na,1857,1980
STAT,1924,48,25-29,1972,0.07265708042050206
STAT,1833,23,40-44,1856,2.0840460849008045
SIM,1955,31,na,1986,6520
STAT,1838,27,40-44,1865,3.301315117442161
STAT,1931,12,na,1943,5986.455726343007
SIM,1873,40,35-39,1913,2
STAT,1902,55,na,1957,3419.0385181591255
STAT,1808,102,na,1910,0.14948674072456275
STAT,1929,15,40-44,1944,2.0696992370445884
SIM,1941,23,45-49,1964,2
STAT,1923,89,na,2012,957.4951382877755
STAT,1802,101,na,1903,0.2723915377291642
STAT,1882,41,25-29,1923,0.7271242864730669
STAT,1884,25,na,1909,2739.6251511950995
STAT,1948,15,45-49,1963,0.6600794306298345
STAT,1961,19,50-100,1980,0.5582376983522613
STAT,1961,49,50-100,2010,0.3487183464640932
STAT,1788,80,na,1868,380.2870788304302
STAT,1878,56,na,1934,2457.6683466168734
STAT,1864,16,35-39,1880,0.6465631112309016
SIM,1908,47,35-39,1955,1
STAT,1865,40,35-39,1905,1.9045464285281306
STAT,1871,46,40-44,1917,0.19711730164003388
SIM,1900,26,25-29,1926,6
STAT,1974,17,na,1991,5546.637093674099
STAT,1954,31,40-44,1985,5.694200810653995
STAT,1858,27,na,1885,2199.4645277872637
STAT,1863,24,50-100,1887,0.4137009591518829
STAT,1896,34,35-39,1930,15.304384415596365
SIM,1818,42,na,1860,2169
STAT,1866,41,50-100,1907,1.1351594923075756
SIM,1879,60,na,1939,2216
STAT,1916,34,50-100,1950,0.9767645271777999
STAT,1892,76,na,1968,1824.0826217323765
STAT,1932,69,na,2001,4623.53570154315
STAT,1947,18,20-24,1965,176.1859877158442
STAT,1818,49,40-44,1867,0.20534837080645446
STAT,1893,47,30-34,1940,0.07927945373328772
STAT,1941,33,20-24,1974,2.954334591331714
STAT,1982,12,na,1994,6379.010185514932
SIM,1972,33,45-49,2005,1
SIM,1847,44,40-44,1891,6
STAT,1848,30,25-29,1878,12.957900267207526
STAT,1926,44,35-39,1970,0.2854726463273296
SIM,1861,25,25-29,1886,59
STAT,1815,47,na,1862,1685.6314812440703
SIM,1896,19,na,1915,3953
STAT,1835,61,na,1896,1164.6344452237245
STAT,1941,38,15-19,1979,0.0234993256191471
SIM,1855,34,na,1889,1884
STAT,1844,25,15-19,1869,0.4712998019975154
STAT,1912,48,na,1960,4067.133496542358
STAT,1813,48,45-49,1861,0.7704205219317611
STAT,1809,49,30-34,1858,0.23951319349563535
STAT,1861,32,50-100,1893,0.8790526020004037
SIM,1890,16,na,1906,3634
STAT,1905,40,50-100,1945,0.1237749552439082
SIM,1857,2,na,1859,3450
SIM,1803,74,na,1877,804
SIM,1955,18,20-24,1973,364
STAT,1958,48,25-29,2006,0.08339862147495089
SIM,1904,32,30-34,1936,4
STAT,1823,42,na,1865,1564.9828218097173
SIM,1854,21,25-29,1875,1
STAT,1804,84,na,1888,147.29233079333238
SIM,1889,22,na,1911,4024
STAT,1884,41,na,1925,2647.248296929639
STAT,1924,55,na,1979,4887.710604313028
SIM,1904,41,na,1945,4055
SIM,1951,34,25-29,1985,2
STAT,1896,38,50-100,1934,1.8621489307987869
SIM,1930,22,30-34,1952,98
SIM,1843,39,30-34,1882,12
STAT,1930,33,45-49,1963,2.342441429685325
STAT,1942,17,25-29,1959,52.27212082661679
SIM,1883,31,na,1914,2559
STAT,1828,52,25-29,1880,0.0031503372225221396
STAT,1897,29,na,1926,3656.4035998439367
STAT,1965,34,45-49,1999,2.307973372153769
STAT,1969,39,35-39,2008,3.5847561258976848
STAT,1868,21,45-49,1889,0.7787590743780419
STAT,1901,7,na,1908,4211.513294730077
STAT,1835,39,30-34,1874,4.0279814751169924
STAT,1998,17,45-49,2015,0.846454472274591
STAT,1797,97,na,1894,1.5995936116344922
SIM,1868,27,25-29,1895,103
STAT,1922,22,30-34,1944,38.02039807641831
STAT,1915,48,15-19,1963,4.2725940400496125E-4
STAT,1952,34,35-39,1986,12.865698695931847
SIM,1931,55,na,1986,5863
STAT,1965,45,20-24,2010,0.016639254899147568
SIM,1916,29,30-34,1945,56
STAT,1921,33,35-39,1954,11.682347472381942
SIM,1881,88,na,1969,182
SIM,1943,39,35-39,1982,5
STAT,1967,39,na,2006,5575.6133642799805
STAT,1937,23,50-100,1960,0.7396220675224786
STAT,1971,35,35-39,2006,3.6486438524384273
STAT,1911,82,na,1993,1762.8364708273364
STAT,1844,39,40-44,1883,3.7896144673239522
SIM,1865,20,30-34,1885,1
SIM,1995,16,30-34,2011,52
SIM,1962,33,30-34,1995,46
SIM,1859,27,na,1886,2393
SIM,1878,84,na,1962,552
STAT,1907,33,45-49,1940,1.6930119567601751
STAT,1939,44,45-49,1983,0.19921552503395473
SIM,1923,45,na,1968,5282
SIM,1909,8,na,1917,5138
SIM,1856,30,25-29,1886,24
SIM,1980,24,30-34,2004,1
STAT,1924,8,na,1932,5479.680504637302
STAT,1848,49,na,1897,2340.6059633054697
SIM,1880,39,50-100,1919,5
STAT,1890,113,na,2003,0.0021399247141661395
STAT,1836,50,50-100,1886,0.01447405491818474
SIM,1931,3,na,1934,6461
STAT,1987,16,30-34,2003,20.086658500242194
STAT,1954,33,30-34,1987,22.89747779589228
STAT,2013,1,na,2014,7262.912327087288
SIM,1909,19,na,1928,4977
STAT,1837,21,50-100,1858,0.3893564583373273
SIM,1902,23,30-34,1925,2
STAT,1963,46,na,2009,5616.570084675283
STAT,1975,34,na,2009,5861.758461171287
SIM,1915,33,45-49,1948,3
SIM,1960,34,35-39,1994,49
STAT,1872,53,na,1925,2455.034038403478
STAT,1908,29,30-34,1937,42.49485588910417
STAT,1845,42,15-19,1887,0.00947629042781357
STAT,1935,39,35-39,1974,3.896991439724965
SIM,1907,39,25-29,1946,2
STAT,1830,33,40-44,1863,4.600365353280753
SIM,1929,28,20-24,1957,19
STAT,1936,43,na,1979,4240.227109695944
STAT,1821,42,50-100,1863,2.0380677445856312
STAT,1890,37,50-100,1927,1.7312648717146868
SIM,1946,24,40-44,1970,1
STAT,1969,30,na,1999,5563.959694634718
SIM,1877,41,25-29,1918,1
STAT,1869,41,25-29,1910,0.7209273696904667
SIM,1828,31,25-29,1859,6
STAT,1853,25,25-29,1878,49.497856122753255
STAT,1935,20,15-19,1955,8.375814799489836
STAT,1839,44,40-44,1883,1.8324730185014684
STAT,1948,35,20-24,1983,0.3592930313448587
SIM,1931,40,na,1971,6091
STAT,1857,20,30-34,1877,18.75076912894391
STAT,1917,44,25-29,1961,0.08571769078907833
SIM,1843,27,50-100,1870,2
SIM,1924,27,25-29,1951,104
SIM,1827,84,na,1911,112
STAT,1905,24,45-49,1929,1.1574602401056553
STAT,1811,45,30-34,1856,0.3121011394528237
SIM,1839,30,30-34,1869,27
STAT,1861,29,30-34,1890,23.987022638237573
STAT,1836,54,40-44,1890,0.009320969898744192
SIM,1807,55,na,1862,1040
STAT,1925,17,30-34,1942,16.986747893238036
SIM,1822,47,na,1869,1561
STAT,1938,24,40-44,1962,3.8396279523244847
STAT,1847,89,na,1936,80.83388952874199
STAT,1826,107,na,1933,0.002596630328004166
SIM,1932,39,50-100,1971,1
STAT,1865,34,40-44,1899,4.47697134245405
STAT,1873,19,na,1892,2960.4393658646645
SIM,1890,19,15-19,1909,7
SIM,1876,26,15-19,1902,2
SIM,1974,20,na,1994,5953
STAT,1974,25,20-24,1999,27.65028517932448
SIM,1836,61,na,1897,1155
STAT,1886,110,na,1996,0.03434518708864137
STAT,1968,3,na,1971,5670.132217026321
STAT,1911,23,25-29,1934,100.87132321139043
STAT,1916,27,25-29,1943,78.54762871001958
SIM,1895,47,50-100,1942,2
SIM,1913,24,45-49,1937,2
STAT,1820,47,30-34,1867,0.10043994802970856
STAT,1958,42,50-100,2000,0.18505494087852847
SIM,1866,42,50-100,1908,3
STAT,1882,19,15-19,1901,6.653640158843196
SIM,1958,38,35-39,1996,11
STAT,1870,29,40-44,1899,3.3837669938975425
STAT,1904,40,40-44,1944,0.26146011198874486
STAT,1934,19,30-34,1953,18.933620665914685
STAT,1886,45,40-44,1931,0.21048136349587376
SIM,1867,22,na,1889,2355
SIM,1830,31,25-29,1861,16
SIM,1923,43,20-24,1966,1
STAT,1945,35,na,1980,4894.7713895376155
SIM,1981,17,na,1998,6454
STAT,1880,32,25-29,1912,12.529175990890836
STAT,1934,32,50-100,1966,1.3033951769062757
STAT,1826,44,30-34,1870,0.8362602567383496
SIM,1829,30,50-100,1859,2
SIM,1858,45,na,1903,2501
SIM,1940,5,na,1945,5183
SIM,1942,19,30-34,1961,31
STAT,1910,44,15-19,1954,0.0016560625364197236
STAT,1840,91,na,1931,46.485826924685306
SIM,1978,28,50-100,2006,5
STAT,1862,53,30-34,1915,0.005704297711353634
STAT,1861,16,na,1877,2546.245080089599
STAT,1886,51,na,1937,2633.6880587246383
STAT,1915,43,20-24,1958,0.02049018986675812
STAT,1863,44,25-29,1907,0.6392603075122248
SIM,1932,2,na,1934,5887
SIM,1943,43,na,1986,5340
STAT,1962,43,20-24,2005,0.027095703298645222
STAT,1960,41,20-24,2001,0.027626174699614602
SIM,1968,18,30-34,1986,20
STAT,1845,26,50-100,1871,0.5284711787454429
SIM,1928,22,30-34,1950,1
STAT,1866,22,na,1888,2550.458410819124
STAT,1936,18,45-49,1954,0.5508139319538807
STAT,1879,31,50-100,1910,1.1086052134206812
STAT,1861,90,na,1951,75.64020952110543
STAT,1827,35,25-29,1862,4.433272766011478
SIM,1851,34,50-100,1885,4
STAT,1846,21,25-29,1867,73.54738379089318
SIM,1873,53,na,1926,2924
STAT,1975,33,20-24,2008,3.7829625398725923
SIM,1853,24,na,1877,2585
STAT,1924,45,20-24,1969,0.015250531740234092
SIM,1871,44,25-29,1915,2
STAT,1836,18,40-44,1854,0.3738821356758086
STAT,1838,72,na,1910,1093.9322374275444
STAT,1908,48,50-100,1956,0.2357040566140589
STAT,1979,20,50-100,1999,1.0497223521827324
STAT,1796,109,na,1905,1.8121234415676758E-4
STAT,1896,44,na,1940,3487.439478072057
SIM,1912,82,na,1994,597
SIM,1889,21,30-34,1910,48
SIM,1891,66,na,1957,2299
STAT,1961,29,35-39,1990,22.459722249585337
SIM,1933,29,25-29,1962,190
SIM,1835,35,25-29,1870,5
SIM,1824,32,45-49,1856,1
STAT,1762,106,na,1868,0.016726095019912218
SIM,1790,84,na,1874,10
SIM,1964,46,na,2010,5762
SIM,1984,0,na,1984,6326
STAT,1925,29,25-29,1954,89.04725198801329
STAT,1877,15,25-29,1892,6.834201247876999
STAT,1813,45,40-44,1858,0.5863398845131541
SIM,1884,40,50-100,1924,3
STAT,1850,47,50-100,1897,0.2516532314745265
STAT,1879,15,35-39,1894,0.6642769314862903
STAT,1819,50,25-29,1869,0.006825998594134248
STAT,1879,21,20-24,1900,83.29156383595986
STAT,1971,21,30-34,1992,42.1628177846019
SIM,1819,43,na,1862,1185
SIM,1932,37,na,1969,5484
STAT,1842,22,45-49,1864,0.676818948718639
SIM,1887,21,20-24,1908,132
SIM,1834,35,na,1869,1946
SIM,1857,29,15-19,1886,1
STAT,1911,25,50-100,1936,1.1287721064583487
SIM,1952,58,na,2010,4253
SIM,1934,41,30-34,1975,2
STAT,1849,29,15-19,1878,0.41088412411202113
STAT,1931,84,na,2015,2073.8744002303697
STAT,1893,15,50-100,1908,0.07179740021784209
STAT,1926,46,25-29,1972,0.07570654688933831
STAT,1884,45,30-34,1929,0.11147376692538251
STAT,2001,9,na,2010,6789.685849664934
STAT,1956,32,45-49,1988,2.4494014334925462
STAT,1876,40,50-100,1916,1.2730418936136116
SIM,1947,36,na,1983,5970
SIM,1793,79,na,1872,537
STAT,1863,42,na,1905,2329.424090738556
STAT,1858,40,35-39,1898,1.646700106096012
SIM,1818,98,na,1916,7
SIM,1921,19,na,1940,4867
STAT,1930,30,40-44,1960,5.835630832961302
SIM,1928,51,na,1979,5574
STAT,1987,22,25-29,2009,152.68134341691
SIM,1882,20,25-29,1902,5
SIM,1937,66,na,2003,3366
STAT,1853,22,20-24,1875,81.0662978810853
SIM,1808,80,na,1888,340
STAT,1851,38,na,1889,1868.7788126357757
STAT,1939,41,40-44,1980,0.30083041490295415
SIM,1902,26,35-39,1928,5
STAT,1838,33,35-39,1871,10.789756445856154
SIM,1843,31,na,1874,2088
STAT,1948,46,na,1994,5059.228043581827
SIM,1941,33,na,1974,3978
STAT,1835,23,15-19,1858,2.7615516178266706
STAT,1932,36,15-19,1968,0.029810705240537895
SIM,1861,22,20-24,1883,113
SIM,1856,3,na,1859,2913
SIM,1865,12,na,1877,3411
SIM,1960,31,30-34,1991,53
STAT,1959,37,30-34,1996,2.83452951319931
STAT,1960,46,15-19,2006,5.773527607401958E-4
SIM,1878,22,25-29,1900,150
STAT,1923,70,na,1993,3886.0687825972914
SIM,1917,92,na,2009,425
SIM,1791,69,na,1860,771
SIM,1872,23,35-39,1895,8
STAT,1927,17,50-100,1944,0.5374822769266916
SIM,1896,17,35-39,1913,1
SIM,1956,32,na,1988,5433
STAT,1957,42,na,1999,5872.703277914532
STAT,1898,34,45-49,1932,2.696519280405297
SIM,1845,72,na,1917,1143
STAT,1871,53,40-44,1924,0.011893001042443084
STAT,1958,45,20-24,2003,0.017505153200962034
STAT,1895,33,15-19,1928,0.2130209069835817
STAT,1965,31,40-44,1996,5.750452371082011
SIM,1845,97,na,1942,1
SIM,1969,32,25-29,2001,45
STAT,1857,23,35-39,1880,6.011566265988214
SIM,1955,45,45-49,2000,1
STAT,1934,40,45-49,1974,0.2682349515291488
STAT,1948,38,25-29,1986,1.33832144602631
STAT,1840,19,45-49,1859,0.06704920613827108
SIM,1829,43,50-100,1872,3
STAT,1913,46,15-19,1959,4.161841925356851E-4
STAT,1945,31,30-34,1976,20.257418617568092
STAT,1934,45,50-100,1979,0.36555791305247165
SIM,1964,32,45-49,1996,4
STAT,1906,46,15-19,1952,3.8078950819020604E-4
STAT,1903,56,na,1959,3447.401673207674
SIM,1956,38,25-29,1994,3
SIM,1937,22,40-44,1959,5
STAT,1946,15,35-39,1961,5.373854057768712
STAT,1864,23,35-39,1887,6.0659487638534655
STAT,1824,39,na,1863,1741.1498439408579
STAT,1839,38,na,1877,2008.8307393758214
STAT,1885,26,na,1911,2756.576493670771
SIM,1934,46,25-29,1980,1
SIM,1915,30,40-44,1945,9
STAT,1900,45,na,1945,3639.390122851586
STAT,1936,58,na,1994,3988.73508761334
SIM,1908,37,na,1945,3842
STAT,1854,17,50-100,1871,0.04774611134236111
SIM,1966,45,20-24,2011,1
SIM,1843,46,na,1889,1752
SIM,1857,60,na,1917,1982
STAT,1802,58,na,1860,1387.9082288756035
STAT,1945,58,na,2003,4569.870711475091
STAT,1929,22,40-44,1951,4.907209067024356
STAT,1863,106,na,1969,0.1360959736824618
STAT,1888,17,35-39,1905,0.744364885302893
STAT,1907,30,40-44,1937,4.262186245140765
STAT,1857,26,na,1883,2225.395296008658
STAT,1888,18,na,1906,3417.196547287987
SIM,1936,43,30-34,1979,1
STAT,1848,34,na,1882,2635.44707512223
SIM,1864,29,15-19,1893,1
SIM,1891,41,na,1932,3328
STAT,1970,24,na,1994,5289.334066613464
SIM,1867,78,na,1945,745
STAT,1904,43,45-49,1947,0.1709902175743462
STAT,1892,31,50-100,1923,1.3307049992855167
STAT,1969,43,30-34,2012,0.19123454905255258
SIM,1884,43,15-19,1927,2
STAT,1818,52,50-100,1870,0.01793923448351012
SIM,1892,26,na,1918,3769
SIM,1938,42,45-49,1980,1
STAT,1820,45,40-44,1865,0.18941301133463476
STAT,1973,41,30-34,2014,0.19858802508466306
SIM,1962,45,45-49,2007,1
STAT,1928,43,30-34,1971,0.1877856351324755
SIM,1949,54,na,2003,5544
STAT,1920,16,35-39,1936,5.4440625901694375
STAT,1867,41,15-19,1908,0.014947259758922493
STAT,1854,42,25-29,1896,0.5225192982441351
SIM,1870,42,na,1912,2991
SIM,1954,15,35-39,1969,11
STAT,1881,30,na,1911,2677.6237714654467
SIM,1840,49,50-100,1889,1
SIM,1810,44,na,1854,1534
STAT,1985,16,20-24,2001,222.5944182745893
STAT,1870,112,na,1982,0.0021375948925417827
STAT,1851,25,15-19,1876,0.42737182866924667
SIM,1924,24,20-24,1948,242
SIM,1839,33,35-39,1872,24
STAT,1961,28,na,1989,5606.96041297992
STAT,1852,41,50-100,1893,1.0005438617181617
STAT,1880,41,15-19,1921,0.016969188756259412
SIM,1953,31,30-34,1984,1
SIM,1910,102,na,2012,28
STAT,1990,23,45-49,2013,1.8651122168470122
SIM,1902,32,20-24,1934,10
STAT,1952,31,30-34,1983,22.222828275652763
STAT,1869,25,50-100,1894,0.7197758192816452
STAT,1916,24,20-24,1940,133.63773981866825
STAT,1801,73,na,1874,574.825588705405
STAT,1811,48,35-39,1859,0.4291108653174821
STAT,1896,28,40-44,1924,4.550023757873354
STAT,1870,15,15-19,1885,6.897210282553797
SIM,1910,56,na,1966,3187
SIM,1888,77,na,1965,1105
STAT,1874,63,na,1937,2108.0613231335647
SIM,1977,5,na,1982,6245
STAT,1882,49,20-24,1931,0.013244155838184982
STAT,1893,31,15-19,1924,0.2085816412380218
STAT,1973,35,45-49,2008,1.0500874263198696
STAT,1920,22,20-24,1942,142.5991997768394
SIM,1886,11,na,1897,2392
SIM,1960,36,25-29,1996,2
STAT,1856,48,50-100,1904,0.21352130022323107
STAT,1913,96,na,2009,165.94969061751482
STAT,1903,28,35-39,1931,15.804858990509542
SIM,1933,26,20-24,1959,45
SIM,1812,43,40-44,1855,3
SIM,1835,32,20-24,1867,1
SIM,1911,28,35-39,1939,47
SIM,1845,18,25-29,1863,5
STAT,1832,50,25-29,1882,0.0026611463295438966
SIM,1809,65,na,1874,1131
STAT,1833,35,na,1868,1923.3681369259855
STAT,1791,94,na,1885,4.715213556554684
STAT,1837,54,25-29,1891,0.0024943550179986115
STAT,1925,26,20-24,1951,24.958602853320585
STAT,1943,34,25-29,1977,11.515791674198123
STAT,1853,64,na,1917,1730.7426474925464
STAT,1866,17,15-19,1883,6.515668092535438
STAT,1837,18,25-29,1855,7.736217123934359
STAT,1832,49,50-100,1881,0.17880299587742546
STAT,1956,48,15-19,2004,5.834890763775002E-4
STAT,1827,32,20-24,1859,4.680615974129333
STAT,1936,0,na,1936,4980.596748854353
STAT,1816,72,na,1888,662.4649537565917
STAT,1885,45,15-19,1930,4.6503373904485993E-4
STAT,1913,45,45-49,1958,0.2460927452373591
SIM,1924,70,na,1994,3684
STAT,1911,39,40-44,1950,1.653245122846818
SIM,1826,49,40-44,1875,1
STAT,1971,42,50-100,2013,0.1784534452912152
STAT,1893,30,45-49,1923,2.5641927504651365
SIM,1958,35,30-34,1993,4
SIM,1942,18,na,1960,4733
SIM,1853,40,25-29,1893,1
SIM,1919,55,na,1974,5085
STAT,1919,41,30-34,1960,0.1600790667495296
SIM,1899,35,15-19,1934,2
STAT,1926,41,30-34,1967,0.18211112838843854
STAT,1891,24,40-44,1915,2.9535680997016476
STAT,1980,35,45-49,2015,1.127154374442789
STAT,1845,40,25-29,1885,0.45208427965498194
STAT,1911,20,20-24,1931,122.53243980187608
STAT,1875,19,15-19,1894,7.03956278155479
SIM,1929,32,50-100,1961,1
STAT,1869,43,15-19,1912,0.01532248870350254
SIM,1928,25,35-39,1953,48
STAT,1896,69,na,1965,2531.9792691003945
STAT,1945,2,na,1947,5097.449607098215
STAT,1770,95,na,1865,1.1595625079844052
SIM,1985,19,40-44,2004,2
STAT,1952,36,25-29,1988,1.4041471620858341
SIM,1864,48,50-100,1912,1
STAT,1876,43,15-19,1919,0.016355824162712782
STAT,1850,26,15-19,1876,0.5536139011921343
STAT,1980,33,25-29,2013,15.084251939763163
SIM,1857,54,na,1911,2167
STAT,1967,25,20-24,1992,26.45100829577444
SIM,1917,24,20-24,1941,5
SIM,1967,17,40-44,1984,2
SIM,1936,55,na,1991,3760
STAT,1888,24,35-39,1912,7.866706840000052
STAT,1964,30,na,1994,5609.852532353376
SIM,1898,76,na,1974,2250
STAT,1938,39,50-100,1977,0.4916123291373987
STAT,1905,48,20-24,1953,0.011164345695929362
STAT,1913,24,40-44,1937,3.895879996788224
SIM,1873,37,45-49,1910,5
STAT,1956,35,na,1991,5929.188413402305
SIM,1853,44,35-39,1897,2
STAT,1884,31,40-44,1915,4.965022806655618
STAT,1873,29,20-24,1902,13.726583605670461
STAT,1971,25,40-44,1996,6.848288099960052
SIM,1892,31,40-44,1923,12
STAT,1920,38,45-49,1958,0.8601456599091446
SIM,1880,66,na,1946,2322
STAT,1897,19,35-39,1916,0.8421907878619371
SIM,1953,30,50-100,1983,1
SIM,1966,30,20-24,1996,6
STAT,1915,13,na,1928,4763.605863070334
STAT,1820,77,na,1897,507.3114817717775
STAT,1876,107,na,1983,0.27306543794145344
SIM,1949,17,20-24,1966,349
STAT,2001,10,na,2011,6788.9389842214705
STAT,1982,15,45-49,1997,0.8116463800186718
STAT,1902,86,na,1988,1034.3272322932469
STAT,1909,24,20-24,1933,118.65167229024776
STAT,1884,48,35-39,1932,0.15762517001961499
STAT,1922,92,na,2014,540.338677608415
STAT,1864,95,na,1959,23.536855528176094
STAT,1959,17,40-44,1976,2.1114675892625563
SIM,1972,32,30-34,2004,4
STAT,1843,49,30-34,1892,0.09509933411577277
SIM,1867,26,50-100,1893,5
STAT,1896,32,15-19,1928,0.2170700379033874
STAT,1866,18,20-24,1884,19.34988137451311
SIM,1909,16,40-44,1925,3
STAT,1826,51,45-49,1877,0.010290921800945105
SIM,1979,18,15-19,1997,129
STAT,1925,43,na,1968,5179.213561539361
SIM,1984,22,50-100,2006,1
STAT,1855,18,45-49,1873,0.06572060422853615
STAT,1782,100,na,1882,0.29511766772199693
SIM,1848,28,20-24,1876,23
STAT,1782,98,na,1880,0.7874752916921159
STAT,1865,37,45-49,1902,2.0757301354235858
SIM,1857,20,35-39,1877,14
SIM,1842,25,20-24,1867,25
SIM,1976,25,25-29,2001,200
STAT,1883,48,50-100,1931,0.2738207171818192
SIM,1954,33,35-39,1987,25
STAT,1827,44,15-19,1871,0.017751737158837162
SIM,1774,91,na,1865,93
STAT,1813,51,35-39,1864,0.02788998194164145
SIM,1896,41,na,1937,3675
SIM,1907,17,15-19,1924,13
SIM,1933,25,15-19,1958,2
SIM,1934,20,na,1954,5070
STAT,1957,18,15-19,1975,69.031645030822
SIM,1837,43,40-44,1880,4
STAT,1834,25,20-24,1859,14.242290825164181
STAT,1931,38,20-24,1969,0.4025780216838203
STAT,1898,31,40-44,1929,6.791532945346642
SIM,1871,26,25-29,1897,4
STAT,1876,37,20-24,1913,0.9196064220788738
SIM,1894,29,30-34,1923,87
SIM,1887,37,45-49,1924,7
STAT,1993,17,30-34,2010,20.238181164711314
STAT,1879,37,45-49,1916,2.40218911778726
SIM,1931,81,na,2012,2771
SIM,1884,37,20-24,1921,3
SIM,1888,46,na,1934,2610
STAT,1950,47,15-19,1997,5.228402320085571E-4
STAT,1863,26,25-29,1889,42.995501341522136
STAT,1924,33,50-100,1957,1.1121994089016896
SIM,1905,63,na,1968,3509
STAT,1871,31,30-34,1902,20.127882347238486
STAT,1827,28,50-100,1855,1.7519501611718378
STAT,1886,29,30-34,1915,30.43511592461336
STAT,1973,36,15-19,2009,0.029555675476308732
STAT,1853,34,15-19,1887,0.1430069888656098
STAT,1969,20,25-29,1989,133.6946260398762
STAT,1947,30,45-49,1977,2.087467605903038
STAT,1868,47,40-44,1915,0.18893606194193632
STAT,1849,40,50-100,1889,0.8331330442561872
SIM,1844,28,na,1872,2549
STAT,1918,61,na,1979,4155.295278480187
STAT,1958,30,20-24,1988,3.7728316898128536
STAT,1925,25,15-19,1950,0.9684748631399656
STAT,1849,90,na,1939,61.106817948687166
SIM,1977,20,25-29,1997,6
STAT,1860,45,15-19,1905,3.757522584944051E-4
STAT,1882,21,35-39,1903,6.597699745160091
STAT,1847,25,30-34,1872,23.627422200207764
SIM,1847,47,50-100,1894,1
STAT,1845,44,35-39,1889,1.211143810481644
SIM,1849,59,na,1908,2192
SIM,1926,25,na,1951,5520
SIM,1898,37,20-24,1935,1
STAT,1841,39,na,1880,2197.477404128448
SIM,1890,21,35-39,1911,19
STAT,1907,18,na,1925,4277.179633775983
SIM,1855,25,30-34,1880,7
SIM,1959,12,na,1971,6025
SIM,1923,86,na,2009,1875
STAT,1918,3,na,1921,5093.786689052597
SIM,1887,101,na,1988,5
SIM,1919,38,45-49,1957,4
STAT,1801,98,na,1899,1.3634920548311598
STAT,1990,25,35-39,2015,24.941985902208263
SIM,1826,39,25-29,1865,3
STAT,1950,17,20-24,1967,184.99872075041657
SIM,1833,41,50-100,1874,4
SIM,1868,38,na,1906,3074
STAT,1994,15,25-29,2009,72.2062720220093
STAT,1844,46,40-44,1890,0.1436021113850535
STAT,1860,18,25-29,1878,6.042971532754169
STAT,1903,32,30-34,1935,28.69988544329151
STAT,1889,87,na,1976,702.4149614650089
STAT,1778,114,na,1892,1.5963940000016878E-4
SIM,1845,33,20-24,1878,4
SIM,1988,19,na,2007,5761
STAT,1908,31,na,1939,4142.006371397114
STAT,1981,30,35-39,2011,15.048691021602583
STAT,1862,47,45-49,1909,0.22877648558495534
STAT,1866,90,na,1956,95.03615715361035
STAT,1846,110,na,1956,3.079441367560999E-4
STAT,1972,23,35-39,1995,13.954391217431603
STAT,1923,48,na,1971,4944.131283663708
STAT,1812,42,na,1854,1411.3361028835338
SIM,1976,22,30-34,1998,99
STAT,1891,27,45-49,1918,1.583645527817519
STAT,1860,30,40-44,1890,4.066040331428433
SIM,1863,36,45-49,1899,5
STAT,1968,22,30-34,1990,41.56492375675913
STAT,1970,41,15-19,2011,0.0023088639572191576
STAT,1943,47,50-100,1990,0.2879363817106156
SIM,1821,33,35-39,1854,8
SIM,1837,46,na,1883,2213
STAT,1855,36,45-49,1891,1.704413090735066
STAT,1848,22,40-44,1870,2.695899050286404
STAT,1919,25,50-100,1944,1.249264479982291
SIM,1920,40,na,1960,4128
SIM,1838,16,na,1854,2245
SIM,1934,38,40-44,1972,2
STAT,1829,46,45-49,1875,0.2439983006943305
STAT,1976,25,na,2001,5805.8338407995325
STAT,1894,37,40-44,1931,6.4941970357379635
STAT,1986,9,na,1995,6461.873217691797
STAT,1844,47,25-29,1891,0.04795333451741775
STAT,1849,20,35-39,1869,5.547694999043541
STAT,1837,33,20-24,1870,2.42876827072912
SIM,1842,92,na,1934,63
SIM,1910,10,na,1920,4030
SIM,1879,29,35-39,1908,14
STAT,1848,40,40-44,1888,2.4489283805291455
STAT,1824,36,15-19,1860,0.08816318606810365
SIM,1911,32,30-34,1943,44
STAT,1938,39,15-19,1977,0.022485390037429318
STAT,1837,51,20-24,1888,5.47015646210862E-4
STAT,1886,47,30-34,1933,0.11728636306033173
STAT,1958,30,na,1988,5849.980040290449
SIM,1868,23,15-19,1891,4
SIM,2012,0,na,2012,7659
STAT,1926,38,40-44,1964,2.1087809136622244
STAT,1820,43,20-24,1863,0.18997042986235926
STAT,1881,53,35-39,1934,0.009429129069932207
SIM,1830,36,na,1866,2011
STAT,1867,34,15-19,1901,0.1521289062194961
STAT,1843,34,na,1877,2560.5310087408466
SIM,1881,15,30-34,1896,9
SIM,1871,23,20-24,1894,65
SIM,1867,84,na,1951,324
STAT,1899,1,na,1900,4303.462619397958
STAT,1913,42,40-44,1955,0.2816409721369133
STAT,1939,22,35-39,1961,10.917451287780276
SIM,1877,45,35-39,1922,1
STAT,1829,28,45-49,1857,1.9476026908903061
SIM,1936,7,na,1943,4146
SIM,1994,19,na,2013,5820
STAT,1869,45,35-39,1914,0.15802505424993127
SIM,1855,4,na,1859,2346
STAT,1870,34,20-24,1904,3.049005519914607
SIM,1838,45,50-100,1883,2
STAT,1861,17,50-100,1878,0.05402469932461601
STAT,1881,23,40-44,1904,2.312380856246458
STAT,1917,48,na,1965,4416.226660276255
STAT,1865,114,na,1979,1.365214261116436E-4
STAT,1973,20,45-49,1993,1.6860831568746382
STAT,1933,35,50-100,1968,0.6614029833099173
STAT,1956,22,40-44,1978,5.151539478322941
STAT,1840,20,15-19,1860,3.4143924734952766
STAT,1959,41,na,2000,5834.826892221105
STAT,1841,54,45-49,1895,0.01254802470719568
STAT,1819,54,35-39,1873,0.015320911281804751
STAT,1873,15,30-34,1888,1.9006830742041887
SIM,1902,48,45-49,1950,2
STAT,1937,28,45-49,1965,1.9436052448418744
STAT,1983,25,20-24,2008,29.955250029270662
STAT,1818,39,25-29,1857,4.200100539121651
SIM,1947,22,35-39,1969,36
STAT,1880,26,na,1906,2929.3118870945655
STAT,1924,27,20-24,1951,24.52101856397175
SIM,1793,70,na,1863,836
STAT,1994,18,50-100,2012,0.6237311189819722
SIM,1870,47,45-49,1917,2
STAT,1974,39,50-100,2013,0.6504400319421203
SIM,1873,84,na,1957,386
STAT,1847,39,20-24,1886,0.6027533742352944
SIM,1951,32,na,1983,6265
STAT,1952,46,40-44,1998,0.2273613614863698
SIM,1868,39,30-34,1907,11
SIM,1921,24,40-44,1945,9
STAT,1891,45,45-49,1936,0.19176967676326637
SIM,1843,53,50-100,1896,2
STAT,1830,35,30-34,1865,5.558843783442962
STAT,1989,15,45-49,2004,0.826173452470347
SIM,1859,15,20-24,1874,30
SIM,1989,22,30-34,2011,61
SIM,1917,20,na,1937,5662
STAT,1878,87,na,1965,443.8522483522634
SIM,1928,40,30-34,1968,1
STAT,1823,38,20-24,1861,0.8801526554222199
STAT,1847,28,35-39,1875,8.859689236510134
STAT,1958,33,25-29,1991,14.271253015038376
STAT,1846,41,15-19,1887,0.014635495222190905
SIM,1818,67,na,1885,1532
STAT,1897,16,30-34,1913,2.4655945509488912
SIM,1963,29,na,1992,6512
SIM,1880,48,45-49,1928,3
STAT,1855,90,na,1945,67.08508706555408
STAT,1943,23,50-100,1966,0.8077163609926572
SIM,1870,28,30-34,1898,43
STAT,1837,65,na,1902,1223.7493815612313
SIM,1847,47,45-49,1894,1
SIM,1842,28,25-29,1870,90
SIM,1838,21,50-100,1859,1
STAT,1855,15,40-44,1870,0.18730801312929832
STAT,1972,40,40-44,2012,0.38515249118190764
STAT,1845,60,na,1905,1285.1623821555831
STAT,1874,15,45-49,1889,0.0778230138901419
STAT,1862,28,30-34,1890,24.439138679994194
SIM,1916,48,50-100,1964,1
SIM,1850,28,na,1878,1806
SIM,1906,21,40-44,1927,7
STAT,1928,27,50-100,1955,1.415135576160456
SIM,1855,28,35-39,1883,1
STAT,1839,47,45-49,1886,0.1906915793126933
SIM,1826,62,na,1888,1254
SIM,1965,38,25-29,2003,1
STAT,1935,46,35-39,1981,0.21069356131731448
STAT,1844,29,25-29,1873,42.693628935041865
SIM,1899,20,40-44,1919,1
SIM,1831,38,20-24,1869,1
SIM,1814,40,35-39,1854,4
SIM,1817,85,na,1902,65
STAT,1858,3,na,1861,2971.2643610226473
STAT,1851,69,na,1920,1163.7543160597102
STAT,1865,77,na,1942,900.0535704270006
SIM,1922,75,na,1997,3237
STAT,1807,54,45-49,1861,0.054730237306487066
SIM,1871,41,20-24,1912,1
SIM,1852,29,25-29,1881,73
SIM,1884,84,na,1968,475
STAT,1826,47,35-39,1873,0.10073587261090335
STAT,1942,37,50-100,1979,0.5217588553629318
STAT,1962,16,50-100,1978,0.5541505575765854
SIM,1844,38,30-34,1882,1
STAT,1868,48,25-29,1916,0.06306254853676632
SIM,1950,37,50-100,1987,1
STAT,1842,80,na,1922,476.0254560303645
STAT,1944,22,15-19,1966,6.633168534819
SIM,1875,16,15-19,1891,10
SIM,1892,11,na,1903,4115
SIM,1820,38,45-49,1858,5
STAT,1891,69,na,1960,2250.237722965488
STAT,1870,19,25-29,1889,6.432144443087489
SIM,1863,54,na,1917,2056
SIM,1855,59,na,1914,1509
STAT,1814,77,na,1891,538.9644903265196
SIM,1837,35,50-100,1872,2
STAT,1820,46,25-29,1866,0.06250213072624766
SIM,1938,50,na,1988,4019
STAT,1838,31,15-19,1869,0.15491040240591153
SIM,1804,59,na,1863,1050
STAT,1867,16,15-19,1883,6.5757362466799165
STAT,1871,32,15-19,1903,0.1635020049074501
SIM,1840,30,35-39,1870,29
STAT,1911,92,na,2003,445.8512241069148
STAT,1874,27,15-19,1901,0.5360256121323178
STAT,1844,31,50-100,1875,0.9260144386903699
STAT,1961,36,35-39,1997,3.7188190247415944
STAT,1953,44,35-39,1997,0.29117647128017754
SIM,1911,35,35-39,1946,10
SIM,1914,40,na,1954,3919
SIM,1820,36,25-29,1856,5
STAT,1919,45,40-44,1964,0.1982319391333832
SIM,1984,15,15-19,1999,136
STAT,1936,41,25-29,1977,0.08177549727393335
STAT,1858,95,na,1953,11.969787014776443
SIM,1952,22,15-19,1974,14
SIM,1909,25,na,1934,4740
STAT,1834,28,25-29,1862,50.25677484628954
SIM,1836,28,30-34,1864,2
STAT,1965,37,50-100,2002,0.6232066399080163
STAT,1828,28,30-34,1856,36.57013211312758
STAT,1796,78,na,1874,363.48023404193765
STAT,1793,98,na,1891,0.6116895464326979
STAT,1911,51,na,1962,3966.0032813827474
SIM,1966,33,25-29,1999,47
STAT,1976,15,15-19,1991,70.00915457064617
STAT,1914,22,35-39,1936,11.106993712673331
STAT,1826,51,50-100,1877,0.010709535551530511
SIM,1944,41,25-29,1985,4
SIM,1922,22,35-39,1944,33
STAT,1903,97,na,2000,104.62742545648739
SIM,1958,23,25-29,1981,144
STAT,1821,40,30-34,1861,2.3198478292565556
STAT,1906,36,na,1942,4015.324283820633
STAT,1836,38,30-34,1874,5.894076233239366
STAT,1927,76,na,2003,3378.538397642197
SIM,1861,28,na,1889,1833
STAT,1862,44,40-44,1906,2.16107307909929
STAT,1903,35,35-39,1938,2.533268660898644
STAT,1828,38,50-100,1866,1.2374634904629953
STAT,1870,36,40-44,1906,5.004361723053014
SIM,1890,38,50-100,1928,5
STAT,1898,29,20-24,1927,18.16653945773082
STAT,1989,20,na,2009,6060.508291944208
SIM,1902,15,na,1917,4300
STAT,1866,50,35-39,1916,0.009341116416531155
STAT,1860,15,20-24,1875,19.243655803981856
STAT,1990,22,30-34,2012,47.657888448570674
SIM,1871,24,50-100,1895,1
SIM,1914,31,40-44,1945,7
SIM,1939,4,na,1943,5116
STAT,1957,36,15-19,1993,0.030130374230555926
SIM,1983,18,25-29,2001,177
STAT,1832,30,35-39,1862,9.406165051328427
STAT,1800,85,na,1885,122.53589683294415
STAT,1864,21,15-19,1885,3.479097436106513
SIM,1943,37,na,1980,5343
SIM,1832,31,na,1863,2308
STAT,1854,18,30-34,1872,1.5441912961044886
STAT,1887,27,25-29,1914,54.70940110938611
STAT,1829,43,40-44,1872,2.364098961513307
STAT,1813,49,15-19,1862,0.0012850925935269416
SIM,1791,75,na,1866,505
SIM,1872,21,15-19,1893,3
STAT,1893,24,15-19,1917,4.782221379032731
SIM,1852,7,na,1859,2530
STAT,1842,48,50-100,1890,0.18662066377726882
STAT,1957,34,50-100,1991,1.2806777966358946
STAT,1862,27,50-100,1889,0.6253138836433455
SIM,1837,25,40-44,1862,2
STAT,1945,35,40-44,1980,1.9476400320529081
STAT,1852,41,45-49,1893,1.4174371414959106
STAT,1835,39,na,1874,1616.305065787633
STAT,1884,56,na,1940,2325.6335089951303
SIM,1895,27,25-29,1922,5
STAT,1852,23,45-49,1875,0.7754052104368909
STAT,1921,49,15-19,1970,4.7625566074470035E-4
SIM,1866,41,40-44,1907,3
SIM,1975,27,30-34,2002,69
STAT,1913,18,na,1931,4547.700640756238
SIM,1979,33,25-29,2012,13
STAT,1947,22,50-100,1969,0.8581931609221563
STAT,1918,32,15-19,1950,0.15755594150905586
STAT,1877,52,30-34,1929,0.007107667550831279
STAT,1882,38,50-100,1920,1.3770657667804185
STAT,1906,31,40-44,1937,4.2077144310870445
STAT,1860,33,45-49,1893,1.615099505711555
SIM,1849,26,15-19,1875,1
STAT,1881,26,45-49,1907,1.2401520371369217
SIM,1970,16,50-100,1986,1
STAT,1848,43,45-49,1891,1.5787342500744248
SIM,1896,2,na,1898,4124
SIM,1874,32,35-39,1906,23
STAT,1829,25,40-44,1854,10.894579328845136
STAT,1983,28,25-29,2011,107.867281172667
STAT,1776,86,na,1862,98.32633807523125
SIM,1785,75,na,1860,552
STAT,1863,41,20-24,1904,0.1609849820564026
STAT,1873,18,35-39,1891,0.6449539388852518
STAT,1888,42,35-39,1930,2.453479617219803
SIM,1974,34,50-100,2008,2
SIM,1834,97,na,1931,2
SIM,1937,37,na,1974,4357
STAT,1887,23,50-100,1910,0.5257750399644078
SIM,1945,61,na,2006,4194
SIM,1862,18,30-34,1880,1
STAT,1870,54,40-44,1924,0.011648186430304656
STAT,1977,30,15-19,2007,0.20447965178847424
SIM,1848,46,na,1894,1664
STAT,1897,35,50-100,1932,1.9125643544615232
STAT,1876,21,na,1897,2829.9711886280475
SIM,1879,26,30-34,1905,33
STAT,1773,81,na,1854,360.0
SIM,1870,44,40-44,1914,2
STAT,1878,21,50-100,1899,0.49285280730156367
SIM,1939,28,15-19,1967,4
STAT,1881,50,30-34,1931,0.006721173845984096
SIM,1939,61,na,2000,4480
STAT,1885,111,na,1996,0.012552324544441383
SIM,1863,33,40-44,1896,7
STAT,1871,77,na,1948,992.4314127965224
STAT,1826,33,45-49,1859,1.560675344806311
STAT,1829,39,na,1868,1963.3650679916577
STAT,1879,36,30-34,1915,6.453152452005015
SIM,1888,32,35-39,1920,4
STAT,1879,19,45-49,1898,0.07829272013555283
STAT,1932,21,40-44,1953,5.107934449029706
STAT,1848,25,45-49,1873,1.4288162200784391
STAT,1872,48,45-49,1920,0.2700410687285578
STAT,1841,51,40-44,1892,0.009404813686239246
SIM,1940,21,40-44,1961,5
STAT,1931,43,na,1974,5718.0362661140625
SIM,1874,41,50-100,1915,1
SIM,1964,25,45-49,1989,6
STAT,1831,29,15-19,1860,0.46620050619808867
SIM,1816,38,25-29,1854,6
STAT,1855,33,40-44,1888,3.718463042445499
SIM,1896,24,35-39,1920,25
SIM,1779,75,na,1854,531
SIM,1832,62,na,1894,1483
STAT,1956,25,45-49,1981,2.65190190222553
SIM,1887,36,30-34,1923,13
STAT,1954,43,35-39,1997,0.29808268638847263
STAT,1975,17,20-24,1992,206.4094667981896
SIM,1899,23,45-49,1922,1
STAT,1913,39,15-19,1952,0.021661667427118347
SIM,1814,46,50-100,1860,1
STAT,1823,52,35-39,1875,0.008193249992378844
STAT,1842,24,50-100,1866,0.39013727817307264
STAT,1889,38,45-49,1927,2.821806996774238
SIM,1865,45,45-49,1910,1
STAT,1844,26,20-24,1870,12.098967383686052
SIM,1951,24,20-24,1975,199
STAT,1978,26,25-29,2004,104.15978190583323
SIM,1968,34,30-34,2002,2
SIM,1879,38,na,1917,2796
STAT,1947,17,15-19,1964,58.996391758702096
STAT,1819,53,20-24,1872,0.0013396291325216579
SIM,1871,58,na,1929,1738
STAT,1803,109,na,1912,2.4797188434220335E-4
SIM,1863,16,25-29,1879,7
STAT,1796,100,na,1896,0.2704062772639326
STAT,1874,57,na,1931,2374.272991774145
SIM,1954,12,na,1966,5539
STAT,1837,53,40-44,1890,0.0075010142682625175
STAT,1941,39,20-24,1980,0.3222203196907375
STAT,1846,14,na,1860,3072.0742381033356
STAT,1872,31,15-19,1903,0.16569671232428893
STAT,1943,24,20-24,1967,136.44819978710106
STAT,1857,45,45-49,1902,0.21423405848467578
STAT,1848,19,15-19,1867,7.724945311374278
STAT,1917,16,20-24,1933,33.752559340423545
SIM,1893,61,na,1954,2584
SIM,1886,19,30-34,1905,3
STAT,1855,16,25-29,1871,5.769022513201093
STAT,1932,24,45-49,1956,1.6983033473109177
SIM,1880,45,40-44,1925,1
STAT,1929,71,na,2000,4192.440974553055
STAT,1920,68,na,1988,3853.4899805318655
STAT,1951,20,na,1971,5038.498363260869
STAT,1829,30,na,1859,2117.456375727122
STAT,1869,42,30-34,1911,1.2832968754058105
SIM,1852,26,20-24,1878,25
SIM,1891,48,50-100,1939,1
SIM,1896,22,15-19,1918,7
SIM,1888,33,40-44,1921,7
STAT,1923,18,50-100,1941,0.5061890777980357
STAT,1928,23,na,1951,5245.46325809508
STAT,1967,44,50-100,2011,0.17541413401750144
SIM,1865,30,35-39,1895,1
STAT,1907,86,na,1993,1108.63076569845
STAT,1895,37,25-29,1932,4.325106894091484
STAT,1891,38,na,1929,3343.70561594789
SIM,1847,92,na,1939,225
STAT,1876,38,35-39,1914,8.395994032409185
SIM,1853,43,20-24,1896,4
SIM,1884,38,35-39,1922,1
STAT,1967,27,40-44,1994,6.748249942468932
STAT,1905,51,na,1956,3634.5495439046763
SIM,1856,43,45-49,1899,1
STAT,1917,34,20-24,1951,2.9224901402980956
SIM,1877,42,30-34,1919,1
STAT,1948,32,50-100,1980,1.1130228852992792
STAT,1892,29,25-29,1921,60.74891826557166
SIM,1946,39,50-100,1985,3
SIM,1906,76,na,1982,2105
STAT,1857,30,35-39,1887,9.35069833210973
STAT,1946,49,15-19,1995,4.8756602043062045E-4
STAT,1849,36,15-19,1885,0.045001030200994704
SIM,1923,20,na,1943,5225
STAT,1884,87,na,1971,514.8485506883708
SIM,1981,20,35-39,2001,18
SIM,1877,47,25-29,1924,1
STAT,1930,39,45-49,1969,1.0241400806192404
STAT,1986,20,45-49,2006,1.8576212516194184
STAT,1869,17,30-34,1886,1.8059886250582768
SIM,1882,30,40-44,1912,9
STAT,1870,16,20-24,1886,20.48296489125719
STAT,1833,26,45-49,1859,1.0568115878226476
SIM,1930,32,35-39,1962,34
STAT,1892,40,35-39,1932,2.645652139391125
STAT,1939,20,45-49,1959,1.3055018414447015
STAT,1852,101,na,1953,0.5379915873267612
STAT,1853,50,25-29,1903,0.003577172513929889
STAT,1817,43,15-19,1860,0.04147541884689357
SIM,1958,20,20-24,1978,5
STAT,1859,26,50-100,1885,0.6025492381604024
SIM,1986,26,25-29,2012,209
STAT,1888,33,50-100,1921,1.237710170787773
STAT,1949,27,20-24,1976,24.60577445143155
STAT,1821,43,35-39,1864,3.417062561107982
STAT,1953,26,35-39,1979,21.059825139762506
STAT,1869,47,25-29,1916,0.06407412212698482
SIM,1942,47,35-39,1989,1
STAT,1892,22,35-39,1914,8.44063875051172
STAT,1922,32,35-39,1954,11.91062400722601
SIM,1957,27,20-24,1984,29
SIM,1974,30,na,2004,6357
STAT,1975,40,na,2015,5892.49701034489
SIM,1857,40,50-100,1897,2
SIM,1961,26,35-39,1987,46
STAT,1971,41,na,2012,5649.6400585296615
STAT,1864,34,50-100,1898,0.9360541841933804
STAT,1868,45,20-24,1913,0.013437859262939446
STAT,1862,46,30-34,1908,0.09454432641523337
SIM,1877,17,30-34,1894,6
STAT,1839,47,50-100,1886,0.19844852458593482
SIM,1955,17,15-19,1972,73
SIM,1947,20,45-49,1967,4
STAT,1848,37,15-19,1885,0.061486757459377234
STAT,1833,22,50-100,1855,0.44081539639535594
STAT,1825,41,50-100,1866,1.604667768784279
SIM,1821,35,25-29,1856,1
STAT,1894,39,30-34,1933,7.827060789444527
STAT,1826,30,40-44,1856,4.612804558979956
SIM,1914,34,45-49,1948,2
STAT,1870,39,45-49,1909,2.2452112486263163
SIM,1959,40,25-29,1999,2
STAT,1841,48,15-19,1889,3.5270023242190665E-4
SIM,1889,31,35-39,1920,28
SIM,1921,25,na,1946,5044
STAT,1906,34,45-49,1940,1.6706365383443944
STAT,1986,24,30-34,2010,47.38583895439035
SIM,1949,37,40-44,1986,1
STAT,1795,101,na,1896,0.0999895512558607
SIM,1872,34,50-100,1906,2
SIM,1979,30,20-24,2009,5
STAT,1860,6,na,1866,2676.163141132237
SIM,1861,59,na,1920,1464
SIM,1860,74,na,1934,1444
STAT,1833,44,45-49,1877,1.25254004100312
SIM,1818,48,30-34,1866,1
SIM,1820,74,na,1894,1118
SIM,1866,44,45-49,1910,1
SIM,1994,20,45-49,2014,2
STAT,1939,6,na,1945,4621.8646872005365
STAT,1898,28,15-19,1926,0.7051400646626261
STAT,1916,17,20-24,1933,33.19875605309352
SIM,1839,40,35-39,1879,9
SIM,1855,28,na,1883,1962
SIM,1951,47,50-100,1998,1
STAT,1879,39,35-39,1918,8.437223664567332
STAT,1841,18,20-24,1859,20.209440591276476
SIM,1830,67,na,1897,1059
SIM,1929,27,15-19,1956,1
STAT,1832,46,15-19,1878,3.325772939360713E-4
SIM,1858,76,na,1934,1457
SIM,1952,44,50-100,1996,1
SIM,1829,38,35-39,1867,3
STAT,1915,49,20-24,1964,0.012778186413515844
STAT,1852,37,35-39,1889,6.704628692360937
STAT,1824,44,50-100,1868,1.4538205459000355
STAT,1866,36,20-24,1902,0.828516254450766
STAT,1839,69,na,1908,1163.8349618613613
STAT,1991,16,15-19,2007,75.0796931197791
SIM,1837,77,na,1914,987
SIM,1912,28,50-100,1940,1
SIM,1860,37,35-39,1897,12
STAT,1808,77,na,1885,482.6993036797284
SIM,1978,33,40-44,2011,7
STAT,1927,36,35-39,1963,3.472882121462311
SIM,1915,25,na,1940,4859
STAT,1940,46,15-19,1986,4.5022904693640655E-4
SIM,1841,26,45-49,1867,2
SIM,1834,30,40-44,1864,6
STAT,1918,15,50-100,1933,0.09483647325558911
STAT,1904,46,40-44,1950,0.16049379146270942
SIM,1887,39,35-39,1926,3
STAT,1872,45,40-44,1917,0.20036477022424862
STAT,1979,24,50-100,2003,1.048284970871472
SIM,1968,17,25-29,1985,159
SIM,1967,15,50-100,1982,3
STAT,1852,20,40-44,1872,2.3677832164158312
STAT,1874,33,45-49,1907,2.0515397239256186
SIM,1935,36,35-39,1971,2
SIM,1958,25,15-19,1983,1
STAT,1822,54,40-44,1876,0.018403373393049975
STAT,1845,43,20-24,1888,0.10759005257164408
STAT,1960,37,35-39,1997,3.745530920268507
SIM,1916,75,na,1991,2757
SIM,1837,23,20-24,1860,81
STAT,1883,17,45-49,1900,0.07375513641619517
STAT,1879,6,na,1885,3242.2043740285817
SIM,1848,42,35-39,1890,1
SIM,1869,19,25-29,1888,11
SIM,1904,10,na,1914,4453
STAT,1813,53,25-29,1866,0.011024629482559485
STAT,1888,22,15-19,1910,4.475372195309822
SIM,1824,67,na,1891,838
SIM,1980,23,25-29,2003,1
SIM,1947,40,35-39,1987,1
STAT,1892,82,na,1974,1260.608671609094
SIM,1841,44,45-49,1885,6
STAT,1930,36,40-44,1966,2.2557625505004766
SIM,1877,46,na,1923,3043
STAT,1842,16,15-19,1858,5.899099806544584
STAT,1923,17,na,1940,4986.055150726335
SIM,1849,28,na,1877,2781
SIM,1838,20,30-34,1858,30
STAT,1899,49,na,1948,3483.5335727744505
STAT,1906,16,45-49,1922,0.11019933747750722
STAT,1962,31,25-29,1993,13.93905954373799
SIM,1860,20,40-44,1880,3
STAT,1883,35,45-49,1918,2.272206871017478
SIM,1915,4,na,1919,5112
SIM,1900,88,na,1988,590
STAT,1801,67,na,1868,854.2948407743222
STAT,1886,82,na,1968,975.3915265719694
STAT,1902,18,na,1920,4107.534097186855
SIM,1972,23,50-100,1995,2
SIM,1883,46,na,1929,2414
SIM,1924,17,20-24,1941,358
STAT,1921,2,na,1923,5378.047216716731
STAT,1917,19,25-29,1936,53.3545666416788
STAT,1966,43,15-19,2009,0.0022967886833212938
SIM,1809,59,na,1868,1346
STAT,1845,69,na,1914,988.9113125635567
STAT,1939,40,35-39,1979,0.24251064748591258
STAT,1959,15,na,1974,5559.3333456176215
SIM,1891,35,45-49,1926,4
STAT,1921,34,40-44,1955,4.980923218771249
STAT,1913,86,na,1999,1213.2283040342568
SIM,1962,7,na,1969,5590
STAT,1868,49,30-34,1917,0.10508776472460542
SIM,1868,69,na,1937,1994
SIM,1871,43,40-44,1914,5
SIM,1838,41,35-39,1879,4
SIM,1887,20,15-19,1907,8
SIM,1908,32,25-29,1940,2
STAT,1952,28,40-44,1980,6.470836719125406
SIM,1899,36,20-24,1935,3
SIM,1897,30,50-100,1927,5
STAT,1889,30,50-100,1919,1.3138998642867978
STAT,1884,34,45-49,1918,1.9713192637859696
SIM,1956,28,20-24,1984,52
SIM,1939,31,40-44,1970,1
STAT,1857,19,50-100,1876,0.05114773880715913
STAT,1828,29,45-49,1857,1.462381383953415
STAT,1940,28,15-19,1968,0.8306423062854541
STAT,1934,23,na,1957,5664.518157743603
STAT,1879,16,40-44,1895,0.22094294871754994
SIM,1836,29,45-49,1865,2
STAT,1843,15,15-19,1858,7.700027823599241
SIM,1860,41,45-49,1901,3
SIM,1787,70,na,1857,1018
SIM,1960,28,40-44,1988,14
STAT,1819,51,30-34,1870,0.01124533131361567
STAT,1873,72,na,1945,1488.3088301531452
SIM,1850,59,na,1909,1215
STAT,1954,40,30-34,1994,0.19007546030271924
SIM,1979,19,50-100,1998,2
STAT,1860,77,na,1937,803.9786147382104
SIM,1933,30,50-100,1963,2
STAT,1877,35,15-19,1912,0.06805066390667326
STAT,1948,28,20-24,1976,24.20001597431063
SIM,1964,19,15-19,1983,71
SIM,1894,46,na,1940,3606
STAT,1866,32,35-39,1898,10.832536356497842
STAT,1902,36,35-39,1938,2.501343755535832
STAT,1949,22,na,1971,4917.5317578955555
STAT,1863,43,40-44,1906,2.2533708152425485
SIM,1948,12,na,1960,4469
STAT,1902,47,50-100,1949,0.22485215258660632
SIM,1853,41,30-34,1894,1
STAT,1892,26,20-24,1918,17.027006346735245
SIM,1940,57,na,1997,4696
STAT,1963,18,45-49,1981,0.7321733602152931
SIM,1968,29,na,1997,5140
SIM,1910,18,35-39,1928,1
STAT,1969,40,na,2009,5579.613478282833
SIM,1949,60,na,2009,5304
STAT,1902,18,35-39,1920,0.8923962798349786
STAT,1869,44,20-24,1913,0.17509497215427708
SIM,1835,42,25-29,1877,2
STAT,1956,19,15-19,1975,69.25729724214926
STAT,1920,21,15-19,1941,6.847212367651886
STAT,1965,15,na,1980,5305.902024010383
STAT,1861,32,20-24,1893,2.5933340842665564
SIM,1976,27,15-19,2003,1
STAT,1847,95,na,1942,10.23030984039363
STAT,1965,41,na,2006,5568.836745792709
STAT,1920,35,40-44,1955,1.8939809517207729
SIM,1892,34,45-49,1926,6
SIM,1912,30,25-29,1942,3
STAT,1827,42,25-29,1869,0.8564597978360944
STAT,1895,34,20-24,1929,4.0257486601559584
STAT,1845,41,30-34,1886,0.7990733256341785
STAT,1953,23,30-34,1976,40.24367462795479
SIM,1910,36,35-39,1946,4
STAT,1921,13,na,1934,5202.212060311891
STAT,1965,30,35-39,1995,13.43580050729886
SIM,1887,34,40-44,1921,12
SIM,1864,31,35-39,1895,24
SIM,1983,1,na,1984,7037
STAT,1868,57,na,1925,2228.213790874267
STAT,1834,85,na,1919,250.17524329074155
STAT,1858,44,45-49,1902,1.3292167701866253
SIM,1856,40,40-44,1896,4
STAT,1832,59,na,1891,1324.0633441426269
SIM,1888,36,45-49,1924,1
SIM,1813,67,na,1880,970
STAT,1871,52,35-39,1923,0.009831668692232167
STAT,1882,21,na,1903,2673.966906192188
SIM,1898,40,50-100,1938,1
STAT,1914,38,15-19,1952,0.0220277675449686
SIM,1965,21,40-44,1986,15
SIM,1961,23,30-34,1984,104
STAT,1817,100,na,1917,0.7339790370278987
STAT,1778,81,na,1859,262.0083861699845
SIM,1873,31,50-100,1904,2
STAT,1991,21,30-34,2012,47.707470582499816
SIM,1842,21,35-39,1863,1
STAT,1858,41,40-44,1899,2.0341541525378255
SIM,1865,42,40-44,1907,7
STAT,1850,47,na,1897,2305.2919467339275
STAT,1871,34,35-39,1905,11.527604454273186
STAT,1939,23,na,1962,4232.744235817551
STAT,1826,45,15-19,1871,2.9541953690721313E-4
SIM,1977,24,25-29,2001,160
STAT,1879,34,40-44,1913,5.1810838297117545
SIM,1801,79,na,1880,276
SIM,1906,18,15-19,1924,8
STAT,1854,19,45-49,1873,0.06291375808482322
STAT,1989,6,na,1995,6498.185483721425
STAT,1856,31,35-39,1887,9.119740932504431
STAT,1960,40,15-19,2000,0.0024054754729641117
SIM,1848,77,na,1925,284
STAT,1929,21,35-39,1950,13.783594026829478
STAT,1930,20,25-29,1950,137.39269751941762
STAT,1866,39,25-29,1905,3.0487709448144127
SIM,1928,20,na,1948,5544
SIM,1870,46,30-34,1916,1
SIM,1865,80,na,1945,660
SIM,1938,32,40-44,1970,13
STAT,1812,53,40-44,1865,0.022857959307613914
STAT,1893,64,na,1957,2593.8552350716695
STAT,1994,17,15-19,2011,75.57883006056085
STAT,1953,41,30-34,1994,0.1857497607115586
STAT,1920,17,40-44,1937,1.8102416504186725
SIM,1912,7,na,1919,4251
STAT,1927,33,30-34,1960,22.34745173919596
SIM,1937,21,35-39,1958,1
SIM,1846,11,na,1857,2061
SIM,1956,2,na,1958,5524
STAT,1904,49,45-49,1953,0.21600880008384712
STAT,1894,49,na,1943,3268.64541333317
SIM,1874,39,25-29,1913,1
STAT,1957,21,40-44,1978,5.134652145805642
STAT,1879,20,15-19,1899,3.999105658617519
STAT,1840,85,na,1925,219.91105766643528
STAT,1883,32,40-44,1915,4.896553145092136
SIM,1798,70,na,1868,911
STAT,1870,37,25-29,1907,3.2757322693351587
STAT,1974,18,20-24,1992,204.2370172820246
STAT,1818,54,20-24,1872,8.423117369239554E-4
STAT,1810,78,na,1888,425.73840913617954
STAT,1855,49,20-24,1904,0.009997554292374507
STAT,1944,21,30-34,1965,35.82601337966134
STAT,1938,23,35-39,1961,10.756225258933044
SIM,1859,58,na,1917,1746
STAT,1973,40,25-29,2013,0.11107076561038308
STAT,1910,104,na,2014,5.032451974273895
STAT,1949,48,25-29,1997,0.07384870864298826
STAT,1966,5,na,1971,5667.400282936501
STAT,1916,35,na,1951,4488.886921482809
STAT,1900,51,na,1951,3464.579532618518
STAT,1937,29,50-100,1966,1.119221741292748
STAT,1921,37,45-49,1958,0.8781288664060931
SIM,1891,32,40-44,1923,10
SIM,1996,14,na,2010,6931
SIM,1980,30,na,2010,5971
STAT,1926,22,25-29,1948,129.47801371901605
STAT,1897,82,na,1979,1411.6824148800763
SIM,1934,22,25-29,1956,156
STAT,1823,34,50-100,1857,2.074550945101708
SIM,1925,34,20-24,1959,2
STAT,1911,15,40-44,1926,0.3247907524848847
STAT,1821,41,15-19,1862,0.027233983368838352
SIM,1946,23,35-39,1969,1
STAT,1874,30,40-44,1904,5.164785964895761
STAT,1856,69,na,1925,1292.0975156214643
SIM,1828,66,na,1894,1434
SIM,1968,15,35-39,1983,5
SIM,1783,71,na,1854,791
STAT,1843,33,15-19,1876,0.17000570564712394
STAT,1910,18,30-34,1928,2.782795895596398
STAT,1878,50,25-29,1928,0.00432930061694751
STAT,1965,16,20-24,1981,195.38640543196138
SIM,1926,31,30-34,1957,36
SIM,1980,20,20-24,2000,312
SIM,1837,26,25-29,1863,58
STAT,1798,73,na,1871,455.3557354502437
STAT,1971,18,50-100,1989,0.5474460834523708
STAT,1896,101,na,1997,19.131053293713702
SIM,1820,35,40-44,1855,15
SIM,1843,24,20-24,1867,65
STAT,1905,17,45-49,1922,0.10910963815053688
STAT,1853,32,25-29,1885,10.501551213631625
STAT,1904,30,25-29,1934,17.110681855252544
STAT,1818,36,20-24,1854,1.4334095094105117
SIM,1838,23,35-39,1861,7
SIM,1973,31,30-34,2004,49
STAT,1845,46,25-29,1891,0.03892424260927961
STAT,1899,27,15-19,1926,0.7173356715459749
SIM,1859,80,na,1939,83
STAT,1972,43,45-49,2015,0.2551624913901167
STAT,1830,44,50-100,1874,0.9852096240832127
SIM,1858,48,35-39,1906,1
SIM,1844,59,na,1903,1772
SIM,1851,15,15-19,1866,9
SIM,1829,35,30-34,1864,5
SIM,1973,16,20-24,1989,355
STAT,1888,49,na,1937,2988.90742283909
STAT,1852,35,15-19,1887,0.05434756945824278
SIM,1981,22,25-29,2003,307
STAT,1858,16,50-100,1874,0.05182775420714085
STAT,1804,78,na,1882,415.0206608021143
STAT,1918,31,30-34,1949,19.395893375116433
SIM,1935,33,30-34,1968,10
STAT,1853,95,na,1948,13.237290460119642
STAT,1835,24,20-24,1859,56.813541377467
STAT,1829,26,25-29,1855,105.40621183072044
STAT,1874,94,na,1968,94.03536592098803
SIM,1912,76,na,1988,1846
STAT,1813,50,20-24,1863,0.0024388820880659142
STAT,1844,49,45-49,1893,0.1932742661699764
STAT,1844,44,20-24,1888,0.13260335135841286
STAT,1881,39,20-24,1920,0.8494183944702551
STAT,1951,15,15-19,1966,62.40053701485415
STAT,1835,42,20-24,1877,0.11875867628504091
SIM,1989,25,35-39,2014,59
SIM,1860,17,15-19,1877,13
SIM,1971,37,40-44,2008,4
STAT,1881,39,na,1920,2596.11238610914
SIM,1861,32,25-29,1893,4
STAT,1823,106,na,1929,0.0068756912860971665
SIM,1980,25,45-49,2005,2
STAT,1985,29,40-44,2014,7.676047956378941
STAT,1899,45,15-19,1944,3.602984210101224E-4
SIM,1865,58,na,1923,2540
STAT,1791,63,na,1854,933.0
STAT,1819,77,na,1896,575.4365861928151
STAT,1963,37,40-44,2000,2.2612118318472203
SIM,1836,26,40-44,1862,7
STAT,1858,64,na,1922,1565.0197395221965
STAT,1939,26,20-24,1965,21.195843767480415
SIM,1930,29,45-49,1959,1
STAT,1907,39,20-24,1946,0.2796673148325942
STAT,1882,40,40-44,1922,2.5610007447842955
SIM,1881,11,na,1892,2169
STAT,1981,17,15-19,1998,73.23572598325707
SIM,1899,39,25-29,1938,1
STAT,1954,16,45-49,1970,0.7128779481438825
SIM,1933,39,40-44,1972,5
STAT,1809,50,50-100,1859,0.038048419716619306
SIM,1962,16,45-49,1978,3
SIM,1924,39,30-34,1963,6
STAT,1916,39,30-34,1955,2.132470862938675
STAT,1863,46,45-49,1909,0.23882615019300285
STAT,1871,54,25-29,1925,0.0039548474070763345
STAT,1963,8,na,1971,5762.178756120178
SIM,1963,20,na,1983,6113
STAT,1899,86,na,1985,981.5255974543426
SIM,1850,24,50-100,1874,4
SIM,1953,16,35-39,1969,10
STAT,1873,40,30-34,1913,1.3685434971192532
STAT,1978,16,30-34,1994,19.202365635378293
STAT,1991,24,35-39,2015,15.613658639087515
STAT,1945,16,35-39,1961,5.291389040813807
SIM,1873,16,na,1889,3570
SIM,1947,26,20-24,1973,26
SIM,1904,19,na,1923,4379
SIM,1804,50,na,1854,1249
STAT,1840,34,40-44,1874,4.1502106239007155
SIM,1890,40,40-44,1930,5
STAT,1974,34,45-49,2008,2.4139680963030807
STAT,1870,17,35-39,1887,0.6302265556941314
STAT,1847,27,na,1874,2000.689561329182
STAT,1893,95,na,1988,156.83130135549345
SIM,1969,11,na,1980,5830
STAT,1923,16,15-19,1939,61.62844331295049
STAT,1891,60,na,1951,2720.2450391683615
STAT,1892,14,na,1906,3723.336868120824
SIM,1869,32,30-34,1901,22
STAT,1881,76,na,1957,1136.4102794634996
STAT,1922,29,45-49,1951,2.238943660890167
STAT,1817,109,na,1926,4.918749047084087E-4
STAT,1935,42,50-100,1977,0.19133750751663536
STAT,1889,56,na,1945,2901.520671487819
STAT,1926,42,15-19,1968,0.002184371186220421
STAT,1824,30,na,1854,1801.4669217975584
SIM,1875,8,na,1883,3613
STAT,1831,34,30-34,1865,17.414368081596542
STAT,1844,27,35-39,1871,9.879754819225905
SIM,1912,14,na,1926,4187
SIM,1852,27,35-39,1879,23
STAT,1854,46,35-39,1900,0.11438140845920322
SIM,1808,74,na,1882,696
SIM,1931,16,15-19,1947,74
STAT,1995,15,50-100,2010,0.6262076299191424
STAT,1809,52,20-24,1861,0.0017836398303055258
STAT,1874,46,20-24,1920,0.014217619562368562
STAT,1942,12,na,1954,4744.790467265961
STAT,1786,85,na,1871,146.74392463101083
SIM,1909,56,na,1965,4450
STAT,1988,21,25-29,2009,153.01391230586435
SIM,1884,53,na,1937,2426
SIM,1959,8,na,1967,6029
STAT,1897,51,na,1948,3338.6148816820587
STAT,1919,26,35-39,1945,18.780782381435916
STAT,1851,43,15-19,1894,0.010872014989928989
SIM,1851,66,na,1917,1906
STAT,1899,33,45-49,1932,2.7454707242648593
STAT,1875,43,50-100,1918,1.2508183014418912
STAT,1937,69,na,2006,3442.0159179337284
STAT,1960,34,30-34,1994,24.107693720877002
STAT,1880,51,50-100,1931,0.018562698520672133
SIM,1967,39,40-44,2006,3
STAT,1863,21,30-34,1884,18.465350623856462
STAT,1780,94,na,1874,5.8569285876235355
STAT,1894,23,15-19,1917,4.879108304557866
SIM,1896,33,50-100,1929,1
SIM,1823,42,35-39,1865,2
STAT,1890,28,45-49,1918,1.560149734824473
STAT,1929,20,20-24,1949,163.25188359928632
STAT,1811,54,50-100,1865,0.04318228359368711
SIM,1871,21,30-34,1892,41
SIM,1911,98,na,2009,78
STAT,1880,36,35-39,1916,8.693531223620639
STAT,1959,44,20-24,2003,0.02761347971685052
SIM,1922,41,40-44,1963,1
STAT,1856,50,40-44,1906,0.009402261716207139
STAT,1879,32,na,1911,2875.549870771747
SIM,1907,23,45-49,1930,3
STAT,1861,17,25-29,1878,6.248858149743307
STAT,1896,46,40-44,1942,0.14761985398272076
SIM,1963,27,15-19,1990,3
STAT,1878,22,20-24,1900,83.03649264568908
STAT,1905,20,35-39,1925,9.805289564738283
STAT,1877,33,25-29,1910,12.243794589550129
SIM,1830,29,40-44,1859,8
SIM,1886,22,20-24,1908,2
STAT,1818,37,35-39,1855,11.661724262571862
STAT,1999,13,na,2012,6695.945883159578
STAT,1945,64,na,2009,4266.191431461344
SIM,1885,33,25-29,1918,19
STAT,1902,33,30-34,1935,28.350159608866576
STAT,1952,32,15-19,1984,0.18115217345992343
SIM,1910,33,30-34,1943,2
STAT,1781,101,na,1882,0.10267076293801461
SIM,1929,70,na,1999,3747
STAT,1878,19,na,1897,3026.9228585485503
STAT,1772,99,na,1871,0.0444445539698551
STAT,1815,42,35-39,1857,4.0467194373976625
STAT,1900,29,25-29,1929,67.25547212477612
STAT,1955,27,15-19,1982,1.0862033985493351
SIM,1936,47,40-44,1983,1
SIM,1917,51,na,1968,5155
STAT,1895,15,15-19,1910,8.956254169902296
STAT,1873,41,na,1914,2736.097030380732
SIM,1839,34,40-44,1873,7
SIM,1845,66,na,1911,1469
SIM,1975,29,20-24,2004,31
STAT,1834,21,35-39,1855,7.173731537820054
STAT,1866,99,na,1965,8.27698059156438
SIM,1841,22,50-100,1863,1
STAT,1815,48,50-100,1863,0.49408322204432426
STAT,1969,42,25-29,2011,0.1069847303764204
SIM,1826,34,30-34,1860,28
STAT,1838,48,45-49,1886,0.20767406322298748
STAT,1845,91,na,1936,39.048420712637665
SIM,1952,24,35-39,1976,28
STAT,1895,28,50-100,1923,0.9575582610660434
STAT,1940,34,45-49,1974,1.877642553592624
STAT,1934,44,30-34,1978,0.2047949569837763
STAT,1929,37,15-19,1966,0.028453075377583233
SIM,1894,83,na,1977,1488
SIM,1872,35,40-44,1907,11
SIM,1822,44,40-44,1866,9
SIM,1930,33,na,1963,5946
SIM,1883,38,20-24,1921,1
STAT,1829,48,35-39,1877,0.14096369932954994
STAT,1891,39,15-19,1930,0.07928815908818858
SIM,1840,29,na,1869,2029
STAT,1904,28,50-100,1932,1.0563789162637343
STAT,1890,19,na,1909,3542.3091201249235
SIM,1813,44,30-34,1857,1
STAT,1850,32,45-49,1882,1.877928633757947
SIM,1853,61,na,1914,1802
STAT,1964,23,50-100,1987,0.9592530129573181
SIM,1946,20,30-34,1966,71
STAT,1988,16,45-49,2004,0.8247444229726192
STAT,1917,17,na,1934,4796.608187359305
SIM,1936,24,na,1960,4023
STAT,1850,45,20-24,1895,0.012476510576550689
STAT,1945,21,15-19,1966,6.735116896792403
STAT,1854,16,40-44,1870,0.1793083183530561
SIM,1927,26,35-39,1953,2
SIM,1817,37,25-29,1854,4
SIM,1836,31,20-24,1867,10
SIM,1898,33,35-39,1931,20
STAT,1887,25,35-39,1912,12.563844073027886
STAT,1906,47,20-24,1953,0.011338246053567074
STAT,1968,27,25-29,1995,95.28426148670609
STAT,1918,20,45-49,1938,1.4085239554938789
SIM,1965,24,45-49,1989,2
STAT,1944,47,na,1991,4746.000909284708
SIM,1984,9,na,1993,6303
STAT,1942,29,30-34,1971,47.420421696861865
SIM,1897,26,na,1923,3846
SIM,1895,25,35-39,1920,25
SIM,1834,29,na,1863,1883
SIM,1904,36,40-44,1940,6
SIM,1986,18,40-44,2004,3
SIM,1829,42,na,1871,1645
STAT,1828,31,20-24,1859,3.222882619783664
STAT,1957,24,45-49,1981,1.7165147553067557
SIM,1950,29,30-34,1979,2
STAT,1860,51,45-49,1911,0.013562705254338735
SIM,1987,24,50-100,2011,1
STAT,1939,36,50-100,1975,0.5003359729130838
STAT,1881,28,35-39,1909,10.702696480512428
SIM,1891,35,na,1926,3378
STAT,1854,21,20-24,1875,66.44287770465628
STAT,1857,24,40-44,1881,1.939460022615257
STAT,1822,35,na,1857,2406.8736288939276
SIM,1973,34,35-39,2007,43
STAT,1933,29,20-24,1962,27.95589034800918
STAT,1914,44,45-49,1958,0.18977450736511045
SIM,1835,42,na,1877,2160
SIM,1875,11,na,1886,3531
STAT,1950,45,25-29,1995,0.07564340912637671
SIM,1797,63,na,1860,904
SIM,1959,34,30-34,1993,4
SIM,1986,24,35-39,2010,2
STAT,1875,76,na,1951,1129.8692572632413
STAT,1884,19,na,1903,2864.3056084740424
STAT,1885,18,25-29,1903,6.505933271778551
STAT,1835,27,25-29,1862,34.4920090917818
STAT,1938,20,30-34,1958,32.86593138431098
SIM,1901,33,20-24,1934,1
STAT,1833,38,15-19,1871,0.049270791682164854
SIM,1961,25,na,1986,5208
STAT,1845,19,35-39,1864,0.46184320298153164
STAT,1875,38,20-24,1913,0.9147510689654076
SIM,1962,21,25-29,1983,150
SIM,1843,27,25-29,1870,7
STAT,1913,55,na,1968,4010.4080926276456
STAT,1766,106,na,1872,0.031084919290839355
SIM,1952,18,40-44,1970,4
STAT,1839,91,na,1930,45.955503444519735
STAT,1944,18,40-44,1962,1.7366291352999315
STAT,1857,100,na,1957,1.3341074863676465
SIM,1967,16,na,1983,5418
STAT,1848,40,na,1888,2516.3924069421328
STAT,1918,34,35-39,1952,11.108381051138045
SIM,1941,29,20-24,1970,38
STAT,1857,4,na,1861,2815.774596717503
STAT,1928,26,45-49,1954,2.464655703396757
STAT,1814,44,40-44,1858,6.625696469243013
SIM,1893,18,25-29,1911,14
STAT,1932,37,20-24,1969,0.4088472396800335
STAT,1828,26,40-44,1854,7.622329852495155
STAT,1860,37,30-34,1897,4.957086411429041
SIM,1987,21,15-19,2008,9
STAT,1871,111,na,1982,0.006361332257517815
SIM,1862,21,20-24,1883,5
STAT,1868,27,20-24,1895,13.00745339102898
STAT,1824,42,45-49,1866,2.129816639170532
STAT,1968,44,30-34,2012,0.190871478440217
SIM,1814,74,na,1888,519
STAT,1895,56,na,1951,3063.9218502764907
STAT,1954,21,25-29,1975,132.25945008383997
SIM,1926,34,35-39,1960,17
SIM,1925,19,25-29,1944,80
STAT,1979,21,15-19,2000,8.48919564047704
STAT,1919,31,15-19,1950,0.16061477008664807
SIM,1910,19,na,1929,3838
STAT,1828,26,na,1854,1828.584875544358
SIM,1832,42,45-49,1874,5
STAT,1946,49,50-100,1995,0.299365788023852
STAT,1886,26,50-100,1912,0.781376985216958
SIM,1831,27,35-39,1858,10
STAT,1951,40,15-19,1991,0.0021992843272760684
SIM,1915,56,na,1971,4235
STAT,1861,22,na,1883,2331.0779552019076
STAT,1909,28,30-34,1937,43.11112454251727
SIM,1852,29,50-100,1881,1
SIM,1869,35,35-39,1904,4
STAT,1844,29,50-100,1873,0.6456234545381743
STAT,1917,4,na,1921,4996.178232194842
STAT,1954,29,20-24,1983,26.12893294328251
SIM,1887,37,50-100,1924,5
STAT,1918,28,40-44,1946,5.703145178594781
STAT,1943,31,na,1974,4721.045927034467
STAT,1844,24,30-34,1868,18.335704892877903
STAT,1851,37,20-24,1888,0.6178252710024984
STAT,1774,94,na,1868,0.1692824563102266
STAT,1779,113,na,1892,1.6704387201315327E-4
STAT,1941,37,30-34,1978,2.2325542497288993
SIM,1868,23,50-100,1891,1
STAT,1886,14,na,1900,3133.5397384222024
STAT,1951,29,na,1980,5165.235413250365
STAT,1926,19,35-39,1945,5.90414738275831
STAT,1939,64,na,2003,3910.8277989739117
STAT,1978,24,35-39,2002,14.868666865711965
STAT,1831,39,50-100,1870,1.1891263390914564
STAT,1840,40,35-39,1880,1.708397674736707
SIM,1844,19,25-29,1863,18
SIM,1917,28,30-34,1945,1
SIM,1913,44,35-39,1957,1
STAT,1966,28,na,1994,5420.531664585124
STAT,1993,19,20-24,2012,224.9574959244405
STAT,1973,25,50-100,1998,1.4933241702883882
STAT,1904,44,na,1948,3791.5793115337488
STAT,1814,50,35-39,1864,0.02382005993621873
STAT,1865,49,15-19,1914,4.078058323146197E-4
STAT,1899,30,40-44,1929,6.911768998838767
STAT,1905,20,na,1925,3973.9637774476464
SIM,1931,49,na,1980,6024
STAT,1974,31,40-44,2005,6.014544504969063
SIM,1833,47,na,1880,1488
STAT,1928,23,40-44,1951,4.829709729652824
SIM,1825,31,45-49,1856,3
SIM,1909,18,30-34,1927,3
STAT,1890,25,40-44,1915,4.252762883994119
STAT,1893,43,20-24,1936,0.015970979395138873
STAT,1871,51,20-24,1922,8.512783503450878E-4
SIM,1923,51,na,1974,5190
STAT,1875,44,15-19,1919,0.01624723164184089
STAT,1905,44,35-39,1949,0.20720228228159787
SIM,1926,28,40-44,1954,18
STAT,1911,18,45-49,1929,0.1151577182817116
STAT,1836,19,25-29,1855,7.497920232246435
SIM,1994,10,na,2004,6225
STAT,1851,91,na,1942,45.95231904248937
STAT,1975,37,30-34,2012,2.8587381807524914
SIM,1978,22,50-100,2000,5
STAT,1935,18,30-34,1953,19.18968754540446
STAT,1793,67,na,1860,751.567004739161
SIM,1886,25,25-29,1911,82
SIM,1953,21,15-19,1974,3
STAT,1900,26,20-24,1926,18.8506953443192
SIM,1936,23,40-44,1959,4
SIM,1875,42,na,1917,3050
SIM,1903,22,30-34,1925,83
STAT,1855,38,35-39,1893,5.988466496487473
STAT,1845,24,15-19,1869,2.720301614473431
SIM,1852,24,30-34,1876,24
SIM,1982,31,40-44,2013,15
SIM,1839,37,45-49,1876,2
STAT,1834,47,30-34,1881,0.09368507841188284
STAT,1938,45,45-49,1983,0.25869072080562
STAT,1928,31,25-29,1959,13.344706241779033
STAT,1842,38,25-29,1880,2.572234894881821
SIM,1850,38,25-29,1888,5
SIM,1889,25,40-44,1914,1
STAT,1864,64,na,1928,1791.2767846914767
SIM,1928,21,25-29,1949,170
STAT,1867,53,20-24,1920,7.823334224941078E-4
STAT,1856,38,na,1894,2064.0297797473313
SIM,1962,42,na,2004,5490
SIM,1827,29,35-39,1856,4
SIM,1899,21,na,1920,4441
STAT,1974,24,15-19,1998,8.042688421261682
STAT,1869,25,15-19,1894,0.5105018023214042
STAT,1980,19,20-24,1999,217.05780670962213
SIM,1854,5,na,1859,3366
SIM,1896,10,na,1906,4056
SIM,1884,18,15-19,1902,12
STAT,1976,29,30-34,2005,60.61281704615506
SIM,1860,43,na,1903,2345
SIM,1946,45,45-49,1991,2
SIM,1973,37,50-100,2010,3
STAT,1901,18,20-24,1919,28.582781387179278
SIM,1792,88,na,1880,6
SIM,1878,53,na,1931,2522
SIM,1943,18,30-34,1961,28
STAT,1944,24,35-39,1968,11.725105868735902
STAT,1825,77,na,1902,611.4089947947728
SIM,1958,39,40-44,1997,1
SIM,1863,38,50-100,1901,2
SIM,1918,23,20-24,1941,258
SIM,1957,1,na,1958,6329
STAT,1949,45,20-24,1994,0.015500651397181615
SIM,1844,22,15-19,1866,8
STAT,1931,34,35-39,1965,13.80407201090161
STAT,1967,41,45-49,2008,0.24969250374870214
STAT,1887,22,30-34,1909,23.037035695233307
STAT,1964,35,45-49,1999,1.0226306141269732
STAT,1967,45,na,2012,5534.58749734745
STAT,1809,53,na,1862,1336.2281277982097
STAT,1952,42,na,1994,5337.769227536612
STAT,1928,47,40-44,1975,0.23215325361464048
SIM,1922,38,na,1960,5011
STAT,1936,33,40-44,1969,4.38649759261384
SIM,1937,20,20-24,1957,219
STAT,1934,47,35-39,1981,0.2074037587674256
STAT,1843,21,45-49,1864,0.8845919536849518
SIM,1851,21,45-49,1872,5
STAT,1902,23,50-100,1925,0.6628997550443538
STAT,1959,39,50-100,1998,0.6515834124563447
SIM,1858,28,15-19,1886,1
SIM,1829,73,na,1902,638
STAT,1918,96,na,2014,180.7965412201357
STAT,1771,104,na,1875,0.04018328797217868
STAT,1850,48,25-29,1898,0.05855103394133172
SIM,1956,44,45-49,2000,1
SIM,1944,33,40-44,1977,8
STAT,1997,15,40-44,2012,2.358339442943667
STAT,1910,44,na,1954,4005.0518586602866
STAT,1865,46,na,1911,2349.3116136873414
STAT,1911,20,na,1931,4205.2632192972815
SIM,1826,37,35-39,1863,14
SIM,1876,27,20-24,1903,26
SIM,1984,29,30-34,2013,111
STAT,1981,28,50-100,2009,1.6123787760145796
STAT,1840,54,na,1894,1679.7754967383598
SIM,1895,22,30-34,1917,39
STAT,1915,47,30-34,1962,0.1036851074927049
SIM,1930,18,20-24,1948,218
STAT,1968,24,20-24,1992,160.69782362332492
STAT,1914,41,40-44,1955,0.28657376868052503
STAT,1948,34,15-19,1982,0.17276874797113248
STAT,1919,74,na,1993,3173.405859463083
STAT,1841,32,35-39,1873,10.924387555868107
STAT,1922,18,20-24,1940,180.5206757458651
STAT,1845,16,30-34,1861,1.365531670346624
SIM,1871,24,35-39,1895,3
STAT,1878,25,25-29,1903,51.3171385017598
SIM,1902,83,na,1985,899
SIM,1813,98,na,1911,8
SIM,1913,6,na,1919,5131
STAT,1787,67,na,1854,580.0
STAT,1838,45,40-44,1883,0.15655473087328095
STAT,1931,78,na,2009,3258.151187597384
STAT,1855,22,na,1877,2125.4211703510277
STAT,1963,15,40-44,1978,2.0518294706100786
STAT,1944,20,50-100,1964,0.8204880786637199
STAT,1954,37,40-44,1991,2.2002999591981083
STAT,1968,19,40-44,1987,2.0147766011210697
SIM,1908,29,35-39,1937,1
SIM,1901,36,25-29,1937,2
STAT,1863,24,35-39,1887,5.920060032559958
STAT,1885,15,20-24,1900,20.502292792380544
SIM,1982,2,na,1984,6833
STAT,1871,46,na,1917,2590.4354145997
STAT,1946,25,50-100,1971,1.2806540455205018
STAT,1815,53,na,1868,1530.168743322707
STAT,1842,89,na,1931,80.84133609326592
STAT,1895,32,30-34,1927,26.227847360333953
STAT,1933,41,45-49,1974,0.26438972761531976
STAT,1968,47,35-39,2015,0.19330291454946688
SIM,1893,15,20-24,1908,48
STAT,1925,74,na,1999,3545.032799271827
SIM,1962,37,40-44,1999,5
SIM,1903,37,na,1940,3835
SIM,1918,67,na,1985,3006
STAT,1864,35,40-44,1899,4.55360014459194
STAT,1946,42,na,1988,4940.28670126596
STAT,1919,2,na,1921,5214.617213115882
STAT,1871,29,50-100,1900,0.729198461508686
SIM,1976,19,40-44,1995,4
STAT,1940,31,40-44,1971,4.678257645700346
SIM,1881,40,30-34,1921,2
STAT,1894,17,20-24,1911,26.300971361398705
SIM,1872,38,45-49,1910,1
STAT,1816,48,25-29,1864,0.11571292892823778
SIM,1841,41,40-44,1882,5
STAT,1931,28,50-100,1959,1.4826098328494692
SIM,1970,23,40-44,1993,7
STAT,1857,27,45-49,1884,1.0279064145087367
STAT,1897,44,35-39,1941,0.1914246400585605
SIM,1848,15,na,1863,2227
STAT,1962,23,40-44,1985,4.986628758326258
STAT,1958,49,30-34,2007,0.13972293590059884
SIM,1827,47,na,1874,1405
STAT,1994,20,50-100,2014,1.1001691895283143
STAT,1800,54,na,1854,1488.7757920979254
STAT,1864,38,45-49,1902,2.0439828940671827
STAT,1887,46,30-34,1933,0.12554911590003595
STAT,1926,28,na,1954,5163.244922986727
STAT,1833,41,40-44,1874,1.95662942026904
STAT,1857,88,na,1945,123.3919567995739
STAT,1862,107,na,1969,0.056814326024939826
SIM,1907,22,50-100,1929,1
STAT,1856,47,15-19,1903,3.505375365362624E-4
SIM,1923,25,20-24,1948,3
STAT,1915,81,na,1996,2026.3093640554018
STAT,1953,48,35-39,2001,0.1866995898654182
SIM,1812,48,na,1860,1544
STAT,1838,19,na,1857,2595.5136159655904
STAT,1899,18,na,1917,3982.699098100337
SIM,1870,26,40-44,1896,1
STAT,1884,46,15-19,1930,4.573829291883095E-4
STAT,1972,42,30-34,2014,0.19631735460568675
SIM,1971,32,50-100,2003,7
STAT,1937,25,40-44,1962,5.250873061606053
STAT,1858,33,na,1891,2139.296338100991
SIM,1949,43,50-100,1992,1
SIM,1913,42,45-49,1955,1
SIM,1881,42,na,1923,1849
SIM,1959,53,na,2012,5674
STAT,1887,47,45-49,1934,0.3038012601386574
STAT,1810,48,20-24,1858,0.045696617765963295
STAT,1921,15,35-39,1936,5.543461794061564
SIM,1900,38,30-34,1938,7
STAT,1775,79,na,1854,356.0
STAT,1862,26,40-44,1888,2.949408713713705
STAT,1973,26,20-24,1999,27.37487917485162
SIM,1914,71,na,1985,2899
SIM,1902,52,na,1954,3690
STAT,1861,54,30-34,1915,0.005553872476344473
STAT,1795,93,na,1888,6.216594629580347
STAT,1967,35,15-19,2002,0.028569637871857945
STAT,1901,24,15-19,1925,5.29943104439664
STAT,1832,28,na,1860,1931.6519229160956
STAT,1909,26,40-44,1935,5.207983770154817
SIM,1945,25,40-44,1970,6
SIM,1826,31,na,1857,2178
STAT,1950,39,30-34,1989,2.5567481707350743
STAT,1893,41,50-100,1934,1.548038912104403
STAT,1806,73,na,1879,516.7579702129154
STAT,1842,35,20-24,1877,0.7104561051683658
STAT,1905,42,45-49,1947,0.17338248002341342
STAT,1920,21,50-100,1941,0.8463798709424472
STAT,1882,52,na,1934,2414.162312750406
STAT,1833,46,50-100,1879,0.20646874087429348
STAT,1876,18,15-19,1894,7.061244521860833
SIM,1919,18,na,1937,5591
STAT,1901,38,40-44,1939,1.5197509408203584
STAT,1928,25,30-34,1953,56.08565588969869
SIM,1868,60,na,1928,2512
SIM,1831,24,30-34,1855,21
STAT,1852,54,20-24,1906,6.765884594505768E-4
STAT,1976,35,25-29,2011,1.5666953920689812
SIM,1914,5,na,1919,4390
STAT,1855,35,30-34,1890,4.5779826066868505
STAT,1917,44,50-100,1961,0.1410194258955988
STAT,1902,41,15-19,1943,0.001570819952043179
STAT,1807,51,40-44,1858,0.042195567922073254
STAT,1965,6,na,1971,5663.877708596009
STAT,1868,28,35-39,1896,10.660761039107063
STAT,1938,42,40-44,1980,0.29605873192328913
SIM,1851,35,na,1886,2838
SIM,1917,26,40-44,1943,11
SIM,1858,34,45-49,1892,4
SIM,2011,1,na,2012,7169
STAT,1787,98,na,1885,0.4779007335962365
STAT,1923,24,35-39,1947,12.55974558116517
STAT,1855,53,na,1908,1802.7041268814694
STAT,1919,48,45-49,1967,0.27122743156774365
SIM,1931,24,35-39,1955,15
STAT,1915,85,na,2000,1406.4016720007075
STAT,1924,49,30-34,1973,0.12172695916044142
SIM,1967,25,25-29,1992,103
STAT,1954,15,30-34,1969,17.39857511491371
SIM,1874,0,na,1874,4261
STAT,1888,40,na,1928,3167.0061563685917
SIM,1884,21,40-44,1905,3
STAT,1831,35,45-49,1866,2.0126689052804263
STAT,1891,112,na,2003,0.00631579267023322
SIM,1850,50,na,1900,1433
STAT,1894,15,30-34,1909,2.3755539332900697
SIM,1845,34,35-39,1879,25
SIM,1813,47,35-39,1860,1
STAT,1870,40,15-19,1910,0.015870314668482776
STAT,1882,37,15-19,1919,0.06329826437727393
SIM,1979,25,40-44,2004,1
SIM,1962,15,30-34,1977,45
STAT,1930,15,45-49,1945,0.748876701545011
STAT,1851,60,na,1911,1512.3836182984464
SIM,1877,23,25-29,1900,1
SIM,1909,24,25-29,1933,15
STAT,1898,47,20-24,1945,0.01050825602558121
STAT,1890,31,35-39,1921,14.338739018830049
STAT,1836,22,15-19,1858,3.963771519329649
STAT,1871,15,na,1886,2953.1278081519617
STAT,1933,35,15-19,1968,0.03025128372540541
SIM,1910,23,50-100,1933,2
SIM,1903,25,35-39,1928,34
STAT,1843,65,na,1908,1695.676220061005
SIM,1947,65,na,2012,4950
STAT,1970,33,30-34,2003,23.185803311578027
STAT,1910,43,30-34,1953,0.13874405883688423
STAT,1972,20,30-34,1992,42.63801224142751
SIM,1883,43,50-100,1926,5
SIM,1880,26,35-39,1906,3
STAT,1867,22,45-49,1889,0.7544511951308194
STAT,1902,49,na,1951,3592.7225673893286
STAT,1928,54,na,1982,5268.374761331274
STAT,1985,1,na,1986,6463.049626344954
SIM,1918,24,35-39,1942,31
SIM,1767,87,na,1854,106
STAT,1907,55,na,1962,3664.6538658131312
STAT,1903,93,na,1996,318.48696815410807
STAT,1964,32,40-44,1996,5.798012517863914
STAT,1887,24,20-24,1911,88.56816931446026
SIM,1824,36,na,1860,1651
SIM,1950,35,25-29,1985,3
STAT,1837,34,35-39,1871,9.005433904141256
STAT,1936,36,45-49,1972,0.7735183398203372
STAT,1959,25,25-29,1984,99.87702221416527
SIM,1895,24,20-24,1919,207
STAT,1981,30,50-100,2011,1.3615292142216489
STAT,1945,38,45-49,1983,0.8845147672227468
STAT,1953,40,50-100,1993,0.17091628759044872
STAT,1939,48,30-34,1987,0.10685970673179322
SIM,1845,35,na,1880,2155
SIM,1858,23,20-24,1881,1
SIM,1919,35,40-44,1954,7
STAT,1895,25,na,1920,3609.337984616764
STAT,1894,40,na,1934,3463.4127734806725
SIM,1876,25,30-34,1901,68
STAT,1988,18,35-39,2006,6.923698344610335
STAT,1925,47,25-29,1972,0.07415624769944004
SIM,1844,50,na,1894,2076
SIM,1953,38,45-49,1991,1
STAT,1942,35,25-29,1977,1.2257037336817558
STAT,1858,22,35-39,1880,6.027766224373284
STAT,1946,30,30-34,1976,20.579300915740987
SIM,1963,32,30-34,1995,8
SIM,1894,27,40-44,1921,7
STAT,1916,47,15-19,1963,4.360779733773291E-4
STAT,1941,15,20-24,1956,161.2825782320342
SIM,1952,17,na,1969,4834
SIM,1970,26,45-49,1996,5
STAT,1883,48,20-24,1931,0.013378862932724656
SIM,1973,32,45-49,2005,3
SIM,1813,42,40-44,1855,1
STAT,1859,52,50-100,1911,0.013810116971192294
SIM,1885,27,30-34,1912,49
SIM,1905,34,35-39,1939,1
SIM,1830,35,35-39,1865,5
STAT,1877,27,30-34,1904,30.22948370991105
STAT,1822,35,35-39,1857,18.67001285254611
SIM,1972,35,na,2007,5765
STAT,1955,30,40-44,1985,6.1180308528668
SIM,1937,6,na,1943,4537
STAT,1951,37,25-29,1988,1.3940116545660772
STAT,1864,33,na,1897,2448.577336913164
STAT,1916,45,25-29,1961,0.06309083068160419
SIM,1944,36,45-49,1980,2
STAT,1874,26,na,1900,2829.227244831705
STAT,1819,48,40-44,1867,0.3248929650684127
STAT,1836,24,50-100,1860,0.4829488939480186
STAT,1955,32,30-34,1987,24.60350319097223
SIM,1954,19,20-24,1973,7
SIM,1966,31,na,1997,5752
STAT,1825,47,20-24,1872,0.016757114945603814
SIM,1907,93,na,2000,384
SIM,1954,30,30-34,1984,67
STAT,1962,26,45-49,1988,2.566778297658033
SIM,1862,78,na,1940,1131
STAT,1831,32,40-44,1863,4.416220310905909
STAT,1886,27,40-44,1913,3.646533330596023
STAT,1907,45,15-19,1952,3.86938864942419E-4
SIM,1945,32,na,1977,4668
SIM,1920,71,na,1991,2931
SIM,1883,77,na,1960,1019
STAT,1864,41,35-39,1905,1.8743807341017666
STAT,1887,30,15-19,1917,0.1856595798621339
STAT,1802,80,na,1882,356.11165976466776
STAT,1942,5,na,1947,4814.844809051245
STAT,1881,9,na,1890,2888.1616064967893
STAT,1929,42,30-34,1971,0.19107810919198717
SIM,1814,43,na,1857,1481
SIM,1912,22,40-44,1934,8
SIM,1844,36,40-44,1880,2
STAT,1831,37,35-39,1868,6.9942095626205605
STAT,1859,25,20-24,1884,11.130190123943482
STAT,1932,18,15-19,1950,69.18679476190039
STAT,1827,72,na,1899,1025.6227041645714
STAT,1974,23,na,1997,5519.357055518378
SIM,1872,41,35-39,1913,7
SIM,1990,16,40-44,2006,8
STAT,1946,19,20-24,1965,173.4184096037696
STAT,1816,45,20-24,1861,0.02522208125395658
SIM,1958,0,na,1958,6254
STAT,1847,53,35-39,1900,0.006517918168564087
STAT,1872,104,na,1976,1.4525191793921497
STAT,1845,38,40-44,1883,3.067313625251646
STAT,1897,41,30-34,1938,0.12375401870541414
SIM,1925,18,na,1943,4949
SIM,1952,18,50-100,1970,1
STAT,1835,53,50-100,1888,0.00941659956863122
STAT,1904,22,40-44,1926,3.453328004969688
STAT,1986,0,na,1986,6513.370906313617
STAT,1847,103,na,1950,0.11042825720001041
STAT,1931,32,45-49,1963,2.380050634582497
STAT,1899,42,50-100,1941,0.11584798024546775
SIM,1900,57,na,1957,3089
STAT,1938,47,na,1985,4352.300803205317
SIM,1946,17,na,1963,4385
STAT,1812,73,na,1885,551.0016190661006
SIM,1820,43,na,1863,1906
STAT,1964,7,na,1971,5713.235999942745
STAT,1878,47,35-39,1925,0.16790731950360577
STAT,1915,25,20-24,1940,21.636394776999786
STAT,1935,16,40-44,1951,2.2133026169600702
SIM,1819,44,35-39,1863,1
STAT,1836,36,40-44,1872,4.942749105604408
SIM,1853,38,40-44,1891,13
SIM,1921,56,na,1977,4917
STAT,1980,27,na,2007,6027.588322248257
STAT,1807,58,na,1865,1427.3636641705766
STAT,1911,41,25-29,1952,0.07917608060663006
STAT,1934,54,na,1988,5755.648087321505
STAT,1832,52,45-49,1884,0.010479839024318944
STAT,1962,48,45-49,2010,0.33334845984762773
STAT,1837,34,na,1871,1927.2038697534965
STAT,1971,31,25-29,2002,13.778681703347514
SIM,1877,77,na,1954,981
SIM,1876,7,na,1883,3080
SIM,1954,47,na,2001,5376
STAT,1904,107,na,2011,0.6447431761196767
STAT,1862,29,45-49,1891,1.0736315129382952
STAT,1887,44,40-44,1931,2.86977362644331
STAT,1955,57,na,2012,5597.239338013201
SIM,1881,36,50-100,1917,1
STAT,1976,37,15-19,2013,0.03050328026804461
STAT,1991,22,45-49,2013,1.8670526352486452
SIM,1928,29,20-24,1957,57
STAT,1847,50,30-34,1897,0.004646034729179125
STAT,1984,23,15-19,2007,8.750978273119665
SIM,1913,93,na,2006,955
SIM,1937,40,40-44,1977,1
SIM,1958,31,45-49,1989,6
STAT,1827,106,na,1933,0.009860513925614973
STAT,1913,27,45-49,1940,1.9876331205958049
STAT,1887,49,35-39,1936,0.10000334533001329
STAT,1910,26,15-19,1936,0.7902346532362252
SIM,1943,19,45-49,1962,1
STAT,1853,27,na,1880,2495.073184327543
SIM,1945,31,35-39,1976,12
SIM,1817,54,na,1871,1297
STAT,1976,32,20-24,2008,3.833375055594401
SIM,1795,68,na,1863,852
STAT,1861,53,na,1914,2032.5965699147241
STAT,1962,45,40-44,2007,0.24363432275550387
SIM,1930,26,40-44,1956,18
STAT,1882,43,45-49,1925,1.674848493056485
STAT,1868,26,na,1894,2655.180422088083
STAT,1891,42,40-44,1933,3.204233222506473
STAT,1971,28,45-49,1999,2.53488677275306
SIM,1869,34,20-24,1903,6
STAT,1863,23,20-24,1886,70.41691109930055
STAT,1876,16,25-29,1892,6.776890589775941
STAT,1803,100,na,1903,0.37002531159295465
SIM,1981,3,na,1984,6483
STAT,1848,71,na,1919,1418.2626356079625
SIM,1921,27,45-49,1948,5
STAT,1909,29,45-49,1938,1.8939072474327099
SIM,1847,61,na,1908,1966
SIM,1967,19,30-34,1986,26
STAT,1970,36,35-39,2006,3.6031652616253975
STAT,1922,26,40-44,1948,6.104964669246131
STAT,1935,19,45-49,1954,0.7842996727017835
STAT,1810,46,30-34,1856,0.38499593156536727
STAT,1873,43,35-39,1916,2.118609939227106
SIM,1882,49,25-29,1931,1
SIM,1890,43,45-49,1933,5
SIM,1960,9,na,1969,6323
STAT,1872,23,30-34,1895,20.577132574139828
STAT,1895,35,35-39,1930,10.725791698691808
STAT,1938,20,50-100,1958,0.752425250657336
SIM,1827,32,25-29,1859,20
STAT,1873,36,50-100,1909,1.45384631189106
SIM,1881,43,35-39,1924,3
STAT,1896,49,45-49,1945,0.19868175109296488
STAT,1831,46,na,1877,1917.207203322475
STAT,1959,47,25-29,2006,0.08329124243452227
SIM,1839,15,35-39,1854,1
STAT,1987,8,na,1995,6474.853838137814
SIM,1931,21,30-34,1952,58
STAT,1968,17,50-100,1985,0.5400339348894833
SIM,1926,20,45-49,1946,4
STAT,1942,37,15-19,1979,0.023864233407049622
SIM,1963,35,35-39,1998,3
SIM,1863,38,35-39,1901,10
SIM,1963,30,40-44,1993,2
STAT,1894,18,35-39,1912,0.8118987626360996
STAT,1929,40,40-44,1969,0.37487368303958696
STAT,1896,30,25-29,1926,15.73815618658405
STAT,1959,19,30-34,1978,18.387605222723973
STAT,1964,29,15-19,1993,1.0295311150717439
STAT,1850,16,na,1866,2904.6985305913604
SIM,1866,22,35-39,1888,16
STAT,1881,25,30-34,1906,28.220874952193427
STAT,1889,25,na,1914,3418.0273794537775
SIM,1900,22,15-19,1922,6
SIM,1798,79,na,1877,493
STAT,1923,21,30-34,1944,38.69548942936096
STAT,1790,87,na,1877,59.96494948608457
STAT,1868,25,30-34,1893,28.110299561204744
STAT,1892,48,30-34,1940,0.07798764552585565
STAT,1846,33,30-34,1879,21.109719363943828
SIM,1886,21,50-100,1907,1
SIM,1888,15,na,1903,2999
STAT,1856,53,45-49,1909,0.012572288898034353
SIM,1870,29,45-49,1899,1
SIM,1849,32,45-49,1881,4
STAT,1770,111,na,1881,5.836033831774547E-4
STAT,1906,28,15-19,1934,0.7608352457258329
SIM,1893,30,na,1923,3543
STAT,1807,48,15-19,1855,0.001631057838430753
STAT,1840,37,45-49,1877,1.8914364060283901
STAT,1871,28,40-44,1899,3.4271796051370838
STAT,1963,21,35-39,1984,13.855444447263856
STAT,1876,52,na,1928,2555.009104239173
STAT,1909,81,na,1990,1849.5414208907737
STAT,1865,52,40-44,1917,0.010903622714828136
SIM,1866,34,na,1900,2499
SIM,1858,26,25-29,1884,89
STAT,1838,31,50-100,1869,0.9966876325255204
STAT,1925,44,20-24,1969,0.02458496213855852
STAT,1988,15,30-34,2003,20.128800211953113
STAT,1968,25,35-39,1993,21.753203427931993
SIM,1853,22,25-29,1875,134
SIM,1865,89,na,1954,133
SIM,1853,6,na,1859,2936
SIM,1905,31,30-34,1936,36
STAT,1962,39,na,2001,5719.148852364318
SIM,1950,32,20-24,1982,6
SIM,1918,29,50-100,1947,1
STAT,1829,45,30-34,1874,0.10141414048395446
SIM,1948,43,na,1991,4371
STAT,1921,85,na,2006,1572.540871795828
STAT,1898,16,45-49,1914,0.10213245034480078
SIM,1865,45,50-100,1910,1
SIM,1846,31,50-100,1877,3
SIM,1925,81,na,2006,1971
SIM,1859,37,30-34,1896,3
SIM,1903,19,40-44,1922,1
SIM,1918,26,25-29,1944,1
STAT,1837,31,30-34,1868,16.01721463580405
STAT,1910,46,35-39,1956,0.1393113987677906
SIM,1854,33,30-34,1887,43
SIM,1822,47,45-49,1869,1
SIM,1955,36,20-24,1991,1
SIM,1913,22,25-29,1935,217
SIM,1887,42,25-29,1929,2
STAT,1970,45,50-100,2015,0.3414650374809299
STAT,1814,47,45-49,1861,0.65613677355877
STAT,1825,46,na,1871,1846.7707143379641
STAT,1955,35,35-39,1990,3.824246737051267
STAT,1828,34,25-29,1862,11.089944531137341
STAT,1904,30,50-100,1934,1.530624991178331
STAT,1857,45,50-100,1902,0.2229486638873877
STAT,1845,22,25-29,1867,47.88866670717192
STAT,1824,61,na,1885,1221.9810914949967
STAT,1916,42,20-24,1958,0.020887968842380693
SIM,1899,17,15-19,1916,11
SIM,1979,31,35-39,2010,36
STAT,1880,1,na,1881,4161.4064984131755
SIM,1912,30,50-100,1942,1
STAT,1833,72,na,1905,888.6659302953268
STAT,1823,49,45-49,1872,0.22673860938203924
SIM,1818,49,45-49,1867,1
SIM,1897,1,na,1898,4349
SIM,1990,19,45-49,2009,1
SIM,1862,24,25-29,1886,158
STAT,1982,19,45-49,2001,0.8106728402116806
STAT,1846,45,na,1891,2349.032794583648
SIM,1845,31,30-34,1876,23
STAT,1976,21,45-49,1997,1.7410997756495021
STAT,1876,24,45-49,1900,0.8266821152560324
STAT,1950,23,15-19,1973,7.285318505769815
SIM,1878,40,25-29,1918,3
STAT,1946,33,35-39,1979,11.915624556064754
STAT,1947,36,20-24,1983,0.3533677936538082
SIM,1904,20,25-29,1924,186
SIM,1894,15,na,1909,4105
SIM,1927,44,na,1971,4970
SIM,1801,70,na,1871,779
STAT,1962,35,na,1997,5741.278272138564
STAT,1839,60,na,1899,1512.4884234000208
STAT,1854,24,25-29,1878,54.01373613796778
SIM,1876,28,35-39,1904,26
STAT,1900,82,na,1982,1500.0900100159643
SIM,1842,24,na,1866,2204
STAT,1941,36,na,1977,4612.6951982402725
STAT,1892,101,na,1993,17.445065182638537
STAT,1843,52,20-24,1895,7.364726609276527E-4
STAT,1951,34,20-24,1985,3.4123564106025763
SIM,1917,29,45-49,1946,6
SIM,1831,30,25-29,1861,2
SIM,1863,23,na,1886,2644
SIM,1933,44,na,1977,6364
STAT,1933,49,40-44,1982,0.248855065798755
STAT,1956,38,20-24,1994,0.4143084895241811
STAT,1810,47,na,1857,1667.7059376560117
STAT,1920,37,na,1957,4751.685319515328
STAT,1937,31,35-39,1968,10.44552828606982
SIM,1836,34,25-29,1870,2
SIM,1936,25,30-34,1961,6
STAT,1830,61,na,1891,1172.2266242569144
SIM,1912,45,na,1957,3638
SIM,1960,47,na,2007,6114
SIM,1844,16,20-24,1860,36
STAT,1838,51,35-39,1889,0.007567351836157634
SIM,1789,68,na,1857,1089
STAT,1819,46,na,1865,1818.1112282335491
SIM,1941,49,40-44,1990,1
STAT,1977,38,na,2015,6037.717405788796
STAT,1891,34,50-100,1925,1.2956688952430808
SIM,1904,39,45-49,1943,1
STAT,1874,49,25-29,1923,0.06663049977908185
STAT,1919,23,30-34,1942,36.19950568802728
STAT,1836,39,45-49,1875,2.1818590589013103
STAT,1969,22,15-19,1991,7.699411204279986
STAT,1929,45,35-39,1974,0.19377606469417724
STAT,1868,28,50-100,1896,0.7067735794775705
STAT,1904,25,45-49,1929,1.852498916537469
STAT,1942,32,20-24,1974,2.999039980605041
STAT,1951,33,50-100,1984,1.1574489791611806
SIM,1927,23,30-34,1950,51
STAT,1876,21,40-44,1897,2.493445149096469
SIM,1881,29,20-24,1910,8
SIM,1845,36,25-29,1881,4
STAT,1905,22,25-29,1927,95.61862295509026
SIM,1867,28,25-29,1895,5
SIM,1899,8,na,1907,4545
SIM,1928,29,na,1957,5309
SIM,1802,55,na,1857,1222
STAT,1936,16,25-29,1952,48.026303317962956
STAT,1920,40,20-24,1960,0.02256221415261601
SIM,1857,23,na,1880,2620
STAT,1980,30,20-24,2010,3.9877608276925676
SIM,1959,37,35-39,1996,6
STAT,1837,36,25-29,1873,2.5649050888626017
SIM,1968,20,15-19,1988,9
STAT,1935,36,na,1971,6079.9736797784
SIM,1944,16,25-29,1960,77
SIM,1828,43,30-34,1871,3
SIM,1954,43,na,1997,5448
STAT,1859,28,25-29,1887,39.27510440013608
STAT,1880,35,30-34,1915,6.5812744671002505
STAT,1958,12,na,1970,5954.036332177099
STAT,1843,36,na,1879,2535.008629549216
STAT,1914,48,30-34,1962,0.10179552120122061
SIM,1938,44,na,1982,4037
SIM,1969,31,30-34,2000,80
STAT,1866,27,20-24,1893,12.548686116802083
STAT,1885,44,20-24,1929,0.18034354437058214
SIM,1934,30,na,1964,5826
STAT,1995,18,35-39,2013,7.007566937076489
SIM,1864,48,45-49,1912,1
STAT,1979,35,40-44,2014,2.454879035165133
STAT,1877,25,30-34,1902,30.434570453321914
SIM,1785,77,na,1862,499
SIM,1899,35,50-100,1934,2
STAT,1845,42,25-29,1887,0.44064747546352867
STAT,1866,39,15-19,1905,0.05946185196802651
STAT,1865,46,45-49,1911,0.24643412419758234
SIM,1830,81,na,1911,361
SIM,1836,25,35-39,1861,16
SIM,1865,29,20-24,1894,26
SIM,1885,25,30-34,1910,4
STAT,1929,21,25-29,1950,135.21599956931146
STAT,1921,67,na,1988,4014.4662117586245
SIM,1928,23,25-29,1951,10
STAT,1861,18,30-34,1879,1.7472516216774823
STAT,1856,48,45-49,1904,0.20517519110521765
SIM,1834,95,na,1929,11
STAT,1824,50,40-44,1874,0.014366792962537765
STAT,1870,16,30-34,1886,1.8415045853716492
STAT,1964,41,30-34,2005,0.1933955106598242
SIM,1873,46,45-49,1919,1
STAT,1836,44,25-29,1880,0.677882346432773
SIM,1835,46,25-29,1881,1
STAT,1820,34,20-24,1854,9.201746766294134
STAT,1815,52,40-44,1867,0.020656325538181083
STAT,1818,37,na,1855,1362.706082903668
SIM,1909,31,na,1940,4750
SIM,1854,29,45-49,1883,1
STAT,1980,24,25-29,2004,148.37165668500515
SIM,1839,39,20-24,1878,3
STAT,1896,45,35-39,1941,0.12157549357600686
SIM,1917,30,50-100,1947,1
SIM,1853,42,25-29,1895,2
SIM,1990,15,na,2005,5540
STAT,1939,41,na,1980,4466.823120340328
SIM,1900,18,na,1918,3835
STAT,1881,53,na,1934,2358.2711689565353
STAT,1885,67,na,1952,1824.7589266730572
STAT,1846,29,45-49,1875,1.3686999045785773
SIM,1837,22,50-100,1859,1
SIM,1894,23,30-34,1917,46
STAT,1835,28,30-34,1863,20.37186875129521
SIM,1959,22,15-19,1981,9
SIM,1834,40,50-100,1874,2
SIM,1938,30,30-34,1968,35
STAT,1892,37,na,1929,3407.766276740303
STAT,1875,37,15-19,1912,0.06696967305258415
STAT,1879,53,35-39,1932,0.010207511898949353
STAT,1889,19,15-19,1908,8.397035183703593
SIM,1969,39,40-44,2008,6
STAT,1968,41,15-19,2009,0.0023037220007997824
SIM,1842,16,20-24,1858,41
STAT,1969,26,25-29,1995,95.34134762226981
SIM,1917,82,na,1999,2034
STAT,1843,47,20-24,1890,0.011984438280062987
STAT,1857,29,20-24,1886,10.705446650878054
STAT,1871,37,30-34,1908,6.11902876577242
SIM,1919,25,25-29,1944,173
STAT,1792,70,na,1862,989.9402108137131
STAT,1966,30,40-44,1996,5.7562740955428415
STAT,1827,46,25-29,1873,0.07393644068528388
STAT,1848,67,na,1915,1684.337867776625
SIM,1937,21,25-29,1958,14
SIM,1843,28,30-34,1871,3
STAT,1886,23,30-34,1909,21.6160900750812
STAT,1831,35,35-39,1866,7.140980207566001
STAT,1881,17,45-49,1898,0.07271238125499599
STAT,1993,15,20-24,2008,225.22764815638922
SIM,1983,19,20-24,2002,7
SIM,1876,27,30-34,1903,62
STAT,1876,46,20-24,1922,0.014356391853393177
STAT,1882,38,45-49,1920,2.2359425610934225
SIM,1821,39,35-39,1860,2
SIM,1890,30,35-39,1920,26
STAT,1867,38,na,1905,2525.946987552687
STAT,1957,52,na,2009,5716.526902431592
SIM,1890,38,45-49,1928,7
SIM,1902,31,50-100,1933,4
SIM,1840,44,40-44,1884,3
STAT,1892,29,15-19,1921,0.6515605845923305
STAT,1894,42,20-24,1936,0.016340776494813695
STAT,1978,26,35-39,2004,23.758783076634053
STAT,1818,108,na,1926,8.104665884945215E-4
STAT,1850,40,40-44,1890,2.338872418999924
STAT,1882,30,35-39,1912,11.50713917043678
STAT,1837,53,30-34,1890,0.004241227701595955
SIM,1872,34,35-39,1906,22
STAT,1894,17,30-34,1911,2.3645678064124938
SIM,1964,20,30-34,1984,3
SIM,1872,25,45-49,1897,1
SIM,1986,23,30-34,2009,114
STAT,1899,26,20-24,1925,18.61190349692811
STAT,1818,48,25-29,1866,0.07008340231989268
STAT,1970,34,50-100,2004,1.2159220729042575
SIM,1830,38,na,1868,1955
STAT,1832,44,40-44,1876,1.8621186186024128
SIM,1855,57,na,1912,1555
SIM,1861,36,25-29,1897,3
STAT,1855,37,na,1892,2004.6904712806727
SIM,1852,26,30-34,1878,61
SIM,1877,39,40-44,1916,14
STAT,1910,83,na,1993,1593.8349899569148
SIM,1822,43,35-39,1865,7
SIM,1831,55,na,1886,1390
SIM,1837,60,na,1897,1692
SIM,1857,35,20-24,1892,1
STAT,1854,15,35-39,1869,0.5411120740299915
STAT,1829,37,45-49,1866,2.2877438249085196
STAT,1869,39,40-44,1908,4.843094361876542
STAT,1865,18,15-19,1883,6.330239696117644
STAT,1872,92,na,1964,126.84710041359014
STAT,1965,21,35-39,1986,13.615397803457332
STAT,1838,32,40-44,1870,4.668728588690481
STAT,1956,20,30-34,1976,44.06547555571644
STAT,1864,25,45-49,1889,1.1563312167788151
STAT,1805,62,na,1867,1128.2051147678792
SIM,1826,48,25-29,1874,1
STAT,1844,108,na,1952,0.0015320950555673242
STAT,1849,53,50-100,1902,0.011517714225598077
SIM,1828,39,45-49,1867,4
STAT,1978,23,30-34,2001,45.401171631143086
SIM,1837,37,45-49,1874,8
STAT,1814,43,35-39,1857,5.710509116084814
STAT,1844,30,15-19,1874,0.14542827927430166
SIM,1883,30,50-100,1913,3
STAT,1859,54,20-24,1913,6.597179649724158E-4
SIM,1852,38,25-29,1890,3
STAT,1809,76,na,1885,453.73398610626367
STAT,1937,15,25-29,1952,48.90481553745116
STAT,1869,43,25-29,1912,0.7124956771269674
STAT,1987,21,30-34,2008,47.523312368345564
STAT,1857,52,45-49,1909,0.012974473252522382
SIM,1888,52,na,1940,2456
STAT,1849,35,20-24,1884,0.6241892114095463
SIM,1910,45,50-100,1955,1
STAT,1839,28,15-19,1867,0.4500236273997407
STAT,1853,36,25-29,1889,2.8965042750790437
STAT,1862,16,50-100,1878,0.05497155017540097
SIM,1850,26,na,1876,1767
STAT,1879,28,45-49,1907,1.333226689349352
SIM,2012,2,na,2014,7648
SIM,1946,31,na,1977,4636
SIM,1936,67,na,2003,3269
SIM,1877,43,25-29,1920,2
STAT,1844,38,25-29,1882,2.5185443225572612
STAT,1932,29,50-100,1961,1.5034101532908561
SIM,1975,21,45-49,1996,1
STAT,1823,46,40-44,1869,0.17153957617573573
STAT,1930,28,na,1958,5495.259813529249
STAT,1867,104,na,1971,0.8365542114557678
STAT,1854,40,25-29,1894,0.5284423056203016
STAT,1984,17,20-24,2001,222.21674791015374
STAT,1970,35,20-24,2005,0.3930165718292139
STAT,1855,27,45-49,1882,0.984746375551836
SIM,1958,46,na,2004,6074
STAT,1841,45,45-49,1886,0.2162471049058731
STAT,1949,65,na,2014,4470.816124078196
STAT,1891,36,45-49,1927,2.857031509903627
STAT,1955,46,35-39,2001,0.2059636217475343
STAT,1818,40,15-19,1858,0.019525052491206996
SIM,1992,17,20-24,2009,265
SIM,1846,32,40-44,1878,1
SIM,1863,27,45-49,1890,1
SIM,1864,40,35-39,1904,2
STAT,1881,51,25-29,1932,0.003961582029802705
STAT,1860,91,na,1951,53.89776578998221
STAT,1983,11,na,1994,6413.847866816477
STAT,1937,50,na,1987,4244.009734620881
STAT,1954,20,20-24,1974,159.2717874486986
STAT,1819,52,25-29,1871,0.0065595278341506235
STAT,1890,24,35-39,1914,8.177215054324487
STAT,1851,36,15-19,1887,0.04547692120586652
SIM,1817,38,30-34,1855,6
STAT,1856,54,na,1910,1843.6229306756056
STAT,1892,40,45-49,1932,2.186635275572079
STAT,1895,29,40-44,1924,4.467750337934619
STAT,1959,43,15-19,2002,0.002405381696950405
STAT,1797,58,na,1855,1226.46789
STAT,1880,36,na,1916,2895.7993057962717
SIM,1862,15,35-39,1877,1
SIM,1970,13,na,1983,6043
STAT,1881,47,40-44,1928,0.1896792656518649
SIM,1977,28,35-39,2005,37
STAT,1851,23,na,1874,2010.2487151083349
STAT,1840,33,35-39,1873,9.792697532981787
SIM,1901,7,na,1908,4514
STAT,1844,26,30-34,1870,25.970783667222715
STAT,1939,31,35-39,1970,10.77107098752884
SIM,1882,41,40-44,1923,6
SIM,1908,14,na,1922,4344
STAT,1874,41,40-44,1915,2.669424835436822
STAT,1942,29,na,1971,4533.7500022182385
STAT,1950,38,50-100,1988,0.5896430913109623
SIM,1878,44,50-100,1922,3
SIM,1842,39,na,1881,2296
STAT,1967,21,45-49,1988,1.6279092638494517
SIM,1845,36,50-100,1881,5
STAT,1940,3,na,1943,4734.737146565485
SIM,1868,33,30-34,1901,42
SIM,1942,1,na,1943,5186
STAT,1854,45,30-34,1899,0.0796488950118785
SIM,1928,19,40-44,1947,4
STAT,1840,30,30-34,1870,17.417454829927493
STAT,1974,30,35-39,2004,14.052845740869877
SIM,1830,25,40-44,1855,6
STAT,1909,20,45-49,1929,1.2154017308077734
SIM,1871,20,na,1891,2099
SIM,1943,15,15-19,1958,115
SIM,1947,31,35-39,1978,1
STAT,1896,33,40-44,1929,6.582500808498098
SIM,1875,18,25-29,1893,8
STAT,1886,35,25-29,1921,3.53816508011859
SIM,1905,49,na,1954,3765
STAT,1825,41,45-49,1866,2.273279345625437
SIM,1884,49,25-29,1933,1
STAT,1834,109,na,1943,6.492786016619913E-4
STAT,1834,75,na,1909,939.4877007032521
SIM,1894,35,25-29,1929,1
SIM,1901,35,na,1936,4123
STAT,1964,44,35-39,2008,0.3031617491168667
STAT,1830,44,30-34,1874,1.072139887384435
STAT,1870,28,25-29,1898,47.95794141526869
STAT,1876,41,15-19,1917,0.016549379415593382
STAT,1867,43,15-19,1910,0.014772442288740837
STAT,1868,55,na,1923,2292.613860311025
STAT,1978,21,20-24,1999,175.7648870786656
STAT,1985,21,20-24,2006,183.17729372601224
SIM,1880,20,25-29,1900,150
STAT,1864,41,na,1905,2392.373709219374
SIM,1844,73,na,1917,1088
SIM,1867,90,na,1957,161
SIM,1870,22,30-34,1892,1
STAT,1981,34,na,2015,6213.069464313014
STAT,1833,58,na,1891,1391.5833363005456
SIM,1870,34,25-29,1904,22
SIM,1905,81,na,1986,1089
SIM,1771,85,na,1856,15
STAT,1985,29,30-34,2014,64.52790742132461
SIM,1994,17,30-34,2011,1
STAT,1928,30,20-24,1958,3.523652187752337
STAT,1844,51,20-24,1895,6.201655941353058E-4
SIM,1982,30,35-39,2012,38
SIM,1859,35,30-34,1894,9
STAT,1863,24,na,1887,2399.327829574074
SIM,1891,19,20-24,1910,54
STAT,1935,15,15-19,1950,71.9706583720259
SIM,1923,22,50-100,1945,5
SIM,1968,16,30-34,1984,1
STAT,1836,41,20-24,1877,0.17421734697905755
STAT,1835,53,20-24,1888,4.600944596804092E-4
STAT,2010,4,na,2014,7170.419381483893
STAT,1838,89,na,1927,90.9984145880889
STAT,1883,19,20-24,1902,19.909800186594723
STAT,1943,20,45-49,1963,1.382604702448134
SIM,1846,21,na,1867,1918
STAT,1826,34,15-19,1860,0.12194591988833595
STAT,1876,49,25-29,1925,0.06728085246758199
SIM,1833,41,45-49,1874,2
SIM,1819,38,40-44,1857,1
SIM,1878,52,30-34,1930,1
STAT,1867,18,25-29,1885,6.205229119808922
STAT,1919,32,20-24,1951,3.0362420207120735
SIM,1864,103,na,1967,2
SIM,1928,20,20-24,1948,147
SIM,1919,22,20-24,1941,7
SIM,1927,32,20-24,1959,2
SIM,1868,49,50-100,1917,2
SIM,1936,30,20-24,1966,2
STAT,1894,45,25-29,1939,0.04868251682471751
STAT,1852,24,15-19,1876,3.64209785416301
STAT,1986,17,30-34,2003,20.04318147667333
STAT,1901,79,na,1980,1884.59880237951
STAT,1971,10,na,1981,5743.187564209396
STAT,1821,46,30-34,1867,0.1776254492395035
STAT,1957,23,50-100,1980,1.0041612931256247
SIM,1842,19,25-29,1861,16
STAT,1804,54,30-34,1858,0.026319431058765996
STAT,1815,40,na,1855,1822.7722057652843
SIM,1920,35,50-100,1955,1
STAT,1814,40,30-34,1854,5.138484294215202
SIM,1835,69,na,1904,1203
SIM,1903,90,na,1993,497
SIM,1849,28,25-29,1877,89
STAT,1957,46,45-49,2003,0.3448285127428221
SIM,1843,56,na,1899,1609
STAT,1945,22,20-24,1967,140.64175766923609
STAT,1975,24,na,1999,5574.329246424416
STAT,1877,50,20-24,1927,8.985613531641308E-4
STAT,1890,45,40-44,1935,0.24381935789655798
STAT,1968,37,30-34,2005,2.70654023989047
STAT,1818,36,30-34,1854,9.910460533834895
SIM,1824,45,50-100,1869,1
SIM,1953,22,20-24,1975,272
SIM,1990,15,45-49,2005,1
STAT,1963,23,na,1986,5370.04450132996
STAT,1816,45,50-100,1861,0.5162119092261309
STAT,1871,75,na,1946,1181.9525518715413
SIM,1890,35,40-44,1925,12
STAT,1845,17,35-39,1862,0.46733216312905546
SIM,1876,51,na,1927,2427
SIM,1938,33,35-39,1971,8
SIM,1987,22,50-100,2009,1
STAT,1875,89,na,1964,280.10032091694046
SIM,1838,34,na,1872,1853
STAT,1870,20,15-19,1890,3.7757742316672225
STAT,1934,10,na,1944,6206.757507949658
SIM,1979,28,45-49,2007,7
SIM,1826,36,30-34,1862,10
STAT,1893,33,15-19,1926,0.20685608190527954
STAT,1854,48,35-39,1902,0.11262444038986838
SIM,1836,22,30-34,1858,1
STAT,1836,32,30-34,1868,20.091836808554753
STAT,1860,34,15-19,1894,0.131320586184081
STAT,1989,24,45-49,2013,1.8647747080832728
SIM,1844,32,30-34,1876,18
STAT,1931,45,na,1976,5696.877625546858
STAT,1871,41,15-19,1912,0.0159271715222938
STAT,1935,59,na,1994,5631.4655293115775
SIM,1920,40,50-100,1960,1
SIM,1839,44,50-100,1883,2
STAT,1970,23,50-100,1993,0.9533872487481431
SIM,1865,35,na,1900,2984
SIM,1873,86,na,1959,294
STAT,1769,111,na,1880,0.0018028029876975618
STAT,1819,54,na,1873,1597.2714163266223
STAT,1938,24,na,1962,4170.152757838864
STAT,1950,48,40-44,1998,0.223153710699184
SIM,1869,49,na,1918,1808
STAT,1820,37,25-29,1857,6.318100458089691
SIM,1862,48,35-39,1910,1
SIM,1822,40,30-34,1862,3
STAT,1944,46,50-100,1990,0.2929174673688643
STAT,1878,113,na,1991,0.0013463342893241998
STAT,1846,76,na,1922,979.4089380893741
STAT,1905,106,na,2011,1.3230775228679676
STAT,1842,62,na,1904,1406.4852351248348
STAT,1832,47,45-49,1879,0.19371753831614041
SIM,1856,74,na,1930,1000
STAT,1828,50,25-29,1878,0.0032777578083333578
SIM,1925,30,45-49,1955,9
SIM,1861,33,20-24,1894,1
SIM,1852,60,na,1912,1424
STAT,1872,53,25-29,1925,0.004038590322563128
STAT,1913,16,na,1929,4570.845487118749
STAT,1863,43,30-34,1906,1.151761290120223
STAT,1882,35,40-44,1917,4.9812493045059805
SIM,1898,28,20-24,1926,2
SIM,1985,8,na,1993,6448
SIM,1797,78,na,1875,225
SIM,1986,26,35-39,2012,54
SIM,1837,34,40-44,1871,2
STAT,1956,23,35-39,1979,14.421565470849666
STAT,1799,92,na,1891,18.708281981718084
SIM,1871,43,30-34,1914,3
SIM,1969,28,40-44,1997,10
STAT,1849,38,25-29,1887,2.2599021373965296
STAT,1890,15,50-100,1905,0.06940541418723414
SIM,1857,38,25-29,1895,2
STAT,1887,47,35-39,1934,0.18022108677417717
STAT,1918,23,15-19,1941,6.6037256065381635
STAT,1834,44,15-19,1878,0.014808712898210879
SIM,1879,91,na,1970,192
STAT,1943,46,na,1989,4688.521000810612
STAT,1869,40,20-24,1909,0.17928171012317093
STAT,1808,54,15-19,1862,1.1262524196388346E-4
SIM,1839,19,na,1858,2563
STAT,1856,24,50-100,1880,0.4110234711384533
STAT,1829,34,40-44,1863,5.23614753509303
STAT,1946,11,na,1957,5028.727354684856
STAT,1848,54,45-49,1902,0.014995806524809944
SIM,1956,55,na,2011,5175
SIM,1926,23,15-19,1949,8
SIM,1926,43,na,1969,5809
SIM,1971,32,25-29,2003,36
STAT,1833,51,45-49,1884,0.010808944163900745
STAT,1868,27,30-34,1895,27.920875176124188
STAT,1888,32,na,1920,3237.2089552862244
STAT,1954,41,50-100,1995,0.17443163307608042
SIM,1969,20,30-34,1989,57
SIM,1858,22,na,1880,2748
SIM,1873,35,50-100,1908,4
STAT,1880,30,25-29,1910,12.629887288048593
STAT,1851,31,45-49,1882,1.4543137157055053
STAT,1872,28,35-39,1900,11.141841747565106
SIM,1863,24,40-44,1887,3
STAT,1970,38,25-29,2008,1.4639374016077842
STAT,1962,7,na,1969,5812.127875997205
SIM,1964,5,na,1969,5977
STAT,1872,19,45-49,1891,0.07528992146612914
SIM,1821,77,na,1898,189
STAT,1896,42,30-34,1938,0.12154204702522788
STAT,1775,102,na,1877,0.11330542633021776
STAT,1874,44,45-49,1918,1.744334004179812
STAT,1863,88,na,1951,138.53426597480836
STAT,1997,0,na,1997,6674.934936607721
STAT,1888,26,45-49,1914,1.5113779241212921
SIM,1998,11,na,2009,6861
SIM,1851,43,na,1894,2615
SIM,1975,25,20-24,2000,54
STAT,1882,47,50-100,1929,0.2755533427125588
STAT,1968,19,50-100,1987,0.539672172636908
STAT,1914,25,50-100,1939,1.166399245104927
STAT,1862,22,30-34,1884,17.758913193651676
SIM,1951,20,45-49,1971,4
SIM,1882,44,45-49,1926,2
STAT,1851,87,na,1938,139.71045042636132
SIM,1888,41,35-39,1929,4
STAT,1917,30,45-49,1947,1.916950950685489
SIM,1896,26,45-49,1922,1
STAT,1791,103,na,1894,0.030721677613300524
STAT,1901,15,na,1916,4101.567062527353
STAT,1905,29,na,1934,3957.7724717076326
SIM,1977,37,25-29,2014,4
STAT,1877,15,50-100,1892,0.05908530145713696
STAT,1878,37,40-44,1915,5.274696350261902
SIM,1840,27,50-100,1867,1
STAT,1841,42,40-44,1883,2.0780518284935705
STAT,1855,24,40-44,1879,2.0417861635352708
SIM,1864,45,40-44,1909,1
SIM,1880,28,35-39,1908,22
SIM,1948,40,40-44,1988,1
STAT,1856,45,40-44,1901,0.15223565887615562
STAT,1848,51,40-44,1899,0.011239439651394137
SIM,1793,64,na,1857,1293
SIM,1878,27,40-44,1905,5
STAT,1897,68,na,1965,2646.213593954889
STAT,1976,35,15-19,2011,0.030556119553896432
STAT,1863,34,40-44,1897,4.338757198193213
SIM,1888,49,45-49,1937,1
STAT,1893,54,na,1947,3054.577606716145
STAT,1895,30,20-24,1925,4.093152134582394
SIM,1881,32,35-39,1913,13
STAT,1873,32,35-39,1905,11.934644526223357
STAT,1880,38,35-39,1918,8.608975838582559
STAT,1881,42,35-39,1923,2.013187897486366
STAT,1951,33,na,1984,5294.590956358847
SIM,1979,17,45-49,1996,6
STAT,1889,17,na,1906,3592.849667257175
STAT,1900,45,25-29,1945,0.05254867807410246
STAT,1842,19,na,1861,2241.6489535598116
SIM,1894,32,20-24,1926,7
STAT,1877,16,na,1893,3039.2973363870396
STAT,1924,32,na,1956,5090.759299545546
STAT,1835,37,20-24,1872,0.5948893046614421
STAT,1928,46,na,1974,5422.988696699543
STAT,1830,47,35-39,1877,0.12917279128071293
SIM,1850,26,20-24,1876,22
STAT,1969,37,25-29,2006,1.4623715481014838
SIM,1848,9,na,1857,2350
SIM,1931,65,na,1996,4904
STAT,1896,17,40-44,1913,0.27879658954966435
SIM,1966,20,40-44,1986,7
STAT,1919,35,25-29,1954,1.227237331580053
SIM,1866,73,na,1939,1157
STAT,1839,53,40-44,1892,0.008214898786466415
STAT,1846,30,25-29,1876,12.775691880726939
STAT,1896,36,45-49,1932,3.053269237208714
STAT,1969,17,35-39,1986,6.049281459078264
STAT,1976,26,25-29,2002,101.96625479829753
SIM,1879,43,35-39,1922,4
STAT,1965,48,50-100,2013,0.338012462553409
STAT,1814,52,25-29,1866,0.009415515135626669
SIM,1959,45,30-34,2004,1
SIM,1835,37,35-39,1872,8
STAT,1895,38,30-34,1933,7.966338972645456
STAT,1869,72,na,1941,1411.4218413707977
STAT,1938,40,30-34,1978,0.1517439966650956
SIM,1824,40,40-44,1864,2
STAT,1850,27,45-49,1877,1.3450791927040302
SIM,1895,38,45-49,1933,7
SIM,1960,49,na,2009,6088
SIM,1874,17,na,1891,2745
SIM,1963,4,na,1967,6584
STAT,1917,87,na,2004,1142.8237249837316
SIM,1966,20,50-100,1986,2
SIM,1854,38,35-39,1892,17
SIM,1865,7,na,1872,3542
STAT,1963,21,25-29,1984,135.92084667954984
STAT,1907,49,50-100,1956,0.23156197985685523
STAT,1842,26,20-24,1868,11.244773908863385
STAT,1922,20,na,1942,4859.608839174598
STAT,1896,116,na,2012,1.0303327599628122E-4
STAT,1864,34,35-39,1898,10.34600657133698
STAT,1985,24,25-29,2009,152.0117503935862
STAT,1836,35,35-39,1871,8.069573152385212
STAT,1875,32,45-49,1907,2.0796743558361417
SIM,1845,32,25-29,1877,6
STAT,1894,71,na,1965,2295.7103325986136
STAT,1898,85,na,1983,1079.0224554714634
STAT,1887,38,45-49,1925,2.5654342514136443
STAT,1851,24,20-24,1875,64.32571491625704
SIM,1984,26,25-29,2010,128
STAT,1938,49,30-34,1987,0.10499095766393579
STAT,1827,41,na,1868,2205.301661099001
STAT,1890,21,30-34,1911,25.193292065624
SIM,1854,30,25-29,1884,6
SIM,1919,16,35-39,1935,6
STAT,1910,27,40-44,1937,5.19966800835524
STAT,1827,37,35-39,1864,10.343967757096397
STAT,1816,89,na,1905,51.88066455874216
SIM,1877,36,na,1913,3148
STAT,1870,41,20-24,1911,0.18150298639544954
SIM,1953,25,25-29,1978,188
STAT,1847,17,45-49,1864,0.06273278229958308
STAT,1880,26,40-44,1906,3.6768721949582286
STAT,1837,32,25-29,1869,9.299307038335034
STAT,1844,10,na,1854,2570.0
STAT,1957,43,40-44,2000,0.3948883467084624
STAT,1841,88,na,1929,122.05748829531774
SIM,1844,35,35-39,1879,17
STAT,1809,47,20-24,1856,0.030805803253144907
STAT,1899,16,na,1915,4002.9684531030694
SIM,1861,27,35-39,1888,25
SIM,1971,21,25-29,1992,1
STAT,1949,41,45-49,1990,0.23247605630724252
SIM,1815,42,40-44,1857,1
STAT,1853,27,35-39,1880,11.128882419872268
SIM,1977,17,35-39,1994,16
STAT,1855,52,35-39,1907,0.007286413170638655
SIM,1883,32,45-49,1915,7
STAT,1973,30,40-44,2003,5.960417876793321
SIM,1884,37,30-34,1921,12
STAT,1885,23,15-19,1908,3.7858027208890346
SIM,1927,35,25-29,1962,1
STAT,1826,40,50-100,1866,0.8169706098225799
SIM,1794,81,na,1875,5
STAT,1860,59,na,1919,1807.6328209932985
STAT,1871,51,50-100,1922,0.017422829547247384
STAT,1853,42,50-100,1895,1.0505285941421227
STAT,1927,86,na,2013,1559.1197306210563
SIM,1798,95,na,1893,7
SIM,1819,74,na,1893,174
STAT,1937,31,25-29,1968,10.564699896456416
STAT,1886,32,20-24,1918,3.290463542569238
STAT,1825,34,20-24,1859,4.931129727952051
SIM,1850,30,40-44,1880,3
STAT,1926,42,50-100,1968,0.16710438353495502
STAT,1958,20,40-44,1978,5.116818775290889
STAT,1898,38,20-24,1936,0.2582139847676173
STAT,1989,21,40-44,2010,5.578145732043381
STAT,1853,33,20-24,1886,2.7427672057671946
SIM,1815,60,na,1875,1520
STAT,1890,40,35-39,1930,2.579230475059555
SIM,1862,40,25-29,1902,2
STAT,1890,48,45-49,1938,0.18536164074637052
STAT,1831,26,45-49,1857,1.1658201019464445
STAT,1920,41,35-39,1961,0.2569161320319978
STAT,1834,54,50-100,1888,0.013583185148585994
STAT,1876,37,30-34,1913,6.358073595048072
STAT,1841,21,35-39,1862,6.620034196604682
STAT,1906,38,30-34,1944,1.9262761471130543
SIM,1882,20,35-39,1902,1
STAT,1885,29,50-100,1914,0.7310929595599722
STAT,1838,44,35-39,1882,1.6273593566259048
SIM,1892,19,15-19,1911,9
STAT,1862,53,50-100,1915,0.014472887544311792
SIM,1828,48,35-39,1876,1
SIM,1986,9,na,1995,6755
SIM,1927,28,na,1955,4650
SIM,1914,38,30-34,1952,5
SIM,1815,81,na,1896,382
STAT,1822,50,30-34,1872,0.011267722806368242
SIM,1923,14,na,1937,5656
STAT,1863,18,40-44,1881,0.19052712930355437
STAT,1882,51,40-44,1933,0.011923703157798313
STAT,1997,18,45-49,2015,0.8415481594359382
STAT,1875,28,25-29,1903,50.270902036180416
SIM,1945,31,25-29,1976,17
STAT,1911,43,35-39,1954,0.22065677499275285
STAT,1911,38,50-100,1949,0.46607076759235216
STAT,1920,49,45-49,1969,0.2755149284287282
STAT,1976,30,45-49,2006,2.475819164226371
STAT,1879,71,na,1950,1608.459941299081
SIM,1882,90,na,1972,442
STAT,1863,46,35-39,1909,0.14167652997302024
STAT,1832,51,50-100,1883,0.01112430286673039
STAT,1862,31,20-24,1893,2.6433549742249514
SIM,1864,18,na,1882,2982
SIM,1956,30,50-100,1986,1
STAT,1894,21,15-19,1915,4.909007592684518
STAT,1887,44,30-34,1931,1.466822127981435
STAT,1941,20,35-39,1961,11.240127456369505
SIM,1846,44,35-39,1890,1
STAT,1892,42,50-100,1934,1.5262069595179117
STAT,1971,15,25-29,1986,63.375130110011405
STAT,1884,1,na,1885,3790.264664695175
SIM,1881,41,25-29,1922,1
SIM,1872,31,30-34,1903,45
STAT,1867,3,na,1870,3419.9372898511538
STAT,1931,44,15-19,1975,0.002360232646397992
SIM,1885,87,na,1972,1001
STAT,1838,20,50-100,1858,0.4650228245342489
STAT,1828,49,45-49,1877,0.21168631692102877
SIM,1955,16,45-49,1971,2
STAT,1827,43,20-24,1870,0.20792974891657642
STAT,1872,20,25-29,1892,66.73214145753927
SIM,1952,27,na,1979,4595
STAT,1873,41,25-29,1914,0.7601997778122255
STAT,1842,33,45-49,1875,1.6043211613432016
SIM,1917,25,15-19,1942,2
STAT,1897,33,35-39,1930,15.561470351572241
SIM,1985,19,30-34,2004,22
STAT,1964,30,30-34,1994,23.369327662689738
STAT,1901,29,40-44,1930,4.807668674364916
STAT,1868,39,25-29,1907,3.1602309274034988
SIM,1861,21,na,1882,1867
SIM,1876,39,25-29,1915,3
SIM,1909,100,na,2009,17
STAT,1886,20,na,1906,2896.177787538753
STAT,1947,16,45-49,1963,0.6495641544677795
SIM,1881,73,na,1954,780
STAT,1766,97,na,1863,2.2370665566056496
STAT,1945,25,25-29,1970,83.40805819288478
STAT,1852,40,15-19,1892,0.013151470285343265
STAT,1936,15,30-34,1951,13.53777520522082
SIM,1896,23,40-44,1919,6
SIM,1939,21,35-39,1960,24
STAT,1986,21,15-19,2007,8.785230779188389
STAT,1924,20,50-100,1944,0.901130430743615
SIM,1844,20,15-19,1864,7
STAT,1852,36,30-34,1888,5.104794861767847
SIM,1940,29,50-100,1969,3
SIM,1835,43,20-24,1878,1
STAT,1837,47,45-49,1884,0.17739808018782388
SIM,1844,16,30-34,1860,4
STAT,1816,40,40-44,1856,5.479366826187518
STAT,1894,29,25-29,1923,62.30728865627428
SIM,1899,16,20-24,1915,42
STAT,1909,25,15-19,1934,0.7914269924306895
SIM,1818,38,25-29,1856,7
STAT,1802,97,na,1899,2.564480959533476
SIM,1824,36,20-24,1860,2
STAT,1774,103,na,1877,0.0021928225474105866
SIM,1855,42,35-39,1897,1
STAT,1947,33,50-100,1980,1.0948867158246252
STAT,1900,42,20-24,1942,0.0176384924098839
STAT,1817,48,30-34,1865,0.27242116409605804
SIM,1860,36,30-34,1896,4
SIM,1779,81,na,1860,345
SIM,1869,45,40-44,1914,1
STAT,1846,38,35-39,1884,7.556759251212264
STAT,1837,28,40-44,1865,2.7641403693897373
SIM,1849,18,na,1867,2996
STAT,1901,48,50-100,1949,0.2211317796648298
STAT,1883,105,na,1988,1.3325525581616287
STAT,1864,50,35-39,1914,0.008998614432076139
SIM,1826,44,na,1870,1854
STAT,1874,49,15-19,1923,4.627114185888932E-4
STAT,1953,45,na,1998,5359.85307664951
STAT,1966,41,40-44,2007,0.3752217467312478
STAT,1977,38,35-39,2015,3.8816954998075484
STAT,1897,115,na,2012,3.032064693645815E-4
SIM,1845,28,40-44,1873,6
STAT,1898,45,45-49,1943,0.20970032942731884
STAT,1826,88,na,1914,75.58910711189486
STAT,1862,25,35-39,1887,9.568964404915256
SIM,1916,65,na,1981,3980
STAT,1888,23,40-44,1911,2.8181071946307887
STAT,1861,27,20-24,1888,11.337010836451945
SIM,1895,19,40-44,1914,1
SIM,1912,51,na,1963,3565
STAT,1847,42,35-39,1889,1.4011095008593095
STAT,1914,90,na,2004,687.1015505785077
STAT,1981,24,40-44,2005,5.44011508821211
SIM,1870,25,35-39,1895,22
SIM,1984,30,45-49,2014,1
STAT,1893,17,15-19,1910,8.656839235353305
STAT,1887,19,40-44,1906,0.23528415072238448
SIM,1944,15,30-34,1959,40
SIM,1978,21,35-39,1999,34
STAT,1936,12,na,1948,4380.436830452763
SIM,1835,34,30-34,1869,8
STAT,1847,38,15-19,1885,0.04436750808556325
STAT,1821,37,40-44,1858,9.740369167387918
STAT,1860,109,na,1969,0.008523265333859886
STAT,1896,21,25-29,1917,87.52213174364333
STAT,1880,51,30-34,1931,0.007316242758317692
STAT,1850,48,15-19,1898,4.066040636745368E-4
SIM,1879,40,30-34,1919,1
STAT,1776,96,na,1872,2.2201527162019428
SIM,1959,48,35-39,2007,1
SIM,1993,17,15-19,2010,138
STAT,1772,82,na,1854,20.0
STAT,1861,22,15-19,1883,3.251638112894108
STAT,1865,43,40-44,1908,2.3251535181466862
STAT,1959,28,30-34,1987,59.37623980660555
SIM,1933,13,na,1946,6621
SIM,1973,32,35-39,2005,16
SIM,1956,30,na,1986,5311
SIM,1974,37,20-24,2011,1
STAT,1929,63,na,1992,4937.423041990599
STAT,1825,43,50-100,1868,1.5380088385409052
STAT,1998,1,na,1999,6672.035906529452
SIM,1923,30,35-39,1953,1
SIM,1860,48,25-29,1908,1
STAT,1902,32,na,1934,3891.185648689051
STAT,1879,50,na,1929,2631.8933246529527
SIM,1984,23,20-24,2007,194
STAT,1984,29,15-19,2013,1.1609524667495181
STAT,1820,50,20-24,1870,7.541114807325333E-4
STAT,1905,16,40-44,1921,0.306257391722901
STAT,1985,17,15-19,2002,74.49167490631648
STAT,1906,46,na,1952,3797.6474450871306
STAT,1934,2,na,1936,6387.267399600276
SIM,1833,78,na,1911,509
SIM,1949,17,50-100,1966,1
STAT,1895,33,25-29,1928,15.321427592609924
STAT,1895,42,15-19,1937,0.0014388028293135268
STAT,1816,43,45-49,1859,3.269658570615004
STAT,1810,103,na,1913,0.08171563031231022
STAT,1851,20,50-100,1871,0.39177939621691527
STAT,1885,47,25-29,1932,0.06599478068754883
STAT,1831,23,40-44,1854,4.7660021768797405
SIM,1937,27,na,1964,4160
STAT,1836,77,na,1913,786.655453640349
STAT,1864,31,30-34,1895,18.064742233104038
SIM,1871,8,na,1879,2445
STAT,1966,37,20-24,2003,0.39146637636692105
STAT,1915,30,35-39,1945,10.829077328168703
SIM,1824,43,45-49,1867,6
STAT,1825,46,15-19,1871,5.663681054022919E-4
SIM,1963,37,45-49,2000,1
SIM,1846,35,45-49,1881,1
STAT,1896,29,35-39,1925,14.602608629590604
SIM,1967,28,30-34,1995,5
STAT,1959,20,20-24,1979,168.52780927826967
STAT,1866,50,45-49,1916,0.0157464533659148
STAT,1877,49,40-44,1926,0.20122514987209714
SIM,1836,22,na,1858,1885
STAT,1969,23,20-24,1992,160.77801490035878
STAT,1835,32,15-19,1867,0.11322223211266831
STAT,1938,15,40-44,1953,1.6004801351344442
STAT,1886,26,35-39,1912,11.786056472305122
STAT,1858,45,15-19,1903,3.6370427930622985E-4
STAT,1942,32,45-49,1974,1.9347683381244078
STAT,1854,36,40-44,1890,3.583503316036851
SIM,1857,42,45-49,1899,7
SIM,1907,83,na,1990,1795
STAT,1831,32,30-34,1863,17.779801517894033
STAT,1885,19,30-34,1904,1.8248786621726079
SIM,1850,33,45-49,1883,2
SIM,1897,13,na,1910,4199
SIM,1806,56,na,1862,1356
SIM,1950,32,45-49,1982,6
SIM,1962,26,na,1988,5318
STAT,1902,45,50-100,1947,0.22815751411734095
STAT,1975,38,50-100,2013,0.6578851766382166
STAT,1838,41,30-34,1879,1.1798667258466373
STAT,1859,83,na,1942,364.9520152118431
SIM,1979,29,na,2008,6402
STAT,1948,20,45-49,1968,1.491923035559472
STAT,1874,28,45-49,1902,1.3071471447497105
SIM,1861,24,30-34,1885,36
SIM,1878,39,35-39,1917,16
STAT,1838,16,40-44,1854,0.21055121435886692
STAT,1988,17,40-44,2005,2.30863834609883
STAT,1915,50,na,1965,4234.461946563692
STAT,1919,64,na,1983,4071.474149491398
STAT,1988,15,50-100,2003,0.618712995478334
SIM,1885,49,40-44,1934,2
SIM,1911,91,na,2002,785
SIM,1862,36,40-44,1898,18
STAT,1850,92,na,1942,42.875824133445214
STAT,1853,24,30-34,1877,20.653944108129487
SIM,1860,25,na,1885,2710
SIM,1882,28,45-49,1910,1
STAT,1849,42,45-49,1891,1.1585700908027303
STAT,1864,22,40-44,1886,2.181772714120472
STAT,1885,28,20-24,1913,13.456647503605065
STAT,1887,35,40-44,1922,5.715293318787587
STAT,1840,17,35-39,1857,0.5699071711106304
STAT,1931,31,30-34,1962,23.843673713578475
SIM,1893,28,20-24,1921,33
SIM,1895,35,40-44,1930,3
STAT,1931,49,20-24,1980,0.01695651303274716
STAT,1808,59,na,1867,1387.900989919889
SIM,1969,34,35-39,2003,28
STAT,1958,23,45-49,1981,1.710535946138276
SIM,1873,43,40-44,1916,3
SIM,1989,19,15-19,2008,73
SIM,1894,26,35-39,1920,19
STAT,1963,17,40-44,1980,2.050742144618718
STAT,1966,44,45-49,2010,0.2484788557810452
SIM,1907,35,50-100,1942,1
STAT,1852,45,20-24,1897,0.011426554966380007
STAT,1837,37,30-34,1874,4.698758257253495
STAT,1842,30,40-44,1872,4.116033749024772
STAT,1943,60,na,2003,4355.190589548859
SIM,1858,47,30-34,1905,1
SIM,1805,82,na,1887,125
STAT,1977,35,30-34,2012,2.932958699388241
STAT,1875,25,20-24,1900,14.085793745370868
STAT,1913,94,na,2007,288.9887950407049
STAT,1909,16,25-29,1925,9.842398156396387
STAT,1981,33,30-34,2014,25.899540372600363
STAT,1825,37,25-29,1862,4.78199830534582
SIM,1867,38,20-24,1905,5
SIM,1856,30,35-39,1886,22
STAT,1791,96,na,1887,1.7670939549499167
STAT,1869,18,35-39,1887,0.6180717657912059
STAT,1884,35,15-19,1919,0.0646366972700517
STAT,1847,31,50-100,1878,0.8364106669201862
STAT,1834,28,15-19,1862,0.5390274351128878
STAT,1932,28,30-34,1960,59.21290017869825
STAT,1916,42,45-49,1958,0.19684639883715166
SIM,1966,16,20-24,1982,1
SIM,1940,28,30-34,1968,7
STAT,1919,29,50-100,1948,1.2319776122373522
SIM,1917,16,25-29,1933,22
STAT,1924,6,na,1930,5506.685419894239
STAT,1822,74,na,1896,911.831914889349
SIM,1878,31,25-29,1909,16
SIM,1845,37,30-34,1882,9
SIM,1868,36,35-39,1904,1
STAT,1890,15,45-49,1905,0.09254055224964555
STAT,1852,40,na,1892,2201.055473775477
STAT,1862,34,25-29,1896,9.890197185748072
STAT,1838,35,45-49,1873,2.1277482091294386
STAT,1941,38,25-29,1979,1.2048743656506478
STAT,1897,30,30-34,1927,27.15924949592829
STAT,1859,29,30-34,1888,23.212472421051594
STAT,1960,33,50-100,1993,1.2659641575439087
SIM,1867,29,30-34,1896,30
STAT,1828,46,40-44,1874,0.15973107873550035
SIM,1846,41,30-34,1887,5
STAT,1870,58,na,1928,2249.960487610017
STAT,1991,22,35-39,2013,15.624281345798162
SIM,1855,31,50-100,1886,2
SIM,1883,25,20-24,1908,15
SIM,1877,27,25-29,1904,13
STAT,1848,47,20-24,1895,0.012690890258161624
STAT,1982,31,45-49,2013,2.6062557772576214
SIM,1853,55,na,1908,1994
SIM,1857,69,na,1926,1468
SIM,1947,7,na,1954,6105
SIM,1899,19,25-29,1918,24
STAT,1837,40,na,1877,1843.1099791521424
STAT,1898,42,40-44,1940,0.24331329396936968
SIM,1861,52,25-29,1913,1
STAT,1900,18,50-100,1918,0.07824787445085654
STAT,1911,48,40-44,1959,0.17192008777622272
SIM,1872,69,na,1941,1911
STAT,1981,27,45-49,2008,2.7999221871171818
STAT,1806,54,40-44,1860,0.03559921526387525
SIM,1967,20,20-24,1987,305
STAT,1967,26,15-19,1993,1.02253753364641
STAT,1840,42,25-29,1882,0.5373654458469415
STAT,1881,22,50-100,1903,0.45392337164910773
STAT,1936,18,35-39,1954,4.626837885655507
STAT,1940,27,na,1967,4409.933041324054
SIM,1823,31,35-39,1854,5
STAT,1958,16,20-24,1974,205.5542138877256
SIM,1844,19,35-39,1863,2
STAT,1888,48,50-100,1936,0.1855768378978259
STAT,1847,51,25-29,1898,0.002738457316344032
STAT,1836,19,35-39,1855,0.7260233879928525
SIM,1866,17,20-24,1883,41
STAT,1867,27,15-19,1894,0.4888592365289158
STAT,1891,33,40-44,1924,6.159434613449914
STAT,1858,17,20-24,1875,18.644275005526886
SIM,1883,21,na,1904,2322
STAT,1905,41,30-34,1946,0.13395409864392024
STAT,1831,51,35-39,1882,0.007158071462874245
STAT,1862,43,15-19,1905,0.013352681993961956
STAT,1851,27,25-29,1878,39.276309207911055
STAT,1860,18,15-19,1878,6.32857595435598
STAT,1961,21,15-19,1982,7.965725832713247
SIM,1887,35,na,1922,3714
STAT,1852,48,25-29,1900,0.05362369578930564
SIM,1905,1,na,1906,4798
SIM,1860,39,35-39,1899,19
SIM,1895,86,na,1981,619
STAT,1823,59,na,1882,1188.723410244486
STAT,1987,24,35-39,2011,15.55338750217162
STAT,1971,38,40-44,2009,2.2520008837988494
STAT,1827,34,30-34,1861,27.49165205552082
SIM,1891,72,na,1963,2008
STAT,1852,39,35-39,1891,6.60133043049487
STAT,1963,48,na,2011,5587.065648910681
STAT,1883,0,na,1883,3999.2635163616837
STAT,1846,34,50-100,1880,1.0963457445612164
STAT,1911,40,30-34,1951,0.14253609827857394
STAT,1879,42,50-100,1921,1.2714771440619306
STAT,1971,30,30-34,2001,23.50030014951978
STAT,1980,21,20-24,2001,178.79090574797408
SIM,1942,49,na,1991,4877
SIM,1813,42,30-34,1855,1
STAT,1835,92,na,1927,25.95816043500846
STAT,1853,52,25-29,1905,0.003507721949242501
SIM,1829,36,35-39,1865,19
STAT,1868,31,15-19,1899,0.15854228547456653
SIM,1903,47,na,1950,3556
STAT,1968,30,15-19,1998,0.1890211030986405
STAT,1918,5,na,1923,5049.464214623304
STAT,1913,43,45-49,1956,0.18710430851232282
SIM,1845,58,na,1903,1827
STAT,1900,84,na,1984,1250.2914861359702
STAT,1903,17,na,1920,4151.533782503075
STAT,1886,19,25-29,1905,6.861178230580996
STAT,1841,38,20-24,1879,0.7991406445167487
SIM,1830,41,40-44,1871,4
STAT,1858,51,50-100,1909,0.01366184940669837
STAT,1914,36,15-19,1950,0.022244119222707855
STAT,1788,76,na,1864,555.6061681401965
STAT,1942,47,30-34,1989,0.11184755269254845
STAT,1964,21,40-44,1985,4.905019318182018
SIM,1961,31,na,1992,5603
STAT,1861,37,35-39,1898,6.785811948264749
STAT,1873,28,15-19,1901,0.5328017520244019
STAT,1859,38,20-24,1897,0.705130135186016
SIM,1880,35,45-49,1915,5
STAT,1845,54,40-44,1899,0.0068990249793733915
STAT,1857,45,20-24,1902,0.010893257624487394
STAT,1969,30,30-34,1999,23.178148882885342
STAT,1960,44,15-19,2004,0.002390835485279532
SIM,1924,19,20-24,1943,5
STAT,1933,41,20-24,1974,0.028055196464341008
STAT,1872,35,45-49,1907,2.3319956827114705
SIM,1879,70,na,1949,1655
SIM,1894,19,25-29,1913,19
SIM,1953,48,40-44,2001,1
STAT,1798,96,na,1894,2.1841005671439566
SIM,1844,25,20-24,1869,18
SIM,1899,28,15-19,1927,1
STAT,1845,38,na,1883,1650.8318054758622
STAT,1804,52,50-100,1856,0.06951705399468669
SIM,1871,37,45-49,1908,3
STAT,1836,25,20-24,1861,14.020514036552708
STAT,1947,53,na,2000,4861.866419386938
SIM,1927,85,na,2012,863
STAT,1954,46,40-44,2000,0.23454505847622828
SIM,1859,19,30-34,1878,3
SIM,1870,57,na,1927,2581
STAT,1826,49,35-39,1875,0.0981437912732182
STAT,1933,26,50-100,1959,1.526575557276533
SIM,1851,47,50-100,1898,2
SIM,1921,43,45-49,1964,1
STAT,1853,18,50-100,1871,0.05833025002526879
STAT,1975,38,25-29,2013,1.5428159707714633
STAT,1922,41,45-49,1963,0.22067684204282573
STAT,1881,74,na,1955,1235.3379583758326
STAT,1904,45,45-49,1949,0.22281451215995973
SIM,1869,38,30-34,1907,4
STAT,1938,31,40-44,1969,4.545882921688772
STAT,1958,20,50-100,1978,1.0013344711465502
SIM,1891,35,20-24,1926,2
STAT,1935,31,15-19,1966,0.20540255399942262
SIM,1970,32,30-34,2002,6
STAT,1863,27,30-34,1890,25.41131091470534
SIM,1868,21,na,1889,3252
SIM,1855,26,35-39,1881,24
STAT,1883,35,20-24,1918,0.8786254421490542
STAT,1865,36,na,1901,2464.9827985036227
STAT,1850,36,20-24,1886,0.8145276678269737
STAT,1803,60,na,1863,1011.617086201405
STAT,1940,26,15-19,1966,0.8314153429687009
STAT,1871,54,na,1925,2404.1272388584466
STAT,1923,34,15-19,1957,0.16972989115217219
STAT,1895,48,45-49,1943,0.19746456303605306
SIM,1802,63,na,1865,884
STAT,1913,30,25-29,1943,10.703262230116804
STAT,1827,27,20-24,1854,45.22749707730097
SIM,1871,27,30-34,1898,1
STAT,1909,41,15-19,1950,0.001669070614384224
SIM,1834,49,35-39,1883,1
STAT,1924,43,20-24,1967,0.024197441084047096
STAT,1822,41,40-44,1863,4.722167138450195
STAT,1963,44,40-44,2007,0.3798432004914564
SIM,1815,47,50-100,1862,1
STAT,1944,42,35-39,1986,0.25990693076966287
STAT,1895,17,25-29,1912,8.512513997467526
SIM,1787,79,na,1866,538
STAT,1847,26,35-39,1873,8.988297824951648
STAT,1920,49,50-100,1969,0.28672231487696914
STAT,1870,32,30-34,1902,19.864342791345035
SIM,1856,38,45-49,1894,5
SIM,1921,80,na,2001,2405
STAT,1843,109,na,1952,7.138651849092816E-4
SIM,1936,42,na,1978,3935
STAT,1962,18,50-100,1980,0.5538181168939292
STAT,1931,66,na,1997,4857.108812998068
STAT,1916,19,20-24,1935,33.020717930125755
SIM,1889,90,na,1979,716
SIM,1936,32,na,1968,3879
SIM,1921,30,25-29,1951,25
STAT,1862,15,20-24,1877,20.010235912615737
SIM,1833,37,25-29,1870,6
SIM,1972,21,40-44,1993,12
STAT,1905,19,45-49,1924,0.10852450552861136
SIM,1910,17,na,1927,3950
STAT,1815,48,20-24,1863,0.02414087499705401
SIM,1995,17,25-29,2012,173
SIM,1870,15,20-24,1885,38
STAT,1848,38,45-49,1886,2.1602315166418182
STAT,1955,50,na,2005,5801.513478056525
STAT,1880,54,35-39,1934,0.010241361863233272
STAT,1920,46,40-44,1966,0.20154329204062837
STAT,1894,36,35-39,1930,10.54345945401379
STAT,1902,42,30-34,1944,0.13002143533121505
SIM,1934,51,na,1985,5615
STAT,1926,18,50-100,1944,0.5286095950345913
SIM,1900,32,20-24,1932,4
STAT,1958,43,20-24,2001,0.027774763559883276
STAT,1851,40,35-39,1891,1.4504553785172987
STAT,1868,17,50-100,1885,0.05530412918527986
SIM,1852,42,30-34,1894,1
STAT,1929,42,na,1971,5550.832659506583
STAT,1824,46,20-24,1870,0.016517818648982104
SIM,1976,21,25-29,1997,164
STAT,1911,68,na,1979,3304.455579988961
SIM,1846,28,35-39,1874,23
STAT,1950,36,25-29,1986,1.385439246946136
STAT,1896,21,50-100,1917,0.6234658846423289
STAT,1838,28,35-39,1866,10.557424766668772
STAT,1844,45,35-39,1889,0.11894581362017871
STAT,1906,67,na,1973,3133.8455934960266
SIM,1843,47,35-39,1890,1
STAT,1842,22,50-100,1864,0.3958005698873559
STAT,1848,88,na,1936,145.8676183775144
STAT,1828,36,na,1864,1862.8895738799745
STAT,1878,53,40-44,1931,0.012481672893412989
SIM,1864,6,na,1870,3209
STAT,1786,95,na,1881,4.3802965854393054
SIM,1947,26,na,1973,5800
SIM,1936,0,na,1936,4387
SIM,1820,92,na,1912,28
STAT,1968,21,25-29,1989,133.62660640188224
STAT,1883,55,na,1938,2334.639436610284
STAT,1859,48,35-39,1907,0.12708550649240938
STAT,1840,60,na,1900,1529.9424400963248
SIM,1948,8,na,1956,4469
STAT,1967,41,20-24,2008,0.026495629431319615
STAT,1874,37,20-24,1911,0.910717288142155
STAT,1958,19,25-29,1977,65.64072650552401
STAT,1825,93,na,1918,20.67194692694475
STAT,1983,24,15-19,2007,8.713137712827734
SIM,1846,20,50-100,1866,1
STAT,1915,48,25-29,1963,0.061525405426522975
STAT,1974,26,15-19,2000,1.068898928000527
STAT,1838,68,na,1906,1323.7400472509937
STAT,1852,18,na,1870,2602.069237877304
SIM,1924,31,na,1955,4934
SIM,1954,53,na,2007,5242
SIM,1997,9,na,2006,6607
STAT,1873,16,35-39,1889,0.6504794812010142
STAT,1936,40,20-24,1976,0.020250981777069646
SIM,1956,20,45-49,1976,3
SIM,1872,18,35-39,1890,2
SIM,1882,37,20-24,1919,3
SIM,1966,19,25-29,1985,73
STAT,1973,33,45-49,2006,2.3925313599305795
STAT,1915,28,na,1943,4394.869083202942
STAT,1820,62,na,1882,1109.6637113192166
SIM,1821,43,40-44,1864,1
SIM,1911,33,35-39,1944,2
STAT,1835,47,35-39,1882,0.09209099038767785
STAT,1875,49,30-34,1924,0.11303286983842234
STAT,1825,50,35-39,1875,0.012054685257831967
STAT,1830,38,45-49,1868,1.9844036502483346
STAT,1940,32,35-39,1972,10.918293903629273
STAT,1911,78,na,1989,2308.313354618315
SIM,1944,3,na,1947,4755
STAT,1962,30,20-24,1992,3.680590397916066
SIM,1795,66,na,1861,914
STAT,1870,44,25-29,1914,0.7207358935934215
STAT,1922,30,50-100,1952,1.0862748368014208
STAT,1813,43,40-44,1856,8.115735186703441
STAT,1945,43,50-100,1988,0.1536695538643117
STAT,1876,85,na,1961,506.2555941840421
STAT,1903,33,35-39,1936,9.518164517351419
STAT,1951,22,50-100,1973,0.9072306601914807
SIM,1955,33,50-100,1988,3
STAT,1818,52,30-34,1870,0.007070512632286808
SIM,1962,46,40-44,2008,1
STAT,1971,33,35-39,2004,13.60691282386195
STAT,1820,53,25-29,1873,0.003409588855044308
SIM,1919,30,na,1949,5327
STAT,1833,80,na,1913,435.28994037942994
SIM,1856,20,na,1876,2241
SIM,1962,40,na,2002,5503
SIM,1820,82,na,1902,552
STAT,1833,90,na,1923,55.478033503035135
STAT,1938,7,na,1945,4552.788014267987
STAT,1885,38,35-39,1923,8.101322544645171
SIM,1955,41,35-39,1996,1
STAT,1798,109,na,1907,1.809667694702634E-4
STAT,1891,52,na,1943,3054.8368862741363
STAT,1778,98,na,1876,0.7697224471760185
STAT,1891,42,na,1933,3292.504678901557
STAT,1947,41,35-39,1988,0.27243078662097425
SIM,1893,38,35-39,1931,8
STAT,1853,17,20-24,1870,21.232838807041585
STAT,1903,27,na,1930,3922.9124974890924
SIM,1795,76,na,1871,531
SIM,1861,17,20-24,1878,32
SIM,1882,58,na,1940,2734
STAT,1832,63,na,1895,1215.6292413474087
STAT,1861,46,25-29,1907,0.05541875426259126
STAT,1793,65,na,1858,809.7564602667737
STAT,1883,44,50-100,1927,1.1767306883005173
SIM,1830,44,45-49,1874,1
STAT,1813,92,na,1905,19.070112293075084
STAT,1975,35,20-24,2010,0.4141927401609036
STAT,1807,54,20-24,1861,0.0027828935279753395
SIM,1880,32,40-44,1912,14
SIM,1894,91,na,1985,799
STAT,1927,61,na,1988,4901.456511684437
STAT,1826,46,30-34,1872,0.07056558393666577
STAT,1912,40,50-100,1952,0.13236877668345362
SIM,1875,88,na,1963,333
SIM,1954,20,35-39,1974,23
STAT,1990,25,45-49,2015,2.870076712137273
STAT,1861,76,na,1937,908.9459097878688
SIM,1909,27,30-34,1936,70
SIM,1922,42,35-39,1964,1
STAT,1913,40,40-44,1953,0.2848335079169376
SIM,1891,38,25-29,1929,2
SIM,1879,27,35-39,1906,27
SIM,1869,29,40-44,1898,7
STAT,1820,49,40-44,1869,0.16987668208907802
STAT,1898,2,na,1900,4157.577364095131
STAT,1915,22,50-100,1937,0.7850802491482749
STAT,1966,45,50-100,2011,0.34070734886262777
STAT,1988,13,na,2001,6482.47093021135
STAT,1951,35,50-100,1986,0.5954619774163452
STAT,1898,114,na,2012,8.904596808438437E-4
STAT,1908,58,na,1966,3641.936279291233
STAT,1958,47,na,2005,5792.082096182916
STAT,1866,53,na,1919,2266.1816514449747
STAT,1830,35,40-44,1865,4.565812768848287
STAT,1946,20,35-39,1966,12.100413471124511
SIM,1844,28,25-29,1872,60
SIM,1848,33,na,1881,1882
STAT,1952,36,35-39,1988,3.4493721675199183
STAT,1954,49,45-49,2003,0.32062920251577165
STAT,1951,48,35-39,1999,0.18378188242230856
STAT,1836,28,25-29,1864,49.47419104230718
SIM,1939,29,na,1968,4751
STAT,1914,42,35-39,1956,0.2303783548672348
STAT,1925,7,na,1932,5570.814883785939
SIM,1851,6,na,1857,3315
STAT,1872,32,40-44,1904,5.025396648593401
STAT,1992,22,50-100,2014,1.0935618211156664
STAT,1933,44,25-29,1977,0.11290032119493386
STAT,1811,43,30-34,1854,4.3004911671773165
SIM,1854,19,na,1873,2989
SIM,1933,34,25-29,1967,24
SIM,1890,55,na,1945,2983
STAT,1850,39,25-29,1889,2.9490301720114505
STAT,1982,9,na,1991,6381.434826367146
STAT,1849,20,na,1869,2032.6829401861544
SIM,1928,30,35-39,1958,26
STAT,1958,32,20-24,1990,3.7685695935366734
STAT,1821,101,na,1922,0.34898864471451824
STAT,1920,29,na,1949,4706.5676282867225
STAT,1925,34,25-29,1959,12.645933256785435
STAT,1928,29,40-44,1957,6.620265336453239
STAT,1965,25,na,1990,5425.350348660137
STAT,1979,22,50-100,2001,1.048998168466741
STAT,1859,40,na,1899,2146.17293225739
STAT,1833,44,20-24,1877,0.13291082541952784
STAT,1945,41,25-29,1986,0.09368971408228187
SIM,1897,34,na,1931,3732
STAT,1842,41,na,1883,1863.837152565856
STAT,1883,38,25-29,1921,3.2347549608387953
STAT,1898,29,45-49,1927,1.7193410239800604
STAT,1862,18,25-29,1880,6.283696155000401
SIM,1789,80,na,1869,322
STAT,1912,31,35-39,1943,10.429682846041914
SIM,1870,18,25-29,1888,14
SIM,1936,29,40-44,1965,1
SIM,1903,44,40-44,1947,2
STAT,1836,87,na,1923,160.33645714986233
STAT,1811,52,20-24,1863,0.0021962434735327938
STAT,1817,42,na,1859,2113.38190074536
STAT,1844,42,30-34,1886,0.9848475619030478
STAT,1926,46,35-39,1972,0.1840089699906487
STAT,1878,54,na,1932,2523.125129013785
STAT,1883,47,15-19,1930,4.495309814672274E-4
STAT,1851,48,30-34,1899,0.07579738356899293
SIM,1980,21,35-39,2001,30
SIM,1935,17,30-34,1952,41
STAT,1941,35,20-24,1976,0.32346710464043826
STAT,1927,17,30-34,1944,17.486093631117026
STAT,1859,45,30-34,1904,0.08987587533492342
SIM,1867,37,na,1904,2246
STAT,1869,27,25-29,1896,47.27641951105681
STAT,1812,75,na,1887,455.8533287617562
STAT,1903,41,20-24,1944,0.018210097877186356
STAT,1987,17,25-29,2004,71.39466054833377
STAT,1884,19,15-19,1903,6.730410915672896
STAT,1822,44,45-49,1866,2.8994302967811665
SIM,1873,22,na,1895,3512
SIM,1860,89,na,1949,293
STAT,1812,96,na,1908,3.769829010068339
STAT,1861,108,na,1969,0.022858029508234342
SIM,1934,46,35-39,1980,1
SIM,1833,34,20-24,1867,2
SIM,1846,25,30-34,1871,23
STAT,1919,10,na,1929,5067.247464951289
SIM,1883,75,na,1958,1086
STAT,1947,32,45-49,1979,2.085109433410533
STAT,1858,29,15-19,1887,0.412157815402563
SIM,1901,34,50-100,1935,2
SIM,1920,49,na,1969,4051
STAT,1962,21,30-34,1983,42.6535745788044
STAT,1973,38,15-19,2011,0.029498955744015558
STAT,1887,28,30-34,1915,32.45368993540433
STAT,1893,45,30-34,1938,0.08044487400404421
STAT,1842,17,45-49,1859,0.0645498395376732
STAT,1901,30,20-24,1931,4.404570042725085
STAT,1930,35,45-49,1965,1.0281028426204917
STAT,1910,40,15-19,1950,0.0016956610458159953
SIM,1970,21,30-34,1991,108
SIM,1967,34,25-29,2001,1
STAT,1915,45,20-24,1960,0.012914022182801549
STAT,1971,42,25-29,2013,0.10847170272159998
STAT,1838,25,30-34,1863,28.155020526122907
STAT,1879,49,15-19,1928,4.719432048696668E-4
STAT,1951,30,45-49,1981,2.2067463369164795
SIM,1899,15,na,1914,4397
STAT,1823,69,na,1892,831.0519687263705
STAT,1811,79,na,1890,359.9648033774509
STAT,1938,18,45-49,1956,0.5687743885332196
STAT,1925,40,45-49,1965,0.2331052457227736
STAT,1950,45,15-19,1995,5.253010146976879E-4
STAT,1853,48,40-44,1901,0.16830826114777836
STAT,1838,19,45-49,1857,0.0738759265956483
SIM,1868,17,30-34,1885,3
SIM,1892,36,na,1928,3769
STAT,1870,37,na,1907,2680.4522103113804
STAT,1897,17,35-39,1914,0.8467316360460667
STAT,1953,45,40-44,1998,0.2300209265776619
SIM,1818,45,35-39,1863,1
STAT,1841,100,na,1941,0.9438981500413284
STAT,1916,3,na,1919,4950.529186924703
SIM,1886,40,na,1926,1997
STAT,1832,110,na,1942,1.8826646823530126E-4
SIM,1962,49,45-49,2011,3
STAT,1870,35,35-39,1905,8.123457487159337
SIM,1946,18,45-49,1964,1
STAT,1858,66,na,1924,1475.5778848361854
SIM,1972,25,na,1997,5311
SIM,1824,42,na,1866,1630
STAT,1818,58,na,1876,1020.2484999831084
SIM,1857,26,45-49,1883,1
STAT,1819,51,50-100,1870,0.028531543011254646
SIM,1880,35,na,1915,3302
STAT,1858,40,45-49,1898,1.3609999918985967
STAT,1973,22,45-49,1995,1.6849199598030733
STAT,1871,27,50-100,1898,0.7344476966855065
STAT,1863,37,45-49,1900,2.0116476916376635
STAT,1885,35,30-34,1920,6.193190480784921
SIM,1992,17,na,2009,6516
STAT,1840,24,45-49,1864,0.7012019768112503
STAT,1865,35,50-100,1900,1.2905356749947494
SIM,1895,28,30-34,1923,1
SIM,1914,53,na,1967,3810
STAT,1967,44,25-29,2011,0.10662427821027894
STAT,1982,19,na,2001,5973.265926879838
STAT,1871,53,30-34,1924,0.006724547330850891
SIM,1893,35,30-34,1928,4
SIM,2002,6,na,2008,6945
STAT,1941,4,na,1945,4771.32452565329
STAT,1849,26,45-49,1875,1.0274913156291543
STAT,1916,45,na,1961,4369.5132673240705
STAT,1946,47,15-19,1993,4.904406943226419E-4
STAT,1845,107,na,1952,0.0031778685864452608
STAT,1824,49,25-29,1873,0.07619933231827399
SIM,1942,28,na,1970,4799
SIM,1869,46,50-100,1915,1
STAT,1823,37,15-19,1860,0.10524540458569007
STAT,1886,16,20-24,1902,21.63414256601105
SIM,1900,35,25-29,1935,1
STAT,1954,19,40-44,1973,1.9941630823478527
STAT,1853,35,na,1888,2394.878239109127
SIM,1894,16,20-24,1910,30
STAT,1886,47,40-44,1933,0.20743207973887234
STAT,1940,17,na,1957,4314.307986243674
SIM,1899,79,na,1978,1797
STAT,1821,41,25-29,1862,1.2663801420724494
SIM,1839,72,na,1911,1288
SIM,1897,88,na,1985,412
STAT,1956,46,15-19,2002,5.865703925916172E-4
SIM,1968,19,35-39,1987,15
STAT,1907,63,na,1970,3399.0648065649957
SIM,1908,78,na,1986,1823
STAT,1957,42,20-24,1999,0.02792572545773553
SIM,1917,29,na,1946,4946
STAT,1943,49,50-100,1992,0.2862486685810806
SIM,1922,31,45-49,1953,13
SIM,1921,33,na,1954,5228
STAT,1836,107,na,1943,0.004291837636257728
STAT,1862,49,45-49,1911,0.22504899708697398
SIM,1841,24,50-100,1865,2
SIM,1997,17,35-39,2014,17
SIM,1968,10,na,1978,5397
STAT,1918,26,na,1944,4615.680431280691
STAT,1989,17,35-39,2006,6.936180647439654
STAT,1864,15,30-34,1879,1.8892395493434653
STAT,1855,17,30-34,1872,1.6130841347548561
STAT,1976,38,40-44,2014,2.3754674147590102
STAT,1929,24,50-100,1953,0.9543032172553677
STAT,1846,54,35-39,1900,0.008655150132455556
STAT,1896,73,na,1969,2256.652212301482
STAT,1952,33,30-34,1985,22.19616887305103
SIM,1854,42,40-44,1896,8
SIM,1926,4,na,1930,6295
STAT,1970,30,15-19,2000,0.18944300221413185
SIM,1854,54,35-39,1908,1
SIM,1868,26,20-24,1894,1
STAT,1820,34,50-100,1854,3.1190811422768636
SIM,1869,33,50-100,1902,2
STAT,1875,16,45-49,1891,0.07809465196161208
SIM,1906,66,na,1972,2896
SIM,1864,61,na,1925,2004
SIM,1864,71,na,1935,1339
STAT,1882,47,20-24,1929,0.013463518906633718
SIM,1978,34,na,2012,5842
SIM,1911,13,na,1924,5167
STAT,1839,52,na,1891,1698.4789008393402
STAT,1949,18,20-24,1967,181.90716339908502
STAT,1940,20,40-44,1960,3.9568548552020992
STAT,1843,47,50-100,1890,0.2452814937539529
SIM,1828,35,na,1863,2399
STAT,1922,30,na,1952,4969.014643925896
STAT,1945,30,50-100,1975,1.0636474429148077
SIM,1876,19,na,1895,2793
STAT,1846,42,40-44,1888,2.353410903025841
STAT,1913,48,15-19,1961,4.139979330232444E-4
STAT,1932,62,na,1994,5236.482244211218
STAT,1909,30,50-100,1939,0.9188725120953002
STAT,1943,41,15-19,1984,0.001956085731166326
STAT,1830,39,na,1869,1651.869096816717
STAT,1883,51,35-39,1934,0.009766930844523816
STAT,1920,36,50-100,1956,0.5307625703278854
STAT,1865,22,50-100,1887,0.42977578447114567
STAT,1861,43,20-24,1904,0.15126570929315683
SIM,1900,50,na,1950,3318
SIM,1964,30,45-49,1994,6
STAT,1896,83,na,1979,1268.0300946611617
STAT,1840,28,50-100,1868,0.6352443221611241
STAT,1914,31,45-49,1945,1.8363147641918638
STAT,1942,38,40-44,1980,1.8584463158881037
STAT,1837,44,40-44,1881,1.7047275849820844
STAT,1833,47,25-29,1880,0.04780582280535163
SIM,1957,18,20-24,1975,1
STAT,1849,16,50-100,1865,0.0470175073141755
STAT,1873,49,20-24,1922,0.01384660712453269
STAT,1823,50,25-29,1873,0.0035076872798617954
STAT,1925,84,na,2009,1878.448809822252
SIM,1970,18,50-100,1988,1
STAT,1807,47,50-100,1854,1.0223987335695972
STAT,1829,27,30-34,1856,51.90348370106395
SIM,1817,72,na,1889,292
STAT,1877,52,50-100,1929,0.018033503574119095
STAT,1811,46,35-39,1857,0.44382369427140206
STAT,1894,27,50-100,1921,0.9490087367300766
STAT,1936,31,30-34,1967,17.681348450727583
SIM,1845,44,40-44,1889,2
SIM,1950,25,na,1975,4306
SIM,1922,30,40-44,1952,17
STAT,1969,41,30-34,2010,0.19181338907373247
SIM,1949,50,na,1999,5692
STAT,1897,14,na,1911,3972.2556999041662
STAT,1990,22,40-44,2012,5.575362148947641
SIM,1859,28,20-24,1887,24
SIM,1960,33,30-34,1993,49
STAT,1940,21,45-49,1961,1.323637220531937
STAT,1885,103,na,1988,4.597947171497058
SIM,1925,26,na,1951,5486
STAT,1914,30,40-44,1944,4.584708604049036
STAT,1875,14,na,1889,3078.059322503215
SIM,1957,51,na,2008,6087
SIM,1950,38,40-44,1988,4
SIM,1880,44,35-39,1924,6
STAT,1872,44,35-39,1916,2.070050881209502
SIM,1944,31,30-34,1975,43
STAT,1840,54,40-44,1894,0.008213056387103472
STAT,1872,50,20-24,1922,8.673907968114673E-4
STAT,1937,44,45-49,1981,0.19319447473475787
STAT,1949,18,50-100,1967,0.5026910284385699
SIM,1848,28,45-49,1876,2
STAT,1873,23,na,1896,2778.5733783799556
STAT,1801,59,na,1860,1131.2599627358309
SIM,1818,42,30-34,1860,1
STAT,1888,19,35-39,1907,0.7403730090178151
STAT,1916,48,40-44,1964,0.1861226660761988
STAT,1903,108,na,2011,0.29794545035672804
STAT,1950,42,45-49,1992,0.23601104188083247
STAT,1849,19,20-24,1868,16.715200699292783
STAT,1946,41,40-44,1987,0.3331969177256856
STAT,1872,49,na,1921,2552.6857677418525
STAT,1762,116,na,1878,1.5623689732513816E-4
STAT,1912,42,25-29,1954,0.07955762903789582
STAT,1894,33,30-34,1927,25.792868064433303
STAT,1936,32,35-39,1968,10.249669219656619
STAT,1821,57,na,1878,1332.2818955121236
SIM,1857,19,20-24,1876,37
SIM,1944,32,35-39,1976,4
STAT,1914,33,na,1947,4377.030539262238
STAT,1903,70,na,1973,2806.699087068741
STAT,1937,28,na,1965,4214.5105845361495
SIM,1904,85,na,1989,1169
STAT,1901,42,15-19,1943,0.0015482707778778954
SIM,1826,54,na,1880,1474
STAT,1822,53,35-39,1875,0.015351947856226386
STAT,1925,31,20-24,1956,3.343554125488475
STAT,1868,34,na,1902,2623.211602521856
STAT,1956,30,45-49,1986,2.4521716051636404
SIM,1866,52,na,1918,2201
STAT,1961,32,na,1993,5748.0108973833785
SIM,1882,46,50-100,1928,1
SIM,1930,30,50-100,1960,7
SIM,1866,40,45-49,1906,2
STAT,1962,44,25-29,2006,0.10936915430097047
STAT,1926,43,30-34,1969,0.18156156711994476
STAT,1861,86,na,1947,212.86961342619634
SIM,1836,18,25-29,1854,11
SIM,1837,17,na,1854,2807
SIM,1914,24,50-100,1938,1
SIM,1831,50,25-29,1881,1
SIM,1958,48,40-44,2006,1
STAT,1840,21,40-44,1861,2.141195660880087
STAT,1935,41,30-34,1976,0.20852049874321196
STAT,1836,39,50-100,1875,1.3437569775868667
STAT,1946,42,45-49,1988,0.2213858310084124
STAT,1941,44,na,1985,4573.785250267575
STAT,1877,53,25-29,1930,0.004183721107553618
STAT,1897,46,50-100,1943,0.2143909621047231
SIM,1978,32,35-39,2010,3
SIM,1933,31,20-24,1964,1
STAT,1957,38,na,1995,5891.628991240964
STAT,1979,31,na,2010,6129.297966686102
STAT,1802,54,20-24,1856,0.00282126917858184
STAT,1911,30,15-19,1941,0.1456944932160403
SIM,1818,57,na,1875,1823
STAT,1902,20,20-24,1922,113.04111027074852
SIM,1987,19,40-44,2006,1
STAT,1866,18,45-49,1884,0.07129652720696358
STAT,1922,46,15-19,1968,4.893797450210745E-4
STAT,1853,89,na,1942,104.59328127954434
STAT,1810,44,50-100,1854,4.676600955915999
SIM,1939,39,na,1978,4911
SIM,1931,11,na,1942,6378
STAT,1961,31,30-34,1992,23.958759032511878
SIM,1993,21,20-24,2014,370
STAT,1884,30,45-49,1914,2.004325240760645
SIM,1937,17,40-44,1954,1
SIM,1889,47,na,1936,3620
SIM,1980,2,na,1982,6015
STAT,1883,115,na,1998,1.8148333484503549E-4
STAT,1790,79,na,1869,289.930938720425
STAT,1839,42,na,1881,1931.8259241566989
SIM,1954,42,45-49,1996,1
SIM,1810,48,35-39,1858,1
SIM,1918,42,35-39,1960,1
SIM,1892,30,45-49,1922,2
SIM,1940,47,na,1987,4885
STAT,1808,91,na,1899,29.546962000721678
STAT,1874,33,50-100,1907,1.0779276449001227
SIM,1858,86,na,1944,260
STAT,1857,48,25-29,1905,0.05112098394736939
SIM,1923,0,na,1923,5928
STAT,1812,43,25-29,1855,1.733270990528023
STAT,1821,47,na,1868,1588.6262253060788
SIM,1916,44,na,1960,4358
STAT,1940,47,20-24,1987,0.013473386218639288
SIM,1876,43,30-34,1919,5
SIM,1835,91,na,1926,15
STAT,1977,28,50-100,2005,1.5580044456724813
STAT,1868,43,30-34,1911,1.265506660481998
STAT,1893,48,35-39,1941,0.11374996370744091
SIM,1820,43,25-29,1863,3
STAT,1912,52,na,1964,4009.845364217856
STAT,1846,45,45-49,1891,0.24640487710186793
STAT,1937,41,40-44,1978,0.2917381764373516
SIM,1946,10,na,1956,4694
STAT,1959,16,15-19,1975,68.52876757431277
SIM,1909,15,15-19,1924,14
STAT,1945,32,35-39,1977,11.742986721447853
STAT,1822,49,15-19,1871,7.347574604290566E-4
STAT,1900,20,na,1920,3809.881072396295
STAT,1871,32,25-29,1903,11.75980407232575
SIM,1953,32,35-39,1985,2
SIM,1895,22,na,1917,3689
SIM,1842,61,na,1903,1633
STAT,1861,34,30-34,1895,16.607563796122978
STAT,1958,29,50-100,1987,1.513708984955842
STAT,1954,4,na,1958,5610.548745602997
STAT,1918,41,50-100,1959,0.1443252588627032
SIM,1964,28,na,1992,5485
STAT,1850,43,45-49,1893,1.5295805572845849
SIM,1848,25,40-44,1873,5
SIM,1901,47,50-100,1948,1
STAT,1844,53,na,1897,1772.041849628643
SIM,1945,41,40-44,1986,1
SIM,1932,74,na,2006,3700
STAT,1924,46,25-29,1970,0.07304077130527412
STAT,1848,16,35-39,1864,0.7270201251612048
STAT,1923,40,35-39,1963,0.2722656726008804
SIM,1866,27,50-100,1893,1
STAT,1824,53,45-49,1877,0.0186607636776859
STAT,1929,17,40-44,1946,2.060127583840698
SIM,1926,41,50-100,1967,1
STAT,1938,35,50-100,1973,0.49351455198183025
STAT,1879,50,30-34,1929,0.007276012609326081
STAT,1960,21,20-24,1981,167.74190598013908
STAT,1864,18,35-39,1882,0.5814618125986976
SIM,1871,34,40-44,1905,1
SIM,1870,46,40-44,1916,2
STAT,1862,46,40-44,1908,0.16721062657330887
STAT,1858,27,50-100,1885,0.5895524896127524
SIM,1854,45,45-49,1899,2
STAT,1888,6,na,1894,3543.857552823253
SIM,1812,95,na,1907,6
STAT,1963,13,na,1976,5758.319123614274
STAT,1912,40,25-29,1952,0.08045945299962365
SIM,1833,24,na,1857,1811
SIM,1959,18,30-34,1977,20
SIM,1965,47,50-100,2012,1
STAT,1969,44,35-39,2013,0.30068165665909097
SIM,1880,41,30-34,1921,1
SIM,1920,40,25-29,1960,2
SIM,1988,12,na,2000,6632
STAT,1776,101,na,1877,0.19540618314289177
STAT,1856,40,35-39,1896,1.61041704871824
SIM,1844,39,50-100,1883,1
SIM,1846,42,na,1888,1556
STAT,1839,16,35-39,1855,0.5726169191490443
SIM,1848,23,na,1871,1956
SIM,1827,39,na,1866,1539
SIM,1970,35,35-39,2005,2
SIM,1926,30,25-29,1956,22
SIM,1966,46,25-29,2012,1
SIM,1894,48,na,1942,3577
STAT,1952,49,35-39,2001,0.1843781622625235
STAT,1872,41,30-34,1913,1.3382661469076815
STAT,1902,45,35-39,1947,0.13005721528264425
SIM,1984,19,15-19,2003,127
STAT,1861,50,45-49,1911,0.014123398748495136
SIM,1862,16,na,1878,3138
SIM,1878,43,40-44,1921,1
STAT,1938,14,na,1952,4498.253556813751
STAT,1855,48,15-19,1903,3.3608132133204405E-4
SIM,2010,0,na,2010,7261
STAT,1908,48,na,1956,3828.4941846599836
STAT,1933,47,na,1980,5832.907507878562
STAT,1815,61,na,1876,1283.4243938638094
STAT,1873,53,40-44,1926,0.012207524774260148
STAT,1971,22,35-39,1993,13.808397707001713
SIM,1966,29,50-100,1995,4
STAT,1882,70,na,1952,1581.5662907408084
SIM,1865,56,na,1921,2540
STAT,1974,38,30-34,2012,2.8266977082506175
STAT,1895,45,40-44,1940,0.14651453568316555
STAT,1923,15,na,1938,5009.221090123768
STAT,1901,33,25-29,1934,16.487122581158662
STAT,1972,30,25-29,2002,13.936622730741052
SIM,1852,38,na,1890,1923
STAT,1845,41,50-100,1886,0.7342835949173925
STAT,1809,54,30-34,1863,0.013804449542947527
SIM,1915,48,na,1963,4484
STAT,1858,56,na,1914,1836.2539463883504
STAT,1868,52,20-24,1920,8.138255271424975E-4
STAT,1930,32,40-44,1962,5.829038431686292
STAT,1990,16,na,2006,6084.927973530434
STAT,1794,61,na,1855,1222.5546
SIM,1926,19,30-34,1945,47
STAT,1823,41,35-39,1864,1.9384601700803947
SIM,1853,41,50-100,1894,3
SIM,1840,80,na,1920,174
STAT,1958,46,25-29,2004,0.08383903678860373
SIM,1891,42,45-49,1933,4
SIM,1945,14,na,1959,4776
STAT,1857,71,na,1928,1199.7330443174235
SIM,1878,17,25-29,1895,14
SIM,1898,84,na,1982,1343
STAT,1916,47,50-100,1963,0.2677521005763465
STAT,1843,42,15-19,1885,0.014266854018517551
STAT,1820,47,50-100,1867,0.25483523938401503
STAT,1888,22,na,1910,3208.3648621417246
STAT,1961,33,30-34,1994,23.93001713724261
STAT,1884,47,30-34,1931,0.10985882515015023
STAT,1888,16,30-34,1904,2.1675132084242317
STAT,1908,41,20-24,1949,0.018989050666105994
SIM,1896,16,30-34,1912,3
STAT,1935,44,35-39,1979,0.3268712852228884
SIM,1867,17,15-19,1884,9
SIM,1924,47,50-100,1971,1
STAT,1883,42,45-49,1925,1.6877644039668425
SIM,1847,16,35-39,1863,1
STAT,1962,41,20-24,2003,0.027177718172782646
SIM,1980,30,25-29,2010,1
STAT,1951,58,na,2009,4981.593739307201
STAT,1866,15,40-44,1881,0.20319975768507578
STAT,1946,44,45-49,1990,0.22064922832297723
STAT,1924,11,na,1935,5451.890656204338
STAT,1846,51,30-34,1897,0.006183081930349717
STAT,1899,40,50-100,1939,0.11716117277981755
STAT,1784,83,na,1867,138.46811981222626
STAT,1878,41,25-29,1919,0.7772718168309021
SIM,1837,27,30-34,1864,55
STAT,1942,24,50-100,1966,0.7957740949068283
STAT,1967,30,20-24,1997,3.588217327579732
STAT,1918,30,25-29,1948,11.423225607476276
STAT,1847,93,na,1940,22.487606355075435
SIM,1954,44,45-49,1998,1
STAT,1862,60,na,1922,1857.4640972003117
STAT,1869,29,na,1898,2648.1352411820635
STAT,1964,42,50-100,2006,0.17745888388712797
SIM,1886,41,25-29,1927,2
STAT,1961,34,35-39,1995,13.870699580505091
STAT,1963,47,45-49,2010,0.33144807490913064
STAT,1904,42,40-44,1946,0.25852955522708515
SIM,1972,32,40-44,2004,1
STAT,1957,47,50-100,2004,0.3579654732276418
SIM,1883,85,na,1968,465
STAT,1927,51,na,1978,5252.979257112611
STAT,1843,57,na,1900,2016.4254928729076
SIM,1987,16,na,2003,6550
STAT,1813,46,45-49,1859,0.7954508198077792
STAT,1892,45,15-19,1937,3.296171991365951E-4
STAT,1844,54,25-29,1898,0.002881149615668858
SIM,1911,30,30-34,1941,33
SIM,1875,34,na,1909,3136
STAT,1835,44,30-34,1879,0.8379266494255595
STAT,1944,20,25-29,1964,115.18010445125073
SIM,1972,42,50-100,2014,1
STAT,1881,38,15-19,1919,0.06219724081721598
STAT,1919,42,35-39,1961,0.2517734717035134
STAT,1868,46,35-39,1914,0.15566818736903346
STAT,1940,38,30-34,1978,2.198673591122611
SIM,1820,34,35-39,1854,14
SIM,1968,23,50-100,1991,1
SIM,1942,31,20-24,1973,5
SIM,1950,24,50-100,1974,2
STAT,1899,17,45-49,1916,0.10327948123356388
STAT,1951,45,30-34,1996,0.12802602983966468
SIM,1816,76,na,1892,655
STAT,1873,47,20-24,1920,0.014075948598882011
STAT,1851,49,35-39,1900,0.10870127839541666
SIM,1831,41,35-39,1872,4
STAT,1903,3,na,1906,4345.557776752805
STAT,1973,42,35-39,2015,0.3123406297248228
SIM,1929,62,na,1991,4634
SIM,1868,29,25-29,1897,4
STAT,1889,101,na,1990,16.529435928094337
STAT,1918,19,30-34,1937,15.225147119852373
STAT,1813,52,30-34,1865,0.018901932804573578
STAT,1916,92,na,2008,482.6836676126498
SIM,1967,16,15-19,1983,59
STAT,1935,43,30-34,1978,0.20789124126284628
STAT,1859,17,15-19,1876,6.332878710897941
STAT,1934,31,20-24,1965,3.847438422094103
SIM,1843,44,30-34,1887,1
STAT,1849,19,na,1868,2164.238981555967
SIM,1906,12,na,1918,4007
STAT,1893,33,na,1926,3466.266535345158
SIM,1914,63,na,1977,3564
STAT,1903,30,30-34,1933,28.930579201075293
SIM,1952,20,25-29,1972,6
SIM,1845,68,na,1913,1359
STAT,1950,33,20-24,1983,3.3905578139370247
STAT,1891,3,na,1894,3770.6740564636393
STAT,1918,33,30-34,1951,19.235434551263793
SIM,1961,21,30-34,1982,48
STAT,1942,35,15-19,1977,0.023905572208632583
STAT,1930,18,na,1948,5478.025867941172
SIM,1910,23,25-29,1933,203
STAT,1965,33,15-19,1998,0.1886049388272507
STAT,1944,41,30-34,1985,0.16525036826888864
SIM,1872,59,na,1931,2369
STAT,1960,24,25-29,1984,139.20251917542296
STAT,1949,55,na,2004,4967.872563281603
SIM,1843,20,35-39,1863,9
STAT,1770,105,na,1875,0.00963572447339366
STAT,1900,28,20-24,1928,18.720098450840457
STAT,1873,56,na,1929,2403.6879899387204
STAT,1921,43,30-34,1964,0.16585361620120417
STAT,1925,36,25-29,1961,1.3645937571576616
STAT,1953,21,30-34,1974,40.27024860660508
STAT,1916,38,25-29,1954,1.157964842491871
STAT,1888,102,na,1990,9.611105003145852
STAT,1902,23,25-29,1925,93.05785789242493
STAT,1867,24,45-49,1891,0.7466523066807318
STAT,1927,31,30-34,1958,22.374292844814022
SIM,1958,37,40-44,1995,6
STAT,1930,34,40-44,1964,5.821521393491983
STAT,1805,72,na,1877,692.6493892411216
STAT,1809,86,na,1895,103.12355397704003
STAT,1822,64,na,1886,1457.5634519810847
STAT,1812,101,na,1913,0.2505227864699661
SIM,1866,26,45-49,1892,4
SIM,1917,35,30-34,1952,4
STAT,1792,80,na,1872,383.6809554210678
STAT,1796,94,na,1890,5.0905535057205284
STAT,1803,81,na,1884,218.55129973751247
STAT,1951,33,15-19,1984,0.17989677134032153
STAT,1959,35,40-44,1994,2.33220255885468
STAT,1828,69,na,1897,974.0076898070575
SIM,1905,18,20-24,1923,51
SIM,1867,19,15-19,1886,5
SIM,1949,39,40-44,1988,4
STAT,1815,49,25-29,1864,0.11418243723860998
STAT,1876,22,45-49,1898,0.8318898905533595
SIM,1926,33,30-34,1959,29
SIM,1823,49,25-29,1872,1
SIM,1988,20,15-19,2008,10
SIM,1954,36,50-100,1990,2
STAT,1837,18,na,1855,2189.3847455772743
SIM,1830,28,na,1858,2105
STAT,1894,18,na,1912,3737.018997443918
STAT,1843,26,na,1869,2690.6102927695893
SIM,1920,30,30-34,1950,2
STAT,1958,38,30-34,1996,2.8432213774537876
STAT,1947,46,50-100,1993,0.30658984042649434
STAT,1898,19,50-100,1917,0.07600188926259345
STAT,1913,26,na,1939,4324.771279495932
SIM,1926,26,40-44,1952,7
STAT,1939,43,15-19,1982,0.0018414281649907739
STAT,1903,17,35-39,1920,0.9019555810023134
STAT,1944,23,30-34,1967,35.802372112283614
SIM,1872,49,20-24,1921,1
STAT,1869,5,na,1874,3130.9863492824443
SIM,1908,37,30-34,1945,2
SIM,1899,32,35-39,1931,27
SIM,1971,34,na,2005,5608
SIM,1855,67,na,1922,1035
SIM,1911,17,35-39,1928,2
STAT,1823,81,na,1904,306.2283616068591
STAT,1950,40,45-49,1990,0.2366661538640179
STAT,1977,32,50-100,2009,1.3141280717609776
SIM,1804,75,na,1879,375
SIM,1808,89,na,1897,17
SIM,1900,28,na,1928,3742
SIM,1912,44,40-44,1956,1
SIM,1887,22,15-19,1909,6
SIM,1912,29,na,1941,3635
STAT,1930,41,30-34,1971,0.19443039501526155
STAT,1879,22,15-19,1901,3.975386240317866
STAT,1841,39,25-29,1880,2.95403599720357
STAT,1835,20,35-39,1855,7.598421942428413
STAT,1924,39,15-19,1963,0.026069656051274745
STAT,1914,40,35-39,1954,0.23198883658930536
STAT,1942,28,25-29,1970,79.69910108487798
STAT,1944,49,40-44,1993,0.2024833013322637
STAT,1853,49,45-49,1902,0.23006016912911764
STAT,1939,32,50-100,1971,0.9739466391330349
STAT,1904,44,40-44,1948,0.25535427454742177
SIM,1933,36,25-29,1969,2
SIM,1953,11,na,1964,5699
STAT,1846,16,25-29,1862,7.402636661681095
STAT,1910,24,15-19,1934,5.738866578039195
SIM,1957,25,na,1982,6019
STAT,1910,42,15-19,1952,0.0016766553515802603
SIM,1901,89,na,1990,941
STAT,1929,29,20-24,1958,26.339673629714873
SIM,1909,34,40-44,1943,13
SIM,1929,29,15-19,1958,1
SIM,1837,21,20-24,1858,128
SIM,1854,16,25-29,1870,14
STAT,1833,24,50-100,1857,0.39396759261551517
STAT,1939,25,15-19,1964,0.8200732018055497
SIM,1950,28,25-29,1978,216
STAT,1820,47,40-44,1867,0.17763759370686188
STAT,1907,47,15-19,1954,3.813332076232873E-4
SIM,1887,15,25-29,1902,9
STAT,1884,41,50-100,1925,1.2100390911126602
STAT,1918,26,40-44,1944,5.742931990899139
STAT,1852,94,na,1946,18.84314253913873
STAT,1864,49,20-24,1913,0.012107121377202075
SIM,1906,16,15-19,1922,14
STAT,1859,30,45-49,1889,1.626456551537263
STAT,1899,32,40-44,1931,6.856654237665362
STAT,1860,38,na,1898,2180.445829254391
STAT,1892,47,na,1939,3239.6777157443266
STAT,1912,38,40-44,1950,1.6794010173237228
STAT,1988,20,20-24,2008,184.26508882370706
STAT,1929,37,50-100,1966,0.6220876148561956
SIM,1934,27,30-34,1961,2
STAT,1895,16,20-24,1911,26.697065414236203
STAT,1956,43,na,1999,5884.6505294787585
STAT,1946,40,50-100,1986,0.15670612669962145
STAT,1925,43,15-19,1968,0.0021415706587757863
STAT,1970,16,35-39,1986,6.063579108774645
SIM,1959,35,35-39,1994,7
STAT,1937,46,45-49,1983,0.2539858678894932
SIM,1920,38,40-44,1958,1
SIM,1955,19,15-19,1974,71
SIM,1898,34,40-44,1932,13
SIM,1860,58,na,1918,2041
STAT,1834,22,40-44,1856,2.54329608628806
SIM,2003,7,na,2010,6667
STAT,1877,28,50-100,1905,0.7652124180435004
SIM,1869,71,na,1940,928
STAT,1968,46,na,2014,5521.766663232616
STAT,1869,29,25-29,1898,46.93852609066556
STAT,1967,29,40-44,1996,6.7415708269974735
SIM,1836,76,na,1912,266
SIM,1867,30,45-49,1897,2
STAT,1960,31,15-19,1991,0.19699909574241709
STAT,1874,18,na,1892,2976.052644081061
STAT,1964,17,20-24,1981,197.0615187235892
STAT,1912,30,30-34,1942,18.052213089386285
STAT,1926,27,30-34,1953,54.19534471898942
STAT,1979,22,20-24,2001,177.27018170142213
STAT,1935,28,35-39,1963,23.619530740983386
STAT,1874,46,50-100,1920,0.29098726885552917
SIM,1907,50,na,1957,4219
SIM,1995,18,50-100,2013,1
STAT,1928,40,35-39,1968,0.2970668462479537
STAT,1868,65,na,1933,1873.775724296312
SIM,1987,22,20-24,2009,175
STAT,1908,44,25-29,1952,0.07540421605244606
STAT,1859,19,15-19,1878,6.258497100545092
SIM,1943,28,35-39,1971,1
SIM,1905,71,na,1976,2866
SIM,1935,31,30-34,1966,42
STAT,1883,86,na,1969,564.2221304028874
STAT,1841,38,50-100,1879,1.2728034761303257
SIM,1909,85,na,1994,2078
STAT,1834,41,50-100,1875,1.1772559541977832
STAT,1937,60,na,1997,3988.0275104714074
SIM,1946,27,20-24,1973,40
SIM,1882,89,na,1971,528
STAT,1934,34,25-29,1968,14.5517158297193
SIM,1901,25,25-29,1926,120
STAT,1883,22,na,1905,2670.358136711557
SIM,1828,26,25-29,1854,77
SIM,1925,29,30-34,1954,6
SIM,1901,45,na,1946,3956
SIM,1927,50,na,1977,4850
STAT,1944,26,35-39,1970,18.735657298790787
SIM,1870,88,na,1958,320
STAT,1927,24,40-44,1951,4.749787292699601
STAT,1839,45,50-100,1884,0.20359916550447105
SIM,1823,58,na,1881,1832
STAT,1858,26,45-49,1884,1.0306764149382424
STAT,1907,36,50-100,1943,0.4521247067452631
STAT,1933,37,15-19,1970,0.030198971578068383
STAT,1947,19,15-19,1966,58.95687078381965
SIM,1842,22,40-44,1864,7
STAT,1948,49,25-29,1997,0.07244125793083668
STAT,1861,55,na,1916,1983.7793312246129
STAT,1930,37,45-49,1967,1.0263249918730994
SIM,1935,24,40-44,1959,4
STAT,1890,39,20-24,1929,1.0760495207355256
STAT,1909,38,35-39,1947,2.6319458694907825
SIM,1920,8,na,1928,4701
STAT,1944,19,45-49,1963,0.6200074617662898
SIM,1879,21,25-29,1900,1
STAT,1934,41,15-19,1975,0.002471771329649653
SIM,1870,29,50-100,1899,2
SIM,1890,88,na,1978,429
SIM,1960,17,30-34,1977,26
STAT,1840,48,20-24,1888,0.009583898790466724
SIM,1828,89,na,1917,255
STAT,1927,15,50-100,1942,0.5399794979718022
STAT,1954,47,45-49,2001,0.32251962218996827
STAT,1837,73,na,1910,860.0851014618878
STAT,1876,115,na,1991,1.449716517114279E-4
STAT,1938,27,20-24,1965,20.88032239426001
STAT,1851,110,na,1961,6.430786571497505E-4
STAT,1956,45,na,2001,5862.875360588224
STAT,1925,33,20-24,1958,3.3395430628799514
SIM,1863,21,15-19,1884,6
STAT,1916,78,na,1994,2499.0066097457807
SIM,1869,17,25-29,1886,7
STAT,1863,50,50-100,1913,0.015459348053561686
STAT,1954,38,45-49,1992,1.0009904674018908
STAT,1939,48,20-24,1987,0.013247071572719414
SIM,1959,28,45-49,1987,4
STAT,1870,54,50-100,1924,0.01671024874528944
STAT,1896,49,50-100,1945,0.2067637202893747
STAT,1838,35,na,1873,2285.619750231435
SIM,1904,37,45-49,1941,1
STAT,1898,30,50-100,1928,1.4405370717027408
STAT,1922,34,35-39,1956,11.852414731928995
STAT,1874,73,na,1947,1403.2670964144509
STAT,1878,24,20-24,1902,82.51666976998467
STAT,1940,23,45-49,1963,1.3227637641104795
STAT,1862,29,50-100,1891,0.6185643301257363
SIM,1886,24,20-24,1910,6
STAT,1804,55,na,1859,1420.103218971936
STAT,1904,21,35-39,1925,9.699866178892295
STAT,1808,69,na,1877,972.7856065839896
STAT,1830,36,45-49,1866,2.047565839036624
STAT,1855,21,15-19,1876,3.303134877311139
STAT,1911,17,40-44,1928,0.3232887060082888
SIM,1837,24,25-29,1861,82
STAT,1934,23,50-100,1957,1.020655747230558
SIM,1903,23,35-39,1926,22
STAT,1815,46,20-24,1861,0.024863445784141805
STAT,1841,54,20-24,1895,6.380351788167842E-4
STAT,1857,18,na,1875,2410.650682438805
SIM,1869,16,na,1885,2216
STAT,1941,59,na,2000,4272.425404160284
STAT,1814,101,na,1915,0.35579436334028536
SIM,1799,59,na,1858,931
SIM,1900,34,20-24,1934,9
STAT,1954,30,35-39,1984,13.30437002229288
STAT,1847,20,25-29,1867,54.782261408897895
SIM,1924,62,na,1986,4389
SIM,1955,48,na,2003,6370
STAT,1950,35,20-24,1985,0.37122874382886106
STAT,1944,44,35-39,1988,0.25904215933286345
STAT,1921,46,35-39,1967,0.16808927996444614
SIM,1851,20,40-44,1871,7
STAT,1897,90,na,1987,525.4307167981005
STAT,1852,39,na,1891,2198.891058908223
STAT,1917,29,30-34,1946,47.083751155230125
SIM,1964,37,50-100,2001,5
STAT,1853,56,na,1909,2030.698358866123
STAT,1901,19,25-29,1920,9.111044611074515
SIM,1930,34,35-39,1964,19
STAT,1962,22,35-39,1984,13.969121428703167
STAT,1840,93,na,1933,23.44465535020836
STAT,1948,19,30-34,1967,16.08662290100244
SIM,1970,22,35-39,1992,17
STAT,1798,65,na,1863,729.1371359105812
STAT,1913,36,35-39,1949,2.769389694803172
SIM,1962,30,35-39,1992,25
STAT,1768,99,na,1867,0.32635550614816594
SIM,1855,20,25-29,1875,135
STAT,1830,54,45-49,1884,0.011315355938554653
STAT,1921,39,45-49,1960,0.876259445260022
SIM,1867,68,na,1935,1213
STAT,1810,63,na,1873,1179.7970805748405
STAT,1914,33,45-49,1947,1.8211232542373141
SIM,1956,19,30-34,1975,20
STAT,1846,23,15-19,1869,4.177837484807248
STAT,1887,48,na,1935,2873.209478607152
STAT,1951,29,30-34,1980,54.02539649077601
SIM,1925,31,50-100,1956,2
STAT,1904,47,45-49,1951,0.2195865557201637
SIM,1899,46,na,1945,3839
STAT,1831,54,50-100,1885,0.011832948482308118
SIM,1926,36,35-39,1962,2
STAT,1772,105,na,1877,0.0026296152653940592
SIM,1936,22,35-39,1958,16
STAT,1817,73,na,1890,821.1648153234011
STAT,1860,15,45-49,1875,0.07090512872069525
STAT,1908,46,50-100,1954,0.23814244608157503
SIM,2008,4,na,2012,7733
STAT,1918,29,45-49,1947,2.1061712675783184
STAT,2006,6,na,2012,7021.578655932855
STAT,1843,20,40-44,1863,2.6625467504039992
STAT,1917,31,50-100,1948,1.0032632411242215
STAT,1962,27,na,1989,5563.293452153919
SIM,1854,23,15-19,1877,7
STAT,1928,48,45-49,1976,0.3191346775482057
STAT,1784,93,na,1877,7.2236049850823285
SIM,1884,16,na,1900,2956
STAT,1928,22,35-39,1950,13.566998968170507
STAT,1943,19,30-34,1962,14.907900702193572
STAT,1921,31,35-39,1952,11.779799689032437
SIM,1912,21,35-39,1933,14
STAT,1891,48,25-29,1939,0.04576048568910627
STAT,1968,27,35-39,1995,21.734282252305157
SIM,1925,16,na,1941,5602
STAT,1954,45,35-39,1999,0.19222568478203805
SIM,1918,26,35-39,1944,1
STAT,1979,25,25-29,2004,105.13066585806543
SIM,1901,28,30-34,1929,101
SIM,1933,33,20-24,1966,8
SIM,1942,23,50-100,1965,1
STAT,1918,36,35-39,1954,2.955674877304324
STAT,1841,36,20-24,1877,0.8159102861392529
SIM,1922,33,45-49,1955,6
STAT,1834,21,na,1855,2628.464202433774
STAT,1971,16,50-100,1987,0.5477746991912725
STAT,1829,31,15-19,1860,0.19190981515976835
STAT,1851,33,50-100,1884,0.7484255251974912
STAT,1910,73,na,1983,2836.4715248267735
SIM,1917,32,25-29,1949,16
STAT,1932,39,20-24,1971,0.40797685754751256
STAT,1872,24,50-100,1896,0.4695901904099027
STAT,1871,54,35-39,1925,0.009612476433643673
STAT,1956,17,15-19,1973,69.30372297452519
STAT,1818,90,na,1908,34.88389043652408
SIM,1936,63,na,1999,3621
STAT,1877,18,20-24,1895,21.22636635834642
SIM,1817,62,na,1879,933
SIM,1921,28,50-100,1949,4
SIM,1896,20,15-19,1916,10
STAT,1895,19,25-29,1914,8.466863129964477
SIM,1810,83,na,1893,105
SIM,1893,1,na,1894,3945
STAT,1913,28,50-100,1941,1.1411281888707658
STAT,1855,27,50-100,1882,0.5673538591186796
SIM,1876,29,na,1905,2736
STAT,1960,42,15-19,2002,0.0023988169128706274
STAT,1886,74,na,1960,1534.2418562150378
STAT,1879,15,25-29,1894,6.860241042888646
STAT,1882,60,na,1942,2149.8015362093665
STAT,1924,28,50-100,1952,1.3323751807442215
STAT,1901,26,15-19,1927,0.7359191675511975
STAT,1905,82,na,1987,1615.5096293289466
SIM,1870,24,na,1894,3052
STAT,1888,20,15-19,1908,4.502074814559894
STAT,1965,47,20-24,2012,0.016561307990098806
SIM,1863,27,50-100,1890,3
SIM,1987,25,25-29,2012,10
STAT,1869,51,na,1920,2417.9118070491345
SIM,1918,91,na,2009,648
STAT,1870,0,na,1870,4247.115297857644
SIM,1896,35,50-100,1931,2
STAT,1952,26,40-44,1978,6.4768587988067985
STAT,1927,30,na,1957,5373.9481615933
SIM,1871,41,na,1912,2045
SIM,1937,74,na,2011,2819
STAT,1944,16,40-44,1960,1.7376715825540903
STAT,1937,43,40-44,1980,0.29085779090720987
SIM,1905,28,15-19,1933,1
SIM,1849,41,35-39,1890,2
SIM,1914,16,20-24,1930,61
STAT,1826,34,na,1860,1597.7396458471549
STAT,1936,68,na,2004,3458.7454425355304
STAT,1909,32,25-29,1941,10.19006163959223
STAT,1949,44,15-19,1993,0.002134891980645316
STAT,1961,18,35-39,1979,6.254452438294288
STAT,1967,2,na,1969,5672.893148771499
SIM,1824,75,na,1899,192
STAT,1869,26,20-24,1895,13.156161532922402
STAT,1940,30,35-39,1970,10.930642042262217
SIM,1898,37,45-49,1935,2
STAT,1906,16,20-24,1922,29.908106204805915
STAT,1867,31,35-39,1898,10.956388940932595
STAT,1896,0,na,1896,4475.816913221207
STAT,1846,47,50-100,1893,0.2527132026295264
STAT,1902,30,15-19,1932,0.2340805109740046
SIM,1960,26,40-44,1986,2
SIM,1969,0,na,1969,5838
STAT,1923,18,15-19,1941,61.31638269833149
STAT,1869,82,na,1951,521.4564017767785
SIM,1941,10,na,1951,4044
SIM,1945,24,na,1969,4188
SIM,1907,3,na,1910,4894
STAT,1916,45,15-19,1961,4.381304036654036E-4
STAT,1940,48,na,1988,4466.5867480161605
SIM,1889,40,25-29,1929,3
SIM,1931,18,15-19,1949,1
STAT,1939,31,na,1970,4457.770279802525
STAT,1779,82,na,1861,139.04459085751913
SIM,1973,0,na,1973,5514
STAT,1869,19,na,1888,2828.113100652288
SIM,1960,44,30-34,2004,1
STAT,1886,48,45-49,1934,0.2836756795231812
STAT,1863,21,20-24,1884,71.43909362705479
SIM,1849,34,45-49,1883,2
SIM,1825,30,40-44,1855,5
SIM,1938,27,15-19,1965,5
STAT,1888,35,50-100,1923,1.681342335324884
STAT,1834,25,45-49,1859,1.3479372308708435
SIM,1782,79,na,1861,77
STAT,1963,33,40-44,1996,5.844815780341247
SIM,1839,41,na,1880,2119
SIM,1971,28,50-100,1999,4
SIM,1837,93,na,1930,64
SIM,1994,3,na,1997,6240
SIM,1841,75,na,1916,767
STAT,1970,40,na,2010,5591.235069982127
STAT,2000,8,na,2008,6745.0635334048275
STAT,1906,49,20-24,1955,0.011153510364302984
STAT,1975,36,25-29,2011,1.5457824523513253
SIM,1910,70,na,1980,2383
SIM,1840,58,na,1898,1584
SIM,1906,39,20-24,1945,4
SIM,1842,25,45-49,1867,3
SIM,1906,33,na,1939,3617
SIM,1962,35,40-44,1997,1
SIM,1872,91,na,1963,90
STAT,1808,60,na,1868,1360.6842515075607
STAT,1852,21,45-49,1873,0.7866611097040492
STAT,1838,18,40-44,1856,0.20807822551750316
STAT,1951,49,40-44,2000,0.22404454365934723
STAT,1930,50,na,1980,5533.723471584518
STAT,1841,78,na,1919,694.6752142675246
SIM,1923,24,15-19,1947,1
STAT,1919,89,na,2008,887.8865722608373
STAT,1905,32,40-44,1937,4.159341038651187
STAT,1837,31,20-24,1868,2.479734985741928
SIM,1879,24,30-34,1903,54
SIM,1934,24,25-29,1958,147
STAT,1979,21,na,2000,5823.737062158403
STAT,1902,109,na,2011,0.1302679128280034
STAT,1870,68,na,1938,1738.6673120399773
SIM,1807,63,na,1870,921
STAT,1977,22,30-34,1999,44.96419181281204
STAT,1878,27,25-29,1905,50.97133224723648
STAT,1973,25,15-19,1998,1.0591418327211624
SIM,1959,25,40-44,1984,17
STAT,1877,90,na,1967,266.6084800319777
SIM,1887,68,na,1955,2677
STAT,1941,32,15-19,1973,0.15574242553903697
STAT,1926,24,25-29,1950,128.66745884985622
SIM,1914,7,na,1921,4377
SIM,1858,55,na,1913,2356
SIM,1913,32,40-44,1945,6
STAT,1821,53,40-44,1874,0.017996345366781314
STAT,2001,0,na,2001,6843.796030404584
SIM,1930,31,30-34,1961,37
STAT,1871,47,45-49,1918,0.26969460279742136
STAT,1957,38,15-19,1995,0.030072551604860217
STAT,1931,18,20-24,1949,204.29945133175454
SIM,1951,35,30-34,1986,1
STAT,1844,48,40-44,1892,0.1413962955292137
STAT,1998,15,35-39,2013,7.113988800545925
STAT,1941,47,15-19,1988,4.555725246192392E-4
SIM,1871,21,20-24,1892,129
STAT,1949,49,40-44,1998,0.21881653576627727
STAT,1962,38,40-44,2000,2.2782131910483416
STAT,1950,19,20-24,1969,184.8747923273705
STAT,1960,47,40-44,2007,0.246494363527763
STAT,1917,45,30-34,1962,0.10796566832795104
STAT,1915,24,15-19,1939,6.311538252059994
STAT,1973,40,50-100,2013,0.18272932292007743
STAT,1922,31,30-34,1953,20.61860456839781
SIM,1905,26,50-100,1931,3
STAT,1943,35,30-34,1978,2.3020988033000735
STAT,1946,36,50-100,1982,0.5541673838255395
STAT,1945,27,na,1972,4743.029048661963
STAT,1891,45,20-24,1936,0.00975100088343965
STAT,1952,21,15-19,1973,7.38856954281736
SIM,1809,75,na,1884,683
SIM,1805,61,na,1866,1256
SIM,1970,38,40-44,2008,1
STAT,1928,45,40-44,1973,0.2332458985045061
STAT,1920,40,30-34,1960,0.16333080839317898
SIM,1918,1,na,1919,4457
STAT,1891,45,50-100,1936,0.19957047684621407
STAT,1783,99,na,1882,0.26730683092645385
STAT,1909,65,na,1974,3399.826054761377
STAT,1826,31,45-49,1857,1.7377589192400602
STAT,1903,44,25-29,1947,0.07231104802508431
SIM,1939,15,15-19,1954,51
SIM,1866,83,na,1949,370
STAT,1928,56,na,1984,5207.962097734937
SIM,1929,19,20-24,1948,362
STAT,1940,16,20-24,1956,158.9558327053824
SIM,1908,68,na,1976,2778
STAT,1891,27,20-24,1918,16.732782250235864
STAT,1911,42,30-34,1953,0.14093849272637846
SIM,1942,25,15-19,1967,4
STAT,1869,102,na,1971,3.1779001706094054
STAT,1947,35,15-19,1982,0.025763153728067343
SIM,1892,41,50-100,1933,4
STAT,1921,91,na,2012,649.0134067580694
STAT,1954,42,30-34,1996,0.18954931531020236
SIM,1943,22,25-29,1965,1
SIM,1823,89,na,1912,288
SIM,1838,55,na,1893,1432
STAT,1982,16,50-100,1998,0.60858260131775
STAT,1924,42,na,1966,5096.708124425052
STAT,1931,22,40-44,1953,5.033791178368754
STAT,1915,42,15-19,1957,0.0017845753658999543
STAT,1847,16,40-44,1863,0.1766925522859296
SIM,1796,62,na,1858,824
SIM,1888,15,40-44,1903,1
STAT,1819,35,20-24,1854,3.203106599904475
STAT,1858,35,na,1893,2141.1971576800565
STAT,1876,18,50-100,1894,0.05829314606199739
SIM,1841,23,na,1864,2322
SIM,1932,29,20-24,1961,3
STAT,1924,29,20-24,1953,24.345762253960377
STAT,1854,21,na,1875,2061.503719501113
SIM,1899,22,40-44,1921,4
STAT,1880,45,45-49,1925,0.29156299690318654
SIM,1845,37,na,1882,2105
STAT,1870,17,50-100,1887,0.05627021776144233
STAT,1934,25,15-19,1959,1.0974722977584384
STAT,1927,18,35-39,1945,6.00403073404877
SIM,1832,31,50-100,1863,2
STAT,1954,35,40-44,1989,2.204111427259319
SIM,1834,31,45-49,1865,4
STAT,1988,5,na,1993,6489.606072613326
STAT,1935,22,25-29,1957,145.23927489732378
SIM,1837,70,na,1907,1401
STAT,1871,18,25-29,1889,6.509570713998849
SIM,1877,29,25-29,1906,64
SIM,1904,34,40-44,1938,7
SIM,1911,44,25-29,1955,1
STAT,1847,105,na,1952,0.02256091791806713
SIM,1827,35,20-24,1862,1
SIM,1820,37,40-44,1857,12
SIM,1834,41,na,1875,1861
SIM,1878,30,20-24,1908,1
STAT,1950,38,25-29,1988,1.3827804769492114
SIM,1902,32,30-34,1934,61
SIM,1794,71,na,1865,552
STAT,1860,69,na,1929,1364.9748015126354
SIM,1845,31,20-24,1876,3
STAT,1880,27,45-49,1907,1.3581685649114366
SIM,1909,44,35-39,1953,1
STAT,1938,45,na,1983,4372.785199429523
SIM,1959,32,30-34,1991,2
SIM,1899,22,50-100,1921,4
SIM,1913,28,20-24,1941,20
STAT,1945,48,na,1993,4803.961986653775
SIM,1853,25,20-24,1878,1
SIM,1857,41,40-44,1898,4
SIM,1933,46,na,1979,6360
SIM,1958,28,30-34,1986,6
STAT,1961,45,35-39,2006,0.20089391382126737
STAT,1936,16,35-39,1952,4.650385489261608
STAT,1868,15,15-19,1883,6.7787938923842255
STAT,1899,26,na,1925,3786.210172969377
STAT,1941,34,na,1975,4577.786749231975
STAT,1888,86,na,1974,749.9518516908555
STAT,1911,24,30-34,1935,31.286850772517898
STAT,1942,25,20-24,1967,22.132814270937555
STAT,1769,101,na,1870,0.1930008505715465
SIM,1918,19,45-49,1937,2
STAT,1926,13,na,1939,5596.449705774306
STAT,1878,34,15-19,1912,0.17012579114790047
SIM,1914,30,35-39,1944,19
STAT,1867,91,na,1958,89.41590058461082
STAT,1925,27,15-19,1952,0.9619486873865972
STAT,1884,72,na,1956,1477.450118295048
STAT,1966,35,20-24,2001,0.3921444937228404
SIM,1902,25,40-44,1927,4
SIM,1933,27,15-19,1960,2
STAT,1905,28,20-24,1933,19.526329494349
STAT,1981,25,45-49,2006,2.8023597104192612
STAT,1960,15,15-19,1975,68.25082115459415
STAT,1976,8,na,1984,6059.45290214131
SIM,1913,46,na,1959,4469
STAT,1785,78,na,1863,203.09918362729027
SIM,1908,34,25-29,1942,1
STAT,1909,32,na,1941,4169.73881034775
SIM,1918,18,50-100,1936,1
SIM,1956,49,50-100,2005,1
STAT,1810,94,na,1904,11.379818860111271
SIM,1935,18,35-39,1953,15
SIM,1885,28,50-100,1913,3
SIM,1950,25,20-24,1975,52
SIM,1966,32,20-24,1998,9
STAT,1960,47,20-24,2007,0.017277642974796885
STAT,1849,41,40-44,1890,1.751230431849615
STAT,1897,48,20-24,1945,0.010314224499844817
STAT,1797,80,na,1877,314.68904562213424
SIM,1855,23,30-34,1878,48
SIM,1944,16,35-39,1960,7
STAT,1877,47,40-44,1924,0.20455804378125303
SIM,1865,34,50-100,1899,1
STAT,1907,53,na,1960,3702.9169587894958
STAT,1890,2,na,1892,3758.90092694708
STAT,1930,44,35-39,1974,0.30478400679108925
SIM,1890,24,na,1914,3621
STAT,1971,36,40-44,2007,2.2563309654587385
STAT,1847,23,30-34,1870,16.681261774522724
SIM,1829,30,25-29,1859,16
STAT,1987,18,50-100,2005,0.617047260969255
STAT,1898,31,na,1929,3737.092366048681
STAT,1959,38,45-49,1997,1.0591626632808933
STAT,1874,115,na,1989,1.2698118713707E-4
STAT,1920,48,40-44,1968,0.20048456384456728
SIM,1912,28,40-44,1940,7
SIM,1967,26,30-34,1993,3
STAT,1951,23,20-24,1974,153.2622997623754
STAT,1933,71,na,2004,4449.691435921357
SIM,1979,31,25-29,2010,34
STAT,1839,21,na,1860,2194.4547578982333
STAT,1920,15,40-44,1935,0.3648747427725614
STAT,1952,29,45-49,1981,2.3971867433530547
SIM,1839,15,45-49,1854,3
SIM,1878,31,50-100,1909,2
STAT,1880,52,35-39,1932,0.010474894528131912
SIM,1967,19,40-44,1986,2
STAT,1959,19,40-44,1978,2.110053142462121
SIM,1854,62,na,1916,1915
SIM,1881,40,na,1921,1910
STAT,1997,17,40-44,2014,2.3570896881226666
SIM,1908,24,na,1932,3623
STAT,1898,52,na,1950,3340.467128122718
STAT,1879,31,25-29,1910,12.392970988480078
STAT,1885,13,na,1898,2968.1424063614995
SIM,1886,25,50-100,1911,2
SIM,1885,54,na,1939,2753
STAT,1904,28,40-44,1932,4.9468316384595346
STAT,1920,22,30-34,1942,36.858589448333845
STAT,1896,20,20-24,1916,105.66909913978476
STAT,1991,4,na,1995,6504.106271033129
STAT,1947,20,50-100,1967,0.8587856209768985
STAT,1898,44,40-44,1942,0.24032490062777434
SIM,1889,16,na,1905,3987
STAT,1821,78,na,1899,477.85658646634096
STAT,1915,21,45-49,1936,1.3465402610767863
STAT,1845,25,20-24,1870,9.761832431187102
STAT,1826,78,na,1904,430.2061259215731
SIM,1906,2,na,1908,4078
SIM,1829,26,40-44,1855,1
STAT,1972,26,na,1998,5561.7644000323835
STAT,1926,31,15-19,1957,0.179388075072498
SIM,1901,14,na,1915,4466
STAT,1891,21,na,1912,3383.4961455536313
SIM,1909,28,35-39,1937,41
STAT,1906,13,na,1919,4339.293362492415
STAT,1832,38,20-24,1870,0.6699838903019893
STAT,1916,35,20-24,1951,0.3145268757741256
STAT,1959,26,30-34,1985,59.431498262786285
SIM,1886,27,25-29,1913,44
SIM,1924,87,na,2011,457
SIM,1958,11,na,1969,6233
STAT,1914,43,na,1957,4242.295194681257
SIM,1968,30,30-34,1998,5
STAT,1821,35,40-44,1856,10.81358913698646
STAT,1964,24,45-49,1988,1.6397484767496477
SIM,1922,50,na,1972,4946
SIM,1943,45,na,1988,5323
SIM,1935,27,45-49,1962,7
SIM,1973,11,na,1984,5489
STAT,1890,48,50-100,1938,0.19290177496839667
STAT,1901,69,na,1970,2793.436474632473
STAT,1889,45,50-100,1934,0.3528662106871707
SIM,1945,37,35-39,1982,4
SIM,1934,21,20-24,1955,355
STAT,1839,47,20-24,1886,0.009696182366923349
STAT,1931,35,na,1966,5761.313132635708
SIM,1862,37,45-49,1899,2
STAT,1905,35,45-49,1940,0.7255261829786274
SIM,1887,31,25-29,1918,22
SIM,1873,76,na,1949,1063
SIM,1913,79,na,1992,2345
STAT,1920,43,35-39,1963,0.25614082984884495
STAT,1952,17,30-34,1969,16.85675014372142
STAT,1925,45,50-100,1970,0.3176821911619547
SIM,1897,45,50-100,1942,1
SIM,1902,35,35-39,1937,2
STAT,1889,27,na,1916,3394.994621189077
STAT,1854,37,45-49,1891,1.6240876053149969
STAT,1976,32,45-49,2008,2.473022278357109
STAT,1882,106,na,1988,0.6717233638648328
STAT,1842,32,40-44,1874,4.031435709203641
SIM,1972,24,45-49,1996,1
STAT,1963,36,45-49,1999,1.0306792842148211
STAT,1973,22,na,1995,5468.483034318326
SIM,1827,38,25-29,1865,7
STAT,1855,50,35-39,1905,0.007430679311618207
STAT,1871,15,20-24,1886,20.729526454476225
SIM,1961,24,35-39,1985,32
STAT,1908,9,na,1917,4447.437766896257
STAT,1953,24,35-39,1977,13.179611230224534
STAT,1868,4,na,1872,3306.408442792083
STAT,1768,112,na,1880,7.328868625450717E-4
STAT,1930,18,40-44,1948,2.081689679565066
STAT,1931,32,35-39,1963,13.821896515791165
STAT,1927,15,30-34,1942,17.567336572302153
STAT,1948,46,20-24,1994,0.015218653240013749
STAT,1871,44,40-44,1915,2.547594627977846
SIM,1926,64,na,1990,5148
STAT,1973,37,na,2010,5785.096572451327
STAT,1931,25,45-49,1956,2.5768176334586146
STAT,1819,38,25-29,1857,7.574044549100029
SIM,1888,25,35-39,1913,33
SIM,1882,80,na,1962,1130
SIM,1901,22,20-24,1923,1
STAT,1806,48,20-24,1854,0.04351481334552152
STAT,1847,19,45-49,1866,0.06199596645605081
STAT,1961,30,50-100,1991,1.2579921095298294
SIM,1909,37,45-49,1946,2
STAT,1831,89,na,1920,82.4215345355124
STAT,1925,27,na,1952,5104.595620058697
STAT,1872,39,na,1911,2702.634183599382
STAT,1938,34,45-49,1972,1.824513283328372
SIM,1784,82,na,1866,41
SIM,1878,20,na,1898,2793
STAT,1838,99,na,1937,1.6404866193432377
SIM,1949,52,na,2001,5622
SIM,1866,23,40-44,1889,7
SIM,1841,44,na,1885,1822
STAT,1870,38,40-44,1908,4.95568809188081
STAT,1789,81,na,1870,167.64472591136297
STAT,1816,42,40-44,1858,5.0945900293821005
SIM,1974,38,25-29,2012,1
SIM,1899,18,20-24,1917,63
STAT,1963,27,35-39,1990,22.107438969310053
STAT,1964,31,35-39,1995,13.547330346574382
SIM,1971,27,35-39,1998,69
SIM,1856,20,40-44,1876,1
STAT,1953,17,45-49,1970,0.6973868746304386
STAT,1973,29,50-100,2002,1.490548520738396
STAT,1871,51,30-34,1922,0.006866978438641189
STAT,1873,87,na,1960,323.35699077905866
STAT,1915,47,20-24,1962,0.012853526197936989
STAT,1966,38,25-29,2004,1.4606890201181648
SIM,1825,37,na,1862,1788
SIM,1871,10,na,1881,2417
SIM,1974,32,50-100,2006,3
STAT,1938,71,na,2009,3320.195903058293
SIM,1886,28,na,1914,2013
SIM,1974,28,30-34,2002,120
STAT,1836,33,na,1869,2467.247263719182
STAT,1848,20,40-44,1868,2.735033128489662
STAT,1872,22,25-29,1894,66.33634106805661
STAT,1937,39,20-24,1976,0.3037205568367154
SIM,1883,31,40-44,1914,1
STAT,1996,10,na,2006,6589.966285219242
STAT,1849,10,na,1859,2306.0735684063084
SIM,1911,42,50-100,1953,2
STAT,1885,20,45-49,1905,0.8074826455337056
STAT,1963,29,20-24,1992,26.852271699548492
SIM,1868,54,na,1922,2769
STAT,1819,44,na,1863,1850.2472476360272
STAT,1845,28,25-29,1873,34.44658030115192
STAT,1943,28,40-44,1971,5.726563873586923
SIM,1927,29,50-100,1956,1
SIM,1951,28,40-44,1979,10
SIM,1894,39,50-100,1933,1
STAT,1908,79,na,1987,2081.716283996985
STAT,1871,21,na,1892,2723.5726121523835
STAT,1910,36,30-34,1946,2.0233937487212112
STAT,1870,80,na,1950,703.7919619758337
STAT,1956,49,20-24,2005,0.017450598204072073
STAT,1903,42,50-100,1945,0.1204426222475894
SIM,1869,39,na,1908,1959
STAT,1890,35,na,1925,3353.762437832319
STAT,1972,42,40-44,2014,0.3840863564253849
SIM,1921,9,na,1930,5566
STAT,1936,43,25-29,1979,0.08152872132777743
STAT,1885,57,na,1942,2313.304854050813
STAT,1882,34,50-100,1916,1.023963261142032
SIM,1829,29,45-49,1858,3
STAT,1896,19,40-44,1915,0.27730146059321037
SIM,1918,20,25-29,1938,107
STAT,1858,23,40-44,1881,1.9446864761326434
STAT,1875,31,40-44,1906,5.193084077216287
STAT,1971,39,45-49,2010,1.0243981470283356
SIM,1870,40,50-100,1910,1
STAT,1921,36,40-44,1957,1.9300418746864396
STAT,1862,40,50-100,1902,1.0392948347516549
STAT,1961,42,30-34,2003,0.19809685608864186
SIM,1909,25,30-34,1934,59
STAT,1938,41,35-39,1979,0.2386903062919073
STAT,1900,100,na,2000,32.3346252798192
STAT,1940,19,25-29,1959,50.760216216102
STAT,1841,55,na,1896,1838.3837706548625
STAT,1920,18,45-49,1938,0.6448208493722923
SIM,1946,34,45-49,1980,5
SIM,1902,28,45-49,1930,1
STAT,1950,29,15-19,1979,0.966510054802615
SIM,1899,25,45-49,1924,5
STAT,1849,51,na,1900,1676.8366718611232
SIM,1856,84,na,1940,303
STAT,1828,47,45-49,1875,0.2173180132611223
STAT,1917,38,40-44,1955,1.7855415917772004
STAT,1962,33,25-29,1995,13.922337684771318
STAT,1927,34,35-39,1961,12.953387692389285
STAT,1958,22,na,1980,5553.453502490203
STAT,1953,42,35-39,1995,0.29214851805464703
SIM,1967,29,35-39,1996,1
STAT,1975,7,na,1982,5984.253060053376
SIM,1819,41,na,1860,1253
SIM,1886,50,na,1936,1881
STAT,1852,46,25-29,1898,0.05446023820350449
STAT,1820,93,na,1913,17.152374459482765
STAT,1884,16,45-49,1900,0.07466502030428955
STAT,1821,38,45-49,1859,4.245627470847534
STAT,1910,29,40-44,1939,5.162505007721675
STAT,1857,39,na,1896,2096.26496029167
STAT,1992,18,30-34,2010,20.184111646873376
STAT,1846,32,25-29,1878,12.513109366498453
STAT,1912,21,na,1933,4237.427988649313
STAT,1959,29,35-39,1988,22.739543372268002
STAT,1941,37,20-24,1978,0.32290774792056387
SIM,1935,34,35-39,1969,20
SIM,1915,17,na,1932,4986
STAT,1958,35,25-29,1993,1.5402094841381697
STAT,1853,25,na,1878,2531.2920438979554
STAT,1937,37,35-39,1974,2.792732346308241
STAT,1811,49,40-44,1860,0.5159909129816054
SIM,1855,36,na,1891,1842
STAT,1926,21,20-24,1947,156.33671902223134
SIM,1914,32,na,1946,3992
SIM,1854,32,25-29,1886,15
STAT,1927,27,45-49,1954,2.4232867918256873
SIM,1887,42,50-100,1929,5
SIM,1925,38,40-44,1963,1
SIM,1873,37,20-24,1910,2
STAT,1905,42,35-39,1947,0.20977880231392165
STAT,1854,73,na,1927,967.6585074845616
SIM,1898,20,na,1918,4072
STAT,1890,68,na,1958,2248.7639828304673
STAT,1920,25,35-39,1945,19.12732854198508
STAT,1824,46,50-100,1870,0.33806467496430204
SIM,1840,37,na,1877,2022
SIM,1853,28,25-29,1881,52
STAT,1951,26,25-29,1977,90.88452925662126
SIM,1903,20,30-34,1923,41
STAT,1919,31,na,1950,4727.097116988773
SIM,1909,18,40-44,1927,1
STAT,1795,77,na,1872,298.7523640896167
STAT,1865,37,20-24,1902,0.8026510839666574
STAT,1850,23,50-100,1873,0.5002461129426107
SIM,1880,3,na,1883,3847
STAT,1918,21,15-19,1939,6.6441933892342
SIM,1928,35,40-44,1963,4
STAT,1906,105,na,2011,2.581146042134507
SIM,1867,23,20-24,1890,121
STAT,1865,22,35-39,1887,6.150090755955048
STAT,1819,46,40-44,1865,0.33445277183492594
SIM,1854,47,50-100,1901,1
STAT,1827,45,20-24,1872,0.015611063986790819
SIM,1847,25,45-49,1872,4
STAT,1920,1,na,1921,5404.761440974294
STAT,1880,23,15-19,1903,4.023032532548217
STAT,1946,32,30-34,1978,20.556052870503194
SIM,1850,35,45-49,1885,5
SIM,1975,24,15-19,1999,1
STAT,1843,48,25-29,1891,0.05706855017048319
STAT,1871,44,na,1915,2617.776750345327
SIM,1806,87,na,1893,36
SIM,1917,23,15-19,1940,12
STAT,1958,44,50-100,2002,0.18443921960231446
STAT,1984,18,25-29,2002,71.0063896795613
SIM,1949,27,25-29,1976,14
SIM,1818,48,40-44,1866,2
SIM,1951,34,50-100,1985,1
SIM,1903,34,25-29,1937,27
STAT,1940,44,15-19,1984,0.0018644122884925922
SIM,1914,20,40-44,1934,10
STAT,1925,17,20-24,1942,188.94276097803544
STAT,1967,24,15-19,1991,7.6938525867428025
SIM,1954,32,30-34,1986,36
STAT,1852,61,na,1913,1761.7747173426847
STAT,1888,25,40-44,1913,4.091275409312151
STAT,1910,98,na,2008,81.97410123072176
STAT,1930,44,50-100,1974,0.17781488232454032
STAT,1848,23,45-49,1871,0.8956727642316159
SIM,1955,13,na,1968,6578
STAT,1841,24,na,1865,2373.7165102988233
STAT,1862,33,20-24,1895,2.6214869621676504
SIM,1868,31,na,1899,3103
STAT,1794,82,na,1876,221.8750151902321
STAT,1862,8,na,1870,2739.140928887337
SIM,1938,39,30-34,1977,3
SIM,1825,42,50-100,1867,1
STAT,1839,25,45-49,1864,1.1253668415163662
STAT,1887,79,na,1966,1302.8436295613963
SIM,1958,25,25-29,1983,205
SIM,1864,24,35-39,1888,9
SIM,1961,35,25-29,1996,1
STAT,1875,41,35-39,1916,2.1693397511863624
SIM,1872,36,na,1908,2989
SIM,1878,36,30-34,1914,4
STAT,1905,38,15-19,1943,0.020144673983583824
SIM,1873,22,35-39,1895,1
STAT,1889,38,20-24,1927,1.0911468721551059
STAT,1892,16,na,1908,3662.0955652395505
STAT,1811,89,na,1900,54.09138360093111
SIM,1896,25,40-44,1921,13
STAT,1874,20,35-39,1894,6.935447194899479
STAT,1929,33,40-44,1962,5.733240814876172
STAT,1881,16,40-44,1897,0.2040947491585706
SIM,1984,15,25-29,1999,173
STAT,1822,41,na,1863,2296.659997512929
STAT,1854,3,na,1857,2753.4834301004607
STAT,1885,88,na,1973,463.05543565096394
SIM,1883,41,35-39,1924,3
STAT,1956,39,50-100,1995,0.6591363810500154
STAT,1807,74,na,1881,646.7602395918173
STAT,1872,18,40-44,1890,0.2113931625663841
STAT,1953,35,25-29,1988,1.4185959920187932
SIM,1919,37,40-44,1956,4
SIM,1853,36,40-44,1889,10
STAT,1794,92,na,1886,15.301816773502217
SIM,1813,59,na,1872,1197
SIM,1878,29,40-44,1907,1
STAT,1979,36,45-49,2015,1.1170194607251895
STAT,1879,34,30-34,1913,20.85915911222934
STAT,1826,57,na,1883,1179.116520508951
STAT,1937,49,15-19,1986,4.268995723734466E-4
SIM,1838,34,35-39,1872,6
SIM,1919,44,30-34,1963,1
STAT,1875,68,na,1943,1822.5213914049116
SIM,1851,74,na,1925,1616
SIM,1806,77,na,1883,525
SIM,1937,33,40-44,1970,1
STAT,1877,49,na,1926,2644.4190854880567
SIM,1838,27,45-49,1865,2
STAT,1887,38,50-100,1925,1.5799921456032764
SIM,1824,45,45-49,1869,2
SIM,1922,21,30-34,1943,93
STAT,1934,15,20-24,1949,212.7169562332979
STAT,1889,7,na,1896,3706.299639392482
SIM,1954,25,40-44,1979,1
SIM,1942,50,na,1992,4855
STAT,1959,23,25-29,1982,139.85331088544424
STAT,1896,26,30-34,1922,38.516144980313136
STAT,1907,21,50-100,1928,0.694508262386162
STAT,1892,48,20-24,1940,0.009667890299024253
STAT,1816,45,45-49,1861,0.49603424583650596
STAT,1927,45,25-29,1972,0.07718736610515563
STAT,1792,102,na,1894,0.08232605093748216
SIM,1891,19,na,1910,3525
SIM,1941,39,50-100,1980,1
STAT,1824,31,50-100,1855,2.1755035956390927
STAT,1859,23,20-24,1882,65.25747515226767
STAT,1930,22,25-29,1952,136.57779660356954
SIM,1868,44,20-24,1912,1
STAT,1862,50,25-29,1912,0.0034992545198695188
STAT,1993,16,25-29,2009,71.97352198930487
SIM,1849,27,20-24,1876,2
SIM,1979,34,30-34,2013,7
STAT,1849,51,35-39,1900,0.0067045340740734365
STAT,1854,96,na,1950,6.995523985514008
STAT,1850,18,20-24,1868,22.170543022394
SIM,1823,35,na,1858,2414
STAT,1833,26,20-24,1859,11.166260294961678
STAT,1877,39,25-29,1916,3.4215313358512853
SIM,1857,44,45-49,1901,4
SIM,1907,27,20-24,1934,3
STAT,1884,17,na,1901,2879.749112616436
STAT,1848,30,35-39,1878,12.811732949895472
STAT,1906,20,40-44,1926,3.5277049149318995
STAT,1909,23,15-19,1932,5.698291108688906
SIM,1841,26,20-24,1867,2
SIM,1955,23,na,1978,6073
STAT,1923,15,45-49,1938,0.6798357109977325
SIM,1885,39,25-29,1924,7
SIM,1821,44,na,1865,1510
STAT,1865,15,45-49,1880,0.07793820837201675
SIM,1877,15,30-34,1892,1
STAT,1963,24,30-34,1987,42.24980897729429
STAT,1855,26,40-44,1881,2.6760295263140983
STAT,1906,39,50-100,1945,0.44146823475804
SIM,1860,30,50-100,1890,3
STAT,1989,26,45-49,2015,2.8693564067024164
STAT,1782,81,na,1863,268.0513360133397
STAT,1908,25,20-24,1933,20.24520202723567
STAT,1956,29,30-34,1985,60.03387929829039
STAT,1968,11,na,1979,5662.935081272676
STAT,1876,47,25-29,1923,0.06839522581273567
SIM,1908,90,na,1998,249
STAT,1777,80,na,1857,182.1057878787933
SIM,1965,28,20-24,1993,1
STAT,1840,29,15-19,1869,0.4473128109423432
STAT,1970,36,25-29,2006,1.4667522177739465
STAT,1957,28,20-24,1985,27.88122553977556
SIM,1849,40,na,1889,2597
SIM,1940,73,na,2013,3002
STAT,1937,27,40-44,1964,5.246305794457464
SIM,1938,11,na,1949,4188
STAT,1946,25,40-44,1971,5.997071555260365
SIM,1964,29,30-34,1993,76
SIM,1935,72,na,2007,4496
SIM,1943,12,na,1955,5464
STAT,1869,15,30-34,1884,1.8274526187380167
STAT,1914,24,35-39,1938,11.037462001636486
SIM,1971,24,30-34,1995,1
STAT,1889,23,35-39,1912,8.275723370108448
SIM,1887,34,30-34,1921,37
STAT,1887,69,na,1956,1931.1329875431377
SIM,1967,23,25-29,1990,284
SIM,1886,35,40-44,1921,1
STAT,1830,25,25-29,1855,58.969118302314094
SIM,1928,45,na,1973,5655
SIM,1975,17,25-29,1992,157
STAT,1959,30,15-19,1989,0.19795970052611103
STAT,1967,17,25-29,1984,62.47060517008513
SIM,1856,1,na,1857,3420
STAT,1912,89,na,2001,787.6531439555424
SIM,1919,86,na,2005,1218
STAT,1869,47,50-100,1916,0.2732049393299134
STAT,1881,48,45-49,1929,0.25939765268220183
SIM,1811,78,na,1889,560
STAT,1868,86,na,1954,246.00912939176646
SIM,1940,16,50-100,1956,1
STAT,1857,34,50-100,1891,0.8164805401009969
STAT,1949,42,50-100,1991,0.16386444008536194
STAT,1908,20,50-100,1928,0.7031605254030232
STAT,1911,14,na,1925,4549.913843304412
STAT,1930,49,na,1979,5551.322678403078
STAT,1878,35,40-44,1913,5.3247907806534895
STAT,1947,0,na,1947,5770.88627207574
SIM,1922,24,35-39,1946,30
SIM,1927,5,na,1932,5344
STAT,1809,55,na,1864,1284.4693934939442
STAT,1955,5,na,1960,6023.571708199155
STAT,1829,36,40-44,1865,5.126049177127712
STAT,1886,44,15-19,1930,0.0165839444858203
STAT,1971,31,50-100,2002,1.2325630701947292
STAT,1977,17,50-100,1994,0.5841990611097824
SIM,1957,3,na,1960,6330
STAT,1826,53,50-100,1879,0.010293335744572918
STAT,1867,17,20-24,1884,19.528268554549683
SIM,1912,32,25-29,1944,24
STAT,1878,25,50-100,1903,0.7760302664111685
STAT,1972,22,30-34,1994,42.608597078376775
STAT,1933,49,30-34,1982,0.14070777110955165
STAT,1853,35,20-24,1888,0.7835768742911061
STAT,1918,94,na,2012,314.8434588839163
STAT,1845,39,45-49,1884,1.3824056478298978
STAT,1879,27,40-44,1906,3.6097110567530435
SIM,1924,21,na,1945,4749
STAT,1820,35,25-29,1855,7.963586281245058
SIM,1858,28,25-29,1886,65
STAT,1872,71,na,1943,1546.7698970243143
STAT,1863,31,15-19,1894,0.14429230043502642
STAT,1864,24,40-44,1888,2.150554933565371
STAT,1969,15,35-39,1984,6.052488854496924
SIM,1912,20,na,1932,3528
SIM,1875,17,20-24,1892,46
SIM,1896,70,na,1966,2615
STAT,1904,32,25-29,1936,9.74660946765903
SIM,1847,32,35-39,1879,31
STAT,1910,39,35-39,1949,2.6455016747890334
SIM,1882,19,20-24,1901,19
STAT,1956,10,na,1966,6000.196311597449
STAT,1954,17,50-100,1971,0.5345087567388015
SIM,1837,36,40-44,1873,11
STAT,1837,94,na,1931,14.472480923184927
STAT,1910,50,na,1960,3924.0762555095253
SIM,1916,25,20-24,1941,24
SIM,1977,15,35-39,1992,10
SIM,1909,38,50-100,1947,3
SIM,1945,34,30-34,1979,5
SIM,1926,21,15-19,1947,15
STAT,1937,34,30-34,1971,17.975111534884572
STAT,1810,46,20-24,1856,0.04772677014220942
STAT,1886,37,25-29,1923,3.5048788212548763
STAT,1875,34,45-49,1909,2.061869014207475
STAT,1917,48,35-39,1965,0.15498515252830278
STAT,1839,32,35-39,1871,9.883401350996083
STAT,1852,71,na,1923,1258.4679485647027
SIM,1894,37,25-29,1931,10
STAT,1976,35,50-100,2011,0.6680678021722779
SIM,1865,102,na,1967,10
STAT,1914,17,45-49,1931,0.11930904158857376
SIM,1832,28,20-24,1860,23
STAT,1828,43,15-19,1871,0.013074538943503041
STAT,1972,15,40-44,1987,2.0678468851833816
SIM,1951,38,35-39,1989,9
SIM,1868,39,40-44,1907,9
STAT,1953,32,20-24,1985,3.4710068832139642
STAT,1823,47,45-49,1870,0.23318136204933168
STAT,1946,44,na,1990,4923.849206443472
STAT,1797,79,na,1876,345.97562103206377
STAT,1932,20,35-39,1952,14.34624952643394
STAT,1879,112,na,1991,0.004055811159580071
SIM,1825,48,30-34,1873,1
STAT,1830,32,15-19,1862,0.1540806557320432
STAT,1976,10,na,1986,6058.059307958596
SIM,1829,33,30-34,1862,23
STAT,1900,17,30-34,1917,2.5523518615715655
SIM,1914,23,45-49,1937,3
SIM,1871,74,na,1945,551
STAT,1794,102,na,1896,0.07337740034914335
STAT,1894,39,40-44,1933,6.428835831192101
STAT,1994,15,15-19,2009,75.61890278571408
STAT,1946,35,35-39,1981,3.1951310960270116
SIM,1853,39,45-49,1892,4
STAT,1991,18,15-19,2009,75.03465203104776
SIM,1867,26,25-29,1893,42
SIM,1928,38,45-49,1966,1
STAT,1854,33,15-19,1887,0.11758325209299247
STAT,1948,43,50-100,1991,0.16098489021064558
STAT,1906,23,45-49,1929,1.1698761292661615
STAT,1930,59,na,1989,5250.937313013319
SIM,1836,36,25-29,1872,4
SIM,1831,47,45-49,1878,1
STAT,1929,36,45-49,1965,1.011004069483738
SIM,1822,49,45-49,1871,1
SIM,1842,18,20-24,1860,36
SIM,1888,85,na,1973,316
STAT,1837,34,25-29,1871,9.108175673747853
SIM,1867,14,na,1881,2702
SIM,1949,24,20-24,1973,277
STAT,1832,27,50-100,1859,0.6078313983245466
STAT,1872,47,40-44,1919,0.19746204748826587
STAT,1842,95,na,1937,10.231252275092379
STAT,1859,26,25-29,1885,39.8452277535579
SIM,1958,22,20-24,1980,6
STAT,1828,36,25-29,1864,3.0277927766222796
SIM,1983,17,20-24,2000,242
SIM,1913,69,na,1982,3490
SIM,1979,27,40-44,2006,12
STAT,1843,45,20-24,1888,0.012295488908026888
SIM,1939,38,20-24,1977,3
STAT,1943,38,35-39,1981,3.046768632216377
STAT,1819,107,na,1926,0.0031394689841317794
STAT,1868,49,40-44,1917,0.1858576992512002
STAT,1960,25,na,1985,5660.015887234306
SIM,1854,35,30-34,1889,2
STAT,1949,34,20-24,1983,3.3327301632625685
STAT,1836,20,15-19,1856,4.126439151777765
STAT,1864,105,na,1969,0.3042072595621564
SIM,1841,54,na,1895,1700
STAT,1983,27,20-24,2010,29.92919462328746
STAT,1948,60,na,2008,4699.542214267518
STAT,1927,42,20-24,1969,0.025555017754743694
SIM,1970,38,na,2008,5962
SIM,1862,26,25-29,1888,4
SIM,1878,33,25-29,1911,10
STAT,1867,69,na,1936,1581.2610163056295
SIM,1954,28,45-49,1982,2
SIM,1984,7,na,1991,6303
STAT,1906,30,35-39,1936,9.864490204013705
SIM,1989,23,35-39,2012,37
STAT,1961,11,na,1972,5857.748473932963
STAT,1814,49,45-49,1863,0.6349444257340174
STAT,1836,23,na,1859,2549.4654419882836
SIM,1830,26,45-49,1856,1
SIM,1929,33,35-39,1962,3
STAT,1982,21,30-34,2003,46.8432685264996
SIM,1965,23,50-100,1988,2
SIM,1945,25,50-100,1970,2
STAT,1927,39,na,1966,5385.43056786995
SIM,1859,16,25-29,1875,21
STAT,1975,24,20-24,1999,169.73440748637088
SIM,1845,34,25-29,1879,20
SIM,1911,44,na,1955,4630
SIM,1886,18,na,1904,2295
STAT,1875,30,50-100,1905,1.1014936082766003
SIM,1819,39,45-49,1858,2
STAT,1901,38,30-34,1939,1.8502856988355745
SIM,1975,23,na,1998,6096
SIM,1901,68,na,1969,3003
STAT,2005,5,na,2010,6979.979825682561
STAT,1823,60,na,1883,1165.4125441695924
SIM,1896,20,50-100,1916,1
SIM,1978,35,40-44,2013,1
SIM,1859,23,15-19,1882,6
STAT,1888,20,50-100,1908,0.5564988050497937
SIM,1851,38,30-34,1889,17
SIM,1854,41,na,1895,2495
SIM,1776,83,na,1859,198
STAT,1854,26,25-29,1880,39.98853715325272
SIM,1906,20,35-39,1926,22
SIM,1961,32,20-24,1993,4
STAT,1806,57,na,1863,1058.073317043465
STAT,1843,38,30-34,1881,5.622305108808931
STAT,1819,49,45-49,1868,0.44143019177747145
STAT,1866,29,20-24,1895,12.45899830801126
STAT,1973,12,na,1985,5862.93675703335
SIM,1954,35,35-39,1989,1
STAT,1796,63,na,1859,1007.2685709504981
STAT,1882,91,na,1973,253.89529137420945
STAT,1959,17,na,1976,5556.387288097781
SIM,1828,38,40-44,1866,5
STAT,1859,33,15-19,1892,0.13036357991410336
STAT,1934,18,25-29,1952,67.50085646733103
SIM,1937,40,30-34,1977,1
SIM,1916,46,50-100,1962,1
STAT,1862,36,25-29,1898,2.817639944017415
STAT,1901,48,na,1949,3591.799583986529
SIM,1925,23,20-24,1948,175
SIM,1942,18,25-29,1960,69
STAT,1917,23,20-24,1940,135.9665100093087
STAT,1837,41,15-19,1878,0.011952295943904394
SIM,1952,6,na,1958,4847
STAT,1840,39,45-49,1879,1.8525611629781509
STAT,1922,24,40-44,1946,4.420054670108059
STAT,1854,52,40-44,1906,0.008531185341474902
SIM,1896,32,30-34,1928,9
SIM,1975,26,25-29,2001,12
STAT,1931,28,15-19,1959,1.0515426769469285
STAT,1898,21,35-39,1919,9.128961634484368
SIM,1796,93,na,1889,5
SIM,1993,20,50-100,2013,3
STAT,1876,18,25-29,1894,6.742575255346473
SIM,1976,25,15-19,2001,2
SIM,1823,79,na,1902,801
STAT,1899,20,25-29,1919,91.04937430986479
STAT,1888,32,30-34,1920,23.685409111235437
STAT,1871,26,40-44,1897,3.451088614536793
STAT,1885,98,na,1983,42.657250374270156
STAT,1908,28,25-29,1936,71.64510796574316
SIM,1854,28,40-44,1882,3
STAT,1929,40,30-34,1969,0.19160849776219346
STAT,1984,19,20-24,2003,222.06788757732969
SIM,1886,38,45-49,1924,1
SIM,1980,18,45-49,1998,1
STAT,1977,15,40-44,1992,2.18216675413838
SIM,1965,37,20-24,2002,3
STAT,1872,25,30-34,1897,29.378813392277813
SIM,1887,89,na,1976,634
STAT,1856,46,45-49,1902,0.20837597290838267
STAT,1936,39,40-44,1975,1.6934125564193216
STAT,1849,44,45-49,1893,1.1443404402618838
SIM,1990,21,30-34,2011,51
SIM,1873,55,na,1928,2799
STAT,1855,68,na,1923,1300.33648045112
SIM,1973,36,na,2009,5397
STAT,1878,16,35-39,1894,0.6627939778289059
STAT,1886,29,40-44,1915,3.6204708742512146
STAT,1825,30,50-100,1855,2.253231668964418
STAT,1811,48,na,1859,1530.996942135142
STAT,1864,38,50-100,1902,1.2588422083294655
SIM,1967,40,na,2007,5663
SIM,1973,28,15-19,2001,3
SIM,1872,38,50-100,1910,2
STAT,1959,49,25-29,2008,0.08280303832986236
SIM,1890,36,45-49,1926,4
STAT,1825,49,20-24,1874,0.016298821620651754
SIM,1887,37,35-39,1924,27
SIM,1921,90,na,2011,1060
STAT,1900,110,na,2010,0.05282070905913158
SIM,1973,9,na,1982,5494
STAT,1914,21,30-34,1935,32.63167103106316
STAT,1766,112,na,1878,0.0018827088833874375
SIM,1887,0,na,1887,4287
SIM,1911,88,na,1999,1514
STAT,1880,106,na,1986,0.6825456984670024
STAT,1959,43,50-100,2002,0.18401168637032264
STAT,1969,32,na,2001,5557.674195082927
SIM,1781,94,na,1875,7
SIM,1876,49,40-44,1925,1
STAT,1870,90,na,1960,154.7714396241866
STAT,1937,25,50-100,1962,1.121305918546517
SIM,1864,92,na,1956,97
SIM,1960,24,na,1984,6299
STAT,1989,23,40-44,2012,5.574464763320301
STAT,1846,35,30-34,1881,5.874329975875616
STAT,1946,28,45-49,1974,2.2198098471896657
STAT,1898,47,45-49,1945,0.20666236066020216
STAT,1985,20,50-100,2005,1.0843439299420239
STAT,1972,25,35-39,1997,22.29941489725442
STAT,1845,36,40-44,1881,3.13167995499877
STAT,1854,52,na,1906,1744.8408265217079
STAT,1864,27,45-49,1891,1.1441025002877871
STAT,1955,23,40-44,1978,5.166490832044499
SIM,1887,14,na,1901,3937
SIM,1947,22,45-49,1969,3
SIM,1880,47,40-44,1927,2
STAT,1872,16,na,1888,2953.702202139014
STAT,1896,30,15-19,1926,0.21881487771625532
SIM,1909,22,25-29,1931,125
STAT,1890,89,na,1979,527.9620451684843
STAT,1880,42,40-44,1922,2.748019528998177
STAT,1810,49,25-29,1859,0.21467649142086292
SIM,1838,78,na,1916,338
SIM,1956,40,na,1996,5398
SIM,1916,28,25-29,1944,75
STAT,1896,50,na,1946,3329.2991705238555
STAT,1846,28,40-44,1874,3.719415931095005
STAT,1878,38,45-49,1916,2.3901486570067956
SIM,1840,27,na,1867,2020
STAT,1856,24,35-39,1880,5.881745183572279
STAT,1966,34,na,2000,5549.72620521697
STAT,1939,22,45-49,1961,1.3046012002677239
SIM,1894,34,20-24,1928,7
SIM,1963,30,30-34,1993,2
SIM,1968,45,na,2013,5280
STAT,1940,74,na,2014,3091.651175958081
STAT,1886,34,20-24,1920,3.2622919072708063
SIM,1894,29,40-44,1923,13
STAT,1885,34,na,1919,2723.3868483217902
SIM,1840,20,30-34,1860,40
STAT,1879,37,35-39,1916,8.523003907867881
STAT,1939,66,na,2005,3782.83257483543
SIM,1963,23,40-44,1986,10
SIM,1858,26,50-100,1884,2
STAT,1972,18,45-49,1990,0.7378890029712236
STAT,1912,31,na,1943,4316.481645389156
SIM,1943,2,na,1945,5572
STAT,1928,15,na,1943,5377.071924241702
SIM,1817,48,25-29,1865,1
STAT,1880,16,25-29,1896,6.948800478286866
STAT,1955,30,30-34,1985,24.631328735048985
STAT,1910,21,45-49,1931,1.2243631570727718
STAT,1811,102,na,1913,0.15095391876955708
STAT,1851,48,50-100,1899,0.19231236938486881
STAT,1871,29,45-49,1900,1.2656572798219847
SIM,1826,77,na,1903,442
SIM,1872,27,45-49,1899,4
STAT,1856,17,45-49,1873,0.06800554725876443
STAT,1896,23,25-29,1919,86.98906077460227
STAT,1938,37,15-19,1975,0.022533360605782107
SIM,1970,29,40-44,1999,2
STAT,1908,35,15-19,1943,0.02097289728691504
STAT,1842,35,45-49,1877,1.8373053707293148
SIM,1847,22,40-44,1869,2
STAT,1962,29,40-44,1991,6.915122075243536
STAT,1908,80,na,1988,1952.816411691893
STAT,1839,22,40-44,1861,2.1233489350374466
STAT,1919,47,40-44,1966,0.19730331780845964
STAT,1893,36,20-24,1929,1.1298636093801522
SIM,1828,34,40-44,1862,8
SIM,1852,36,25-29,1888,2
SIM,1938,21,40-44,1959,6
SIM,1951,23,15-19,1974,1
SIM,1962,23,25-29,1985,1
SIM,1863,36,35-39,1899,16
STAT,1932,49,15-19,1981,5.734387814879759E-4
SIM,1875,39,30-34,1914,15
STAT,1822,95,na,1917,10.92396919194533
STAT,1963,28,50-100,1991,1.4649473652321978
STAT,1916,20,35-39,1936,11.455619970299695
SIM,1913,15,na,1928,4975
STAT,1897,29,15-19,1926,0.6951198179621143
STAT,1908,47,30-34,1955,0.0931586256829031
STAT,1899,42,35-39,1941,0.19856949618775335
SIM,1902,20,15-19,1922,8
STAT,1901,16,20-24,1917,28.72824920401197
STAT,1867,70,na,1937,1511.7962198593234
SIM,1886,39,40-44,1925,3
SIM,1955,20,30-34,1975,1
STAT,1914,12,na,1926,4716.853538053123
STAT,1855,36,35-39,1891,6.047283840140454
STAT,1878,39,40-44,1917,5.221608877681451
SIM,1892,38,20-24,1930,1
SIM,1951,7,na,1958,6326
SIM,1856,53,na,1909,1935
STAT,1818,80,na,1898,273.70484549504454
SIM,1904,22,25-29,1926,121
STAT,1969,29,50-100,1998,1.439699917554349
SIM,1837,39,45-49,1876,6
SIM,1948,39,25-29,1987,2
STAT,1905,20,25-29,1925,96.18913811462534
STAT,1919,21,30-34,1940,36.421337093080915
SIM,1927,47,40-44,1974,1
STAT,1858,48,20-24,1906,0.01066768688899985
STAT,1943,23,15-19,1966,6.534424608167191
STAT,1811,58,na,1869,1276.0589071438997
STAT,1817,42,50-100,1859,3.257447625950518
SIM,1838,32,50-100,1870,1
SIM,1978,6,na,1984,6040
STAT,1884,38,20-24,1922,0.8745785456761628
SIM,1887,45,na,1932,3647
SIM,1972,27,15-19,1999,1
SIM,1826,39,35-39,1865,7
STAT,1830,51,40-44,1881,0.008711240200603407
STAT,1964,27,15-19,1991,1.0305511083901393
STAT,1829,39,45-49,1868,2.1938115639760993
STAT,1881,23,30-34,1904,19.76610414776465
STAT,1873,38,45-49,1911,2.337651306338368
STAT,1843,19,25-29,1862,7.180829516313446
SIM,1880,25,30-34,1905,42
STAT,1943,34,50-100,1977,1.03013770455443
SIM,1927,21,30-34,1948,96
STAT,1867,60,na,1927,2054.9640283283684
STAT,1947,39,na,1986,5027.903569394117
SIM,1918,23,30-34,1941,84
STAT,1859,0,na,1859,3590.8251588449534
SIM,1884,18,25-29,1902,13
STAT,1882,36,45-49,1918,2.2579034758086163
SIM,1815,39,25-29,1854,2
STAT,1954,23,25-29,1977,132.17217324983875
STAT,1926,44,na,1970,5265.146276834392
SIM,1885,9,na,1894,3415
SIM,1915,27,na,1942,4570
STAT,1869,48,30-34,1917,0.10682514276946653
STAT,1818,39,35-39,1857,10.317800221816078
STAT,1892,23,40-44,1915,3.0047791109494253
SIM,1881,38,45-49,1919,3
STAT,1799,61,na,1860,1273.111659902306
SIM,1868,85,na,1953,196
SIM,1942,37,30-34,1979,2
SIM,1848,20,35-39,1868,7
STAT,1917,26,25-29,1943,79.93564481912895
SIM,1957,37,25-29,1994,4
STAT,1889,20,30-34,1909,25.490394735129104
STAT,1814,46,40-44,1860,0.4838429643907147
SIM,1807,73,na,1880,467
STAT,1854,42,na,1896,1880.6418285951386
SIM,1796,83,na,1879,227
STAT,1849,37,20-24,1886,0.611360068845967
STAT,1968,24,30-34,1992,41.53666440935322
SIM,1929,30,30-34,1959,25
SIM,1981,26,35-39,2007,49
SIM,1862,23,20-24,1885,86
SIM,1819,36,40-44,1855,2
SIM,1874,33,40-44,1907,2
STAT,1843,30,35-39,1873,12.472184551426343
STAT,1899,38,15-19,1937,0.019068264856431212
SIM,1927,59,na,1986,4601
STAT,1877,18,40-44,1895,0.2189897874217149
STAT,1841,17,15-19,1858,6.805106691869002
SIM,1836,43,na,1879,1602
SIM,1877,4,na,1881,3645
SIM,1925,26,25-29,1951,4
SIM,1989,20,30-34,2009,68
STAT,1852,30,na,1882,2378.3295029192236
STAT,1949,37,25-29,1986,1.361482837688554
SIM,1831,25,35-39,1856,2
SIM,1915,21,50-100,1936,2
STAT,1821,49,35-39,1870,0.24640783532442873
STAT,1917,33,15-19,1950,0.15464241632828543
SIM,1985,23,15-19,2008,8
STAT,1818,46,25-29,1864,0.07211782887867291
STAT,1988,11,na,1999,6484.545819517677
SIM,1925,47,na,1972,5228
STAT,1887,25,25-29,1912,55.08056765047407
STAT,1977,23,15-19,2000,8.325097720630904
STAT,1987,27,40-44,2014,7.712251428109957
STAT,1953,44,50-100,1997,0.16987607230929472
SIM,1895,25,25-29,1920,81
STAT,1855,29,45-49,1884,0.9706561836379626
SIM,1798,64,na,1862,1076
SIM,1836,53,na,1889,1302
SIM,1975,27,20-24,2002,29
SIM,1864,39,20-24,1903,2
STAT,1843,23,45-49,1866,0.871934816068269
STAT,1892,19,20-24,1911,25.505637595302503
SIM,1857,37,20-24,1894,1
SIM,1940,14,na,1954,5076
STAT,1856,23,na,1879,2170.664751873259
STAT,1929,39,15-19,1968,0.028392502513147837
STAT,1913,29,45-49,1942,1.9734271345979861
SIM,1914,39,50-100,1953,3
STAT,1911,27,35-39,1938,16.911328453265725
STAT,1912,9,na,1921,4634.778841091667
SIM,1885,23,na,1908,2944
STAT,1888,35,35-39,1923,9.686069959733581
SIM,1886,46,30-34,1932,1
STAT,1925,39,30-34,1964,2.518279022411004
SIM,1842,41,50-100,1883,2
STAT,1835,108,na,1943,0.0011416289146514375
SIM,1821,36,30-34,1857,2
SIM,1976,17,40-44,1993,3
STAT,1857,27,20-24,1884,10.860848533004084
SIM,1921,29,45-49,1950,3
STAT,1904,4,na,1908,4359.62622508483
STAT,1959,46,20-24,2005,0.01739548378307941
STAT,1929,43,35-39,1972,0.300486846944109
SIM,1969,37,40-44,2006,6
STAT,1843,26,15-19,1869,0.5643014800660019
SIM,1914,19,25-29,1933,26
STAT,1840,36,40-44,1876,4.196762844983514
SIM,1885,35,25-29,1920,9
STAT,1877,35,25-29,1912,3.4891427028804354
STAT,1804,76,na,1880,501.6461252328862
STAT,1931,14,na,1945,5967.07529131043
STAT,1942,51,na,1993,4550.638251618405
STAT,1882,29,20-24,1911,13.12935441616426
STAT,1900,38,15-19,1938,0.01931291184766245
SIM,1825,29,25-29,1854,5
STAT,1873,49,50-100,1922,0.28339388126179693
STAT,1968,17,40-44,1985,2.016127180525777
STAT,1961,6,na,1967,5861.381630933244
STAT,1907,84,na,1991,1383.7768399741392
STAT,1955,29,15-19,1984,1.0851283230873634
SIM,1959,20,15-19,1979,8
STAT,1846,24,40-44,1870,2.6199587668297464
STAT,1921,21,20-24,1942,145.32369768782164
SIM,1822,40,na,1862,1681
SIM,1933,39,30-34,1972,6
SIM,1803,80,na,1883,329
STAT,1878,46,30-34,1924,0.11697086003724552
SIM,1896,35,35-39,1931,5
STAT,1852,17,25-29,1869,6.46175409601066
STAT,1982,24,35-39,2006,15.33082335704817
SIM,1916,20,50-100,1936,5
STAT,1893,29,30-34,1922,36.470764198872395
SIM,1875,31,35-39,1906,24
STAT,1872,17,45-49,1889,0.07594485489564032
STAT,1934,37,30-34,1971,2.903973901877835
SIM,1851,30,35-39,1881,23
SIM,1997,15,na,2012,5790
STAT,1867,46,20-24,1913,0.012966571908512399
SIM,1865,27,20-24,1892,1
STAT,1941,11,na,1952,4690.93160622279
SIM,1837,43,30-34,1880,1
STAT,1906,26,15-19,1932,0.7661430553937073
STAT,1966,29,25-29,1995,95.19072765227394
SIM,1932,29,na,1961,5505
SIM,1860,17,25-29,1877,15
SIM,1990,24,35-39,2014,17
STAT,1909,102,na,2011,14.64651301652339
SIM,1849,71,na,1920,1620
STAT,1977,18,45-49,1995,0.7786828232136361
STAT,1922,51,na,1973,4806.502376988211
STAT,1895,24,50-100,1919,0.6087446257453547
SIM,1979,26,45-49,2005,5
STAT,1908,105,na,2013,2.656910424962433
STAT,1797,89,na,1886,46.86703604670582
STAT,1893,21,35-39,1914,8.53802240762468
STAT,1832,23,35-39,1855,6.932932567899231
SIM,1830,34,30-34,1864,10
SIM,1822,36,50-100,1858,1
STAT,1932,16,50-100,1948,0.574069041803388
STAT,1955,33,35-39,1988,14.261789879332493
SIM,1967,39,30-34,2006,2
SIM,1951,55,na,2006,6024
STAT,1867,21,40-44,1888,2.2708341055625287
SIM,1830,27,40-44,1857,5
STAT,1896,48,40-44,1944,0.1453523231545791
STAT,1969,20,15-19,1989,7.704726550278166
STAT,1866,52,50-100,1918,0.016068834779881386
STAT,1829,43,30-34,1872,1.2083575643502602
STAT,1887,15,na,1902,3281.600815943075
SIM,1939,51,na,1990,4738
SIM,1840,19,15-19,1859,7
STAT,1945,37,40-44,1982,1.9442720681264487
SIM,1857,38,na,1895,2508
SIM,1885,33,na,1918,3135
SIM,1825,33,45-49,1858,4
SIM,1890,29,20-24,1919,2
STAT,1840,38,na,1878,2011.1703076919412
STAT,1966,49,15-19,2015,5.490608228957145E-4
SIM,1885,28,35-39,1913,21
STAT,1822,34,30-34,1856,50.08478120176501
SIM,1840,23,35-39,1863,1
STAT,1902,29,35-39,1931,15.62136050913528
STAT,1945,44,30-34,1989,0.16693598240652485
SIM,1854,72,na,1926,1565
SIM,1872,15,na,1887,3260
SIM,1910,29,35-39,1939,1
STAT,1927,23,15-19,1950,7.543710637766507
SIM,1908,45,na,1953,3611
SIM,1825,40,35-39,1865,1
STAT,1960,27,30-34,1987,59.149022880416126
STAT,1837,36,50-100,1873,1.093722822043944
SIM,1859,28,40-44,1887,6
STAT,1863,24,25-29,1887,58.07533457926822
SIM,1990,17,45-49,2007,2
SIM,1938,17,20-24,1955,277
SIM,1871,24,25-29,1895,59
STAT,1889,16,45-49,1905,0.09315401545945277
STAT,1771,98,na,1869,0.6952349194186329
STAT,1976,19,na,1995,5671.197963118549
SIM,1963,33,35-39,1996,4
STAT,1998,12,na,2010,6656.106316100141
STAT,1867,39,30-34,1906,5.684762092851667
STAT,1817,40,35-39,1857,5.887813345425868
STAT,1922,27,45-49,1949,2.255061004033413
SIM,1924,20,35-39,1944,28
STAT,1898,21,na,1919,3699.8563501493536
SIM,1942,22,45-49,1964,2
STAT,1816,48,15-19,1864,8.035613370901001E-4
SIM,1886,16,35-39,1902,1
SIM,1948,36,20-24,1984,4
SIM,1835,22,15-19,1857,5
STAT,1873,35,40-44,1908,5.207836796210507
STAT,1877,28,35-39,1905,11.54223498132041
STAT,1838,22,25-29,1860,64.34584329937165
STAT,1909,11,na,1920,4481.182663060026
SIM,1917,38,35-39,1955,9
SIM,1863,33,30-34,1896,26
SIM,1962,20,20-24,1982,169
STAT,1827,48,25-29,1875,0.07198294779843947
SIM,1927,24,35-39,1951,21
SIM,1846,22,25-29,1868,49
STAT,1863,49,40-44,1912,0.16915256960149663
STAT,1848,19,50-100,1867,0.06377223787715727
STAT,1866,33,40-44,1899,4.619244454702664
STAT,1877,36,20-24,1913,0.9298154496280119
SIM,1960,14,na,1974,6317
SIM,1881,35,40-44,1916,6
STAT,1892,26,45-49,1918,1.6114918636885802
STAT,1935,73,na,2008,4289.85921056648
SIM,1832,35,45-49,1867,2
SIM,1837,38,na,1875,2420
SIM,1838,31,30-34,1869,36
STAT,1855,33,30-34,1888,14.97061518489854
SIM,1838,24,na,1862,2065
SIM,1971,29,45-49,2000,5
STAT,1893,39,25-29,1932,4.157667789106784
SIM,1945,47,na,1992,4617
STAT,1843,16,20-24,1859,22.867129333642527
SIM,1864,21,30-34,1885,47
STAT,1923,22,35-39,1945,12.638867085757107
STAT,1944,32,na,1976,4788.027112658543
SIM,1924,52,na,1976,4746
SIM,1982,29,20-24,2011,54
STAT,1995,15,30-34,2010,20.372625701999635
SIM,1878,25,40-44,1903,7
STAT,1974,29,20-24,2003,27.59889144771407
STAT,1910,17,25-29,1927,9.9197415090332
SIM,1877,37,40-44,1914,13
STAT,1869,37,40-44,1906,4.892333522672289
SIM,1963,26,45-49,1989,2
STAT,1845,47,30-34,1892,0.0649250534343776
STAT,1886,102,na,1988,8.347063986037304
SIM,1930,48,na,1978,5900
STAT,1955,26,45-49,1981,2.6593590951799846
STAT,1857,49,na,1906,1979.9593159980884
SIM,1977,35,25-29,2012,3
STAT,1934,22,45-49,1956,1.745897407406961
SIM,1992,15,20-24,2007,423
STAT,1945,9,na,1954,4961.627421834366
SIM,1823,80,na,1903,702
STAT,1856,21,30-34,1877,18.345842186988186
STAT,1849,47,15-19,1896,3.0858166506713325E-4
SIM,1838,24,40-44,1862,1
STAT,1842,38,15-19,1880,0.05016770800922389
SIM,1849,31,40-44,1880,8
SIM,1916,32,45-49,1948,1
SIM,1938,21,50-100,1959,3
STAT,1886,84,na,1970,812.9670307644551
STAT,1968,47,25-29,2015,0.07953034118352319
STAT,1961,15,30-34,1976,18.18314682406546
STAT,1964,27,50-100,1991,1.4530130255761868
SIM,1943,18,40-44,1961,4
STAT,1895,27,40-44,1922,4.4999120517520215
STAT,1908,32,45-49,1940,1.7163242570474473
STAT,1913,26,40-44,1939,5.380976370464977
STAT,1849,41,na,1890,1799.474005262737
STAT,1846,27,45-49,1873,1.3885681593253114
STAT,1944,33,50-100,1977,1.0460602458614545
STAT,1906,19,25-29,1925,9.485231345970313
STAT,1909,1,na,1910,4715.958977135829
SIM,1890,34,na,1924,3313
STAT,1862,28,40-44,1890,2.9072072536825493
SIM,1895,22,20-24,1917,100
STAT,1935,18,40-44,1953,2.2020953798815817
SIM,1870,28,40-44,1898,4
STAT,1921,33,50-100,1954,1.0569595290051068
SIM,1975,13,na,1988,6126
STAT,1899,47,na,1946,3541.231369667233
STAT,1941,69,na,2010,3651.670736444336
STAT,1907,37,20-24,1944,0.28251065895422744
STAT,1932,16,15-19,1948,69.53891066872319
SIM,1810,62,na,1872,1004
STAT,1871,85,na,1956,343.7072495080093
STAT,1876,15,20-24,1891,21.248027959251225
SIM,1874,36,45-49,1910,2
STAT,1887,22,20-24,1909,89.12611427997155
STAT,1956,21,35-39,1977,14.431088417659797
STAT,1834,42,na,1876,2313.0445434027133
STAT,1899,28,20-24,1927,18.48296094419849
STAT,1824,35,45-49,1859,3.207874710749209
STAT,1899,113,na,2012,0.0026219796410824345
STAT,1819,75,na,1894,685.3256887287731
STAT,1870,19,35-39,1889,0.6228243507507475
SIM,1964,21,35-39,1985,1
STAT,1881,26,35-39,1907,10.77736162802067
STAT,1927,29,na,1956,5233.484492008733
STAT,1888,28,45-49,1916,1.5009071558998928
STAT,1912,85,na,1997,1342.383176323062
STAT,1914,66,na,1980,3603.5604565042204
STAT,1999,15,15-19,2014,77.41486331021649
STAT,1971,27,40-44,1998,6.842331383639538
STAT,1966,33,45-49,1999,2.3105873740100225
SIM,1808,58,na,1866,1430
STAT,1866,36,45-49,1902,2.1426198648517274
STAT,1967,37,15-19,2004,0.02852023371700341
STAT,1844,29,35-39,1873,9.738390865094166
STAT,1974,36,45-49,2010,1.0593370274489955
SIM,1979,23,40-44,2002,12
STAT,1963,45,50-100,2008,0.3465541474558616
SIM,1940,16,15-19,1956,93
SIM,1920,15,35-39,1935,8
SIM,1906,28,30-34,1934,49
STAT,1907,30,na,1937,4119.209002641013
SIM,1917,28,40-44,1945,1
SIM,1938,31,35-39,1969,32
STAT,1890,99,na,1989,38.88817018233601
SIM,1931,15,45-49,1946,1
STAT,1935,25,30-34,1960,61.72585294124784
STAT,1860,37,20-24,1897,0.7169732200489882
SIM,1841,29,25-29,1870,9
SIM,1855,2,na,1857,2718
STAT,1854,23,20-24,1877,65.49218327062597
STAT,1833,29,25-29,1862,39.117395547914576
STAT,1881,19,45-49,1900,0.0723224396603636
SIM,1941,27,20-24,1968,38
STAT,1883,17,20-24,1900,20.017148048061138
SIM,1921,26,40-44,1947,18
SIM,1958,32,15-19,1990,1
SIM,1848,46,45-49,1894,1
SIM,1891,17,20-24,1908,42
STAT,1798,75,na,1873,376.72380732305885
STAT,1981,16,45-49,1997,0.8063425746394315
STAT,1908,70,na,1978,3009.182176153233
SIM,1884,15,20-24,1899,25
STAT,1919,17,45-49,1936,0.6369222091272948
STAT,1878,49,35-39,1927,0.16517158116679065
SIM,1884,92,na,1976,102
STAT,1887,32,15-19,1919,0.18417912190623648
STAT,1850,49,50-100,1899,0.24755300883406295
SIM,1869,35,25-29,1904,2
SIM,1943,25,30-34,1968,2
STAT,1933,27,20-24,1960,27.98358724900353
STAT,1966,26,20-24,1992,26.437292002014715
SIM,1897,20,30-34,1917,1
STAT,1838,90,na,1928,68.29249018006897
SIM,1938,69,na,2007,3376
STAT,1870,26,25-29,1896,48.29251007060545
STAT,1971,35,na,2006,5675.2211749953
STAT,1928,25,na,1953,5362.21175213969
STAT,1870,89,na,1959,183.00336942545098
SIM,1781,84,na,1865,236
STAT,1856,39,20-24,1895,0.6718626001879762
SIM,1949,49,35-39,1998,1
STAT,1799,108,na,1907,8.227823272475619E-4
SIM,1883,52,na,1935,2264
SIM,1889,108,na,1997,34
STAT,1869,41,na,1910,2594.748502830405
SIM,1871,19,na,1890,2247
STAT,1844,44,50-100,1888,0.8821005378733903
SIM,1876,34,20-24,1910,3
STAT,1836,38,40-44,1874,4.8411593444026595
SIM,1952,33,50-100,1985,3
SIM,1977,25,30-34,2002,67
STAT,1823,91,na,1914,32.81514378146777
STAT,1783,76,na,1859,268.32300491333893
SIM,1887,99,na,1986,5
STAT,1899,35,45-49,1934,3.181776324970569
STAT,1928,40,15-19,1968,0.002265524247883813
SIM,1844,38,40-44,1882,1
SIM,1911,34,na,1945,4844
STAT,1976,15,25-29,1991,66.84968801099802
STAT,1902,26,30-34,1928,41.203226178394225
STAT,1900,109,na,2009,0.12615708294712455
SIM,1981,23,30-34,2004,112
STAT,1866,105,na,1971,0.40267945168590014
SIM,1905,32,35-39,1937,14
STAT,1820,102,na,1922,0.17206430986739724
SIM,1830,37,35-39,1867,5
SIM,1963,19,20-24,1982,208
STAT,1834,47,20-24,1881,0.011613853125509284
STAT,1913,33,30-34,1946,18.023096731774256
STAT,1911,30,50-100,1941,0.9373928235949075
SIM,1805,51,na,1856,1569
STAT,1945,47,35-39,1992,0.1690625137189727
SIM,1850,5,na,1855,2400
STAT,1909,35,30-34,1944,2.012034703598564
STAT,1965,15,15-19,1980,65.42112667608663
STAT,1954,30,15-19,1984,0.18708719635429472
STAT,1959,34,15-19,1993,0.19748107182393854
SIM,1921,33,30-34,1954,6
STAT,1839,75,na,1914,816.4146752681892
STAT,1821,44,50-100,1865,1.9499466149890121
STAT,1928,33,25-29,1961,13.328697393045257
SIM,1874,29,20-24,1903,28
SIM,1952,51,na,2003,4506
STAT,1840,83,na,1923,318.46357240824045
STAT,1955,19,20-24,1974,207.5641866139659
SIM,1932,18,30-34,1950,21
STAT,1984,21,50-100,2005,1.0824175262160969
STAT,1993,17,20-24,2010,225.1082932688017
SIM,1851,16,20-24,1867,39
SIM,1926,33,na,1959,5789
STAT,1822,37,35-39,1859,17.208293272435007
STAT,1939,8,na,1947,4599.198953698498
STAT,1828,33,20-24,1861,3.0181609177742783
STAT,1959,26,50-100,1985,1.509730301229675
SIM,1861,38,25-29,1899,1
STAT,1988,23,25-29,2011,152.9129397869574
SIM,1852,29,35-39,1881,20
STAT,1912,15,35-39,1927,0.9847100758596203
STAT,1902,19,40-44,1921,0.2966474138640089
SIM,1859,38,35-39,1897,10
STAT,1976,22,15-19,1998,8.234413968668315
STAT,1876,25,15-19,1901,0.544929604784646
STAT,1941,27,50-100,1968,1.1885704610258998
SIM,1910,26,30-34,1936,1
SIM,1898,51,na,1949,3699
SIM,1922,85,na,2007,856
STAT,1844,36,25-29,1880,2.8257087240826126
SIM,1927,17,45-49,1944,4
SIM,1900,6,na,1906,3964
STAT,1867,49,25-29,1916,0.060767497884973175
STAT,1924,18,30-34,1942,16.702326340672503
STAT,1822,44,25-29,1866,1.244046221558999
SIM,1828,37,45-49,1865,1
STAT,1919,24,35-39,1943,11.821603353797002
STAT,1943,16,25-29,1959,53.052859077194576
SIM,1836,33,20-24,1869,5
STAT,1824,76,na,1900,586.2071479295972
SIM,1951,16,25-29,1967,148
STAT,1853,38,25-29,1891,2.8523651323233277
STAT,1921,24,25-29,1945,119.60357751589876
STAT,1909,28,40-44,1937,5.128371160110288
SIM,1968,35,na,2003,5334
SIM,1858,25,20-24,1883,27
STAT,1829,46,35-39,1875,0.1447447548509665
STAT,1843,29,20-24,1872,14.279180142405016
STAT,1977,29,25-29,2006,102.97479066922187
STAT,1894,16,na,1910,3756.0380000964847
SIM,1955,18,45-49,1973,1
STAT,1895,97,na,1992,89.89354633191692
SIM,1823,56,na,1879,1869
STAT,1914,99,na,2013,59.8417104490009
STAT,1911,49,45-49,1960,0.23626033730880788
STAT,1971,44,25-29,2015,0.10811079187579505
SIM,1862,33,35-39,1895,29
SIM,1871,28,35-39,1899,2
SIM,1822,36,45-49,1858,3
SIM,1862,38,40-44,1900,11
SIM,1971,32,na,2003,5593
STAT,1853,51,20-24,1904,7.382017497836543E-4
STAT,1863,28,35-39,1891,9.70255809115121
STAT,1854,22,25-29,1876,54.79780769800966
SIM,1811,47,na,1858,1650
STAT,1879,59,na,1938,2341.910992076352
SIM,1919,61,na,1980,4817
STAT,1827,50,50-100,1877,0.019208052321257406
SIM,1954,31,25-29,1985,25
STAT,1950,20,35-39,1970,12.899792084708611
STAT,1844,19,40-44,1863,0.19218512348969985
SIM,1862,22,25-29,1884,4
STAT,1883,49,15-19,1932,4.4220670791428324E-4
STAT,1862,19,na,1881,2533.519379596301
STAT,1927,20,na,1947,5222.1318591151885
SIM,1985,29,25-29,2014,198
STAT,1884,17,15-19,1901,6.766699337044098
STAT,1849,17,20-24,1866,16.913859183176438
SIM,1981,21,30-34,2002,106
STAT,1852,38,30-34,1890,4.9998745269681475
SIM,1851,29,20-24,1880,16
STAT,1933,46,50-100,1979,0.36000003524275076
STAT,1868,45,30-34,1913,0.1083987273759433
SIM,1867,36,20-24,1903,3
STAT,1790,91,na,1881,19.45831503208054
STAT,1977,32,25-29,2009,14.69048753453864
STAT,1902,84,na,1986,1291.032247422996
SIM,1851,32,50-100,1883,3
SIM,1857,40,45-49,1897,2
STAT,1843,32,20-24,1875,3.260582422866288
STAT,1862,70,na,1932,1366.4994432803408
SIM,1872,41,25-29,1913,2
STAT,1940,45,20-24,1985,0.013536799616348629
STAT,1946,31,25-29,1977,12.066043207588455
STAT,1796,96,na,1892,2.187064425169604
SIM,1975,30,45-49,2005,3
STAT,1812,103,na,1915,0.06300788011727257
SIM,1841,30,40-44,1871,12
STAT,1803,83,na,1886,143.14377767401646
STAT,1874,26,45-49,1900,1.31626618634408
STAT,1908,89,na,1997,741.4375465488339
STAT,1828,67,na,1895,1052.1081510501401
SIM,1965,22,na,1987,4784
STAT,1894,35,30-34,1929,7.98172787498298
SIM,1860,38,30-34,1898,10
SIM,1891,24,45-49,1915,2
STAT,1883,24,45-49,1907,0.7824115206718296
SIM,1870,34,na,1904,2993
STAT,1833,30,40-44,1863,4.051545610780388
SIM,1874,48,na,1922,2483
STAT,1893,26,25-29,1919,61.91762512022007
SIM,1882,26,45-49,1908,2
STAT,1888,100,na,1988,24.208566370626766
STAT,1859,39,25-29,1898,2.6202200684130923
SIM,1828,44,50-100,1872,3
SIM,1869,61,na,1930,1400
SIM,1857,17,20-24,1874,27
STAT,1922,49,20-24,1971,0.014559155060387982
STAT,1849,40,45-49,1889,1.1802718160784857
STAT,1872,34,40-44,1906,4.9823712086264855
SIM,1865,87,na,1952,194
STAT,1811,54,20-24,1865,0.0021098836467452783
STAT,1923,46,na,1969,4970.240481771853
STAT,1845,24,25-29,1869,47.2034542289585
SIM,1876,45,30-34,1921,1
STAT,1828,32,25-29,1860,11.809835172780376
STAT,1891,32,50-100,1923,1.3068576890793886
SIM,1898,74,na,1972,2450
STAT,1956,33,na,1989,5883.433626667327
SIM,1966,18,20-24,1984,190
SIM,1836,43,35-39,1879,1
SIM,1944,52,na,1996,4416
STAT,1864,52,35-39,1916,0.00882390693578455
SIM,1986,19,45-49,2005,2
STAT,1880,53,30-34,1933,0.007164493255935954
STAT,1911,45,na,1956,4036.0860946950916
SIM,1851,32,20-24,1883,5
STAT,1841,19,15-19,1860,6.725178618480653
STAT,1846,47,45-49,1893,0.24283516253468068
STAT,1993,20,45-49,2013,1.8756940094288552
STAT,1886,49,40-44,1935,0.20405235874454888
STAT,1812,44,na,1856,1378.3397523215517
SIM,1922,20,25-29,1942,141
STAT,1864,41,25-29,1905,0.6646993662864749
STAT,1817,42,20-24,1859,0.48968167859517037
SIM,1910,48,na,1958,3361
STAT,1817,39,20-24,1856,2.5662846007565814
SIM,1880,34,40-44,1914,10
STAT,1982,30,40-44,2012,6.485071888312307
SIM,1972,34,40-44,2006,1
SIM,1818,47,35-39,1865,1
STAT,1947,18,45-49,1965,0.6491744741760472
SIM,1853,24,25-29,1877,8
STAT,1854,75,na,1929,838.6996483002788
STAT,1858,89,na,1947,94.57821476869177
STAT,1838,17,45-49,1855,0.07475393457395586
SIM,1890,86,na,1976,645
STAT,1828,43,35-39,1871,1.7143987991832312
STAT,1840,15,50-100,1855,0.0514893173067933
SIM,1957,35,na,1992,6262
SIM,1869,39,35-39,1908,2
STAT,1989,19,20-24,2008,223.95457226601079
SIM,1844,18,na,1862,2866
STAT,1865,53,35-39,1918,0.008820304737647408
SIM,1887,35,35-39,1922,20
SIM,1836,32,25-29,1868,22
STAT,1879,35,35-39,1914,8.603947908742686
STAT,1889,37,15-19,1926,0.07988375390828933
SIM,1994,1,na,1995,6243
SIM,1919,53,na,1972,5113
SIM,1841,77,na,1918,680
STAT,1972,21,25-29,1993,136.98190003783574
STAT,1829,41,30-34,1870,1.249597255069855
SIM,1791,85,na,1876,101
STAT,1897,31,35-39,1928,15.691281571764659
SIM,1828,87,na,1915,359
STAT,1975,37,20-24,2012,0.4134764957910479
SIM,1837,41,30-34,1878,2
STAT,1958,18,20-24,1976,205.43089977705063
SIM,1977,3,na,1980,6245
SIM,1932,30,35-39,1962,4
SIM,1774,81,na,1855,360
STAT,1900,38,50-100,1938,0.4222504283915047
SIM,1882,99,na,1981,36
STAT,1890,27,40-44,1917,4.224105167542538
STAT,1867,36,25-29,1903,3.117233188229169
STAT,1895,89,na,1984,594.162068154935
STAT,1925,32,50-100,1957,1.1326944950855837
STAT,1914,20,25-29,1934,105.18075281171147
STAT,1948,45,50-100,1993,0.3121649752421191
STAT,1883,32,na,1915,2694.3653996427006
STAT,1939,24,45-49,1963,1.30371422213298
STAT,1800,54,45-49,1854,0.05514075133244596
STAT,1886,41,30-34,1927,1.4058363803489062
STAT,1887,46,na,1933,2918.032230160439
STAT,1828,59,na,1887,1333.1272030384118
STAT,1870,23,20-24,1893,78.16114459445397
STAT,1964,37,45-49,2001,1.020862226251498
STAT,1866,45,50-100,1911,0.2653280501653077
STAT,1861,40,15-19,1901,0.013382939993977274
STAT,1870,41,50-100,1911,1.2073894082232417
STAT,1880,42,20-24,1922,0.19402747552429697
STAT,1830,37,40-44,1867,4.426725870609035
STAT,2006,4,na,2010,7024.177365545748
SIM,1804,77,na,1881,344
STAT,1840,40,25-29,1880,0.6058378808011811
SIM,1936,9,na,1945,4129
STAT,1824,45,na,1869,1647.1632827831688
STAT,1865,50,30-34,1915,0.006287198009127644
STAT,1904,48,15-19,1952,3.692251781575468E-4
STAT,1830,30,15-19,1860,0.1602763017665091
STAT,1843,52,45-49,1895,0.014483961781906732
SIM,1875,36,25-29,1911,6
SIM,1933,8,na,1941,6662
SIM,1894,30,20-24,1924,6
STAT,1835,35,20-24,1870,0.6074489323948049
SIM,1890,78,na,1968,1372
STAT,1900,53,na,1953,3392.71912046378
STAT,1946,23,50-100,1969,0.8447293261028175
SIM,1907,60,na,1967,3911
STAT,1835,37,na,1872,1650.2203353901639
STAT,1969,35,25-29,2004,1.4649047401900952
STAT,1895,36,30-34,1931,8.044582525863133
STAT,1930,38,15-19,1968,0.028881366917272482
SIM,1950,6,na,1956,4819
SIM,1826,29,40-44,1855,7
SIM,1815,69,na,1884,978
STAT,1850,25,45-49,1875,1.3646045656260117
STAT,1890,42,35-39,1932,2.5503213567582135
STAT,1841,57,na,1898,1786.7431326341527
STAT,1861,48,25-29,1909,0.05456748845818025
STAT,1886,30,20-24,1916,3.316912756137903
STAT,1890,31,25-29,1921,14.502327740528875
STAT,1840,26,45-49,1866,1.1185879464343043
SIM,1867,39,50-100,1906,3
STAT,1978,20,na,1998,5774.457929669205
STAT,1851,29,25-29,1880,38.71432619568828
STAT,1928,23,30-34,1951,41.28409265364339
STAT,1844,44,30-34,1888,0.9599329403804606
STAT,1860,28,na,1888,2227.4011764241054
STAT,1978,30,20-24,2008,3.9202683640079514
STAT,1885,26,20-24,1911,13.55052502060768
SIM,1878,48,45-49,1926,1
SIM,1879,41,35-39,1920,4
SIM,1866,27,15-19,1893,1
SIM,1880,37,50-100,1917,4
SIM,1861,18,25-29,1879,11
STAT,1838,47,40-44,1885,0.15259421757339395
STAT,1880,20,30-34,1900,21.918723163255706
STAT,1896,15,40-44,1911,0.2800919191644555
SIM,1893,26,20-24,1919,21
SIM,1983,23,50-100,2006,1
STAT,1825,39,25-29,1864,4.497848661317821
STAT,1957,19,50-100,1976,0.5696819206741255
SIM,1936,23,30-34,1959,47
SIM,1877,25,25-29,1902,14
SIM,1791,93,na,1884,11
SIM,1845,35,30-34,1880,12
SIM,1869,18,na,1887,2151
SIM,1828,79,na,1907,775
STAT,1839,51,40-44,1890,0.00838889668951835
STAT,1837,63,na,1900,1292.0648831772482
STAT,1891,43,35-39,1934,2.5641390679937697
STAT,1924,30,35-39,1954,12.356102739982386
STAT,1950,28,na,1978,5131.417609935175
STAT,1858,27,15-19,1885,0.41814076056452465
STAT,1870,14,na,1884,2985.769957217942
SIM,1963,37,na,2000,6513
STAT,1976,35,na,2011,5986.3666438755445
STAT,1844,45,15-19,1889,3.398448952562352E-4
STAT,1840,51,35-39,1891,0.006939243944739037
STAT,1854,33,35-39,1887,8.361721832140782
STAT,1817,75,na,1892,711.7290206010897
STAT,1899,44,20-24,1943,0.017201163072591757
STAT,1968,20,20-24,1988,160.91816833383263
STAT,1987,27,na,2014,6198.451950023948
STAT,1988,15,40-44,2003,2.3098624114865487
STAT,1855,34,35-39,1889,8.593626684167077
STAT,1837,35,30-34,1872,4.79735978951891
STAT,1838,50,40-44,1888,0.009438886794049485
SIM,1897,42,40-44,1939,1
STAT,1809,45,20-24,1854,0.03077347597125254
SIM,1985,26,20-24,2011,1
SIM,1929,25,40-44,1954,22
STAT,1989,8,na,1997,6496.431091907797
STAT,1880,28,40-44,1908,3.6513989655834505
STAT,1922,86,na,2008,1426.6023763738367
SIM,1827,34,25-29,1861,20
SIM,1976,20,20-24,1996,182
STAT,1881,21,30-34,1902,19.887231289480976
STAT,1865,59,na,1924,2023.6438441659539
STAT,1865,104,na,1969,0.6387752790965702
STAT,1889,42,40-44,1931,3.1958112711343913
SIM,1952,31,50-100,1983,4
SIM,1863,34,35-39,1897,2
STAT,1852,92,na,1944,39.26762680828831
STAT,1980,31,15-19,2011,0.2099752387664471
STAT,1853,54,25-29,1907,0.003429518999100134
SIM,1837,44,35-39,1881,5
SIM,1965,20,45-49,1985,4
STAT,1868,46,15-19,1914,4.447658746535521E-4
SIM,1836,48,40-44,1884,1
STAT,1822,41,20-24,1863,0.3334147225697874
SIM,1823,35,50-100,1858,2
STAT,1918,16,25-29,1934,10.945507616156064
STAT,1832,32,na,1864,1906.5346729499868
SIM,1863,56,na,1919,1993
STAT,1859,27,30-34,1886,23.549428180177635
SIM,1872,40,40-44,1912,2
STAT,1962,51,na,2013,5578.48994824041
SIM,1822,33,40-44,1855,16
STAT,1807,52,35-39,1859,0.033812331211586555
STAT,1967,43,20-24,2010,0.026415672913293123
STAT,1961,23,15-19,1984,7.960469321131199
STAT,1834,26,15-19,1860,0.5468520388558092
STAT,1822,52,30-34,1874,0.01082810816442385
STAT,1872,46,35-39,1918,0.16269291680337297
SIM,1899,48,na,1947,3798
SIM,1859,23,50-100,1882,4
STAT,1977,26,20-24,2003,28.59915746955136
SIM,1914,37,50-100,1951,1
SIM,1867,27,30-34,1894,29
STAT,1779,84,na,1863,91.0695476274354
STAT,1814,75,na,1889,649.453808952496
SIM,1980,28,40-44,2008,15
SIM,1882,23,40-44,1905,4
SIM,1974,29,na,2003,6092
SIM,1847,30,35-39,1877,2
STAT,1833,33,45-49,1866,1.5776719690614
STAT,1864,40,40-44,1904,2.3411342514418485
SIM,1872,37,40-44,1909,14
STAT,1832,47,50-100,1879,0.20159757344197746
STAT,1867,53,45-49,1920,0.015385890058485245
STAT,1883,21,40-44,1904,2.3599158307811576
SIM,1883,30,45-49,1913,6
STAT,1911,46,40-44,1957,0.17282797136041278
STAT,1957,20,45-49,1977,1.7188683960612627
SIM,1833,34,na,1867,1812
SIM,1897,8,na,1905,4212
STAT,1901,39,35-39,1940,2.442930762152416
STAT,1829,44,35-39,1873,1.8716559613829173
STAT,1972,28,40-44,2000,6.913636482603303
STAT,1894,38,35-39,1932,10.440911220064248
STAT,1849,72,na,1921,978.8297059373314
STAT,1978,33,25-29,2011,14.828952444571737
STAT,1848,41,50-100,1889,1.1355833848573436
STAT,1853,18,25-29,1871,6.746866947964385
STAT,1842,108,na,1950,0.0014095575351897216
SIM,1856,41,50-100,1897,2
STAT,1882,53,40-44,1935,0.011676388233934368
STAT,1839,30,35-39,1869,10.090800511337639
SIM,1852,44,30-34,1896,1
SIM,1880,46,35-39,1926,1
SIM,1842,26,15-19,1868,1
STAT,1903,22,15-19,1925,5.422860492646319
STAT,1951,43,30-34,1994,0.18229511541101623
STAT,1835,29,50-100,1864,0.5135147124320898
STAT,1844,33,20-24,1877,2.675729297421172
STAT,1845,54,50-100,1899,0.009897199379069306
SIM,1911,22,15-19,1933,7
SIM,1969,2,na,1971,5833
SIM,1812,47,40-44,1859,1
SIM,1980,20,30-34,2000,106
SIM,1862,30,30-34,1892,49
SIM,1922,73,na,1995,3543
SIM,1884,23,15-19,1907,8
SIM,1852,33,20-24,1885,2
STAT,1878,85,na,1963,566.1071037974982
STAT,1875,30,45-49,1905,2.09639107385449
STAT,1860,16,15-19,1876,6.403790444857913
STAT,1982,31,25-29,2013,15.308238891158554
SIM,1939,30,45-49,1969,1
SIM,1943,35,na,1978,5355
SIM,1947,49,na,1996,5843
SIM,1906,35,na,1941,3662
STAT,1822,43,40-44,1865,4.474723377427294
STAT,1838,51,25-29,1889,0.0031134247240300447
SIM,1830,43,40-44,1873,2
SIM,1927,25,30-34,1952,7
SIM,1979,35,35-39,2014,3
STAT,1928,49,15-19,1977,5.392343790073537E-4
SIM,1829,34,35-39,1863,23
SIM,1814,42,45-49,1856,6
STAT,1861,45,20-24,1906,0.01162766566285522
STAT,1857,16,na,1873,2439.3010240267845
STAT,1847,40,35-39,1887,1.4374746587335416
STAT,1875,27,20-24,1902,13.990875055060274
SIM,1931,34,na,1965,5981
STAT,1818,43,20-24,1861,0.2064517420186577
STAT,1821,88,na,1909,83.96150245687927
STAT,1845,24,50-100,1869,0.3362548736270784
STAT,1883,37,20-24,1920,0.8703595322072158
STAT,1891,31,40-44,1922,6.2108156015444385
STAT,1960,41,45-49,2001,0.26034666387626415
SIM,1939,63,na,2002,4379
STAT,1823,36,na,1859,1634.8729866661217
STAT,1885,41,15-19,1926,0.015968551197381227
STAT,1828,48,40-44,1876,0.15559149589498256
SIM,1818,44,30-34,1862,2
SIM,1926,16,25-29,1942,3
SIM,1972,37,45-49,2009,1
STAT,1836,50,30-34,1886,0.0057047578163666336
STAT,1886,42,15-19,1928,0.016790162606162198
SIM,1855,40,35-39,1895,1
STAT,1976,17,25-29,1993,66.81426235583032
STAT,1971,41,20-24,2012,0.026865021054758634
SIM,1883,27,20-24,1910,1
STAT,1964,25,50-100,1989,1.4542779725537718
SIM,1986,16,40-44,2002,5
SIM,1881,18,na,1899,2073
STAT,1919,25,30-34,1944,49.178094730797326
STAT,1982,33,45-49,2015,2.6031292075344905
STAT,1893,43,45-49,1936,0.15050911860117094
STAT,1986,26,40-44,2012,7.701179361172743
SIM,1868,38,35-39,1906,11
SIM,1955,44,na,1999,6440
STAT,1818,54,30-34,1872,0.00679464775972096
STAT,1771,96,na,1867,1.8551255341291981
STAT,1828,40,30-34,1868,1.1420666945167637
STAT,1906,37,50-100,1943,0.4459565894695601
STAT,1954,48,40-44,2002,0.23331296851609443
STAT,1868,48,35-39,1916,0.15327702924025263
SIM,1951,30,na,1981,6272
STAT,1814,50,25-29,1864,0.00980025313200675
SIM,1815,43,45-49,1858,3
STAT,1890,30,40-44,1920,6.164447121291904
STAT,1827,28,25-29,1855,115.8525291607643
SIM,1812,72,na,1884,416
STAT,1973,21,40-44,1994,5.03671515474449
STAT,1984,30,na,2014,6325.959497671756
STAT,1836,54,na,1890,1905.6428076423158
SIM,1984,17,15-19,2001,74
STAT,1920,23,50-100,1943,0.84122482582424
STAT,1787,71,na,1858,471.71973646925653
STAT,1832,40,na,1872,1786.920908571296
STAT,1855,31,30-34,1886,15.28476745989762
SIM,1819,51,na,1870,1032
SIM,1977,19,35-39,1996,16
STAT,1825,48,15-19,1873,5.508789489860953E-4
SIM,1835,28,25-29,1863,4
STAT,1891,104,na,1995,3.5582306686450123
STAT,1824,33,50-100,1857,1.7154978775279532
STAT,1886,28,35-39,1914,11.704403125649561
STAT,1900,27,25-29,1927,67.7396198688355
SIM,1852,69,na,1921,1360
STAT,1881,24,35-39,1905,6.454978835857391
STAT,1855,4,na,1859,2697.5450190314255
SIM,1855,26,na,1881,1832
SIM,1914,22,na,1936,4244
SIM,1953,15,30-34,1968,42
STAT,1865,41,40-44,1906,2.35266944597239
SIM,1863,31,30-34,1894,29
STAT,1958,21,45-49,1979,1.7116654589408085
SIM,1788,73,na,1861,355
SIM,1908,17,20-24,1925,2
STAT,1924,63,na,1987,4533.4827539322405
STAT,1896,35,40-44,1931,6.735936866773556
SIM,1978,34,35-39,2012,27
STAT,1797,108,na,1905,5.453985907059762E-4
STAT,1861,25,20-24,1886,11.501580599781093
STAT,1900,38,35-39,1938,2.4325487463189908
STAT,1810,96,na,1906,4.889133758412526
STAT,1948,31,35-39,1979,12.309143054258394
SIM,1872,0,na,1872,4475
STAT,1832,32,45-49,1864,1.5836962258744767
SIM,1884,39,30-34,1923,3
STAT,1833,25,15-19,1858,0.43664175933560273
STAT,1820,44,15-19,1864,0.01589545967688103
STAT,1876,39,30-34,1915,6.294082412385053
STAT,1880,45,25-29,1925,0.07116113760833424
STAT,1871,34,25-29,1905,11.65912132437228
STAT,1969,19,35-39,1988,6.045229118020205
SIM,1956,31,35-39,1987,35
SIM,1840,32,45-49,1872,6
SIM,1873,41,40-44,1914,2
STAT,1905,84,na,1989,1346.491158419996
STAT,1956,41,35-39,1997,0.3200275000365098
STAT,1916,76,na,1992,2761.5243886745993
STAT,1947,31,40-44,1978,5.188474050253099
SIM,1872,81,na,1953,744
STAT,1850,45,45-49,1895,0.2453713653602509
STAT,1904,11,na,1915,4286.170085604913
SIM,1873,20,35-39,1893,15
STAT,1968,44,20-24,2012,0.02636663110016453
STAT,1832,29,45-49,1861,1.0244679830914531
STAT,1990,24,40-44,2014,5.571571546640684
STAT,1838,37,na,1875,2238.642742161016
STAT,1866,52,45-49,1918,0.015440737028827936
SIM,1840,29,45-49,1869,2
STAT,1870,34,30-34,1904,19.694272218211182
STAT,1945,15,30-34,1960,15.374069103493957
STAT,1854,30,30-34,1884,14.872297630067276
SIM,1893,3,na,1896,3888
SIM,1982,28,50-100,2010,5
SIM,1917,84,na,2001,1528
SIM,1894,28,35-39,1922,37
SIM,1965,14,na,1979,5612
SIM,1860,56,na,1916,2130
SIM,1959,51,na,2010,5759
STAT,1974,21,35-39,1995,14.240691124330375
STAT,1974,28,50-100,2002,1.5056798084736343
STAT,1864,37,40-44,1901,4.5107609017238115
STAT,1849,29,na,1878,1959.1106749217022
STAT,1919,41,na,1960,4650.308272225075
STAT,1889,45,45-49,1934,0.3390733951911239
STAT,1854,38,40-44,1892,3.548649297010676
SIM,1833,30,50-100,1863,2
SIM,1955,31,40-44,1986,3
STAT,1811,70,na,1881,844.7630094703612
SIM,1884,18,na,1902,2852
STAT,1865,20,35-39,1885,6.239366403192326
SIM,1895,29,35-39,1924,20
SIM,1834,29,50-100,1863,2
STAT,1858,97,na,1955,4.836554508251708
STAT,1840,23,40-44,1863,2.1105584749650363
SIM,1892,69,na,1961,2788
SIM,1968,19,na,1987,4736
STAT,1880,23,35-39,1903,7.116142822029705
SIM,1957,27,na,1984,6040
STAT,1895,39,35-39,1934,10.517951119795507
STAT,1984,27,15-19,2011,1.162102663904051
STAT,1888,44,45-49,1932,2.0028987552539843
SIM,1948,22,40-44,1970,12
SIM,1967,33,20-24,2000,5
STAT,1887,29,35-39,1916,12.389990165918038
STAT,1954,39,15-19,1993,0.028165337379924507
STAT,1826,29,50-100,1855,1.1076241826552504
STAT,1939,21,40-44,1960,3.899831916677082
STAT,1949,40,50-100,1989,0.16431928981384245
STAT,1983,26,15-19,2009,1.158003775968918
SIM,1947,21,40-44,1968,18
SIM,1896,44,45-49,1940,1
SIM,1893,16,25-29,1909,12
STAT,1898,27,45-49,1925,1.7317179362480222
SIM,1868,43,25-29,1911,3
STAT,1838,37,45-49,1875,2.0840159807996983
STAT,1921,35,45-49,1956,0.8796500045190774
STAT,1843,67,na,1910,1590.5773991040676
STAT,1885,17,30-34,1902,1.8347178780353453
SIM,1916,27,20-24,1943,2
STAT,1864,43,45-49,1907,1.5310597550804528
SIM,1828,33,35-39,1861,5
STAT,1849,53,20-24,1902,5.62754789003967E-4
STAT,1943,15,na,1958,4507.274790979194
STAT,1947,29,na,1976,4886.044862360366
SIM,1796,60,na,1856,859
STAT,1797,70,na,1867,811.9332892665018
STAT,1981,31,30-34,2012,25.930647825329814
SIM,1923,47,na,1970,5258
STAT,1906,45,20-24,1951,0.0115049200297792
STAT,1809,48,25-29,1857,0.14582304167825044
STAT,1893,35,15-19,1928,0.08269164464095521
SIM,1857,36,na,1893,2511
STAT,1901,36,30-34,1937,1.8684587803529276
SIM,1843,22,20-24,1865,138
STAT,1908,27,20-24,1935,20.10877747805964
STAT,1927,28,50-100,1955,1.3912431017659765
STAT,1974,26,50-100,2000,1.507081068337678
STAT,1916,21,40-44,1937,4.078735405617295
STAT,1859,113,na,1972,1.5416202261127768E-4
SIM,1868,35,30-34,1903,2
SIM,1889,28,20-24,1917,22
SIM,1861,15,20-24,1876,13
SIM,1894,17,na,1911,4074
SIM,1900,73,na,1973,2184
SIM,1940,46,30-34,1986,1
STAT,2007,5,na,2012,7062.658941408378
SIM,1812,42,35-39,1854,3
STAT,1987,15,25-29,2002,71.43251478089161
STAT,1840,50,50-100,1890,0.0122895527567873
STAT,1837,50,25-29,1887,0.002678194370945941
STAT,1869,25,25-29,1894,47.597158264344536
STAT,1823,44,40-44,1867,2.267666156214752
SIM,1831,44,40-44,1875,5
STAT,1926,46,na,1972,5243.246244857407
SIM,1872,43,45-49,1915,3
SIM,1985,15,50-100,2000,2
SIM,1809,52,na,1861,1545
STAT,1853,15,20-24,1868,21.48518896674569
SIM,1965,44,45-49,2009,1
STAT,1885,16,25-29,1901,6.539044252011194
STAT,1835,22,20-24,1857,59.33006729726535
STAT,1862,24,30-34,1886,17.504810714787354
SIM,1868,87,na,1955,97
SIM,1997,17,na,2014,5730
STAT,1932,35,20-24,1967,0.40955546502423734
STAT,1862,109,na,1971,0.011810467055059917
STAT,1957,44,45-49,2001,0.26229397700939244
SIM,1962,40,30-34,2002,1
SIM,1927,28,35-39,1955,38
STAT,1815,49,na,1864,1642.9957780510094
STAT,1896,18,45-49,1914,0.09930931245225456
SIM,1879,25,35-39,1904,16
SIM,1924,21,40-44,1945,4
STAT,1836,109,na,1945,6.474766176330422E-4
STAT,1835,38,25-29,1873,2.1988817645901855
STAT,1974,22,40-44,1996,5.083572382233914
SIM,1971,34,25-29,2005,29
SIM,1917,27,na,1944,5269
STAT,1926,23,20-24,1949,155.38451910838563
STAT,1919,17,25-29,1936,55.25301279341129
STAT,1934,41,na,1975,5977.776889632837
SIM,1921,43,na,1964,5192
STAT,1904,6,na,1910,4329.248659953826
SIM,1992,19,20-24,2011,437
STAT,1890,33,45-49,1923,2.4486219237982527
STAT,1976,33,15-19,2009,0.20183193084583093
STAT,1914,10,na,1924,4731.130767411896
SIM,1843,38,25-29,1881,3
SIM,1894,33,25-29,1927,6
STAT,1875,80,na,1955,737.7351014293965
SIM,1856,51,na,1907,1935
STAT,1910,45,40-44,1955,0.17073526360431304
STAT,1917,46,35-39,1963,0.15580360531990892
STAT,1986,29,45-49,2015,2.850326932584737
STAT,1919,28,35-39,1947,18.650669842279374
SIM,1846,37,45-49,1883,4
STAT,1969,16,30-34,1985,17.57664411075348
STAT,1874,46,45-49,1920,0.2796131741151827
STAT,1883,16,15-19,1899,6.7171124247689304
SIM,1973,30,35-39,2003,29
STAT,1838,80,na,1918,535.8343131830492
STAT,1975,32,15-19,2007,0.19942485980150834
STAT,1874,23,40-44,1897,2.454302891807882
STAT,1901,28,50-100,1929,1.0304118420669752
SIM,1895,45,35-39,1940,1
SIM,1919,15,30-34,1934,6
SIM,1843,25,na,1868,2164
SIM,1903,45,45-49,1948,1
STAT,1878,32,50-100,1910,1.1040351729484876
SIM,2002,8,na,2010,6943
STAT,1885,49,25-29,1934,0.06491951814336441
STAT,1910,26,50-100,1936,1.1141817567957344
SIM,1946,19,na,1965,4673
STAT,1938,22,30-34,1960,32.84325779612845
SIM,1832,60,na,1892,1572
STAT,1965,48,na,2013,5490.269305577742
STAT,1919,40,50-100,1959,0.1472955857652995
SIM,1850,19,30-34,1869,2
STAT,1867,45,15-19,1912,4.35291843840312E-4
STAT,1985,23,20-24,2008,183.05641666016038
SIM,1927,17,25-29,1944,134
STAT,1887,45,35-39,1932,0.18287036471258208
STAT,1842,19,30-34,1861,1.5565173523126716
SIM,1977,21,20-24,1998,3
STAT,1872,40,na,1912,2705.294443453569
STAT,1876,54,na,1930,2498.0464223381036
STAT,1825,62,na,1887,1336.8360757281646
SIM,1923,20,40-44,1943,6
STAT,1886,25,30-34,1911,30.862175490115686
SIM,1865,26,15-19,1891,1
STAT,1836,42,25-29,1878,0.6954764734678572
SIM,1853,44,25-29,1897,1
SIM,1844,34,30-34,1878,44
SIM,1933,32,50-100,1965,3
SIM,1892,13,na,1905,4115
SIM,1863,21,na,1884,2315
SIM,1919,23,25-29,1942,10
SIM,1977,16,30-34,1993,26
STAT,1909,43,15-19,1952,0.0016495497987252191
STAT,1931,17,50-100,1948,0.566054018385341
SIM,1878,86,na,1964,347
STAT,1836,53,35-39,1889,0.007774751360353624
STAT,1836,34,30-34,1870,19.678883437894832
STAT,1969,21,20-24,1990,160.88418093949159
STAT,1831,30,30-34,1861,18.152903426325494
STAT,1910,28,na,1938,4164.340774457973
SIM,1953,18,35-39,1971,13
STAT,1845,44,25-29,1889,0.4294999989395038
SIM,1889,49,na,1938,3514
STAT,1911,94,na,2005,280.3918082692635
STAT,1846,32,na,1878,2647.673163726874
STAT,1915,20,40-44,1935,3.872657230600184
STAT,1893,40,40-44,1933,3.314167450701599
STAT,1861,28,25-29,1889,40.58563005597008
SIM,1894,25,30-34,1919,1
STAT,1851,42,20-24,1893,0.12578286280815243
STAT,1934,17,20-24,1951,211.733212847201
SIM,1942,17,20-24,1959,178
STAT,1851,39,20-24,1890,0.6051269283586483
SIM,1889,78,na,1967,1907
SIM,1835,25,20-24,1860,2
STAT,1835,19,20-24,1854,24.812025141777454
STAT,1852,22,15-19,1874,3.6949670972578486
STAT,1830,51,20-24,1881,6.106009723697862E-4
STAT,1904,41,50-100,1945,0.12212733162775696
SIM,1860,22,15-19,1882,2
STAT,1848,36,na,1884,2606.6169821947437
SIM,1895,26,30-34,1921,9
STAT,1823,39,15-19,1862,0.0618732277550989
SIM,1934,23,20-24,1957,313
STAT,1980,30,30-34,2010,25.75792230244834
STAT,1922,53,na,1975,4764.968009521172
STAT,1826,39,40-44,1865,3.3626980698694022
STAT,1862,41,15-19,1903,0.013510697983511878
SIM,1918,22,25-29,1940,111
STAT,1842,15,45-49,1857,0.06531700790664345
STAT,1894,36,15-19,1930,0.08370845735893404
SIM,1939,30,na,1969,4963
STAT,1915,83,na,1998,1719.9037874451155
SIM,1932,27,na,1959,5512
STAT,1887,26,30-34,1913,32.68009638826653
STAT,1935,33,15-19,1968,0.20515614479738176
SIM,1870,24,30-34,1894,33
STAT,1847,24,35-39,1871,5.425707975537362
STAT,1826,32,15-19,1858,0.1340072018318097
SIM,1900,81,na,1981,1493
SIM,1964,43,45-49,2007,1
STAT,1836,35,15-19,1871,0.06406735124059149
STAT,1968,5,na,1973,5667.354185643752
STAT,1932,49,35-39,1981,0.20070374272952907
STAT,1890,17,45-49,1907,0.09211258375181929
STAT,1899,31,45-49,1930,2.7683729884254813
SIM,1893,43,na,1936,3351
STAT,1862,32,25-29,1894,9.975604327740946
STAT,1947,34,45-49,1981,2.082420508395893
SIM,1908,45,50-100,1953,1
STAT,1888,38,40-44,1926,5.9089546086073605
SIM,1855,24,35-39,1879,13
SIM,1971,9,na,1980,5818
STAT,1852,29,40-44,1881,2.950639848954427
STAT,1872,61,na,1933,2165.379023941093
STAT,1857,26,15-19,1883,0.4230704655036742
STAT,1937,38,na,1975,4339.520797513822
SIM,1984,19,35-39,2003,14
SIM,1943,68,na,2011,4211
SIM,1854,23,35-39,1877,15
STAT,1945,18,35-39,1963,5.288214681497776
SIM,1899,34,20-24,1933,7
STAT,1897,15,35-39,1912,0.8506656747146265
STAT,1900,35,30-34,1935,8.615603217223436
SIM,1921,35,na,1956,5218
STAT,1991,20,35-39,2011,15.635067685054805
STAT,1801,57,na,1858,1176.9680438840558
STAT,1946,22,35-39,1968,12.092065623358563
STAT,1846,23,35-39,1869,7.389969628281004
SIM,1954,22,35-39,1976,1
STAT,1859,50,na,1909,2007.8622626201086
STAT,1793,96,na,1889,1.6524150240903777
STAT,1867,50,40-44,1917,0.01150643023238875
STAT,1841,52,35-39,1893,0.007613482356797023
STAT,1900,24,20-24,1924,109.6625808395277
SIM,1931,42,na,1973,6085
SIM,1846,44,na,1890,1502
SIM,1812,64,na,1876,667
SIM,1896,38,40-44,1934,2
STAT,1838,53,45-49,1891,0.012371297877347387
STAT,1825,70,na,1895,992.4340391641667
SIM,1871,25,30-34,1896,53
STAT,1988,18,45-49,2006,0.824249650215936
SIM,1880,25,na,1905,3349
STAT,1888,41,40-44,1929,3.0651169256168087
STAT,1883,24,na,1907,2653.641230667499
STAT,1921,48,20-24,1969,0.014331968171913416
SIM,1822,71,na,1893,785
SIM,1878,24,35-39,1902,2
STAT,1854,18,40-44,1872,0.17720228694496826
SIM,1955,15,40-44,1970,4
SIM,1843,25,25-29,1868,1
SIM,1955,34,45-49,1989,4
STAT,1903,58,na,1961,3396.8761716235545
STAT,1954,56,na,2010,5248.569345387744
SIM,1856,36,45-49,1892,4
STAT,1898,24,40-44,1922,3.22972961078743
SIM,1833,39,25-29,1872,6
SIM,1940,38,25-29,1978,4
SIM,1813,43,35-39,1856,1
STAT,1910,46,25-29,1956,0.05731668920036361
STAT,1931,24,40-44,1955,5.002278770719257
SIM,1881,23,25-29,1904,127
STAT,1832,26,40-44,1858,2.899018581255047
STAT,1863,25,30-34,1888,25.780185345844643
STAT,1932,38,25-29,1970,1.525542702922947
STAT,1848,98,na,1946,3.45166501723108
SIM,1893,29,25-29,1922,6
SIM,1821,33,25-29,1854,6
STAT,1868,24,na,1892,2605.8733397197657
STAT,1891,40,30-34,1931,1.6563388013238858
STAT,1854,54,40-44,1908,0.008340986724945812
SIM,1970,23,30-34,1993,62
STAT,1895,15,25-29,1910,8.552064378966291
STAT,1853,39,30-34,1892,5.252824016705337
SIM,1945,45,na,1990,4652
STAT,1848,36,45-49,1884,2.205563097014168
STAT,1863,40,25-29,1903,0.6545458143919427
STAT,1910,48,45-49,1958,0.23360557954427522
STAT,1962,23,30-34,1985,42.62542786455665
STAT,1912,48,50-100,1960,0.25039606113730944
STAT,1874,28,na,1902,2809.626467121834
STAT,1962,37,na,1999,5731.350144869605
STAT,1859,28,na,1887,2215.7872588970818
STAT,1916,68,na,1984,3577.4416499744234
STAT,1974,25,45-49,1999,2.6169139006454833
STAT,1860,36,na,1896,2201.8616678052404
STAT,1990,18,na,2008,6081.277561955866
SIM,1840,26,40-44,1866,3
STAT,1828,28,40-44,1856,4.350274154074194
STAT,1919,90,na,2009,750.9123107581578
STAT,1885,29,25-29,1914,48.34553533189442
SIM,1924,24,45-49,1948,3
STAT,1912,54,na,1966,3972.0416793161558
STAT,1837,108,na,1945,0.0013264025706419443
SIM,1870,27,35-39,1897,15
STAT,1865,44,45-49,1909,1.537350391262457
STAT,1862,27,35-39,1889,9.432047379141258
STAT,1887,42,30-34,1929,1.48506177551323
SIM,1873,44,45-49,1917,5
SIM,1792,78,na,1870,235
SIM,1895,42,30-34,1937,2
SIM,1911,65,na,1976,4096
SIM,1907,28,na,1935,4652
STAT,1896,47,35-39,1943,0.11981420615533687
SIM,1954,30,na,1984,5317
STAT,1912,7,na,1919,4653.933431897851
STAT,1881,45,40-44,1926,0.1924675802872882
STAT,1922,61,na,1983,4484.857301162293
SIM,1978,20,30-34,1998,102
STAT,1929,3,na,1932,5974.063730906412
SIM,1869,36,30-34,1905,5
STAT,1906,48,25-29,1954,0.053991455304976996
SIM,1825,82,na,1907,626
STAT,1859,9,na,1868,2599.847935847154
SIM,1859,62,na,1921,1571
STAT,1842,51,45-49,1893,0.011221101881752496
STAT,1995,17,50-100,2012,0.6258757837098192
STAT,1992,16,45-49,2008,0.8277140765465453
SIM,1846,34,40-44,1880,4
STAT,1916,24,45-49,1940,1.3522726232446696
STAT,1947,15,40-44,1962,1.819234883512487
SIM,1988,10,na,1998,6634
STAT,1896,42,na,1938,3530.805108883776
STAT,1880,44,40-44,1924,2.714268133301459
SIM,1963,45,na,2008,6465
STAT,1896,38,45-49,1934,3.0235724029377726
STAT,1838,34,40-44,1872,4.572770850940236
STAT,1973,24,45-49,1997,1.6837744088386628
STAT,1983,31,40-44,2014,6.515925000051877
STAT,1893,31,na,1924,3495.1815593306524
SIM,1856,43,na,1899,2079
SIM,1807,49,25-29,1856,1
STAT,1959,45,15-19,2004,5.811332538721455E-4
STAT,1836,37,35-39,1873,7.903716866331493
SIM,1949,21,15-19,1970,9
STAT,1895,35,25-29,1930,4.366182958352791
STAT,1980,22,25-29,2002,148.4726009050351
SIM,1891,16,15-19,1907,15
SIM,1967,30,50-100,1997,3
SIM,1963,44,35-39,2007,1
STAT,1851,45,25-29,1896,0.0461318768636986
SIM,1941,47,30-34,1988,1
STAT,1936,45,na,1981,4224.536855706295
STAT,1899,18,50-100,1917,0.07725666674454895
SIM,1973,35,50-100,2008,1
SIM,1929,60,na,1989,4821
SIM,1930,17,na,1947,5648
SIM,1879,6,na,1885,3157
STAT,1851,26,20-24,1877,10.971270927465273
SIM,1923,23,45-49,1946,1
STAT,1886,44,35-39,1930,2.174569568767836
STAT,1915,23,45-49,1938,1.3383388895205324
STAT,1886,33,25-29,1919,12.415819630744307
STAT,1933,47,30-34,1980,0.1415373796939562
STAT,1980,33,35-39,2013,14.914099014194342
STAT,1990,3,na,1993,6501.311785607301
STAT,1830,54,25-29,1884,0.002761713967764371
STAT,1821,44,30-34,1865,2.122000732732796
STAT,1985,26,25-29,2011,108.55243775773515
STAT,1885,46,20-24,1931,0.013852530210562937
STAT,1840,35,35-39,1875,6.851669801003489
STAT,1970,33,20-24,2003,3.5895534243345013
SIM,1833,26,na,1859,2005
SIM,1949,18,15-19,1967,67
SIM,1836,74,na,1910,418
SIM,1815,40,40-44,1855,2
STAT,1948,1,na,1949,5423.204420864925
SIM,1866,21,na,1887,2311
STAT,1859,105,na,1964,0.13629626209692358
STAT,1862,62,na,1924,1780.0865950666416
SIM,1984,16,30-34,2000,21
STAT,1880,13,na,1893,3154.135157688333
SIM,1843,33,na,1876,1954
STAT,1905,34,40-44,1939,4.123730421087198
STAT,1947,37,na,1984,5038.63015191927
SIM,1777,78,na,1855,423
SIM,1913,34,40-44,1947,10
STAT,1932,46,30-34,1978,0.13993754428261673
STAT,1966,44,na,2010,5544.875122176332
STAT,1850,29,na,1879,2583.200692350131
STAT,1970,44,30-34,2014,0.1912975076327589
STAT,1854,52,20-24,1906,5.979803041833949E-4
STAT,1882,79,na,1961,1013.4641604730259
STAT,1969,24,25-29,1993,133.51155843491753
STAT,1839,54,45-49,1893,0.011192575040609954
SIM,1884,44,20-24,1928,1
STAT,1959,30,50-100,1989,1.2736651779900179
STAT,1891,34,45-49,1925,2.465950493265524
STAT,1831,33,35-39,1864,10.206192255712843
STAT,1861,15,25-29,1876,6.323125202132604
STAT,1825,36,20-24,1861,1.3155051832355105
STAT,1876,44,20-24,1920,0.1869032264762454
STAT,1968,23,25-29,1991,133.5384273935945
STAT,1875,43,20-24,1918,0.18803151295146248
SIM,1876,5,na,1881,3123
STAT,1837,38,35-39,1875,6.1713409222363325
STAT,1873,23,50-100,1896,0.479091876291758
STAT,1918,17,50-100,1935,0.09439788690601945
SIM,1892,17,15-19,1909,7
SIM,1929,28,45-49,1957,3
SIM,1906,43,na,1949,3511
SIM,1899,37,25-29,1936,4
SIM,1972,38,50-100,2010,1
STAT,1901,91,na,1992,472.13387578530717
STAT,1780,78,na,1858,418.2016300199937
STAT,1873,54,na,1927,2467.7070761283076
STAT,1964,38,50-100,2002,0.628090630071822
STAT,1830,32,35-39,1862,10.95716915472162
STAT,1904,22,30-34,1926,29.518857509235506
STAT,1869,45,25-29,1914,0.06501602166389298
STAT,1847,62,na,1909,1406.3556790887596
STAT,1859,36,20-24,1895,0.7120557615555776
SIM,1880,87,na,1967,544
SIM,1912,22,30-34,1934,81
SIM,1976,23,25-29,1999,283
STAT,1835,25,25-29,1860,35.061308870914694
SIM,1910,80,na,1990,1287
STAT,1979,33,40-44,2012,6.334436978587884
STAT,1959,35,20-24,1994,0.41068522960362097
SIM,1844,37,35-39,1881,6
SIM,1879,79,na,1958,674
STAT,1826,48,30-34,1874,0.06874965863239607
STAT,1827,49,30-34,1876,0.11936275602501169
STAT,1897,16,na,1913,3906.92018956597
STAT,1958,33,50-100,1991,1.276625718661311
STAT,1958,34,20-24,1992,3.7637097042248207
STAT,1911,22,30-34,1933,31.483945744790038
SIM,1919,20,20-24,1939,261
STAT,1912,83,na,1995,1641.6148779717012
SIM,1951,36,35-39,1987,7
SIM,1845,38,35-39,1883,14
SIM,1871,51,na,1922,1822
SIM,1867,39,25-29,1906,1
STAT,1978,29,40-44,2007,7.36543091569747
STAT,1813,102,na,1915,0.13423670225416756
STAT,1834,44,na,1878,2254.529264903766
STAT,1986,19,30-34,2005,20.029754789920286
STAT,1886,39,50-100,1925,1.4795030227526877
STAT,1820,43,30-34,1863,1.3752206973277592
STAT,1875,19,50-100,1894,0.05811415539673638
STAT,1814,45,35-39,1859,0.4020591667733097
SIM,1877,13,na,1890,3452
SIM,1808,56,na,1864,1508
STAT,1981,34,35-39,2015,15.01230616431131
SIM,1934,53,na,1987,5615
SIM,1964,40,40-44,2004,2
SIM,1994,19,30-34,2013,25
STAT,1943,36,35-39,1979,3.0526268701376855
STAT,1892,103,na,1995,6.410142762597013
STAT,1972,42,na,2014,5703.033111334975
STAT,1834,42,15-19,1876,0.015193066285385356
STAT,1910,43,20-24,1953,0.019165846288749944
SIM,1891,17,na,1908,3537
SIM,1959,39,na,1998,5912
STAT,1826,55,na,1881,1226.7582256677688
STAT,1847,33,25-29,1880,9.157963125744358
STAT,1875,58,na,1933,2358.4736942422014
STAT,1873,51,40-44,1924,0.012466089580399353
SIM,1866,42,45-49,1908,1
SIM,1802,73,na,1875,418
STAT,1766,104,na,1870,0.07915383019059065
STAT,1858,42,45-49,1900,1.3457453218897002
SIM,1813,49,na,1862,1327
STAT,1894,43,25-29,1937,0.0656771322362312
STAT,1864,82,na,1946,480.78593542074736
STAT,1922,21,35-39,1943,12.493463654346652
SIM,1926,12,na,1938,6181
STAT,1934,19,na,1953,5717.550164931602
SIM,1837,40,25-29,1877,2
SIM,1926,10,na,1936,6216
STAT,1950,29,35-39,1979,20.554847150155524
SIM,1900,28,35-39,1928,3
STAT,1973,28,20-24,2001,27.34942645019291
STAT,1827,74,na,1901,901.2819304863478
STAT,1896,28,na,1924,3624.939343493424
STAT,1880,108,na,1988,0.15802198796065306
STAT,1902,35,40-44,1937,1.5553237144051923
SIM,1981,28,20-24,2009,11
SIM,1855,33,25-29,1888,3
STAT,1813,50,30-34,1863,0.01967364811562247
SIM,1887,12,na,1899,3963
STAT,1911,8,na,1919,4594.805286504639
STAT,1960,36,40-44,1996,2.32025849914128
STAT,1863,44,35-39,1907,1.8026453239621
STAT,1856,42,35-39,1898,1.5923668056608338
STAT,1866,103,na,1969,1.2983680663092196
SIM,1966,39,35-39,2005,6
STAT,1934,46,40-44,1980,0.2542557214685193
STAT,1831,54,40-44,1885,0.008248374518121398
SIM,1935,70,na,2005,4752
STAT,1829,40,25-29,1869,0.7097488954760421
STAT,1873,23,25-29,1896,67.2549105684775
SIM,1910,22,20-24,1932,127
SIM,1952,22,25-29,1974,272
SIM,1892,32,45-49,1924,6
SIM,1959,37,na,1996,5927
STAT,1865,48,50-100,1913,0.252519203071345
STAT,1859,39,50-100,1898,1.1173101492312028
STAT,1805,93,na,1898,12.010109443831928
STAT,1968,21,na,1989,5282.888374825249
STAT,1973,40,35-39,2013,0.31320761496304633
SIM,1871,44,35-39,1915,6
STAT,1836,26,50-100,1862,0.7590211808842734
SIM,1957,28,15-19,1985,2
STAT,1971,19,na,1990,5376.433600305504
STAT,1930,40,25-29,1970,0.10874539299672072
STAT,1852,63,na,1915,1682.2660118018396
STAT,1944,22,25-29,1966,115.10064386257581
STAT,1960,23,20-24,1983,167.63121458928575
STAT,1993,12,na,2005,6522.261555125264
STAT,1949,31,15-19,1980,0.17590996632112174
STAT,1877,16,20-24,1893,21.334394794474214
SIM,1825,68,na,1893,1003
STAT,1815,53,45-49,1868,0.027912997807781052
SIM,1927,75,na,2002,2840
SIM,1935,27,25-29,1962,186
STAT,1938,5,na,1943,4579.493473337954
STAT,1869,20,na,1889,2670.351144261927
STAT,1896,44,30-34,1940,0.12004925788030026
STAT,1884,32,45-49,1916,1.988342659893589
SIM,1863,30,25-29,1893,5
STAT,1850,82,na,1932,480.32143526417315
STAT,1866,16,45-49,1882,0.07214387928223386
SIM,1870,32,25-29,1902,14
STAT,1811,104,na,1915,0.034343422686018366
STAT,1850,29,30-34,1879,30.07016551466585
STAT,1955,3,na,1958,6026.5243507714
STAT,1847,44,50-100,1891,0.8019189932099772
STAT,1977,33,30-34,2010,25.026128873467904
SIM,1827,49,na,1876,1388
SIM,1981,20,25-29,2001,184
STAT,1904,17,50-100,1921,0.0811902817843553
SIM,1874,16,45-49,1890,3
STAT,1978,18,40-44,1996,2.2022283100159297
SIM,1880,79,na,1959,1109
STAT,1927,27,25-29,1954,92.32476466612005
STAT,1902,22,20-24,1924,112.37064301920407
STAT,1845,41,20-24,1886,0.11038250330091626
STAT,1985,17,na,2002,6041.557960539104
STAT,1808,52,15-19,1860,1.1724270626804195E-4
STAT,1877,31,15-19,1908,0.1716511895079774
STAT,1856,87,na,1943,155.11824395501964
STAT,1954,32,35-39,1986,13.289340328261728
SIM,1894,26,15-19,1920,2
STAT,1952,43,25-29,1995,0.10246949086771671
STAT,1943,33,30-34,1976,19.6431751128513
STAT,1987,6,na,1993,6476.602402912437
STAT,1972,30,50-100,2002,1.246691582764011
STAT,1940,17,50-100,1957,0.4391432197523587
STAT,1850,21,35-39,1871,7.262435212031433
SIM,1880,33,na,1913,3304
SIM,1982,32,35-39,2014,34
SIM,1851,84,na,1935,772
STAT,1924,39,35-39,1963,3.2835912908788645
SIM,1886,32,50-100,1918,1
STAT,1778,101,na,1879,0.18077206979981075
STAT,1881,20,25-29,1901,64.10195654329269
STAT,1872,18,na,1890,2919.0100603299857
STAT,1881,40,35-39,1921,2.0360083498725072
STAT,1969,31,15-19,2000,0.1889452607513109
STAT,1815,71,na,1886,834.5765835409253
STAT,1834,41,45-49,1875,1.6677792732260956
SIM,1815,91,na,1906,38
STAT,1920,19,na,1939,4738.155863061712
STAT,1963,35,40-44,1998,2.265128814457111
STAT,1855,15,30-34,1870,1.6322554779144223
STAT,1989,15,35-39,2004,6.939858286541442
SIM,1932,39,35-39,1971,10
SIM,1881,34,50-100,1915,5
STAT,1950,49,na,1999,5183.768541799898
STAT,1814,42,30-34,1856,3.9352531370258452
STAT,1895,32,20-24,1927,4.060513152813498
STAT,1880,47,45-49,1927,0.287339068020205
SIM,1870,55,na,1925,2717
SIM,1927,83,na,2010,999
STAT,1974,32,35-39,2006,14.036970508040485
STAT,1969,26,45-49,1995,2.50246430893629
STAT,1840,32,30-34,1872,17.0594688105869
STAT,1831,49,15-19,1880,3.612237391348299E-4
SIM,1942,33,20-24,1975,6
SIM,1863,15,30-34,1878,4
SIM,1951,33,30-34,1984,3
SIM,1888,43,35-39,1931,3
SIM,1988,20,35-39,2008,19
STAT,1879,19,35-39,1898,0.6576589709871945
STAT,1923,30,40-44,1953,5.217030293929638
STAT,1906,77,na,1983,2258.577343160301
SIM,1997,15,35-39,2012,14
STAT,1984,15,30-34,1999,19.98881176163247
STAT,1817,107,na,1924,0.0032604223393819447
STAT,1959,38,25-29,1997,1.529750934181679
STAT,1934,33,20-24,1967,3.842822879526447
STAT,1877,39,na,1916,2799.756047735127
STAT,1953,17,25-29,1970,60.49832358446085
SIM,1832,39,30-34,1871,11
STAT,1860,32,15-19,1892,0.13245460967624886
STAT,1917,20,15-19,1937,6.56821042637724
STAT,1833,44,50-100,1877,0.8841459087626861
SIM,1829,40,na,1869,1734
STAT,1845,93,na,1938,19.693674957335936
SIM,1920,47,na,1967,4099
STAT,1929,32,na,1961,5544.3537851781475
STAT,1820,46,35-39,1866,0.15191490260371904
SIM,1848,26,45-49,1874,4
SIM,1888,31,40-44,1919,8
SIM,1822,42,30-34,1864,5
STAT,1860,31,45-49,1891,1.6285723995211954
STAT,1771,106,na,1877,0.015780591544946054
SIM,1925,17,15-19,1942,115
SIM,1781,86,na,1867,110
STAT,1917,17,15-19,1934,11.270844845221628
STAT,1897,33,50-100,1930,1.4079228864154945
SIM,1876,20,na,1896,2456
SIM,1916,34,na,1950,4419
SIM,1938,36,50-100,1974,1
STAT,1908,43,20-24,1951,0.01876696194535447
SIM,1944,33,30-34,1977,33
STAT,1819,51,20-24,1870,0.00139404938799152
STAT,1958,25,30-34,1983,59.69908469580251
STAT,1824,39,30-34,1863,7.812785329525969
SIM,1883,23,35-39,1906,12
STAT,1914,64,na,1978,3725.4898623666754
SIM,1810,60,na,1870,1130
SIM,1900,25,30-34,1925,44
STAT,1984,29,35-39,2013,24.69006957977878
SIM,1909,34,20-24,1943,5
STAT,1886,26,15-19,1912,0.5541924979416909
STAT,1860,39,40-44,1899,4.0305748705968165
SIM,1916,91,na,2007,100
SIM,1962,32,35-39,1994,24
SIM,1888,28,40-44,1916,10
SIM,1993,2,na,1995,6965
SIM,1832,31,35-39,1863,8
STAT,1968,46,40-44,2014,0.23696953369034796
STAT,1860,48,30-34,1908,0.08890323083188868
SIM,1889,92,na,1981,581
STAT,1943,43,15-19,1986,0.0019501828027444605
SIM,1926,32,25-29,1958,20
STAT,1829,25,30-34,1854,91.58416027635502
STAT,1869,42,20-24,1911,0.17727224403732306
STAT,1937,45,40-44,1982,0.18465546375720987
STAT,1824,31,35-39,1855,24.045375659363952
STAT,1856,85,na,1941,241.36146134420943
STAT,1860,100,na,1960,2.1845510715109167
STAT,1918,32,25-29,1950,11.332136285583175
SIM,1966,25,30-34,1991,87
STAT,1846,53,30-34,1899,0.006054835829569454
SIM,1884,71,na,1955,1323
STAT,1858,19,20-24,1877,18.425292255014703
SIM,1808,49,40-44,1857,1
STAT,1942,30,na,1972,4655.433206451098
STAT,1926,39,45-49,1965,0.9592497391920471
SIM,1837,25,30-34,1862,9
STAT,1857,47,50-100,1904,0.2197187639658666
STAT,1834,49,40-44,1883,0.16149932355521582
STAT,1890,105,na,1995,1.8919298979691503
STAT,1921,32,40-44,1953,5.023936154571376
SIM,1900,59,na,1959,3044
SIM,1979,16,40-44,1995,7
STAT,1960,39,45-49,1999,1.0534219241474756
STAT,1815,45,15-19,1860,8.412955964640298E-4
STAT,1983,1,na,1984,6428.233297510802
STAT,1936,33,30-34,1969,17.660137190799613
SIM,1935,24,20-24,1959,169
STAT,1768,102,na,1870,0.07845992535466123
SIM,1951,57,na,2008,5909
SIM,1865,47,50-100,1912,1
STAT,1927,24,20-24,1951,157.07759841891803
STAT,1885,36,na,1921,2725.040079178313
STAT,1868,50,20-24,1918,8.299387320187462E-4
SIM,1929,52,na,1981,5064
STAT,1922,19,50-100,1941,0.4974876778501329
SIM,1926,17,30-34,1943,29
STAT,1883,40,45-49,1923,1.706896024650556
SIM,1910,25,50-100,1935,4
SIM,1830,69,na,1899,1010
STAT,1875,46,25-29,1921,0.0688885290564116
SIM,1896,48,na,1944,3408
STAT,1933,24,15-19,1957,8.146722705654813
STAT,1884,33,15-19,1917,0.16169099069966367
STAT,1951,17,15-19,1968,62.367469098273865
SIM,1941,24,15-19,1965,12
STAT,1911,32,15-19,1943,0.14453271868346673
SIM,1899,70,na,1969,2656
STAT,1918,17,30-34,1935,3.0710785450575653
STAT,1852,43,20-24,1895,0.14864943591285612
SIM,1891,40,45-49,1931,3
SIM,1915,58,na,1973,4179
SIM,1922,1,na,1923,5599
STAT,1863,55,na,1918,2086.550770498211
SIM,1971,31,20-24,2002,6
STAT,1860,50,na,1910,2031.4592531878523
SIM,1834,39,40-44,1873,3
SIM,1913,77,na,1990,2772
STAT,1850,37,na,1887,2463.7581519945993
STAT,1877,19,25-29,1896,6.7661144729830935
STAT,1928,42,35-39,1970,0.2962445400262709
SIM,1940,71,na,2011,3331
STAT,1938,25,35-39,1963,17.188677459296784
STAT,1949,16,20-24,1965,182.01635690456223
SIM,1934,61,na,1995,5238
STAT,1837,54,35-39,1891,0.006062668507702982
SIM,1972,25,50-100,1997,7
SIM,1925,43,30-34,1968,2
SIM,1936,42,35-39,1978,1
SIM,1866,19,20-24,1885,18
SIM,1828,30,30-34,1858,6
STAT,1789,91,na,1880,15.284628789317532
STAT,1972,41,50-100,2013,0.18065988109218328
SIM,1844,42,25-29,1886,1
STAT,1910,42,na,1952,4054.8538986315934
SIM,1928,32,35-39,1960,29
STAT,1826,53,20-24,1879,5.02931733816597E-4
SIM,1878,22,15-19,1900,7
STAT,1891,47,20-24,1938,0.00960973626924989
SIM,1968,17,35-39,1985,11
STAT,1961,48,40-44,2009,0.243833988385074
SIM,1908,47,na,1955,3585
SIM,1946,25,35-39,1971,3
SIM,1862,15,15-19,1877,9
STAT,1882,21,50-100,1903,0.461055242304457
STAT,1934,49,45-49,1983,0.3475741920940364
STAT,1917,43,30-34,1960,0.15373134660912235
STAT,1854,15,15-19,1869,5.852384853007369
STAT,1892,78,na,1970,1650.6805252657705
STAT,1844,52,25-29,1896,0.0029468481581775806
STAT,1862,25,15-19,1887,0.4499425485306486
SIM,1942,49,45-49,1991,1
STAT,1908,103,na,2011,8.566733754038413
SIM,1879,34,25-29,1913,2
SIM,1924,89,na,2013,132
STAT,1874,43,40-44,1917,2.6382042569429918
SIM,1918,43,30-34,1961,1
SIM,1835,60,na,1895,1690
SIM,1972,15,35-39,1987,8
STAT,1989,25,50-100,2014,1.6538516853002325
SIM,1846,52,na,1898,1427
SIM,1963,41,30-34,2004,1
STAT,1780,92,na,1872,15.628296955448466
STAT,1965,46,15-19,2011,5.534155847241436E-4
STAT,1822,33,na,1855,2360.4503512724427
STAT,1849,33,35-39,1882,8.185623262590846
STAT,1860,44,50-100,1904,0.9693515834562252
SIM,1909,37,25-29,1946,2
STAT,1855,30,25-29,1885,9.060279938816933
STAT,1846,20,30-34,1866,23.05016833196732
STAT,1893,23,na,1916,3439.279931921704
STAT,1858,43,15-19,1901,0.012342984487874737
STAT,1869,21,50-100,1890,0.45712589896949474
SIM,1818,88,na,1906,178
STAT,1841,35,15-19,1876,0.060057575394420484
STAT,1881,20,na,1901,2648.312048113007
SIM,1882,43,40-44,1925,9
STAT,1841,43,45-49,1884,1.3651079533461254
STAT,1884,17,50-100,1901,0.055861568253408024
SIM,1854,20,30-34,1874,4
STAT,1981,22,40-44,2003,5.443816254504394
STAT,1976,6,na,1982,6061.089285936688
SIM,1995,13,na,2008,6763
SIM,1832,38,na,1870,2173
SIM,1947,40,45-49,1987,1
SIM,1832,33,50-100,1865,3
STAT,1850,46,15-19,1896,4.129471838202616E-4
STAT,1960,27,na,1987,5655.092743155413
SIM,1857,33,35-39,1890,16
STAT,1890,80,na,1970,1390.5593955343686
STAT,1819,54,25-29,1873,0.006303460578048392
STAT,1939,40,45-49,1979,0.20043539685325443
SIM,1913,4,na,1917,5155
STAT,1875,23,35-39,1898,6.937862346905591
STAT,1907,34,15-19,1941,0.13765549539961922
STAT,1901,46,na,1947,3647.8325121739517
STAT,1935,20,50-100,1955,1.0353295134412654
STAT,1939,34,50-100,1973,0.9726906525459874
STAT,1965,30,45-49,1995,2.313567135087908
SIM,1901,16,15-19,1917,16
STAT,1909,34,na,1943,4134.039171213287
STAT,1879,16,30-34,1895,1.9253599049275076
STAT,1976,18,30-34,1994,18.78670107362624
STAT,1856,31,na,1887,2148.9480320681296
SIM,1943,20,50-100,1963,1
STAT,1943,13,na,1956,4806.848260310771
SIM,1821,46,na,1867,1472
SIM,1975,21,na,1996,5732
STAT,1908,46,25-29,1954,0.05585099673261671
STAT,1857,50,45-49,1907,0.013231359204986116
STAT,1897,24,25-29,1921,87.78463036204425
STAT,1931,46,15-19,1977,5.699626104669834E-4
STAT,1932,52,na,1984,5655.877261397335
STAT,1947,51,na,1998,4904.245412495597
SIM,1847,37,na,1884,2555
STAT,2003,0,na,2003,6937.747277690313
SIM,1859,70,na,1929,929
SIM,1878,7,na,1885,3190
STAT,1848,53,40-44,1901,0.011006317346614185
STAT,1889,72,na,1961,2015.7055245103384
SIM,1887,19,35-39,1906,1
STAT,1955,41,40-44,1996,0.3988027993569438
SIM,1848,23,40-44,1871,1
STAT,1969,23,40-44,1992,4.861682250084729
STAT,1985,15,na,2000,6044.7612608740765
STAT,1887,101,na,1988,14.591196915708808
STAT,1964,15,35-39,1979,6.102411194707485
STAT,1865,36,15-19,1901,0.05875270382537039
STAT,1872,43,30-34,1915,1.3226142945945851
STAT,1877,52,20-24,1929,8.811158446960602E-4
SIM,1916,46,25-29,1962,1
STAT,1844,12,na,1856,2538.198125586
STAT,1901,35,25-29,1936,1.0141027031463374
SIM,1898,7,na,1905,4212
SIM,1895,63,na,1958,2617
STAT,1774,101,na,1875,0.00558374631543556
SIM,1837,28,35-39,1865,2
STAT,1981,30,25-29,2011,15.22037948906347
STAT,1892,42,45-49,1934,2.1621265321795593
STAT,1869,104,na,1973,1.0754859816577629
SIM,1834,64,na,1898,1305
SIM,1930,30,25-29,1960,30
SIM,1902,31,25-29,1933,21
STAT,1891,110,na,2001,0.04326151644462592
STAT,1916,14,na,1930,4820.39533501799
STAT,1982,15,20-24,1997,220.28087182737764
SIM,1885,56,na,1941,2690
STAT,1829,28,35-39,1857,16.925359051854343
SIM,1934,36,40-44,1970,8
SIM,1880,43,30-34,1923,3
SIM,1902,50,na,1952,3746
STAT,1865,81,na,1946,563.0743241683736
SIM,1927,32,40-44,1959,2
SIM,1892,49,30-34,1941,1
STAT,1872,51,25-29,1923,0.00412413078577243
STAT,1878,31,30-34,1909,21.124158872832698
SIM,1920,35,35-39,1955,3
SIM,1847,23,25-29,1870,5
STAT,1799,82,na,1881,231.05035053623422
STAT,1909,63,na,1972,3504.0219658997394
STAT,1967,46,25-29,2013,0.07973657699725928
STAT,1853,46,40-44,1899,0.1709339100710339
STAT,1884,106,na,1990,0.7170132952845325
STAT,1846,24,na,1870,2688.2536034143864
STAT,1912,35,35-39,1947,2.7529058558937107
SIM,1959,28,25-29,1987,104
STAT,1833,46,20-24,1879,0.010088049627797942
SIM,1863,18,35-39,1881,1
SIM,1886,31,30-34,1917,44
SIM,1908,28,50-100,1936,1
STAT,1808,50,na,1858,1658.4102040590365
STAT,1873,30,35-39,1903,12.030576894978218
STAT,1884,49,30-34,1933,0.10806887936047742
STAT,1867,93,na,1960,58.545195156807075
STAT,1871,19,30-34,1890,1.820149811998205
STAT,1879,81,na,1960,852.6077497682128
STAT,1915,48,50-100,1963,0.26233749443322296
STAT,1831,52,50-100,1883,0.012311053769570365
STAT,1859,42,na,1901,2122.117708114486
STAT,1821,40,20-24,1861,0.3204594653028954
STAT,1851,46,50-100,1897,0.19531248810845744
STAT,1862,48,40-44,1910,0.16464216955131344
SIM,1883,44,na,1927,2394
STAT,1977,18,25-29,1995,67.55074854743177
SIM,1874,19,na,1893,2790
SIM,1929,41,40-44,1970,1
STAT,1907,19,20-24,1926,29.941163527298897
SIM,1829,75,na,1904,520
STAT,1806,51,35-39,1857,0.030918150642490542
SIM,1870,26,na,1896,3208
STAT,1922,30,25-29,1952,12.14334226018786
STAT,1951,10,na,1961,5399.667463531302
STAT,1953,46,45-49,1999,0.3163841647620448
STAT,1855,18,35-39,1873,0.552053177802015
STAT,1837,51,30-34,1888,0.004412592716127026
STAT,1856,33,45-49,1889,1.538090437576858
SIM,1933,69,na,2002,5209
STAT,1885,113,na,1998,0.0016129432018120748
STAT,1908,0,na,1908,5033.148567600795
STAT,1897,47,15-19,1944,3.465588582380602E-4
STAT,1933,46,25-29,1979,0.08442997509649075
STAT,1920,21,25-29,1941,118.8147938716636
STAT,2002,13,na,2015,6832.172212072002
STAT,1926,36,40-44,1962,2.1128356161379944
SIM,1890,20,40-44,1910,4
STAT,1949,19,25-29,1968,58.12425674537654
SIM,1870,48,40-44,1918,1
STAT,1952,40,20-24,1992,0.0254524756242035
STAT,1882,20,40-44,1902,2.3629154590634647
SIM,1893,51,na,1944,3082
STAT,1830,94,na,1924,12.537603787595957
STAT,1945,22,40-44,1967,4.252792505897008
SIM,1836,20,na,1856,1922
STAT,1841,86,na,1927,197.26793017180827
STAT,1958,16,50-100,1974,0.5680384282196022
STAT,1958,46,50-100,2004,0.3574803399399571
STAT,1831,79,na,1910,548.4949634868054
SIM,1849,49,na,1898,2475
SIM,1864,33,45-49,1897,4
SIM,1978,31,30-34,2009,31
SIM,1820,36,35-39,1856,12
SIM,1838,57,na,1895,1385
SIM,1864,30,40-44,1894,7
SIM,1868,21,50-100,1889,1
SIM,1904,31,na,1935,4078
SIM,1880,37,45-49,1917,4
STAT,1898,54,na,1952,3265.993042647039
STAT,1973,23,50-100,1996,0.9850081873657467
SIM,1841,21,na,1862,2023
STAT,1891,11,na,1902,3688.9762874993894
STAT,1944,43,30-34,1987,0.1647516881343545
SIM,1948,25,45-49,1973,1
STAT,1790,69,na,1859,706.257007576255
SIM,1881,30,35-39,1911,1
SIM,1830,46,45-49,1876,1
STAT,1892,43,15-19,1935,0.019830716713947472
STAT,1939,45,15-19,1984,4.4488371332068277E-4
SIM,1987,26,30-34,2013,156
STAT,1875,45,50-100,1920,0.2958215357299569
STAT,1852,49,na,1901,2076.891480523756
STAT,1945,25,na,1970,4747.158179064858
SIM,1953,22,40-44,1975,12
SIM,1913,48,na,1961,4432
STAT,1898,83,na,1981,1319.5482093416945
SIM,1859,29,25-29,1888,52
SIM,1964,25,20-24,1989,24
STAT,1841,40,40-44,1881,2.131986715643832
SIM,1784,72,na,1856,344
SIM,1902,85,na,1987,539
STAT,1872,37,45-49,1909,2.3100567934267473
STAT,1766,95,na,1861,5.969261863566856
STAT,1979,26,30-34,2005,62.55766188054248
SIM,1865,5,na,1870,3542
STAT,1857,47,20-24,1904,0.010735444918490588
STAT,1971,15,45-49,1986,0.7305489028140669
STAT,1892,92,na,1984,318.8293007648787
STAT,1956,25,20-24,1981,28.019968041761928
STAT,1935,18,na,1953,5794.876908447488
STAT,1930,40,na,1970,5655.738933834259
SIM,1890,32,35-39,1922,21
SIM,1938,35,20-24,1973,1
STAT,1822,46,45-49,1868,0.45247850958538394
STAT,1870,37,35-39,1907,8.047033831772152
SIM,1968,36,40-44,2004,3
SIM,1838,40,40-44,1878,5
STAT,1850,42,40-44,1892,2.312657336592039
SIM,1840,41,35-39,1881,7
STAT,1919,32,40-44,1951,4.871267003344899
STAT,1925,38,50-100,1963,0.5807712486330098
SIM,1798,72,na,1870,716
SIM,1847,45,50-100,1892,1
STAT,1952,47,50-100,1999,0.32535903775366826
STAT,1940,48,25-29,1988,0.06449246197537283
SIM,1841,44,50-100,1885,4
STAT,1906,23,na,1929,3967.773287296078
STAT,1955,44,45-49,1999,0.26409466969798834
STAT,1887,41,25-29,1928,0.8342743601787782
STAT,1902,47,35-39,1949,0.12817305153790495
SIM,1874,93,na,1967,59
STAT,1944,31,50-100,1975,1.047316649225458
STAT,1899,29,50-100,1928,1.0041700664675468
SIM,1849,43,20-24,1892,2
STAT,1944,40,na,1984,4806.928163548928
SIM,1970,37,35-39,2007,2
SIM,1838,37,40-44,1875,2
SIM,1868,19,30-34,1887,2
STAT,1832,41,35-39,1873,1.5589282714853827
STAT,1934,33,na,1967,5958.505173793298
STAT,1932,40,35-39,1972,0.3159102181995324
STAT,1843,44,15-19,1887,0.01390593190027367
SIM,1927,26,na,1953,5099
STAT,1887,91,na,1978,326.39127839324067
SIM,1910,38,45-49,1948,1
SIM,1962,28,na,1990,5523
SIM,1972,8,na,1980,5837
STAT,1912,32,30-34,1944,17.908263919030595
STAT,1839,46,15-19,1885,3.273732561453459E-4
STAT,1880,59,na,1939,2377.3254899271697
STAT,1873,54,45-49,1927,0.016632418809725096
STAT,1950,43,15-19,1993,0.002174285222406646
SIM,1960,40,na,2000,6188
STAT,1921,15,na,1936,4862.592979497933
SIM,1927,35,45-49,1962,2
STAT,1802,53,25-29,1855,0.01383263909413161
SIM,1960,48,30-34,2008,1
STAT,1901,32,20-24,1933,4.369447800356
STAT,1879,51,35-39,1930,0.010423714887198085
STAT,1952,48,30-34,2000,0.12787947686153128
SIM,1861,30,15-19,1891,1
SIM,1911,67,na,1978,3974
STAT,1899,47,25-29,1946,0.051131376672735186
SIM,1830,41,50-100,1871,2
STAT,1882,17,40-44,1899,0.20617107096760906
STAT,1966,15,45-49,1981,0.7204328822418761
STAT,1813,53,35-39,1866,0.02679597470717555
STAT,1865,67,na,1932,1650.617691840083
SIM,1799,57,na,1856,951
SIM,1848,64,na,1912,1138
STAT,1979,35,50-100,2014,0.6885112586136509
STAT,1833,49,25-29,1882,0.0424021139111339
STAT,1882,32,35-39,1914,11.415380717966176
STAT,1894,40,20-24,1934,0.2379827019250256
STAT,1978,12,na,1990,6186.7112530391305
STAT,1890,4,na,1894,3709.585928504573
SIM,1896,22,50-100,1918,1
SIM,1948,10,na,1958,4469
STAT,1822,41,50-100,1863,2.217932677423674
STAT,1950,26,30-34,1976,53.72163119977659
STAT,1888,22,50-100,1910,0.5531981100777094
STAT,1902,38,45-49,1940,0.6981410238131764
STAT,1868,6,na,1874,3094.7171036748514
SIM,1970,34,30-34,2004,3
STAT,1908,34,30-34,1942,17.037273123684848
STAT,1808,51,45-49,1859,0.0705770162900159
STAT,1982,20,na,2002,5953.942966239535
SIM,1885,85,na,1970,1194
STAT,1883,9,na,1892,2929.580211823305
STAT,1923,33,45-49,1956,2.0797839158765483
STAT,1977,15,20-24,1992,211.5142971902438
SIM,1871,41,30-34,1912,2
STAT,1856,27,40-44,1883,2.732993840831441
STAT,1878,34,35-39,1912,12.09819014808828
STAT,1846,44,40-44,1890,2.29387443849653
STAT,1913,38,20-24,1951,0.2988888790369707
STAT,1922,88,na,2010,1094.0685659271346
SIM,1916,34,30-34,1950,29
SIM,1912,5,na,1917,4264
SIM,1956,0,na,1956,5533
STAT,1864,23,50-100,1887,0.4238958402398499
SIM,1966,36,30-34,2002,1
SIM,1850,57,na,1907,1241
SIM,1886,34,35-39,1920,2
STAT,1961,26,40-44,1987,6.982797028505514
STAT,1802,52,20-24,1854,0.0029436350572882393
STAT,1915,35,50-100,1950,0.4942133575644619
STAT,1827,40,15-19,1867,0.01910992800385243
STAT,1917,2,na,1919,5062.597106561906
SIM,1923,35,50-100,1958,1
STAT,1959,41,50-100,2000,0.18456866380438805
STAT,1863,41,30-34,1904,1.1653912634893142
STAT,1893,23,20-24,1916,100.21331347016566
SIM,1864,27,40-44,1891,2
STAT,1962,48,50-100,2010,0.34690839662762213
STAT,1842,35,50-100,1877,1.131554259567329
SIM,1887,37,na,1924,3676
STAT,1945,49,20-24,1994,0.014406135016140334
SIM,1814,76,na,1890,415
STAT,1941,40,45-49,1981,0.2062171015293852
STAT,1953,43,40-44,1996,0.3623146437452545
STAT,1871,31,20-24,1902,3.1161356815294448
SIM,1854,44,40-44,1898,7
STAT,1873,34,50-100,1907,1.0705413889883701
STAT,1890,66,na,1956,2341.775849042633
STAT,1856,30,40-44,1886,3.9461127252215493
STAT,1817,45,25-29,1862,0.1692209221902314
STAT,1824,52,40-44,1876,0.013808104239493114
SIM,1842,41,45-49,1883,3
STAT,1962,42,25-29,2004,0.10973426599147663
SIM,1850,35,50-100,1885,1
SIM,1897,44,na,1941,3600
SIM,1915,6,na,1921,5087
STAT,1878,19,40-44,1897,0.21920815025924328
STAT,1893,77,na,1970,1773.6840793309707
STAT,1791,65,na,1856,865.9542094800001
SIM,1951,36,50-100,1987,1
SIM,1864,42,35-39,1906,3
SIM,1904,31,35-39,1935,18
SIM,1859,26,20-24,1885,13
SIM,1941,46,25-29,1987,1
STAT,1818,68,na,1886,727.7074922936989
STAT,1943,36,50-100,1979,0.5298857856746225
SIM,1932,36,30-34,1968,7
STAT,1833,101,na,1934,0.40153281413983216
STAT,1940,58,na,1998,4248.935361422316
STAT,1867,33,20-24,1900,2.9002237061303373
STAT,1983,24,50-100,2007,1.0770257992473926
SIM,1875,33,20-24,1908,9
SIM,1915,19,20-24,1934,33
STAT,1949,28,15-19,1977,0.951147774244351
STAT,1815,50,40-44,1865,0.021496265587447085
STAT,1945,25,45-49,1970,2.1892462599995928
STAT,1832,94,na,1926,13.616321621406286
SIM,1903,16,na,1919,4125
SIM,1861,75,na,1936,489
STAT,1845,29,30-34,1874,20.358705787100543
STAT,1851,46,30-34,1897,0.07697984078883656
SIM,1890,23,45-49,1913,2
SIM,1971,30,50-100,2001,5
STAT,1979,29,35-39,2008,23.935668916006577
STAT,1793,103,na,1896,0.02702340307633103
STAT,1910,35,25-29,1945,1.098193383597149
SIM,1869,15,25-29,1884,14
SIM,1872,38,na,1910,2927
SIM,1898,29,na,1927,3985
STAT,1821,43,25-29,1864,1.2117705211146272
STAT,1899,24,35-39,1923,9.168546732131395
STAT,1895,39,50-100,1934,1.8257432139253695
SIM,1820,41,25-29,1861,2
SIM,1953,25,45-49,1978,8
STAT,1924,36,30-34,1960,2.481784074281796
STAT,1902,44,30-34,1946,0.12842450166076227
SIM,1853,29,30-34,1882,31
STAT,1882,23,45-49,1905,0.7836025001217273
STAT,1842,31,na,1873,2035.7189986873009
STAT,1975,40,45-49,2015,0.26405660768948974
SIM,1943,36,40-44,1979,7
STAT,1889,58,na,1947,2813.269403929814
SIM,1903,16,25-29,1919,16
STAT,1839,23,25-29,1862,57.91301965229348
STAT,1935,36,40-44,1971,2.419234564841047
SIM,1928,22,na,1950,5893
SIM,1919,88,na,2007,1218
STAT,1807,76,na,1883,535.0761194284477
SIM,1947,9,na,1956,6091
SIM,1926,66,na,1992,5148
STAT,1816,87,na,1903,87.00685122639189
STAT,1913,44,40-44,1957,0.2807038864369852
SIM,1800,92,na,1892,17
SIM,1918,29,40-44,1947,8
STAT,1954,54,na,2008,5309.453055421436
SIM,1877,59,na,1936,2423
SIM,1918,15,na,1933,4193
STAT,1803,69,na,1872,723.2291692513159
SIM,1930,21,35-39,1951,19
STAT,1912,33,35-39,1945,10.343399909222981
SIM,1851,35,25-29,1886,6
STAT,1984,26,30-34,2010,64.52934446908127
SIM,1887,66,na,1953,2918
STAT,1891,26,15-19,1917,0.6493449403079917
SIM,1920,33,35-39,1953,4
SIM,1930,15,na,1945,6346
SIM,1838,43,45-49,1881,2
STAT,1857,30,na,1887,2203.3701316701517
SIM,1937,58,na,1995,3939
STAT,1934,24,30-34,1958,44.56663442059189
STAT,1890,37,na,1927,3322.210997426001
SIM,1959,25,20-24,1984,61
STAT,1844,97,na,1941,4.493464972342528
STAT,1843,35,25-29,1878,3.443343916278634
STAT,1909,46,40-44,1955,0.16779595337266306
STAT,1954,41,25-29,1995,0.10602707175193563
STAT,1957,50,na,2007,5761.95666718005
STAT,1939,47,50-100,1986,0.2718792116622607
STAT,1805,95,na,1900,5.4637714164587905
STAT,1951,46,35-39,1997,0.18475240632257522
STAT,1939,10,na,1949,4582.886226939666
SIM,1827,39,30-34,1866,7
SIM,1852,47,35-39,1899,1
SIM,1886,81,na,1967,405
SIM,1942,24,30-34,1966,86
SIM,1920,32,30-34,1952,10
SIM,1922,59,na,1981,4548
SIM,1801,77,na,1878,381
STAT,1844,47,35-39,1891,0.11655324479486619
STAT,1975,18,15-19,1993,69.07258418141147
STAT,1853,30,15-19,1883,0.14907184952122698
SIM,1876,74,na,1950,1406
SIM,1952,46,35-39,1998,1
STAT,1868,53,25-29,1921,0.003864212698327433
STAT,1819,39,30-34,1858,12.655321866958579
STAT,1944,46,35-39,1990,0.16697249819283438
STAT,1975,21,15-19,1996,8.1338491118685
SIM,1825,39,na,1864,1791
STAT,1919,35,45-49,1954,0.8497095386899705
SIM,1970,27,40-44,1997,7
SIM,1949,28,30-34,1977,6
STAT,1963,45,45-49,2008,0.33300805754847135
SIM,1889,21,40-44,1910,6
STAT,1829,74,na,1903,813.0081598629173
STAT,1953,42,50-100,1995,0.17044317681269722
STAT,1960,45,20-24,2005,0.017358961362592004
STAT,1916,27,15-19,1943,0.8424600855756502
SIM,1932,41,na,1973,5456
STAT,1911,47,na,1958,4017.178971891639
STAT,1942,39,na,1981,4665.380376364703
STAT,1861,38,40-44,1899,4.17897677191104
SIM,1843,31,45-49,1874,3
SIM,1903,35,30-34,1938,2
STAT,1920,27,35-39,1947,18.998436907820512
STAT,1964,38,15-19,2002,0.028727641596784488
STAT,1983,13,na,1996,6411.795599052215
STAT,1937,52,na,1989,4210.548121670508
STAT,1830,42,50-100,1872,1.0147682455139098
STAT,1850,21,50-100,1871,0.5075077611496133
STAT,1876,16,50-100,1892,0.058589820363181784
STAT,1962,27,40-44,1989,6.921973134147318
SIM,1963,33,na,1996,6510
SIM,1879,93,na,1972,147
STAT,1860,81,na,1941,502.9697453727942
SIM,1893,29,na,1922,3589
SIM,1907,28,25-29,1935,2
STAT,1844,106,na,1950,0.010155584067029415
STAT,1883,78,na,1961,1106.4149355425047
STAT,1933,40,15-19,1973,0.002442831398771369
SIM,1848,40,50-100,1888,2
STAT,1926,8,na,1934,5642.115413485018
SIM,1990,13,na,2003,6330
STAT,1911,21,25-29,1932,101.48946500455313
STAT,1877,15,15-19,1892,7.157200964809421
STAT,1807,54,50-100,1861,0.05695655195083637
STAT,1862,51,30-34,1913,0.00582511914396759
STAT,1816,48,na,1864,1452.0696345089573
STAT,1984,0,na,1984,6492.260279946967
STAT,1955,31,35-39,1986,14.27891944797063
STAT,1911,36,25-29,1947,1.1037243364419254
STAT,1961,29,45-49,1990,2.584442395338661
STAT,1925,18,25-29,1943,60.23522723628385
SIM,1895,25,50-100,1920,1
SIM,1930,22,40-44,1952,14
SIM,1972,22,45-49,1994,3
STAT,1959,24,30-34,1983,43.50088700433723
SIM,1958,19,40-44,1977,4
STAT,1813,50,50-100,1863,0.049915784759452485
STAT,1921,25,30-34,1946,50.71937300117966
STAT,1835,31,45-49,1866,1.4010492886068993
SIM,1831,36,50-100,1867,1
STAT,1777,100,na,1877,0.1622596457605601
STAT,1896,25,25-29,1921,64.91691774768773
SIM,1965,29,25-29,1994,15
STAT,1904,26,40-44,1930,4.981342185839491
STAT,1923,16,50-100,1939,0.508765251860818
STAT,1850,51,na,1901,2227.175398646624
STAT,1936,37,40-44,1973,1.6970253006346527
STAT,1926,45,30-34,1971,0.12751085818961905
STAT,1929,41,35-39,1970,0.301396378269443
SIM,1851,53,na,1904,2494
STAT,1839,24,40-44,1863,2.0929671080639465
STAT,1889,18,45-49,1907,0.09268232255669859
STAT,1932,44,45-49,1976,0.2595111622299672
STAT,1862,17,na,1879,2560.4406494816917
SIM,1800,61,na,1861,1203
STAT,1943,62,na,2005,4257.231959963083
STAT,1964,22,45-49,1986,1.6408640748007115
SIM,1911,28,45-49,1939,8
STAT,1903,28,45-49,1931,1.8186666412660721
SIM,1905,30,35-39,1935,14
STAT,1867,48,na,1915,2393.717526759526
STAT,1856,37,50-100,1893,1.0809652306050515
STAT,1892,49,25-29,1941,0.04601513383451285
STAT,1907,32,15-19,1939,0.13884422422078324
SIM,1912,26,40-44,1938,7
SIM,1806,49,50-100,1855,1
STAT,1936,19,40-44,1955,1.5380381162072243
SIM,1967,24,30-34,1991,93
SIM,1960,32,50-100,1992,3
SIM,1842,37,na,1879,2335
SIM,1970,15,na,1985,5338
SIM,1797,76,na,1873,306
SIM,1869,31,50-100,1900,1
STAT,1881,107,na,1988,0.31772840622092946
STAT,1943,32,25-29,1975,11.530661437615878
STAT,1855,35,na,1890,2023.7292596016848
SIM,1982,27,20-24,2009,73
STAT,1898,20,30-34,1918,27.947227628508685
SIM,1922,28,20-24,1950,1
STAT,1835,48,40-44,1883,0.11118033171149255
STAT,1914,28,20-24,1942,21.1719045952962
STAT,1922,22,40-44,1944,4.447899292725416
STAT,1942,17,15-19,1959,54.74261878505776
STAT,1957,29,25-29,1986,100.48321597365266
SIM,1909,23,30-34,1932,35
STAT,1940,5,na,1945,4693.538863457344
SIM,1888,24,30-34,1912,2
STAT,1835,94,na,1929,12.456401287471067
SIM,1893,39,40-44,1932,12
SIM,1960,35,30-34,1995,7
STAT,1937,35,35-39,1972,2.7975700549565423
STAT,1930,26,na,1956,5500.373973243588
STAT,1974,27,20-24,2001,27.626234657122374
STAT,1906,24,50-100,1930,0.6819625541572948
SIM,1958,44,na,2002,6095
SIM,1921,31,30-34,1952,18
STAT,1874,81,na,1955,638.8847305791467
SIM,1925,21,20-24,1946,142
SIM,1852,27,50-100,1879,3
STAT,1930,19,45-49,1949,0.7414159029012445
SIM,1916,11,na,1927,4861
SIM,1843,48,40-44,1891,1
STAT,1816,56,na,1872,1258.4290681446084
STAT,1810,47,25-29,1857,0.22414889497184354
STAT,1935,39,45-49,1974,1.0983581058757539
STAT,1837,23,50-100,1860,0.383785371855486
SIM,1888,27,35-39,1915,34
STAT,1799,106,na,1905,0.005453862058274585
STAT,1908,33,15-19,1941,0.13957059569335895
STAT,1947,37,15-19,1984,0.02571860269658309
SIM,1945,35,35-39,1980,3
STAT,1920,45,35-39,1965,0.1651784845838593
STAT,1948,38,15-19,1986,0.026102017222581403
STAT,1885,39,40-44,1924,4.988268893137733
SIM,1924,54,na,1978,4691
STAT,1927,46,30-34,1973,0.1294309821523489
SIM,1943,39,45-49,1982,3
STAT,1917,21,20-24,1938,136.79971591591803
STAT,1805,64,na,1869,1047.1317988104095
STAT,1943,44,20-24,1987,0.02238785359346863
SIM,1847,24,40-44,1871,7
STAT,1864,51,na,1915,2229.3292132495894
STAT,1954,33,40-44,1987,5.687369817315821
SIM,1962,33,40-44,1995,13
STAT,1807,51,na,1858,1639.3809214246407
SIM,1906,27,25-29,1933,7
SIM,1929,30,50-100,1959,1
STAT,1847,18,40-44,1865,0.1746172438556945
STAT,1890,12,na,1902,3641.648284019019
SIM,1923,90,na,2013,1185
STAT,1889,15,40-44,1904,0.2614011612456337
STAT,1869,21,15-19,1890,3.6981480969208325
STAT,1847,48,na,1895,1709.397817915534
SIM,1905,59,na,1964,3572
STAT,1995,16,na,2011,6150.56101101893
SIM,1985,28,50-100,2013,4
STAT,1963,25,35-39,1988,22.126685003319484
STAT,1859,24,50-100,1883,0.3833891552592036
STAT,1891,73,na,1964,2005.547200842019
STAT,1949,35,25-29,1984,1.3638412653793082
STAT,1967,42,50-100,2009,0.17599972646739417
SIM,1867,49,40-44,1916,1
STAT,1989,25,40-44,2014,7.7446886871796226
STAT,1824,43,na,1867,1679.2845243281106
SIM,1811,45,na,1856,1713
STAT,1875,35,na,1910,2836.411899139008
STAT,1902,30,na,1932,3922.4635519163708
STAT,1928,43,40-44,1971,0.3673944187559359
SIM,1971,25,35-39,1996,29
SIM,1901,97,na,1998,54
SIM,1946,41,na,1987,4627
SIM,1982,18,na,2000,6031
STAT,1913,31,30-34,1944,18.17344243340401
SIM,1882,37,na,1919,3241
SIM,1878,35,25-29,1913,1
STAT,1952,35,30-34,1987,2.601299102967676
STAT,1831,33,na,1864,2179.490775753936
STAT,1953,36,30-34,1989,2.623758496691363
STAT,1897,1,na,1898,4200.204220878837
STAT,1933,22,15-19,1955,8.152265304475211
STAT,1904,57,na,1961,3472.252405266914
STAT,1941,67,na,2008,3817.614862822305
STAT,1967,18,30-34,1985,17.565360206607256
SIM,1939,18,20-24,1957,171
SIM,1877,98,na,1975,117
SIM,1970,23,na,1993,5583
SIM,1803,58,na,1861,1425
STAT,1881,115,na,1996,1.6868341959616113E-4
SIM,1931,20,35-39,1951,1
SIM,1916,19,35-39,1935,6
SIM,1942,23,15-19,1965,6
STAT,1908,19,35-39,1927,0.9354936062595898
STAT,1934,23,15-19,1957,8.25710404451156
SIM,1817,41,45-49,1858,3
SIM,1902,37,35-39,1939,9
SIM,1965,49,50-100,2014,3
STAT,1909,49,45-49,1958,0.22938143768525981
STAT,1938,32,45-49,1970,1.8268691856964614
SIM,1975,18,30-34,1993,46
STAT,1920,41,15-19,1961,0.001959322402154528
SIM,1957,35,25-29,1992,1
STAT,1778,77,na,1855,430.22660999999994
STAT,1859,49,40-44,1908,0.15409888854141351
SIM,1946,32,45-49,1978,7
STAT,1852,43,50-100,1895,0.9888418809181735
STAT,1923,20,35-39,1943,12.714277764649234
STAT,1836,56,na,1892,1856.2052287957754
SIM,1961,36,30-34,1997,5
SIM,1974,17,30-34,1991,23
STAT,1933,25,20-24,1958,28.00794887101897
STAT,1927,43,25-29,1970,0.103167894198469
SIM,1862,37,na,1899,2880
STAT,1907,22,na,1929,4015.7926698614856
SIM,1912,29,45-49,1941,4
STAT,1818,82,na,1900,206.44461336915217
STAT,1779,100,na,1879,0.18915672754445623
SIM,1903,92,na,1995,252
STAT,1937,6,na,1943,4502.283142990124
STAT,1941,16,15-19,1957,53.97516256729064
SIM,1895,49,50-100,1944,1
STAT,1823,38,na,1861,1621.665508779658
STAT,1862,54,35-39,1916,0.008154069653032857
STAT,1971,34,40-44,2005,5.822988320868346
STAT,1957,26,20-24,1983,27.907173182886233
STAT,1838,33,50-100,1871,0.9762024214784537
SIM,1839,30,40-44,1869,3
SIM,1849,63,na,1912,2071
STAT,1902,25,50-100,1927,1.0501770638492207
SIM,1944,34,35-39,1978,20
SIM,1920,16,na,1936,4599
SIM,1858,27,20-24,1885,21
SIM,1959,17,35-39,1976,5
STAT,1904,29,45-49,1933,1.8268647099455382
STAT,1849,74,na,1923,860.1618542592483
STAT,1914,15,45-49,1929,0.11986336879584579
STAT,1826,54,25-29,1880,0.0023666989098161204
SIM,1907,25,20-24,1932,40
STAT,1903,42,25-29,1945,0.07321022182637354
STAT,1885,22,45-49,1907,0.8026933200509313
SIM,1923,9,na,1932,5693
STAT,1963,42,40-44,2005,0.38111124717194056
SIM,1918,44,35-39,1962,1
SIM,1877,21,15-19,1898,6
STAT,1879,29,40-44,1908,3.583911776092521
SIM,1790,66,na,1856,614
SIM,1965,26,20-24,1991,17
STAT,1882,17,na,1899,2846.9011154250043
STAT,1943,44,na,1987,4708.104052044038
STAT,1943,70,na,2013,3665.801516973418
STAT,1983,16,20-24,1999,221.39530625915555
SIM,1893,22,45-49,1915,3
SIM,1864,101,na,1965,3
SIM,1911,42,25-29,1953,1
STAT,1910,38,30-34,1948,2.0037137322692207
STAT,1893,32,45-49,1925,2.5437457605457374
STAT,1835,51,50-100,1886,0.009797075731331296
SIM,1926,41,na,1967,5830
STAT,1945,42,30-34,1987,0.1674932718829985
STAT,1982,20,25-29,2002,150.6004172036407
SIM,1854,34,25-29,1888,25
STAT,1921,28,35-39,1949,19.235195784435867
STAT,1876,17,20-24,1893,21.149763075517225
SIM,1948,27,30-34,1975,5
STAT,1910,23,30-34,1933,31.08447208238812
STAT,1922,25,45-49,1947,2.2703600783394156
STAT,1860,53,20-24,1913,6.753251974683451E-4
STAT,1936,34,35-39,1970,10.236451404075856
STAT,1822,100,na,1922,0.8722759016123741
STAT,1911,33,20-24,1944,2.731817373621987
STAT,1953,33,25-29,1986,13.144408300762931
SIM,1793,66,na,1859,1122
SIM,1961,33,25-29,1994,16
STAT,1925,15,20-24,1940,189.82061660098472
SIM,1921,47,45-49,1968,1
SIM,1892,67,na,1959,2893
STAT,1913,47,45-49,1960,0.24493991904731396
SIM,1930,25,45-49,1955,6
STAT,1795,69,na,1864,602.0766914388322
STAT,1958,40,15-19,1998,0.0024257336482201765
STAT,1858,21,40-44,1879,2.1680393929143813
STAT,1815,94,na,1909,11.08990754265811
STAT,1790,77,na,1867,350.44696741876896
STAT,1895,43,na,1938,3458.749256230608
STAT,1875,47,30-34,1922,0.11490503424559681
SIM,1941,25,20-24,1966,22
STAT,1921,40,25-29,1961,0.09304310957566811
STAT,1950,26,na,1976,5136.193160156405
STAT,1852,44,25-29,1896,0.5972620509534227
SIM,1911,25,40-44,1936,11
SIM,1984,18,50-100,2002,1
SIM,1901,39,40-44,1940,6
STAT,1943,47,25-29,1990,0.06752905321469814
STAT,1899,21,30-34,1920,28.24749919200826
STAT,1933,43,20-24,1976,0.027970533602201687
STAT,1846,34,25-29,1880,12.255923787122676
SIM,1895,32,na,1927,3530
SIM,1868,2,na,1870,3707
STAT,1842,17,na,1859,2268.2907265498566
STAT,1909,98,na,2007,80.74130607074129
SIM,1908,16,na,1924,4262
STAT,1902,22,na,1924,3856.514509802561
SIM,1903,24,na,1927,4064
STAT,1818,54,50-100,1872,0.01723931286649411
STAT,1928,25,50-100,1953,1.4247363205722585
SIM,1918,54,na,1972,3697
STAT,1903,25,40-44,1928,4.957445953868501
STAT,1951,21,20-24,1972,153.36350297305208
SIM,1951,32,25-29,1983,3
SIM,1964,44,na,2008,5787
STAT,1917,52,na,1969,4354.021331264067
STAT,1930,16,40-44,1946,2.0922841297309716
STAT,1918,43,50-100,1961,0.1438897249497668
STAT,1938,22,50-100,1960,0.7519061666225022
STAT,1908,27,na,1935,4090.7184945362037
STAT,1924,47,20-24,1971,0.01517909033148675
SIM,1904,2,na,1906,4489
SIM,1925,24,25-29,1949,147
STAT,1935,40,50-100,1975,0.19186861611650452
STAT,1919,19,na,1938,4667.854599100035
SIM,1939,39,25-29,1978,2
SIM,1943,37,25-29,1980,3
STAT,1857,20,40-44,1877,2.1935996719196904
SIM,1841,20,25-29,1861,54
SIM,1950,15,na,1965,4516
STAT,1901,77,na,1978,2104.7313680703965
STAT,1937,32,30-34,1969,17.998321893624443
SIM,1964,28,25-29,1992,184
SIM,1836,45,na,1881,1591
STAT,1900,33,45-49,1933,2.7806952796851863
STAT,1956,28,25-29,1984,100.89843243693554
STAT,1915,44,15-19,1959,0.001778637664282394
STAT,1874,22,35-39,1896,6.894311804351224
SIM,1838,33,30-34,1871,31
SIM,1945,32,30-34,1977,26
STAT,1909,47,25-29,1956,0.056314705156910186
SIM,1896,31,25-29,1927,2
SIM,1881,75,na,1956,750
SIM,1827,40,na,1867,1537
SIM,1866,21,40-44,1887,5
SIM,1848,22,35-39,1870,15
STAT,1896,22,20-24,1918,105.04235661838047
STAT,1952,32,50-100,1984,1.165526188612711
SIM,1901,20,20-24,1921,221
STAT,1831,25,na,1856,2282.8428377983546
SIM,1917,29,25-29,1946,239
SIM,1897,18,45-49,1915,2
SIM,1884,40,na,1924,2620
STAT,1872,24,25-29,1896,65.92106404371448
SIM,1875,55,na,1930,2647
STAT,1866,86,na,1952,237.33249344057978
SIM,1839,17,na,1856,2587
STAT,1917,24,25-29,1941,112.58821298264823
STAT,1954,19,50-100,1973,0.5341506957367674
SIM,1954,39,20-24,1993,2
SIM,1903,32,25-29,1935,2
STAT,1917,42,25-29,1959,0.08600384579494186
STAT,1946,39,20-24,1985,0.34688210718165674
STAT,1924,65,na,1989,4398.674704561256
SIM,1820,61,na,1881,1469
SIM,1886,42,20-24,1928,1
STAT,1881,12,na,1893,2874.6660623224884
STAT,1909,29,25-29,1938,72.15594188377102
SIM,1882,14,na,1896,3546
SIM,1964,7,na,1971,5976
STAT,1941,34,15-19,1975,0.1555415825054953
SIM,1938,46,na,1984,4039
STAT,1854,15,50-100,1869,0.04831356908703627
STAT,1938,19,15-19,1957,51.65507804733143
STAT,1878,42,20-24,1920,0.19112704689758322
STAT,1901,44,15-19,1945,0.0015292547923223365
SIM,1949,38,na,1987,5833
SIM,1971,22,30-34,1993,1
STAT,1907,35,20-24,1942,0.2851936969151066
STAT,1855,53,40-44,1908,0.008814100855792973
STAT,1925,19,na,1944,5102.1268683633425
STAT,1905,5,na,1910,4377.311013276255
STAT,1905,104,na,2009,4.67873899789932
STAT,1961,47,35-39,2008,0.19995282242480847
SIM,1916,31,50-100,1947,2
SIM,1844,32,na,1876,2483
SIM,1844,71,na,1915,1258
SIM,1906,24,20-24,1930,1
STAT,1864,20,na,1884,2512.1794952563396
SIM,1946,19,15-19,1965,1
SIM,1888,21,25-29,1909,64
STAT,1889,32,25-29,1921,14.570814154407675
SIM,1838,32,na,1870,1866
SIM,1889,22,25-29,1911,4
STAT,1888,31,25-29,1919,13.951640023458516
STAT,1931,41,50-100,1972,0.18142179535659453
STAT,1878,15,30-34,1893,1.9294649658487861
SIM,1831,53,na,1884,1463
STAT,1856,23,30-34,1879,18.083341665377798
STAT,1958,9,na,1967,5956.299441861317
SIM,1897,32,25-29,1929,19
SIM,1914,84,na,1998,830
STAT,1818,106,na,1924,0.005372226444479226
STAT,1877,78,na,1955,937.9468794168156
SIM,1924,27,15-19,1951,1
STAT,1935,57,na,1992,5725.779531673475
STAT,1923,36,15-19,1959,0.025692210145273665
STAT,1963,22,30-34,1985,42.2785535105085
SIM,1864,23,30-34,1887,25
STAT,1858,44,50-100,1902,0.9382706586194709
STAT,1861,7,na,1868,2729.390824324306
STAT,1862,48,na,1910,2163.6604356582293
SIM,1938,38,25-29,1976,2
STAT,1915,26,15-19,1941,0.833980222580494
STAT,1781,97,na,1878,0.7141188114937388
SIM,1940,16,na,1956,4495
STAT,1867,29,15-19,1896,0.48536526805099445
SIM,1900,26,15-19,1926,1
STAT,1970,31,20-24,2001,3.593864769704375
STAT,1820,100,na,1920,0.6230791429991053
SIM,1911,26,25-29,1937,105
SIM,1950,23,na,1973,4779
STAT,1950,27,15-19,1977,0.9674676109013359
SIM,1950,30,45-49,1980,6
STAT,1971,37,45-49,2008,1.026583608843795
STAT,1779,109,na,1888,0.002819498926344811
STAT,1956,47,20-24,2003,0.01755348638117083
SIM,1850,7,na,1857,2324
SIM,1879,25,na,1904,2835
STAT,1905,21,30-34,1926,29.84207878162723
STAT,1905,40,35-39,1945,0.21215674586097164
SIM,1962,49,na,2011,5376
STAT,1934,64,na,1998,5233.709821547333
STAT,1961,27,25-29,1988,98.56218185502212
STAT,1957,41,15-19,1998,0.00243182591331763
STAT,1935,19,25-29,1954,68.03801033887174
SIM,1925,27,30-34,1952,95
STAT,1848,50,35-39,1898,0.009278815382608056
STAT,1903,72,na,1975,2651.774496872605
STAT,1928,27,40-44,1955,6.6268242702341915
STAT,1811,56,na,1867,1327.617528503214
STAT,1949,18,na,1967,4938.625535032908
STAT,1888,53,na,1941,2874.1126550521703
STAT,1907,34,50-100,1941,0.8856702176427789
STAT,1942,19,35-39,1961,5.058117226078129
SIM,1828,33,na,1861,2423
SIM,1978,36,na,2014,5962
SIM,1928,39,50-100,1967,1
SIM,1955,1,na,1956,6590
SIM,1961,19,45-49,1980,3
STAT,1829,43,na,1872,1885.6489778490632
STAT,1881,43,40-44,1924,2.4856479772670292
STAT,1953,19,45-49,1972,0.696919703531766
STAT,1942,37,35-39,1979,3.0058083169477383
SIM,1856,32,35-39,1888,25
STAT,1925,45,15-19,1970,5.17397270840357E-4
STAT,1880,98,na,1978,39.31626793901201
STAT,1903,26,25-29,1929,69.772734056888
SIM,1879,35,40-44,1914,12
STAT,1915,98,na,2013,88.45807004333555
STAT,1909,104,na,2013,4.956769748502885
STAT,1848,32,35-39,1880,12.548409673080808
STAT,1811,47,40-44,1858,0.5336542739420446
STAT,1857,61,na,1918,1679.5496043023265
STAT,1970,26,na,1996,5437.642051198274
SIM,1896,17,na,1913,3932
STAT,1893,49,40-44,1942,0.13792873367499017
SIM,1965,23,15-19,1988,13
SIM,1934,7,na,1941,6052
SIM,1904,54,na,1958,3795
STAT,1949,38,30-34,1987,2.5176462559895594
STAT,1924,34,na,1958,5084.194334750543
SIM,1935,29,45-49,1964,6
SIM,1957,38,30-34,1995,6
STAT,1927,29,45-49,1956,2.4135252963390794
STAT,1873,24,40-44,1897,2.4403741631330385
SIM,1950,46,na,1996,4676
SIM,1889,5,na,1894,4149
SIM,1894,2,na,1896,4248
STAT,1950,37,20-24,1987,0.3705867951129256
SIM,1951,5,na,1956,6327
SIM,1907,22,15-19,1929,11
STAT,1961,44,na,2005,5735.580424349292
STAT,1961,8,na,1969,5859.799164570038
STAT,1942,30,45-49,1972,1.9369564810588868
SIM,1962,36,45-49,1998,3
STAT,1823,45,45-49,1868,0.23979923057490887
STAT,1857,23,45-49,1880,0.7183633211970802
STAT,1934,36,25-29,1970,1.5702423991928394
STAT,1967,47,30-34,2014,0.1336694244083288
STAT,1869,24,20-24,1893,76.53503498356454
STAT,1954,36,45-49,1990,1.0029151426965606
SIM,1855,44,50-100,1899,2
SIM,1956,37,30-34,1993,4
STAT,1912,36,40-44,1948,1.6958957087150897
SIM,1943,4,na,1947,5571
SIM,1904,16,40-44,1920,1
STAT,1858,106,na,1964,0.05948966438946725
STAT,1946,67,na,2013,4109.803780515212
SIM,1943,19,25-29,1962,128
STAT,1870,42,25-29,1912,0.7296981040836251
SIM,1901,23,25-29,1924,98
SIM,1931,16,50-100,1947,1
STAT,1859,73,na,1932,1091.906615559328
STAT,1868,26,25-29,1894,47.063402797348814
STAT,1922,43,45-49,1965,0.2200109000638074
STAT,1858,24,45-49,1882,0.6460934475482389
STAT,1935,37,25-29,1972,1.5897453563097648
STAT,1823,36,50-100,1859,2.509590190416882
STAT,1900,30,40-44,1930,7.000447413072193
SIM,1920,36,40-44,1956,2
SIM,1880,24,25-29,1904,9
STAT,1962,24,35-39,1986,13.959624039565174
STAT,1847,34,40-44,1881,3.492056964304904
STAT,1959,37,40-44,1996,2.3281695887174103
SIM,1866,24,45-49,1890,1
STAT,1930,31,50-100,1961,1.2322525628725196
STAT,1844,27,50-100,1871,0.6549954222151797
STAT,1956,26,50-100,1982,1.5272306631666286
STAT,1950,25,50-100,1975,1.365256729373578
STAT,1775,100,na,1875,0.28851799136108897
STAT,1895,12,na,1907,3879.4244819981104
SIM,1896,15,25-29,1911,12
STAT,1867,17,na,1884,2781.9966384734903
STAT,1822,33,25-29,1855,34.55400842137855
STAT,1817,49,35-39,1866,0.3883993979446324
SIM,1908,23,15-19,1931,4
STAT,1887,17,na,1904,3266.4245311952172
STAT,1970,35,40-44,2005,2.231865644101815
STAT,1897,25,40-44,1922,4.6539169018327335
STAT,1951,24,25-29,1975,127.2704387056627
STAT,1916,47,35-39,1963,0.15262741935875346
STAT,1948,37,30-34,1985,2.479823056253562
STAT,1925,30,15-19,1955,0.17624840448576098
STAT,1888,15,25-29,1903,7.723056367476934
SIM,1879,43,50-100,1922,4
SIM,1935,46,na,1981,6203
STAT,1951,35,15-19,1986,0.027235270600634902
SIM,1885,15,15-19,1900,11
STAT,1953,49,na,2002,5303.475616891491
SIM,1959,46,35-39,2005,1
STAT,1789,69,na,1858,554.769319587024
SIM,1851,39,35-39,1890,18
STAT,1846,106,na,1952,0.01255186163207547
STAT,1954,17,40-44,1971,1.9954998437471805
STAT,1808,81,na,1889,293.9643030506663
SIM,1857,30,30-34,1887,8
STAT,1936,15,50-100,1951,0.41612005490325044
STAT,1930,75,na,2005,3702.6005255175182
STAT,1932,60,na,1992,5356.973358934889
SIM,1962,17,40-44,1979,7
STAT,1959,27,35-39,1986,22.762072251641843
SIM,1838,36,35-39,1874,3
SIM,1919,39,na,1958,5355
STAT,1960,26,25-29,1986,99.40529438931843
SIM,1912,20,30-34,1932,80
STAT,1951,20,15-19,1971,7.344562071298652
STAT,1955,29,50-100,1984,1.5299635069342779
STAT,1849,30,30-34,1879,15.998995550739783
SIM,1844,40,na,1884,2392
STAT,1843,39,35-39,1882,7.384325750687171
STAT,1800,72,na,1872,753.4017241836325
SIM,1855,34,40-44,1889,1
STAT,1844,43,na,1887,1954.6878945776587
SIM,1967,27,35-39,1994,28
STAT,1898,26,40-44,1924,4.688155574942199
SIM,1830,60,na,1890,1330
SIM,1924,40,45-49,1964,1
SIM,1950,33,15-19,1983,2
STAT,1881,24,50-100,1905,0.4510817324507023
STAT,1813,90,na,1903,36.09891060882447
SIM,1824,32,50-100,1856,1
SIM,1924,29,35-39,1953,43
SIM,1950,37,35-39,1987,5
SIM,1911,22,50-100,1933,4
STAT,1878,45,25-29,1923,0.07009738207540776
STAT,1921,41,30-34,1962,0.1663556317166552
STAT,1875,20,30-34,1895,21.369594164950335
STAT,1904,20,30-34,1924,29.694983824180294
SIM,1834,33,na,1867,1940
SIM,1865,25,na,1890,2906
SIM,1864,26,35-39,1890,4
STAT,1876,42,20-24,1918,0.18922733170240083
SIM,1897,67,na,1964,2541
STAT,1836,25,na,1861,2584.3406321795246
STAT,1916,40,45-49,1956,0.19739279884325928
SIM,1970,24,35-39,1994,22
STAT,1922,39,na,1961,4927.695990903273
STAT,1946,59,na,2005,4599.4241716164615
SIM,1905,28,na,1933,4172
STAT,1931,30,35-39,1961,13.837528508834556
SIM,1903,38,35-39,1941,4
STAT,1939,46,20-24,1985,0.013317027323527993
SIM,1828,44,25-29,1872,3
STAT,1895,35,na,1930,3572.741542676786
SIM,1909,39,45-49,1948,2
STAT,1918,57,na,1975,4312.717586670428
SIM,1839,33,45-49,1872,1
STAT,1916,29,35-39,1945,17.78861269798032
STAT,1942,33,15-19,1975,0.15790315875457717
STAT,1961,44,30-34,2005,0.19743774129567382
STAT,1870,54,20-24,1924,8.164616974051427E-4
STAT,1938,16,45-49,1954,0.5703538214612712
STAT,1920,24,30-34,1944,36.62784827236442
STAT,1960,48,25-29,2008,0.08270212955334473
STAT,1878,18,35-39,1896,0.6594378668358574
SIM,1856,17,40-44,1873,1
STAT,1965,49,20-24,2014,0.016464235377144823
STAT,1881,46,45-49,1927,0.2634443177883312
STAT,1893,19,15-19,1912,8.610414381186148
STAT,1849,43,na,1892,1778.4280410973042
STAT,1833,99,na,1932,1.332664417262183
STAT,1916,43,15-19,1959,0.0018134753893917011
STAT,1899,48,30-34,1947,0.0852468427462689
STAT,1916,26,30-34,1942,46.919615738085994
STAT,1935,49,na,1984,5953.619409631154
STAT,1924,17,25-29,1941,59.53823640503793
SIM,1853,37,50-100,1890,2
SIM,1890,32,na,1922,3431
SIM,1908,39,30-34,1947,1
SIM,1827,30,15-19,1857,3
STAT,1839,19,50-100,1858,0.050228406500247416
SIM,1918,46,na,1964,3767
STAT,1877,29,40-44,1906,3.5703081246456065
SIM,1932,17,25-29,1949,147
SIM,1889,24,45-49,1913,2
STAT,1874,40,35-39,1914,2.1609680634306825
STAT,1927,26,40-44,1953,6.560390260434581
SIM,1901,80,na,1981,1827
STAT,1971,37,na,2008,5665.407277212596
SIM,1938,67,na,2005,3673
STAT,1845,37,50-100,1882,0.869258062320146
SIM,1831,45,na,1876,1645
STAT,1856,26,35-39,1882,8.866835125349546
STAT,1920,72,na,1992,3469.1869314383716
STAT,1948,44,na,1992,5080.359466894622
SIM,1833,43,50-100,1876,2
STAT,2010,2,na,2012,7175.154219832573
SIM,1924,26,30-34,1950,14
STAT,1942,16,30-34,1958,14.706593351148772
SIM,1887,97,na,1984,53
SIM,1888,50,na,1938,2538
STAT,1874,25,40-44,1899,3.5631111149314623
STAT,1874,47,15-19,1921,4.703753118432503E-4
SIM,1841,52,na,1893,1737
STAT,1932,41,40-44,1973,0.3918813586053731
SIM,1900,39,25-29,1939,2
SIM,1882,40,35-39,1922,5
STAT,2002,1,na,2003,6849.687615503731
SIM,1901,41,25-29,1942,1
SIM,1930,72,na,2002,4478
STAT,1777,109,na,1886,0.002418581157275878
STAT,1851,25,na,1876,2037.724659029323
STAT,1981,18,na,1999,5937.795026674079
SIM,1923,29,20-24,1952,30
STAT,1820,51,25-29,1871,0.003548285286549481
SIM,1831,42,40-44,1873,7
STAT,1955,48,20-24,2003,0.017561286907065383
SIM,1909,26,35-39,1935,1
STAT,1872,21,20-24,1893,80.09704208952145
SIM,1910,25,25-29,1935,133
SIM,1864,20,25-29,1884,3
SIM,1875,24,na,1899,3363
STAT,1902,25,25-29,1927,69.4458504642498
STAT,1864,43,na,1907,2364.393415418354
SIM,1880,21,20-24,1901,148
STAT,1953,16,40-44,1969,1.953230628385021
STAT,1892,46,20-24,1938,0.009818711688186474
STAT,1957,36,50-100,1993,0.6587594624157348
STAT,1976,39,25-29,2015,1.5606566567305966
SIM,1878,21,30-34,1899,63
STAT,1915,29,20-24,1944,21.33699821127609
SIM,1940,27,50-100,1967,2
STAT,1977,36,35-39,2013,3.889159110774097
SIM,1981,33,na,2014,6405
STAT,1848,35,40-44,1883,4.89375441242136
STAT,1877,61,na,1938,2243.1940862391316
STAT,1935,75,na,2010,3970.922901057673
STAT,1903,80,na,1983,1821.4144970495095
STAT,1874,50,na,1924,2580.4102723782594
STAT,1930,83,na,2013,2247.622502588708
SIM,1900,8,na,1908,3958
STAT,1882,16,35-39,1898,0.6200322561191424
STAT,1970,34,25-29,2004,13.592653896384709
STAT,1798,107,na,1905,0.0011995490971762578
STAT,1856,20,25-29,1876,59.386775631814295
STAT,1816,49,20-24,1865,0.02374634008277082
STAT,1823,42,40-44,1865,2.363310221128432
SIM,1854,70,na,1924,1667
STAT,1857,21,25-29,1878,59.829064744325294
STAT,1894,16,25-29,1910,8.427461087134215
STAT,1883,46,50-100,1929,0.27809238552614524
SIM,1817,41,na,1858,1566
SIM,1844,63,na,1907,1552
STAT,1848,17,40-44,1865,0.2409126728232248
STAT,1898,23,na,1921,3677.3216384073726
SIM,2009,5,na,2014,7158
STAT,1907,104,na,2011,4.808297941721367
SIM,1858,32,na,1890,2621
SIM,1960,19,30-34,1979,40
STAT,1817,46,30-34,1863,0.28033638564468877
STAT,1965,35,50-100,2000,0.6242861891729311
SIM,1876,23,20-24,1899,164
STAT,1944,47,40-44,1991,0.20367713649615815
STAT,1836,18,30-34,1854,3.258115623862353
SIM,1953,26,50-100,1979,2
STAT,1952,38,35-39,1990,3.44275254327624
SIM,1864,40,na,1904,2745
STAT,1960,49,40-44,2009,0.24504955904973652
STAT,1927,49,35-39,1976,0.18563483214105708
SIM,1875,32,na,1907,3119
SIM,1960,38,35-39,1998,3
STAT,1945,26,50-100,1971,1.2607872164080884
STAT,1847,37,45-49,1884,1.5914864042822006
STAT,1839,73,na,1912,941.94698633719
STAT,1846,31,20-24,1877,3.3367212146677065
STAT,1891,50,na,1941,3115.3206275311713
SIM,1848,25,na,1873,1943
STAT,1863,52,50-100,1915,0.015159205846878108
SIM,1910,95,na,2005,223
STAT,1952,19,30-34,1971,16.845458009081145
STAT,1897,78,na,1975,1848.5012221344505
STAT,1904,65,na,1969,3165.7664203286654
STAT,1889,9,na,1898,3691.0453058192757
SIM,1909,36,40-44,1945,6
STAT,1881,43,na,1924,2554.123569336203
STAT,1874,20,50-100,1894,0.4846574428125261
STAT,1901,15,50-100,1916,0.07956247556618982
SIM,1904,32,40-44,1936,1
STAT,1922,40,40-44,1962,0.3320932703905688
SIM,1970,22,15-19,1992,4
SIM,1825,46,30-34,1871,1
SIM,1902,34,30-34,1936,3
STAT,1916,21,50-100,1937,0.7981870259023037
SIM,1951,17,30-34,1968,27
STAT,1921,46,na,1967,4789.622408185619
SIM,1889,24,na,1913,3713
STAT,1966,18,na,1984,5303.841659910334
STAT,1953,30,20-24,1983,3.474932448377178
STAT,1868,23,20-24,1891,76.1718416742568
STAT,1810,44,20-24,1854,0.7030184577547872
STAT,1936,32,15-19,1968,0.14413173075097563
STAT,1970,38,45-49,2008,1.0135949601448404
SIM,1930,40,40-44,1970,1
STAT,1916,44,30-34,1960,0.15070761478904257
SIM,1859,17,na,1876,2553
STAT,1930,31,35-39,1961,13.619823860957304
STAT,1958,24,15-19,1982,8.089702547529665
STAT,1983,32,45-49,2015,2.618576589843587
STAT,1975,22,20-24,1997,169.849885791047
SIM,1854,31,20-24,1885,2
SIM,1935,49,35-39,1984,2
STAT,1906,21,45-49,1927,1.1770451571454466
SIM,1889,106,na,1995,79
STAT,1879,40,15-19,1919,0.016809020163990482
STAT,1957,23,15-19,1980,8.123663926164694
SIM,1816,45,na,1861,1655
STAT,1933,1,na,1934,6454.316145318259
STAT,1828,81,na,1909,358.90508688549164
STAT,1943,17,30-34,1960,14.917894020383097
SIM,1952,47,40-44,1999,1
STAT,1861,21,45-49,1882,0.6922760552167254
SIM,1914,21,45-49,1935,2
SIM,1844,18,30-34,1862,4
SIM,1930,46,na,1976,5958
STAT,1926,48,35-39,1974,0.1830423514399407
SIM,1807,71,na,1878,569
SIM,1911,36,na,1947,4799
SIM,1883,20,30-34,1903,55
STAT,1949,32,20-24,1981,3.3370335503387687
SIM,1853,20,15-19,1873,1
STAT,1885,27,50-100,1912,0.7363558325409542
STAT,1921,44,35-39,1965,0.26077474143322693
SIM,1935,26,40-44,1961,13
SIM,1961,30,20-24,1991,4
SIM,1854,34,50-100,1888,2
SIM,1950,34,30-34,1984,47
STAT,1876,45,25-29,1921,0.06940064624428012
SIM,1922,28,na,1950,5134
STAT,1937,48,45-49,1985,0.2526516533045621
STAT,1810,71,na,1881,826.5896037994547
SIM,1884,45,25-29,1929,1
STAT,1969,45,40-44,2014,0.23752974601811164
SIM,1851,36,30-34,1887,5
STAT,1917,27,30-34,1944,47.422689998174626
SIM,1895,24,na,1919,3385
STAT,1920,42,30-34,1962,0.16287869486509407
STAT,1962,22,15-19,1984,7.8972880905108225
SIM,1953,34,na,1987,5651
SIM,1966,33,50-100,1999,4
STAT,1953,39,35-39,1992,3.47143437593312
STAT,1904,41,35-39,1945,0.20933263282358444
STAT,1843,36,30-34,1879,6.308007547504432
STAT,1939,19,na,1958,4250.815567367203
SIM,1876,26,25-29,1902,100
STAT,1842,39,20-24,1881,0.6202121468465129
STAT,1800,64,na,1864,1138.975815073792
SIM,1862,14,na,1876,3138
STAT,1844,51,na,1895,1809.575065066868
STAT,1845,36,na,1881,1685.4738399497844
STAT,1904,23,35-39,1927,9.640787212686392
SIM,1851,22,na,1873,2987
STAT,1845,20,15-19,1865,2.799851451773301
STAT,1846,21,15-19,1867,4.238483605378261
STAT,1940,18,20-24,1958,158.8604734482018
STAT,1942,34,30-34,1976,19.346551351776377
STAT,1843,107,na,1950,0.0047318982406004744
STAT,1982,29,na,2011,6103.706866700256
SIM,1929,38,na,1967,5231
STAT,1854,53,25-29,1907,0.00283933473171895
STAT,1941,19,20-24,1960,161.08912574589192
SIM,1839,31,25-29,1870,2
STAT,1942,49,30-34,1991,0.11119196835109035
STAT,1905,24,35-39,1929,9.68611387625793
STAT,1928,46,45-49,1974,0.32081997877530194
STAT,1810,48,40-44,1858,0.6519383881252476
STAT,1927,40,20-24,1967,0.02562595256452306
SIM,1934,29,30-34,1963,65
STAT,1815,63,na,1878,1191.1969522140232
STAT,1926,29,30-34,1955,53.80800044491427
STAT,1927,16,35-39,1943,6.034587355927081
SIM,1838,30,25-29,1868,25
STAT,1883,31,50-100,1914,1.0387535125942855
SIM,1813,71,na,1884,702
STAT,1843,54,30-34,1897,0.005808430239548906
SIM,1919,25,45-49,1944,6
SIM,1913,24,35-39,1937,14
STAT,1984,9,na,1993,6440.9295015900325
SIM,1935,16,35-39,1951,8
SIM,1926,17,50-100,1943,1
STAT,1955,26,na,1981,5766.550118375689
STAT,1862,93,na,1955,28.4635581332756
SIM,1950,27,20-24,1977,50
STAT,1826,29,25-29,1855,73.24469940081191
SIM,1927,19,45-49,1946,2
STAT,1935,40,na,1975,6065.60256770528
SIM,1848,41,40-44,1889,4
SIM,1946,56,na,2002,4366
STAT,1974,31,na,2005,5812.78349811655
SIM,1973,36,45-49,2009,1
SIM,1851,76,na,1927,1479
SIM,1877,81,na,1958,847
STAT,1834,100,na,1934,0.9688578909981174
SIM,1851,28,15-19,1879,1
STAT,1948,15,20-24,1963,179.14559349246892
STAT,1835,29,35-39,1864,7.745702157331457
SIM,1876,35,25-29,1911,7
STAT,1843,28,15-19,1871,0.5562272019078751
STAT,1966,36,na,2002,5592.04629238078
SIM,1815,41,45-49,1856,7
STAT,1979,23,25-29,2002,147.20975225227053
STAT,1965,36,45-49,2001,1.0128226861130156
STAT,1815,40,25-29,1855,1.7337803728837802
STAT,1845,23,20-24,1868,57.23464985782535
STAT,1846,55,na,1901,2137.565269039816
SIM,1973,27,45-49,2000,5
STAT,1792,104,na,1896,0.01872994347190688
STAT,1868,35,25-29,1903,3.2226788526616175
STAT,1831,36,40-44,1867,4.373970328734524
STAT,1877,47,na,1924,2688.218621822759
SIM,1884,20,45-49,1904,2
SIM,1800,84,na,1884,130
STAT,1942,27,20-24,1969,22.11356290562373
SIM,1834,29,25-29,1863,86
SIM,1958,46,20-24,2004,1
STAT,1931,27,45-49,1958,2.5745762891360395
STAT,1966,31,45-49,1997,2.313362577217502
STAT,1984,21,40-44,2005,5.531153156551876
STAT,1850,36,50-100,1886,1.2973106225142956
SIM,1954,51,na,2005,5313
STAT,1916,37,20-24,1953,0.31156787788410567
SIM,1823,40,25-29,1863,1
SIM,1853,48,35-39,1901,1
STAT,1951,27,30-34,1978,54.07892138442664
STAT,1801,71,na,1872,694.8064433743251
STAT,1900,36,15-19,1936,0.019502598835766997
SIM,1956,15,20-24,1971,174
STAT,1820,64,na,1884,1029.9227887717846
SIM,1915,34,50-100,1949,2
SIM,1857,67,na,1924,1655
SIM,1918,28,35-39,1946,5
SIM,1843,29,35-39,1872,12
SIM,1909,19,25-29,1928,12
SIM,1922,18,15-19,1940,1
STAT,1915,26,na,1941,4425.5289780223675
STAT,1834,23,45-49,1857,0.8449726764149694
SIM,1881,33,40-44,1914,1
SIM,1837,37,50-100,1874,4
STAT,1839,30,50-100,1869,0.9129644346705341
STAT,1816,47,50-100,1863,0.5008796993084164
STAT,1937,15,45-49,1952,0.5637441575455704
SIM,1905,50,na,1955,3768
STAT,1966,47,15-19,2013,5.522980682052137E-4
SIM,1860,43,50-100,1903,4
SIM,1886,38,50-100,1924,1
STAT,1914,18,15-19,1932,10.810829842714503
SIM,1872,33,30-34,1905,41
SIM,1879,17,na,1896,3000
SIM,1938,19,20-24,1957,140
STAT,1857,40,30-34,1897,1.0437607972686926
SIM,1882,25,40-44,1907,4
STAT,1833,31,45-49,1864,1.6118226393985986
STAT,1851,22,35-39,1873,5.526144159566311
STAT,1861,19,35-39,1880,0.59796993187424
STAT,1972,19,15-19,1991,67.01376645499212
STAT,1826,38,25-29,1864,2.2570376966162655
STAT,1864,29,na,1893,2441.5966027345507
STAT,1801,53,45-49,1854,0.05658350909544105
STAT,1861,24,15-19,1885,3.2051122193416
STAT,1950,21,40-44,1971,4.60476659774738
SIM,1942,20,45-49,1962,3
STAT,1847,46,45-49,1893,0.182106798261261
SIM,1834,38,25-29,1872,3
STAT,1993,21,50-100,2014,1.0965022403678615
SIM,1855,37,45-49,1892,2
STAT,1961,41,25-29,2002,0.11080825873715408
SIM,1862,39,45-49,1901,6
STAT,1945,23,25-29,1968,116.79255983210865
SIM,1820,84,na,1904,476
SIM,1917,36,35-39,1953,7
SIM,1980,19,15-19,1999,2
STAT,1949,46,15-19,1995,5.155460450945944E-4
STAT,1862,6,na,1868,2782.7693625460815
STAT,1957,40,35-39,1997,0.31929781670058666
STAT,1833,82,na,1915,328.3217850329936
STAT,1905,37,45-49,1942,0.7187005963278713
STAT,1919,19,45-49,1938,0.6335065258887981
STAT,1884,27,20-24,1911,13.376446963030801
SIM,1853,23,20-24,1876,5
SIM,1872,9,na,1881,3358
STAT,1880,43,25-29,1923,0.7798385940543191
STAT,1813,110,na,1923,1.2652755136319916E-4
SIM,1826,75,na,1901,676
STAT,1898,0,na,1898,4579.746270822082
SIM,1841,31,45-49,1872,2
SIM,1942,28,40-44,1970,9
STAT,1934,28,40-44,1962,7.236265862283943
SIM,1844,49,na,1893,2095
STAT,1949,40,na,1989,5194.677099318559
SIM,1900,20,40-44,1920,9
STAT,1862,47,25-29,1909,0.05583697226732744
SIM,1967,37,30-34,2004,1
STAT,1812,53,20-24,1865,0.00160219347167712
STAT,1894,25,25-29,1919,63.181572285983016
SIM,1894,79,na,1973,2254
STAT,1902,17,40-44,1919,0.2982468505830816
STAT,1948,30,50-100,1978,1.1142816681284118
STAT,1813,82,na,1895,213.6351636938846
SIM,1953,23,25-29,1976,150
STAT,1833,37,na,1870,1883.8452112059342
SIM,1972,27,na,1999,5578
STAT,1871,38,35-39,1909,8.080329400650308
STAT,1943,21,50-100,1964,0.8082497177880026
SIM,1932,58,na,1990,5009
SIM,1969,20,50-100,1989,1
STAT,1917,35,15-19,1952,0.02323769915677023
SIM,1915,80,na,1995,2186
STAT,1825,32,35-39,1857,21.210559369464125
STAT,1861,30,50-100,1891,0.8861185517389766
STAT,1934,20,45-49,1954,1.7516059491734746
STAT,1950,47,35-39,1997,0.1829942354812517
SIM,1877,24,20-24,1901,12
SIM,1827,33,20-24,1860,1
STAT,1875,66,na,1941,1954.6759884505275
STAT,1889,43,45-49,1932,2.1136943669663952
STAT,1947,2,na,1949,5238.916026507864
STAT,1876,42,50-100,1918,1.2587730955899727
STAT,1948,48,20-24,1996,0.015138708047454177
SIM,1919,2,na,1921,5835
SIM,1978,18,na,1996,6028
STAT,1892,21,40-44,1913,3.0231924665847805
STAT,1910,19,25-29,1929,9.866543968867264
SIM,1837,22,25-29,1859,88
STAT,1844,74,na,1918,928.2522678023413
STAT,1890,23,30-34,1913,25.039847304313867
SIM,1965,6,na,1971,5621
SIM,1864,37,50-100,1901,1
STAT,1844,34,25-29,1878,10.034309485190095
STAT,1902,53,na,1955,3454.7371116690115
SIM,1861,52,na,1913,1606
STAT,1865,39,20-24,1904,0.7945727578257352
STAT,1849,49,15-19,1898,3.0355389919213663E-4
STAT,1968,42,20-24,2010,0.026454651944025517
STAT,1879,54,40-44,1933,0.012337159323610913
STAT,1924,31,40-44,1955,5.270515833637684
SIM,1856,35,40-44,1891,7
SIM,1949,15,na,1964,5502
STAT,1879,28,na,1907,2865.6827260150685
STAT,1903,22,50-100,1925,0.6703165781140897
STAT,1768,110,na,1878,0.001866204049752929
SIM,1863,37,40-44,1900,1
STAT,1958,37,25-29,1995,1.5375460710349282
STAT,1821,47,35-39,1868,0.25334907244855864
STAT,1854,5,na,1859,2450.610055190421
SIM,1889,44,35-39,1933,3
SIM,1886,15,30-34,1901,5
STAT,1948,13,na,1961,5186.911078270136
STAT,1948,35,45-49,1983,0.9291650973976578
STAT,1824,74,na,1898,686.6830114444645
STAT,1965,22,50-100,1987,0.9511464930291875
STAT,1928,24,35-39,1952,13.482067196685335
SIM,1986,25,50-100,2011,2
STAT,1864,74,na,1938,1143.5722882269447
SIM,1967,26,na,1993,5737
STAT,1872,53,45-49,1925,0.016547002159965542
STAT,1911,16,na,1927,4475.077033842655
SIM,1932,31,40-44,1963,9
SIM,1836,24,30-34,1860,40
STAT,1870,24,25-29,1894,64.7219936289125
STAT,1904,88,na,1992,816.1276076053362
STAT,1834,21,50-100,1855,0.5013090410522303
STAT,1838,46,35-39,1884,0.12639398674531654
SIM,1969,30,25-29,1999,30
SIM,1919,28,50-100,1947,2
STAT,1808,51,50-100,1859,0.07344794564559394
STAT,1880,29,45-49,1909,1.34846147992886
STAT,1908,38,40-44,1946,1.6115184275869956
STAT,1871,16,25-29,1887,6.586936309066519
STAT,1908,30,45-49,1938,1.7301203153354185
SIM,1906,41,40-44,1947,1
SIM,1916,38,40-44,1954,1
SIM,1955,15,na,1970,6131
SIM,1892,44,na,1936,3604
STAT,1840,50,30-34,1890,0.00484376510557866
SIM,1951,25,15-19,1976,1
STAT,1968,29,35-39,1997,21.712770633427663
STAT,1943,25,15-19,1968,0.8685066762627602
SIM,1956,35,45-49,1991,3
STAT,1919,33,25-29,1952,11.456572241798211
STAT,1968,13,na,1981,5661.123086451514
STAT,1933,45,na,1978,5860.360479061646
SIM,1976,28,40-44,2004,13
SIM,1882,68,na,1950,2216
STAT,1885,25,15-19,1910,0.5258043866450529
SIM,1901,26,30-34,1927,85
STAT,1794,84,na,1878,145.320699917843
SIM,1847,8,na,1855,3189
STAT,1818,41,20-24,1859,0.21820516847306823
SIM,1787,77,na,1864,665
SIM,1898,35,45-49,1933,6
STAT,1850,24,40-44,1874,2.5379035226599895
SIM,1776,85,na,1861,89
SIM,1901,66,na,1967,3095
STAT,1903,48,35-39,1951,0.1281807232000588
SIM,1817,39,35-39,1856,3
STAT,1973,14,na,1987,5860.767669773097
STAT,1868,29,30-34,1897,27.721319454452605
SIM,1826,41,20-24,1867,3
STAT,1849,16,15-19,1865,5.695388538485711
STAT,1895,66,na,1961,2635.40607578794
STAT,1964,40,50-100,2004,0.17795146864261527
STAT,1847,17,na,1864,2204.43907157611
STAT,1861,49,30-34,1910,0.09093155163817472
STAT,1774,84,na,1858,4.289811030229201
STAT,1835,34,15-19,1869,0.11087333321427141
SIM,1857,16,15-19,1873,9
SIM,1959,27,40-44,1986,23
SIM,1987,23,25-29,2010,343
SIM,1833,32,35-39,1865,4
SIM,1927,33,25-29,1960,1
SIM,1874,31,40-44,1905,16
STAT,1856,22,50-100,1878,0.4169899499875771
SIM,1911,48,35-39,1959,1
SIM,1976,4,na,1980,6054
STAT,1969,34,20-24,2003,3.5796924010654867
STAT,1903,20,15-19,1923,5.455216366674667
STAT,1978,31,25-29,2009,14.846763221541533
SIM,1862,68,na,1930,1841
SIM,1987,8,na,1995,6561
STAT,1831,56,na,1887,1618.1172770911003
STAT,1831,39,45-49,1870,1.9307851928583748
SIM,1911,23,20-24,1934,6
STAT,1916,45,50-100,1961,0.2690122938318377
STAT,1961,24,20-24,1985,166.226067857788
SIM,1879,38,45-49,1917,2
STAT,1837,18,45-49,1855,0.08917827737806638
SIM,1949,44,30-34,1993,1
SIM,1826,44,25-29,1870,1
STAT,1952,16,25-29,1968,59.948058931938036
STAT,1849,97,na,1946,4.163854263248785
SIM,1820,39,na,1859,1968
SIM,1859,38,50-100,1897,2
SIM,1860,25,20-24,1885,2
STAT,1929,16,35-39,1945,6.195561519407855
SIM,1909,16,20-24,1925,56
STAT,1965,17,15-19,1982,65.38645805842712
STAT,1891,29,20-24,1920,16.61318992311659
STAT,1851,56,na,1907,1617.419227097146
STAT,1860,35,20-24,1895,0.7237824015979115
SIM,1932,76,na,2008,3177
STAT,1968,26,30-34,1994,56.7479508737439
SIM,1872,36,35-39,1908,3
SIM,1937,16,35-39,1953,13
STAT,1894,19,30-34,1913,2.351887114003105
STAT,1842,93,na,1935,22.489677954162012
SIM,1820,39,40-44,1859,6
SIM,1853,26,25-29,1879,75
STAT,1866,55,na,1921,2211.7543576911617
SIM,1901,29,35-39,1930,44
SIM,1935,15,na,1950,6431
STAT,1903,15,35-39,1918,0.9061461981730101
SIM,1934,39,na,1973,5804
STAT,1847,31,na,1878,1978.4141631094599
STAT,1911,25,35-39,1936,17.026060458367574
STAT,1955,47,40-44,2002,0.25123946250997564
STAT,1897,37,45-49,1934,3.0762167551151935
SIM,1811,76,na,1887,682
STAT,1977,28,na,2005,5863.7866023625065
SIM,1960,16,25-29,1976,76
STAT,1818,44,25-29,1862,0.8126290899749208
SIM,1876,29,30-34,1905,4
STAT,1845,26,25-29,1871,34.94661206873497
STAT,1848,18,20-24,1866,23.21378095625183
STAT,1883,22,45-49,1905,0.7873404084686061
STAT,1978,25,30-34,2003,62.032036500625026
STAT,1935,34,20-24,1969,3.891486660144108
SIM,1914,32,35-39,1946,26
STAT,1951,42,25-29,1993,0.10198363145054137
SIM,1918,23,na,1941,3474
STAT,1876,7,na,1883,3213.0729344699807
SIM,1920,39,45-49,1959,1
SIM,1835,38,na,1873,2295
STAT,1803,52,na,1855,1185.0774023393933
SIM,1836,49,45-49,1885,1
STAT,1868,103,na,1971,1.6891120474463843
SIM,1916,42,na,1958,4383
STAT,1926,26,25-29,1952,91.35162569803911
STAT,1986,16,25-29,2002,71.28003999007359
STAT,1825,52,20-24,1877,9.929972901108056E-4
STAT,1921,20,50-100,1941,0.8624815836727633
SIM,1994,16,25-29,2010,103
STAT,1934,0,na,1934,7035.843591675252
STAT,1912,39,45-49,1951,0.7608650877821205
SIM,1893,20,na,1913,3257
SIM,1839,20,35-39,1859,1
SIM,1875,37,30-34,1912,14
STAT,1858,37,20-24,1895,0.6939844601989718
STAT,1838,43,30-34,1881,1.046516946639421
SIM,1900,23,45-49,1923,3
STAT,1805,49,45-49,1854,0.8622978119948242
SIM,1918,25,30-34,1943,10
STAT,1822,42,25-29,1864,1.3121982605903426
STAT,1931,82,na,2013,2488.2183909193654
SIM,1943,10,na,1953,5488
SIM,1846,43,30-34,1889,3
STAT,1986,25,25-29,2011,108.79678130270364
STAT,1947,48,50-100,1995,0.30497929161884685
STAT,1978,20,15-19,1998,8.417362006467004
STAT,1918,35,30-34,1953,2.237538130673591
STAT,1903,23,20-24,1926,112.92676125961486
SIM,1883,28,25-29,1911,44
SIM,1986,25,30-34,2011,133
STAT,1991,2,na,1993,6508.401123280615
STAT,1826,35,20-24,1861,0.6493122773195504
STAT,1819,36,25-29,1855,9.24251785519513
SIM,1813,49,45-49,1862,1
SIM,1917,33,30-34,1950,22
STAT,1814,52,45-49,1866,0.038577458182865114
STAT,1948,18,25-29,1966,57.21324326603671
SIM,1830,42,25-29,1872,1
SIM,1852,34,25-29,1886,12
STAT,1857,92,na,1949,37.43493786040277
STAT,1898,48,15-19,1946,3.474937100906292E-4
STAT,1938,43,35-39,1981,0.2379700046350907
STAT,1878,32,15-19,1910,0.17159491833801915
STAT,1994,18,40-44,2012,2.3285967437891872
STAT,1876,20,45-49,1896,0.8368534194032529
STAT,1887,49,50-100,1936,0.1754344395605296
SIM,1834,26,20-24,1860,20
SIM,1901,12,na,1913,4475
STAT,1979,3,na,1982,6250.625944888883
STAT,1834,45,20-24,1879,0.013093712649327646
STAT,1844,31,20-24,1875,2.731878389204285
SIM,1834,35,20-24,1869,1
SIM,1936,21,30-34,1957,3
STAT,1887,39,40-44,1926,5.604544396441477
STAT,1938,37,50-100,1975,0.4926611400674607
STAT,1970,19,50-100,1989,0.5408767323847793
SIM,1922,42,na,1964,5009
STAT,1952,38,na,1990,5354.9710314457025
STAT,1830,53,40-44,1883,0.008372721540890716
SIM,1827,36,25-29,1863,8
STAT,1863,22,25-29,1885,58.918364916351514
SIM,1904,16,50-100,1920,4
STAT,1969,16,50-100,1985,0.5402655902840668
STAT,1991,17,45-49,2008,0.8261822302382346
STAT,1948,32,40-44,1980,5.268090737214086
SIM,1802,65,na,1867,843
STAT,1867,37,30-34,1904,5.742558388744406
SIM,1983,10,na,1993,7024
STAT,1866,31,40-44,1897,4.657777430410286
STAT,1917,21,na,1938,4492.705212959751
SIM,1823,35,45-49,1858,3
SIM,1871,22,25-29,1893,120
SIM,1969,27,35-39,1996,2
STAT,1959,54,na,2013,5618.009982993394
SIM,1934,26,25-29,1960,10
STAT,1928,21,30-34,1949,41.5370825247938
SIM,1977,16,50-100,1993,1
STAT,1882,114,na,1996,5.076760754438346E-4
STAT,1873,33,40-44,1906,5.089208910296973
SIM,1864,63,na,1927,1919
STAT,1840,42,45-49,1882,1.2524081719242217
SIM,1895,39,40-44,1934,13
SIM,1899,30,35-39,1929,2
STAT,1972,43,25-29,2015,0.10948148456952315
SIM,1859,48,na,1907,2111
SIM,1899,17,na,1916,4439
STAT,1854,39,45-49,1893,1.607741885961669
STAT,1976,27,20-24,2003,28.265571976680967
SIM,1902,28,na,1930,4169
STAT,1841,30,25-29,1871,11.280881650918225
STAT,1842,36,15-19,1878,0.05122045697163697
STAT,1897,28,45-49,1925,1.7073153190873998
STAT,1958,0,na,1958,6003.767976705903
SIM,1948,41,45-49,1989,1
STAT,1899,40,35-39,1939,0.20082037686250348
SIM,1984,27,20-24,2011,33
STAT,1947,21,35-39,1968,12.284796678320994
SIM,1897,32,50-100,1929,3
SIM,1813,57,na,1870,1241
SIM,1955,21,35-39,1976,33
STAT,1890,35,50-100,1925,1.7477069039846966
SIM,1864,94,na,1958,61
STAT,1889,32,50-100,1921,1.3034227668551417
STAT,1839,49,20-24,1888,0.009450888858332973
STAT,1857,17,50-100,1874,0.05175562455309199
STAT,1890,26,35-39,1916,13.652841626837631
STAT,1976,36,20-24,2012,0.4191081830800519
STAT,1852,111,na,1963,3.6938844130756266E-4
STAT,1910,22,15-19,1932,5.775019201941686
SIM,1828,56,na,1884,1765
STAT,1831,27,40-44,1858,3.1227634242148383
STAT,1887,20,20-24,1907,89.65789143525501
SIM,1829,41,50-100,1870,2
STAT,1964,33,35-39,1997,13.531078421778489
SIM,1890,16,35-39,1906,3
STAT,1853,28,40-44,1881,3.1214972918676764
STAT,1978,15,35-39,1993,6.612303421276909
STAT,1939,49,25-29,1988,0.06338946002654434
STAT,1872,50,40-44,1922,0.012374774886931315
STAT,1817,38,15-19,1855,0.19658375328686173
SIM,1884,49,na,1933,2463
STAT,1924,37,15-19,1961,0.026125273330559643
STAT,1847,21,30-34,1868,16.92340949245891
STAT,1870,21,20-24,1891,78.64011788970869
STAT,1814,44,na,1858,1968.602860656573
STAT,1956,42,40-44,1998,0.39694505115561046
STAT,1966,32,na,1998,5556.892287935351
STAT,1934,43,50-100,1977,0.1885198698308181
SIM,1855,21,30-34,1876,25
SIM,1875,86,na,1961,378
STAT,1796,65,na,1861,934.885808243824
SIM,1879,47,45-49,1926,1
STAT,1906,69,na,1975,2997.6235575121013
SIM,1861,28,40-44,1889,4
SIM,1827,71,na,1898,643
SIM,1889,41,30-34,1930,3
STAT,1864,36,35-39,1900,7.323311013256216
SIM,1886,18,35-39,1904,2
STAT,1887,48,40-44,1935,0.21863478868363564
STAT,1935,26,na,1961,5898.97852177335
STAT,1960,18,40-44,1978,2.1017051827886464
STAT,1897,42,25-29,1939,0.06872778683120287
SIM,1895,20,20-24,1915,206
STAT,1816,46,15-19,1862,8.281549609393872E-4
SIM,1858,30,45-49,1888,5
SIM,1956,32,40-44,1988,3
SIM,1947,49,25-29,1996,1
STAT,1893,85,na,1978,964.0355076998733
STAT,1853,19,40-44,1872,0.21648367609319685
STAT,1882,93,na,1975,166.23832322565409
STAT,1841,16,45-49,1857,0.07534865016273071
STAT,1875,12,na,1887,3106.199591046425
STAT,1946,29,15-19,1975,0.9066170377253043
SIM,1908,36,25-29,1944,1
SIM,1873,20,na,1893,3290
STAT,1932,47,15-19,1979,5.768197584731242E-4
STAT,1907,16,15-19,1923,10.101465592641688
STAT,1968,45,25-29,2013,0.0799046560790951
STAT,1920,27,na,1947,4740.448501136306
STAT,1841,25,45-49,1866,1.2438980349623225
STAT,1864,33,30-34,1897,17.915295789165356
SIM,1965,49,na,2014,5452
STAT,1871,35,30-34,1906,6.177141923424781
SIM,1893,17,30-34,1910,4
STAT,1893,27,30-34,1920,36.733303999027946
SIM,1860,87,na,1947,654
STAT,1828,98,na,1926,2.1560548918354256
SIM,1877,49,35-39,1926,1
SIM,1908,28,40-44,1936,5
STAT,1958,29,40-44,1987,7.0884257371249575
SIM,1893,74,na,1967,1692
SIM,1874,34,45-49,1908,1
SIM,1929,31,35-39,1960,3
STAT,1841,22,40-44,1863,2.346994304784665
SIM,1909,31,15-19,1940,1
SIM,1867,32,45-49,1899,2
SIM,1830,28,45-49,1858,2
SIM,1851,45,na,1896,2595
STAT,1966,28,20-24,1994,26.412711030907925
STAT,1897,20,15-19,1917,5.121210374912985
STAT,1938,29,20-24,1967,20.859655986592617
SIM,1875,15,20-24,1890,24
STAT,1818,38,30-34,1856,8.261875936321744
STAT,1878,23,na,1901,2840.972650934962
SIM,1869,1,na,1870,3313
STAT,1866,34,45-49,1900,1.8493301506464126
SIM,1857,4,na,1861,3075
STAT,1839,41,25-29,1880,0.5974297728723307
SIM,1845,90,na,1935,55
SIM,1866,49,25-29,1915,1
SIM,1906,89,na,1995,827
SIM,1863,28,40-44,1891,6
SIM,1891,33,35-39,1924,5
SIM,1988,23,40-44,2011,9
STAT,1825,54,45-49,1879,0.018767990102968386
STAT,1820,95,na,1915,7.8031473180496365
SIM,1975,28,25-29,2003,13
STAT,1829,38,40-44,1867,4.920263581793545
SIM,1840,22,30-34,1862,1
SIM,1966,29,40-44,1995,18
STAT,1863,26,50-100,1889,0.6501884425882196
SIM,1941,28,25-29,1969,70
STAT,1855,28,40-44,1883,2.6377396980607792
SIM,1983,22,45-49,2005,5
STAT,1859,32,45-49,1891,1.6031039584705689
SIM,1859,44,20-24,1903,1
STAT,1933,28,25-29,1961,100.8551520347114
STAT,1785,76,na,1861,245.4911962881091
SIM,1865,32,45-49,1897,1
STAT,1827,110,na,1937,2.2441979517220207E-4
SIM,1844,15,25-29,1859,9
SIM,1879,44,40-44,1923,4
STAT,1800,95,na,1895,7.174096652803059
SIM,1862,82,na,1944,579
STAT,1888,30,na,1918,3263.2301009142057
STAT,1923,17,45-49,1940,0.6766917026583454
SIM,1986,28,35-39,2014,2
STAT,1828,41,15-19,1869,0.013499427920424682
STAT,1856,15,45-49,1871,0.06881378636741452
STAT,1978,28,35-39,2006,23.736692540269935
SIM,1852,28,30-34,1880,3
STAT,1920,41,na,1961,4738.461051977386
STAT,1844,28,30-34,1872,25.59918206998931
STAT,1945,45,35-39,1990,0.16985821780154176
SIM,1946,29,20-24,1975,1
STAT,1971,44,50-100,2015,0.1778596887421717
STAT,1824,37,45-49,1861,3.056178569384975
STAT,1832,22,30-34,1854,27.39398453807935
STAT,1922,28,15-19,1950,0.9182406839577495
STAT,1986,22,20-24,2008,183.45194556361258
SIM,1930,28,15-19,1958,1
STAT,1857,32,45-49,1889,1.5770425712448664
STAT,1887,25,50-100,1912,0.8329417585590815
STAT,1987,28,45-49,2015,2.85716710243038
SIM,1848,7,na,1855,2377
SIM,1821,37,35-39,1858,6
STAT,1946,23,40-44,1969,4.316566542338803
SIM,1866,75,na,1941,906
STAT,1877,92,na,1969,181.1646427893217
STAT,1851,38,15-19,1889,0.04454222080599061
SIM,1837,38,40-44,1875,12
STAT,1964,19,20-24,1983,196.92950957693455
SIM,1906,0,na,1906,4122
SIM,1874,70,na,1944,1266
SIM,1914,88,na,2002,157
STAT,1921,22,25-29,1943,120.35703346343229
STAT,1801,54,25-29,1855,0.013524409586294193
SIM,1905,27,45-49,1932,3
SIM,1899,28,50-100,1927,2
SIM,1920,17,35-39,1937,15
SIM,1950,39,50-100,1989,2
SIM,1954,39,na,1993,5428
STAT,1912,17,35-39,1929,0.9801561275449053
STAT,1813,68,na,1881,827.9211763357692
SIM,1876,82,na,1958,689
SIM,1972,19,20-24,1991,373
STAT,1867,15,20-24,1882,19.760360067760388
STAT,1878,38,50-100,1916,1.4720377662432844
SIM,1976,32,na,2008,5967
SIM,1819,39,50-100,1858,3
SIM,1848,56,na,1904,1464
STAT,1869,49,35-39,1918,0.15319829045608552
SIM,1835,38,40-44,1873,11
STAT,1983,29,20-24,2012,29.899572047277253
STAT,1869,27,50-100,1896,0.7149255297403896
STAT,1906,15,na,1921,4270.0166808310305
SIM,1884,17,20-24,1901,18
STAT,1916,22,na,1938,4416.509352518438
STAT,1906,18,20-24,1924,29.756664086481273
SIM,1880,33,25-29,1913,20
SIM,1921,12,na,1933,5566
SIM,1896,34,30-34,1930,56
STAT,1926,18,40-44,1944,1.9734763013625538
STAT,1826,86,na,1912,122.16625879946622
SIM,1892,39,25-29,1931,9
STAT,1892,24,45-49,1916,1.0023156691487807
SIM,1963,28,45-49,1991,1
STAT,1955,28,45-49,1983,2.6568864656430318
STAT,1967,15,25-29,1982,62.50372777054257
SIM,1858,63,na,1921,2037
SIM,1897,21,35-39,1918,16
STAT,1857,43,35-39,1900,1.6158214948401959
STAT,1888,34,30-34,1922,23.48262409364036
STAT,1909,33,30-34,1942,17.296850196823513
SIM,1967,32,15-19,1999,1
STAT,1872,33,25-29,1905,11.819064672243861
SIM,1914,18,20-24,1932,29
STAT,1838,24,25-29,1862,63.42515417224479
STAT,1883,107,na,1990,0.34183804711820465
SIM,1865,43,35-39,1908,7
STAT,1889,21,35-39,1910,8.326437193629896
STAT,1970,18,35-39,1988,6.059941504606069
STAT,1827,38,40-44,1865,6.229008456047281
STAT,1865,31,25-29,1896,10.70875858929627
STAT,1900,19,30-34,1919,2.5386641217700885
SIM,1829,31,30-34,1860,22
STAT,1959,32,15-19,1991,0.19773606921366105
STAT,1884,39,25-29,1923,3.249879905047156
SIM,1990,18,15-19,2008,66
STAT,1845,45,30-34,1890,0.06587946179353359
STAT,1978,25,50-100,2003,1.5757914218800688
STAT,1880,67,na,1947,1939.1038221715744
STAT,1870,18,30-34,1888,1.8198755470171974
STAT,1878,54,25-29,1932,0.004150601812135137
SIM,1824,40,na,1864,1656
STAT,1912,31,15-19,1943,0.14666309785889298
SIM,1915,38,25-29,1953,3
SIM,1959,27,50-100,1986,5
SIM,1846,24,25-29,1870,54
SIM,1939,33,50-100,1972,2
SIM,1958,27,25-29,1985,130
SIM,1833,21,45-49,1854,1
STAT,1953,14,na,1967,5481.882363160009
SIM,1940,22,35-39,1962,23
SIM,1926,35,30-34,1961,3
STAT,1882,50,35-39,1932,0.00984371496353982
SIM,1809,83,na,1892,162
SIM,1838,22,40-44,1860,3
STAT,1911,19,40-44,1930,0.32155497495215113
STAT,1881,18,40-44,1899,0.20306129886453145
SIM,1835,21,45-49,1856,1
STAT,1898,43,50-100,1941,0.1135950030538372
STAT,1894,22,20-24,1916,102.2343863208232
SIM,1921,66,na,1987,4498
STAT,1963,21,na,1984,5373.590485866628
SIM,1884,42,50-100,1926,2
STAT,1933,14,na,1947,6104.035125191959
SIM,1989,21,35-39,2010,37
STAT,1851,44,45-49,1895,1.1708079731065315
STAT,1907,38,25-29,1945,1.0499715597122379
STAT,1922,22,na,1944,4830.785621018139
STAT,1903,89,na,1992,691.5473916827863
STAT,1863,47,40-44,1910,0.1719542450844134
STAT,1972,29,45-49,2001,2.561226382899477
SIM,1918,3,na,1921,4363
STAT,1799,90,na,1889,42.51899148611913
STAT,1939,27,15-19,1966,0.8193598931138139
STAT,1980,31,50-100,2011,1.3509726936654367
STAT,1847,43,40-44,1890,1.7182127841845125
STAT,1982,18,15-19,2000,73.67542883676087
SIM,1910,28,30-34,1938,1
SIM,1909,25,50-100,1934,2
STAT,1833,68,na,1901,1075.3524215775744
STAT,1906,32,35-39,1938,9.785830309306144
STAT,1932,36,50-100,1968,0.651770336744614
STAT,1949,49,na,1998,5098.772967739908
SIM,1947,27,15-19,1974,5
STAT,1836,54,20-24,1890,6.533390369844791E-4
SIM,1827,34,50-100,1861,2
STAT,1902,28,30-34,1930,40.91777180963422
SIM,1855,43,40-44,1898,7
SIM,1849,25,20-24,1874,20
SIM,1979,32,30-34,2011,8
STAT,1880,81,na,1961,900.6179068286528
SIM,1877,67,na,1944,1963
STAT,1897,34,40-44,1931,6.634838518166656
SIM,1860,16,20-24,1876,31
STAT,1976,20,15-19,1996,8.240098657818487
SIM,1943,23,30-34,1966,56
STAT,1833,42,35-39,1875,1.555043719013426
STAT,1802,76,na,1878,520.2854520337705
STAT,1877,34,20-24,1911,3.217091838614357
STAT,1841,25,50-100,1866,0.7166620441639467
SIM,1869,33,25-29,1902,21
STAT,1950,24,45-49,1974,1.5393739605581174
SIM,1889,33,45-49,1922,5
SIM,1885,34,20-24,1919,4
STAT,1834,98,na,1932,2.9646206098291397
STAT,1884,74,na,1958,1377.1026577383245
SIM,1839,42,45-49,1881,3
STAT,1880,21,15-19,1901,4.047685768616211
STAT,1858,49,25-29,1907,0.05077374946543904
STAT,1957,49,50-100,2006,0.3558672908948035
STAT,1872,37,50-100,1909,1.4227110234848315
STAT,1935,23,30-34,1958,45.17707625858864
STAT,1790,104,na,1894,0.01476264682303417
SIM,1928,33,40-44,1961,10
STAT,1966,17,30-34,1983,17.569250491176618
SIM,1819,76,na,1895,174
SIM,1869,30,20-24,1899,6
SIM,1971,38,35-39,2009,7
STAT,1932,22,35-39,1954,14.261159328125373
STAT,1789,83,na,1872,109.80167769717745
STAT,1852,16,20-24,1868,20.33556970805991
STAT,1972,26,50-100,1998,1.4777573347471722
SIM,1973,17,15-19,1990,115
STAT,1868,32,20-24,1900,2.9970640244226505
STAT,1883,33,35-39,1916,11.386138975094383
SIM,1949,25,25-29,1974,173
STAT,1929,35,40-44,1964,2.221888500519919
SIM,1952,25,30-34,1977,3
SIM,1876,32,20-24,1908,2
SIM,1948,38,20-24,1986,1
SIM,1977,34,20-24,2011,7
STAT,1981,18,45-49,1999,0.8058588413429426
STAT,1875,8,na,1883,3195.2128818094575
SIM,1848,44,45-49,1892,5
STAT,1905,27,50-100,1932,1.068492476111034
STAT,1909,44,20-24,1953,0.018849932387867446
STAT,1963,38,35-39,2001,3.649848118772404
SIM,1937,35,40-44,1972,1
STAT,1872,16,40-44,1888,0.2139055491021069
SIM,1867,24,50-100,1891,1
STAT,1901,17,25-29,1918,9.160168718074962
SIM,1980,21,15-19,2001,13
SIM,1841,42,35-39,1883,2
STAT,1860,67,na,1927,1474.4248219785309
STAT,1944,25,30-34,1969,48.91710882973573
SIM,1815,83,na,1898,382
STAT,1972,16,45-49,1988,0.7383319359782688
SIM,1843,26,30-34,1869,55
SIM,1994,20,na,2014,5784
STAT,1865,17,45-49,1882,0.0700907477143461
STAT,1873,85,na,1958,412.42258031173895
STAT,1923,39,20-24,1962,0.3516128543066276
SIM,1973,33,40-44,2006,14
STAT,1850,49,20-24,1899,0.01209542436328995
STAT,1961,16,35-39,1977,6.258206801639941
SIM,1896,37,35-39,1933,24
STAT,1977,17,40-44,1994,2.181010358510359
SIM,1784,80,na,1864,99
STAT,1832,25,35-39,1857,9.548073322444115
SIM,1846,75,na,1921,271
SIM,1913,15,35-39,1928,2
STAT,1861,54,50-100,1915,0.01409123013085298
STAT,1846,26,40-44,1872,3.7734075350842
STAT,1854,17,35-39,1871,0.5347565461121017
STAT,1905,15,35-39,1920,0.9207794211109114
SIM,1977,26,35-39,2003,32
STAT,1879,32,30-34,1911,21.03928910667649
SIM,1897,36,na,1933,3792
SIM,1862,17,35-39,1879,1
SIM,1887,32,30-34,1919,46
STAT,1882,48,na,1930,2504.188659917806
STAT,1898,23,35-39,1921,9.073359876073278
SIM,1919,22,na,1941,5552
STAT,1838,48,50-100,1886,0.21612182137202912
SIM,1873,31,25-29,1904,13
SIM,1916,16,30-34,1932,6
SIM,1880,30,20-24,1910,3
SIM,1986,0,na,1986,6768
SIM,1905,24,40-44,1929,8
SIM,1969,35,40-44,2004,5
STAT,1887,23,25-29,1910,73.8082924002864
STAT,1977,25,15-19,2002,1.1065095068769715
STAT,1944,42,15-19,1986,0.0019821311643785852
STAT,1835,26,30-34,1861,20.699183206714398
SIM,1891,30,30-34,1921,39
SIM,1831,76,na,1907,682
SIM,1895,23,25-29,1918,1
SIM,1885,37,25-29,1922,7
SIM,1971,16,35-39,1987,9
STAT,1919,16,40-44,1935,0.3586773753262679
SIM,1789,72,na,1861,845
STAT,1925,9,na,1934,5547.886605778232
SIM,1898,32,40-44,1930,2
STAT,1981,15,40-44,1996,2.2583243391058914
STAT,1831,87,na,1918,138.22564252357589
STAT,1812,53,50-100,1865,0.03279155842202141
STAT,1825,51,40-44,1876,0.014451105777583538
STAT,1877,37,25-29,1914,3.45631763548233
STAT,1883,30,30-34,1913,19.87209320413979
STAT,1963,16,35-39,1979,6.15394918342094
SIM,1822,49,50-100,1871,2
STAT,1838,21,20-24,1859,78.01996424208068
STAT,1846,86,na,1932,229.37162683960315
SIM,1832,34,40-44,1866,5
STAT,1814,49,50-100,1863,0.6607726724752763
SIM,1899,38,30-34,1937,3
STAT,1839,27,45-49,1866,1.1092645890337522
SIM,1868,56,na,1924,2674
STAT,1872,30,20-24,1902,3.1574883932680273
STAT,1879,73,na,1952,1431.2643781077522
STAT,1891,21,25-29,1912,81.89696642478978
STAT,1889,80,na,1969,1384.5201650652634
STAT,1946,26,45-49,1972,2.221875711676371
SIM,1881,36,45-49,1917,1
SIM,1840,25,35-39,1865,3
SIM,1865,40,30-34,1905,2
STAT,1834,20,40-44,1854,3.993474584794084
STAT,1945,20,20-24,1965,140.73885075648263
STAT,1861,19,50-100,1880,0.053390162596843496
STAT,1968,39,30-34,2007,2.7007783708178223
STAT,1888,37,35-39,1925,9.594945598729794
STAT,1908,49,30-34,1957,0.09261258480137077
SIM,1963,25,40-44,1988,12
STAT,1960,29,30-34,1989,59.090479827445286
STAT,1970,15,30-34,1985,17.617658333900597
SIM,1833,57,na,1890,1382
STAT,1929,40,na,1969,5566.240485186779
STAT,1862,44,20-24,1906,0.15258536176197343
STAT,1815,110,na,1925,1.5333493025237741E-4
SIM,1914,30,na,1944,4013
STAT,1824,34,40-44,1858,7.275619031375115
STAT,1893,38,20-24,1931,1.1188742829402734
STAT,1955,25,40-44,1980,7.177884298889984
STAT,1984,24,45-49,2008,1.8490650851272319
STAT,1861,16,30-34,1877,1.7680175319629858
STAT,1991,23,40-44,2014,5.577479663613364
STAT,1896,11,na,1907,3942.3568750889353
STAT,1869,46,30-34,1915,0.10849164041596641
STAT,1904,34,na,1938,3954.1336206709257
SIM,1856,82,na,1938,377
SIM,1936,11,na,1947,4118
SIM,1858,3,na,1861,3597
STAT,1873,36,45-49,1909,2.360611181008517
STAT,1969,4,na,1973,5669.388311146433
SIM,1904,23,na,1927,3782
SIM,1854,26,40-44,1880,6
STAT,1896,36,50-100,1932,1.8804385302580264
STAT,1919,33,na,1952,4687.990671672761
STAT,1914,41,na,1955,4255.136024188823
SIM,1880,1,na,1881,4248
STAT,1982,27,50-100,2009,1.6233578372388036
STAT,1963,15,50-100,1978,0.549597045979411
SIM,1895,55,na,1950,3110
STAT,1844,20,na,1864,2265.320251638215
STAT,1959,8,na,1967,5932.805213474096
STAT,1884,36,20-24,1920,0.883168455447342
STAT,1909,36,35-39,1945,2.657796237823424
SIM,1926,38,35-39,1964,8
SIM,1838,25,45-49,1863,4
STAT,1876,23,15-19,1899,3.923504696584693
STAT,1924,34,45-49,1958,2.115348396366557
STAT,1929,38,45-49,1967,1.0090638708841693
STAT,1993,18,25-29,2011,71.93034432493887
SIM,1969,24,30-34,1993,51
STAT,1962,43,na,2005,5698.151900124601
STAT,1845,48,35-39,1893,0.0931543057386534
STAT,1878,52,35-39,1930,0.01031831008631972
STAT,1910,16,20-24,1926,31.11043201077375
STAT,1792,72,na,1864,818.9949444057979
STAT,1816,79,na,1895,345.2530139505924
SIM,1907,85,na,1992,1498
STAT,1851,41,40-44,1892,1.7917347672228532
SIM,1844,94,na,1938,29
SIM,1864,49,na,1913,2554
SIM,1949,22,20-24,1971,180
STAT,1985,27,30-34,2012,64.59183752839591
SIM,1813,88,na,1901,64
SIM,1954,26,45-49,1980,1
STAT,1912,42,50-100,1954,0.13088513082025963
STAT,1834,48,25-29,1882,0.05503683955374773
SIM,1966,15,15-19,1981,55
STAT,1877,22,50-100,1899,0.48952992627857705
STAT,1870,35,15-19,1905,0.06449515907344061
STAT,1884,114,na,1998,5.419053666627422E-4
STAT,1938,21,25-29,1959,105.58742049334633
STAT,1892,27,15-19,1919,0.6562509328596531
STAT,1942,39,50-100,1981,0.5206480992146256
SIM,1892,36,20-24,1928,2
SIM,1846,21,20-24,1867,1
SIM,1828,36,40-44,1864,8
STAT,1859,35,15-19,1894,0.05211342458529214
SIM,1831,23,35-39,1854,7
SIM,1953,20,20-24,1973,263
SIM,1894,70,na,1964,2577
STAT,1987,25,40-44,2012,7.718965469183672
SIM,1853,57,na,1910,1994
STAT,1927,21,15-19,1948,7.589938670395337
SIM,1948,44,50-100,1992,1
SIM,1930,2,na,1932,6468
SIM,1935,21,15-19,1956,1
STAT,1918,38,35-39,1956,2.9385462622754477
SIM,1963,10,na,1973,6579
STAT,1921,77,na,1998,2893.2447883131777
STAT,1850,111,na,1961,2.6569050346128716E-4
STAT,1871,50,25-29,1921,0.004125118258593238
STAT,1899,29,25-29,1928,66.40351106220051
STAT,1836,79,na,1915,636.2331735590791
STAT,1935,26,35-39,1961,23.641512240800683
STAT,1958,15,15-19,1973,68.8256085976007
STAT,1829,37,50-100,1866,1.4089689776754446
SIM,1903,78,na,1981,1607
STAT,1833,28,20-24,1861,10.947572223691255
STAT,1852,19,25-29,1871,6.38585880457893
STAT,1866,37,15-19,1903,0.06006639350108307
SIM,1879,48,na,1927,2577
STAT,1822,40,35-39,1862,3.9067008123611386
SIM,1952,28,35-39,1980,72
SIM,1970,33,50-100,2003,1
SIM,1841,28,20-24,1869,13
SIM,1971,35,30-34,2006,9
STAT,1903,45,30-34,1948,0.09065042125285074
SIM,1946,21,25-29,1967,3
STAT,1867,48,20-24,1915,0.012767397469948668
STAT,1908,16,30-34,1924,2.7387475276199433
STAT,1888,84,na,1972,936.0790224973796
SIM,1821,34,30-34,1855,5
STAT,1786,72,na,1858,902.2427605944847
SIM,1826,38,30-34,1864,11
STAT,1770,107,na,1877,0.0037840963203295917
STAT,1944,28,35-39,1972,18.7182371844049
SIM,1847,41,25-29,1888,4
STAT,1925,37,30-34,1962,2.5236515454481823
STAT,1843,32,50-100,1875,1.1052272363388973
STAT,1843,17,25-29,1860,7.266172954923676
STAT,1914,38,50-100,1952,0.4816070386349976
SIM,1813,100,na,1913,8
STAT,1875,39,15-19,1914,0.06629565308142046
SIM,1942,39,30-34,1981,3
STAT,1854,31,15-19,1885,0.12005068884763342
SIM,1987,20,20-24,2007,170
STAT,1860,38,25-29,1898,2.664683495176411
SIM,1880,56,na,1936,2866
SIM,1958,24,20-24,1982,189
STAT,1828,27,35-39,1855,15.656561026573382
STAT,1950,44,30-34,1994,0.1806924657796892
SIM,1851,17,25-29,1868,16
SIM,1981,24,35-39,2005,38
SIM,1918,77,na,1995,2253
STAT,1913,34,35-39,1947,10.40826115388775
SIM,1921,34,35-39,1955,4
SIM,1928,36,45-49,1964,2
STAT,1919,30,20-24,1949,3.060647765560189
STAT,1995,16,35-39,2011,7.011773372845302
SIM,1922,38,50-100,1960,1
SIM,1830,40,35-39,1870,3
SIM,1836,27,35-39,1863,23
SIM,1943,26,35-39,1969,29
STAT,1934,39,30-34,1973,2.8977917224421126
STAT,1897,47,na,1944,3456.2621454966106
STAT,1858,46,20-24,1904,0.010834105342869655
STAT,1815,41,30-34,1856,2.653985042986771
STAT,1925,16,15-19,1941,63.403126373871125
STAT,1857,44,15-19,1901,0.012244877904102152
SIM,1953,47,35-39,2000,1
STAT,1924,23,45-49,1947,1.5270601842332696
STAT,1856,51,45-49,1907,0.012838579690128473
STAT,1944,21,20-24,1965,138.6043501826136
SIM,1822,86,na,1908,3
STAT,1870,27,40-44,1897,3.408125504882029
SIM,1928,34,35-39,1962,30
STAT,1851,31,na,1882,1990.1369000309714
SIM,1933,16,15-19,1949,66
STAT,1880,46,40-44,1926,0.2100134787882619
SIM,1888,44,na,1932,2631
STAT,1823,83,na,1906,224.80890647955334
SIM,1926,35,na,1961,5847
SIM,1896,15,35-39,1911,1
STAT,1861,29,40-44,1890,2.8534248739795753
SIM,1932,23,45-49,1955,2
SIM,1804,73,na,1877,375
STAT,1845,53,35-39,1898,0.00570811138292824
SIM,1978,26,30-34,2004,141
STAT,1820,45,30-34,1865,0.10709801128017876
STAT,1843,54,50-100,1897,0.014737091561447048
SIM,1883,13,na,1896,2769
STAT,1820,41,50-100,1861,1.346677469724291
SIM,1922,21,na,1943,4604
SIM,1962,45,35-39,2007,1
SIM,1884,30,na,1914,2713
STAT,1877,17,25-29,1894,6.802595397568192
SIM,1895,36,25-29,1931,7
STAT,1871,40,30-34,1911,1.3332833263780466
STAT,1847,53,45-49,1900,0.0109873477545478
SIM,1842,90,na,1932,94
SIM,1829,37,40-44,1866,1
STAT,1918,31,20-24,1949,3.002811442289318
STAT,1909,33,20-24,1942,2.67784415402181
STAT,1959,15,30-34,1974,18.4096869611906
SIM,1949,19,30-34,1968,35
STAT,1896,34,25-29,1930,15.478990054184743
STAT,1876,29,50-100,1905,0.7576851917418309
STAT,1917,42,50-100,1959,0.14149019703131827
SIM,1919,36,35-39,1955,1
SIM,1967,15,30-34,1982,39
SIM,1927,18,40-44,1945,3
STAT,1964,32,na,1996,5603.515188534779
STAT,1871,53,50-100,1924,0.017061454754035272
STAT,1826,32,na,1858,1628.086624539534
SIM,1939,6,na,1945,5096
STAT,1889,89,na,1978,525.6690942309317
STAT,1827,35,15-19,1862,0.08646455037720277
STAT,1847,27,40-44,1874,2.770431867501665
SIM,1880,64,na,1944,2415
STAT,1893,62,na,1955,2666.1452970161763
SIM,1917,33,20-24,1950,4
STAT,1933,21,45-49,1954,1.728363653254374
SIM,1818,81,na,1899,588
STAT,1871,48,40-44,1919,0.19408945988182974
STAT,1919,18,40-44,1937,1.778710156768093
SIM,1873,35,35-39,1908,23
SIM,1855,27,40-44,1882,2
STAT,1865,35,35-39,1900,7.434666082511827
SIM,1837,23,30-34,1860,21
STAT,1978,37,45-49,2015,1.10616124936804
STAT,1847,52,30-34,1899,0.004555832276196439
STAT,1870,39,35-39,1909,7.966044015576015
STAT,1898,22,40-44,1920,3.2500756492146623
STAT,1922,20,30-34,1942,38.2472494240302
STAT,1884,40,40-44,1924,2.5905499780949075
SIM,1842,47,na,1889,2023
SIM,1967,19,50-100,1986,1
STAT,1880,28,na,1908,2909.0177268263524
SIM,1839,43,na,1882,2034
SIM,1956,4,na,1960,5523
STAT,1843,50,20-24,1893,7.510543304323567E-4
SIM,1793,72,na,1865,750
SIM,1983,31,35-39,2014,8
SIM,1952,21,20-24,1973,3
STAT,1831,24,25-29,1855,74.00056682154018
STAT,1910,44,25-29,1954,0.07700690280040827
SIM,1890,41,45-49,1931,7
STAT,1882,41,45-49,1923,1.6946686941289129
SIM,1843,39,40-44,1882,7
STAT,1868,38,40-44,1906,4.829559376085819
STAT,1920,29,45-49,1949,2.170527121489686
STAT,1835,39,40-44,1874,3.3084234722607655
STAT,1970,42,na,2012,5575.758057171688
SIM,1876,38,40-44,1914,5
SIM,1892,40,40-44,1932,6
STAT,1967,40,15-19,2007,0.0023070362593006605
STAT,1975,31,35-39,2006,14.189970987169815
STAT,1874,36,15-19,1910,0.06666296746829443
SIM,1951,34,na,1985,6261
STAT,1856,62,na,1918,1609.224563186938
STAT,1916,49,50-100,1965,0.26618269579005777
SIM,1821,69,na,1890,701
STAT,1903,15,25-29,1918,9.358117141980397
STAT,1838,22,50-100,1860,0.45836906981659653
STAT,1848,31,40-44,1879,5.429697998958293
SIM,1938,52,na,1990,3990
SIM,1841,48,20-24,1889,1
SIM,1822,32,25-29,1854,18
STAT,1838,29,40-44,1867,3.2540784230731528
STAT,1776,88,na,1864,64.40045652368758
STAT,1921,11,na,1932,5218.062920473816
STAT,1987,18,30-34,2005,20.074608304906643
STAT,1814,79,na,1893,435.9050541494966
SIM,1943,18,50-100,1961,1
SIM,1945,26,35-39,1971,24
STAT,1837,42,20-24,1879,0.13570163966082918
STAT,1853,25,15-19,1878,0.5308876765577858
STAT,1809,49,40-44,1858,0.4236018455627442
STAT,1829,26,35-39,1855,24.04309298650303
STAT,1831,70,na,1901,1100.8058279132106
STAT,1824,45,15-19,1869,5.579291002215912E-4
SIM,1877,60,na,1937,2339
SIM,1934,47,40-44,1981,1
STAT,1862,15,na,1877,2590.8712298050013
STAT,1965,32,45-49,1997,2.310953542253175
STAT,1866,29,na,1895,2534.5277631912454
SIM,1892,65,na,1957,2971
SIM,1896,79,na,1975,1840
STAT,1834,27,30-34,1861,30.13405891305416
STAT,1858,53,20-24,1911,6.536718241607562E-4
STAT,1897,46,35-39,1943,0.12220983218973436
STAT,1818,37,15-19,1855,0.09258677879142596
STAT,1835,84,na,1919,207.3336386103173
SIM,1861,25,15-19,1886,1
STAT,1813,42,35-39,1855,6.803496207505357
SIM,1857,22,45-49,1879,3
SIM,1842,27,30-34,1869,8
STAT,1809,53,25-29,1862,0.008386046421465218
STAT,1839,98,na,1937,2.5762548787549644
STAT,1958,20,na,1978,5557.287370570154
SIM,1868,25,25-29,1893,7
STAT,1894,28,40-44,1922,4.428393474846625
STAT,1849,22,45-49,1871,0.6534466290747529
STAT,1855,109,na,1964,0.0035245152121550455
SIM,1856,31,40-44,1887,7
SIM,1907,26,15-19,1933,4
STAT,1869,54,35-39,1923,0.009356969648694296
STAT,1950,40,na,1990,5281.271376982313
STAT,1818,47,40-44,1865,0.21130289337289274
SIM,1867,41,45-49,1908,3
SIM,1906,33,45-49,1939,3
STAT,1844,27,15-19,1871,0.4645562334767435
STAT,1847,10,na,1857,2321.3195433809306
STAT,1926,47,40-44,1973,0.224458641410632
STAT,1823,51,50-100,1874,0.014661947105324702
SIM,1867,82,na,1949,402
SIM,1995,18,30-34,2013,25
STAT,1926,44,50-100,1970,0.16654838798140412
STAT,1994,17,35-39,2011,6.9880259952171055
SIM,1837,26,35-39,1863,16
SIM,1964,31,40-44,1995,13
STAT,1977,19,40-44,1996,2.179549325843317
STAT,1874,30,30-34,1904,20.79354354479983
STAT,1980,35,35-39,2015,3.999161043155242
STAT,1874,21,40-44,1895,2.4693429164869203
STAT,1796,92,na,1888,13.583345035675084
STAT,1862,51,50-100,1913,0.014779434484118953
SIM,1902,39,45-49,1941,1
SIM,1969,38,na,2007,5729
SIM,1783,94,na,1877,2
SIM,1878,44,25-29,1922,1
SIM,1960,37,40-44,1997,2
STAT,1954,31,30-34,1985,22.92497952750264
SIM,1956,23,50-100,1979,1
STAT,1858,1,na,1859,3338.4859281042054
STAT,1913,22,30-34,1935,32.15771488087528
STAT,1956,31,40-44,1987,6.094958649504432
STAT,1770,103,na,1873,0.024536158244267567
SIM,1921,22,30-34,1943,1
STAT,1859,41,45-49,1900,1.382093846565688
SIM,1846,13,na,1859,2052
SIM,1926,31,20-24,1957,4
STAT,1957,44,na,2001,5853.163414023642
STAT,1838,21,30-34,1859,20.166353214273812
STAT,1855,16,35-39,1871,0.5586142744527982
STAT,1841,34,35-39,1875,10.699855438343139
SIM,1976,27,35-39,2003,47
STAT,1834,52,20-24,1886,6.904890180233985E-4
STAT,1863,32,20-24,1895,2.727684045556269
STAT,1881,50,40-44,1931,0.011887034713846747
STAT,1937,26,35-39,1963,16.906339069613363
STAT,1891,49,20-24,1940,0.009453163440881296
STAT,1850,7,na,1857,3113.6270341052054
STAT,1960,48,na,2008,5727.742818017138
SIM,1852,5,na,1857,2556
STAT,1834,47,50-100,1881,0.23769685122438294
SIM,1882,30,30-34,1912,39
STAT,1952,37,40-44,1989,2.1329086941833357
STAT,1873,58,na,1931,2330.57856355739
SIM,1913,60,na,1973,3984
SIM,1917,74,na,1991,3482
STAT,1939,42,45-49,1981,0.19988057467784293
STAT,1965,48,15-19,2013,5.50508434216902E-4
STAT,1794,109,na,1903,1.780679453170121E-4
STAT,1833,48,20-24,1881,0.008947744935865368
STAT,1859,11,na,1870,2559.087355858537
STAT,1924,47,30-34,1971,0.12244465747572729
SIM,1909,23,na,1932,4670
STAT,1784,91,na,1875,19.27505895057037
STAT,1867,46,na,1913,2431.0600897677405
SIM,1920,78,na,1998,2083
SIM,1971,22,na,1993,5782
SIM,1852,37,40-44,1889,2
STAT,1958,42,15-19,2000,0.002419019011779689
STAT,1969,39,45-49,2008,1.0103552982773212
SIM,1829,49,na,1878,1608
STAT,1838,33,na,1871,2308.6265245406025
STAT,1849,18,50-100,1867,0.04646527221408002
STAT,1978,22,na,2000,5770.474239703334
STAT,1873,17,40-44,1890,0.21554939816563312
STAT,1848,43,35-39,1891,1.9101409791107908
STAT,1939,20,25-29,1959,107.17329610597623
STAT,1884,43,20-24,1927,0.17977385620808417
STAT,1902,38,50-100,1940,0.42996905242861905
SIM,1825,35,na,1860,1860
STAT,1850,35,15-19,1885,0.05995580353917846
STAT,1891,25,35-39,1916,13.855810975473624
STAT,1981,26,na,2007,6074.080244027321
STAT,1867,27,50-100,1894,0.6892611463582424
STAT,1840,22,25-29,1862,58.39977798362527
STAT,1844,37,40-44,1881,3.869137986670048
SIM,1942,57,na,1999,4670
STAT,1861,9,na,1870,2686.599262755988
STAT,1826,45,25-29,1871,0.04254044875024191
STAT,1947,20,na,1967,4766.158184904517
STAT,1885,31,45-49,1916,2.015533094303086
STAT,1870,17,15-19,1887,6.816200424134155
STAT,1944,24,25-29,1968,115.02238871887357
SIM,1949,36,na,1985,5847
SIM,1927,52,na,1979,4821
STAT,1836,29,30-34,1865,29.2403626333687
STAT,1876,38,15-19,1914,0.06665892836342568
STAT,1985,18,20-24,2003,222.46088156808446
STAT,1928,41,30-34,1969,0.1883540357774211
STAT,1980,23,40-44,2003,5.402797017553965
SIM,1958,21,15-19,1979,12
STAT,1855,29,na,1884,2086.3613671794274
STAT,1865,33,50-100,1898,0.9500201696859184
STAT,1851,15,na,1866,2239.4225355677586
SIM,1971,17,50-100,1988,1
STAT,2006,8,na,2014,7019.682957488486
SIM,1941,56,na,1997,3711
SIM,1854,43,25-29,1897,2
STAT,1840,39,50-100,1879,1.1409499522906308
SIM,1880,31,35-39,1911,19
STAT,1911,90,na,2001,656.130883760656
SIM,1881,81,na,1962,553
SIM,1889,61,na,1950,3029
SIM,1888,60,na,1948,2202
SIM,1993,18,20-24,2011,236
SIM,1836,78,na,1914,113
SIM,1885,95,na,1980,155
SIM,1893,31,45-49,1924,1
SIM,1913,44,na,1957,4502
SIM,1917,58,na,1975,4914
STAT,1856,46,na,1902,1986.4947468661696
SIM,1952,24,25-29,1976,253
SIM,1838,26,na,1864,2037
SIM,1879,28,40-44,1907,5
STAT,1866,19,15-19,1885,6.439139564614401
STAT,1867,54,25-29,1921,0.0037115272738619674
SIM,1955,46,na,2001,6404
SIM,1928,31,30-34,1959,48
STAT,1921,40,50-100,1961,0.15307092124294364
SIM,1937,76,na,2013,2674
SIM,1943,26,25-29,1969,102
SIM,1918,24,25-29,1942,232
STAT,1919,43,30-34,1962,0.15959599217983864
SIM,1878,41,20-24,1919,3
SIM,1831,29,20-24,1860,2
SIM,1831,47,na,1878,1618
STAT,1844,49,35-39,1893,0.11465422585389229
STAT,1815,44,35-39,1859,3.806339260594552
STAT,1935,26,25-29,1961,103.64566025890714
STAT,1935,46,50-100,1981,0.3696167035886322
SIM,1823,44,35-39,1867,1
SIM,1859,24,20-24,1883,142
SIM,1943,46,50-100,1989,1
STAT,1897,18,40-44,1915,0.2815044160186451
SIM,1844,21,20-24,1865,86
STAT,1878,89,na,1967,332.16748241960636
STAT,1871,52,25-29,1923,0.004045029363985573
STAT,1837,32,na,1869,1967.6454596676385
SIM,1826,47,40-44,1873,1
SIM,1876,28,15-19,1904,3
STAT,1857,49,20-24,1906,0.01056053075564702
STAT,1904,2,na,1906,4417.58281771905
STAT,1996,19,35-39,2015,7.0329514486434395
STAT,1875,17,15-19,1892,7.0775180600194725
STAT,1800,87,na,1887,80.25690624767556
STAT,1918,34,25-29,1952,11.235115058494813
STAT,1978,34,40-44,2012,6.274368673508912
SIM,1860,35,25-29,1895,9
SIM,1953,33,30-34,1986,33
STAT,1884,30,50-100,1914,1.053120035254714
STAT,1846,43,25-29,1889,0.6633339522774038
STAT,1852,35,25-29,1887,2.786547764685658
STAT,1825,45,50-100,1870,0.35260490058737165
STAT,1994,16,20-24,2010,225.8430318872861
SIM,1958,40,na,1998,6141
SIM,1898,39,30-34,1937,2
SIM,1820,38,35-39,1858,16
STAT,1910,41,20-24,1951,0.019392655417301646
SIM,1847,78,na,1925,1042
SIM,1873,30,na,1903,3420
SIM,1906,90,na,1996,638
STAT,1839,45,35-39,1884,0.11605815658459237
STAT,1765,111,na,1876,1.0506307707925064E-4
SIM,1843,64,na,1907,1377
STAT,1950,37,30-34,1987,2.5622027642591783
STAT,1830,53,na,1883,1374.2686466417024
STAT,1958,31,15-19,1989,0.19865816159101565
STAT,1820,48,35-39,1868,0.14099541670138807
SIM,1938,44,45-49,1982,1
STAT,1968,25,25-29,1993,95.36721293755848
SIM,1844,29,30-34,1873,8
SIM,1859,49,50-100,1908,1
STAT,1836,21,20-24,1857,83.397029880147
STAT,1956,45,45-49,2001,0.34684334671228395
STAT,1821,49,na,1870,1548.4408897527014
SIM,1965,27,15-19,1992,2
STAT,1873,43,45-49,1916,1.7510341436488959
STAT,1852,32,45-49,1884,1.702268184832028
STAT,1888,40,25-29,1928,0.8799239755274101
STAT,1897,43,30-34,1940,0.12230663872916268
STAT,1906,40,40-44,1946,0.26550720691291446
SIM,1863,52,na,1915,2136
STAT,1922,23,35-39,1945,12.417369726511243
SIM,1901,43,na,1944,3993
STAT,1817,71,na,1888,992.5629894868696
STAT,1995,18,na,2013,6146.871225502583
STAT,1851,22,50-100,1873,0.386173641255386
SIM,1937,35,na,1972,4362
SIM,1945,63,na,2008,4041
STAT,1898,49,30-34,1947,0.08338548102110784
STAT,1941,43,15-19,1984,0.0018945454985527736
STAT,1862,31,na,1893,2333.6034416622683
STAT,1831,103,na,1934,0.11259716026989938
STAT,1939,33,na,1972,4452.422558480958
SIM,1832,40,45-49,1872,1
STAT,1983,19,25-29,2002,70.69934725688319
STAT,1961,16,25-29,1977,64.63088678909104
SIM,1964,34,45-49,1998,1
STAT,1848,34,45-49,1882,1.9258809925621543
STAT,1893,44,25-29,1937,0.06417017226266188
STAT,1876,23,na,1899,2812.7346856564436
SIM,1930,56,na,1986,5684
SIM,2008,6,na,2014,7729
SIM,1887,38,40-44,1925,11
STAT,1957,27,15-19,1984,1.078797272101071
STAT,1809,50,20-24,1859,0.0018590433822339974
STAT,1888,104,na,1992,3.2526536845686893
STAT,1832,50,45-49,1882,0.010903307972817767
STAT,1884,58,na,1942,2254.898150442971
STAT,1858,50,40-44,1908,0.009614096781913566
SIM,1900,36,30-34,1936,2
STAT,1931,29,20-24,1960,27.176022156800094
STAT,1908,40,50-100,1948,0.12701833609846783
SIM,1856,40,30-34,1896,2
STAT,1988,22,50-100,2010,1.0896383651030122
STAT,1879,38,40-44,1917,5.248809667794424
STAT,1849,27,15-19,1876,0.41684858017864157
STAT,1945,33,30-34,1978,20.23311699979474
SIM,1860,32,45-49,1892,2
STAT,1897,92,na,1989,357.03841118575036
SIM,1849,17,15-19,1866,15
SIM,1871,32,20-24,1903,1
SIM,1924,60,na,1984,4504
SIM,1945,23,30-34,1968,79
SIM,1872,23,25-29,1895,86
STAT,1824,40,45-49,1864,2.2027937745876107
STAT,1848,11,na,1859,3158.715192073
STAT,1937,23,30-34,1960,32.30668840563186
STAT,1869,51,30-34,1920,0.006684449035808745
SIM,1782,72,na,1854,383
SIM,1825,51,na,1876,1621
SIM,1829,65,na,1894,1019
SIM,1833,86,na,1919,50
SIM,1926,34,25-29,1960,19
SIM,1950,17,na,1967,4811
STAT,1887,36,25-29,1923,3.7416544948699872
STAT,1925,41,na,1966,5194.890310863735
STAT,1864,97,na,1961,12.843719941762169
STAT,1989,22,na,2011,6056.327261211153
STAT,1874,24,45-49,1898,0.8186912097238718
STAT,1902,88,na,1990,793.230777177618
SIM,1976,26,20-24,2002,27
STAT,1905,53,na,1958,3603.1423574531673
STAT,1909,67,na,1976,3277.1290931037947
STAT,1967,36,30-34,2003,2.70929459524003
STAT,1848,40,30-34,1888,1.2517162696396569
SIM,1946,38,20-24,1984,1
STAT,1826,42,45-49,1868,1.122175377203178
STAT,1847,24,50-100,1871,0.37915503917402094
STAT,1860,17,30-34,1877,1.7097651057259928
SIM,1975,36,30-34,2011,8
STAT,1862,19,30-34,1881,1.598863369090221
SIM,1810,85,na,1895,27
SIM,1962,18,na,1980,5569
SIM,1956,24,45-49,1980,6
STAT,1795,103,na,1898,0.02514793064248646
STAT,1888,15,35-39,1903,0.7478233131183151
STAT,1998,16,40-44,2014,2.3707369050447693
STAT,1825,33,15-19,1858,0.27779339695923144
SIM,1991,19,25-29,2010,97
SIM,1970,31,25-29,2001,8
STAT,1896,31,20-24,1927,4.137072758738223
SIM,1831,26,40-44,1857,3
STAT,1833,43,15-19,1876,0.011707383980620717
STAT,1874,33,35-39,1907,11.914103569947306
SIM,1881,43,45-49,1924,1
STAT,1950,24,na,1974,4996.106988825351
STAT,1954,38,na,1992,5524.16639968193
STAT,1956,34,45-49,1990,2.4462427231246977
STAT,1879,17,35-39,1896,0.6612048771965998
STAT,1900,34,15-19,1934,0.2260929019148503
STAT,1898,41,50-100,1939,0.11493928930461403
STAT,1924,20,40-44,1944,4.604776166084936
SIM,1871,23,30-34,1894,20
SIM,1940,30,40-44,1970,11
STAT,1872,31,35-39,1903,11.783224160701097
STAT,1958,47,20-24,2005,0.017423149974693186
SIM,1882,33,35-39,1915,1
STAT,1862,18,50-100,1880,0.054325892392850614
STAT,1872,39,45-49,1911,2.286807099314168
STAT,1948,24,45-49,1972,1.4898801503292094
STAT,1971,23,30-34,1994,42.13499491639491
SIM,1855,24,50-100,1879,2
STAT,1881,53,45-49,1934,0.015894817552869738
STAT,1881,109,na,1990,0.06604884958912889
STAT,1880,49,45-49,1929,0.282657410863319
SIM,1999,9,na,2008,6973
STAT,1895,26,50-100,1921,0.964238468146606
STAT,1852,96,na,1948,8.09561605814361
STAT,1841,31,30-34,1872,19.030940979890502
STAT,1960,26,50-100,1986,1.5032310713306434
SIM,1880,39,45-49,1919,8
SIM,1813,50,na,1863,1281
STAT,1906,38,na,1944,3976.2702697338505
STAT,1863,23,30-34,1886,18.201140122039384
STAT,1932,30,40-44,1962,6.011849080490368
SIM,1959,14,na,1973,6023
SIM,1923,84,na,2007,2489
STAT,1905,39,20-24,1944,0.2751127929058578
STAT,1941,38,50-100,1979,0.5137806451903478
SIM,1792,71,na,1863,633
SIM,1796,85,na,1881,174
SIM,1885,31,na,1916,3255
SIM,1918,21,20-24,1939,1
STAT,1855,37,40-44,1892,3.7247976302460817
STAT,1886,40,15-19,1926,0.016980487168905663
STAT,1980,26,45-49,2006,2.7809934934807
STAT,1895,41,30-34,1936,0.12047062372436641
STAT,1925,82,na,2007,2253.7482860491104
SIM,1863,47,50-100,1910,1
SIM,1939,25,20-24,1964,25
STAT,1762,108,na,1870,0.006568593237913679
SIM,1852,52,na,1904,1722
SIM,1902,48,35-39,1950,1
SIM,1948,19,na,1967,4162
STAT,1968,22,20-24,1990,160.80715391476068
STAT,1850,30,45-49,1880,2.1069628846171757
STAT,1910,11,na,1921,4527.48895840505
STAT,1943,43,25-29,1986,0.09068349427108136
SIM,1854,41,35-39,1895,3
STAT,1854,44,na,1898,1857.5436352049871
STAT,1887,27,35-39,1914,12.479181210129555
STAT,1830,104,na,1934,0.04184206116784833
STAT,1949,17,15-19,1966,60.9121441196288
STAT,1860,24,50-100,1884,0.3853986667825044
STAT,1834,52,45-49,1886,0.013579616839109875
SIM,1850,37,30-34,1887,14
STAT,1835,40,20-24,1875,0.12184601934176033
STAT,1839,42,30-34,1881,0.9609383388328635
STAT,1965,36,20-24,2001,0.39164206030507853
STAT,1985,16,30-34,2001,20.0121732428372
STAT,1901,15,15-19,1916,9.637669823823437
STAT,1968,26,50-100,1994,1.4415605103536488
STAT,1850,30,na,1880,2618.5701591143875
SIM,1881,65,na,1946,1166
SIM,1889,45,na,1934,3661
STAT,1969,40,25-29,2009,0.10728169520623898
SIM,1928,24,50-100,1952,3
SIM,1954,15,45-49,1969,1
STAT,1919,72,na,1991,3404.6473123232067
STAT,1835,45,15-19,1880,2.96644964451451E-4
SIM,1803,72,na,1875,927
STAT,1826,42,20-24,1868,0.11907743526513966
SIM,1983,8,na,1991,7027
STAT,1826,47,15-19,1873,2.8781653623654837E-4
STAT,1835,48,30-34,1883,0.06286364561690586
STAT,1891,28,na,1919,3391.959608291213
STAT,1984,20,45-49,2004,1.8516004754748154
SIM,1976,22,20-24,1998,328
STAT,1806,71,na,1877,624.6186224548554
SIM,1928,25,45-49,1953,6
STAT,1870,52,30-34,1922,0.0067363067899039565
STAT,1864,23,25-29,1887,59.506491836900246
STAT,1795,70,na,1865,580.040684532171
STAT,1865,32,30-34,1897,18.180036743670417
SIM,1836,36,50-100,1872,2
STAT,1799,84,na,1883,151.33023710398703
STAT,1910,16,30-34,1926,2.796958521624283
STAT,1862,105,na,1967,0.22147351976470653
STAT,1938,38,20-24,1976,0.30900913281696835
STAT,1815,42,45-49,1857,3.34461940041497
STAT,1966,32,50-100,1998,1.2147905964774741
SIM,1835,30,45-49,1865,3
SIM,1824,34,na,1858,1730
SIM,1871,30,30-34,1901,41
SIM,1876,52,50-100,1928,1
STAT,1952,31,20-24,1983,3.4404686464079974
STAT,1829,47,40-44,1876,0.1746749347235361
STAT,1957,22,45-49,1979,1.7176825810695457
SIM,1907,21,45-49,1928,1
STAT,1951,24,50-100,1975,0.9066138481276917
STAT,1853,16,25-29,1869,6.827052784973445
STAT,1862,17,40-44,1879,0.20401838252634147
STAT,1842,37,30-34,1879,4.811069348135435
SIM,1844,24,25-29,1868,90
SIM,1957,17,15-19,1974,121
STAT,1909,24,30-34,1933,30.668708401930292
SIM,1893,34,25-29,1927,36
STAT,1870,66,na,1936,1864.7414854914643
STAT,1885,34,25-29,1919,11.68941236829883
SIM,1973,36,20-24,2009,4
STAT,1823,51,30-34,1874,0.005778813043411148
STAT,1861,35,15-19,1896,0.05438675047168373
SIM,1965,22,45-49,1987,6
SIM,1845,43,35-39,1888,4
STAT,1933,26,15-19,1959,1.0827254160152993
SIM,1862,6,na,1868,3233
STAT,1959,19,50-100,1978,0.5651926685758846
STAT,1837,43,35-39,1880,1.5275966227266258
SIM,1847,42,30-34,1889,2
STAT,1836,24,25-29,1860,67.79635865050437
STAT,1876,30,40-44,1906,5.2151972997789455
SIM,1995,19,45-49,2014,1
SIM,1914,27,20-24,1941,20
SIM,1914,40,40-44,1954,1
STAT,1827,30,45-49,1857,3.3417665390592783
STAT,1858,10,na,1868,2542.0023500674224
STAT,1964,28,20-24,1992,26.634316406205375
SIM,1870,81,na,1951,1015
STAT,1816,70,na,1886,800.7383933905695
STAT,1841,32,45-49,1873,1.8811163507890551
SIM,1960,31,20-24,1991,7
SIM,1903,27,45-49,1930,5
STAT,1856,50,30-34,1906,0.005316232101724786
SIM,1874,95,na,1969,39
STAT,1827,29,40-44,1856,6.613206463066722
SIM,1884,30,40-44,1914,12
SIM,1891,64,na,1955,2405
STAT,1987,19,45-49,2006,0.8224417259038881
SIM,1933,21,na,1954,6477
SIM,1917,24,30-34,1941,1
STAT,1976,17,na,1993,5674.999577235348
STAT,1980,25,na,2005,6032.835749144055
SIM,1920,19,45-49,1939,3
STAT,1919,46,35-39,1965,0.16174730479301824
SIM,1835,29,40-44,1864,5
SIM,1968,37,na,2005,5320
SIM,1901,36,50-100,1937,1
SIM,1918,75,na,1993,2539
STAT,1974,15,na,1989,5549.577981533856
STAT,1876,48,40-44,1924,0.20167172229268465
SIM,1846,22,50-100,1868,1
SIM,1978,27,45-49,2005,4
STAT,1852,32,20-24,1884,2.6386468309545776
STAT,1882,46,15-19,1928,4.5216576873930906E-4
STAT,1906,27,20-24,1933,19.742519149148627
STAT,1843,49,40-44,1892,0.16819221043855984
STAT,1838,33,25-29,1871,10.912855308461952
STAT,1853,16,50-100,1869,0.05902349919666903
STAT,1936,20,na,1956,4034.2983113705177
STAT,1912,19,45-49,1931,0.11605947268323494
SIM,1847,17,40-44,1864,1
SIM,1872,49,50-100,1921,2
STAT,1862,51,20-24,1913,7.221222346551516E-4
STAT,1883,39,20-24,1922,0.86159975065147
SIM,1873,8,na,1881,3753
STAT,1926,41,20-24,1967,0.025156492634160577
STAT,1946,21,30-34,1967,36.92213755246906
STAT,1806,48,50-100,1854,0.8906031445436988
SIM,1818,37,40-44,1855,3
STAT,1836,85,na,1921,249.4809160917636
SIM,1998,8,na,2006,6866
STAT,1863,38,40-44,1901,4.395472352231012
SIM,1954,21,30-34,1975,53
STAT,1937,20,15-19,1957,5.989649204422679
SIM,1846,33,25-29,1879,2
SIM,1939,37,na,1976,4928
STAT,1863,26,35-39,1889,9.807247777917484
STAT,1880,27,50-100,1907,0.782498108921063
STAT,1898,34,35-39,1932,15.659755261104205
STAT,1982,25,40-44,2007,7.608509470408713
SIM,1923,43,na,1966,5325
STAT,1916,49,25-29,1965,0.06242721160156859
SIM,1891,39,20-24,1930,1
STAT,1935,18,50-100,1953,0.5898468333179624
SIM,1903,39,na,1942,3773
STAT,1920,38,35-39,1958,3.051810020475868
STAT,1941,31,45-49,1972,1.908216758909709
SIM,1871,38,40-44,1909,5
STAT,1897,12,na,1909,3985.1571700158106
STAT,1956,39,15-19,1995,0.030147613754469095
STAT,1845,62,na,1907,1231.6255977206956
STAT,1859,34,20-24,1893,2.4636596219768463
STAT,1849,76,na,1925,734.3024640765087
SIM,1868,83,na,1951,447
STAT,1957,18,25-29,1975,65.91629282624288
STAT,1885,0,na,1885,4036.865762173609
STAT,1971,26,35-39,1997,22.049567625409352
SIM,1867,44,25-29,1911,1
SIM,2003,0,na,2003,6682
STAT,1839,17,40-44,1856,0.1897480794846063
STAT,1970,21,50-100,1991,0.9540167959410351
STAT,1897,44,45-49,1941,0.15821273867926886
STAT,1921,42,35-39,1963,0.26164529682239973
STAT,1953,18,50-100,1971,0.5228727831229176
SIM,1904,27,50-100,1931,2
STAT,1946,60,na,2006,4554.763762910065
SIM,1918,15,35-39,1933,1
STAT,1852,37,15-19,1889,0.05323054804259005
STAT,1898,93,na,1991,291.5806582260511
SIM,1964,42,40-44,2006,2
STAT,1945,36,35-39,1981,3.1443061656465385
SIM,1891,80,na,1971,1377
SIM,1919,33,30-34,1952,39
STAT,1983,28,15-19,2011,1.1569270825860825
SIM,1962,34,na,1996,5408
STAT,1884,18,30-34,1902,1.8126018979176737
STAT,1865,50,na,1915,2274.217398934252
STAT,1907,36,15-19,1943,0.020679303130097623
SIM,1935,1,na,1936,6681
STAT,1901,18,30-34,1919,2.5697121128022133
STAT,1952,21,50-100,1973,0.913296711175847
SIM,1848,21,40-44,1869,4
STAT,1859,44,25-29,1903,0.5823695324780007
SIM,1965,18,25-29,1983,1
STAT,1873,52,35-39,1925,0.010091678181513661
SIM,1953,36,35-39,1989,7
SIM,1907,91,na,1998,487
SIM,1869,34,30-34,1903,21
SIM,1973,18,na,1991,5091
STAT,1883,52,40-44,1935,0.011823408894612555
STAT,1972,40,20-24,2012,0.027194190131233666
STAT,1946,15,45-49,1961,0.6397444121573199
SIM,1917,36,25-29,1953,3
STAT,1846,49,45-49,1895,0.23887861397183757
SIM,1871,26,35-39,1897,1
STAT,1900,22,na,1922,3787.283979310402
STAT,1920,47,50-100,1967,0.2884128206101391
STAT,1904,36,na,1940,3954.1191710973617
SIM,1959,55,na,2014,5603
STAT,1893,32,50-100,1925,1.3365443744091747
STAT,1996,17,45-49,2013,0.8378172134123352
SIM,1835,26,25-29,1861,83
SIM,1894,18,40-44,1912,1
STAT,1808,67,na,1875,1048.102729921338
STAT,1846,41,35-39,1887,1.91907917692533
STAT,1976,37,35-39,2013,3.842026347965215
STAT,1905,80,na,1985,1872.5917655890094
STAT,1943,38,na,1981,4739.044575509895
SIM,1890,40,30-34,1930,2
STAT,1867,20,35-39,1887,6.405213426804377
STAT,1942,53,na,1995,4511.314879542864
SIM,1819,66,na,1885,426
SIM,1854,48,na,1902,2337
STAT,1816,47,30-34,1863,0.1974151262960261
SIM,1843,48,na,1891,1722
SIM,1902,44,na,1946,3815
STAT,1886,18,40-44,1904,0.22206658905594662
SIM,1815,52,na,1867,1774
STAT,1936,41,na,1977,4253.061679401806
SIM,1899,23,na,1922,3932
STAT,1825,38,20-24,1863,1.2430892211117461
STAT,1894,18,15-19,1912,8.781071886345634
STAT,1882,40,30-34,1922,1.3089996115415716
STAT,1861,38,30-34,1899,5.0878737753300385
STAT,1911,32,25-29,1943,10.395447167270158
SIM,1867,39,na,1906,2257
STAT,1817,44,na,1861,2060.60112007996
STAT,1987,22,15-19,2009,8.798917616969423
STAT,1902,49,45-49,1951,0.21254279554683236
STAT,1861,30,20-24,1891,2.614179672179106
STAT,1836,27,40-44,1863,3.5288387807874573
SIM,1833,38,20-24,1871,2
SIM,1972,6,na,1978,5841
SIM,1871,35,25-29,1906,1
STAT,1852,47,40-44,1899,0.16065715934865882
SIM,1844,27,40-44,1871,8
SIM,1939,32,45-49,1971,6
STAT,1863,104,na,1967,0.48127001518773194
STAT,1921,17,45-49,1938,0.6568838275312923
SIM,1836,51,na,1887,1430
STAT,1927,78,na,2005,3057.365642546436
SIM,1873,51,na,1924,2987
STAT,1846,84,na,1930,343.9012529314992
STAT,1904,40,30-34,1944,0.1336396272917561
SIM,1810,44,25-29,1854,2
STAT,1948,21,40-44,1969,4.456714564923144
STAT,1973,20,25-29,1993,138.4165718457004
SIM,1939,28,25-29,1967,135
SIM,1977,7,na,1984,6243
STAT,1885,39,30-34,1924,6.073181037109226
SIM,1863,25,na,1888,2395
STAT,1840,28,45-49,1868,1.102582689416757
SIM,1928,53,na,1981,5503
SIM,1912,43,na,1955,3645
STAT,1866,24,na,1890,2513.9653102919438
STAT,1909,36,25-29,1945,1.08191777039397
STAT,1850,14,na,1864,2975.8590591063708
STAT,1910,19,35-39,1929,0.9553771523535222
STAT,1827,70,na,1897,1139.4651720155114
STAT,1985,20,15-19,2005,8.772341383331591
SIM,1846,24,35-39,1870,7
STAT,1942,39,25-29,1981,1.2209793306558425
STAT,1959,39,40-44,1998,2.3232132211188827
STAT,1934,30,15-19,1964,0.20280960253701055
STAT,1864,20,20-24,1884,73.19957556080003
SIM,1956,21,40-44,1977,4
SIM,1967,17,20-24,1984,221
STAT,1912,33,50-100,1945,0.935818346630185
SIM,1832,48,na,1880,1980
STAT,1795,108,na,1903,3.209702919088852E-4
STAT,1923,42,45-49,1965,0.22440507115331804
STAT,1967,29,50-100,1996,1.4396393094866902
SIM,1875,20,35-39,1895,7
SIM,1993,20,15-19,2013,14
STAT,1976,34,30-34,2010,24.728775822693013
SIM,1884,33,45-49,1917,6
STAT,1851,19,30-34,1870,1.5186586865977605
SIM,1993,19,35-39,2012,15
SIM,1829,81,na,1910,187
STAT,1876,33,45-49,1909,2.0715639527614136
STAT,1985,19,35-39,2004,6.882893665034114
STAT,1856,41,40-44,1897,1.9893340109962425
SIM,1950,39,25-29,1989,3
SIM,1920,33,50-100,1953,1
STAT,1960,23,na,1983,5505.257277748674
STAT,1881,27,40-44,1908,3.3344493541848514
STAT,1835,43,25-29,1878,0.47407553338942054
SIM,1824,32,35-39,1856,4
STAT,1959,17,20-24,1976,204.6615284262216
STAT,1963,15,na,1978,5399.4478749370855
STAT,1895,44,35-39,1939,0.18634583365702237
SIM,1952,19,na,1971,4821
STAT,1857,47,na,1904,2012.7533993860795
STAT,1896,32,35-39,1928,15.436545959835328
SIM,1858,43,45-49,1901,1
STAT,1838,24,35-39,1862,6.465407784462408
STAT,1939,21,50-100,1960,0.7631765558521819
STAT,1915,41,45-49,1956,0.1936822441325158
STAT,2001,7,na,2008,6791.383589616754
STAT,1948,17,45-49,1965,0.6597296347371608
STAT,1932,45,15-19,1977,5.795345994312239E-4
SIM,1843,43,25-29,1886,3
SIM,1891,43,na,1934,3303
SIM,1906,10,na,1916,4010
STAT,1848,32,na,1880,2685.4345828026144
SIM,1872,20,20-24,1892,1
SIM,1871,33,35-39,1904,9
STAT,1864,19,40-44,1883,0.1926790119967154
SIM,1895,57,na,1952,3062
SIM,1893,31,20-24,1924,2
STAT,1962,40,15-19,2002,0.002366427317086057
STAT,1908,15,25-29,1923,9.758418749140596
SIM,1895,33,20-24,1928,5
STAT,1995,0,na,1995,6616.921016645616
STAT,1930,30,30-34,1960,23.494379953266154
STAT,1842,22,35-39,1864,5.663905492165755
SIM,1811,86,na,1897,154
STAT,1785,92,na,1877,7.589866048548636
STAT,1887,33,20-24,1920,3.481175263739458
STAT,1952,48,40-44,2000,0.22616700824512212
SIM,1808,82,na,1890,248
STAT,1968,44,na,2012,5544.830021474246
STAT,1874,31,45-49,1905,2.068653330083607
STAT,1889,103,na,1992,6.073697230419825
SIM,1969,32,15-19,2001,1
SIM,1858,40,40-44,1898,3
SIM,1894,24,50-100,1918,1
SIM,1849,30,35-39,1879,36
STAT,1887,93,na,1980,213.70517957183972
SIM,1843,44,50-100,1887,1
SIM,1879,30,50-100,1909,1
SIM,1873,32,30-34,1905,7
STAT,1886,24,50-100,1910,0.4933002116646623
SIM,1982,18,20-24,2000,419
SIM,1963,19,na,1982,6151
STAT,1916,94,na,2010,303.5553993488565
STAT,1840,20,35-39,1860,6.039549592323476
SIM,1916,15,25-29,1931,28
SIM,1967,38,25-29,2005,1
SIM,1872,19,40-44,1891,1
STAT,1885,31,20-24,1916,3.1242315748806018
SIM,1895,24,30-34,1919,71
STAT,1970,17,40-44,1987,2.0206272191999686
STAT,1930,48,20-24,1978,0.016750681682706717
STAT,1963,20,40-44,1983,4.949463446342788
STAT,1886,15,25-29,1901,6.930221623145204
STAT,1887,24,30-34,1911,22.892819847944338
SIM,1893,39,30-34,1932,19
STAT,1942,3,na,1945,4857.107874370564
SIM,1856,41,45-49,1897,2
STAT,1861,14,na,1875,2608.624064937653
STAT,1897,41,40-44,1938,0.24211934921918793
STAT,1982,28,45-49,2010,2.816281928474641
SIM,1876,24,50-100,1900,2
SIM,1899,60,na,1959,3270
STAT,1961,40,45-49,2001,0.25859866740109777
SIM,1931,57,na,1988,5808
STAT,1840,15,na,1855,2412.4561072991987
STAT,1810,49,na,1859,1625.5797396096123
SIM,1915,39,30-34,1954,5
SIM,1917,27,35-39,1944,27
STAT,1954,15,50-100,1969,0.5347921591476987
STAT,1946,24,35-39,1970,12.083844415368254
SIM,1878,61,na,1939,2278
SIM,1904,48,45-49,1952,1
SIM,1861,20,45-49,1881,1
SIM,1940,17,20-24,1957,158
SIM,1960,48,40-44,2008,1
STAT,1837,48,40-44,1885,0.12705056856949995
STAT,1909,3,na,1912,4580.424999513603
STAT,1932,17,20-24,1949,207.22753795573317
SIM,1915,47,50-100,1962,1
STAT,1957,15,20-24,1972,206.3965041148185
SIM,1959,39,45-49,1998,2
STAT,1859,41,20-24,1900,0.1466581729452577
SIM,1962,15,50-100,1977,1
STAT,1907,39,30-34,1946,1.933593901851421
STAT,1912,16,40-44,1928,0.3275211549278329
SIM,1822,38,45-49,1860,5
SIM,1833,29,30-34,1862,4
STAT,1862,54,25-29,1916,0.003354817194822809
SIM,1954,24,35-39,1978,34
STAT,1968,1,na,1969,5675.636311771078
STAT,1909,27,35-39,1936,16.57720698044976
SIM,1868,22,20-24,1890,83
STAT,1968,16,35-39,1984,6.05007521244274
SIM,1878,42,35-39,1920,6
STAT,1852,19,50-100,1871,0.055209142787310726
SIM,1908,2,na,1910,4528
STAT,1838,30,20-24,1868,2.9710657844171227
STAT,1915,4,na,1919,4860.007468303307
STAT,1982,20,35-39,2002,15.351844586572543
STAT,1858,28,30-34,1886,23.04147633638617
STAT,1941,49,35-39,1990,0.15851591321673167
STAT,1898,31,30-34,1929,27.342863188302182
STAT,1830,37,na,1867,1686.2745342067835
STAT,1988,21,na,2009,6049.359781509765
STAT,1832,52,35-39,1884,0.006216853667161154
STAT,1859,46,15-19,1905,3.687656051989972E-4
STAT,1863,35,25-29,1898,2.9330203221301057
STAT,1883,57,na,1940,2269.058858724788
STAT,1987,16,40-44,2003,2.305026477163004
SIM,1976,16,35-39,1992,10
STAT,1898,25,45-49,1923,1.7434664793412287
SIM,1846,30,20-24,1876,4
SIM,1995,16,40-44,2011,3
STAT,1820,36,40-44,1856,11.09375731751252
SIM,1829,44,na,1873,1634
STAT,1926,42,na,1968,5282.72313815497
STAT,1837,40,30-34,1877,1.0078586068687212
STAT,1853,20,45-49,1873,0.8322128925456461
SIM,1869,37,35-39,1906,6
SIM,1894,13,na,1907,4130
STAT,1813,51,25-29,1864,0.011474735311626268
STAT,1966,28,30-34,1994,56.695648685978476
STAT,1935,23,20-24,1958,174.78191702811364
SIM,1941,29,30-34,1970,76
STAT,1859,49,30-34,1908,0.08713068013112557
STAT,1903,49,15-19,1952,3.631466695839842E-4
STAT,1978,36,30-34,2014,2.9600107576709225
SIM,1902,33,50-100,1935,1
STAT,1913,25,35-39,1938,17.390425018609122
STAT,1922,30,35-39,1952,12.006363295635579
SIM,1948,38,30-34,1986,2
STAT,1851,16,15-19,1867,5.755617919071215
SIM,1956,9,na,1965,5518
STAT,1980,32,30-34,2012,25.728824067023798
SIM,1845,40,30-34,1885,6
SIM,1823,42,45-49,1865,1
STAT,1827,33,na,1860,2336.185245245331
SIM,1880,80,na,1960,1024
STAT,1885,36,15-19,1921,0.0649511521059776
SIM,1839,70,na,1909,1375
SIM,1846,77,na,1923,161
SIM,1842,63,na,1905,1557
SIM,1990,20,35-39,2010,19
SIM,1866,28,30-34,1894,37
STAT,1891,22,30-34,1913,25.405983246293562
SIM,1921,25,35-39,1946,50
STAT,1861,33,25-29,1894,9.785359362278221
STAT,1884,46,25-29,1930,0.06586319666624502
SIM,1885,79,na,1964,1569
SIM,1943,23,20-24,1966,142
STAT,1933,29,30-34,1962,60.008127754085486
SIM,1930,30,35-39,1960,38
SIM,1912,40,30-34,1952,1
STAT,1837,45,25-29,1882,0.044420916165040264
STAT,1933,49,na,1982,5798.718446649388
STAT,1935,17,35-39,1952,6.623639693144694
STAT,1859,37,25-29,1896,2.6468595322823947
STAT,1825,29,30-34,1854,104.22778558645909
SIM,1829,25,25-29,1854,3
STAT,1902,46,40-44,1948,0.1579185620778116
SIM,1817,39,50-100,1856,1
SIM,1891,34,15-19,1925,5
STAT,1883,34,15-19,1917,0.15941477417042815
STAT,1876,50,na,1926,2605.5965874087415
STAT,1821,51,20-24,1872,0.0013125729320405527
SIM,1965,15,20-24,1980,375
STAT,1970,36,50-100,2006,0.6254501898837593
STAT,1907,47,50-100,1954,0.23413878616681208
SIM,1943,17,35-39,1960,6
STAT,1861,42,15-19,1903,0.01323293827864134
STAT,1911,37,30-34,1948,2.0332779309001645
SIM,1959,17,25-29,1976,83
SIM,1835,23,20-24,1858,85
STAT,1960,20,15-19,1980,8.033142283177702
STAT,1868,28,15-19,1896,0.5012799492438449
SIM,1948,51,na,1999,4284
SIM,1885,24,25-29,1909,1
SIM,1889,26,35-39,1915,1
STAT,1934,17,30-34,1951,19.035705250855433
SIM,1973,25,20-24,1998,45
STAT,1929,34,na,1963,5537.203871919832
STAT,1934,49,50-100,1983,0.36171280270380823
STAT,1810,51,45-49,1861,0.05423180931206185
STAT,1916,22,20-24,1938,134.4796055217901
STAT,1953,46,35-39,1999,0.18768552173066047
STAT,1828,36,50-100,1864,1.2911066669059839
SIM,1928,37,na,1965,5688
SIM,1924,22,20-24,1946,143
STAT,1866,26,15-19,1892,0.48697375699989826
SIM,1982,25,45-49,2007,6
SIM,1958,36,35-39,1994,5
STAT,1944,39,na,1983,4803.684224086007
STAT,1904,43,35-39,1947,0.20688435789648035
STAT,1877,24,25-29,1901,68.29000345275084
SIM,1914,39,na,1953,3907
SIM,1928,24,30-34,1952,108
STAT,1840,25,40-44,1865,3.039741446887592
STAT,1900,27,15-19,1927,0.7265391315916527
STAT,1865,33,45-49,1898,1.8081029147571466
STAT,1919,28,45-49,1947,2.146134369170168
STAT,1825,85,na,1910,193.90303012871706
STAT,1889,5,na,1894,3728.0398199171714
STAT,1804,50,20-24,1854,0.0035359509213957418
SIM,1848,30,30-34,1878,7
SIM,1839,32,30-34,1871,29
STAT,1926,83,na,2009,2105.2113282264713
STAT,1933,38,20-24,1971,0.41413077181699387
STAT,1963,6,na,1969,5763.7348596323045
STAT,1883,33,50-100,1916,1.0301600869819592
STAT,1922,38,45-49,1960,0.8939099650788324
STAT,1947,55,na,2002,4811.62763495995
STAT,1907,48,20-24,1955,0.011349172641752916
SIM,1927,28,45-49,1955,3
STAT,1875,24,15-19,1899,3.9097709056317074
STAT,1900,102,na,2002,12.837252485086779
STAT,1954,25,45-49,1979,2.477533126931922
SIM,1824,30,45-49,1854,4
STAT,1891,20,40-44,1911,2.989908113483474
STAT,1929,22,30-34,1951,41.94655271930705
STAT,1939,35,20-24,1974,0.3143980640147867
SIM,1869,41,30-34,1910,2
SIM,1953,18,45-49,1971,1
STAT,1796,71,na,1867,705.7126540573767
SIM,1938,28,20-24,1966,39
SIM,1930,38,45-49,1968,3
SIM,1890,31,40-44,1921,15
STAT,1882,31,40-44,1913,4.908389034465565
SIM,1930,0,na,1930,6469
STAT,1885,43,15-19,1928,0.015781789090626126
STAT,1876,45,15-19,1921,4.819485307951757E-4
SIM,1878,39,na,1917,2755
STAT,1890,27,na,1917,3365.284628763259
STAT,1865,20,25-29,1885,61.20770556972723
STAT,1911,12,na,1923,4564.69148651136
SIM,1874,20,30-34,1894,26
STAT,1945,18,45-49,1963,0.6295492502044633
STAT,1853,53,50-100,1906,0.01479515571866459
SIM,1859,39,40-44,1898,2
SIM,1878,47,40-44,1925,1
STAT,1905,49,25-29,1954,0.05313763866609102
SIM,1853,53,na,1906,2046
SIM,1948,41,na,1989,4389
STAT,1883,15,35-39,1898,0.6224217490260855
STAT,1862,95,na,1957,17.135653651136693
SIM,1963,18,15-19,1981,130
STAT,1827,30,20-24,1857,5.179995588620429
SIM,1918,17,25-29,1935,122
STAT,1868,52,50-100,1920,0.016656295129383467
SIM,1835,50,na,1885,1948
STAT,1822,109,na,1931,5.845543323994413E-4
STAT,1908,44,50-100,1952,0.12405209659682641
SIM,1952,39,35-39,1991,6
STAT,1881,52,30-34,1933,0.006590682706082964
STAT,1817,40,50-100,1857,3.4350255060573844
STAT,1879,23,20-24,1902,82.7842599830666
SIM,1838,23,25-29,1861,63
SIM,1939,25,45-49,1964,4
SIM,1919,4,na,1923,5746
SIM,1964,18,20-24,1982,185
STAT,1896,37,40-44,1933,6.6725666923583065
SIM,1864,41,40-44,1905,3
STAT,1863,30,30-34,1893,17.76040048681473
STAT,1963,23,45-49,1986,1.654589601638855
STAT,1828,34,na,1862,1875.8203241480182
SIM,1830,38,40-44,1868,4
SIM,1862,30,na,1892,2817
STAT,1877,45,na,1922,2727.7358526633884
STAT,1944,39,35-39,1983,3.088325965248638
STAT,1822,38,40-44,1860,10.128583931927144
SIM,1907,29,30-34,1936,53
STAT,1848,41,45-49,1889,1.6087431331579634
STAT,1900,49,35-39,1949,0.12382128959376945
SIM,1898,43,na,1941,3851
STAT,1815,51,35-39,1866,0.01723186440563129
SIM,1835,30,20-24,1865,2
SIM,1841,22,45-49,1863,2
STAT,1955,18,15-19,1973,69.5055589952449
STAT,1908,72,na,1980,2843.080894539555
SIM,1949,38,35-39,1987,2
SIM,1826,79,na,1905,216
SIM,1990,16,50-100,2006,7
STAT,1974,23,20-24,1997,168.0605429119652
STAT,1980,15,45-49,1995,0.8007311292663701
SIM,1878,20,15-19,1898,4
SIM,1906,17,20-24,1923,31
STAT,1920,43,50-100,1963,0.1494358316159982
STAT,1880,34,25-29,1914,12.421906187703884
SIM,1793,93,na,1886,13
SIM,1942,17,30-34,1959,19
STAT,1905,22,45-49,1927,1.1647517887370096
SIM,1913,22,45-49,1935,1
STAT,1899,78,na,1977,1924.7287940749784
STAT,1830,40,20-24,1870,0.15709873482560466
STAT,1930,33,35-39,1963,13.603484970012815
SIM,1815,41,50-100,1856,3
SIM,1837,33,35-39,1870,27
STAT,1839,30,25-29,1869,10.205925080827308
STAT,1853,20,20-24,1873,82.2430685174302
STAT,1861,30,na,1891,2307.8469367926627
STAT,1987,20,25-29,2007,152.78674812204864
SIM,1936,35,45-49,1971,2
SIM,1902,21,30-34,1923,75
SIM,1911,27,40-44,1938,12
STAT,1899,25,15-19,1924,0.7222023122806156
STAT,1838,31,35-39,1869,11.01617509948443
STAT,1967,28,35-39,1995,21.72616860988357
STAT,1857,22,30-34,1879,18.48247473140272
SIM,1883,9,na,1892,2796
STAT,1918,25,35-39,1943,18.56020567621876
SIM,1869,78,na,1947,561
SIM,1887,23,20-24,1910,161
SIM,1960,34,25-29,1994,40
SIM,1951,24,30-34,1975,72
STAT,1957,15,45-49,1972,0.7604880715406764
STAT,1947,26,50-100,1973,1.3000903074601116
SIM,1956,33,20-24,1989,9
STAT,1917,46,25-29,1963,0.06410205411333524
STAT,1956,18,20-24,1974,206.96765548972607
SIM,1878,45,na,1923,2708
SIM,1941,2,na,1943,4127
SIM,1852,25,25-29,1877,5
STAT,1833,22,45-49,1855,0.7537942991143378
SIM,1783,73,na,1856,707
SIM,1956,17,45-49,1973,4
STAT,1828,50,na,1878,1593.1873527576608
SIM,1847,30,25-29,1877,4
SIM,1872,21,35-39,1893,5
STAT,1839,28,na,1867,2145.729271753152
STAT,1928,35,45-49,1963,0.9959724640101072
STAT,1948,33,20-24,1981,3.2815449104367627
SIM,1873,20,25-29,1893,89
STAT,1842,97,na,1939,4.134076007791254
SIM,1897,34,45-49,1931,4
STAT,1844,25,25-29,1869,43.94211962352052
STAT,1866,51,na,1917,2314.1811296534956
SIM,1944,15,50-100,1959,1
STAT,1818,49,30-34,1867,0.116108191185146
STAT,1892,35,50-100,1927,1.7927147473895253
SIM,1965,15,45-49,1980,1
STAT,1944,49,na,1993,4718.1826530442195
STAT,1903,27,40-44,1930,4.92403965204888
STAT,1967,38,20-24,2005,0.3911095571943696
STAT,1828,51,30-34,1879,0.005400324165841739
STAT,1960,46,25-29,2006,0.08313886680011003
SIM,1832,85,na,1917,201
STAT,1899,94,na,1993,233.79762800351648
SIM,1951,39,na,1990,6255
SIM,1975,38,20-24,2013,1
STAT,1864,21,35-39,1885,6.1540029932120826
STAT,1929,28,15-19,1957,1.019181201674443
SIM,1873,30,40-44,1903,2
SIM,1970,31,50-100,2001,2
STAT,1828,54,25-29,1882,0.002755370155879695
STAT,1868,23,45-49,1891,0.7707784963887553
STAT,1861,20,na,1881,2364.9162352321127
SIM,1951,36,25-29,1987,1
SIM,1913,95,na,2008,733
SIM,1862,41,20-24,1903,1
STAT,1848,39,15-19,1887,0.06022300223451956
STAT,1907,24,20-24,1931,116.27915696294139
STAT,1854,41,30-34,1895,0.9408692755909713
SIM,1945,49,na,1994,4589
SIM,1826,32,20-24,1858,1
STAT,1943,24,30-34,1967,35.268698455444174
STAT,1886,12,na,1898,3143.7171470114527
SIM,1896,58,na,1954,3151
STAT,1873,79,na,1952,823.8884442086727
STAT,1889,34,45-49,1923,2.459469031493525
SIM,1853,63,na,1916,1698
SIM,1960,16,na,1976,5909
STAT,1908,27,30-34,1935,43.16407286122481
STAT,1894,47,na,1941,3322.7840157703563
SIM,1846,31,35-39,1877,22
STAT,1954,33,na,1987,5496.5840546140535
SIM,1962,25,45-49,1987,6
SIM,1926,25,35-39,1951,48
STAT,1875,52,45-49,1927,0.017215302105542438
STAT,1968,18,25-29,1986,62.443949282459364
SIM,1861,20,20-24,1881,126
SIM,1870,102,na,1972,17
SIM,1915,24,20-24,1939,143
SIM,1916,27,30-34,1943,4
STAT,1969,45,30-34,2014,0.1343042024366682
STAT,1954,41,35-39,1995,0.29898494065872494
STAT,1849,34,15-19,1883,0.11391788417292747
SIM,1847,43,45-49,1890,7
STAT,1870,15,25-29,1885,6.5859437721062175
STAT,1806,49,na,1855,1227.662859653147
STAT,1892,16,15-19,1908,8.605020321018214
SIM,2007,5,na,2012,6952
STAT,1912,87,na,1999,1052.4859818299933
STAT,1910,28,25-29,1938,73.16789636013685
SIM,1878,55,na,1933,2475
STAT,1876,33,20-24,1909,3.2110837221650934
STAT,1918,49,35-39,1967,0.15737516790740802
STAT,1839,43,45-49,1882,1.235026652190614
SIM,1926,49,35-39,1975,1
STAT,1825,79,na,1904,494.49690242494745
STAT,1894,57,na,1951,2981.366372340394
STAT,1964,40,25-29,2004,0.10816657965876833
STAT,1820,48,na,1868,1494.296247510692
STAT,1978,22,25-29,2000,145.9597165928278
STAT,1841,16,na,1857,2647.7624986568967
SIM,1822,35,40-44,1857,5
SIM,1965,45,na,2010,5493
SIM,1873,24,na,1897,3493
SIM,1986,22,25-29,2008,174
SIM,1958,33,30-34,1991,59
STAT,1870,29,30-34,1899,28.44528910689044
STAT,1974,21,na,1995,5523.001635142694
SIM,1878,37,50-100,1915,3
STAT,1949,45,30-34,1994,0.12503858330966625
STAT,1979,16,35-39,1995,6.669466538693265
STAT,1931,10,na,1941,6004.57585679896
STAT,1944,55,na,1999,4597.053114329848
STAT,1792,89,na,1881,57.14208809716799
SIM,1972,23,na,1995,5033
STAT,1989,22,25-29,2011,153.19014935681315
STAT,1935,16,20-24,1951,214.5322517666537
STAT,1901,44,na,1945,3698.3776962897423
STAT,1845,83,na,1928,267.5116348299898
SIM,1948,35,na,1983,4408
SIM,1920,73,na,1993,2614
STAT,1965,28,25-29,1993,95.19533493350436
STAT,1806,50,40-44,1856,0.03857496404701475
STAT,1911,16,35-39,1927,0.9722480696413962
STAT,1854,44,25-29,1898,0.5161016744215567
STAT,1842,18,15-19,1860,5.829813062983886
SIM,1906,45,50-100,1951,1
SIM,1974,16,25-29,1990,78
SIM,1918,69,na,1987,3006
STAT,1859,81,na,1940,497.12735777934483
STAT,1822,39,50-100,1861,2.703269607371459
STAT,1953,43,30-34,1996,0.18518921905206528
STAT,1882,1,na,1883,3788.044501032288
SIM,1830,39,50-100,1869,2
STAT,1968,28,40-44,1996,6.744290893989282
STAT,1830,43,25-29,1873,0.6077792345434465
STAT,1943,36,25-29,1979,1.2426427617674685
SIM,1840,40,40-44,1880,4
STAT,1943,40,20-24,1983,0.02252494286745281
SIM,1869,44,35-39,1913,3
STAT,1835,31,50-100,1866,0.7361445369272228
STAT,1943,49,45-49,1992,0.2750597959938209
STAT,1804,53,25-29,1857,0.01597918166607612
STAT,1966,16,25-29,1982,62.48194075696937
STAT,1958,45,na,2003,5819.342919822212
STAT,1963,17,50-100,1980,0.549305798016835
SIM,1928,27,35-39,1955,32
SIM,1951,59,na,2010,5843
STAT,1944,16,50-100,1960,0.4654476321417376
SIM,1885,21,45-49,1906,6
SIM,1949,35,30-34,1984,1
STAT,1855,23,35-39,1878,5.759150841227932
STAT,1868,101,na,1969,4.59688198216416
STAT,1900,46,30-34,1946,0.08768749825115855
STAT,1845,15,15-19,1860,5.1144912441077635
STAT,1909,48,40-44,1957,0.16691450351034376
STAT,1844,22,45-49,1866,0.7282325506565224
SIM,1918,27,40-44,1945,10
STAT,1889,33,30-34,1922,24.732842507577853
STAT,1844,82,na,1926,390.26009940633605
STAT,1968,15,20-24,1983,195.52393319503443
STAT,1965,39,25-29,2004,1.458379514279396
SIM,1833,49,na,1882,1462
STAT,1865,30,40-44,1895,4.551929679117149
SIM,1889,23,30-34,1912,55
STAT,1932,40,45-49,1972,0.26110024698399975
STAT,1831,39,20-24,1870,0.7466032320421528
SIM,1826,35,25-29,1861,3
STAT,1872,29,40-44,1901,3.446456269450907
STAT,1911,25,25-29,1936,74.64316410225595
STAT,1933,20,50-100,1953,1.0137091849352393
STAT,1944,15,35-39,1959,5.214318025341269
STAT,1953,16,na,1969,5139.982204544385
SIM,1805,68,na,1873,967
SIM,1941,20,50-100,1961,1
STAT,1982,32,40-44,2014,6.477745825816447
STAT,1861,106,na,1967,0.0987308786430526
STAT,1946,17,35-39,1963,5.371006291287877
SIM,1948,26,25-29,1974,5
SIM,1835,34,na,1869,2472
SIM,1973,39,25-29,2012,4
STAT,1966,40,45-49,2006,0.25000038556045107
SIM,1853,15,15-19,1868,13
STAT,1937,77,na,2014,2593.4074168720376
STAT,1774,92,na,1866,0.45170373122773727
STAT,1916,43,na,1959,4385.741974829101
STAT,1952,34,25-29,1986,13.012481701094703
STAT,1820,39,45-49,1859,2.70674895828573
SIM,1883,17,15-19,1900,10
STAT,1885,96,na,1981,82.58958860643482
SIM,1943,61,na,2004,4867
STAT,1928,32,40-44,1960,5.64686870704358
STAT,1941,2,na,1943,4834.75420920456
STAT,1807,66,na,1873,1096.9131283568083
SIM,1917,48,30-34,1965,2
SIM,1920,28,35-39,1948,6
STAT,1923,19,20-24,1942,182.66926538957458
STAT,1822,54,50-100,1876,0.026401101063271995
SIM,1830,33,25-29,1863,6
STAT,1912,28,35-39,1940,17.03059447606504
SIM,1978,33,30-34,2011,29
STAT,1905,99,na,2004,52.36861330492273
STAT,1829,33,35-39,1862,12.664784166880217
SIM,1821,48,na,1869,1473
SIM,1833,45,50-100,1878,3
STAT,1774,86,na,1860,2.809682473232504
STAT,1917,34,30-34,1951,18.877078444804148
STAT,1837,52,25-29,1889,0.002574185492986997
SIM,1941,17,25-29,1958,122
STAT,1909,48,30-34,1957,0.09437689234661105
STAT,1933,17,25-29,1950,66.97638326210775
STAT,1935,38,40-44,1973,2.414591857995042
STAT,1940,19,na,1959,4311.417883095384
STAT,1844,22,20-24,1866,71.96725753318258
STAT,1877,21,45-49,1898,0.8396234085001927
STAT,1844,39,30-34,1883,4.613828006057957
SIM,1839,35,35-39,1874,16
STAT,1891,23,45-49,1914,0.9915291145407668
STAT,1811,54,30-34,1865,0.01701972745385592
SIM,1925,34,30-34,1959,29
SIM,1859,34,25-29,1893,13
SIM,1852,22,20-24,1874,151
SIM,1874,26,15-19,1900,1
SIM,1943,38,40-44,1981,5
STAT,1830,40,50-100,1870,1.0450480856576263
SIM,1903,42,30-34,1945,1
STAT,1961,28,40-44,1989,6.976304535553163
SIM,1887,26,25-29,1913,4
STAT,1931,39,25-29,1970,1.5019847975994185
STAT,1956,24,40-44,1980,5.14803702648049
STAT,1898,32,45-49,1930,2.7198051664946017
SIM,1841,21,30-34,1862,43
STAT,1797,87,na,1884,71.55638763550455
STAT,1950,59,na,2009,4903.2717489216275
SIM,1871,42,25-29,1913,2
STAT,1888,21,20-24,1909,93.76717791967862
STAT,1932,38,15-19,1970,0.02975349608549525
STAT,1857,25,35-39,1882,9.062542708328747
SIM,1845,38,50-100,1883,3
STAT,1899,31,35-39,1930,16.077038197063715
STAT,1905,16,50-100,1921,0.08203320997734719
STAT,1868,47,30-34,1915,0.1068283342866113
STAT,1845,18,40-44,1863,0.15485986786227673
STAT,1927,37,na,1964,5396.919902265984
STAT,1919,4,na,1923,5146.20390700836
STAT,1901,27,20-24,1928,18.96368851133017
STAT,1805,49,20-24,1854,0.04384565312131881
SIM,1853,18,40-44,1871,2
SIM,1896,21,20-24,1917,113
SIM,1878,29,na,1907,2924
SIM,1912,22,na,1934,3504
SIM,1964,24,40-44,1988,1
SIM,1936,32,40-44,1968,11
STAT,1837,38,50-100,1875,1.0712432184997618
STAT,1946,40,na,1986,4953.999792791591
SIM,1826,32,45-49,1858,1
STAT,1863,42,25-29,1905,0.6472093849549931
STAT,1971,44,35-39,2015,0.30486080733397475
SIM,1902,24,35-39,1926,1
SIM,1845,12,na,1857,2570
STAT,1843,98,na,1941,3.2595243927710627
STAT,1926,44,25-29,1970,0.10123529529171772
STAT,1879,26,25-29,1905,51.14894017562194
STAT,1846,46,40-44,1892,0.17748598409331232
SIM,1976,15,20-24,1991,202
STAT,1795,91,na,1886,16.588009477873563
STAT,1866,20,30-34,1886,19.4875270272685
SIM,1931,19,20-24,1950,203
STAT,1907,24,45-49,1931,1.176622119083384
STAT,1971,9,na,1980,5743.819384341675
STAT,1948,36,25-29,1984,1.3408947314944306
STAT,1967,25,30-34,1992,56.77785487344502
SIM,1914,86,na,2000,191
STAT,1879,35,50-100,1914,1.4935037564292986
STAT,1904,42,na,1946,3838.726861950374
SIM,1888,23,na,1911,2591
STAT,1925,5,na,1930,5603.491821170038
STAT,1887,23,na,1910,3049.3201854503886
SIM,1903,61,na,1964,3083
SIM,1852,22,45-49,1874,2
STAT,1906,48,15-19,1954,3.74940349519752E-4
STAT,1841,41,35-39,1882,1.6945387596811996
STAT,1970,29,35-39,1999,21.76123399849611
SIM,1862,41,30-34,1903,4
STAT,1841,32,na,1873,2337.8841544678526
STAT,1863,33,35-39,1896,10.17619966446611
SIM,1956,36,25-29,1992,5
SIM,1891,27,na,1918,3250
STAT,1832,40,40-44,1872,1.9617335371388107
SIM,1847,40,40-44,1887,4
SIM,1897,33,30-34,1930,38
STAT,1859,50,50-100,1909,0.014083548114232385
STAT,1967,43,na,2010,5555.143379927583
SIM,1895,31,30-34,1926,41
STAT,1917,46,50-100,1963,0.27332403821699763
SIM,1961,33,na,1994,5547
STAT,1880,31,30-34,1911,21.444726349307356
STAT,1895,49,40-44,1944,0.14203935255815842
SIM,1896,74,na,1970,2324
STAT,1786,93,na,1879,11.688135644139528
STAT,1842,20,45-49,1862,0.6866437549055722
STAT,1887,31,30-34,1918,22.673334792713018
SIM,1865,25,35-39,1890,29
STAT,1911,22,na,1933,4180.321043252564
STAT,1908,17,15-19,1925,10.17236128589434
SIM,1808,66,na,1874,988
STAT,1960,43,20-24,2003,0.027542806507094446
STAT,1839,40,40-44,1879,2.1195926070764606
SIM,1859,31,45-49,1890,3
SIM,1938,15,na,1953,4156
STAT,1907,27,25-29,1934,71.82674191176034
STAT,1841,36,50-100,1877,1.2995127397587454
STAT,1969,39,na,2008,5575.848094708492
STAT,1894,63,na,1957,2703.6500126556166
STAT,1950,6,na,1956,5364.260616125226
SIM,1905,29,20-24,1934,22
STAT,1894,37,30-34,1931,7.906637579812946
STAT,1855,61,na,1916,1590.013678694112
SIM,1915,27,25-29,1942,92
SIM,1941,19,na,1960,3748
STAT,1833,21,30-34,1854,24.96089893923354
STAT,1954,22,40-44,1976,4.81281366461241
SIM,1899,37,50-100,1936,1
STAT,1939,47,15-19,1986,4.427996470238646E-4
SIM,1923,16,na,1939,5223
STAT,1873,38,50-100,1911,1.4397058514123393
SIM,1798,87,na,1885,37
STAT,1884,80,na,1964,1014.8106738728455
STAT,1933,39,35-39,1972,3.795599717276506
SIM,1859,31,20-24,1890,4
STAT,1947,39,50-100,1986,0.5611050386590907
STAT,1824,84,na,1908,205.83574930780617
STAT,1909,88,na,1997,876.4676656272791
STAT,1855,20,30-34,1875,17.963456281534697
STAT,1931,17,15-19,1948,68.56802396888584
STAT,1908,36,20-24,1944,0.2865647857246355
SIM,1964,38,20-24,2002,1
STAT,1989,20,35-39,2009,15.626616166987743
STAT,1901,60,na,1961,3236.563041892086
STAT,1855,25,25-29,1880,41.82686956161605
SIM,1854,46,40-44,1900,1
SIM,1870,9,na,1879,3432
SIM,1823,87,na,1910,388
SIM,1854,39,40-44,1893,14
STAT,1969,38,30-34,2007,2.7042090807358163
STAT,1957,39,20-24,1996,0.41235171379296587
STAT,1876,36,25-29,1912,3.4513533310404716
SIM,1938,37,45-49,1975,1
STAT,1961,28,30-34,1989,58.645586344864434
STAT,1879,4,na,1883,3463.9844471780298
STAT,1839,52,35-39,1891,0.006791066688762917
STAT,1900,22,45-49,1922,1.116659849576931
SIM,1927,36,na,1963,5012
STAT,1927,84,na,2011,1946.070631208673
STAT,1843,41,45-49,1884,1.5661067344328052
STAT,1973,37,45-49,2010,1.0482715586475735
SIM,1941,39,35-39,1980,5
STAT,1920,20,20-24,1940,143.45002781321972
STAT,1844,46,30-34,1890,0.08119558649433586
STAT,1854,41,20-24,1895,0.12996993215388206
SIM,1863,25,25-29,1888,115
SIM,1874,21,45-49,1895,2
STAT,1897,31,25-29,1928,15.870301267343917
STAT,1887,7,na,1894,3369.567107803241
SIM,1913,38,na,1951,4695
SIM,1948,28,15-19,1976,1
STAT,1860,19,20-24,1879,18.794265184666994
SIM,2005,7,na,2012,6473
STAT,1954,34,35-39,1988,13.27220259963024
STAT,1894,73,na,1967,2155.6645814264484
STAT,1958,18,30-34,1976,18.469100832074087
STAT,1922,55,na,1977,4715.730498659652
SIM,1966,18,30-34,1984,20
STAT,1994,19,25-29,2013,72.11966326989953
STAT,1889,31,40-44,1920,6.194491200870425
SIM,1864,96,na,1960,38
STAT,1914,28,45-49,1942,2.0037786619285853
STAT,1837,30,15-19,1867,0.13200572670358593
SIM,1962,34,35-39,1996,36
STAT,1815,46,50-100,1861,0.5088718369012011
STAT,1926,21,na,1947,5134.329320975393
STAT,1890,41,40-44,1931,3.1861007124320895
SIM,1940,18,na,1958,5058
STAT,1830,40,30-34,1870,1.13725821335831
STAT,1934,26,20-24,1960,28.365579208307427
STAT,1922,38,20-24,1960,0.34566044506199955
STAT,1929,23,45-49,1952,1.63706430381433
STAT,1869,74,na,1943,1240.3089330568766
SIM,1807,65,na,1872,869
STAT,1978,24,15-19,2002,8.405836140781618
STAT,1829,30,30-34,1859,24.49646484339625
STAT,1889,36,35-39,1925,10.110148336731134
SIM,1851,41,45-49,1892,4
STAT,1881,15,25-29,1896,6.337107307305856
SIM,1820,35,30-34,1855,20
SIM,1825,40,50-100,1865,1
STAT,1860,8,na,1868,2634.206086539671
STAT,1933,33,50-100,1966,1.2856239976359727
SIM,1975,39,35-39,2014,11
STAT,1863,20,15-19,1883,3.444712097663196
STAT,1874,59,na,1933,2296.100348879542
SIM,1884,14,na,1898,2971
STAT,1967,39,35-39,2006,3.58460521587875
SIM,1902,30,20-24,1932,8
STAT,1907,49,35-39,1956,0.13199787165470953
STAT,1926,36,na,1962,5309.937747463285
SIM,1897,36,35-39,1933,4
STAT,1876,40,45-49,1916,1.8034760211207086
SIM,1942,26,20-24,1968,27
SIM,1925,37,35-39,1962,9
SIM,1815,41,35-39,1856,5
SIM,1868,77,na,1945,942
STAT,1813,47,40-44,1860,0.5678868267823284
STAT,1967,45,20-24,2012,0.016648581013362272
SIM,1916,73,na,1989,2942
SIM,1943,0,na,1943,5817
SIM,1830,30,20-24,1860,2
SIM,1863,20,30-34,1883,57
SIM,1891,70,na,1961,2067
STAT,1905,27,15-19,1932,0.75782947997049
SIM,1877,8,na,1885,3527
STAT,1875,30,35-39,1905,12.174573119755491
STAT,1845,67,na,1912,1068.2068155128359
STAT,1949,48,35-39,1997,0.17949339087409222
STAT,1963,28,15-19,1991,1.0390155520970557
SIM,1926,24,20-24,1950,258
SIM,1958,13,na,1971,6230
SIM,1977,19,45-49,1996,2
STAT,1807,49,30-34,1856,0.38665404018889954
STAT,1969,19,45-49,1988,0.7196699997599003
SIM,1871,20,15-19,1891,3
STAT,1949,20,50-100,1969,0.8866724210314753
SIM,1930,38,20-24,1968,1
SIM,1986,24,15-19,2010,1
STAT,1940,66,na,2006,3836.7630289833146
STAT,1851,23,15-19,1874,3.101713041316475
STAT,1910,26,35-39,1936,16.805983992938405
STAT,1981,19,15-19,2000,73.18666624924963
SIM,1832,64,na,1896,1424
SIM,1815,49,30-34,1864,1
SIM,1883,30,35-39,1913,22
SIM,1930,23,35-39,1953,15
STAT,1982,28,20-24,2010,29.756805697158875
SIM,1910,18,25-29,1928,9
SIM,1943,38,30-34,1981,6
STAT,1895,100,na,1995,29.10105401638082
STAT,1840,31,na,1871,2139.67305668568
STAT,1848,46,15-19,1894,4.262174093832522E-4
STAT,1869,19,40-44,1888,0.20481045288851285
STAT,1833,24,35-39,1857,5.637675590475749
SIM,1899,44,na,1943,3892
SIM,1875,42,45-49,1917,8
SIM,1888,81,na,1969,701
SIM,1944,29,35-39,1973,51
STAT,1863,86,na,1949,223.8975116430407
STAT,1820,91,na,1911,34.00955563476953
STAT,1918,24,20-24,1942,137.50492412837895
STAT,1925,28,20-24,1953,24.785690611163123
STAT,1864,51,40-44,1915,0.010900031920567887
SIM,1951,3,na,1954,6328
STAT,1886,28,50-100,1914,0.7759636354682509
STAT,1900,49,25-29,1949,0.050943615775934356
STAT,1867,42,45-49,1909,1.6106270831408604
STAT,1921,32,30-34,1953,20.226479065426773
STAT,1940,18,45-49,1958,0.5853369252293844
SIM,1940,33,45-49,1973,7
STAT,1872,36,40-44,1908,5.097074906789056
SIM,1877,19,40-44,1896,1
SIM,1976,29,25-29,2005,164
SIM,1877,44,na,1921,3065
STAT,1911,38,45-49,1949,0.7567594016788824
STAT,1971,34,30-34,2005,23.443480917467316
STAT,1936,17,40-44,1953,1.5463307711350134
SIM,1841,24,35-39,1865,10
SIM,1818,39,30-34,1857,12
SIM,1990,20,25-29,2010,172
SIM,1847,94,na,1941,144
STAT,1857,107,na,1964,0.02503948625255277
SIM,1910,39,40-44,1949,4
SIM,1947,38,25-29,1985,1
STAT,1898,37,15-19,1935,0.08758316524686906
SIM,1831,84,na,1915,199
STAT,1976,23,30-34,1999,44.44505691138657
SIM,1856,45,na,1901,2044
SIM,1867,12,na,1879,2720
STAT,1806,50,na,1856,1215.196153755929
STAT,1956,27,45-49,1983,2.6495952487800536
STAT,1906,43,45-49,1949,0.17363694497136328
STAT,1863,96,na,1959,15.17813020113254
SIM,1937,25,35-39,1962,41
SIM,1955,26,50-100,1981,5
SIM,1964,27,45-49,1991,4
STAT,1888,24,25-29,1912,77.17179036315692
STAT,1911,22,20-24,1933,121.80567775979925
STAT,1853,32,15-19,1885,0.1460079324032019
SIM,1896,24,25-29,1920,208
STAT,1902,39,40-44,1941,1.5251852043302165
STAT,1887,40,20-24,1927,0.20746907426886046
STAT,1971,41,30-34,2012,0.19447938826805003
SIM,1837,32,20-24,1869,2
SIM,1980,25,35-39,2005,29
SIM,1890,26,na,1916,3585
STAT,1935,38,30-34,1973,2.9397479964456505
SIM,1896,22,35-39,1918,24
STAT,1888,22,35-39,1910,7.91626402866619
SIM,1828,64,na,1892,1507
STAT,1831,54,na,1885,1683.4503891671206
STAT,1829,32,20-24,1861,3.5062365962385256
STAT,1966,18,15-19,1984,65.39572263730521
STAT,1876,44,na,1920,2720.042325540589
SIM,1989,24,40-44,2013,2
STAT,1939,38,25-29,1977,1.1710933275972162
SIM,1880,36,40-44,1916,1
SIM,1954,39,45-49,1993,1
STAT,1855,45,na,1900,1933.4650283741792
SIM,1863,31,na,1894,2472
STAT,1937,38,15-19,1975,0.02215014952869781
STAT,1911,37,40-44,1948,1.6700534681641062
STAT,1824,107,na,1931,0.0029180020484645777
SIM,1863,46,na,1909,2258
STAT,1866,38,30-34,1904,5.672569936002953
STAT,1846,39,40-44,1885,4.628641977073721
SIM,1933,28,20-24,1961,57
STAT,1888,88,na,1976,575.1418618685971
SIM,1874,38,30-34,1912,5
STAT,1929,25,35-39,1954,21.767666833548667
STAT,1936,76,na,2012,2669.8995618411477
STAT,1972,28,na,2000,5556.593160481468
SIM,1917,48,40-44,1965,1
STAT,1847,40,25-29,1887,0.5097622256403191
STAT,1932,33,45-49,1965,2.4131760144275827
SIM,1904,33,35-39,1937,2
STAT,1884,95,na,1979,106.82659623888486
STAT,1866,21,45-49,1887,0.757426959358489
SIM,1948,23,20-24,1971,255
STAT,1909,73,na,1982,2793.8142914478185
STAT,1909,26,20-24,1935,20.39589538486639
SIM,1868,93,na,1961,62
SIM,1937,20,40-44,1957,7
STAT,1892,48,50-100,1940,0.19786948028585918
STAT,1922,16,35-39,1938,5.615663266802942
SIM,1978,29,35-39,2007,1
STAT,1817,51,45-49,1868,0.04067064361385634
STAT,1842,25,15-19,1867,0.43802578754779287
SIM,1881,49,na,1930,1791
STAT,1971,43,na,2014,5632.590999613958
SIM,1947,20,25-29,1967,281
SIM,1917,26,20-24,1943,42
STAT,1919,66,na,1985,3938.2212237361628
SIM,1928,15,40-44,1943,2
STAT,1960,16,20-24,1976,203.8375566229781
STAT,1827,42,15-19,1869,0.01841849150617245
SIM,1947,50,na,1997,5848
STAT,1902,18,25-29,1920,9.216116494889018
SIM,1831,29,45-49,1860,1
SIM,1884,33,20-24,1917,8
STAT,1901,28,35-39,1929,15.542423682931064
SIM,1881,59,na,1940,1535
SIM,1848,79,na,1927,113
STAT,1946,39,45-49,1985,0.8970692966087246
SIM,1918,39,35-39,1957,7
STAT,1813,51,na,1864,1333.164467259835
STAT,1822,45,40-44,1867,0.33296040867192306
SIM,1895,1,na,1896,4194
SIM,1848,33,35-39,1881,2
STAT,1872,50,50-100,1922,0.017752597605202897
SIM,1910,38,50-100,1948,1
SIM,1850,25,15-19,1875,1
STAT,1862,100,na,1962,3.0270755924585715
STAT,1916,25,25-29,1941,79.08052161448892
STAT,1855,22,20-24,1877,68.50295614634919
STAT,1920,23,25-29,1943,118.09112871356278
SIM,1863,22,20-24,1885,5
STAT,1872,0,na,1872,4299.075530349234
SIM,1934,20,15-19,1954,14
STAT,1912,77,na,1989,2469.788352388368
SIM,1951,40,na,1991,6264
STAT,1880,31,20-24,1911,3.320005344073345
SIM,1962,31,30-34,1993,7
SIM,1984,22,15-19,2006,7
STAT,1912,5,na,1917,4681.232183429967
STAT,1840,18,40-44,1858,0.18885015022512813
SIM,1896,42,50-100,1938,1
STAT,1905,29,50-100,1934,1.060855760362477
SIM,1977,16,40-44,1993,3
STAT,1827,33,25-29,1860,16.899635276828405
STAT,1943,54,na,1997,4554.847352655444
SIM,1839,27,na,1866,2307
STAT,1929,20,40-44,1949,4.936488270982987
STAT,1955,15,35-39,1970,6.431956382436325
STAT,1888,42,50-100,1930,1.4313913450210354
STAT,1877,26,15-19,1903,0.5465139885783739
STAT,1915,46,15-19,1961,4.295156953092782E-4
STAT,1926,20,15-19,1946,7.506247078309492
SIM,1835,33,25-29,1868,1
STAT,1865,42,35-39,1907,1.8831994575826798
SIM,1874,30,35-39,1904,21
SIM,1873,42,35-39,1915,3
SIM,1942,29,25-29,1971,88
SIM,1838,20,20-24,1858,82
STAT,1882,108,na,1990,0.1555164167849044
STAT,1934,29,25-29,1963,102.13376335636889
STAT,1931,48,15-19,1979,5.669685366861489E-4
SIM,1895,34,35-39,1929,21
SIM,1939,22,40-44,1961,8
STAT,1973,34,40-44,2007,5.946006726113696
SIM,1813,41,25-29,1854,2
SIM,1828,80,na,1908,677
STAT,1892,28,30-34,1920,36.29575212792428
STAT,1982,29,50-100,2011,1.6217511103779354
SIM,1898,21,30-34,1919,69
STAT,1887,34,35-39,1921,12.985431385213024
STAT,1870,36,30-34,1906,6.092773940292405
SIM,1928,20,50-100,1948,2
STAT,1880,53,40-44,1933,0.01267108722255674
STAT,1982,17,45-49,1999,0.8112162642525084
STAT,1956,33,50-100,1989,1.2861757029539873
SIM,1932,16,45-49,1948,4
STAT,1929,47,20-24,1976,0.016531570632784105
SIM,1964,33,50-100,1997,5
STAT,1866,23,35-39,1889,6.247773586195239
STAT,1911,45,50-100,1956,0.24848460503740238
SIM,1961,17,na,1978,5656
SIM,1933,11,na,1944,6642
STAT,1797,101,na,1898,0.1699040743488815
SIM,1979,12,na,1991,6470
STAT,1891,32,35-39,1923,14.444418354551521
STAT,1969,16,40-44,1985,2.0169920275425324
SIM,1874,23,35-39,1897,15
STAT,1905,37,na,1942,3966.29320154332
STAT,1897,8,na,1905,4011.4477148016435
STAT,1992,15,50-100,2007,0.620940792608061
STAT,1831,52,40-44,1883,0.00858164660785704
SIM,1924,25,25-29,1949,82
STAT,1860,20,50-100,1880,0.43589987891186194
STAT,1880,34,na,1914,2894.042478510239
SIM,1776,87,na,1863,9
STAT,1967,48,25-29,2015,0.07931771233811014
STAT,1941,36,15-19,1977,0.023544509437508496
STAT,1813,104,na,1917,0.030540100204551966
STAT,1856,31,50-100,1887,0.8251078906406748
STAT,1895,58,na,1953,2970.7310659947725
STAT,1908,39,25-29,1947,1.0545000026624765
STAT,1966,38,50-100,2004,0.622864730609072
STAT,1893,49,30-34,1942,0.07798774208223457
STAT,1924,16,45-49,1940,0.6880052022387455
SIM,1814,51,na,1865,1338
SIM,1832,69,na,1901,1264
SIM,1902,33,25-29,1935,9
SIM,1885,21,20-24,1906,145
SIM,1903,45,na,1948,3606
STAT,1834,46,na,1880,2205.425940484561
STAT,1898,41,35-39,1939,0.19701195239688732
STAT,1872,63,na,1935,2067.655698986959
SIM,1976,16,na,1992,5661
STAT,1849,40,35-39,1889,1.4280336049431686
SIM,1864,31,50-100,1895,2
STAT,1921,29,15-19,1950,0.9011664606192122
SIM,1980,22,30-34,2002,1
STAT,1918,22,30-34,1940,35.76573694516493
SIM,1872,67,na,1939,1911
SIM,1951,27,35-39,1978,35
STAT,1960,19,25-29,1979,65.09253715981414
STAT,1918,27,25-29,1945,80.82062552756929
SIM,1930,20,30-34,1950,51
SIM,1934,22,na,1956,5462
SIM,1971,28,15-19,1999,1
SIM,1899,1,na,1900,4638
STAT,1804,50,30-34,1854,0.02852333637696172
STAT,1838,27,na,1865,2383.6012290277145
SIM,1913,23,na,1936,4367
STAT,1834,29,20-24,1863,13.837636529236564
SIM,1837,35,25-29,1872,6
STAT,1796,86,na,1882,84.49097015619799
STAT,1831,37,50-100,1868,1.2140796720088467
SIM,1828,31,50-100,1859,1
STAT,1853,23,25-29,1876,66.85826315084442
STAT,1966,16,15-19,1982,65.43497776098779
STAT,1928,29,50-100,1957,1.4137349383652462
SIM,1892,81,na,1973,1596
STAT,1901,25,30-34,1926,40.982269842805685
SIM,1974,16,15-19,1990,70
STAT,1930,40,35-39,1970,0.306650314252791
SIM,1929,37,45-49,1966,2
STAT,1887,43,25-29,1930,0.8245170042863844
SIM,1841,46,na,1887,1826
SIM,1842,29,20-24,1871,25
SIM,1972,40,35-39,2012,1
SIM,2013,1,na,2014,7575
STAT,1822,48,45-49,1870,0.4397397563009212
SIM,1902,60,na,1962,3445
STAT,1917,43,20-24,1960,0.021236162352270032
SIM,1937,23,45-49,1960,4
SIM,1944,26,30-34,1970,82
STAT,1967,27,20-24,1994,26.42800091779769
STAT,1895,1,na,1896,4088.765985559489
STAT,1886,22,na,1908,2879.000033741534
STAT,1899,18,15-19,1917,9.358359458708584
STAT,1930,42,50-100,1972,0.1784084892944178
SIM,1926,27,25-29,1953,130
SIM,1976,24,30-34,2000,57
STAT,1806,65,na,1871,827.4572977266957
STAT,1907,31,45-49,1938,1.707134783391734
SIM,1878,20,25-29,1898,83
STAT,1917,37,35-39,1954,2.8993579359055865
SIM,1879,41,25-29,1920,1
STAT,1971,37,35-39,2008,3.642334421191751
SIM,1858,46,25-29,1904,1
STAT,1852,44,15-19,1896,0.01284434603963746
STAT,1996,16,30-34,2012,20.44846973500611
SIM,1897,31,40-44,1928,15
SIM,1837,30,30-34,1867,11
STAT,1996,19,na,2015,6169.137915942423
STAT,1841,23,50-100,1864,0.45599668399276844
STAT,1980,20,15-19,2000,8.562277723145366
SIM,1915,31,45-49,1946,5
SIM,1848,48,30-34,1896,1
STAT,1886,106,na,1992,0.798830648468065
STAT,1955,37,20-24,1992,0.4160683332170147
SIM,1977,36,40-44,2013,3
STAT,1831,31,25-29,1862,10.539249578468969
STAT,1964,40,35-39,2004,0.3050181228827882
SIM,1841,39,30-34,1880,8
SIM,1859,27,25-29,1886,4
SIM,1929,5,na,1934,5572
SIM,1976,24,na,2000,5566
STAT,1954,17,na,1971,5251.214852447923
STAT,1960,39,50-100,1999,0.6487784145090287
STAT,1944,17,25-29,1961,53.82171268315633
SIM,1949,37,20-24,1986,1
STAT,1942,15,25-29,1957,52.299836078750005
STAT,1811,47,30-34,1858,0.3017390993768021
SIM,1861,23,25-29,1884,115
SIM,1884,36,25-29,1920,2
STAT,1902,15,20-24,1917,29.04295369989988
SIM,1918,36,30-34,1954,2
SIM,1950,15,25-29,1965,68
STAT,1833,39,30-34,1872,4.626932494880187
SIM,1862,44,25-29,1906,2
SIM,1944,62,na,2006,4110
STAT,1824,68,na,1892,945.574065342713
STAT,1912,26,45-49,1938,1.9733836675272742
SIM,1876,20,40-44,1896,5
STAT,1800,101,na,1901,0.30790094351243324
STAT,1969,36,40-44,2005,2.225400301856815
STAT,1862,32,15-19,1894,0.13869544915185894
STAT,1965,25,20-24,1990,26.436191109597257
SIM,1935,6,na,1941,6524
SIM,1958,17,50-100,1975,2
STAT,1868,20,40-44,1888,2.3439987603271297
STAT,1921,35,35-39,1956,3.12101173490374
STAT,1915,15,50-100,1930,0.09092951013716533
STAT,1928,44,35-39,1972,0.29525886482413655
STAT,1828,51,20-24,1879,6.694616982278074E-4
STAT,1943,33,20-24,1976,3.0410948261571673
SIM,1951,33,20-24,1984,1
STAT,1936,14,na,1950,4366.255689676374
STAT,1829,35,25-29,1864,3.437440643320527
SIM,1969,21,15-19,1990,10
SIM,1926,22,30-34,1948,1
SIM,1933,19,30-34,1952,42
SIM,1936,29,50-100,1965,1
STAT,1943,27,35-39,1970,18.454535476119094
STAT,1925,19,30-34,1944,16.89565144656992
SIM,1911,27,30-34,1938,89
STAT,1775,87,na,1862,73.62967923071889
SIM,1904,24,45-49,1928,2
SIM,1955,21,na,1976,5784
STAT,1903,27,30-34,1930,41.393432741948295
STAT,1975,16,na,1991,5605.41185090378
SIM,1904,30,30-34,1934,65
SIM,1854,10,na,1864,3223
STAT,1900,39,30-34,1939,1.8235675516651546
STAT,1923,56,na,1979,4773.165775073303
STAT,1925,47,35-39,1972,0.18024088164384428
SIM,1865,97,na,1962,23
STAT,1875,39,25-29,1914,3.3991585225232104
STAT,1845,22,15-19,1867,2.759789923987818
SIM,1937,23,35-39,1960,25
STAT,1932,23,50-100,1955,0.9935076177370485
STAT,1856,34,40-44,1890,3.7855685051914705
SIM,1860,8,na,1868,3015
SIM,1903,76,na,1979,1821
STAT,1915,34,45-49,1949,1.833997691399644
STAT,1889,40,30-34,1929,1.651985308968067
STAT,1849,27,na,1876,1987.5494216741374
SIM,1923,34,45-49,1957,5
STAT,1949,47,20-24,1996,0.015428038298099016
STAT,1941,31,35-39,1972,11.081770357366825
STAT,1911,18,25-29,1929,9.989934077189313
STAT,1841,47,na,1888,2009.3794806523363
STAT,1918,44,40-44,1962,0.3058173328676298
SIM,1951,24,na,1975,5814
SIM,1848,40,35-39,1888,5
SIM,1907,39,35-39,1946,6
SIM,1966,27,20-24,1993,49
SIM,1783,88,na,1871,95
STAT,1784,85,na,1869,90.69197841031328
STAT,1934,27,35-39,1961,23.319730298669036
STAT,1881,99,na,1980,25.458479450652433
SIM,1883,39,25-29,1922,13
STAT,1825,45,20-24,1870,0.017228253153807275
SIM,1853,22,15-19,1875,11
STAT,1930,29,15-19,1959,1.0350402690370482
SIM,1910,34,35-39,1944,10
SIM,1958,47,25-29,2005,1
SIM,1844,24,15-19,1868,5
SIM,1917,46,40-44,1963,2
SIM,1876,25,20-24,1901,26
STAT,1814,45,45-49,1859,0.6777568801872954
STAT,1833,21,40-44,1854,2.920105268610234
STAT,1920,16,25-29,1936,56.22290922789004
STAT,1959,45,25-29,2004,0.08368325826458127
STAT,1861,16,20-24,1877,19.665572012146963
STAT,1902,41,25-29,1943,0.07304312289163047
SIM,1841,21,40-44,1862,4
SIM,1912,37,na,1949,3758
SIM,1965,20,na,1985,4841
SIM,1908,26,20-24,1934,37
SIM,1942,27,35-39,1969,28
STAT,1936,19,na,1955,4047.3912462413887
SIM,1933,29,35-39,1962,46
STAT,1868,28,25-29,1896,46.73734935000346
SIM,1926,44,40-44,1970,2
STAT,1904,73,na,1977,2601.4752890411037
SIM,1813,47,45-49,1860,1
STAT,1836,42,15-19,1878,0.014956484299292165
STAT,1885,65,na,1950,1945.331501030024
SIM,1952,34,40-44,1986,13
STAT,1895,95,na,1990,164.73509407893877
STAT,1926,34,20-24,1960,3.3986252241806008
STAT,1853,53,30-34,1906,0.005831315461182365
STAT,1954,15,40-44,1969,1.9965578796643515
SIM,1972,19,45-49,1991,1
STAT,1958,27,20-24,1985,27.78772584221482
SIM,1899,38,20-24,1937,2
SIM,1982,16,na,1998,6060
STAT,1883,22,35-39,1905,6.588795529693714
STAT,1902,34,35-39,1936,9.400857919027409
STAT,1970,32,na,2002,5569.250090177524
STAT,1944,18,na,1962,4569.989186947877
STAT,1947,45,45-49,1992,0.2952583942576779
SIM,1962,15,40-44,1977,6
STAT,1850,54,45-49,1904,0.014528913970207006
STAT,1907,29,15-19,1936,0.7584315068368925
SIM,1933,47,35-39,1980,1
STAT,1923,7,na,1930,5414.885178498506
STAT,1897,22,35-39,1919,9.00492664916296
STAT,1841,46,15-19,1887,3.6185440604390737E-4
STAT,1946,29,50-100,1975,1.278273687058575
STAT,1975,39,30-34,2014,2.8526523022321197
SIM,1886,59,na,1945,1598
SIM,1924,38,na,1962,4920
SIM,1955,27,45-49,1982,1
STAT,1943,29,25-29,1972,80.82559853950103
SIM,1847,68,na,1915,1705
SIM,1793,62,na,1855,1334
SIM,1915,29,15-19,1944,2
SIM,1839,33,na,1872,2193
STAT,1905,27,na,1932,3986.2630398821093
STAT,1851,21,na,1872,2039.4297893836085
SIM,1921,19,15-19,1940,107
SIM,1859,41,na,1900,2287
STAT,1913,19,15-19,1932,10.656587144493663
SIM,1910,16,35-39,1926,3
STAT,1915,41,35-39,1956,0.23433987792829494
STAT,1947,27,45-49,1974,2.255529033504924
STAT,1900,46,20-24,1946,0.010870351425175699
SIM,1934,34,20-24,1968,7
SIM,1951,29,25-29,1980,8
STAT,1876,13,na,1889,3084.910291170199
SIM,1930,62,na,1992,5448
STAT,1835,90,na,1925,49.13769246409573
STAT,1960,35,35-39,1995,3.752019113578335
STAT,1929,23,35-39,1952,13.699642303095507
STAT,1883,2,na,1885,3559.358766940017
SIM,1940,26,45-49,1966,6
STAT,1872,43,40-44,1915,2.5876372793801368
STAT,1891,38,50-100,1929,1.7424661102894434
STAT,1916,74,na,1990,3001.9227755673596
SIM,1902,26,25-29,1928,11
STAT,1933,19,15-19,1952,69.76568142754583
STAT,1893,102,na,1995,10.999161724375993
STAT,1865,47,15-19,1912,4.1456032386551954E-4
STAT,1928,25,40-44,1953,6.67178282201696
STAT,1919,35,na,1954,4689.29229196724
SIM,1929,79,na,2008,2523
STAT,1932,26,45-49,1958,2.6132044632563374
SIM,1888,38,45-49,1926,4
SIM,1850,37,20-24,1887,2
STAT,1904,39,15-19,1943,0.019884114171739
SIM,1880,43,40-44,1923,6
STAT,1941,25,50-100,1966,1.1896051927081739
SIM,1879,32,35-39,1911,23
STAT,1917,36,20-24,1953,0.31751007924632396
SIM,1960,24,20-24,1984,2
STAT,1964,19,45-49,1983,0.7256060058279917
STAT,1926,16,20-24,1942,192.25975341822084
STAT,1804,53,35-39,1857,0.038838289163631155
STAT,1952,24,20-24,1976,154.1821659430638
SIM,1843,26,20-24,1869,23
STAT,1896,47,45-49,1943,0.20197251866599963
SIM,1836,29,na,1865,1711
STAT,1850,16,45-49,1866,0.0826604023286634
STAT,1892,20,35-39,1912,8.491000408256866
STAT,1842,37,20-24,1879,0.6958538940250681
SIM,1934,16,20-24,1950,394
STAT,1920,23,15-19,1943,6.8055080574467235
STAT,1944,40,50-100,1984,0.15205392114249655
STAT,1835,26,20-24,1861,9.643095321881033
SIM,1977,26,25-29,2003,106
STAT,1839,20,20-24,1859,71.23942828979547
STAT,1978,19,45-49,1997,0.7862346409885753
STAT,1851,38,25-29,1889,2.28380085914299
SIM,1925,18,20-24,1943,321
SIM,1928,68,na,1996,4655
STAT,1815,86,na,1901,123.11502025887457
SIM,1893,17,20-24,1910,42
STAT,1869,41,15-19,1910,0.015503815437408603
STAT,1946,13,na,1959,5027.118290163905
SIM,1852,15,na,1867,2428
STAT,1845,40,15-19,1885,0.009722243222551002
STAT,1958,47,30-34,2005,0.14054673792764594
STAT,1970,27,45-49,1997,2.5065481543024157
STAT,1830,50,25-29,1880,0.003285216540033233
SIM,1918,38,na,1956,3833
STAT,1894,15,20-24,1909,26.423169510082023
STAT,1885,17,20-24,1902,20.407476679497616
SIM,1864,105,na,1969,1
STAT,1846,78,na,1924,807.7277633668967
SIM,1847,20,20-24,1867,129
SIM,1938,42,na,1980,4052
STAT,1917,18,20-24,1935,33.581650522246
STAT,1995,16,25-29,2011,72.41325597172246
STAT,1905,108,na,2013,0.3063169848689046
STAT,1912,23,40-44,1935,3.710794382477858
SIM,1976,32,50-100,2008,1
STAT,1921,21,na,1942,4772.645394745968
SIM,1986,21,20-24,2007,329
STAT,1810,55,na,1865,1456.7768363285284
SIM,1852,24,20-24,1876,78
STAT,1925,35,na,1960,5218.412356992644
STAT,1814,69,na,1883,1082.8317653478746
SIM,1985,6,na,1991,6448
STAT,1840,35,45-49,1875,1.9311274302535857
SIM,1959,20,na,1979,5615
STAT,1887,60,na,1947,2466.599362031976
STAT,1944,37,45-49,1981,0.8722945960032708
STAT,1898,49,20-24,1947,0.010337043484357643
STAT,1934,45,35-39,1979,0.20837991849651705
STAT,1973,41,40-44,2014,0.38852882435016095
STAT,1906,44,na,1950,3850.268498460111
SIM,1901,36,35-39,1937,4
SIM,1878,24,na,1902,2979
STAT,1844,24,20-24,1868,70.93751779985331
STAT,1973,17,45-49,1990,0.7455874054550331
SIM,1941,19,15-19,1960,47
STAT,1949,24,15-19,1973,7.163356850213569
STAT,1895,31,15-19,1926,0.21479789227078752
STAT,1983,8,na,1991,6416.093237683225
SIM,1920,23,40-44,1943,11
SIM,1873,46,50-100,1919,1
SIM,1936,25,40-44,1961,2
STAT,1840,53,45-49,1893,0.011454957777670291
STAT,1908,37,35-39,1945,2.616779560554457
STAT,1821,86,na,1907,135.6976293311054
STAT,1835,47,na,1882,1477.9773237225759
STAT,1900,43,na,1943,3687.0704954709227
STAT,1938,47,45-49,1985,0.2574788791571442
SIM,1884,24,na,1908,2869
STAT,1938,29,45-49,1967,1.9742264269597887
STAT,1889,33,40-44,1922,6.14324526167938
SIM,1928,37,50-100,1965,2
SIM,1944,56,na,2000,4366
STAT,1770,113,na,1883,2.2918997122755157E-4
SIM,1897,33,40-44,1930,10
STAT,1927,32,15-19,1959,0.18238685590292258
STAT,1882,36,50-100,1918,1.3905909907229734
STAT,1957,54,na,2011,5662.633108002498
STAT,1915,21,na,1936,4370.256598767805
STAT,1937,27,50-100,1964,1.1203305943242001
STAT,1820,69,na,1889,854.7475755964183
STAT,1938,21,35-39,1959,10.763327883209557
SIM,1896,89,na,1985,776
STAT,1972,37,40-44,2009,2.2788637702112733
STAT,1957,37,30-34,1994,2.857043813670897
SIM,1902,23,na,1925,4195
SIM,1906,37,na,1943,3628
SIM,1907,36,30-34,1943,2
SIM,1964,3,na,1967,5979
STAT,1875,36,20-24,1911,0.9237355440412607
STAT,1814,42,40-44,1856,7.699151417599834
STAT,1907,17,20-24,1924,30.102597587126155
SIM,1958,38,25-29,1996,4
STAT,1910,41,30-34,1951,0.14038595967457335
STAT,1882,24,40-44,1906,2.334196054624105
SIM,1814,41,na,1855,1503
STAT,1869,19,30-34,1888,1.7847767325930701
SIM,1946,26,40-44,1972,12
STAT,1840,50,40-44,1890,0.00856665893118298
SIM,1825,29,na,1854,1941
STAT,1921,20,25-29,1941,121.07515206863135
STAT,1902,4,na,1906,4289.673129331475
SIM,1965,16,na,1981,4911
STAT,1922,45,45-49,1967,0.28937380870242635
STAT,1911,15,20-24,1926,31.48150232581832
STAT,1809,54,50-100,1863,0.03502451238625754
SIM,1961,22,15-19,1983,5
STAT,1938,44,40-44,1982,0.2950736749483784
STAT,1950,18,na,1968,5020.951481897638
STAT,1961,32,15-19,1993,0.1953028308686156
STAT,1886,15,15-19,1901,7.257759478904166
STAT,1829,33,50-100,1862,1.1458454167386367
SIM,1910,31,30-34,1941,1
STAT,1900,15,45-49,1915,0.10509057127973816
STAT,1963,39,40-44,2002,2.256398008528211
STAT,1978,31,15-19,2009,0.20642142829749952
SIM,1833,21,35-39,1854,12
STAT,1847,31,35-39,1878,9.24466809979544
SIM,1986,24,25-29,2010,10
STAT,1894,25,15-19,1919,0.6776519376715902
SIM,1971,39,40-44,2010,4
SIM,1843,31,50-100,1874,1
STAT,1854,51,25-29,1905,0.002899474034980426
STAT,1903,31,15-19,1934,0.23504311341064557
STAT,1951,18,20-24,1969,186.25332527723572
STAT,1868,25,20-24,1893,13.095700225861954
STAT,1883,46,20-24,1929,0.013587576378007353
STAT,1943,26,20-24,1969,22.447669038018528
SIM,1901,17,20-24,1918,49
SIM,1946,44,40-44,1990,3
SIM,1863,15,na,1878,2783
STAT,1835,78,na,1913,486.9686712621249
SIM,1901,37,na,1938,4112
SIM,1870,96,na,1966,138
SIM,1916,67,na,1983,3740
SIM,1855,31,35-39,1886,3
STAT,1830,43,35-39,1873,1.7138720835253114
STAT,1891,37,15-19,1928,0.08009427231308743
SIM,1882,97,na,1979,158
SIM,1882,29,na,1911,3166
STAT,1851,53,20-24,1904,5.75770785238476E-4
STAT,1978,24,25-29,2002,145.86048084389193
STAT,1863,15,50-100,1878,0.05708410982340023
STAT,1951,37,50-100,1988,0.5944322725291422
STAT,1953,22,15-19,1975,7.4560164737256756
SIM,1822,42,40-44,1864,6
STAT,1822,52,40-44,1874,0.01915053837101692
SIM,1973,18,20-24,1991,205
SIM,1933,26,30-34,1959,106
STAT,1899,57,na,1956,3202.5538837202257
SIM,1982,32,45-49,2014,5
SIM,1907,29,40-44,1936,6
SIM,1964,39,50-100,2003,3
STAT,1911,35,40-44,1946,1.6859141683174002
SIM,1951,26,20-24,1977,39
SIM,1948,16,20-24,1964,343
STAT,1968,39,40-44,2007,2.2183117302266995
SIM,1826,34,20-24,1860,3
STAT,1965,18,20-24,1983,195.26919109532417
SIM,1926,47,45-49,1973,1
STAT,1867,102,na,1969,2.4718925366293383
SIM,1876,28,25-29,1904,99
SIM,1912,53,na,1965,3565
STAT,1893,56,na,1949,2975.251951495159
STAT,1902,16,35-39,1918,0.8969379980400322
STAT,1861,54,20-24,1915,6.8849661345741E-4
STAT,1925,44,30-34,1969,0.1779737446531098
SIM,1958,34,na,1992,6171
STAT,1816,64,na,1880,1001.4996467924576
SIM,1907,38,na,1945,4475
STAT,1974,32,45-49,2006,2.4170851320662816
SIM,1861,67,na,1928,1191
STAT,1918,47,45-49,1965,0.2668537073236371
SIM,1927,27,50-100,1954,2
STAT,1894,43,15-19,1937,0.0014124115402720755
STAT,1866,30,35-39,1896,10.919609823161954
STAT,1819,38,50-100,1857,3.2297122472479916
STAT,1829,78,na,1907,572.3881825932698
STAT,1922,28,50-100,1950,1.2946623059663906
STAT,1929,16,45-49,1945,0.7375667108949762
SIM,1977,17,na,1994,5493
SIM,1838,44,40-44,1882,1
SIM,1917,80,na,1997,2198
STAT,1960,17,35-39,1977,6.307133466016395
STAT,1765,105,na,1870,0.0017346692843875342
STAT,1976,37,25-29,2013,1.5639861781088034
SIM,1984,21,na,2005,5851
SIM,1887,21,30-34,1908,51
STAT,1791,105,na,1896,0.006276556965701423
SIM,1901,49,50-100,1950,2
STAT,1879,21,30-34,1900,21.528939578509178
SIM,1887,35,50-100,1922,5
STAT,1837,26,na,1863,2025.1087877768043
STAT,1889,36,45-49,1925,2.849522137528388
STAT,1944,34,40-44,1978,4.94783006578911
SIM,1771,87,na,1858,15
STAT,1831,37,45-49,1868,1.9713019353822805
SIM,1841,31,35-39,1872,19
STAT,1917,39,25-29,1956,1.1730817075253939
SIM,1857,49,25-29,1906,1
STAT,1812,105,na,1917,0.012872752387484627
SIM,1889,26,45-49,1915,1
STAT,1828,65,na,1893,1121.627135952628
STAT,1962,48,35-39,2010,0.19774908662596796
SIM,1804,83,na,1887,172
STAT,1816,47,20-24,1863,0.024472950446558034
SIM,1888,54,na,1942,2428
SIM,1972,16,40-44,1988,6
STAT,1948,40,35-39,1988,0.2771403378123854
STAT,1915,16,45-49,1931,0.12097504507342176
STAT,1964,16,40-44,1980,2.033628648380944
STAT,1896,44,40-44,1940,0.23487114597397027
STAT,1824,90,na,1914,48.78269544390458
SIM,1923,16,45-49,1939,3
STAT,1886,43,na,1929,2793.1738457374804
SIM,1897,36,45-49,1933,2
STAT,1833,31,35-39,1864,9.360492335695549
STAT,1863,45,40-44,1908,0.17448199916730844
STAT,1938,26,40-44,1964,5.334079975098623
STAT,1940,48,15-19,1988,4.4786394620866226E-4
STAT,1802,72,na,1874,760.1462748421992
SIM,1877,19,30-34,1896,3
STAT,1768,90,na,1858,27.02580949044396
STAT,1978,16,40-44,1994,2.2035502427234603
STAT,1894,18,25-29,1912,8.384787955295165
STAT,1820,54,50-100,1874,0.01425114033500427
SIM,1777,88,na,1865,71
STAT,1964,34,40-44,1998,5.790535490210267
STAT,1871,36,35-39,1907,8.159692541692525
SIM,1881,44,na,1925,1855
STAT,1912,20,50-100,1932,0.7327800175837408
SIM,1971,16,na,1987,5467
STAT,1876,60,na,1936,2275.225020418989
STAT,1981,32,na,2013,6221.092088865992
SIM,1968,18,40-44,1986,2
STAT,1980,35,50-100,2015,0.6941885404081758
SIM,1832,70,na,1902,1153
STAT,1887,49,45-49,1936,0.16857706760701047
SIM,1864,34,40-44,1898,6
STAT,1870,99,na,1969,13.479503383404696
STAT,1852,5,na,1857,2867.3342592911604
STAT,1959,42,20-24,2001,0.027705662968377096
STAT,1833,24,45-49,1857,0.6736845577032204
STAT,1970,24,40-44,1994,4.870103353690129
SIM,1886,17,30-34,1903,5
SIM,1842,84,na,1926,387
STAT,1873,21,35-39,1894,6.897816471886278
SIM,1889,33,35-39,1922,29
STAT,1932,21,na,1953,5547.638259218827
STAT,1963,16,45-49,1979,0.7326128622905548
STAT,1889,43,35-39,1932,2.5573995290643876
STAT,1941,24,45-49,1965,1.3413208062632422
STAT,1832,48,15-19,1880,3.2414587775657323E-4
STAT,1840,32,40-44,1872,4.237301107031895
SIM,1995,18,40-44,2013,2
SIM,1824,44,na,1868,1543
SIM,1818,36,50-100,1854,2
STAT,1818,37,25-29,1855,4.747176075259857
STAT,1967,37,na,2004,5587.508436660524
STAT,1907,31,35-39,1938,9.914007698700592
STAT,1952,32,25-29,1984,13.029284065174172
SIM,1868,62,na,1930,2440
STAT,1897,21,20-24,1918,106.66225333163705
STAT,1939,35,45-49,1974,0.8130625486346896
SIM,1933,42,na,1975,6387
STAT,1953,22,na,1975,5114.958037609764
SIM,1856,21,25-29,1877,107
STAT,1821,42,30-34,1863,2.2178972563277894
SIM,1944,30,50-100,1974,2
SIM,1908,27,35-39,1935,38
STAT,1961,38,35-39,1999,3.7116823101806578
SIM,1975,29,30-34,2004,76
SIM,1930,42,40-44,1972,2
STAT,1882,27,45-49,1909,1.2515503344338548
STAT,1853,87,na,1940,175.40893396354963
SIM,1934,35,35-39,1969,5
STAT,1829,48,45-49,1877,0.23762452139568513
SIM,1828,58,na,1886,1732
SIM,1966,33,na,1999,5644
STAT,1896,23,50-100,1919,0.6196685415398571
STAT,1990,20,30-34,2010,47.690789427609936
STAT,1848,21,25-29,1869,74.59632503458607
SIM,1891,33,50-100,1924,1
STAT,1926,35,35-39,1961,3.4166019081635577
STAT,1893,27,20-24,1920,17.11288548986597
STAT,1923,38,50-100,1961,0.5606470731463056
SIM,1951,46,40-44,1997,1
STAT,1903,37,35-39,1940,2.50943624084232
STAT,1844,34,15-19,1878,0.13951165415683278
STAT,1867,32,15-19,1899,0.15344262068349412
STAT,1863,39,50-100,1902,1.2264584421937454
SIM,1960,32,25-29,1992,16
STAT,1961,30,25-29,1991,14.062950028022291
SIM,1941,21,35-39,1962,1
STAT,1870,24,15-19,1894,3.7298826248325274
SIM,1913,22,35-39,1935,24
SIM,1958,35,20-24,1993,1
STAT,1800,93,na,1893,15.769635915083109
STAT,1888,78,na,1966,1470.6228007327973
SIM,1946,24,50-100,1970,1
STAT,1922,42,40-44,1964,0.3311740080566182
SIM,1881,21,35-39,1902,13
SIM,1973,25,45-49,1998,7
SIM,1919,16,na,1935,5259
SIM,1911,37,35-39,1948,4
STAT,1848,45,50-100,1893,0.2635584317260338
STAT,1868,24,50-100,1892,0.44931429827234715
STAT,1905,22,35-39,1927,9.747132620514
STAT,1880,65,na,1945,2067.231837531354
STAT,1884,79,na,1963,1081.7954480138637
SIM,1856,76,na,1932,898
SIM,1892,28,na,1920,3758
STAT,1935,48,35-39,1983,0.20958676579047456
SIM,1915,24,45-49,1939,3
STAT,1855,38,45-49,1893,1.6878355572283747
STAT,1903,95,na,1998,191.73577502628788
SIM,1920,25,30-34,1945,15
STAT,1987,25,30-34,2012,64.88868907729585
STAT,1858,31,na,1889,2170.7866536777237
STAT,1939,17,45-49,1956,0.5772940242068344
STAT,1853,47,25-29,1900,0.05708029562342244
SIM,1958,2,na,1960,6245
STAT,1821,55,na,1876,1386.1121829777096
STAT,1826,105,na,1931,0.01614412427423503
STAT,1981,32,35-39,2013,15.0316908012806
STAT,1806,81,na,1887,215.40194391420653
STAT,1895,27,na,1922,3585.016058527173
SIM,1947,35,45-49,1982,2
STAT,1870,39,25-29,1909,3.242763481090014
STAT,1970,26,30-34,1996,56.874613504990364
STAT,1857,18,20-24,1875,18.61832741959126
STAT,1791,71,na,1862,653.6785969746005
STAT,1795,85,na,1880,78.04901667462163
STAT,1913,30,50-100,1943,0.9574534080605812
STAT,1914,35,na,1949,4378.245821496885
STAT,1965,32,35-39,1997,13.42062233874597
STAT,1923,44,45-49,1967,0.2236584227463993
STAT,1857,22,40-44,1879,2.1622126659586507
STAT,1881,25,40-44,1906,3.3570713534780103
SIM,1826,37,25-29,1863,8
STAT,1987,18,40-44,2005,2.303643667807078
SIM,1958,17,20-24,1975,410
STAT,1820,45,20-24,1865,0.013276613459976237
STAT,1785,71,na,1856,394.3258821
STAT,1789,85,na,1874,71.9164194374316
SIM,1915,31,35-39,1946,14
STAT,1818,44,15-19,1862,0.017475895575236457
SIM,1960,25,35-39,1985,50
STAT,1935,40,25-29,1975,0.11662602229411145
SIM,1879,31,20-24,1910,7
STAT,1866,39,na,1905,2494.7352670612213
STAT,1952,25,35-39,1977,20.871197537685976
SIM,1921,58,na,1979,4917
STAT,1849,46,20-24,1895,0.009327225743745615
SIM,1956,26,20-24,1982,59
STAT,1912,25,30-34,1937,44.90627926762773
STAT,1824,99,na,1923,1.171832494615603
SIM,1853,32,na,1885,2352
SIM,1829,41,35-39,1870,3
STAT,1832,25,45-49,1857,1.0986977138055316
STAT,1934,56,na,1990,5689.647841053829
STAT,1878,79,na,1957,932.618614185104
STAT,1962,45,30-34,2007,0.1377558556450474
STAT,1866,16,20-24,1882,19.57985277398018
SIM,1947,28,20-24,1975,50
STAT,1896,47,50-100,1943,0.21018834958856958
STAT,1868,35,15-19,1903,0.06285367328214267
STAT,1876,5,na,1881,3264.250052771511
SIM,1869,22,25-29,1891,2
STAT,1948,26,20-24,1974,24.222537702305633
STAT,1874,65,na,1939,1996.6015438281654
SIM,1878,18,30-34,1896,1
STAT,1920,33,40-44,1953,4.923765458913488
SIM,1907,19,15-19,1926,20
STAT,1932,23,40-44,1955,5.076823557278143
SIM,2011,3,na,2014,7164
STAT,1846,15,40-44,1861,0.24034802461677546
SIM,1940,23,40-44,1963,10
SIM,1880,46,45-49,1926,1
SIM,1950,15,15-19,1965,53
STAT,1872,46,45-49,1918,0.27425377365763653
SIM,1914,15,40-44,1929,3
SIM,1951,32,50-100,1983,1
SIM,1976,30,na,2006,5989
STAT,1916,25,15-19,1941,0.8481756114199669
STAT,1925,26,30-34,1951,53.57436339680737
STAT,1973,27,50-100,2000,1.4920252604985063
STAT,1843,28,25-29,1871,51.86041271500645
STAT,1887,21,50-100,1908,0.528997001525502
STAT,1822,40,25-29,1862,1.385407728004484
STAT,1906,15,40-44,1921,0.30923234648600173
SIM,1827,28,30-34,1855,1
SIM,1874,16,20-24,1890,33
STAT,1851,52,na,1903,1698.3612078699462
STAT,1880,34,35-39,1914,12.281784974705065
SIM,1843,70,na,1913,1068
STAT,1838,35,50-100,1873,1.3104313456458552
STAT,1879,24,35-39,1903,6.987842968932258
SIM,1851,28,25-29,1879,7
SIM,1978,20,50-100,1998,2
SIM,1887,24,35-39,1911,2
SIM,1934,17,35-39,1951,15
STAT,1877,33,15-19,1910,0.17023114932479658
STAT,1873,80,na,1953,729.0094509736017
STAT,1926,17,35-39,1943,5.935980831079319
SIM,1988,15,45-49,2003,1
STAT,1877,94,na,1971,113.93280771608246
SIM,1959,45,na,2004,5871
STAT,1818,99,na,1917,0.837962641878517
SIM,1923,53,na,1976,5129
SIM,1933,19,40-44,1952,7
STAT,1824,48,50-100,1872,0.3292338213489723
SIM,1868,18,25-29,1886,11
STAT,1804,86,na,1890,96.47154090362783
SIM,1825,38,25-29,1863,2
SIM,1862,44,35-39,1906,7
SIM,1978,11,na,1989,6038
SIM,1889,30,30-34,1919,6
STAT,1820,38,na,1858,1657.3025494884732
STAT,1971,23,40-44,1994,4.929254388945027
STAT,1965,25,45-49,1990,2.502008046070928
SIM,1908,76,na,1984,1929
STAT,1879,42,35-39,1921,2.1793783143707293
STAT,1916,18,25-29,1934,10.583811755839166
STAT,1904,105,na,2009,2.5133368738162747
STAT,1925,19,40-44,1944,1.9388453252586295
STAT,1992,11,na,2003,6507.894694795681
SIM,1875,37,20-24,1912,3
STAT,1942,15,15-19,1957,54.77164392232151
SIM,1839,32,40-44,1871,6
STAT,1942,35,50-100,1977,0.5226626717742157
SIM,1849,24,15-19,1873,4
SIM,1838,21,35-39,1859,7
SIM,1977,22,25-29,1999,2
STAT,1912,49,15-19,1961,4.0655069644213025E-4
STAT,1974,16,20-24,1990,204.35961474024728
SIM,1887,42,35-39,1929,8
STAT,1883,15,45-49,1898,0.0740978135364468
SIM,1935,79,na,2014,3317
STAT,1867,37,20-24,1904,0.8305807560273037
SIM,1902,54,na,1956,3590
SIM,1982,16,20-24,1998,400
SIM,1857,0,na,1857,3910
STAT,1880,41,25-29,1921,0.7890672244661293
STAT,1951,34,30-34,1985,22.041244470376473
STAT,1817,38,25-29,1855,10.079383931160123
SIM,1853,18,30-34,1871,3
STAT,1969,22,25-29,1991,133.60239263083017
SIM,1889,23,40-44,1912,7
STAT,1905,15,45-49,1920,0.10961657744195298
SIM,1837,33,50-100,1870,3
STAT,1927,41,50-100,1968,0.17024156707146795
STAT,1939,28,20-24,1967,21.176136211078916
SIM,1868,31,45-49,1899,3
STAT,1867,42,50-100,1909,1.136913231900283
SIM,1903,30,25-29,1933,5
SIM,1874,62,na,1936,1901
STAT,1877,54,30-34,1931,0.00694920556919496
STAT,1865,46,50-100,1911,0.2564585627268018
STAT,1906,33,40-44,1939,4.172904747631771
SIM,1839,28,20-24,1867,2
SIM,1969,35,30-34,2004,5
STAT,1951,16,30-34,1967,16.755007829822866
STAT,1894,78,na,1972,1729.2025465371507
STAT,1871,13,na,1884,3017.6129388960653
STAT,1834,34,50-100,1868,1.049037555901422
SIM,1869,47,na,1916,1805
SIM,1822,49,na,1871,1494
STAT,1931,36,20-24,1967,0.4033520869698993
STAT,1905,90,na,1995,601.2955701546027
STAT,1926,42,25-29,1968,0.10157325337541229
SIM,1914,33,40-44,1947,1
SIM,1890,57,na,1947,2889
SIM,1957,24,15-19,1981,12
STAT,1961,47,50-100,2008,0.35077437884584917
STAT,1945,33,40-44,1978,5.025584912041968
SIM,1847,99,na,1946,25
STAT,1845,18,30-34,1863,1.3494930804312018
STAT,1948,36,15-19,1984,0.026152205420496753
STAT,1770,93,na,1863,3.0941110075132254
SIM,1969,44,na,2013,5697
STAT,1939,32,40-44,1971,4.609823693587313
STAT,1945,48,15-19,1993,4.816925079838123E-4
STAT,1966,45,15-19,2011,5.548974961801015E-4
SIM,1865,50,35-39,1915,1
STAT,1857,50,35-39,1907,0.007849111403730756
STAT,1847,30,20-24,1877,2.4932898062668003
SIM,1890,36,50-100,1926,7
STAT,1952,34,15-19,1986,0.18091856240677306
STAT,1790,106,na,1896,0.0026873068848038573
STAT,1867,79,na,1946,753.2778182898635
SIM,1902,91,na,1993,248
STAT,1899,37,20-24,1936,0.26306001687084235
SIM,1863,38,45-49,1901,3
STAT,1849,49,25-29,1898,0.043711797894988455
SIM,1934,37,25-29,1971,4
SIM,1937,20,30-34,1957,72
SIM,1981,1,na,1982,6487
SIM,1908,24,30-34,1932,70
STAT,1870,110,na,1980,0.014641962050383437
STAT,1970,43,15-19,2013,0.002301896441195632
STAT,1893,22,15-19,1915,4.812347510836568
SIM,1865,25,45-49,1890,3
STAT,1916,15,20-24,1931,33.35300231542857
STAT,1871,33,30-34,1904,19.961367907010352
SIM,1815,67,na,1882,1115
STAT,1835,99,na,1934,1.1803600480844363
STAT,1863,7,na,1870,2850.082862248507
STAT,1923,38,15-19,1961,0.0256429047155051
SIM,1908,47,25-29,1955,1
STAT,1831,85,na,1916,215.07684862914516
STAT,1857,25,45-49,1882,1.0428276594295143
STAT,1856,37,45-49,1893,1.755163932237524
SIM,1969,24,40-44,1993,5
STAT,1865,13,na,1878,2802.050064982493
SIM,1919,21,25-29,1940,2
STAT,1879,17,45-49,1896,0.07871485174893775
SIM,1982,26,na,2008,6742
STAT,1888,37,45-49,1925,2.7043134266021216
STAT,1929,20,30-34,1949,42.196829741470836
STAT,1818,66,na,1884,784.0496447470668
STAT,1935,34,na,1969,6033.961003446934
SIM,1932,35,50-100,1967,1
STAT,1955,59,na,2014,5505.042626416939
STAT,1840,47,15-19,1887,3.2358221358393054E-4
STAT,1924,35,50-100,1959,0.5721828531792807
STAT,1971,33,50-100,2004,1.2310844377401753
SIM,1767,89,na,1856,106
SIM,1891,40,35-39,1931,2
STAT,1970,22,na,1992,5292.9326494813895
SIM,1948,45,na,1993,4372
STAT,1949,44,50-100,1993,0.1633192245850545
STAT,1940,56,na,1996,4312.13448305287
STAT,1926,37,25-29,1963,1.3884022071344488
STAT,1872,94,na,1966,79.77299586857357
STAT,1881,28,45-49,1909,1.2315603114454756
STAT,1977,25,25-29,2002,103.16654687668833
STAT,1965,22,40-44,1987,4.860358225769648
STAT,1905,46,20-24,1951,0.011338512145368415
SIM,1888,30,35-39,1918,19
SIM,1956,29,25-29,1985,11
SIM,1845,33,na,1878,2187
STAT,1883,94,na,1977,134.39669438821952
SIM,1973,22,40-44,1995,1
STAT,1825,48,na,1873,1800.0539922364574
SIM,1924,79,na,2003,1986
SIM,1871,29,na,1900,2173
STAT,1878,17,30-34,1895,1.9205418483292884
STAT,1850,51,40-44,1901,0.010889501108077845
SIM,1908,29,25-29,1937,5
SIM,1896,37,45-49,1933,6
SIM,1901,38,25-29,1939,1
STAT,1913,37,15-19,1950,0.021881899007560764
STAT,1857,32,35-39,1889,9.158510707301597
STAT,1846,53,40-44,1899,0.01070855260435492
SIM,1864,47,na,1911,2606
SIM,1899,6,na,1905,4571
SIM,1959,38,50-100,1997,2
STAT,1873,20,20-24,1893,81.69723582729765
SIM,1953,33,40-44,1986,9
STAT,1907,21,40-44,1928,3.54893696259466
SIM,1865,32,35-39,1897,1
STAT,1864,36,50-100,1900,1.2712062676116909
STAT,1923,41,40-44,1964,0.33774102746194956
STAT,1954,18,45-49,1972,0.7124502852488603
SIM,1880,58,na,1938,2725
STAT,1870,36,20-24,1906,0.8812345374755501
STAT,1883,40,35-39,1923,2.065206378852315
SIM,1898,31,35-39,1929,21
STAT,1977,15,50-100,1992,0.5845088098633934
SIM,1915,21,40-44,1936,10
STAT,1926,44,15-19,1970,0.0021771032699566366
STAT,1831,48,na,1879,1868.705796913084
STAT,1952,27,25-29,1979,91.42086361257486
STAT,1892,28,20-24,1920,16.90904390060212
SIM,1940,24,na,1964,5045
STAT,1846,18,45-49,1864,0.08433070822253472
SIM,1888,35,40-44,1923,1
SIM,1972,30,30-34,2002,4
SIM,1835,44,na,1879,2090
STAT,1994,20,15-19,2014,8.900367718645885
SIM,1961,31,25-29,1992,5
STAT,1836,41,50-100,1877,1.1589240686815554
STAT,1964,22,na,1986,5325.497690536504
STAT,1913,57,na,1970,3958.5610675884086
STAT,1926,19,25-29,1945,60.97438022999911
SIM,1814,45,na,1859,1479
STAT,1906,18,45-49,1924,0.10964133420604352
SIM,1879,46,na,1925,2600
SIM,1961,23,na,1984,4850
SIM,1809,67,na,1876,1011
STAT,1830,63,na,1893,1119.3241614291123
SIM,1844,11,na,1855,3074
SIM,1891,22,35-39,1913,10
SIM,1918,46,35-39,1964,1
STAT,1951,19,35-39,1970,5.762639362057361
SIM,1980,0,na,1980,6028
STAT,1952,22,30-34,1974,39.87963139499073
STAT,1852,47,na,1899,2111.291052196657
STAT,1870,17,25-29,1887,6.50858983469074
SIM,1914,3,na,1917,4466
STAT,1927,41,25-29,1968,0.10348016887037735
SIM,1960,22,30-34,1982,61
STAT,1948,48,na,1996,5032.651384414415
STAT,1854,44,35-39,1898,1.4553512225803853
STAT,1978,14,na,1992,6184.422380223689
SIM,1901,33,30-34,1934,6
STAT,1945,40,30-34,1985,0.1679581944079747
STAT,1975,19,20-24,1994,206.2711955732951
STAT,1948,29,25-29,1977,87.21623187773525
SIM,1839,35,45-49,1874,4
SIM,1999,15,20-24,2014,437
STAT,1928,28,45-49,1956,2.455047592132312
STAT,1939,42,35-39,1981,0.24183935744876858
STAT,1846,47,na,1893,2315.001907353444
SIM,1952,36,30-34,1988,6
SIM,1858,47,na,1905,2477
STAT,1925,29,35-39,1954,20.31162416858993
STAT,1871,30,15-19,1901,0.16481625725845028
STAT,1944,36,30-34,1980,2.334199818971252
STAT,1820,48,25-29,1868,0.058009542286052075
SIM,1934,19,25-29,1953,1
STAT,1882,13,na,1895,2906.5309074590637
SIM,1865,10,na,1875,3444
SIM,1902,23,20-24,1925,5
SIM,1910,58,na,1968,3125
STAT,1943,46,40-44,1989,0.20121035585539554
STAT,1844,27,25-29,1871,43.31337610745447
SIM,1953,60,na,2013,5229
SIM,1957,29,20-24,1986,31
STAT,1884,43,50-100,1927,1.1958869337178613
STAT,1866,38,20-24,1904,0.8204579051904508
SIM,1944,36,35-39,1980,1
STAT,1904,109,na,2013,0.1340281329253734
STAT,1906,36,45-49,1942,0.7275851306476211
STAT,1910,24,50-100,1934,0.7093779034258924
STAT,1921,83,na,2004,1923.0772084239447
SIM,1867,76,na,1943,882
SIM,1859,10,na,1869,2611
SIM,1927,42,na,1969,4988
STAT,1817,81,na,1898,373.86301092605237
SIM,1913,91,na,2004,1204
STAT,1836,36,30-34,1872,6.0177610274058715
SIM,1863,62,na,1925,1946
STAT,1886,21,45-49,1907,0.8514200986829995
STAT,1919,43,40-44,1962,0.31224260972530854
STAT,1836,28,50-100,1864,0.748160766090301
STAT,1984,14,na,1998,6436.100236072837
SIM,1901,15,30-34,1916,5
STAT,1890,49,15-19,1939,3.115266797104874E-4
STAT,1828,54,35-39,1882,0.006697080307565819
STAT,1813,54,40-44,1867,0.032118551706260455
STAT,1894,42,na,1936,3436.420365515646
STAT,1874,29,15-19,1903,0.5321945367384132
SIM,1871,39,50-100,1910,6
STAT,1843,25,20-24,1868,14.696746507494913
STAT,1861,51,na,1912,2075.648535630769
STAT,1953,31,25-29,1984,13.160195803320503
SIM,1839,42,35-39,1881,2
STAT,1985,25,na,2010,6180.843043434661
STAT,1918,46,30-34,1964,0.10972737343371432
STAT,1920,36,45-49,1956,0.8617995229131966
SIM,1960,27,25-29,1987,7
STAT,1821,45,35-39,1866,0.2604966864678851
STAT,1936,36,35-39,1972,2.7444549574718664
STAT,1949,29,20-24,1978,24.58142075821821
SIM,1828,28,45-49,1856,4
STAT,1855,51,na,1906,1840.886793041301
SIM,1837,48,45-49,1885,1
SIM,1909,17,na,1926,4952
SIM,1851,25,20-24,1876,21
STAT,1829,99,na,1928,1.3874078202560187
STAT,1974,19,25-29,1993,65.25924877057378
SIM,1966,28,35-39,1994,49
STAT,1958,28,35-39,1986,22.84398350109817
STAT,1926,32,30-34,1958,21.98089760667475
SIM,1852,27,25-29,1879,74
SIM,1857,62,na,1919,1934
STAT,1951,37,35-39,1988,3.4244736821714135
SIM,1934,32,30-34,1966,29
STAT,1866,19,25-29,1885,6.1485454808538655
STAT,1993,19,30-34,2012,20.22462385000725
SIM,1944,38,45-49,1982,2
SIM,1909,54,na,1963,4490
SIM,1882,66,na,1948,2333
STAT,1843,31,15-19,1874,0.17357320628301917
STAT,1884,50,45-49,1934,0.01678515155646228
STAT,1936,30,50-100,1966,0.928386850365629
STAT,1927,38,35-39,1965,3.4662173797150615
STAT,1914,18,50-100,1932,0.08924733892470876
STAT,1938,24,50-100,1962,0.7513949572743613
SIM,1881,20,20-24,1901,59
SIM,1970,26,35-39,1996,50
STAT,1946,8,na,1954,5039.408643984695
STAT,1940,25,na,1965,4413.772188925471
STAT,1945,36,45-49,1981,0.8862154864360504
STAT,1868,96,na,1964,30.340294028073508
SIM,1852,46,na,1898,1846
STAT,1936,38,45-49,1974,0.7720338955485879
SIM,1979,34,50-100,2013,2
STAT,1971,17,na,1988,5380.037622948667
SIM,1844,36,30-34,1880,4
STAT,1921,42,na,1963,4825.683925023403
STAT,1883,63,na,1946,2014.6441612078659
SIM,1863,83,na,1946,105
STAT,1853,44,20-24,1897,0.15598298409666211
SIM,1906,35,20-24,1941,1
SIM,1983,18,15-19,2001,139
SIM,1880,24,35-39,1904,1
STAT,1857,37,15-19,1894,0.05047231970859123
STAT,1916,99,na,2015,61.86516716017251
STAT,1913,32,35-39,1945,10.498142055306976
STAT,1847,25,na,1872,2029.7318734829646
STAT,1888,34,40-44,1922,5.832710864141667
STAT,1856,31,25-29,1887,9.22378681543833
STAT,1906,75,na,1981,2473.033477701327
STAT,1920,19,40-44,1939,1.800533695547016
SIM,1931,38,50-100,1969,1
SIM,1874,43,50-100,1917,2
STAT,1910,48,50-100,1958,0.2431081789908792
STAT,1901,45,20-24,1946,0.011051057777593933
SIM,1830,30,30-34,1860,11
STAT,1786,87,na,1873,96.11235324439772
STAT,1855,34,50-100,1889,0.7775077426875211
SIM,1912,25,35-39,1937,3
STAT,1942,49,40-44,1991,0.19665356349621904
SIM,1800,86,na,1886,90
SIM,1922,36,na,1958,5010
STAT,1950,18,25-29,1968,59.113866886107
STAT,1895,37,35-39,1932,10.624885870129125
STAT,1901,38,na,1939,3819.4087726310863
STAT,1904,25,35-39,1929,16.098873477749645
STAT,1941,18,15-19,1959,53.94278230592482
SIM,1835,38,30-34,1873,12
STAT,1967,15,15-19,1982,65.45779447780816
SIM,1929,34,50-100,1963,3
SIM,1853,43,30-34,1896,2
STAT,1803,54,35-39,1857,0.030005920400268993
SIM,1843,79,na,1922,322
SIM,1864,31,25-29,1895,25
SIM,1921,32,35-39,1953,6
STAT,1917,16,30-34,1933,3.0344968671966366
STAT,1899,43,15-19,1942,0.0015052666768447485
SIM,1953,36,45-49,1989,3
STAT,1962,26,35-39,1988,22.306214967545696
STAT,1843,17,50-100,1860,0.0628199264127213
STAT,1847,15,25-29,1862,5.5067484185560245
STAT,1899,88,na,1987,752.736936803087
STAT,1856,77,na,1933,761.0534418399749
SIM,1947,28,na,1975,5631
SIM,1821,54,na,1875,1257
STAT,1956,36,20-24,1992,0.4151051098119135
STAT,1900,40,50-100,1940,0.11866435771171963
STAT,1962,28,45-49,1990,2.5643917482653227
STAT,1845,43,30-34,1888,0.7788584109132639
STAT,1980,25,30-34,2005,63.099997819099904
SIM,1856,12,na,1868,2582
SIM,1814,72,na,1886,613
SIM,1985,22,20-24,2007,4
SIM,1814,82,na,1896,134
STAT,1816,54,45-49,1870,0.027302663769836817
STAT,1863,59,na,1922,1961.1694209866464
STAT,1834,52,na,1886,2014.770573941441
STAT,1878,42,30-34,1920,1.3835935987676014
SIM,1935,38,35-39,1973,7
STAT,1962,43,40-44,2005,0.3837576179116614
STAT,1863,49,na,1912,2222.9342788307745
STAT,1827,54,20-24,1881,7.888779618498847E-4
STAT,1960,7,na,1967,5908.033156352315
SIM,1970,28,45-49,1998,1
STAT,1852,54,30-34,1906,0.005457813370911106
STAT,1895,64,na,1959,2724.577188887247
SIM,1870,26,30-34,1896,4
SIM,1934,55,na,1989,5496
STAT,1811,44,15-19,1855,0.04556555332620641
SIM,1869,35,50-100,1904,1
STAT,1869,44,30-34,1913,1.2675353205183255
STAT,1963,42,30-34,2005,0.19479669247195502
SIM,1961,45,40-44,2006,1
STAT,1920,35,30-34,1955,2.305908010785152
STAT,1945,43,35-39,1988,0.2633976511768058
SIM,1917,53,na,1970,5079
SIM,1927,46,45-49,1973,2
STAT,1866,45,45-49,1911,0.2549569215873427
STAT,1862,26,30-34,1888,24.793900911993024
STAT,1865,54,40-44,1919,0.010660531764097841
SIM,1880,31,25-29,1911,17
SIM,1907,69,na,1976,3313
STAT,1788,72,na,1860,811.7504676331132
STAT,1872,31,25-29,1903,11.917657361236264
SIM,1981,22,35-39,2003,33
STAT,1924,28,25-29,1952,88.10697809862435
SIM,1874,31,na,1905,2579
STAT,1904,27,45-49,1931,1.8400156462200021
SIM,1955,30,25-29,1985,3
STAT,1823,54,35-39,1877,0.007873828071454193
SIM,1870,65,na,1935,2305
SIM,1898,27,15-19,1925,1
STAT,1818,101,na,1919,0.2524787886426576
STAT,1849,15,45-49,1864,0.06306144164351431
STAT,1889,21,25-29,1910,81.68170984986074
STAT,1827,38,30-34,1865,7.583772415978065
SIM,1902,29,40-44,1931,9
STAT,1908,40,15-19,1948,0.0016603705278450454
SIM,1838,41,25-29,1879,1
STAT,1915,28,15-19,1943,0.8282024396232969
SIM,1969,13,na,1982,5826
STAT,1855,35,40-44,1890,3.7601724846871054
STAT,1866,61,na,1927,1998.8082184270957
STAT,1870,42,15-19,1912,0.015692433393944837
STAT,1965,17,na,1982,5303.090267350799
SIM,1897,21,25-29,1918,104
STAT,1941,60,na,2001,4230.940153485887
STAT,1984,25,15-19,2009,1.163114353563038
STAT,1980,32,20-24,2012,3.983255930052979
STAT,1819,53,30-34,1872,0.01080634126907219
STAT,1829,51,35-39,1880,0.008651174565255522
STAT,1881,78,na,1959,1028.3801263567157
SIM,1989,21,na,2010,5954
STAT,1943,48,30-34,1991,0.11317083464708695
SIM,1869,40,na,1909,1937
SIM,1923,28,15-19,1951,1
STAT,1881,31,35-39,1912,11.318799405976549
SIM,1808,72,na,1880,696
STAT,1919,46,45-49,1965,0.2726597419852609
STAT,1947,61,na,2008,4576.059496033099
SIM,1961,28,35-39,1989,58
STAT,1891,44,40-44,1935,3.1648785737289913
STAT,1869,22,20-24,1891,77.01717589022255
SIM,1921,25,45-49,1946,5
SIM,1880,31,na,1911,3354
STAT,1947,30,25-29,1977,12.261057823857561
SIM,1888,32,25-29,1920,2
STAT,1944,1,na,1945,5135.078762514189
STAT,1953,28,35-39,1981,21.040244051304768
SIM,1932,28,25-29,1960,11
SIM,1812,87,na,1899,41
STAT,1964,48,20-24,2012,0.01666152371738457
STAT,1913,25,45-49,1938,2.0011178763299853
SIM,1873,14,na,1887,3639
STAT,1803,53,50-100,1856,0.05370797686176569
STAT,1915,42,na,1957,4315.849630635876
SIM,1870,0,na,1870,4613
STAT,1810,86,na,1896,126.33348151152526
SIM,1932,20,na,1952,5574
STAT,1950,25,15-19,1975,0.9683098574667691
SIM,1861,28,30-34,1889,38
SIM,1877,44,30-34,1921,5
SIM,1877,22,20-24,1899,6
STAT,1807,53,40-44,1860,0.040516779883204616
STAT,1853,28,30-34,1881,26.24054583949883
STAT,1912,18,50-100,1930,0.08728463726490468
STAT,1829,45,40-44,1874,0.1793605456475422
SIM,1950,35,50-100,1985,1
STAT,1947,38,20-24,1985,0.352689652270332
STAT,1957,34,15-19,1991,0.19904963837715
STAT,1953,61,na,2014,4914.337741460064
SIM,1855,30,20-24,1885,4
SIM,1909,45,30-34,1954,1
SIM,1940,63,na,2003,4201
STAT,1887,105,na,1992,1.6628292952732553
SIM,1938,21,na,1959,3598
STAT,1861,52,30-34,1913,0.005680516828651191
STAT,1952,47,45-49,1999,0.31264142115623733
SIM,1845,36,35-39,1881,18
SIM,1905,24,na,1929,3833
STAT,1858,22,45-49,1880,0.7202991654336472
STAT,1961,23,50-100,1984,0.9839889045198185
SIM,1935,35,30-34,1970,2
STAT,1848,42,na,1890,2452.7328449484708
SIM,1891,27,15-19,1918,1
STAT,1905,58,na,1963,3492.320039184844
SIM,1891,33,na,1924,3421
STAT,1822,33,35-39,1855,34.16423333365751
STAT,1947,39,15-19,1986,0.025663851165722746
STAT,1941,17,20-24,1958,161.19710975535176
STAT,1877,26,50-100,1903,0.7705507641483711
STAT,1925,49,25-29,1974,0.07372158754244326
STAT,1980,28,35-39,2008,24.14535024186392
SIM,1866,22,45-49,1888,5
SIM,1837,45,40-44,1882,1
STAT,1882,50,25-29,1932,0.004049985544130706
STAT,1883,27,15-19,1910,0.5122720377673871
SIM,1880,21,30-34,1901,56
STAT,1848,21,50-100,1869,0.5313886082548803
STAT,1925,72,na,1997,3803.3541647838647
SIM,1933,49,25-29,1982,1
SIM,1909,38,40-44,1947,5
SIM,1856,21,50-100,1877,1
STAT,1837,36,35-39,1873,6.3008440032099955
STAT,1967,43,45-49,2010,0.24893900048776565
SIM,1810,52,na,1862,1376
SIM,1898,37,na,1935,3901
STAT,1803,51,30-34,1854,0.022036817919237103
SIM,1910,79,na,1989,1386
STAT,1840,52,na,1892,1718.0792353840031
SIM,1831,30,35-39,1861,3
SIM,1886,45,35-39,1931,1
STAT,1933,33,15-19,1966,0.1998184027947048
SIM,1913,8,na,1921,5118
SIM,1815,85,na,1900,239
STAT,1836,39,35-39,1875,7.7412694728058025
SIM,1933,23,15-19,1956,12
STAT,1836,30,45-49,1866,2.048820076205006
SIM,1979,5,na,1984,6475
STAT,1820,38,30-34,1858,7.667796597538931
STAT,1930,17,45-49,1947,0.7454134021673207
STAT,1845,46,35-39,1891,0.09460753507446447
SIM,1949,62,na,2011,5191
SIM,1944,21,na,1965,3930
SIM,1851,4,na,1855,3353
SIM,1844,39,35-39,1883,4
STAT,1925,23,15-19,1948,7.328286893948864
SIM,1902,81,na,1983,1446
SIM,1880,95,na,1975,92
STAT,1856,53,35-39,1909,0.007458137492282114
SIM,1896,80,na,1976,1840
SIM,1854,17,na,1871,3080
STAT,1813,84,na,1897,152.31725608330112
SIM,1911,35,50-100,1946,1
STAT,1917,6,na,1923,4961.365218000798
STAT,1820,70,na,1890,823.4638143295892
STAT,1878,45,35-39,1923,0.17037558315254814
SIM,1924,25,50-100,1949,1
SIM,1846,46,na,1892,1492
STAT,1963,40,20-24,2003,0.026983545609901727
STAT,1893,45,50-100,1938,0.2041039359954061
STAT,1840,20,25-29,1860,59.24751799021839
STAT,1850,25,50-100,1875,0.7862061599820871
STAT,1891,47,45-49,1938,0.1889914727896348
SIM,1829,71,na,1900,762
STAT,1949,27,30-34,1976,52.8170070203064
STAT,1884,48,15-19,1932,4.5035724894124975E-4
STAT,1967,12,na,1979,5662.690014464149
STAT,1869,10,na,1879,3009.706070496543
STAT,1903,35,50-100,1938,0.43973374795217984
SIM,1957,27,30-34,1984,71
STAT,1938,9,na,1947,4534.049716284848
STAT,1923,19,na,1942,4959.315959094295
SIM,1935,28,40-44,1963,10
SIM,1968,15,25-29,1983,79
STAT,1878,52,25-29,1930,0.0042452475355326145
SIM,1984,28,na,2012,5731
STAT,1927,35,30-34,1962,2.619028828590507
SIM,1828,27,na,1855,2359
SIM,1958,19,30-34,1977,38
STAT,1862,20,45-49,1882,0.7053243236328538
SIM,1971,42,30-34,2013,2
STAT,1850,28,15-19,1878,0.5456925456962951
STAT,1980,35,25-29,2015,1.6279515102332693
SIM,1830,33,35-39,1863,9
STAT,1987,28,35-39,2015,24.829796809160445
STAT,1919,27,50-100,1946,1.2408461721158672
SIM,1878,42,25-29,1920,1
SIM,1889,94,na,1983,444
STAT,1987,25,50-100,2012,1.6483585803928178
STAT,1951,39,25-29,1990,1.391043986647835
STAT,1800,56,na,1856,1431.1740180768995
STAT,1828,28,na,1856,1901.7409950923336
STAT,1866,17,50-100,1883,0.05378921387494612
SIM,1889,39,na,1928,3764
SIM,1973,19,15-19,1992,61
STAT,1896,32,25-29,1928,15.612659411492299
STAT,1844,40,45-49,1884,1.315352037714032
STAT,1927,28,40-44,1955,6.514940128629275
STAT,1929,22,50-100,1951,0.9603149557812981
STAT,1911,23,50-100,1934,0.7185591519324417
SIM,1878,35,35-39,1913,1
STAT,1793,69,na,1862,697.559069089123
STAT,1859,44,na,1903,2096.0536886540067
SIM,1916,40,na,1956,4411
STAT,1893,17,50-100,1910,0.07146536172474803
STAT,1847,50,40-44,1897,0.008216953968611947
SIM,1938,16,40-44,1954,2
SIM,1916,36,na,1952,4393
STAT,1866,44,15-19,1910,0.014572455928458588
STAT,1930,15,35-39,1945,6.290565458470115
SIM,1868,15,20-24,1883,43
STAT,1913,22,40-44,1935,3.7620404969674968
STAT,1940,28,50-100,1968,1.1711540367103228
STAT,1844,76,na,1920,792.4298481230143
STAT,1855,41,35-39,1896,1.5477851893885752
SIM,1870,29,35-39,1899,29
SIM,1900,96,na,1996,229
STAT,1953,25,30-34,1978,54.98530112223265
STAT,1907,43,15-19,1950,0.0016165660058709789
STAT,1862,29,35-39,1891,9.330239134943618
STAT,1866,42,40-44,1908,2.403002462647609
STAT,1933,39,na,1972,5903.801181608289
SIM,1992,19,na,2011,6181
SIM,1962,38,35-39,2000,6
SIM,1941,41,na,1982,3946
STAT,1911,41,15-19,1952,0.0017027115246153375
SIM,1896,34,40-44,1930,18
STAT,1953,48,45-49,2001,0.3147221653343819
SIM,1835,26,50-100,1861,4
STAT,1915,27,20-24,1942,21.49059552050058
STAT,1971,31,15-19,2002,0.19157139605586734
SIM,1818,40,45-49,1858,5
STAT,1874,52,40-44,1926,0.012371649285888187
STAT,1975,17,30-34,1992,18.55707811788636
SIM,1834,27,na,1861,2119
SIM,1874,42,40-44,1916,1
SIM,1923,27,20-24,1950,51
SIM,1865,41,50-100,1906,3
SIM,1961,25,30-34,1986,127
STAT,1870,35,na,1905,2705.908789752347
STAT,1923,37,20-24,1960,0.35236298887992873
SIM,1890,43,35-39,1933,9
SIM,1827,86,na,1913,112
STAT,1861,24,na,1885,2297.7238484283844
STAT,1818,50,45-49,1868,0.017937897412738463
STAT,1953,18,40-44,1971,1.9520588650174537
SIM,1969,38,35-39,2007,11
SIM,1878,51,na,1929,2579
STAT,1851,51,45-49,1902,0.011563331982166492
STAT,1817,41,15-19,1858,0.04372021150465936
SIM,1850,44,45-49,1894,3
STAT,1925,76,na,2001,3261.1413636349425
STAT,1771,102,na,1873,0.10232167961866862
STAT,1858,20,35-39,1878,6.11526619021604
SIM,1837,69,na,1906,1401
SIM,1872,7,na,1879,3443
STAT,1967,33,15-19,2000,0.18871064976272378
SIM,1948,31,50-100,1979,1
STAT,1848,24,40-44,1872,2.657324919990491
STAT,1865,44,na,1909,2374.107953807967
SIM,1804,52,na,1856,1159
SIM,1844,30,45-49,1874,1
STAT,1939,29,15-19,1968,0.8185489273989328
STAT,1882,43,35-39,1925,2.0264314530696534
SIM,1888,32,50-100,1920,1
STAT,1896,25,35-39,1921,14.807509564155803
STAT,1817,40,na,1857,2167.4784083035393
SIM,1856,24,40-44,1880,2
SIM,1792,86,na,1878,26
SIM,1962,44,na,2006,5467
SIM,1854,3,na,1857,3802
SIM,1907,17,25-29,1924,16
STAT,1886,27,30-34,1913,30.654207282529196
STAT,1842,44,45-49,1886,1.1614170178152383
SIM,1900,24,15-19,1924,5
STAT,1832,22,40-44,1854,3.2047451004314285
STAT,1844,51,50-100,1895,0.012692721990764518
STAT,1859,75,na,1934,946.3893381425855
SIM,1866,20,35-39,1886,12
STAT,1824,38,15-19,1862,0.0841468536095541
STAT,1971,26,45-49,1997,2.5372458633608805
SIM,1857,83,na,1940,458
STAT,1891,98,na,1989,57.960366541967915
SIM,1894,27,30-34,1921,52
SIM,1840,22,40-44,1862,1
STAT,1976,27,30-34,2003,60.67286833308668
STAT,1830,90,na,1920,49.458018004865366
SIM,1840,68,na,1908,1016
STAT,1812,53,30-34,1865,0.012924360193206379
SIM,1967,24,20-24,1991,286
STAT,1827,43,na,1870,2149.641761309951
SIM,1979,33,35-39,2012,16
STAT,1823,32,25-29,1855,28.30059879739336
STAT,1952,44,40-44,1996,0.3582905649723267
SIM,1831,32,25-29,1863,18
STAT,1991,18,50-100,2009,0.619438388943419
SIM,1922,20,35-39,1942,21
SIM,1878,82,na,1960,696
SIM,1904,89,na,1993,1014
STAT,1869,23,15-19,1892,3.67562378963525
STAT,1923,40,50-100,1963,0.15884327082726965
STAT,1950,47,25-29,1997,0.07528905612397074
STAT,1929,39,50-100,1968,0.6207632719420617
STAT,1901,46,35-39,1947,0.1280187639331031
SIM,1845,33,30-34,1878,30
STAT,1846,31,30-34,1877,21.552698244963015
STAT,1887,45,50-100,1932,0.3208068674073947
SIM,1923,22,na,1945,5177
STAT,1914,46,45-49,1960,0.24948975907620433
SIM,1959,39,35-39,1998,10
STAT,1888,42,25-29,1930,0.8700614112662147
STAT,1963,23,35-39,1986,13.846301362786571
STAT,1910,44,35-39,1954,0.21715118491586505
STAT,1970,41,25-29,2011,0.10736216684022569
SIM,1956,39,na,1995,5400
STAT,1936,51,na,1987,4151.18177337078
STAT,1916,37,na,1953,4446.656486018389
SIM,1909,23,20-24,1932,122
SIM,1858,78,na,1936,1121
STAT,1810,51,20-24,1861,0.002757549730686831
STAT,1972,21,35-39,1993,13.963605676541466
SIM,1878,92,na,1970,21
STAT,1858,40,50-100,1898,0.9607058738812769
SIM,1847,90,na,1937,322
STAT,1803,53,20-24,1856,0.002624168354472557
STAT,1914,20,35-39,1934,10.721873157102134
STAT,1898,62,na,1960,2984.1542371131354
STAT,1817,49,na,1866,1953.6171081845973
SIM,1860,82,na,1942,1009
SIM,1919,36,45-49,1955,1
SIM,1877,38,na,1915,3142
SIM,1900,46,25-29,1946,1
STAT,1854,19,35-39,1873,0.5284756658264746
STAT,1937,26,45-49,1963,1.945414059707966
STAT,1990,5,na,1995,6498.126525109487
STAT,1860,45,25-29,1905,0.054108370294715595
SIM,1859,39,30-34,1898,2
STAT,1872,21,30-34,1893,20.703229716742676
STAT,1982,0,na,1982,6432.29146384325
STAT,1866,30,na,1896,2573.0636664030385
STAT,1850,47,20-24,1897,0.012295760982319373
STAT,1879,44,25-29,1923,0.7633663491488739
STAT,1967,40,40-44,2007,0.3757585045821153
SIM,1846,50,na,1896,1452
SIM,1887,44,25-29,1931,1
STAT,1796,102,na,1898,0.07467312941543522
STAT,1830,27,50-100,1857,0.8041391536548563
STAT,1838,46,45-49,1884,0.21306414878793117
STAT,1897,31,50-100,1928,1.419667547022322
STAT,1953,47,30-34,2000,0.12944929970161656
STAT,1991,24,45-49,2015,1.8657832551012556
SIM,1954,14,na,1968,5537
STAT,1893,25,na,1918,3504.883742830307
STAT,1837,33,30-34,1870,15.688008160783184
STAT,1851,41,15-19,1892,0.011000674700975202
SIM,1962,16,35-39,1978,12
SIM,1849,26,na,1875,2755
SIM,1945,26,45-49,1971,2
SIM,1983,21,40-44,2004,13
SIM,1950,27,30-34,1977,120
SIM,1912,74,na,1986,2065
SIM,1891,74,na,1965,1741
STAT,1878,58,na,1936,2382.9170794770434
STAT,1932,54,na,1986,5602.555254583674
SIM,1900,39,35-39,1939,4
SIM,1898,30,40-44,1928,12
STAT,1833,36,15-19,1869,0.050326194183945065
STAT,1963,43,25-29,2006,0.10863344773516383
STAT,1982,27,na,2009,6109.754027519714
SIM,1846,46,45-49,1892,1
STAT,1853,97,na,1950,5.348706436705526
STAT,1835,29,25-29,1864,33.95757454465911
SIM,1999,0,na,1999,6976
STAT,1937,33,35-39,1970,10.432997408338506
SIM,1841,13,na,1854,2457
SIM,1843,29,25-29,1872,36
STAT,1934,44,20-24,1978,0.028289994535021908
STAT,1955,24,na,1979,5609.27139020432
SIM,1942,26,na,1968,4785
STAT,1942,27,30-34,1969,47.46740280561923
SIM,1872,33,40-44,1905,12
STAT,1805,50,35-39,1855,0.03205812228980905
STAT,1940,36,45-49,1976,0.8239778663109634
STAT,1874,48,50-100,1922,0.28651752725285895
SIM,1897,65,na,1962,2701
SIM,1909,19,35-39,1928,1
SIM,1839,64,na,1903,1482
SIM,1949,17,30-34,1966,39
SIM,1878,32,30-34,1910,7
SIM,1930,70,na,2000,4886
STAT,1829,50,20-24,1879,7.563819236366985E-4
STAT,1873,40,40-44,1913,2.677495764314674
STAT,1901,93,na,1994,309.1303640322308
STAT,1951,36,20-24,1987,0.37355937022671126
SIM,1954,31,35-39,1985,31
STAT,1916,37,30-34,1953,2.1541514390057053
SIM,1891,49,25-29,1940,1
SIM,1903,24,30-34,1927,3
STAT,1962,25,40-44,1987,6.927999184045589
STAT,1828,29,35-39,1857,12.708613573975214
SIM,1881,40,40-44,1921,3
STAT,1873,45,35-39,1918,0.16663344489354207
SIM,1828,41,30-34,1869,2
STAT,1941,21,40-44,1962,4.012325402272763
SIM,1935,16,25-29,1951,85
STAT,1987,20,na,2007,6040.378912668065
SIM,1948,14,na,1962,4465
SIM,1973,31,40-44,2004,12
SIM,1980,9,na,1989,6008
STAT,1988,15,na,2003,6078.468931138685
STAT,1883,49,25-29,1932,0.06367781898239595
SIM,1970,25,40-44,1995,17
SIM,1836,29,35-39,1865,12
STAT,1917,85,na,2002,1457.6035865614192
SIM,1889,30,na,1919,3898
SIM,1895,46,40-44,1941,1
STAT,1887,46,40-44,1933,0.22204554341176727
SIM,1890,21,25-29,1911,161
STAT,1962,5,na,1967,5813.871907338676
STAT,1902,31,30-34,1933,28.58665196648656
STAT,1916,32,50-100,1948,0.9851994112452771
SIM,1849,30,45-49,1879,7
STAT,1927,16,25-29,1943,62.32148354662868
SIM,1886,20,20-24,1906,86
STAT,1844,45,na,1889,1911.4938646938417
STAT,1991,21,40-44,2012,5.581162623156038
STAT,1936,10,na,1946,4393.695775386171
SIM,1923,12,na,1935,5667
SIM,1899,15,15-19,1914,18
SIM,1840,30,25-29,1870,24
SIM,1924,37,30-34,1961,5
SIM,1819,43,30-34,1862,2
STAT,1902,36,25-29,1938,1.018230148897518
STAT,1855,40,20-24,1895,0.13649684468946294
SIM,1986,23,na,2009,5898
STAT,1872,30,na,1902,2787.4900849059745
STAT,1855,2,na,1857,3030.9373358365274
STAT,1863,48,45-49,1911,0.23515763512867807
STAT,1873,70,na,1943,1653.5087125865139
STAT,1842,43,15-19,1885,0.010854833465829834
SIM,1860,72,na,1932,1444
STAT,1771,88,na,1859,53.812033034849634
STAT,1959,24,20-24,1983,168.29704471182941
STAT,1898,18,45-49,1916,0.10161529440975145
STAT,1831,40,35-39,1871,1.7805344297473087
STAT,1972,43,35-39,2015,0.3087260133320659
SIM,1910,36,25-29,1946,4
SIM,1889,19,20-24,1908,62
SIM,1958,15,30-34,1973,41
STAT,1960,34,20-24,1994,3.7322776090906005
SIM,1828,31,na,1859,2475
SIM,1839,20,25-29,1859,1
STAT,1861,19,25-29,1880,6.175463386751151
STAT,1890,26,45-49,1916,1.5710337966398968
STAT,1963,41,35-39,2004,0.3072618724258119
STAT,1915,52,na,1967,4201.075612514284
STAT,1955,40,25-29,1995,0.11400784054111433
STAT,1832,30,25-29,1862,9.513478708046383
STAT,1925,46,20-24,1971,0.015487628309587574
STAT,1976,34,20-24,2010,3.8284315941566813
SIM,1984,27,30-34,2011,75
SIM,1854,31,30-34,1885,21
SIM,1967,17,30-34,1984,33
STAT,1900,12,na,1912,4135.515611955973
STAT,1959,17,30-34,1976,18.399931115779253
SIM,1895,30,na,1925,3589
STAT,1850,45,na,1895,2339.1800960364417
STAT,1946,31,35-39,1977,11.929936189487083
STAT,1936,35,40-44,1971,1.6999649715215233
SIM,1940,23,50-100,1963,2
STAT,1914,43,40-44,1957,0.2857089679117485
STAT,1896,22,30-34,1918,27.15101559715198
STAT,1897,22,na,1919,3649.5864896267108
STAT,1935,42,15-19,1977,0.0025011440718737555
SIM,1971,41,35-39,2012,1
SIM,1923,31,40-44,1954,3
SIM,1967,27,25-29,1994,113
STAT,1850,32,35-39,1882,10.905875220758341
SIM,1878,3,na,1881,3316
STAT,1842,41,40-44,1883,1.8138680147861816
STAT,1879,40,25-29,1919,0.781619385423048
SIM,1860,49,30-34,1909,1
STAT,1889,95,na,1984,145.7449950674772
STAT,1857,41,50-100,1898,0.9538467265386418
STAT,1921,47,15-19,1968,4.7906364911243183E-4
STAT,1878,20,20-24,1898,83.53193565025154
SIM,1867,45,na,1912,2204
SIM,1971,20,30-34,1991,3
STAT,1842,20,50-100,1862,0.401546070800389
STAT,1888,40,35-39,1928,2.481290987859893
SIM,1813,44,40-44,1857,3
STAT,1825,48,25-29,1873,0.07932663473198319
STAT,1849,22,35-39,1871,5.468316095848942
STAT,1956,39,25-29,1995,1.545750188196892
STAT,1937,30,30-34,1967,18.01867725095998
SIM,1959,36,30-34,1995,4
STAT,1832,102,na,1934,0.19973728700717078
SIM,1827,31,20-24,1858,5
SIM,1822,39,na,1861,1695
SIM,1909,26,25-29,1935,7
STAT,1834,21,45-49,1855,0.8572384275360756
STAT,1945,21,25-29,1966,116.86968109452273
STAT,1882,39,15-19,1921,0.06266119550138466
STAT,1948,48,30-34,1996,0.12211890706325364
STAT,1969,42,15-19,2011,0.0023007470434769344
SIM,1942,30,50-100,1972,2
STAT,1952,46,30-34,1998,0.1285547887421796
STAT,1902,43,15-19,1945,0.0015524482387956641
STAT,1934,47,25-29,1981,0.08533183131751172
STAT,1901,43,30-34,1944,0.12812017192373854
SIM,1856,27,45-49,1883,2
SIM,1933,77,na,2010,4007
STAT,1852,49,30-34,1901,0.08935881053847626
STAT,1852,16,na,1868,2632.994569798618
SIM,1910,89,na,1999,317
STAT,1960,32,30-34,1992,24.138822774989755
SIM,1854,34,35-39,1888,32
STAT,1841,53,40-44,1894,0.009209744188954282
STAT,1867,20,45-49,1887,0.7654029227437859
SIM,1940,55,na,1995,4760
SIM,1842,53,na,1895,1876
STAT,1862,64,na,1926,1693.0436003254856
SIM,1892,59,na,1951,3216
SIM,1933,15,na,1948,6576
STAT,1864,33,40-44,1897,4.44987493591382
SIM,1859,19,na,1878,2448
SIM,1987,21,25-29,2008,153
STAT,1963,20,30-34,1983,42.3077408255185
SIM,1945,30,30-34,1975,32
STAT,1846,34,35-39,1880,12.117674883812445
SIM,1837,79,na,1916,777
SIM,1899,91,na,1990,84
STAT,1882,21,25-29,1903,64.72292815382772
STAT,1924,35,15-19,1959,0.026170528816964397
SIM,1850,41,40-44,1891,5
STAT,1848,27,45-49,1875,1.4083720780634166
SIM,1881,71,na,1952,976
SIM,1853,21,20-24,1874,82
STAT,1824,42,35-39,1866,2.576906176755124
STAT,1940,33,40-44,1973,4.672645418826956
STAT,1947,42,40-44,1989,0.3379086251003082
STAT,1915,49,30-34,1964,0.10307736658753311
SIM,1898,33,45-49,1931,4
STAT,1810,54,25-29,1864,0.012452847016598354
SIM,1885,29,30-34,1914,4
STAT,1901,22,15-19,1923,5.332815395616516
STAT,1978,20,25-29,1998,146.0604809727138
STAT,1776,94,na,1870,5.924129928537845
SIM,1956,36,50-100,1992,2
STAT,1854,16,30-34,1870,1.562543854786205
STAT,1816,51,40-44,1867,0.02102751978868805
STAT,1874,96,na,1970,53.99911743808177
SIM,1818,65,na,1883,1664
SIM,1880,27,na,1907,3467
STAT,1823,108,na,1931,0.0010372827947175024
STAT,1864,36,45-49,1900,2.064058424985103
STAT,1929,65,na,1994,4790.603388020862
SIM,1972,27,50-100,1999,1
STAT,1968,42,30-34,2010,0.19150867279915806
STAT,1845,31,na,1876,1754.5630036927
STAT,1868,41,45-49,1909,1.6669346865724237
SIM,1961,42,50-100,2003,1
SIM,1894,44,na,1938,3703
STAT,1877,29,30-34,1906,30.013427930876958
STAT,1878,23,25-29,1901,68.76527467398539
SIM,1846,43,40-44,1889,6
SIM,1787,72,na,1859,912
SIM,1959,29,40-44,1988,1
STAT,1832,98,na,1930,2.21319971850445
SIM,1875,20,45-49,1895,2
STAT,1872,24,35-39,1896,6.7198348382539255
STAT,1948,36,50-100,1984,0.5717822371525996
STAT,1966,3,na,1969,5670.178336915103
SIM,1840,34,50-100,1874,4
SIM,1803,66,na,1869,1118
STAT,1921,0,na,1921,5924.145127825925
SIM,1857,22,35-39,1879,12
SIM,1877,11,na,1888,3485
STAT,1937,36,na,1973,4347.86470161848
SIM,1886,23,25-29,1909,111
STAT,1838,43,40-44,1881,2.0474648396699138
STAT,1915,31,40-44,1946,4.619160646594089
SIM,1879,77,na,1956,837
STAT,1879,41,20-24,1920,0.19223861794022454
STAT,1873,42,30-34,1915,1.3532042762774865
STAT,1884,48,na,1932,2533.082386370794
STAT,1901,48,25-29,1949,0.051861524506670774
STAT,1832,34,50-100,1866,0.8134680215709249
SIM,1907,59,na,1966,3911
STAT,1856,49,15-19,1905,3.448261775554268E-4
STAT,1843,105,na,1948,0.029419803206259705
STAT,1831,34,40-44,1865,4.325452449294128
SIM,1945,23,40-44,1968,8
STAT,1974,35,50-100,2009,0.6529568156238159
STAT,1937,23,40-44,1960,3.7794684900691933
SIM,1962,5,na,1967,5592
STAT,1830,32,na,1862,1749.8085117755422
STAT,1895,34,30-34,1929,26.003295001391436
STAT,1874,17,45-49,1891,0.0771750929793001
SIM,1828,44,35-39,1872,5
STAT,1893,41,20-24,1934,0.2327117363210802
STAT,1835,68,na,1903,952.4551114290783
STAT,1834,83,na,1917,362.2905667040973
STAT,1941,39,30-34,1980,2.2278014346423425
STAT,1803,91,na,1894,20.19710748191677
STAT,1846,41,25-29,1887,0.6805504823795203
STAT,1859,27,20-24,1886,10.970934381777006
SIM,1909,16,30-34,1925,9
SIM,1894,0,na,1894,4248
SIM,1927,81,na,2008,1123
STAT,1875,37,na,1912,2809.727575886434
STAT,1954,16,35-39,1970,5.988175873875045
STAT,1918,22,na,1940,4544.3134870011345
STAT,1876,81,na,1957,729.4007619041283
STAT,1893,46,15-19,1939,3.3006969374941143E-4
STAT,1942,40,15-19,1982,0.001930406753211638
SIM,1824,65,na,1889,869
STAT,1902,78,na,1980,2028.2704920319688
STAT,1858,16,15-19,1874,6.278069896695903
STAT,1823,50,na,1873,1420.604205507208
STAT,1960,43,na,2003,5792.176475486112
STAT,1849,82,na,1931,361.63321372055367
SIM,1836,26,30-34,1862,60
STAT,1909,17,50-100,1926,0.08488428500841064
STAT,1962,46,45-49,2008,0.3351088218764361
STAT,1917,19,35-39,1936,5.166321064804963
STAT,1855,43,25-29,1898,0.542461424067731
SIM,1832,42,35-39,1874,2
SIM,1842,94,na,1936,18
SIM,1858,18,30-34,1876,3
STAT,1829,53,25-29,1882,0.003113055222122015
STAT,1845,21,20-24,1866,58.06547668839019
STAT,1889,48,15-19,1937,3.169456361084257E-4
STAT,1867,15,na,1882,2815.0603895053246
STAT,1823,52,45-49,1875,0.013811478539327012
SIM,1932,25,20-24,1957,6
STAT,1924,25,20-24,1949,24.687377205444466
STAT,1904,24,40-44,1928,3.4317095714701704
STAT,1957,30,50-100,1987,1.283781735388321
STAT,1828,83,na,1911,263.48003721569484
STAT,1843,53,25-29,1896,0.0034969252172761187
STAT,1902,33,20-24,1935,4.389082885630266
STAT,1828,26,30-34,1854,64.07633170762917
SIM,1918,48,45-49,1966,1
SIM,1925,19,35-39,1944,10
STAT,1878,30,15-19,1908,0.1729742226772723
STAT,1919,31,25-29,1950,11.552141078696733
STAT,1869,47,35-39,1916,0.15573571507462217
STAT,1874,31,50-100,1905,1.0869195396055928
SIM,1873,45,na,1918,3195
SIM,1903,27,35-39,1930,45
SIM,1906,74,na,1980,2211
SIM,1927,31,25-29,1958,9
STAT,1867,51,20-24,1918,7.989038488060765E-4
STAT,1921,17,35-39,1938,5.5178251735845
SIM,1811,92,na,1903,12
STAT,1979,21,25-29,2000,147.3069588033529
SIM,2009,3,na,2012,7162
SIM,1958,18,35-39,1976,14
SIM,1863,34,50-100,1897,1
STAT,1988,16,35-39,2004,6.9278544365364985
SIM,1847,43,50-100,1890,6
SIM,1866,16,15-19,1882,5
STAT,1872,17,50-100,1889,0.056958641171730204
STAT,1860,42,20-24,1902,0.14753151573827514
STAT,1928,26,35-39,1954,21.418733355785967
STAT,1950,15,20-24,1965,185.09680910246422
STAT,1890,23,40-44,1913,2.929341215495819
STAT,1952,45,50-100,1997,0.3268903619304264
STAT,1875,42,15-19,1917,0.01644926280353493
STAT,1836,24,15-19,1860,3.9070561022469494
SIM,1832,91,na,1923,33
STAT,1839,43,50-100,1882,0.8717835166951667
SIM,1867,27,20-24,1894,12
STAT,1860,47,15-19,1907,3.703086636817649E-4
SIM,1927,77,na,2004,2337
STAT,1934,30,50-100,1964,1.3048692629200807
SIM,1979,30,30-34,2009,34
SIM,1919,33,40-44,1952,13
STAT,1817,50,na,1867,1931.2071780896206
STAT,1816,43,50-100,1859,2.3079942785261482
SIM,1953,21,25-29,1974,12
STAT,1856,108,na,1964,0.009753350446519038
STAT,1851,35,20-24,1886,0.630790083205617
STAT,1874,48,20-24,1922,0.013999228270203796
SIM,1872,60,na,1932,2369
SIM,1949,19,20-24,1968,354
STAT,1890,22,50-100,1912,0.5750334931447971
SIM,1821,35,35-39,1856,2
SIM,1824,43,50-100,1867,3
SIM,1978,26,50-100,2004,3
SIM,1936,26,35-39,1962,2
SIM,1854,41,25-29,1895,2
STAT,1894,31,45-49,1925,2.597600821686777
STAT,1855,82,na,1937,397.012910222413
SIM,1844,17,25-29,1861,15
STAT,1910,38,40-44,1948,1.645770613515091
STAT,1960,37,25-29,1997,1.5247054700917242
STAT,1898,15,40-44,1913,0.2865957091523726
STAT,1989,4,na,1993,6500.590483780585
STAT,1959,27,25-29,1986,99.79014808159613
STAT,1972,40,30-34,2012,0.19686228610755438
STAT,1934,42,30-34,1976,0.20547863268218863
SIM,1973,34,45-49,2007,9
STAT,1842,66,na,1908,1261.2596675838327
STAT,1847,45,40-44,1892,0.13304388232571965
STAT,1829,44,50-100,1873,1.0919479930370743
STAT,1891,83,na,1974,1126.9322729786165
SIM,1933,34,50-100,1967,3
STAT,1884,39,35-39,1923,7.983525940115582
SIM,1945,18,na,1963,4473
STAT,1947,21,45-49,1968,1.4679946875074226
SIM,1901,23,15-19,1924,4
STAT,1913,15,50-100,1928,0.08885928345577743
STAT,1992,3,na,1995,6516.165706367713
SIM,1842,34,20-24,1876,2
SIM,1901,3,na,1904,4588
SIM,1976,34,25-29,2010,1
SIM,1942,67,na,2009,4045
STAT,1975,5,na,1980,5986.048740588061
STAT,1973,27,15-19,2000,1.0582205795045012
SIM,1848,19,20-24,1867,1
SIM,1975,16,20-24,1991,200
STAT,1819,45,35-39,1864,0.27750568217756755
STAT,1863,17,25-29,1880,6.525178938276217
STAT,1936,28,50-100,1964,1.099433811500188
STAT,1951,24,15-19,1975,7.3345051869818425
SIM,1862,39,na,1901,2816
SIM,1871,17,25-29,1888,8
STAT,1892,47,15-19,1939,3.2484197174989483E-4
STAT,1852,32,50-100,1884,0.8944120915939537
STAT,1920,47,45-49,1967,0.27713935576457255
STAT,1899,63,na,1962,3009.3600306571393
STAT,1968,45,35-39,2013,0.19421270770760718
STAT,1933,40,na,1973,5907.788032687762
SIM,1879,95,na,1974,58
SIM,1950,62,na,2012,4125
STAT,1823,34,45-49,1857,3.948338919889136
STAT,1958,40,50-100,1998,0.1855686105286901
SIM,1875,81,na,1956,600
SIM,1892,22,40-44,1914,4
STAT,1937,54,na,1991,4170.852268090847
STAT,1899,107,na,2006,0.5946643624041099
STAT,1883,88,na,1971,432.7048007891995
SIM,1892,28,25-29,1920,66
STAT,1834,45,30-34,1879,0.10562261146221706
STAT,1844,104,na,1948,0.055789423125052195
SIM,1808,51,na,1859,1624
STAT,1911,37,na,1948,4197.146187404756
STAT,1968,34,25-29,2002,13.562382370970523
STAT,1946,42,35-39,1988,0.267858981322366
STAT,1852,27,20-24,1879,12.88270119449945
STAT,1931,47,20-24,1978,0.01705648809924565
STAT,1971,16,40-44,1987,2.045026040946605
SIM,1892,39,35-39,1931,18
STAT,1884,28,25-29,1912,48.06318777233822
STAT,1824,53,na,1877,1456.9448652686428
STAT,1834,34,20-24,1868,3.0948146256594447
SIM,1832,27,15-19,1859,3
SIM,1901,34,25-29,1935,9
SIM,1853,78,na,1931,654
STAT,1858,35,45-49,1893,1.8117527303280399
STAT,1958,21,20-24,1979,169.15457676698543
STAT,1894,46,40-44,1940,0.14367371093473916
STAT,1884,22,40-44,1906,2.376002568427981
STAT,1831,42,25-29,1873,0.615445654692876
SIM,1906,19,na,1925,3946
STAT,1893,15,15-19,1908,8.697060172955705
SIM,1853,35,35-39,1888,17
SIM,1949,26,20-24,1975,15
STAT,1986,27,25-29,2013,108.70214866556195
STAT,1970,39,40-44,2009,2.2232630491086907
STAT,1829,52,40-44,1881,0.00943799814128427
STAT,1936,20,30-34,1956,31.75169419441171
SIM,1894,60,na,1954,3116
STAT,1981,21,35-39,2002,15.249847939401104
STAT,1881,37,50-100,1918,1.366636199725683
SIM,1907,44,na,1951,4429
STAT,1986,16,15-19,2002,74.64889494541715
SIM,2003,9,na,2012,6666
STAT,1949,20,40-44,1969,4.530895741830982
STAT,1770,87,na,1857,25.443090257136006
SIM,1861,73,na,1934,679
STAT,1816,58,na,1874,1209.5574116328326
SIM,1981,27,15-19,2008,4
STAT,1897,20,25-29,1917,88.86471200211595
STAT,1860,24,20-24,1884,65.12851379700618
STAT,1897,39,45-49,1936,0.657291754326734
STAT,1821,39,40-44,1860,8.951092724493732
STAT,1981,29,45-49,2010,2.797150949572888
SIM,1994,16,15-19,2010,74
STAT,1879,46,45-49,1925,0.28519187600369955
SIM,1869,27,40-44,1896,3
SIM,1966,21,20-24,1987,2
STAT,1853,43,15-19,1896,0.013650006521339967
SIM,1966,29,30-34,1995,144
STAT,1831,53,35-39,1884,0.006880084551513316
STAT,1850,61,na,1911,1923.659489592359
STAT,1958,29,30-34,1987,59.5881216906709
SIM,1818,49,50-100,1867,2
STAT,1863,28,50-100,1891,0.6432478588551481
STAT,1885,9,na,1894,2986.7061836160356
SIM,1855,34,30-34,1889,7
SIM,1955,21,45-49,1976,6
STAT,1939,16,15-19,1955,52.461862033553096
STAT,1772,111,na,1883,1.5926694142994277E-4
STAT,1897,28,35-39,1925,14.83717645567427
STAT,1942,48,35-39,1990,0.16131328839385578
STAT,1845,35,35-39,1880,5.618468816437146
STAT,1847,34,30-34,1881,14.059099262143585
STAT,1925,34,15-19,1959,0.17582226954579686
SIM,1947,16,15-19,1963,1
STAT,1957,44,20-24,2001,0.027832810006592153
STAT,1898,40,40-44,1938,0.24607136709651112
STAT,1919,36,40-44,1955,1.8572217778208537
SIM,1841,37,50-100,1878,3
SIM,1870,38,45-49,1908,6
SIM,1879,49,45-49,1928,1
STAT,1958,16,na,1974,5580.622942882111
STAT,1855,54,35-39,1909,0.0071239661425829695
SIM,1819,35,na,1854,1417
STAT,1851,49,25-29,1900,0.0447228112313864
STAT,1979,31,20-24,2010,3.9529723940512294
STAT,1805,52,25-29,1857,0.012657495932714247
STAT,1861,51,25-29,1912,0.0034144920021117356
STAT,1936,29,na,1965,4135.775979893521
SIM,1975,38,na,2013,6042
STAT,1870,43,20-24,1913,0.17938019643770325
SIM,1963,39,45-49,2002,2
STAT,1994,21,45-49,2015,1.880611978283644
SIM,1924,32,50-100,1956,1
STAT,1860,21,40-44,1881,2.0124241695952403
STAT,1968,31,30-34,1999,23.16195337384896
STAT,1843,30,50-100,1873,1.1284199806849722
SIM,1922,31,35-39,1953,54
SIM,1879,38,35-39,1917,2
SIM,1891,12,na,1903,3645
STAT,1862,38,45-49,1900,1.9318913679614538
STAT,1841,27,45-49,1868,1.2260997851093212
SIM,1921,89,na,2010,1292
STAT,1895,25,20-24,1920,17.742451472206636
SIM,1895,26,na,1921,3820
SIM,1886,65,na,1951,1266
STAT,1978,17,35-39,1995,6.608799363324874
SIM,1802,94,na,1896,2
STAT,1831,23,na,1854,2059.4367339468254
STAT,1860,38,35-39,1898,6.545955674515933
STAT,1820,52,20-24,1872,7.246345899280531E-4
STAT,1886,38,30-34,1924,6.455575187356698
STAT,1912,47,40-44,1959,0.17502976555775476
STAT,1890,20,15-19,1910,4.679777027170118
SIM,1866,35,20-24,1901,2
STAT,1904,67,na,1971,3051.5164808213367
SIM,1811,55,na,1866,1458
SIM,1866,46,30-34,1912,1
STAT,1891,18,45-49,1909,0.09292656914931643
STAT,1841,16,35-39,1857,0.6329287786335727
STAT,1881,33,25-29,1914,11.353227297292841
SIM,1856,27,na,1883,2132
SIM,1920,47,40-44,1967,2
STAT,1938,48,15-19,1986,4.351913080677095E-4
STAT,1892,22,45-49,1914,1.0086298674186926
STAT,1810,45,15-19,1855,0.0016260558649171836
SIM,1894,38,30-34,1932,11
STAT,1860,27,25-29,1887,39.76648589969657
STAT,1903,41,30-34,1944,0.131825271539447
STAT,1837,24,20-24,1861,64.39021787540959
STAT,1896,41,15-19,1937,0.0014683784407782399
STAT,1923,62,na,1985,4513.036546928785
STAT,1829,84,na,1913,243.70217551578148
SIM,1934,29,40-44,1963,7
STAT,2009,5,na,2014,7135.900717670903
SIM,1902,13,na,1915,4312
SIM,1932,51,na,1983,5289
SIM,1879,30,25-29,1909,11
SIM,1874,32,45-49,1906,6
STAT,1820,79,na,1899,410.3046543908958
SIM,1831,31,40-44,1862,12
SIM,1896,30,30-34,1926,7
STAT,1924,18,20-24,1942,185.77915404390387
STAT,1834,31,40-44,1865,5.122346724744633
SIM,1932,18,20-24,1950,193
STAT,1850,17,15-19,1867,7.465466943661381
SIM,1863,43,25-29,1906,1
STAT,1873,24,30-34,1897,20.860183882641728
STAT,1913,15,40-44,1928,0.3317414055727821
SIM,1845,24,20-24,1869,6
SIM,1823,37,45-49,1860,2
STAT,1853,10,na,1863,2894.932955564242
SIM,1920,26,na,1946,4412
STAT,1870,104,na,1974,1.2042915435823265
STAT,1967,16,20-24,1983,195.49591730278172
STAT,1990,16,35-39,2006,6.9369502821034486
SIM,1917,18,25-29,1935,4
SIM,1921,15,40-44,1936,7
SIM,1892,25,20-24,1917,20
STAT,1830,26,30-34,1856,33.27747934800765
SIM,1877,36,35-39,1913,21
STAT,1959,3,na,1962,5938.266453985459
SIM,1849,57,na,1906,2279
STAT,1922,17,50-100,1939,0.5001699869553269
STAT,1854,26,50-100,1880,0.6047163978047496
STAT,1909,96,na,2005,156.32491999416297
STAT,1847,48,20-24,1895,0.009117433920925237
STAT,1881,32,40-44,1913,4.827325341955569
STAT,1869,36,35-39,1905,7.942801834922497
STAT,1909,18,25-29,1927,9.792560376097226
STAT,1974,33,40-44,2007,6.0073292143933035
STAT,1861,45,na,1906,2180.0329439096195
STAT,1962,44,50-100,2006,0.17992989788025363
STAT,1936,32,25-29,1968,10.366606300614542
STAT,1862,37,30-34,1899,5.190648539890042
STAT,1922,78,na,2000,2797.504903207825
SIM,1847,27,35-39,1874,2
SIM,1842,37,25-29,1879,5
SIM,1823,37,20-24,1860,1
STAT,1897,36,40-44,1933,6.787585168883386
STAT,1858,38,25-29,1896,2.5792440851204437
STAT,1859,16,20-24,1875,19.03056310325412
STAT,1847,48,50-100,1895,0.1866034735268167
STAT,1972,31,40-44,2003,5.8975176877411855
STAT,1815,92,na,1907,23.11049496223917
STAT,1834,37,25-29,1871,3.268284536695362
SIM,1938,43,50-100,1981,1
STAT,1977,37,30-34,2014,2.9278868694120814
SIM,1837,48,na,1885,2136
STAT,1838,40,15-19,1878,0.014355317479496735
STAT,1863,50,20-24,1913,7.55342768679368E-4
STAT,1995,19,50-100,2014,0.6254565170328216
STAT,1926,29,40-44,1955,6.400839704210305
STAT,1832,88,na,1920,93.52998344868539
STAT,1977,11,na,1988,6126.06198216447
STAT,1847,37,35-39,1884,5.64661822109589
STAT,1823,47,20-24,1870,0.011856679876201546
STAT,1957,47,25-29,2004,0.08395281397579228
STAT,1961,36,na,1997,5784.3739561163475
SIM,1847,38,45-49,1885,8
STAT,1863,16,40-44,1879,0.2118588200071839
STAT,1930,73,na,2003,3999.9857371214466
STAT,1983,21,na,2004,5983.4064574668555
STAT,1839,27,35-39,1866,9.63990322087788
STAT,1870,2,na,1872,3779.9477348237638
STAT,1975,26,na,2001,5730.628229536038
STAT,1940,21,35-39,1961,11.076752707942314
STAT,1926,18,30-34,1944,17.197435654873573
STAT,1858,46,30-34,1904,0.08739511319804413
STAT,1847,48,45-49,1895,0.17930952697334915
STAT,1833,89,na,1922,73.92340036114909
STAT,1906,22,40-44,1928,3.506781459625161
SIM,1980,31,40-44,2011,16
SIM,1845,43,na,1888,2037
STAT,1869,25,na,1894,2685.2933544710645
STAT,1950,44,20-24,1994,0.024960521219436052
STAT,1936,23,35-39,1959,10.391562348081898
STAT,1974,20,50-100,1994,0.9955151143795522
STAT,1874,71,na,1945,1576.9964976769618
STAT,1966,19,50-100,1985,0.5396765622383545
STAT,1839,38,45-49,1877,1.869720313459535
STAT,1908,95,na,2003,205.5681278403824
SIM,1855,37,35-39,1892,3
SIM,1950,45,30-34,1995,1
STAT,1916,25,50-100,1941,1.195874907450685
STAT,1988,27,35-39,2015,24.887615184832505
SIM,1903,94,na,1997,142
STAT,1830,27,45-49,1857,1.39573055558488
STAT,1836,47,30-34,1883,0.09222624176221328
STAT,1818,84,na,1902,147.19054905504476
STAT,1984,23,50-100,2007,1.0817032485240625
SIM,1967,43,50-100,2010,1
STAT,1848,63,na,1911,1895.8727001453735
STAT,1867,25,15-19,1892,0.4921758181076201
STAT,1944,42,25-29,1986,0.09216909298784853
SIM,1882,18,15-19,1900,9
SIM,1834,38,35-39,1872,10
SIM,1836,47,na,1883,1590
STAT,1958,24,25-29,1982,140.3748400164526
STAT,1997,16,45-49,2013,0.8420533159775473
STAT,1903,44,35-39,1947,0.2039093794208775
STAT,1812,45,25-29,1857,0.1380622737211152
STAT,1897,25,30-34,1922,39.12267363291278
STAT,1841,84,na,1925,295.76756848277734
SIM,1834,27,25-29,1861,1
STAT,1918,19,50-100,1937,0.4679859843572942
SIM,1919,29,45-49,1948,3
SIM,1944,23,35-39,1967,1
SIM,1882,35,na,1917,3297
SIM,1858,38,20-24,1896,1
SIM,1889,14,na,1903,4109
STAT,1944,31,15-19,1975,0.1627794288636088
SIM,1886,49,na,1935,1880
STAT,1986,15,30-34,2001,20.053808591460204
SIM,1968,23,20-24,1991,176
STAT,1834,48,35-39,1882,0.1337700974874596
SIM,1836,37,30-34,1873,6
STAT,1826,38,35-39,1864,5.544549191116408
STAT,1971,0,na,1971,5789.594566272659
STAT,1986,24,20-24,2010,183.327219429329
STAT,1936,21,15-19,1957,5.878633944272305
SIM,1858,29,30-34,1887,5
SIM,1927,36,40-44,1963,2
STAT,1931,19,50-100,1950,0.5630183867258143
SIM,1944,32,25-29,1976,4
SIM,1944,21,15-19,1965,14
SIM,1966,24,25-29,1990,9
STAT,1877,76,na,1953,1137.3059077784749
STAT,1914,31,35-39,1945,10.664207001432862
SIM,1878,14,na,1892,3078
SIM,1877,34,50-100,1911,2
STAT,1828,37,30-34,1865,5.485216402360164
SIM,1870,50,na,1920,2859
SIM,1961,35,35-39,1996,8
SIM,1908,39,40-44,1947,1
SIM,1956,18,na,1974,5510
STAT,1881,35,45-49,1916,2.2400822549270725
SIM,1837,91,na,1928,90
STAT,1876,19,30-34,1895,1.8912554429275765
SIM,1840,21,35-39,1861,11
SIM,1919,48,50-100,1967,1
STAT,1860,24,45-49,1884,0.6590316950870881
STAT,1900,16,15-19,1916,9.526666825627412
STAT,1821,51,50-100,1872,0.026863991612147576
STAT,1876,28,20-24,1904,13.946109602953799
STAT,1955,49,na,2004,5819.964352243732
SIM,1823,33,50-100,1856,2
STAT,1855,51,30-34,1906,0.005089231920247589
STAT,1865,28,45-49,1893,1.15204036016225
STAT,1886,39,45-49,1925,2.402269998747706
STAT,1953,35,35-39,1988,3.484866589450697
STAT,1890,58,na,1948,2788.650156476259
SIM,1988,18,40-44,2006,3
SIM,1939,19,15-19,1958,104
SIM,1975,16,50-100,1991,1
SIM,1938,26,45-49,1964,3
STAT,1860,35,30-34,1895,5.004164461745641
STAT,1888,63,na,1951,2420.5418170980306
STAT,1864,30,15-19,1894,0.14792232743785663
SIM,1903,34,35-39,1937,31
STAT,1979,34,25-29,2013,14.950864614397128
SIM,1968,34,20-24,2002,1
SIM,1908,28,30-34,1936,46
SIM,1895,18,25-29,1913,15
STAT,1894,42,50-100,1936,0.10870168504553043
SIM,1869,5,na,1874,2487
SIM,1894,39,45-49,1933,1
SIM,1983,24,45-49,2007,3
SIM,1898,46,45-49,1944,1
STAT,1789,67,na,1856,597.72187664
STAT,1871,25,35-39,1896,11.153347209084973
SIM,1924,56,na,1980,4644
SIM,1884,28,20-24,1912,11
SIM,1885,43,30-34,1928,4
SIM,1979,24,25-29,2003,312
STAT,1804,92,na,1896,18.109123122140172
STAT,1857,40,na,1897,2098.3283581245832
SIM,1926,80,na,2006,3608
STAT,1880,17,30-34,1897,1.9496868314497613
SIM,1851,12,na,1863,3168
STAT,1949,35,15-19,1984,0.026599744256880192
STAT,1877,32,20-24,1909,3.244873147146869
STAT,1918,41,15-19,1959,0.0018866048288765916
STAT,1944,24,na,1968,4547.376129421851
STAT,1837,26,40-44,1863,2.804265048898412
SIM,1922,6,na,1928,5559
SIM,1918,40,50-100,1958,2
STAT,1877,43,30-34,1920,1.370143762919645
STAT,1919,17,na,1936,4693.022315709608
SIM,1823,34,40-44,1857,13
SIM,1845,26,40-44,1871,8
STAT,1861,61,na,1922,1792.7824656517498
STAT,1865,75,na,1940,1071.9336375998002
STAT,1879,45,30-34,1924,0.11780873655778261
STAT,1834,34,45-49,1868,1.9965553606531912
STAT,1808,47,25-29,1855,0.28796958971710035
STAT,1845,15,na,1860,1978.2490697229366
SIM,1958,42,na,2000,6123
STAT,1854,27,30-34,1881,21.50705562840371
STAT,1957,34,na,1991,5858.284211362841
SIM,1929,85,na,2014,1796
STAT,1912,62,na,1974,3712.507022574929
SIM,1862,27,30-34,1889,38
STAT,1891,5,na,1896,3737.864358168265
STAT,1894,49,45-49,1943,0.19337063209586777
STAT,1895,28,25-29,1923,63.32117706423935
STAT,1841,24,40-44,1865,2.3134124597571555
STAT,1881,41,30-34,1922,1.2855196389437034
SIM,1881,25,45-49,1906,3
SIM,1969,28,na,1997,5542
SIM,1953,26,40-44,1979,8
STAT,1866,32,45-49,1898,1.865300105522091
SIM,1798,56,na,1854,1300
SIM,1850,73,na,1923,472
STAT,1945,26,40-44,1971,5.904038783310744
SIM,1985,21,15-19,2006,9
SIM,1824,81,na,1905,13
STAT,1855,92,na,1947,35.439300575959805
SIM,1973,28,50-100,2001,3
STAT,1881,30,20-24,1911,3.0330389427110376
SIM,1842,34,45-49,1876,1
STAT,1887,18,25-29,1905,7.309708566859701
STAT,1874,51,35-39,1925,0.010219814275646933
STAT,1900,37,na,1937,3802.5272102101067
SIM,1953,13,na,1966,5699
SIM,1992,10,na,2002,7036
STAT,1788,103,na,1891,0.0651398258518518
STAT,1956,16,45-49,1972,0.7630502963560746
STAT,1975,27,25-29,2002,100.64241880544674
STAT,1855,42,40-44,1897,1.9115424633144695
STAT,1894,32,na,1926,3540.1859966764946
SIM,1870,35,40-44,1905,19
STAT,1810,61,na,1871,1271.1418965643927
SIM,1834,24,45-49,1858,3
STAT,1865,17,35-39,1882,0.5887623898841616
STAT,1915,67,na,1982,3590.337201194678
STAT,1950,50,na,2000,5167.334581831835
STAT,1961,45,25-29,2006,0.08265349513811954
STAT,1947,20,30-34,1967,37.51175185601734
SIM,1879,35,30-34,1914,11
STAT,1866,41,35-39,1907,1.9457227307946927
STAT,1966,39,20-24,2005,0.39063299581202454
SIM,1896,33,35-39,1929,16
STAT,1870,45,40-44,1915,0.19672023760588606
STAT,1848,16,45-49,1864,0.08654999886448611
STAT,1888,33,35-39,1921,13.680145633252618
STAT,1907,16,na,1923,4298.947703688373
SIM,1983,27,25-29,2010,114
STAT,1917,24,15-19,1941,6.488378923750092
SIM,1961,39,35-39,2000,9
STAT,1823,33,30-34,1856,43.55766816536462
SIM,1980,33,30-34,2013,46
STAT,1858,35,20-24,1893,0.7005753147099719
STAT,1853,45,35-39,1898,0.14077628398274414
SIM,1945,16,40-44,1961,2
STAT,1874,19,20-24,1893,20.832998964697733
SIM,1805,86,na,1891,43
SIM,1917,17,40-44,1934,1
STAT,1901,47,40-44,1948,0.15537767556100168
STAT,1886,53,na,1939,2579.0615426914155
STAT,1891,25,50-100,1916,0.9185949374323794
STAT,1853,34,25-29,1887,10.285709774536302
STAT,1946,16,50-100,1962,0.4796883570407103
STAT,1908,30,20-24,1938,2.681819778991174
STAT,1990,15,50-100,2005,0.6195253274793433
SIM,1853,22,na,1875,2316
SIM,1921,15,50-100,1936,2
STAT,1791,92,na,1883,12.581809145822822
STAT,1937,16,40-44,1953,1.575042929800987
STAT,1863,53,25-29,1916,0.0035168922785672407
STAT,1972,33,30-34,2005,23.71505410439261
SIM,1950,48,na,1998,4633
SIM,1916,38,30-34,1954,3
STAT,1817,59,na,1876,1616.0569338516484
STAT,1981,20,20-24,2001,180.1537324771995
STAT,1892,32,40-44,1924,6.272775658941415
SIM,1831,33,30-34,1864,35
STAT,1913,98,na,2011,85.71246838312085
SIM,1872,32,35-39,1904,17
STAT,1862,47,35-39,1909,0.1357148645192572
STAT,1855,45,45-49,1900,0.20281335100804382
STAT,1862,35,40-44,1897,4.303881817220359
STAT,1901,5,na,1906,4236.216925903452
STAT,1921,24,35-39,1945,12.192101244575918
STAT,1819,43,15-19,1862,0.028153288650350248
STAT,1918,16,na,1934,4878.307014599083
STAT,1861,0,na,1861,3710.643261639462
STAT,1868,37,50-100,1905,1.361281428394888
SIM,1916,30,20-24,1946,1
STAT,1910,36,na,1946,4176.742996617333
STAT,1909,17,40-44,1926,0.31690140776056297
SIM,1852,77,na,1929,339
SIM,1868,27,50-100,1895,2
STAT,1948,47,50-100,1995,0.31070263242202995
SIM,1932,48,50-100,1980,1
SIM,1966,23,na,1989,5907
STAT,1908,17,na,1925,4329.119254035669
STAT,1910,34,30-34,1944,17.399393616227997
STAT,1983,23,35-39,2006,15.417633555075014
STAT,1839,24,30-34,1863,17.89056751792642
STAT,1902,107,na,2009,0.626654613699448
STAT,1890,22,35-39,1912,8.22872832378436
STAT,1901,33,15-19,1934,0.2292281045326298
SIM,1894,22,15-19,1916,9
STAT,1919,20,25-29,1939,117.39587746556633
STAT,1903,106,na,2009,1.2869182836089543
SIM,1913,13,na,1926,5074
STAT,1908,49,40-44,1957,0.16379415794024607
STAT,1863,19,45-49,1882,0.06764459944764847
SIM,1900,65,na,1965,2731
STAT,1938,55,na,1993,4215.708834512373
STAT,1839,35,40-44,1874,4.235634913895932
SIM,1925,57,na,1982,5096
SIM,1861,34,25-29,1895,5
SIM,1916,49,40-44,1965,1
STAT,1864,6,na,1870,2922.3487905972984
STAT,1936,48,40-44,1984,0.17994728804262067
STAT,1949,46,25-29,1995,0.0742386923334217
STAT,2000,11,na,2011,6742.7030363560425
STAT,1908,38,30-34,1946,1.9620119454340699
STAT,1969,27,40-44,1996,6.748534040288707
STAT,1886,22,15-19,1908,4.01593872733722
STAT,1907,18,15-19,1925,10.050316003394633
STAT,1884,37,15-19,1921,0.06402860980417399
STAT,1912,37,45-49,1949,0.7686007120755645
SIM,1942,20,20-24,1962,247
STAT,1855,44,30-34,1899,0.965043069169372
STAT,1965,19,15-19,1984,65.34265645481129
STAT,1865,91,na,1956,68.27610938950599
STAT,1933,39,50-100,1972,0.6588536443711257
SIM,1847,24,30-34,1871,42
SIM,1884,19,30-34,1903,5
SIM,1991,23,35-39,2014,18
SIM,1838,30,na,1868,1852
SIM,1879,36,45-49,1915,1
STAT,1917,35,25-29,1952,1.1914600650446374
SIM,1816,44,45-49,1860,2
SIM,1847,35,40-44,1882,9
SIM,1904,79,na,1983,2716
STAT,1854,11,na,1865,2337.1452461305157
STAT,1858,25,na,1883,2231.392287406664
SIM,1811,71,na,1882,988
SIM,1895,38,50-100,1933,5
STAT,1998,14,na,2012,6653.643783070799
STAT,1830,24,40-44,1854,3.587708884779508
SIM,1860,29,na,1889,2566
STAT,1873,25,45-49,1898,1.3173581269038581
STAT,1952,60,na,2012,4921.22812348727
SIM,1927,20,25-29,1947,6
STAT,1873,21,50-100,1894,0.48202776235007866
STAT,1938,33,40-44,1971,4.540429496882243
SIM,1849,20,40-44,1869,3
SIM,1925,24,15-19,1949,9
STAT,1945,0,na,1945,5615.05506317678
SIM,1946,33,40-44,1979,10
STAT,1816,41,45-49,1857,3.519326655986193
STAT,1856,23,40-44,1879,2.115519212657415
SIM,1812,56,na,1868,1232
SIM,1845,25,35-39,1870,1
STAT,1845,33,15-19,1878,0.11292072092463537
STAT,1980,15,na,1995,5900.012599151477
STAT,1975,29,15-19,2004,1.0783686733490419
STAT,1853,66,na,1919,1631.8296252049358
STAT,1870,30,45-49,1900,1.9999362699131074
STAT,1866,20,na,1886,2587.481250710906
STAT,1816,54,20-24,1870,0.001388271091829522
STAT,1826,35,30-34,1861,4.489284922601247
STAT,1837,29,45-49,1866,1.0171700960348689
STAT,1986,18,35-39,2004,6.89790349577687
STAT,1957,40,45-49,1997,0.26390010198821257
SIM,1865,3,na,1868,3749
SIM,1896,27,na,1923,3594
SIM,1936,18,50-100,1954,1
SIM,1993,11,na,2004,6960
SIM,1969,41,25-29,2010,2
SIM,1972,23,40-44,1995,12
STAT,1837,18,35-39,1855,0.7490976687657223
SIM,1873,39,na,1912,3314
STAT,1919,39,45-49,1958,0.8431983503065325
STAT,1882,28,15-19,1910,0.509620109186663
SIM,1983,24,20-24,2007,352
STAT,1833,37,50-100,1870,1.0887179559117424
SIM,1864,65,na,1929,1724
STAT,1890,111,na,2001,0.016653425540779795
STAT,1940,72,na,2012,3316.935284365889
SIM,1864,23,40-44,1887,3
STAT,1831,41,40-44,1872,2.183510295231167
SIM,1834,35,30-34,1869,8
STAT,1827,58,na,1885,1686.0546715248677
STAT,1965,41,45-49,2006,0.24955263232022126
STAT,1861,41,50-100,1902,1.0181537251876138
STAT,1886,112,na,1998,0.005014088702828538
STAT,1805,51,40-44,1856,0.038403537905524865
SIM,1850,31,45-49,1881,2
STAT,1862,21,15-19,1883,3.312926159143046
SIM,1942,28,30-34,1970,63
SIM,1863,23,50-100,1886,1
SIM,1860,51,na,1911,2213
SIM,1915,18,15-19,1933,12
STAT,1934,20,20-24,1954,173.1016779285368
STAT,1886,36,40-44,1922,5.354430696678062
STAT,1887,15,20-24,1902,23.035247827520458
SIM,1834,24,20-24,1858,66
SIM,1942,39,40-44,1981,6
STAT,1852,19,15-19,1871,6.687668849591894
STAT,1926,67,na,1993,4394.675215719972
STAT,1934,39,40-44,1973,2.3801306464479155
SIM,1885,64,na,1949,2360
SIM,1870,21,15-19,1891,6
STAT,1909,42,na,1951,4013.38162472082
SIM,1881,50,na,1931,1763
SIM,1894,36,40-44,1930,10
STAT,1949,23,45-49,1972,1.5146637735213015
SIM,1895,15,20-24,1910,24
SIM,1904,95,na,1999,374
SIM,1858,25,45-49,1883,2
SIM,1971,41,50-100,2012,1
SIM,1968,35,35-39,2003,1
STAT,1934,28,30-34,1962,60.830924492793606
SIM,1898,90,na,1988,746
SIM,1952,45,40-44,1997,1
SIM,1839,74,na,1913,1288
STAT,1836,46,25-29,1882,0.05558603454103969
STAT,1876,15,45-49,1891,0.07829043362955486
SIM,1819,35,35-39,1854,5
STAT,1986,25,35-39,2011,24.81647982657854
STAT,1871,23,15-19,1894,3.7759924829658087
STAT,1907,32,na,1939,4086.36224221802
SIM,1870,33,20-24,1903,5
STAT,1842,44,20-24,1886,0.12324148485543332
SIM,1905,18,na,1923,4386
STAT,1964,23,40-44,1987,4.901782539588616
SIM,1845,18,35-39,1863,2
SIM,1870,44,30-34,1914,1
SIM,1834,29,15-19,1863,1
SIM,1867,16,20-24,1883,1
STAT,1847,35,45-49,1882,1.6248830996324157
STAT,1960,18,30-34,1978,18.314858719898
STAT,1970,21,15-19,1991,7.717994990643244
STAT,1855,76,na,1931,806.1415466992388
STAT,1836,45,40-44,1881,0.16734434186622488
SIM,1842,78,na,1920,854
STAT,1944,45,40-44,1989,0.20463575662708422
SIM,1824,41,45-49,1865,1
SIM,1935,56,na,1991,5864
STAT,1933,24,na,1957,5588.794623819418
STAT,1894,47,25-29,1941,0.04797724389538063
STAT,1899,20,35-39,1919,9.281354395052265
STAT,1963,44,na,2007,5640.029418590029
SIM,1835,81,na,1916,559
STAT,1827,44,25-29,1871,0.8254557227556932
STAT,1826,29,15-19,1855,0.7855836864658855
SIM,1855,35,45-49,1890,6
STAT,1865,25,40-44,1890,3.1403104299552647
SIM,1953,29,45-49,1982,8
STAT,1852,18,30-34,1870,1.8067797432078891
SIM,1861,42,30-34,1903,2
SIM,1835,44,25-29,1879,1
STAT,1951,37,na,1988,5326.539487071326
SIM,1918,33,35-39,1951,4
STAT,1858,47,15-19,1905,3.584352258716623E-4
SIM,1899,75,na,1974,2399
SIM,1905,5,na,1910,4660
STAT,1807,97,na,1904,2.627048022418351
STAT,1876,75,na,1951,1228.1264884208329
STAT,1897,26,45-49,1923,1.719226051151497
STAT,1839,32,50-100,1871,0.8942000108808038
STAT,1945,29,45-49,1974,2.185177096373038
SIM,1892,36,30-34,1928,14
STAT,1971,19,45-49,1990,0.7296726364308835
SIM,1838,22,30-34,1860,21
STAT,1853,31,20-24,1884,2.800323060810066
STAT,1984,22,na,2006,6005.30628942319
STAT,1898,43,45-49,1941,0.1609262547874242
STAT,1912,20,15-19,1932,5.928189659780721
STAT,1863,51,35-39,1914,0.008729055441911377
STAT,1809,45,na,1854,1509.531848023364
SIM,1884,39,na,1923,2646
SIM,1893,40,50-100,1933,5
STAT,1908,33,25-29,1941,10.038548827219334
SIM,1881,34,35-39,1915,16
SIM,1975,19,25-29,1994,168
STAT,1853,4,na,1857,3192.2708210322085
SIM,1955,23,35-39,1978,23
STAT,1887,38,na,1925,3031.9261759011497
STAT,1833,33,na,1866,1942.5231705187816
STAT,1912,31,25-29,1943,10.548673677960089
STAT,1901,49,30-34,1950,0.08642231898444361
STAT,1947,23,35-39,1970,12.27669005032766
STAT,1892,68,na,1960,2363.0242668658443
STAT,1888,30,30-34,1918,23.875795795646212
SIM,1838,33,40-44,1871,8
STAT,1862,44,30-34,1906,1.1045853176009843
STAT,1956,29,20-24,1985,27.96788717865576
STAT,1932,27,15-19,1959,1.067351744349974
STAT,1885,40,50-100,1925,1.2283623539034816
STAT,1981,26,40-44,2007,7.557505392338024
STAT,1884,36,30-34,1920,6.106144869959949
STAT,1838,42,35-39,1880,1.8347215131525798
STAT,1873,34,35-39,1907,11.832464864099926
STAT,1884,25,20-24,1909,13.467197171416156
STAT,1967,19,25-29,1986,62.42875686132895
SIM,1800,68,na,1868,1002
STAT,1960,29,40-44,1989,7.029227741096979
SIM,1818,96,na,1914,19
SIM,1861,31,20-24,1892,3
STAT,1864,10,na,1874,2831.4335713102428
SIM,1920,34,40-44,1954,2
STAT,1875,52,50-100,1927,0.017915585551598754
STAT,1831,50,30-34,1881,0.0050482921322288704
SIM,1831,78,na,1909,557
STAT,1910,35,15-19,1945,0.02141866791232321
STAT,1953,31,50-100,1984,1.1772368135743845
STAT,1845,17,50-100,1862,0.04172607826281529
SIM,1942,23,25-29,1965,147
SIM,1920,20,15-19,1940,13
SIM,1941,31,na,1972,3941
SIM,1915,79,na,1994,2186
STAT,1910,7,na,1917,4560.73731078162
STAT,1892,35,45-49,1927,2.9108320751882046
STAT,1853,42,30-34,1895,1.1432222961339387
SIM,1906,28,20-24,1934,23
SIM,1976,31,45-49,2007,2
SIM,1842,31,40-44,1873,3
SIM,1816,86,na,1902,49
STAT,1913,18,45-49,1931,0.11762213989484617
STAT,1855,14,na,1869,2394.1287748976833
STAT,1942,20,na,1962,4422.507424736288
STAT,1946,34,na,1980,4928.1569682692525
STAT,1920,30,50-100,1950,1.0530809845084936
STAT,1877,45,20-24,1922,0.014548954684360084
SIM,1884,61,na,1945,2148
STAT,1895,26,35-39,1921,14.54428432543273
SIM,1949,29,25-29,1978,14
STAT,1954,2,na,1956,5614.25355559311
STAT,1929,16,na,1945,5434.599365435005
SIM,1819,37,25-29,1856,1
STAT,1840,46,45-49,1886,0.19337533471422838
SIM,1916,22,15-19,1938,11
STAT,1789,102,na,1891,0.05942692081513547
STAT,1792,74,na,1866,677.5689194511145
SIM,1831,49,50-100,1880,1
STAT,1810,107,na,1917,0.0026852041861546564
STAT,1823,49,50-100,1872,0.2359618744608991
STAT,1905,68,na,1973,3028.2898598396473
STAT,1842,31,45-49,1873,1.637987188853784
SIM,1991,20,30-34,2011,71
STAT,1876,51,45-49,1927,0.017395839208332764
STAT,1892,22,50-100,1914,0.5898420502048993
SIM,1903,14,na,1917,4227
STAT,1881,34,30-34,1915,19.268525523806385
SIM,1968,32,30-34,2000,8
STAT,1933,44,15-19,1977,0.0024279640588232097
STAT,1908,22,15-19,1930,5.654828070918428
SIM,1816,41,40-44,1857,4
SIM,1850,40,35-39,1890,4
SIM,1858,22,40-44,1880,4
STAT,1916,90,na,2006,710.3348477777811
SIM,1813,102,na,1915,8
STAT,1983,20,30-34,2003,47.108987988952684
SIM,1916,33,25-29,1949,20
STAT,1994,21,na,2015,6103.610226435853
STAT,1816,108,na,1924,9.045964007207566E-4
SIM,1887,22,50-100,1909,1
STAT,1894,16,50-100,1910,0.07285987941989534
STAT,1895,24,15-19,1919,4.924743455328044
STAT,1906,37,15-19,1943,0.02039718546436669
STAT,1856,38,15-19,1894,0.04919601484028821
STAT,1864,32,35-39,1896,10.43534987114203
STAT,1834,46,15-19,1880,4.3090061054186464E-4
SIM,1986,5,na,1991,6757
STAT,1879,22,50-100,1901,0.4913951419007129
STAT,1842,40,35-39,1882,1.479111162607216
STAT,1880,83,na,1963,764.4322118195281
SIM,1968,25,40-44,1993,20
STAT,1821,33,20-24,1854,10.92316839083728
STAT,1942,46,15-19,1988,4.6332863537573265E-4
SIM,1957,20,40-44,1977,1
SIM,1829,34,50-100,1863,1
STAT,1827,52,50-100,1879,0.01846074223537893
STAT,1887,17,40-44,1904,0.23655273454443562
SIM,1866,38,25-29,1904,3
STAT,1860,36,15-19,1896,0.052481228879783307
STAT,1826,37,20-24,1863,0.6176747528599499
STAT,1922,24,na,1946,4800.544063440024
STAT,1966,11,na,1977,5662.981142621184
SIM,1856,29,20-24,1885,18
STAT,1869,109,na,1978,0.031230562449947954
SIM,1827,30,na,1857,1619
SIM,1845,22,30-34,1867,25
SIM,1870,36,25-29,1906,6
STAT,1866,76,na,1942,1013.4015639924294
STAT,1863,28,na,1891,2399.787759451782
STAT,1988,24,30-34,2012,47.56303925204947
STAT,1943,23,na,1966,4482.729858293703
SIM,1858,39,50-100,1897,2
STAT,1831,44,45-49,1875,1.3980984254552795
SIM,1944,20,30-34,1964,2
SIM,1885,7,na,1892,3431
SIM,1849,73,na,1922,1500
STAT,1851,34,15-19,1885,0.11512257873502509
SIM,1834,37,20-24,1871,1
STAT,1830,29,35-39,1859,11.089330730794133
STAT,1779,92,na,1871,9.589339524435143
STAT,1910,37,35-39,1947,2.672398173724867
STAT,1934,36,50-100,1970,0.6695803114102074
SIM,1888,75,na,1963,1236
SIM,1870,47,35-39,1917,2
SIM,1942,36,50-100,1978,1
SIM,1985,28,40-44,2013,8
STAT,1816,50,35-39,1866,0.01754187878023836
STAT,1912,34,40-44,1946,4.4100452319777395
STAT,1848,29,20-24,1877,14.667923006881898
STAT,1934,23,25-29,1957,143.27963882942305
SIM,1951,25,25-29,1976,125
SIM,1983,21,50-100,2004,4
STAT,1827,41,20-24,1868,0.2157902600971186
STAT,1981,23,25-29,2004,149.50111832110338
STAT,1979,22,30-34,2001,45.82023502929562
STAT,1805,54,45-49,1859,0.04976846388830532
STAT,1897,23,40-44,1920,3.2056597007419905
SIM,1860,27,20-24,1887,9
STAT,1788,66,na,1854,1138.9999999999998
SIM,1899,26,15-19,1925,1
SIM,1929,31,na,1960,5272
STAT,1858,49,35-39,1907,0.12340842008492708
STAT,1829,54,30-34,1883,0.005128943578207671
SIM,1847,47,na,1894,2328
SIM,1964,29,20-24,1993,33
STAT,1819,85,na,1904,182.49469448378736
SIM,1846,42,35-39,1888,3
STAT,1944,48,45-49,1992,0.27998934439893697
STAT,1909,15,20-24,1924,30.859514174347545
SIM,1866,49,35-39,1915,1
STAT,1836,54,30-34,1890,0.0052702680366255176
STAT,1977,28,40-44,2005,7.295853378040226
STAT,1943,25,25-29,1968,80.97610926296471
STAT,1891,15,40-44,1906,0.26209003417392623
STAT,1843,88,na,1931,137.74774140694015
STAT,1838,58,na,1896,1713.0147795136493
STAT,1869,34,15-19,1903,0.1577933696719227
STAT,1820,54,40-44,1874,0.0099340196544566
SIM,1824,50,35-39,1874,1
SIM,1826,48,na,1874,1727
STAT,1822,89,na,1911,86.31477762193701
SIM,1875,65,na,1940,2129
STAT,1859,19,25-29,1878,5.976055290983261
SIM,1918,30,30-34,1948,22
SIM,1928,16,35-39,1944,8
SIM,1987,22,30-34,2009,53
STAT,1836,48,45-49,1884,0.22198677254196528
STAT,1981,1,na,1982,6354.080936513561
SIM,1896,64,na,1960,2888
STAT,1837,27,25-29,1864,39.31569373977053
STAT,1986,22,30-34,2008,47.4180777704863
STAT,1827,52,30-34,1879,0.007276058033391489
STAT,1902,28,40-44,1930,4.86745644218932
STAT,1836,43,20-24,1879,0.16981000575127908
STAT,1873,38,20-24,1911,0.9039317409079625
STAT,1902,17,30-34,1919,2.599008165758033
SIM,1867,19,25-29,1886,7
SIM,1887,90,na,1977,411
SIM,1902,69,na,1971,2823
SIM,1845,27,25-29,1872,50
STAT,1863,108,na,1971,0.0315087419978562
SIM,1846,28,na,1874,1644
SIM,1857,30,40-44,1887,4
STAT,1966,20,35-39,1986,13.626591475685961
SIM,1905,40,na,1945,4118
SIM,1851,39,25-29,1890,7
STAT,1844,18,35-39,1862,0.5799713684473865
STAT,1809,61,na,1870,1120.7913389395737
STAT,1976,18,50-100,1994,0.5774599565808635
STAT,1871,1,na,1872,4031.075441782219
SIM,1951,17,40-44,1968,1
SIM,1961,20,25-29,1981,280
STAT,1948,17,na,1965,4861.073854527272
SIM,1935,49,45-49,1984,3
STAT,1828,35,40-44,1863,4.706806318434872
STAT,1943,17,40-44,1960,1.7118895459929333
SIM,1838,36,45-49,1874,1
SIM,1970,15,25-29,1985,148
STAT,1925,48,40-44,1973,0.21979611244441127
SIM,1897,29,20-24,1926,19
STAT,1894,111,na,2005,0.01833203692439729
SIM,1987,25,35-39,2012,2
SIM,1842,39,15-19,1881,1
STAT,1834,39,15-19,1873,0.06243301451789109
STAT,1962,15,25-29,1977,64.11278896013492
STAT,1819,35,30-34,1854,22.14598224416284
STAT,1916,48,30-34,1964,0.10523758241565329
SIM,1829,34,na,1863,1736
STAT,1873,33,na,1906,2800.3756914598926
STAT,1889,29,20-24,1918,16.569524101076897
SIM,1880,89,na,1969,321
SIM,1968,30,20-24,1998,2
STAT,1873,31,30-34,1904,20.660186737596785
STAT,1864,48,15-19,1912,4.069972746315631E-4
STAT,1879,24,na,1903,2832.087176792135
STAT,1841,22,na,1863,2408.1737380412796
STAT,1882,112,na,1994,0.004216263530498839
SIM,1862,25,40-44,1887,6
SIM,1852,18,35-39,1870,1
SIM,1853,25,30-34,1878,6
STAT,1942,38,30-34,1980,2.2626448505340218
STAT,1843,11,na,1854,3075.0000000000005
SIM,1965,2,na,1967,5623
SIM,1950,38,30-34,1988,6
SIM,1949,36,25-29,1985,1
STAT,1895,19,35-39,1914,0.819846099302506
SIM,1812,43,30-34,1855,3
STAT,1780,86,na,1866,97.21095710864938
STAT,1771,112,na,1883,9.557772889419779E-4
STAT,1766,114,na,1880,7.39368563054094E-4
STAT,1845,25,30-34,1870,20.954055848425735
STAT,1911,6,na,1917,4617.449367173062
STAT,1975,20,45-49,1995,1.7198877693078136
STAT,1823,38,50-100,1861,1.4018325397830005
STAT,1979,25,35-39,2004,23.980241117267465
STAT,1989,18,15-19,2007,74.99409213517326
STAT,1923,25,15-19,1948,0.9413668002913447
STAT,1968,45,50-100,2013,0.340704577629678
STAT,1855,30,na,1885,2110.854374032036
STAT,1951,38,40-44,1989,2.117300848029388
SIM,1953,25,35-39,1978,53
SIM,1842,16,na,1858,2589
STAT,1854,25,40-44,1879,2.852256857978481
SIM,1797,71,na,1868,512
SIM,1909,64,na,1973,4151
SIM,1881,2,na,1883,2771
STAT,1840,52,50-100,1892,0.012050951913414308
STAT,1917,27,40-44,1944,5.641262163821272
SIM,1849,36,20-24,1885,4
STAT,1856,20,15-19,1876,3.422417792689581
SIM,1827,35,30-34,1862,6
STAT,1822,43,na,1865,2239.0472770685624
SIM,1917,25,25-29,1942,170
SIM,1921,7,na,1928,5575
STAT,1913,47,na,1960,4140.348171067024
SIM,1834,80,na,1914,474
SIM,1838,30,50-100,1868,2
SIM,1935,30,25-29,1965,22
STAT,1961,49,35-39,2010,0.19878081699191005
STAT,1825,44,15-19,1869,0.0196681830483307
STAT,1890,38,15-19,1928,0.0787919258732052
SIM,1841,17,20-24,1858,1
SIM,1877,29,35-39,1906,17
STAT,1812,42,50-100,1854,3.0162673720830773
SIM,1910,27,na,1937,3649
SIM,1916,18,na,1934,4700
STAT,1959,48,40-44,2007,0.2468718665751911
STAT,1949,30,45-49,1979,2.1552526157172505
SIM,1810,49,50-100,1859,1
STAT,1893,87,na,1980,755.8451832059407
SIM,1943,14,na,1957,5461
STAT,1849,30,40-44,1879,3.973896392159455
STAT,1956,12,na,1968,5998.576366596851
STAT,1927,49,45-49,1976,0.31292728803010395
STAT,1843,39,25-29,1882,3.0059615324720865
SIM,1898,53,na,1951,3700
STAT,1851,33,45-49,1884,1.4244227825558877
SIM,1864,20,15-19,1884,1
STAT,1943,32,50-100,1975,1.0314678696345054
STAT,1945,25,35-39,1970,19.02532748426425
SIM,1826,28,35-39,1854,28
STAT,1808,49,15-19,1857,0.0019318059139460018
SIM,1930,41,na,1971,6036
SIM,1930,79,na,2009,3312
STAT,1839,83,na,1922,314.8304497728375
STAT,1877,48,25-29,1925,0.0682768097945518
STAT,1899,24,45-49,1923,1.095612589069888
STAT,1952,41,15-19,1993,0.0022103152351743705
STAT,1938,49,20-24,1987,0.013015408456560079
STAT,1946,43,40-44,1989,0.33219142112378125
SIM,1865,104,na,1969,4
STAT,1927,30,25-29,1957,13.132924028409837
SIM,1833,43,45-49,1876,4
STAT,1860,60,na,1920,1773.8843162253536
SIM,1880,42,35-39,1922,5
STAT,1820,60,na,1880,1195.5785090328613
SIM,1833,55,na,1888,1409
SIM,1879,15,na,1894,3051
STAT,1880,18,45-49,1898,0.07969583018846721
STAT,1880,27,35-39,1907,11.802967166552609
SIM,1988,17,35-39,2005,16
STAT,1830,36,35-39,1866,7.264795064845283
SIM,1839,25,40-44,1864,5
STAT,1850,41,45-49,1891,1.547681653788264
STAT,1875,47,20-24,1922,0.014244426260102395
STAT,1777,107,na,1884,0.006158612169264788
SIM,1927,35,35-39,1962,4
STAT,1849,31,50-100,1880,0.8309172844460961
STAT,1879,52,30-34,1931,0.007134749312008858
STAT,1914,35,45-49,1949,0.7933472698275127
SIM,1919,19,40-44,1938,5
SIM,1875,42,50-100,1917,5
SIM,1929,22,25-29,1951,251
STAT,1825,43,45-49,1868,2.1788458608433774
SIM,1972,33,35-39,2005,11
STAT,1827,80,na,1907,502.37466130745116
STAT,1872,42,35-39,1914,2.095791560822854
SIM,1914,38,20-24,1952,3
STAT,1924,17,15-19,1941,62.35214732278518
STAT,1860,29,15-19,1889,0.42041141998714066
STAT,1860,37,50-100,1897,1.1419341676990362
SIM,1962,50,na,2012,5380
STAT,1865,28,20-24,1893,12.172446517526161
STAT,1925,66,na,1991,4399.413131258049
STAT,1990,17,40-44,2007,2.3116694458510567
SIM,1892,2,na,1894,4198
SIM,1925,27,40-44,1952,13
STAT,1876,26,30-34,1902,30.14456831409992
STAT,1864,44,40-44,1908,2.286462106391159
SIM,1961,48,50-100,2009,1
SIM,1979,15,45-49,1994,1
STAT,1870,53,25-29,1923,0.003965130431653606
STAT,1787,104,na,1891,0.02048525753391346
STAT,1975,36,15-19,2011,0.030148243019969687
STAT,1919,35,35-39,1954,3.014782502003075
SIM,1836,22,20-24,1858,4
STAT,1881,37,35-39,1918,7.873074722459521
SIM,1968,27,50-100,1995,2
STAT,1967,26,25-29,1993,95.33733396999627
STAT,1821,36,25-29,1857,6.726828772203783
SIM,1872,44,40-44,1916,10
SIM,1963,12,na,1975,6578
STAT,1906,38,20-24,1944,0.27860890395514853
STAT,1871,18,35-39,1889,0.630321534207696
STAT,1940,25,45-49,1965,2.035498690502617
STAT,1864,72,na,1936,1301.339417762522
STAT,1908,46,15-19,1954,3.878538208993876E-4
SIM,1892,96,na,1988,170
STAT,1900,74,na,1974,2359.5662036815033
SIM,1901,37,40-44,1938,2
SIM,1930,43,50-100,1973,1
STAT,1885,45,25-29,1930,0.0669649142033037
STAT,1919,22,15-19,1941,6.72531416634868
STAT,1958,26,15-19,1984,1.075147255243427
SIM,1884,45,na,1929,2608
SIM,1959,29,na,1988,5922
SIM,1865,15,40-44,1880,1
STAT,1988,25,45-49,2013,2.866313419411037
STAT,1790,70,na,1860,680.4080010989642
SIM,1858,39,35-39,1897,15
SIM,1917,43,na,1960,5332
STAT,1886,48,35-39,1934,0.16828218300258965
SIM,1877,26,30-34,1903,2
STAT,1873,27,50-100,1900,0.7538709885494845
STAT,1814,48,na,1862,1891.6400132459526
STAT,1901,35,50-100,1936,0.4324320908183983
STAT,1932,83,na,2015,2315.493845010846
SIM,1922,35,45-49,1957,3
STAT,1890,34,40-44,1924,6.0629348539166985
SIM,1932,17,15-19,1949,116
STAT,1953,20,25-29,1973,129.46825513719645
STAT,1918,19,40-44,1937,1.74714809979662
SIM,1968,41,na,2009,5334
SIM,1888,21,15-19,1909,4
SIM,1884,26,30-34,1910,61
STAT,1867,26,20-24,1893,12.683881890676322
SIM,1966,26,15-19,1992,3
STAT,1947,49,30-34,1996,0.11983213574453064
STAT,1811,106,na,1917,0.006251678126436234
STAT,1953,39,45-49,1992,0.9784158227689048
STAT,1952,34,50-100,1986,1.1640231439889808
STAT,1861,41,20-24,1902,0.153055791671344
STAT,1898,108,na,2006,0.2727745220910742
STAT,1796,61,na,1857,1085.25550936596
STAT,1903,40,25-29,1943,0.07404009487670023
SIM,1847,32,50-100,1879,3
STAT,1868,18,20-24,1886,19.894849955305943
STAT,1824,51,45-49,1875,0.019415795440643174
SIM,1927,22,15-19,1949,6
STAT,1879,40,na,1919,2813.190087346038
STAT,1835,54,25-29,1889,0.002165145265348946
STAT,1857,15,40-44,1872,0.19551745806284257
STAT,1873,89,na,1962,241.99196455261585
STAT,1875,23,45-49,1898,0.8290527987238262
STAT,1897,43,na,1940,3553.016552252856
STAT,1865,38,na,1903,2441.0077802655337
STAT,1817,46,20-24,1863,0.03475244578757361
STAT,1839,38,20-24,1877,0.7229904363297808
SIM,1853,28,35-39,1881,14
SIM,1883,20,40-44,1903,9
STAT,1932,28,20-24,1960,27.585418951361998
STAT,1899,21,40-44,1920,3.304595376010103
STAT,1846,53,na,1899,2190.166902856613
STAT,1836,54,50-100,1890,0.013371671760862862
SIM,1881,21,50-100,1902,4
SIM,1987,26,na,2013,5974
SIM,1949,0,na,1949,6090
STAT,1851,30,40-44,1881,3.6544878838169117
STAT,1869,29,35-39,1898,10.706649331632256
STAT,1968,15,na,1983,5308.309310879634
SIM,1986,15,35-39,2001,16
STAT,1985,30,45-49,2015,2.635736756790035
STAT,1850,39,na,1889,2413.119813496658
SIM,1949,33,20-24,1982,1
SIM,1911,34,30-34,1945,3
STAT,1803,54,na,1857,1139.0545141661712
STAT,1841,47,50-100,1888,0.21935045592866476
SIM,1940,28,20-24,1968,3
STAT,1859,52,20-24,1911,6.747614422461381E-4
STAT,1902,57,na,1959,3374.8367881688578
SIM,1894,23,na,1917,3703
STAT,1814,41,35-39,1855,6.294565861317399
STAT,1823,36,35-39,1859,14.457535294227887
STAT,1925,41,15-19,1966,0.002148052891257447
SIM,1844,98,na,1942,15
STAT,1859,15,15-19,1874,6.408144339229837
STAT,1946,46,45-49,1992,0.29007965073379893
STAT,1845,28,35-39,1873,7.857244073790549
SIM,1787,93,na,1880,23
SIM,1912,68,na,1980,2796
SIM,1814,66,na,1880,789
SIM,1874,77,na,1951,919
STAT,1873,22,40-44,1895,2.4557475697284654
SIM,1899,13,na,1912,4525
SIM,1926,19,40-44,1945,3
SIM,1926,19,50-100,1945,1
STAT,1845,52,na,1897,1443.1986099680528
SIM,1860,35,na,1895,2393
SIM,1831,36,35-39,1867,14
STAT,1851,46,20-24,1897,0.009542955822869214
STAT,1961,46,30-34,2007,0.13859681439935354
SIM,1904,27,40-44,1931,10
STAT,1909,19,30-34,1928,2.74675957035931
SIM,1822,41,35-39,1863,4
SIM,1851,36,20-24,1887,3
SIM,1934,37,na,1971,5801
STAT,1959,41,15-19,2000,0.0024126624482545336
SIM,1930,25,na,1955,5711
STAT,1883,45,15-19,1928,4.5613915664332585E-4
STAT,1828,47,50-100,1875,0.22615806766641883
STAT,1773,110,na,1883,0.003702275906915198
STAT,1954,39,50-100,1993,0.6157966167025112
STAT,1941,28,30-34,1969,46.766377240341086
STAT,1961,35,30-34,1996,2.8044989416479296
STAT,1873,8,na,1881,3180.1712120275206
STAT,1828,47,35-39,1875,0.12891746567360898
STAT,1844,15,30-34,1859,1.7148011844635647
SIM,1917,19,30-34,1936,2
SIM,1849,37,50-100,1886,1
SIM,1959,25,50-100,1984,6
STAT,1889,26,40-44,1915,4.276021141469824
STAT,1900,90,na,1990,558.3361816484171
SIM,1842,32,na,1874,2289
STAT,1901,22,50-100,1923,0.6591861569279245
SIM,1975,23,20-24,1998,8
SIM,1875,26,20-24,1901,2
SIM,1983,28,30-34,2011,76
SIM,1827,38,35-39,1865,14
STAT,1988,22,40-44,2010,5.568051640579508
SIM,1828,27,30-34,1855,56
STAT,1943,43,50-100,1986,0.14918897350818636
SIM,1845,23,15-19,1868,4
SIM,1933,36,na,1969,6379
STAT,1915,38,30-34,1953,2.1146347070228346
SIM,1957,38,40-44,1995,4
STAT,1884,27,na,1911,2721.1638819195286
STAT,1806,96,na,1902,2.9471187169652584
STAT,1852,25,30-34,1877,28.054507425028998
STAT,1777,82,na,1859,119.27318869565778
STAT,1822,51,35-39,1873,0.015975227298692562
STAT,1903,34,30-34,1937,16.33838450367773
STAT,1980,18,40-44,1998,2.240142503749092
SIM,1832,79,na,1911,500
SIM,1838,41,50-100,1879,2
STAT,1837,23,15-19,1860,3.1048233008739103
SIM,1921,64,na,1985,4654
STAT,1843,36,20-24,1879,0.9123650685209191
STAT,1882,16,45-49,1898,0.07381335014784833
SIM,1860,25,30-34,1885,5
STAT,1935,45,30-34,1980,0.14600221293539767
SIM,1943,9,na,1952,5502
STAT,1842,47,25-29,1889,0.04433205948589657
STAT,1910,37,50-100,1947,0.46388434163778325
STAT,1923,25,na,1948,4995.377517163419
STAT,1940,49,20-24,1989,0.01339441318061817
SIM,1936,22,25-29,1958,109
SIM,1865,66,na,1931,2126
SIM,1804,98,na,1902,7
STAT,1928,22,25-29,1950,133.09121866664267
STAT,1928,38,40-44,1966,2.181071520305257
STAT,1938,48,50-100,1986,0.26720768761891106
SIM,1917,22,20-24,1939,264
STAT,1841,109,na,1950,6.325518702632568E-4
STAT,1926,15,15-19,1941,64.49874514440494
STAT,1949,38,40-44,1987,2.0678943087550716
SIM,1897,26,40-44,1923,4
STAT,1979,28,50-100,2007,1.587666251727431
SIM,1862,37,35-39,1899,10
STAT,1986,26,na,2012,6189.553164041992
SIM,1859,72,na,1931,706
STAT,1875,6,na,1881,3246.1055291243283
SIM,1867,15,15-19,1882,7
STAT,1967,23,20-24,1990,160.77124651433166
SIM,1974,23,15-19,1997,13
SIM,1981,23,na,2004,5635
STAT,1927,46,40-44,1973,0.22891099280396315
STAT,1966,23,15-19,1989,7.695787528704388
SIM,1885,80,na,1965,1464
STAT,1990,23,35-39,2013,15.60804310887687
SIM,1851,30,50-100,1881,3
STAT,1909,22,20-24,1931,119.3991316056683
STAT,1837,57,na,1894,1455.2303209033303
STAT,1951,31,15-19,1982,0.18011284198212213
STAT,1825,38,na,1863,1999.4485835590674
STAT,1819,38,35-39,1857,18.606097116211377
STAT,1906,21,35-39,1927,9.850008695389837
STAT,1944,59,na,2003,4462.878988977983
STAT,1813,66,na,1879,892.0222906302678
STAT,1877,20,15-19,1897,3.9839260328683253
STAT,1871,15,30-34,1886,1.8636715056224404
STAT,1980,2,na,1982,6304.5626875714515
SIM,1877,69,na,1946,1803
STAT,1953,36,40-44,1989,2.155050674791198
STAT,1881,100,na,1981,16.928615910711336
STAT,1923,48,30-34,1971,0.11997093830263517
SIM,1889,16,40-44,1905,1
SIM,1854,17,30-34,1871,4
SIM,1936,38,40-44,1974,3
STAT,1881,84,na,1965,654.5832574852298
STAT,1812,81,na,1893,237.41365161434217
SIM,1820,35,na,1855,1990
STAT,1852,65,na,1917,1593.3193590879189
STAT,1830,33,30-34,1863,18.521173567618007
STAT,1900,17,20-24,1917,28.38968416695758
SIM,1833,40,40-44,1873,1
STAT,1854,37,35-39,1891,5.762287783390661
STAT,1909,43,50-100,1952,0.12619055038129037
STAT,1899,48,20-24,1947,0.010567790814198414
STAT,1894,44,20-24,1938,0.016140077770642268
STAT,1967,16,50-100,1983,0.5402428463406587
SIM,1934,15,15-19,1949,57
STAT,1915,28,50-100,1943,1.167713976327174
STAT,1846,17,30-34,1863,2.069861181333233
SIM,1922,32,40-44,1954,20
SIM,1961,36,40-44,1997,5
STAT,1890,37,45-49,1927,2.8110558729836383
STAT,1965,23,na,1988,5277.008066119071
SIM,1811,43,25-29,1854,1
SIM,1948,30,35-39,1978,30
STAT,1840,62,na,1902,1466.2087051609465
STAT,1975,28,30-34,2003,59.88335029649199
STAT,1871,103,na,1974,2.3301715596064287
STAT,1838,54,40-44,1892,0.008870060372145015
STAT,1848,104,na,1952,0.07087064160631927
SIM,1887,10,na,1897,3970
STAT,1942,61,na,2003,4246.115280298191
SIM,1927,21,na,1948,4464
SIM,1954,55,na,2009,5242
STAT,1874,49,na,1923,2602.569731375791
SIM,1889,76,na,1965,2022
SIM,1923,38,30-34,1961,4
STAT,1840,31,35-39,1871,9.998193310567961
SIM,1935,19,na,1954,5726
SIM,1896,23,30-34,1919,38
STAT,1895,23,30-34,1918,26.674788195262813
STAT,1936,24,40-44,1960,3.70945497137866
STAT,1888,23,30-34,1911,24.089025022917816
STAT,1914,32,40-44,1946,4.5481499285776374
STAT,1885,42,20-24,1927,0.18258608122709996
SIM,1989,22,50-100,2011,3
STAT,1940,22,40-44,1962,3.9541250954263663
SIM,1886,29,45-49,1915,4
SIM,1920,20,50-100,1940,2
STAT,1838,107,na,1945,0.004085006464420123
SIM,1855,32,40-44,1887,5
SIM,1871,72,na,1943,793
STAT,1886,45,30-34,1931,0.11901049079528893
STAT,1968,43,15-19,2011,0.0022967700017856633
STAT,1794,100,na,1894,0.26571418419241577
SIM,1965,48,30-34,2013,1
STAT,1846,21,50-100,1867,0.5239164515853835
STAT,1889,48,na,1937,3160.9268619802697
SIM,1864,26,45-49,1890,1
STAT,1864,47,45-49,1911,0.24205047491561968
STAT,1933,61,na,1994,5373.24256261454
SIM,1872,47,45-49,1919,2
STAT,1817,49,25-29,1866,0.15979860782754446
STAT,1948,43,15-19,1991,0.002104377803586663
STAT,1857,18,45-49,1875,0.06860104523263238
STAT,1847,32,40-44,1879,3.9179520896041184
SIM,1974,20,35-39,1994,18
SIM,1848,54,na,1902,1552
STAT,1954,28,40-44,1982,6.675288917850621
STAT,1833,50,40-44,1883,0.0079979072957527
STAT,1897,99,na,1996,45.761318380332106
STAT,1971,15,35-39,1986,6.136611920606258
STAT,1906,93,na,1999,331.72634136497595
SIM,1885,27,na,1912,3169
STAT,1955,1,na,1956,6032.374401482498
STAT,1825,40,40-44,1865,3.4853988931589748
STAT,1957,48,30-34,2005,0.14069514640468966
STAT,1878,29,45-49,1907,1.3283039415810671
SIM,1901,10,na,1911,4489
STAT,1856,26,45-49,1882,1.0203075690686436
STAT,1893,16,20-24,1909,25.92445233736369
STAT,1896,43,35-39,1939,0.19028922194216688
SIM,1893,78,na,1971,1432
SIM,1986,17,25-29,2003,90
SIM,1953,34,25-29,1987,4
SIM,1968,38,50-100,2006,1
STAT,1825,54,na,1879,1622.0013218487522
SIM,1767,95,na,1862,11
SIM,1941,66,na,2007,3355
STAT,1869,33,30-34,1902,19.430779876722866
STAT,1906,44,15-19,1950,0.001592060637534345
STAT,1921,93,na,2014,424.942502503575
SIM,1831,43,35-39,1874,5
SIM,1883,23,45-49,1906,2
STAT,1890,95,na,1985,146.38072984197913
STAT,1832,33,40-44,1865,3.8941987345343057
SIM,1872,25,35-39,1897,18
STAT,1888,31,15-19,1919,0.193976115720383
STAT,1864,25,35-39,1889,10.04892893113761
SIM,1813,81,na,1894,265
STAT,1977,21,25-29,1998,144.55487508436252
SIM,1902,75,na,1977,2319
STAT,1878,28,30-34,1906,30.236262485104913
STAT,1896,98,na,1994,65.21730793861269
STAT,1967,18,40-44,1985,2.0156971532446253
STAT,1840,46,na,1886,1843.4903085117085
STAT,1945,34,25-29,1979,11.861644512697698
STAT,1844,17,20-24,1861,18.84962331483809
SIM,1868,33,20-24,1901,7
SIM,1952,25,na,1977,4801
STAT,1873,27,35-39,1900,11.371164254869434
STAT,1874,34,na,1908,2795.1628722001988
SIM,1944,28,50-100,1972,1
SIM,1877,33,30-34,1910,32
SIM,1886,28,30-34,1914,54
STAT,1870,43,50-100,1913,1.1932682405126376
SIM,1975,18,40-44,1993,5
SIM,1875,59,na,1934,2422
SIM,1875,29,25-29,1904,5
SIM,1889,27,50-100,1916,5
SIM,1840,33,40-44,1873,5
STAT,1910,33,25-29,1943,10.251914206722327
SIM,1852,17,20-24,1869,26
STAT,1847,37,50-100,1884,0.9801599932700199
STAT,1833,31,50-100,1864,0.8468898561510981
STAT,1925,34,50-100,1959,1.131233789708217
SIM,1862,61,na,1923,2278
SIM,1831,38,50-100,1869,4
STAT,1812,42,20-24,1854,0.4534258227474943
SIM,1832,39,20-24,1871,2
STAT,1783,97,na,1880,0.7132664278622405
SIM,1884,29,35-39,1913,30
STAT,1838,35,35-39,1873,7.549283346214517
STAT,1835,21,15-19,1856,3.083032013073228
SIM,1933,52,na,1985,6221
SIM,1868,52,na,1920,2874
SIM,1945,40,na,1985,4695
SIM,1881,27,35-39,1908,3
STAT,1932,34,15-19,1966,0.1969378160553765
SIM,1918,34,40-44,1952,1
STAT,1888,45,40-44,1933,0.2345609596600885
STAT,1979,20,20-24,1999,177.3925614946171
STAT,1824,39,20-24,1863,1.130010129003763
STAT,1977,33,20-24,2010,3.87446686182896
STAT,1919,44,25-29,1963,0.08898770621993499
STAT,1871,27,25-29,1898,48.56737656304148
STAT,1889,29,45-49,1918,1.5681942398052262
STAT,1901,75,na,1976,2304.579540111314
STAT,1926,11,na,1937,5613.501786823874
STAT,1870,50,20-24,1920,8.516134021711378E-4
SIM,1894,23,20-24,1917,121
STAT,1889,19,50-100,1908,0.06932058462725077
STAT,1886,23,20-24,1909,83.6287333060164
SIM,1928,84,na,2012,2210
STAT,1937,15,35-39,1952,4.735451800749276
SIM,1958,28,na,1986,6178
STAT,1934,62,na,1996,5379.571935239571
STAT,1969,26,35-39,1995,21.747303565202756
SIM,1937,32,25-29,1969,5
SIM,1954,35,na,1989,5464
STAT,1815,49,15-19,1864,7.929329314321178E-4
STAT,1823,43,35-39,1866,1.8648880332432853
STAT,1869,26,30-34,1895,28.240081506730238
STAT,1868,54,20-24,1922,7.95681683917565E-4
SIM,1862,34,30-34,1896,38
SIM,1846,35,35-39,1881,4
SIM,1906,4,na,1910,4031
STAT,1862,46,na,1908,2197.414053302633
STAT,1959,38,na,1997,5845.20131493401
STAT,1857,54,45-49,1911,0.012685213699008002
SIM,1897,29,45-49,1926,3
SIM,1914,29,30-34,1943,8
STAT,1899,25,50-100,1924,1.0182603834993045
STAT,1825,32,50-100,1857,1.9190238001466233
SIM,1829,42,40-44,1871,7
SIM,1845,27,na,1872,2242
SIM,1877,38,25-29,1915,5
SIM,1895,88,na,1983,346
STAT,1869,38,25-29,1907,3.2018543324474793
SIM,1888,91,na,1979,38
SIM,1891,95,na,1986,67
STAT,1891,18,20-24,1909,25.220275937986205
STAT,1951,48,50-100,1999,0.3224059298990309
STAT,1819,44,20-24,1863,0.31429856509350884
STAT,1946,50,na,1996,4847.1234709220425
STAT,1955,20,35-39,1975,14.482963403742584
STAT,1947,26,15-19,1973,0.9220905000689845
STAT,1951,47,30-34,1998,0.12742628944478102
STAT,1970,1,na,1971,5688.304452526438
STAT,1986,19,40-44,2005,2.298496542931324
STAT,1841,27,20-24,1868,12.95495763472348
STAT,1857,96,na,1953,7.717779471570141
STAT,1957,28,na,1985,5721.906611893814
STAT,1954,26,50-100,1980,1.4268116619570732
STAT,1915,73,na,1988,3060.830104289321
STAT,1934,66,na,2000,5062.4187557887035
SIM,1953,19,40-44,1972,1
SIM,1903,35,40-44,1938,1
STAT,1894,88,na,1982,676.2691097049003
STAT,1966,34,15-19,2000,0.18856561996394602
SIM,1857,15,na,1872,2899
STAT,1893,19,25-29,1912,8.221832109783069
STAT,1882,44,na,1926,2570.0979540585463
STAT,1800,62,na,1862,1227.1600782470607
STAT,1916,32,15-19,1948,0.15312484299554624
SIM,1857,31,na,1888,2654
SIM,1885,46,35-39,1931,1
STAT,1935,28,na,1963,5893.493745927456
STAT,1845,34,20-24,1879,2.1212220809236477
SIM,1779,83,na,1862,187
SIM,1832,54,na,1886,1778
STAT,1929,32,25-29,1961,13.549363495494338
SIM,1958,16,15-19,1974,1
STAT,1862,22,20-24,1884,68.70601529314789
SIM,1994,19,40-44,2013,3
STAT,1896,40,30-34,1936,0.12291978454317969
STAT,1962,33,50-100,1995,1.2454137232054985
SIM,1860,28,35-39,1888,3
SIM,1869,24,15-19,1893,6
SIM,1968,26,25-29,1994,115
STAT,1942,45,30-34,1987,0.11237397071594758
SIM,1964,13,na,1977,5967
STAT,1841,39,15-19,1880,0.05761418432326103
STAT,1866,45,20-24,1911,0.012963911759137109
STAT,1900,23,15-19,1923,5.266586616875858
SIM,1853,34,20-24,1887,1
SIM,1959,31,25-29,1990,1
STAT,1821,34,35-39,1855,28.59252911155369
STAT,1850,29,20-24,1879,14.008739838033913
STAT,1871,22,30-34,1893,20.45075187844947
SIM,1882,1,na,1883,4118
SIM,1979,21,20-24,2000,7
SIM,1912,37,40-44,1949,1
SIM,1985,12,na,1997,6444
STAT,1850,50,35-39,1900,0.00898992062989786
STAT,1852,28,35-39,1880,10.519734881062805
STAT,1947,35,na,1982,5047.358315466257
STAT,1832,37,15-19,1869,0.049342600415052354
STAT,1836,32,20-24,1868,3.1105552241661423
STAT,1871,24,20-24,1895,78.6249445866557
STAT,1915,15,15-19,1930,11.0145968901502
STAT,1945,19,40-44,1964,1.7621213708111434
SIM,1864,16,na,1880,2947
STAT,1793,75,na,1868,418.37745149981384
SIM,1891,3,na,1894,3725
STAT,1830,84,na,1914,208.68523361971083
STAT,1877,14,na,1891,3090.1235710955675
SIM,1881,22,40-44,1903,3
STAT,1883,44,45-49,1927,1.6670351465361692
STAT,1907,23,50-100,1930,0.6902782215375043
STAT,1897,39,20-24,1936,0.254164031291591
STAT,1851,83,na,1934,314.80863417626404
SIM,1780,77,na,1857,206
STAT,1922,43,50-100,1965,0.15530181136470908
STAT,1962,22,25-29,1984,137.03600914323084
STAT,1901,108,na,2009,0.28919232100559766
STAT,1892,35,20-24,1927,1.1255714220856314
STAT,1963,49,45-49,2012,0.32950532191466725
SIM,1822,61,na,1883,1163
STAT,1856,15,na,1871,2418.1264367805397
SIM,1919,25,35-39,1944,48
STAT,1968,32,50-100,2000,1.2147807156582349
SIM,1883,60,na,1943,1937
STAT,1992,23,45-49,2015,1.8693735459436491
STAT,1904,37,40-44,1941,1.5658161387760199
STAT,1871,23,na,1894,2706.984150894762
STAT,1919,29,40-44,1948,5.769128611203793
STAT,1977,36,25-29,2013,1.5831726653665525
SIM,1866,42,na,1908,2443
STAT,1833,53,45-49,1886,0.010389164010394905
SIM,1814,43,40-44,1857,9
STAT,1883,20,50-100,1903,0.4631802104773619
SIM,1927,29,40-44,1956,10
STAT,1967,31,50-100,1998,1.2156154388281948
STAT,1879,48,35-39,1927,0.16658288888852676
STAT,1902,25,15-19,1927,0.7448392534034922
STAT,1921,25,40-44,1946,6.03342576929538
SIM,1968,21,30-34,1989,45
STAT,1971,24,25-29,1995,135.36722507497038
SIM,1901,90,na,1991,755
STAT,1946,69,na,2015,3931.1587829320133
SIM,1891,44,45-49,1935,1
STAT,1972,32,25-29,2004,13.920878792837966
SIM,1970,22,25-29,1992,161
STAT,1877,46,35-39,1923,0.1685394495888723
SIM,1887,48,35-39,1935,1
SIM,1926,74,na,2000,4346
SIM,1817,41,50-100,1858,1
STAT,1888,49,15-19,1937,2.9969727417465436E-4
STAT,1983,21,45-49,2004,1.8435754311629169
SIM,1786,68,na,1854,517
SIM,1980,32,25-29,2012,17
SIM,1915,36,50-100,1951,1
STAT,1955,22,25-29,1977,141.97874339779486
STAT,1901,34,20-24,1935,4.332038332572913
SIM,1843,17,na,1860,2306
SIM,1963,22,25-29,1985,296
STAT,1890,15,35-39,1905,0.7773407829197639
STAT,1939,72,na,2011,3270.311652696774
STAT,1832,36,45-49,1868,1.7707280902192946
SIM,1847,38,20-24,1885,1
SIM,1882,42,45-49,1924,7
STAT,1956,28,15-19,1984,1.0821829178202378
STAT,1930,27,40-44,1957,6.840607663331041
STAT,1969,16,na,1985,5307.77214816074
SIM,1827,42,30-34,1869,4
SIM,1907,81,na,1988,1795
STAT,1857,51,40-44,1908,0.009507637591826393
SIM,1872,22,30-34,1894,1
STAT,1829,90,na,1919,57.756969074528435
SIM,1976,31,20-24,2007,2
SIM,1829,50,na,1879,1568
STAT,1901,40,15-19,1941,0.0015658211712671721
SIM,1888,27,45-49,1915,3
STAT,1830,53,50-100,1883,0.012011334164374948
SIM,1887,43,40-44,1930,9
STAT,1854,37,50-100,1891,1.0002383256383776
STAT,1886,37,na,1923,2867.9572721042064
SIM,1971,30,25-29,2001,28
STAT,1993,2,na,1995,6534.013480529023
SIM,1893,22,na,1915,3266
STAT,1869,35,20-24,1904,0.869688960246324
STAT,1849,33,45-49,1882,1.409516980417606
SIM,1866,26,na,1892,2373
SIM,1862,28,45-49,1890,2
SIM,1862,37,50-100,1899,1
SIM,1868,24,30-34,1892,23
STAT,1968,36,15-19,2004,0.028543164059209654
STAT,1819,47,25-29,1866,0.1109052534089725
STAT,1874,42,45-49,1916,1.7660244578531203
STAT,1974,38,na,2012,5834.944317660209
SIM,1960,19,40-44,1979,4
STAT,1852,50,45-49,1902,0.013879122154958342
STAT,1932,36,na,1968,5840.329665145767
STAT,1878,26,40-44,1904,3.6219083021270375
STAT,1920,44,40-44,1964,0.31760480100726507
STAT,1952,19,40-44,1971,1.9330854223663654
SIM,1892,25,45-49,1917,1
STAT,1823,31,40-44,1854,13.30146180311787
SIM,1835,65,na,1900,1441
SIM,1923,74,na,1997,3707
STAT,1969,23,30-34,1992,41.55739199661988
SIM,1937,29,na,1966,4379
STAT,1830,110,na,1940,1.7335154462813328E-4
STAT,1896,34,50-100,1930,1.3846630552518266
SIM,1831,40,30-34,1871,3
SIM,1916,96,na,2012,7
SIM,1979,23,50-100,2002,4
SIM,1860,50,45-49,1910,2
STAT,1864,22,30-34,1886,18.64967294533771
SIM,1844,42,na,1886,2288
STAT,1921,28,45-49,1949,2.213395825447189
SIM,1891,41,40-44,1932,4
SIM,1931,26,na,1957,5679
STAT,1942,22,15-19,1964,6.442191632892454
STAT,1881,44,35-39,1925,1.9884617626744052
STAT,1888,48,45-49,1936,0.1783230204226987
STAT,1907,106,na,2013,1.3597148575289582
STAT,1964,22,35-39,1986,13.731440384102966
SIM,1866,35,45-49,1901,2
STAT,1842,72,na,1914,971.8294991121095
SIM,1901,39,30-34,1940,5
SIM,1999,15,45-49,2014,3
SIM,1853,32,30-34,1885,29
SIM,1856,52,45-49,1908,1
SIM,1849,39,25-29,1888,1
STAT,1925,51,na,1976,5070.449384160147
SIM,1900,49,na,1949,3317
STAT,1814,91,na,1905,36.13153551129564
STAT,1938,39,na,1977,4405.199052097366
STAT,1823,40,30-34,1863,1.252671093975626
SIM,1847,53,na,1900,2211
SIM,1890,30,na,1920,3451
SIM,1916,44,25-29,1960,1
SIM,1899,27,20-24,1926,39
STAT,1858,32,40-44,1890,3.9042851436517774
STAT,1934,36,15-19,1970,0.03062529877934371
STAT,1849,45,na,1894,1761.1648231679687
SIM,1828,48,50-100,1876,1
SIM,1846,32,30-34,1878,5
SIM,1973,28,na,2001,4999
STAT,1952,54,na,2006,5146.833974124994
STAT,1838,32,30-34,1870,18.79640547887577
SIM,1964,28,15-19,1992,1
STAT,1895,33,na,1928,3569.569888422104
SIM,1918,44,na,1962,3785
SIM,1866,32,40-44,1898,2
STAT,1875,99,na,1974,20.631386380187315
STAT,1895,16,30-34,1911,2.4001783256127687
SIM,1840,36,45-49,1876,4
SIM,1857,33,45-49,1890,5
SIM,1889,101,na,1990,308
STAT,1989,21,50-100,2010,1.0916137256114768
STAT,1847,19,na,1866,2178.547255933659
STAT,1905,12,na,1917,4313.622638264025
STAT,1970,32,15-19,2002,0.1892289920539476
SIM,1881,24,30-34,1905,1
SIM,1972,22,35-39,1994,37
STAT,1854,28,45-49,1882,0.9414657955043978
STAT,1879,43,40-44,1922,2.6908403858273835
STAT,1892,22,na,1914,3420.8875150083177
SIM,1908,23,25-29,1931,99
STAT,1848,52,45-49,1900,0.015337754276174497
STAT,1913,63,na,1976,3719.7611307253505
SIM,1985,16,na,2001,6442
STAT,1910,52,na,1962,3893.137136831625
SIM,1982,19,15-19,2001,2
SIM,1930,9,na,1939,6396
STAT,1837,42,na,1879,1796.4830804000694
STAT,1913,23,25-29,1936,107.36757695923384
STAT,1859,26,na,1885,2247.9519617490855
STAT,1880,24,30-34,1904,21.652318086042577
SIM,1829,44,30-34,1873,5
STAT,1968,20,45-49,1988,1.628321714478152
STAT,1854,34,30-34,1888,14.267230925354651
SIM,1968,24,35-39,1992,30
STAT,1980,34,40-44,2014,6.382390002795602
STAT,1880,15,40-44,1895,0.2247740667585858
STAT,1838,46,50-100,1884,0.22173116464565637
STAT,1858,41,na,1899,2090.191818059612
SIM,1955,34,35-39,1989,13
STAT,1981,16,na,1997,5941.359309914232
STAT,1983,30,35-39,2013,15.2243098058641
SIM,1963,20,35-39,1983,16
STAT,1947,34,35-39,1981,12.093440513906671
STAT,1812,65,na,1877,882.2898475423924
SIM,1820,51,na,1871,1741
SIM,1935,62,na,1997,5331
SIM,1955,17,na,1972,6139
STAT,1960,17,na,1977,5532.467626179366
SIM,1899,69,na,1968,2749
STAT,1909,25,25-29,1934,73.78950601565457
STAT,1864,113,na,1977,3.4408285088395314E-4
STAT,1906,29,30-34,1935,42.07500605357942
STAT,1875,20,40-44,1895,2.499968637389552
STAT,1904,45,50-100,1949,0.23187815295174685
STAT,1835,51,20-24,1886,4.7868450093924245E-4
STAT,1892,38,25-29,1930,4.143913397800523
STAT,1904,21,25-29,1925,95.15494279028542
STAT,1929,30,35-39,1959,13.411675287193448
SIM,1946,32,35-39,1978,27
STAT,1854,52,50-100,1906,0.012238663074392782
SIM,1912,45,50-100,1957,1
STAT,1811,80,na,1891,318.5112566205038
STAT,1845,32,30-34,1877,13.989012360640436
STAT,1866,48,25-29,1914,0.06083835963304387
STAT,1827,64,na,1891,1411.7563141069413
STAT,1949,33,50-100,1982,1.1304402767842057
STAT,1979,32,35-39,2011,14.80130385403875
STAT,1876,29,35-39,1905,11.428696553711537
SIM,1903,38,45-49,1941,1
SIM,1862,52,50-100,1914,1
SIM,1948,19,25-29,1967,75
STAT,1862,25,25-29,1887,41.95085422792029
STAT,1769,87,na,1856,78.5959788
SIM,1870,25,25-29,1895,81
STAT,1870,46,25-29,1916,0.06571897274279434
STAT,1938,32,35-39,1970,10.609352786737494
STAT,2010,0,na,2010,7222.072508493149
SIM,1967,24,na,1991,5031
STAT,1920,30,15-19,1950,0.16367535198852504
SIM,1841,50,na,1891,1762
STAT,1933,45,20-24,1978,0.017628538034663816
SIM,1853,37,25-29,1890,8
SIM,1937,30,35-39,1967,4
STAT,1836,35,25-29,1871,3.284907423982772
SIM,1909,48,na,1957,4540
STAT,1837,21,25-29,1858,54.65785391190647
STAT,1781,87,na,1868,41.81074375247176
STAT,1891,77,na,1968,1695.4550297278156
STAT,1932,19,30-34,1951,18.530713922603926
SIM,1920,63,na,1983,3572
STAT,1844,27,na,1871,2215.021274118582
STAT,1863,71,na,1934,1346.9608633421917
SIM,1858,36,30-34,1894,2
SIM,1912,21,25-29,1933,112
STAT,1883,26,na,1909,2703.8521541003865
STAT,1883,41,40-44,1924,2.5511312690381915
STAT,1973,16,15-19,1989,67.7556010607908
STAT,1884,25,45-49,1909,1.2745798190524655
STAT,1933,18,na,1951,5673.8650559057905
STAT,1828,44,30-34,1872,1.0713028229014534
STAT,1874,7,na,1881,3202.360152548796
STAT,1861,44,25-29,1905,0.6077740370593723
SIM,1905,21,25-29,1926,1
STAT,1884,70,na,1954,1599.814653774856
STAT,1973,38,50-100,2011,0.6449543599775828
STAT,1846,52,35-39,1898,0.00885251258312596
SIM,1844,35,25-29,1879,6
STAT,1845,37,25-29,1882,2.038509558951313
SIM,1921,23,25-29,1944,6
STAT,1928,15,25-29,1943,63.306629253966484
SIM,1819,72,na,1891,266
STAT,1828,38,45-49,1866,2.0092702562742826
STAT,1963,46,40-44,2009,0.2410380726094419
STAT,1925,21,50-100,1946,0.9113962489167511
SIM,1943,15,25-29,1958,154
STAT,1865,5,na,1870,2964.9458847044602
STAT,1965,24,50-100,1989,0.9504998232713477
STAT,1994,21,20-24,2015,185.85064130834567
SIM,1845,21,25-29,1866,65
STAT,1878,36,50-100,1914,1.48649578336972
SIM,1919,22,30-34,1941,3
SIM,1938,62,na,2000,3673
STAT,1898,25,na,1923,3747.4660634589814
SIM,1836,44,30-34,1880,3
STAT,1867,29,25-29,1896,45.25352775325661
STAT,1924,88,na,2012,1133.968646649235
STAT,1935,15,25-29,1950,68.72267045106308
SIM,1878,30,na,1908,2906
SIM,1881,34,na,1915,1899
STAT,1819,42,30-34,1861,2.4172524099495485
STAT,1910,27,30-34,1937,43.71047416215576
STAT,1960,26,15-19,1986,1.0661683133308313
STAT,1844,53,20-24,1897,6.07302458860398E-4
SIM,1876,17,15-19,1893,4
SIM,1987,26,40-44,2013,22
SIM,1806,62,na,1868,1041
STAT,1927,39,40-44,1966,2.1428743712616516
STAT,1862,40,20-24,1902,0.15623386702586733
SIM,1919,34,25-29,1953,2
STAT,1836,53,25-29,1889,0.0031987548131238983
STAT,1912,44,50-100,1956,0.12987214535027622
STAT,1934,16,25-29,1950,67.84439204183062
STAT,1889,79,na,1968,1475.9084140641135
SIM,1881,30,25-29,1911,2
STAT,1871,69,na,1940,1684.9252528164996
STAT,1897,74,na,1971,2220.505499164726
SIM,1829,59,na,1888,1254
STAT,1931,51,na,1982,5597.956739885072
SIM,1970,16,30-34,1986,26
STAT,1962,16,30-34,1978,18.0283684718436
SIM,1873,92,na,1965,153
SIM,1928,12,na,1940,6040
STAT,1840,24,35-39,1864,5.867952921675275
STAT,1859,40,15-19,1899,0.012823543014741052
STAT,1941,42,45-49,1983,0.20564627510514158
SIM,1811,49,na,1860,1615
STAT,1868,17,15-19,1885,6.699174870927534
SIM,1935,39,40-44,1974,5
STAT,1911,29,35-39,1940,16.790460023009555
STAT,1937,42,25-29,1979,0.0831698569706365
SIM,1867,22,15-19,1889,7
STAT,1857,30,50-100,1887,0.8460037443964513
SIM,1841,31,50-100,1872,1
STAT,1859,22,15-19,1881,3.1466414634751203
STAT,1837,51,50-100,1888,0.01119558644918641
STAT,1839,106,na,1945,0.00962896450144884
STAT,1866,82,na,1948,499.08543455171247
STAT,1956,35,15-19,1991,0.03026426558801746
STAT,1930,23,30-34,1953,42.365608083694184
STAT,1798,81,na,1879,189.80744612038137
STAT,1911,47,35-39,1958,0.14098078372933193
SIM,1874,46,na,1920,2485
STAT,1927,20,20-24,1947,159.01024459421237
STAT,1914,89,na,2003,812.4360618383024
STAT,1865,106,na,1971,0.1806361103527774
SIM,1971,30,na,2001,5637
STAT,1936,26,30-34,1962,43.32019312310267
SIM,1822,34,35-39,1856,3
STAT,1887,44,na,1931,2948.831260497859
STAT,1991,10,na,2001,6498.449728124251
STAT,1929,34,45-49,1963,2.3038291929088937
STAT,1932,0,na,1932,6886.121101825807
STAT,1976,33,na,2009,5940.170620067513
SIM,1919,63,na,1982,4750
STAT,1793,101,na,1894,0.10744653249693487
STAT,1827,95,na,1922,10.79757780038291
STAT,1879,33,25-29,1912,12.290446113219495
STAT,1869,1,na,1870,3952.7348839059923
SIM,1971,34,35-39,2005,29
STAT,1926,4,na,1930,5709.705661609097
SIM,1948,34,20-24,1982,6
STAT,1904,33,30-34,1937,16.544124054561276
STAT,1856,52,na,1908,1885.6628646041756
STAT,1896,36,35-39,1932,10.833046177677042
STAT,1888,110,na,1998,0.039546264412707734
STAT,1924,42,15-19,1966,0.0021074552045250543
SIM,1912,33,30-34,1945,33
STAT,1886,35,50-100,1921,1.508738827447483
SIM,1926,15,30-34,1941,37
STAT,1846,27,35-39,1873,12.067150438064921
SIM,1887,33,25-29,1920,48
SIM,1854,27,35-39,1881,1
STAT,1901,13,na,1914,4168.110820302142
SIM,1909,49,40-44,1958,1
STAT,1979,26,40-44,2005,7.441673406494075
SIM,2002,12,na,2014,6942
SIM,1873,21,30-34,1894,45
STAT,1819,100,na,1919,0.7067502862800308
STAT,1922,84,na,2006,1780.6643919307805
STAT,1904,15,30-34,1919,2.6536633257218227
STAT,1914,39,30-34,1953,2.0799101889697402
SIM,1979,22,na,2001,6443
STAT,1918,15,30-34,1933,3.085347223864534
SIM,1914,26,50-100,1940,3
SIM,1943,29,na,1972,5042
STAT,1848,57,na,1905,2135.28861727135
STAT,1976,16,30-34,1992,18.79797817623313
STAT,1815,39,50-100,1854,3.6610364386622005
STAT,1985,24,15-19,2009,8.760329445570928
STAT,1865,21,30-34,1886,18.908366299791112
STAT,1968,38,na,2006,5581.26930605614
SIM,1922,39,30-34,1961,2
STAT,1962,34,30-34,1996,23.716352801855606
SIM,1937,34,45-49,1971,1
STAT,1940,15,40-44,1955,1.640337683234999
SIM,1912,15,30-34,1927,5
SIM,1857,46,na,1903,2422
SIM,1905,24,50-100,1929,1
SIM,1858,21,35-39,1879,7
SIM,1940,40,na,1980,4978
STAT,1878,95,na,1973,92.0954810129166
STAT,1872,32,30-34,1904,20.232359046949792
SIM,1959,24,25-29,1983,1
STAT,1864,54,45-49,1918,0.01454296431715915
STAT,1999,9,na,2008,6699.629927318753
STAT,1840,26,50-100,1866,0.6444656247833374
SIM,1900,31,15-19,1931,1
SIM,1955,31,30-34,1986,7
SIM,1932,24,15-19,1956,15
STAT,1947,48,25-29,1995,0.07152608743207935
STAT,1912,41,40-44,1953,0.2802715212609119
STAT,1920,34,25-29,1954,11.578413552075185
STAT,1916,84,na,2000,1590.6646240624627
SIM,1945,40,50-100,1985,1
SIM,1853,84,na,1937,76
SIM,1884,76,na,1960,986
STAT,1923,44,20-24,1967,0.02373307407837158
STAT,1839,31,30-34,1870,17.217480323676583
STAT,1917,47,30-34,1964,0.10745990108172795
STAT,1830,32,25-29,1862,11.082178006134898
STAT,1933,18,30-34,1951,18.78895778422858
STAT,1860,49,35-39,1909,0.12749641728876782
STAT,1801,100,na,1901,0.445598344778606
SIM,1850,36,na,1886,1615
STAT,1902,94,na,1996,246.37488224126747
SIM,1974,24,20-24,1998,336
SIM,1828,37,35-39,1865,1
SIM,1916,26,25-29,1942,7
SIM,1909,33,na,1942,4728
SIM,1935,20,20-24,1955,4
SIM,1950,4,na,1954,4822
STAT,1921,46,50-100,1967,0.2948766216708286
SIM,1936,37,35-39,1973,2
SIM,1941,18,30-34,1959,34
SIM,1945,24,25-29,1969,225
SIM,1905,23,45-49,1928,4
SIM,1977,27,na,2004,6178
STAT,1947,31,30-34,1978,20.888912305038605
STAT,1937,24,25-29,1961,103.79179514580755
STAT,1963,31,40-44,1994,5.8518358790759555
STAT,1803,85,na,1888,93.75437762849099
STAT,1894,26,na,1920,3552.6508521446735
STAT,1933,48,25-29,1981,0.08398645552150354
STAT,1986,28,50-100,2014,1.6430313321146035
STAT,1832,42,na,1874,1741.7183810888325
STAT,1860,107,na,1967,0.04100122147730986
SIM,1812,42,25-29,1854,1
SIM,1785,83,na,1868,204
SIM,1929,41,30-34,1970,1
STAT,1952,42,20-24,1994,0.02538202101330576
STAT,1879,49,na,1928,2654.494898068552
SIM,1861,38,35-39,1899,3
STAT,1966,24,20-24,1990,160.69913071202586
STAT,1953,29,40-44,1982,6.5287303084196875
STAT,1973,16,50-100,1989,0.5593471712992387
STAT,1853,38,35-39,1891,7.007006932538966
SIM,1923,78,na,2001,3338
STAT,1914,25,40-44,1939,5.46203696413025
STAT,1954,58,na,2012,5171.645730470544
STAT,1895,38,40-44,1933,6.543233380764347
STAT,1865,69,na,1934,1528.088460467785
STAT,1890,44,45-49,1934,2.0819555357614594
SIM,1926,17,na,1943,5662
SIM,1878,28,35-39,1906,2
SIM,1922,25,40-44,1947,1
STAT,1885,46,30-34,1931,0.11174373956297605
SIM,1881,28,na,1909,1837
STAT,1895,37,50-100,1932,1.8443053266915108
SIM,1961,29,40-44,1990,10
STAT,1908,26,25-29,1934,72.75732349461148
SIM,1766,88,na,1854,24
SIM,1847,31,30-34,1878,46
STAT,1963,32,25-29,1995,13.813048523369137
STAT,1984,26,20-24,2010,30.06218233635409
STAT,1923,31,45-49,1954,2.0895787674528394
SIM,1948,1,na,1949,4606
STAT,1955,36,50-100,1991,0.6632819579798364
STAT,1884,49,20-24,1933,0.013396969011574979
STAT,1974,21,45-49,1995,1.7017179416442967
SIM,1981,23,40-44,2004,11
STAT,1855,32,25-29,1887,8.874061367786942
SIM,1925,47,30-34,1972,1
SIM,1931,26,20-24,1957,56
STAT,1923,26,20-24,1949,24.25999992565347
SIM,1888,38,na,1926,2720
SIM,1804,67,na,1871,726
STAT,1889,22,30-34,1911,25.33920659784072
SIM,1931,31,45-49,1962,4
STAT,1903,48,na,1951,3652.4474628381986
STAT,1840,77,na,1917,693.4166971131704
SIM,1791,83,na,1874,172
SIM,1845,37,40-44,1882,7
SIM,1897,22,30-34,1919,3
STAT,1970,44,20-24,2014,0.026425481980607464
STAT,1831,24,50-100,1855,0.527144711152173
STAT,1888,26,na,1914,3248.6070405240657
STAT,1965,29,30-34,1994,56.6405751717732
STAT,1991,19,20-24,2010,224.07569612887937
STAT,1908,23,na,1931,4041.3824352839333
STAT,1811,45,50-100,1856,0.7918599137562204
SIM,1868,46,na,1914,2979
SIM,1886,35,30-34,1921,3
STAT,1928,19,35-39,1947,6.068908131878188
SIM,1941,36,30-34,1977,2
SIM,1844,23,30-34,1867,22
SIM,1915,28,30-34,1943,108
SIM,1878,43,30-34,1921,1
STAT,1778,106,na,1884,0.017471325450709976
SIM,1919,31,20-24,1950,5
SIM,1863,32,25-29,1895,4
STAT,1904,18,35-39,1922,0.9069488763921351
STAT,1979,29,45-49,2008,2.7542797199310534
STAT,1954,27,35-39,1981,21.511915149678977
SIM,1912,18,35-39,1930,3
STAT,1851,40,45-49,1891,1.1988034439928668
STAT,1854,101,na,1955,0.4648853189329882
SIM,1843,54,na,1897,1609
STAT,1930,26,35-39,1956,22.044012897732703
STAT,1836,23,30-34,1859,21.247764347833332
STAT,1862,43,25-29,1905,0.620899671250811
SIM,1974,30,40-44,2004,1
STAT,1836,50,20-24,1886,7.07201408367286E-4
STAT,1941,49,50-100,1990,0.2780822011986903
STAT,1946,36,40-44,1982,1.9758774827660508
STAT,1907,28,30-34,1935,42.60771940116629
SIM,1923,19,25-29,1942,82
STAT,1933,36,30-34,1969,2.8687671808765405
SIM,1939,29,30-34,1968,67
STAT,1940,41,50-100,1981,0.1433100356354392
SIM,1970,19,35-39,1989,11
SIM,1971,31,30-34,2002,44
STAT,1910,30,20-24,1940,2.7388207962449393
STAT,1902,32,50-100,1934,1.4940556657348218
SIM,1962,27,35-39,1989,29
SIM,1870,43,25-29,1913,1
STAT,1910,49,40-44,1959,0.16893938966607752
STAT,1976,19,35-39,1995,6.465289068540021
SIM,1891,58,na,1949,2749
SIM,1886,71,na,1957,977
STAT,1915,19,25-29,1934,10.412733105993523
STAT,1886,26,25-29,1912,51.6707050072977
STAT,1825,50,45-49,1875,0.02032075512058775
SIM,1894,26,25-29,1920,70
STAT,1962,19,35-39,1981,6.200593091016067
STAT,1907,46,30-34,1953,0.09297819087218585
STAT,1904,19,50-100,1923,0.0807548749471536
SIM,1969,4,na,1973,5831
STAT,1894,20,45-49,1914,1.040676329981785
STAT,1972,26,40-44,1998,6.920070653575868
SIM,1925,63,na,1988,4588
STAT,1911,26,30-34,1937,44.28686743147473
STAT,1953,40,15-19,1993,0.002234200001044511
SIM,1991,2,na,1993,6724
STAT,1875,54,20-24,1929,8.55838778631977E-4
SIM,1913,30,40-44,1943,12
SIM,1967,31,20-24,1998,1
STAT,1854,26,na,1880,2044.990912174399
STAT,1878,107,na,1985,0.3053482983617851
STAT,1904,36,35-39,1940,2.5421339821959053
STAT,1918,18,35-39,1936,5.255897714631724
SIM,1958,29,35-39,1987,29
STAT,1926,31,50-100,1957,1.1541760467371651
SIM,1796,67,na,1863,780
SIM,1951,37,30-34,1988,1
STAT,1861,47,50-100,1908,0.23453189260004478
SIM,1934,78,na,2012,2701
STAT,1962,53,na,2015,5530.284614455354
SIM,1915,33,na,1948,4633
SIM,1921,21,35-39,1942,16
SIM,1836,47,50-100,1883,1
SIM,1907,18,30-34,1925,9
SIM,1868,36,25-29,1904,1
STAT,1936,29,35-39,1965,16.575072801666835
STAT,1928,37,35-39,1965,3.5276149004382207
SIM,1928,28,40-44,1956,6
STAT,1762,114,na,1876,3.9783757276870855E-4
SIM,1867,92,na,1959,95
STAT,1842,48,30-34,1890,0.073554072883981
STAT,1886,44,25-29,1930,0.7711533670871352
STAT,1829,42,25-29,1871,0.6863583063220272
STAT,1913,78,na,1991,2379.087673941289
SIM,1951,21,15-19,1972,14
STAT,1911,44,30-34,1955,0.13920747488363358
SIM,1936,19,35-39,1955,6
STAT,1896,21,na,1917,3615.89456035843
SIM,1869,24,50-100,1893,1
STAT,1941,27,25-29,1968,78.59749497869427
STAT,1856,44,50-100,1900,0.9175969925302154
STAT,1982,31,35-39,2013,15.135559354709628
STAT,1913,21,35-39,1934,10.566991993706804
SIM,1904,26,35-39,1930,24
SIM,1829,32,25-29,1861,16
SIM,1837,42,25-29,1879,2
SIM,1965,19,30-34,1984,24
SIM,1854,45,35-39,1899,1
SIM,1954,20,na,1974,4828
STAT,1943,37,30-34,1980,2.298117890196491
STAT,1957,19,30-34,1976,18.53365558734696
STAT,1959,31,20-24,1990,3.7554324267827073
SIM,1918,37,45-49,1955,1
SIM,1912,36,35-39,1948,5
STAT,1812,50,na,1862,1295.8172128207425
STAT,1827,48,35-39,1875,0.1749585554422749
STAT,1846,45,35-39,1891,0.14617238492522486
SIM,1890,4,na,1894,3854
STAT,1943,21,15-19,1964,6.538739464144799
SIM,1780,83,na,1863,61
STAT,1909,21,15-19,1930,5.733210367916888
SIM,1901,46,30-34,1947,2
STAT,1866,4,na,1870,3215.8378317727597
STAT,1852,45,50-100,1897,0.23386348238597693
STAT,1955,24,45-49,1979,1.7282989205590054
SIM,1876,30,45-49,1906,4
STAT,1822,41,30-34,1863,2.4136326248457665
STAT,1984,29,25-29,2013,108.24259198691011
STAT,1830,47,na,1877,1514.705653901154
SIM,1884,8,na,1892,3021
SIM,1917,21,15-19,1938,6
STAT,1920,51,na,1971,4624.95365352013
STAT,1916,20,45-49,1936,1.3689106705510652
STAT,1882,69,na,1951,1654.2369185737534
STAT,1942,35,na,1977,4683.432391344591
SIM,1963,24,45-49,1987,1
STAT,1819,60,na,1879,1418.4058335214777
STAT,1937,21,20-24,1958,125.07125335079267
SIM,1905,20,40-44,1925,8
STAT,1905,30,40-44,1935,7.3019403799862905
SIM,1885,89,na,1974,719
STAT,1867,64,na,1931,1873.0610741302678
SIM,1850,33,50-100,1883,2
SIM,1909,30,20-24,1939,8
STAT,1824,47,na,1871,1605.494537005506
SIM,1866,11,na,1877,2763
SIM,1948,20,na,1968,4449
STAT,1962,37,35-39,1999,3.684729603911498
SIM,1928,6,na,1934,6081
STAT,1907,78,na,1985,2173.9764732284075
STAT,1877,21,20-24,1898,82.97540945669995
STAT,1765,94,na,1859,0.3409944757147503
SIM,1905,39,25-29,1944,3
SIM,1898,40,45-49,1938,2
SIM,1954,29,na,1983,5482
SIM,1924,20,45-49,1944,8
STAT,1952,15,30-34,1967,16.86568777764542
STAT,1811,53,25-29,1864,0.01033262547919826
SIM,1839,89,na,1928,152
STAT,1860,85,na,1945,254.97480554527192
STAT,1981,19,50-100,2000,0.6041825930613546
STAT,1896,33,30-34,1929,26.50129514088156
SIM,1774,83,na,1857,208
SIM,1863,5,na,1868,3121
STAT,1945,19,50-100,1964,0.47199668097516867
STAT,1825,60,na,1885,1440.3395064080273
STAT,1856,16,40-44,1872,0.191543771442644
SIM,1931,29,25-29,1960,116
STAT,1861,39,na,1900,2237.5921821803963
STAT,1917,31,15-19,1948,0.15593241787078438
STAT,1955,42,45-49,1997,0.264976308144618
SIM,1954,36,40-44,1990,2
STAT,1980,17,35-39,1997,6.7225783472136476
STAT,1878,53,30-34,1931,0.007057394499539406
SIM,1801,87,na,1888,48
STAT,1825,106,na,1931,0.008588160396445504
STAT,1873,30,25-29,1903,12.167832109189483
STAT,1889,25,35-39,1914,13.819392600732188
SIM,1939,55,na,1994,4644
STAT,1901,37,25-29,1938,1.0045622536967067
STAT,1798,100,na,1898,0.27003982906705704
STAT,1849,29,50-100,1878,0.5793210831337182
SIM,1885,58,na,1943,2551
STAT,1963,34,45-49,1997,2.34866415989114
STAT,1923,29,25-29,1952,86.55477789781158
STAT,1900,99,na,1999,48.6271528382874
SIM,1837,54,na,1891,1923
SIM,1908,20,na,1928,4228
STAT,1960,20,50-100,1980,0.9929719663755466
STAT,1992,20,40-44,2012,5.591958286238404
STAT,1878,35,30-34,1913,6.482893983547307
STAT,1880,42,50-100,1922,1.2907044864921502
STAT,1973,39,20-24,2012,0.40448662674110375
STAT,1840,21,30-34,1861,18.30282253002128
SIM,1878,25,30-34,1903,84
SIM,1954,18,40-44,1972,2
SIM,1973,29,20-24,2002,2
STAT,1915,37,25-29,1952,1.148083351867764
SIM,1923,28,50-100,1951,8
SIM,1872,11,na,1883,3333
STAT,1895,22,25-29,1917,85.99389838518816
STAT,1771,94,na,1865,4.9501120430716785
SIM,1880,17,35-39,1897,3
STAT,1868,49,na,1917,2442.4662990544252
STAT,1881,22,25-29,1903,63.72175625581088
STAT,1872,17,35-39,1889,0.6379368993178988
STAT,1873,49,45-49,1922,0.27231659644798445
STAT,1936,35,na,1971,4272.319201125168
STAT,1873,64,na,1937,2048.6377493186537
SIM,1881,49,45-49,1930,2
SIM,1845,89,na,1934,105
STAT,1946,18,40-44,1964,1.7897626267166762
STAT,1931,20,40-44,1951,5.063825643292414
SIM,1839,80,na,1919,776
STAT,1923,47,25-29,1970,0.07158667603821951
STAT,1934,43,15-19,1977,0.0024643122040082397
STAT,1793,81,na,1874,210.7940991248118
SIM,1979,34,40-44,2013,1
SIM,1908,16,25-29,1924,10
SIM,1949,20,45-49,1969,3
SIM,1877,32,25-29,1909,25
SIM,1886,38,35-39,1924,3
STAT,1816,54,50-100,1870,0.028413280554488086
STAT,1868,30,45-49,1898,1.9490352873009786
STAT,1928,16,30-34,1944,17.767312390290932
STAT,1954,24,30-34,1978,41.111695799382986
STAT,1907,42,45-49,1949,0.17625284566013183
SIM,1821,39,45-49,1860,1
STAT,1868,19,35-39,1887,0.612131243203749
SIM,1870,28,na,1898,3027
SIM,1904,23,30-34,1927,75
SIM,1960,34,50-100,1994,5
STAT,1808,85,na,1893,139.77816668585928
SIM,1910,99,na,2009,75
STAT,1878,38,35-39,1916,8.480284167975398
STAT,1952,43,35-39,1995,0.2889529451317204
STAT,1973,17,20-24,1990,202.35246252606822
STAT,1904,16,45-49,1920,0.10851958202176039
STAT,1930,24,45-49,1954,1.6532696703247525
STAT,2004,10,na,2014,6929.405768024786
SIM,1854,66,na,1920,1860
STAT,1950,48,30-34,1998,0.12617569647025037
STAT,1872,9,na,1881,3112.639059047005
STAT,1912,25,na,1937,4293.379022032047
STAT,1941,13,na,1954,4676.682007846417
SIM,1883,54,na,1937,2264
SIM,1810,49,40-44,1859,1
STAT,1875,90,na,1965,236.889244409084
SIM,1836,43,25-29,1879,1
STAT,1947,27,20-24,1974,23.831896414809133
STAT,1962,17,45-49,1979,0.7386605272272849
STAT,1806,53,45-49,1859,0.050068539463709455
STAT,1941,24,20-24,1965,132.55543138237542
SIM,1970,17,45-49,1987,1
STAT,1841,20,30-34,1861,20.353200704451464
STAT,1920,20,na,1940,4711.111301954696
SIM,1960,20,na,1980,6302
STAT,1994,1,na,1995,6557.373424571461
SIM,1882,10,na,1892,3564
STAT,1884,64,na,1948,1982.1127440626303
STAT,1910,21,na,1931,4152.572487849761
STAT,1879,106,na,1985,0.646160538971653
SIM,1852,62,na,1914,1360
STAT,1909,28,50-100,1937,1.0951460579730843
STAT,1960,33,15-19,1993,0.19676276766840112
SIM,1909,33,25-29,1942,24
STAT,1838,95,na,1933,11.516728709308634
SIM,1858,19,15-19,1877,10
SIM,1900,29,30-34,1929,4
STAT,1825,69,na,1894,1038.034912887306
STAT,1845,77,na,1922,582.474889860766
SIM,1876,19,35-39,1895,2
SIM,1823,39,50-100,1862,1
STAT,1773,104,na,1877,0.06112731966920615
SIM,1837,85,na,1922,388
STAT,1861,45,30-34,1906,0.09379649954234977
STAT,1871,21,25-29,1892,65.92362608896175
STAT,1959,34,25-29,1993,14.203732327055931
SIM,1900,40,na,1940,3535
STAT,1938,30,na,1968,4395.806621054342
STAT,1860,46,30-34,1906,0.09029014238760096
STAT,1993,16,15-19,2009,75.3751524631509
STAT,1973,7,na,1980,5866.631806499974
SIM,1885,101,na,1986,7
STAT,1948,44,20-24,1992,0.024157992833155253
SIM,1937,20,na,1957,3846
STAT,1902,32,15-19,1934,0.2322139423054265
SIM,1940,49,na,1989,4889
STAT,1817,53,20-24,1870,0.0019873062730020835
STAT,1915,39,15-19,1954,0.022166336833925892
SIM,1880,35,35-39,1915,18
STAT,1923,33,35-39,1956,12.078128777077556
SIM,1879,42,30-34,1921,5
SIM,1951,50,na,2001,6185
STAT,1820,85,na,1905,160.8894117883496
STAT,1869,32,25-29,1901,11.447219718970349
STAT,1934,31,na,1965,5965.661822728575
STAT,1870,31,15-19,1901,0.16268277393509276
SIM,1808,97,na,1905,4
SIM,1824,59,na,1883,1058
STAT,1970,42,30-34,2012,0.1919361242230381
SIM,1844,67,na,1911,1439
SIM,1931,33,35-39,1964,4
STAT,1894,24,30-34,1918,26.259793857451893
SIM,1928,78,na,2006,3293
SIM,1834,20,35-39,1854,7
SIM,1969,25,25-29,1994,1
STAT,1857,65,na,1922,1518.95635278482
STAT,1850,38,50-100,1888,1.2706466196426376
STAT,1892,39,30-34,1931,7.631297821041447
SIM,1962,24,30-34,1986,4
SIM,1876,72,na,1948,1524
STAT,1912,43,30-34,1955,0.1415792162314906
STAT,1881,52,50-100,1933,0.016721814756534524
SIM,1944,27,45-49,1971,5
SIM,1967,16,25-29,1983,73
STAT,1873,46,40-44,1919,0.2023302894381748
STAT,1822,44,35-39,1866,3.508076565575224
STAT,1781,93,na,1874,5.084566425281385
STAT,1896,9,na,1905,3954.9631627627077
SIM,1875,28,na,1903,3343
SIM,1959,21,20-24,1980,320
STAT,1811,50,20-24,1861,0.002286139113863942
STAT,1877,36,30-34,1913,6.4286578655934665
SIM,1810,67,na,1877,729
STAT,1916,36,25-29,1952,1.1693381074368885
SIM,1929,37,20-24,1966,1
STAT,1925,38,25-29,1963,1.3619749913420416
STAT,1951,46,25-29,1997,0.07601241783424437
STAT,1872,35,35-39,1907,8.273956521453654
STAT,1931,23,45-49,1954,1.679292595528223
STAT,1962,35,45-49,1997,1.040331591286459
SIM,1881,46,40-44,1927,1
SIM,1931,32,na,1963,6138
STAT,1936,27,45-49,1963,1.9091848440817925
STAT,1936,43,50-100,1979,0.13412789553484258
STAT,1819,69,na,1888,1014.0521414984527
SIM,1803,82,na,1885,251
STAT,1846,22,na,1868,2727.2766991549456
SIM,1925,32,na,1957,5242
STAT,1831,46,35-39,1877,0.13138230385314975
STAT,1953,48,50-100,2001,0.3275244223694014
STAT,1905,1,na,1906,4546.394342696196
STAT,1911,34,50-100,1945,0.9219564236920361
SIM,1847,84,na,1931,470
SIM,1830,44,35-39,1874,1
STAT,1804,50,50-100,1854,0.07236912599261643
STAT,1955,41,30-34,1996,0.20383934307832463
STAT,1971,33,na,2004,5631.426220874981
SIM,1871,66,na,1937,1216
SIM,1883,0,na,1883,3487
STAT,1880,23,25-29,1903,69.80881494955473
STAT,1897,20,50-100,1917,0.6330297854737634
STAT,1928,31,na,1959,5460.608728100158
SIM,1927,67,na,1994,3877
STAT,1905,33,45-49,1938,1.665440411319096
SIM,1850,67,na,1917,869
STAT,1955,21,40-44,1976,5.169902404629183
STAT,1846,9,na,1855,3163.9025699999993
SIM,1963,21,40-44,1984,13
STAT,1936,45,45-49,1981,0.24992045902806814
SIM,1849,11,na,1860,3203
STAT,1888,57,na,1945,2726.2143651746323
STAT,1943,48,na,1991,4663.891704885538
STAT,1959,16,25-29,1975,65.4361098947166
SIM,1827,39,40-44,1866,9
SIM,1894,38,na,1932,3763
SIM,1924,36,25-29,1960,2
STAT,1922,17,40-44,1939,1.8673017387143012
STAT,1842,49,15-19,1891,3.013830005526103E-4
STAT,1845,47,40-44,1892,0.1148261273488607
SIM,1857,23,40-44,1880,3
STAT,1971,40,25-29,2011,0.10877279504220985
SIM,1905,43,35-39,1948,1
STAT,1969,22,na,1991,5281.93109054598
STAT,1942,26,25-29,1968,79.77327299773891
SIM,1930,17,40-44,1947,5
STAT,1882,52,45-49,1934,0.01627152551806012
SIM,1988,21,30-34,2009,49
SIM,1830,26,35-39,1856,26
STAT,1819,39,40-44,1858,10.394577078447115
STAT,1967,44,15-19,2011,0.0022929953834723046
STAT,1939,15,na,1954,4264.152258254667
SIM,1861,11,na,1872,2225
STAT,1903,79,na,1982,1941.6409016816365
SIM,1900,39,50-100,1939,1
SIM,1821,79,na,1900,68
STAT,1952,18,35-39,1970,5.801286381562621
SIM,1950,26,25-29,1976,163
STAT,1939,39,30-34,1978,2.1653406111866946
SIM,1906,68,na,1974,2767
STAT,1992,17,15-19,2009,75.17678367603723
STAT,1949,42,15-19,1991,0.00214201898117013
SIM,1923,34,20-24,1957,5
SIM,1960,18,35-39,1978,17
STAT,1843,46,25-29,1889,0.058267040486297376
STAT,1904,31,40-44,1935,7.216260003826997
SIM,1923,16,20-24,1939,223
STAT,1823,34,na,1857,1610.7191630692473
STAT,1868,34,30-34,1902,19.19302734215258
SIM,1970,39,45-49,2009,1
STAT,1915,34,20-24,1949,2.842837714708977
STAT,1941,29,15-19,1970,0.8421605660390343
STAT,1937,40,50-100,1977,0.13720763070667455
SIM,1855,11,na,1866,2216
STAT,1832,43,45-49,1875,1.2553083840491133
STAT,1962,39,45-49,2001,1.0363216942919686
SIM,1840,43,45-49,1883,4
SIM,1878,76,na,1954,1173
STAT,1799,66,na,1865,1056.5734797098016
STAT,1942,44,25-29,1986,0.08921759503503955
SIM,1798,62,na,1860,1076
SIM,1970,34,20-24,2004,1
STAT,1881,90,na,1971,292.31384889678407
SIM,1968,27,30-34,1995,125
SIM,1978,23,35-39,2001,20
STAT,1893,3,na,1896,3856.3289943584296
STAT,1897,32,30-34,1929,26.942680401985978
SIM,1876,10,na,1886,2988
STAT,1974,6,na,1980,5923.993861833006
STAT,1890,64,na,1954,2451.294313580411
STAT,1915,16,20-24,1931,32.832633834351114
SIM,1876,34,30-34,1910,16
STAT,1812,52,25-29,1864,0.007846254033017771
STAT,1831,28,35-39,1859,9.986426239975781
STAT,1931,41,45-49,1972,0.2570142108250162
SIM,1893,53,na,1946,2968
SIM,1890,34,45-49,1924,9
STAT,1868,16,30-34,1884,1.8098882772489278
SIM,1984,28,15-19,2012,3
STAT,1970,45,35-39,2015,0.1946461945948162
SIM,1855,41,30-34,1896,1
STAT,1922,35,40-44,1957,1.9683276046425948
STAT,1930,21,40-44,1951,4.986605085006393
STAT,1863,65,na,1928,1705.3583461895776
STAT,1870,84,na,1954,378.4789601235822
STAT,1837,25,50-100,1862,0.6031719500805289
SIM,1849,29,20-24,1878,27
STAT,1887,13,na,1900,3334.841454577204
STAT,1975,22,na,1997,5578.121724924298
SIM,1958,22,45-49,1980,1
STAT,1839,77,na,1916,685.5060030297074
SIM,1853,29,40-44,1882,4
STAT,1937,40,35-39,1977,0.23518105404004727
SIM,1827,41,25-29,1868,3
STAT,1845,29,40-44,1874,2.421811092233701
STAT,1833,29,15-19,1862,0.4195523778630496
STAT,1950,27,50-100,1977,1.3640692140525446
STAT,1849,23,40-44,1872,1.938676803256123
STAT,1887,21,15-19,1908,4.279585249662066
STAT,1847,41,30-34,1888,0.9010209274163629
STAT,1851,35,50-100,1886,1.004668973004313
STAT,1819,41,25-29,1860,1.3939311025364294
STAT,1820,40,15-19,1860,0.01809642147135499
STAT,1976,28,15-19,2004,1.0926189674066311
STAT,1890,6,na,1896,3683.7377978772706
SIM,1830,59,na,1889,1402
STAT,1834,77,na,1911,788.8447845368493
STAT,1879,30,20-24,1909,3.2834189529152615
STAT,1944,30,na,1974,4793.4421732062165
STAT,1854,15,25-29,1869,5.58827061893803
STAT,1977,15,30-34,1992,19.0160238137082
SIM,1899,38,na,1937,4113
SIM,1835,59,na,1894,1758
SIM,1919,32,35-39,1951,29
SIM,1866,31,35-39,1897,28
SIM,1887,30,20-24,1917,6
STAT,1952,40,30-34,1992,0.1842537878236933
SIM,1862,15,25-29,1877,13
SIM,1821,36,40-44,1857,3
SIM,1943,20,na,1963,5053
SIM,1911,40,na,1951,4766
STAT,1855,47,35-39,1902,0.1185700074956825
STAT,1817,96,na,1913,5.936472544005074
SIM,1840,74,na,1914,512
STAT,1955,44,35-39,1999,0.31953322792045286
SIM,1930,10,na,1940,6396
SIM,1969,22,20-24,1991,4
STAT,1923,30,30-34,1953,21.00388037930149
STAT,1969,23,50-100,1992,0.9514055976106768
STAT,1855,39,na,1894,1984.5141533735555
SIM,1924,38,50-100,1962,1
SIM,1953,22,30-34,1975,87
STAT,1905,43,na,1948,3845.864034984573
STAT,1858,31,35-39,1889,9.212420033362347
STAT,1855,23,50-100,1878,0.40245643013962756
STAT,1916,38,50-100,1954,0.4937775595897401
STAT,1929,31,40-44,1960,5.740126903010148
STAT,1949,30,na,1979,5180.103266964219
STAT,1856,19,45-49,1875,0.06720680116730222
SIM,1880,32,30-34,1912,52
STAT,1894,27,35-39,1921,14.31456361708167
SIM,1985,22,na,2007,6422
SIM,1909,15,25-29,1924,18
SIM,1900,4,na,1904,3972
STAT,1886,90,na,1976,363.04246873333824
STAT,1869,48,40-44,1917,0.18893041744055017
STAT,1878,64,na,1942,2094.6446341038004
STAT,1956,41,45-49,1997,0.2645031863085473
SIM,1858,84,na,1942,435
STAT,1945,22,30-34,1967,36.35263601292929
STAT,1883,51,45-49,1934,0.016464254829244605
STAT,1948,47,25-29,1995,0.07286836930478982
STAT,1963,30,35-39,1993,13.672680756057526
STAT,1856,44,45-49,1900,1.299929076476252
STAT,1921,18,40-44,1939,1.8344562634227324
STAT,1840,101,na,1941,0.4577551150530116
STAT,1824,78,na,1902,483.4505486447308
SIM,1919,35,50-100,1954,2
STAT,1917,31,na,1948,4589.289531494645
STAT,1846,24,30-34,1870,22.39526317998817
SIM,1982,24,50-100,2006,1
STAT,1835,44,50-100,1879,0.7699866491338285
STAT,1871,19,40-44,1890,0.20886965888370834
STAT,1931,20,na,1951,5499.732456840512
STAT,1870,47,30-34,1917,0.1096182618068748
SIM,1877,48,40-44,1925,1
STAT,1924,24,15-19,1948,7.201538296058161
STAT,1830,78,na,1908,490.1431895420358
STAT,1947,45,20-24,1992,0.015013139260821226
STAT,1905,31,25-29,1936,9.863818682063204
SIM,1839,58,na,1897,1640
STAT,1942,41,20-24,1983,0.022170150893214353
STAT,1879,51,25-29,1930,0.004288614081742099
STAT,1851,77,na,1928,685.4585021528969
STAT,1940,29,30-34,1969,46.07971456067455
SIM,1927,32,30-34,1959,9
SIM,1918,13,na,1931,4284
STAT,1950,32,15-19,1982,0.17873862338485452
SIM,1834,74,na,1908,799
SIM,1818,59,na,1877,1789
STAT,1916,33,20-24,1949,2.894217380249299
STAT,1845,31,25-29,1876,8.292201264265856
STAT,1856,20,50-100,1876,0.4230430391457386
STAT,1854,33,25-29,1887,8.45711957833902
STAT,1911,43,na,1954,4069.707596360177
SIM,1935,23,25-29,1958,181
STAT,1893,40,15-19,1933,0.020347921297658205
STAT,1903,19,35-39,1922,0.8971185781222922
SIM,1931,30,30-34,1961,2
STAT,1877,39,35-39,1916,8.405198029707105
SIM,1962,45,50-100,2007,1
SIM,1936,34,30-34,1970,32
SIM,1836,25,25-29,1861,51
STAT,1846,42,30-34,1888,1.2028945966269116
SIM,1862,33,25-29,1895,26
STAT,1887,75,na,1962,1593.180876938141
STAT,1937,22,35-39,1959,10.587484417318985
STAT,1925,35,20-24,1960,0.36564319036216786
SIM,1991,22,na,2013,6228
SIM,1913,31,25-29,1944,4
SIM,1983,20,35-39,2003,42
SIM,1885,39,35-39,1924,20
SIM,1854,42,30-34,1896,4
STAT,1961,39,30-34,2000,2.793689165254175
SIM,1839,24,35-39,1863,15
SIM,1875,19,20-24,1894,40
STAT,1867,19,20-24,1886,19.298903027622607
STAT,1892,90,na,1982,469.2007996584244
SIM,1955,27,20-24,1982,4
STAT,1868,37,35-39,1905,7.842226340997433
SIM,2004,8,na,2012,7404
STAT,1828,43,25-29,1871,0.6079660202682795
STAT,1860,48,20-24,1908,0.011021062081257142
STAT,1787,81,na,1868,162.67422162156066
SIM,1903,28,40-44,1931,1
STAT,1931,21,25-29,1952,138.70391428402024
STAT,1985,25,20-24,2010,30.11749240397293
STAT,1834,110,na,1944,2.521863016715341E-4
SIM,1859,28,30-34,1887,51
STAT,1928,34,30-34,1962,22.70510146499342
STAT,1898,56,na,1954,3181.1770479623656
SIM,1876,37,35-39,1913,1
SIM,1943,33,50-100,1976,3
SIM,1945,22,35-39,1967,23
SIM,1958,26,30-34,1984,7
SIM,1874,49,30-34,1923,1
SIM,1981,26,45-49,2007,9
STAT,1866,49,30-34,1915,0.10138136456094585
STAT,1887,111,na,1998,0.014636802286165915
SIM,1970,36,40-44,2006,2
STAT,1927,23,25-29,1950,130.90063172103328
STAT,1935,33,50-100,1968,1.3199668265038493
SIM,1923,68,na,1991,4436
SIM,1917,68,na,1985,4107
STAT,1951,12,na,1963,5398.209650510164
STAT,1920,31,20-24,1951,3.094564899132148
STAT,1933,8,na,1941,6164.26020978735
STAT,1843,43,20-24,1886,0.16198021637021867
SIM,1828,34,30-34,1862,34
SIM,1988,24,35-39,2012,2
STAT,1858,87,na,1945,158.61309278951182
STAT,1835,22,na,1857,1766.2260824295931
STAT,1952,45,25-29,1997,0.07666484004219137
STAT,1919,32,30-34,1951,19.611829655838044
SIM,1966,17,25-29,1983,149
STAT,1844,16,15-19,1860,6.3472166475693905
STAT,1891,46,na,1937,3218.6980436358294
STAT,1857,54,50-100,1911,0.013201222370168181
STAT,1942,23,20-24,1965,134.5249337726481
STAT,1890,28,50-100,1918,0.8988679672566675
SIM,1770,90,na,1860,16
STAT,1987,10,na,1997,6473.364707223113
SIM,1950,23,20-24,1973,7
STAT,1904,34,45-49,1938,1.6451712233607472
SIM,1944,25,25-29,1969,6
STAT,1814,85,na,1899,170.9278873811315
SIM,1912,34,45-49,1946,3
SIM,1860,66,na,1926,1636
STAT,1936,25,25-29,1961,72.80132618812442
STAT,1951,43,20-24,1994,0.02518190825932975
STAT,1856,21,na,1877,2202.1744495912935
SIM,1853,31,25-29,1884,17
STAT,1996,15,25-29,2011,72.71919401501385
STAT,1958,17,25-29,1975,65.68472791653859
SIM,1978,25,25-29,2003,115
STAT,1877,114,na,1991,4.4337121029566995E-4
STAT,1946,28,na,1974,4813.432213905938
STAT,1968,35,30-34,2003,2.7112286423228746
SIM,1867,61,na,1928,1729
STAT,1841,49,30-34,1890,0.08426697775346341
STAT,1870,26,35-39,1896,11.015492256223942
STAT,1925,20,na,1945,5073.004824712786
STAT,1872,14,na,1886,3022.2985867142283
SIM,1910,24,30-34,1934,81
SIM,1979,20,25-29,1999,154
SIM,1920,57,na,1977,3876
SIM,1879,41,50-100,1920,2
STAT,1894,32,15-19,1926,0.2112673670709274
STAT,1919,16,50-100,1935,0.09607427359952699
STAT,1890,19,45-49,1909,0.09161860284823795
STAT,1983,26,50-100,2009,1.6327133671009177
STAT,1928,17,45-49,1945,0.7263843799798427
STAT,1900,38,25-29,1938,0.9902255404452639
SIM,1908,92,na,2000,120
STAT,1769,93,na,1862,9.557985319143778
STAT,1951,25,20-24,1976,25.21559327514872
SIM,1875,31,45-49,1906,4
STAT,1801,81,na,1882,239.60646251427232
SIM,1965,39,na,2004,5536
STAT,1902,24,30-34,1926,28.86337980308868
SIM,1969,17,40-44,1986,2
STAT,1993,14,na,2007,6519.84854010676
STAT,1855,47,50-100,1902,0.20800566966083195
SIM,1888,69,na,1957,1477
SIM,1973,34,na,2007,5228
STAT,1812,59,na,1871,1084.3742576873178
STAT,1919,17,35-39,1936,5.35014754792425
SIM,1870,59,na,1929,2484
STAT,1939,17,20-24,1956,156.6776296717929
STAT,1957,49,15-19,2006,5.795879347749015E-4
STAT,1881,19,35-39,1900,0.6075086057039363
STAT,1806,51,25-29,1857,0.012720610421689172
SIM,1890,47,50-100,1937,1
SIM,1954,16,50-100,1970,2
STAT,1928,72,na,2000,4006.0144945635775
STAT,1966,49,25-29,2015,0.0790648243568839
SIM,1947,17,20-24,1964,2
STAT,1832,49,20-24,1881,0.008736303076060459
SIM,1934,33,15-19,1967,1
STAT,1960,25,30-34,1985,59.20051614056084
STAT,1782,75,na,1857,532.0198017781275
SIM,1837,20,15-19,1857,7
SIM,1855,44,35-39,1899,8
STAT,1807,72,na,1879,781.7557022796669
SIM,1980,12,na,1992,6008
STAT,1847,44,35-39,1891,1.374531089171278
STAT,1821,49,45-49,1870,0.4153732075392543
SIM,1972,17,na,1989,5822
SIM,1927,17,35-39,1944,11
STAT,1906,107,na,2013,0.6621381775645674
STAT,1833,27,na,1860,2004.6249105423967
STAT,1935,50,na,1985,5934.744812462315
STAT,1808,110,na,1918,1.409017872722445E-4
STAT,1830,51,30-34,1881,0.0049255143281594456
SIM,1877,91,na,1968,423
STAT,1860,31,50-100,1891,0.8556905775171189
SIM,1915,70,na,1985,3329
STAT,1877,42,25-29,1919,0.7699250788386718
STAT,1977,18,35-39,1995,6.540936926874439
STAT,1884,21,35-39,1905,6.673825052612717
SIM,1907,32,45-49,1939,3
STAT,1957,33,45-49,1990,2.4390532130058573
SIM,1946,66,na,2012,3888
SIM,1839,43,40-44,1882,5
SIM,1867,37,25-29,1904,7
SIM,1952,33,35-39,1985,30
SIM,1906,21,50-100,1927,5
STAT,1837,22,30-34,1859,16.88497736203255
STAT,1851,15,45-49,1866,0.06372832355040307
STAT,1934,35,30-34,1969,2.909004308632754
STAT,1899,42,45-49,1941,0.16411797248471377
SIM,1886,34,na,1920,2124
SIM,1793,87,na,1880,216
STAT,1877,18,30-34,1895,1.9083395000280308
SIM,1879,20,20-24,1899,1
STAT,1884,29,30-34,1913,28.50771386837814
SIM,1864,4,na,1868,3270
STAT,1851,46,na,1897,1789.1775253383537
STAT,1826,36,15-19,1862,0.04608245741747692
STAT,1944,33,35-39,1977,11.561880028369321
STAT,1880,45,35-39,1925,0.17296110009894616
STAT,1864,19,na,1883,2660.596812142551
STAT,1955,36,15-19,1991,0.03033722436566093
STAT,1861,26,25-29,1887,41.17477719794859
STAT,1923,49,15-19,1972,4.942154021705027E-4
STAT,1912,46,35-39,1958,0.14348766737417137
SIM,1889,37,45-49,1926,5
STAT,1909,43,25-29,1952,0.07670406051783996
SIM,1892,29,30-34,1921,4
SIM,1823,33,35-39,1856,29
STAT,1995,17,30-34,2012,20.361829636461376
SIM,1885,42,25-29,1927,2
SIM,1818,50,na,1868,1980
STAT,1856,83,na,1939,349.52691345762264
SIM,1865,33,40-44,1898,2
STAT,1824,33,45-49,1857,3.2649798515787953
SIM,1846,39,45-49,1885,3
STAT,1952,4,na,1956,5438.707640115254
SIM,1927,7,na,1934,5296
STAT,1864,49,50-100,1913,0.24779240770931926
SIM,1862,30,20-24,1892,8
SIM,1837,39,35-39,1876,11
SIM,1883,91,na,1974,66
STAT,1903,16,30-34,1919,2.626400941037068
STAT,1876,27,15-19,1903,0.5412575359376466
STAT,1818,43,30-34,1861,1.4945310637510145
STAT,1814,53,40-44,1867,0.027430202663838926
SIM,1893,27,25-29,1920,66
SIM,1960,23,15-19,1983,17
STAT,1887,16,35-39,1903,0.7114010952282528
SIM,1977,33,25-29,2010,30
SIM,1843,36,25-29,1879,5
SIM,1895,16,35-39,1911,2
STAT,1855,100,na,1955,0.9033490313486471
STAT,1857,33,40-44,1890,3.881438011184841
STAT,1805,53,30-34,1858,0.020838138833823922
STAT,1829,39,35-39,1868,7.7836771445028
STAT,1979,15,na,1994,5851.760529048247
STAT,1838,20,25-29,1858,65.27989728906563
STAT,1952,23,15-19,1975,7.383693891534323
SIM,1849,42,na,1891,2583
SIM,1986,27,40-44,2013,2
SIM,1787,87,na,1874,286
SIM,1888,45,45-49,1933,1
STAT,1880,16,50-100,1896,0.06007607270163702
STAT,1972,19,50-100,1991,0.5532230563651377
STAT,1809,46,25-29,1855,0.14821902153960503
STAT,1828,40,20-24,1868,0.15776296947131016
SIM,1942,35,30-34,1977,3
SIM,1819,46,50-100,1865,1
STAT,1825,91,na,1916,40.98812853880125
STAT,1965,43,35-39,2008,0.3010273693744598
STAT,1908,54,na,1962,3738.981885747551
STAT,1963,41,50-100,2004,0.17926050078363565
SIM,1852,36,35-39,1888,4
SIM,1975,35,50-100,2010,1
STAT,1928,18,50-100,1946,0.5433609396782217
STAT,1958,39,35-39,1997,3.76903373438026
STAT,1844,36,35-39,1880,6.9415238584322765
SIM,1910,33,na,1943,3721
STAT,1840,43,40-44,1883,1.8582628796966834
SIM,1911,16,30-34,1927,5
STAT,1902,63,na,1965,3171.249980190469
STAT,1837,49,50-100,1886,0.17994391086533407
STAT,1978,27,40-44,2005,7.372728111684195
STAT,1924,48,50-100,1972,0.3098017200896141
STAT,1775,93,na,1868,8.954038156726622
SIM,1883,29,20-24,1912,13
SIM,1863,44,30-34,1907,3
STAT,1903,22,25-29,1925,94.09903140619481
STAT,1991,19,na,2010,6083.4655106711725
SIM,1925,28,25-29,1953,93
STAT,1873,27,na,1900,2812.493420105205
STAT,1878,16,25-29,1894,6.844926015280617
STAT,1860,28,30-34,1888,23.5028899687825
SIM,1846,20,25-29,1866,52
SIM,1944,22,20-24,1966,149
STAT,1978,33,35-39,2011,14.661679340698843
SIM,1840,43,na,1883,1939
STAT,1948,23,na,1971,4837.165623649761
STAT,1927,55,na,1982,5153.775562494271
SIM,1914,57,na,1971,3763
SIM,1888,20,30-34,1908,32
SIM,1857,77,na,1934,700
STAT,1929,46,15-19,1975,5.524218759545036E-4
STAT,1853,41,na,1894,2311.5261933119195
STAT,1954,30,25-29,1984,13.456157768906928
SIM,1977,27,30-34,2004,8
STAT,1835,36,25-29,1871,2.245303909316448
STAT,1890,33,na,1923,3350.7851793942073
SIM,1930,35,40-44,1965,6
STAT,1882,34,45-49,1916,1.9488333154939579
STAT,1940,43,45-49,1983,0.20240988487801698
STAT,1918,43,35-39,1961,0.24663451299995715
SIM,1825,66,na,1891,1042
STAT,1860,20,35-39,1880,6.237726537144516
STAT,1821,54,25-29,1875,0.005935704023436826
STAT,1854,30,20-24,1884,2.3024825220988423
STAT,1918,78,na,1996,2591.935068438421
STAT,1931,1,na,1932,6309.496849729123
STAT,1838,39,45-49,1877,2.0411825936892702
STAT,1917,28,25-29,1945,79.3818537413508
SIM,1863,77,na,1940,924
STAT,1944,27,40-44,1971,5.813972323924491
STAT,1875,29,20-24,1904,13.890879651949941
STAT,1860,42,45-49,1902,1.3903241529709256
SIM,1911,22,25-29,1933,126
SIM,1952,27,40-44,1979,11
SIM,1832,33,45-49,1865,4
STAT,1806,59,na,1865,1016.9825658650425
SIM,1941,25,na,1966,3797
STAT,1854,52,30-34,1906,0.004823707608557022
STAT,1985,28,25-29,2013,108.45150743794703
SIM,1852,40,50-100,1892,1
STAT,1979,30,15-19,2009,0.20837260330756663
STAT,1845,103,na,1948,0.09670830096646812
STAT,1876,44,30-34,1920,1.3530168123202162
STAT,1932,46,20-24,1978,0.017347630098547513
STAT,1954,23,na,1977,5225.3877901903115
SIM,1829,28,na,1857,2024
STAT,1933,55,na,1988,5649.848395990378
STAT,1871,45,25-29,1916,0.06679138647635213
STAT,1885,27,25-29,1912,48.69355730136118
STAT,1908,45,30-34,1953,0.09452807193478978
STAT,1985,19,na,2004,6037.510793360032
SIM,1901,24,20-24,1925,122
STAT,1964,45,40-44,2009,0.2394889467826093
STAT,1928,40,25-29,1968,0.10534687049072905
STAT,1966,40,na,2006,5578.828484505529
STAT,1890,16,40-44,1906,0.25854874164066344
SIM,1943,27,30-34,1970,6
STAT,1900,68,na,1968,2811.9345646147954
STAT,1842,29,25-29,1871,39.67943622782074
STAT,1894,101,na,1995,18.274917936327025
SIM,1825,40,45-49,1865,3
STAT,1889,70,na,1959,2133.4690646262666
STAT,1867,44,20-24,1911,0.16880941609743075
SIM,1978,22,20-24,2000,333
STAT,1827,27,na,1854,2183.056043649794
STAT,1870,23,30-34,1893,20.20284506453975
STAT,1863,15,35-39,1878,0.6393421484769622
STAT,1993,22,45-49,2015,1.874400003394797
STAT,1960,28,35-39,1988,22.653205168262076
SIM,1789,82,na,1871,97
STAT,1968,38,35-39,2006,3.588241464855667
STAT,1972,43,50-100,2015,0.18011469928864635
STAT,1834,38,30-34,1872,5.987308856196779
STAT,1909,36,na,1945,4134.024064211646
STAT,1869,56,na,1925,2279.511926628214
STAT,1980,22,35-39,2002,15.134940106946857
SIM,1874,32,50-100,1906,2
STAT,1921,21,30-34,1942,37.56280903800118
STAT,1897,35,35-39,1932,11.0181203141045
SIM,1821,70,na,1891,670
SIM,1889,34,40-44,1923,23
SIM,1901,27,25-29,1928,129
STAT,1881,22,na,1903,2632.6044308056594
STAT,1817,40,45-49,1857,4.866286147526263
STAT,1936,22,20-24,1958,122.75680189162641
STAT,1871,42,20-24,1913,0.18211294170283893
STAT,1909,37,30-34,1946,1.9931059350221372
STAT,1976,4,na,1980,6063.332515239354
STAT,2008,6,na,2014,7099.171415622091
SIM,1951,18,25-29,1969,144
STAT,1889,44,40-44,1933,3.1565600614374163
SIM,1962,30,25-29,1992,25
STAT,1943,18,25-29,1961,53.02103211528443
STAT,1951,28,25-29,1979,90.80002627547097
SIM,1892,34,na,1926,3755
STAT,1986,23,15-19,2009,8.779433483585755
SIM,1948,61,na,2009,3933
STAT,1819,109,na,1928,4.736275999438622E-4
SIM,1932,30,45-49,1962,2
STAT,1847,72,na,1919,971.7399806625004
STAT,1875,35,15-19,1910,0.0676056921525108
SIM,1812,93,na,1905,6
STAT,1855,29,35-39,1884,8.435346952855733
STAT,1866,14,na,1880,2854.1247075150477
STAT,1918,37,40-44,1955,1.8205348169179576
STAT,1880,39,40-44,1919,5.300848860259352
STAT,1900,35,20-24,1935,1.2461265083205084
STAT,1861,48,35-39,1909,0.13262931356311028
STAT,1864,107,na,1971,0.07803790919239308
STAT,1941,46,30-34,1987,0.11052274025182984
SIM,1894,69,na,1963,2704
SIM,1906,97,na,2003,58
STAT,1844,33,30-34,1877,17.28318982089982
STAT,1851,28,20-24,1879,10.814289072294228
STAT,1945,30,15-19,1975,0.16531764619416278
SIM,1934,31,50-100,1965,3
SIM,1826,46,35-39,1872,1
STAT,1826,28,30-34,1854,73.00336505402026
SIM,1926,37,40-44,1963,5
SIM,1867,34,20-24,1901,4
STAT,1812,46,30-34,1858,0.22819667306303332
STAT,1898,19,15-19,1917,9.206364048970542
SIM,1863,29,35-39,1892,1
STAT,1808,48,30-34,1856,0.47564911257895814
STAT,1932,9,na,1941,6084.778671709268
STAT,1830,54,35-39,1884,0.00671249929494111
STAT,1912,22,35-39,1934,10.423885984093893
STAT,1974,15,15-19,1989,68.42562159757604
STAT,1832,73,na,1905,809.2044083833323
STAT,1864,52,25-29,1916,0.0036304073883739437
SIM,1853,47,na,1900,2200
SIM,1982,15,15-19,1997,138
SIM,1886,6,na,1892,2414
SIM,1842,38,30-34,1880,2
SIM,1834,28,30-34,1862,49
STAT,1909,40,20-24,1949,0.019300657652381776
STAT,1891,48,15-19,1939,3.1778088591150684E-4
STAT,1974,40,40-44,2014,0.39279522708825326
SIM,1920,22,35-39,1942,28
STAT,1837,25,35-39,1862,9.098065083380497
SIM,1877,16,15-19,1893,9
SIM,1839,46,45-49,1885,3
SIM,1936,40,25-29,1976,2
STAT,1934,72,na,2006,4376.53179736794
STAT,1978,32,20-24,2010,3.9158397113222287
STAT,1869,34,50-100,1903,1.0152365341769414
SIM,1852,33,30-34,1885,11
STAT,1858,39,30-34,1897,4.749853068155544
SIM,1904,33,na,1937,4166
SIM,1993,0,na,1993,6970
SIM,1967,34,na,2001,5703
STAT,1844,41,15-19,1885,0.011982539307464325
SIM,1850,29,25-29,1879,83
SIM,1934,28,35-39,1962,1
SIM,1851,18,20-24,1869,22
STAT,1926,28,35-39,1954,20.692890743454864
SIM,1975,32,45-49,2007,4
STAT,1791,86,na,1877,78.2612278682989
STAT,1931,43,35-39,1974,0.3100280331935343
STAT,1972,36,35-39,2008,3.6854129217875533
STAT,1874,40,na,1914,2758.1606486644455
SIM,1919,32,na,1951,5258
STAT,1836,31,15-19,1867,0.16558668776245614
STAT,1935,27,30-34,1962,61.67216311537518
STAT,1869,16,15-19,1885,6.764188052463216
STAT,1934,38,35-39,1972,3.8499924789584647
SIM,1873,61,na,1934,2663
STAT,1913,41,50-100,1954,0.13304498347941737
STAT,1948,25,15-19,1973,0.937176847843256
SIM,1942,38,35-39,1980,5
STAT,1876,38,na,1914,2796.690213116225
STAT,1890,101,na,1991,16.60153677256948
STAT,1971,20,15-19,1991,7.811813938049537
STAT,1887,32,50-100,1919,1.185001459697653
STAT,1950,20,45-49,1970,1.5414847104242595
SIM,1862,49,40-44,1911,1
STAT,1846,27,50-100,1873,0.8000125955285302
SIM,1895,32,50-100,1927,3
STAT,1941,50,na,1991,4502.514376053026
STAT,1978,37,na,2015,6104.572426398285
SIM,1832,30,40-44,1862,3
STAT,1896,52,na,1948,3264.661050191178
SIM,1869,25,20-24,1894,25
SIM,1908,38,35-39,1946,2
SIM,1918,32,20-24,1950,4
SIM,1893,24,20-24,1917,106
STAT,1961,17,30-34,1978,18.173511029068987
STAT,1868,36,20-24,1904,0.858805970853675
STAT,1897,37,na,1934,3635.588048081927
STAT,1854,49,40-44,1903,0.1365639683523943
STAT,1818,46,35-39,1864,0.1752863914044839
STAT,1877,50,45-49,1927,0.017671705941581673
STAT,1843,30,45-49,1873,2.147638041012576
SIM,1913,75,na,1988,2961
SIM,1968,28,45-49,1996,3
STAT,1936,42,40-44,1978,0.28602160120437065
STAT,1842,33,50-100,1875,0.842948401603949
STAT,1908,48,35-39,1956,0.13435899033455198
STAT,1938,36,45-49,1974,0.800662809530197
SIM,1970,8,na,1978,6047
STAT,1831,43,30-34,1874,1.0878197455082002
SIM,1977,30,20-24,2007,10
SIM,1907,75,na,1982,2676
SIM,1846,36,40-44,1882,9
SIM,1928,43,na,1971,5658
STAT,1815,109,na,1924,3.9477595904425085E-4
SIM,1845,80,na,1925,873
STAT,1897,44,50-100,1941,0.11167957992415756
STAT,1970,23,35-39,1993,13.64296993276742
SIM,1879,45,35-39,1924,1
STAT,1926,33,15-19,1959,0.17917287389036282
STAT,1868,40,na,1908,2588.4856611237806
SIM,1948,15,15-19,1963,114
SIM,1992,20,45-49,2012,6
STAT,1845,46,na,1891,1520.3706405852633
SIM,1886,16,25-29,1902,10
STAT,1882,38,na,1920,2642.5205693948396
STAT,1816,39,25-29,1855,8.899337906066556
SIM,1968,12,na,1980,5394
STAT,1894,94,na,1988,210.0469712733342
SIM,1868,28,40-44,1896,6
STAT,1894,26,20-24,1920,17.463794083712873
SIM,1956,45,50-100,2001,1
SIM,1995,15,na,2010,6762
STAT,1924,30,45-49,1954,2.127649424495658
STAT,1913,49,20-24,1962,0.012381571273548459
SIM,1948,29,na,1977,4279
STAT,1873,95,na,1968,67.09376310526642
SIM,1851,30,45-49,1881,2
STAT,1838,36,40-44,1874,4.6240628596850515
SIM,1888,42,40-44,1930,7
SIM,1834,42,50-100,1876,1
STAT,1933,32,45-49,1965,2.4483507622711067
SIM,1795,82,na,1877,168
SIM,1837,23,na,1860,2583
STAT,1871,37,40-44,1908,5.025926390471372
SIM,1816,55,na,1871,1431
STAT,1893,34,20-24,1927,3.9092434933603646
STAT,1885,24,20-24,1909,78.82921655397956
SIM,1976,38,35-39,2014,2
SIM,1824,30,50-100,1854,7
STAT,1915,36,na,1951,4407.95786380071
STAT,1841,23,35-39,1864,6.525311784192356
STAT,1881,40,25-29,1921,0.7220163093293672
SIM,1824,39,25-29,1863,2
STAT,1932,49,25-29,1981,0.08257525331830814
STAT,1921,36,na,1957,4850.54403963293
STAT,1964,26,45-49,1990,2.5231052184197815
STAT,1962,32,40-44,1994,5.898371812541139
STAT,1880,20,20-24,1900,84.7995658540218
STAT,1839,46,na,1885,1841.3458001623267
STAT,1925,22,45-49,1947,1.5537964788107506
STAT,1826,42,50-100,1868,0.7921237934028991
STAT,1833,32,40-44,1865,3.9657675999154973
SIM,1843,23,na,1866,2174
STAT,1963,38,na,2001,5677.094330632114
SIM,1833,22,40-44,1855,5
STAT,1888,94,na,1982,178.6371792003347
SIM,1888,23,35-39,1911,18
STAT,1940,40,40-44,1980,0.3055255926366574
STAT,1824,30,40-44,1854,13.50031311413649
SIM,1841,32,40-44,1873,8
SIM,1953,44,na,1997,5585
SIM,1974,12,na,1986,6402
STAT,1890,42,25-29,1932,0.904403763238856
SIM,1801,56,na,1857,1430
STAT,1857,36,45-49,1893,1.8003910095055886
SIM,1872,29,45-49,1901,2
STAT,1942,46,50-100,1988,0.28448402109886073
STAT,1961,42,20-24,2003,0.027364731332699066
SIM,1830,50,na,1880,1638
SIM,1904,64,na,1968,3419
STAT,1926,25,30-34,1951,54.56302373273329
SIM,1837,44,50-100,1881,3
SIM,1879,23,25-29,1902,137
SIM,1911,38,40-44,1949,4
STAT,1848,26,na,1874,2763.860685437166
SIM,1992,1,na,1993,7042
STAT,1970,16,na,1986,5318.8275305772695
STAT,1863,54,30-34,1917,0.005841595742209734
SIM,1847,16,na,1863,2967
STAT,1932,15,45-49,1947,0.7670976619742877
STAT,1864,26,40-44,1890,3.097346515132062
SIM,1949,9,na,1958,5903
SIM,1822,55,na,1877,1363
STAT,1965,35,15-19,2000,0.028553633882950288
STAT,1876,47,35-39,1923,0.1662383977501384
STAT,1917,25,20-24,1942,22.242616973952792
SIM,1869,48,50-100,1917,1
STAT,1874,18,15-19,1892,6.992988856385113
STAT,1906,26,50-100,1932,1.0802141008618096
STAT,1900,25,50-100,1925,1.0313247257972902
STAT,1838,17,35-39,1855,0.627933166762296
STAT,1940,15,50-100,1955,0.4393760583069373
STAT,1944,65,na,2009,4137.098712776453
STAT,1964,48,45-49,2012,0.3276766206731428
STAT,1840,51,25-29,1891,0.0028550031941684197
STAT,1863,114,na,1977,1.0285881587516541E-4
STAT,1867,95,na,1962,35.245424428242465
STAT,1867,47,25-29,1914,0.06177399048147119
STAT,1823,65,na,1888,967.1924512773746
SIM,1934,25,30-34,1959,86
STAT,1892,31,35-39,1923,14.707997570656334
STAT,1830,48,40-44,1878,0.15591508977564553
STAT,1898,87,na,1985,845.9998817730882
STAT,1853,35,30-34,1888,5.417577905619805
STAT,1884,104,na,1988,2.5355415753630153
SIM,1951,15,20-24,1966,336
SIM,1865,36,45-49,1901,7
STAT,1872,45,na,1917,2633.112326054747
STAT,1816,80,na,1896,305.4936768640423
STAT,1912,24,25-29,1936,105.89546627895803
SIM,1872,26,40-44,1898,7
STAT,1785,86,na,1871,47.21039950860617
SIM,1871,35,na,1906,2113
STAT,1916,12,na,1928,4836.051473756124
STAT,1996,16,50-100,2012,0.6285389009515177
STAT,1850,20,40-44,1870,2.612119488726476
STAT,1849,45,15-19,1894,3.1311786342267306E-4
SIM,1960,15,30-34,1975,52
STAT,1872,40,15-19,1912,0.016164335660816275
STAT,2007,7,na,2014,7060.540301929515
STAT,1842,35,na,1877,1974.0040688289898
STAT,1995,20,20-24,2015,186.4971406652384
SIM,1784,76,na,1860,115
STAT,1931,29,na,1960,5577.181700357176
STAT,1905,74,na,1979,2541.1154648287047
SIM,1925,25,20-24,1950,45
STAT,1895,46,25-29,1941,0.048946589807784074
STAT,1872,54,40-44,1926,0.011863986268219981
STAT,1845,52,20-24,1897,4.946034793936615E-4
STAT,1970,20,30-34,1990,41.686456251570704
STAT,1875,41,45-49,1916,1.7929624057592648
STAT,1896,15,30-34,1911,2.440800912559755
SIM,1874,15,na,1889,2773
SIM,1861,35,30-34,1896,3
STAT,1922,41,35-39,1963,0.2670011619161926
SIM,1803,51,na,1854,1600
STAT,1970,25,25-29,1995,95.5800745817117
STAT,1848,28,15-19,1876,0.5713701830603778
SIM,1971,7,na,1978,5818
STAT,1918,42,20-24,1960,0.021664712185984678
STAT,1879,46,50-100,1925,0.29679290098082356
SIM,1858,53,na,1911,2405
STAT,1978,35,25-29,2013,1.600398589450828
STAT,1979,19,15-19,1998,72.06495260845705
STAT,1865,60,na,1925,1985.8624135953758
SIM,1841,28,na,1869,2092
SIM,1883,41,45-49,1924,4
STAT,1815,100,na,1915,0.5890873380353425
STAT,1870,25,20-24,1895,13.437707378751085
STAT,1889,47,45-49,1936,0.18849473086011698
STAT,1879,18,na,1897,3035.4293546326926
STAT,1900,41,15-19,1941,0.0015426212512963803
STAT,1821,52,35-39,1873,0.015012029298641415
SIM,1876,36,20-24,1912,2
STAT,1910,15,25-29,1925,9.965830074781008
SIM,1891,89,na,1980,431
SIM,1924,85,na,2009,868
SIM,1830,41,30-34,1871,1
STAT,1878,33,na,1911,2863.2645852308738
SIM,1929,24,45-49,1953,8
STAT,1922,49,30-34,1971,0.11744384647394071
STAT,1855,50,25-29,1905,0.0030571937430726804
SIM,1897,40,na,1937,3727
STAT,1853,72,na,1925,1257.3621499664785
STAT,1930,2,na,1932,6102.857620799524
STAT,1886,41,20-24,1927,0.19419962338406696
STAT,1908,4,na,1912,4509.238723852514
SIM,1856,28,15-19,1884,4
STAT,1892,99,na,1991,40.86408824424706
SIM,1870,37,30-34,1907,12
SIM,1869,23,30-34,1892,23
STAT,1847,22,25-29,1869,53.99841229211919
SIM,1841,35,45-49,1876,2
SIM,1869,28,25-29,1897,86
STAT,1938,61,na,1999,4009.3157468203685
STAT,1843,18,20-24,1861,22.59854785882978
STAT,1882,23,50-100,1905,0.45824709355510296
SIM,1835,28,na,1863,2656
STAT,1912,56,na,1968,3926.494118894974
STAT,1921,43,40-44,1964,0.32448537865968885
STAT,1944,32,20-24,1976,3.0879456507383956
STAT,1859,17,50-100,1876,0.05228022093618175
STAT,1856,22,35-39,1878,5.967125485910047
STAT,1883,26,45-49,1909,1.2579368341010202
STAT,1949,36,20-24,1985,0.3648424815929716
STAT,1768,106,na,1874,0.012100505379536067
STAT,1858,53,45-49,1911,0.012855545387289962
SIM,1930,17,50-100,1947,1
SIM,1962,24,na,1986,5541
SIM,1926,8,na,1934,6223
STAT,1813,44,25-29,1857,2.223756477964563
SIM,1772,88,na,1860,79
SIM,1798,93,na,1891,8
SIM,1994,15,30-34,2009,39
STAT,1920,32,35-39,1952,11.546665015801144
STAT,1918,47,na,1965,4510.7684503090495
STAT,1917,62,na,1979,4031.1616285761293
STAT,1833,35,45-49,1868,1.8055875916846083
STAT,1886,99,na,1985,31.61844457538973
SIM,1874,27,20-24,1901,28
STAT,1936,47,35-39,1983,0.1475633826527465
SIM,1889,40,35-39,1929,4
STAT,1884,33,na,1917,2709.439649860951
STAT,1931,35,15-19,1966,0.029407382364118054
STAT,1852,46,35-39,1898,0.1323686358581429
STAT,1837,19,40-44,1856,0.19862189987652726
STAT,1827,45,30-34,1872,0.12592924483288442
SIM,1845,49,50-100,1894,2
STAT,1865,24,35-39,1889,6.0620925046382235
STAT,1935,49,40-44,1984,0.255502722464581
STAT,1953,3,na,1956,5491.704590354928
STAT,1967,22,15-19,1989,7.699087076710407
SIM,1809,73,na,1882,683
STAT,1894,48,30-34,1942,0.07998823485481787
SIM,1975,22,15-19,1997,9
STAT,1935,30,20-24,1965,3.900918334746962
SIM,1820,47,45-49,1867,1
SIM,1900,71,na,1971,2432
SIM,1952,32,20-24,1984,7
STAT,1812,47,45-49,1859,0.5471766471155571
STAT,1849,51,45-49,1900,0.011301928851967862
STAT,1939,45,50-100,1984,0.273158829443438
SIM,1903,31,30-34,1934,8
STAT,1868,2,na,1870,3715.0508058552964
STAT,1967,35,50-100,2002,0.624636094522551
SIM,1872,85,na,1957,599
STAT,1893,37,25-29,1930,4.199938299963361
SIM,1956,24,na,1980,5112
STAT,1942,22,50-100,1964,0.7963154974706689
SIM,1824,50,na,1874,1435
STAT,1964,16,na,1980,5351.55189122359
SIM,1931,63,na,1994,5221
STAT,1927,45,35-39,1972,0.1876081833987467
STAT,1943,17,na,1960,4504.886250849211
SIM,1920,24,25-29,1944,130
STAT,1906,25,45-49,1931,1.8811734202891957
SIM,1893,84,na,1977,869
SIM,1983,27,na,2010,6722
STAT,1848,110,na,1958,4.361256239592079E-4
STAT,1961,20,20-24,1981,166.45399275418748
STAT,1948,23,50-100,1971,0.8715800279208298
STAT,1950,65,na,2015,4545.343777179635
STAT,1940,37,15-19,1977,0.02318952519308644
STAT,1970,22,20-24,1992,161.1660788966233
STAT,1901,21,45-49,1922,1.1306114257885111
SIM,1930,19,na,1949,5468
SIM,1917,37,30-34,1954,4
STAT,1813,52,50-100,1865,0.04795779633069224
STAT,1949,39,na,1988,5191.17148877764
SIM,1935,25,na,1960,5819
SIM,1910,64,na,1974,2875
STAT,1870,48,45-49,1918,0.26512915990258396
STAT,1941,48,20-24,1989,0.01362919297871591
SIM,1985,18,25-29,2003,81
STAT,1864,25,50-100,1889,0.6662111123701475
SIM,1821,44,25-29,1865,2
SIM,1969,23,35-39,1992,15
STAT,1779,86,na,1865,59.64750195542918
STAT,1981,33,40-44,2014,6.433034481374406
SIM,1882,24,45-49,1906,1
STAT,1930,45,40-44,1975,0.24077048306791332
SIM,1834,43,na,1877,1809
SIM,1891,26,45-49,1917,5
STAT,1937,19,45-49,1956,0.5594709706281696
SIM,1855,42,na,1897,1808
STAT,1819,91,na,1910,38.5765812436519
STAT,1817,65,na,1882,1314.8879325379005
SIM,1986,18,50-100,2004,1
SIM,1963,36,50-100,1999,1
STAT,1873,111,na,1984,0.007633115296873189
SIM,1908,35,30-34,1943,3
SIM,1884,44,30-34,1928,3
SIM,1949,32,15-19,1981,1
STAT,1861,23,20-24,1884,67.43497656768592
STAT,1926,73,na,1999,3746.543415023508
STAT,1880,101,na,1981,11.533159540396172
STAT,1871,60,na,1931,2189.6832649738553
SIM,1807,47,na,1854,1273
SIM,1956,31,45-49,1987,7
STAT,1802,66,na,1868,1066.5920643935906
SIM,1832,35,50-100,1867,2
STAT,1925,29,na,1954,5068.1121195818405
STAT,1919,40,15-19,1959,0.0019254326343621933
STAT,1871,43,35-39,1914,2.0640244997811457
STAT,1899,36,15-19,1935,0.08921164111149263
SIM,1939,40,40-44,1979,1
SIM,1868,15,na,1883,3267
STAT,1849,103,na,1952,0.11123393157968621
SIM,1966,17,na,1983,5232
STAT,1847,41,na,1888,1811.370735717296
STAT,1966,21,50-100,1987,0.9518998949742885
SIM,1926,40,30-34,1966,1
SIM,1816,40,35-39,1856,1
SIM,1909,70,na,1979,3679
STAT,1863,52,40-44,1915,0.010567003431925398
STAT,1895,43,20-24,1938,0.01644695425356863
STAT,1966,46,20-24,2012,0.01661014979224715
STAT,1824,35,50-100,1859,1.9756564972461306
STAT,1810,92,na,1902,23.714647342746005
STAT,1838,64,na,1902,1505.783498281119
STAT,1884,43,45-49,1927,1.6941731609551745
STAT,1864,29,45-49,1893,1.1359253855422424
STAT,1827,51,25-29,1878,0.0044163182372921024
STAT,1863,34,na,1897,2387.433961373362
STAT,1885,30,15-19,1915,0.1652444590370859
STAT,1885,49,35-39,1934,0.15779049707961304
STAT,1908,23,20-24,1931,117.75730177730422
SIM,1974,21,50-100,1995,2
STAT,1845,50,30-34,1895,0.004068796667471776
SIM,1910,27,35-39,1937,16
STAT,1892,17,20-24,1909,25.64315658723272
STAT,1955,46,45-49,2001,0.34719581903324914
STAT,1902,27,35-39,1929,15.733813016131366
STAT,1821,46,40-44,1867,0.31414748815553856
SIM,1827,61,na,1888,973
STAT,1967,27,na,1994,5423.669521806102
STAT,1841,53,na,1894,1883.6230863002593
STAT,1869,53,20-24,1922,8.114633175906766E-4
SIM,1893,49,35-39,1942,1
SIM,1951,18,na,1969,5637
SIM,1853,16,na,1869,2731
SIM,1916,23,20-24,1939,6
STAT,1926,77,na,2003,3167.263215958386
STAT,1952,28,na,1980,5200.7083604351565
STAT,1920,26,40-44,1946,5.918412160968211
STAT,1898,30,25-29,1928,16.10359929875923
SIM,1918,85,na,2003,1513
STAT,1903,48,50-100,1951,0.22486561087388676
SIM,1817,46,25-29,1863,1
SIM,1948,37,25-29,1985,3
STAT,1850,23,45-49,1873,0.8554208205378819
STAT,1899,32,na,1931,3772.925849645082
SIM,1973,21,35-39,1994,21
STAT,1918,45,25-29,1963,0.06543693638217149
STAT,1866,45,na,1911,2430.561347075786
STAT,1858,19,na,1877,2385.6570113783464
STAT,1880,42,30-34,1922,1.4045901795589844
SIM,1790,76,na,1866,144
STAT,1948,31,45-49,1979,2.1195632382274074
STAT,1919,95,na,2014,246.17202250392532
SIM,1916,33,50-100,1949,3
SIM,1913,101,na,2014,112
SIM,1856,34,50-100,1890,4
SIM,1861,42,na,1903,1782
SIM,1876,41,na,1917,2591
STAT,1848,34,50-100,1882,1.0119035661167148
SIM,1902,22,15-19,1924,8
STAT,1908,33,50-100,1941,0.8979919000357718
STAT,1834,30,35-39,1864,12.086517210863395
STAT,1969,42,50-100,2011,0.17600713596452275
STAT,1892,4,na,1896,3805.117085465858
STAT,1773,98,na,1871,1.0576000449221918
STAT,1957,30,40-44,1987,6.076315912395031
STAT,1974,37,15-19,2011,0.029813328355505736
SIM,1864,22,35-39,1886,17
STAT,1904,96,na,2000,145.56279480387147
STAT,1961,36,50-100,1997,0.6455257797747334
STAT,1969,33,25-29,2002,13.573495297543861
STAT,1871,40,50-100,1911,1.2251792701994009
SIM,1842,30,35-39,1872,10
STAT,1795,79,na,1874,247.1630843417872
SIM,1898,22,na,1920,3544
STAT,1896,18,35-39,1914,0.8341983791560389
STAT,1921,46,45-49,1967,0.28335050011647817
STAT,1944,35,25-29,1979,1.262039365261414
SIM,1891,23,40-44,1914,7
SIM,1938,36,na,1974,4082
STAT,1879,25,40-44,1904,3.6342005218192615
SIM,1896,27,40-44,1923,10
STAT,1907,20,35-39,1927,9.9676171898876
SIM,1959,35,na,1994,5927
STAT,1949,39,25-29,1988,1.3585844193536627
STAT,1944,30,30-34,1974,19.968353915146242
SIM,1961,32,30-34,1993,28
STAT,1881,48,20-24,1929,0.013189711653885562
SIM,1885,39,50-100,1924,4
STAT,1914,47,15-19,1961,4.218149406833433E-4
SIM,1917,37,na,1954,5364
STAT,1815,39,na,1854,1794.5049495884582
STAT,1814,54,na,1868,1705.5702062081302
STAT,1893,112,na,2005,0.00660720615476677
SIM,1936,73,na,2009,2375
SIM,1883,23,na,1906,2460
STAT,1953,32,30-34,1985,22.420082214615046
SIM,1896,95,na,1991,407
STAT,1936,44,30-34,1980,0.14570727542424872
SIM,1937,51,na,1988,4160
SIM,1929,21,40-44,1950,9
STAT,1931,40,30-34,1971,0.19769253233047426
SIM,1866,39,30-34,1905,3
STAT,1888,27,40-44,1915,4.063705894198418
SIM,1820,49,35-39,1869,1
SIM,1915,20,35-39,1935,24
SIM,1848,37,20-24,1885,1
STAT,1788,97,na,1885,1.4769334704475978
STAT,1935,33,25-29,1968,14.755758306551321
STAT,1822,80,na,1902,508.2552239393866
SIM,1957,39,25-29,1996,1
SIM,1952,30,30-34,1982,50
STAT,1839,34,35-39,1873,9.68026492597093
STAT,1958,36,30-34,1994,2.848688240646467
STAT,1924,24,50-100,1948,0.8901778893846453
STAT,1930,48,45-49,1978,0.3294300605912684
STAT,1905,45,15-19,1950,3.806373722358375E-4
STAT,1961,23,25-29,1984,138.13234798736872
SIM,1981,31,25-29,2012,2
STAT,1847,8,na,1855,2358.29301
SIM,1985,15,20-24,2000,225
STAT,1812,49,35-39,1861,0.31398878504644584
STAT,1866,32,50-100,1898,0.9800729307497809
STAT,1932,77,na,2009,3483.630542810737
STAT,1818,45,20-24,1863,0.015242464435136405
SIM,1851,24,15-19,1875,7
STAT,1877,39,50-100,1916,1.4590040483792421
SIM,1812,62,na,1874,853
SIM,1922,52,na,1974,4901
SIM,1847,34,35-39,1881,18
STAT,1943,15,20-24,1958,166.01897958674962
SIM,1945,38,50-100,1983,1
SIM,1961,29,50-100,1990,1
STAT,1820,54,na,1874,1346.3776774023415
STAT,1930,44,na,1974,5621.317486070957
SIM,1944,36,na,1980,4601
SIM,1943,51,na,1994,5242
STAT,1937,38,50-100,1975,0.484282753486527
STAT,1953,29,50-100,1982,1.394187947325065
STAT,1820,35,35-39,1855,19.56302986886711
STAT,1843,24,15-19,1867,4.095499849405159
SIM,1971,39,na,2010,5712
STAT,1911,74,na,1985,2772.8531830813868
STAT,1965,40,30-34,2005,0.19195316739395782
STAT,1948,19,20-24,1967,178.9307149803417
STAT,1868,42,15-19,1910,0.0152930405276102
SIM,1943,33,25-29,1976,29
STAT,1918,40,30-34,1958,0.15726900865322027
STAT,1850,54,20-24,1904,7.387583655042404E-4
SIM,1902,38,na,1940,3952
STAT,1913,41,25-29,1954,0.08087048066249901
STAT,1829,53,na,1882,1632.1749804621859
STAT,1844,35,20-24,1879,0.7644249065067716
STAT,1973,31,25-29,2004,14.069774756626439
SIM,1956,19,20-24,1975,186
STAT,1812,44,40-44,1856,5.549438010328142
STAT,1951,43,na,1994,5295.686065614596
SIM,1944,44,30-34,1988,1
STAT,1849,39,20-24,1888,0.5987946073840595
SIM,1860,97,na,1957,3
SIM,1838,32,35-39,1870,16
SIM,1853,53,35-39,1906,1
STAT,1853,41,25-29,1894,0.6422366162644241
SIM,1902,36,40-44,1938,4
STAT,1912,44,45-49,1956,0.18398553977345888
STAT,1883,23,40-44,1906,2.345542293554543
STAT,1883,111,na,1994,0.01172959147711623
SIM,1820,44,40-44,1864,6
SIM,1843,33,20-24,1876,5
SIM,1837,17,25-29,1854,11
SIM,1867,30,na,1897,2346
STAT,1966,27,25-29,1993,95.28503651264448
STAT,1927,42,30-34,1969,0.18499610366921274
STAT,1912,21,20-24,1933,123.46965287483745
SIM,1980,34,45-49,2014,7
STAT,1852,26,15-19,1878,0.5018291503411737
STAT,1978,30,30-34,2008,25.3219719757596
SIM,1920,21,20-24,1941,267
STAT,1903,38,40-44,1941,1.5454120805327494
SIM,1875,96,na,1971,77
SIM,1852,31,na,1883,2087
STAT,1877,44,15-19,1921,0.01635416877884475
SIM,1958,30,50-100,1988,1
STAT,1835,53,na,1888,1340.7436002946279
STAT,1869,100,na,1969,8.004533003670531
STAT,1898,15,50-100,1913,0.07676668914092781
SIM,1923,37,na,1960,5390
STAT,1835,33,20-24,1868,2.1266754729744406
STAT,1813,41,20-24,1854,0.620597614763052
STAT,1972,34,45-49,2006,2.366998786662658
STAT,1831,50,50-100,1881,0.012808476699096492
SIM,1935,42,30-34,1977,1
STAT,1850,97,na,1947,5.530433544469625
STAT,1861,32,40-44,1893,4.160677135472436
STAT,1882,29,30-34,1911,28.182539254735545
STAT,1910,46,20-24,1956,0.011940977473755826
STAT,1887,38,20-24,1925,0.9920117011367421
SIM,1816,40,30-34,1856,1
SIM,1924,21,15-19,1945,8
STAT,1842,27,35-39,1869,9.182238921232017
SIM,1841,29,35-39,1870,2
STAT,2006,0,na,2006,7074.7770175737705
STAT,1973,17,na,1990,5493.6981031119585
SIM,1887,19,30-34,1906,5
SIM,1846,38,25-29,1884,2
SIM,1949,22,30-34,1971,58
STAT,1991,16,25-29,2007,71.69139652949222
SIM,1936,5,na,1941,4171
STAT,1861,44,35-39,1905,1.7138574271791365
SIM,1919,7,na,1926,5696
SIM,1860,34,40-44,1894,7
STAT,1866,53,25-29,1919,0.003727923582129849
STAT,1887,42,na,1929,2985.4994030055236
SIM,1890,29,30-34,1919,6
STAT,1975,33,30-34,2008,24.43508008264708
SIM,1879,2,na,1881,3576
SIM,1844,14,na,1858,3017
SIM,1969,21,45-49,1990,4
SIM,1904,30,50-100,1934,2
SIM,1848,28,na,1876,1811
SIM,1881,23,20-24,1904,129
STAT,1833,21,25-29,1854,80.2200322134831
SIM,1974,35,30-34,2009,4
STAT,1811,50,30-34,1861,0.01844152150266011
STAT,1916,21,15-19,1937,6.457332296161341
SIM,1832,23,25-29,1855,2
STAT,1893,22,35-39,1915,8.51232296017773
STAT,1888,17,30-34,1905,2.162202801063593
STAT,1838,38,25-29,1876,2.978856034624513
STAT,1871,51,40-44,1922,0.012144903992944286
SIM,1835,53,na,1888,1908
STAT,1966,35,30-34,2001,2.7112506949944297
SIM,1841,21,25-29,1862,137
STAT,1987,27,15-19,2014,1.1680832647593473
SIM,1830,28,20-24,1858,13
SIM,1958,20,30-34,1978,1
STAT,1891,27,30-34,1918,35.917401393905244
STAT,1993,19,50-100,2012,0.6216583935901844
STAT,1847,36,25-29,1883,2.322579515461317
SIM,1836,70,na,1906,732
STAT,1901,48,20-24,1949,0.010804484776222258
STAT,1871,23,50-100,1894,0.46674819748700586
STAT,1951,31,50-100,1982,1.1588391694459501
STAT,1900,39,15-19,1939,0.019213836609883943
SIM,1827,41,45-49,1868,7
SIM,1844,48,50-100,1892,2
STAT,1968,24,40-44,1992,4.859257388026265
SIM,1939,15,25-29,1954,61
STAT,1882,11,na,1893,2915.3869507030386
SIM,1820,87,na,1907,237
STAT,1974,22,15-19,1996,8.048160240662828
STAT,1831,26,20-24,1857,12.31804312654583
STAT,1873,26,25-29,1899,50.02287345520729
SIM,1842,30,30-34,1872,22
SIM,1896,17,30-34,1913,1
SIM,1883,48,50-100,1931,1
STAT,1870,42,35-39,1912,2.057670185013327
STAT,1884,24,35-39,1908,6.612083290171468
STAT,1802,52,30-34,1854,0.02374532191665915
STAT,1835,42,40-44,1877,1.6819842694309444
STAT,1856,34,25-29,1890,8.94088427505533
STAT,1927,56,na,1983,5122.492144829931
STAT,1851,25,35-39,1876,9.088951088432125
STAT,1866,80,na,1946,661.6888642598763
STAT,1949,19,35-39,1968,5.62817001244642
STAT,1955,19,50-100,1974,0.5735928837891744
STAT,1823,44,15-19,1867,0.013922740224321703
SIM,1921,85,na,2006,2070
SIM,1890,21,20-24,1911,183
STAT,1894,112,na,2006,0.006788536593473561
SIM,1965,37,30-34,2002,6
STAT,1919,21,40-44,1940,4.260829651778585
SIM,1865,83,na,1948,379
STAT,1896,36,20-24,1932,1.1806495560597114
STAT,1852,34,40-44,1886,4.146365913453511
STAT,1923,42,na,1965,5007.6618890449745
STAT,1889,33,25-29,1922,14.509325318676074
SIM,1864,34,25-29,1898,15
SIM,1911,61,na,1972,4197
SIM,1892,24,35-39,1916,9
STAT,1875,51,25-29,1926,0.004244399475055271
SIM,1997,15,30-34,2012,50
STAT,1882,21,20-24,1903,77.91371713943616
SIM,1927,21,40-44,1948,11
STAT,1834,30,30-34,1864,20.837938117692513
SIM,1894,96,na,1990,189
SIM,1886,45,na,1931,1946
STAT,1821,84,na,1905,203.45404263725558
STAT,1833,29,35-39,1862,8.922654198585112
STAT,1912,49,35-39,1961,0.14229286371860622
STAT,1866,19,45-49,1885,0.07087659066171459
STAT,1825,98,na,1923,2.297784992097933
SIM,1890,82,na,1972,931
SIM,1843,42,40-44,1885,2
SIM,1897,33,25-29,1930,19
STAT,1977,36,45-49,2013,1.0961505819116573
STAT,1948,18,na,1966,4859.518310893822
SIM,1854,43,50-100,1897,3
SIM,1876,41,40-44,1917,1
STAT,1975,1,na,1976,5994.796598768417
STAT,1817,46,40-44,1863,0.49580154063472637
SIM,1858,45,40-44,1903,1
SIM,1824,37,35-39,1861,5
STAT,1892,43,25-29,1935,0.9221282656117923
SIM,1881,14,na,1895,2148
STAT,1878,81,na,1959,815.633363014501
SIM,1875,32,35-39,1907,41
SIM,1827,66,na,1893,755
STAT,1868,41,40-44,1909,2.50520864813359
STAT,1885,36,45-49,1921,2.3057656255502823
STAT,1877,19,20-24,1896,21.167993850860967
STAT,1836,50,na,1886,2062.747212580307
STAT,1820,67,na,1887,920.9257017300483
SIM,1882,31,na,1913,3395
STAT,1841,40,15-19,1881,0.013089712135212051
SIM,1874,28,35-39,1902,21
STAT,1979,33,15-19,2012,0.2080081636672728
STAT,1833,51,20-24,1884,5.496073512255881E-4
STAT,1890,15,20-24,1905,25.115510930351178
STAT,1962,33,na,1995,5696.9735638695465
STAT,1825,35,35-39,1860,12.381833495255808
SIM,1982,21,20-24,2003,5
STAT,1854,39,20-24,1893,0.6216876391990102
STAT,1813,53,45-49,1866,0.04517035730055286
SIM,1894,29,15-19,1923,1
SIM,1823,52,na,1875,1933
STAT,1968,38,45-49,2006,1.0113376330746728
STAT,1874,47,25-29,1921,0.0677341013269941
STAT,1865,37,30-34,1902,5.54945522397343
SIM,1865,39,50-100,1904,4
STAT,1834,38,40-44,1872,4.917736905664603
SIM,1857,25,50-100,1882,4
STAT,1862,98,na,1960,6.6250482478014945
STAT,1814,46,15-19,1860,0.0011304732653961882
SIM,1842,38,40-44,1880,2
STAT,1840,24,20-24,1864,69.29597310976776
SIM,1965,43,50-100,2008,1
SIM,1976,38,45-49,2014,2
STAT,1875,26,35-39,1901,11.546757757968187
STAT,1865,32,25-29,1897,10.665173941837832
SIM,1893,33,40-44,1926,2
STAT,1899,40,30-34,1939,0.1274989235989969
STAT,1860,23,35-39,1883,5.554938736283886
STAT,1894,31,40-44,1925,6.459981064505264
STAT,1947,58,na,2005,4712.329361381764
STAT,1857,12,na,1869,2521.9069831973325
STAT,1809,52,40-44,1861,0.02544659392344553
SIM,1917,48,50-100,1965,2
SIM,1982,24,25-29,2006,317
STAT,1977,22,40-44,1999,5.260234165886389
STAT,1989,18,35-39,2007,6.933961069632475
STAT,1848,51,na,1899,2298.746585147915
SIM,1858,48,45-49,1906,1
SIM,1864,39,30-34,1903,8
SIM,1914,20,50-100,1934,4
SIM,1915,75,na,1990,2876
STAT,1848,45,30-34,1893,0.10387807922225217
STAT,1855,18,30-34,1873,1.6035830692011495
STAT,1899,48,40-44,1947,0.15076714309007197
SIM,1938,39,50-100,1977,1
STAT,1962,27,50-100,1989,1.4781636029428913
SIM,1966,17,35-39,1983,14
STAT,1871,59,na,1930,2231.3424281066054
STAT,1958,17,35-39,1975,6.3602502059515995
STAT,1936,17,na,1953,4069.213604614145
STAT,1839,42,25-29,1881,0.5367403355982103
SIM,1863,18,30-34,1881,4
SIM,1889,10,na,1899,4142
SIM,1889,47,35-39,1936,1
SIM,1873,37,30-34,1910,11
STAT,1994,20,35-39,2014,15.743419259488109
STAT,1819,41,45-49,1860,3.2487587681869923
SIM,1838,44,25-29,1882,1
SIM,1976,30,35-39,2006,5
STAT,1952,37,50-100,1989,0.5982093734575331
SIM,1867,43,40-44,1910,3
STAT,1855,50,45-49,1905,0.012526002250694009
STAT,1876,38,45-49,1914,2.36639167547977
SIM,1903,74,na,1977,2155
SIM,1907,88,na,1995,754
STAT,1877,64,na,1941,2086.803532176083
SIM,1836,27,na,1863,1630
STAT,1948,32,15-19,1980,0.17299183557821987
SIM,1929,81,na,2010,1796
STAT,1849,25,na,1874,2016.4009895740458
STAT,1982,23,50-100,2005,1.0717115876244065
SIM,1847,35,50-100,1882,4
STAT,1808,48,40-44,1856,0.8412306603577555
STAT,1943,48,25-29,1991,0.06734132244676129
SIM,1883,26,35-39,1909,15
SIM,1851,36,40-44,1887,4
SIM,1888,35,25-29,1923,2
STAT,1978,29,15-19,2007,1.115554474664706
STAT,1873,50,na,1923,2573.951019799771
STAT,1845,11,na,1856,2042.4680190674999
STAT,1984,31,30-34,2015,26.337967183400636
STAT,1832,68,na,1900,1041.146220956702
STAT,1829,28,30-34,1857,44.17202358469812
STAT,1857,18,40-44,1875,0.19208297336114577
SIM,1879,75,na,1954,979
SIM,1816,48,40-44,1864,1
STAT,1864,28,25-29,1892,43.43570904972504
SIM,1961,36,na,1997,5579
STAT,1872,47,15-19,1919,4.61359536139947E-4
SIM,1875,61,na,1936,2270
STAT,1843,36,40-44,1879,5.181146031153375
SIM,1852,40,40-44,1892,2
STAT,1858,93,na,1951,26.3112127337122
STAT,1850,46,25-29,1896,0.05946444400317399
STAT,1983,29,50-100,2012,1.6303633867344702
STAT,1969,42,45-49,2011,0.24934344333093297
STAT,1908,21,na,1929,4066.148119978757
STAT,1983,27,30-34,2010,64.24388249394534
STAT,1916,72,na,1988,3220.6685064123694
SIM,1816,82,na,1898,188
STAT,1886,29,15-19,1915,0.5483497884090499
STAT,1865,41,15-19,1906,0.014444633060383532
SIM,1833,35,35-39,1868,12
STAT,1844,40,40-44,1884,1.9768208837246275
STAT,1859,43,40-44,1902,2.0528327705490756
SIM,1893,38,50-100,1931,1
SIM,1820,41,35-39,1861,7
SIM,1922,34,50-100,1956,1
SIM,1876,44,45-49,1920,3
SIM,1944,16,45-49,1960,5
SIM,1826,44,50-100,1870,1
STAT,1818,44,50-100,1862,1.3369059138131545
STAT,1847,33,20-24,1880,2.41681817544774
STAT,1856,39,30-34,1895,4.645195765487086
STAT,1811,53,35-39,1864,0.02511402051536659
SIM,1896,23,na,1919,3621
SIM,1866,57,na,1923,2042
STAT,1976,24,35-39,2000,14.555543861553385
SIM,1986,26,na,2012,6208
STAT,1898,27,40-44,1925,4.672122082875898
STAT,1827,35,45-49,1862,3.06949117335313
STAT,1956,40,50-100,1996,0.1869567834989331
STAT,1987,15,20-24,2002,223.4787838235895
SIM,1896,29,25-29,1925,9
STAT,1970,20,na,1990,5296.586665045775
STAT,1959,22,50-100,1981,0.9965770930816714
STAT,1940,54,na,1994,4362.155494154341
STAT,1842,24,30-34,1866,17.041194462434984
SIM,1816,43,35-39,1859,9
SIM,1882,95,na,1977,322
STAT,1837,47,20-24,1884,0.009020241707803276
STAT,1888,29,25-29,1917,56.97489143424984
SIM,1834,79,na,1913,474
SIM,1923,62,na,1985,4794
STAT,1803,55,na,1858,1116.9192911222349
SIM,1826,37,45-49,1863,7
STAT,1807,69,na,1876,980.826430371118
STAT,1936,16,45-49,1952,0.5536172175780817
SIM,1929,26,20-24,1955,5
STAT,1910,49,25-29,1959,0.05683942037974151
STAT,1925,15,30-34,1940,17.065670801300307
STAT,1868,44,45-49,1912,1.6370270383693606
STAT,1911,15,50-100,1926,0.0869975018314009
STAT,1857,43,30-34,1900,1.0258695085573941
STAT,1892,18,35-39,1910,0.7915923262748573
SIM,1841,26,30-34,1867,8
STAT,1860,28,40-44,1888,2.7958338914652603
STAT,1841,36,30-34,1877,5.641128119247916
STAT,1826,47,45-49,1873,0.16981189930736085
STAT,1883,33,30-34,1916,19.630440698765586
STAT,1867,32,35-39,1899,10.911796437943005
SIM,1891,33,30-34,1924,4
STAT,1823,32,20-24,1855,7.468626004544589
STAT,1818,37,45-49,1855,3.2868302562111196
STAT,1931,46,50-100,1977,0.3499573368051399
SIM,1831,32,20-24,1863,5
STAT,1882,24,25-29,1906,64.12415494310187
SIM,1979,17,20-24,1996,401
STAT,1851,38,50-100,1889,0.9738547954442694
SIM,1984,24,35-39,2008,21
SIM,1850,24,30-34,1874,40
STAT,1861,41,30-34,1902,1.107990821017896
SIM,1881,26,25-29,1907,93
STAT,1896,39,25-29,1935,4.344549721488639
STAT,1972,22,50-100,1994,0.9754716506272293
STAT,1844,52,35-39,1896,0.007162478234513969
STAT,1833,26,30-34,1859,23.968700906109753
STAT,1853,50,35-39,1903,0.008694516614649568
STAT,1858,34,35-39,1892,9.03919743042812
STAT,1873,35,15-19,1908,0.06680607771448016
STAT,1774,108,na,1882,2.1193271960592096E-4
STAT,1842,15,40-44,1857,0.18288766661230818
SIM,1919,19,15-19,1938,109
STAT,1873,23,20-24,1896,80.96172759391035
SIM,1958,23,35-39,1981,15
SIM,1840,17,25-29,1857,11
STAT,1972,33,50-100,2005,1.2445111433743408
SIM,1988,17,na,2005,5834
SIM,1865,43,30-34,1908,5
STAT,1848,48,35-39,1896,0.14688478150808987
SIM,1853,82,na,1935,412
SIM,1896,25,50-100,1921,4
SIM,1902,57,na,1959,3481
SIM,1835,35,45-49,1870,5
SIM,1910,44,na,1954,3432
SIM,1968,41,40-44,2009,1
SIM,1914,58,na,1972,3717
STAT,1835,45,45-49,1880,0.17502067633829269
SIM,1907,24,na,1931,4171
STAT,1818,50,40-44,1868,0.013012576416356062
STAT,1891,31,15-19,1922,0.20394872543846915
SIM,1903,10,na,1913,4243
SIM,1897,38,30-34,1935,2
SIM,1915,2,na,1917,5148
STAT,1790,109,na,1899,1.5746660819165328E-4
SIM,1824,34,30-34,1858,10
STAT,1881,45,15-19,1926,4.4969023006103504E-4
STAT,1897,48,30-34,1945,0.08320140788618345
SIM,1852,27,45-49,1879,3
STAT,1882,19,50-100,1901,0.05492822354793708
STAT,1856,31,20-24,1887,2.434189275051781
STAT,1895,27,15-19,1922,0.681548314332977
STAT,1857,52,20-24,1909,6.597190039783378E-4
STAT,1844,27,45-49,1871,1.1368643354808308
STAT,1852,37,45-49,1889,1.8896842307822779
SIM,1897,30,20-24,1927,8
STAT,1889,30,20-24,1919,3.876197276038086
SIM,1944,24,na,1968,4623
STAT,1771,92,na,1863,13.208598980588848
STAT,1820,51,35-39,1871,0.008624304602947011
STAT,1834,33,35-39,1867,11.715811936364524
STAT,1947,16,20-24,1963,176.29174696828466
STAT,1879,44,20-24,1923,0.18878952962098072
SIM,1940,10,na,1950,5111
SIM,1955,40,na,1995,6501
SIM,1860,37,45-49,1897,3
SIM,1864,31,20-24,1895,5
SIM,1961,50,na,2011,5473
SIM,1955,16,20-24,1971,375
SIM,1842,33,35-39,1875,3
STAT,1897,40,20-24,1937,0.017189866182107057
STAT,1886,25,na,1911,2924.8507772872817
STAT,1840,27,25-29,1867,42.31107373257468
SIM,1853,31,45-49,1884,4
SIM,1871,79,na,1950,95
SIM,1848,38,35-39,1886,13
STAT,1962,42,35-39,2004,0.30943882975898007
SIM,1854,24,15-19,1878,1
SIM,1988,17,30-34,2005,48
STAT,1889,38,30-34,1927,7.544088372594727
SIM,1822,35,na,1857,1813
STAT,1891,47,na,1938,3194.622182269434
SIM,1856,15,na,1871,2474
SIM,1859,29,20-24,1888,14
SIM,1863,27,20-24,1890,15
STAT,1967,47,40-44,2014,0.23640708074693037
SIM,1826,49,na,1875,1699
STAT,1978,18,15-19,1996,71.45444064220099
STAT,1870,30,40-44,1900,4.973647346425816
SIM,1963,9,na,1972,6579
STAT,1833,54,25-29,1887,0.002485934854976519
STAT,1824,44,30-34,1868,1.5820988328335615
STAT,1944,61,na,2005,4371.990135885222
STAT,1884,45,40-44,1929,0.19715195105644032
STAT,1946,45,50-100,1991,0.3025481318086499
STAT,1957,30,15-19,1987,0.19953206876505722
STAT,1958,44,35-39,2002,0.3161384672921546
STAT,1829,37,20-24,1866,0.8846333295277466
SIM,1838,49,30-34,1887,1
STAT,1845,31,45-49,1876,1.4117624897830585
SIM,1849,42,35-39,1891,3
SIM,1833,44,25-29,1877,1
SIM,1958,24,50-100,1982,1
STAT,1894,12,na,1906,3831.2535298038006
SIM,1957,8,na,1965,6328
STAT,1898,26,na,1924,3734.987001467659
SIM,1878,58,na,1936,2380
STAT,1937,20,45-49,1957,1.2660446141443047
SIM,1809,45,45-49,1854,1
SIM,1874,44,na,1918,2505
SIM,1870,30,na,1900,3053
SIM,1880,20,50-100,1900,1
STAT,1860,20,30-34,1880,19.04010464591794
SIM,1883,23,30-34,1906,27
STAT,1914,95,na,2009,225.25290363227242
SIM,1930,48,50-100,1978,2
STAT,1828,63,na,1891,1184.241688877659
SIM,1815,39,35-39,1854,1
SIM,1884,35,40-44,1919,12
STAT,1943,45,20-24,1988,0.01413476800141119
STAT,1870,17,45-49,1887,0.07502695701525644
STAT,1921,47,35-39,1968,0.16767241855013426
SIM,1991,22,25-29,2013,181
SIM,1932,23,na,1955,5150
STAT,1825,44,25-29,1869,0.9145704506653811
STAT,1838,51,20-24,1889,6.486301810963876E-4
STAT,1972,29,20-24,2001,27.061891443395318
SIM,1936,37,na,1973,3953
SIM,1980,29,20-24,2009,1
STAT,1854,34,15-19,1888,0.11636861709887188
STAT,1974,33,15-19,2007,0.19726670620524112
STAT,1829,80,na,1909,453.17085046954014
SIM,1837,37,20-24,1874,4
SIM,1922,49,45-49,1971,1
STAT,1988,27,30-34,2015,64.95202385623068
SIM,1855,36,25-29,1891,2
STAT,1876,35,40-44,1911,5.2718648022460695
STAT,1922,25,na,1947,4923.0452563675
STAT,1983,22,25-29,2005,151.2957295263622
STAT,1903,48,30-34,1951,0.08862781428673383
STAT,1926,39,na,1965,5293.811830098905
SIM,1920,22,na,1942,3846
STAT,1914,49,45-49,1963,0.24741228941190926
SIM,1924,36,na,1960,4912
STAT,1869,37,15-19,1906,0.06275880491466729
STAT,1871,21,45-49,1892,0.8030304038493826
SIM,1822,37,25-29,1859,7
STAT,1969,15,45-49,1984,0.7205342539422414
STAT,1808,49,50-100,1857,1.1861298275601948
STAT,1922,82,na,2004,2136.427301270149
SIM,1860,35,50-100,1895,4
SIM,1981,33,20-24,2014,1
SIM,1816,49,50-100,1865,1
STAT,1832,42,15-19,1874,0.01173503952208316
SIM,1990,18,25-29,2008,86
STAT,1880,52,45-49,1932,0.017657679322805948
STAT,1949,27,50-100,1976,1.341703276034467
STAT,1982,18,25-29,2000,70.35050575912835
STAT,1961,16,na,1977,5489.550318629405
STAT,1846,24,15-19,1870,4.147840611666332
SIM,1880,42,45-49,1922,4
STAT,1796,105,na,1901,0.007468120895004291
STAT,1894,34,45-49,1928,2.5648794803280586
SIM,1875,34,50-100,1909,3
STAT,1872,42,45-49,1914,1.7321747212754117
STAT,1867,34,50-100,1901,0.9787915919377947
STAT,1973,33,20-24,2006,3.708607930931406
SIM,1906,16,25-29,1922,17
STAT,1886,24,45-49,1910,0.8435433298051566
SIM,1861,26,na,1887,1874
SIM,1959,46,45-49,2005,2
SIM,1862,34,15-19,1896,5
SIM,1894,24,45-49,1918,2
STAT,1833,29,50-100,1862,0.5915427822874065
STAT,1855,41,50-100,1896,0.902997648112953
STAT,1954,60,na,2014,5076.71897481744
SIM,1981,30,50-100,2011,1
SIM,1891,36,35-39,1927,5
SIM,1876,28,45-49,1904,3
STAT,1835,51,30-34,1886,0.003861388164669027
STAT,1965,47,30-34,2012,0.13359454617588082
SIM,1867,31,na,1898,2261
STAT,1856,43,15-19,1899,0.012071021661900157
STAT,1836,48,50-100,1884,0.23101674257104532
STAT,1830,47,50-100,1877,0.22660598173009264
STAT,1985,27,40-44,2012,7.68365289178358
STAT,1827,32,40-44,1859,7.509457413002271
STAT,1768,93,na,1861,6.200348810762986
STAT,1810,53,50-100,1863,0.05418837949360146
STAT,1823,35,25-29,1858,6.103136889581538
SIM,1870,32,35-39,1902,11
SIM,1875,41,25-29,1916,4
STAT,1867,41,25-29,1908,0.6950475323693156
SIM,1891,17,30-34,1908,5
STAT,1868,39,na,1907,2585.9402655554422
SIM,1880,19,20-24,1899,1
STAT,1842,40,30-34,1882,0.9390734349871288
STAT,1851,46,40-44,1897,0.13614616444864697
STAT,1863,37,20-24,1900,0.77787144518307
STAT,1857,76,na,1933,851.5365206684152
SIM,1983,15,na,1998,6563
STAT,1956,17,25-29,1973,66.17609207339528
SIM,1984,21,30-34,2005,60
STAT,1853,62,na,1915,1819.7238309275306
STAT,1965,15,25-29,1980,62.46871476231285
SIM,1871,37,20-24,1908,1
STAT,1881,17,20-24,1898,19.734144240410107
SIM,1831,35,25-29,1866,8
STAT,1864,52,50-100,1916,0.015479653834630637
STAT,1887,28,50-100,1915,0.8244166900445122
SIM,1866,43,25-29,1909,1
SIM,1932,80,na,2012,2332
STAT,1797,104,na,1901,0.01986004238975615
STAT,1872,33,na,1905,2753.593104059338
STAT,1872,19,20-24,1891,20.433688794364098
STAT,1914,38,na,1952,4315.544473428695
STAT,1910,24,na,1934,4114.155666605028
STAT,1866,28,35-39,1894,10.28476059258856
SIM,1939,36,30-34,1975,3
STAT,1872,35,20-24,1907,0.9017448032337594
SIM,1948,22,15-19,1970,10
SIM,1919,30,45-49,1949,4
STAT,1857,22,25-29,1879,59.39949205946106
SIM,1847,26,25-29,1873,59
STAT,1886,89,na,1975,429.2652131689053
STAT,1882,75,na,1957,1239.3135164435346
STAT,1883,17,30-34,1900,1.7996256944375044
STAT,1819,59,na,1878,1446.777133101601
SIM,1850,40,30-34,1890,3
STAT,1819,46,15-19,1865,7.814310528895455E-4
STAT,1846,48,25-29,1894,0.05879765269806131
STAT,1769,116,na,1885,1.74237965834307E-4
STAT,1826,53,30-34,1879,0.004056982502640863
STAT,1815,105,na,1920,0.016269501960822257
SIM,1954,23,na,1977,5494
STAT,1827,51,45-49,1878,0.018094637379606447
SIM,1978,30,45-49,2008,7
STAT,1967,21,na,1988,5283.452272599827
STAT,1842,48,40-44,1890,0.13008736833062487
STAT,1890,39,30-34,1929,7.439706683742451
STAT,1833,30,15-19,1863,0.1330433257701302
STAT,1879,47,25-29,1926,0.06908549816366184
SIM,1870,25,50-100,1895,1
SIM,1882,19,30-34,1901,4
STAT,1873,45,50-100,1918,0.2923226710113404
STAT,1815,45,na,1860,1729.3729779309201
STAT,1903,102,na,2005,13.447142117901198
SIM,1899,63,na,1962,3118
SIM,1842,66,na,1908,1417
STAT,1987,22,45-49,2009,1.8598455233468565
SIM,1882,38,35-39,1920,17
STAT,1885,45,35-39,1930,0.1627619458865769
SIM,1851,48,na,1899,2561
STAT,1957,22,na,1979,5574.815585911125
STAT,1853,41,45-49,1894,1.4968256569806078
STAT,1874,38,35-39,1912,8.314836361372848
STAT,1992,16,40-44,2008,2.3175999779126775
STAT,1900,25,na,1925,3847.5999864083997
SIM,1937,15,15-19,1952,95
STAT,1928,36,50-100,1964,0.6128936237586248
SIM,1880,35,20-24,1915,1
STAT,1850,33,na,1883,2543.280970572768
STAT,1905,23,50-100,1928,0.6790366958789791
STAT,1938,31,50-100,1969,0.9604374674090087
SIM,1832,44,30-34,1876,1
SIM,1887,47,25-29,1934,1
STAT,1951,39,20-24,1990,0.37242489599716994
STAT,1862,20,40-44,1882,2.1077234905700313
STAT,1837,54,45-49,1891,0.010219926898737512
STAT,1855,27,20-24,1882,10.404820008254113
STAT,1876,51,40-44,1927,0.012619354532840731
SIM,1814,48,na,1862,1411
STAT,1949,20,15-19,1969,7.173179060345819
STAT,1859,5,na,1864,2683.3271131782203
STAT,1861,19,45-49,1880,0.07118688346245802
STAT,1874,44,20-24,1918,0.18509657552920608
STAT,1894,18,45-49,1912,0.09665459669173661
STAT,1977,37,50-100,2014,0.67447967976317
SIM,1835,32,40-44,1867,1
STAT,1940,39,45-49,1979,0.8214755019492431
STAT,1895,22,45-49,1917,1.0475108704677747
STAT,1852,43,30-34,1895,1.0760926374782136
SIM,1946,15,na,1961,4687
STAT,1861,1,na,1862,3500.6208530306685
STAT,1969,37,na,2006,5587.743667865408
STAT,1857,46,35-39,1903,0.1261907596862959
SIM,1916,23,30-34,1939,3
SIM,1983,24,40-44,2007,8
SIM,1897,61,na,1958,2843
STAT,1887,17,15-19,1904,7.675291091473363
SIM,1841,30,15-19,1871,1
STAT,1908,23,30-34,1931,30.437534344832702
SIM,1892,33,25-29,1925,2
STAT,1841,105,na,1946,0.026068719884779715
STAT,1873,50,50-100,1923,0.018054208052958567
SIM,1907,25,30-34,1932,92
SIM,1957,56,na,2013,5913
STAT,1865,16,25-29,1881,6.116399182596128
SIM,1927,24,45-49,1951,1
STAT,1929,15,15-19,1944,67.15434571792491
STAT,1932,45,45-49,1977,0.3419257014574892
SIM,1873,16,25-29,1889,2
STAT,1845,36,15-19,1881,0.040173158767717786
STAT,1884,29,40-44,1913,3.3911928578685595
SIM,1843,45,45-49,1888,1
STAT,1883,42,20-24,1925,0.17909380355240206
STAT,1869,19,50-100,1888,0.054859929397428495
STAT,1909,48,50-100,1957,0.23945211467407648
STAT,1956,46,50-100,2002,0.36015452359571726
SIM,1828,39,20-24,1867,2
STAT,1863,41,40-44,1904,2.2800372646760403
SIM,1845,95,na,1940,10
STAT,1956,42,15-19,1998,0.002437114835190175
SIM,1818,40,40-44,1858,5
SIM,1834,20,30-34,1854,21
STAT,1928,41,50-100,1969,0.1730820865507918
STAT,1840,42,50-100,1882,0.88405282470726
STAT,1957,43,50-100,2000,0.18547326734096803
STAT,1868,53,35-39,1921,0.009392183736544891
SIM,1991,20,50-100,2011,1
STAT,1906,20,50-100,1926,0.6903532625412558
SIM,1945,41,na,1986,4692
STAT,1983,31,15-19,2014,0.21396780778401747
SIM,1871,41,40-44,1912,6
STAT,1864,49,30-34,1913,0.09766410882827661
STAT,1878,38,na,1916,2824.7671026769312
STAT,1973,36,25-29,2009,1.5153999020243532
STAT,2007,1,na,2008,7072.980130137894
STAT,1849,25,50-100,1874,0.5962621817466353
STAT,1884,21,30-34,1905,20.371256520082184
STAT,1783,93,na,1876,5.078497405498656
SIM,1965,29,35-39,1994,4
STAT,1957,29,35-39,1986,22.92016061745311
SIM,1838,28,25-29,1866,3
SIM,1890,24,25-29,1914,8
STAT,1951,38,na,1989,5321.15968218938
STAT,1919,24,45-49,1943,1.412644537440221
SIM,1979,35,30-34,2014,7
STAT,1850,34,30-34,1884,18.415982977609932
STAT,1977,33,40-44,2010,6.21609293687147
STAT,1919,83,na,2002,1850.519887034129
SIM,1839,32,25-29,1871,19
SIM,1938,27,25-29,1965,150
SIM,1876,53,35-39,1929,1
STAT,1864,101,na,1965,2.6693948922340454
STAT,1864,41,20-24,1905,0.1643880174185075
SIM,1974,26,40-44,2000,1
SIM,1844,30,40-44,1874,3
SIM,1983,17,30-34,2000,26
STAT,1957,21,25-29,1978,141.05723001472307
STAT,1846,52,45-49,1898,0.014922806905037143
STAT,1909,48,25-29,1957,0.05615815027657399
SIM,1854,29,20-24,1883,16
STAT,1921,44,30-34,1965,0.16556337237285218
STAT,1871,26,15-19,1897,0.5226954662226134
STAT,1894,39,15-19,1933,0.08246904097777605
SIM,1864,66,na,1930,1611
SIM,1990,23,50-100,2013,2
SIM,1860,52,na,1912,2214
STAT,1834,50,50-100,1884,0.014703005826088151
STAT,1826,29,na,1855,1557.5352165789502
STAT,1819,81,na,1900,359.9936465099048
STAT,1858,43,25-29,1901,0.5739487403534969
STAT,1849,52,35-39,1901,0.006637086461288256
STAT,1886,21,40-44,1907,2.5443020780774077
STAT,1894,43,35-39,1937,0.18520245027823604
SIM,1910,39,25-29,1949,2
STAT,1913,37,50-100,1950,0.4784178223793062
STAT,1912,15,45-49,1927,0.11722736826384356
SIM,1877,32,45-49,1909,5
STAT,1902,39,25-29,1941,1.0031538810250715
STAT,1856,18,25-29,1874,5.864734463953392
STAT,1869,32,45-49,1901,1.9489101743333135
STAT,1981,16,20-24,1997,218.84141875803115
SIM,1878,16,50-100,1894,1
STAT,1848,28,50-100,1876,0.8055964538328212
STAT,1897,6,na,1903,4031.2168976042135
STAT,1836,30,40-44,1866,5.09521662695967
STAT,1883,36,35-39,1919,8.024418031171155
SIM,1943,38,25-29,1981,4
SIM,1969,32,45-49,2001,12
SIM,1968,15,na,1983,5056
STAT,1843,63,na,1906,1790.3369188096583
SIM,1866,39,40-44,1905,3
STAT,1815,46,30-34,1861,0.2005651219026226
STAT,1814,71,na,1885,948.8635356371132
STAT,1879,12,na,1891,3111.972253114321
STAT,1825,41,20-24,1866,0.24122457114765267
STAT,1902,30,25-29,1932,16.836129610535203
SIM,1843,26,40-44,1869,8
STAT,1843,84,na,1927,333.7879150958079
STAT,1847,98,na,1945,2.499604153082804
STAT,1893,31,25-29,1924,15.00213551162094
STAT,1848,54,20-24,1902,7.624986657917817E-4
STAT,1835,26,40-44,1861,2.4623132734675615
SIM,1886,19,15-19,1905,9
STAT,1861,35,45-49,1896,1.9307294121338279
STAT,1847,77,na,1924,665.1102987777108
STAT,1846,29,20-24,1875,14.461669020588376
STAT,1925,49,20-24,1974,0.015358664787781369
STAT,1816,50,30-34,1866,0.012128956179696832
STAT,1924,16,na,1940,5069.416203675546
STAT,1884,48,45-49,1932,0.2657110005197826
SIM,1811,43,35-39,1854,5
SIM,1911,18,na,1929,5151
STAT,1847,52,25-29,1899,0.002710908435741611
STAT,1868,49,15-19,1917,4.342465957650267E-4
SIM,1905,25,20-24,1930,4
STAT,1891,100,na,1991,26.482888022342518
STAT,1861,16,40-44,1877,0.20288726585429487
SIM,1882,26,40-44,1908,7
STAT,1930,29,35-39,1959,22.012284733713702
SIM,1949,25,35-39,1974,44
STAT,1882,33,15-19,1915,0.15984665461319214
STAT,1925,79,na,2004,2784.832578575146
STAT,1835,33,na,1868,1701.770701069623
SIM,1942,28,50-100,1970,1
STAT,1794,66,na,1860,1014.6154563978677
SIM,1840,26,15-19,1866,1
STAT,1955,45,na,2000,5881.832234697398
STAT,1970,40,40-44,2010,0.37655701168541417
SIM,1865,27,30-34,1892,1
STAT,1854,47,na,1901,1824.3932382620442
STAT,1855,0,na,1855,3405.533946219865
STAT,1934,28,50-100,1962,1.5452797362184372
STAT,1850,43,20-24,1893,0.1623084354664947
STAT,1990,25,20-24,2015,30.32520082436001
STAT,1874,26,40-44,1900,3.5512459549187425
STAT,1935,38,25-29,1973,1.5881397134998918
STAT,1828,28,15-19,1856,0.6588844365171991
SIM,1939,39,35-39,1978,4
STAT,1869,13,na,1882,2958.968171636855
STAT,1975,36,35-39,2011,3.7973077980379166
SIM,1904,91,na,1995,844
SIM,1899,38,40-44,1937,3
STAT,1813,46,20-24,1859,0.04044665338959469
STAT,1896,43,45-49,1939,0.15727431398281522
SIM,1802,90,na,1892,37
STAT,1835,54,35-39,1889,0.005262505906382804
STAT,1839,100,na,1939,0.8419373663627059
STAT,1934,41,25-29,1975,0.11493735915231454
SIM,1892,21,30-34,1913,2
STAT,1872,38,25-29,1910,3.3198713988254465
SIM,1885,28,na,1913,3151
SIM,1817,67,na,1884,628
SIM,1860,43,30-34,1903,1
STAT,1985,22,35-39,2007,15.506254962451974
STAT,1839,47,na,1886,1817.9054681262617
SIM,1939,31,25-29,1970,8
SIM,1813,53,na,1866,1241
STAT,1851,22,30-34,1873,16.868062820647037
SIM,1822,34,20-24,1856,1
STAT,1889,106,na,1995,0.9782311040864322
SIM,1938,24,20-24,1962,235
STAT,1926,71,na,1997,3989.9428248282106
STAT,1854,18,15-19,1872,5.749581111360753
SIM,1839,37,30-34,1876,2
SIM,1916,26,35-39,1942,1
SIM,1885,3,na,1888,3480
SIM,1925,53,na,1978,5180
STAT,1833,85,na,1918,192.90118873940847
SIM,1959,33,na,1992,5816
STAT,1867,65,na,1932,1820.9150538264812
STAT,1808,52,25-29,1860,0.01688296376587246
STAT,1886,40,45-49,1926,1.8402601677293473
STAT,1959,41,25-29,2000,0.11218879635101146
SIM,1909,34,50-100,1943,2
STAT,1902,103,na,2005,7.876450479716221
STAT,1860,32,na,1892,2219.52855697625
STAT,1837,99,na,1936,1.3714023724953248
STAT,1863,51,na,1914,2183.17934012868
STAT,1824,53,20-24,1877,9.488524264000249E-4
STAT,1895,33,50-100,1928,1.3705684070432893
SIM,1851,70,na,1921,1616
STAT,1912,3,na,1915,4722.322442698819
STAT,1875,47,40-44,1922,0.2032204734131781
STAT,1885,33,40-44,1918,4.97096813783355
STAT,1841,29,na,1870,2354.702853902271
SIM,1911,27,25-29,1938,143
STAT,1903,27,25-29,1930,69.53411130641346
STAT,1968,27,45-49,1995,2.5009659452111483
SIM,1929,67,na,1996,4141
STAT,1918,20,na,1938,4571.427449259636
STAT,1905,48,40-44,1953,0.15927799240534898
SIM,1862,18,15-19,1880,7
STAT,1840,31,45-49,1871,1.7216310588282298
STAT,1846,45,20-24,1891,0.012529062023034032
STAT,1888,27,na,1915,3237.4968044454763
STAT,1824,47,35-39,1871,0.19017424408537323
SIM,1912,39,35-39,1951,5
STAT,1897,39,40-44,1936,1.4433487289503522
STAT,1941,41,50-100,1982,0.14537141096060854
SIM,1838,25,20-24,1863,13
STAT,1838,101,na,1939,0.4942798804344736
SIM,1889,19,40-44,1908,1
STAT,1937,47,50-100,1984,0.2636619885896842
STAT,1983,16,30-34,1999,19.90436803560678
SIM,1963,41,na,2004,6495
STAT,1878,35,15-19,1913,0.06830636224325057
STAT,1885,42,30-34,1927,1.3217644352829232
STAT,1986,27,20-24,2013,30.14636237701612
STAT,1862,23,45-49,1885,0.6902404601136466
STAT,1936,60,na,1996,3915.520930890277
STAT,1816,104,na,1920,0.03293980433774196
SIM,1871,44,45-49,1915,6
STAT,1863,44,45-49,1907,1.489888937412514
STAT,1961,28,25-29,1989,98.51487200773165
SIM,1962,17,15-19,1979,104
STAT,1904,39,35-39,1943,2.504494266926493
SIM,1832,47,35-39,1879,1
SIM,1878,1,na,1879,4131
SIM,1935,4,na,1939,6562
STAT,1954,17,15-19,1971,64.7468405015295
STAT,1832,26,15-19,1858,0.43907996524178283
STAT,1873,30,45-49,1903,2.071595756817709
SIM,1893,36,45-49,1929,6
STAT,1957,26,30-34,1983,59.9035549491373
SIM,1971,30,35-39,2001,31
STAT,1869,41,35-39,1910,2.032937657190555
SIM,1843,29,45-49,1872,1
SIM,1983,27,45-49,2010,3
SIM,1822,41,45-49,1863,3
STAT,1901,114,na,2015,9.440548182104623E-4
STAT,1902,48,15-19,1950,3.633007151626253E-4
SIM,1960,19,na,1979,5525
STAT,1810,89,na,1899,59.816141275081016
STAT,1837,51,40-44,1888,0.007804089582656719
STAT,1889,42,15-19,1931,0.019621252454653536
STAT,1995,10,na,2005,6563.882506995775
STAT,1965,44,na,2009,5542.3154738619605
SIM,1838,29,na,1867,1917
SIM,1966,30,30-34,1996,46
STAT,1825,32,30-34,1857,36.56837746321828
STAT,1931,38,40-44,1969,2.2861632818298534
SIM,1988,21,15-19,2009,9
SIM,1917,30,35-39,1947,17
SIM,1892,30,20-24,1922,1
SIM,1857,32,na,1889,2540
STAT,1884,30,20-24,1914,3.1068585384254317
STAT,1892,64,na,1956,2544.0239817099236
STAT,1825,51,35-39,1876,0.011817493069668934
SIM,1833,32,30-34,1865,6
STAT,1975,27,45-49,2002,2.6416037459787383
SIM,1833,30,na,1863,1826
SIM,1837,44,na,1881,2284
SIM,1842,42,25-29,1884,3
STAT,1895,93,na,1988,273.63688729758246
STAT,1896,78,na,1974,1810.211470644587
SIM,1849,26,35-39,1875,22
STAT,1868,28,45-49,1896,1.2267347961772592
STAT,1979,36,na,2015,6164.495640747661
STAT,1874,35,30-34,1909,6.356414661773489
SIM,1980,7,na,1987,6008
STAT,1908,26,35-39,1934,16.595901359583745
SIM,1818,43,45-49,1861,8
STAT,1859,52,30-34,1911,0.005443075432674074
SIM,1792,74,na,1866,387
STAT,1827,42,50-100,1869,1.4090144972605296
STAT,1814,41,45-49,1855,5.20246768342569
SIM,1904,16,15-19,1920,9
STAT,1841,27,40-44,1868,3.307979759238459
STAT,1984,18,35-39,2002,6.875546552573866
STAT,1904,39,na,1943,3895.573114601605
SIM,1987,17,15-19,2004,59
SIM,1796,88,na,1884,174
STAT,1818,85,na,1903,121.29384385430014
STAT,1834,42,25-29,1876,0.7064775350864558
SIM,1867,10,na,1877,2774
STAT,1858,31,30-34,1889,15.88280852294275
SIM,1898,29,35-39,1927,2
STAT,1842,104,na,1946,0.05132736475067192
STAT,1923,15,20-24,1938,184.50744906238674
STAT,1850,18,30-34,1868,1.9932249482761335
STAT,1958,30,30-34,1988,24.369642444841833
STAT,1990,16,30-34,2006,20.150189278071075
STAT,1840,40,20-24,1880,0.1498308756608825
STAT,1909,30,35-39,1939,10.156101226715851
SIM,1931,15,20-24,1946,397
SIM,1899,33,35-39,1932,22
SIM,1855,84,na,1939,16
STAT,1902,80,na,1982,1795.4639661139818
SIM,1893,79,na,1972,1229
SIM,1882,35,30-34,1917,12
SIM,1973,30,na,2003,5292
SIM,1877,41,35-39,1918,3
SIM,1880,38,25-29,1918,6
STAT,1888,38,15-19,1926,0.07580000991605627
STAT,1858,39,40-44,1897,3.9013400328558316
STAT,1967,15,35-39,1982,6.052234058584578
STAT,1774,89,na,1863,1.4893125991739105
SIM,1832,28,30-34,1860,52
SIM,1918,23,40-44,1941,12
STAT,1840,48,30-34,1888,0.07731011404856655
STAT,1851,50,25-29,1901,0.002849161510084755
STAT,1960,31,25-29,1991,14.169066426234426
SIM,1887,28,20-24,1915,1
STAT,1836,33,45-49,1869,1.9859807656329143
STAT,1859,46,45-49,1905,0.21757189019398032
STAT,1942,56,na,1998,4437.597705400219
STAT,1979,18,30-34,1997,19.361590484292254
STAT,1895,48,20-24,1943,0.010040571382875712
STAT,1879,19,30-34,1898,1.9103427596997447
SIM,1943,64,na,2007,4675
STAT,1938,19,na,1957,4189.423158649657
SIM,1866,31,30-34,1897,41
SIM,1889,44,30-34,1933,3
STAT,1889,17,25-29,1906,8.061313746547597
STAT,1870,39,50-100,1909,1.3827741389571577
SIM,1844,33,45-49,1877,5
STAT,1835,29,45-49,1864,0.8912986908127554
STAT,1907,68,na,1975,3112.146222847717
SIM,1965,26,30-34,1991,43
STAT,1903,54,na,1957,3487.391733361054
STAT,1857,27,30-34,1884,23.313125719592513
STAT,1934,16,35-39,1950,6.5693704175040954
STAT,1937,34,na,1971,4314.9604652212165
STAT,1826,44,40-44,1870,1.6361067806721834
STAT,1793,92,na,1885,11.765288656303841
SIM,1905,76,na,1981,2121
STAT,1848,36,40-44,1884,4.843201929341047
SIM,1901,62,na,1963,3233
STAT,1861,28,50-100,1889,0.6137457820981094
SIM,1913,98,na,2011,352
STAT,1850,37,35-39,1887,7.396492698559197
STAT,1883,45,25-29,1928,0.06568409327057674
STAT,1932,42,40-44,1974,0.3913170494489812
SIM,1897,17,25-29,1914,20
STAT,1933,20,na,1953,5625.965562157382
STAT,1935,20,35-39,1955,14.81556360328175
SIM,1834,44,40-44,1878,1
STAT,1865,100,na,1965,4.7542207808008605
STAT,1851,41,35-39,1892,1.442463369381668
SIM,1842,17,35-39,1859,1
STAT,1801,53,na,1854,1273.76919884715
STAT,1874,24,na,1898,2776.6880879295563
STAT,1902,17,50-100,1919,0.07988752983667143
STAT,1945,56,na,2001,4637.843460025856
STAT,1835,21,35-39,1856,5.45342249967398
SIM,1864,15,20-24,1879,25
SIM,1866,34,35-39,1900,2
STAT,1962,38,15-19,2000,0.02922489575750086
STAT,1805,67,na,1872,936.3134762493396
SIM,1888,32,20-24,1920,1
STAT,1857,39,50-100,1896,1.0924019848140858
STAT,1860,32,25-29,1892,9.526734911604096
SIM,1959,20,25-29,1979,139
STAT,1856,15,20-24,1871,18.6760653751801
STAT,1894,36,50-100,1930,1.8301710409391223
SIM,1856,36,40-44,1892,13
SIM,1943,20,35-39,1963,17
STAT,1879,28,20-24,1907,14.0868593957575
SIM,1840,54,30-34,1894,2
STAT,1867,16,35-39,1883,0.6079932144050131
STAT,1945,30,45-49,1975,2.0243612748180535
SIM,1884,43,na,1927,2618
STAT,1847,48,40-44,1895,0.13007538555017076
STAT,1952,34,na,1986,5324.663567998375
STAT,1960,48,20-24,2008,0.017229611127326953
SIM,1966,35,45-49,2001,3
SIM,1898,89,na,1987,746
SIM,1866,23,50-100,1889,1
STAT,1847,13,na,1860,2282.1865272476816
STAT,1862,49,20-24,1911,0.011443169777676962
SIM,1970,18,na,1988,5314
STAT,1771,100,na,1871,0.2605492643417901
STAT,1882,48,35-39,1930,0.15582721091289298
STAT,1971,25,50-100,1996,1.4624284168180122
SIM,1846,16,na,1862,1988
STAT,1943,65,na,2008,4076.857615306659
STAT,1832,54,30-34,1886,0.004131562230369259
STAT,1915,37,45-49,1952,0.7949052316043879
SIM,1949,41,35-39,1990,1
STAT,1975,19,na,1994,5600.08838885103
SIM,1871,15,na,1886,2337
STAT,1791,108,na,1899,3.9210963206699723E-4
STAT,1882,100,na,1982,17.679306586035242
SIM,1945,19,na,1964,4491
SIM,1939,9,na,1948,5052
STAT,1900,30,15-19,1930,0.22987839584869807
STAT,1970,43,50-100,2013,0.17609506488357787
SIM,1981,24,30-34,2005,104
SIM,1994,15,40-44,2009,4
STAT,1810,68,na,1878,979.1303826956389
STAT,2002,6,na,2008,6838.597913797803
SIM,1859,44,na,1903,2207
STAT,1868,82,na,1950,517.3314933250729
STAT,1986,15,40-44,2001,2.3012568153492197
SIM,1832,35,40-44,1867,1
STAT,1824,35,40-44,1859,7.044180694362207
STAT,1858,18,35-39,1876,0.5736531445778505
STAT,1930,26,30-34,1956,57.53075338826309
STAT,1950,43,na,1993,5258.331059214473
STAT,1909,45,20-24,1954,0.011845024933996676
SIM,1846,26,na,1872,1790
SIM,1880,8,na,1888,3708
SIM,1823,37,40-44,1860,7
SIM,1977,35,20-24,2012,1
SIM,1936,36,50-100,1972,1
SIM,1884,33,na,1917,2673
STAT,1955,21,15-19,1976,8.18483535839014
STAT,1855,10,na,1865,2446.2874275144254
STAT,1956,30,20-24,1986,3.8010549057875442
STAT,1919,40,45-49,1959,0.20866874709880803
SIM,1912,36,30-34,1948,4
STAT,1864,44,25-29,1908,0.6527735272192154
SIM,1889,28,30-34,1917,50
STAT,1927,35,na,1962,5406.268712981726
SIM,1914,37,na,1951,3948
STAT,1862,25,50-100,1887,0.6343910345186657
SIM,1869,76,na,1945,642
STAT,1823,86,na,1909,125.64578404121691
STAT,1896,40,40-44,1936,0.2404872064041944
STAT,1831,45,25-29,1876,0.054751418598591
STAT,1904,36,30-34,1940,1.9155452032784281
SIM,1892,84,na,1976,1175
STAT,1925,54,na,1979,5001.852868316801
STAT,1961,25,20-24,1986,27.358042128357425
STAT,1893,113,na,2006,0.0022927005357040687
STAT,1947,48,45-49,1995,0.2930582774440352
STAT,1961,45,45-49,2006,0.3386497399694561
SIM,1864,0,na,1864,4176
SIM,1953,30,45-49,1983,1
SIM,1973,38,40-44,2011,7
STAT,1950,25,45-49,1975,2.3696527208553886
STAT,1900,43,35-39,1943,0.19991045190302703
SIM,1888,16,20-24,1904,53
STAT,1853,46,15-19,1899,3.993779587727914E-4
STAT,1938,1,na,1939,4756.386547917392
STAT,1962,37,30-34,1999,2.7765122403398017
SIM,1963,21,15-19,1984,15
SIM,1905,28,25-29,1933,89
STAT,1806,51,50-100,1857,0.05423926981956129
SIM,1956,19,40-44,1975,2
STAT,1971,36,15-19,2007,0.02894419078910238
STAT,1948,19,40-44,1967,1.8460059802629827
SIM,1821,40,na,1861,1647
STAT,1965,38,40-44,2003,2.219791905914896
STAT,1847,17,20-24,1864,17.025680539339493
SIM,1964,30,20-24,1994,9
SIM,1892,94,na,1986,291
SIM,1891,40,50-100,1931,1
STAT,1963,47,20-24,2010,0.016853292584119262
STAT,1840,43,25-29,1883,0.5305247837213104
STAT,1956,43,40-44,1999,0.3963178779747844
STAT,1903,30,40-44,1933,7.185896386159098
SIM,1895,27,na,1922,3838
SIM,1839,46,na,1885,1933
STAT,1954,9,na,1963,5606.286010375927
STAT,1929,31,15-19,1960,0.188492404352316
SIM,1921,34,30-34,1955,6
STAT,1967,31,35-39,1998,13.435937289434674
SIM,1884,32,50-100,1916,2
STAT,1820,42,45-49,1862,1.850946506960707
STAT,1845,32,na,1877,1736.438367864555
SIM,1842,26,25-29,1868,93
STAT,1865,53,30-34,1918,0.0060986107015524645
STAT,1877,43,na,1920,2754.4735536773633
STAT,1834,26,25-29,1860,50.986309788211535
STAT,1913,34,30-34,1947,17.944516030023713
STAT,1984,25,45-49,2009,2.846379256942758
STAT,1880,45,20-24,1925,0.014825237693292435
STAT,1922,44,25-29,1966,0.09423394233821612
SIM,1871,25,na,1896,2018
SIM,1856,28,50-100,1884,1
STAT,1885,17,40-44,1902,0.2105414042333026
SIM,1854,13,na,1867,3179
SIM,1911,30,40-44,1941,11
SIM,1830,33,50-100,1863,1
SIM,1867,95,na,1962,50
SIM,1848,32,50-100,1880,4
STAT,1884,13,na,1897,2940.0669226609043
STAT,1916,97,na,2013,127.07349530366392
STAT,1831,83,na,1914,311.46292634650956
STAT,1892,10,na,1902,3746.7364786908715
STAT,1983,20,50-100,2003,1.078502589241144
SIM,1872,32,na,1904,2967
STAT,1969,38,25-29,2007,1.4608945528379014
STAT,1835,38,20-24,1873,0.5887077046794318
STAT,1970,45,na,2015,5546.348794501258
STAT,1953,34,50-100,1987,1.1750367502821233
STAT,1957,42,30-34,1999,0.20215796566442373
STAT,1947,45,40-44,1992,0.2141874451305649
STAT,1895,39,30-34,1934,7.925471653715782
STAT,1903,24,20-24,1927,112.56765415880932
SIM,1911,24,20-24,1935,149
STAT,1810,53,40-44,1863,0.037773007231594886
STAT,1850,28,45-49,1878,1.3354215241004161
STAT,1881,36,25-29,1917,3.220343614071757
STAT,1958,17,na,1975,5579.060368458103
STAT,1890,34,25-29,1924,14.31964546982274
STAT,1917,57,na,1974,4234.097561994916
STAT,1851,49,45-49,1900,0.18323929761110708
STAT,1830,33,15-19,1863,0.15106528844932887
STAT,1947,42,50-100,1989,0.15871072743080608
SIM,1934,35,na,1969,5823
SIM,1875,82,na,1957,600
STAT,1935,25,50-100,1960,1.5680134823893597
SIM,1922,24,na,1946,4558
STAT,1871,47,20-24,1918,0.013713285408427513
STAT,1888,80,na,1968,1301.8235274014637
STAT,1775,107,na,1882,0.010950784493085172
STAT,1872,12,na,1884,3049.92907883182
SIM,1932,35,45-49,1967,2
STAT,1885,30,na,1915,2768.984760978622
STAT,1891,46,35-39,1937,0.11295851540469694
SIM,2004,4,na,2008,7409
STAT,1880,34,50-100,1914,1.111193592973953
STAT,1913,46,25-29,1959,0.05993057364647447
SIM,1830,86,na,1916,71
STAT,1784,88,na,1872,48.07258733941313
SIM,1880,83,na,1963,872
STAT,1893,81,na,1974,1388.9589406952687
STAT,1923,18,25-29,1941,58.54921514885797
STAT,1855,46,25-29,1901,0.049150735809809325
STAT,1935,22,na,1957,5741.991790284013
SIM,1931,18,25-29,1949,1
STAT,1924,35,45-49,1959,0.9290536625150347
STAT,1908,42,na,1950,3970.4632742598606
SIM,1864,45,na,1909,2634
STAT,1920,44,15-19,1964,0.0019499912393642382
STAT,1860,44,40-44,1904,2.0638318915607288
STAT,1898,20,50-100,1918,0.6398175517276348
STAT,1970,43,45-49,2013,0.2494680092999513
STAT,1838,19,20-24,1857,20.049930509356038
STAT,1844,48,15-19,1892,3.303648987086567E-4
STAT,1958,21,40-44,1979,5.1149767205317875
SIM,1929,17,30-34,1946,39
STAT,1809,48,20-24,1857,0.030379801766768806
STAT,1843,103,na,1946,0.14400024001828693
STAT,1989,25,na,2014,6224.52226082852
STAT,1974,36,40-44,2010,2.3262010241779207
STAT,1963,18,na,1981,5394.8596378301545
SIM,1846,19,20-24,1865,10
STAT,1980,34,15-19,2014,0.20958282934655198
SIM,1866,14,na,1880,2742
STAT,1874,19,30-34,1893,1.8729741189425544
STAT,1842,43,35-39,1885,1.4233399387593697
SIM,1965,44,40-44,2009,1
SIM,1955,46,25-29,2001,1
SIM,1923,34,40-44,1957,12
STAT,1900,31,40-44,1931,6.97300565921295
STAT,1965,31,25-29,1996,13.581613728176686
STAT,1907,30,25-29,1937,10.066576241923997
STAT,1872,97,na,1969,33.39434395701377
STAT,1913,53,na,1966,4052.281247184721
SIM,1979,28,20-24,2007,59
STAT,1875,62,na,1937,2179.743781449332
STAT,1957,44,40-44,2001,0.39419729210172244
STAT,1960,22,35-39,1982,14.199624359044229
STAT,1773,94,na,1867,7.530172281191346
STAT,1824,38,45-49,1862,2.987212947886498
STAT,1873,38,40-44,1911,5.1332547830128465
STAT,1856,59,na,1915,1711.1216079395442
STAT,1979,11,na,1990,6242.691984665603
SIM,1934,25,na,1959,5568
SIM,1793,69,na,1862,977
STAT,1880,102,na,1982,7.1319905281855895
STAT,1852,18,40-44,1870,0.20733538863349238
SIM,1942,6,na,1948,5100
STAT,1986,18,45-49,2004,0.8211788354475673
STAT,1891,43,30-34,1934,1.6279472045368073
STAT,1845,40,35-39,1885,1.2748290534857636
STAT,1884,110,na,1994,0.0308275049521651
STAT,1851,28,na,1879,1994.146464407864
STAT,1831,73,na,1904,931.8716313480578
SIM,1904,59,na,1963,3619
STAT,1885,94,na,1979,143.82350220399917
SIM,1847,43,na,1890,2353
STAT,1878,19,15-19,1897,7.112521299334526
STAT,1944,45,15-19,1989,4.781205247085722E-4
SIM,1885,60,na,1945,2438
STAT,1856,27,15-19,1883,0.4139341666857369
SIM,1800,56,na,1856,1407
SIM,1919,82,na,2001,2239
STAT,1831,42,20-24,1873,0.15220699181499403
STAT,1873,47,30-34,1920,0.11354598116205006
STAT,1965,42,25-29,2007,0.10692029894590473
SIM,1834,28,40-44,1862,7
SIM,1909,36,na,1945,4773
SIM,1853,40,35-39,1893,3
STAT,1844,21,50-100,1865,0.4289468432493063
STAT,1940,36,40-44,1976,1.809375210010573
STAT,1923,44,40-44,1967,0.33613255480592225
STAT,1876,54,45-49,1930,0.016836906902115
STAT,1878,60,na,1938,2298.0667500193763
SIM,1980,33,50-100,2013,3
STAT,1796,89,na,1885,44.785653741606865
STAT,1928,52,na,1980,5318.516223959566
STAT,1900,40,30-34,1940,0.12913474249906823
SIM,1810,46,45-49,1856,1
STAT,1848,29,30-34,1877,31.48512126521272
SIM,1817,77,na,1894,192
STAT,1904,40,15-19,1944,0.0016052809220902884
SIM,1804,92,na,1896,61
SIM,1856,29,30-34,1885,46
STAT,1882,17,15-19,1899,6.689514654585232
STAT,1831,44,50-100,1875,0.9868930033756577
SIM,1888,19,25-29,1907,15
SIM,1925,74,na,1999,3295
SIM,1941,20,25-29,1961,3
STAT,1864,25,na,1889,2485.4575894307923
STAT,1858,15,30-34,1873,1.6961200936983585
STAT,1826,28,40-44,1854,8.68426318976694
SIM,1881,38,40-44,1919,3
STAT,1888,37,na,1925,3196.0587808624678
STAT,1819,50,35-39,1869,0.016590968972607416
STAT,1935,41,40-44,1976,0.407961276592937
STAT,1869,49,30-34,1918,0.10592567506734758
STAT,1933,20,25-29,1953,142.30448051627002
SIM,1866,15,30-34,1881,3
SIM,1850,43,35-39,1893,5
SIM,1967,33,50-100,2000,1
STAT,1934,32,35-39,1966,14.406147948520239
STAT,1881,58,na,1939,2201.3213081812073
STAT,1911,46,15-19,1957,4.03803331896406E-4
STAT,1961,42,40-44,2003,0.38756787359545164
STAT,1843,52,40-44,1895,0.010507009554241234
STAT,1915,34,40-44,1949,4.560974211231859
SIM,1943,41,40-44,1984,1
STAT,1875,42,35-39,1917,2.1569094344120643
STAT,1860,16,25-29,1876,6.1147916433496565
STAT,1940,45,30-34,1985,0.10919684619723953
SIM,1942,32,35-39,1974,23
STAT,1869,16,45-49,1885,0.07445444891238433
SIM,1867,27,40-44,1894,4
STAT,1890,31,20-24,1921,3.827214500469104
STAT,1805,52,20-24,1857,0.002636978442323183
STAT,1919,29,15-19,1948,0.8737814950417108
STAT,1781,81,na,1862,148.80949769519341
SIM,1840,64,na,1904,1396
STAT,1847,101,na,1948,0.4390688061124731
STAT,1829,48,na,1877,1776.1344076677592
STAT,1863,61,na,1924,1885.6591437174304
STAT,1864,46,na,1910,2324.911643905141
STAT,1932,41,15-19,1973,0.0024060253929636052
STAT,1923,31,20-24,1954,3.23900807281637
STAT,1859,14,na,1873,2524.3905872557184
STAT,1817,90,na,1907,54.50722355875792
SIM,1907,28,35-39,1935,1
SIM,1877,0,na,1877,4467
STAT,1931,42,25-29,1973,0.11011719651786579
STAT,1809,46,50-100,1855,0.6319894435231412
STAT,1868,50,30-34,1918,0.006694838857179477
SIM,1918,19,20-24,1937,152
SIM,1829,27,20-24,1856,2
SIM,1927,29,15-19,1956,1
SIM,1821,50,na,1871,1416
STAT,1974,39,45-49,2013,1.056119893430083
STAT,1936,47,30-34,1983,0.10202953881651877
SIM,1886,4,na,1890,2418
STAT,1850,25,40-44,1875,3.6816614253404754
STAT,1884,98,na,1982,41.30168411661813
SIM,1787,73,na,1860,832
STAT,1839,26,na,1865,2176.877002271805
STAT,1867,109,na,1976,0.02429232829549801
STAT,1870,38,15-19,1908,0.06357151668727737
STAT,1908,42,35-39,1950,0.21527581541949417
STAT,1855,17,50-100,1872,0.0495824940614239
SIM,1905,86,na,1991,641
SIM,1806,83,na,1889,125
STAT,1969,35,20-24,2004,0.3921996721511125
SIM,1925,78,na,2003,2578
STAT,2008,2,na,2010,7106.488368766426
STAT,1922,48,50-100,1970,0.298900965755756
STAT,1902,36,20-24,1938,0.2726112624361928
SIM,1899,17,35-39,1916,1
STAT,1821,35,15-19,1856,0.1387166120074349
SIM,1811,72,na,1883,880
SIM,1817,46,50-100,1863,2
STAT,1848,94,na,1942,21.235761332797566
SIM,1839,16,25-29,1855,16
STAT,1940,8,na,1948,4655.762789727025
STAT,1859,27,40-44,1886,2.801369938684964
STAT,1938,29,na,1967,4280.909508129016
STAT,1997,18,20-24,2015,228.39621639291838
SIM,1931,31,20-24,1962,5
STAT,1971,20,45-49,1991,1.6511993650082721
SIM,1823,41,25-29,1864,1
STAT,1786,69,na,1855,1131.9950000000003
SIM,1826,71,na,1897,822
STAT,1797,85,na,1882,109.25198270144254
STAT,1816,53,35-39,1869,0.016522843939552896
STAT,1933,41,na,1974,5899.930674604282
STAT,1863,29,na,1892,2391.0525320073752
SIM,1903,33,50-100,1936,3
STAT,1849,79,na,1928,541.854262523564
STAT,1903,75,na,1978,2374.333407518371
SIM,1779,86,na,1865,153
STAT,1879,51,45-49,1930,0.01757140507106633
SIM,1971,38,30-34,2009,6
STAT,1963,38,30-34,2001,2.7502283929858145
SIM,1821,37,30-34,1858,7
STAT,1973,27,35-39,2000,22.505262262694448
STAT,1815,41,25-29,1856,1.4824060661119216
STAT,1961,31,40-44,1992,5.950975220785924
STAT,1840,34,na,1874,2074.047196565812
STAT,1822,47,25-29,1869,0.10886962635230865
SIM,1814,70,na,1884,744
SIM,1935,52,na,1987,6003
STAT,1930,30,15-19,1960,0.19162853107664815
SIM,1915,30,25-29,1945,13
SIM,1953,19,15-19,1972,61
STAT,1945,19,15-19,1964,57.17454285839596
SIM,1981,27,35-39,2008,33
STAT,1877,47,15-19,1924,4.779389527915336E-4
SIM,1943,35,20-24,1978,1
STAT,1990,20,15-19,2010,8.832840748530655
SIM,1921,37,35-39,1958,2
STAT,1918,74,na,1992,3113.5527550799743
STAT,1935,35,20-24,1970,0.4263605978644044
SIM,1806,48,45-49,1854,1
STAT,1913,37,35-39,1950,2.756124318165065
STAT,1913,43,20-24,1956,0.01985420606913825
SIM,1920,90,na,2010,68
STAT,1894,40,30-34,1934,1.7227877913968193
STAT,1806,84,na,1890,114.17689792857713
STAT,1901,30,30-34,1931,28.450194943574687
STAT,1828,44,15-19,1872,0.01286850328930288
STAT,1966,41,50-100,2007,0.17623615364625891
SIM,1881,78,na,1959,706
STAT,1807,52,30-34,1859,0.023378811855702283
STAT,1858,23,50-100,1881,0.3805648958152569
STAT,1880,63,na,1943,2182.6345352286417
SIM,1908,41,na,1949,3762
STAT,1913,99,na,2012,58.896465524777646
STAT,1878,59,na,1937,2341.7879306852697
STAT,1893,39,20-24,1932,1.1131344578687898
STAT,1956,21,30-34,1977,44.049611984516375
STAT,1971,31,45-49,2002,2.3458458577546772
SIM,1947,57,na,2004,5619
STAT,1884,6,na,1890,2978.6646158750773
STAT,1888,45,25-29,1933,0.07891770543949377
STAT,1972,36,30-34,2008,2.7770271330594447
STAT,1892,34,35-39,1926,14.522724527471766
SIM,1856,79,na,1935,572
STAT,1911,34,20-24,1945,2.719906649872994
SIM,1841,42,30-34,1883,1
STAT,1871,30,35-39,1901,11.720612179698742
SIM,1929,29,25-29,1958,169
STAT,1931,20,15-19,1951,8.016897792273753
STAT,1944,42,45-49,1986,0.21481344985792786
STAT,1900,34,45-49,1934,2.7685714482657597
STAT,1855,64,na,1919,1479.1614248903857
STAT,1783,72,na,1855,392.02467000000007
STAT,1891,26,na,1917,3415.622912670272
STAT,1817,47,na,1864,2004.3141340312013
SIM,1831,47,40-44,1878,1
SIM,1958,16,na,1974,6222
STAT,1870,31,na,1901,2726.058861670535
STAT,1902,41,50-100,1943,0.12016771755022396
STAT,1933,42,35-39,1975,0.3194295822552897
STAT,1823,47,40-44,1870,0.1691552929933773
SIM,1826,53,45-49,1879,1
STAT,1957,47,45-49,2004,0.34397333803121993
STAT,1945,48,35-39,1993,0.1685925199308339
SIM,1879,18,20-24,1897,1
STAT,1818,53,45-49,1871,0.016898399225468468
STAT,1851,71,na,1922,1058.4899844966465
STAT,1920,77,na,1997,2836.859238194274
STAT,1912,26,na,1938,4279.082069888678
STAT,1967,42,35-39,2009,0.30167273473186085
SIM,1854,67,na,1921,1860
STAT,1773,109,na,1882,0.005907855660738823
STAT,1916,8,na,1924,4867.955467107753
STAT,1912,31,45-49,1943,1.7959310611142547
STAT,1910,18,50-100,1928,0.08553674169545539
SIM,1790,72,na,1862,326
STAT,1917,40,35-39,1957,0.24319478044423204
STAT,1947,19,25-29,1966,56.29618643696026
STAT,1923,47,45-49,1970,0.29330652242968513
SIM,1949,26,50-100,1975,1
STAT,1804,72,na,1876,732.9138877403223
STAT,1893,43,40-44,1936,0.2261976720383253
SIM,1841,49,na,1890,1778
STAT,1841,31,25-29,1872,11.16435014346424
STAT,1973,40,45-49,2013,0.25886654154525834
SIM,1964,21,30-34,1985,3
SIM,1955,19,25-29,1974,93
STAT,1823,32,na,1855,1623.0039071378244
SIM,1878,40,50-100,1918,4
STAT,1897,43,25-29,1940,0.06831542011021567
STAT,1883,40,50-100,1923,1.204867778653571
STAT,1833,64,na,1897,1223.2370959924046
STAT,1906,29,50-100,1935,1.0688256803259129
STAT,1905,30,15-19,1935,0.23977872299985398
SIM,1931,47,45-49,1978,2
STAT,1866,15,15-19,1881,6.593106154335491
STAT,1876,3,na,1879,3667.6820177792447
STAT,1955,20,na,1975,5616.962678441871
STAT,1957,32,na,1989,5865.8487195374855
STAT,1925,18,35-39,1943,5.832575220862766
SIM,1899,73,na,1972,2506
STAT,1894,76,na,1970,1910.8532913029553
SIM,1940,30,25-29,1970,23
STAT,1922,41,20-24,1963,0.023416689500318864
SIM,1820,66,na,1886,1397
STAT,1896,88,na,1984,707.9506689843479
STAT,1934,47,20-24,1981,0.017777465687084312
STAT,1982,31,20-24,2013,4.039897243333883
STAT,1959,13,na,1972,5928.831291660441
STAT,1813,50,40-44,1863,0.034794716437537496
STAT,1981,22,15-19,2003,8.618487599408065
STAT,1856,46,40-44,1902,0.15116087512448997
SIM,1874,15,15-19,1889,15
STAT,1870,33,45-49,1903,1.9756162546410094
STAT,1845,48,30-34,1893,0.06440954851010865
STAT,1876,32,50-100,1908,1.0930615696405785
STAT,1899,45,50-100,1944,0.22122341633689238
STAT,1962,48,30-34,2010,0.1367293684051354
STAT,1941,18,na,1959,4374.964669056644
STAT,1969,0,na,1969,5710.228549202333
STAT,1911,41,45-49,1952,0.18453134852462857
SIM,1906,60,na,1966,3218
STAT,1874,78,na,1952,923.1033656520657
SIM,1928,17,15-19,1945,4
SIM,1869,12,na,1881,2311
STAT,1912,46,30-34,1958,0.09921147282518113
STAT,1822,33,50-100,1855,3.091006500066088
STAT,1843,40,25-29,1883,0.680627136856593
STAT,1939,41,25-29,1980,0.08588558300708897
SIM,1956,35,na,1991,5409
STAT,1842,27,50-100,1869,0.608752400149567
STAT,1829,53,20-24,1882,6.485532015286236E-4
STAT,1902,42,40-44,1944,0.2543812769577662
STAT,1802,91,na,1893,27.66183372338814
SIM,1874,41,30-34,1915,1
STAT,1898,40,15-19,1938,0.0015107989821778601
SIM,1917,23,na,1940,5275
STAT,1867,49,20-24,1916,0.012659895983251701
SIM,1833,84,na,1917,66
STAT,1906,40,25-29,1946,0.07580098330700916
STAT,1875,110,na,1985,0.022410616165385696
STAT,1977,24,na,2001,5709.164104734369
STAT,1840,106,na,1946,0.009740082117012862
STAT,1845,46,50-100,1891,0.16596864674096612
SIM,1945,66,na,2011,3806
SIM,1852,21,50-100,1873,1
STAT,1905,56,na,1961,3544.2651831221174
SIM,1851,40,25-29,1891,3
SIM,1910,42,40-44,1952,1
SIM,1840,33,25-29,1873,12
STAT,1842,46,na,1888,1753.926018373231
SIM,1933,40,na,1973,6402
SIM,1974,30,25-29,2004,2
STAT,1916,19,50-100,1935,0.09125104446633545
STAT,1937,41,15-19,1978,0.0017911784911208593
SIM,1824,47,na,1871,1491
STAT,1882,36,40-44,1918,4.9581363077330725
STAT,1837,45,na,1882,1735.0580244522248
STAT,1932,32,25-29,1964,14.182949026486734
SIM,1900,21,40-44,1921,1
SIM,1899,26,25-29,1925,80
SIM,1837,65,na,1902,1609
STAT,1832,33,25-29,1865,9.197450840419297
STAT,1867,21,50-100,1888,0.44439026825329253
STAT,1880,24,15-19,1904,4.010239289094713
STAT,1955,43,25-29,1998,0.113512623404302
STAT,1866,41,30-34,1907,1.2353206266925612
STAT,1960,37,20-24,1997,0.4082101512070902
STAT,1880,21,50-100,1901,0.5003320438317006
STAT,1902,43,45-49,1945,0.1682465660672419
STAT,1966,31,40-44,1997,5.753108144790294
SIM,1892,17,25-29,1909,9
SIM,1805,87,na,1892,33
SIM,1885,42,45-49,1927,4
SIM,1899,4,na,1903,4594
SIM,1922,46,40-44,1968,1
SIM,1970,33,45-49,2003,1
STAT,1955,42,20-24,1997,0.028117440304674928
SIM,1890,36,40-44,1926,9
SIM,1938,31,30-34,1969,45
STAT,1920,23,na,1943,4668.697857779961
STAT,1855,43,20-24,1898,0.13415712809643607
SIM,1976,27,na,2003,5561
STAT,1833,45,35-39,1878,0.119212450612611
STAT,1901,63,na,1964,3122.5727948460863
STAT,1914,46,40-44,1960,0.18098579116479352
STAT,1867,53,40-44,1920,0.01116128972716249
STAT,1901,31,35-39,1932,16.437126500794985
STAT,1884,17,25-29,1901,6.461322698721598
STAT,1843,48,20-24,1891,0.011889281840119283
STAT,1972,39,35-39,2011,3.674220575086549
STAT,1814,50,na,1864,1846.18014541176
STAT,1910,40,25-29,1950,0.07884823336435677
SIM,1865,15,15-19,1880,8
STAT,1892,31,30-34,1923,25.35753996503141
SIM,1886,30,45-49,1916,7
STAT,1959,4,na,1963,5936.603739378344
STAT,1881,40,45-49,1921,1.6827638119556854
SIM,1851,31,35-39,1882,25
STAT,1964,48,40-44,2012,0.23770439579694563
SIM,1968,17,45-49,1985,1
STAT,1862,34,na,1896,2304.2076106427326
STAT,1876,45,50-100,1921,0.29591664649026955
STAT,1906,42,25-29,1948,0.07495137346602362
STAT,1878,30,45-49,1908,2.118118216602027
SIM,1916,30,40-44,1946,1
SIM,1940,32,25-29,1972,15
SIM,1984,24,na,2008,5835
STAT,1876,19,40-44,1895,0.2170293217746568
SIM,1845,31,na,1876,2251
STAT,1881,48,na,1929,2472.895829641399
STAT,1968,42,na,2010,5563.340562912087
STAT,1911,37,25-29,1948,1.0984374968703678
STAT,1960,42,25-29,2002,0.11154497899865892
STAT,1877,42,45-49,1919,1.794422153414019
SIM,1894,11,na,1905,4141
STAT,1953,43,15-19,1996,0.002224495281418809
STAT,1880,112,na,1992,0.004284193004375476
STAT,1867,11,na,1878,2902.8285014043036
SIM,1826,28,na,1854,2046
STAT,1817,41,35-39,1858,5.7328123330016725
STAT,1817,50,25-29,1867,0.010125915028811158
STAT,1857,15,15-19,1872,6.343842978553097
STAT,1938,76,na,2014,2763.5922437775575
STAT,1870,85,na,1955,311.8893718794391
SIM,1912,56,na,1968,3515
STAT,1795,106,na,1901,0.002127570851857251
STAT,1950,22,40-44,1972,4.603247024770125
SIM,1815,65,na,1880,1233
STAT,1882,45,30-34,1927,0.1102022360247074
SIM,1923,19,na,1942,5192
STAT,1822,44,20-24,1866,0.3076673490477351
STAT,1838,54,25-29,1892,0.00298431935431144
STAT,1860,53,30-34,1913,0.005447623057964907
STAT,1877,51,35-39,1928,0.010384149018123586
SIM,1964,44,25-29,2008,2
STAT,1832,30,20-24,1862,2.510639968478009
SIM,1847,42,25-29,1889,1
STAT,1956,44,25-29,2000,0.1129487705920541
STAT,1954,31,15-19,1985,0.18698429839629985
STAT,1842,52,25-29,1894,0.0027111581695438945
STAT,1892,40,20-24,1932,0.2320305058950349
STAT,1864,15,50-100,1879,0.05807087598079022
STAT,1921,32,15-19,1953,0.16497436748150818
STAT,1928,41,15-19,1969,0.0022625111006341287
SIM,1825,41,35-39,1866,3
STAT,1919,69,na,1988,3695.0842182341535
SIM,1840,30,20-24,1870,7
SIM,1851,27,na,1878,2934
STAT,1945,45,30-34,1990,0.11744482482670002
STAT,1846,82,na,1928,482.3445639302549
STAT,1911,41,na,1952,4117.86862298453
SIM,1830,46,50-100,1876,1
SIM,1927,55,na,1982,4752
SIM,1839,25,15-19,1864,1
STAT,1992,20,25-29,2012,153.6201720809861
SIM,1900,24,na,1924,3534
STAT,1812,49,30-34,1861,0.21710081699087194
SIM,1914,1,na,1915,4489
SIM,1955,6,na,1961,6580
SIM,1954,58,na,2012,5132
STAT,1869,77,na,1946,966.0518464780137
SIM,1957,21,na,1978,5538
STAT,1923,77,na,2000,3002.349902567158
STAT,1964,17,50-100,1981,0.5445693048134568
STAT,1928,49,50-100,1977,0.33109018683975294
STAT,1932,5,na,1937,6145.765035111047
SIM,1953,45,30-34,1998,1
STAT,1892,0,na,1892,4247.217941014958
STAT,1899,43,na,1942,3640.364400072696
STAT,1822,46,50-100,1868,0.47088441428669386
SIM,1942,22,na,1964,4712
SIM,1868,17,40-44,1885,3
SIM,1828,83,na,1911,574
STAT,1871,54,45-49,1925,0.01620388882269534
STAT,1856,49,na,1905,1939.5116183400576
SIM,1814,43,25-29,1857,2
STAT,1893,46,45-49,1939,0.19474128322258988
SIM,1903,20,na,1923,3892
STAT,1886,45,15-19,1931,4.917784731991625E-4
SIM,1883,59,na,1942,1991
SIM,1966,13,na,1979,5935
STAT,1943,30,35-39,1973,11.41348721652443
STAT,1796,90,na,1886,36.245029573082434
STAT,1934,20,40-44,1954,5.234331046857407
STAT,1984,22,40-44,2006,5.529327876010213
STAT,1813,54,na,1867,1256.2624714828276
STAT,1879,51,50-100,1930,0.018286174060874304
STAT,1963,31,15-19,1994,0.19216066706534718
SIM,1936,47,na,1983,3880
STAT,1879,55,na,1934,2491.6338857133424
SIM,1873,27,na,1900,3460
SIM,1906,42,40-44,1948,1
SIM,1988,19,50-100,2007,1
STAT,1882,4,na,1886,3180.553374386345
STAT,1932,30,25-29,1962,14.198989354980249
STAT,1858,27,25-29,1885,38.985781963670476
STAT,1849,17,30-34,1866,1.5206269896720048
STAT,1930,55,na,1985,5408.80400018791
SIM,1971,35,50-100,2006,2
STAT,1897,18,50-100,1915,0.0754029502403067
STAT,1970,30,50-100,2000,1.218869065232798
STAT,1983,16,na,1999,6010.695194169558
STAT,1808,65,na,1873,1129.2512194193491
STAT,1844,43,45-49,1887,1.2657554997467568
STAT,1856,49,45-49,1905,0.20344761599611166
STAT,1868,92,na,1960,84.01348190608459
STAT,1944,23,50-100,1967,0.8196514650904356
STAT,1899,43,35-39,1942,0.19737807921062683
SIM,1942,20,40-44,1962,9
SIM,1890,39,45-49,1929,5
SIM,1864,49,45-49,1913,1
SIM,1892,30,na,1922,3906
SIM,1863,43,20-24,1906,3
SIM,1889,95,na,1984,308
STAT,1860,40,50-100,1900,0.9925299821831042
SIM,1858,29,40-44,1887,1
SIM,1979,1,na,1980,6482
STAT,1820,47,15-19,1867,4.1504075783719565E-4
STAT,1971,40,35-39,2011,0.3067275850743755
STAT,1882,39,45-49,1921,2.224472175755012
STAT,1880,48,25-29,1928,0.06957337871373455
STAT,1891,22,25-29,1913,81.65045655585116
STAT,1955,40,20-24,1995,0.028195487805899033
STAT,1960,21,na,1981,5508.892546911235
STAT,1860,47,45-49,1907,0.21848229546508602
SIM,1847,97,na,1944,88
STAT,1833,42,30-34,1875,0.9872822839055851
STAT,1910,31,35-39,1941,10.220825972614907
STAT,1968,47,20-24,2015,0.016568821852790155
STAT,1949,35,na,1984,5211.2579764632555
SIM,1932,32,40-44,1964,13
STAT,1908,30,40-44,1938,4.302641261533434
STAT,1781,91,na,1872,13.567369448880871
STAT,1847,40,50-100,1887,0.8386410756205283
SIM,1951,51,na,2002,6152
STAT,1949,16,30-34,1965,16.36403507167371
SIM,1873,32,25-29,1905,5
STAT,1895,111,na,2006,0.018741562678082822
SIM,1897,18,na,1915,4047
SIM,1970,30,40-44,2000,2
STAT,1918,46,50-100,1964,0.2783992029514887
SIM,1857,17,30-34,1874,1
STAT,1948,50,na,1998,5001.194914840373
SIM,1855,40,50-100,1895,1
SIM,1866,27,25-29,1893,52
STAT,1822,51,45-49,1873,0.02692966883739647
STAT,1922,35,50-100,1957,0.5520498961551905
STAT,1828,53,na,1881,1501.2907509674185
STAT,1881,33,20-24,1914,2.99615599073037
SIM,1877,63,na,1940,2155
STAT,1890,43,15-19,1933,0.019332847326881553
STAT,1811,44,45-49,1855,4.9381664950293125
SIM,1951,30,35-39,1981,2
SIM,1852,43,45-49,1895,2
STAT,1866,44,35-39,1910,1.91081315011222
STAT,1933,41,30-34,1974,0.20309522315295342
STAT,1924,32,40-44,1956,5.267458934454177
STAT,1825,52,50-100,1877,0.020323343732946794
SIM,1992,22,40-44,2014,1
STAT,1902,40,40-44,1942,0.2572648109915188
SIM,1862,64,na,1926,2114
SIM,1926,46,50-100,1972,1
SIM,1868,26,na,1894,3192
SIM,1874,44,35-39,1918,4
STAT,1782,76,na,1858,483.90925110333154
STAT,1900,89,na,1989,660.1825424762242
STAT,1834,54,40-44,1888,0.00946840919843737
STAT,1866,50,20-24,1916,8.006671506862957E-4
STAT,1871,38,30-34,1909,6.088678383094187
STAT,1888,42,20-24,1930,0.21517648080434457
STAT,1843,31,35-39,1874,12.343346885010108
SIM,1976,9,na,1985,6048
SIM,1871,22,35-39,1893,13
STAT,1960,46,na,2006,5757.990148309973
STAT,1914,31,20-24,1945,2.846429356046553
STAT,1846,19,50-100,1865,0.06287550026332799
STAT,1967,27,15-19,1994,1.0220773917562693
STAT,1830,52,20-24,1882,5.986194465196807E-4
STAT,1894,49,50-100,1943,0.20123655578282912
STAT,1946,35,30-34,1981,2.4075906650496246
SIM,1917,26,15-19,1943,2
STAT,1915,18,40-44,1933,0.337015020728023
SIM,1806,50,na,1856,1455
STAT,1928,46,20-24,1974,0.016312880895788685
STAT,1874,14,na,1888,3060.6660226478484
SIM,1945,37,30-34,1982,4
STAT,1963,34,20-24,1997,3.6406103912967587
STAT,1920,41,45-49,1961,0.21234155042544248
STAT,1840,65,na,1905,1355.6905046779007
STAT,1844,79,na,1923,584.7474466756211
STAT,1911,43,45-49,1954,0.182373139994197
SIM,1931,22,30-34,1953,3
STAT,1868,31,50-100,1899,1.0200550299442048
STAT,1931,41,20-24,1972,0.027272557991793844
SIM,1985,2,na,1987,6454
STAT,1896,30,50-100,1926,1.4078465941939435
STAT,1912,36,15-19,1948,0.02175493298763007
SIM,1879,25,45-49,1904,1
SIM,1876,25,na,1901,2545
SIM,1899,23,20-24,1922,202
STAT,1921,34,15-19,1955,0.16356192280489898
SIM,1905,32,30-34,1937,29
SIM,1940,30,50-100,1970,2
SIM,1951,36,45-49,1987,2
STAT,1934,38,45-49,1972,1.08511155649938
SIM,1829,31,40-44,1860,4
SIM,1959,26,20-24,1985,3
STAT,1943,36,45-49,1979,0.860375887114212
SIM,1930,42,na,1972,6003
STAT,1887,108,na,1995,0.19992179378682662
SIM,1942,38,45-49,1980,2
SIM,1977,23,na,2000,6213
SIM,1940,66,na,2006,3975
STAT,1952,34,45-49,1986,2.2153989006223624
SIM,1859,77,na,1936,243
STAT,1917,36,na,1953,4531.462815887744
STAT,1897,15,45-49,1912,0.10126970441744386
STAT,1954,36,20-24,1990,0.38781097440091733
STAT,1867,15,30-34,1882,1.776539376333527
STAT,1917,46,45-49,1963,0.262640362887416
STAT,1931,19,35-39,1950,6.3058070996450555
STAT,1982,17,40-44,1999,2.271406092256177
SIM,1855,21,40-44,1876,5
SIM,1901,1,na,1902,4688
SIM,1936,39,30-34,1975,1
SIM,1953,39,na,1992,5620
SIM,1916,39,na,1955,4403
STAT,1814,49,na,1863,1867.5686812788606
SIM,1892,63,na,1955,3025
STAT,1924,16,40-44,1940,1.926415034724444
SIM,1922,24,30-34,1946,88
SIM,1818,43,50-100,1861,2
SIM,1808,85,na,1893,112
STAT,1846,30,35-39,1876,12.631579904982141
STAT,1923,45,50-100,1968,0.30667425614624655
STAT,1903,31,45-49,1934,2.87816931619233
SIM,1932,16,40-44,1948,2
SIM,1922,31,20-24,1953,14
SIM,1884,64,na,1948,1898
STAT,1935,49,15-19,1984,5.969684758067629E-4
STAT,1855,31,na,1886,2089.049248348285
STAT,1897,62,na,1959,2928.302881422794
SIM,1850,27,50-100,1877,1
SIM,1869,33,35-39,1902,22
STAT,1829,27,50-100,1856,1.3184971668793168
STAT,1942,23,na,1965,4417.997999388499
SIM,1797,72,na,1869,512
SIM,1939,28,45-49,1967,3
SIM,1954,35,30-34,1989,1
SIM,1911,31,45-49,1942,7
STAT,1950,22,na,1972,4999.506075513753
STAT,1944,14,na,1958,4876.90038387515
STAT,1880,46,25-29,1926,0.07065873997681943
STAT,1948,28,na,1976,4966.432742126111
STAT,1929,37,na,1966,5574.351188658072
SIM,1829,47,na,1876,1608
STAT,1980,28,30-34,2008,63.01485109277838
SIM,1825,33,na,1858,1794
STAT,1920,23,45-49,1943,1.4384943973486957
STAT,1909,26,15-19,1935,0.788791540545895
STAT,1811,47,15-19,1858,0.0012468547319182065
STAT,1928,39,30-34,1967,2.6524645952100494
STAT,1863,22,35-39,1885,6.005996519038401
STAT,1905,29,35-39,1934,16.001630630483273
SIM,1910,27,45-49,1937,2
SIM,1927,18,25-29,1945,84
SIM,1906,30,25-29,1936,2
STAT,1895,30,30-34,1925,26.43867052470129
SIM,1971,36,30-34,2007,6
SIM,1862,33,na,1895,2791
STAT,1953,45,15-19,1998,5.374316195858204E-4
STAT,1889,75,na,1964,1804.8129553280637
STAT,1927,66,na,1993,4557.786533509642
STAT,1908,15,45-49,1923,0.11248895423188586
STAT,1957,18,45-49,1975,0.7598418388757736
STAT,1977,16,20-24,1993,211.4614186159462
STAT,1800,69,na,1869,945.2522336730228
STAT,1916,62,na,1978,3958.800875210304
STAT,1989,10,na,1999,6494.936998509548
SIM,1930,25,20-24,1955,50
STAT,1889,23,na,1912,3354.049331011852
STAT,1935,42,45-49,1977,0.2710614697586616
SIM,1955,33,25-29,1988,22
STAT,1919,18,25-29,1937,55.108249899892556
SIM,1904,28,30-34,1932,2
STAT,1807,91,na,1898,28.33671480747193
STAT,1847,21,40-44,1868,1.9798220145069485
SIM,1913,29,35-39,1942,25
STAT,1874,1,na,1875,4107.23470930625
STAT,1940,17,35-39,1957,4.918404972489771
SIM,1971,27,30-34,1998,164
STAT,1825,88,na,1913,97.10456335354225
STAT,1832,78,na,1910,532.3144216719553
STAT,1947,29,40-44,1976,6.079325414049951
STAT,1832,41,50-100,1873,0.909498664529915
SIM,1866,24,20-24,1890,7
STAT,1963,27,30-34,1990,57.696283580031334
STAT,1981,14,na,1995,6336.565287214333
STAT,1943,40,na,1983,4736.933549415995
SIM,1945,34,50-100,1979,1
STAT,1903,8,na,1911,4273.074844775816
SIM,1889,16,15-19,1905,15
STAT,1885,61,na,1946,2151.0037117272464
STAT,1961,48,15-19,2009,5.697051013470116E-4
SIM,1925,43,40-44,1968,1
SIM,1853,72,na,1925,988
SIM,1817,46,na,1863,1482
STAT,1933,32,40-44,1965,6.088810656160754
STAT,1858,24,20-24,1882,63.84989724544311
STAT,1926,41,40-44,1967,0.3562924933851196
STAT,1839,22,50-100,1861,0.4155281975575611
STAT,1903,38,15-19,1941,0.019824530528316908
STAT,1937,44,20-24,1981,0.020500452091674747
SIM,1899,19,35-39,1918,3
STAT,1972,25,30-34,1997,58.19730486949837
SIM,1922,27,35-39,1949,1
SIM,1960,31,40-44,1991,13
SIM,1785,71,na,1856,609
STAT,1844,49,50-100,1893,0.2011362698872356
SIM,1890,43,50-100,1933,4
STAT,1908,23,50-100,1931,0.6968300743101595
STAT,1914,27,35-39,1941,17.475060403026074
STAT,1944,47,15-19,1991,4.758807599306608E-4
SIM,1916,48,45-49,1964,1
SIM,1966,25,50-100,1991,6
SIM,1878,31,35-39,1909,17
STAT,1923,22,30-34,1945,38.57901600617859
STAT,1870,36,15-19,1906,0.06419590153533984
STAT,1958,29,15-19,1987,1.0735997852515884
STAT,1947,33,25-29,1980,12.239613471615376
SIM,1866,21,15-19,1887,6
SIM,1866,17,30-34,1883,7
STAT,1813,87,na,1900,80.66829807765359
SIM,1836,80,na,1916,22
SIM,1918,18,na,1936,3644
STAT,1808,96,na,1904,4.378243355174888
STAT,1974,26,na,2000,5672.1287296316
STAT,1928,77,na,2005,3275.839397484119
STAT,1860,45,45-49,1905,0.22169401910779707
SIM,1966,29,15-19,1995,3
STAT,1858,17,30-34,1875,1.6761986409624952
STAT,1854,53,20-24,1907,5.915280967012561E-4
STAT,1922,25,20-24,1947,23.98860108097331
STAT,1858,83,na,1941,357.4018332283441
STAT,1911,28,50-100,1939,1.1172192464342112
STAT,1859,21,30-34,1880,18.804832281236315
SIM,1840,54,na,1894,1677
STAT,1908,48,45-49,1956,0.22649086910535282
STAT,1933,44,35-39,1977,0.31836676496917454
SIM,1955,26,35-39,1981,31
STAT,1973,19,40-44,1992,2.0862467544407033
STAT,1810,54,45-49,1864,0.051022081970076454
STAT,1937,37,30-34,1974,2.104375728218012
SIM,1962,38,30-34,2000,4
SIM,1980,17,na,1997,5610
SIM,1901,29,45-49,1930,5
STAT,1940,24,25-29,1964,108.55238218510897
SIM,1906,26,40-44,1932,1
SIM,1948,62,na,2010,3933
STAT,1892,43,na,1935,3318.907059446368
STAT,1904,29,20-24,1933,19.302633610367735
STAT,1939,2,na,1941,4716.169393748171
STAT,1939,35,40-44,1974,1.7854062346043968
STAT,1896,57,na,1953,3063.252599870505
SIM,1867,21,30-34,1888,23
STAT,1922,18,30-34,1940,16.22956705268245
SIM,1951,33,40-44,1984,1
SIM,1783,92,na,1875,14
SIM,1872,63,na,1935,2236
SIM,1948,23,40-44,1971,6
STAT,1927,39,50-100,1966,0.601004411734304
SIM,1976,12,na,1988,6041
STAT,1848,35,15-19,1883,0.06277703207398795
STAT,1902,113,na,2015,0.0027630302789084277
STAT,1947,18,50-100,1965,0.4868808556320354
SIM,1870,20,na,1890,3295
SIM,1930,18,30-34,1948,23
STAT,1858,21,15-19,1879,3.4323753318088235
STAT,1947,26,35-39,1973,19.610172903373684
STAT,1915,22,25-29,1937,110.20955386308975
SIM,1937,37,25-29,1974,1
STAT,1915,48,35-39,1963,0.1495409174762655
STAT,1845,96,na,1941,5.786161315366486
STAT,1841,82,na,1923,414.83384439123734
SIM,1915,42,40-44,1957,1
STAT,1943,33,40-44,1976,4.879052717025521
SIM,1923,22,25-29,1945,137
STAT,1971,40,50-100,2011,0.17894879071878222
STAT,1941,30,25-29,1971,11.2143686697089
STAT,1834,20,15-19,1854,6.322349906487151
STAT,1933,47,40-44,1980,0.2503223074246525
SIM,1947,35,40-44,1982,4
STAT,1799,102,na,1901,0.13168973729529843
SIM,1917,56,na,1973,4952
SIM,1875,51,na,1926,2847
SIM,1913,42,na,1955,4519
STAT,1830,99,na,1929,1.1880547413381293
STAT,1933,10,na,1943,6142.396425792587
STAT,1923,25,35-39,1948,20.020123532156372
SIM,1963,27,25-29,1990,176
STAT,1948,33,40-44,1981,5.2648245209570135
STAT,1901,33,35-39,1934,16.301145036325888
STAT,1973,23,25-29,1996,138.2754348983334
STAT,1880,43,20-24,1923,0.1928633106711512
STAT,1944,36,50-100,1980,0.5377155664211548
STAT,1854,44,50-100,1898,0.8490704912918446
STAT,1876,20,20-24,1896,82.7016665176843
SIM,1931,25,35-39,1956,5
STAT,1949,45,na,1994,5152.974379902242
STAT,1921,73,na,1994,3422.4080761869445
SIM,1952,36,50-100,1988,1
STAT,1911,40,40-44,1951,0.2788656701129069
SIM,1876,77,na,1953,1082
STAT,1887,96,na,1983,96.30467050531192
SIM,1939,25,40-44,1964,11
STAT,1917,43,40-44,1960,0.3007686860189352
SIM,1856,17,15-19,1873,9
STAT,1962,23,na,1985,5415.890270374685
SIM,1941,32,40-44,1973,1
STAT,1996,8,na,2004,6591.482239126676
STAT,1863,3,na,1866,3253.3334525050172
STAT,1971,28,20-24,1999,26.783587395302256
STAT,1951,43,40-44,1994,0.3566524559838075
SIM,1956,33,40-44,1989,17
STAT,1874,25,15-19,1899,0.539662185890307
STAT,1955,55,na,2010,5670.548857091901
SIM,1865,1,na,1866,4164
STAT,1924,19,45-49,1943,0.682638998230324
STAT,1801,53,40-44,1854,0.04104702011993498
SIM,1858,30,20-24,1888,8
STAT,1955,27,25-29,1982,101.27328607445732
STAT,1848,17,15-19,1865,7.816755511637477
SIM,1973,25,40-44,1998,13
SIM,1998,6,na,2004,6866
STAT,1930,19,20-24,1949,201.22031650533745
SIM,1857,9,na,1866,2957
STAT,1848,52,50-100,1900,0.015961662898482467
SIM,1904,38,25-29,1942,3
STAT,1961,0,na,1961,5905.7898637534145
SIM,1948,41,40-44,1989,1
STAT,1862,13,na,1875,2650.743778500781
STAT,1965,25,40-44,1990,6.7503412645296565
STAT,1902,17,15-19,1919,9.677044739088856
STAT,1910,34,40-44,1944,4.321733029927216
STAT,1875,95,na,1970,77.65953969609672
STAT,1902,27,45-49,1929,1.810491374174135
STAT,1907,24,40-44,1931,3.516104573202358
STAT,1931,16,30-34,1947,18.460856908314277
STAT,1973,16,35-39,1989,6.264689479249295
STAT,1860,65,na,1925,1571.8487577561118
STAT,1956,24,35-39,1980,14.416517922934876
STAT,1916,19,na,1935,4704.130631191516
STAT,1846,30,50-100,1876,1.1428412635836558
SIM,1829,34,45-49,1863,4
STAT,1907,42,40-44,1949,0.2648874948507068
STAT,1954,31,50-100,1985,1.2030498584576765
STAT,1953,15,20-24,1968,189.37118930439158
STAT,1867,18,35-39,1885,0.6008521469007154
STAT,1769,88,na,1857,63.60772564284
SIM,1972,4,na,1976,5841
SIM,1857,42,na,1899,2458
SIM,1909,47,50-100,1956,1
STAT,1941,38,35-39,1979,2.959846527809674
STAT,1864,79,na,1943,720.3871176236051
SIM,1962,31,50-100,1993,1
SIM,1932,19,45-49,1951,1
SIM,1915,24,40-44,1939,9
SIM,1875,18,35-39,1893,1
STAT,1956,31,25-29,1987,14.395280357952572
SIM,1930,28,25-29,1958,119
STAT,1977,19,25-29,1996,67.52710578544014
STAT,1893,49,15-19,1942,3.222631254871658E-4
SIM,1854,30,35-39,1884,5
STAT,1963,39,35-39,2002,3.6457602888793788
STAT,1960,28,45-49,1988,2.6067064933646833
SIM,1913,26,30-34,1939,93
SIM,1993,9,na,2002,6961
STAT,1915,15,35-39,1930,1.01841070222351
STAT,1931,23,20-24,1954,165.95534295602803
STAT,1933,40,50-100,1973,0.18687658835027782
STAT,1955,47,35-39,2002,0.20545283196560035
SIM,1965,15,40-44,1980,4
SIM,1906,29,45-49,1935,1
SIM,1938,34,35-39,1972,2
STAT,1881,27,na,1908,2656.5084703030975
SIM,1971,39,35-39,2010,5
STAT,1836,35,50-100,1871,1.400745093263762
SIM,1893,25,na,1918,3503
STAT,1901,40,25-29,1941,0.07281067960107049
SIM,1931,16,na,1947,5878
STAT,1821,47,30-34,1868,0.17517278715647647
SIM,1844,35,50-100,1879,2
SIM,1964,31,25-29,1995,27
STAT,1809,82,na,1891,216.8580585112074
SIM,1818,51,na,1869,1980
STAT,1857,97,na,1954,4.828628726387859
SIM,1887,32,40-44,1919,11
SIM,1800,89,na,1889,67
STAT,1853,83,na,1936,395.2477910912262
STAT,1946,42,20-24,1988,0.02349192247135746
STAT,1935,16,15-19,1951,71.81376233677489
STAT,1961,32,45-49,1993,2.3915383310528013
STAT,1957,15,40-44,1972,2.129367118122721
SIM,1871,2,na,1873,3133
SIM,1943,16,15-19,1959,1
STAT,1945,38,20-24,1983,0.3420274748533123
STAT,1928,43,15-19,1971,0.002255683464775469
STAT,1889,21,45-49,1910,0.9949831394184284
STAT,1905,26,30-34,1931,42.206234578950884
STAT,1844,46,15-19,1890,3.355186697396234E-4
STAT,1844,102,na,1946,0.24521819282875762
STAT,1961,43,45-49,2004,0.25747538946647475
STAT,1953,33,20-24,1986,3.4688548589463717
STAT,1869,23,na,1892,2635.0304954472185
STAT,1860,103,na,1963,0.5153462266357728
SIM,1841,16,na,1857,2395
STAT,1857,66,na,1923,1473.1598187483578
SIM,1902,36,50-100,1938,1
STAT,1911,31,na,1942,4271.165518331425
SIM,1889,43,na,1932,3712
STAT,1887,23,35-39,1910,7.523839941275464
SIM,1893,80,na,1973,1154
SIM,1935,25,20-24,1960,57
STAT,1915,40,25-29,1955,0.08321308986133262
SIM,1855,24,45-49,1879,1
STAT,1937,47,25-29,1984,0.061836035975684066
SIM,1892,5,na,1897,4149
SIM,1905,55,na,1960,3687
STAT,1913,36,30-34,1949,2.086786606466172
STAT,1915,31,50-100,1946,0.9759193163122821
STAT,1875,31,na,1906,2857.533787642312
STAT,1843,30,na,1873,2669.1219517121317
STAT,1879,32,40-44,1911,5.22582525943358
STAT,1781,110,na,1891,9.485242288772277E-4
STAT,1919,15,20-24,1934,34.842039776765105
SIM,1908,97,na,2005,30
STAT,1847,24,45-49,1871,0.6483550922833906
SIM,1848,25,15-19,1873,1
SIM,1905,35,35-39,1940,3
STAT,1919,48,20-24,1967,0.013791225857333963
SIM,1921,36,30-34,1957,1
STAT,1839,57,na,1896,1593.737425368174
SIM,1893,89,na,1982,294
SIM,1899,16,30-34,1915,7
STAT,1923,32,25-29,1955,12.223505077386982
SIM,1931,32,25-29,1963,1
SIM,1959,29,25-29,1988,21
STAT,1984,21,15-19,2005,8.756756778982984
SIM,1912,29,20-24,1941,36
STAT,1914,18,25-29,1932,10.322944285753012
STAT,1927,25,20-24,1952,25.77813196624136
STAT,1903,44,na,1947,3760.8251567416855
STAT,1981,19,35-39,2000,6.766846296022695
STAT,1900,79,na,1979,1853.5785724371462
STAT,1887,32,na,1919,3086.271000072293
STAT,1969,36,50-100,2005,0.6241501682169717
STAT,1954,33,15-19,1987,0.18675998447777792
STAT,1821,54,20-24,1875,0.001236605062566862
STAT,1912,39,20-24,1951,0.29421415483572955
STAT,1922,28,25-29,1950,85.61311039521183
STAT,1905,33,20-24,1938,2.5815609447605645
SIM,1927,15,20-24,1942,388
SIM,1962,33,15-19,1995,2
STAT,1872,20,35-39,1892,6.802514120528954
STAT,1941,63,na,2004,4081.9284064288145
STAT,1929,37,25-29,1966,1.4588665948116648
STAT,1895,33,35-39,1928,15.148599285367105
SIM,1928,45,30-34,1973,1
SIM,1989,24,na,2013,6713
SIM,1935,39,50-100,1974,2
STAT,1889,22,50-100,1911,0.5801101040739012
SIM,1950,33,45-49,1983,6
STAT,1878,41,35-39,1919,2.1918229390942705
STAT,1908,38,15-19,1946,0.020672542079281774
SIM,1784,77,na,1861,115
SIM,1900,99,na,1999,17
STAT,1911,48,15-19,1959,4.0168211035232216E-4
SIM,1955,23,30-34,1978,63
SIM,1877,43,35-39,1920,4
STAT,1959,36,20-24,1995,0.4103484677153459
STAT,1893,28,na,1921,3469.0116380448317
STAT,1936,49,30-34,1985,0.10143150187781014
STAT,1842,36,na,1878,1953.6126067979856
STAT,1922,22,15-19,1944,7.0417815564680275
STAT,1915,45,30-34,1960,0.10417310841921842
STAT,1933,19,na,1952,5658.261927002048
SIM,1834,25,50-100,1859,1
SIM,1924,25,45-49,1949,4
SIM,1962,20,na,1982,5155
SIM,1837,22,35-39,1859,9
SIM,1917,36,45-49,1953,2
STAT,1901,73,na,1974,2489.6785993997305
STAT,1785,74,na,1859,296.73151008603577
STAT,1927,43,20-24,1970,0.025514640826691196
SIM,1858,26,35-39,1884,28
STAT,1789,88,na,1877,38.12033230659629
STAT,1876,23,25-29,1899,68.08177937952259
SIM,1857,11,na,1868,2913
SIM,1842,16,30-34,1858,6
SIM,1900,32,30-34,1932,32
SIM,1889,20,na,1909,3758
STAT,1942,33,45-49,1975,1.9335687817547706
STAT,1973,20,20-24,1993,166.62641715721796
SIM,1921,24,15-19,1945,11
SIM,1961,22,45-49,1983,4
STAT,1835,48,15-19,1883,2.597669117623618E-4
STAT,1872,43,na,1915,2658.922512199244
STAT,1981,34,30-34,2015,25.88218768055073
STAT,1876,57,na,1933,2397.4472862571997
SIM,1822,49,40-44,1871,1
SIM,1829,78,na,1907,341
SIM,1859,13,na,1872,2579
STAT,1837,102,na,1939,0.21229625417451337
STAT,1952,24,50-100,1976,0.9123745918923015
STAT,1860,42,40-44,1902,2.089495239248801
STAT,1925,17,50-100,1942,0.5221335381042465
SIM,1906,20,30-34,1926,69
SIM,1930,22,15-19,1952,15
SIM,1950,48,45-49,1998,1
STAT,1950,33,30-34,1983,21.900442004161714
STAT,1982,3,na,1985,6388.075606566102
STAT,1962,20,45-49,1982,1.6704186048394547
STAT,1814,49,40-44,1863,0.4606037524852741
SIM,1942,28,15-19,1970,1
STAT,1953,22,45-49,1975,1.5759937147172975
STAT,1942,48,45-49,1990,0.27192811434197844
STAT,1988,18,na,2006,6073.303688812216
SIM,1812,46,na,1858,1593
SIM,1838,51,na,1889,1531
STAT,1825,44,na,1869,1883.880389480503
STAT,1923,16,25-29,1939,58.8471926755934
SIM,1901,45,45-49,1946,1
STAT,1934,28,15-19,1962,1.095991375783597
STAT,1941,35,30-34,1976,2.2364215902622613
SIM,1964,34,na,1998,5882
STAT,1829,58,na,1887,1478.3418785571173
STAT,1843,53,45-49,1896,0.014327679834279957
STAT,1857,29,30-34,1886,22.979551081841507
STAT,1924,43,30-34,1967,0.1751684292405979
STAT,1978,19,50-100,1997,0.5896759807414318
SIM,1858,33,25-29,1891,2
STAT,1945,35,15-19,1980,0.024984306619561712
STAT,1953,8,na,1961,5486.65403901681
SIM,1912,38,30-34,1950,4
SIM,1959,21,50-100,1980,2
SIM,1905,19,35-39,1924,4
STAT,1861,38,15-19,1899,0.05360787173562028
STAT,1950,40,20-24,1990,0.025113363907903394
STAT,1927,32,45-49,1959,2.2333785692306454
STAT,1932,30,50-100,1962,1.2701614196360196
STAT,1868,22,35-39,1890,6.470191378272637
STAT,1844,15,na,1859,2469.6045148513726
STAT,1953,40,45-49,1993,0.24213140811366107
STAT,1867,25,25-29,1892,45.88851636140333
SIM,1865,29,30-34,1894,73
SIM,1898,28,30-34,1926,3
STAT,1840,46,30-34,1886,0.07931666278792399
SIM,1931,16,25-29,1947,88
SIM,1900,0,na,1900,4036
STAT,1869,43,35-39,1912,2.0091611908683635
SIM,1875,39,na,1914,3107
STAT,1970,6,na,1976,5679.095039903264
SIM,1900,76,na,1976,1884
STAT,1909,36,45-49,1945,0.7490937782982313
STAT,1890,83,na,1973,1100.370581904097
STAT,1904,45,20-24,1949,0.011329551895720342
STAT,1779,105,na,1884,0.01828168893447018
STAT,1942,15,45-49,1957,0.6028798331200698
SIM,1950,15,45-49,1965,1
STAT,1826,82,na,1908,256.9028769579493
SIM,1929,33,30-34,1962,4
STAT,1965,48,35-39,2013,0.19267811441842933
SIM,1860,85,na,1945,654
STAT,1778,92,na,1870,14.623769386622996
SIM,1864,99,na,1963,5
SIM,1832,67,na,1899,1327
STAT,1946,29,25-29,1975,84.52936783677494
SIM,1861,47,na,1908,1706
SIM,1929,57,na,1986,4936
STAT,1868,0,na,1868,4174.197691810689
STAT,1873,48,35-39,1921,0.16291549232617725
STAT,1911,15,15-19,1926,10.538299520997038
STAT,1855,95,na,1950,11.313114313699716
STAT,1951,44,50-100,1995,0.16722127975757917
STAT,1925,41,25-29,1966,0.099884452772425
SIM,1887,35,45-49,1922,4
STAT,1926,28,45-49,1954,2.3811329243166863
STAT,1840,39,40-44,1879,4.068044034153714
STAT,1831,52,na,1883,1751.469491346755
STAT,1925,37,40-44,1962,2.072826814211059
STAT,1838,16,15-19,1854,6.831634658461078
STAT,1932,26,40-44,1958,7.050345800715403
SIM,1940,26,40-44,1966,7
SIM,1935,32,45-49,1967,3
STAT,1866,27,30-34,1893,26.936117943981095
SIM,1840,41,50-100,1881,6
SIM,1880,20,35-39,1900,16
SIM,1926,9,na,1935,6223
STAT,1891,17,50-100,1908,0.06987800724095859
STAT,1946,45,25-29,1991,0.07095591314836817
SIM,1958,19,15-19,1977,128
STAT,1936,30,45-49,1966,1.766929822893403
STAT,1961,40,40-44,2001,0.38864367223718765
SIM,1846,16,15-19,1862,6
STAT,1811,52,na,1863,1436.8929289303414
STAT,1937,34,50-100,1971,0.943292244246535
STAT,1838,62,na,1900,1583.1990504246114
STAT,1866,31,15-19,1897,0.15295056740567584
STAT,1957,28,50-100,1985,1.5203070206309361
SIM,1954,29,25-29,1983,2
STAT,1941,24,40-44,1965,4.008274317252941
STAT,1981,17,25-29,1998,69.93064640281212
STAT,1879,35,45-49,1914,2.4250029989204265
STAT,1932,19,50-100,1951,0.5695915006696699
STAT,1912,57,na,1969,3899.4013094745983
STAT,1935,26,45-49,1961,2.7204310830767837
STAT,1904,38,30-34,1942,1.8969141478356217
STAT,1961,16,45-49,1977,0.7450244812075246
SIM,1944,30,45-49,1974,2
STAT,1959,49,20-24,2008,0.017250633790082112
SIM,1870,44,15-19,1914,1
SIM,1926,60,na,1986,5362
STAT,1960,18,15-19,1978,68.19282430798069
STAT,1862,44,15-19,1906,0.013268293043760123
STAT,1868,47,15-19,1915,4.414390259111436E-4
STAT,1951,46,45-49,1997,0.31143977022387964
STAT,1906,36,40-44,1942,1.5977061428362216
STAT,1909,29,20-24,1938,20.01100436731492
STAT,1932,57,na,1989,5500.096187280839
SIM,1889,36,50-100,1925,5
SIM,1933,34,35-39,1967,28
STAT,1930,28,30-34,1958,57.47726221425475
SIM,1831,23,45-49,1854,3
SIM,1924,43,45-49,1967,1
SIM,1943,26,45-49,1969,2
SIM,1909,42,45-49,1951,2
SIM,1949,34,na,1983,5838
STAT,1972,19,25-29,1991,63.98947976778514
SIM,1945,20,na,1965,4769
STAT,1951,27,40-44,1978,6.433067653437076
SIM,1980,19,25-29,1999,2
STAT,1942,40,35-39,1982,0.2531245678292748
SIM,1976,37,na,2013,5963
STAT,1951,48,na,1999,5236.7754948716065
STAT,1985,21,na,2006,6015.813533739616
SIM,1905,26,25-29,1931,84
STAT,1930,35,20-24,1965,0.397550648312066
STAT,1973,41,na,2014,5768.996250215596
SIM,1838,32,45-49,1870,3
STAT,1877,20,35-39,1897,7.046969273284998
STAT,1878,28,na,1906,2865.532141768333
SIM,1825,85,na,1910,204
SIM,1849,28,35-39,1877,18
STAT,1916,25,45-49,1941,2.0756595937406157
STAT,1947,23,na,1970,4761.298354842868
SIM,1849,35,25-29,1884,9
SIM,1886,41,35-39,1927,2
STAT,1971,25,15-19,1996,1.0372289851258565
SIM,1846,42,50-100,1888,2
SIM,2002,2,na,2004,6949
SIM,1917,29,20-24,1946,63
STAT,1889,44,15-19,1933,0.01938026266230529
SIM,1914,36,40-44,1950,3
STAT,1959,40,40-44,1999,0.3934857048981628
SIM,1839,39,30-34,1878,11
STAT,1925,34,35-39,1959,12.503284980372202
STAT,1931,33,50-100,1964,1.2497597397235871
SIM,1925,20,na,1945,5530
SIM,1929,34,na,1963,5169
STAT,1799,87,na,1886,80.21476835980275
STAT,1958,25,50-100,1983,1.5165277631468608
SIM,1860,62,na,1922,1816
STAT,1831,48,30-34,1879,0.08854337570231999
SIM,1914,80,na,1994,1864
STAT,1884,109,na,1993,0.07362847202504262
STAT,1862,44,na,1906,2220.607156309524
STAT,1916,43,45-49,1959,0.19653538152698902
STAT,1876,16,35-39,1892,0.6562061096470062
STAT,1914,15,20-24,1929,32.53092483195451
SIM,1845,85,na,1930,313
SIM,1841,71,na,1912,963
SIM,1869,15,35-39,1884,2
STAT,1811,50,50-100,1861,0.04678964534455753
SIM,1821,71,na,1892,623
STAT,1810,51,40-44,1861,0.0393410412955819
STAT,1863,22,50-100,1885,0.4197063048218153
STAT,1899,29,35-39,1928,15.14660059753196
STAT,1961,37,na,1998,5779.110175816282
STAT,1935,19,20-24,1954,212.8589739693059
SIM,1864,22,45-49,1886,1
STAT,1883,16,50-100,1899,0.05545221022720303
STAT,1901,32,na,1933,3857.4306230150114
STAT,1950,36,35-39,1986,3.403415045974809
SIM,1921,17,na,1938,4937
SIM,1944,34,na,1978,4532
STAT,1890,37,30-34,1927,7.515345291273534
SIM,1978,14,na,1992,6033
STAT,1914,34,25-29,1948,10.650006480819545
SIM,1910,91,na,2001,317
STAT,1988,17,15-19,2005,74.90706613631477
SIM,1950,30,40-44,1980,11
SIM,1843,20,30-34,1863,41
SIM,1938,25,25-29,1963,13
STAT,1942,45,40-44,1987,0.19874404701366324
STAT,1952,31,40-44,1983,5.519797591550188
STAT,1892,27,50-100,1919,0.9252730366581825
STAT,1811,85,na,1896,141.15005730530186
STAT,1919,93,na,2012,408.90950622485906
STAT,1946,19,30-34,1965,15.59104349241501
STAT,1974,23,40-44,1997,5.081894803347775
SIM,1871,22,50-100,1893,1
STAT,1844,70,na,1914,1173.5630042360044
SIM,1857,23,15-19,1880,3
STAT,1840,49,35-39,1889,0.11038877981802099
STAT,1899,30,15-19,1929,0.2269664031705844
STAT,1916,40,40-44,1956,0.2966583818339318
STAT,1940,42,25-29,1982,0.0869845837763416
STAT,1810,90,na,1900,44.89081770412281
STAT,1833,32,15-19,1865,0.130226575586436
STAT,1924,20,25-29,1944,126.50067665369433
STAT,1938,47,40-44,1985,0.1867812884385626
SIM,1936,16,na,1952,4075
STAT,1856,22,45-49,1878,0.7130527873094045
STAT,1921,18,15-19,1939,59.52155168893696
STAT,1932,24,na,1956,5511.919416623931
SIM,1891,46,na,1937,3275
STAT,1849,23,15-19,1872,3.069255317774151
SIM,1874,65,na,1939,1726
STAT,1953,19,na,1972,5135.100761227549
SIM,1893,30,50-100,1923,3
STAT,1913,39,35-39,1952,2.7283851528268306
SIM,1849,32,20-24,1881,6
STAT,1902,21,35-39,1923,9.544225389390075
STAT,1854,14,na,1868,2305.457626084828
STAT,1819,52,35-39,1871,0.015943296980000424
STAT,1942,30,40-44,1972,4.817022725718849
STAT,1835,20,30-34,1855,23.19350617026323
STAT,1846,102,na,1948,0.30307905539838526
STAT,1841,51,na,1892,1923.5196785378178
STAT,1885,108,na,1993,0.17145023824575334
SIM,1910,21,35-39,1931,12
SIM,1915,21,na,1936,4354
STAT,1815,47,35-39,1862,0.2858244331383998
SIM,1914,68,na,1982,3171
STAT,1824,70,na,1894,868.1538476350813
SIM,1843,38,20-24,1881,2
SIM,1791,67,na,1858,819
SIM,1870,51,na,1921,2859
SIM,1921,39,35-39,1960,4
SIM,1918,17,20-24,1935,302
STAT,1839,20,15-19,1859,3.410420555045982
STAT,1869,40,30-34,1909,1.2978436622601561
SIM,1932,20,25-29,1952,1
STAT,1968,18,20-24,1986,195.35778469497328
STAT,1873,112,na,1985,0.002826618925585111
STAT,1873,83,na,1956,504.3560257554147
STAT,1924,46,35-39,1970,0.1775296542695542
SIM,1845,45,50-100,1890,1
SIM,1915,54,na,1969,4297
SIM,1921,27,20-24,1948,41
STAT,1877,97,na,1974,47.69422694275456
STAT,1913,27,20-24,1940,21.001310972741084
SIM,1919,68,na,1987,4269
SIM,1922,34,25-29,1956,3
STAT,1965,45,30-34,2010,0.13422331788560374
SIM,1899,32,30-34,1931,45
STAT,1950,47,50-100,1997,0.32102417212662965
SIM,1950,42,na,1992,4694
STAT,1920,20,40-44,1940,4.337710317084745
STAT,1837,45,50-100,1882,0.1894058522065636
SIM,1976,26,50-100,2002,3
SIM,1812,67,na,1879,644
SIM,1881,47,na,1928,1794
SIM,1844,99,na,1943,8
STAT,1984,25,na,2009,6172.084345741384
SIM,1877,40,30-34,1917,1
SIM,1847,20,15-19,1867,5
STAT,1902,58,na,1960,3348.4793128532597
SIM,1943,19,20-24,1962,351
STAT,1873,28,na,1901,2802.5934432664394
STAT,1894,37,15-19,1931,0.08330749384818477
SIM,1842,33,na,1875,2374
STAT,1909,94,na,2003,272.2279872643506
SIM,1992,6,na,1998,7039
SIM,1880,33,50-100,1913,3
STAT,1946,38,35-39,1984,3.186384401475237
SIM,1928,39,25-29,1967,2
SIM,1904,69,na,1973,3088
SIM,1920,76,na,1996,2352
SIM,1948,48,na,1996,4344
SIM,1900,55,na,1955,3112
STAT,1893,15,25-29,1908,8.304567634626686
STAT,1947,7,na,1954,5120.39891330142
SIM,1928,29,30-34,1957,129
SIM,1954,38,35-39,1992,2
SIM,1891,19,30-34,1910,7
STAT,1861,102,na,1963,1.0316491524350793
STAT,1883,19,30-34,1902,1.789974670761503
STAT,1959,35,50-100,1994,0.6541046202836623
SIM,1934,25,40-44,1959,12
STAT,1901,29,15-19,1930,0.728160560295643
STAT,1867,47,50-100,1914,0.263397433494438
STAT,1985,21,30-34,2006,47.34708663351511
STAT,1801,86,na,1887,83.1852314592354
SIM,1842,23,20-24,1865,5
SIM,1882,36,35-39,1918,17
STAT,1956,15,25-29,1971,66.21117936367548
SIM,1954,26,20-24,1980,49
SIM,1993,21,30-34,2014,114
SIM,1938,18,35-39,1956,5
STAT,1858,36,50-100,1894,1.1106395833513196
STAT,1845,42,35-39,1887,1.2425784955291372
STAT,1940,44,50-100,1984,0.1426275296473863
STAT,1926,44,45-49,1970,0.23594355031644906
STAT,1830,34,50-100,1864,0.9529386453176679
SIM,1875,47,50-100,1922,3
STAT,1892,21,15-19,1913,4.7862281836433676
STAT,1887,19,15-19,1906,7.634130078784467
SIM,1842,39,50-100,1881,1
SIM,1956,36,45-49,1992,5
SIM,1839,77,na,1916,1040
SIM,1955,30,20-24,1985,2
SIM,1875,15,30-34,1890,4
SIM,1835,42,50-100,1877,4
STAT,1914,24,30-34,1938,33.690869627751475
STAT,1926,25,40-44,1951,6.490655029037751
STAT,1861,28,20-24,1889,11.255611098646222
STAT,1945,52,na,1997,4736.295161798564
STAT,1946,26,20-24,1972,23.476315764807023
STAT,1919,45,15-19,1964,4.631583468825049E-4
STAT,1908,5,na,1913,4492.0134319273975
STAT,1970,41,45-49,2011,0.25022311379598666
STAT,1867,22,20-24,1889,74.55830339806685
STAT,1950,43,25-29,1993,0.10110425608939494
SIM,1895,19,15-19,1914,18
STAT,1824,48,na,1872,1585.0571352518648
STAT,1948,36,45-49,1984,0.9284031820177916
STAT,1843,50,40-44,1893,0.01071504136442375
STAT,1864,47,30-34,1911,0.09928172031304283
STAT,1940,21,20-24,1961,130.80785889706473
SIM,1875,22,20-24,1897,105
STAT,1903,15,45-49,1918,0.1078745274149633
STAT,1947,30,20-24,1977,3.2357356097681538
SIM,1901,26,40-44,1927,16
SIM,1924,40,40-44,1964,2
SIM,1908,72,na,1980,2597
STAT,1891,57,na,1948,2866.373228397347
STAT,1948,17,40-44,1965,1.8472434264674515
SIM,1856,25,na,1881,2213
SIM,1960,34,45-49,1994,8
SIM,1826,59,na,1885,1372
SIM,1898,35,20-24,1933,3
SIM,1933,31,30-34,1964,32
SIM,1869,6,na,1875,2487
SIM,1989,21,45-49,2010,2
SIM,1889,64,na,1953,2736
SIM,1956,17,40-44,1973,2
STAT,1963,42,15-19,2005,0.0023399003757234227
STAT,1892,114,na,2006,7.802832317685473E-4
STAT,1885,30,50-100,1915,1.0631765595319924
SIM,1885,50,na,1935,2895
SIM,1875,25,25-29,1900,55
STAT,1874,36,35-39,1910,8.396502775966974
STAT,1972,16,20-24,1988,200.38332771415446
SIM,1924,22,40-44,1946,6
STAT,1872,48,50-100,1920,0.2810257897068251
STAT,1958,39,45-49,1997,1.0622935198871994
SIM,1853,42,35-39,1895,4
SIM,1880,48,50-100,1928,2
SIM,1950,45,40-44,1995,1
STAT,1947,23,30-34,1970,37.4735028654756
STAT,1898,26,15-19,1924,0.7100593284236665
SIM,1902,30,40-44,1932,14
STAT,1941,27,45-49,1968,2.062981391192749
STAT,1925,31,30-34,1956,21.59683368678758
SIM,1924,83,na,2007,1358
STAT,1815,89,na,1904,58.29227024205355
STAT,1874,54,35-39,1928,0.00989144929745903
SIM,1873,80,na,1953,702
STAT,1916,22,40-44,1938,4.066458412046388
SIM,1869,43,na,1912,1859
STAT,1834,23,20-24,1857,83.50404847632308
STAT,1918,53,na,1971,4414.822533359341
SIM,1849,25,30-34,1874,46
STAT,1919,22,45-49,1941,1.421543647739356
STAT,1836,36,15-19,1872,0.06340553550227615
STAT,1881,24,45-49,1905,0.7713497331000678
STAT,1942,30,20-24,1972,3.0024317707302313
SIM,1973,30,45-49,2003,5
STAT,1884,23,30-34,1907,20.247181326329446
STAT,1946,16,na,1962,4712.638648630133
STAT,1861,20,25-29,1881,57.24240761106393
SIM,1956,7,na,1963,5520
SIM,1825,34,25-29,1859,22
SIM,1883,25,30-34,1908,43
SIM,1924,33,30-34,1957,4
SIM,1894,75,na,1969,2443
SIM,1945,25,15-19,1970,1
STAT,1813,49,25-29,1862,0.18505348761486556
STAT,1898,38,30-34,1936,1.7852675655654808
STAT,1939,20,20-24,1959,129.01563813454
SIM,1918,24,45-49,1942,3
STAT,1849,38,35-39,1887,5.5515858626062204
SIM,1914,39,45-49,1953,1
STAT,1841,52,30-34,1893,0.0052641792271712
SIM,1927,22,45-49,1949,6
SIM,1916,16,na,1932,4663
SIM,1857,38,35-39,1895,6
STAT,1835,23,35-39,1858,4.884771764551034
STAT,1941,45,45-49,1986,0.27005308461958766
STAT,1946,23,15-19,1969,6.833859461436513
STAT,1858,36,35-39,1894,6.398300023957662
SIM,1948,2,na,1950,4552
SIM,1978,29,30-34,2007,2
SIM,1867,39,20-24,1906,1
STAT,1903,42,20-24,1945,0.01810575401635008
SIM,1951,37,na,1988,6270
SIM,1808,62,na,1870,1259
STAT,1919,38,na,1957,4658.576600429582
STAT,1962,48,na,2010,5634.764196160008
STAT,1828,32,na,1860,1912.9162280078192
STAT,1826,32,25-29,1858,9.638404365223096
SIM,1913,23,50-100,1936,3
SIM,1858,37,na,1895,2515
STAT,1830,48,15-19,1878,3.6428728665129746E-4
STAT,1842,67,na,1909,1219.865125293731
SIM,1988,23,15-19,2011,22
STAT,1920,19,25-29,1939,55.784389868033344
STAT,1827,38,15-19,1865,0.0799056574318248
SIM,1947,20,20-24,1967,284
STAT,1889,54,na,1943,2978.8805160170664
STAT,1896,17,15-19,1913,9.045953259533048
STAT,1901,17,35-39,1918,0.886978858308071
SIM,1882,29,45-49,1911,5
STAT,1951,21,30-34,1972,39.640912440521014
STAT,1822,105,na,1927,0.024090645945625634
SIM,1938,22,20-24,1960,2
STAT,1939,46,30-34,1985,0.10742401643409769
SIM,1859,33,40-44,1892,9
STAT,1874,29,45-49,1903,1.3023891291428218
STAT,1931,30,45-49,1961,2.382742373369588
STAT,1973,39,30-34,2012,2.7965830591079777
SIM,1984,30,20-24,2014,1
STAT,1819,101,na,1920,0.3798712113726538
SIM,1851,24,25-29,1875,151
SIM,1913,73,na,1986,3214
SIM,1921,3,na,1924,5673
SIM,1987,27,30-34,2014,146
STAT,1926,37,20-24,1963,0.37171761105868917
SIM,1834,32,25-29,1866,18
STAT,1950,43,45-49,1993,0.23563814443466077
SIM,1905,20,15-19,1925,12
STAT,1916,40,20-24,1956,0.020945949005444248
SIM,1874,27,30-34,1901,74
STAT,1859,24,na,1883,2223.529458708813
STAT,1777,105,na,1882,0.015682129887316404
SIM,1873,38,35-39,1911,20
STAT,1945,20,50-100,1965,0.8328236325967501
SIM,1899,35,35-39,1934,13
SIM,1930,20,50-100,1950,1
SIM,1827,35,na,1862,1611
STAT,1890,22,45-49,1912,0.9833072358107825
STAT,1863,39,na,1902,2353.512620230366
STAT,1979,27,30-34,2006,62.529510932696255
STAT,1833,28,30-34,1861,23.499280631680005
STAT,1976,26,35-39,2002,23.25844087384629
STAT,1929,68,na,1997,4520.650044993045
STAT,1937,25,15-19,1962,0.7952874729008722
STAT,1865,38,35-39,1903,7.3281933980587315
SIM,1980,20,50-100,2000,3
SIM,1890,51,na,1941,3052
STAT,1879,25,15-19,1904,0.5504292553072404
SIM,1841,28,30-34,1869,32
SIM,1969,20,40-44,1989,5
STAT,1812,47,na,1859,1344.508188688943
SIM,1950,30,20-24,1980,6
STAT,1843,24,25-29,1867,71.06628862679413
STAT,1916,33,30-34,1949,18.69445777418734
SIM,1934,37,20-24,1971,1
STAT,1838,52,na,1890,1855.1665873731783
STAT,1877,42,50-100,1919,1.2666509281919092
SIM,1874,34,20-24,1908,1
STAT,1847,40,45-49,1887,1.188074860533663
STAT,1866,34,20-24,1900,2.866604207769657
SIM,1825,54,na,1879,1584
SIM,1827,45,na,1872,1403
STAT,1856,112,na,1968,2.6442671865768236E-4
STAT,1832,36,30-34,1868,4.73403362161945
SIM,1840,36,30-34,1876,14
STAT,1931,62,na,1993,5161.399622844589
STAT,1932,29,45-49,1961,2.6094432524364177
SIM,1888,57,na,1945,2298
SIM,1940,29,45-49,1969,4
STAT,1993,18,35-39,2011,6.965013052777988
SIM,1842,12,na,1854,2741
SIM,1933,18,na,1951,6529
STAT,1838,42,45-49,1880,1.5163999536362744
SIM,1891,13,na,1904,3629
STAT,1905,40,45-49,1945,0.17534785376468506
STAT,1985,24,35-39,2009,15.495712500049956
STAT,1952,27,20-24,1979,25.353744310645638
SIM,1906,95,na,2001,91
SIM,1886,76,na,1962,670
SIM,1966,33,35-39,1999,53
SIM,1941,25,30-34,1966,58
STAT,1836,20,50-100,1856,0.510066702945161
STAT,1845,15,45-49,1860,0.056295984690814364
SIM,1902,29,25-29,1931,147
STAT,1858,40,20-24,1898,0.1444198400031529
SIM,1837,44,45-49,1881,3
STAT,1810,108,na,1918,0.0010429601579443305
SIM,1846,42,45-49,1888,3
STAT,1853,28,15-19,1881,0.4727761771786305
STAT,1798,92,na,1890,10.593936936535771
STAT,1933,25,30-34,1958,60.11987288044605
STAT,1862,2,na,1864,3340.573376015578
SIM,1843,30,25-29,1873,21
SIM,1911,96,na,2007,143
STAT,1897,49,35-39,1946,0.11931941414962484
STAT,1856,45,15-19,1901,3.5569049271220635E-4
STAT,1889,98,na,1987,56.34845590693742
STAT,1984,26,50-100,2010,1.63923019797839
STAT,1899,36,25-29,1935,4.5741235827330184
SIM,1858,27,na,1885,2666
SIM,1953,18,na,1971,5046
SIM,1847,16,30-34,1863,2
STAT,1826,51,na,1877,1327.8523975035853
STAT,1958,33,35-39,1991,14.110270855516061
STAT,1874,51,30-34,1925,0.007066271581673618
STAT,1942,23,30-34,1965,34.77157874833786
SIM,1910,100,na,2010,75
SIM,1930,21,na,1951,5747
STAT,1772,87,na,1859,6.943488133528985
STAT,1917,29,50-100,1946,1.19606215378081
STAT,1882,35,15-19,1917,0.06389941566413396
STAT,1887,45,45-49,1932,0.30826718580002843
STAT,1888,48,30-34,1936,0.0731426626828772
SIM,1876,56,na,1932,2396
SIM,1887,93,na,1980,216
STAT,1868,25,40-44,1893,3.343917633824861
STAT,1862,38,50-100,1900,1.1898076069795596
STAT,1913,43,na,1956,4175.284944310046
SIM,1950,23,30-34,1973,1
STAT,1839,16,30-34,1855,1.6633158427626011
SIM,1851,17,35-39,1868,1
STAT,1843,17,35-39,1860,0.7035833061797153
SIM,1986,21,40-44,2007,15
SIM,1891,23,na,1914,3121
STAT,1885,29,20-24,1914,13.407665306691952
STAT,1924,84,na,2008,1845.6042459670762
STAT,1858,62,na,1920,1645.4807535981752
STAT,1910,15,35-39,1925,0.9649910229687496
SIM,1863,28,na,1891,2465
STAT,1948,44,30-34,1992,0.1748828582117849
STAT,1958,40,25-29,1998,0.11279660710881963
STAT,1817,47,50-100,1864,0.7011505157152231
STAT,1835,30,25-29,1865,8.31600106218894
STAT,1875,32,20-24,1907,3.2236554717645864
STAT,1958,36,40-44,1994,2.3397990032300857
SIM,1975,25,30-34,2000,123
STAT,1830,66,na,1896,1028.178719401174
STAT,1839,23,20-24,1862,69.71592232593622
SIM,1925,31,25-29,1956,21
STAT,1889,44,na,1933,3243.5181991486506
SIM,1876,46,na,1922,2498
STAT,1928,27,15-19,1955,1.003686485161525
STAT,1881,39,30-34,1920,5.872800075515619
STAT,1944,21,40-44,1965,4.1911844071775315
SIM,1936,20,45-49,1956,1
SIM,1893,29,20-24,1922,2
STAT,1929,46,50-100,1975,0.33918731676722186
SIM,1883,32,20-24,1915,7
SIM,1901,20,30-34,1921,73
STAT,1841,37,35-39,1878,7.409047859857711
STAT,1983,28,35-39,2011,24.604461410687385
STAT,1939,16,35-39,1955,4.850628877877632
SIM,1808,52,na,1860,1589
STAT,1875,25,30-34,1900,30.235563956921407
STAT,1928,20,45-49,1948,1.6308869262176193
STAT,1878,41,50-100,1919,1.2787374970708942
SIM,1915,35,30-34,1950,1
STAT,1968,25,45-49,1993,2.503143206706916
STAT,1917,39,20-24,1956,0.3140697469776933
STAT,1885,21,25-29,1906,66.09489932629255
STAT,1839,49,30-34,1888,0.0762371673023967
SIM,1866,36,50-100,1902,1
STAT,1892,27,25-29,1919,61.18622768892623
STAT,1831,33,45-49,1864,1.7574472741224894
STAT,1917,31,25-29,1948,11.215365118748434
STAT,1849,45,25-29,1894,0.045089009891384195
SIM,1845,64,na,1909,1607
SIM,1903,43,na,1946,3661
STAT,1910,22,25-29,1932,100.20979038494525
SIM,1987,22,na,2009,6090
SIM,1847,23,20-24,1870,9
SIM,1985,29,20-24,2014,55
STAT,1823,38,30-34,1861,6.08529390801872
STAT,1907,35,30-34,1942,1.9718027955165374
STAT,1989,17,30-34,2006,20.14795367257879
STAT,1891,28,35-39,1919,13.713998253663185
SIM,1925,39,20-24,1964,1
STAT,1848,46,35-39,1894,0.14917621905119846
STAT,1869,44,na,1913,2548.1942940643466
STAT,1963,15,15-19,1978,66.57453564138677
SIM,1831,38,30-34,1869,13
SIM,1959,30,40-44,1989,8
SIM,1893,21,25-29,1914,4
STAT,1848,47,30-34,1895,0.10237317762707064
STAT,1870,26,50-100,1896,0.7302910986447699
SIM,1843,73,na,1916,713
SIM,1917,33,40-44,1950,8
STAT,1898,15,25-29,1913,8.879348836070681
STAT,1919,0,na,1919,5744.120107487109
STAT,1926,22,35-39,1948,13.198677539549273
STAT,1855,34,45-49,1889,1.4797728097334255
STAT,1926,61,na,1987,4818.071301684821
SIM,1825,31,20-24,1856,5
STAT,1904,48,25-29,1952,0.05316846994328406
SIM,1889,102,na,1991,160
STAT,1918,31,40-44,1949,4.817631860802703
STAT,1916,41,na,1957,4399.016997518129
STAT,1848,39,45-49,1887,2.1379163250749085
SIM,1902,40,50-100,1942,1
STAT,1837,21,45-49,1858,0.6657995183879618
SIM,1976,22,40-44,1998,11
STAT,1976,2,na,1978,6067.336311640453
STAT,1920,16,20-24,1936,175.89507265442106
SIM,1947,22,na,1969,5346
SIM,1876,25,40-44,1901,8
STAT,1786,91,na,1877,31.187960032186687
SIM,1946,46,na,1992,4582
SIM,1856,39,45-49,1895,4
STAT,1917,67,na,1984,3721.048179629593
STAT,1877,29,15-19,1906,0.5407522316028677
STAT,1891,78,na,1969,1608.7833686081299
STAT,1909,33,40-44,1942,4.29626287318401
STAT,1884,26,35-39,1910,11.03966636372485
SIM,1879,41,45-49,1920,5
SIM,1948,37,35-39,1985,9
STAT,1898,28,50-100,1926,0.9942036745862705
SIM,1901,23,35-39,1924,8
STAT,1894,45,na,1939,3371.629456360197
STAT,1932,34,na,1966,5796.130592468002
SIM,1833,34,30-34,1867,7
SIM,1874,75,na,1949,919
SIM,1930,11,na,1941,6377
SIM,1807,90,na,1897,38
STAT,1929,49,40-44,1978,0.23446798269142627
STAT,1995,16,45-49,2011,0.8347347706822164
STAT,1943,21,25-29,1964,113.46208353097978
SIM,1824,35,35-39,1859,13
SIM,1893,58,na,1951,2750
SIM,1915,44,na,1959,4539
SIM,1909,38,25-29,1947,4
STAT,1941,42,40-44,1983,0.30906239518549783
SIM,1889,74,na,1963,2236
STAT,1811,75,na,1886,525.9149632035334
SIM,1926,31,40-44,1957,10
SIM,1951,21,25-29,1972,277
STAT,1947,33,na,1980,5008.408498527212
STAT,1812,92,na,1904,18.285481627987128
STAT,1934,59,na,1993,5557.317083295034
STAT,1825,34,30-34,1859,31.85137270867298
STAT,1930,16,50-100,1946,0.5604331127517321
STAT,1966,27,35-39,1993,21.73445903525163
SIM,1876,31,50-100,1907,2
SIM,1874,37,25-29,1911,3
STAT,1951,31,25-29,1982,12.954530642107203
SIM,1834,22,30-34,1856,37
SIM,1969,23,45-49,1992,2
SIM,1840,29,40-44,1869,11
STAT,1955,17,30-34,1972,18.673401367386937
SIM,1884,23,25-29,1907,121
SIM,1840,31,na,1871,2166
SIM,1850,25,35-39,1875,14
STAT,1897,31,45-49,1928,2.701947928753787
SIM,1859,36,45-49,1895,1
STAT,1888,25,50-100,1913,0.8736778202484986
SIM,1892,26,35-39,1918,20
STAT,1832,29,40-44,1861,2.763983317844083
STAT,1948,21,25-29,1969,122.43318410729323
SIM,1813,43,45-49,1856,1
SIM,1951,1,na,1952,6328
SIM,1851,21,20-24,1872,142
SIM,1900,45,na,1945,3404
STAT,1955,39,40-44,1994,2.3577421386523167
STAT,1911,62,na,1973,3656.714189104215
STAT,1948,47,35-39,1995,0.17711062162525967
SIM,1968,31,45-49,1999,3
STAT,1842,25,35-39,1867,9.315529689662798
STAT,1993,15,30-34,2008,20.248911670472836
SIM,1845,21,45-49,1866,1
SIM,1943,23,40-44,1966,4
SIM,1956,21,25-29,1977,148
SIM,1866,33,30-34,1899,12
SIM,1875,29,na,1904,3312
STAT,1865,35,30-34,1900,5.602159072682135
STAT,1866,37,25-29,1903,3.079767434158665
STAT,1848,21,20-24,1869,89.79935139171323
STAT,1883,52,35-39,1935,0.009668675520227904
STAT,1851,31,20-24,1882,2.254298301145049
STAT,1951,24,35-39,1975,12.973642648229053
SIM,1944,55,na,1999,4366
STAT,1843,21,20-24,1864,87.41940590987488
SIM,1934,22,35-39,1956,18
SIM,1863,49,30-34,1912,1
SIM,1889,46,30-34,1935,1
STAT,1839,19,35-39,1858,0.5625582570314239
STAT,1972,40,15-19,2012,0.0023647123130448268
SIM,1984,23,30-34,2007,62
SIM,1860,21,na,1881,2817
STAT,1954,49,20-24,2003,0.01630318040764782
STAT,1858,33,30-34,1891,15.652406031852754
SIM,1873,35,30-34,1908,15
STAT,1964,45,15-19,2009,5.59553143521592E-4
STAT,1829,44,45-49,1873,1.546926327902105
STAT,1992,19,45-49,2011,0.8269279961310062
SIM,1819,38,15-19,1857,2
SIM,1856,21,20-24,1877,113
SIM,1941,28,35-39,1969,21
STAT,1998,15,30-34,2013,20.664444031392375
SIM,1899,94,na,1993,47
SIM,1848,37,30-34,1885,10
STAT,1859,20,50-100,1879,0.43362704845037736
STAT,1855,49,30-34,1904,0.08064693497379571
STAT,1914,34,50-100,1948,0.9526894494125338
STAT,1854,112,na,1966,1.7268974943367125E-4
SIM,1959,23,na,1982,5629
STAT,1851,24,30-34,1875,16.626707027664306
STAT,1944,35,na,1979,4822.271385812659
STAT,1933,28,35-39,1961,23.00499900739003
SIM,1889,20,20-24,1909,122
STAT,1825,34,na,1859,2037.1305073723415
STAT,1859,49,15-19,1908,3.600438293914315E-4
STAT,1894,15,40-44,1909,0.27260456058912447
STAT,1884,33,25-29,1917,11.629547735299045
STAT,1884,50,50-100,1934,0.017467937353799673
STAT,1837,28,15-19,1865,0.4186515620019331
SIM,1825,64,na,1889,1151
STAT,1964,38,25-29,2002,1.4729443519588599
SIM,1878,20,45-49,1898,3
SIM,1948,44,25-29,1992,1
SIM,1977,26,45-49,2003,3
SIM,1928,17,na,1945,5991
SIM,1908,32,35-39,1940,3
STAT,1863,47,15-19,1910,4.0176191708006086E-4
SIM,1844,78,na,1922,645
STAT,1888,19,30-34,1907,2.150607350693064
SIM,1973,40,na,2013,5390
STAT,1956,47,30-34,2003,0.14159811823432136
SIM,1954,45,50-100,1999,1
STAT,1860,96,na,1956,9.256790315376554
SIM,1972,38,25-29,2010,2
STAT,1889,1,na,1890,3872.0436119826386
SIM,1871,18,15-19,1889,9
SIM,1902,26,na,1928,4176
STAT,1949,14,na,1963,5270.293600782718
STAT,1830,38,20-24,1868,0.7673366174713185
SIM,1830,55,na,1885,1443
SIM,1978,33,50-100,2011,2
STAT,1887,42,40-44,1929,2.905458702666151
STAT,1899,33,20-24,1932,4.255691136455609
STAT,1835,38,50-100,1873,0.9376437277743562
STAT,1935,23,40-44,1958,5.2851389176435575
STAT,1976,30,20-24,2006,3.837710444166677
STAT,1887,63,na,1950,2307.6817461452447
STAT,1971,36,50-100,2007,0.6328251822690932
SIM,1938,63,na,2001,3673
SIM,1964,47,30-34,2011,1
SIM,1868,31,40-44,1899,6
STAT,1904,39,50-100,1943,0.434738986716734
STAT,1934,15,na,1949,5775.0853356087655
STAT,1863,18,15-19,1881,6.1819246395262715
STAT,1996,19,30-34,2015,20.42904981447813
SIM,1869,30,30-34,1899,21
SIM,1902,26,20-24,1928,4
SIM,1798,67,na,1865,1026
STAT,1839,26,25-29,1865,42.56748837619463
SIM,1944,59,na,2003,4228
STAT,1832,47,na,1879,1639.6937819792079
STAT,1991,20,45-49,2011,1.868341568972258
STAT,1856,81,na,1937,476.1157185530153
SIM,1820,38,50-100,1858,2
STAT,1913,24,15-19,1937,6.167841064311981
STAT,1920,39,50-100,1959,0.5291506807434357
STAT,1859,39,20-24,1898,0.701512817592512
SIM,1901,30,25-29,1931,23
SIM,1838,22,15-19,1860,7
SIM,1956,15,50-100,1971,1
SIM,1975,28,35-39,2003,4
SIM,1838,82,na,1920,121
STAT,1892,24,20-24,1916,99.0533996676525
STAT,1930,38,25-29,1968,1.4808262674235533
SIM,1905,16,30-34,1921,6
SIM,1845,28,15-19,1873,1
STAT,1815,99,na,1914,1.050872037453561
SIM,1974,29,45-49,2003,4
STAT,1891,25,30-34,1916,36.16107683852564
STAT,1885,39,15-19,1924,0.06398946287605847
STAT,1906,39,45-49,1945,0.7168122534729183
STAT,1853,22,40-44,1875,2.451321355925475
STAT,1862,26,15-19,1888,0.4467119610321985
SIM,1909,21,50-100,1930,1
STAT,1861,15,50-100,1876,0.05466677745775816
STAT,1924,31,15-19,1955,0.17307147009909266
SIM,1878,27,na,1905,2837
SIM,1861,22,40-44,1883,4
STAT,1907,38,35-39,1945,2.5793184450687083
STAT,1998,15,50-100,2013,0.6351774537940322
SIM,1951,39,50-100,1990,1
STAT,1892,17,30-34,1909,2.305427494969158
STAT,1943,39,50-100,1982,0.5282765588251306
STAT,1831,30,40-44,1861,4.508892899201931
SIM,1899,31,50-100,1930,1
SIM,1915,38,35-39,1953,8
SIM,1905,23,20-24,1928,132
STAT,1844,48,na,1892,1858.172612878797
STAT,1968,22,40-44,1990,4.862563369491451
STAT,1852,35,50-100,1887,1.1882353456999613
STAT,1891,18,40-44,1909,0.2601944568908705
STAT,1920,49,20-24,1969,0.01400923418057276
STAT,1959,39,25-29,1998,1.5280376131353954
SIM,1954,23,15-19,1977,1
SIM,1872,32,45-49,1904,3
SIM,1979,15,50-100,1994,2
STAT,1914,60,na,1974,3917.4306470062697
STAT,1966,36,35-39,2002,3.59517007321977
STAT,1953,29,15-19,1982,0.9888293560549932
STAT,1845,65,na,1910,1138.7895340349285
STAT,1990,12,na,2002,6492.085669269407
SIM,1827,76,na,1903,356
STAT,1874,45,na,1919,2684.5679659054676
SIM,1931,20,45-49,1951,2
SIM,1896,26,20-24,1922,34
STAT,1823,53,na,1876,1338.6582491451998
STAT,1838,20,35-39,1858,6.654475840223154
STAT,1919,43,50-100,1962,0.14665577627586815
SIM,1833,37,35-39,1870,14
STAT,1950,21,15-19,1971,7.290129197144861
STAT,1851,34,25-29,1885,8.280136815393275
STAT,1939,38,45-49,1977,0.8108367840101213
SIM,1856,24,25-29,1880,53
STAT,1787,76,na,1863,293.6734505019937
SIM,1863,31,40-44,1894,5
SIM,1926,85,na,2011,2023
STAT,1897,24,20-24,1921,105.67548555532683
STAT,1899,26,30-34,1925,39.95098953698349
STAT,1900,15,40-44,1915,0.29425367113840023
STAT,1911,97,na,2008,117.37681888617124
SIM,1885,42,50-100,1927,3
STAT,1840,34,15-19,1874,0.13628325510666647
SIM,1936,21,40-44,1957,1
SIM,1972,22,20-24,1994,295
STAT,1901,96,na,1997,139.307329429062
STAT,1859,24,35-39,1883,5.486298169624648
STAT,1936,37,15-19,1973,0.02176942338134189
SIM,1862,39,20-24,1901,5
STAT,1938,32,20-24,1970,2.8317879816817464
SIM,1882,25,15-19,1907,2
SIM,1945,51,na,1996,4576
SIM,1843,28,na,1871,2135
STAT,1923,20,45-49,1943,1.519316330805547
STAT,1987,18,25-29,2005,71.3718142569583
SIM,1849,47,40-44,1896,1
SIM,1861,18,20-24,1879,34
STAT,1949,32,30-34,1981,21.554715697437
SIM,1835,20,25-29,1855,125
STAT,1853,18,20-24,1871,21.10777738646812
STAT,1929,34,20-24,1963,3.571112738343014
SIM,1937,46,50-100,1983,3
SIM,1948,34,30-34,1982,51
SIM,1946,32,20-24,1978,4
STAT,1787,86,na,1873,56.47632637301854
SIM,1952,24,45-49,1976,3
STAT,1855,31,40-44,1886,3.7964934780593023
STAT,1902,27,na,1929,3891.5316487566843
SIM,1879,27,30-34,1906,60
STAT,1861,82,na,1943,447.6425540368211
SIM,1999,15,40-44,2014,7
STAT,1859,78,na,1937,718.282837512552
STAT,1848,24,25-29,1872,73.00102944055259
STAT,1944,24,45-49,1968,1.4011133905163564
SIM,1900,20,15-19,1920,11
SIM,1958,38,20-24,1996,1
SIM,1844,68,na,1912,1439
STAT,1816,46,25-29,1862,0.11925441371254275
STAT,1965,28,45-49,1993,2.4986318526998317
STAT,1766,91,na,1857,42.501482899909206
STAT,1895,29,15-19,1924,0.6766771609445952
STAT,1983,25,30-34,2008,64.299811177005
SIM,1836,26,15-19,1862,1
STAT,1883,23,15-19,1906,3.7133926322660873
STAT,1829,41,40-44,1870,2.444782620787413
STAT,1874,55,na,1929,2442.894479603677
SIM,1948,17,na,1965,4461
STAT,1869,39,15-19,1908,0.062127165458317604
STAT,1955,31,45-49,1986,2.4587473400968083
STAT,1839,38,40-44,1877,4.105723858788883
SIM,1967,17,15-19,1984,75
STAT,1831,36,15-19,1867,0.05610924710906738
SIM,1974,24,30-34,1998,109
STAT,1889,39,35-39,1928,9.96045398254239
SIM,1970,27,15-19,1997,2
SIM,1957,32,30-34,1989,5
SIM,1891,23,15-19,1914,8
STAT,1902,24,40-44,1926,3.3766455141733576
STAT,1907,27,45-49,1934,1.885266597798478
STAT,1928,21,40-44,1949,4.859306302174103
STAT,1825,65,na,1890,1195.358248753929
STAT,1964,22,20-24,1986,162.15766150753635
SIM,1889,49,35-39,1938,1
STAT,1927,39,15-19,1966,0.02748877074701
STAT,1966,24,30-34,1990,41.53700226150017
SIM,1946,25,30-34,1971,5
SIM,1897,39,35-39,1936,3
STAT,1896,46,15-19,1942,3.449059109070666E-4
STAT,1922,20,50-100,1942,0.8756239370890692
STAT,1959,17,15-19,1976,68.50957951939195
SIM,1884,20,20-24,1904,76
SIM,1953,20,50-100,1973,2
STAT,1825,37,35-39,1862,11.747267170404312
SIM,1905,30,45-49,1935,3
STAT,1905,89,na,1994,710.978172885676
SIM,1969,30,35-39,1999,33
STAT,1827,46,na,1873,2078.162825830522
STAT,1888,26,20-24,1914,15.969203497822887
STAT,1839,45,30-34,1884,0.08024592537355263
STAT,1990,8,na,1998,6495.332729669736
SIM,1769,87,na,1856,29
SIM,1846,20,35-39,1866,7
STAT,1808,86,na,1894,113.13225477053398
STAT,1877,26,45-49,1903,1.3374317632253552
STAT,1920,56,na,1976,4510.067068755506
STAT,1906,21,20-24,1927,116.32096351104384
STAT,1960,25,40-44,1985,7.042317333649595
STAT,1933,6,na,1939,6194.638864974662
STAT,1966,31,20-24,1997,3.585890218482937
STAT,1978,27,15-19,2005,1.1166596944038722
STAT,1842,13,na,1855,2348.29014
SIM,1926,27,20-24,1953,36
STAT,1890,62,na,1952,2577.3206002070433
STAT,1938,25,30-34,1963,44.85923541094052
SIM,1847,38,40-44,1885,7
STAT,1953,18,25-29,1971,60.47896412091381
STAT,1891,29,30-34,1920,35.66069300240549
STAT,1959,34,na,1993,5812.119301202399
STAT,1910,37,45-49,1947,0.7532093004662661
STAT,1892,74,na,1966,1982.8740927119406
SIM,1909,16,15-19,1925,19
SIM,1879,34,20-24,1913,1
STAT,1892,16,35-39,1908,0.7956210177435038
STAT,1888,58,na,1946,2682.758508193748
STAT,1863,102,na,1965,1.4220808912979155
SIM,1914,21,20-24,1935,2
STAT,1962,27,15-19,1989,1.0483891834284753
STAT,1810,44,30-34,1854,5.08924222789995
STAT,1987,25,15-19,2012,1.1691001609394347
SIM,1870,38,50-100,1908,2
SIM,1941,62,na,2003,3553
SIM,1914,17,35-39,1931,3
SIM,1972,15,30-34,1987,19
SIM,1926,0,na,1926,6574
STAT,1898,48,25-29,1946,0.050039135934956146
SIM,1835,28,20-24,1863,1
SIM,1856,46,na,1902,2022
STAT,1887,48,15-19,1935,5.108285160323357E-4
STAT,1918,27,20-24,1945,22.413980722564286
STAT,1806,51,na,1857,1191.3662133876219
SIM,1965,35,30-34,2000,3
STAT,1921,37,20-24,1958,0.3395581508669624
STAT,1841,38,30-34,1879,5.525184370880619
SIM,1855,30,na,1885,1916
SIM,1910,24,40-44,1934,7
STAT,1865,28,40-44,1893,3.10816969346644
SIM,1924,43,25-29,1967,1
STAT,1865,25,50-100,1890,0.6706025131190608
SIM,1958,30,25-29,1988,2
STAT,1898,110,na,2008,0.050655800642773495
SIM,1841,27,35-39,1868,2
SIM,1978,0,na,1978,6049
STAT,1907,26,50-100,1933,1.0899089728577718
SIM,1889,23,25-29,1912,163
STAT,1833,27,35-39,1860,9.09082715121425
SIM,1844,20,50-100,1864,1
STAT,1898,37,35-39,1935,11.031496467256277
STAT,1911,22,40-44,1933,3.683218143297495
STAT,1902,37,na,1939,3872.036382855149
STAT,1893,59,na,1952,2834.967183570644
STAT,1814,52,50-100,1866,0.04014671065318293
STAT,1906,17,35-39,1923,0.9234067035310526
SIM,1963,17,30-34,1980,45
STAT,1964,15,30-34,1979,17.726051885251486
STAT,1827,28,20-24,1855,32.129377102926554
STAT,1856,26,na,1882,2193.0837413173595
STAT,1856,37,30-34,1893,4.692422914936206
SIM,1896,33,45-49,1929,3
STAT,1831,29,25-29,1860,43.46668155827114
STAT,1850,53,35-39,1903,0.008720263952241824
STAT,1958,43,na,2001,5840.9564058879205
STAT,1955,24,20-24,1979,170.7983712044435
SIM,1967,21,35-39,1988,18
SIM,1774,88,na,1862,154
SIM,1891,77,na,1968,1551
SIM,1975,16,na,1991,5749
STAT,1888,33,45-49,1921,2.355641952492232
STAT,1842,18,45-49,1860,0.06416964098279627
STAT,1893,27,40-44,1920,4.369684596336422
STAT,1830,35,na,1865,1721.4101458701398
SIM,1850,29,35-39,1879,23
SIM,1978,21,45-49,1999,6
STAT,1930,16,15-19,1946,67.88714479535479
STAT,1882,43,50-100,1925,1.1822459917108172
STAT,1842,29,35-39,1871,9.050855336776888
STAT,1851,27,35-39,1878,8.958902308044332
SIM,1957,46,na,2003,6162
STAT,1842,36,25-29,1878,2.626212198691907
SIM,1947,49,35-39,1996,1
SIM,1887,62,na,1949,3047
STAT,1959,21,35-39,1980,14.265724221835193
SIM,1895,20,30-34,1915,71
SIM,1863,41,50-100,1904,2
STAT,1901,42,na,1943,3744.366302769664
STAT,1853,25,45-49,1878,1.299190974379734
STAT,1954,50,na,2004,5402.581775699169
STAT,1927,28,25-29,1955,91.99978149449538
STAT,1838,83,na,1921,343.8741180957664
SIM,1929,21,15-19,1950,14
STAT,1944,17,20-24,1961,168.38285661128594
STAT,1989,24,20-24,2013,184.28553013320635
SIM,1875,30,na,1905,3215
STAT,1917,24,35-39,1941,11.476971844323426
STAT,1896,110,na,2006,0.04867808483953613
SIM,1985,21,25-29,2006,177
SIM,1824,39,35-39,1863,4
STAT,1816,39,35-39,1855,21.861760156920425
SIM,1963,24,20-24,1987,192
STAT,1939,49,35-39,1988,0.15407160578592569
STAT,1821,49,50-100,1870,0.43226974408515684
SIM,1825,47,50-100,1872,2
SIM,1995,18,25-29,2013,100
STAT,1897,17,30-34,1914,2.4595538442990676
STAT,1892,46,30-34,1938,0.0792042713534043
STAT,1887,20,30-34,1907,23.174487769826086
SIM,1935,28,25-29,1963,110
SIM,1947,23,25-29,1970,2
STAT,1868,108,na,1976,0.06298433891404706
SIM,1937,27,30-34,1964,66
STAT,1885,38,50-100,1923,1.406256265240572
SIM,1850,36,25-29,1886,5
STAT,1930,49,50-100,1979,0.3417712582968012
SIM,1990,15,20-24,2005,413
STAT,1975,22,30-34,1997,43.90226044757507
SIM,1925,24,35-39,1949,20
STAT,1880,39,15-19,1919,0.0679992355307452
STAT,1866,49,40-44,1915,0.17930257831274188
STAT,1873,60,na,1933,2247.5918911935237
STAT,1843,24,50-100,1867,0.5062423140781107
STAT,1901,39,45-49,1940,0.6885344364248104
SIM,1861,25,45-49,1886,4
SIM,1848,36,35-39,1884,1
SIM,1886,41,50-100,1927,1
STAT,1861,27,na,1888,2306.282415827219
STAT,1929,27,30-34,1956,56.59488687398675
SIM,1948,29,50-100,1977,1
SIM,1931,37,na,1968,6114
SIM,1857,35,30-34,1892,4
STAT,1930,22,na,1952,5399.56280687288
STAT,1850,32,50-100,1882,0.9867082591039321
SIM,1836,23,45-49,1859,1
SIM,1913,36,25-29,1949,2
STAT,1908,45,40-44,1953,0.16718187897985035
STAT,1816,43,20-24,1859,0.3469533948890271
STAT,1921,38,50-100,1959,0.5402732110193487
STAT,1901,44,50-100,1945,0.1169879830639339
STAT,1977,20,40-44,1997,5.263865607808543
STAT,1817,49,45-49,1866,0.6547304127653402
STAT,1939,23,25-29,1962,107.06401647529357
STAT,1977,29,20-24,2006,28.55799442164312
SIM,1997,17,30-34,2014,53
SIM,1864,37,30-34,1901,1
SIM,1811,51,na,1862,1532
SIM,1883,28,35-39,1911,16
STAT,1865,20,45-49,1885,0.7455847233892088
STAT,1867,37,40-44,1904,4.716708624782871
STAT,1900,56,na,1956,3291.0461798097485
SIM,1956,22,20-24,1978,8
STAT,1843,46,35-39,1889,0.14162128038885535
STAT,1843,94,na,1937,20.0536499682826
STAT,1886,27,15-19,1913,0.5522971595987303
STAT,1877,23,40-44,1900,2.493768113269491
STAT,1916,36,35-39,1952,2.8725495668285648
STAT,1824,34,15-19,1858,0.23891439118814523
SIM,1809,47,na,1856,1746
SIM,1875,37,40-44,1912,12
SIM,1833,22,15-19,1855,5
SIM,1916,45,40-44,1961,1
STAT,1900,18,45-49,1918,0.10433049926780871
SIM,1914,24,25-29,1938,242
STAT,1966,16,na,1982,5307.025399640643
STAT,1843,53,na,1896,2125.759176463274
STAT,1905,36,25-29,1941,1.0430168825533355
STAT,1874,99,na,1973,19.164586247349938
STAT,1950,40,40-44,1990,0.35568165936949736
STAT,1911,18,20-24,1929,31.25381102563828
STAT,1964,25,25-29,1989,96.16813591914607
SIM,1826,50,na,1876,1624
STAT,1954,39,25-29,1993,1.4441134847428314
STAT,1866,24,50-100,1890,0.4334671766496211
SIM,1918,32,50-100,1950,2
STAT,1864,32,45-49,1896,1.7969068900585914
STAT,1881,21,40-44,1902,2.3265511794210605
STAT,1889,36,30-34,1925,7.618184677319761
STAT,1957,57,na,2014,5559.075341883295
STAT,1942,33,25-29,1975,11.35710972110878
STAT,1980,19,30-34,1999,19.514408605811404
STAT,1806,49,35-39,1855,0.49913478580424175
STAT,1892,39,40-44,1931,6.268043929922154
STAT,2000,15,25-29,2015,74.4135485669226
SIM,1972,25,25-29,1997,217
STAT,1951,17,na,1968,5058.2387882032
SIM,1905,6,na,1911,4639
STAT,1883,5,na,1888,2988.5421181714346
SIM,1872,28,25-29,1900,83
SIM,1873,20,45-49,1893,1
SIM,1950,33,25-29,1983,20
STAT,1875,28,35-39,1903,11.466762263616483
SIM,1938,37,40-44,1975,2
STAT,1828,49,20-24,1877,0.01076371143836869
STAT,1938,28,35-39,1966,17.165483169819126
STAT,1997,15,15-19,2012,76.51968915918653
STAT,1892,33,na,1925,3437.076315678869
SIM,1883,35,50-100,1918,1
SIM,1909,20,35-39,1929,17
STAT,1846,26,15-19,1872,0.5715132907601354
SIM,1890,27,30-34,1917,2
SIM,1904,38,na,1942,4059
STAT,1976,33,25-29,2009,14.51666579642059
STAT,1889,29,40-44,1918,4.230940146007363
STAT,1906,24,25-29,1930,95.73389335236445
STAT,1942,58,na,2000,4372.559780856528
SIM,1824,36,30-34,1860,12
STAT,1862,67,na,1929,1543.8950250565033
SIM,1894,27,15-19,1921,1
STAT,1866,16,40-44,1882,0.2020029111123107
STAT,1943,29,20-24,1972,22.415359887756885
STAT,1810,47,35-39,1857,0.5448063474431112
STAT,1838,35,20-24,1873,0.8227656270536081
STAT,1915,55,na,1970,4138.872286052103
SIM,1893,48,na,1941,3238
STAT,1854,49,15-19,1903,3.190744241433792E-4
STAT,1875,35,50-100,1910,1.4781060825147927
SIM,1840,39,35-39,1879,17
STAT,1857,33,15-19,1890,0.12745738821367117
STAT,1890,52,na,1942,3020.144638263291
SIM,1872,35,15-19,1907,4
STAT,1832,39,35-39,1871,6.080258937909396
STAT,1993,19,na,2012,6107.405628837881
SIM,1861,57,na,1918,1487
STAT,1913,74,na,1987,2857.870581703844
SIM,1885,23,40-44,1908,7
SIM,1946,28,35-39,1974,40
STAT,1981,27,20-24,2008,29.583948839360776
STAT,1875,85,na,1960,477.36997099171646
SIM,1897,29,40-44,1926,7
STAT,1882,27,30-34,1909,28.38541513042238
STAT,1928,49,25-29,1977,0.07764981525827702
STAT,1938,35,25-29,1973,1.157348059575449
STAT,1931,26,25-29,1957,98.13290060609982
STAT,1839,48,35-39,1887,0.11168207884690681
STAT,1916,43,25-29,1959,0.08432659997474
STAT,1812,108,na,1920,8.041877465509596E-4
STAT,1799,64,na,1863,1138.377810024391
STAT,1839,30,45-49,1869,1.7375774831634834
STAT,1829,27,na,1856,2038.1983561393372
STAT,1982,19,50-100,2001,0.6080046301587604
SIM,1924,36,35-39,1960,5
SIM,1946,36,na,1982,4649
SIM,1986,17,20-24,2003,262
STAT,1896,21,35-39,1917,8.921795764995121
SIM,1840,21,45-49,1861,1
SIM,1905,38,40-44,1943,2
STAT,1860,86,na,1946,206.3689583641768
SIM,1973,39,na,2012,5375
SIM,1913,63,na,1976,3881
STAT,1888,2,na,1890,3616.16655994134
SIM,1959,33,45-49,1992,7
SIM,1879,37,25-29,1916,8
STAT,1964,18,35-39,1982,6.097225607193015
SIM,1962,29,30-34,1991,119
STAT,1864,25,20-24,1889,12.217783664110295
SIM,1965,38,35-39,2003,6
SIM,1810,55,na,1865,1279
SIM,1846,28,30-34,1874,48
STAT,1898,45,20-24,1943,0.010662729019601977
SIM,1867,31,25-29,1898,30
SIM,1984,26,35-39,2010,31
STAT,1978,24,45-49,2002,1.7767590738966956
STAT,1844,24,40-44,1868,2.145042475902884
STAT,1929,14,na,1943,5817.024372994457
STAT,1876,26,na,1902,2856.842159190063
STAT,1888,30,40-44,1918,5.93036847040483
SIM,1903,17,25-29,1920,19
STAT,1769,98,na,1867,0.8217922557035378
STAT,1880,29,20-24,1909,14.247830035283233
SIM,1861,16,na,1877,2148
STAT,1901,36,40-44,1937,1.5346775857979342
SIM,1850,26,30-34,1876,52
SIM,1847,30,45-49,1877,2
STAT,1956,27,40-44,1983,7.148527028211916
STAT,1929,41,45-49,1970,0.24910453753202172
SIM,1852,24,40-44,1876,3
SIM,1955,49,30-34,2004,1
STAT,1848,17,35-39,1865,0.7227379766240051
STAT,1904,26,15-19,1930,0.7544648274965313
STAT,1856,71,na,1927,1175.2242379723612
STAT,1917,9,na,1926,4927.703570553984
STAT,1926,18,15-19,1944,64.03225523582566
SIM,1896,30,40-44,1926,1
STAT,1824,80,na,1904,382.75719686717815
SIM,1874,16,40-44,1890,1
SIM,1976,20,50-100,1996,4
STAT,1819,54,50-100,1873,0.0268772557098981
STAT,1949,42,25-29,1991,0.09960387597210381
STAT,1841,15,25-29,1856,6.57522479490854
STAT,1887,73,na,1960,1721.141867854211
STAT,1968,20,50-100,1988,0.9522349570303339
STAT,1954,29,30-34,1983,56.08651080755463
STAT,1863,18,50-100,1881,0.05103404008181826
STAT,1968,35,40-44,2003,2.2268951668071293
SIM,1830,65,na,1895,1170
SIM,1819,42,35-39,1861,1
SIM,1856,17,35-39,1873,1
SIM,1957,35,35-39,1992,1
SIM,1938,73,na,2011,2981
SIM,1860,31,na,1891,2498
STAT,1964,35,na,1999,5643.591884055586
SIM,1857,42,20-24,1899,1
SIM,1928,62,na,1990,5036
STAT,1890,18,25-29,1908,7.969832440409561
SIM,1837,41,40-44,1878,8
SIM,1897,36,30-34,1933,2
STAT,1872,16,15-19,1888,6.940470836669675
SIM,1885,81,na,1966,1356
STAT,1950,21,50-100,1971,0.9011285582703759
STAT,1966,16,45-49,1982,0.7202527740213155
SIM,1976,35,40-44,2011,1
STAT,1838,28,30-34,1866,27.55290533915597
STAT,1975,17,50-100,1992,0.5704018753599052
STAT,1850,24,15-19,1874,4.017933195383073
STAT,1892,49,35-39,1941,0.11184234030971225
SIM,1853,31,50-100,1884,2
STAT,1852,15,35-39,1867,0.6331277327031649
SIM,1843,83,na,1926,156
SIM,1926,34,45-49,1960,2
SIM,1991,18,40-44,2009,2
STAT,1917,21,30-34,1938,35.35955723092685
SIM,1845,32,35-39,1877,3
SIM,1974,16,45-49,1990,2
STAT,1945,21,na,1966,4620.408287305663
STAT,1849,42,20-24,1891,0.12293938878923598
STAT,1842,33,20-24,1875,2.4868213986090115
SIM,1901,19,15-19,1920,17
SIM,1950,26,35-39,1976,39
STAT,1934,35,40-44,1969,2.3893402179335412
STAT,1843,39,45-49,1882,2.08125528889197
SIM,1872,18,30-34,1890,8
SIM,1834,25,35-39,1859,27
STAT,1842,26,30-34,1868,24.137232650754548
SIM,1874,34,na,1908,2626
SIM,1850,33,20-24,1883,2
STAT,1983,18,40-44,2001,2.282737638337124
STAT,1837,32,35-39,1869,9.1944092744516
STAT,1923,28,40-44,1951,6.151745998353114
SIM,1964,27,40-44,1991,15
SIM,1986,24,45-49,2010,1
STAT,1867,8,na,1875,2972.457354056632
STAT,1949,35,35-39,1984,3.3503583019932486
STAT,1864,18,30-34,1882,1.6890081527701692
SIM,1931,28,40-44,1959,22
SIM,1942,35,40-44,1977,3
STAT,1865,39,30-34,1904,5.49360242554182
SIM,1872,25,20-24,1897,25
SIM,1895,38,20-24,1933,3
STAT,1897,27,25-29,1924,65.27675316567253
STAT,1849,35,30-34,1884,4.315586372706446
STAT,1955,47,15-19,2002,5.870075964371837E-4
STAT,1948,22,20-24,1970,147.33691448994557
STAT,1918,34,45-49,1952,1.9127989664616556
SIM,1972,18,35-39,1990,1
SIM,1874,26,35-39,1900,28
SIM,1883,35,25-29,1918,2
SIM,1846,49,na,1895,1476
SIM,1925,21,30-34,1946,47
SIM,1867,24,35-39,1891,19
SIM,1873,39,30-34,1912,1
STAT,1859,31,25-29,1890,9.454554459495872
STAT,1852,22,25-29,1874,64.11612937511713
STAT,1875,35,25-29,1910,3.4663277902860026
STAT,1987,23,na,2010,6034.219818931624
SIM,1858,82,na,1940,599
SIM,1860,22,25-29,1882,63
SIM,1848,26,40-44,1874,6
STAT,1833,24,30-34,1857,17.20850257913584
STAT,1911,25,45-49,1936,1.9591904114048764
SIM,1841,24,30-34,1865,27
SIM,1927,22,na,1949,4783
STAT,1850,50,30-34,1900,0.006215887975569631
STAT,1903,23,na,1926,3875.600260365929
SIM,1826,34,40-44,1860,9
STAT,1890,25,15-19,1915,0.6441155608175803
STAT,1933,17,45-49,1950,0.7720618990706866
STAT,1942,26,35-39,1968,18.196235185859635
STAT,1841,72,na,1913,1122.8274243418846
SIM,1851,39,45-49,1890,5
SIM,1941,17,45-49,1958,1
STAT,1860,16,45-49,1876,0.07048749751253038
SIM,1889,29,35-39,1918,19
SIM,1859,67,na,1926,1237
SIM,1970,21,40-44,1991,12
STAT,1973,38,25-29,2011,1.5124917270165168
STAT,1815,43,25-29,1858,1.3913478704105073
STAT,1849,39,40-44,1888,3.4004395943758445
STAT,1900,103,na,2003,7.627895426638563
STAT,1976,27,50-100,2003,1.5412646569998318
STAT,1855,45,20-24,1900,0.010312543662959379
SIM,1892,7,na,1899,4149
STAT,1814,59,na,1873,1544.9069855386058
STAT,1865,27,50-100,1892,0.666083583379288
SIM,1813,41,45-49,1854,1
STAT,1864,35,15-19,1899,0.05841353656889457
STAT,1835,24,40-44,1859,1.7179549445890643
SIM,1843,24,40-44,1867,3
SIM,1907,22,25-29,1929,201
SIM,1892,61,na,1953,3025
SIM,1930,52,na,1982,5817
STAT,1890,44,50-100,1934,1.4696156680908339
STAT,1845,26,20-24,1871,9.69174247433118
SIM,1848,44,40-44,1892,7
STAT,1885,18,45-49,1903,0.07499633381783835
STAT,1979,26,25-29,2005,105.08651097840503
STAT,1856,50,na,1906,1922.9977368237603
STAT,1798,71,na,1869,550.4001652585247
SIM,1839,35,30-34,1874,10
STAT,1936,31,40-44,1967,4.391766132693971
SIM,1985,4,na,1989,6450
STAT,1884,31,25-29,1915,11.726559505247423
SIM,1848,33,30-34,1881,2
SIM,1892,26,50-100,1918,1
STAT,1962,21,40-44,1983,4.989921563155485
STAT,1912,27,50-100,1939,1.1330610719716792
STAT,1824,38,25-29,1862,4.314438146331336
STAT,1875,44,35-39,1919,2.130418100185862
STAT,1984,24,40-44,2008,5.525568571691897
STAT,1993,19,40-44,2012,2.320858567111448
SIM,1832,38,25-29,1870,3
STAT,1856,16,25-29,1872,5.9344362448622165
SIM,1865,40,25-29,1905,1
STAT,1810,45,na,1855,1710.9207524474882
STAT,1852,41,30-34,1893,1.0888271460237924
SIM,1854,36,na,1890,2592
STAT,1866,35,25-29,1901,3.109016358666913
SIM,1864,16,25-29,1880,16
SIM,1883,44,35-39,1927,5
STAT,1893,37,35-39,1930,10.31740167154143
SIM,1858,42,50-100,1900,1
STAT,1820,41,40-44,1861,2.8671907665881577
STAT,1874,28,40-44,1902,3.526643059310909
STAT,1893,40,35-39,1933,2.668120993736056
SIM,1809,92,na,1901,33
STAT,1879,37,30-34,1916,6.42224185175991
STAT,1838,45,15-19,1883,3.6578177394065194E-4
STAT,1981,32,45-49,2013,2.5883702131297537
SIM,1855,29,35-39,1884,2
STAT,1889,77,na,1966,1648.3034646724889
SIM,1841,47,35-39,1888,1
SIM,1806,52,na,1858,1455
SIM,1944,31,40-44,1975,10
STAT,1834,26,45-49,1860,1.3382590415531908
STAT,1841,33,25-29,1874,10.934886005023296
STAT,1833,47,35-39,1880,0.11619470937997636
SIM,1943,19,na,1962,4800
SIM,1968,6,na,1974,5398
STAT,1931,39,45-49,1970,1.0399380597756047
SIM,1838,26,25-29,1864,8
STAT,1849,54,35-39,1903,0.0064891158555409004
STAT,1853,20,40-44,1873,2.4869051073400232
STAT,1847,29,35-39,1876,8.796076667791988
SIM,1982,15,25-29,1997,171
STAT,1889,21,na,1910,3374.603022604487
STAT,1813,48,20-24,1861,0.03917392633064936
STAT,1841,22,15-19,1863,3.7156914131572774
STAT,1899,25,35-39,1924,15.359134720485255
SIM,1975,29,40-44,2004,4
STAT,1904,20,40-44,1924,3.4739325265241088
SIM,1908,31,30-34,1939,4
STAT,1896,18,20-24,1914,26.952552818700227
STAT,1897,72,na,1969,2382.3104936880613
STAT,1881,89,na,1970,345.63495311362266
SIM,1882,28,40-44,1910,5
STAT,1845,46,45-49,1891,0.1594812731889085
STAT,1870,35,45-49,1905,2.289577874820339
STAT,1882,36,20-24,1918,0.8730945518503239
SIM,1877,96,na,1973,183
STAT,1942,39,20-24,1981,0.32689340135821077
STAT,1823,104,na,1927,0.03777142190006138
SIM,1853,26,20-24,1879,21
STAT,1881,35,20-24,1916,0.8662033755774211
SIM,1950,39,20-24,1989,1
SIM,1874,22,50-100,1896,3
SIM,1912,20,40-44,1932,10
STAT,1974,15,25-29,1989,65.33761882727373
SIM,1965,23,25-29,1988,258
STAT,1920,49,40-44,1969,0.19986506654228753
SIM,1938,40,na,1978,4067
STAT,1880,26,15-19,1906,0.5568922275971786
STAT,1935,55,na,1990,5800.772598517503
SIM,1861,20,40-44,1881,6
SIM,1966,32,30-34,1998,66
STAT,1871,33,40-44,1904,4.95808675342547
SIM,1873,82,na,1955,471
SIM,1905,53,na,1958,3736
SIM,1922,57,na,1979,4716
STAT,1957,23,25-29,1980,140.96414760404568
STAT,1958,32,30-34,1990,24.342112522795095
STAT,1868,44,50-100,1912,1.1555484943611167
STAT,1931,41,na,1972,5735.343955806028
STAT,1889,40,15-19,1929,0.01984366878149366
SIM,1989,22,na,2011,6261
SIM,1853,46,45-49,1899,1
SIM,1855,61,na,1916,1452
STAT,1920,38,30-34,1958,2.299595570879351
STAT,1857,25,30-34,1882,23.65154257721779
STAT,1921,63,na,1984,4292.408808968149
STAT,1878,17,15-19,1895,7.150869948942365
SIM,1785,73,na,1858,552
STAT,1891,45,30-34,1936,0.07865807088199447
STAT,1847,53,50-100,1900,0.011434290695275903
SIM,1850,31,20-24,1881,2
SIM,1877,27,20-24,1904,3
SIM,1827,36,20-24,1863,1
STAT,1867,47,35-39,1914,0.15014511726869495
STAT,1980,20,35-39,2000,15.145388625826504
SIM,1926,15,na,1941,5452
SIM,1875,47,35-39,1922,1
STAT,1851,52,25-29,1903,0.0027938452302602827
STAT,1827,77,na,1904,701.9904879647256
STAT,1985,25,40-44,2010,7.69034203588015
STAT,1867,50,35-39,1917,0.009409463996783565
STAT,1814,45,50-100,1859,0.7053266504263626
STAT,1886,18,50-100,1904,0.0594821076039927
STAT,1862,41,45-49,1903,1.4642217911631614
STAT,1871,36,45-49,1907,2.299790641894364
STAT,1980,31,45-49,2011,2.571206110267489
SIM,1949,15,40-44,1964,1
STAT,1991,23,15-19,2014,8.830099523845648
SIM,1887,37,30-34,1924,15
SIM,1888,17,25-29,1905,1
STAT,1876,45,35-39,1921,0.1686821279903575
SIM,1842,26,45-49,1868,3
STAT,1873,19,35-39,1892,0.6431803155533173
STAT,1910,102,na,2012,14.87014267073707
SIM,1865,25,30-34,1890,55
SIM,1934,21,30-34,1955,121
SIM,1913,40,na,1953,4628
STAT,1807,54,30-34,1861,0.022448673628189898
STAT,1905,49,45-49,1954,0.21771671587259206
SIM,1969,28,15-19,1997,1
SIM,1856,38,40-44,1894,10
SIM,1821,49,na,1870,1472
STAT,1850,28,50-100,1878,0.7693925807281508
STAT,1970,31,30-34,2001,23.213651345563683
SIM,1892,53,na,1945,3433
SIM,1831,37,25-29,1868,6
SIM,1913,49,45-49,1962,1
STAT,1809,80,na,1889,310.5602169969045
STAT,1990,22,15-19,2012,8.826747137755653
STAT,1851,43,35-39,1894,1.425592865949461
STAT,1973,24,20-24,1997,166.39825616065923
STAT,1926,21,30-34,1947,40.409419906687695
STAT,1823,37,25-29,1860,5.396218263578896
SIM,1934,58,na,1992,5287
SIM,1876,79,na,1955,938
STAT,1819,36,20-24,1855,2.4745038862990794
STAT,1869,30,50-100,1899,1.0322347314179798
STAT,1800,59,na,1859,1348.618340937084
STAT,1970,42,40-44,2012,0.37551466994503446
STAT,1877,24,45-49,1901,0.8318557747041236
STAT,1886,47,15-19,1933,4.8465398442988216E-4
STAT,1850,28,25-29,1878,50.878203256228964
SIM,1862,31,na,1893,2815
SIM,1868,30,50-100,1898,1
SIM,1987,26,25-29,2013,229
STAT,1846,100,na,1946,1.097509636043274
STAT,1861,17,45-49,1878,0.07203293243282134
STAT,1883,15,30-34,1898,1.8079870178715873
SIM,1854,44,na,1898,2434
STAT,1882,30,50-100,1912,1.0411075707630213
STAT,1847,51,20-24,1898,5.705119675178038E-4
STAT,1825,53,35-39,1878,0.01135701810136482
STAT,1851,59,na,1910,1541.157019859218
SIM,1809,49,na,1858,1673
STAT,1841,54,50-100,1895,0.013058452809431865
STAT,1856,46,20-24,1902,0.010595388855066595
SIM,1841,44,30-34,1885,3
STAT,1944,20,35-39,1964,11.741183031450777
SIM,1966,35,25-29,2001,4
STAT,1840,67,na,1907,1271.664160533593
STAT,1937,21,50-100,1958,0.7401104598279358
STAT,1850,27,40-44,1877,3.628982565755049
STAT,1872,29,15-19,1901,0.5219938598471145
STAT,1901,11,na,1912,4180.810829641642
SIM,1867,62,na,1929,1649
STAT,1871,19,25-29,1890,6.471229342493394
STAT,1950,20,na,1970,5002.957521852475
STAT,1909,21,25-29,1930,99.48431149953215
STAT,1948,25,25-29,1973,87.37864302463545
STAT,1965,44,25-29,2009,0.1065645499850414
STAT,1905,25,na,1930,4013.307157243612
SIM,1870,41,45-49,1911,5
SIM,1977,24,45-49,2001,2
STAT,1879,49,25-29,1928,0.067959878110867
SIM,1877,47,45-49,1924,1
STAT,1843,18,40-44,1861,0.23314641366767166
SIM,1884,66,na,1950,1847
STAT,1872,32,15-19,1904,0.16502232670512906
SIM,1939,30,20-24,1969,1
SIM,1870,30,35-39,1900,28
SIM,1973,33,15-19,2006,4
SIM,1956,25,25-29,1981,9
STAT,1918,1,na,1919,5244.510949617885
STAT,1866,34,40-44,1900,4.599104548880158
STAT,1969,37,20-24,2006,0.3915214593776863
STAT,1897,64,na,1961,2848.904659230162
SIM,1874,34,40-44,1908,3
STAT,1828,46,15-19,1874,3.7320314121083465E-4
SIM,1937,17,15-19,1954,47
SIM,1926,49,30-34,1975,1
STAT,1805,98,na,1903,1.3349806542662852
STAT,1855,48,25-29,1903,0.048395750584802714
SIM,1863,36,30-34,1899,10
STAT,1947,34,20-24,1981,3.2279122197985752
STAT,1883,80,na,1963,979.4197352576681
STAT,1887,94,na,1981,167.70727672079693
STAT,1957,20,20-24,1977,169.86640382041193
STAT,1921,71,na,1992,3644.7495823641857
SIM,1971,17,15-19,1988,2
STAT,1771,109,na,1880,0.0038836491866193626
SIM,1888,49,40-44,1937,1
STAT,1848,109,na,1957,0.0010416432777453676
STAT,1894,41,35-39,1935,2.6985686167928375
STAT,1813,105,na,1918,0.013425122648919001
STAT,1940,31,50-100,1971,0.9884051134898301
STAT,1979,23,20-24,2002,177.21168254146068
SIM,1949,24,na,1973,5199
SIM,1970,24,45-49,1994,2
SIM,1945,10,na,1955,4776
SIM,1897,92,na,1989,12
STAT,1918,43,na,1961,4548.830875976884
SIM,1883,41,30-34,1924,2
STAT,1939,13,na,1952,4561.974320784922
STAT,1984,27,45-49,2011,2.8439034449548966
STAT,1961,2,na,1963,5867.422822537694
STAT,1834,40,25-29,1874,0.724813837197219
SIM,1998,4,na,2002,6866
STAT,1762,112,na,1874,0.0010130432504501061
STAT,1862,11,na,1873,2674.977438073526
STAT,1839,78,na,1917,619.6357311985828
SIM,1856,70,na,1926,1294
STAT,1913,76,na,1989,2629.008106165969
SIM,1955,34,20-24,1989,4
STAT,1918,49,30-34,1967,0.10881368747523894
STAT,1962,24,45-49,1986,1.668131306222268
SIM,1834,30,25-29,1864,14
STAT,1898,43,20-24,1941,0.017076373333614267
STAT,1849,51,30-34,1900,0.004635706414829986
STAT,1858,41,25-29,1899,0.5807408648269843
SIM,1873,34,25-29,1907,4
SIM,1965,20,20-24,1985,316
STAT,1833,44,30-34,1877,0.9621587851766379
STAT,1830,97,na,1927,3.3700982318261614
SIM,1908,99,na,2007,30
STAT,1855,36,30-34,1891,4.556740767391823
STAT,1874,29,25-29,1903,49.619702569844804
SIM,1895,58,na,1953,2958
STAT,1788,93,na,1881,10.515850045322622
STAT,1815,40,20-24,1855,0.4287843987723156
SIM,1947,3,na,1950,6173
STAT,1860,30,25-29,1890,9.603312160684432
SIM,1842,40,25-29,1882,1
STAT,1778,104,na,1882,0.044488528826181824
STAT,1963,17,15-19,1980,66.53925579771435
STAT,1834,47,na,1881,2177.442719209279
STAT,1964,12,na,1976,5709.637565554737
STAT,1835,27,45-49,1862,0.9053262183544861
STAT,1904,23,45-49,1927,1.1520438459179623
SIM,1898,35,40-44,1933,17
STAT,1997,18,50-100,2015,0.6311611195769536
SIM,1817,44,na,1861,1525
SIM,1882,29,25-29,1911,113
STAT,1848,38,40-44,1886,4.743658190231221
STAT,1868,51,35-39,1919,0.009591117444398922
STAT,1958,35,35-39,1993,3.7836174655969943
STAT,1826,30,25-29,1856,10.894678484546777
SIM,1832,42,50-100,1874,2
SIM,1872,23,20-24,1895,81
STAT,1992,18,40-44,2010,2.316209625582889
STAT,1834,23,40-44,1857,2.5250352203885105
SIM,1879,28,50-100,1907,1
STAT,1845,98,na,1943,2.189045420643863
SIM,1810,65,na,1875,814
SIM,1979,30,50-100,2009,2
SIM,1906,9,na,1915,4010
STAT,1841,18,30-34,1859,1.8169136018251195
SIM,1832,37,40-44,1869,4
STAT,1891,24,25-29,1915,81.13931050696218
STAT,1931,36,40-44,1967,2.2905590499529396
SIM,1814,79,na,1893,318
STAT,1824,37,40-44,1861,6.7110707300526595
STAT,1875,41,30-34,1916,1.3772929197625698
STAT,1881,38,25-29,1919,3.1890217740462785
SIM,1843,52,na,1895,1645
SIM,1798,91,na,1889,17
STAT,1820,44,45-49,1864,1.722670321536916
STAT,1833,54,na,1887,1500.6487012722457
STAT,1965,30,20-24,1995,3.586207298941412
STAT,1968,21,35-39,1989,13.621575107185055
SIM,1876,23,na,1899,2429
SIM,1916,38,50-100,1954,1
STAT,1864,23,20-24,1887,71.63415045007076
SIM,1970,35,45-49,2005,1
STAT,1942,33,na,1975,4647.290944098752
STAT,1883,51,30-34,1934,0.006753135038010393
STAT,1800,67,na,1867,1018.4376083194027
STAT,1830,30,45-49,1860,1.9626285882760761
STAT,1946,47,na,1993,4891.208422766736
STAT,1842,31,20-24,1873,2.539006334915269
STAT,1852,44,35-39,1896,1.6842147567727896
SIM,1831,25,30-34,1856,4
SIM,1834,49,45-49,1883,2
STAT,1892,9,na,1901,3752.9664029197183
SIM,1949,39,50-100,1988,1
STAT,1844,45,45-49,1889,0.2005086569659166
SIM,1842,43,na,1885,2140
SIM,1976,21,35-39,1997,19
SIM,1980,19,na,1999,5983
STAT,1974,28,na,2002,5666.85487509285
STAT,1841,30,20-24,1871,2.9770637241780866
STAT,1895,17,20-24,1912,26.63165760397131
SIM,1847,74,na,1921,1301
SIM,1871,39,20-24,1910,2
STAT,1888,36,15-19,1924,0.076544500218331
STAT,1859,28,45-49,1887,1.0308701255249502
STAT,1886,80,na,1966,1130.6092564998592
SIM,1926,30,35-39,1956,23
SIM,1809,57,na,1866,1424
STAT,1846,72,na,1918,1305.5581449915028
SIM,1868,41,35-39,1909,7
STAT,1982,23,na,2005,5947.872007221785
SIM,1944,34,45-49,1978,2
STAT,1860,18,50-100,1878,0.05224470011335891
STAT,1905,33,na,1938,4002.850177605391
SIM,1849,24,35-39,1873,9
SIM,1918,20,35-39,1938,12
STAT,1936,34,45-49,1970,1.7626577244525903
STAT,1863,39,20-24,1902,0.7700425150845213
STAT,1902,68,na,1970,2903.5614821152567
STAT,1808,55,na,1863,1502.3218867741007
STAT,1826,49,45-49,1875,0.16544239077278303
STAT,1918,30,35-39,1948,11.294369681156118
SIM,1985,18,45-49,2003,1
SIM,1861,23,45-49,1884,1
SIM,1927,78,na,2005,1997
SIM,1939,33,25-29,1972,22
STAT,1900,41,35-39,1941,0.20227619744336964
STAT,1970,34,35-39,2004,13.439326450254113
STAT,1975,38,35-39,2013,3.7900204571712823
STAT,1847,46,na,1893,1736.0648306302837
STAT,1892,25,25-29,1917,61.60133514821118
STAT,1860,105,na,1965,0.1598308995383654
STAT,1905,46,40-44,1951,0.16176276698744874
STAT,1838,85,na,1923,237.45799383802898
STAT,1876,53,40-44,1929,0.012357610788955219
STAT,1965,41,20-24,2006,0.026480787249510314
STAT,1969,22,35-39,1991,13.619106813557798
STAT,1854,24,na,1878,2017.4169927182727
STAT,1843,32,na,1875,2614.2627112571927
STAT,1858,38,na,1896,2110.5328337156234
STAT,1913,20,na,1933,4295.257548129014
STAT,1909,4,na,1913,4557.980917015987
STAT,1886,42,45-49,1928,1.8196337446901627
STAT,1970,45,45-49,2015,0.32811787043097795
STAT,1854,16,15-19,1870,5.817914306223159
STAT,1821,42,40-44,1863,4.3392194124651375
SIM,1916,86,na,2002,688
SIM,1817,37,45-49,1854,1
STAT,1898,34,30-34,1932,26.998431837403466
STAT,1976,31,25-29,2007,14.534101491747789
STAT,1853,23,45-49,1876,0.8144154265155117
SIM,1800,87,na,1887,90
SIM,1974,28,40-44,2002,15
STAT,1816,41,20-24,1857,0.373446433212195
STAT,1871,49,50-100,1920,0.27609231089787506
SIM,1913,46,40-44,1959,1
STAT,1944,39,30-34,1983,2.327111013945117
SIM,1940,19,na,1959,5047
SIM,1884,42,30-34,1926,1
SIM,1978,30,na,2008,5883
STAT,1832,24,15-19,1856,3.424400483924475
STAT,1828,26,15-19,1854,1.1544639100747205
STAT,1898,45,40-44,1943,0.152121594767859
STAT,1831,31,45-49,1862,1.7943265908731758
STAT,1838,33,20-24,1871,2.879940298228543
STAT,1872,64,na,1936,2014.413564738045
STAT,1914,69,na,1983,3381.0846612748505
SIM,1838,23,20-24,1861,63
STAT,1876,42,30-34,1918,1.3698413129127147
STAT,1815,48,30-34,1863,0.19473638443583216
STAT,1823,50,20-24,1873,7.307682173928467E-4
STAT,1860,53,50-100,1913,0.013821655160949969
SIM,1783,90,na,1873,38
STAT,1966,42,20-24,2008,0.026454867121654322
SIM,1952,39,30-34,1991,6
STAT,1877,54,40-44,1931,0.012290330488034386
SIM,1981,26,30-34,2007,129
SIM,1885,21,40-44,1906,1
STAT,1937,27,15-19,1964,0.7945957231087806
SIM,1871,48,na,1919,1938
SIM,1894,31,35-39,1925,6
SIM,1899,36,40-44,1935,3
SIM,1993,5,na,1998,6962
STAT,1982,25,15-19,2007,1.1523707006950439
STAT,1886,31,35-39,1917,12.37816950028741
SIM,1987,23,20-24,2010,370
STAT,1910,28,20-24,1938,20.291649660237574
SIM,1840,24,15-19,1864,1
STAT,1929,17,15-19,1946,66.84377976861141
SIM,1823,83,na,1906,469
SIM,1988,24,20-24,2012,7
STAT,1864,77,na,1941,890.7056066265283
STAT,1846,39,15-19,1885,0.059376172436489856
STAT,1883,101,na,1984,11.693044398446597
STAT,1887,43,45-49,1930,1.9216565598690762
STAT,1975,30,25-29,2005,14.35976030281205
STAT,1925,21,na,1946,5058.140920576381
STAT,1854,8,na,1862,2393.205306823452
SIM,1900,31,50-100,1931,2
STAT,1867,42,na,1909,2487.2680882873897
SIM,1847,44,25-29,1891,2
SIM,1972,2,na,1974,5842
SIM,1829,39,35-39,1868,17
STAT,1961,53,na,2014,5576.369142124062
STAT,1846,42,15-19,1888,0.01444918536801241
STAT,1929,35,na,1964,5584.007354595233
SIM,1825,31,na,1856,1823
STAT,1847,43,15-19,1890,0.010549273392270898
SIM,1983,30,25-29,2013,8
STAT,1808,50,25-29,1858,0.01757514334403371
SIM,1984,27,50-100,2011,3
STAT,1961,17,50-100,1978,0.55861190576459
SIM,1824,32,30-34,1856,7
SIM,1923,10,na,1933,5679
STAT,1879,46,20-24,1925,0.014501282381024326
STAT,1855,39,35-39,1894,5.95774566336049
STAT,1983,24,25-29,2007,151.19286590494102
STAT,1859,25,40-44,1884,2.842035048250214
STAT,1894,36,45-49,1930,2.9716498828403126
STAT,1885,31,40-44,1916,5.012435134520312
STAT,1839,44,25-29,1883,0.5231619069818105
STAT,1958,23,40-44,1981,5.1116013929172
STAT,1897,111,na,2008,0.019596774667503786
STAT,1825,38,40-44,1863,7.059264987834194
STAT,1825,67,na,1892,1121.2693743102764
SIM,1841,26,na,1867,2238
SIM,1833,38,40-44,1871,9
SIM,1967,38,45-49,2005,1
STAT,1881,44,50-100,1925,1.1600939893777091
STAT,1899,46,40-44,1945,0.15311914639767654
SIM,1824,43,40-44,1867,6
SIM,1899,15,35-39,1914,2
STAT,1936,35,50-100,1971,0.47678317561690814
SIM,1941,22,25-29,1963,1
STAT,1836,81,na,1917,492.13236019025413
STAT,1970,29,na,1999,5429.815599649849
SIM,1817,43,30-34,1860,3
SIM,1956,37,na,1993,5399
SIM,1977,33,35-39,2010,30
STAT,1992,14,na,2006,6504.511171977772
STAT,1802,93,na,1895,13.950965292073182
STAT,1885,27,35-39,1912,11.106970886311936
STAT,1834,24,25-29,1858,68.86876289059585
STAT,1861,80,na,1941,593.4857494710636
STAT,1870,54,na,1924,2382.345527030596
STAT,1974,38,40-44,2012,2.321736856222862
SIM,1833,82,na,1915,186
SIM,1973,29,30-34,2002,7
STAT,1913,22,50-100,1935,0.7362115011096316
STAT,1874,45,25-29,1919,0.06872980312601909
STAT,1994,6,na,2000,6546.7569819926375
SIM,1893,30,35-39,1923,9
STAT,1885,30,35-39,1915,11.751062980278297
SIM,1973,32,30-34,2005,26
SIM,1893,27,35-39,1920,18
SIM,1842,24,25-29,1866,154
STAT,1824,51,20-24,1875,9.872438734310886E-4
STAT,1874,47,na,1921,2645.676116494
SIM,1848,59,na,1907,1369
STAT,1990,10,na,2000,6493.838888880304
SIM,1843,33,30-34,1876,44
STAT,1933,22,25-29,1955,141.46044692790838
STAT,1919,31,35-39,1950,11.421830963950995
STAT,1823,34,20-24,1857,6.120229509857235
STAT,1865,34,25-29,1899,10.573862980085256
STAT,1920,47,20-24,1967,0.014091832183835048
STAT,1969,33,35-39,2002,13.42038396366434
STAT,1826,32,50-100,1858,0.8621972356971885
STAT,1973,29,35-39,2002,22.482987562342572
SIM,1942,31,30-34,1973,32
STAT,1849,45,50-100,1894,0.19225452964315412
STAT,1940,46,35-39,1986,0.15758029928009035
STAT,1856,49,25-29,1905,0.049655010929916206
SIM,1918,71,na,1989,2664
STAT,1823,53,25-29,1876,0.003304574275862193
SIM,1876,44,50-100,1920,3
STAT,1829,51,50-100,1880,0.01517663190553697
SIM,1962,22,na,1984,5552
STAT,1827,33,45-49,1860,2.877193933733248
STAT,1882,42,na,1924,2602.0566216501825
STAT,1891,16,na,1907,3611.165292599755
STAT,1904,46,25-29,1950,0.053997910725962904
STAT,1850,41,20-24,1891,0.16422919775635786
SIM,1811,82,na,1893,416
STAT,1984,22,20-24,2006,182.8573555218764
STAT,1907,32,25-29,1939,9.986304903935023
SIM,1992,22,20-24,2014,12
STAT,1823,63,na,1886,1042.0765291777611
SIM,1820,56,na,1876,1635
SIM,1867,37,35-39,1904,22
STAT,1843,34,40-44,1877,5.123674626546174
STAT,1873,16,30-34,1889,1.8894880508971261
STAT,1884,54,na,1938,2387.6391491602303
SIM,1867,40,35-39,1907,3
SIM,1831,34,20-24,1865,2
STAT,1908,41,30-34,1949,0.13746421228585484
STAT,1858,27,45-49,1885,1.0232761582789858
STAT,1842,22,30-34,1864,17.288567017686635
STAT,1929,33,15-19,1962,0.18826628124896183
SIM,1831,28,35-39,1859,1
SIM,1851,34,40-44,1885,13
STAT,1871,49,20-24,1920,0.013489852858098958
SIM,1989,9,na,1998,6751
SIM,1819,70,na,1889,324
STAT,1861,29,na,1890,2273.283094729553
SIM,1927,31,35-39,1958,10
STAT,1874,26,20-24,1900,13.907654896608763
SIM,1989,23,30-34,2012,118
STAT,1842,33,40-44,1875,3.9897909783275676
SIM,1850,33,40-44,1883,3
SIM,1882,26,20-24,1908,18
STAT,1985,28,45-49,2013,2.846572168132523
STAT,1867,49,50-100,1916,0.2591058608652058
STAT,1965,33,25-29,1998,13.565320675651176
STAT,1848,39,na,1887,2526.669496327646
STAT,1938,20,na,1958,4175.870763730176
SIM,1902,88,na,1990,248
SIM,1874,13,na,1887,2888
SIM,1931,61,na,1992,5520
STAT,1857,45,30-34,1902,0.08787227491876778
SIM,1866,27,45-49,1893,2
STAT,1945,21,35-39,1966,11.91341441384822
SIM,1953,21,35-39,1974,1
SIM,1857,7,na,1864,3013
SIM,1881,25,20-24,1906,30
SIM,1833,74,na,1907,696
STAT,1822,38,15-19,1860,0.1299293721697129
STAT,1846,80,na,1926,639.4937711929277
STAT,1863,35,50-100,1898,1.2506939448800094
STAT,1896,112,na,2008,0.007106562984773142
SIM,1881,29,30-34,1910,24
STAT,1841,54,30-34,1895,0.005146816918641627
STAT,1861,23,30-34,1884,17.430379130150254
STAT,1826,46,40-44,1872,0.12480194160715033
STAT,1991,19,30-34,2010,20.145346344259103
STAT,1882,39,25-29,1921,3.2128099931142726
STAT,1916,17,na,1933,4729.493937632788
STAT,1955,23,15-19,1978,8.179434258382171
SIM,1820,34,45-49,1854,4
STAT,1966,44,40-44,2010,0.37343477425680666
SIM,1881,44,25-29,1925,1
SIM,1890,39,25-29,1929,7
SIM,1860,41,30-34,1901,1
STAT,1873,29,30-34,1902,29.464508995502865
SIM,1958,25,35-39,1983,62
STAT,1991,22,30-34,2013,47.69172711720759
STAT,1873,33,15-19,1906,0.16711777282311593
STAT,1912,25,50-100,1937,1.140748130327231
STAT,1878,37,15-19,1915,0.06766375139718141
STAT,1981,30,na,2011,6228.1278866050625
SIM,1974,33,30-34,2007,8
STAT,1836,73,na,1909,1080.9354412176178
SIM,1895,40,40-44,1935,1
STAT,1882,15,15-19,1897,6.720595115270424
SIM,1871,42,45-49,1913,3
SIM,1915,32,25-29,1947,21
SIM,1985,15,40-44,2000,6
STAT,1822,41,15-19,1863,0.028992586137200536
STAT,1930,36,25-29,1966,1.4836735570086432
STAT,1992,22,na,2014,6069.138207601315
SIM,1825,44,40-44,1869,7
SIM,1822,45,50-100,1867,1
STAT,1873,44,25-29,1917,0.7465604986599003
SIM,1875,34,35-39,1909,30
SIM,1968,46,45-49,2014,1
SIM,1871,4,na,1875,2548
SIM,1880,28,na,1908,3282
STAT,1949,12,na,1961,5272.2441518626065
STAT,1867,34,35-39,1901,10.818373992830466
STAT,1952,41,50-100,1993,0.16908910313490175
STAT,1835,33,30-34,1868,13.736716910150001
STAT,1817,44,40-44,1861,6.580715498079821
STAT,1847,54,25-29,1901,0.002650470054276796
SIM,1832,44,na,1876,2045
SIM,1841,18,na,1859,2396
STAT,1847,26,30-34,1873,23.45777730881026
SIM,1981,29,35-39,2010,3
STAT,1934,31,30-34,1965,24.851545572029117
STAT,1816,85,na,1901,135.3812435180073
STAT,1823,42,15-19,1865,0.01450996399451464
STAT,1887,40,40-44,1927,2.938393473467666
SIM,1864,25,15-19,1889,5
STAT,1863,42,45-49,1905,1.5084154162278574
STAT,1978,17,na,1995,5797.081784064888
SIM,1984,15,35-39,1999,16
STAT,1972,42,15-19,2014,0.0023581665888347137
STAT,1992,23,30-34,2015,47.75101213008821
SIM,1891,35,30-34,1926,10
SIM,1810,57,na,1867,1190
STAT,1893,24,35-39,1917,8.459034339005287
SIM,1855,26,30-34,1881,52
STAT,1868,46,45-49,1914,0.26241208691340134
SIM,1965,19,na,1984,5255
SIM,1984,22,35-39,2006,21
STAT,1977,34,45-49,2011,2.497857117154529
SIM,1819,46,45-49,1865,1
STAT,1816,43,40-44,1859,4.9139159401569845
STAT,1933,16,50-100,1949,0.5804685723051625
SIM,1963,23,15-19,1986,15
STAT,1863,84,na,1947,335.69380765708587
SIM,1876,46,45-49,1922,1
SIM,1869,10,na,1879,2341
STAT,1885,39,na,1924,2684.6921929550176
STAT,1901,94,na,1995,242.5931444779335
STAT,1902,23,35-39,1925,9.486094384400717
STAT,1853,53,40-44,1906,0.010313235589923475
STAT,1956,29,50-100,1985,1.5250325050907567
STAT,1990,6,na,1996,6497.08682486547
STAT,1883,35,30-34,1918,6.074734896953779
STAT,1924,68,na,1992,4150.8067753652285
STAT,1976,15,35-39,1991,6.4730532564586465
STAT,1960,21,30-34,1981,43.357396503477034
STAT,1851,28,40-44,1879,2.761371389267884
SIM,1910,23,35-39,1933,28
STAT,1856,25,15-19,1881,0.4199428976314891
SIM,1887,31,na,1918,3693
STAT,1857,40,25-29,1897,0.5830015287876806
STAT,1846,29,na,1875,2666.7204801031808
STAT,1956,24,15-19,1980,8.150218743570537
STAT,1826,54,35-39,1880,0.005752393241628427
STAT,1935,45,15-19,1980,6.033144211174962E-4
STAT,1975,35,30-34,2010,2.863690227961218
STAT,1869,47,45-49,1916,0.2625259193312348
STAT,1976,33,45-49,2009,2.471489004544527
SIM,1948,15,25-29,1963,132
STAT,1833,62,na,1895,1286.126332922382
STAT,1929,47,40-44,1976,0.23585039852869627
SIM,1891,18,35-39,1909,1
STAT,1997,7,na,2004,6623.815699480648
STAT,1823,55,na,1878,1286.7237717253304
SIM,1820,64,na,1884,1469
SIM,1942,45,na,1987,4943
STAT,1883,18,35-39,1901,0.6179200573396679
SIM,1899,96,na,1995,16
STAT,1852,52,40-44,1904,0.009872770244010376
STAT,1907,30,50-100,1937,0.9004990743113488
SIM,1830,34,na,1864,2075
STAT,1903,34,15-19,1937,0.13326168338270966
SIM,1829,36,30-34,1865,15
STAT,1967,22,25-29,1989,133.5967682762316
SIM,1915,30,50-100,1945,1
STAT,1875,29,40-44,1904,3.5469624851188173
SIM,1834,48,na,1882,1776
STAT,1984,30,50-100,2014,1.3829161540801163
SIM,1822,90,na,1912,1
STAT,1824,35,20-24,1859,1.2404329781947538
STAT,1809,46,35-39,1855,0.3602545698774361
SIM,1917,21,25-29,1938,155
STAT,1837,47,na,1884,1691.1646183342027
SIM,1967,34,35-39,2001,3
SIM,1983,18,35-39,2001,17
STAT,1854,36,15-19,1890,0.04596914427031485
SIM,1839,19,30-34,1858,3
STAT,1968,40,na,2008,5578.783107634829
STAT,1874,42,20-24,1916,0.1873982154026385
SIM,1897,35,50-100,1932,4
SIM,1900,22,na,1922,3506
STAT,1824,54,25-29,1878,0.004465056958858492
STAT,1923,33,20-24,1956,3.223825298267833
SIM,1854,27,20-24,1881,1
STAT,1973,35,20-24,2008,0.40605172927424044
SIM,1849,6,na,1855,3286
SIM,1877,41,50-100,1918,1
STAT,1994,18,15-19,2012,75.55464483494148
STAT,1840,22,20-24,1862,70.30188393219285
STAT,1961,35,15-19,1996,0.029549321816025733
SIM,1893,34,45-49,1927,5
STAT,1884,47,40-44,1931,0.19429577304603265
STAT,1957,19,40-44,1976,2.126813021037804
SIM,1933,49,na,1982,6304
STAT,1859,47,na,1906,2058.646754854076
STAT,1822,70,na,1892,1152.8032179541888
STAT,1889,35,50-100,1924,1.7631363147501744
STAT,1905,16,15-19,1921,9.93695817939105
STAT,1813,85,na,1898,125.5185580480051
SIM,1889,97,na,1986,308
SIM,1867,34,30-34,1901,9
STAT,1903,45,25-29,1948,0.053940746010748775
SIM,1938,17,30-34,1955,33
SIM,1965,19,40-44,1984,2
SIM,1889,26,30-34,1915,7
STAT,1885,34,45-49,1919,1.9901439175489528
SIM,1916,94,na,2010,100
STAT,1845,29,25-29,1874,34.199253854589664
STAT,1885,24,30-34,1909,20.375526188393412
STAT,1832,44,15-19,1876,0.011432808891477304
STAT,1850,44,25-29,1894,0.652142865248342
STAT,1847,18,50-100,1865,0.04677246465887892
SIM,1889,21,50-100,1910,2
STAT,1984,25,25-29,2009,108.4441577176182
SIM,1868,36,na,1904,3132
SIM,1982,22,25-29,2004,5
SIM,1959,44,45-49,2003,1
STAT,1954,59,na,2013,5126.497263243534
SIM,1853,29,25-29,1882,42
STAT,1846,27,20-24,1873,14.671596794531254
STAT,1870,62,na,1932,2079.4539253703447
STAT,1858,24,40-44,1882,1.9307236272340116
STAT,1874,76,na,1950,1119.3074301809613
STAT,1895,37,45-49,1932,2.9945997316033885
STAT,1862,30,35-39,1892,9.94235863663097
STAT,1935,38,50-100,1973,0.6772120562244363
SIM,1883,28,na,1911,2491
SIM,1886,17,15-19,1903,10
SIM,1893,24,30-34,1917,35
SIM,1967,29,na,1996,5723
STAT,1864,69,na,1933,1512.217721123242
SIM,1821,39,30-34,1860,1
STAT,1860,55,na,1915,1923.1982790777479
SIM,1971,37,na,2008,5728
SIM,1916,44,35-39,1960,1
SIM,1954,20,45-49,1974,4
STAT,1884,17,45-49,1901,0.07448209100454405
SIM,1831,48,na,1879,1574
SIM,1868,28,na,1896,3075
SIM,1839,38,35-39,1877,11
SIM,1883,29,40-44,1912,1
SIM,1839,47,50-100,1886,2
STAT,1872,33,50-100,1905,1.0572667946681529
SIM,1988,19,30-34,2007,56
STAT,1946,20,45-49,1966,1.4459614723295378
STAT,1903,21,na,1924,3899.3500280724957
STAT,1908,44,35-39,1952,0.21263178063244675
STAT,1812,71,na,1883,666.0097997707871
STAT,1885,15,40-44,1900,0.21151961030276584
STAT,1976,30,40-44,2006,6.157121905149351
STAT,1872,17,20-24,1889,20.611437762872146
SIM,1841,23,25-29,1864,4
STAT,1914,47,50-100,1961,0.25899459114557477
STAT,1888,23,15-19,1911,4.461543295226313
STAT,1944,49,50-100,1993,0.290478380671061
SIM,1939,29,40-44,1968,7
STAT,1836,51,45-49,1887,0.013635552194594613
STAT,1857,48,35-39,1905,0.12425239279257988
SIM,1827,39,25-29,1866,4
SIM,1866,41,25-29,1907,1
STAT,1861,26,35-39,1887,9.391941705093116
STAT,1911,72,na,1983,2974.906947087495
SIM,1891,30,25-29,1921,23
STAT,1926,2,na,1928,5785.610124057533
STAT,1847,39,30-34,1886,4.167380980646149
SIM,1976,28,15-19,2004,3
STAT,1900,80,na,1980,1738.804987231838
SIM,1960,45,na,2005,6137
SIM,1896,23,15-19,1919,6
SIM,1939,18,30-34,1957,16
STAT,1917,0,na,1917,5576.663568471612
SIM,1858,58,na,1916,2300
SIM,1806,48,25-29,1854,1
SIM,1877,61,na,1938,2258
SIM,1949,32,25-29,1981,1
STAT,1819,39,25-29,1858,6.83678304002276
SIM,1968,43,40-44,2011,1
STAT,1883,30,25-29,1913,11.65780540484075
SIM,1942,53,na,1995,4774
STAT,1851,40,30-34,1891,0.9208801535909326
STAT,1826,51,30-34,1877,0.0042210221663931775
SIM,1979,33,45-49,2012,3
STAT,1833,23,25-29,1856,57.25212918255268
SIM,1809,45,50-100,1854,1
SIM,1984,30,40-44,2014,1
STAT,1916,49,20-24,1965,0.013005669690338463
STAT,1834,39,50-100,1873,1.3650125539791835
STAT,1960,24,35-39,1984,14.189970254536693
STAT,1850,66,na,1916,1687.2725031533694
STAT,1950,12,na,1962,5360.131457515801
SIM,1891,38,35-39,1929,7
SIM,1891,79,na,1970,1377
STAT,1895,38,na,1933,3521.575911472353
STAT,1950,48,15-19,1998,5.213867361635734E-4
STAT,1848,52,20-24,1900,7.798858402498271E-4
STAT,1890,18,50-100,1908,0.06890343658679213
STAT,1827,30,40-44,1857,8.31064895887352
SIM,1940,68,na,2008,3713
STAT,1786,81,na,1867,342.0754984239257
SIM,1855,39,30-34,1894,2
STAT,1904,94,na,1998,253.4865628046457
STAT,1934,38,na,1972,5988.405479903293
STAT,1883,38,35-39,1921,7.946370602700586
STAT,1900,58,na,1958,3242.812241692331
SIM,1897,35,25-29,1932,10
SIM,1892,31,25-29,1923,21
STAT,1825,50,30-34,1875,0.008334953803066621
SIM,1835,30,40-44,1865,11
STAT,1835,36,35-39,1871,5.515724435118996
STAT,1850,25,20-24,1875,14.418397711617722
STAT,1871,28,na,1899,2730.3853449957005
SIM,1844,40,35-39,1884,2
STAT,1841,52,50-100,1893,0.013356223293940163
STAT,1848,43,30-34,1891,1.2127301151601069
STAT,1968,8,na,1976,5664.917571302969
STAT,1987,20,45-49,2007,1.8611294815869694
STAT,1934,34,35-39,1968,14.387570001980505
SIM,1903,20,50-100,1923,2
SIM,1865,28,35-39,1893,12
STAT,1837,52,45-49,1889,0.010547010097715104
STAT,1888,38,50-100,1926,1.657263643701092
SIM,1928,30,45-49,1958,4
STAT,1889,35,25-29,1924,4.134756279118289
SIM,1908,10,na,1918,4366
STAT,1873,49,30-34,1922,0.11169596000410033
SIM,1880,17,20-24,1897,53
SIM,1923,44,50-100,1967,1
SIM,1843,36,35-39,1879,11
STAT,1896,34,20-24,1930,4.084959066428632
SIM,1847,66,na,1913,1840
STAT,1884,46,na,1930,2572.5990743511425
SIM,1975,22,25-29,1997,167
SIM,1860,44,35-39,1904,4
STAT,1857,28,35-39,1885,8.86873377140546
STAT,1892,97,na,1989,83.9364502507449
STAT,1873,41,20-24,1914,0.1880063990653521
SIM,1898,36,25-29,1934,4
STAT,1828,54,50-100,1882,0.011748592275313158
STAT,1871,16,20-24,1887,20.607429543659357
STAT,1836,40,35-39,1876,2.0120701099217526
STAT,1902,20,30-34,1922,29.21850810364835
STAT,1977,31,40-44,2008,6.223558969643236
STAT,1915,44,50-100,1959,0.13606577137479703
SIM,1819,43,40-44,1862,4
SIM,1875,92,na,1967,231
STAT,1998,16,15-19,2014,76.9219425112973
STAT,1835,43,45-49,1878,1.104901844201123
STAT,1933,51,na,1984,5758.60086844855
SIM,1922,22,na,1944,4548
SIM,1834,70,na,1904,1049
SIM,1942,22,40-44,1964,1
STAT,1831,28,na,1859,2234.022616167839
SIM,1979,23,na,2002,5587
STAT,1850,32,30-34,1882,18.802434895403966
STAT,1875,45,40-44,1920,0.20620784590372548
SIM,1940,47,45-49,1987,1
SIM,1851,42,25-29,1893,1
SIM,1848,29,25-29,1877,2
STAT,1845,33,50-100,1878,0.7265276201823029
SIM,1818,42,40-44,1860,5
SIM,1907,65,na,1972,3669
STAT,1921,46,30-34,1967,0.11622173066560532
STAT,1849,30,25-29,1879,9.38568347518532
STAT,1906,16,50-100,1922,0.0826495031081304
STAT,1929,29,50-100,1958,1.4362493027164618
STAT,1929,24,25-29,1953,133.96507164449326
SIM,1904,45,50-100,1949,1
STAT,1925,56,na,1981,4944.496421901882
STAT,1963,33,15-19,1996,0.19193014336584463
STAT,1951,41,40-44,1992,0.35773199268990113
STAT,1887,65,na,1952,2185.6674122594977
SIM,1867,97,na,1964,29
STAT,1898,27,20-24,1925,18.29731378460654
STAT,1853,16,35-39,1869,0.6610633134819874
SIM,1849,31,50-100,1880,2
STAT,1874,38,50-100,1912,1.4433187498946598
SIM,1843,43,45-49,1886,6
SIM,1897,32,20-24,1929,5
STAT,1793,108,na,1901,3.4490748750227334E-4
STAT,1908,32,40-44,1940,4.268331803913524
SIM,1938,33,30-34,1971,16
SIM,1947,28,30-34,1975,110
STAT,1889,32,20-24,1921,3.8452883022043625
SIM,1972,33,20-24,2005,3
SIM,1928,15,15-19,1943,113
STAT,1942,41,30-34,1983,0.16049261136755974
STAT,1908,52,na,1960,3774.5674370769884
SIM,1852,32,na,1884,2001
STAT,1863,23,40-44,1886,2.129300122342162
SIM,1871,23,40-44,1894,5
STAT,1942,38,15-19,1980,0.02384013053130851
STAT,1965,29,50-100,1994,1.4388328599389781
SIM,1922,32,25-29,1954,48
STAT,1903,29,50-100,1932,1.043996414366656
STAT,1966,41,15-19,2007,0.0023037407388817872
STAT,1852,97,na,1949,5.06502218677755
STAT,1877,33,na,1910,2852.546228000589
STAT,1899,32,50-100,1931,1.4486487541294022
SIM,1908,29,20-24,1937,2
STAT,1905,32,15-19,1937,0.13658307667126424
STAT,1846,43,20-24,1889,0.1640503343796914
SIM,1968,45,50-100,2013,2
STAT,1807,70,na,1877,944.9281830195354
STAT,1827,49,25-29,1876,0.07102577149563612
STAT,1966,33,40-44,1999,5.746206483834234
STAT,1837,33,40-44,1870,3.896652063724193
SIM,1834,32,50-100,1866,2
STAT,1943,67,na,2010,3929.727134378626
STAT,1914,32,25-29,1946,10.741974982422636
STAT,1990,23,20-24,2013,184.31888428648864
STAT,1847,11,na,1858,2303.0507585745227
STAT,1971,29,25-29,2000,96.52735648050795
SIM,1937,24,25-29,1961,235
STAT,1861,33,45-49,1894,1.665975397418785
STAT,1859,34,30-34,1893,15.913379930380108
STAT,1958,42,35-39,2000,0.3171938457575437
SIM,1894,65,na,1959,2877
STAT,1858,25,25-29,1883,39.55170546886234
SIM,1845,33,40-44,1878,11
STAT,1911,39,25-29,1950,1.0873822120493672
SIM,1877,23,35-39,1900,2
STAT,1952,24,na,1976,5063.570607877454
STAT,1929,8,na,1937,5874.417683775254
STAT,1932,47,45-49,1979,0.3403239439440382
STAT,1899,84,na,1983,1225.1260127562941
STAT,1889,3,na,1892,3760.7632817670724
STAT,1910,27,15-19,1937,0.7875320507221574
STAT,1831,38,35-39,1869,6.92195937783869
STAT,1964,47,50-100,2011,0.3419564775888543
STAT,1920,40,40-44,1960,0.31954961502894846
STAT,1934,22,40-44,1956,5.217272188719341
STAT,1904,29,40-44,1933,4.928825171295543
STAT,1887,27,45-49,1914,1.4359805798207448
SIM,1952,44,45-49,1996,1
STAT,1877,53,35-39,1930,0.010168766683472837
STAT,1930,33,20-24,1963,3.6309646800723083
STAT,1952,15,40-44,1967,1.9354068713105486
STAT,1927,25,na,1952,5290.3005834332225
STAT,1937,43,15-19,1980,0.0017857732073669772
SIM,1841,20,20-24,1861,73
SIM,1866,25,25-29,1891,82
SIM,1914,27,na,1941,4013
STAT,1925,41,50-100,1966,0.16432603417331135
SIM,1928,27,na,1955,5472
STAT,1875,20,25-29,1895,68.67819690607722
SIM,1869,66,na,1935,1207
STAT,1870,50,50-100,1920,0.0174296869410157
STAT,1856,29,50-100,1885,0.5752707366489456
STAT,1843,42,25-29,1885,0.6634086675535706
STAT,1845,101,na,1946,0.3845175077752553
SIM,1960,15,40-44,1975,4
STAT,1813,48,50-100,1861,0.8017596604901943
SIM,1912,29,40-44,1941,16
STAT,1888,90,na,1978,418.0199520974192
STAT,1944,44,45-49,1988,0.21409871502908984
SIM,1835,23,30-34,1858,23
STAT,1864,15,na,1879,2720.825342883083
SIM,1882,62,na,1944,2593
STAT,1796,99,na,1895,0.4823773610145614
SIM,1856,15,15-19,1871,11
STAT,1853,39,25-29,1892,2.8377324991945083
STAT,1872,10,na,1882,3088.1425896523047
SIM,1822,32,20-24,1854,3
STAT,1832,47,40-44,1879,0.14052729885371404
STAT,1871,32,35-39,1903,11.627151483717913
SIM,1935,37,50-100,1972,1
STAT,1924,42,35-39,1966,0.2763400443857008
STAT,1780,76,na,1856,505.49104437389997
STAT,1858,60,na,1918,1717.0071562323626
STAT,1871,52,45-49,1923,0.016573384343800835
SIM,1934,19,20-24,1953,5
STAT,1926,19,20-24,1945,190.76019344964234
SIM,1918,49,na,1967,3743
SIM,1880,46,50-100,1926,2
STAT,1915,42,25-29,1957,0.08298274897212642
STAT,1935,20,na,1955,5745.955817178313
STAT,1907,17,30-34,1924,2.7063499733845395
STAT,1885,84,na,1969,753.6514176832511
STAT,1841,20,na,1861,2443.131152111192
STAT,1943,47,20-24,1990,0.01406855340932103
STAT,1882,102,na,1984,7.018906835696009
STAT,1960,40,25-29,2000,0.11185460202232696
STAT,1904,43,20-24,1947,0.01814429097074621
STAT,1812,49,na,1861,1310.5113139147845
STAT,1915,32,na,1947,4446.039184479796
STAT,1951,62,na,2013,4780.16416645464
STAT,1859,44,45-49,1903,1.3572967283104436
STAT,1932,26,na,1958,5666.468486427114
STAT,1854,78,na,1932,636.5493977185328
SIM,1920,25,50-100,1945,1
SIM,1926,21,45-49,1947,1
SIM,1963,47,50-100,2010,1
STAT,1821,41,35-39,1862,3.571055819732255
STAT,1875,50,20-24,1925,8.926858128154219E-4
STAT,1817,105,na,1922,0.020271142513355787
STAT,1950,32,35-39,1982,12.71067624683428
SIM,1867,44,45-49,1911,1
SIM,1878,35,na,1913,2878
STAT,1791,68,na,1859,774.3099742287262
STAT,1877,110,na,1987,0.025222167968570002
STAT,1956,23,30-34,1979,44.02054403760933
STAT,1881,43,15-19,1924,0.015261078435975123
STAT,1874,33,30-34,1907,20.540685839192765
SIM,1869,37,45-49,1906,1
STAT,1809,53,45-49,1862,0.03435949605343691
STAT,1954,7,na,1961,5607.68784485721
SIM,1857,30,25-29,1887,5
SIM,1929,24,20-24,1953,289
SIM,1916,32,40-44,1948,1
STAT,1899,21,25-29,1920,90.7825996431369
SIM,1827,43,na,1870,1406
STAT,1955,49,35-39,2004,0.20424858872287938
SIM,1911,84,na,1995,2690
SIM,1872,3,na,1875,3745
SIM,1931,39,na,1970,6098
STAT,1954,33,50-100,1987,1.201606631244256
STAT,1860,51,30-34,1911,0.005563007923115637
STAT,1824,42,30-34,1866,1.6360529189567066
STAT,1857,35,na,1892,2137.6883247763208
SIM,1903,33,na,1936,3821
SIM,1766,89,na,1855,3
SIM,1816,51,na,1867,1497
SIM,1891,29,50-100,1920,2
SIM,1863,39,35-39,1902,16
STAT,1978,16,15-19,1994,71.4973326356213
SIM,1882,33,30-34,1915,4
STAT,1884,15,25-29,1899,6.491342946300294
STAT,1960,15,45-49,1975,0.7512471914544906
STAT,1910,33,35-39,1943,10.13627087207634
SIM,1969,29,20-24,1998,2
SIM,1849,78,na,1927,1187
SIM,1832,42,30-34,1874,1
STAT,1838,42,50-100,1880,1.0703999642052957
SIM,1907,57,na,1964,4017
STAT,1885,47,20-24,1932,0.013748913284587928
STAT,1867,31,30-34,1898,18.889523819096507
STAT,1848,15,15-19,1863,7.9096568669228375
STAT,1886,109,na,1995,0.08203011079472014
SIM,1964,29,50-100,1993,2
STAT,1803,86,na,1889,75.87541781473772
SIM,1911,30,na,1941,4836
SIM,1935,24,50-100,1959,1
STAT,1963,18,20-24,1981,198.7118899160186
SIM,1987,19,15-19,2006,67
STAT,1881,29,35-39,1910,10.663738665323361
STAT,1936,24,50-100,1960,0.7259207908523647
SIM,1909,38,na,1947,4721
STAT,1850,35,35-39,1885,7.551705091608376
STAT,1927,24,50-100,1951,0.9295083440831011
STAT,1952,30,35-39,1982,12.896880887787004
SIM,1851,17,na,1868,3025
STAT,1863,26,45-49,1889,1.1285209432769712
SIM,1942,25,45-49,1967,3
STAT,1983,21,20-24,2004,182.19052103169187
SIM,1971,18,20-24,1989,203
STAT,1894,23,50-100,1917,0.6031036917498241
SIM,1948,22,35-39,1970,27
STAT,1945,44,na,1989,4849.5021596530105
STAT,1898,42,15-19,1940,0.0014938653010168862
STAT,1951,44,45-49,1995,0.2368968136687621
SIM,1779,88,na,1867,153
SIM,1887,85,na,1972,1232
SIM,1880,81,na,1961,945
STAT,1969,45,15-19,2014,5.549755754906146E-4
STAT,1829,26,45-49,1855,2.7666410180355294
STAT,1793,106,na,1899,0.002286239990103091
STAT,1890,31,na,1921,3378.7368769467394
STAT,1820,49,15-19,1869,3.969078020132836E-4
SIM,1973,35,35-39,2008,7
STAT,1864,19,15-19,1883,6.251745544773985
SIM,1880,33,20-24,1913,7
SIM,1928,41,na,1969,5682
SIM,1937,21,20-24,1958,16
STAT,1825,54,40-44,1879,0.013614745350414344
STAT,1864,22,15-19,1886,3.4541175165152693
STAT,1912,33,45-49,1945,1.7810736384519645
SIM,1819,56,na,1875,836
SIM,1933,16,35-39,1949,7
STAT,1869,23,35-39,1892,6.501628718007644
STAT,1898,57,na,1955,3134.3819335868398
SIM,1878,89,na,1967,118
STAT,1816,46,45-49,1862,0.48861183821054044
STAT,1974,22,35-39,1996,14.235991696259351
STAT,1925,16,35-39,1941,5.862259245394819
SIM,1872,19,15-19,1891,6
STAT,1894,33,40-44,1927,6.40653877423929
STAT,1936,48,na,1984,4193.057735224517
SIM,1991,21,20-24,2012,6
STAT,1929,21,20-24,1950,162.77355558034043
SIM,1842,19,35-39,1861,2
STAT,1868,43,40-44,1911,2.4759086797643066
STAT,1859,40,35-39,1899,1.681486960323837
STAT,1931,35,35-39,1966,3.703993041889061
STAT,1929,18,20-24,1947,199.16203998914577
STAT,1859,37,35-39,1896,6.502170034960748
STAT,1928,50,na,1978,5360.782961261644
STAT,1934,25,45-49,1959,2.6857396900309336
STAT,1836,59,na,1895,1768.6841300831009
STAT,1930,45,na,1975,5610.334823176339
STAT,1932,44,40-44,1976,0.39001504566595774
SIM,1898,23,na,1921,3596
SIM,1960,30,35-39,1990,39
SIM,1872,86,na,1958,532
STAT,1880,47,50-100,1927,0.29902743639772056
SIM,1874,11,na,1885,2924
STAT,1872,33,20-24,1905,3.1190920867951792
STAT,1918,21,45-49,1939,1.4043969803042824
SIM,1856,48,na,1904,1984
SIM,1960,18,45-49,1978,2
SIM,1866,22,20-24,1888,148
SIM,1956,32,35-39,1988,3
STAT,1837,36,45-49,1873,1.7758784415684425
STAT,1952,18,45-49,1970,0.6906292031812338
SIM,1859,30,35-39,1889,23
STAT,1831,42,na,1873,2010.7462365881445
STAT,1818,62,na,1880,910.1584269169482
STAT,1842,30,15-19,1872,0.13516096610026196
STAT,1952,21,45-49,1973,1.5617373166040356
STAT,1865,31,20-24,1896,2.826078467420093
SIM,1856,36,20-24,1892,1
SIM,1980,21,45-49,2001,4
SIM,1861,78,na,1939,18
SIM,1841,40,na,1881,1867
STAT,1908,35,45-49,1943,0.7445377651417354
STAT,1955,44,20-24,1999,0.028023886973182803
SIM,1850,36,45-49,1886,5
STAT,1918,18,45-49,1936,0.625701992957024
STAT,1884,20,50-100,1904,0.46774546512401965
STAT,1977,24,50-100,2001,1.0287002341785578
SIM,1940,41,na,1981,4963
SIM,1848,26,20-24,1874,23
STAT,1850,54,40-44,1904,0.010539618938266604
SIM,1895,80,na,1975,869
STAT,1941,17,30-34,1958,14.492297298709945
SIM,1837,26,45-49,1863,2
STAT,1851,44,40-44,1895,1.7595879929533202
STAT,1963,21,20-24,1984,163.6220533220239
STAT,1858,22,20-24,1880,71.18324427130644
STAT,1831,35,30-34,1866,5.380861307511962
STAT,1948,32,35-39,1980,12.302003751286925
STAT,1926,40,35-39,1966,0.28722070304317165
SIM,1971,21,20-24,1992,3
SIM,1845,62,na,1907,1736
STAT,1963,16,na,1979,5398.098012968349
STAT,1848,36,20-24,1884,0.8528553786275407
SIM,1866,16,na,1882,2713
SIM,1864,35,na,1899,2715
STAT,1921,36,50-100,1957,0.5413120326020557
STAT,1967,9,na,1976,5664.842384368444
SIM,1902,20,45-49,1922,3
SIM,1845,36,45-49,1881,6
SIM,1955,17,25-29,1972,84
STAT,1849,77,na,1926,669.9628821741252
STAT,1931,22,15-19,1953,7.969348122814345
STAT,1895,52,na,1947,3217.3406477144404
STAT,1966,47,45-49,2013,0.32585613450866113
SIM,1920,53,na,1973,4026
SIM,1952,44,na,1996,4655
STAT,1870,7,na,1877,3123.9967591760283
SIM,1945,31,20-24,1976,2
STAT,1844,17,na,1861,2440.5982494332125
SIM,1871,70,na,1941,943
STAT,1861,112,na,1973,6.197125563144387E-4
STAT,1940,21,na,1961,4295.923757065079
STAT,1905,45,35-39,1950,0.13322319259997134
SIM,1864,40,45-49,1904,3
SIM,1791,88,na,1879,70
SIM,1867,41,40-44,1908,6
SIM,1945,28,20-24,1973,1
STAT,1867,19,40-44,1886,0.19910438744639666
STAT,1947,17,25-29,1964,56.33392385654469
SIM,1895,24,40-44,1919,11
STAT,1938,66,na,2004,3728.199011025421
SIM,1875,31,30-34,1906,33
SIM,1919,38,20-24,1957,1
STAT,1850,40,15-19,1890,0.01435992375611528
STAT,1906,71,na,1977,2845.230677152666
STAT,1892,12,na,1904,3735.4298759603753
STAT,1842,50,25-29,1892,0.002764837300488783
SIM,1863,59,na,1922,1993
SIM,1916,35,45-49,1951,1
STAT,1914,48,40-44,1962,0.18003505369170528
SIM,1858,29,na,1887,2758
STAT,1867,51,40-44,1918,0.011397694466692676
SIM,1973,14,na,1987,5486
SIM,1978,2,na,1980,6043
SIM,1872,30,na,1902,3080
SIM,1913,11,na,1924,5086
SIM,1935,24,15-19,1959,11
STAT,1887,24,40-44,1911,2.6781665201269353
STAT,1809,51,na,1860,1390.2175998103232
STAT,1927,24,15-19,1951,7.5197216379384075
STAT,1802,53,35-39,1855,0.033620998137507116
STAT,1937,31,20-24,1968,2.788060879621791
STAT,1890,40,45-49,1930,2.131737675042085
STAT,1824,45,35-39,1869,0.1952753497097404
STAT,1848,92,na,1940,44.25365616558609
STAT,1829,49,35-39,1878,0.1391105620565636
STAT,1930,78,na,2008,3208.6557353768403
STAT,1937,28,20-24,1965,20.536112893379062
SIM,1929,27,25-29,1956,9
SIM,1799,76,na,1875,111
STAT,1880,53,na,1933,2591.554328898481
SIM,1876,43,40-44,1919,4
STAT,1955,46,30-34,2001,0.14240913268661592
SIM,1952,48,na,2000,4584
STAT,1893,21,30-34,1914,26.06155289789034
STAT,1855,16,45-49,1871,0.06650168701843712
STAT,1878,32,45-49,1910,2.1012282453566504
SIM,1935,21,na,1956,6300
STAT,1864,50,45-49,1914,0.015169092878638385
STAT,1939,43,25-29,1982,0.08562640395328602
STAT,1817,52,25-29,1869,0.009730804989255252
SIM,1869,34,40-44,1903,8
SIM,1900,31,35-39,1931,21
STAT,1910,40,50-100,1950,0.12971806052596707
STAT,1965,35,35-39,2000,3.5964595526918983
SIM,1823,75,na,1898,1111
SIM,1837,18,15-19,1855,11
STAT,1946,43,25-29,1989,0.09483899386427763
STAT,1851,42,50-100,1893,0.8367294627300295
STAT,1862,46,15-19,1908,3.9067870557817427E-4
STAT,1829,89,na,1918,76.96003767525906
SIM,1879,23,45-49,1902,1
STAT,1838,32,15-19,1870,0.15331017794905843
STAT,1893,41,40-44,1934,3.2959063880482313
STAT,1838,29,15-19,1867,0.4928566688518554
STAT,1816,40,15-19,1856,0.033641548472953586
STAT,1916,39,50-100,1955,0.49124448070904475
STAT,1887,11,na,1898,3345.002537006344
SIM,1909,34,15-19,1943,1
STAT,1938,43,30-34,1981,0.15108486456330078
STAT,1899,45,35-39,1944,0.12610455366940937
SIM,1964,32,na,1996,5764
STAT,1810,99,na,1909,1.078343835183249
SIM,1914,16,50-100,1930,1
STAT,1866,37,45-49,1903,2.132356715699088
STAT,1922,42,25-29,1964,0.0945485275081397
STAT,1929,84,na,2013,2010.0504237122175
SIM,1917,35,50-100,1952,1
STAT,1928,21,na,1949,5277.607577819457
STAT,1967,41,30-34,2008,0.19180531416956578
STAT,1912,30,40-44,1942,4.4838830187116825
SIM,1862,44,50-100,1906,2
SIM,1993,16,na,2009,6952
SIM,1903,19,na,1922,4079
SIM,1837,23,40-44,1860,2
SIM,1939,33,na,1972,4863
STAT,1850,31,na,1881,2596.6506880492598
STAT,1867,96,na,1963,26.382962455760897
STAT,1800,81,na,1881,285.6440434542805
STAT,1905,23,25-29,1928,95.32316141015902
SIM,1874,37,45-49,1911,1
SIM,1865,31,na,1896,3076
STAT,1963,24,25-29,1987,135.7836128187187
STAT,1911,99,na,2010,57.14438328598416
SIM,1792,72,na,1864,541
STAT,1881,26,30-34,1907,28.126899438602617
STAT,1797,106,na,1903,0.003615207305726155
STAT,1971,31,na,2002,5638.190021407538
STAT,1853,52,35-39,1905,0.008525713157108766
STAT,1910,21,40-44,1931,3.6587693075137295
STAT,1865,96,na,1961,20.145477693245795
SIM,1928,70,na,1998,4246
SIM,1882,38,50-100,1920,5
SIM,1961,33,20-24,1994,5
STAT,1918,15,40-44,1933,0.3540562529184918
STAT,1986,12,na,1998,6459.418014087632
SIM,1970,32,40-44,2002,3
STAT,1876,59,na,1935,2318.511632599623
SIM,1852,42,40-44,1894,3
SIM,1954,25,na,1979,5484
STAT,1962,1,na,1963,5822.368150708584
SIM,1937,21,na,1958,4354
SIM,1856,39,25-29,1895,7
SIM,1957,54,na,2011,5986
STAT,1768,95,na,1863,2.3236697067197003
STAT,1878,69,na,1947,1768.3245616857835
SIM,1971,24,25-29,1995,1
SIM,1903,100,na,2003,9
STAT,1964,33,30-34,1997,23.328455162024536
SIM,1788,68,na,1856,580
SIM,1914,32,30-34,1946,32
STAT,1976,16,40-44,1992,2.157145122610973
STAT,1860,49,45-49,1909,0.21492253170144401
STAT,1843,33,35-39,1876,12.089650483334221
STAT,1859,41,40-44,1900,2.077126047492652
SIM,1849,29,40-44,1878,7
SIM,1829,29,20-24,1858,22
SIM,1871,56,na,1927,1738
STAT,1844,42,40-44,1886,1.926811373581987
STAT,1920,46,15-19,1966,4.7089514623567194E-4
SIM,1830,42,20-24,1872,1
SIM,1962,30,45-49,1992,5
STAT,1813,51,45-49,1864,0.047014540921795814
STAT,1891,21,20-24,1912,98.58789239932753
SIM,1763,92,na,1855,14
STAT,1821,51,na,1872,1500.2806454946817
STAT,1853,36,20-24,1889,0.775482525179679
STAT,1848,39,25-29,1887,3.0877971900509316
STAT,1856,53,30-34,1909,0.0051567693494695655
STAT,1950,49,20-24,1999,0.015593283250836018
STAT,1793,94,na,1887,4.409210784078774
STAT,1906,32,30-34,1938,16.871404959592535
STAT,1844,46,na,1890,1887.1605477962898
STAT,1986,16,na,2002,6054.309103267192
STAT,1843,39,50-100,1882,1.2817974218721773
SIM,1803,52,na,1855,1563
SIM,1859,24,30-34,1883,48
SIM,1929,26,na,1955,5255
STAT,1776,90,na,1866,42.18014096371725
STAT,1963,46,25-29,2009,0.08109692099427383
SIM,1913,23,25-29,1936,197
STAT,1879,14,na,1893,3101.897614825548
STAT,1999,16,30-34,2015,20.786465997857977
STAT,1974,40,50-100,2014,0.18449015974072716
STAT,1892,27,45-49,1919,1.605980561514765
STAT,1954,30,45-49,1984,2.2909355657598787
SIM,1803,87,na,1890,82
SIM,1920,30,40-44,1950,1
STAT,1892,95,na,1987,153.81837287466334
STAT,1822,42,20-24,1864,0.32452215461492234
SIM,1924,81,na,2005,1986
STAT,1972,29,40-44,2001,6.910110527997181
STAT,1799,85,na,1884,122.47156088825668
STAT,1846,27,na,1873,2705.430997770191
SIM,1889,41,25-29,1930,3
STAT,1866,22,50-100,1888,0.43975945172117825
STAT,1912,39,40-44,1951,1.6707856901048532
SIM,1928,74,na,2002,3688
STAT,1880,21,45-49,1901,0.8555677623526269
SIM,1920,39,40-44,1959,3
STAT,1959,35,15-19,1994,0.029917470821306708
STAT,1900,33,40-44,1933,6.915319206459473
STAT,1978,15,na,1993,5800.1554604480425
SIM,1949,5,na,1954,5918
SIM,1989,19,25-29,2008,88
STAT,1932,55,na,1987,5572.133379551284
STAT,1910,22,45-49,1932,1.2206778239699825
SIM,1889,41,na,1930,3716
SIM,1940,25,35-39,1965,39
SIM,1796,65,na,1861,824
SIM,1847,12,na,1859,3074
STAT,1903,112,na,2015,0.00807771013753876
STAT,1842,18,25-29,1860,5.566717478778383
SIM,1945,34,25-29,1979,2
STAT,1905,110,na,2015,0.0568848292724126
STAT,1817,43,35-39,1860,5.438463916318007
STAT,1904,103,na,2007,8.103806447481455
STAT,1929,46,35-39,1975,0.19334781959120306
STAT,1937,34,25-29,1971,10.544956198189466
STAT,1920,43,45-49,1963,0.2117007620626532
STAT,1823,45,50-100,1868,0.2495537751375968
SIM,1979,18,25-29,1997,157
STAT,1901,42,50-100,1943,0.1184427058526324
SIM,1960,10,na,1970,6321
STAT,1921,18,na,1939,4827.424069631767
STAT,1921,24,20-24,1945,143.97926010532723
SIM,1910,85,na,1995,351
STAT,1847,29,50-100,1876,0.583151106102947
STAT,1890,45,15-19,1935,5.696709179913691E-4
STAT,1831,47,25-29,1878,0.053366320107233856
STAT,1910,26,na,1936,4193.392436229908
STAT,1842,36,45-49,1878,1.818326006249681
STAT,1887,47,30-34,1934,0.12461000851310365
STAT,1921,25,25-29,1946,85.20014635272149
STAT,1852,12,na,1864,2722.159883872897
STAT,1893,44,45-49,1937,0.1495579009716116
STAT,1897,42,20-24,1939,0.016997194809832233
STAT,1972,43,20-24,2015,0.02707606642227821
STAT,1982,32,25-29,2014,15.299360112601686
SIM,1879,34,na,1913,2829
SIM,1915,23,na,1938,4867
STAT,1827,46,20-24,1873,0.01540342586129448
SIM,1861,49,na,1910,1679
STAT,1867,54,45-49,1921,0.015206952157105066
SIM,1851,33,35-39,1884,22
SIM,1868,81,na,1949,653
STAT,1906,35,35-39,1941,2.593517144956765
STAT,2007,3,na,2010,7066.120925173805
STAT,1927,37,50-100,1964,0.6022866008875913
STAT,1936,19,15-19,1955,49.90384184062041
STAT,1884,100,na,1984,18.871307081927633
SIM,1837,75,na,1912,1235
SIM,1981,28,na,2009,6306
STAT,1931,46,25-29,1977,0.08207468427431822
STAT,1967,23,na,1990,5279.965769467861
STAT,1892,41,na,1933,3358.1830927900655
STAT,1939,4,na,1943,4654.295486766488
STAT,1877,37,20-24,1914,0.9253616336242936
SIM,1938,18,na,1956,3854
STAT,1955,36,35-39,1991,3.821110854726883
SIM,1944,19,15-19,1963,59
SIM,1948,46,45-49,1994,1
SIM,1968,15,45-49,1983,4
STAT,1779,87,na,1866,48.272723332528855
STAT,1890,85,na,1975,899.7962778541167
STAT,1883,29,50-100,1912,0.7171095299160422
STAT,1768,107,na,1875,0.007583023706193868
STAT,1849,15,30-34,1864,1.5386994889351202
STAT,1940,43,30-34,1983,0.15548440973272704
SIM,1960,43,na,2003,6157
STAT,1829,46,30-34,1875,0.10008065902302844
SIM,1890,43,30-34,1933,4
STAT,1939,62,na,2001,4019.8215392642437
SIM,1860,93,na,1953,53
SIM,1903,32,20-24,1935,2
STAT,1940,70,na,2010,3510.720555414967
SIM,1918,63,na,1981,3366
STAT,1893,26,na,1919,3493.212479966683
SIM,1902,34,na,1936,4056
STAT,1943,18,na,1961,4503.444687248937
STAT,1932,25,35-39,1957,22.71921690539781
SIM,1885,37,20-24,1922,2
SIM,1900,2,na,1902,4036
STAT,1874,18,50-100,1892,0.05772967067677075
STAT,1945,47,30-34,1992,0.11689465228985871
STAT,1882,43,30-34,1925,1.2865618173320614
STAT,1898,48,45-49,1946,0.2050214615165602
STAT,1962,40,35-39,2002,0.310297760272665
SIM,1900,78,na,1978,1767
STAT,1836,19,45-49,1855,0.08643133969976224
SIM,1953,40,na,1993,5632
STAT,1882,34,na,1916,2666.8558862437385
SIM,1853,33,50-100,1886,3
STAT,1870,40,35-39,1910,2.0809948655074377
SIM,1849,44,50-100,1893,1
STAT,1946,61,na,2007,4505.754504821153
SIM,1963,36,35-39,1999,5
STAT,1939,40,20-24,1979,0.021268808315079095
SIM,1969,5,na,1974,5831
STAT,1961,30,45-49,1991,2.3942430619492674
SIM,1959,31,na,1990,5969
SIM,1965,17,na,1982,5214
STAT,1953,35,20-24,1988,0.3798014080509116
SIM,1873,19,30-34,1892,4
STAT,1830,35,15-19,1865,0.05857019998925387
STAT,1934,36,na,1970,5999.919811414909
STAT,1820,36,na,1856,1666.8236533492993
STAT,1942,44,35-39,1986,0.25158402393376
STAT,1874,41,15-19,1915,0.016389409186305263
STAT,1830,68,na,1898,958.6641066693473
STAT,1921,23,50-100,1944,0.8547167884564696
STAT,1927,46,25-29,1973,0.07701678202606321
SIM,1772,84,na,1856,155
SIM,1903,34,20-24,1937,4
STAT,1839,41,20-24,1880,0.14775145109277055
STAT,1946,40,20-24,1986,0.023557130606520985
SIM,1957,17,35-39,1974,11
SIM,1917,33,na,1950,5393
STAT,1799,56,na,1855,1430.4225980045376
STAT,1840,18,15-19,1858,6.127512659863385
STAT,1931,44,25-29,1975,0.10975081072750968
SIM,1909,19,20-24,1928,40
STAT,2006,9,na,2015,7018.840595533588
STAT,1830,43,na,1873,1587.166521958474
STAT,1835,104,na,1939,0.0415710620172316
STAT,1816,50,na,1866,1417.0939939300777
SIM,1843,40,40-44,1883,4
STAT,1879,99,na,1978,25.575622602186534
SIM,1862,31,45-49,1893,2
STAT,1839,29,30-34,1868,24.798368730057565
STAT,1856,16,50-100,1872,0.05130635487428284
STAT,1865,19,30-34,1884,1.690127594976854
STAT,1805,54,20-24,1859,0.00253059995476437
SIM,1924,21,35-39,1945,22
SIM,1950,44,35-39,1994,3
STAT,1995,5,na,2000,6568.216390377035
SIM,1781,80,na,1861,380
STAT,1843,30,30-34,1873,21.502853579811124
STAT,1835,35,na,1870,1684.8471974228303
STAT,1977,30,35-39,2007,14.541203259423437
STAT,1967,44,35-39,2011,0.30066899865031527
STAT,1835,40,40-44,1875,1.7257104426940673
STAT,1881,33,50-100,1914,1.015595613241443
STAT,1814,54,30-34,1868,0.015202129551583763
STAT,1813,107,na,1920,0.0021593045268483903
STAT,1969,40,45-49,2009,0.25003556297225576
STAT,1985,23,50-100,2008,1.0832382748161442
STAT,1845,42,na,1887,1585.9702728804682
STAT,1856,51,50-100,1907,0.01336082697761448
STAT,1931,26,50-100,1957,1.483989622656782
STAT,1921,49,35-39,1970,0.1666896217928548
SIM,1830,32,na,1862,2118
SIM,1787,83,na,1870,341
STAT,1822,45,25-29,1867,0.11202406185864247
STAT,1860,46,40-44,1906,0.15968669781110706
STAT,1976,19,45-49,1995,0.7696771274614137
SIM,1946,62,na,2008,4159
SIM,1828,28,na,1856,2377
STAT,1916,21,35-39,1937,11.422055003786713
STAT,1911,36,20-24,1947,0.29550066364148286
STAT,1931,43,20-24,1974,0.027190256917182583
STAT,1953,36,25-29,1989,1.417432743305338
SIM,1898,58,na,1956,3437
SIM,1914,35,35-39,1949,1
SIM,1971,3,na,1974,5822
STAT,1886,48,50-100,1934,0.2952150287138587
STAT,1909,37,na,1946,4114.222088944068
STAT,1827,79,na,1906,567.7576299754209
STAT,1821,49,30-34,1870,0.17037341748996732
SIM,1898,21,50-100,1919,1
STAT,1870,32,40-44,1902,4.933987255687101
STAT,1975,20,na,1995,5581.97262289575
STAT,1956,17,na,1973,5620.795340664784
SIM,1890,38,40-44,1928,19
STAT,1963,43,20-24,2006,0.02686633687991829
STAT,1876,88,na,1964,345.6511845974085
SIM,1961,36,25-29,1997,3
SIM,1861,39,25-29,1900,1
SIM,1884,74,na,1958,1173
SIM,1961,35,20-24,1996,1
STAT,1853,93,na,1946,29.097356944128705
STAT,1905,17,20-24,1922,29.612361748002925
SIM,1926,26,50-100,1952,6
STAT,1988,18,20-24,2006,223.70140004665637
STAT,1892,24,40-44,1916,2.995223913376606
STAT,1777,87,na,1864,41.40859851782317
STAT,1976,22,45-49,1998,1.7405252127235376
STAT,1843,61,na,1904,1874.953364661808
STAT,1861,30,40-44,1891,4.194121249568422
STAT,1838,31,na,1869,2357.0721138400495
STAT,1899,42,30-34,1941,0.12606986113200971
STAT,1877,50,30-34,1927,0.007248394647265495
STAT,1831,44,20-24,1875,0.1483564673878082
STAT,1854,31,45-49,1885,1.470054595581109
STAT,1843,86,na,1929,222.6263395445519
STAT,1840,21,15-19,1861,3.3898771355355795
STAT,1938,46,35-39,1984,0.1531214493819804
SIM,1950,18,na,1968,4515
STAT,1905,20,20-24,1925,115.7928652600038
STAT,1921,22,20-24,1943,144.88627335778125
SIM,1849,12,na,1861,3177
SIM,1836,79,na,1915,22
STAT,1965,18,30-34,1983,17.555520535864254
SIM,1979,15,20-24,1994,397
STAT,1838,17,20-24,1855,20.288221922580277
STAT,1929,43,30-34,1972,0.19077620577946375
SIM,1855,19,20-24,1874,37
STAT,1891,48,35-39,1939,0.1112234038389366
SIM,1874,96,na,1970,39
STAT,1797,75,na,1872,505.4765196407403
STAT,1878,54,20-24,1932,8.647087511977467E-4
STAT,1897,45,25-29,1942,0.050638121301352104
STAT,1910,30,30-34,1940,17.690713239396302
SIM,1904,60,na,1964,3619
SIM,1905,45,na,1950,3932
STAT,1892,41,25-29,1933,0.933040755735386
STAT,1900,36,45-49,1936,0.692342176333312
SIM,1812,69,na,1881,538
STAT,1944,41,40-44,1985,0.3233051503461523
STAT,1817,40,30-34,1857,3.7381160000888984
STAT,1937,32,na,1969,4320.532156954629
SIM,1915,52,na,1967,4361
SIM,1835,26,35-39,1861,17
SIM,1916,37,na,1953,4415
STAT,1882,38,40-44,1920,4.909912276118329
SIM,1940,22,30-34,1962,94
SIM,1851,39,50-100,1890,3
SIM,1885,59,na,1944,2551
SIM,1874,67,na,1941,1422
STAT,1839,16,na,1855,2395.456891520251
STAT,1918,26,50-100,1944,1.2263834138918799
SIM,1973,18,30-34,1991,22
STAT,1847,19,20-24,1866,16.825708679197913
STAT,1869,107,na,1976,0.1502348170230415
STAT,1821,34,50-100,1855,2.5869069700467264
STAT,1859,45,na,1904,2088.909181566869
SIM,1838,20,na,1858,1956
STAT,1941,32,25-29,1973,11.201700010495736
STAT,1911,44,15-19,1955,0.0016721619789854438
STAT,1863,30,na,1893,2427.4069844169794
SIM,1817,50,40-44,1867,1
SIM,1885,5,na,1890,3446
STAT,1865,30,na,1895,2504.7337311783986
SIM,1825,40,30-34,1865,3
STAT,1839,102,na,1941,0.23250236109248326
STAT,1961,39,na,2000,5766.807208471225
STAT,1926,40,na,1966,5297.386753908179
SIM,1951,14,na,1965,6320
STAT,1862,103,na,1965,0.714101860404583
STAT,1849,18,35-39,1867,0.5204111452174923
STAT,1976,38,na,2014,5969.978921764853
SIM,1847,29,30-34,1876,8
STAT,1866,51,25-29,1917,0.003806883883758529
STAT,1896,33,15-19,1929,0.21615400234343515
STAT,1935,40,45-49,1975,0.2718138736106323
STAT,1967,23,50-100,1990,0.9513655456150297
SIM,1926,15,40-44,1941,4
STAT,1976,38,15-19,2014,0.030472471954973886
STAT,1971,34,15-19,2005,0.1912133804115636
STAT,1900,35,40-44,1935,7.076513158670742
STAT,1838,18,50-100,1856,0.05573522542448644
STAT,1961,46,15-19,2007,5.727136265056044E-4
STAT,1894,22,na,1916,3508.6423255550353
STAT,1828,41,45-49,1869,1.4630003981618382
STAT,1955,33,30-34,1988,24.588249018993835
STAT,1928,40,45-49,1968,0.24552617312653102
STAT,1809,50,40-44,1859,0.026522351222485314
STAT,1900,47,50-100,1947,0.22081570107934342
SIM,1851,30,30-34,1881,30
STAT,1945,35,50-100,1980,0.5462477256867675
SIM,1963,33,30-34,1996,6
STAT,1939,28,30-34,1967,45.45518927401404
STAT,1918,29,na,1947,4567.018494939746
SIM,1883,20,25-29,1903,168
STAT,1901,18,40-44,1919,0.2948850083065916
STAT,1818,52,40-44,1870,0.012504873557898458
STAT,1875,53,25-29,1928,0.004156364464527948
SIM,1857,18,35-39,1875,1
STAT,1842,15,20-24,1857,17.72703951011294
STAT,1882,52,20-24,1934,8.273657357069041E-4
SIM,1977,19,50-100,1996,1
STAT,1856,48,40-44,1904,0.14883895205583703
STAT,1910,24,45-49,1934,1.213036168638125
STAT,1882,46,35-39,1928,0.15825815248258868
SIM,1958,29,45-49,1987,3
STAT,1932,22,30-34,1954,43.530918574689196
STAT,1844,50,35-39,1894,0.007304290546078621
SIM,1844,22,50-100,1866,1
STAT,1860,54,35-39,1914,0.007787163311918504
STAT,1954,46,15-19,2000,5.480020123306974E-4
SIM,1836,41,45-49,1877,5
STAT,1916,48,15-19,1964,4.3486567661134024E-4
SIM,1822,76,na,1898,470
SIM,1936,40,45-49,1976,1
STAT,1871,6,na,1877,3167.9111736450072
SIM,1950,9,na,1959,4818
STAT,1907,37,na,1944,4031.955612816495
SIM,1827,68,na,1895,643
SIM,1873,31,20-24,1904,4
SIM,1958,32,45-49,1990,8
STAT,1965,46,na,2011,5519.262574716855
STAT,1836,22,50-100,1858,0.4899594531089527
SIM,1864,48,40-44,1912,1
STAT,1949,17,35-39,1966,5.631942783333662
STAT,1909,35,50-100,1944,0.4635003273975693
STAT,1944,29,15-19,1973,0.8797018882673993
SIM,1882,20,45-49,1902,1
STAT,1847,16,15-19,1863,5.733042042830984
STAT,1965,39,45-49,2004,1.0097468129638756
STAT,1913,15,25-29,1928,10.278059194120871
STAT,1831,39,40-44,1870,4.23981639149394
STAT,1923,37,30-34,1960,2.4362050565122524
SIM,1949,33,50-100,1982,1
STAT,1979,31,50-100,2010,1.3399240343572079
STAT,1960,47,15-19,2007,5.7592092589356E-4
STAT,1878,91,na,1969,233.6416856408813
SIM,1949,42,40-44,1991,2
STAT,1878,16,45-49,1894,0.07890403036059056
STAT,1908,75,na,1983,2545.624432297562
SIM,1997,17,50-100,2014,5
STAT,1811,107,na,1918,0.002428214301089099
SIM,1850,32,na,1882,1745
STAT,1885,53,na,1938,2438.8026271716753
STAT,1916,41,25-29,1957,0.08458184470513644
STAT,1946,24,20-24,1970,142.70083091104848
SIM,1928,2,na,1930,6155
STAT,1971,16,25-29,1987,63.3592863274839
SIM,1921,15,25-29,1936,124
SIM,1933,32,35-39,1965,21
STAT,1934,41,45-49,1975,0.26787819904361504
SIM,1973,39,45-49,2012,4
STAT,1906,38,40-44,1944,1.5821664668851927
STAT,1871,36,50-100,1907,1.4163883360966045
STAT,1929,25,30-34,1954,56.80954181294126
SIM,1950,0,na,1950,5118
STAT,1864,45,30-34,1909,0.10074117700604239
SIM,1919,29,30-34,1948,106
STAT,1822,48,30-34,1870,0.18036783241517362
STAT,1932,28,40-44,1960,7.043790501995432
STAT,1956,48,35-39,2004,0.20422134890647586
SIM,1934,56,na,1990,5455
SIM,1914,38,40-44,1952,4
SIM,1905,29,30-34,1934,53
STAT,1925,32,35-39,1957,12.519429844300191
SIM,1972,21,50-100,1993,2
STAT,1926,27,50-100,1953,1.376717001918135
SIM,1901,26,50-100,1927,2
STAT,1976,39,20-24,2015,0.41783538022462985
SIM,1855,63,na,1918,1413
STAT,1805,49,40-44,1854,0.6255312935545603
SIM,1868,30,35-39,1898,16
STAT,1859,33,25-29,1892,9.376338588781314
SIM,1940,46,40-44,1986,1
SIM,1903,19,25-29,1922,21
STAT,1928,28,20-24,1956,25.94000743949906
STAT,1902,45,45-49,1947,0.21923930545653195
STAT,1913,22,na,1935,4269.781599458018
STAT,1939,47,35-39,1986,0.1549800071184538
STAT,1875,31,15-19,1906,0.17052879148105757
SIM,1941,38,na,1979,3952
SIM,1942,23,45-49,1965,2
SIM,1863,50,na,1913,2178
SIM,1954,24,20-24,1978,299
SIM,1839,15,20-24,1854,39
SIM,1950,31,25-29,1981,28
STAT,1900,32,50-100,1932,1.4672350052496295
STAT,1950,24,40-44,1974,4.600117348468311
STAT,1970,19,15-19,1989,65.51821477420438
STAT,1900,31,20-24,1931,4.346247655615608
SIM,1804,71,na,1875,475
SIM,1907,42,35-39,1949,1
SIM,1937,25,30-34,1962,97
SIM,1896,77,na,1973,1975
SIM,1910,45,45-49,1955,1
STAT,1899,53,na,1952,3349.7417314785607
SIM,1886,55,na,1941,1711
STAT,1853,32,50-100,1885,0.9394094793942653
STAT,1932,46,40-44,1978,0.24749284645446862
STAT,1954,36,na,1990,5534.788105821353
SIM,1879,73,na,1952,1326
SIM,1983,31,na,2014,6939
STAT,1912,18,15-19,1930,10.573081200213743
SIM,1943,24,45-49,1967,2
STAT,1794,107,na,1901,0.0011803340672230556
STAT,1913,33,25-29,1946,10.57310633224461
SIM,1781,89,na,1870,56
STAT,1788,79,na,1867,418.0954504111065
STAT,1945,26,25-29,1971,83.37302680844375
SIM,1880,50,na,1930,3057
STAT,1920,93,na,2013,416.66092990060946
SIM,1900,23,40-44,1923,9
SIM,1925,28,45-49,1953,2
STAT,1917,28,45-49,1945,2.0835687843637154
SIM,1921,33,25-29,1954,5
SIM,1889,34,50-100,1923,5
STAT,1949,49,15-19,1998,5.112531583917609E-4
STAT,1848,53,na,1901,2251.0672418126574
STAT,1916,70,na,1986,3408.829584626973
STAT,1942,31,25-29,1973,11.370750532826277
STAT,1935,24,45-49,1959,1.7679891793697613
STAT,1943,19,50-100,1962,0.45823455956755993
STAT,1833,53,50-100,1886,0.010811774054078148
STAT,1937,19,30-34,1956,13.651094458734704
SIM,1901,21,35-39,1922,2
STAT,1902,30,45-49,1932,2.8663819774499624
SIM,1852,20,30-34,1872,26
SIM,1953,26,25-29,1979,111
STAT,1913,45,20-24,1958,0.012513190910677032
SIM,1932,21,na,1953,4799
STAT,1938,49,40-44,1987,0.18568648676405217
SIM,1872,55,na,1927,2635
STAT,1923,52,na,1975,4874.490086135022
STAT,1868,24,35-39,1892,6.429686855725387
STAT,1904,42,15-19,1946,0.0015872882469368502
SIM,1843,50,na,1893,1692
STAT,1934,23,45-49,1957,1.745321261262517
STAT,1912,1,na,1913,4862.055140940061
STAT,1970,39,25-29,2009,1.4622977917179836
STAT,1770,101,na,1871,0.06247823534702106
STAT,1964,20,20-24,1984,162.26960825960606
SIM,1921,30,20-24,1951,8
STAT,1909,34,45-49,1943,1.7200233813980743
SIM,1867,15,25-29,1882,9
SIM,1894,42,na,1936,3738
STAT,1840,44,30-34,1884,0.9377194083879014
STAT,1952,59,na,2011,4969.481791684528
STAT,1864,32,50-100,1896,0.9441375126772279
STAT,1839,22,15-19,1861,3.361622731240143
STAT,1948,38,45-49,1986,0.926621501203682
STAT,1858,35,30-34,1893,4.843712813282122
SIM,1915,77,na,1992,2739
STAT,1922,33,50-100,1955,1.0730653055687818
STAT,1907,36,35-39,1943,2.6046519189159887
SIM,1888,41,45-49,1929,3
SIM,1837,20,35-39,1857,17
SIM,1957,39,45-49,1996,1
STAT,1949,39,45-49,1988,0.9406510953786779
STAT,1924,34,40-44,1958,5.260666100531171
STAT,1933,29,40-44,1962,7.138388409301659
SIM,1874,42,na,1916,2548
STAT,1927,45,20-24,1972,0.016080702022027472
SIM,1972,20,20-24,1992,302
SIM,1941,29,40-44,1970,7
STAT,1917,38,15-19,1955,0.022904909468265646
STAT,1930,32,15-19,1962,0.19141205196603295
STAT,1885,20,20-24,1905,79.79911286897283
STAT,1819,43,50-100,1862,2.1537264243714027
STAT,1869,25,35-39,1894,10.856882930967913
STAT,1918,39,15-19,1957,0.023304085025334778
SIM,1884,18,35-39,1902,1
STAT,1846,58,na,1904,2044.4048738740976
STAT,1900,105,na,2005,2.3657365177253746
STAT,1904,24,15-19,1928,5.4329802851103475
SIM,1856,17,na,1873,2448
STAT,1923,19,30-34,1942,16.42273428711257
SIM,1893,20,20-24,1913,197
STAT,1966,39,na,2005,5575.063630681629
SIM,1917,34,45-49,1951,4
STAT,1940,44,na,1984,4508.928701134405
STAT,1919,36,25-29,1955,1.2215429503615216
SIM,1956,38,45-49,1994,1
SIM,1848,81,na,1929,96
STAT,1943,18,45-49,1961,0.6111933304223944
SIM,1941,26,35-39,1967,1
SIM,1951,28,15-19,1979,2
SIM,1915,18,35-39,1933,3
SIM,1931,19,30-34,1950,23
STAT,1851,30,15-19,1881,0.12000487437583035
SIM,1951,18,45-49,1969,1
STAT,1943,28,15-19,1971,0.8673347190071643
SIM,1890,80,na,1970,1150
SIM,1945,19,30-34,1964,19
SIM,1879,0,na,1879,3821
STAT,1844,20,30-34,1864,18.871896296524593
STAT,1967,32,40-44,1999,5.7503383028579655
SIM,1835,63,na,1898,1574
SIM,1926,69,na,1995,4722
SIM,1931,37,30-34,1968,1
STAT,1862,96,na,1958,12.826893540558373
SIM,1828,81,na,1909,574
STAT,1908,33,45-49,1941,1.709081368682707
SIM,1917,64,na,1981,4400
SIM,1946,30,20-24,1976,6
STAT,1907,18,35-39,1925,0.9292531974309716
SIM,1930,36,30-34,1966,4
SIM,1829,39,50-100,1868,3
STAT,1954,44,na,1998,5488.09993155839
SIM,1941,46,na,1987,3929
SIM,1903,64,na,1967,2984
SIM,1916,33,45-49,1949,3
STAT,1868,9,na,1877,3022.224355908987
STAT,1810,49,20-24,1859,0.04472427113227601
SIM,1927,36,25-29,1963,2
STAT,1890,35,30-34,1925,7.586719436165068
STAT,1922,36,30-34,1958,2.394459450985314
STAT,1938,30,20-24,1968,2.834990616716629
STAT,1771,90,na,1861,35.24507839659952
STAT,1886,27,na,1913,2905.1413444961554
STAT,1849,15,na,1864,2215.9882086053067
STAT,1807,79,na,1886,402.64652191588726
SIM,1887,60,na,1947,3047
STAT,1994,21,30-34,2015,48.03808504826165
SIM,1961,21,50-100,1982,1
SIM,1925,25,40-44,1950,17
STAT,1904,0,na,1904,4866.1532098512735
STAT,1953,36,50-100,1989,0.6044194566095501
SIM,1973,36,40-44,2009,7
STAT,1889,104,na,1993,3.4592742575856112
STAT,1888,49,35-39,1937,0.10489413439497591
STAT,1860,2,na,1862,3212.5980181703
SIM,1979,27,15-19,2006,2
SIM,1915,39,40-44,1954,6
SIM,1963,18,35-39,1981,13
STAT,1955,18,35-39,1973,6.426490760463928
SIM,1939,0,na,1939,5351
SIM,1902,59,na,1961,3445
SIM,1876,24,35-39,1900,13
STAT,1862,111,na,1973,0.0019494870156738244
SIM,1869,35,na,1904,1995
STAT,1859,48,50-100,1907,0.22294428785544435
STAT,1957,40,30-34,1997,0.20271910934968415
STAT,1879,27,50-100,1906,0.7708414057417676
STAT,1942,17,45-49,1959,0.6025603490101045
STAT,1970,28,50-100,1998,1.4434347724559058
SIM,1879,65,na,1944,1930
SIM,1851,93,na,1944,10
STAT,1762,110,na,1872,0.0025795869910938576
SIM,1922,4,na,1926,5559
STAT,1937,24,na,1961,4103.377933051413
STAT,1839,110,na,1949,2.191498594735549E-4
STAT,1933,26,35-39,1959,23.026408593677896
STAT,1965,36,40-44,2001,2.224060057090912
STAT,1914,43,15-19,1957,0.001754161091610713
STAT,1977,37,15-19,2014,0.030849386341481745
STAT,1951,25,40-44,1976,6.438668077756456
STAT,1969,30,50-100,1999,1.216335600187286
SIM,1824,71,na,1895,523
STAT,1939,44,30-34,1983,0.1530306108230183
STAT,1924,14,na,1938,5426.143792896368
SIM,1826,30,30-34,1856,14
SIM,1866,55,na,1921,2102
STAT,1852,17,35-39,1869,0.6256914525425376
STAT,1828,61,na,1889,1259.1489430105512
STAT,1832,37,35-39,1869,6.2149240739315115
STAT,1955,47,na,2002,5854.278678662778
SIM,1987,21,35-39,2008,19
STAT,1916,27,45-49,1943,2.0616725303397154
SIM,1822,37,na,1859,1748
STAT,1942,35,45-49,1977,0.8486477124814896
STAT,1901,15,35-39,1916,0.891099891440922
STAT,1862,47,20-24,1909,0.011632703098326484
STAT,1897,10,na,1907,3997.2196609301586
STAT,1907,39,40-44,1946,1.5881769790214124
STAT,1881,48,40-44,1929,0.18817321228258918
STAT,1970,18,30-34,1988,17.60268754511308
STAT,1925,35,40-44,1960,2.076417467006266
STAT,1939,17,40-44,1956,1.616423660852944
SIM,1924,27,45-49,1951,2
STAT,1866,27,na,1893,2552.772909051322
STAT,1893,37,50-100,1930,1.7909311302756141
SIM,1950,35,45-49,1985,1
STAT,1963,42,na,2005,5658.857768216458
STAT,1917,25,40-44,1942,5.679534338662477
STAT,1871,81,na,1952,620.8659855421225
STAT,1905,36,50-100,1941,0.44476163004206226
STAT,1794,87,na,1881,77.02932675499699
SIM,1860,17,35-39,1877,1
STAT,1859,15,25-29,1874,6.118949049365783
SIM,1856,8,na,1864,2652
SIM,1901,24,40-44,1925,5
SIM,1921,32,45-49,1953,1
STAT,1965,28,na,1993,5418.029416214775
STAT,1911,20,40-44,1931,3.7051943203400453
STAT,1921,49,na,1970,4749.7398282621925
STAT,1979,21,35-39,2000,15.016117352529143
STAT,1921,42,45-49,1963,0.21625021188577565
SIM,1861,24,na,1885,1686
SIM,1961,38,na,1999,5599
SIM,1935,67,na,2002,4998
SIM,1835,22,25-29,1857,126
SIM,1986,20,35-39,2006,1
STAT,1950,42,40-44,1992,0.35469710237455787
STAT,1969,27,25-29,1996,95.2984440158398
SIM,1892,25,30-34,1917,44
STAT,1930,14,na,1944,5893.348182438392
STAT,1964,23,25-29,1987,134.65992389254973
SIM,1943,41,na,1984,5354
STAT,1852,35,na,1887,2280.1644032116965
SIM,1812,49,25-29,1861,1
SIM,1900,41,40-44,1941,1
SIM,1921,18,30-34,1939,22
STAT,1964,39,30-34,2003,2.7234603324557174
SIM,1928,34,20-24,1962,7
STAT,1924,37,45-49,1961,0.9274470929387265
STAT,1916,45,45-49,1961,0.25849715573526244
SIM,1846,78,na,1924,134
SIM,1930,39,35-39,1969,7
SIM,1903,72,na,1975,2415
STAT,1940,33,15-19,1973,0.15343879753227305
STAT,1946,49,na,1995,4862.53904578369
STAT,1932,42,20-24,1974,0.027629446746283554
SIM,1910,46,na,1956,3388
SIM,1955,18,na,1973,5843
SIM,1897,39,na,1936,3743
STAT,1960,31,45-49,1991,2.4123095735753632
SIM,1840,37,35-39,1877,13
SIM,1924,45,45-49,1969,1
SIM,1932,32,20-24,1964,8
STAT,1872,35,na,1907,2756.0397420457452
STAT,1936,35,15-19,1971,0.02180713344972694
SIM,1976,31,30-34,2007,12
STAT,1979,26,na,2005,5980.984342626503
STAT,1945,23,20-24,1968,140.5953458892053
STAT,1840,47,35-39,1887,0.11325387023612474
STAT,1962,25,15-19,1987,1.0493018777440573
STAT,1783,95,na,1878,1.9032397913367833
SIM,1814,44,50-100,1858,3
SIM,1877,25,35-39,1902,4
STAT,1945,41,20-24,1986,0.02317057474650178
STAT,1965,31,50-100,1996,1.2149344817895982
STAT,1868,21,30-34,1889,19.892511096957147
SIM,1951,15,40-44,1966,3
STAT,1913,18,30-34,1931,2.869980796930747
STAT,1914,93,na,2007,374.161339144539
STAT,1850,45,50-100,1895,0.2553525730233275
SIM,1853,37,na,1890,2251
SIM,1921,38,na,1959,5214
STAT,1943,15,40-44,1958,1.7127972086176964
SIM,1844,16,40-44,1860,2
SIM,1953,23,20-24,1976,169
STAT,1970,36,20-24,2006,0.39269429824031393
STAT,1872,66,na,1938,1899.288572519201
STAT,1877,19,na,1896,3015.5918622187714
SIM,1876,21,30-34,1897,19
STAT,1912,17,30-34,1929,2.847120231356517
STAT,1836,28,na,1864,2529.0726652644485
STAT,1895,20,50-100,1915,0.6162344777963145
STAT,1895,15,35-39,1910,0.828096133651429
SIM,1997,11,na,2008,6607
STAT,1806,86,na,1892,76.15250192354942
STAT,1890,7,na,1897,3673.86538057896
SIM,1938,26,na,1964,3869
SIM,1986,28,na,2014,6689
SIM,1877,22,30-34,1899,1
STAT,1857,26,50-100,1883,0.59650306725079
STAT,1879,45,na,1924,2738.129120270386
SIM,1920,17,30-34,1937,39
SIM,1815,55,na,1870,1639
SIM,1930,20,15-19,1950,9
STAT,1938,33,25-29,1971,10.723740604614566
SIM,1814,47,35-39,1861,1
STAT,1928,25,15-19,1953,1.0104958238397035
STAT,1869,22,30-34,1891,19.90715565760762
SIM,1881,24,na,1905,2063
SIM,1844,12,na,1856,3054
STAT,1835,43,na,1878,1550.0253326689217
STAT,1902,90,na,1992,576.5295720271257
STAT,1906,40,na,1946,3942.333194062768
STAT,1959,38,20-24,1997,0.40956097580860906
SIM,1886,47,na,1933,1921
SIM,1915,0,na,1915,5215
STAT,1848,61,na,1909,1985.4770690152727
STAT,1884,25,30-34,1909,28.90772850700316
SIM,1946,33,25-29,1979,21
STAT,1922,39,35-39,1961,3.168054095074034
SIM,1807,68,na,1875,807
SIM,1938,23,25-29,1961,1
SIM,1972,39,30-34,2011,1
STAT,1790,107,na,1897,0.0010437768671266664
STAT,1997,17,15-19,2014,76.47913908031035
SIM,1922,29,35-39,1951,2
SIM,1856,48,50-100,1904,1
STAT,1919,33,20-24,1952,3.023429079384667
STAT,1960,46,35-39,2006,0.20207363662273223
STAT,1877,10,na,1887,3148.431261325861
STAT,1883,58,na,1941,2232.8900605167137
STAT,1830,39,25-29,1869,2.8209974091525836
SIM,1896,85,na,1981,1093
STAT,1890,60,na,1950,2689.3525826928203
SIM,1944,26,na,1970,4324
SIM,1890,29,na,1919,3543
STAT,1895,83,na,1978,1238.3436776640756
SIM,1906,47,45-49,1953,1
STAT,1922,20,15-19,1942,7.0837968355417145
SIM,1909,69,na,1978,3847
STAT,1950,22,20-24,1972,152.23144596206896
SIM,1900,21,20-24,1921,11
STAT,1851,73,na,1924,941.8817158544193
STAT,1903,29,25-29,1932,69.03713799612089
SIM,1970,44,na,2014,5917
STAT,1863,45,15-19,1908,4.076678795978942E-4
STAT,1954,15,15-19,1969,64.7811699869407
STAT,1960,40,50-100,2000,0.1840188602348469
STAT,1839,25,20-24,1864,11.890614395684935
STAT,1878,17,50-100,1895,0.059033036614655324
STAT,1893,30,20-24,1923,3.9746963112273477
STAT,1964,21,50-100,1985,0.9598864334717773
STAT,1950,41,25-29,1991,0.10141028441966322
SIM,1822,38,30-34,1860,12
STAT,1984,15,50-100,1999,0.6144100726752735
STAT,1979,16,30-34,1995,19.37321267605803
STAT,1904,9,na,1913,4299.875768481893
STAT,1886,42,50-100,1928,1.2844473455123073
STAT,1888,46,30-34,1934,0.1316892529237854
STAT,1905,24,30-34,1929,29.565999842733426
SIM,1880,36,25-29,1916,2
SIM,1939,56,na,1995,4590
STAT,1951,28,45-49,1979,2.38326634426309
SIM,1925,41,40-44,1966,1
STAT,1936,38,20-24,1974,0.29853295115100337
SIM,1878,22,45-49,1900,1
STAT,1989,17,50-100,2006,0.6193017287795096
STAT,1852,22,50-100,1874,0.4567326974825736
STAT,1860,24,30-34,1884,16.83421193934278
STAT,1905,87,na,1992,950.0305636963368
SIM,1934,46,45-49,1980,3
SIM,1868,50,na,1918,2908
STAT,1894,17,40-44,1911,0.2713438574545551
STAT,1897,23,15-19,1920,5.075104868924761
SIM,1962,15,15-19,1977,129
SIM,1830,63,na,1893,1246
STAT,1804,82,na,1886,224.88529267097687
STAT,1872,54,25-29,1926,0.00399162151711172
SIM,1911,29,25-29,1940,142
STAT,1947,38,30-34,1985,2.438463576926124
STAT,1916,24,40-44,1940,4.0410016756365055
SIM,1906,28,40-44,1934,6
STAT,1940,38,40-44,1978,1.805902872604109
SIM,1884,15,30-34,1899,2
STAT,1859,76,na,1935,870.9526439992401
SIM,1826,33,35-39,1859,10
STAT,1876,15,30-34,1891,1.9102869689420512
STAT,1882,30,45-49,1912,1.9814628081998427
SIM,1901,27,45-49,1928,4
SIM,1858,25,30-34,1883,68
STAT,1902,19,50-100,1921,0.079459109391101
SIM,1955,38,30-34,1993,3
STAT,1954,47,20-24,2001,0.0163993034455769
SIM,1970,28,20-24,1998,10
SIM,1850,63,na,1913,1039
SIM,1848,50,na,1898,1650
STAT,1962,28,20-24,1990,27.09533666107742
STAT,1980,29,50-100,2009,1.5999413414152617
SIM,1873,15,20-24,1888,49
STAT,1845,24,35-39,1869,4.811806678413658
STAT,1903,40,35-39,1943,0.20878510560839333
SIM,1897,19,25-29,1916,1
SIM,1924,24,40-44,1948,9
STAT,1880,61,na,1941,2285.7920889967886
STAT,1999,15,25-29,2014,73.92118204312523
STAT,1966,34,35-39,2000,13.40950546253565
SIM,1908,64,na,1972,3054
SIM,1828,29,50-100,1857,1
STAT,1974,25,40-44,1999,7.060353749457002
SIM,1899,42,na,1941,3981
STAT,1903,47,25-29,1950,0.053159296109820446
STAT,1899,32,15-19,1931,0.2251565627220342
STAT,1904,27,20-24,1931,19.4415862668821
SIM,1974,34,35-39,2008,22
STAT,1924,32,20-24,1956,3.283186930255122
SIM,1847,25,20-24,1872,22
SIM,1912,27,20-24,1939,3
STAT,1891,49,40-44,1940,0.13486512651540344
SIM,1878,80,na,1958,942
SIM,1932,37,45-49,1969,2
SIM,1870,29,na,1899,2918
SIM,1921,69,na,1990,4211
SIM,1841,53,50-100,1894,1
SIM,1939,37,35-39,1976,7
SIM,1912,80,na,1992,1163
STAT,1796,107,na,1903,0.0012011769037307304
STAT,1889,19,25-29,1908,8.018082573494178
STAT,1941,49,na,1990,4516.833971550454
SIM,1833,29,na,1862,1960
STAT,1866,35,na,1901,2544.032626993153
STAT,1942,32,40-44,1974,4.811581026669035
STAT,1872,36,25-29,1908,3.3524784138372112
SIM,1866,35,30-34,1901,4
STAT,1841,74,na,1915,986.7020927917023
SIM,1950,32,40-44,1982,8
STAT,1968,34,35-39,2002,13.409396392791484
STAT,1925,38,45-49,1963,0.9429986456739664
STAT,1828,84,na,1912,220.78836678563582
STAT,1989,2,na,1991,6504.883014450569
STAT,2004,11,na,2015,6928.574239332623
STAT,1924,18,40-44,1942,1.9166604761564983
SIM,1843,81,na,1924,156
STAT,1851,81,na,1932,428.82345621061216
STAT,1807,48,na,1855,1711.9072788328078
STAT,1843,20,15-19,1863,4.215264637599385
STAT,1832,52,30-34,1884,0.004298510247917731
SIM,1848,23,15-19,1871,3
SIM,1976,34,35-39,2010,1
STAT,1872,46,50-100,1918,0.28540985889700526
SIM,1827,31,30-34,1858,35
SIM,1851,25,na,1876,2789
STAT,1852,52,50-100,1904,0.014163273190175957
STAT,1941,36,35-39,1977,2.9655376344421622
SIM,1924,42,40-44,1966,1
STAT,1969,24,20-24,1993,160.7217425951437
STAT,1926,31,45-49,1957,2.196657650898379
STAT,1921,36,15-19,1957,0.02475855763497151
STAT,1950,45,45-49,1995,0.30992785953266183
SIM,1967,22,40-44,1989,11
SIM,1906,69,na,1975,2628
SIM,1928,37,25-29,1965,2
STAT,1840,28,30-34,1868,25.006798762807808
STAT,1848,48,50-100,1896,0.25767787306320067
STAT,1857,21,20-24,1878,72.02246499304425
STAT,1815,66,na,1881,1065.132164348559
STAT,1830,54,20-24,1884,5.753571034563868E-4
SIM,1932,18,40-44,1950,4
STAT,1851,47,45-49,1898,0.18627429169268314
STAT,1905,42,30-34,1947,0.1331865416586906
SIM,1814,44,30-34,1858,3
STAT,1855,66,na,1921,1394.626426461171
SIM,1876,27,40-44,1903,9
SIM,1883,50,na,1933,2354
SIM,1934,31,45-49,1965,5
STAT,1916,42,40-44,1958,0.2958372062763844
STAT,1946,21,15-19,1967,6.838372042285706
SIM,2005,3,na,2008,6478
SIM,1958,18,na,1976,5478
SIM,1859,23,25-29,1882,122
STAT,1955,29,na,1984,5758.250266219525
STAT,1910,57,na,1967,3785.907602520864
SIM,1805,56,na,1861,1383
SIM,1881,43,50-100,1924,2
SIM,1815,63,na,1878,1354
STAT,1865,15,20-24,1880,21.152434005134996
STAT,1877,17,35-39,1894,0.6586951054035592
STAT,1915,46,35-39,1961,0.15033062009855666
SIM,1827,43,50-100,1870,2
STAT,1867,40,20-24,1907,0.17284585862451363
SIM,1853,21,30-34,1874,30
SIM,1907,26,35-39,1933,37
STAT,1915,27,30-34,1942,46.130185283024375
STAT,1950,27,45-49,1977,2.3675915708526087
STAT,1926,46,45-49,1972,0.3101865489803793
STAT,1832,34,30-34,1866,15.501217684111136
SIM,1949,59,na,2008,5381
STAT,1932,45,50-100,1977,0.35583454296627587
SIM,1939,36,50-100,1975,2
SIM,1855,32,na,1887,1905
SIM,1913,24,30-34,1937,45
SIM,1923,64,na,1987,4582
SIM,1801,83,na,1884,216
STAT,1897,19,na,1916,3876.4475554730734
SIM,1851,20,15-19,1871,5
SIM,1840,34,30-34,1874,25
STAT,1959,22,40-44,1981,5.09250857514802
STAT,1791,99,na,1890,0.40541242274183553
STAT,1931,32,30-34,1963,23.829844382824607
STAT,1850,15,50-100,1865,0.062362617563949216
STAT,1804,74,na,1878,606.3525475449931
STAT,1845,21,30-34,1866,15.008580481016002
SIM,1849,20,25-29,1869,87
STAT,1827,48,na,1875,2025.5909562327558
SIM,1879,17,15-19,1896,6
STAT,1866,58,na,1924,2115.360618067686
STAT,1882,65,na,1947,1904.9510969821245
STAT,1814,81,na,1895,337.17667049238213
STAT,1930,17,20-24,1947,202.3052380242879
STAT,1776,82,na,1858,229.2090196569282
STAT,1917,44,45-49,1961,0.19977752059125317
STAT,1878,30,25-29,1908,12.441088838017553
SIM,1922,26,30-34,1948,80
SIM,1911,39,na,1950,4758
STAT,1933,4,na,1937,6238.105540225842
STAT,1863,49,35-39,1912,0.13832569975947112
STAT,1912,34,15-19,1946,0.14481561873519466
SIM,1873,29,na,1902,3431
STAT,1959,36,na,1995,5856.440297651217
SIM,1923,27,30-34,1950,114
STAT,1909,47,20-24,1956,0.011732230788298915
STAT,1931,47,30-34,1978,0.13758899890849993
STAT,1936,18,30-34,1954,13.439862672136467
SIM,1908,23,45-49,1931,3
SIM,1946,38,na,1984,4628
SIM,1886,30,25-29,1916,28
STAT,1981,26,50-100,2007,1.6138793351983771
STAT,1904,26,50-100,1930,1.0637485251983654
STAT,1979,19,35-39,1998,6.66313254344453
STAT,1961,27,20-24,1988,27.334245802375722
SIM,1911,26,20-24,1937,30
STAT,1959,37,50-100,1996,0.6529735073834395
STAT,1953,21,50-100,1974,0.9219380259621176
STAT,1968,46,50-100,2014,0.33995162051311645
STAT,1893,33,25-29,1926,14.878025475907867
STAT,1875,48,45-49,1923,0.2779160579264183
STAT,1933,42,50-100,1975,0.18635929810658955
SIM,1872,29,30-34,1901,52
STAT,1862,65,na,1927,1645.9092664924242
STAT,1919,67,na,1986,3863.001198362801
STAT,1979,16,50-100,1995,0.595487973482133
STAT,1972,27,30-34,1999,58.14668421355253
SIM,1900,47,na,1947,3354
STAT,1927,30,45-49,1957,2.2359044279807514
STAT,1950,25,25-29,1975,90.2813610553208
STAT,1907,90,na,1997,617.9460435041713
STAT,1964,36,25-29,2000,1.4757764864266305
STAT,1960,43,30-34,2003,0.19938596548154164
STAT,1992,21,30-34,2013,47.7825434052167
SIM,1980,17,25-29,1997,74
SIM,1836,48,na,1884,1560
STAT,1896,5,na,1901,3994.602865979249
STAT,1830,36,20-24,1866,0.7917604086142276
STAT,1848,84,na,1932,353.4638587966595
SIM,1883,48,45-49,1931,1
SIM,1867,33,50-100,1900,5
STAT,1893,57,na,1950,2931.485995288665
STAT,1856,28,na,1884,2161.7041175223094
STAT,1876,18,35-39,1894,0.6528833568581138
SIM,1802,68,na,1870,776
STAT,1889,16,20-24,1905,25.282004878968607
STAT,1869,41,50-100,1910,1.1860417942934982
STAT,1856,40,45-49,1896,1.331011993103675
SIM,1872,48,35-39,1920,3
SIM,1900,24,25-29,1924,86
STAT,1864,48,35-39,1912,0.14244916621668277
SIM,1897,16,20-24,1913,36
SIM,1954,21,15-19,1975,7
STAT,1914,16,25-29,1930,10.375481376114962
STAT,1968,29,30-34,1997,56.666272991344854
SIM,1910,54,na,1964,3239
STAT,1835,74,na,1909,691.6800789631908
SIM,1922,16,25-29,1938,83
STAT,1899,38,50-100,1937,0.41690155621381764
STAT,1814,53,25-29,1867,0.009228853160847617
SIM,1848,73,na,1921,688
STAT,1876,28,na,1904,2837.0500664139313
STAT,1845,73,na,1918,800.3729576350019
STAT,1849,41,15-19,1890,0.010751991120363088
STAT,1989,23,15-19,2012,8.82532642358391
SIM,1816,44,30-34,1860,4
STAT,1987,21,na,2008,6038.204376259505
SIM,1954,27,25-29,1981,102
STAT,1956,40,15-19,1996,0.0024438797014447733
STAT,1811,52,50-100,1863,0.04494978131195841
SIM,2008,0,na,2008,7736
STAT,1773,100,na,1873,0.3963507959334761
STAT,1903,44,20-24,1947,0.01788337769706094
STAT,1945,44,25-29,1989,0.09324352208605081
SIM,1858,80,na,1938,964
SIM,1929,28,50-100,1957,2
STAT,1851,25,50-100,1876,0.6025677220325152
STAT,1913,30,20-24,1943,2.8246279592032204
SIM,1815,86,na,1901,183
STAT,1862,22,40-44,1884,2.0775652394499216
STAT,1879,53,na,1932,2552.9485108899994
SIM,1939,19,35-39,1958,14
STAT,1831,46,50-100,1877,0.23048209805968373
STAT,1835,66,na,1901,1021.5194977504477
STAT,1935,37,20-24,1972,0.42562331218037713
SIM,1853,29,na,1882,2368
SIM,1918,28,30-34,1946,9
SIM,1927,17,20-24,1944,343
STAT,1919,17,20-24,1936,172.86072231302535
STAT,1772,101,na,1873,0.01705047937776346
STAT,1911,17,15-19,1928,10.489563479272562
SIM,1931,34,25-29,1965,28
STAT,1915,43,30-34,1958,0.14833115457683443
STAT,1846,46,25-29,1892,0.05971491007119209
STAT,1906,98,na,2004,77.21111346372355
SIM,1952,56,na,2008,4371
SIM,1961,20,45-49,1981,2
SIM,1938,36,35-39,1974,1
STAT,1956,45,30-34,2001,0.14226455929381276
SIM,1846,47,na,1893,1494
STAT,1903,26,20-24,1929,19.350069439616323
STAT,1846,21,45-49,1867,0.8958970980747617
STAT,1923,34,25-29,1957,12.207741833481165
SIM,1945,35,30-34,1980,2
STAT,1839,28,25-29,1867,41.95841369930026
STAT,1953,20,45-49,1973,1.5770817137424726
STAT,1847,22,45-49,1869,0.6577667128268984
SIM,1932,35,25-29,1967,5
STAT,1913,48,25-29,1961,0.059615752014440984
STAT,1924,35,25-29,1959,1.3418342218888923
STAT,1868,27,40-44,1895,3.321384272336908
SIM,1964,45,30-34,2009,1
STAT,1822,48,na,1870,2114.33198089063
STAT,1858,91,na,1949,52.16960808541173
STAT,1946,27,25-29,1973,84.61311410644997
SIM,1886,24,na,1910,2273
SIM,1974,31,30-34,2005,27
STAT,1869,46,na,1915,2521.579711392267
STAT,1890,19,30-34,1909,2.235494363995913
SIM,1847,28,25-29,1875,84
STAT,1906,32,na,1938,4050.0135563607455
STAT,1963,24,50-100,1987,0.9672576364332263
SIM,1967,25,45-49,1992,4
STAT,1951,22,35-39,1973,12.982469227828778
STAT,1863,46,30-34,1909,0.09795920067980984
STAT,1836,32,40-44,1868,4.990493156408208
STAT,1812,106,na,1918,0.005330606763657384
SIM,1992,11,na,2003,7033
STAT,1930,19,40-44,1949,2.0759650329462604
SIM,1954,37,30-34,1991,4
STAT,1901,40,na,1941,3786.8104944098604
SIM,1921,87,na,2008,1552
STAT,1880,49,30-34,1929,0.1159374465987878
STAT,1948,35,40-44,1983,2.040356133308931
STAT,1940,22,25-29,1962,108.62623547890443
STAT,1943,31,40-44,1974,4.884912855837866
SIM,1922,47,50-100,1969,1
STAT,1852,66,na,1918,1545.2807804114184
SIM,1859,20,20-24,1879,5
STAT,1952,33,40-44,1985,5.5131758193595415
STAT,1833,27,50-100,1860,0.6026920988573012
SIM,1852,23,35-39,1875,3
STAT,1844,23,35-39,1867,6.05040008605796
STAT,1915,57,na,1972,4085.3644608899644
SIM,1829,55,na,1884,1417
STAT,1937,35,30-34,1972,2.1080210315973837
STAT,1956,26,35-39,1982,23.03629001476155
STAT,1983,4,na,1987,6420.201192603443
SIM,1960,33,40-44,1993,16
STAT,1939,59,na,1998,4152.639500108417
STAT,1959,25,45-49,1984,2.6215140608669656
SIM,1819,48,na,1867,1096
STAT,1788,70,na,1858,981.1836257913357
STAT,1958,24,45-49,1982,1.7099372585571277
SIM,1844,32,40-44,1876,7
SIM,1964,26,35-39,1990,33
STAT,1890,38,35-39,1928,9.924200038541699
SIM,1827,34,35-39,1861,24
SIM,1835,55,na,1890,1875
STAT,1923,75,na,1998,3287.4286299324294
SIM,1975,18,na,1993,5354
STAT,1855,29,20-24,1884,10.255943186378573
SIM,1923,72,na,1995,3986
STAT,1864,91,na,1955,59.711839710329386
STAT,1915,19,45-49,1934,0.12003148131884617
SIM,1848,25,35-39,1873,13
SIM,1951,31,40-44,1982,2
STAT,1937,33,45-49,1970,1.7965018095703993
STAT,1946,37,30-34,1983,2.4034273297432422
SIM,1829,32,45-49,1861,7
STAT,1866,15,35-39,1881,0.6095992377601568
STAT,1868,61,na,1929,2071.882625543095
STAT,1949,36,40-44,1985,2.0718703956586557
SIM,1866,47,na,1913,2286
STAT,1831,31,50-100,1862,0.9427817622661415
STAT,1957,27,35-39,1984,22.942868440795305
STAT,1926,43,40-44,1969,0.35521730069177737
SIM,1822,45,na,1867,1626
SIM,1924,57,na,1981,4574
SIM,1853,24,35-39,1877,3
STAT,1842,53,30-34,1895,0.004507090008997522
SIM,1858,28,35-39,1886,20
SIM,1909,49,50-100,1958,1
STAT,1865,18,25-29,1883,6.044560190957229
STAT,1821,74,na,1895,678.7374649861317
STAT,1857,10,na,1867,2553.5047408171854
SIM,1874,15,35-39,1889,1
STAT,1963,39,15-19,2002,0.028945050816919032
STAT,1899,45,na,1944,3593.288020253312
SIM,1957,36,40-44,1993,2
STAT,1891,15,50-100,1906,0.07020267065362092
STAT,1972,17,25-29,1989,64.03237428693147
STAT,1894,53,na,1947,3143.106767226509
STAT,1867,43,25-29,1910,0.6869185205487862
SIM,1909,21,40-44,1930,7
SIM,1875,43,25-29,1918,1
SIM,1935,30,45-49,1965,3
STAT,1834,34,30-34,1868,19.990164433793968
SIM,1842,34,30-34,1876,9
STAT,1963,25,30-34,1988,57.74651213149496
SIM,1971,25,30-34,1996,74
STAT,1917,41,40-44,1958,0.301679070431417
SIM,1912,26,50-100,1938,1
STAT,1876,1,na,1877,4120.974547314445
STAT,1951,40,35-39,1991,0.2883811372651262
STAT,1876,111,na,1987,0.009369776303646889
SIM,1932,79,na,2011,2682
STAT,1926,49,na,1975,5199.586396627752
SIM,1956,35,40-44,1991,4
SIM,1877,39,na,1916,3105
STAT,1941,33,30-34,1974,19.08276954086787
SIM,1832,24,30-34,1856,27
SIM,1833,51,na,1884,1466
SIM,1994,20,50-100,2014,1
STAT,1895,60,na,1955,2864.9499996493573
SIM,1921,5,na,1926,5612
SIM,1882,54,na,1936,2871
SIM,1852,29,45-49,1881,1
STAT,1927,41,35-39,1968,0.291802948415387
STAT,1829,39,20-24,1868,0.8483112519271057
STAT,1859,22,na,1881,2255.8065485038137
STAT,1973,30,50-100,2003,1.2592952235910413
STAT,1912,37,20-24,1949,0.2972053949388292
STAT,1924,15,35-39,1939,5.791871048447548
SIM,1944,32,45-49,1976,3
STAT,1920,22,40-44,1942,4.31198257336986
SIM,1887,30,40-44,1917,7
STAT,1897,16,50-100,1913,0.07578670234636035
SIM,1899,22,15-19,1921,5
STAT,1879,30,40-44,1909,5.267831185520018
STAT,1879,53,50-100,1932,0.017906892248355333
STAT,1844,29,45-49,1873,1.120597571708295
STAT,1955,29,25-29,1984,101.17305031294404
SIM,1885,35,35-39,1920,20
SIM,1869,17,20-24,1886,6
STAT,1828,30,na,1858,1950.313707540937
SIM,1919,40,40-44,1959,1
STAT,1850,47,30-34,1897,0.09918580158657259
STAT,1879,22,na,1901,2849.928222784288
SIM,1872,32,50-100,1904,1
SIM,1961,31,35-39,1992,6
STAT,1877,18,15-19,1895,7.105436205413216
SIM,1997,5,na,2002,6609
SIM,1965,0,na,1965,5634
STAT,1957,24,30-34,1981,43.846408910613256
STAT,1877,35,35-39,1912,8.571289429480247
STAT,1930,37,40-44,1967,2.2537098065795216
STAT,1892,44,30-34,1936,0.1139178326013763
STAT,1936,32,45-49,1968,1.7649337558441471
SIM,1859,42,na,1901,2249
STAT,1990,22,50-100,2012,1.091068993067787
STAT,1848,15,50-100,1863,0.06529709906183885
SIM,1863,29,20-24,1892,2
SIM,1967,20,na,1987,5020
STAT,1880,27,20-24,1907,14.350394994704322
STAT,1896,37,25-29,1933,4.388720238587257
STAT,1901,37,45-49,1938,0.6955346836418382
STAT,1911,10,na,1921,4578.508143479654
SIM,1903,30,35-39,1933,5
STAT,1873,25,20-24,1898,13.919192329257688
SIM,1853,51,na,1904,2123
STAT,1973,42,30-34,2015,0.19830205832854103
STAT,1868,84,na,1952,368.8461776903975
STAT,1982,16,35-39,1998,6.816126397624756
STAT,1997,14,na,2011,6617.194700891242
SIM,1894,26,45-49,1920,3
SIM,1888,36,30-34,1924,2
STAT,1870,23,na,1893,2682.45851525272
STAT,1890,49,25-29,1939,0.04485987924596681
SIM,1998,16,na,2014,6853
SIM,1923,19,45-49,1942,1
STAT,1921,28,30-34,1949,50.20026572217968
STAT,1940,40,25-29,1980,0.08722603283198814
STAT,1919,47,15-19,1966,4.6098867271389355E-4
SIM,1835,41,30-34,1876,5
SIM,1841,48,40-44,1889,1
SIM,1865,62,na,1927,2346
SIM,1910,23,na,1933,3347
STAT,1814,50,20-24,1864,0.0020417194977419457
STAT,1866,54,30-34,1920,0.006192120997668089
STAT,1895,31,35-39,1926,15.274966403191597
STAT,1882,16,30-34,1898,1.8010461097786257
SIM,1883,15,50-100,1898,4
STAT,1946,6,na,1952,5064.2438151704455
SIM,1907,23,30-34,1930,69
SIM,1863,54,50-100,1917,1
STAT,1833,48,40-44,1881,0.12765448945739805
STAT,1944,48,20-24,1992,0.014236746865658215
STAT,1923,21,na,1944,4916.561198488793
STAT,1847,35,20-24,1882,0.6283158677430454
STAT,1817,47,45-49,1864,0.6737439820055059
SIM,1918,45,50-100,1963,1
STAT,1973,25,25-29,1998,98.75017327495809
STAT,1906,63,na,1969,3350.8181964684
STAT,1887,46,15-19,1933,5.18797562435298E-4
STAT,1904,47,40-44,1951,0.1592932979025684
SIM,1963,29,25-29,1992,9
SIM,1901,60,na,1961,3327
SIM,1923,24,25-29,1947,6
SIM,1826,39,45-49,1865,3
STAT,1818,39,45-49,1857,2.908048345427762
STAT,1957,15,50-100,1972,0.5703660536555072
STAT,1966,15,40-44,1981,2.017212560812896
STAT,1962,22,45-49,1984,1.6692662144478454
SIM,1834,38,50-100,1872,2
STAT,1909,20,50-100,1929,0.7107612731684556
SIM,1962,37,25-29,1999,2
SIM,1888,27,30-34,1915,67
SIM,1903,41,na,1944,3720
STAT,1924,86,na,2010,1478.6297828348017
SIM,1949,23,35-39,1972,27
SIM,1959,25,15-19,1984,2
SIM,1970,22,45-49,1992,2
STAT,1915,24,25-29,1939,109.51962290148636
STAT,1937,30,40-44,1967,4.4755532490766
STAT,1995,17,15-19,2012,75.81443527487814
SIM,1906,25,35-39,1931,2
SIM,1898,30,15-19,1928,1
STAT,1876,37,40-44,1913,5.222268287519238
STAT,1933,45,40-44,1978,0.25150046618731586
STAT,1874,48,30-34,1922,0.11292710386695003
STAT,1911,2,na,1913,4711.663983359405
SIM,1835,32,na,1867,2519
SIM,1840,33,na,1873,2117
SIM,1894,40,25-29,1934,2
STAT,1904,21,45-49,1925,1.159103597153954
SIM,1912,21,45-49,1933,1
STAT,1834,46,35-39,1880,0.15081534083861883
STAT,1932,81,na,2013,2728.0054237963286
STAT,1927,49,30-34,1976,0.1283532267365072
STAT,1849,46,na,1895,1748.7309995164035
STAT,1815,97,na,1912,2.980958597336091
SIM,1822,35,25-29,1857,2
SIM,1897,16,na,1913,4108
STAT,1897,29,25-29,1926,64.81020799098931
STAT,1845,49,15-19,1894,2.639139103124103E-4
SIM,1842,37,35-39,1879,6
SIM,1935,49,30-34,1984,1
STAT,1935,78,na,2013,3441.1826102782375
STAT,1874,23,15-19,1897,3.8855791689764336
SIM,1984,16,na,2000,5908
SIM,1884,37,40-44,1921,9
SIM,1941,45,40-44,1986,1
STAT,1877,41,na,1918,2787.0700660836515
STAT,1919,36,na,1955,4667.533975732511
STAT,1859,33,50-100,1892,0.8387543109705383
SIM,1912,58,na,1970,3452
STAT,1831,34,15-19,1865,0.1420377886857362
STAT,1834,37,35-39,1871,8.028738027477186
STAT,1870,19,45-49,1889,0.07414574230431219
STAT,1886,26,45-49,1912,1.356222649700993
STAT,1828,47,20-24,1875,0.01105006889025774
SIM,1863,81,na,1944,267
STAT,1831,81,na,1912,424.26602722274356
STAT,1808,47,35-39,1855,0.6999260931809285
STAT,1776,99,na,1875,0.5093546322259963
STAT,1859,22,35-39,1881,5.565938103320854
STAT,1766,110,na,1876,0.0047940809451573075
STAT,1974,40,25-29,2014,0.11214107819436864
SIM,1902,32,40-44,1934,13
STAT,1827,41,30-34,1868,1.562133813048229
STAT,1929,39,25-29,1968,1.4557608592346083
SIM,1943,38,50-100,1981,2
STAT,1881,25,15-19,1906,0.5084557866342384
SIM,1880,59,na,1939,2642
STAT,1913,45,na,1958,4159.8349979839195
STAT,1937,38,35-39,1975,2.7899116866384697
STAT,1835,97,na,1932,3.348271062398341
SIM,1851,37,45-49,1888,8
SIM,1979,30,40-44,2009,10
SIM,1945,38,35-39,1983,11
STAT,1918,36,45-49,1954,0.8330501901358158
STAT,1843,37,45-49,1880,2.3350874448354713
SIM,1836,47,20-24,1883,1
STAT,1850,17,35-39,1867,0.6902578013834977
SIM,1938,49,na,1987,4018
STAT,1928,47,25-29,1975,0.07810763612209795
STAT,1866,89,na,1955,112.37174648364179
STAT,1873,43,50-100,1916,1.2360240978572343
SIM,1965,24,30-34,1989,55
STAT,1953,31,35-39,1984,13.011746557979356
SIM,1867,22,35-39,1889,8
STAT,1939,36,na,1975,4483.36915690111
SIM,1955,32,20-24,1987,1
SIM,1883,81,na,1964,805
STAT,1837,38,30-34,1875,4.650220084456066
STAT,1818,54,na,1872,1104.292149045831
SIM,1845,38,30-34,1883,15
STAT,1897,95,na,1992,172.25225953384788
STAT,1944,37,na,1981,4813.9324546941125
STAT,1906,33,50-100,1939,0.881636007041203
STAT,1848,33,15-19,1881,0.15891695449155827
STAT,1841,17,25-29,1858,6.497996755180625
STAT,1931,20,50-100,1951,0.9909639944628068
SIM,1866,24,na,1890,2596
STAT,1954,13,na,1967,5603.203182599579
SIM,1921,26,15-19,1947,1
SIM,1971,28,35-39,1999,54
SIM,1926,38,na,1964,5830
STAT,1963,28,35-39,1991,22.096827398604784
STAT,1862,0,na,1862,3753.438217725307
STAT,1978,34,50-100,2012,1.3256255962123726
STAT,1890,16,25-29,1906,8.010393717841746
STAT,1881,19,20-24,1900,19.62831407034836
STAT,1886,48,20-24,1934,0.014424187641801018
SIM,1982,25,30-34,2007,93
SIM,1868,59,na,1927,2512
SIM,1945,30,40-44,1975,12
STAT,1977,15,15-19,1992,70.80351482895858
SIM,1936,47,25-29,1983,1
SIM,1929,37,40-44,1966,2
STAT,1947,32,20-24,1979,3.232080260728775
SIM,1941,15,na,1956,3737
STAT,1892,47,35-39,1939,0.11369478596593821
SIM,1907,8,na,1915,4847
STAT,1964,34,15-19,1998,0.19014770500366066
SIM,1903,95,na,1998,142
SIM,1823,100,na,1923,4
STAT,1853,31,30-34,1884,18.087971405205053
STAT,1838,54,na,1892,1813.8065530724373
STAT,1928,34,50-100,1962,1.1915111667147977
SIM,1894,73,na,1967,2443
SIM,1793,91,na,1884,22
STAT,1899,49,45-49,1948,0.20608325581809184
STAT,1840,98,na,1938,2.6059846902180093
SIM,1941,16,50-100,1957,1
STAT,1967,45,40-44,2012,0.23751974656007016
STAT,1880,42,15-19,1922,0.016871955304686048
STAT,1886,40,25-29,1926,0.7895926006190911
STAT,1840,25,25-29,1865,42.92526767583026
STAT,1970,32,35-39,2002,13.456679977520254
STAT,1953,39,30-34,1992,2.615790321787251
STAT,1940,13,na,1953,4618.080344908911
SIM,1846,24,na,1870,1758
SIM,1888,59,na,1947,2248
STAT,1914,26,30-34,1940,45.76315134346407
STAT,1853,31,na,1884,2472.1778180354486
SIM,1861,31,30-34,1892,6
STAT,1947,27,40-44,1974,6.085348419291758
STAT,1966,18,45-49,1984,0.7198206868915513
SIM,1871,28,30-34,1899,3
SIM,1909,18,15-19,1927,11
SIM,1961,36,50-100,1997,1
STAT,1959,19,15-19,1978,68.46368577418687
STAT,1899,22,na,1921,3739.308426075084
SIM,1868,33,40-44,1901,11
SIM,1967,22,50-100,1989,3
STAT,1911,64,na,1975,3557.5657685213077
STAT,1875,2,na,1877,3896.7849266559992
STAT,1802,79,na,1881,391.51649654745427
STAT,1950,55,na,2005,5050.686052535701
SIM,1813,103,na,1916,5
SIM,1931,26,40-44,1957,19
SIM,1986,26,45-49,2012,10
SIM,1925,44,45-49,1969,4
SIM,1818,45,45-49,1863,1
SIM,1879,42,na,1921,2676
SIM,1832,27,35-39,1859,20
SIM,1858,31,25-29,1889,4
SIM,1848,28,40-44,1876,6
STAT,1834,21,20-24,1855,84.7162058688686
STAT,1879,76,na,1955,1141.639290953763
SIM,1868,28,50-100,1896,1
STAT,1822,79,na,1901,574.4035350338892
STAT,1910,88,na,1998,889.8499744930535
SIM,1957,30,30-34,1987,1
STAT,1858,47,35-39,1905,0.12545243482116178
SIM,1837,67,na,1904,1468
SIM,1898,33,20-24,1931,3
STAT,1923,26,40-44,1949,6.194662381456808
SIM,1874,37,50-100,1911,2
STAT,1881,80,na,1961,910.34182452235
STAT,1917,16,50-100,1933,0.0932734503151332
STAT,1994,16,50-100,2010,0.6241055263779437
STAT,1947,31,na,1978,5014.424004145314
SIM,1910,77,na,1987,1592
STAT,1941,39,40-44,1980,1.8298273225531296
SIM,1906,38,na,1944,3602
STAT,1891,41,50-100,1932,1.5136546111101146
STAT,1837,78,na,1915,565.7849841525657
STAT,1848,19,35-39,1867,0.7142491965575337
SIM,1858,47,40-44,1905,1
SIM,1965,21,25-29,1986,286
STAT,1866,37,50-100,1903,1.3132696191970068
STAT,1824,103,na,1927,0.08880009120809625
STAT,1920,25,45-49,1945,2.2009835315033834
STAT,1872,51,20-24,1923,8.591939537815989E-4
SIM,1920,15,45-49,1935,1
SIM,1852,26,40-44,1878,8
SIM,1845,30,35-39,1875,27
STAT,1934,13,na,1947,6178.43580758352
STAT,1863,28,30-34,1891,25.32186310028558
SIM,1798,69,na,1867,1026
SIM,1889,72,na,1961,2477
SIM,1903,99,na,2002,34
STAT,1852,36,40-44,1888,4.192875078021145
STAT,1844,26,40-44,1870,3.089407186145077
STAT,1978,26,45-49,2004,2.7339254494138463
STAT,1837,32,50-100,1869,0.8318635033908218
SIM,1826,36,40-44,1862,12
STAT,1926,63,na,1989,4698.941680778709
SIM,1905,22,na,1927,4410
STAT,1876,43,35-39,1919,2.1446572934903076
SIM,1923,49,40-44,1972,2
STAT,1824,42,50-100,1866,1.5033999762827777
SIM,1951,34,45-49,1985,1
SIM,1839,48,na,1887,1891
STAT,1860,36,35-39,1896,6.610248548938963
STAT,1915,21,20-24,1936,133.07124168007562
STAT,1973,17,40-44,1990,2.0876452429372043
STAT,1898,24,15-19,1922,5.113211632920302
STAT,1949,30,30-34,1979,21.579093189009857
STAT,1971,27,15-19,1998,1.036326791945075
STAT,1835,49,50-100,1884,0.15746631578704612
SIM,1918,6,na,1924,4345
STAT,1871,50,na,1921,2507.633834683851
STAT,1908,38,50-100,1946,0.45197688560747273
SIM,1860,36,40-44,1896,6
STAT,1817,78,na,1895,540.1822694460224
STAT,1955,45,15-19,2000,5.897703871393296E-4
STAT,1792,75,na,1867,616.2963620651501
STAT,1850,22,15-19,1872,4.076258121113096
SIM,1819,40,35-39,1859,4
SIM,1888,39,35-39,1927,11
SIM,1921,60,na,1981,4836
STAT,1955,37,40-44,1992,2.362772170607833
SIM,1849,23,30-34,1872,56
SIM,1947,20,na,1967,5345
STAT,1944,26,45-49,1970,2.155913883949525
SIM,1923,16,40-44,1939,2
SIM,1842,21,20-24,1863,3
SIM,1832,75,na,1907,740
SIM,1898,49,35-39,1947,1
STAT,1915,49,40-44,1964,0.18230211908147875
SIM,1866,38,35-39,1904,7
STAT,1940,16,30-34,1956,14.290797077110266
STAT,1818,36,40-44,1854,8.140057359648354
STAT,1915,16,40-44,1931,0.338730208576296
SIM,1884,43,35-39,1927,3
STAT,1901,34,40-44,1935,6.950208594286775
STAT,1943,34,45-49,1977,1.9605846756094503
SIM,1869,39,30-34,1908,3
STAT,1884,23,na,1907,2688.3453189475636
STAT,1950,34,50-100,1984,1.1485144802346465
SIM,1864,43,na,1907,2675
STAT,1860,27,35-39,1887,9.070711314133485
SIM,1941,48,45-49,1989,1
STAT,1875,60,na,1935,2274.493738876901
STAT,1931,17,35-39,1948,6.339806180530975
SIM,1844,35,45-49,1879,4
STAT,1973,22,20-24,1995,166.51146472459786
SIM,1900,46,50-100,1946,1
STAT,1890,46,20-24,1936,0.009572203403060494
SIM,1963,26,20-24,1989,35
STAT,1876,21,25-29,1897,68.49898609246692
STAT,1933,48,45-49,1981,0.3441111749210966
STAT,1800,98,na,1898,1.7528698610045217
STAT,1836,35,45-49,1871,2.2743906985603215
SIM,1966,40,50-100,2006,1
STAT,1977,18,20-24,1995,211.3345607117197
STAT,1857,24,25-29,1881,53.28011533125494
STAT,1897,41,na,1938,3595.06304348551
STAT,1963,36,20-24,1999,0.3985469163736864
STAT,1934,21,25-29,1955,143.37425022111313
STAT,1955,26,20-24,1981,28.098760665308713
STAT,1908,17,45-49,1925,0.11196873117729678
STAT,1957,39,50-100,1996,0.6567588550340392
SIM,1942,21,25-29,1963,208
STAT,1952,36,45-49,1988,0.9721976398914313
STAT,1975,20,30-34,1995,43.93256870078947
SIM,1859,28,15-19,1887,4
STAT,1906,33,15-19,1939,0.13702847729757173
STAT,1820,44,na,1864,1564.0145908102584
STAT,1945,37,15-19,1982,0.024941102412399458
STAT,1810,45,35-39,1855,0.5691200325331037
STAT,1908,22,25-29,1930,98.12419938952132
STAT,1815,49,35-39,1864,0.2775267599777083
SIM,1962,34,20-24,1996,9
SIM,1855,35,20-24,1890,2
SIM,1804,94,na,1898,24
STAT,1829,36,15-19,1865,0.06575690696463955
STAT,1848,50,50-100,1898,0.016277693221777828
SIM,1919,23,20-24,1942,11
STAT,1937,46,20-24,1983,0.012914536145508235
SIM,1939,34,30-34,1973,2
STAT,1826,38,50-100,1864,0.9624424894791668
SIM,1824,49,na,1873,1434
SIM,1910,18,20-24,1928,27
STAT,1975,39,40-44,2014,2.343054925452292
STAT,1855,35,15-19,1890,0.048235454577732664
STAT,1902,18,20-24,1920,28.832899306035213
STAT,1954,34,20-24,1988,3.5425406777933803
SIM,1954,33,na,1987,5369
STAT,1880,84,na,1964,694.624262236169
STAT,1838,47,15-19,1885,3.5652824597335713E-4
STAT,1870,16,40-44,1886,0.2113202067455645
STAT,1939,25,25-29,1964,76.46036467881423
STAT,1925,3,na,1928,5652.677360942616
SIM,1870,25,45-49,1895,2
STAT,1899,27,35-39,1926,15.255635480163647
STAT,1989,26,20-24,2015,30.317590084593192
STAT,1871,39,15-19,1910,0.06382364550477022
SIM,1923,21,20-24,1944,4
STAT,1908,31,25-29,1939,10.122288746570263
SIM,1894,23,40-44,1917,6
SIM,1835,86,na,1921,158
SIM,1916,22,25-29,1938,220
STAT,1878,50,45-49,1928,0.017738106848704954
STAT,1921,40,na,1961,4839.078905788517
STAT,1841,20,15-19,1861,3.769628951480986
STAT,2002,4,na,2006,6841.128901629475
STAT,1898,22,50-100,1920,0.6360226782133066
STAT,1982,5,na,1987,6384.94582513773
SIM,1969,17,25-29,1986,77
STAT,1895,34,40-44,1929,6.458805483292313
STAT,1947,35,25-29,1982,1.320946992622331
STAT,1866,18,40-44,1884,0.19963032472460024
STAT,1886,23,40-44,1909,2.528805499700334
STAT,1919,85,na,2004,1513.2092168140603
STAT,1829,45,15-19,1874,4.190663430990468E-4
SIM,1909,60,na,1969,4314
SIM,1807,48,40-44,1855,1
SIM,1860,101,na,1961,1
STAT,1946,18,na,1964,4709.8114876933805
STAT,1929,36,20-24,1965,0.3909388308322785
STAT,1862,25,45-49,1887,1.101101652670979
STAT,1937,55,na,1992,4148.204540275114
STAT,1932,23,15-19,1955,8.037475702193374
SIM,1886,78,na,1964,622
STAT,1901,104,na,2005,4.417173898342528
STAT,1793,71,na,1864,611.2568783009408
STAT,1855,26,15-19,1881,0.4053064575016622
SIM,1907,20,25-29,1927,1
STAT,1906,19,35-39,1925,0.9184546626783896
STAT,1906,49,na,1955,3707.828250603553
SIM,1896,54,na,1950,3311
STAT,1967,29,15-19,1996,1.0210657853429757
SIM,1928,19,na,1947,5542
SIM,1959,28,20-24,1987,32
SIM,1905,36,40-44,1941,2
SIM,1955,35,25-29,1990,2
STAT,1988,15,15-19,2003,74.94678268486295
SIM,1903,38,30-34,1941,3
STAT,1883,27,na,1910,2694.6049797333635
SIM,1940,23,15-19,1963,11
SIM,1916,31,25-29,1947,16
SIM,1969,41,35-39,2010,1
SIM,1914,19,35-39,1933,4
STAT,1967,48,45-49,2015,0.32498229643388604
SIM,1830,29,25-29,1859,84
SIM,1887,33,45-49,1920,8
SIM,1839,34,25-29,1873,15
SIM,1967,19,15-19,1986,62
STAT,1871,21,50-100,1892,0.469608441197158
STAT,1970,16,45-49,1986,0.7218545220640225
STAT,1974,28,35-39,2002,22.711223375682653
STAT,1824,32,15-19,1856,0.3376259514771537
STAT,1911,101,na,2012,24.39519720315839
STAT,1924,31,50-100,1955,1.1135352507753438
STAT,1814,106,na,1920,0.007570568196279714
STAT,1991,21,15-19,2012,8.835930275594732
STAT,1928,44,20-24,1972,0.025894962816579856
SIM,1823,49,35-39,1872,1
STAT,1922,56,na,1978,4687.106014532784
SIM,1971,29,na,2000,5256
STAT,1905,27,35-39,1932,16.11682056412387
SIM,1982,28,35-39,2010,93
STAT,1874,111,na,1985,0.008207020505044578
SIM,1881,55,na,1936,1649
SIM,1957,49,40-44,2006,1
STAT,1879,33,45-49,1912,2.09247101612402
SIM,1838,19,15-19,1857,8
STAT,1825,36,na,1861,2039.9813144210316
STAT,1963,37,50-100,2000,0.6341941016382843
STAT,1802,70,na,1872,918.8083134170056
STAT,1884,77,na,1961,1208.155714837411
SIM,1851,15,35-39,1866,1
SIM,1981,22,45-49,2003,6
SIM,1964,29,40-44,1993,10
STAT,1922,23,20-24,1945,146.63950616984602
STAT,1891,44,15-19,1935,0.019431335649998393
STAT,1967,31,na,1998,5560.665415675038
SIM,1877,44,40-44,1921,9
STAT,1923,29,45-49,1952,2.271839530896118
SIM,1822,68,na,1890,933
SIM,1957,33,35-39,1990,2
STAT,1986,20,50-100,2006,1.0863282587135124
STAT,1903,104,na,2007,4.550870721149523
STAT,1957,24,na,1981,5571.025355203905
STAT,1848,100,na,1948,1.128027268628892
SIM,1947,51,na,1998,5812
STAT,1881,16,15-19,1897,6.6221454300669205
SIM,1826,42,35-39,1868,3
STAT,1904,111,na,2015,0.022123266053316572
SIM,2001,12,na,2013,7313
STAT,1854,15,45-49,1869,0.06441809211604838
STAT,1931,28,25-29,1959,98.04165820524264
SIM,1884,12,na,1896,2988
SIM,1899,65,na,1964,3118
SIM,1976,35,na,2011,5974
SIM,1837,42,45-49,1879,6
STAT,1931,19,na,1950,5531.304169111361
STAT,1914,29,35-39,1943,17.350162874994346
SIM,1817,42,25-29,1859,1
STAT,1869,44,40-44,1913,2.4798776647954273
STAT,1835,25,50-100,1860,0.5302056517217368
SIM,1956,14,na,1970,5510
STAT,1829,42,45-49,1871,1.5996576600695986
STAT,1898,21,45-49,1919,1.0908822940090959
SIM,1842,68,na,1910,1295
STAT,1853,85,na,1938,272.93344454407895
STAT,1887,21,35-39,1908,7.569946205818291
SIM,1931,29,45-49,1960,4
SIM,1859,11,na,1870,2594
STAT,1919,39,30-34,1958,2.2542870145301794
STAT,1900,27,na,1927,3821.6725052773463
STAT,1818,42,35-39,1860,2.4193105331424216
STAT,1851,50,na,1901,1731.9876316961559
SIM,1831,70,na,1901,931
SIM,1889,22,20-24,1911,4
SIM,1884,21,25-29,1905,76
STAT,1884,26,50-100,1910,0.7318937628848198
STAT,1863,92,na,1955,42.02884671589364
STAT,1996,15,na,2011,6176.5464549214985
STAT,1908,39,20-24,1947,0.28232180836134246
STAT,1906,18,na,1924,4239.133604166308
STAT,1966,32,25-29,1998,13.580005250715788
STAT,1905,38,25-29,1943,1.0328722483607429
SIM,1838,48,35-39,1886,1
SIM,1843,32,25-29,1875,27
STAT,1938,51,na,1989,4296.855924979854
STAT,1940,19,35-39,1959,4.915110192019558
STAT,1959,16,45-49,1975,0.7543065900618051
STAT,1911,23,45-49,1934,1.2287361029861124
SIM,1945,16,25-29,1961,123
SIM,1973,28,25-29,2001,191
STAT,1855,54,50-100,1909,0.01249747199504076
STAT,1860,33,30-34,1893,16.170903813831966
STAT,1939,17,50-100,1956,0.4329705181551257
SIM,1965,15,50-100,1980,1
STAT,1841,39,35-39,1880,7.256767542420221
SIM,1947,55,na,2002,5681
STAT,1837,49,20-24,1886,0.008792048110250054
STAT,1875,15,50-100,1890,0.05869895268806904
STAT,1890,27,15-19,1917,0.6397751163565375
STAT,1869,27,20-24,1896,13.111167460479804
STAT,1952,50,na,2002,5237.110327732225
STAT,1955,43,50-100,1998,0.1867465728138533
STAT,1821,48,15-19,1869,7.138661674182633E-4
STAT,1934,29,20-24,1963,28.324752351882037
SIM,1857,33,30-34,1890,22
SIM,1897,30,na,1927,3757
SIM,1930,23,20-24,1953,181
SIM,1972,23,25-29,1995,282
STAT,1956,29,40-44,1985,7.141451736413402
SIM,1836,25,45-49,1861,2
STAT,1920,28,15-19,1948,0.8901815366774909
STAT,1937,16,25-29,1953,48.798203039579526
STAT,1897,32,15-19,1929,0.21975409774465743
STAT,1897,4,na,1901,4059.5032270536944
STAT,1903,52,na,1955,3520.582789462831
STAT,1944,23,40-44,1967,4.188418681888778
STAT,1949,33,35-39,1982,12.494514451844156
STAT,1843,15,35-39,1858,0.7119453232087676
STAT,1858,44,30-34,1902,1.0210592483853311
STAT,1944,25,50-100,1969,1.2426346904844028
SIM,1845,93,na,1938,32
SIM,1925,22,na,1947,5493
STAT,1880,30,na,1910,2942.4976938394875
SIM,1942,29,20-24,1971,22
STAT,1930,29,50-100,1959,1.4593424631370793
STAT,1948,65,na,2013,4399.202301425874
STAT,1910,40,45-49,1950,0.18376725293839535
STAT,1855,32,45-49,1887,1.5108252407069018
STAT,1835,32,25-29,1867,8.143455286863572
STAT,1892,22,20-24,1914,99.67739749993379
STAT,1932,45,25-29,1977,0.08345305183332981
SIM,1919,26,25-29,1945,5
SIM,1958,22,30-34,1980,1
STAT,1882,96,na,1978,74.91408011578096
STAT,1913,32,45-49,1945,1.8077193409836767
STAT,1993,16,35-39,2009,6.969193944705032
SIM,1914,22,25-29,1936,3
STAT,1872,89,na,1961,220.72388152220145
SIM,1938,20,20-24,1958,197
SIM,1881,28,25-29,1909,82
STAT,1838,36,25-29,1874,3.0413661177850253
STAT,1979,29,30-34,2008,62.46762202409716
SIM,1855,38,25-29,1893,3
STAT,1877,95,na,1972,87.40241411131551
STAT,1878,38,20-24,1916,0.9242316126014435
SIM,1794,76,na,1870,218
SIM,1955,46,50-100,2001,1
STAT,1863,20,35-39,1883,6.093180472547185
STAT,1955,43,na,1998,5903.677810872745
STAT,1860,30,na,1890,2237.3694429382876
STAT,1968,43,35-39,2011,0.30116394544207276
STAT,1969,12,na,1981,5662.928410774437
SIM,1995,17,20-24,2012,422
STAT,1849,33,30-34,1882,14.11254441827975
STAT,1975,23,35-39,1998,14.378068268432536
STAT,1866,32,20-24,1898,2.891358868168455
SIM,1918,40,na,1958,3813
STAT,1820,37,50-100,1857,2.6941545295320553
STAT,1886,58,na,1944,2407.3514601622664
STAT,1904,37,na,1941,3935.1789402678064
SIM,1983,17,na,2000,6547
SIM,1949,20,30-34,1969,74
STAT,1971,19,30-34,1990,17.80401594865241
SIM,1943,7,na,1950,5519
STAT,1873,28,25-29,1901,49.67631690878797
STAT,1820,98,na,1918,1.90656781149488
STAT,1893,28,45-49,1921,1.6139186866426902
STAT,1877,21,40-44,1898,2.5090499817351
STAT,1906,22,25-29,1928,96.33697958795213
STAT,1921,40,20-24,1961,0.023010661801962737
STAT,1987,17,20-24,2004,223.36035571167784
SIM,1895,29,30-34,1924,50
SIM,1952,21,na,1973,4812
STAT,1861,22,25-29,1883,56.42335762126318
SIM,1904,33,20-24,1937,1
STAT,1832,48,25-29,1880,0.04667704527827723
SIM,1846,36,25-29,1882,4
STAT,1837,110,na,1947,2.0010417980486847E-4
STAT,1926,49,15-19,1975,5.213617049486119E-4
SIM,1948,28,45-49,1976,6
SIM,1905,39,45-49,1944,2
SIM,1860,20,25-29,1880,103
STAT,1840,19,30-34,1859,1.6360009623895717
STAT,1898,29,40-44,1927,4.638729551728331
SIM,1942,8,na,1950,5084
STAT,1965,34,30-34,1999,23.108183287779077
SIM,1837,98,na,1935,2
SIM,1896,27,25-29,1923,121
SIM,1990,16,25-29,2006,184
STAT,1888,27,25-29,1915,57.38503300763355
SIM,1937,28,35-39,1965,3
STAT,1900,34,25-29,1934,16.261624621466968
STAT,1852,20,25-29,1872,65.04684880275647
STAT,1937,49,25-29,1986,0.06147358962842304
STAT,1821,45,45-49,1866,0.43912298514797155
SIM,1930,33,50-100,1963,6
SIM,1875,35,40-44,1910,17
STAT,1846,49,30-34,1895,0.09798071972131821
SIM,1964,1,na,1965,5979
STAT,1977,21,45-49,1998,1.760855198722594
SIM,1972,21,na,1993,5109
STAT,1852,39,45-49,1891,1.8605698524218581
STAT,1855,97,na,1952,4.571217012361622
STAT,1875,48,50-100,1923,0.28922111743486817
STAT,1875,23,30-34,1898,21.177206842499285
SIM,1986,3,na,1989,6758
SIM,1938,39,40-44,1977,4
STAT,1781,83,na,1864,97.46523438408391
STAT,1929,28,35-39,1957,21.675008671284157
SIM,1948,42,25-29,1990,1
SIM,1921,15,na,1936,4955
STAT,1882,25,30-34,1907,28.577991107085687
STAT,1909,28,15-19,1937,0.7767335626228886
SIM,1929,1,na,1930,5730
STAT,1887,29,30-34,1916,32.335558504039454
SIM,1777,84,na,1861,195
STAT,1837,30,35-39,1867,9.387350216100765
SIM,1860,39,45-49,1899,7
SIM,1978,12,na,1990,6038
STAT,1939,22,20-24,1961,128.92663267128495
STAT,1952,39,15-19,1991,0.027302683309661853
SIM,1942,14,na,1956,5043
STAT,1945,40,40-44,1985,0.32860289428572387
STAT,1791,90,na,1881,33.57258785487096
STAT,1956,43,20-24,1999,0.02798253671677048
SIM,1871,20,35-39,1891,8
STAT,1869,15,na,1884,2895.7362551255724
STAT,1991,18,25-29,2009,71.64838811512368
SIM,1830,26,20-24,1856,25
STAT,1966,45,25-29,2011,0.07990530600994518
SIM,1849,48,45-49,1897,2
STAT,1833,31,na,1864,1983.2576931259273
STAT,1868,30,na,1898,2667.1322719654518
SIM,1983,13,na,1996,7024
STAT,1927,80,na,2007,2706.438743743517
STAT,1864,37,15-19,1901,0.05786399519494828
STAT,1867,35,40-44,1902,4.761503778132288
STAT,1856,38,35-39,1894,6.196460956669152
STAT,1836,38,15-19,1874,0.06210234307374648
SIM,1947,22,20-24,1969,294
SIM,1907,45,40-44,1952,1
STAT,1831,28,20-24,1859,12.141791051935108
STAT,1836,103,na,1939,0.13060839821910525
STAT,1945,29,30-34,1974,49.56025923008362
SIM,1859,31,40-44,1890,9
STAT,1838,103,na,1941,0.12431415077897023
STAT,1924,37,na,1961,5118.30255645961
STAT,1855,19,50-100,1874,0.04900013240222255
SIM,1893,6,na,1899,3838
SIM,1892,28,35-39,1920,19
STAT,1906,16,30-34,1922,2.6888643811248545
STAT,1884,28,35-39,1912,10.963183979080155
SIM,1864,97,na,1961,22
SIM,1914,16,30-34,1930,8
STAT,1861,104,na,1965,0.34913752536797715
STAT,1960,19,20-24,1979,203.64397200752586
SIM,1890,25,30-34,1915,89
SIM,1890,30,50-100,1920,4
SIM,1936,34,50-100,1970,3
SIM,1953,29,30-34,1982,132
STAT,1842,17,40-44,1859,0.18073959465683406
STAT,1854,16,na,1870,2250.3281391425185
STAT,1896,48,15-19,1944,3.3960794613681556E-4
STAT,1927,27,20-24,1954,25.60442315230294
SIM,1837,28,30-34,1865,7
SIM,1898,80,na,1978,1708
SIM,1967,35,40-44,2002,1
STAT,1775,83,na,1858,171.63851440510865
SIM,1879,11,na,1890,3078
STAT,1864,23,na,1887,2458.454745701377
STAT,1966,26,50-100,1992,1.441572235761076
STAT,1895,69,na,1964,2472.7019753461195
SIM,1856,30,45-49,1886,4
SIM,1954,32,50-100,1986,5
STAT,1935,18,15-19,1953,71.45012753426793
STAT,1948,30,15-19,1978,0.17318748218628355
SIM,1828,50,na,1878,1988
STAT,1968,16,na,1984,5306.982233551913
SIM,1943,18,15-19,1961,67
SIM,1950,40,na,1990,4724
SIM,1936,14,na,1950,4096
STAT,1945,43,45-49,1988,0.21769853526495136
STAT,1854,37,20-24,1891,0.6280082630283148
STAT,1931,25,20-24,1956,27.22662843537513
SIM,1899,11,na,1910,4531
STAT,1949,27,40-44,1976,6.282954073701971
STAT,1951,54,na,2005,5114.336804664773
STAT,1953,17,na,1970,5138.543009527112
SIM,1835,44,35-39,1879,3
SIM,1935,27,20-24,1962,59
STAT,1913,26,15-19,1939,0.814992678207589
SIM,1845,19,25-29,1864,9
STAT,1837,19,25-29,1856,6.15373182209483
SIM,1875,38,45-49,1913,10
STAT,1922,26,25-29,1948,86.21037254573035
STAT,1938,27,30-34,1965,44.820216354528505
SIM,1930,26,25-29,1956,196
STAT,1839,31,15-19,1870,0.14043190200508213
SIM,1791,65,na,1856,819
SIM,1813,51,na,1864,1280
SIM,1946,27,30-34,1973,105
STAT,1844,36,50-100,1880,1.2049343008432019
SIM,1819,79,na,1898,84
SIM,1968,19,30-34,1987,34
STAT,1848,30,na,1878,2741.7873360548433
STAT,1848,30,45-49,1878,2.2061063112911605
STAT,1870,50,40-44,1920,0.012149684065476831
SIM,1877,30,na,1907,3273
STAT,1946,32,50-100,1978,1.07873407113142
STAT,1840,36,15-19,1876,0.05383603130098522
STAT,1877,32,30-34,1909,20.959429117486103
SIM,1908,34,35-39,1942,3
STAT,1935,21,40-44,1956,5.288628836744128
STAT,1808,53,30-34,1861,0.02780843231598078
STAT,1953,17,20-24,1970,189.2708358300435
SIM,1903,16,20-24,1919,41
STAT,1796,68,na,1864,835.946517914347
SIM,1893,23,25-29,1916,1
STAT,1885,23,25-29,1908,65.69233518245132
STAT,1832,45,20-24,1877,0.010106254506127885
STAT,1905,35,20-24,1940,0.2805491750955138
SIM,1956,28,50-100,1984,8
SIM,1839,79,na,1918,776
SIM,1923,41,na,1964,5350
STAT,1816,44,25-29,1860,1.3547281984872708
STAT,1994,19,20-24,2013,225.62854866248304
SIM,1824,44,25-29,1868,1
SIM,1885,32,30-34,1917,2
SIM,1878,25,15-19,1903,1
STAT,1881,22,45-49,1903,0.7762089359441916
SIM,1965,9,na,1974,5618
STAT,1918,51,na,1969,4453.304819291989
SIM,1870,28,15-19,1898,1
SIM,1965,43,na,2008,5506
STAT,1938,44,15-19,1982,0.0018116573782623229
STAT,1948,28,50-100,1976,1.3195780842789095
STAT,1853,47,50-100,1900,0.24338404000018238
STAT,1867,34,na,1901,2549.208763070177
STAT,1862,28,15-19,1890,0.44032020634547625
STAT,1975,17,40-44,1992,2.1295008525183285
SIM,1891,39,40-44,1930,12
STAT,1908,44,na,1952,3921.6977266883373
STAT,1870,22,35-39,1892,6.63916682011734
STAT,1899,24,30-34,1923,27.986172236188597
SIM,1956,30,15-19,1986,2
SIM,1838,45,30-34,1883,1
STAT,1862,42,na,1904,2248.2199738863937
STAT,1921,43,25-29,1964,0.09263895717610084
STAT,1847,38,25-29,1885,2.2748428625771435
SIM,1849,31,15-19,1880,1
STAT,1954,37,25-29,1991,1.4471943716882536
STAT,1819,50,na,1869,1728.9531162032197
STAT,1883,39,40-44,1922,4.892859538964527
SIM,1907,34,na,1941,4450
STAT,1893,25,40-44,1918,4.399329971434293
STAT,1774,87,na,1861,2.2738760255870654
SIM,1897,84,na,1981,942
SIM,1926,33,40-44,1959,7
STAT,2001,5,na,2006,6793.421463883278
STAT,1834,43,30-34,1877,1.24872148591011
STAT,1858,38,35-39,1896,6.336068612095365
SIM,1865,93,na,1958,58
STAT,1853,34,35-39,1887,10.169685220141544
STAT,1928,22,45-49,1950,1.6212138411569554
SIM,1949,32,na,1981,5870
STAT,1853,9,na,1862,2917.896803407056
SIM,1904,36,25-29,1940,3
STAT,1989,15,30-34,2004,20.158636338733775
STAT,1896,15,15-19,1911,9.087982077640252
STAT,1917,22,35-39,1939,11.549272296160918
SIM,1890,28,35-39,1918,3
STAT,1857,49,40-44,1906,0.15066356625876398
SIM,1915,33,30-34,1948,25
STAT,1849,36,35-39,1885,5.6680836355467585
STAT,1918,33,40-44,1951,4.77777643743091
STAT,1984,27,na,2011,6166.715798884536
SIM,1861,34,35-39,1895,4
STAT,1845,43,40-44,1888,1.5238025686511325
STAT,1846,43,50-100,1889,1.0912913339837278
SIM,1943,62,na,2005,4803
STAT,1792,107,na,1899,0.001324280256306262
STAT,1874,20,45-49,1894,0.828764195631131
STAT,1888,24,20-24,1912,92.89970675010757
STAT,1804,51,na,1855,1536.9017914404596
SIM,1934,24,35-39,1958,17
STAT,1919,20,45-49,1939,1.4300253867135408
SIM,1934,33,na,1967,5793
STAT,1879,27,15-19,1906,0.5467201264525341
STAT,1983,19,45-49,2002,0.8149779018761757
SIM,1924,26,na,1950,4976
STAT,1921,20,35-39,1941,12.342110017795703
SIM,1853,43,40-44,1896,5
SIM,1925,49,50-100,1974,1
STAT,1859,30,20-24,1889,2.5211329587426845
STAT,1907,33,30-34,1940,16.950988723369512
STAT,1917,49,50-100,1966,0.27104810352524544
SIM,1943,21,40-44,1964,6
STAT,1882,28,35-39,1910,10.838131892085395
SIM,1936,22,45-49,1958,1
SIM,1891,48,na,1939,3224
STAT,1867,38,45-49,1905,2.137304981443602
SIM,1925,22,35-39,1947,1
STAT,1998,17,30-34,2015,20.653493322566817
SIM,1855,86,na,1941,16
SIM,1908,19,na,1927,4151
SIM,1976,29,20-24,2005,44
STAT,1842,34,25-29,1876,9.325881946311215
STAT,1910,20,25-29,1930,100.80769906404538
SIM,1850,34,25-29,1884,2
STAT,1839,47,30-34,1886,0.07821586819846198
STAT,1861,51,45-49,1912,0.013989932630321856
STAT,1815,43,na,1858,1757.7437511688593
SIM,1857,36,35-39,1893,14
SIM,1967,16,45-49,1983,1
STAT,1991,15,20-24,2006,224.34478940441525
SIM,1939,25,na,1964,4783
SIM,1869,31,35-39,1900,19
SIM,1872,26,25-29,1898,91
SIM,1932,70,na,2002,4074
STAT,1897,26,20-24,1923,18.16532465601463
SIM,1864,38,35-39,1902,3
STAT,1864,26,25-29,1890,43.73872928665579
SIM,1849,45,40-44,1894,1
SIM,1867,30,20-24,1897,3
SIM,1882,23,15-19,1905,7
STAT,1949,61,na,2010,4724.654969788885
STAT,1827,44,35-39,1871,2.3276963723183313
SIM,1957,27,40-44,1984,10
STAT,1965,44,50-100,2009,0.17531587145401872
STAT,1831,50,na,1881,1822.2368766306017
STAT,1941,40,na,1981,4601.792262940809
STAT,1872,39,30-34,1911,6.113768541939495
SIM,1865,49,40-44,1914,1
SIM,1919,5,na,1924,5712
STAT,1769,106,na,1875,0.018653217149825783
SIM,1927,23,50-100,1950,1
STAT,1948,16,35-39,1964,5.5432820775244895
STAT,1978,23,40-44,2001,5.311355204150724
SIM,1874,32,20-24,1906,4
STAT,1789,86,na,1875,58.201958250713396
SIM,1956,16,35-39,1972,6
SIM,1853,20,na,1873,2648
STAT,1964,17,30-34,1981,17.71665831857595
SIM,1867,33,25-29,1900,27
SIM,1917,31,40-44,1948,10
STAT,1926,24,35-39,1950,13.116051524221536
STAT,1911,19,na,1930,4440.172971723851
STAT,1926,18,na,1944,5193.259271425927
STAT,1955,15,30-34,1970,18.68330220972694
STAT,1881,101,na,1982,10.868340700835786
SIM,1834,24,30-34,1858,19
SIM,1859,34,45-49,1893,2
STAT,1900,17,40-44,1917,0.29289284824988704
SIM,1842,43,30-34,1885,2
STAT,1909,92,na,2001,432.86992621915766
STAT,1844,32,35-39,1876,10.129311455779847
STAT,1867,21,15-19,1888,3.595116856288038
SIM,1986,23,40-44,2009,14
SIM,1896,24,20-24,1920,208
SIM,1948,25,40-44,1973,8
STAT,1974,20,15-19,1994,8.053716348161556
SIM,1967,30,25-29,1997,20
SIM,1851,79,na,1930,1178
SIM,1866,78,na,1944,645
STAT,1995,19,na,2014,6144.719820573657
STAT,1848,16,30-34,1864,2.111820401648187
SIM,1864,35,30-34,1899,10
SIM,1882,85,na,1967,881
STAT,1933,23,30-34,1956,44.00166141667997
SIM,1864,12,na,1876,3056
STAT,1779,103,na,1882,0.04655201732959619
STAT,1947,5,na,1952,5150.433828868
SIM,1856,16,30-34,1872,4
SIM,1941,23,30-34,1964,72
STAT,1856,35,30-34,1891,4.736987423956423
STAT,1919,23,50-100,1942,0.8287433519680437
SIM,1880,39,30-34,1919,16
STAT,1920,26,50-100,1946,1.2638566018698445
SIM,1889,25,25-29,1914,13
STAT,1952,32,na,1984,5331.539038636898
STAT,1898,46,25-29,1944,0.05081975836247263
SIM,1852,32,35-39,1884,8
STAT,1816,106,na,1922,0.00599617155663367
STAT,1909,31,40-44,1940,4.332101589785689
STAT,1899,76,na,1975,2126.919346949229
SIM,1795,72,na,1867,699
STAT,1819,53,40-44,1872,0.019112041547904312
STAT,1942,25,na,1967,4542.192599677053
SIM,1892,92,na,1984,432
STAT,1821,43,na,1864,1657.8021036380483
STAT,1778,94,na,1872,5.480467463824711
STAT,1959,30,25-29,1989,14.238157469207104
SIM,1856,23,na,1879,2377
STAT,1914,87,na,2001,1085.6016671549555
STAT,1928,43,50-100,1971,0.17255977244577178
SIM,1841,18,25-29,1859,10
SIM,1881,34,30-34,1915,23
STAT,1925,30,25-29,1955,12.676582810013768
STAT,1881,53,20-24,1934,8.082110926821637E-4
STAT,1858,45,45-49,1903,0.21458570540382657
SIM,1823,44,na,1867,2200
STAT,1846,41,50-100,1887,1.119615302683362
STAT,1879,47,na,1926,2698.461320174743
STAT,1926,17,45-49,1943,0.7066642537242127
STAT,1841,51,25-29,1892,0.0031642363557836256
STAT,1903,49,50-100,1952,0.2229722424303286
STAT,1875,33,na,1908,2833.8939118285725
STAT,1909,8,na,1917,4504.024534781196
SIM,1924,32,25-29,1956,4
STAT,1905,30,50-100,1935,1.54272717677478
STAT,1874,40,50-100,1914,1.2607363685240807
SIM,1912,27,na,1939,3950
STAT,1890,38,na,1928,3305.7328308787683
SIM,1808,87,na,1895,24
SIM,1975,34,na,2009,6088
STAT,1866,30,20-24,1896,2.9146000216468284
STAT,1873,52,50-100,1925,0.017703686813242313
STAT,1813,89,na,1902,48.10109611025542
STAT,1862,48,15-19,1910,3.846776428152976E-4
STAT,1882,18,20-24,1900,19.93150880689878
STAT,1986,23,35-39,2009,15.529504685892626
STAT,1862,36,20-24,1898,0.7543681387365212
STAT,1976,31,na,2007,5947.305247713804
STAT,1969,28,20-24,1997,26.41642754842739
SIM,1836,36,45-49,1872,4
STAT,1874,3,na,1877,3655.4535130381273
STAT,1852,23,30-34,1875,19.80684047318904
SIM,1837,29,15-19,1866,1
STAT,1873,34,30-34,1907,20.399935425258203
SIM,1890,74,na,1964,1738
SIM,1865,105,na,1970,4
SIM,1821,33,20-24,1854,1
SIM,1950,2,na,1952,4902
SIM,1827,30,35-39,1857,22
STAT,1848,35,50-100,1883,1.3725340277777434
STAT,1944,49,25-29,1993,0.06812522234779558
SIM,1872,36,30-34,1908,2
STAT,1916,32,25-29,1948,11.013431628881607
STAT,1966,46,40-44,2012,0.23697146116013543
STAT,1895,6,na,1901,3924.262170254181
STAT,1981,12,na,1993,6338.910468564746
STAT,1899,47,50-100,1946,0.2180185104065026
STAT,1838,49,35-39,1887,0.12162818718541783
SIM,1846,49,35-39,1895,1
STAT,1865,39,na,1904,2428.485410352771
STAT,1847,47,35-39,1894,0.10722139640980419
STAT,1956,13,na,1969,5997.556608614529
SIM,1943,15,na,1958,4785
SIM,1887,31,45-49,1918,6
STAT,1864,36,30-34,1900,5.5182509583706025
STAT,1833,93,na,1926,20.565140901194383
SIM,1920,38,25-29,1958,2
SIM,1898,54,na,1952,3699
SIM,1873,19,na,1892,3468
SIM,1892,35,45-49,1927,7
STAT,1866,72,na,1938,1350.8705246231987
SIM,1983,22,20-24,2005,354
STAT,1850,54,30-34,1904,0.005959317261183651
STAT,1870,53,45-49,1923,0.016246020659871404
STAT,1912,38,25-29,1950,1.1045856224822084
SIM,1968,33,35-39,2001,7
STAT,1907,19,50-100,1926,0.08274085530741111
STAT,1856,23,15-19,1879,3.3492269481930452
SIM,1890,18,20-24,1908,1
STAT,1786,98,na,1884,1.0049418402775692
SIM,1894,40,na,1934,3772
SIM,1981,23,50-100,2004,2
SIM,1861,18,na,1879,2039
STAT,1977,25,35-39,2002,23.532226768913453
STAT,1874,16,na,1890,2991.198821601344
SIM,1842,41,40-44,1883,5
STAT,1929,31,50-100,1960,1.2127529547737048
STAT,1931,43,30-34,1974,0.19683381305849093
SIM,1927,8,na,1935,5296
STAT,1896,47,30-34,1943,0.08284296536129046
STAT,1845,44,20-24,1889,0.10622043120240708
SIM,1919,27,20-24,1946,48
STAT,1935,51,na,1986,5912.430171967456
SIM,1887,3,na,1890,4027
SIM,1835,61,na,1896,1637
STAT,1889,22,15-19,1911,4.693090201674633
SIM,1933,30,25-29,1963,19
SIM,1981,23,25-29,2004,297
STAT,1851,36,45-49,1887,1.614430510812992
STAT,1957,41,25-29,1998,0.113079897416931
STAT,1892,32,15-19,1924,0.20598334947900027
STAT,1884,35,45-49,1919,2.2946024802024843
STAT,1801,54,35-39,1855,0.03287182918728685
STAT,1886,34,40-44,1920,5.233935508026606
STAT,1854,71,na,1925,1087.4580335772166
SIM,1894,34,40-44,1928,12
SIM,1950,31,50-100,1981,2
STAT,1858,85,na,1943,246.79938921370444
SIM,1877,92,na,1969,332
STAT,1899,99,na,1998,47.6484008161783
STAT,1826,39,15-19,1865,0.043136656807197554
STAT,1874,50,25-29,1924,0.004244837257346665
STAT,1942,22,25-29,1964,111.78675785783477
SIM,1823,36,35-39,1859,3
SIM,1791,81,na,1872,217
SIM,1983,17,50-100,2000,1
STAT,1867,17,40-44,1884,0.20147072312230374
SIM,1875,29,35-39,1904,2
SIM,1839,17,30-34,1856,4
SIM,1863,19,15-19,1882,7
SIM,1950,22,25-29,1972,1
STAT,1908,49,15-19,1957,3.8269630894127016E-4
STAT,1875,37,45-49,1912,2.377423110632988
STAT,1948,18,35-39,1966,5.539956604956049
STAT,1865,21,15-19,1886,3.502030273465088
STAT,1888,18,50-100,1906,0.06628700997782491
STAT,1958,20,35-39,1978,14.329094604982316
STAT,1973,25,na,1998,5620.352552294275
STAT,1983,30,30-34,2013,26.247695683090267
SIM,1866,49,na,1915,2252
STAT,1925,25,na,1950,5139.226872851287
SIM,1852,41,25-29,1893,2
SIM,1868,44,40-44,1912,7
STAT,1895,35,20-24,1930,1.1689603274787175
STAT,1834,41,40-44,1875,2.5064779634858483
STAT,1968,41,45-49,2009,0.24966585430816088
STAT,1947,31,15-19,1978,0.17037740892783132
STAT,1916,26,50-100,1942,1.1918926440088744
STAT,1922,45,30-34,1967,0.1186923080879289
STAT,1825,46,45-49,1871,0.33415746344202507
STAT,1899,37,30-34,1936,1.8187725825124244
STAT,1939,39,50-100,1978,0.49881648682165514
STAT,1890,26,30-34,1916,35.631364775847814
STAT,1829,40,45-49,1869,1.6541728233146764
STAT,1810,51,50-100,1861,0.05643784892020167
SIM,1964,50,na,2014,5648
STAT,1854,26,45-49,1880,1.0495958939981822
STAT,1818,51,25-29,1869,0.004291805326075247
STAT,1942,44,45-49,1986,0.2079345554591829
STAT,1886,17,na,1903,3074.4484977276106
SIM,1898,34,25-29,1932,18
STAT,1849,46,30-34,1895,0.07523961821497736
STAT,1974,35,35-39,2009,3.7616285892159174
STAT,1949,22,35-39,1971,12.679527453456334
SIM,1966,20,35-39,1986,18
STAT,1840,35,30-34,1875,5.162860539090368
STAT,1958,28,45-49,1986,2.628659374438391
STAT,1839,39,25-29,1878,2.6725455515325476
STAT,1854,55,na,1909,1684.5600043752486
SIM,1876,1,na,1877,3414
STAT,1879,31,45-49,1910,2.1099260643735507
STAT,1938,33,15-19,1971,0.14909713445720268
STAT,1819,38,45-49,1857,5.244085829386514
SIM,1837,40,45-49,1877,4
SIM,1957,22,35-39,1979,1
STAT,1907,102,na,2009,14.207801040590063
SIM,1857,88,na,1945,58
SIM,1853,74,na,1927,911
STAT,1830,28,25-29,1858,50.75922241994283
STAT,1857,37,50-100,1894,1.1035083050640617
STAT,1844,100,na,1944,0.8879839262034104
STAT,1883,84,na,1967,704.2538785765144
SIM,1966,28,45-49,1994,6
STAT,1844,41,25-29,1885,0.5571880405838203
STAT,1887,98,na,1985,49.74104498247382
SIM,1847,39,25-29,1886,2
STAT,1963,46,15-19,2009,5.631725933448924E-4
STAT,1957,48,40-44,2005,0.24883273780837925
SIM,1827,38,45-49,1865,5
STAT,1795,59,na,1854,858.9999999999999
STAT,1834,24,50-100,1858,0.49058818980293656
STAT,1829,29,15-19,1858,0.6962197002968862
STAT,1869,45,20-24,1914,0.013545005145147879
STAT,1828,36,45-49,1864,2.0963707159724057
STAT,1937,17,20-24,1954,152.2926213911642
STAT,1891,1,na,1892,3882.2476447755803
STAT,1907,12,na,1919,4385.035125782787
STAT,1948,43,25-29,1991,0.09785356133137195
STAT,1949,43,na,1992,5172.112922086723
SIM,1932,31,na,1963,5422
SIM,1936,45,na,1981,3905
SIM,1888,24,15-19,1912,1
STAT,1855,30,45-49,1885,1.542529294323408
STAT,1819,54,20-24,1873,0.0013132210150181903
SIM,1969,24,na,1993,5414
STAT,1843,25,30-34,1868,31.54699174351171
STAT,1973,17,30-34,1990,18.192336391791198
STAT,1808,51,40-44,1859,0.05119824227894469
SIM,1944,32,na,1976,4608
STAT,1865,29,25-29,1894,43.73180192399331
STAT,1933,46,45-49,1979,0.34592837319552905
SIM,1851,25,30-34,1876,54
STAT,1973,21,15-19,1994,7.973977275040855
SIM,1961,27,50-100,1988,2
STAT,1866,42,15-19,1908,0.014753661580280516
STAT,1891,16,20-24,1907,25.348630783196008
STAT,1814,45,30-34,1859,0.2779951951858503
STAT,1820,59,na,1879,1219.492762097596
SIM,1945,17,20-24,1962,321
STAT,1937,40,45-49,1977,0.19437747739146935
SIM,1890,90,na,1980,211
SIM,1883,37,45-49,1920,6
STAT,1790,71,na,1861,618.8787055595847
SIM,1957,23,na,1980,5852
SIM,1873,21,15-19,1894,10
SIM,1884,27,35-39,1911,21
STAT,1860,34,45-49,1894,1.608057671866653
SIM,1942,71,na,2013,3609
SIM,1948,46,na,1994,4371
STAT,1938,21,20-24,1959,127.10655479382487
STAT,1929,39,na,1968,5562.484126332291
STAT,1866,39,50-100,1905,1.3000521446221154
SIM,1799,61,na,1860,857
STAT,1884,48,50-100,1932,0.27651958313763614
SIM,1946,21,20-24,1967,5
STAT,1876,27,35-39,1903,11.510967593958695
SIM,1959,22,45-49,1981,4
STAT,1836,43,40-44,1879,2.405026457015221
SIM,1855,44,30-34,1899,6
STAT,1962,25,na,1987,5568.136678686546
STAT,1871,18,45-49,1889,0.07503826397906208
STAT,1944,46,20-24,1990,0.014311928939718247
STAT,1902,15,50-100,1917,0.08025869895110395
SIM,1960,27,na,1987,6264
STAT,1876,52,25-29,1928,0.004203051721902513
SIM,1866,42,40-44,1908,2
SIM,1931,34,50-100,1965,5
SIM,1929,37,30-34,1966,4
STAT,1925,26,40-44,1951,6.3730469358202555
STAT,1873,37,35-39,1910,8.335366177239242
STAT,1984,15,40-44,1999,2.2937981624487
STAT,1932,59,na,1991,5409.499600051388
STAT,1847,42,na,1889,1788.3119862516166
STAT,1857,54,40-44,1911,0.009202155013938652
SIM,1888,28,na,1916,2678
SIM,1994,20,30-34,2014,60
STAT,1894,68,na,1962,2475.432112543768
STAT,1847,44,30-34,1891,0.8726765533493883
STAT,1898,16,30-34,1914,2.492032295068837
SIM,1980,32,20-24,2012,3
STAT,1828,39,na,1867,1806.5040414832642
SIM,1875,21,25-29,1896,2
STAT,1957,43,35-39,2000,0.3179108791897419
STAT,1910,38,15-19,1948,0.02111192877370894
STAT,1843,26,50-100,1869,0.7956300218517797
SIM,1876,20,50-100,1896,1
STAT,1808,54,45-49,1862,0.06644894868764493
STAT,1902,28,15-19,1930,0.7372159044690001
SIM,1821,36,25-29,1857,1
STAT,1823,43,30-34,1866,1.1839994555630429
STAT,1867,29,35-39,1896,10.322302232872188
SIM,1912,1,na,1913,4402
STAT,1861,52,40-44,1913,0.010046533876684844
SIM,1881,37,35-39,1918,2
SIM,1866,23,25-29,1889,137
SIM,1979,20,20-24,1999,158
SIM,1831,43,30-34,1874,5
STAT,1828,32,50-100,1860,1.0564411757562713
SIM,1985,28,15-19,2013,2
STAT,1977,28,15-19,2005,1.105016390150972
STAT,1986,20,30-34,2006,47.45081319443384
STAT,1923,34,50-100,1957,1.092035659025679
SIM,1911,53,na,1964,4486
STAT,1868,20,50-100,1888,0.4587082056481278
STAT,1841,25,20-24,1866,13.143013758391506
SIM,1833,22,na,1855,1804
STAT,1858,23,25-29,1881,53.42369449397689
STAT,1867,21,25-29,1888,62.38349934089891
SIM,1841,15,20-24,1856,27
STAT,1866,33,25-29,1899,10.909888449000256
STAT,1935,40,35-39,1975,0.32887284142345913
STAT,1834,22,25-29,1856,69.86847226489007
STAT,1774,97,na,1871,0.038837329813831534
STAT,1894,43,50-100,1937,0.10804947493525725
SIM,1901,15,40-44,1916,1
SIM,1849,39,35-39,1888,8
STAT,1934,39,15-19,1973,0.03053229184388368
STAT,1930,39,30-34,1969,2.73803392044179
SIM,1873,27,35-39,1900,1
STAT,1820,40,25-29,1860,0.841483542217312
STAT,1983,16,50-100,1999,0.6118144668702302
STAT,1958,25,40-44,1983,7.10162556620376
SIM,1898,70,na,1968,2819
STAT,1812,52,45-49,1864,0.03214784666486904
STAT,1901,35,45-49,1936,0.7021402608127207
SIM,1857,44,40-44,1901,5
STAT,1845,28,45-49,1873,0.9041338298474575
SIM,1836,33,40-44,1869,12
SIM,1893,23,na,1916,3705
SIM,1840,28,35-39,1868,9
STAT,1841,80,na,1921,549.9878705102841
STAT,1828,33,40-44,1861,4.842258156380751
STAT,1832,28,35-39,1860,9.026098464578626
SIM,1922,53,na,1975,4882
STAT,1903,46,na,1949,3709.4265123670166
STAT,1871,34,20-24,1905,3.0768824835383874
SIM,1858,25,40-44,1883,13
SIM,1969,18,50-100,1987,1
SIM,1803,56,na,1859,1465
SIM,1933,26,40-44,1959,12
SIM,1953,55,na,2008,5401
STAT,1870,37,50-100,1907,1.3968326381489695
STAT,1834,44,45-49,1878,1.6048941476673548
STAT,1947,27,30-34,1974,51.155855416489715
STAT,1889,27,20-24,1916,16.68880209378492
STAT,1947,40,50-100,1987,0.15915127164675208
STAT,1845,94,na,1939,13.46771655632375
STAT,1987,15,na,2002,6067.259846760002
SIM,1842,22,25-29,1864,143
STAT,1856,28,20-24,1884,10.62630614419481
STAT,1868,7,na,1875,3070.3616800689297
SIM,1908,24,40-44,1932,13
SIM,1891,91,na,1982,225
STAT,1852,26,35-39,1878,10.672440943060675
SIM,1860,26,35-39,1886,20
SIM,1955,27,30-34,1982,8
SIM,1842,44,45-49,1886,1
STAT,1821,104,na,1925,0.04079319053492439
SIM,1897,27,20-24,1924,37
STAT,1895,38,25-29,1933,4.303654363896793
SIM,1845,87,na,1932,165
STAT,1844,16,35-39,1860,0.5868642699939741
SIM,1853,58,na,1911,1955
SIM,1845,23,na,1868,2250
STAT,1807,77,na,1884,486.68918594853324
STAT,1897,37,20-24,1934,1.1895229880187372
STAT,1873,46,25-29,1919,0.0680737417109328
SIM,1841,73,na,1914,829
SIM,1864,28,20-24,1892,27
STAT,1923,30,15-19,1953,0.17131512949060126
STAT,1959,48,15-19,2007,5.768029416179397E-4
STAT,1922,48,35-39,1970,0.17038328718594675
STAT,1925,87,na,2012,1325.3587077127331
SIM,1898,31,20-24,1929,3
STAT,1832,30,50-100,1862,0.8510220917414051
SIM,1932,17,35-39,1949,13
SIM,1862,23,40-44,1885,3
SIM,1867,66,na,1933,1376
STAT,1854,51,35-39,1905,0.007047332795025618
STAT,1970,12,na,1982,5674.723536380995
SIM,1829,28,50-100,1857,1
STAT,1924,17,35-39,1941,5.765085619876507
STAT,1989,16,15-19,2005,75.03910887699529
STAT,1849,49,35-39,1898,0.10624395428909698
SIM,1853,28,45-49,1881,1
STAT,1961,30,35-39,1991,13.904317561596264
SIM,1838,38,20-24,1876,4
STAT,1845,20,35-39,1865,4.952518442267214
SIM,1869,38,25-29,1907,2
STAT,1875,34,40-44,1909,5.1276680689611105
STAT,1884,34,30-34,1918,19.737492388738396
STAT,1870,100,na,1970,8.963195774794952
STAT,1840,38,35-39,1878,6.641522403697533
SIM,1966,25,40-44,1991,9
SIM,1997,16,15-19,2013,141
SIM,1823,33,30-34,1856,37
SIM,1983,23,35-39,2006,18
STAT,1913,16,20-24,1929,32.08512079395774
SIM,1892,34,30-34,1926,40
STAT,1838,48,20-24,1886,0.01055969853072594
STAT,1938,24,25-29,1962,105.48081308378782
STAT,1849,41,25-29,1890,0.4999675537052336
STAT,1861,35,50-100,1896,1.1890919850219213
STAT,1910,3,na,1913,4627.7568154160535
SIM,1849,31,25-29,1880,20
STAT,1915,47,na,1962,4272.974695851455
STAT,1911,33,na,1944,4235.830915160704
STAT,1960,46,50-100,2006,0.35449489288462405
STAT,1881,20,45-49,1901,0.7808402405084786
SIM,1967,40,40-44,2007,1
SIM,1840,30,50-100,1870,3
SIM,1897,4,na,1901,4265
SIM,1807,49,50-100,1856,1
STAT,1891,17,35-39,1908,0.7826338261021526
STAT,1869,21,na,1890,2651.178023046128
STAT,1897,25,50-100,1922,0.9938279796945945
SIM,1862,35,na,1897,2839
STAT,1876,24,30-34,1900,21.11665044098561
STAT,1919,36,50-100,1955,0.5208884370492425
SIM,1921,16,20-24,1937,207
SIM,1936,61,na,1997,3666
STAT,1860,31,40-44,1891,4.0501014533292325
STAT,1961,41,35-39,2002,0.312467373809367
STAT,1862,33,40-44,1895,4.205844873825725
SIM,1928,10,na,1938,6072
STAT,1860,24,na,1884,2235.1839565170585
STAT,1883,44,40-44,1927,2.5053596277562447
STAT,1951,16,40-44,1967,1.922705893185245
SIM,1921,31,na,1952,5253
SIM,1933,4,na,1937,6712
STAT,1931,6,na,1937,6055.646101580907
STAT,1972,32,20-24,2004,3.6737681100895694
STAT,1855,72,na,1927,1074.591645408486
STAT,1859,86,na,1945,203.9718212538198
SIM,1960,39,50-100,1999,1
SIM,1884,24,30-34,1908,1
STAT,1830,37,15-19,1867,0.05678599466630697
STAT,1880,41,35-39,1921,2.225084720199712
SIM,1828,75,na,1903,1005
SIM,1869,14,na,1883,2268
STAT,1852,29,15-19,1881,0.446898426487163
SIM,1946,24,25-29,1970,123
STAT,1816,38,na,1854,1558.2307694097208
STAT,1893,19,35-39,1912,0.7961197530724721
STAT,1958,36,50-100,1994,0.6562351682263428
STAT,1988,16,20-24,2004,223.8356813998192
STAT,1869,48,25-29,1917,0.06356537359729655
STAT,1939,0,na,1939,5195.058877343169
STAT,1963,40,na,2003,5674.565446575734
STAT,1921,36,25-29,1957,1.269438617445057
STAT,1904,49,30-34,1953,0.08860021977877384
SIM,1822,48,35-39,1870,1
STAT,1915,20,15-19,1935,6.13107547321585
STAT,1831,41,15-19,1872,0.01340605032814035
STAT,1899,28,40-44,1927,4.719526100982778
SIM,1977,30,50-100,2007,2
STAT,1960,29,15-19,1989,1.0646337668181727
STAT,1952,9,na,1961,5434.575464868506
SIM,1884,15,40-44,1899,2
SIM,1906,27,35-39,1933,1
STAT,1861,41,na,1902,2227.4534226304036
STAT,1836,46,20-24,1882,0.011580424402911212
STAT,1850,41,na,1891,2390.0623729662784
STAT,1865,55,na,1920,2153.019304234392
SIM,1954,7,na,1961,5547
STAT,1857,20,na,1877,2250.7805455359367
STAT,1877,36,40-44,1913,5.280243394626203
STAT,1814,48,35-39,1862,0.3828849228097444
STAT,1876,15,40-44,1891,0.2192132674699377
SIM,1899,18,40-44,1917,2
STAT,1814,54,20-24,1868,0.0018845615844055726
STAT,1854,23,40-44,1877,1.9803838548661405
SIM,1923,20,15-19,1943,6
SIM,1831,46,35-39,1877,1
STAT,1980,11,na,1991,6294.167572188651
STAT,1851,35,30-34,1886,4.361224188693001
STAT,1857,19,25-29,1876,5.91608964939538
SIM,1974,33,na,2007,6331
STAT,1920,48,25-29,1968,0.06745274992726372
STAT,1872,46,30-34,1918,0.11249053099592557
STAT,1985,30,40-44,2015,6.554821432812616
STAT,1960,17,45-49,1977,0.750849083030323
STAT,1977,32,na,2009,6011.297888296866
STAT,1887,41,45-49,1928,1.944397494088892
STAT,1858,21,na,1879,2224.5539831143333
STAT,1886,49,15-19,1935,4.7675744668980745E-4
SIM,1948,33,25-29,1981,27
SIM,1870,43,45-49,1913,6
SIM,1964,28,35-39,1992,55
SIM,1852,19,15-19,1871,11
SIM,1824,45,na,1869,1553
SIM,1936,43,50-100,1979,1
STAT,1812,45,20-24,1857,0.028762975033611835
STAT,1955,41,15-19,1996,0.0024485208111264837
STAT,1827,48,45-49,1875,0.29493013590581796
STAT,1869,105,na,1974,0.5856451364519183
SIM,1880,46,30-34,1926,1
STAT,1952,39,50-100,1991,0.5969358641865112
SIM,1855,20,45-49,1875,3
SIM,1960,3,na,1963,6336
SIM,1872,18,na,1890,3154
STAT,1872,68,na,1940,1770.8786890102797
STAT,1859,101,na,1960,1.1959890319375568
STAT,1956,28,35-39,1984,23.014871240886478
SIM,1958,18,45-49,1976,1
STAT,1864,2,na,1866,3508.1313948234174
STAT,1902,16,45-49,1918,0.10677831331652071
STAT,1843,16,40-44,1859,0.23591733541102158
SIM,1855,22,na,1877,2088
SIM,1882,40,50-100,1922,3
SIM,1851,16,40-44,1867,1
SIM,1859,36,na,1895,2348
STAT,1975,21,25-29,1996,141.14088386910728
SIM,1891,75,na,1966,1613
STAT,1827,40,35-39,1867,2.505789134427767
STAT,1836,46,45-49,1882,0.22774833794747343
SIM,1969,18,20-24,1987,200
STAT,1920,19,50-100,1939,0.482285694027389
STAT,1910,30,40-44,1940,4.394092197463843
SIM,1895,89,na,1984,189
STAT,1900,17,na,1917,4044.393679817528
SIM,1847,37,35-39,1884,18
STAT,1847,20,45-49,1867,0.667314953877146
STAT,1901,32,40-44,1933,7.01022736248158
STAT,1882,19,35-39,1901,0.6151962177181088
STAT,1816,81,na,1897,267.05646244100836
SIM,1803,83,na,1886,189
STAT,1990,14,na,2004,6489.683818302688
STAT,1971,17,20-24,1988,198.1659423312456
STAT,1898,41,20-24,1939,0.017278455584315292
SIM,1974,23,25-29,1997,265
STAT,1850,29,40-44,1879,3.5770574588716313
STAT,1853,30,35-39,1883,10.600976895191147
SIM,1943,5,na,1948,5571
STAT,1921,5,na,1926,5287.215175443633
SIM,1887,54,na,1941,3372
SIM,1933,32,na,1965,6321
STAT,1882,17,50-100,1899,0.055224380579989546
SIM,1957,31,25-29,1988,31
SIM,1884,40,30-34,1924,1
STAT,1911,95,na,2006,215.0997717956829
STAT,1876,40,30-34,1916,1.385369122560749
SIM,1925,20,25-29,1945,2
STAT,1904,7,na,1911,4317.64627354515
SIM,1883,40,na,1923,2491
STAT,1821,39,15-19,1860,0.11482452687787235
STAT,1919,37,20-24,1956,0.32674668922878
STAT,1909,78,na,1987,2241.1050536102575
STAT,1933,40,25-29,1973,0.11359165245635092
STAT,1890,28,20-24,1918,16.484525944741122
SIM,1862,26,20-24,1888,1
STAT,1847,46,20-24,1893,0.00925966805960672
STAT,1874,15,30-34,1889,1.8988819249816131
STAT,1939,17,30-34,1956,14.085977054470213
STAT,1854,26,20-24,1880,11.090019348721924
SIM,1916,34,40-44,1950,11
STAT,1827,100,na,1927,0.8621835841502886
STAT,1853,38,45-49,1891,1.974908844763833
STAT,1823,46,35-39,1869,0.14027769112141114
STAT,1949,31,25-29,1980,12.652240805712301
SIM,1988,18,15-19,2006,75
STAT,1906,49,40-44,1955,0.15912340834682004
STAT,1840,36,na,1876,2053.3738991789087
STAT,1868,106,na,1974,0.2720487835355858
STAT,1895,19,45-49,1914,0.09760070802435018
STAT,1862,43,45-49,1905,1.447096809497998
STAT,1884,22,15-19,1906,3.7616164313434455
STAT,1942,49,15-19,1991,4.5947055643831867E-4
STAT,1814,108,na,1922,0.0011421135431305758
SIM,1892,22,15-19,1914,5
STAT,1920,21,na,1941,4697.307745839968
STAT,1887,28,25-29,1915,54.51682401748106
STAT,1825,45,30-34,1870,0.13897457029735127
STAT,1988,23,45-49,2011,1.8626666504237905
SIM,1927,37,20-24,1964,1
SIM,1895,28,25-29,1923,2
SIM,1862,62,na,1924,2212
SIM,1861,30,35-39,1891,7
STAT,1875,39,35-39,1914,8.350237864785113
STAT,1942,31,50-100,1973,1.017163142955377
STAT,1908,34,40-44,1942,4.231788050926474
SIM,1834,24,40-44,1858,2
SIM,1883,39,35-39,1922,29
SIM,1917,37,15-19,1954,2
STAT,1824,89,na,1913,65.00199264991018
SIM,1823,35,20-24,1858,1
SIM,1928,16,30-34,1944,24
SIM,1927,57,na,1984,4752
SIM,1818,41,25-29,1859,2
STAT,1845,47,25-29,1892,0.03863308927456223
STAT,1894,32,25-29,1926,15.195305066971839
STAT,1837,43,na,1880,1773.6138507865753
STAT,1865,27,35-39,1892,10.047005322026305
SIM,1856,87,na,1943,153
SIM,1852,73,na,1925,755
SIM,1938,16,15-19,1954,48
SIM,1829,30,45-49,1859,3
STAT,1972,21,20-24,1993,164.8993535552713
STAT,1966,23,25-29,1989,133.5395135723967
STAT,1873,43,20-24,1916,0.18580754766431537
SIM,1835,88,na,1923,54
SIM,1842,24,50-100,1866,1
SIM,1831,74,na,1905,682
SIM,1947,21,15-19,1968,13
SIM,1995,11,na,2006,6763
SIM,1979,24,20-24,2003,357
STAT,1884,32,40-44,1916,4.944815163832532
STAT,1898,112,na,2010,0.007395291721082676
SIM,1839,29,25-29,1868,52
SIM,1834,44,na,1878,1812
STAT,1868,20,na,1888,2660.3548749846564
SIM,1968,25,15-19,1993,4
STAT,1880,16,20-24,1896,21.739532545979092
SIM,1983,25,25-29,2008,233
STAT,1868,42,25-29,1910,0.7111263370394287
SIM,1838,39,35-39,1877,14
STAT,1806,92,na,1898,14.294941497515905
STAT,1957,32,35-39,1989,14.17333532113779
STAT,1864,38,20-24,1902,0.79037494206709
SIM,1830,30,na,1860,2164
SIM,1898,49,50-100,1947,2
SIM,1828,26,45-49,1854,2
SIM,1892,32,40-44,1924,21
STAT,1909,37,15-19,1946,0.0210001607819446
STAT,1936,39,25-29,1975,1.113801375285853
SIM,1965,32,35-39,1997,5
STAT,1893,20,15-19,1913,4.841060716727147
SIM,1981,25,15-19,2006,1
SIM,1938,38,35-39,1976,3
STAT,1875,17,na,1892,3012.026297856929
SIM,1890,16,30-34,1906,5
SIM,1892,37,35-39,1929,20
STAT,1939,21,15-19,1960,6.174097626062719
STAT,1871,24,na,1895,2698.3759412949166
STAT,1972,20,50-100,1992,0.9761450747627807
SIM,1942,24,40-44,1966,10
SIM,1864,29,35-39,1893,25
SIM,1953,27,20-24,1980,3
STAT,1955,44,30-34,1999,0.20286856966643582
STAT,1856,29,35-39,1885,8.677211534617252
STAT,1934,24,40-44,1958,5.213725046225948
STAT,1883,47,45-49,1930,0.2652235022997904
SIM,1835,40,35-39,1875,7
STAT,1846,16,45-49,1862,0.08533297023193027
STAT,1873,15,50-100,1888,0.0584226235996674
STAT,1773,96,na,1869,2.822040138421105
STAT,1862,36,45-49,1898,1.9508659616335173
STAT,1961,37,50-100,1998,0.6449383513151385
SIM,1899,27,30-34,1926,98
SIM,1820,49,50-100,1869,1
SIM,1856,35,50-100,1891,1
SIM,1877,29,45-49,1906,2
STAT,1826,36,35-39,1862,5.804294292978383
SIM,1855,47,35-39,1902,1
STAT,1884,37,35-39,1921,8.064693492946423
STAT,1946,31,20-24,1977,3.1842705773580318
STAT,1803,54,45-49,1857,0.05058140860422402
STAT,1984,19,50-100,2003,0.6136731105224311
SIM,1792,82,na,1874,117
STAT,1972,35,25-29,2007,1.5014642413367574
STAT,1935,27,15-19,1962,1.1111479804713111
SIM,1983,28,40-44,2011,10
STAT,1904,47,na,1951,3711.786947195272
STAT,1858,42,40-44,1900,2.022498449243783
SIM,1796,96,na,1892,2
SIM,1834,36,35-39,1870,7
STAT,1945,27,20-24,1972,23.111433236706123
SIM,1983,20,30-34,2003,113
SIM,1892,48,50-100,1940,1
SIM,1870,36,20-24,1906,3
SIM,1907,36,40-44,1943,4
STAT,1847,53,20-24,1900,5.586787205858012E-4
STAT,1957,30,na,1987,5872.482751724937
STAT,1900,33,na,1933,3805.2066923943134
SIM,1902,65,na,1967,3103
STAT,1956,42,50-100,1998,0.18643927126827278
SIM,1906,79,na,1985,1990
STAT,1869,54,50-100,1923,0.01641479813386711
SIM,1877,65,na,1942,1963
SIM,1954,31,20-24,1985,7
SIM,1901,91,na,1992,550
SIM,1957,48,na,2005,6112
STAT,1906,22,15-19,1928,5.551831860343545
SIM,1823,60,na,1883,1674
STAT,1857,16,20-24,1873,18.839604373674245
STAT,1828,39,25-29,1867,2.8437075505677982
STAT,1860,40,na,1900,2171.395390680976
STAT,1852,51,25-29,1903,0.0033554353621493955
STAT,1963,26,na,1989,5518.683315648102
SIM,1837,27,25-29,1864,92
STAT,1930,18,25-29,1948,64.49520436985719
SIM,1886,27,20-24,1913,12
STAT,1841,32,50-100,1873,0.9883831612624807
STAT,1878,27,20-24,1905,14.135877456222634
STAT,1893,17,45-49,1910,0.09528714896633078
STAT,1935,31,45-49,1966,2.5152122936519117
SIM,1836,39,25-29,1875,2
SIM,1905,36,30-34,1941,5
STAT,1910,33,45-49,1943,1.74540721628348
SIM,1963,20,45-49,1983,2
STAT,1964,23,15-19,1987,7.760355981428244
STAT,1857,113,na,1970,1.1040349368160339E-4
STAT,1851,33,40-44,1884,3.542401175091134
STAT,1829,27,25-29,1856,87.18925621268798
SIM,1872,40,na,1912,2918
STAT,1872,49,35-39,1921,0.15884502229848213
SIM,1912,54,na,1966,3565
STAT,1862,40,40-44,1902,2.2127470169771124
SIM,1880,49,35-39,1929,2
SIM,1870,40,40-44,1910,2
STAT,1920,45,20-24,1965,0.014158156339041895
STAT,1974,41,20-24,2015,0.027696929417194486
SIM,1948,30,20-24,1978,8
STAT,1847,49,25-29,1896,0.04339519058682792
STAT,1900,21,50-100,1921,0.6549889976577262
STAT,1921,33,20-24,1954,3.1181856080303265
STAT,1975,25,25-29,2000,100.73003489783122
SIM,1884,38,50-100,1922,1
SIM,1967,31,30-34,1998,7
STAT,1850,25,na,1875,2658.7412845021295
SIM,1986,16,15-19,2002,140
STAT,1888,41,15-19,1929,0.018818831244440483
STAT,1959,31,30-34,1990,24.25725635033533
STAT,1997,17,25-29,2014,73.0276864250567
STAT,1855,42,15-19,1897,0.011736255388188184
STAT,1946,30,na,1976,4940.101188300261
SIM,1943,31,na,1974,5312
SIM,1947,45,na,1992,5895
SIM,1894,37,45-49,1931,7
STAT,1908,13,na,1921,4419.7948589627695
STAT,1955,20,45-49,1975,1.7306687194569292
SIM,1827,30,50-100,1857,2
SIM,1911,16,15-19,1927,16
STAT,1978,32,50-100,2010,1.3273373099663102
SIM,1860,17,45-49,1877,1
STAT,1868,17,35-39,1885,0.6194063616363873
STAT,1949,34,50-100,1983,1.1296828817987596
STAT,1828,48,15-19,1876,3.635312268181325E-4
SIM,1839,26,20-24,1865,19
SIM,1966,39,45-49,2005,1
STAT,1812,48,25-29,1860,0.13134743254012024
SIM,1972,23,15-19,1995,17
SIM,1925,23,50-100,1948,1
STAT,1988,20,40-44,2008,5.571895586593062
SIM,1938,35,30-34,1973,3
STAT,1968,30,45-49,1998,2.3146168001138023
SIM,1981,20,20-24,2001,191
STAT,1897,28,30-34,1925,38.72225731356449
STAT,1903,16,15-19,1919,9.77903792071694
STAT,1825,48,35-39,1873,0.19280779469697762
STAT,1852,17,45-49,1869,0.07448706388295322
STAT,1904,28,25-29,1932,69.8559650346452
STAT,1886,37,45-49,1923,2.4266935903411797
STAT,1832,37,25-29,1869,2.5299293834287218
STAT,1869,29,45-49,1898,1.2320151664032981
STAT,1961,21,45-49,1982,1.683732042405782
STAT,1974,32,30-34,2006,24.200645868730593
STAT,1998,10,na,2008,6657.903830292052
SIM,1861,35,40-44,1896,2
STAT,1959,43,45-49,2002,0.2606832231049784
STAT,1864,54,na,1918,2157.700353982865
STAT,1911,17,na,1928,4464.113095109738
SIM,1863,36,na,1899,2404
SIM,1982,32,30-34,2014,57
STAT,1826,37,na,1863,1569.3087658540408
SIM,1862,29,25-29,1891,56
STAT,1953,44,20-24,1997,0.02553692638950617
STAT,1854,29,25-29,1883,35.611351630654426
STAT,1823,52,20-24,1875,7.022785964479584E-4
STAT,1879,20,na,1899,2866.932517600886
STAT,1931,46,35-39,1977,0.19948708184644276
SIM,1865,100,na,1965,23
SIM,1981,28,30-34,2009,29
STAT,1961,17,15-19,1978,67.66653587767081
SIM,1840,37,25-29,1877,8
STAT,1973,28,30-34,2001,58.706335444652154
STAT,1853,35,40-44,1888,4.449782606121166
STAT,1861,25,na,1886,2339.7607600590586
STAT,1834,31,15-19,1865,0.16820594150401139
SIM,1812,60,na,1872,1023
SIM,1912,28,25-29,1940,78
SIM,1888,29,20-24,1917,16
SIM,1944,6,na,1950,4682
STAT,1880,39,na,1919,2852.923099384297
STAT,1900,107,na,2007,0.6068794407112419
SIM,1833,43,40-44,1876,4
SIM,1868,47,45-49,1915,1
STAT,1982,15,30-34,1997,19.80417569884742
STAT,1962,29,25-29,1991,97.65089277405515
SIM,1883,36,30-34,1919,2
STAT,1855,19,15-19,1874,5.935550572749341
STAT,1914,32,50-100,1946,0.9609164323081165
SIM,1971,5,na,1976,5819
STAT,1923,26,30-34,1949,52.074791993036605
SIM,1970,29,25-29,1999,10
SIM,1899,22,25-29,1921,103
STAT,1908,37,45-49,1945,0.7375333218150019
STAT,1825,40,25-29,1865,0.9950639999209792
STAT,1966,20,20-24,1986,160.91947721477987
STAT,1869,21,35-39,1890,6.541470848617997
STAT,1816,52,50-100,1868,0.029569833826185644
SIM,1922,32,50-100,1954,5
STAT,1855,43,50-100,1898,0.8924365307597305
SIM,1864,23,15-19,1887,1
STAT,1824,39,40-44,1863,6.417110537279099
SIM,1838,36,30-34,1874,2
STAT,1841,16,30-34,1857,1.8385074377580275
SIM,1909,50,na,1959,4515
SIM,1932,72,na,2004,3847
STAT,1849,37,40-44,1886,3.4717964371893424
SIM,1898,27,na,1925,3888
SIM,1951,45,na,1996,6250
SIM,1877,21,35-39,1898,16
STAT,1880,28,15-19,1908,0.5530340996290468
STAT,1914,46,na,1960,4217.256508080985
STAT,1830,25,45-49,1855,1.5477871622460042
STAT,1910,32,na,1942,4212.826801037183
SIM,1919,90,na,2009,865
STAT,1875,36,30-34,1911,6.386621961707407
STAT,1906,108,na,2014,0.31033092106096144
SIM,1814,56,na,1870,1166
SIM,1979,27,25-29,2006,120
SIM,1832,39,40-44,1871,10
SIM,1877,30,25-29,1907,4
STAT,1888,49,25-29,1937,0.04315644342986846
STAT,1900,16,35-39,1916,0.8808365434065677
STAT,1894,47,20-24,1941,0.009995259611122041
STAT,1813,109,na,1922,3.257577079972173E-4
STAT,1957,37,40-44,1994,2.346661937950364
STAT,1831,59,na,1890,1524.7779865404018
STAT,1969,39,20-24,2008,0.3906879615582866
SIM,1781,82,na,1863,296
SIM,1901,49,30-34,1950,2
STAT,1917,20,25-29,1937,113.97347212459049
STAT,1848,50,20-24,1898,7.953270618691026E-4
SIM,1880,91,na,1971,239
STAT,1871,37,25-29,1908,3.30568218865051
STAT,1909,41,45-49,1950,0.1808855151342979
SIM,1896,49,25-29,1945,1
SIM,1931,26,30-34,1957,140
SIM,1890,19,35-39,1909,1
STAT,1840,37,20-24,1877,0.7313876961384865
SIM,1971,41,45-49,2012,1
STAT,1984,29,45-49,2013,2.841088676731955
SIM,1917,79,na,1996,2387
SIM,1857,37,40-44,1894,8
SIM,1909,28,na,1937,4595
SIM,1959,31,35-39,1990,1
STAT,1971,41,40-44,2012,0.3804904553127537
STAT,1867,30,15-19,1897,0.1546760142745456
SIM,1905,14,na,1919,4542
STAT,1881,32,15-19,1913,0.1585181261095304
STAT,1858,20,20-24,1878,72.21655100724638
SIM,1941,43,40-44,1984,1
SIM,1864,26,30-34,1890,4
STAT,1860,21,15-19,1881,3.186009949555995
SIM,1834,33,30-34,1867,31
STAT,1851,30,25-29,1881,8.631293611247495
STAT,1840,63,na,1903,1431.3715863263221
STAT,1810,97,na,1907,3.0588865359507986
STAT,1956,25,30-34,1981,60.145672378314394
SIM,1943,31,45-49,1974,4
STAT,1889,28,35-39,1917,13.67795261703539
STAT,2009,1,na,2010,7146.328940054732
STAT,1963,41,45-49,2004,0.2539523768378836
STAT,1885,50,25-29,1935,0.00413583554464738
SIM,1813,82,na,1895,265
SIM,1902,0,na,1902,4385
STAT,1827,45,40-44,1872,0.22271783755622035
STAT,1901,98,na,1999,71.95177661852932
SIM,1897,28,35-39,1925,34
STAT,1968,46,15-19,2014,5.536666692832468E-4
SIM,1849,37,45-49,1886,3
SIM,1974,20,20-24,1994,175
SIM,1954,56,na,2010,5203
STAT,1830,50,35-39,1880,0.007984901393156664
SIM,1866,20,20-24,1886,144
SIM,1942,27,45-49,1969,1
STAT,1880,19,25-29,1899,6.89460222388564
SIM,1964,25,30-34,1989,64
STAT,1856,26,30-34,1882,23.140782365598263
SIM,1867,87,na,1954,236
STAT,1825,43,40-44,1868,3.2745515091288198
SIM,1940,39,40-44,1979,5
SIM,1863,73,na,1936,1131
STAT,1852,42,35-39,1894,1.7051576393114236
STAT,1879,9,na,1888,3166.2567846309144
STAT,1932,39,40-44,1971,2.316822234011532
STAT,1978,17,30-34,1995,19.196988973000394
SIM,1856,25,30-34,1881,33
STAT,1883,68,na,1951,1725.4760610144028
SIM,1879,38,30-34,1917,1
STAT,1864,17,na,1881,2692.2177384140678
STAT,1851,38,35-39,1889,5.610294513563495
SIM,1899,71,na,1970,2656
SIM,1842,74,na,1916,1089
STAT,1803,51,40-44,1854,0.038974206826268565
STAT,1959,20,50-100,1979,0.9972650875169659
STAT,1934,27,45-49,1961,2.6834036041054086
SIM,1844,22,na,1866,2533
SIM,1848,36,na,1884,1819
STAT,1885,101,na,1986,12.513213992849927
STAT,1933,43,40-44,1976,0.3961478773439216
STAT,1826,33,30-34,1859,15.625991337520182
STAT,1848,25,30-34,1873,32.405841328270554
STAT,1896,49,20-24,1945,0.010102462303372542
SIM,1913,71,na,1984,3413
STAT,1975,32,25-29,2007,14.343538354433406
SIM,1919,37,25-29,1956,1
STAT,1841,32,20-24,1873,2.915875266831804
STAT,1866,45,30-34,1911,0.10457555098676448
SIM,1944,21,35-39,1965,40
STAT,1883,89,na,1972,371.8621787502302
STAT,1921,26,20-24,1947,23.54986996954217
STAT,1906,37,35-39,1943,2.569117920754479
STAT,1886,44,45-49,1930,1.7972848574671785
STAT,1869,17,50-100,1886,0.05551193415621781
SIM,1881,22,15-19,1903,2
STAT,1901,28,45-49,1929,1.7884681852298636
SIM,1954,34,25-29,1988,25
STAT,1978,33,na,2011,6067.957261876419
SIM,1793,83,na,1876,254
SIM,1802,61,na,1863,992
SIM,1876,48,na,1924,2474
SIM,1974,34,25-29,2008,18
STAT,1886,22,25-29,1908,69.68572120590339
SIM,1903,49,40-44,1952,1
SIM,1840,34,20-24,1874,3
SIM,1990,19,30-34,2009,52
STAT,1908,50,na,1958,3804.564271452185
STAT,1936,21,35-39,1957,10.398424175649433
STAT,1891,26,25-29,1917,60.54234040202717
SIM,1944,67,na,2011,3895
STAT,1812,45,na,1857,1379.3868277101624
STAT,1863,40,45-49,1903,1.5255140299377505
STAT,1946,34,25-29,1980,12.04349374393105
STAT,1946,43,50-100,1989,0.15602544053789075
STAT,1817,45,35-39,1862,0.4113008566961512
STAT,1882,20,15-19,1902,3.7408973099592795
STAT,1982,19,30-34,2001,19.78042132272732
SIM,1970,4,na,1974,6054
SIM,1882,18,35-39,1900,1
STAT,1854,1,na,1855,3093.7892316975235
SIM,1997,7,na,2004,6607
STAT,1826,53,na,1879,1276.2846560352923
STAT,1970,29,20-24,1999,26.45794900925908
SIM,1931,21,25-29,1952,173
SIM,1885,46,45-49,1931,1
STAT,1826,52,35-39,1878,0.005984984930149449
STAT,1836,50,40-44,1886,0.010089406367275688
STAT,1864,70,na,1934,1445.7859966342978
STAT,1977,35,50-100,2012,0.6756480467154153
STAT,1910,26,45-49,1936,1.9338661914011341
STAT,1850,62,na,1912,1881.550583365183
SIM,1973,32,na,2005,5358
SIM,1909,33,35-39,1942,25
STAT,1877,46,45-49,1923,0.28410935748231014
STAT,1927,23,35-39,1950,13.343695799648092
STAT,1859,51,35-39,1910,0.00795221582967321
STAT,1839,37,50-100,1876,1.1635372191911477
STAT,1815,42,20-24,1857,0.35490771605776766
SIM,1890,20,15-19,1910,6
SIM,1922,32,na,1954,4854
STAT,1939,44,na,1983,4445.550126347357
STAT,1932,27,35-39,1959,22.699455480622117
STAT,1869,26,40-44,1895,3.3593561080840866
STAT,1906,103,na,2009,8.322445015649702
SIM,1945,27,25-29,1972,7
SIM,1953,14,na,1967,5699
STAT,1929,12,na,1941,5835.917458373807
STAT,1944,39,20-24,1983,0.3365840614020493
STAT,1901,18,50-100,1919,0.07898703658873193
SIM,1922,23,25-29,1945,133
STAT,1832,34,20-24,1866,2.399849954371438
SIM,1851,35,35-39,1886,14
STAT,1986,19,15-19,2005,74.57800085768693
STAT,1895,20,25-29,1915,86.50698695664052
SIM,1935,23,35-39,1958,19
STAT,1770,108,na,1878,0.002371379641060945
SIM,1940,27,35-39,1967,39
STAT,1922,42,15-19,1964,0.002033301802641122
SIM,1837,24,20-24,1861,98
STAT,1959,34,35-39,1993,14.043511812369736
SIM,1901,64,na,1965,3233
SIM,1905,31,25-29,1936,21
STAT,1826,43,na,1869,1475.2045568178696
SIM,1901,54,na,1955,3567
STAT,1897,97,na,1994,93.99555425490236
STAT,1891,6,na,1897,3726.052706796453
STAT,1851,42,na,1893,1830.544700143652
STAT,1855,20,40-44,1875,2.1014941592391936
STAT,1801,53,50-100,1854,0.058885211063631204
STAT,1865,24,30-34,1889,18.503997405821583
SIM,1874,45,30-34,1919,1
SIM,1873,24,30-34,1897,1
STAT,1933,39,45-49,1972,1.0697810812806399
STAT,1972,24,25-29,1996,136.84359487372421
STAT,1821,34,45-49,1855,4.923468134674907
STAT,1916,44,40-44,1960,0.29485288636935936
SIM,1964,8,na,1972,5976
STAT,1831,33,50-100,1864,0.923404494262515
STAT,1865,36,25-29,1901,3.0124109899636697
SIM,1868,32,25-29,1900,3
SIM,1858,35,45-49,1893,4
STAT,1841,19,35-39,1860,0.6218106706701293
STAT,1899,35,40-44,1934,6.986871178925124
STAT,1958,22,25-29,1980,140.47034362579336
STAT,1946,24,na,1970,4686.506566444958
SIM,1884,35,na,1919,2690
STAT,1918,49,20-24,1967,0.013489300599466682
STAT,1894,30,35-39,1924,15.144663682051082
STAT,1958,18,40-44,1976,2.1194050980062586
STAT,1952,26,na,1978,5205.548396045025
SIM,1905,20,na,1925,3929
STAT,1909,15,40-44,1924,0.3183737779179753
SIM,1851,56,na,1907,2415
SIM,1941,36,40-44,1977,2
SIM,1905,84,na,1989,884
STAT,1801,61,na,1862,1068.4837749184649
STAT,1889,46,na,1935,3209.641314854265
STAT,1871,40,na,1911,2680.371039489743
STAT,1888,46,20-24,1934,0.016325114602998497
STAT,1914,23,25-29,1937,108.62207334970573
STAT,1843,35,35-39,1878,8.458781948728893
SIM,1813,45,na,1858,1378
SIM,1961,37,20-24,1998,1
SIM,1951,29,na,1980,6271
STAT,1849,53,30-34,1902,0.004539555129959274
SIM,2001,3,na,2004,7328
STAT,1839,34,30-34,1873,16.689403404725056
SIM,1804,78,na,1882,344
SIM,1965,35,na,2000,5573
SIM,1863,20,40-44,1883,6
STAT,1942,34,40-44,1976,4.805376085875393
SIM,1898,33,na,1931,3906
STAT,1937,27,25-29,1964,74.08494586502692
STAT,1910,94,na,2004,276.3844885824824
SIM,1845,27,20-24,1872,16
STAT,1843,55,na,1898,2074.704434636442
STAT,1835,50,35-39,1885,0.005696358592345039
STAT,1835,95,na,1930,8.286496392477252
SIM,1818,76,na,1894,775
SIM,1950,34,40-44,1984,15
STAT,1938,48,35-39,1986,0.15231708623875181
SIM,1980,10,na,1990,6008
SIM,1966,22,25-29,1988,151
STAT,1957,55,na,2012,5631.885010226043
SIM,1933,73,na,2006,4537
STAT,1928,29,25-29,1957,93.48711613063202
STAT,1938,26,15-19,1964,0.8078898373425573
STAT,1874,40,20-24,1914,0.1895224642406052
SIM,1813,55,na,1868,1241
SIM,1936,29,25-29,1965,75
SIM,1962,16,30-34,1978,45
STAT,1988,23,20-24,2011,184.07720227373616
STAT,1819,105,na,1924,0.019519134814190823
STAT,1954,16,30-34,1970,17.394225471134984
STAT,1827,52,40-44,1879,0.01286840013438521
STAT,1923,21,25-29,1944,124.3606416618562
SIM,1881,92,na,1973,15
STAT,1880,23,45-49,1903,0.850356756552477
STAT,1946,14,na,1960,5026.112866505872
SIM,1826,37,50-100,1863,3
SIM,1883,43,30-34,1926,2
STAT,1928,26,30-34,1954,55.89889065558597
SIM,1838,74,na,1912,460
SIM,1897,25,30-34,1922,2
STAT,1830,32,45-49,1862,1.8867611525038406
SIM,1934,25,50-100,1959,3
STAT,1901,112,na,2013,0.00784040078574245
SIM,1847,34,30-34,1881,30
SIM,1933,16,na,1949,6148
STAT,1901,18,na,1919,4071.9023048681697
STAT,1843,50,50-100,1893,0.015371578020914569
STAT,1900,54,na,1954,3353.2617970927863
SIM,1953,30,na,1983,5662
STAT,1899,47,35-39,1946,0.12427765288920996
STAT,1829,30,40-44,1859,6.084532804144197
STAT,1931,39,50-100,1970,0.6404740115455942
SIM,1894,22,25-29,1916,203
STAT,1976,0,na,1976,6107.010585913678
STAT,1981,26,15-19,2007,1.1446457178435125
STAT,1794,64,na,1858,1093.1712213601447
STAT,1853,42,40-44,1895,2.2366646453050123
STAT,1837,27,20-24,1864,10.903419712791742
SIM,1957,38,50-100,1995,2
STAT,1923,30,50-100,1953,1.1022350221541637
STAT,1844,72,na,1916,1056.3138667792853
SIM,1972,16,15-19,1988,123
STAT,1953,37,20-24,1990,0.37914463502279405
STAT,1840,35,50-100,1875,1.1893371152577399
STAT,1907,46,40-44,1953,0.1644407670229688
SIM,1856,28,35-39,1884,20
SIM,1861,40,na,1901,1836
STAT,1905,109,na,2014,0.13586383546875394
STAT,1963,17,25-29,1980,63.53638346071716
SIM,1971,17,25-29,1988,1
STAT,1921,32,na,1953,4855.405617292686
STAT,1964,16,15-19,1980,65.98398398709368
SIM,1893,41,35-39,1934,8
STAT,1885,41,35-39,1926,2.0938761294592463
STAT,1989,20,45-49,2009,1.86733163906062
SIM,1837,30,40-44,1867,3
STAT,1875,43,30-34,1918,1.3611846251443362
STAT,1888,109,na,1997,0.09445237386301975
SIM,1966,18,40-44,1984,2
STAT,1892,38,35-39,1930,10.179773121324903
STAT,1889,25,30-34,1914,36.06603168745578
STAT,1863,17,20-24,1880,20.414219740550873
STAT,1940,34,30-34,1974,18.799570567342357
STAT,1950,29,na,1979,5128.800586954113
STAT,1897,33,na,1930,3666.857571458925
STAT,1836,31,25-29,1867,11.909743896866038
SIM,1986,1,na,1987,6763
STAT,1968,22,50-100,1990,0.951578028035496
STAT,1817,76,na,1893,654.9971003689775
STAT,1986,21,45-49,2007,1.8569525079688356
STAT,1939,38,na,1977,4474.765208784453
SIM,1934,29,15-19,1963,1
STAT,1852,21,40-44,1873,2.3507825329219663
STAT,1929,30,45-49,1959,2.3094129117253077
SIM,1831,31,15-19,1862,1
STAT,1918,39,50-100,1957,0.5095119763833369
SIM,1948,48,45-49,1996,1
STAT,1836,21,na,1857,2586.4738677943915
STAT,1866,48,35-39,1914,0.14787101448915274
STAT,1896,32,na,1928,3637.4207675225834
STAT,1883,41,25-29,1924,0.7283352530682172
STAT,1807,50,50-100,1857,0.06177425535089378
STAT,1835,89,na,1924,65.47501927312618
STAT,1901,25,40-44,1926,4.875128936393788
SIM,1831,58,na,1889,1299
STAT,1926,29,15-19,1955,0.9694592828812311
STAT,1956,16,40-44,1972,2.136541349350429
SIM,1959,39,30-34,1998,6
STAT,1848,28,35-39,1876,12.151375684716438
STAT,1825,52,30-34,1877,0.00801017784377555
SIM,1909,30,30-34,1939,40
STAT,1816,75,na,1891,508.3996782338159
STAT,1904,37,15-19,1941,0.02008627358095684
STAT,1843,19,45-49,1862,0.08277611604633142
STAT,1981,18,40-44,1999,2.2564053044615764
SIM,1844,31,25-29,1875,3
SIM,1901,48,na,1949,3832
SIM,1955,24,15-19,1979,16
SIM,1920,23,15-19,1943,12
SIM,1830,57,na,1887,1443
SIM,1870,32,50-100,1902,2
STAT,1837,50,45-49,1887,0.010973157587503066
SIM,1891,69,na,1960,2121
SIM,1818,86,na,1904,178
STAT,1929,47,30-34,1976,0.13335466483575342
STAT,1981,29,40-44,2010,7.5466278006864975
STAT,1851,26,na,1877,2023.093795977493
SIM,1836,21,25-29,1857,3
STAT,1904,90,na,1994,593.1712609618887
SIM,1888,71,na,1959,1382
SIM,1979,31,20-24,2010,9
SIM,1871,17,20-24,1888,17
SIM,1940,24,30-34,1964,3
SIM,1834,23,na,1857,2158
STAT,1900,28,40-44,1928,4.780077906264278
SIM,1927,3,na,1930,5364
STAT,1912,23,15-19,1935,5.874819037633028
SIM,1905,27,40-44,1932,13
SIM,1909,27,15-19,1936,1
STAT,1897,47,25-29,1944,0.04990451715605063
STAT,1891,23,20-24,1914,97.98742321182006
STAT,1864,103,na,1967,0.9808620472221967
STAT,1897,20,35-39,1917,9.058655169874474
STAT,1856,30,15-19,1886,0.12958115525847022
STAT,1863,109,na,1972,0.013975387425729142
STAT,1862,21,25-29,1883,57.486845386921864
SIM,1873,41,na,1914,3287
STAT,1904,33,50-100,1937,0.8681973337541464
STAT,1869,30,25-29,1899,11.53923409785572
SIM,1849,34,40-44,1883,8
SIM,1963,28,40-44,1991,1
STAT,1854,92,na,1946,33.93165180002177
STAT,1834,78,na,1912,713.0446891907035
STAT,1817,92,na,1909,28.794743567556928
SIM,1895,25,20-24,1920,20
SIM,1908,27,na,1935,3784
SIM,1883,24,na,1907,2652
STAT,1933,36,40-44,1969,2.356291044607553
SIM,1836,43,45-49,1879,1
STAT,1887,25,20-24,1912,15.275491540021422
STAT,1955,28,40-44,1983,7.1681985085399225
STAT,1984,26,40-44,2010,7.676218903306192
STAT,1903,20,45-49,1923,1.1530804333116236
STAT,1923,17,40-44,1940,1.894737228196074
STAT,1876,25,50-100,1901,0.7683168814509915
SIM,1926,19,15-19,1945,109
SIM,1947,24,na,1971,6043
STAT,1919,91,na,2010,624.5262597344523
STAT,1836,53,45-49,1889,0.0131060094177537
STAT,1966,12,na,1978,5662.131695449791
STAT,1895,16,40-44,1911,0.2754303106404429
STAT,1907,6,na,1913,4435.716570639912
SIM,1851,32,30-34,1883,37
STAT,1893,67,na,1960,2461.041262588681
SIM,1848,52,na,1900,1617
STAT,1885,16,na,1901,2914.3888581535493
STAT,1765,99,na,1864,0.029318586503664236
STAT,1850,42,25-29,1892,0.6602521347879787
SIM,1812,42,45-49,1854,3
STAT,1869,8,na,1877,3057.6440061624958
STAT,1955,37,30-34,1992,2.8766579045659078
STAT,1927,20,30-34,1947,41.10046432763454
STAT,1962,34,50-100,1996,1.2445792960109507
SIM,1843,21,na,1864,2235
SIM,1834,31,40-44,1865,8
SIM,1870,21,25-29,1891,124
SIM,1976,22,50-100,1998,2
STAT,1851,42,30-34,1893,0.910558534969044
STAT,1953,48,20-24,2001,0.01600282257346662
STAT,1849,32,50-100,1881,0.748323848459976
STAT,1826,31,40-44,1857,4.321637727877021
STAT,1914,62,na,1976,3829.3182831986032
SIM,1935,20,30-34,1955,1
STAT,1906,11,na,1917,4352.514955824832
STAT,1874,18,35-39,1892,0.6465724313743113
SIM,1938,26,40-44,1964,9
SIM,1857,32,50-100,1889,1
STAT,2005,1,na,2006,6990.180189271788
STAT,1834,49,15-19,1883,3.773345508674383E-4
SIM,1863,43,50-100,1906,2
STAT,1843,32,30-34,1875,21.060899170704587
STAT,1848,22,na,1870,2766.1734330053273
STAT,1884,69,na,1953,1673.3237668526951
STAT,1914,20,20-24,1934,126.61700662873967
STAT,1823,88,na,1911,77.74202731082609
SIM,1894,67,na,1961,2704
STAT,1922,29,30-34,1951,50.77969580563749
SIM,1903,39,50-100,1942,1
SIM,1936,26,20-24,1962,1
SIM,1950,28,na,1978,4280
STAT,1954,19,35-39,1973,5.982488900664565
SIM,1930,29,30-34,1959,8
STAT,1957,49,na,2006,5780.281736653795
STAT,1860,39,15-19,1899,0.05170417364750261
SIM,1908,21,25-29,1929,97
SIM,1994,19,15-19,2013,66
SIM,1817,75,na,1892,221
SIM,1897,32,na,1929,3757
STAT,1858,32,15-19,1890,0.128207634855255
STAT,1919,32,15-19,1951,0.15996106797239537
SIM,1948,6,na,1954,4487
SIM,1888,65,na,1953,1734
SIM,1858,22,15-19,1880,6
STAT,1879,43,15-19,1922,0.01652089377191391
SIM,1862,33,45-49,1895,6
SIM,1922,20,20-24,1942,164
STAT,1839,43,20-24,1882,0.13105242657656618
STAT,1869,91,na,1960,114.95435238883834
STAT,1973,41,15-19,2014,0.002385441911836749
STAT,1936,46,na,1982,4215.200629255181
SIM,1886,2,na,1888,3203
STAT,1839,37,35-39,1876,6.703038797664969
STAT,1882,73,na,1955,1338.8526133002383
SIM,1916,78,na,1994,2515
SIM,1870,39,25-29,1909,3
SIM,1818,92,na,1910,59
STAT,1918,19,15-19,1937,56.688713709773715
SIM,1966,36,40-44,2002,1
SIM,1953,22,50-100,1975,1
STAT,1991,15,na,2006,6090.77116536357
STAT,1899,38,45-49,1937,0.6769233219005705
STAT,1921,39,40-44,1960,1.9241804696641576
STAT,1938,21,45-49,1959,1.28618393663245
STAT,1968,33,50-100,2001,1.2140275516145267
SIM,1937,46,na,1983,4292
SIM,1883,18,na,1901,2706
SIM,1971,27,na,1998,5185
SIM,1989,0,na,1989,6761
STAT,1821,38,50-100,1859,2.6147846328161473
STAT,1812,94,na,1906,8.774554632373086
STAT,1854,33,45-49,1887,1.4398401355452373
STAT,1833,23,na,1856,1998.148464087517
STAT,1899,44,30-34,1943,0.12452146101199746
STAT,1905,16,25-29,1921,9.488509869095756
SIM,1847,37,50-100,1884,1
SIM,1861,42,40-44,1903,5
STAT,1913,48,50-100,1961,0.25419494441037527
STAT,1862,39,25-29,1901,2.775920992157557
SIM,1842,95,na,1937,15
STAT,1875,4,na,1879,3468.152457278178
STAT,1947,24,15-19,1971,6.938061582803421
STAT,1878,52,50-100,1930,0.018101263925037726
SIM,1914,15,15-19,1929,19
STAT,1830,58,na,1888,1244.7462681459842
SIM,1825,62,na,1887,1205
STAT,1907,49,45-49,1956,0.2225106976220242
STAT,1936,48,50-100,1984,0.2581486793866325
STAT,1904,84,na,1988,1328.2982578911474
STAT,1943,18,20-24,1961,165.8779032285295
SIM,1879,30,35-39,1909,16
STAT,1966,34,25-29,2000,13.562492685076553
STAT,1794,80,na,1874,338.75781215956886
STAT,1959,28,15-19,1987,1.069782307224472
SIM,1907,31,35-39,1938,17
STAT,1892,35,30-34,1927,7.782096521167576
STAT,1928,26,20-24,1954,26.041526643639113
SIM,1898,17,na,1915,4108
SIM,1808,46,50-100,1854,1
STAT,1827,35,50-100,1862,1.8904292488587984
STAT,1844,56,na,1900,1705.9960296827858
STAT,1952,19,15-19,1971,62.7217155190337
STAT,1988,26,25-29,2014,109.1577635299937
STAT,1991,0,na,1991,6550.959517604301
STAT,1828,36,20-24,1864,0.8106324607692017
SIM,1839,91,na,1930,75
STAT,1886,41,40-44,1927,2.7504576665827885
SIM,1823,38,25-29,1861,4
STAT,1806,55,na,1861,1100.8243226737113
STAT,1824,52,25-29,1876,0.0046457172780554595
STAT,1928,29,35-39,1957,21.32435448660817
SIM,1904,39,30-34,1943,2
SIM,1845,60,na,1905,1781
SIM,1958,49,na,2007,6046
STAT,1908,101,na,2009,23.314181021603734
STAT,1979,18,50-100,1997,0.5951307340537665
STAT,1864,21,45-49,1885,0.7353840635297213
SIM,1921,48,50-100,1969,1
STAT,1906,15,15-19,1921,10.033484832675095
STAT,1990,17,15-19,2007,75.00541449390376
SIM,1960,19,15-19,1979,120
STAT,1945,22,15-19,1967,6.732894308216463
SIM,1953,22,15-19,1975,12
SIM,1914,37,35-39,1951,6
STAT,1913,2,na,1915,4812.495492768208
SIM,1872,21,45-49,1893,1
STAT,1860,38,50-100,1898,1.1362701742272485
SIM,1936,29,35-39,1965,22
STAT,1823,31,15-19,1854,0.4367890395167709
STAT,1930,27,15-19,1957,1.0360657204714272
SIM,1877,49,na,1926,2962
STAT,1882,50,20-24,1932,8.437470277190177E-4
STAT,1852,24,45-49,1876,0.7698378010259539
STAT,1938,48,25-29,1986,0.06266760056299144
SIM,1973,17,35-39,1990,11
STAT,1897,17,na,1914,3897.348235101533
SIM,1836,36,20-24,1872,1
STAT,1897,35,30-34,1932,8.302358437691899
STAT,1898,98,na,1996,67.8669869672756
STAT,1851,52,35-39,1903,0.006790596114295641
STAT,1876,34,na,1910,2822.445298337753
STAT,1954,38,40-44,1992,2.1980776562393176
STAT,1956,18,30-34,1974,18.607261626007574
SIM,1846,31,45-49,1877,4
SIM,1891,85,na,1976,737
STAT,1871,15,40-44,1886,0.21386395179378243
STAT,1940,37,35-39,1977,2.920825760565081
SIM,1904,37,40-44,1941,3
STAT,1861,19,na,1880,2501.5174130005175
STAT,1968,6,na,1974,5666.447408974049
STAT,1931,39,35-39,1970,3.689716218335219
SIM,1943,66,na,2009,4434
SIM,1955,22,25-29,1977,286
SIM,1964,18,30-34,1982,23
STAT,1811,44,na,1855,1586.294939678236
SIM,1866,34,50-100,1900,1
SIM,1900,31,25-29,1931,16
STAT,1827,54,na,1881,1824.9927764768122
STAT,1840,44,20-24,1884,0.12953481535572797
STAT,1965,17,35-39,1982,6.04563828629436
SIM,1949,29,45-49,1978,1
STAT,1924,42,25-29,1966,0.09799666046544994
SIM,1889,47,50-100,1936,1
STAT,1865,71,na,1936,1389.869243455559
SIM,1968,23,na,1991,4956
SIM,1840,25,30-34,1865,7
STAT,1920,38,20-24,1958,0.33260433739109535
SIM,1871,24,20-24,1895,67
STAT,1853,20,30-34,1873,21.257927829883208
STAT,1987,20,35-39,2007,15.574713905910691
STAT,1837,39,15-19,1876,0.04849044287129928
STAT,1859,111,na,1970,0.001199727143566043
STAT,1917,28,20-24,1945,22.014966202818087
SIM,1923,3,na,1926,5821
STAT,1838,31,45-49,1869,1.8969216349033744
STAT,1928,48,40-44,1976,0.23150786756959174
SIM,1854,41,50-100,1895,3
SIM,1861,20,30-34,1881,33
STAT,1925,48,15-19,1973,5.135418870238506E-4
STAT,1832,25,30-34,1857,24.918686728907005
SIM,1849,36,30-34,1885,9
STAT,1932,18,45-49,1950,0.7615495956141657
SIM,1925,28,20-24,1953,25
SIM,1911,16,na,1927,5056
STAT,1907,16,35-39,1923,0.9339824934390824
SIM,1947,27,35-39,1974,24
STAT,1932,65,na,1997,5014.618117006655
STAT,1924,30,na,1954,5113.759591061515
STAT,1953,20,35-39,1973,13.197682773171719
STAT,1949,21,20-24,1970,149.7848145972661
STAT,1841,23,30-34,1864,19.91793299664902
STAT,1880,20,40-44,1900,2.5642096923692574
STAT,1867,26,30-34,1893,27.226319585548055
STAT,1967,19,45-49,1986,0.7196397033019332
STAT,1841,28,25-29,1869,46.37775561288985
STAT,1945,13,na,1958,4951.211944727717
STAT,1940,15,15-19,1955,53.22309729958604
SIM,1866,71,na,1937,1352
STAT,1826,34,45-49,1860,1.4932622350192195
SIM,1845,17,na,1862,2498
SIM,1835,30,30-34,1865,34
SIM,1957,21,20-24,1978,312
SIM,1929,11,na,1940,5474
STAT,1947,22,25-29,1969,120.47314334578616
SIM,1975,19,45-49,1994,2
SIM,1931,30,na,1961,6140
STAT,1905,85,na,1990,1211.7073934621546
SIM,1957,15,35-39,1972,8
STAT,1890,38,25-29,1928,4.039876430646121
STAT,1939,27,35-39,1966,17.425392814316588
STAT,1845,57,na,1902,1354.199711170259
STAT,1938,36,40-44,1974,1.758177614196527
STAT,1950,32,25-29,1982,12.8556906219768
SIM,1961,20,35-39,1981,30
SIM,1968,13,na,1981,5394
STAT,1833,50,25-29,1883,0.0026908846766881076
STAT,1851,45,35-39,1896,0.11212609073073536
SIM,1803,62,na,1865,1283
STAT,1954,16,20-24,1970,193.47511402691646
SIM,1916,63,na,1979,4073
STAT,1978,21,50-100,1999,1.0400905716722952
SIM,1896,37,30-34,1933,17
SIM,1995,16,na,2011,5967
SIM,1834,34,45-49,1868,6
SIM,1866,86,na,1952,153
SIM,1879,45,30-34,1924,1
STAT,1910,20,50-100,1930,0.718105923880076
SIM,1886,24,40-44,1910,1
SIM,1912,70,na,1982,2573
STAT,1827,30,30-34,1857,33.45885815722659
SIM,1853,25,40-44,1878,1
SIM,1962,16,20-24,1978,362
SIM,1883,34,na,1917,2525
STAT,1843,26,45-49,1869,1.3809614012599423
SIM,1845,34,20-24,1879,5
STAT,1905,49,35-39,1954,0.12915398417226817
SIM,1969,28,25-29,1997,107
SIM,1851,26,45-49,1877,2
STAT,1820,81,na,1901,317.3745198366146
STAT,1839,27,30-34,1866,25.158345599774623
STAT,1863,29,15-19,1892,0.45456360475571167
STAT,1837,34,20-24,1871,2.4036790944924884
STAT,1942,41,40-44,1983,0.3139968061263583
SIM,1847,27,30-34,1874,3
SIM,1782,77,na,1859,81
STAT,1972,39,50-100,2011,0.637784222899075
STAT,1925,21,35-39,1946,13.042078795510495
SIM,1798,60,na,1858,1136
STAT,1878,24,40-44,1902,2.495178392427971
STAT,1888,37,30-34,1925,7.229969838760422
STAT,1845,25,40-44,1870,2.4926321649166665
STAT,1930,15,30-34,1945,18.272595232704095
SIM,1828,38,na,1866,2325
SIM,1828,54,na,1882,1806
STAT,1883,41,15-19,1924,0.01566312476800012
STAT,1988,16,na,2004,6076.949313905898
SIM,1968,18,15-19,1986,62
SIM,1819,44,20-24,1863,1
STAT,1992,21,20-24,2013,184.86199702343757
SIM,1849,37,na,1886,2705
STAT,1927,30,35-39,1957,12.984782413324734
STAT,1902,105,na,2007,2.442824067153162
STAT,1949,15,35-39,1964,5.634928901206281
STAT,1949,39,20-24,1988,0.36373447995736025
SIM,1950,44,na,1994,4673
SIM,1803,77,na,1880,587
SIM,1914,28,45-49,1942,3
SIM,1972,26,40-44,1998,1
STAT,1907,43,50-100,1950,0.12366729041232447
SIM,1908,48,50-100,1956,1
STAT,1894,47,50-100,1941,0.20456963860818378
STAT,1828,43,45-49,1871,1.416953058520842
STAT,1951,38,15-19,1989,0.02716071384981022
STAT,1865,17,30-34,1882,1.7102145919341938
STAT,1830,109,na,1939,4.463107145236562E-4
STAT,1862,32,50-100,1894,0.8923612404995904
STAT,1931,15,na,1946,5586.96516381309
STAT,1906,37,25-29,1943,1.0458191990587602
STAT,1872,41,na,1913,2690.3882710701378
STAT,1969,23,15-19,1992,7.696870398582573
SIM,1839,75,na,1914,1288
SIM,1858,34,30-34,1892,45
SIM,1859,15,na,1874,2516
STAT,1946,43,15-19,1989,0.0020395483913623587
STAT,1815,107,na,1922,0.002616796147959291
STAT,1849,44,40-44,1893,1.7198103743631692
SIM,1895,18,20-24,1913,25
SIM,1858,28,45-49,1886,1
SIM,1937,17,25-29,1954,55
STAT,1840,48,50-100,1888,0.19615045414544247
STAT,1929,17,25-29,1946,63.82716446744673
STAT,1932,24,30-34,1956,43.38121929348071
SIM,1970,40,na,2010,5965
SIM,1935,30,35-39,1965,25
STAT,1887,18,20-24,1905,22.868644421064985
STAT,1936,66,na,2002,3601.80374959634
STAT,1956,54,na,2010,5683.132348218309
SIM,1914,37,25-29,1951,2
STAT,1988,26,na,2014,6212.699122565618
SIM,1892,20,25-29,1912,180
STAT,1785,97,na,1882,0.6525740448702874
SIM,1929,32,25-29,1961,15
STAT,1879,16,50-100,1895,0.059181132586540335
STAT,1981,33,50-100,2014,1.3591479260426642
SIM,1987,22,40-44,2009,9
STAT,1893,16,30-34,1909,2.3307171645292923
STAT,1817,42,30-34,1859,3.5448694830779552
SIM,1948,25,na,1973,4264
SIM,1979,34,25-29,2013,3
STAT,1921,17,30-34,1938,16.027968650413772
STAT,1953,27,50-100,1980,1.3955692192167444
STAT,1949,38,50-100,1987,0.5799750182416575
SIM,1825,36,45-49,1861,6
STAT,1916,48,na,1964,4336.9538556567295
STAT,1926,25,50-100,1951,1.3860571021074473
STAT,1915,63,na,1978,3838.915117639731
STAT,1928,11,na,1939,5770.151799031189
STAT,1842,47,35-39,1889,0.10775153455998944
STAT,1979,22,40-44,2001,5.360380250877047
SIM,1850,47,35-39,1897,2
STAT,1906,28,45-49,1934,1.8619198144626665
SIM,1967,32,45-49,1999,1
STAT,1876,18,45-49,1894,0.07772419474932984
STAT,1992,15,35-39,2007,6.954538165720639
STAT,1836,49,25-29,1885,0.053490112845919834
STAT,1927,17,15-19,1944,65.10703298650965
STAT,1964,26,40-44,1990,6.807260790945647
STAT,1873,22,15-19,1895,3.8878663399905893
STAT,1959,32,45-49,1991,2.421334021903172
SIM,1862,19,na,1881,3120
SIM,1895,31,40-44,1926,8
STAT,1863,27,25-29,1890,42.68679364189002
STAT,1827,38,na,1865,2258.92951933511
STAT,1910,16,na,1926,4431.991348012596
SIM,1825,42,30-34,1867,1
SIM,1844,49,25-29,1893,2
STAT,1884,20,25-29,1904,65.66210153513309
SIM,1938,28,30-34,1966,94
STAT,1964,27,na,1991,5468.6354304684255
STAT,1887,31,40-44,1918,5.631696255257692
SIM,1935,17,15-19,1952,121
SIM,1835,39,na,1874,2275
STAT,1915,9,na,1924,4793.399082553642
STAT,1857,51,25-29,1908,0.0031988313144034404
STAT,1929,38,40-44,1967,2.2158060646329187
SIM,1919,15,15-19,1934,13
SIM,1947,39,50-100,1986,1
STAT,1966,28,40-44,1994,6.744345750901616
STAT,1936,62,na,1998,3827.4515211554053
SIM,1869,35,20-24,1904,2
STAT,1911,70,na,1981,3148.709900616432
STAT,1848,37,na,1885,2579.6906287686706
STAT,1892,16,50-100,1908,0.07103757770838126
STAT,1818,37,50-100,1855,2.024283407724501
STAT,1898,19,35-39,1917,0.8512213174520918
SIM,1923,33,na,1956,5285
STAT,1841,35,25-29,1876,3.079315305836196
STAT,1977,32,35-39,2009,14.524776338384129
SIM,1937,38,40-44,1975,3
STAT,1864,48,25-29,1912,0.058607656366309185
SIM,1924,47,45-49,1971,1
STAT,1906,34,30-34,1940,16.726958725393356
STAT,1924,29,40-44,1953,6.21656133737342
SIM,1903,26,50-100,1929,2
STAT,1943,49,20-24,1992,0.01398609185249582
STAT,1881,23,na,1904,2624.469683114469
SIM,1990,17,40-44,2007,4
SIM,1933,26,na,1959,6108
SIM,1870,86,na,1956,380
STAT,1832,27,20-24,1859,11.147145988848171
SIM,1835,24,na,1859,2736
SIM,1976,0,na,1976,6066
STAT,1837,40,40-44,1877,1.9718314811326316
STAT,1877,99,na,1976,23.21972269148435
SIM,1959,42,35-39,2001,1
SIM,1886,27,45-49,1913,5
SIM,1949,26,40-44,1975,1
STAT,1900,16,25-29,1916,9.096734691107686
SIM,1885,39,45-49,1924,7
STAT,1816,54,30-34,1870,0.011198719726300628
STAT,1882,53,25-29,1935,0.003928504421955585
STAT,1877,39,45-49,1916,2.3689858010237925
STAT,1932,15,40-44,1947,2.147873975837238
STAT,1817,38,35-39,1855,24.76061436911264
SIM,1856,93,na,1949,68
SIM,1789,83,na,1872,63
STAT,1927,38,30-34,1965,2.61185921817469
SIM,1897,18,30-34,1915,7
SIM,1936,26,30-34,1962,3
STAT,1914,52,na,1966,4136.012153681708
SIM,1935,38,30-34,1973,6
STAT,1940,22,15-19,1962,6.260052968033706
STAT,1955,48,30-34,2003,0.14166104247420866
STAT,1905,25,15-19,1930,0.7629708439977213
STAT,1897,38,35-39,1935,10.860328580830917
STAT,1990,24,15-19,2014,8.820745969191268
SIM,1914,34,30-34,1948,21
SIM,1837,17,20-24,1854,21
SIM,1824,61,na,1885,1003
STAT,1876,22,40-44,1898,2.485939879197688
SIM,1959,21,30-34,1980,101
STAT,1825,40,15-19,1865,0.021399227233955903
STAT,1916,47,45-49,1963,0.2572862208460752
STAT,1966,49,45-49,2015,0.323946158168462
SIM,1974,31,20-24,2005,5
STAT,1832,49,40-44,1881,0.12463791904141228
STAT,1837,37,25-29,1874,2.5384096192946504
SIM,1974,27,25-29,2001,110
SIM,1872,39,35-39,1911,4
STAT,1911,29,30-34,1940,43.81996233356432
STAT,1948,40,20-24,1988,0.02430592133753757
STAT,1886,70,na,1956,1742.2063858556012
STAT,1765,101,na,1866,0.011247631259950541
SIM,1985,23,45-49,2008,3
SIM,1871,6,na,1877,2508
STAT,1820,50,50-100,1870,0.015434147694580892
STAT,1931,36,30-34,1967,2.788738956251975
STAT,1988,19,25-29,2007,71.47864530263709
STAT,1890,35,20-24,1925,1.0973128592663384
STAT,1932,73,na,2005,4120.773103031491
STAT,1863,48,50-100,1911,0.24472336903707964
STAT,1847,32,15-19,1879,0.12865642554337714
SIM,1979,16,25-29,1995,92
STAT,1896,22,na,1918,3605.010717731751
STAT,1854,19,20-24,1873,17.07479737732924
SIM,1902,49,na,1951,3740
SIM,1840,27,20-24,1867,25
STAT,1962,21,50-100,1983,0.9765013554190236
SIM,1855,32,15-19,1887,2
STAT,1963,30,45-49,1993,2.354356543815864
STAT,1954,28,15-19,1982,1.0110268505970808
SIM,1919,33,na,1952,5251
STAT,1906,25,40-44,1931,5.075348412510487
STAT,1986,26,15-19,2012,1.1664063100832447
SIM,1842,28,50-100,1870,1
STAT,1834,28,50-100,1862,0.7599951889678089
STAT,1843,23,40-44,1866,2.605606289893936
STAT,1863,30,40-44,1893,4.411401402920989
SIM,1845,37,25-29,1882,5
STAT,1990,15,25-29,2005,71.6584440078085
SIM,1932,15,na,1947,5659
STAT,1877,43,40-44,1920,2.6806266146759126
SIM,1909,31,45-49,1940,3
SIM,2003,5,na,2008,6669
STAT,1932,49,45-49,1981,0.33832916584382994
SIM,1885,43,40-44,1928,7
SIM,1894,20,35-39,1914,20
SIM,1962,19,25-29,1981,3
SIM,1844,42,50-100,1886,2
STAT,1878,27,45-49,1905,1.3378659197580784
STAT,1932,27,25-29,1959,99.51563279215455
STAT,1928,38,15-19,1966,0.02797876338835688
SIM,1946,26,15-19,1972,4
SIM,1946,39,45-49,1985,3
SIM,1875,26,30-34,1901,4
STAT,1938,39,45-49,1977,0.7982312513995236
STAT,1862,21,35-39,1883,5.860070858628503
STAT,1858,15,na,1873,2442.700576065878
STAT,1992,17,25-29,2009,71.78410545355327
SIM,1870,21,35-39,1891,15
STAT,1854,30,40-44,1884,3.6940425233453587
STAT,1886,20,35-39,1906,7.1459790345697565
SIM,1825,38,35-39,1863,7
STAT,1838,46,30-34,1884,0.08739241365287186
STAT,1815,45,25-29,1860,0.1211466668043119
SIM,1913,46,30-34,1959,1
STAT,1954,19,25-29,1973,61.78344294319644
SIM,1836,29,20-24,1865,13
STAT,1950,19,40-44,1969,1.907330288562799
STAT,1876,25,45-49,1901,1.3335544512897857
STAT,1905,46,30-34,1951,0.09146399458761406
STAT,1926,88,na,2014,1175.355202093696
STAT,1889,18,30-34,1907,2.261449130159224
STAT,1936,24,15-19,1960,5.872698521912204
SIM,1903,27,30-34,1930,87
SIM,1904,18,25-29,1922,17
SIM,1862,30,40-44,1892,16
STAT,1927,47,20-24,1974,0.016005371664655803
SIM,1906,39,40-44,1945,3
STAT,1828,29,20-24,1857,15.451506561707452
SIM,1846,46,30-34,1892,1
STAT,1914,32,15-19,1946,0.1493506554607435
SIM,1868,20,40-44,1888,3
STAT,1836,42,50-100,1878,1.1441709652872394
STAT,1967,16,40-44,1983,2.0169071167998274
SIM,1841,94,na,1935,8
STAT,1879,84,na,1963,657.5952184262554
STAT,1896,32,45-49,1928,2.6580839297627303
SIM,1979,28,50-100,2007,6
STAT,1866,56,na,1922,2181.7187335137155
STAT,1885,5,na,1890,3016.6412656487205
SIM,1908,12,na,1920,4365
SIM,1975,16,40-44,1991,2
STAT,1921,48,30-34,1969,0.1156112056414041
STAT,1840,47,25-29,1887,0.046595877569805134
STAT,1931,15,15-19,1946,68.8866010082179
SIM,1937,62,na,1999,3745
SIM,1994,8,na,2002,6229
STAT,1880,16,45-49,1896,0.08010143026884936
STAT,1795,75,na,1870,361.1096506859911
STAT,1849,47,45-49,1896,0.18206333562923208
STAT,1802,62,na,1864,1238.1457755825372
STAT,1960,54,na,2014,5593.825041865309
SIM,1942,17,40-44,1959,1
SIM,1869,41,40-44,1910,2
STAT,1922,27,40-44,1949,6.084085690077307
STAT,1819,35,40-44,1854,18.18982731809371
STAT,1823,61,na,1884,1122.7584450529844
STAT,1911,17,50-100,1928,0.08659516805157882
STAT,1839,36,20-24,1875,0.7381620967839682
SIM,1884,19,na,1903,2851
SIM,1992,19,40-44,2011,5
SIM,1851,72,na,1923,1616
SIM,1940,27,25-29,1967,114
SIM,1858,32,40-44,1890,4
STAT,1792,100,na,1892,0.2981190306354552
STAT,1864,45,20-24,1909,0.012488576124100354
STAT,1798,101,na,1899,0.14514370772525254
STAT,1865,42,50-100,1907,1.0986826161558703
STAT,1830,25,20-24,1855,16.353903130876116
STAT,1930,18,35-39,1948,6.245068677113148
STAT,1867,1,na,1868,3842.610797928891
SIM,1993,20,25-29,2013,323
SIM,1873,56,na,1929,2799
SIM,1906,85,na,1991,1150
SIM,1858,37,35-39,1895,16
SIM,1869,28,20-24,1897,20
SIM,1867,20,15-19,1887,4
STAT,1884,50,30-34,1934,0.006884757085569286
SIM,1849,27,40-44,1876,1
STAT,1863,110,na,1973,0.005851354961278533
STAT,1938,45,30-34,1983,0.1061070415150243
STAT,1967,17,45-49,1984,0.7201221044582445
STAT,1861,40,35-39,1901,1.7548378841012193
SIM,1930,27,40-44,1957,1
STAT,1851,20,20-24,1871,66.20679314984712
STAT,1813,95,na,1908,6.087658527126723
STAT,1985,20,25-29,2005,152.22018498454102
STAT,1900,2,na,1902,4268.669639350663
STAT,1825,30,20-24,1855,6.647363847825295
SIM,1817,91,na,1908,24
SIM,1894,37,20-24,1931,3
STAT,1834,94,na,1928,18.239306363259885
SIM,1962,18,20-24,1980,5
SIM,1914,25,40-44,1939,2
STAT,1954,18,20-24,1972,193.35904629387056
SIM,1879,48,35-39,1927,1
STAT,1876,18,na,1894,3005.100660299056
STAT,1934,17,40-44,1951,2.184425279802689
SIM,1961,28,30-34,1989,122
STAT,1953,28,30-34,1981,54.911104314813024
STAT,1828,40,40-44,1868,2.234403761057098
SIM,1938,47,na,1985,4039
SIM,1957,24,25-29,1981,307
STAT,1853,45,45-49,1898,0.23730859266865292
STAT,1890,29,35-39,1919,13.508903215153907
STAT,1891,19,25-29,1910,8.039212701590682
SIM,1866,30,25-29,1896,28
STAT,1979,25,45-49,2004,2.7594086474089656
SIM,1850,44,30-34,1894,3
STAT,1875,46,35-39,1921,0.16743739870172764
STAT,1897,44,20-24,1941,0.01678843390340229
STAT,1865,26,20-24,1891,12.257365072062587
SIM,1949,27,45-49,1976,1
SIM,1887,70,na,1957,2537
SIM,1858,89,na,1947,180
STAT,1888,39,20-24,1927,1.03518937299714
STAT,1981,21,45-49,2002,1.8223090171156584
STAT,1949,24,25-29,1973,124.30062365353018
STAT,1908,27,40-44,1935,5.1346697346317685
STAT,1854,49,na,1903,1794.6681343291416
STAT,1899,20,45-49,1919,1.109092751111984
STAT,1977,23,45-49,2000,1.7596932260485683
STAT,1908,77,na,1985,2324.8733665856826
STAT,1816,91,na,1907,28.617519836462947
STAT,1892,66,na,1958,2460.762090240791
STAT,1927,21,45-49,1948,1.6043011280601034
STAT,1863,24,20-24,1887,69.91131767760763
STAT,1886,37,20-24,1923,0.938362943959866
STAT,1969,19,50-100,1988,0.5397524998199251
STAT,1864,39,35-39,1903,7.214879536670465
STAT,1910,23,40-44,1933,3.6364848445853486
SIM,1923,48,na,1971,5241
STAT,1853,25,50-100,1878,0.7485186352002975
STAT,1855,93,na,1948,24.867757214151
STAT,1841,26,35-39,1867,10.732300484891546
SIM,1852,57,na,1909,1561
SIM,1932,29,40-44,1961,1
STAT,1858,30,25-29,1888,9.414777935617524
SIM,1825,33,40-44,1858,8
SIM,1827,35,40-44,1862,5
SIM,1861,25,50-100,1886,2
STAT,1836,31,35-39,1867,11.775399961553921
STAT,1859,20,15-19,1879,3.508042418106735
SIM,1950,37,45-49,1987,2
STAT,1964,35,30-34,1999,2.733998368532622
STAT,1928,73,na,2001,3874.9777604464025
STAT,1838,60,na,1898,1652.0181675629374
STAT,1942,37,45-49,1979,0.8471801851998193
STAT,1964,29,45-49,1993,2.519473688326843
SIM,1848,15,30-34,1863,2
SIM,1888,55,na,1943,2344
STAT,1869,48,na,1917,2482.8467118875546
STAT,1843,28,35-39,1871,11.829328685369967
SIM,1844,31,35-39,1875,3
SIM,1849,53,na,1902,2391
SIM,1851,28,35-39,1879,3
STAT,1984,19,40-44,2003,2.2910468364090346
STAT,1842,44,30-34,1886,0.8921611687955607
STAT,1951,20,25-29,1971,127.44494864823993
SIM,1861,71,na,1932,966
SIM,1947,36,25-29,1983,3
SIM,1928,38,40-44,1966,4
STAT,1831,28,30-34,1859,26.062705910556705
STAT,1962,30,40-44,1992,5.905042627001053
STAT,1911,32,35-39,1943,10.278184756434626
SIM,1916,22,35-39,1938,29
SIM,1924,39,50-100,1963,3
STAT,1873,24,15-19,1897,3.86352762099108
SIM,1898,64,na,1962,3167
STAT,1860,18,na,1878,2447.8484558554997
STAT,1801,82,na,1883,193.9135101128006
SIM,1840,43,50-100,1883,3
STAT,1871,37,15-19,1908,0.06447253287073153
STAT,1849,22,30-34,1871,16.691547807029025
SIM,1965,25,35-39,1990,5
STAT,1833,49,45-49,1882,0.1737308848968229
STAT,1857,41,20-24,1898,0.14338872633068261
STAT,1956,23,na,1979,5593.150569829905
SIM,1961,32,40-44,1993,9
STAT,1958,5,na,1963,5959.5765355850035
STAT,1923,48,40-44,1971,0.2121800061916693
STAT,1927,42,40-44,1969,0.361936821907147
STAT,1951,28,20-24,1979,25.18156751771859
SIM,1869,51,na,1920,1740
STAT,1838,36,15-19,1874,0.05931743156497222
SIM,1817,38,na,1855,1615
STAT,1964,41,15-19,2005,0.002323069361772127
SIM,1895,30,50-100,1925,3
SIM,1922,47,na,1969,4978
STAT,1966,23,35-39,1989,13.61269707346049
SIM,1940,17,30-34,1957,18
STAT,1861,22,50-100,1883,0.4019330639348406
SIM,1926,20,50-100,1946,1
STAT,1887,40,na,1927,3019.341473614139
SIM,1876,20,15-19,1896,8
STAT,1920,30,35-39,1950,11.639478750114796
STAT,1932,17,30-34,1949,18.63062615137539
SIM,1906,41,50-100,1947,1
STAT,1953,32,40-44,1985,5.5687923371200245
SIM,1854,23,45-49,1877,4
STAT,1856,88,na,1944,120.87123805463041
SIM,1973,28,35-39,2001,52
STAT,1846,23,45-49,1869,0.883078201391967
STAT,1906,27,30-34,1933,42.37788875767128
SIM,1935,42,40-44,1977,1
STAT,1875,53,35-39,1928,0.010102274842114472
SIM,1839,33,20-24,1872,6
STAT,1868,20,15-19,1888,3.7109489564773006
SIM,1833,30,20-24,1863,5
STAT,1914,83,na,1997,1693.267063998127
STAT,1991,18,35-39,2009,6.937711241559022
SIM,1901,85,na,1986,1529
SIM,1954,28,40-44,1982,12
SIM,1889,27,25-29,1916,74
STAT,1857,23,20-24,1880,70.99193532666845
STAT,1900,113,na,2013,0.0026758380672138524
STAT,1844,49,20-24,1893,0.009827505432446917
STAT,1846,41,45-49,1887,1.5861216833466651
STAT,1996,4,na,2000,6595.702488255339
STAT,1936,40,40-44,1976,0.28681553091590284
SIM,1982,12,na,1994,6825
STAT,1837,25,45-49,1862,1.0469152225367806
STAT,1847,36,na,1883,1900.510445899705
STAT,1930,43,25-29,1973,0.10827303441238333
SIM,1899,18,na,1917,4387
STAT,1966,47,na,2013,5508.117483631961
STAT,1843,22,na,1865,2692.8617457622327
SIM,1864,20,na,1884,2929
STAT,1921,65,na,1986,4164.769356024843
STAT,1964,28,30-34,1992,57.171331037937215
STAT,1880,35,15-19,1915,0.06934293834094522
STAT,1957,25,35-39,1982,22.962841773160857
SIM,1907,24,35-39,1931,22
STAT,1939,36,25-29,1975,1.1733450717134504
STAT,1899,16,35-39,1915,0.86967851546077
STAT,1927,10,na,1937,5701.493141409563
STAT,1946,28,40-44,1974,5.988979145940313
STAT,1922,80,na,2002,2476.4050300336685
SIM,1854,41,45-49,1895,5
STAT,1943,43,35-39,1986,0.255717702143086
SIM,1857,22,30-34,1879,45
SIM,1961,34,na,1995,5599
STAT,1822,44,na,1866,2210.7739849684194
SIM,1893,17,na,1910,3669
STAT,1766,115,na,1881,4.633400974091092E-4
SIM,1928,48,na,1976,5615
STAT,1914,42,30-34,1956,0.146264999224611
STAT,1866,0,na,1866,4059.856211620331
SIM,1858,20,na,1878,3029
SIM,1880,54,na,1934,2900
SIM,1789,77,na,1866,608
SIM,1884,68,na,1952,1681
STAT,1946,46,40-44,1992,0.21043066169632973
STAT,1942,27,na,1969,4538.241750589744
STAT,1798,61,na,1859,846.4136334647394
STAT,1932,24,20-24,1956,167.83407203537388
SIM,1925,1,na,1926,5842
STAT,1923,3,na,1926,5494.456286761505
SIM,1816,38,50-100,1854,3
SIM,1877,33,40-44,1910,8
STAT,1860,52,35-39,1912,0.007964733153168027
STAT,1945,15,15-19,1960,57.24320396391002
SIM,1787,98,na,1885,2
SIM,1821,75,na,1896,311
STAT,1866,48,45-49,1914,0.24926828121992606
SIM,1929,83,na,2012,1796
STAT,1898,5,na,1903,4087.3583378363514
SIM,1900,9,na,1909,3952
STAT,1863,15,45-49,1878,0.0761121464312003
SIM,1842,80,na,1922,760
SIM,1951,40,30-34,1991,2
SIM,1880,31,50-100,1911,1
STAT,1842,51,30-34,1893,0.004602553657524013
SIM,1829,39,na,1868,1735
STAT,1980,18,15-19,1998,72.68462077079246
STAT,1895,41,40-44,1936,0.23569552990118106
STAT,1841,27,na,1868,2388.88407653383
SIM,1873,72,na,1945,1636
STAT,1869,33,40-44,1902,4.826297113719938
SIM,1874,48,45-49,1922,1
SIM,1953,15,15-19,1968,115
STAT,1914,38,45-49,1952,0.7819856548491665
STAT,1816,44,na,1860,1512.3567071713994
SIM,1877,86,na,1963,630
STAT,1872,19,na,1891,2910.9827826640776
STAT,1912,100,na,2012,38.577919926125844
STAT,1874,18,25-29,1892,6.677399922634371
STAT,1821,39,25-29,1860,5.88736592808375
STAT,1788,95,na,1883,3.9409657321708433
STAT,1778,102,na,1880,0.11328443298144741
STAT,1980,35,20-24,2015,0.4358522647066752
SIM,1935,22,50-100,1957,1
STAT,1848,25,20-24,1873,15.09685738773008
SIM,1952,9,na,1961,4844
STAT,1908,83,na,1991,1545.2930224958284
STAT,1945,46,50-100,1991,0.29732130858315736
SIM,1873,25,na,1898,3467
SIM,1896,69,na,1965,2740
SIM,1820,89,na,1909,92
STAT,1840,20,45-49,1860,0.7217072409602333
STAT,1940,28,45-49,1968,2.0327520018192855
STAT,1964,35,20-24,1999,0.39543462655322614
STAT,1937,48,40-44,1985,0.18327950426395093
SIM,1823,38,na,1861,2357
STAT,1891,47,40-44,1938,0.13709889877998582
SIM,1878,42,45-49,1920,3
STAT,1919,25,15-19,1944,0.886042225263366
SIM,1949,24,40-44,1973,14
STAT,1846,54,50-100,1900,0.015183606186260986
STAT,1875,15,35-39,1890,0.6574283919122031
SIM,1922,38,45-49,1960,1
SIM,1939,32,30-34,1971,34
STAT,1947,44,35-39,1991,0.2711333503153149
STAT,1940,35,35-39,1975,2.9258853589403926
SIM,1920,68,na,1988,3280
SIM,1856,25,20-24,1881,13
STAT,1903,49,25-29,1952,0.05229316397957334
SIM,1867,72,na,1939,960
SIM,1919,9,na,1928,5664
SIM,1884,4,na,1888,3056
STAT,1933,66,na,1999,4996.492886305157
SIM,1883,15,35-39,1898,2
STAT,1923,40,30-34,1963,0.17285885392664438
SIM,1885,35,50-100,1920,3
STAT,1859,32,40-44,1891,3.9867639129512322
SIM,1905,51,na,1956,3749
SIM,1909,13,na,1922,5073
STAT,1972,18,40-44,1990,2.0660897107407705
SIM,1872,26,15-19,1898,1
SIM,1974,20,30-34,1994,60
STAT,1975,3,na,1978,5988.982990101011
SIM,1980,18,40-44,1998,5
STAT,1976,38,50-100,2014,0.6662389617178935
SIM,1867,32,40-44,1899,13
STAT,1859,92,na,1951,38.2885023907987
SIM,1905,33,15-19,1938,2
STAT,1794,95,na,1889,3.510592401224649
STAT,1938,38,30-34,1976,2.136460512695028
STAT,1908,22,35-39,1930,10.002545060501806
STAT,1930,22,45-49,1952,1.6636846252270627
STAT,1983,15,35-39,1998,6.854036807720889
STAT,1895,23,40-44,1918,3.120608345784235
STAT,1866,19,na,1885,2740.3473279355007
STAT,1864,26,15-19,1890,0.4691183454288783
SIM,1901,27,20-24,1928,33
STAT,1900,38,45-49,1938,0.6856082890564242
SIM,1909,65,na,1974,4151
SIM,1845,40,40-44,1885,9
STAT,1864,108,na,1972,0.036574807280290784
SIM,1946,38,30-34,1984,4
STAT,1875,50,30-34,1925,0.007200998623540008
STAT,1971,38,na,2009,5659.685215862614
STAT,1853,23,35-39,1876,6.815370662831874
SIM,1923,33,35-39,1956,25
SIM,1936,39,na,1975,3955
STAT,1837,52,50-100,1889,0.010976040998917864
STAT,1929,26,15-19,1955,1.0201297019492397
SIM,1958,25,45-49,1983,8
SIM,1947,33,20-24,1980,1
STAT,1904,32,45-49,1936,1.6593781567147792
STAT,1845,47,15-19,1892,2.6828511870649456E-4
SIM,1888,29,30-34,1917,31
STAT,1985,16,50-100,2001,0.6151281508450006
STAT,1931,27,40-44,1958,6.946128167144178
STAT,1955,34,15-19,1989,0.2004161479424101
SIM,1818,55,na,1873,1897
SIM,1912,32,45-49,1944,6
STAT,1849,25,35-39,1874,8.99384020686816
STAT,1883,31,20-24,1914,3.0644751898034115
STAT,1979,32,45-49,2011,2.5486989133659304
STAT,1797,102,na,1899,0.08729331531896833
SIM,1858,48,50-100,1906,1
STAT,1885,23,50-100,1908,0.4679608351943743
SIM,1861,23,35-39,1884,13
STAT,1905,19,40-44,1924,0.30386868937337724
SIM,1853,80,na,1933,487
STAT,1952,55,na,2007,5118.886665645493
SIM,1959,18,15-19,1977,62
STAT,1907,31,30-34,1938,17.092391076742
SIM,1903,34,45-49,1937,5
STAT,1868,14,na,1882,2934.50805773594
STAT,1881,19,30-34,1900,1.7646678864879333
STAT,1915,33,35-39,1948,10.697391468991185
STAT,1947,43,20-24,1990,0.02382077942842534
STAT,1833,56,na,1889,1442.4101434327515
STAT,1930,71,na,2001,4259.850380285199
STAT,1887,16,45-49,1903,0.0846905908836388
SIM,1881,7,na,1888,2203
STAT,1833,46,40-44,1879,0.14392283576341078
STAT,1930,40,20-24,1970,0.02689402226753877
SIM,1915,31,30-34,1946,23
STAT,1830,36,50-100,1866,1.2610488620009548
STAT,1962,33,45-49,1995,2.3703035523455056
STAT,1824,79,na,1903,432.5722129053593
STAT,1892,38,45-49,1930,2.869145723494955
SIM,1817,42,na,1859,1541
STAT,1842,44,40-44,1886,1.745474481128596
STAT,1980,29,15-19,2009,1.1347601802130227
SIM,1894,34,na,1928,3806
SIM,1841,46,40-44,1887,1
STAT,1955,16,15-19,1971,69.54728113248798
STAT,1910,53,na,1963,3875.540156973146
SIM,1850,44,40-44,1894,5
SIM,1963,16,15-19,1979,80
SIM,1892,9,na,1901,4126
STAT,1877,48,20-24,1925,0.014224336037390694
STAT,1941,49,45-49,1990,0.2672125390499717
SIM,1856,28,25-29,1884,75
STAT,1854,18,na,1872,2223.8973422722543
SIM,1834,38,na,1872,1916
STAT,1874,15,20-24,1889,21.12117021646817
STAT,1933,21,30-34,1954,44.149075475491436
STAT,1827,33,35-39,1860,16.709004518678697
SIM,1871,77,na,1948,242
SIM,1891,31,20-24,1922,5
SIM,1907,21,30-34,1928,81
STAT,1848,18,30-34,1866,2.087016420801326
STAT,1815,90,na,1905,43.74718297125635
SIM,1830,24,na,1854,2096
STAT,1939,33,20-24,1972,2.87150397255724
STAT,1827,91,na,1918,47.06060361995833
STAT,1918,45,na,1963,4531.998685164075
SIM,1884,25,50-100,1909,1
STAT,1816,54,40-44,1870,0.01980600014039435
SIM,1965,22,30-34,1987,114
SIM,1968,17,na,1985,4683
STAT,1883,103,na,1986,4.296578037325014
STAT,1967,36,50-100,2003,0.6241238929250424
STAT,1965,32,30-34,1997,23.13802172426916
STAT,1936,43,45-49,1979,0.19001451921887133
SIM,1835,33,35-39,1868,1
SIM,1948,30,30-34,1978,49
STAT,1925,15,50-100,1940,0.5245594466703253
SIM,1849,15,35-39,1864,1
STAT,1841,47,30-34,1888,0.08645408871638934
STAT,1941,23,35-39,1964,11.228666420627505
SIM,1875,20,na,1895,3192
SIM,1970,11,na,1981,6043
STAT,1870,39,20-24,1909,0.8681866740236405
SIM,1857,25,35-39,1882,13
STAT,1897,66,na,1963,2755.6645041655497
STAT,1943,40,30-34,1983,0.1630609967029618
STAT,1928,33,45-49,1961,2.2692352027512537
STAT,1991,15,30-34,2006,20.16953896009489
SIM,1878,27,50-100,1905,1
STAT,1957,22,30-34,1979,43.87623968589399
SIM,1868,32,35-39,1900,1
STAT,1888,27,15-19,1915,0.6154813405869961
STAT,1893,52,na,1945,3124.2308089135063
SIM,1837,39,30-34,1876,8
STAT,1821,36,20-24,1857,1.8009772012428857
SIM,1976,33,50-100,2009,2
STAT,1875,23,na,1898,2811.8306427859816
SIM,1969,30,na,1999,5643
STAT,1896,37,15-19,1933,0.08559561799807262
STAT,1942,72,na,2014,3413.442800708364
SIM,1921,29,40-44,1950,13
STAT,1921,24,45-49,1945,1.456917873795552
SIM,1977,21,na,1998,6208
STAT,1875,28,50-100,1903,0.7602088237739331
SIM,1860,4,na,1864,3138
STAT,1904,53,na,1957,3554.4590741723887
STAT,1922,17,15-19,1939,60.58727001337777
SIM,1907,86,na,1993,1193
STAT,1914,25,15-19,1939,0.8272699650380918
SIM,1851,41,na,1892,2637
STAT,1886,22,35-39,1908,7.103594941637314
SIM,1913,37,40-44,1950,1
SIM,1944,17,15-19,1961,1
STAT,1911,38,20-24,1949,0.29262655279394556
STAT,1892,45,35-39,1937,0.11536611696034427
SIM,1842,64,na,1906,1557
STAT,1976,15,45-49,1991,0.7706014353757117
STAT,1906,34,20-24,1940,2.5896153419646644
STAT,1870,24,50-100,1894,0.46104858519509084
SIM,1832,24,20-24,1856,80
STAT,1878,31,40-44,1909,5.246905561410162
SIM,1894,22,35-39,1916,25
SIM,1835,35,50-100,1870,5
STAT,1829,39,30-34,1868,5.865145394555866
STAT,1955,8,na,1963,6020.98194219439
SIM,1852,67,na,1919,1360
STAT,1848,28,25-29,1876,53.27228406831438
STAT,1876,49,na,1925,2627.9723356999543
STAT,1913,29,40-44,1942,5.324246115090897
SIM,1978,32,na,2010,5976
STAT,1929,44,15-19,1973,0.0022875959269397896
STAT,1850,108,na,1958,0.0036290250428749615
SIM,1936,36,25-29,1972,1
STAT,1969,16,15-19,1985,65.4441850794244
SIM,1984,15,45-49,1999,4
SIM,1877,36,45-49,1913,6
STAT,1903,46,20-24,1949,0.011158318092153048
STAT,1913,47,40-44,1960,0.17768522924854088
SIM,1916,47,na,1963,4333
SIM,1912,33,na,1945,3792
STAT,1869,36,45-49,1905,2.2386604932772562
STAT,1909,43,35-39,1952,0.21629720224534027
STAT,1785,82,na,1867,110.05239898896846
STAT,1925,38,20-24,1963,0.36464223947629937
SIM,1914,27,30-34,1941,51
STAT,1945,22,50-100,1967,0.8322490832297058
SIM,1778,77,na,1855,242
SIM,1904,36,50-100,1940,1
STAT,1981,33,15-19,2014,0.2112458761216123
STAT,1905,37,40-44,1942,1.5781965700577492
STAT,1949,21,50-100,1970,0.8863532189599038
STAT,1936,72,na,2008,3113.809702123622
STAT,1898,88,na,1986,736.7136170456408
STAT,1840,25,15-19,1865,0.46039358887640996
STAT,1886,23,na,1909,2870.1039236372712
SIM,1939,35,35-39,1974,12
STAT,1954,23,45-49,1977,1.610018743799659
STAT,1868,15,45-49,1883,0.07461521761866316
STAT,1973,19,na,1992,5490.017940677063
STAT,1837,49,30-34,1886,0.0709225187978863
STAT,1981,26,25-29,2007,106.72221555547213
SIM,1921,47,40-44,1968,1
STAT,1834,73,na,1907,1083.9437790453514
STAT,1866,26,50-100,1892,0.6866027373838449
SIM,1901,17,na,1918,4363
STAT,1876,40,na,1916,2785.081911436322
STAT,1936,17,15-19,1953,50.172908865419345
SIM,1977,16,15-19,1993,78
STAT,1940,37,50-100,1977,0.5070072821857514
STAT,1847,34,15-19,1881,0.11467102112183346
STAT,1885,22,40-44,1907,2.398691651070391
STAT,1923,43,35-39,1966,0.2710830291423453
SIM,1845,49,30-34,1894,1
STAT,1922,35,15-19,1957,0.02524968659136808
SIM,1937,26,15-19,1963,2
STAT,1903,28,20-24,1931,19.21601290158133
STAT,1934,5,na,1939,6279.390225472937
STAT,1973,35,30-34,2008,2.8074040330056844
STAT,1895,26,45-49,1921,1.6736121935435728
STAT,1928,36,25-29,1964,1.4373056343216508
SIM,1911,28,20-24,1939,42
STAT,1939,11,na,1950,4575.874411012448
STAT,1954,44,25-29,1998,0.10552212378338936
SIM,1882,33,na,1915,3392
STAT,1897,70,na,1967,2521.4921916001017
SIM,1948,66,na,2014,3778
STAT,1899,34,50-100,1933,1.4362460017971288
SIM,1889,12,na,1901,4126
SIM,1914,34,20-24,1948,3
SIM,1886,31,40-44,1917,15
SIM,1894,98,na,1992,58
SIM,1847,24,15-19,1871,7
SIM,1871,30,40-44,1901,10
STAT,1946,55,na,2001,4737.7034565518115
SIM,1888,34,na,1922,2832
STAT,1895,44,45-49,1939,0.1540150979274652
SIM,1930,17,15-19,1947,110
STAT,1840,73,na,1913,952.8169924623305
SIM,1962,39,50-100,2001,1
STAT,1967,40,25-29,2007,0.10727717889269173
SIM,1798,98,na,1896,1
SIM,1931,6,na,1937,6416
STAT,1901,19,20-24,1920,28.50417873836454
SIM,1807,49,45-49,1856,1
STAT,1833,40,20-24,1873,0.13994217266822456
STAT,1894,20,40-44,1914,3.1098572292036684
STAT,1909,25,35-39,1934,16.831341566583465
STAT,1813,42,45-49,1855,5.623099342143982
STAT,1865,48,30-34,1913,0.09952711286828506
STAT,1942,22,35-39,1964,11.39527343506463
STAT,1934,46,15-19,1980,5.940549245272784E-4
SIM,1930,33,25-29,1963,24
SIM,1904,25,25-29,1929,10
STAT,1886,54,na,1940,2549.067056949915
STAT,1882,40,na,1922,2631.552184043817
STAT,1865,33,20-24,1898,2.8026988159532897
STAT,1795,81,na,1876,181.9404540774178
STAT,1928,30,40-44,1958,5.653255081897753
SIM,1937,56,na,1993,4037
STAT,1931,29,30-34,1960,58.334118110076545
STAT,1878,52,45-49,1930,0.017393722692690513
SIM,1864,35,20-24,1899,1
STAT,1869,26,15-19,1895,0.5088018313196738
STAT,1935,33,35-39,1968,14.589310844995223
STAT,1947,49,40-44,1996,0.21193452067613758
STAT,1922,33,25-29,1955,11.99567442013468
STAT,1910,22,na,1932,4140.073244661335
STAT,1892,35,40-44,1927,6.3919039730146325
SIM,1839,85,na,1924,453
STAT,1856,35,20-24,1891,0.6851389797956959
SIM,1852,63,na,1915,1360
SIM,1917,25,35-39,1942,45
STAT,1916,41,50-100,1957,0.13915077589827923
STAT,1950,44,40-44,1994,0.3535169417611386
STAT,1949,34,40-44,1983,5.346944797090251
STAT,1895,38,15-19,1933,0.08393653158589773
STAT,1959,33,50-100,1992,1.2714375623056449
STAT,1826,101,na,1927,0.31418851824035426
STAT,1969,43,50-100,2012,0.17572904468969872
STAT,1981,23,20-24,2004,179.9700380862783
SIM,1853,35,45-49,1888,4
STAT,1852,48,20-24,1900,0.011171603810562938
SIM,1943,15,35-39,1958,18
SIM,1964,49,na,2013,5666
SIM,1869,20,na,1889,1789
SIM,1936,30,40-44,1966,2
STAT,1861,48,50-100,1909,0.23266970937280046
SIM,1950,22,35-39,1972,1
SIM,1962,26,25-29,1988,106
SIM,1950,34,na,1984,4635
STAT,1855,62,na,1917,1555.208279267498
STAT,1915,35,25-29,1950,1.1589868385776718
STAT,1954,26,25-29,1980,94.35185049056156
STAT,1958,42,25-29,2000,0.11248437653519015
STAT,1918,20,50-100,1938,0.8236982509723242
STAT,1845,35,45-49,1880,1.583552559094003
SIM,1833,39,45-49,1872,7
STAT,1960,36,15-19,1996,0.029764252544186267
STAT,1807,50,20-24,1857,0.003018286211565059
SIM,1870,92,na,1962,257
SIM,1922,19,30-34,1941,44
SIM,1809,78,na,1887,448
STAT,1940,27,30-34,1967,46.125367382893685
SIM,1796,63,na,1859,824
STAT,1871,25,45-49,1896,1.2834167340436955
SIM,1962,20,40-44,1982,8
STAT,1884,75,na,1959,1322.8723550765894
STAT,1924,36,40-44,1960,2.0384385417756583
STAT,1888,89,na,1977,494.2711646712536
STAT,1984,29,na,2013,6160.612259855664
STAT,1854,22,na,1876,2046.702122795096
SIM,1899,25,40-44,1924,6
STAT,1844,23,50-100,1867,0.42280927981948824
STAT,1943,16,45-49,1959,0.6115602117536519
STAT,1870,53,35-39,1923,0.009637469896410084
STAT,1967,43,40-44,2010,0.37412631814749087
STAT,1869,54,45-49,1923,0.015773177385809703
STAT,1980,16,25-29,1996,69.4460736236706
STAT,1914,19,30-34,1933,2.8955293531188455
STAT,1820,96,na,1916,5.039506632415998
STAT,1844,47,50-100,1891,0.20446769167642845
STAT,1941,46,40-44,1987,0.19546997000054642
SIM,1892,39,na,1931,3694
STAT,1820,48,20-24,1868,0.01208532187334085
STAT,1902,35,15-19,1937,0.019951676867319267
STAT,1825,39,45-49,1864,3.114201966285578
STAT,1909,18,45-49,1927,0.1128825175755848
SIM,1913,18,na,1931,5003
SIM,1943,33,35-39,1976,30
SIM,1932,36,40-44,1968,7
STAT,1891,38,30-34,1929,7.563969379334568
STAT,1799,95,na,1894,5.972153209357555
STAT,1924,45,na,1969,5069.825604335628
STAT,1858,102,na,1960,0.6216136500509082
STAT,1877,24,35-39,1901,6.961318828257466
STAT,1839,52,50-100,1891,0.011913471240683997
STAT,1947,46,25-29,1993,0.07190380571655024
STAT,1845,88,na,1933,92.5092210383947
STAT,1791,82,na,1873,182.43514065494276
SIM,1900,39,20-24,1939,1
SIM,1824,55,na,1879,1184
STAT,1922,15,25-29,1937,58.12180034124781
SIM,1808,93,na,1901,17
STAT,1978,19,20-24,1997,213.38412446792947
STAT,1861,21,40-44,1882,2.0687312979992662
SIM,1851,42,35-39,1893,3
STAT,1941,25,25-29,1966,78.6659194607664
STAT,1856,28,30-34,1884,22.809673693697096
STAT,1950,26,40-44,1976,6.390565475676839
STAT,1897,40,50-100,1937,0.11434997720550615
STAT,1889,37,25-29,1926,4.095857424845363
STAT,1941,20,30-34,1961,34.309487876443676
STAT,1966,49,35-39,2015,0.19217145002885658
SIM,1947,42,30-34,1989,1
SIM,1859,34,35-39,1893,13
STAT,1971,23,50-100,1994,0.9646291091129131
STAT,1832,49,30-34,1881,0.07047284220539905
SIM,1928,18,20-24,1946,1
STAT,1948,40,30-34,1988,0.175953731931967
SIM,1947,53,na,2000,5735
SIM,1937,52,na,1989,4160
STAT,1836,39,20-24,1875,0.843689412608654
SIM,1803,93,na,1896,11
STAT,1790,102,na,1892,0.06488809836228707
STAT,1896,53,na,1949,3229.435357459616
STAT,1902,0,na,1902,4788.072552504876
STAT,1814,96,na,1910,5.353939781041848
STAT,1843,42,35-39,1885,1.8707411024710023
SIM,1885,21,30-34,1906,49
STAT,1877,35,50-100,1912,1.487834781910268
SIM,1864,28,30-34,1892,66
SIM,1923,29,50-100,1952,2
STAT,1916,10,na,1926,4850.689497923004
STAT,1975,24,40-44,1999,5.132509918203352
STAT,1800,60,na,1860,1322.1719352713083
STAT,1869,48,15-19,1917,4.4142583783488075E-4
STAT,1884,102,na,1986,7.492146008740315
SIM,1876,30,40-44,1906,9
SIM,1891,54,na,1945,2908
STAT,1851,29,45-49,1880,1.0161511449686882
STAT,1887,3,na,1890,3419.0825047684634
STAT,1946,18,15-19,1964,58.07140285715035
SIM,1830,40,45-49,1870,1
SIM,1880,31,45-49,1911,3
SIM,1848,15,20-24,1863,16
STAT,1908,28,na,1936,4077.671482089197
STAT,1954,20,40-44,1974,4.816136226451681
STAT,1872,31,50-100,1903,1.0660863399671567
STAT,1953,49,25-29,2002,0.07657619091616352
STAT,1962,47,25-29,2009,0.08158643367644476
STAT,1905,39,30-34,1944,1.9021043592545035
STAT,1917,26,45-49,1943,2.0981043708779494
SIM,1809,71,na,1880,950
SIM,1827,42,40-44,1869,8
STAT,1872,31,45-49,1903,2.0290030466560176
SIM,1819,77,na,1896,84
STAT,1878,34,45-49,1912,2.0832383679302233
STAT,1819,42,40-44,1861,4.729249090396562
SIM,1897,37,25-29,1934,11
STAT,1935,15,35-39,1950,6.654414089151817
SIM,1904,18,35-39,1922,2
SIM,1954,18,15-19,1972,55
STAT,1894,90,na,1984,491.5204397143919
STAT,1836,36,na,1872,2417.4321790265476
SIM,1923,38,40-44,1961,6
STAT,1820,52,40-44,1872,0.01033811974787706
STAT,1916,32,35-39,1948,10.889198248287732
SIM,1854,54,50-100,1908,1
STAT,1833,25,25-29,1858,40.710741528065974
STAT,1912,16,15-19,1928,10.626891325217173
STAT,1873,91,na,1964,170.21356244076563
STAT,1929,86,na,2015,1610.3779713311392
STAT,1893,8,na,1901,3792.0062890720587
SIM,1886,34,45-49,1920,2
STAT,1835,21,50-100,1856,0.38109176365902575
STAT,1915,30,30-34,1945,18.670030356906008
STAT,1815,42,50-100,1857,2.3609078052921415
SIM,1849,17,25-29,1866,17
STAT,1806,82,na,1888,174.32479320976728
SIM,1919,27,na,1946,5042
SIM,1905,15,15-19,1920,11
STAT,1871,34,50-100,1905,1.042959165814086
STAT,1822,40,45-49,1862,3.228893806644192
STAT,1869,54,na,1923,2340.2237457627452
SIM,1915,13,na,1928,5022
STAT,1915,38,40-44,1953,1.7368766820776929
STAT,1867,24,40-44,1891,2.231224067211472
SIM,1918,42,na,1960,3793
SIM,1838,38,30-34,1876,11
STAT,1898,16,20-24,1914,27.718752596791614
SIM,1990,17,30-34,2007,56
SIM,1853,32,40-44,1885,8
STAT,1865,61,na,1926,1945.7281342166136
STAT,1817,52,35-39,1869,0.023651262365327712
STAT,1939,42,30-34,1981,0.15354147940725393
STAT,1972,26,15-19,1998,1.048101037257704
SIM,1924,32,35-39,1956,3
STAT,2002,11,na,2013,6834.359032686306
STAT,1825,102,na,1927,0.20737095554917556
STAT,1936,31,na,1967,4244.4420658322115
STAT,1989,26,30-34,2015,65.07758459289496
SIM,1952,0,na,1952,5142
STAT,1943,49,na,1992,4649.480279517442
SIM,1923,30,30-34,1953,3
STAT,1961,29,20-24,1990,27.307191590454742
STAT,1961,23,35-39,1984,14.0808795756057
SIM,1863,1,na,1864,3496
STAT,1901,37,20-24,1938,0.26895195007977424
SIM,1841,25,25-29,1866,46
STAT,1845,50,40-44,1895,0.00719605359690549
STAT,1946,49,45-49,1995,0.28766419417614214
SIM,1932,39,45-49,1971,5
STAT,1966,39,40-44,2005,2.218329773596125
STAT,1835,58,na,1893,1232.5453823729276
STAT,1837,22,na,1859,2026.8029729061
STAT,1868,30,40-44,1898,4.847061544214091
STAT,1914,45,35-39,1959,0.1483302094211353
STAT,1930,23,50-100,1953,0.9699087151639643
SIM,1961,35,45-49,1996,5
SIM,1988,20,45-49,2008,3
SIM,1894,18,15-19,1912,14
SIM,1890,25,20-24,1915,36
SIM,1862,25,na,1887,2904
STAT,1908,16,50-100,1924,0.08418279623374522
STAT,1983,19,35-39,2002,6.845815644126537
STAT,1848,53,25-29,1901,0.0037030600130234866
STAT,1870,3,na,1873,3566.002693032739
SIM,1875,24,40-44,1899,1
STAT,1833,43,25-29,1876,0.5443933187401218
SIM,1899,49,na,1948,3717
STAT,1796,66,na,1862,900.6689876621001
SIM,1832,59,na,1891,1572
SIM,1864,9,na,1873,3142
SIM,1928,28,15-19,1956,1
SIM,1991,19,35-39,2010,5
STAT,1938,45,20-24,1983,0.013153765963881653
STAT,1845,32,40-44,1877,3.4746484911205915
SIM,1843,31,40-44,1874,9
STAT,1924,39,45-49,1963,0.9254726797589186
SIM,1884,72,na,1956,1281
STAT,1862,29,20-24,1891,11.34397944958415
SIM,1890,68,na,1958,2122
STAT,1846,20,40-44,1866,2.696574276126505
STAT,1942,31,na,1973,4652.87271818755
SIM,1887,17,na,1904,3918
SIM,1977,31,45-49,2008,6
STAT,1882,25,20-24,1907,13.313582937132663
STAT,1953,35,45-49,1988,0.982201661363902
STAT,1946,36,15-19,1982,0.02534653635152521
STAT,1886,18,15-19,1904,7.205267425791745
SIM,1881,39,na,1920,1915
SIM,1900,46,45-49,1946,2
STAT,1967,46,45-49,2013,0.32669847803838103
STAT,1885,45,50-100,1930,0.28553095563117264
STAT,1846,35,15-19,1881,0.06189428861352243
SIM,1892,32,na,1924,3709
STAT,1970,30,35-39,2000,13.471898925770619
STAT,1894,23,45-49,1917,1.03130727359644
STAT,1909,49,20-24,1958,0.011663463375780513
STAT,1969,31,45-49,2000,2.3136880891476115
SIM,1870,29,20-24,1899,32
STAT,1839,88,na,1927,108.87272131607327
SIM,1961,39,30-34,2000,6
STAT,1813,46,50-100,1859,0.827808139931948
SIM,1935,46,50-100,1981,1
STAT,1871,22,40-44,1893,2.392475866060884
SIM,1849,43,na,1892,2590
STAT,1835,31,40-44,1866,3.4842735647742624
STAT,1915,32,20-24,1947,2.867387138729836
STAT,1883,90,na,1973,314.4950004344322
SIM,1796,59,na,1855,859
SIM,1849,47,na,1896,2511
STAT,1870,50,30-34,1920,0.006869681189937965
SIM,1879,13,na,1892,3061
STAT,1927,46,50-100,1973,0.3283910034555774
SIM,1814,93,na,1907,1
SIM,1905,47,na,1952,3830
STAT,1846,51,na,1897,2236.556329961743
SIM,1820,36,50-100,1856,1
STAT,1968,28,15-19,1996,1.0214777616331387
SIM,1931,23,15-19,1954,16
STAT,1923,23,15-19,1946,7.123164727897168
STAT,1935,39,20-24,1974,0.4247172159905237
SIM,1927,28,30-34,1955,119
SIM,1919,0,na,1919,5835
SIM,1899,43,40-44,1942,2
SIM,1910,69,na,1979,2383
STAT,1887,49,na,1936,2849.5467634073348
STAT,1890,48,40-44,1938,0.13446573248659563
SIM,1940,32,50-100,1972,1
STAT,1807,53,25-29,1860,0.01363181368635752
STAT,1926,16,na,1942,5219.689592472267
STAT,1839,46,25-29,1885,0.04714178815338488
SIM,1923,32,20-24,1955,7
STAT,1919,28,30-34,1947,48.67476226764733
STAT,1966,46,30-34,2012,0.13398853669862948
SIM,1945,24,20-24,1969,233
STAT,1778,96,na,1874,2.053883839929538
STAT,1859,18,50-100,1877,0.051972290434867646
STAT,1853,47,20-24,1900,0.011891728809595771
STAT,1779,101,na,1880,0.11853884645028442
STAT,1947,3,na,1950,5195.64258012891
STAT,1909,68,na,1977,3208.243839566753
STAT,1869,51,40-44,1920,0.011822083396797472
STAT,1830,44,15-19,1874,0.012878558118639956
STAT,1905,79,na,1984,1996.1962365565932
SIM,1953,49,na,2002,5530
STAT,1774,82,na,1856,6.5496649
STAT,1904,46,50-100,1950,0.23024109319190744
SIM,1874,45,40-44,1919,1
SIM,1827,45,45-49,1872,1
STAT,1849,16,25-29,1865,5.438359443620826
STAT,1882,18,30-34,1900,1.791926366917027
STAT,1974,2,na,1976,5930.099586427709
STAT,1892,42,30-34,1934,1.6608722831199927
STAT,1870,17,na,1887,2900.8156185332514
STAT,1890,31,50-100,1921,1.29729635894657
STAT,1967,33,na,2000,5553.994616791515
STAT,1849,108,na,1957,0.002178737219785405
STAT,1941,22,20-24,1963,132.64561508006136
SIM,1900,25,40-44,1925,9
STAT,1917,23,40-44,1940,4.1114201386793505
STAT,1866,87,na,1953,188.4538664164924
STAT,1952,41,35-39,1993,0.28982756496223055
STAT,1879,29,50-100,1908,0.7653320579134202
STAT,1921,21,40-44,1942,4.3943672398457085
STAT,1937,24,20-24,1961,124.94497389186033
STAT,1804,54,15-19,1858,1.0875788793959767E-4
STAT,1889,34,20-24,1923,3.8123664787999796
SIM,1897,34,20-24,1931,5
SIM,1911,47,na,1958,4600
STAT,1949,37,na,1986,5202.246388804676
SIM,1859,31,30-34,1890,34
SIM,1938,19,50-100,1957,1
STAT,1935,45,na,1980,6016.908083498531
STAT,1934,60,na,1994,5503.35553441624
SIM,1858,20,25-29,1878,7
STAT,1950,29,45-49,1979,2.365248234783881
STAT,1931,31,na,1962,5723.720223936073
SIM,1858,51,na,1909,2405
STAT,1868,33,45-49,1901,1.925334248089825
STAT,1872,25,15-19,1897,0.5293183751055207
STAT,1845,53,45-49,1898,0.009622244889236171
STAT,1915,94,na,2009,298.2458859915875
STAT,1948,43,35-39,1991,0.27593652021584797
STAT,1973,17,50-100,1990,0.5591905540912749
SIM,1818,82,na,1900,511
SIM,1931,68,na,1999,4801
SIM,1922,35,40-44,1957,5
SIM,1857,16,25-29,1873,8
SIM,1932,46,na,1978,5390
STAT,1836,21,30-34,1857,21.556200107526987
SIM,1953,18,30-34,1971,40
STAT,1945,18,30-34,1963,15.361004828038567
STAT,1784,96,na,1880,1.6572628692033686
STAT,1898,19,25-29,1917,8.790886965622567
STAT,1856,53,20-24,1909,6.39268951279132E-4
STAT,1866,45,40-44,1911,0.18495180057603602
STAT,1973,33,na,2006,5750.397620914737
STAT,1780,82,na,1862,226.60894949364578
SIM,1828,30,40-44,1858,1
STAT,1889,15,50-100,1904,0.07001815116412737
SIM,1844,21,30-34,1865,29
STAT,1842,54,35-39,1896,0.006442708239562278
SIM,1918,31,35-39,1949,6
STAT,1914,35,40-44,1949,1.7421134009123205
STAT,1856,40,50-100,1896,0.9395378747925804
STAT,1913,35,50-100,1948,0.48296141440998014
SIM,1921,35,50-100,1956,2
SIM,1911,22,35-39,1933,14
STAT,1914,17,40-44,1931,0.3340653976843563
STAT,1868,40,35-39,1908,2.028030836073776
STAT,1901,47,15-19,1948,3.630316470185835E-4
STAT,1940,25,40-44,1965,5.491713276451382
SIM,1966,20,25-29,1986,142
SIM,1843,59,na,1902,1525
SIM,1952,29,50-100,1981,3
STAT,1874,43,25-29,1917,0.7531941568222981
STAT,1947,41,30-34,1988,0.1729636832281424
SIM,1922,17,40-44,1939,2
STAT,1882,43,20-24,1925,0.17772325704375241
STAT,1929,45,na,1974,5521.554865518913
STAT,1925,31,na,1956,5184.361907940985
STAT,1890,16,15-19,1906,8.388982935445467
STAT,1940,32,30-34,1972,18.82384550862306
STAT,1833,22,20-24,1855,74.49338594175701
SIM,1841,22,20-24,1863,136
STAT,1866,52,30-34,1918,0.006333319261851258
SIM,1817,41,40-44,1858,5
SIM,1926,13,na,1939,6164
STAT,1903,22,35-39,1925,9.592229110106274
SIM,1857,73,na,1930,1081
STAT,1956,48,na,2004,5819.188166903004
SIM,1882,43,25-29,1925,3
STAT,1865,65,na,1930,1759.6837287149756
STAT,1826,74,na,1900,611.0557510335387
SIM,1925,23,40-44,1948,7
STAT,1897,25,15-19,1922,0.704873602641833
SIM,1864,2,na,1866,3503
STAT,1819,45,45-49,1864,0.4677952921614643
SIM,1965,41,na,2006,5520
SIM,1879,50,na,1929,2553
STAT,1825,96,na,1921,6.073585548716564
SIM,1957,37,45-49,1994,2
STAT,1954,48,25-29,2002,0.07849782057188605
STAT,1842,47,45-49,1889,0.18163830086219027
STAT,1921,94,na,2015,333.47787826470557
STAT,1895,31,na,1926,3599.3466519482686
STAT,1927,45,45-49,1972,0.3162537944312861
SIM,1878,72,na,1950,1286
SIM,1839,27,50-100,1866,3
SIM,1903,31,40-44,1934,2
STAT,1926,49,50-100,1975,0.3201163557492206
STAT,1949,37,45-49,1986,0.942657890350519
STAT,1832,43,50-100,1875,0.8861000332601408
STAT,1950,47,45-49,1997,0.30847599652406626
STAT,1958,20,25-29,1978,140.5673183760755
SIM,1828,85,na,1913,476
SIM,1920,4,na,1924,4726
STAT,1944,29,50-100,1973,1.2403249987991856
SIM,1887,18,25-29,1905,11
SIM,1877,30,50-100,1907,2
STAT,1930,15,20-24,1945,203.24517766438004
SIM,1956,37,40-44,1993,5
SIM,1832,81,na,1913,388
STAT,1812,45,45-49,1857,0.5656718208602941
STAT,1934,31,40-44,1965,6.172729217598056
SIM,1834,34,35-39,1868,32
STAT,1877,21,30-34,1898,21.447220996036975
STAT,1858,52,na,1910,1928.1472719606559
SIM,1839,54,na,1893,1756
SIM,1881,39,25-29,1920,1
STAT,1911,48,na,1959,4006.011214349781
STAT,1952,17,50-100,1969,0.5181377064519899
SIM,1912,18,30-34,1930,4
STAT,1910,45,15-19,1955,3.989138319043227E-4
SIM,1889,40,45-49,1929,4
STAT,1867,23,50-100,1890,0.4380317333860403
STAT,1882,28,25-29,1910,47.51495270212314
STAT,1893,83,na,1976,1178.9294295746206
STAT,1896,28,50-100,1924,0.9716419554180095
STAT,1900,41,25-29,1941,0.07173188339447889
SIM,1892,25,40-44,1917,8
SIM,1970,19,30-34,1989,46
STAT,1829,42,20-24,1871,0.16974452953874963
SIM,1928,26,25-29,1954,3
STAT,1873,39,25-29,1912,3.3589545671279613
SIM,1904,7,na,1911,4453
STAT,1962,19,30-34,1981,18.01124692252917
STAT,1844,32,45-49,1876,1.7442088450502793
SIM,1890,28,25-29,1918,8
SIM,1903,18,20-24,1921,55
SIM,1852,32,45-49,1884,1
STAT,1858,38,45-49,1896,1.7858064168524423
STAT,1883,53,na,1936,2392.156267763411
STAT,1832,52,20-24,1884,5.328731909507693E-4
SIM,1854,21,na,1875,2983
STAT,1923,45,25-29,1968,0.07192360353993553
STAT,1854,51,45-49,1905,0.011879789552195949
STAT,1826,34,35-39,1860,8.671965118504817
STAT,1854,86,na,1940,180.76185757174287
SIM,2004,0,na,2004,7414
STAT,1861,45,40-44,1906,0.16588802367661012
STAT,1896,16,na,1912,3859.2013634258265
SIM,1831,64,na,1895,1165
STAT,1842,19,40-44,1861,0.1786167524678684
SIM,1957,38,na,1995,6217
SIM,1984,19,45-49,2003,2
STAT,1835,32,35-39,1867,8.051595727182917
STAT,1914,47,25-29,1961,0.06074140205514608
STAT,1970,43,na,2013,5566.948359441353
STAT,1855,32,20-24,1887,2.3418955186023322
SIM,1967,22,na,1989,5036
SIM,1863,32,20-24,1895,1
STAT,1867,27,45-49,1894,1.1963387659675755
STAT,1871,49,30-34,1920,0.10881814236137445
STAT,1982,20,20-24,2002,181.29337843302753
STAT,1877,112,na,1989,0.0036822098870987223
SIM,1843,32,35-39,1875,31
STAT,1995,20,50-100,2015,1.103598795377947
STAT,1873,69,na,1942,1729.4849881143784
SIM,1963,32,25-29,1995,5
STAT,1922,37,50-100,1959,0.5510952617744741
STAT,1851,26,40-44,1877,2.8014558738424715
STAT,1873,46,15-19,1919,4.7273392365591003E-4
STAT,1884,25,40-44,1909,3.4387774096081762
STAT,1911,19,15-19,1930,10.433310100693737
STAT,1987,19,20-24,2006,223.21072928971094
SIM,1835,30,na,1865,2523
STAT,1957,45,25-29,2002,0.08434794353677087
SIM,1909,15,35-39,1924,2
STAT,1870,43,40-44,1913,2.540569481689769
STAT,1923,67,na,1990,4165.852916565595
STAT,1919,20,35-39,1939,11.967053607286555
STAT,1821,52,45-49,1873,0.02530599221100238
STAT,1861,22,35-39,1883,5.75166147171401
SIM,1995,19,20-24,2014,445
STAT,1904,25,20-24,1929,19.573484371807687
SIM,1958,31,50-100,1989,2
STAT,1873,59,na,1932,2290.35277755039
SIM,1967,33,40-44,2000,4
STAT,1955,32,25-29,1987,14.4334494374242
STAT,1995,20,30-34,2015,48.205190154122064
STAT,1948,37,40-44,1985,2.0368278397120534
SIM,1905,78,na,1983,1619
SIM,1826,42,45-49,1868,2
STAT,1937,41,50-100,1978,0.13702514455783477
STAT,1940,37,25-29,1977,1.188990054846256
SIM,1942,31,40-44,1973,16
STAT,1962,26,20-24,1988,27.12055291725103
SIM,1811,47,45-49,1858,1
SIM,1848,21,15-19,1869,6
STAT,1846,19,25-29,1865,7.272600998274546
SIM,1875,49,50-100,1924,2
STAT,1847,15,na,1862,2230.63860885069
SIM,1898,85,na,1983,1103
STAT,1977,21,35-39,1998,14.735576552392804
SIM,1889,48,40-44,1937,1
SIM,1902,29,50-100,1931,2
SIM,1892,32,30-34,1924,62
STAT,1818,42,45-49,1860,1.9995636144175
STAT,1884,32,30-34,1916,19.90793619115897
STAT,1959,16,35-39,1975,6.336176530461832
SIM,1880,75,na,1955,1301
STAT,1893,73,na,1966,2098.084041221281
STAT,1904,18,30-34,1922,2.634470593220676
SIM,1905,39,35-39,1944,6
SIM,1854,19,25-29,1873,19
STAT,1882,50,50-100,1932,0.017268688483603332
SIM,1926,46,na,1972,5766
SIM,1899,44,35-39,1943,1
SIM,1967,16,35-39,1983,5
STAT,1900,49,20-24,1949,0.010613253781731776
SIM,1822,43,50-100,1865,4
STAT,1916,26,40-44,1942,5.581417946018788
SIM,1909,34,na,1943,4734
STAT,1859,19,35-39,1878,0.5786612520272646
SIM,1888,37,50-100,1925,1
STAT,1894,47,45-49,1941,0.19657343155871618
STAT,1913,23,20-24,1936,129.24951419481877
STAT,1882,44,15-19,1926,0.015356526573700685
STAT,1860,24,40-44,1884,1.9693870439782175
STAT,1830,50,45-49,1880,0.013460262329699256
STAT,1876,30,15-19,1906,0.17125493822994348
STAT,1825,36,40-44,1861,7.470501331371478
SIM,1915,28,40-44,1943,16
SIM,1841,88,na,1929,105
STAT,1805,75,na,1880,521.2209204608242
SIM,1916,41,40-44,1957,1
SIM,1880,85,na,1965,664
STAT,1814,47,20-24,1861,0.033362888057254854
SIM,1935,29,20-24,1964,48
STAT,1920,26,15-19,1946,0.8963917039812315
STAT,1913,49,30-34,1962,0.09987800457686924
STAT,1932,32,50-100,1964,1.2687265424133243
STAT,1875,27,40-44,1902,3.5724957812385383
STAT,1902,20,40-44,1922,3.41819097389504
STAT,1876,40,40-44,1916,2.7104143678858286
STAT,1915,29,50-100,1944,1.1634634974533435
SIM,1867,93,na,1960,72
STAT,1880,41,45-49,1921,1.8390357023447772
SIM,1912,25,20-24,1937,1
SIM,1814,62,na,1876,875
SIM,1833,36,40-44,1869,10
STAT,1927,29,20-24,1956,25.501283292059593
STAT,1979,19,25-29,1998,68.81270925135019
STAT,1810,66,na,1876,1054.9387450909196
STAT,1929,42,25-29,1971,0.10672831367904954
STAT,1979,34,20-24,2013,3.9455849344006326
SIM,1852,36,na,1888,1937
SIM,1817,69,na,1886,564
STAT,1918,84,na,2002,1649.8153326818651
SIM,1927,20,35-39,1947,1
STAT,1875,54,na,1929,2497.24352362543
SIM,1967,36,45-49,2003,2
STAT,1911,4,na,1915,4649.849185226458
SIM,1989,23,50-100,2012,7
STAT,1974,37,25-29,2011,1.5286104662086974
STAT,1810,48,15-19,1858,0.0015232192523232234
STAT,1895,28,20-24,1923,17.560859406659752
SIM,1921,23,20-24,1944,6
STAT,1821,50,35-39,1871,0.015620719671793248
SIM,1867,33,35-39,1900,31
STAT,1871,43,45-49,1914,1.7059191999085563
SIM,1918,11,na,1929,4302
STAT,1865,51,20-24,1916,7.720393659207927E-4
STAT,1891,44,25-29,1935,0.9035570473784876
STAT,1778,78,na,1856,391.3212176576999
SIM,1909,44,na,1953,4646
SIM,1828,29,25-29,1857,80
SIM,1977,30,30-34,2007,54
STAT,1870,22,45-49,1892,0.7933596197491042
STAT,1885,49,45-49,1934,0.2659896947062479
SIM,1884,40,40-44,1924,2
STAT,1951,18,50-100,1969,0.5147014217813265
SIM,1906,91,na,1997,505
SIM,1844,37,na,1881,2392
STAT,1834,34,40-44,1868,4.965239353320209
STAT,1908,41,40-44,1949,0.2689427460033133
STAT,1788,108,na,1896,8.313983848531709E-4
STAT,1985,26,45-49,2011,2.8492213285362538
SIM,1911,44,45-49,1955,1
STAT,1907,28,40-44,1935,5.068487581656901
STAT,1971,5,na,1976,5746.979573757626
STAT,1971,44,45-49,2015,0.2519678931067896
STAT,1973,36,50-100,2009,0.646194459422346
STAT,1848,86,na,1934,235.74959273946754
SIM,1973,3,na,1976,5502
STAT,1865,18,50-100,1883,0.052258434907731466
STAT,1881,22,20-24,1903,76.70850244512198
STAT,1823,45,20-24,1868,0.012193181678407999
SIM,1976,31,40-44,2007,3
STAT,1871,41,35-39,1912,2.0884502199425095
STAT,1881,54,25-29,1935,0.003834295489977262
STAT,1968,16,45-49,1984,0.7202469156556948
SIM,1931,29,35-39,1960,29
SIM,1869,29,na,1898,1975
STAT,1993,10,na,2003,6524.022923882298
STAT,1858,21,50-100,1879,0.4242738846668246
SIM,1893,49,45-49,1942,1
SIM,1831,29,30-34,1860,6
STAT,1923,29,35-39,1952,19.743092340376524
SIM,1877,54,50-100,1931,1
STAT,1979,17,15-19,1996,72.11326041625075
SIM,1961,19,20-24,1980,369
STAT,1953,19,20-24,1972,189.14404556837093
STAT,1841,58,na,1899,1758.2624470999644
STAT,1942,16,40-44,1958,1.6876419272453203
SIM,1924,11,na,1935,5352
STAT,1855,17,25-29,1872,5.735042970598339
STAT,1960,24,45-49,1984,1.695656956725085
SIM,1864,38,25-29,1902,2
STAT,1823,94,na,1917,11.317872711322906
STAT,1860,31,30-34,1891,16.305798827494716
STAT,1927,35,15-19,1962,0.027595134571880033
SIM,1892,28,45-49,1920,2
STAT,1872,48,20-24,1920,0.013730902320848776
STAT,1901,106,na,2007,1.2491108185603121
SIM,1984,16,40-44,2000,3
SIM,1933,36,45-49,1969,3
SIM,1882,70,na,1952,1959
STAT,1935,24,na,1959,5738.087899066672
SIM,1838,37,na,1875,1789
SIM,1877,38,20-24,1915,5
STAT,1911,30,45-49,1941,1.7840702236613855
STAT,1856,38,25-29,1894,2.522413542154384
STAT,1891,19,50-100,1910,0.06950326581311686
SIM,1865,37,50-100,1902,1
STAT,1894,22,30-34,1916,26.425220329417325
STAT,1934,34,45-49,1968,2.4774563370657483
SIM,1887,15,20-24,1902,29
SIM,1862,56,na,1918,2592
SIM,1930,30,20-24,1960,9
STAT,1932,49,50-100,1981,0.3520917076049877
SIM,1907,49,na,1956,4252
STAT,1932,7,na,1939,6109.925814560928
STAT,1975,28,40-44,2003,7.123545254043136
SIM,1869,23,40-44,1892,3
SIM,1834,31,30-34,1865,33
SIM,1848,21,na,1869,1841
STAT,1812,61,na,1873,1024.1998642611873
STAT,1952,37,15-19,1989,0.02736093114230965
STAT,1869,38,20-24,1907,0.8572340473815142
STAT,1831,108,na,1939,0.0014371100315857964
STAT,1945,70,na,2015,3775.8962369796795
STAT,1884,28,45-49,1912,1.261534632911832
STAT,1834,41,30-34,1875,1.2811314823794913
STAT,1930,45,15-19,1975,5.625473846613715E-4
STAT,1968,41,35-39,2009,0.30207552624910794
SIM,1934,24,45-49,1958,3
SIM,1792,66,na,1858,789
STAT,1831,53,30-34,1884,0.004757087030604837
STAT,1881,46,20-24,1927,0.013395474294209368
STAT,1925,36,45-49,1961,0.944811815984116
STAT,1922,89,na,2011,940.2315848721203
STAT,1941,34,50-100,1975,1.0007486212608212
STAT,1898,44,25-29,1942,0.0686115604640428
STAT,1903,44,45-49,1947,0.16853139361107264
SIM,1930,47,30-34,1977,1
STAT,1812,42,40-44,1854,6.421889541649716
STAT,1811,54,40-44,1865,0.030101005523771502
STAT,1840,102,na,1942,0.23518542301193623
STAT,1922,30,20-24,1952,3.204670064962646
SIM,1870,36,45-49,1906,3
STAT,1865,34,na,1899,2463.4873395360946
SIM,1842,34,40-44,1876,2
SIM,1927,63,na,1990,4297
STAT,1922,47,30-34,1969,0.11813629169179868
SIM,1820,42,40-44,1862,4
STAT,1866,9,na,1875,2939.438241825329
STAT,1827,60,na,1887,1620.5759831723124
STAT,1873,36,20-24,1909,0.9128099510265301
SIM,1842,41,30-34,1883,3
SIM,1847,89,na,1936,322
SIM,1889,19,na,1908,3952
STAT,1884,35,35-39,1919,8.141284864275656
SIM,1961,13,na,1974,5666
SIM,1866,38,45-49,1904,2
SIM,1922,16,na,1938,5026
STAT,1912,42,45-49,1954,0.18542060252671444
STAT,1926,24,45-49,1950,1.5673270354249282
STAT,1968,34,45-49,2002,2.309020499290347
SIM,1875,40,30-34,1915,3
STAT,1881,47,35-39,1928,0.1551115493720805
STAT,1826,31,30-34,1857,17.399009928047285
STAT,1844,53,40-44,1897,0.008664181409698277
SIM,1850,32,25-29,1882,3
STAT,1846,16,20-24,1862,23.159372777436438
STAT,1879,78,na,1957,1033.1120542477731
SIM,1845,54,na,1899,1855
STAT,1938,18,40-44,1956,1.5925686751658867
STAT,1972,32,45-49,2004,2.3700551733153157
STAT,1858,35,40-44,1893,3.97843268727728
STAT,1865,54,25-29,1919,0.003586720939437696
STAT,1867,40,30-34,1907,1.2512536945883763
SIM,1816,44,40-44,1860,3
SIM,1883,31,25-29,1914,4
SIM,1975,36,50-100,2011,4
SIM,1980,32,45-49,2012,4
SIM,1954,31,na,1985,5350
SIM,1907,38,50-100,1945,1
SIM,1892,35,35-39,1927,25
STAT,1891,41,20-24,1932,0.22754285437373295
SIM,1901,25,45-49,1926,5
SIM,1940,45,na,1985,4920
SIM,1920,42,45-49,1962,2
STAT,1986,24,50-100,2010,1.0848407530566868
STAT,1918,76,na,1994,2864.2148753987517
STAT,1940,34,20-24,1974,2.910490613552481
STAT,1858,112,na,1970,3.73403868169454E-4
STAT,1918,37,15-19,1955,0.023353802206212963
STAT,1970,35,15-19,2005,0.028630349894343585
STAT,1842,32,25-29,1874,9.521581788543614
STAT,1975,24,50-100,1999,1.0044051451297304
SIM,1943,30,30-34,1973,2
STAT,1875,31,25-29,1906,12.2652023603189
STAT,1958,35,45-49,1993,1.066403911106572
STAT,1951,26,45-49,1977,2.3854843294248393
STAT,1941,28,40-44,1969,5.563189150068951
STAT,1986,21,35-39,2007,15.539759234707754
STAT,1994,21,40-44,2015,5.61984027838393
STAT,1882,36,na,1918,2668.474800003183
STAT,1920,25,na,1945,4772.609260305549
STAT,1977,22,na,1999,5713.048317733348
STAT,1933,18,40-44,1951,2.156109995618367
STAT,1819,47,50-100,1866,0.4728876810659606
STAT,1926,47,15-19,1973,5.244356371315639E-4
STAT,1935,30,30-34,1965,25.196985405152493
SIM,1941,18,40-44,1959,6
SIM,1970,26,20-24,1996,48
STAT,1841,45,50-100,1886,0.22504359693922707
STAT,1913,26,25-29,1939,75.9866768589902
SIM,1875,42,40-44,1917,12
STAT,1859,16,30-34,1875,1.71092756360703
SIM,1866,22,na,1888,2316
SIM,1948,31,na,1979,4299
STAT,1861,72,na,1933,1211.6304944033243
STAT,1925,52,na,1977,5049.457723709725
STAT,1948,24,50-100,1972,0.8712749749110573
STAT,1903,77,na,1980,2168.4363303945706
SIM,1870,43,35-39,1913,3
STAT,1862,43,35-39,1905,1.7508703041264224
SIM,1779,84,na,1863,153
SIM,1933,67,na,2000,5326
STAT,1962,44,20-24,2006,0.0270482858178726
SIM,1854,16,20-24,1870,35
STAT,1903,13,na,1916,4238.489769394134
SIM,1988,16,25-29,2004,91
STAT,1908,44,45-49,1952,0.17574047068244425
STAT,2002,2,na,2004,6845.6462998105835
STAT,1870,46,45-49,1916,0.26926523788517703
STAT,1965,21,na,1986,5280.492616200116
SIM,1944,29,30-34,1973,120
STAT,1896,26,na,1922,3650.2279827894363
SIM,1990,20,20-24,2010,195
STAT,1808,51,30-34,1859,0.028948538912295523
SIM,1912,64,na,1976,3103
SIM,1981,23,15-19,2004,16
SIM,1868,7,na,1875,3422
SIM,1985,17,na,2002,6434
SIM,1922,37,30-34,1959,8
STAT,1970,17,15-19,1987,65.56213406106627
STAT,1873,28,50-100,1901,0.7512173626697904
STAT,1933,48,20-24,1981,0.017497179049841338
SIM,1883,28,50-100,1911,2
STAT,1936,29,30-34,1965,43.25784194416256
STAT,1939,45,35-39,1984,0.15570943093730066
STAT,1946,16,25-29,1962,55.48396449593984
SIM,1812,91,na,1903,13
SIM,1876,32,30-34,1908,3
STAT,1977,26,na,2003,5869.243731275946
SIM,1881,28,50-100,1909,2
STAT,1867,42,40-44,1909,2.420584879602813
STAT,1868,32,30-34,1900,19.35876939771506
SIM,1899,28,45-49,1927,8
STAT,1914,37,30-34,1951,2.1010563869545584
STAT,1960,21,40-44,1981,5.07225970792356
STAT,1974,34,20-24,2008,3.7418365238166627
SIM,1954,16,25-29,1970,136
SIM,1906,34,25-29,1940,2
STAT,1841,17,50-100,1858,0.05617863495995416
STAT,1918,12,na,1930,4975.996240897794
STAT,1885,46,40-44,1931,0.19762942332369626
STAT,1886,20,50-100,1906,0.49936966254080184
SIM,1893,46,40-44,1939,2
STAT,1801,105,na,1906,0.012306601544506001
STAT,1900,70,na,1970,2679.402397510135
STAT,1936,36,20-24,1972,0.29910696160808264
SIM,1851,19,na,1870,3075
SIM,1918,39,30-34,1957,3
SIM,1942,30,na,1972,4946
SIM,1929,16,15-19,1945,119
STAT,1961,20,30-34,1981,43.024500772542225
SIM,1952,27,15-19,1979,1
STAT,1816,42,25-29,1858,1.4544800431722809
STAT,1856,57,na,1913,1769.3781638744672
STAT,1944,27,15-19,1971,0.8805734404090263
SIM,1928,19,35-39,1947,8
SIM,1921,26,25-29,1947,180
STAT,1893,30,30-34,1923,25.673535395968575
SIM,1962,29,na,1991,5133
STAT,1893,32,40-44,1925,6.326048755778563
STAT,1914,44,20-24,1958,0.020137548973908025
STAT,1916,89,na,2005,839.9073555127299
STAT,1871,40,40-44,1911,2.6085107755238
SIM,1936,30,na,1966,3999
SIM,1849,74,na,1923,1500
STAT,1885,20,30-34,1905,20.62622191556251
SIM,1828,26,20-24,1854,23
SIM,1867,35,na,1902,2299
SIM,1893,20,30-34,1913,71
STAT,1876,71,na,1947,1592.3889067902055
SIM,1929,18,25-29,1947,1
STAT,1964,34,50-100,1998,1.223403096156617
SIM,1866,18,na,1884,2633
SIM,1969,9,na,1978,5830
STAT,1823,48,25-29,1871,0.056120555529637406
SIM,1873,35,na,1908,3288
SIM,1899,40,na,1939,4069
STAT,1869,52,35-39,1921,0.009570335613750178
STAT,1903,41,40-44,1944,0.25791040395827797
STAT,1941,14,na,1955,4668.778415253157
SIM,1934,80,na,2014,2701
STAT,1838,93,na,1931,25.31532922791354
STAT,1982,30,50-100,2012,1.3701421984845512
STAT,1970,21,35-39,1991,13.651978752043288
SIM,1920,20,35-39,1940,33
SIM,1883,55,na,1938,2200
SIM,1953,37,25-29,1990,1
STAT,1876,50,35-39,1926,0.01041801589667178
SIM,1913,30,50-100,1943,3
STAT,1931,31,25-29,1962,13.987701518605412
SIM,1908,31,40-44,1939,1
STAT,1883,37,40-44,1920,4.942604656360241
STAT,1808,47,45-49,1855,1.1798754125744249
STAT,1802,95,na,1897,6.346726959593629
STAT,1874,21,15-19,1895,3.909390087664924
SIM,1891,37,40-44,1928,5
STAT,1860,34,35-39,1894,9.338627678340902
SIM,1870,33,40-44,1903,11
SIM,1891,16,25-29,1907,19
STAT,1913,45,30-34,1958,0.10093973627707906
STAT,1839,24,15-19,1863,3.313523128539224
SIM,1906,64,na,1970,2963
STAT,1892,23,25-29,1915,82.54616012164647
STAT,1844,31,30-34,1875,17.64587053471269
STAT,1869,85,na,1954,306.3749174256187
SIM,1980,25,20-24,2005,34
STAT,1978,31,35-39,2009,14.679289209077336
STAT,1958,32,40-44,1990,6.046194139194071
SIM,1889,1,na,1890,4254
STAT,1922,45,40-44,1967,0.20991862713844509
SIM,1941,24,35-39,1965,18
STAT,1945,37,25-29,1982,1.278798184884181
STAT,1924,24,25-29,1948,124.96315905832924
SIM,1966,32,40-44,1998,23
SIM,1932,24,25-29,1956,270
STAT,1834,44,35-39,1878,1.9417923431064994
STAT,1998,15,na,2013,6240.221955677353
SIM,1875,43,35-39,1918,10
SIM,1958,14,na,1972,6228
SIM,1871,39,30-34,1910,21
STAT,1861,50,50-100,1911,0.014697909859888263
STAT,1977,1,na,1978,6139.801946364357
SIM,1906,5,na,1911,4031
STAT,1867,43,35-39,1910,1.937036359772037
SIM,1851,44,45-49,1895,1
STAT,1864,48,na,1912,2289.199585648552
SIM,1851,23,na,1874,2987
SIM,1930,37,50-100,1967,3
STAT,1851,75,na,1926,816.3581033158725
STAT,1912,28,30-34,1940,44.44666837219948
SIM,1857,41,25-29,1898,2
SIM,1884,43,45-49,1927,2
STAT,1848,90,na,1938,83.77028690152228
SIM,1913,49,na,1962,4412
STAT,1848,31,15-19,1879,0.17829864182861577
STAT,1926,21,40-44,1947,4.7273842283592575
STAT,1970,29,30-34,1999,56.792753315823575
STAT,1773,105,na,1878,0.038306657417101424
STAT,1919,47,25-29,1966,0.06638242416643844
SIM,1958,24,na,1982,5747
SIM,1794,61,na,1855,940
STAT,1876,43,45-49,1919,1.7725623191861177
STAT,1912,20,35-39,1932,10.486080824297607
SIM,1882,18,25-29,1900,13
STAT,1904,47,30-34,1951,0.09006770599030481
SIM,1948,27,40-44,1975,4
STAT,1843,44,45-49,1887,1.5070552638849721
STAT,1894,44,40-44,1938,0.2285926196453564
STAT,1969,19,30-34,1988,17.559951564259638
STAT,1837,52,20-24,1889,5.362886693886669E-4
STAT,1870,21,30-34,1891,20.326648564658523
STAT,1880,36,50-100,1916,1.509053945563714
SIM,1895,84,na,1979,713
SIM,1933,63,na,1996,5494
SIM,1807,76,na,1883,297
SIM,1895,74,na,1969,1741
STAT,1979,15,25-29,1994,68.89534667098494
STAT,1953,43,na,1996,5379.759982185497
SIM,1915,34,35-39,1949,2
STAT,1897,113,na,2010,0.002518137924611795
SIM,1973,31,50-100,2004,2
STAT,1840,32,na,1872,2117.5702340101143
STAT,1852,20,na,1872,2429.50455717901
SIM,1973,31,25-29,2004,26
STAT,1882,67,na,1949,1786.8813193294993
SIM,1934,21,40-44,1955,12
STAT,1837,53,na,1890,1534.1351410766645
SIM,1920,28,30-34,1948,7
STAT,1795,71,na,1866,527.5876054299267
STAT,1907,34,35-39,1941,9.789123371811796
STAT,1833,60,na,1893,1342.0321766862053
SIM,1782,73,na,1855,357
STAT,1935,27,50-100,1962,1.5666496070142297
STAT,1905,41,25-29,1946,0.07482120855768969
SIM,1868,88,na,1956,84
STAT,1819,47,20-24,1866,0.023105262204665536
STAT,1839,15,50-100,1854,0.05142942045224595
STAT,1862,40,30-34,1902,1.130997322652779
STAT,1926,47,na,1973,5230.242994170163
SIM,1849,16,na,1865,3004
SIM,1977,19,30-34,1996,47
SIM,1878,17,20-24,1895,42
STAT,1887,43,20-24,1930,0.20391281011703236
SIM,1991,7,na,1998,6712
STAT,1808,54,35-39,1862,0.03941886792050564
STAT,1991,21,25-29,2012,153.32359769048628
SIM,1964,24,na,1988,5932
STAT,1954,0,na,1954,6060.205317021557
SIM,1887,48,na,1935,3577
STAT,1879,15,20-24,1894,21.462471672795434
SIM,1922,88,na,2010,410
STAT,1893,33,35-39,1926,14.71019881990115
SIM,1944,43,45-49,1987,1
SIM,1818,53,40-44,1871,1
SIM,1946,18,40-44,1964,1
STAT,1850,35,na,1885,2515.45911544448
SIM,1971,34,45-49,2005,5
STAT,1845,37,20-24,1882,0.5457711745774441
STAT,1895,40,50-100,1935,1.6030068850026522
STAT,1898,22,15-19,1920,5.145422874388472
SIM,1890,37,na,1927,3344
SIM,1821,40,35-39,1861,2
SIM,1990,21,15-19,2011,10
STAT,1840,42,na,1882,1934.075809443612
STAT,1846,20,na,1866,2766.866260053123
STAT,1815,68,na,1883,988.5912983603192
STAT,1912,35,20-24,1947,0.3000279905879661
STAT,1878,46,15-19,1924,4.833502540280813E-4
STAT,1927,22,50-100,1949,0.9353638845667319
SIM,1866,0,na,1866,3737
STAT,1890,30,15-19,1920,0.20242609249382473
STAT,1842,53,50-100,1895,0.011435344042874844
STAT,1979,8,na,1987,6244.877436987443
STAT,1962,49,15-19,2011,5.632510735591916E-4
STAT,1820,105,na,1925,0.017208292699992144
STAT,1863,39,30-34,1902,5.324002600107309
STAT,1858,45,35-39,1903,0.12729660507803822
STAT,1888,99,na,1987,36.4065965420359
SIM,1919,37,na,1956,5352
STAT,1822,48,50-100,1870,0.45762747444972046
SIM,1874,30,20-24,1904,4
STAT,1812,50,45-49,1862,0.033462959418133154
STAT,1871,27,20-24,1898,13.469188526116964
STAT,1982,21,15-19,2003,8.675870875722783
STAT,1832,51,25-29,1883,0.002608957005714015
STAT,1973,38,35-39,2011,3.715527123969638
SIM,1877,55,na,1932,2719
STAT,1915,19,35-39,1934,1.0082646298857403
STAT,1909,40,30-34,1949,0.139719975865844
STAT,1844,93,na,1937,24.4447803900643
STAT,1900,45,50-100,1945,0.22406172614663175
SIM,1955,48,35-39,2003,1
SIM,1856,56,na,1912,1836
SIM,1853,37,20-24,1890,1
STAT,1906,46,50-100,1952,0.23380495443446794
STAT,1865,92,na,1957,55.78362965450809
STAT,1894,99,na,1993,42.80797184694099
STAT,1864,40,15-19,1904,0.01437381067921177
STAT,1857,47,40-44,1904,0.1531590082183536
STAT,1837,22,40-44,1859,1.9753259478061802
STAT,1806,61,na,1867,960.5478906668367
SIM,1939,10,na,1949,5042
STAT,1852,42,45-49,1894,1.409315226675139
SIM,1916,88,na,2004,100
STAT,1838,16,50-100,1854,0.056397632988770756
STAT,1841,53,25-29,1894,0.0030986054973949433
SIM,1923,19,35-39,1942,10
STAT,1946,48,30-34,1994,0.11835679887484196
STAT,1971,27,25-29,1998,96.62298958689114
SIM,1864,16,15-19,1880,14
STAT,1870,51,45-49,1921,0.016590123928972314
STAT,1868,54,40-44,1922,0.011351724916069726
STAT,1817,54,45-49,1871,0.03831358575009134
STAT,1930,37,30-34,1967,2.7438752708970955
STAT,1950,2,na,1952,5457.289430637467
SIM,1965,19,50-100,1984,1
STAT,1954,41,20-24,1995,0.026221749262927183
SIM,1876,70,na,1946,1707
STAT,1966,20,30-34,1986,41.593956727542746
STAT,1905,43,15-19,1948,0.0015902394209278523
STAT,1831,31,20-24,1862,2.78134445259119
STAT,1856,16,15-19,1872,6.214911044728472
STAT,1907,33,na,1940,4069.1177935558608
SIM,1978,17,25-29,1995,154
STAT,1959,48,50-100,2007,0.35415730365997017
STAT,1931,33,15-19,1964,0.19424419233608883
SIM,1949,1,na,1950,5979
SIM,1885,40,25-29,1925,1
SIM,1838,68,na,1906,902
STAT,1821,46,15-19,1867,7.33988841190262E-4
STAT,1923,42,20-24,1965,0.02381230320703262
SIM,1851,20,25-29,1871,139
STAT,1922,48,45-49,1970,0.28721754085590256
STAT,1920,15,na,1935,5038.351439484021
SIM,1878,21,40-44,1899,10
STAT,1893,34,30-34,1927,25.250759640365008
STAT,1906,96,na,2002,149.49004075190092
STAT,1910,63,na,1973,3557.5229746181494
SIM,1903,12,na,1915,4227
STAT,1954,24,50-100,1978,0.9412019289849012
STAT,1964,37,30-34,2001,2.7292705914646436
STAT,1877,40,25-29,1917,0.7786525496447861
STAT,1790,65,na,1855,819.8534000000002
STAT,1919,44,20-24,1963,0.022007712572139022
SIM,1961,25,15-19,1986,2
STAT,1892,20,20-24,1912,100.27212961988316
SIM,1922,2,na,1924,5559
STAT,1823,39,na,1862,1605.581397898378
SIM,1865,26,25-29,1891,51
STAT,1833,87,na,1920,123.97378391498845
SIM,1813,76,na,1889,444
SIM,1903,24,15-19,1927,1
STAT,1961,49,30-34,2010,0.13744273625783487
STAT,1843,41,40-44,1884,2.3536759817918984
SIM,1829,61,na,1890,1148
STAT,1925,62,na,1987,4675.029971666781
STAT,1913,48,35-39,1961,0.14489939871950624
STAT,1905,48,na,1953,3711.430304790677
SIM,2003,1,na,2004,6675
SIM,1814,40,50-100,1854,2
SIM,1916,92,na,2008,100
STAT,1926,0,na,1926,6373.092806139467
STAT,1854,45,15-19,1899,3.291273880074827E-4
SIM,1921,49,30-34,1970,1
SIM,1937,25,na,1962,4052
SIM,1985,27,na,2012,6404
STAT,1861,48,45-49,1909,0.22357512826613016
SIM,1839,36,25-29,1875,6
STAT,1896,7,na,1903,3971.3082147346813
STAT,1816,54,na,1870,1309.164347895668
STAT,1872,74,na,1946,1286.0254480770543
STAT,1953,25,15-19,1978,0.9906707209746629
SIM,1972,37,30-34,2009,2
STAT,1777,83,na,1860,96.52779161139584
STAT,1898,35,50-100,1933,1.933072141111491
SIM,1832,27,25-29,1859,75
STAT,1813,48,30-34,1861,0.3160029940388344
SIM,1980,28,25-29,2008,192
SIM,1825,30,25-29,1855,12
STAT,1945,34,20-24,1979,3.130329054110238
SIM,1820,38,20-24,1858,1
STAT,1822,34,15-19,1856,0.4085093145714323
STAT,1972,28,25-29,2000,97.62991419319447
SIM,1948,40,25-29,1988,1
SIM,1820,62,na,1882,1469
STAT,1801,55,na,1856,1224.5229407519842
SIM,1953,34,20-24,1987,1
SIM,1938,16,25-29,1954,52
STAT,1865,102,na,1967,1.88748538153241
STAT,1918,41,35-39,1959,0.24738104090213728
STAT,1858,42,30-34,1900,1.0337559213113505
STAT,1860,27,45-49,1887,1.0437676216836314
STAT,1883,16,25-29,1899,6.413973610800837
SIM,1943,25,na,1968,5426
STAT,1886,33,na,1919,2892.624438949911
SIM,1922,26,na,1948,4942
SIM,1870,82,na,1952,862
SIM,1848,40,20-24,1888,1
SIM,1874,33,25-29,1907,5
STAT,1887,18,na,1905,3257.8664989234853
SIM,1948,33,35-39,1981,27
STAT,1960,43,40-44,2003,0.390089959993504
STAT,1983,32,20-24,2015,4.058995452050009
STAT,1855,54,30-34,1909,0.0049257137306394395
SIM,1870,40,30-34,1910,1
SIM,1979,27,na,2006,6143
STAT,1817,39,na,1856,2139.35721301718
STAT,1948,15,30-34,1963,16.105941381870853
STAT,1951,23,40-44,1974,4.634418473344659
SIM,1912,23,na,1935,4064
STAT,1970,15,50-100,1985,0.5415262731162958
SIM,1820,58,na,1878,1594
SIM,1902,71,na,1973,2737
STAT,1893,33,50-100,1926,1.3309041571491684
SIM,1926,41,35-39,1967,1
STAT,1879,18,25-29,1897,6.8106240587168765
STAT,1812,52,35-39,1864,0.01907075652269515
SIM,1888,39,25-29,1927,3
STAT,1995,9,na,2004,6564.60461350326
STAT,1954,28,na,1982,5365.029653858754
SIM,1855,16,na,1871,2152
STAT,1870,31,25-29,1901,11.700881273609266
SIM,1936,19,50-100,1955,2
SIM,1898,49,45-49,1947,1
SIM,1792,76,na,1868,294
STAT,1845,31,50-100,1876,0.7417735070019827
STAT,1859,17,45-49,1876,0.0697069612482423
SIM,1876,15,na,1891,2916
STAT,1838,38,na,1876,2215.517562634491
STAT,1933,29,na,1962,5737.229649229404
STAT,1965,29,40-44,1994,6.737794369444198
SIM,1923,70,na,1993,4194
STAT,1852,28,50-100,1880,0.6974240065760414
SIM,1924,29,45-49,1953,5
STAT,1916,29,45-49,1945,2.046937370820281
SIM,1819,42,50-100,1861,2
STAT,1841,50,20-24,1891,6.655049600782526E-4
STAT,1866,23,30-34,1889,19.0707723682314
STAT,1935,14,na,1949,6234.221619090015
STAT,1924,44,50-100,1968,0.1606838935025442
SIM,1842,44,35-39,1886,1
SIM,1944,40,40-44,1984,1
STAT,1889,108,na,1997,0.22647864326135786
STAT,1867,44,30-34,1911,1.2220333611352163
STAT,1850,17,25-29,1867,7.128555388232504
STAT,1830,80,na,1910,388.05589075980544
SIM,1923,16,30-34,1939,24
STAT,1881,44,30-34,1925,1.2624552265048976
STAT,1985,23,40-44,2008,5.535347181592986
SIM,1884,41,na,1925,2599
STAT,1871,34,na,1905,2716.329673157431
STAT,1915,16,30-34,1931,2.9517916999209857
STAT,1899,32,25-29,1931,16.194278869596886
STAT,1796,97,na,1893,1.368336857607363
STAT,1881,49,25-29,1930,0.06277753762404947
SIM,1830,31,50-100,1861,2
SIM,1947,39,40-44,1986,1
STAT,1902,23,45-49,1925,1.133558537934019
STAT,1857,26,25-29,1883,39.44540805141052
STAT,1939,39,40-44,1978,1.7785244911736977
SIM,1910,23,45-49,1933,1
SIM,1819,35,45-49,1854,1
STAT,1914,15,na,1929,4634.354718961834
SIM,1851,41,40-44,1892,4
STAT,1904,63,na,1967,3262.7890065740453
STAT,1982,31,na,2013,6264.079657234827
STAT,1835,45,50-100,1880,0.1821401611783424
STAT,1864,45,50-100,1909,0.2555995145534002
STAT,1775,98,na,1873,0.7698650885907712
STAT,1928,19,50-100,1947,0.541866697094106
STAT,1942,19,45-49,1961,0.6021567010630265
SIM,1826,41,30-34,1867,3
SIM,1889,24,20-24,1913,110
STAT,1944,31,35-39,1975,11.575766785866628
STAT,1933,24,35-39,1957,14.41033395476702
STAT,1817,51,40-44,1868,0.029503449916703187
SIM,1841,57,na,1898,1658
STAT,1881,51,20-24,1932,8.253296280415633E-4
STAT,1971,29,50-100,2000,1.4597101933687437
STAT,1798,105,na,1903,0.0074580002740493555
SIM,1843,45,50-100,1888,2
STAT,1781,98,na,1879,0.4371692540202369
STAT,1891,88,na,1979,629.1747017001611
STAT,1919,62,na,1981,4184.94506124182
STAT,1845,51,35-39,1896,0.005829013592052554
STAT,1818,41,30-34,1859,1.5796156494748874
SIM,1952,31,35-39,1983,35
STAT,1946,65,na,2011,4263.676399674219
SIM,1974,23,35-39,1997,36
SIM,1842,37,45-49,1879,2
STAT,1971,24,20-24,1995,162.95560144273057
STAT,1940,49,40-44,1989,0.1910936206171472
STAT,1943,41,45-49,1984,0.2119907762317233
STAT,1966,30,25-29,1996,13.595363674747244
STAT,1925,33,40-44,1958,5.357875234412728
SIM,1933,33,40-44,1966,11
STAT,1834,37,45-49,1871,2.262881412193927
SIM,1863,42,na,1905,2309
STAT,1843,20,25-29,1863,73.14448159910589
STAT,1960,28,na,1988,5652.378298638699
SIM,1956,15,30-34,1971,16
STAT,1979,16,20-24,1995,215.48729133056685
SIM,1872,45,50-100,1917,1
SIM,1951,41,45-49,1992,1
STAT,1888,105,na,1993,1.771200037395035
SIM,1917,70,na,1987,3991
SIM,1971,31,40-44,2002,12
STAT,1889,15,15-19,1904,8.48153376063603
STAT,1824,49,35-39,1873,0.18520671236473157
STAT,1917,26,na,1943,4549.526248703896
STAT,1937,46,30-34,1983,0.10417725438489894
SIM,1855,53,na,1908,1631
STAT,1995,14,na,2009,6559.682619141082
SIM,1864,27,50-100,1891,2
SIM,1903,17,15-19,1920,18
SIM,1978,28,25-29,2006,190
SIM,1844,28,20-24,1872,15
STAT,1952,25,45-49,1977,2.4016507042458803
STAT,1863,31,35-39,1894,10.261087844408092
STAT,1780,97,na,1877,1.3437155403554484
STAT,1889,48,25-29,1937,0.0456402096172743
STAT,1913,12,na,1925,4662.37772521514
SIM,1896,75,na,1971,2220
STAT,1829,47,15-19,1876,4.081186632287657E-4
STAT,1849,28,30-34,1877,22.97027126242144
SIM,1837,40,na,1877,2391
STAT,1928,83,na,2011,2177.3795667776153
STAT,1937,35,20-24,1972,0.304895759628216
STAT,1840,28,40-44,1868,2.9747344088736907
STAT,1850,20,15-19,1870,4.135429700283079
STAT,1839,94,na,1933,15.849954576873454
STAT,1840,17,30-34,1857,1.6554446697471648
STAT,1815,54,35-39,1869,0.01623184045485368
STAT,1836,28,20-24,1864,13.720675348008374
STAT,1828,54,45-49,1882,0.011289363931301115
STAT,1954,34,na,1988,5492.9013432974625
STAT,1974,28,45-49,2002,2.6133826540621774
STAT,1974,33,50-100,2007,1.269206478907876
SIM,1948,56,na,2004,4170
STAT,1804,53,20-24,1857,0.003328996335720946
SIM,1851,43,30-34,1894,1
SIM,1971,25,20-24,1996,29
STAT,1809,72,na,1881,662.9134025557793
SIM,1842,27,na,1869,2495
STAT,1882,8,na,1890,2930.2475131377014
STAT,1850,31,25-29,1881,11.145431170653946
SIM,1847,58,na,1905,2136
STAT,1824,41,25-29,1865,0.9293362059396815
STAT,1893,48,45-49,1941,0.19174993855379763
STAT,1866,15,50-100,1881,0.054428493287136614
STAT,1905,17,na,1922,4218.576296719967
STAT,1871,55,na,1926,2373.9964598616343
SIM,1832,49,35-39,1881,1
SIM,1982,28,45-49,2010,11
STAT,1915,0,na,1915,5424.671685317501
STAT,1884,42,35-39,1926,2.0621858561333184
SIM,1848,22,20-24,1870,133
STAT,1843,54,40-44,1897,0.01027276090049798
SIM,1878,39,30-34,1917,12
SIM,1874,23,30-34,1897,46
STAT,1985,28,20-24,2013,30.076852055766196
SIM,1892,42,35-39,1934,1
STAT,1876,48,15-19,1924,4.711952166657559E-4
STAT,1875,18,30-34,1893,1.8958611915720025
STAT,1993,22,40-44,2015,5.601277009037685
SIM,1960,25,45-49,1985,8
SIM,1956,51,na,2007,5241
STAT,1953,18,15-19,1971,63.33733594563726
STAT,1843,43,30-34,1886,1.1725958943786703
SIM,1873,31,45-49,1904,3
SIM,1850,22,na,1872,2051
STAT,1824,30,15-19,1854,0.4433188536403674
STAT,1910,33,50-100,1943,0.9170783622166625
STAT,1887,106,na,1993,0.8635238813283541
STAT,1921,43,15-19,1964,0.0019922357712524215
STAT,1860,50,25-29,1910,0.003341799564596276
SIM,1986,22,45-49,2008,2
STAT,1966,8,na,1974,5664.963648776712
STAT,1834,63,na,1897,1628.35711240953
SIM,1821,65,na,1886,809
STAT,1847,18,25-29,1865,5.410016170771049
STAT,1853,17,40-44,1870,0.21905656287163996
SIM,1884,31,20-24,1915,6
STAT,1885,63,na,1948,2053.9291430837907
STAT,1897,42,45-49,1939,0.1601800832764772
STAT,1882,47,30-34,1929,0.10860571516074995
SIM,1772,90,na,1862,56
STAT,1801,92,na,1893,17.481275928511398
STAT,1930,49,25-29,1979,0.08015482222727449
SIM,1872,49,na,1921,2716
STAT,1833,36,25-29,1869,2.580360912297232
STAT,1855,37,15-19,1892,0.04778166630298391
STAT,1948,17,50-100,1965,0.4947972260528705
STAT,1939,30,25-29,1969,10.899951643688043
STAT,1851,18,45-49,1869,0.06260886365936717
STAT,1880,49,50-100,1929,0.2941553389577087
SIM,1857,28,30-34,1885,3
STAT,1896,29,30-34,1925,38.11007913086035
SIM,1910,39,50-100,1949,1
STAT,1978,22,45-49,2000,1.7779678867043636
STAT,1927,28,15-19,1955,0.9867407210589281
STAT,1983,6,na,1989,6417.82593388094
STAT,1817,53,30-34,1870,0.01603093667558867
SIM,1947,49,45-49,1996,1
STAT,1862,18,20-24,1880,19.658733546534783
SIM,1818,61,na,1879,1722
STAT,1830,43,20-24,1873,0.15031099540972764
STAT,1855,41,na,1896,1975.5221163147714
STAT,1973,30,15-19,2003,0.19572624708909037
STAT,1839,54,20-24,1893,5.691140067137968E-4
SIM,1862,41,40-44,1903,5
STAT,1826,68,na,1894,841.4340547618995
SIM,1947,30,25-29,1977,26
SIM,1870,18,20-24,1888,17
STAT,1941,65,na,2006,3960.5478175944622
STAT,1837,44,15-19,1881,0.010466478610131521
STAT,1975,40,20-24,2015,0.028019848097936454
SIM,1869,30,40-44,1899,6
STAT,1950,22,30-34,1972,39.34830193032715
STAT,1893,98,na,1991,60.63468364842431
STAT,1893,26,50-100,1919,0.936333406741755
STAT,1989,22,20-24,2011,184.41090825135743
SIM,1936,1,na,1937,4284
STAT,1960,46,45-49,2006,0.34063841554629604
STAT,1841,30,45-49,1871,1.9205908128495381
SIM,1923,80,na,2003,2915
SIM,1904,28,na,1932,4218
SIM,1826,32,40-44,1858,2
SIM,1919,32,45-49,1951,7
SIM,1867,19,na,1886,2575
STAT,1891,21,45-49,1912,0.9976052278039074
STAT,1855,25,na,1880,2139.0021798097036
STAT,1857,36,40-44,1893,3.9534834540032793
SIM,1941,36,na,1977,3968
SIM,1954,30,50-100,1984,5
STAT,1960,27,50-100,1987,1.5025546173485447
SIM,1872,29,40-44,1901,5
STAT,1943,50,na,1993,4634.740159049146
SIM,1926,31,na,1957,5775
SIM,1808,83,na,1891,212
SIM,1888,40,na,1928,2745
STAT,1935,22,35-39,1957,14.805342624484444
SIM,1848,83,na,1931,81
SIM,1963,23,na,1986,5768
SIM,1963,43,50-100,2006,1
STAT,1833,38,na,1871,1864.3895886344048
STAT,1974,36,na,2010,5846.163578522027
STAT,1873,38,na,1911,2762.723769635221
STAT,1860,71,na,1931,1241.509600912442
SIM,1917,54,na,1971,5039
STAT,1811,46,45-49,1857,0.7481599407287881
STAT,1879,26,20-24,1905,14.185133455628975
STAT,1827,109,na,1936,5.777909816230324E-4
SIM,1834,91,na,1925,69
SIM,1825,34,50-100,1859,5
STAT,1963,36,30-34,1999,2.7555164519784423
SIM,1934,32,40-44,1966,5
STAT,1978,20,35-39,1998,14.88905439817688
STAT,1930,36,50-100,1966,0.6326657609319428
STAT,1905,38,35-39,1943,2.5373129557210046
SIM,1832,41,25-29,1873,4
SIM,1900,14,na,1914,3896
STAT,1850,39,35-39,1889,7.244470431006683
STAT,1972,4,na,1976,5810.878745831855
SIM,1852,22,40-44,1874,5
STAT,1892,17,na,1909,3653.1234311047137
STAT,1905,27,25-29,1932,70.6570075394795
STAT,1991,19,50-100,2010,0.6192215855072887
SIM,1833,28,45-49,1861,1
SIM,1872,65,na,1937,2115
STAT,1963,25,20-24,1988,26.902275100861594
STAT,1863,34,15-19,1897,0.14247468566583205
STAT,1818,44,35-39,1862,2.2915266471958358
STAT,1868,26,45-49,1894,1.235292857659881
SIM,1810,81,na,1891,123
SIM,1822,39,25-29,1861,5
SIM,1884,34,25-29,1918,13
STAT,1871,47,50-100,1918,0.2806652302468788
STAT,1815,40,45-49,1855,4.04082682298101
STAT,1926,32,40-44,1958,5.459705855818692
STAT,1880,31,40-44,1911,5.3265294311816245
STAT,1876,34,25-29,1910,12.114594369715434
STAT,1924,32,30-34,1956,21.20690721134818
STAT,1907,38,45-49,1945,0.726974992271475
SIM,1971,39,25-29,2010,2
STAT,1833,33,20-24,1866,2.4455130974914567
STAT,1851,51,40-44,1902,0.008388315396361966
STAT,1948,36,35-39,1984,3.293988757930665
SIM,1959,17,20-24,1976,200
STAT,1959,39,15-19,1998,0.02980215568781089
STAT,1792,109,na,1901,1.997840025232274E-4
SIM,1898,27,35-39,1925,18
SIM,1841,33,20-24,1874,2
STAT,1924,21,20-24,1945,151.83582904695132
SIM,1915,38,45-49,1953,4
SIM,1932,32,30-34,1964,46
STAT,1926,38,50-100,1964,0.5914423400126338
STAT,1844,22,40-44,1866,2.176180236789137
STAT,1881,105,na,1986,1.2385683924876632
SIM,1932,21,20-24,1953,313
STAT,1964,43,25-29,2007,0.10769673527242483
STAT,1809,56,na,1865,1259.2809486875278
STAT,1879,38,15-19,1917,0.06733167729648168
SIM,1822,38,40-44,1860,10
STAT,1900,85,na,1985,1125.1373083737597
SIM,1826,44,35-39,1870,6
SIM,1826,33,25-29,1859,7
STAT,1922,29,na,1951,4854.921945721237
SIM,1930,38,40-44,1968,4
STAT,1976,21,na,1997,5650.81713751408
SIM,1837,22,45-49,1859,1
STAT,1922,38,40-44,1960,1.962939293547302
STAT,1830,40,40-44,1870,2.2249961770368274
SIM,1956,36,35-39,1992,13
STAT,1820,36,15-19,1856,0.14231060659170605
STAT,1869,50,45-49,1919,0.016452271183411967
STAT,1874,20,na,1894,2810.8518112557235
STAT,1937,22,45-49,1959,1.265171193766645
STAT,1952,49,na,2001,5253.766199364168
SIM,1945,22,45-49,1967,4
STAT,1889,13,na,1902,3668.1037311610435
SIM,1917,32,35-39,1949,17
SIM,1902,37,20-24,1939,1
STAT,1998,17,20-24,2015,229.72778996505878
STAT,1854,44,45-49,1898,1.2028498661103677
STAT,1859,38,40-44,1897,4.004298638140928
STAT,1967,30,30-34,1997,23.177173135926846
SIM,1930,7,na,1937,6419
STAT,1909,32,35-39,1941,10.075116012415798
STAT,1943,41,50-100,1984,0.149640547499461
STAT,1891,34,20-24,1925,3.822413243884957
STAT,1834,51,35-39,1885,0.00821683709114444
STAT,1855,25,20-24,1880,11.59984399922114
STAT,1828,51,40-44,1879,0.009550986523543366
SIM,1815,96,na,1911,7
STAT,1865,45,35-39,1910,0.14722917285765794
SIM,1859,83,na,1942,53
STAT,1963,20,15-19,1983,7.835842971506082
SIM,1912,79,na,1991,1469
STAT,1948,24,40-44,1972,4.452214797879986
STAT,1918,38,20-24,1956,0.32026018195746153
SIM,1937,15,na,1952,3914
STAT,1844,34,35-39,1878,9.921120768786643
SIM,1852,34,35-39,1886,12
SIM,1971,28,25-29,1999,192
SIM,1847,41,45-49,1888,3
SIM,1874,15,25-29,1889,16
SIM,1930,36,na,1966,6058
STAT,1963,39,25-29,2002,1.4840915142409463
STAT,1889,45,20-24,1934,0.01724102074876551
STAT,1941,47,35-39,1988,0.15945051804582042
SIM,1873,44,20-24,1917,1
STAT,1866,25,na,1891,2570.091758675377
STAT,1822,38,na,1860,2338.8585299484826
SIM,1974,23,na,1997,5672
STAT,1952,38,20-24,1990,0.37521156978157894
STAT,1844,23,25-29,1867,59.353960501023074
SIM,1823,40,45-49,1863,6
SIM,1877,40,na,1917,3120
SIM,1863,25,20-24,1888,28
STAT,1839,41,45-49,1880,1.392396804593306
STAT,1799,104,na,1903,0.029960641950921244
STAT,1902,46,15-19,1948,3.6896829276742967E-4
SIM,1971,20,15-19,1991,1
STAT,1942,15,35-39,1957,5.064191536482715
STAT,1963,28,25-29,1991,96.87367889279903
STAT,1847,51,45-49,1898,0.011220068268712054
SIM,1891,44,na,1935,3311
STAT,1915,42,50-100,1957,0.1365200055153478
SIM,1852,23,25-29,1875,4
SIM,1862,44,45-49,1906,1
STAT,1887,41,50-100,1928,1.3725158742472736
STAT,1804,50,40-44,1854,0.05044623118478904
STAT,1895,45,15-19,1940,3.423233936868897E-4
STAT,1914,91,na,2005,571.4554886006388
STAT,1941,38,45-49,1979,0.8342259602698539
SIM,1906,70,na,1976,2628
SIM,1890,22,na,1912,3381
SIM,1957,4,na,1961,6328
STAT,1830,33,na,1863,1732.2095848409035
SIM,1956,24,40-44,1980,5
STAT,1933,28,45-49,1961,2.647187444204492
STAT,1844,41,na,1885,2005.4209271047885
SIM,1813,44,25-29,1857,1
STAT,1815,51,30-34,1866,0.01191460338363708
SIM,1941,28,45-49,1969,5
SIM,1883,49,na,1932,2402
STAT,1980,23,15-19,2003,8.553547166361316
SIM,1950,15,35-39,1965,1
STAT,1938,17,35-39,1955,4.779235104107496
STAT,1881,33,na,1914,2645.0628084014584
STAT,1866,26,35-39,1892,10.356510096849547
STAT,1875,52,40-44,1927,0.012488388634664819
STAT,1874,32,25-29,1906,12.101096583429538
STAT,1801,76,na,1877,432.55812695904575
STAT,1888,12,na,1900,3503.366277448775
STAT,1881,27,15-19,1908,0.5050295006740291
SIM,1858,35,50-100,1893,2
SIM,1839,23,na,1862,2243
STAT,1891,35,35-39,1926,10.184045677268537
STAT,1908,16,40-44,1924,0.31428251569829657
STAT,1865,44,20-24,1909,0.1631329161326334
SIM,1988,13,na,2001,6631
STAT,1917,36,50-100,1953,0.50570313917085
SIM,1882,32,25-29,1914,23
STAT,1866,15,25-29,1881,6.295563660834683
SIM,1916,16,40-44,1932,1
SIM,1946,11,na,1957,4694
STAT,1777,93,na,1870,5.035661909966224
SIM,1947,46,40-44,1993,1
SIM,1858,44,25-29,1902,2
STAT,1842,98,na,1940,2.499834421151294
SIM,1894,7,na,1901,4167
STAT,1964,40,45-49,2004,0.25209791463279047
STAT,1826,41,35-39,1867,1.3787710703422804
STAT,1976,20,25-29,1996,142.98455647967864
STAT,1909,47,na,1956,3900.2157472038134
STAT,1931,25,30-34,1956,58.44274595172592
SIM,1874,24,15-19,1898,1
STAT,1881,15,20-24,1896,19.82583195258211
STAT,1866,24,15-19,1890,3.5067490553875116
SIM,1865,36,40-44,1901,12
STAT,1861,5,na,1866,2772.8639604641794
SIM,1895,32,35-39,1927,41
STAT,1850,10,na,1860,3040.691327331771
STAT,1768,97,na,1865,0.8708285728303063
STAT,1906,42,na,1948,3898.145837487801
STAT,1927,16,20-24,1943,194.97464693498472
STAT,1921,47,na,1968,4777.74414461332
SIM,1924,25,35-39,1949,22
SIM,1959,17,45-49,1976,1
STAT,1803,59,na,1862,1031.851697999169
STAT,1955,29,35-39,1984,23.077511411839886
STAT,1813,43,15-19,1856,0.04982800154431479
STAT,1898,23,20-24,1921,107.14934328548003
STAT,1928,26,na,1954,5344.355587005064
SIM,1904,44,na,1948,3989
SIM,1885,91,na,1976,551
STAT,1865,31,45-49,1896,1.8231858111863006
SIM,1901,79,na,1980,1827
STAT,1956,46,25-29,2002,0.0844662068923706
STAT,1916,25,35-39,1941,18.03821901551516
STAT,1900,30,25-29,1930,16.533894475308976
SIM,1927,32,na,1959,5013
STAT,1834,105,na,1939,0.02675806173312502
STAT,1955,18,25-29,1973,66.36881936880748
STAT,1887,46,25-29,1933,0.07470691122050281
SIM,1963,0,na,1963,6588
SIM,1891,26,40-44,1917,9
SIM,1900,21,30-34,1921,4
SIM,1975,32,40-44,2007,12
STAT,1868,51,na,1919,2398.785251474418
STAT,1905,35,30-34,1940,1.9396910019994564
SIM,1963,29,35-39,1992,3
STAT,1902,39,50-100,1941,0.4277633111896603
STAT,1876,31,20-24,1907,3.237870053192748
SIM,1946,17,35-39,1963,7
SIM,1843,38,50-100,1881,2
STAT,1887,35,15-19,1922,0.0733157248502492
STAT,1920,39,15-19,1959,0.02420232109712208
SIM,1898,25,50-100,1923,1
STAT,1859,55,na,1914,1900.85882453044
SIM,1893,27,na,1920,3494
SIM,1963,18,25-29,1981,160
SIM,1937,72,na,2009,3064
SIM,1875,14,na,1889,3475
STAT,1863,20,na,1883,2469.491423734424
SIM,1929,19,30-34,1948,44
STAT,1852,47,15-19,1899,3.753668791419952E-4
SIM,1876,26,45-49,1902,3
SIM,1974,17,40-44,1991,2
STAT,1901,31,50-100,1932,1.4871478121627322
STAT,1966,17,40-44,1983,2.0161435793605467
SIM,1876,46,50-100,1922,1
SIM,1818,38,20-24,1856,1
STAT,1900,49,45-49,1949,0.20872731645279777
STAT,1870,24,35-39,1894,6.597604481936212
STAT,1897,48,na,1945,3428.8194240613702
STAT,1852,76,na,1928,893.2248914617495
SIM,1969,34,na,2003,5650
STAT,1871,114,na,1985,2.836432607576177E-4
STAT,1960,44,na,2004,5782.040166654008
STAT,1931,22,50-100,1953,0.9850864079444541
STAT,1880,34,45-49,1914,2.1148523351666397
STAT,1939,15,50-100,1954,0.4340379866655359
STAT,1984,30,15-19,2014,0.21494005838052876
STAT,1926,48,20-24,1974,0.015689344982680428
STAT,1929,39,35-39,1968,3.5761643266432666
STAT,1937,30,15-19,1967,0.14696674951260683
SIM,1913,24,20-24,1937,131
STAT,1968,26,na,1994,5425.532148246214
SIM,1945,38,25-29,1983,3
SIM,1876,23,40-44,1899,8
SIM,1952,28,20-24,1980,68
STAT,1842,42,50-100,1884,0.8411019269866506
SIM,1822,66,na,1888,1005
STAT,1848,44,15-19,1892,0.014475264219174774
STAT,1944,28,20-24,1972,22.75818388802895
STAT,1964,40,20-24,2004,0.026750874881054917
STAT,1895,42,35-39,1937,0.1886630078120101
STAT,1930,46,20-24,1976,0.01683913946050588
STAT,1831,34,25-29,1865,10.216000511774487
SIM,1926,33,50-100,1959,1
STAT,1854,41,40-44,1895,1.8407697712724749
STAT,1894,16,45-49,1910,0.09714650589319378
SIM,1775,79,na,1854,97
STAT,1868,23,40-44,1891,2.3033204561799328
STAT,1905,24,20-24,1929,114.38549280584397
STAT,1937,38,25-29,1975,1.1356984364143388
SIM,1829,28,25-29,1857,4
STAT,1887,32,35-39,1919,13.097567529854679
STAT,1996,18,25-29,2014,72.65740012199106
SIM,1972,38,na,2010,5729
STAT,1794,89,na,1883,50.45162777178347
STAT,1822,46,20-24,1868,0.023007382716461258
STAT,1831,23,15-19,1854,7.545392559163339
STAT,1790,75,na,1865,423.5942445984977
STAT,1885,28,40-44,1913,3.4360836078552293
STAT,1883,26,40-44,1909,3.3938751447017497
SIM,1845,91,na,1936,55
SIM,1856,6,na,1862,2698
SIM,1937,20,15-19,1957,9
SIM,1935,16,20-24,1951,226
STAT,1889,28,50-100,1917,0.9068035101438147
SIM,1939,22,15-19,1961,13
SIM,1826,40,na,1866,1903
STAT,1867,100,na,1967,6.226232521074476
STAT,1937,49,35-39,1986,0.14941497629905726
SIM,1937,28,25-29,1965,4
STAT,1929,28,25-29,1957,95.02440292189615
SIM,1937,39,35-39,1976,3
SIM,1829,45,na,1874,1651
STAT,1929,20,15-19,1949,7.815301060701127
SIM,1945,49,35-39,1994,2
STAT,1874,37,30-34,1911,6.296614946642673
STAT,1894,25,35-39,1919,14.411678316880934
STAT,1919,19,20-24,1938,171.93370569570865
SIM,1937,31,na,1968,4371
SIM,1893,28,40-44,1921,7
STAT,1856,27,50-100,1883,0.5836214536365398
STAT,1857,51,na,1908,1944.5497395703285
SIM,1957,52,na,2009,6087
SIM,1941,25,40-44,1966,7
STAT,1918,27,na,1945,4599.8948042057145
SIM,1882,6,na,1888,3608
STAT,1821,53,na,1874,1442.0165884413004
SIM,1961,42,35-39,2003,1
STAT,1915,16,50-100,1931,0.0907312838050663
SIM,1763,94,na,1857,14
STAT,1884,40,15-19,1924,0.015905142952498175
STAT,1910,47,na,1957,3959.7660236362985
STAT,1804,53,45-49,1857,0.06547025878456378
STAT,1874,48,40-44,1922,0.19972231555990455
SIM,1869,33,45-49,1902,4
STAT,1795,104,na,1899,0.011687752245402007
STAT,1907,35,40-44,1942,1.619560241688258
SIM,1927,19,20-24,1946,398
SIM,1937,25,20-24,1962,39
STAT,1925,1,na,1926,5819.939099105563
STAT,1766,93,na,1859,15.928040715024146
SIM,1893,38,45-49,1931,2
SIM,1865,39,45-49,1904,5
SIM,1952,23,na,1975,4813
STAT,1874,34,15-19,1908,0.1668066878685272
STAT,1808,71,na,1879,852.4323164675895
SIM,1835,22,35-39,1857,14
STAT,1844,37,15-19,1881,0.04963326293435529
STAT,1874,22,20-24,1896,81.41647552078214
SIM,1837,96,na,1933,37
STAT,1856,52,25-29,1908,0.003101960981999029
SIM,1880,28,30-34,1908,55
SIM,1863,28,25-29,1891,50
STAT,1855,28,25-29,1883,37.24845832343901
STAT,1985,27,50-100,2012,1.640817700700376
SIM,1854,52,na,1906,2258
SIM,1982,27,30-34,2009,173
STAT,1974,27,30-34,2001,59.30051227243417
STAT,1870,33,na,1903,2703.5066548586565
STAT,1909,20,40-44,1929,3.6319898416497676
SIM,1915,35,40-44,1950,2
STAT,1881,18,25-29,1899,6.291273910054112
SIM,1824,30,na,1854,1703
SIM,1970,34,na,2004,5991
STAT,1985,17,35-39,2002,6.887507523674132
STAT,2001,3,na,2004,6796.751472455795
STAT,1945,38,na,1983,4881.371917353742
SIM,1883,65,na,1948,1654
SIM,1884,10,na,1894,3012
STAT,1957,26,na,1983,5727.231700293045
SIM,1895,53,na,1948,3217
STAT,1890,93,na,1983,243.1489628743809
STAT,1941,24,na,1965,4353.316624895344
STAT,1953,12,na,1965,5483.911223859855
STAT,1884,51,25-29,1935,0.004058000964525665
SIM,1850,78,na,1928,27
STAT,1829,33,na,1862,2057.7275646312073
SIM,1983,4,na,1987,7028
STAT,1919,42,45-49,1961,0.20809113431172876
SIM,1899,67,na,1966,3010
STAT,1880,46,15-19,1926,4.906852855490971E-4
STAT,1944,15,45-49,1959,0.620752030863366
STAT,1876,33,40-44,1909,5.151778439945409
STAT,1888,68,na,1956,2105.263442772063
SIM,1815,44,35-39,1859,4
STAT,1882,31,15-19,1913,0.16118006905348756
STAT,1927,82,na,2009,2334.880421911565
STAT,1953,33,na,1986,5378.647487056971
SIM,1828,44,45-49,1872,5
SIM,1993,17,35-39,2010,19
SIM,1884,33,40-44,1917,12
STAT,1920,46,na,1966,4696.278942939177
STAT,1932,50,na,1982,5700.8250378736675
SIM,1890,42,25-29,1932,2
SIM,1833,27,30-34,1860,5
SIM,1882,37,30-34,1919,19
SIM,1874,91,na,1965,107
SIM,1831,27,na,1858,1814
SIM,1876,39,20-24,1915,1
STAT,1818,47,15-19,1865,4.936979339148178E-4
STAT,1877,12,na,1889,3109.4717221920882
STAT,1809,54,40-44,1863,0.02441448096460253
SIM,1887,79,na,1966,1722
STAT,1859,48,45-49,1907,0.214229853502834
STAT,1870,28,20-24,1898,13.300173901883792
STAT,1844,25,na,1869,2247.1748578197326
STAT,1896,63,na,1959,2830.3094251847565
SIM,1927,16,na,1943,5215
STAT,1841,43,20-24,1884,0.1448557482607008
STAT,1883,29,45-49,1912,1.244674728317633
SIM,1876,24,25-29,1900,141
STAT,1846,34,45-49,1880,2.086593526722795
STAT,1946,24,30-34,1970,36.884858741968316
STAT,1822,49,25-29,1871,0.10580516243601559
STAT,1862,54,20-24,1916,6.989202815241069E-4
STAT,1939,46,40-44,1985,0.18998958243223285
SIM,1948,15,na,1963,3822
STAT,1934,42,40-44,1976,0.4020099980905391
STAT,1868,35,na,1903,2637.039887113176
STAT,1911,21,35-39,1932,10.34559214943946
SIM,1958,36,45-49,1994,2
SIM,1915,21,15-19,1936,10
STAT,1852,32,40-44,1884,4.2333757168986015
STAT,1854,40,na,1894,1901.9598075867814
STAT,1928,42,na,1970,5463.818887794127
STAT,1858,16,35-39,1874,0.5804709546674263
SIM,1905,29,na,1934,4151
STAT,1867,50,na,1917,2353.352838249858
SIM,1866,16,35-39,1882,1
SIM,1871,31,35-39,1902,12
SIM,1975,29,50-100,2004,3
STAT,1906,40,50-100,1946,0.12470484272119801
SIM,1876,35,35-39,1911,14
STAT,1996,15,20-24,2011,227.504198738558
SIM,1944,37,50-100,1981,2
STAT,1840,22,50-100,1862,0.4160121390795646
STAT,1976,21,50-100,1997,1.0181870420996424
SIM,1954,24,30-34,1978,93
STAT,1907,43,na,1950,3909.53272843054
STAT,1971,38,15-19,2009,0.028888644545393048
STAT,1869,17,na,1886,2861.7249412119286
STAT,1846,47,20-24,1893,0.012347551105949681
STAT,1882,42,25-29,1924,0.7229578643115764
STAT,1794,105,na,1899,0.007338533968756649
SIM,1885,75,na,1960,1797
STAT,1969,30,40-44,1999,5.757084057590963
STAT,1777,77,na,1854,242.0
STAT,1907,21,15-19,1928,5.618571195876559
STAT,1835,44,40-44,1879,1.6393670054082483
STAT,1962,43,15-19,2005,0.0023561482401832797
STAT,1955,26,30-34,1981,60.31480302523767
SIM,1935,19,25-29,1954,126
STAT,1861,34,40-44,1895,4.125055078780832
STAT,1945,45,20-24,1990,0.014559276343792385
STAT,1852,33,25-29,1885,9.89524573709024
SIM,1856,47,30-34,1903,1
STAT,1799,80,na,1879,352.7666744236552
STAT,1917,83,na,2000,1782.5191615097199
STAT,1955,19,30-34,1974,18.660892279891744
STAT,1847,51,50-100,1898,0.011676477806228748
SIM,1813,86,na,1899,86
SIM,1985,10,na,1995,6448
STAT,1847,15,20-24,1862,17.22802904498296
SIM,1830,49,25-29,1879,1
STAT,1882,98,na,1980,38.69287553041549
STAT,1930,47,35-39,1977,0.19596940744028296
SIM,1818,45,na,1863,2139
STAT,1887,23,45-49,1910,0.8990752840817948
SIM,1860,33,25-29,1893,11
STAT,1863,22,45-49,1885,0.7176977538989651
SIM,1909,23,40-44,1932,3
STAT,1963,11,na,1974,5760.162228643302
STAT,1927,19,25-29,1946,61.83539740406685
SIM,1836,58,na,1894,1234
SIM,1871,22,45-49,1893,5
SIM,1963,26,30-34,1989,73
STAT,1955,15,20-24,1970,207.81345116083486
STAT,1826,42,40-44,1868,1.6864988666548053
STAT,1962,3,na,1965,5816.721758977336
STAT,1862,101,na,1963,1.9434128011143277
STAT,1976,25,50-100,2001,1.542606433043963
STAT,1929,25,20-24,1954,26.465770239517312
SIM,1939,24,35-39,1963,1
STAT,1883,24,20-24,1907,77.32147011879006
SIM,1880,39,40-44,1919,11
STAT,1815,53,20-24,1868,0.001419305027140028
STAT,1900,46,40-44,1946,0.15508367430559752
SIM,1980,33,na,2013,5814
SIM,1950,13,na,1963,4816
SIM,1817,60,na,1877,1022
SIM,1843,44,40-44,1887,3
STAT,1872,28,30-34,1900,29.078124425165413
SIM,1845,32,45-49,1877,2
SIM,1910,34,45-49,1944,2
STAT,1891,32,na,1923,3403.6388343827794
STAT,1818,89,na,1907,46.482105367929954
STAT,1928,21,50-100,1949,0.9509406371246717
SIM,1867,30,30-34,1897,15
STAT,1902,34,45-49,1936,1.6187733593750147
STAT,1857,37,25-29,1894,2.5878531655502335
STAT,1873,30,50-100,1903,1.0884655604224414
STAT,1896,43,50-100,1939,0.11101716249326501
SIM,1889,39,30-34,1928,1
STAT,1868,35,35-39,1903,7.916704914827499
STAT,1872,39,40-44,1911,5.021605852230145
SIM,1894,49,na,1943,3576
STAT,1960,32,40-44,1992,5.995700194570823
SIM,1884,90,na,1974,175
SIM,1937,36,30-34,1973,1
SIM,1948,26,35-39,1974,1
STAT,1945,32,45-49,1977,2.022074392348755
STAT,1907,64,na,1971,3350.526161127247
STAT,1826,43,25-29,1869,0.47420838582349306
STAT,1903,50,na,1953,3590.287990244125
STAT,1776,92,na,1868,15.807613212408203
STAT,1929,36,30-34,1965,2.702914853481184
STAT,1837,32,45-49,1869,1.5832240968718574
SIM,1861,22,na,1883,1729
STAT,1842,15,na,1857,2295.2491343398865
STAT,1859,30,30-34,1889,16.284614266350424
SIM,1964,35,25-29,1999,1
STAT,1881,40,50-100,1921,1.1878332756236538
STAT,1853,36,50-100,1889,1.2351228291283973
STAT,1827,69,na,1896,1191.8219084538912
SIM,1891,24,20-24,1915,108
SIM,1939,41,na,1980,4929
STAT,1956,35,25-29,1991,1.5517312451100345
SIM,1854,34,45-49,1888,5
SIM,1891,29,45-49,1920,2
STAT,1851,17,30-34,1868,1.5367077927762465
STAT,1859,45,40-44,1904,0.15895402715731596
STAT,1913,21,45-49,1934,1.2627224133932655
SIM,1878,20,35-39,1898,8
SIM,1928,23,20-24,1951,8
SIM,1938,16,na,1954,3866
STAT,1861,10,na,1871,2665.4557265580984
SIM,1863,24,15-19,1887,6
SIM,1978,25,20-24,2003,31
SIM,1982,25,40-44,2007,7
SIM,1913,9,na,1922,5106
SIM,1840,60,na,1900,1584
STAT,1878,50,na,1928,2631.755025437138
SIM,1879,35,50-100,1914,3
SIM,1916,32,na,1948,4566
STAT,1957,26,50-100,1983,1.5217218932997756
STAT,1865,24,na,1889,2456.891851068163
STAT,1932,41,25-29,1973,0.11188017330059555
STAT,1840,19,20-24,1859,18.197158204700095
STAT,1917,42,na,1959,4472.973849444812
STAT,1909,23,45-49,1932,1.2044596472619853
SIM,1927,53,na,1980,4777
STAT,1855,24,15-19,1879,3.232494983002277
SIM,1863,35,25-29,1898,1
STAT,1868,24,25-29,1892,63.07473460276826
STAT,1876,86,na,1962,450.70923039016884
STAT,1978,34,15-19,2012,0.2060356603688236
SIM,1982,23,20-24,2005,1
SIM,1835,22,50-100,1857,3
SIM,1895,90,na,1985,32
STAT,1824,43,15-19,1867,0.0193251653263393
STAT,1971,22,45-49,1993,1.6500602336089012
SIM,1921,21,45-49,1942,2
SIM,1854,38,30-34,1892,12
SIM,1982,19,25-29,2001,2
STAT,1833,40,50-100,1873,0.9309196526123847
SIM,1889,37,40-44,1926,12
STAT,1885,23,35-39,1908,6.696518767848702
SIM,1913,27,25-29,1940,2
STAT,1787,92,na,1879,9.079519693689216
STAT,1850,33,15-19,1883,0.15177515387014318
SIM,1965,26,50-100,1991,2
STAT,1824,46,30-34,1870,0.13324373217052285
STAT,1922,72,na,1994,3605.3669898905064
STAT,1958,46,35-39,2004,0.2037754386952718
STAT,1931,46,na,1977,5684.287525994404
SIM,1873,87,na,1960,194
STAT,1856,8,na,1864,2556.510342163393
SIM,1913,38,35-39,1951,5
SIM,1928,34,30-34,1962,55
SIM,1906,31,20-24,1937,3
SIM,1974,2,na,1976,6408
STAT,1851,15,40-44,1866,0.17843934933311556
STAT,1940,24,50-100,1964,0.7732753492260155
STAT,1846,38,30-34,1884,5.694158544501936
STAT,1959,44,na,2003,5807.038857171529
STAT,1872,113,na,1985,8.94633418061911E-4
STAT,1864,21,na,1885,2494.1420464803978
STAT,1974,11,na,1985,5920.321894859357
STAT,1845,18,15-19,1863,5.024649436072367
STAT,1862,45,50-100,1907,0.24158249917556396
SIM,1839,47,25-29,1886,1
SIM,1893,35,40-44,1928,3
STAT,1885,35,40-44,1920,5.086839867905707
STAT,1877,48,50-100,1925,0.2911247327055395
SIM,1906,33,40-44,1939,8
SIM,1895,20,40-44,1915,7
STAT,1784,111,na,1895,1.246216191633249E-4
SIM,1889,23,50-100,1912,1
STAT,1922,24,15-19,1946,6.997698780062904
STAT,1899,12,na,1911,4083.1288222457883
STAT,1872,24,45-49,1896,0.8029991950043653
SIM,1853,18,15-19,1871,4
STAT,1823,52,50-100,1875,0.014373301371558277
SIM,1967,24,40-44,1991,8
STAT,1860,51,50-100,1911,0.014114408495741429
STAT,1895,40,45-49,1935,2.270926426928056
STAT,1856,41,15-19,1897,0.012213870449405632
SIM,1930,26,50-100,1956,4
SIM,1839,49,45-49,1888,1
SIM,1940,35,na,1975,4995
STAT,1920,27,20-24,1947,23.09885896165076
STAT,1829,45,25-29,1874,0.0603456036733128
SIM,1883,18,30-34,1901,3
STAT,1830,89,na,1919,65.90184682451945
STAT,1959,24,40-44,1983,5.089046257501661
SIM,1973,22,na,1995,5453
STAT,1938,15,15-19,1953,51.92986226489785
SIM,1862,66,na,1928,1917
STAT,1863,76,na,1939,956.0346549423434
SIM,1968,33,na,2001,5331
STAT,1955,32,50-100,1987,1.2911348948404737
STAT,1871,44,15-19,1915,0.01564141093035479
SIM,1864,14,na,1878,3035
SIM,1905,18,30-34,1923,7
STAT,1829,34,15-19,1863,0.1719428951850463
SIM,1905,44,50-100,1949,1
STAT,1943,47,45-49,1990,0.276681539883171
STAT,1897,46,30-34,1943,0.0844993696471804
SIM,1887,29,25-29,1916,3
STAT,1857,39,45-49,1896,1.7737337973185008
STAT,1852,35,45-49,1887,1.9293384863220893
STAT,1842,16,50-100,1858,0.04869921804755498
SIM,1827,41,na,1868,1455
SIM,1984,27,40-44,2011,10
SIM,1856,32,20-24,1888,3
SIM,1871,42,50-100,1913,2
STAT,1965,20,25-29,1985,133.61410860549378
SIM,1796,81,na,1877,227
STAT,1939,49,45-49,1988,0.2597207065342001
SIM,1888,24,na,1912,2999
STAT,1939,67,na,2006,3710.5804726560737
SIM,1880,37,20-24,1917,5
STAT,1850,47,40-44,1897,0.17541951653054955
STAT,1826,40,20-24,1866,0.12281257767394038
STAT,1887,20,40-44,1907,2.7111180570362317
STAT,1943,34,na,1977,4712.223063422503
SIM,1849,84,na,1933,476
SIM,1866,40,na,1906,2466
SIM,1860,30,20-24,1890,3
STAT,1976,27,40-44,2003,7.217463971595165
SIM,1891,27,25-29,1918,108
STAT,1832,37,na,1869,1830.3479279344112
STAT,1863,42,50-100,1905,1.0647638201684464
STAT,1939,41,50-100,1980,0.14129563567188008
STAT,1868,39,20-24,1907,0.8460901925190171
SIM,1901,95,na,1996,177
STAT,1790,96,na,1886,1.6730191633979197
STAT,1931,17,25-29,1948,65.47359467432496
SIM,1860,35,45-49,1895,5
SIM,1888,26,50-100,1914,2
SIM,1835,27,40-44,1862,3
SIM,1840,19,25-29,1859,11
SIM,1838,22,na,1860,1953
STAT,1861,37,45-49,1898,1.9125655453970278
STAT,1935,4,na,1939,6371.151479869332
SIM,1935,28,15-19,1963,1
STAT,1931,28,35-39,1959,22.36324277135807
STAT,1848,32,20-24,1880,3.3493499948338004
STAT,1879,29,25-29,1908,50.60969000269733
SIM,1797,66,na,1863,748
STAT,1766,109,na,1875,0.007650088475844235
STAT,1910,40,35-39,1950,0.22234353909766577
STAT,1964,33,na,1997,5600.0410091178865
STAT,1819,55,na,1874,1566.051878432826
SIM,1857,19,40-44,1876,2
STAT,1815,41,na,1856,1802.6312403385482
STAT,1833,34,35-39,1867,9.06451865868158
STAT,1849,19,40-44,1868,0.17244865117529165
SIM,1841,34,35-39,1875,29
STAT,1875,22,50-100,1897,0.48632897308420514
STAT,1960,35,45-49,1995,1.0574979880095332
STAT,1846,49,40-44,1895,0.17328821472322242
STAT,1914,19,50-100,1933,0.08900190874266582
SIM,1916,19,45-49,1935,1
STAT,1862,50,35-39,1912,0.00850513259939731
STAT,1827,27,40-44,1854,11.548601632761844
SIM,1865,37,25-29,1902,4
SIM,1990,11,na,2001,6331
STAT,1875,54,30-34,1929,0.00690376589212728
SIM,1962,35,50-100,1997,1
STAT,1841,34,30-34,1875,18.44724345339535
STAT,1930,24,na,1954,5365.760605257843
STAT,1987,17,45-49,2004,0.8229930390648408
SIM,1964,32,20-24,1996,7
STAT,1954,35,50-100,1989,0.6181793526966852
SIM,1858,43,40-44,1901,6
STAT,1830,43,45-49,1873,1.4165177272765517
STAT,1894,29,20-24,1923,17.279677776566974
STAT,1873,52,30-34,1925,0.00697767462519876
STAT,1857,34,20-24,1891,2.4087373258048896
STAT,1921,29,50-100,1950,1.2705887120315424
STAT,1852,30,20-24,1882,2.694017762250687
STAT,1908,19,45-49,1927,0.1113682658255828
STAT,1985,15,45-49,2000,0.8203759617837798
SIM,1917,23,45-49,1940,3
STAT,1851,54,45-49,1905,0.011191799471722386
SIM,1939,21,30-34,1960,74
SIM,1873,10,na,1883,3705
SIM,1849,33,50-100,1882,2
STAT,1837,41,35-39,1878,1.5672446961423916
STAT,1877,68,na,1945,1834.5169869636798
STAT,1883,27,25-29,1910,47.7622079787715
STAT,1899,21,50-100,1920,0.6466919014543944
STAT,1909,90,na,1999,637.0271334625255
SIM,1889,23,15-19,1912,9
STAT,1826,45,45-49,1871,0.17429767347865321
STAT,1933,25,40-44,1958,7.151681277195778
SIM,1843,47,45-49,1890,1
SIM,1973,20,25-29,1993,137
STAT,1956,32,20-24,1988,3.796760926280518
STAT,1858,52,35-39,1910,0.007709354942925902
SIM,1995,17,45-49,2012,3
SIM,1906,54,na,1960,3353
STAT,1902,31,40-44,1933,7.100470323481408
SIM,1865,34,20-24,1899,3
SIM,1902,40,na,1942,3956
STAT,1850,36,30-34,1886,5.63156882434493
SIM,1926,25,45-49,1951,5
STAT,1934,45,45-49,1979,0.351269004975856
STAT,1908,46,na,1954,3868.100460557082
SIM,1948,23,30-34,1971,81
STAT,1904,32,na,1936,3988.2796791626693
STAT,1956,43,30-34,1999,0.20256922977180467
STAT,1859,33,35-39,1892,9.270571895916726
STAT,1880,32,na,1912,2919.034083050916
STAT,1788,77,na,1865,505.3627023552786
SIM,1845,41,35-39,1886,5
STAT,1924,23,40-44,1947,4.563320041544559
SIM,1932,23,40-44,1955,7
STAT,1872,37,20-24,1909,0.8932613915585635
STAT,1856,110,na,1966,0.0018112533825758686
SIM,1898,25,15-19,1923,2
STAT,1835,47,45-49,1882,0.1552390978656679
STAT,1841,45,40-44,1886,0.15687078104288565
STAT,1889,46,35-39,1935,0.19972514935873364
STAT,1918,25,45-49,1943,2.1357246488972335
SIM,1873,4,na,1877,3807
STAT,1859,22,25-29,1881,54.60142563082742
STAT,1881,25,25-29,1906,47.406395896747554
STAT,1941,21,50-100,1962,0.7851909381966069
SIM,1867,22,25-29,1889,58
SIM,1915,28,na,1943,4392
STAT,1849,27,25-29,1876,38.86530420227321
SIM,1899,33,25-29,1932,22
SIM,1874,26,50-100,1900,3
SIM,1884,49,20-24,1933,1
STAT,1928,45,15-19,1973,5.44966594388113E-4
SIM,1893,8,na,1901,3820
STAT,1899,74,na,1973,2312.073598041322
STAT,1924,26,45-49,1950,2.3287140214171815
STAT,1898,49,40-44,1947,0.14747514797894481
STAT,1880,38,30-34,1918,6.487023299413915
SIM,1919,74,na,1993,3558
STAT,1896,26,15-19,1922,0.693945769833808
STAT,1943,20,40-44,1963,4.131643148945812
SIM,1947,31,30-34,1978,3
STAT,1828,108,na,1936,0.0012157138862299698
STAT,1833,106,na,1939,0.008543787832811673
SIM,1872,5,na,1877,3477
STAT,1850,72,na,1922,1300.0821589311504
SIM,1928,37,35-39,1965,5
SIM,1992,15,na,2007,6202
STAT,1948,26,30-34,1974,51.99437824635838
STAT,1955,21,50-100,1976,1.0117226576828178
STAT,1889,49,30-34,1938,0.076055086918118
STAT,1959,50,na,2009,5716.550844879247
SIM,1965,26,40-44,1991,8
SIM,1932,26,45-49,1958,4
STAT,1911,33,40-44,1944,4.382856090032045
STAT,1992,16,50-100,2008,0.6207855574099089
STAT,1925,19,15-19,1944,62.90860378917729
STAT,1815,44,30-34,1859,2.4166081458490756
SIM,1885,13,na,1898,3398
STAT,1848,68,na,1916,1623.7522346726996
SIM,1844,90,na,1934,78
SIM,1838,29,40-44,1867,3
STAT,1887,67,na,1954,2050.198703484299
STAT,1820,37,20-24,1857,1.6915481671245163
STAT,1882,110,na,1992,0.028880294775860113
SIM,1824,76,na,1900,82
STAT,1836,27,15-19,1863,0.5344713618707555
STAT,1865,49,45-49,1914,0.2406056435793174
STAT,1941,34,35-39,1975,11.061060338876587
STAT,1908,27,50-100,1935,1.0964910969421258
STAT,1989,21,15-19,2010,8.831154023526764
STAT,1844,21,35-39,1865,6.138228608458913
STAT,1939,31,30-34,1970,18.57002367048016
SIM,1929,17,50-100,1946,1
STAT,1980,27,25-29,2007,105.90534770085796
SIM,1902,18,na,1920,4268
SIM,1953,24,na,1977,5293
SIM,1862,40,35-39,1902,4
STAT,1866,101,na,1967,3.5334806706620343
STAT,1973,31,20-24,2004,3.7130622704387397
SIM,1852,21,35-39,1873,19
STAT,1909,36,20-24,1945,0.28966238090533736
STAT,1952,45,20-24,1997,0.015971842420498587
SIM,1829,29,30-34,1858,46
SIM,1956,26,30-34,1982,136
SIM,1844,27,15-19,1871,1
SIM,1877,18,na,1895,3416
STAT,1932,34,25-29,1966,14.16465891383959
SIM,1907,25,40-44,1932,13
STAT,1835,21,25-29,1856,53.497656194159234
SIM,1955,19,35-39,1974,8
STAT,1978,21,40-44,1999,5.314862434569023
SIM,1928,20,40-44,1948,3
STAT,1822,75,na,1897,845.8335208896583
STAT,1900,23,25-29,1923,91.38732226965456
STAT,1975,34,35-39,2009,14.163452249455228
SIM,1922,29,25-29,1951,4
STAT,1813,80,na,1893,283.2380972158631
SIM,1833,53,na,1886,1409
STAT,1959,27,45-49,1986,2.6192338391001684
STAT,1875,17,25-29,1892,6.7581143795569005
STAT,1976,37,45-49,2013,1.082866320736296
STAT,1950,16,45-49,1966,0.6818367637928966
SIM,1982,16,30-34,1998,46
SIM,1839,44,na,1883,2012
STAT,1879,36,25-29,1915,3.4861857882680733
STAT,1898,30,20-24,1928,4.249795608584683
STAT,1886,15,35-39,1901,0.6710531489436412
STAT,1901,26,35-39,1927,15.65085218588213
STAT,1942,16,50-100,1958,0.45204683487134223
STAT,1974,16,30-34,1990,18.37278780717819
STAT,1862,91,na,1953,56.43725690479852
STAT,1833,37,30-34,1870,4.726077157322856
SIM,1981,31,20-24,2012,1
STAT,1880,30,35-39,1910,12.487420012889858
STAT,1854,48,30-34,1902,0.07787175589141937
STAT,1857,22,15-19,1879,3.4231506314028253
SIM,1917,36,20-24,1953,5
STAT,1954,35,15-19,1989,0.028274319081582046
SIM,1874,38,40-44,1912,4
STAT,1847,19,30-34,1866,1.512701889075433
SIM,1873,49,45-49,1922,1
SIM,1887,36,25-29,1923,4
SIM,1800,82,na,1882,215
SIM,1905,33,50-100,1938,1
STAT,1876,49,20-24,1925,0.014016844917926435
STAT,1947,19,35-39,1966,5.451158020094527
SIM,1852,47,50-100,1899,2
SIM,1823,44,30-34,1867,1
SIM,1825,58,na,1883,1473
SIM,1884,41,25-29,1925,3
STAT,1915,44,35-39,1959,0.23322384743387434
SIM,1806,73,na,1879,669
SIM,1987,18,30-34,2005,1
STAT,1874,25,50-100,1899,0.7608901481212911
SIM,1855,19,30-34,1874,6
SIM,1967,27,45-49,1994,4
STAT,1851,53,30-34,1904,0.004644550829031823
SIM,1933,19,15-19,1952,103
SIM,1841,37,30-34,1878,10
STAT,1842,77,na,1919,665.1715699448446
STAT,1884,43,40-44,1927,2.5461449020464197
SIM,1894,71,na,1965,2577
STAT,1890,41,15-19,1931,0.019561632750106348
SIM,1848,32,25-29,1880,21
SIM,1939,36,40-44,1975,3
STAT,1819,71,na,1890,888.593344870603
SIM,1907,55,na,1962,4110
SIM,1962,1,na,1963,5600
STAT,1952,30,na,1982,5337.568788683667
STAT,1902,89,na,1991,681.6945975986731
SIM,1886,20,na,1906,2131
SIM,1867,41,na,1908,2243
STAT,1881,46,50-100,1927,0.2741606963667456
STAT,1891,33,15-19,1924,0.20226149340552307
STAT,1965,36,30-34,2001,2.7077769168975783
STAT,1876,41,25-29,1917,0.7695460914289292
SIM,1920,37,na,1957,4152
SIM,1929,26,30-34,1955,9
STAT,1920,37,25-29,1957,1.2435662460238153
STAT,1981,19,25-29,2000,69.88380070195466
SIM,1925,30,40-44,1955,9
SIM,1856,35,25-29,1891,4
SIM,1895,30,45-49,1925,11
STAT,1896,25,45-49,1921,1.7039015470324212
STAT,1887,30,45-49,1917,2.2734539985554454
STAT,1897,18,15-19,1915,9.133812554056323
STAT,1916,15,30-34,1931,2.998575012252692
STAT,1966,28,50-100,1994,1.4402318849614215
SIM,1849,68,na,1917,1925
SIM,1852,26,na,1878,2004
SIM,1973,36,30-34,2009,5
STAT,1798,76,na,1874,342.6566734268347
STAT,1946,4,na,1950,5099.778710118307
STAT,1832,53,na,1885,1487.5225856864786
STAT,1907,20,30-34,1927,30.42526363343739
STAT,1902,9,na,1911,4230.881408454092
STAT,1914,29,25-29,1943,76.0640465153876
SIM,1980,17,35-39,1997,10
STAT,1969,41,40-44,2010,0.3752745439694332
SIM,1819,46,na,1865,1113
STAT,1915,22,na,1937,4357.102126405514
SIM,1940,51,na,1991,4862
STAT,1903,15,20-24,1918,29.277152626970143
STAT,1927,16,45-49,1943,0.718403123554965
STAT,1983,16,40-44,1999,2.2841078984201095
STAT,1991,21,na,2012,6061.6031016263605
STAT,1925,18,45-49,1943,0.6943540643125514
STAT,1887,15,50-100,1902,0.06365671480099523
SIM,1941,34,30-34,1975,1
STAT,1917,30,40-44,1947,4.767270913847455
STAT,1933,34,30-34,1967,24.48207509709261
SIM,1936,12,na,1948,4118
SIM,1979,33,na,2012,6327
SIM,1869,82,na,1951,182
STAT,1916,95,na,2011,232.8694890564818
SIM,1935,16,45-49,1951,1
SIM,1986,11,na,1997,6746
STAT,1770,98,na,1868,0.2660305890163493
STAT,1837,74,na,1911,803.6291154019293
STAT,1906,41,20-24,1947,0.01864318687741158
STAT,1894,37,na,1931,3495.184492829207
SIM,1843,21,25-29,1864,4
STAT,1968,29,20-24,1997,26.399025823106747
STAT,1972,32,na,2004,5696.376590217204
SIM,1895,37,na,1932,3570
STAT,1814,40,na,1854,2060.3750914900584
STAT,1984,5,na,1989,6444.473233709344
SIM,1887,33,20-24,1920,11
STAT,1974,19,35-39,1993,6.319051073191404
SIM,1944,31,50-100,1975,5
SIM,1840,23,na,1863,2271
SIM,1865,35,35-39,1900,4
STAT,1841,48,45-49,1889,0.20809331227753863
STAT,1967,34,30-34,2001,23.121135163205153
SIM,1956,5,na,1961,5523
STAT,1862,75,na,1937,1002.626482475259
STAT,1938,19,25-29,1957,49.32391874784477
STAT,1940,23,na,1963,4293.088915211511
STAT,1892,29,50-100,1921,0.9186599370540741
STAT,1958,27,na,1985,5702.718196487918
STAT,1937,59,na,1996,4027.130952015477
SIM,1823,42,50-100,1865,1
SIM,1862,10,na,1872,3172
SIM,1870,45,na,1915,2978
SIM,1936,68,na,2004,3175
STAT,1855,35,25-29,1890,2.4731630038294528
STAT,1891,94,na,1985,195.41960234083524
STAT,1907,44,30-34,1951,0.13372857047186537
SIM,1846,73,na,1919,539
STAT,1954,23,20-24,1977,159.10938540693115
SIM,1876,21,20-24,1897,79
SIM,1975,34,30-34,2009,4
SIM,1927,73,na,2000,3257
STAT,1886,44,50-100,1930,1.2686716604589374
SIM,1915,20,30-34,1935,82
STAT,1829,95,na,1924,9.740036454219108
STAT,1856,104,na,1960,0.14897437409106523
STAT,1957,26,40-44,1983,7.125948739431787
STAT,1883,43,na,1926,2590.751795345275
SIM,1945,29,na,1974,4752
STAT,1838,24,45-49,1862,0.7725959597613091
SIM,1857,27,25-29,1884,9
STAT,1860,53,40-44,1913,0.009634639109457437
STAT,1899,18,25-29,1917,8.936022923661294
STAT,1848,35,25-29,1883,3.2187492493804535
STAT,1953,42,45-49,1995,0.24146116784325902
SIM,1879,28,15-19,1907,1
SIM,1930,77,na,2007,3666
STAT,1891,39,45-49,1930,2.8147293128905417
STAT,1939,34,35-39,1973,10.750941615405269
SIM,1844,47,na,1891,2146
SIM,1940,31,20-24,1971,3
STAT,1936,37,50-100,1973,0.47595869649869654
STAT,1967,24,45-49,1991,1.6262656287572745
SIM,1865,15,na,1880,3300
STAT,1878,13,na,1891,3106.9854234604227
STAT,1967,7,na,1974,5666.258860689978
STAT,1868,21,20-24,1889,76.96051874025834
SIM,1869,40,45-49,1909,1
SIM,1787,67,na,1854,1175
SIM,1846,24,45-49,1870,1
SIM,1951,20,40-44,1971,12
STAT,1881,17,na,1898,2811.325683411972
STAT,1913,24,50-100,1937,0.7624031859546526
STAT,1917,42,35-39,1959,0.24252159666904502
SIM,1962,23,20-24,1985,2
STAT,1851,18,50-100,1869,0.04695664774452536
SIM,1911,92,na,2003,584
STAT,1895,46,20-24,1941,0.010197206685626362
STAT,1976,23,40-44,1999,5.1995020358271935
STAT,1933,35,na,1968,5926.645086878818
SIM,1951,32,35-39,1983,3
STAT,1915,78,na,1993,2455.29627218364
STAT,1941,31,30-34,1972,19.105689497859355
SIM,1919,58,na,1977,5027
STAT,1834,52,40-44,1886,0.009850976274302169
SIM,1917,95,na,2012,243
STAT,1913,90,na,2003,676.2482636614538
STAT,1923,15,30-34,1938,16.587994720853956
STAT,1926,42,45-49,1968,0.2367312106862367
SIM,1921,62,na,1983,4743
SIM,1909,29,25-29,1938,155
STAT,1850,56,na,1906,2099.693160481249
STAT,1932,31,20-24,1963,3.745101510961503
SIM,1833,23,20-24,1856,3
STAT,1832,99,na,1931,1.2902733038909093
STAT,1924,2,na,1926,5619.044043029918
SIM,1930,36,20-24,1966,1
SIM,1960,32,45-49,1992,2
SIM,1870,61,na,1931,2484
STAT,1909,39,25-29,1948,1.0658985215629657
STAT,1912,29,15-19,1941,0.7978811714853957
SIM,1902,24,na,1926,4182
STAT,1963,48,50-100,2011,0.3439718005303076
STAT,1874,25,25-29,1899,50.31595648497103
STAT,1943,32,35-39,1975,11.400593616872177
SIM,1911,26,45-49,1937,6
STAT,1981,16,30-34,1997,19.674762821282986
SIM,1834,42,40-44,1876,2
STAT,1918,22,40-44,1940,4.184132836864519
STAT,1947,16,30-34,1963,15.84936859135284
STAT,1922,36,20-24,1958,0.3463250708907371
STAT,1951,42,35-39,1993,0.287582873822456
SIM,1977,8,na,1985,6243
SIM,1908,80,na,1988,1554
STAT,1907,80,na,1987,1924.4456970582603
SIM,1955,16,30-34,1971,51
STAT,1911,36,45-49,1947,0.7641921188556886
STAT,1828,50,35-39,1878,0.007966772531203202
SIM,1983,31,30-34,2014,9
STAT,1879,33,20-24,1912,3.2434912810784664
STAT,1857,29,na,1886,2177.8036310163234
SIM,1917,22,30-34,1939,91
SIM,1984,3,na,1987,6307
STAT,1909,22,30-34,1931,30.861909318061194
STAT,1903,26,45-49,1929,1.8313541927897183
STAT,1949,41,40-44,1990,0.34938443085759835
STAT,1972,17,35-39,1989,6.200252854263287
STAT,1813,64,na,1877,961.0863808350841
SIM,1941,37,35-39,1978,1
STAT,1893,21,na,1914,3460.355918600806
SIM,1844,24,35-39,1868,6
SIM,1848,48,40-44,1896,1
STAT,1911,66,na,1977,3441.1322533333628
SIM,1965,27,na,1992,5566
STAT,1884,46,45-49,1930,0.2698561553544544
SIM,1973,24,35-39,1997,2
STAT,1915,41,30-34,1956,0.14878013207113283
SIM,1806,57,na,1863,1335
STAT,1975,37,na,2012,5901.083110080181
SIM,1839,31,45-49,1870,3
STAT,1875,64,na,1939,2073.1582776701416
STAT,1918,48,25-29,1966,0.06494933329698353
STAT,1900,20,20-24,1920,111.01184368518942
STAT,1975,31,30-34,2006,24.464428599558026
SIM,1889,35,20-24,1924,2
SIM,1886,14,na,1900,2380
STAT,1865,43,15-19,1908,0.01427569412106985
STAT,1873,54,20-24,1927,8.457162427591571E-4
SIM,1849,22,na,1871,2805
STAT,1965,24,35-39,1989,13.601650879030599
SIM,1859,16,35-39,1875,1
SIM,1868,57,na,1925,2631
SIM,1910,3,na,1913,4135
STAT,1857,35,35-39,1892,6.417592600638488
SIM,1820,80,na,1900,877
STAT,1873,45,30-34,1918,0.11521512470275065
SIM,1943,46,na,1989,5308
STAT,1933,37,35-39,1970,3.803697289761325
STAT,1952,48,15-19,2000,5.284271450711548E-4
STAT,1836,24,35-39,1860,6.910997863510007
STAT,1854,40,35-39,1894,1.4901504755040194
SIM,1956,29,35-39,1985,5
STAT,1898,33,25-29,1931,15.907773168310285
SIM,1948,19,35-39,1967,3
STAT,1901,23,30-34,1924,28.704277074929283
SIM,1934,42,45-49,1976,2
SIM,1953,39,50-100,1992,2
STAT,1838,105,na,1943,0.02539785941472148
STAT,1924,39,na,1963,5107.406361838203
SIM,1958,33,40-44,1991,18
STAT,1895,46,50-100,1941,0.20870282190272868
STAT,1988,18,50-100,2006,0.6181872376619519
SIM,1931,15,30-34,1946,47
SIM,1940,8,na,1948,5128
STAT,1865,46,40-44,1911,0.1787691611192724
SIM,1931,78,na,2009,3404
STAT,1948,29,35-39,1977,19.89396959200508
STAT,1945,39,50-100,1984,0.544142245922599
STAT,1976,34,40-44,2010,6.142235161742752
STAT,1961,16,20-24,1977,202.19968485457645
STAT,1948,49,na,1997,5017.100491636571
STAT,1813,44,20-24,1857,0.5499612865233383
STAT,1824,58,na,1882,1319.6540601474105
SIM,1865,44,25-29,1909,2
STAT,1889,50,na,1939,3107.132372491169
SIM,1944,18,20-24,1962,1
SIM,1891,25,35-39,1916,31
STAT,1878,21,45-49,1899,0.842778268373409
STAT,1878,30,35-39,1908,12.300751241462956
STAT,1911,37,15-19,1948,0.02142342898738538
SIM,1826,31,35-39,1857,6
STAT,1927,41,na,1968,5381.899902440794
SIM,1929,29,35-39,1958,34
STAT,1867,48,40-44,1915,0.1821481968259022
STAT,1900,48,na,1948,3558.1874575670586
STAT,1944,38,25-29,1982,1.258584523344604
STAT,1924,18,50-100,1942,0.513391074126591
STAT,1865,86,na,1951,231.0299234283235
STAT,1910,84,na,1994,1448.285978674049
SIM,1862,48,30-34,1910,1
STAT,1906,44,25-29,1950,0.07403081470100406
SIM,1933,27,35-39,1960,49
STAT,1857,44,25-29,1901,0.5693867845127537
STAT,1853,49,50-100,1902,0.2394185484970968
SIM,1905,25,30-34,1930,9
STAT,1907,27,na,1934,4052.256053980497
SIM,1774,94,na,1868,24
SIM,1831,24,25-29,1855,54
SIM,1939,23,20-24,1962,5
STAT,1862,54,45-49,1916,0.013745431681664422
STAT,1936,18,20-24,1954,149.49093118936275
SIM,1886,30,35-39,1916,30
STAT,1883,25,35-39,1908,10.968442744036226
STAT,1886,85,na,1971,731.5890309849332
SIM,1859,46,na,1905,2188
STAT,1969,44,45-49,2013,0.24851381909926168
STAT,1920,62,na,1982,4264.276262242532
SIM,1915,23,35-39,1938,1
STAT,1866,38,40-44,1904,4.659222898677265
SIM,1870,17,15-19,1887,6
STAT,1946,27,35-39,1973,19.300200007245284
STAT,1822,45,15-19,1867,7.779442260010704E-4
SIM,1922,26,20-24,1948,32
SIM,1932,56,na,1988,5139
SIM,1954,27,35-39,1981,28
STAT,1982,7,na,1989,6383.030484412974
SIM,1850,42,50-100,1892,2
STAT,1914,26,20-24,1940,21.319606007040097
STAT,1807,47,30-34,1854,0.40296497420682653
STAT,1907,23,35-39,1930,9.877880194061786
STAT,1862,17,15-19,1879,6.619667605690199
SIM,1985,18,20-24,2003,227
STAT,1818,48,20-24,1866,0.014600709497726821
SIM,1904,46,20-24,1950,1
SIM,1857,63,na,1920,1934
STAT,1982,26,20-24,2008,29.784498847635412
STAT,1857,21,45-49,1878,0.7287911917759478
STAT,1882,18,na,1900,2839.44223450259
SIM,1947,15,50-100,1962,1
STAT,1973,34,25-29,2007,14.043480646031592
STAT,1891,36,40-44,1927,6.273763167186563
STAT,1844,38,20-24,1882,0.6742911197603362
STAT,1893,38,40-44,1931,6.353872205797476
SIM,1992,21,na,2013,6966
SIM,1882,64,na,1946,2515
SIM,1975,21,40-44,1996,5
SIM,1907,37,35-39,1944,6
STAT,1868,46,50-100,1914,0.27308647644104034
SIM,1940,34,25-29,1974,24
SIM,1918,28,20-24,1946,4
STAT,1935,26,20-24,1961,28.744046657101652
SIM,1901,41,35-39,1942,2
STAT,1842,21,na,1863,2090.270765915526
STAT,1967,37,35-39,2004,3.5922526504680503
SIM,1815,47,30-34,1862,1
STAT,1939,9,na,1948,4590.5064676760085
SIM,1839,45,35-39,1884,1
SIM,1952,38,25-29,1990,4
STAT,1845,26,na,1871,1787.149747888042
STAT,1826,84,na,1910,183.1662008329806
SIM,1904,22,20-24,1926,114
SIM,1943,26,20-24,1969,31
STAT,1918,33,50-100,1951,1.0094310787282401
SIM,1958,44,40-44,2002,1
STAT,1900,34,50-100,1934,1.4546731248548965
STAT,1879,22,35-39,1901,7.031863657566528
SIM,1989,19,35-39,2008,8
STAT,1838,21,40-44,1859,2.359204867301309
SIM,1887,22,35-39,1909,12
STAT,1973,10,na,1983,5864.520071891398
STAT,1907,47,35-39,1954,0.13346673519090396
STAT,1958,43,30-34,2001,0.2010651328136231
STAT,1870,70,na,1940,1596.3114599148555
SIM,1975,37,35-39,2012,10
STAT,1945,48,25-29,1993,0.06936377892873385
STAT,1892,28,40-44,1920,4.317634727059471
SIM,1852,38,20-24,1890,1
STAT,1980,24,20-24,2004,178.6103876973829
SIM,1921,34,20-24,1955,1
STAT,1920,34,20-24,1954,3.055583423003934
SIM,1885,69,na,1954,2018
SIM,1897,63,na,1960,2790
STAT,1863,100,na,1963,3.5819543777866696
STAT,1907,45,45-49,1952,0.2282941224673204
STAT,1865,32,15-19,1897,0.14828285500783087
SIM,1878,19,na,1897,2984
STAT,1855,9,na,1864,2465.6924269142405
SIM,1897,32,45-49,1929,3
STAT,1899,15,20-24,1914,28.160288574592727
STAT,1829,31,35-39,1860,13.647321898823133
STAT,1913,34,20-24,1947,2.7781137490902412
SIM,1930,39,25-29,1969,3
SIM,1810,59,na,1869,1130
SIM,1833,26,25-29,1859,5
SIM,1871,46,na,1917,1975
SIM,1967,27,20-24,1994,28
STAT,1837,19,50-100,1856,0.05320228167231661
STAT,1922,39,25-29,1961,1.2896300981436273
STAT,1928,19,30-34,1947,17.628733462897056
STAT,1864,29,40-44,1893,3.064691984301949
STAT,1923,18,35-39,1941,5.669318721727792
SIM,1949,57,na,2006,5544
SIM,1813,49,30-34,1862,1
SIM,1930,34,30-34,1964,36
STAT,1901,18,15-19,1919,9.567964968248852
SIM,1852,20,20-24,1872,68
STAT,1922,34,30-34,1956,20.434330288892262
STAT,1880,88,na,1968,426.78821112320065
SIM,1833,21,30-34,1854,44
SIM,1829,32,20-24,1861,2
STAT,1959,27,20-24,1986,27.674797625016616
STAT,1789,65,na,1854,644.0
STAT,1809,53,35-39,1862,0.020382751924522068
STAT,1967,21,40-44,1988,4.864687748551412
STAT,1970,27,na,1997,5435.195112275236
STAT,1860,49,na,1909,2048.904555784901
SIM,1830,61,na,1891,1298
SIM,1932,35,35-39,1967,6
SIM,1875,32,25-29,1907,33
STAT,1913,44,25-29,1957,0.08013955951486282
SIM,1986,20,25-29,2006,3
STAT,1883,34,25-29,1917,11.465831942179866
STAT,1805,49,30-34,1854,0.3536882554221934
STAT,1870,27,15-19,1897,0.5161883534997536
STAT,1974,17,45-49,1991,0.7527721185353313
STAT,1961,24,40-44,1985,5.026423072249192
STAT,1963,49,na,2012,5569.80161605555
STAT,1833,51,50-100,1884,0.011248630009721
SIM,1824,31,25-29,1855,16
SIM,1962,39,na,2001,5502
SIM,1921,44,25-29,1965,1
STAT,1844,20,20-24,1864,73.01194512416579
STAT,1919,87,na,2006,1186.42092389383
SIM,1891,34,25-29,1925,23
STAT,1912,11,na,1923,4620.005667999885
SIM,1884,32,35-39,1916,22
STAT,1904,44,15-19,1948,0.0015677930457049121
SIM,1936,19,30-34,1955,17
STAT,1971,30,40-44,2001,5.8371013156837055
STAT,1942,29,50-100,1971,1.2046145499527088
SIM,1948,16,30-34,1964,40
STAT,1873,15,25-29,1888,6.757551493559601
SIM,1944,28,na,1972,4411
STAT,1912,17,20-24,1929,31.668378239902147
STAT,1924,35,35-39,1959,3.2962966727317715
STAT,1903,27,15-19,1930,0.7457858922500539
STAT,1855,21,35-39,1876,5.842751545557357
SIM,1863,29,30-34,1892,2
SIM,1867,38,40-44,1905,20
STAT,1918,45,20-24,1963,0.013632695715546424
SIM,1889,38,25-29,1927,4
STAT,1949,44,45-49,1993,0.2313689021585112
SIM,1841,21,15-19,1862,7
SIM,1855,37,na,1892,1848
STAT,1876,32,35-39,1908,12.081375601266513
STAT,1969,34,40-44,2003,5.743164529204833
STAT,1848,42,25-29,1890,0.6814696054485754
STAT,1954,45,30-34,1999,0.13291033056049167
SIM,1911,27,15-19,1938,5
STAT,1987,28,30-34,2015,64.80112870263362
SIM,1857,5,na,1862,3076
STAT,1857,50,50-100,1907,0.013769583963591632
STAT,1930,34,15-19,1964,0.19116520993156325
STAT,1967,26,35-39,1993,21.746388053553556
STAT,1833,21,15-19,1854,4.623023605115168
STAT,1855,29,30-34,1884,22.01467888539902
STAT,1892,70,na,1962,2251.650150643643
SIM,1929,36,na,1965,5247
STAT,1911,89,na,2000,775.8160213787569
SIM,1920,17,20-24,1937,319
STAT,1822,39,20-24,1861,1.6972711473928828
SIM,1863,21,35-39,1884,17
STAT,1823,54,30-34,1877,0.00544418969265258
SIM,1891,60,na,1951,2607
STAT,1823,57,na,1880,1236.7532777267993
STAT,1909,44,40-44,1953,0.26697240781070897
STAT,1970,18,20-24,1988,195.79382741833086
SIM,1939,20,25-29,1959,136
SIM,1973,39,35-39,2012,8
STAT,1835,43,35-39,1878,1.3368420241748469
STAT,1889,32,45-49,1921,2.480707861908607
SIM,1963,21,50-100,1984,4
STAT,1965,39,35-39,2004,3.5825972106540935
STAT,1862,51,40-44,1913,0.01030227681404327
SIM,1830,39,20-24,1869,2
SIM,1977,34,40-44,2011,14
STAT,1884,44,na,1928,2599.7521524145063
SIM,1843,43,35-39,1886,6
STAT,1868,38,15-19,1906,0.061953538797578665
STAT,1898,26,25-29,1924,66.20310854608402
STAT,1930,30,na,1960,5639.87157779159
STAT,1847,27,15-19,1874,0.41960446061050577
STAT,1893,22,25-29,1915,83.50523495373048
SIM,1975,35,45-49,2010,3
SIM,1949,36,35-39,1985,4
SIM,1881,45,30-34,1926,1
STAT,1861,27,40-44,1888,2.894845620855678
STAT,1950,25,35-39,1975,20.593123698317964
STAT,1944,35,20-24,1979,0.33788642477400543
SIM,1924,22,30-34,1946,49
STAT,1901,17,45-49,1918,0.10559270166333386
STAT,1847,25,25-29,1872,39.69015605434281
STAT,1847,25,50-100,1872,0.6002042061580702
STAT,1936,3,na,1939,4484.129356008156
STAT,1791,97,na,1888,1.08177957734124
STAT,1833,38,45-49,1871,1.749112896704553
STAT,1846,46,15-19,1892,4.146865300659792E-4
STAT,1841,42,15-19,1883,0.012758569290061224
SIM,1860,40,25-29,1900,1
STAT,1900,23,na,1923,3775.581271814333
SIM,1949,31,40-44,1980,1
STAT,1838,25,15-19,1863,0.5072692867802204
SIM,1903,29,20-24,1932,39
STAT,1857,38,30-34,1895,4.766521622013504
STAT,1982,27,35-39,2009,24.486243524491787
SIM,1910,75,na,1985,1690
STAT,1883,19,40-44,1902,0.20540693762014464
SIM,1989,22,25-29,2011,174
STAT,1811,54,na,1865,1381.0906338336179
STAT,1851,16,25-29,1867,5.495870712338885
STAT,1945,5,na,1950,5011.356693733623
STAT,1910,19,45-49,1929,0.11373535420772382
STAT,1878,49,30-34,1927,0.11420435035499775
SIM,1881,15,25-29,1896,13
SIM,1933,24,30-34,1957,1
STAT,1916,22,30-34,1938,34.759862445641936
STAT,1872,37,na,1909,2730.1115419151465
STAT,1972,27,20-24,1999,27.08870262768231
STAT,1982,29,25-29,2011,107.24275836756146
STAT,1912,67,na,1979,3426.9073708895157
STAT,1852,31,35-39,1883,9.988931091910208
STAT,1986,22,40-44,2008,5.547307373106115
SIM,1839,23,25-29,1862,132
SIM,1973,23,20-24,1996,7
STAT,1842,21,25-29,1863,55.96430188433314
STAT,1832,40,15-19,1872,0.012044412424673
SIM,1877,34,na,1911,3111
SIM,1905,28,35-39,1933,23
STAT,1888,16,15-19,1904,8.07043339333629
SIM,1841,20,45-49,1861,1
STAT,1893,36,na,1929,3453.248634620322
STAT,1926,65,na,1991,4559.213529933898
STAT,1961,28,15-19,1989,1.0566181164870858
STAT,1800,91,na,1891,31.267875550464822
STAT,1965,23,20-24,1988,160.6811865262623
SIM,1891,19,40-44,1910,1
SIM,1917,39,25-29,1956,3
SIM,1830,37,30-34,1867,2
SIM,1964,39,25-29,2003,1
STAT,1936,31,50-100,1967,0.9278762375979275
STAT,1989,0,na,1989,6547.418403882573
SIM,1896,16,15-19,1912,18
STAT,1797,60,na,1857,1178.837460156882
STAT,1957,38,35-39,1995,3.7877741213772462
STAT,1916,16,45-49,1932,0.12262448813172033
SIM,1848,25,25-29,1873,62
SIM,1834,54,na,1888,1526
SIM,1879,44,na,1923,2647
STAT,1888,15,45-49,1903,0.08902656840053078
STAT,1904,16,na,1920,4195.762576128606
STAT,1836,22,45-49,1858,0.8378306328925634
SIM,1978,7,na,1985,6040
STAT,1970,25,20-24,1995,26.50721811606072
STAT,1807,48,45-49,1855,0.9623249346467293
SIM,1907,34,30-34,1941,40
STAT,1949,10,na,1959,5273.66794728235
SIM,1904,49,25-29,1953,1
STAT,1861,33,35-39,1894,9.674978845572262
STAT,1901,24,45-49,1925,1.1201517656215039
STAT,1907,99,na,2006,53.81875237706534
SIM,1889,33,30-34,1922,46
SIM,1943,34,40-44,1977,1
SIM,1844,22,45-49,1866,2
SIM,1855,25,25-29,1880,6
STAT,1943,28,na,1971,4602.525130313408
STAT,1822,37,30-34,1859,12.966768811354145
STAT,1802,77,na,1879,473.2360386063568
STAT,1847,67,na,1914,1219.7527594570815
STAT,1898,73,na,1971,2348.336524808665
STAT,1937,2,na,1939,4594.147903066261
SIM,1879,19,25-29,1898,18
STAT,1859,71,na,1930,1227.0884943622996
SIM,1921,24,50-100,1945,1
STAT,1935,34,40-44,1969,6.243399054555963
SIM,1859,20,30-34,1879,2
STAT,1930,48,40-44,1978,0.2389763827194427
SIM,1895,6,na,1901,4064
SIM,1966,28,na,1994,5496
STAT,1946,30,50-100,1976,1.0799540747305159
STAT,1877,74,na,1951,1332.240059585041
STAT,1831,39,30-34,1870,5.161945568946473
SIM,1969,38,30-34,2007,7
STAT,1946,37,20-24,1983,0.3476221491291268
SIM,1834,69,na,1903,1151
SIM,1810,44,45-49,1854,3
STAT,1873,81,na,1954,637.2854818521032
STAT,1841,76,na,1917,842.3272602228453
SIM,1868,22,30-34,1890,24
SIM,1918,73,na,1991,2539
SIM,1860,83,na,1943,830
STAT,2000,4,na,2004,6749.382114183315
SIM,1999,5,na,2004,6974
STAT,1871,108,na,1979,0.08688844263469948
STAT,1851,57,na,1908,1593.6269902665467
STAT,1902,41,45-49,1943,0.170237600350655
STAT,1914,1,na,1915,4971.384388264768
STAT,1890,19,40-44,1909,0.2565321503572692
SIM,1943,29,25-29,1972,159
STAT,1957,29,45-49,1986,2.637425082530172
STAT,1860,34,na,1894,2200.5258395072206
SIM,1839,39,40-44,1878,6
STAT,1779,97,na,1876,0.8244880793768143
SIM,1849,42,25-29,1891,4
STAT,1893,45,40-44,1938,0.14227440499972518
STAT,1922,37,35-39,1959,3.174812855107109
SIM,1947,34,35-39,1981,3
STAT,1952,22,40-44,1974,4.665405762438551
STAT,1967,23,30-34,1990,41.55564252563974
SIM,1843,37,40-44,1880,11
SIM,1856,19,na,1875,2456
SIM,1857,24,20-24,1881,100
SIM,1977,37,45-49,2014,1
STAT,1809,47,40-44,1856,0.439496109331702
STAT,1914,77,na,1991,2547.4983982312037
SIM,1960,22,40-44,1982,2
SIM,1922,63,na,1985,4349
SIM,2008,2,na,2010,7735
STAT,1826,36,50-100,1862,1.00752996437552
STAT,1938,16,20-24,1954,154.79405826793078
SIM,1918,96,na,2014,301
STAT,1923,73,na,1996,3551.468094089485
SIM,1883,17,25-29,1900,12
STAT,1871,45,20-24,1916,0.013914872831663505
STAT,1935,29,25-29,1964,103.49648204331602
SIM,1975,23,30-34,1998,6
SIM,1899,30,20-24,1929,2
STAT,1943,23,45-49,1966,1.3811949246699624
SIM,1921,37,25-29,1958,2
STAT,1889,47,40-44,1936,0.13673855039754568
STAT,1982,33,20-24,2015,4.035050819388932
STAT,1900,45,35-39,1945,0.12772248271896175
STAT,1945,54,na,1999,4691.642714226435
SIM,1936,32,50-100,1968,2
STAT,1913,37,25-29,1950,1.1219445022917733
STAT,1928,33,20-24,1961,3.517489388442634
STAT,1847,52,na,1899,1647.9444442675947
STAT,1905,100,na,2005,34.82250941710836
SIM,1880,38,na,1918,3246
SIM,1913,67,na,1980,3710
STAT,1905,49,50-100,1954,0.22657298868852113
SIM,1815,48,45-49,1863,1
STAT,1835,37,40-44,1872,3.3782621301130527
SIM,1887,95,na,1982,163
STAT,1934,11,na,1945,6197.261168962496
SIM,1970,21,50-100,1991,2
STAT,1969,37,45-49,2006,1.0125108009310868
SIM,1897,47,40-44,1944,1
SIM,1903,97,na,2000,97
SIM,1930,37,35-39,1967,4
SIM,1876,52,na,1928,2395
SIM,1909,81,na,1990,2605
SIM,1833,24,35-39,1857,12
SIM,1922,16,35-39,1938,10
STAT,1792,79,na,1871,421.826748266838
SIM,1936,33,20-24,1969,1
SIM,1839,20,20-24,1859,2
STAT,1896,47,na,1943,3414.0476224418117
SIM,1880,23,na,1903,3300
STAT,1894,28,15-19,1922,0.6707162436229753
STAT,1879,29,na,1908,2855.251640892375
STAT,1913,41,20-24,1954,0.020000226655941165
STAT,1802,104,na,1906,0.03183977492384174
SIM,1852,34,50-100,1886,1
STAT,1982,24,30-34,2006,46.795972745529376
STAT,1868,33,50-100,1901,1.0116162935991289
STAT,1990,1,na,1991,6507.622720637306
SIM,1800,66,na,1866,1002
SIM,1893,34,35-39,1927,38
SIM,1964,37,35-39,2001,6
STAT,1883,28,30-34,1911,28.33260567546976
SIM,1888,30,45-49,1918,4
SIM,1823,91,na,1914,191
STAT,1967,35,45-49,2002,1.0142220238351551
STAT,1838,56,na,1894,1766.7514481122919
STAT,1871,71,na,1942,1532.5197768291139
STAT,1978,35,20-24,2013,0.42847550756936337
SIM,1868,41,50-100,1909,6
SIM,1899,49,40-44,1948,1
SIM,1877,19,15-19,1896,8
STAT,1961,27,45-49,1988,2.5870028949063095
STAT,1885,34,35-39,1919,11.557553810076042
STAT,1961,19,25-29,1980,64.56950680802828
STAT,1914,16,35-39,1930,1.004657546014841
SIM,1982,22,15-19,2004,1
STAT,1921,19,20-24,1940,177.32223662570328
STAT,1844,34,50-100,1878,0.8976126724333302
STAT,1805,69,na,1874,869.0295778681325
STAT,1807,95,na,1902,6.5015715737904385
SIM,1829,35,25-29,1864,3
STAT,1990,24,50-100,2014,1.0903271921709694
SIM,1900,24,35-39,1924,11
STAT,1876,113,na,1989,0.001203993486462207
SIM,1839,60,na,1899,1529
STAT,1869,19,15-19,1888,6.645367459070896
STAT,1842,23,15-19,1865,3.1790356933455826
STAT,1990,20,na,2010,6059.483631887453
SIM,1866,53,40-44,1919,2
SIM,1893,70,na,1963,2030
STAT,1849,93,na,1942,22.651673856998457
SIM,1947,39,na,1986,5964
SIM,1872,71,na,1943,1805
SIM,1915,22,20-24,1937,8
SIM,1949,33,30-34,1982,6
STAT,1925,15,40-44,1940,1.9583557437923533
STAT,1816,47,40-44,1863,0.3491474128022211
STAT,1903,18,25-29,1921,9.290434163028435
STAT,1974,23,30-34,1997,43.439756768272616
STAT,1847,22,20-24,1869,65.00350248844566
STAT,1929,16,50-100,1945,0.5531750331712323
SIM,1891,28,30-34,1919,75
STAT,1822,91,na,1913,47.611473017637806
SIM,1990,24,30-34,2014,56
STAT,1826,50,25-29,1876,0.0025619580078772657
SIM,1956,10,na,1966,5517
SIM,1852,42,na,1894,1901
SIM,1853,27,na,1880,2366
STAT,1899,4,na,1903,4159.302612979996
SIM,1948,22,25-29,1970,238
SIM,1915,85,na,2000,1754
STAT,1907,22,20-24,1929,117.01167035599825
SIM,1931,47,50-100,1978,2
STAT,1828,94,na,1922,13.264748136004458
STAT,1965,26,25-29,1991,95.28392840559303
SIM,1920,12,na,1932,4648
STAT,1923,47,50-100,1970,0.3052376347051837
SIM,1937,16,50-100,1953,1
STAT,1857,29,40-44,1886,2.7335790539208222
SIM,1850,23,15-19,1873,3
STAT,1916,18,35-39,1934,1.02483017034588
STAT,1889,33,15-19,1922,0.20172987278254811
STAT,1935,38,15-19,1973,0.030974359916836263
SIM,1939,39,45-49,1978,1
SIM,1914,12,na,1926,4343
SIM,1917,48,na,1965,5255
STAT,1965,21,30-34,1986,41.559789040111106
STAT,1917,33,45-49,1950,1.8936400696849858
STAT,1814,65,na,1879,1256.9975163787722
STAT,1829,79,na,1908,512.150050257154
STAT,1896,114,na,2010,8.556941424335492E-4
STAT,1838,39,40-44,1877,4.482238340529204
STAT,1872,36,15-19,1908,0.06538522531797716
STAT,1858,53,40-44,1911,0.009325717662274573
SIM,1831,43,na,1874,1649
STAT,1855,19,na,1874,2295.8290157134193
STAT,1857,45,na,1902,2042.3411866527524
STAT,1909,47,45-49,1956,0.23073386341346336
SIM,1824,47,40-44,1871,1
STAT,1926,36,15-19,1962,0.02710343390029901
SIM,1998,12,na,2010,6861
SIM,1846,39,40-44,1885,2
SIM,1935,11,na,1946,6477
STAT,1864,15,15-19,1879,7.034320200575644
STAT,1898,35,15-19,1933,0.08841495317997276
SIM,1865,29,40-44,1894,7
SIM,1865,38,30-34,1903,1
STAT,1785,72,na,1857,358.666992581697
STAT,1895,62,na,1957,2800.5104372405635
STAT,1883,99,na,1982,27.390301677838174
STAT,1875,48,na,1923,2649.4359279287833
STAT,1789,107,na,1896,9.559294662186844E-4
STAT,1948,33,30-34,1981,21.19630100382273
SIM,1817,47,40-44,1864,1
STAT,1873,17,15-19,1890,6.993807865714418
STAT,1860,25,50-100,1885,0.6100878953512228
STAT,1903,23,40-44,1926,3.4147332339914356
STAT,1880,47,20-24,1927,0.01461046164024426
SIM,1867,56,na,1923,1959
SIM,1881,17,15-19,1898,11
STAT,1837,90,na,1927,57.090671726451106
STAT,1926,35,45-49,1961,0.9629614173971242
STAT,1842,37,40-44,1879,3.9516206458182035
STAT,1853,2,na,1855,3586.8068000000003
STAT,1921,31,45-49,1952,2.028413372441716
STAT,1835,64,na,1899,1083.4386952497146
STAT,1897,38,50-100,1935,1.885174306442041
SIM,1973,26,25-29,1999,113
STAT,1772,106,na,1878,0.0016479009983644956
STAT,1933,35,45-49,1968,1.0739204445364872
STAT,1802,52,50-100,1854,0.060246395120520185
SIM,1941,35,45-49,1976,1
STAT,1894,30,50-100,1924,1.3702123336225076
SIM,1868,25,35-39,1893,3
SIM,1956,27,45-49,1983,3
SIM,1973,21,30-34,1994,41
SIM,1978,16,na,1994,6030
SIM,1846,57,na,1903,1266
STAT,1971,33,45-49,2004,2.343031686291541
SIM,1850,37,40-44,1887,11
STAT,1862,4,na,1866,2973.1221970950833
SIM,1858,42,35-39,1900,3
STAT,1909,48,15-19,1957,3.899868298445448E-4
STAT,1833,35,40-44,1868,3.9648946427693037
STAT,1852,40,25-29,1892,0.6115433274249297
STAT,1948,27,45-49,1975,2.2914689840674867
SIM,1892,24,50-100,1916,1
SIM,1837,31,35-39,1868,6
SIM,1956,33,30-34,1989,53
STAT,1935,37,45-49,1972,1.1007013546477815
STAT,1957,35,30-34,1992,2.861992925813434
SIM,1832,28,na,1860,2184
SIM,1902,21,40-44,1923,6
STAT,1986,25,45-49,2011,2.8556347159662816
STAT,1811,43,40-44,1854,8.413723720749639
SIM,1859,23,35-39,1882,16
STAT,1859,44,35-39,1903,1.6422194561475831
SIM,1963,17,na,1980,5775
STAT,1849,24,20-24,1873,63.652581636806964
SIM,1889,36,35-39,1925,21
STAT,1820,65,na,1885,992.2276147027379
SIM,1841,35,40-44,1876,4
STAT,1884,24,50-100,1908,0.4620603818358948
SIM,1965,29,45-49,1994,1
SIM,1943,37,45-49,1980,3
STAT,1867,32,25-29,1899,11.03628763820662
STAT,1901,21,40-44,1922,3.378610634845715
STAT,1840,94,na,1934,16.03286200779349
STAT,1946,39,na,1985,4950.65660252946
STAT,1890,42,20-24,1932,0.22366975075555734
STAT,1858,28,40-44,1886,2.7409454980314645
STAT,1802,110,na,1912,1.3191210015966583E-4
STAT,1878,45,50-100,1923,0.29888745068006345
STAT,1898,24,50-100,1922,0.6320410657069497
SIM,1867,31,50-100,1898,5
STAT,1962,18,25-29,1980,64.05830844950691
SIM,1970,18,25-29,1988,157
SIM,1944,50,na,1994,4485
STAT,1964,49,25-29,2013,0.07972818640457126
STAT,1898,48,35-39,1946,0.12162290106920784
SIM,1928,27,30-34,1955,81
SIM,1969,30,45-49,1999,5
STAT,1782,86,na,1868,93.06056353926073
STAT,1998,17,50-100,2015,0.6348408542059432
SIM,1867,41,30-34,1908,3
SIM,1941,7,na,1948,4064
STAT,1843,37,50-100,1880,1.4381268278864936
SIM,1868,23,45-49,1891,1
STAT,1805,60,na,1865,1215.5554653525166
SIM,1922,45,50-100,1967,1
STAT,1900,42,30-34,1942,0.12768734507420934
STAT,1809,48,50-100,1857,0.6217732515422382
STAT,1868,31,25-29,1899,11.403078606987073
STAT,1904,17,25-29,1921,9.391011155095038
SIM,1883,24,25-29,1907,4
STAT,1869,18,45-49,1887,0.0735799584853836
SIM,1942,30,35-39,1972,26
SIM,1846,18,15-19,1864,3
STAT,1875,42,25-29,1917,0.764890669279136
SIM,1951,25,35-39,1976,35
SIM,1933,43,45-49,1976,1
STAT,1873,44,na,1917,2687.006788217535
SIM,1836,30,45-49,1866,5
SIM,1899,34,30-34,1933,40
SIM,1912,17,25-29,1929,24
SIM,1931,23,50-100,1954,4
STAT,1900,24,30-34,1924,28.3452365183985
STAT,1838,18,15-19,1856,6.751395005937142
STAT,1903,28,na,1931,3909.1038454979284
STAT,1934,30,35-39,1964,14.422440705759161
STAT,1943,25,35-39,1968,18.47060140840073
STAT,1975,35,40-44,2010,2.3521210377948654
STAT,1806,54,25-29,1860,0.011977305976846524
STAT,1919,15,na,1934,4963.596094848735
SIM,1845,69,na,1914,1269
STAT,1891,29,40-44,1920,4.24208998219754
STAT,1861,30,30-34,1891,16.885625740897748
STAT,1952,44,15-19,1996,0.002199788733127239
SIM,1905,21,20-24,1926,2
STAT,1947,56,na,2003,4782.421055215743
SIM,1897,24,25-29,1921,5
STAT,1957,36,45-49,1993,1.0696281579797886
STAT,1958,23,50-100,1981,1.0003134569091185
STAT,1946,17,30-34,1963,15.60149474652777
STAT,1960,20,35-39,1980,14.209427175715534
SIM,1995,18,15-19,2013,82
STAT,1827,75,na,1902,836.047144357746
STAT,1987,18,15-19,2005,74.7450066704993
STAT,1857,7,na,1864,2614.7545202166116
STAT,1951,49,15-19,2000,5.234681198345469E-4
STAT,1902,74,na,1976,2436.4526933609727
STAT,1917,35,35-39,1952,2.926893489548084
STAT,1872,90,na,1962,186.67280831977146
STAT,1907,43,25-29,1950,0.07517031425255305
STAT,1852,15,50-100,1867,0.056529251374970425
STAT,1975,18,35-39,1993,6.386457866968254
STAT,1930,25,25-29,1955,96.68274403499495
STAT,1935,61,na,1996,5516.777803192485
STAT,1830,49,20-24,1879,0.010787155925864928
SIM,1800,97,na,1897,7
STAT,1902,26,50-100,1928,1.046679974226603
SIM,1915,81,na,1996,2186
SIM,1925,17,35-39,1942,13
STAT,1932,35,30-34,1967,2.831628537338442
STAT,1940,1,na,1941,4874.83719373095
STAT,1910,16,40-44,1926,0.32096246609623635
SIM,1940,35,30-34,1975,5
STAT,1872,18,50-100,1890,0.05662315477522873
STAT,1835,22,30-34,1857,15.335447855767695
SIM,1968,35,45-49,2003,1
STAT,1885,16,35-39,1901,0.6331754559968114
STAT,1913,22,15-19,1935,5.955950358309279
SIM,1843,22,30-34,1865,48
STAT,1816,46,35-39,1862,0.2898544806984723
STAT,1864,52,20-24,1916,7.563349078588263E-4
STAT,1917,17,35-39,1934,1.0421034131297982
STAT,1881,79,na,1960,970.4309062365148
STAT,1907,25,25-29,1932,72.31403811337114
STAT,1969,40,35-39,2009,0.30252284388321055
STAT,1936,43,20-24,1979,0.020163017360186743
STAT,1835,40,30-34,1875,0.8820592120952437
STAT,1944,22,45-49,1966,1.4020666338887051
SIM,1906,17,na,1923,3912
SIM,1921,91,na,2012,772
STAT,1917,49,25-29,1966,0.06356828441740642
SIM,1957,28,35-39,1985,54
STAT,1851,23,25-29,1874,53.821814756922386
SIM,1965,12,na,1977,5616
SIM,1821,59,na,1880,1163
SIM,1867,26,35-39,1893,11
STAT,1871,49,na,1920,2529.168320782951
STAT,1941,71,na,2012,3466.02747238056
STAT,1839,33,25-29,1872,9.892899401667858
STAT,1852,39,50-100,1891,1.1458823205283513
STAT,1944,10,na,1954,4886.914233339783
SIM,1911,63,na,1974,4096
STAT,1866,37,35-39,1903,7.565634398349299
STAT,1877,2,na,1879,3900.8898757916595
SIM,1929,25,25-29,1954,192
STAT,1952,26,15-19,1978,0.9809729936345752
SIM,1843,40,30-34,1883,2
STAT,1920,6,na,1926,5187.3110217046715
SIM,1873,23,25-29,1896,154
SIM,1915,25,25-29,1940,1
STAT,1965,46,35-39,2011,0.1936956179537979
STAT,1889,24,25-29,1913,80.92604534178817
STAT,1822,60,na,1882,1692.0021167979792
SIM,1802,92,na,1894,23
SIM,1874,37,35-39,1911,8
STAT,1854,20,45-49,1874,0.6771939204201912
STAT,1784,81,na,1865,211.41252556634808
STAT,1891,40,15-19,1931,0.019895962987672523
SIM,1856,36,30-34,1892,12
SIM,1925,32,30-34,1957,41
SIM,1893,31,30-34,1924,8
STAT,1855,111,na,1966,5.817717970516179E-4
STAT,1922,43,20-24,1965,0.023346024375679855
SIM,1878,56,na,1934,2475
STAT,1885,31,30-34,1916,20.180175702060538
SIM,1847,33,25-29,1880,2
STAT,1949,28,35-39,1977,20.22813629269072
STAT,1848,36,30-34,1884,5.89656306552132
STAT,1903,19,30-34,1922,2.605915916779033
SIM,1856,41,na,1897,2081
STAT,1865,23,25-29,1888,59.898735148315566
STAT,1917,32,30-34,1949,19.040092112668038
STAT,1895,87,na,1982,793.9373472538095
STAT,1883,74,na,1957,1329.0769945465709
SIM,1831,39,35-39,1870,8
STAT,1967,25,50-100,1992,1.442320157607991
SIM,1870,76,na,1946,1392
STAT,1809,50,30-34,1859,0.014996282728351318
STAT,1851,41,25-29,1892,0.511531339431379
STAT,1825,33,25-29,1858,19.980158180173586
STAT,1865,39,40-44,1904,4.512226117277097
STAT,1925,15,na,1940,5153.469092168969
STAT,1855,47,30-34,1902,0.08198269085986218
SIM,1944,25,20-24,1969,1
STAT,1962,33,20-24,1995,3.6741531167217354
SIM,1912,35,25-29,1947,1
SIM,1961,2,na,1963,5671
SIM,1816,72,na,1888,1061
STAT,1828,57,na,1885,1386.991644797688
STAT,1936,25,20-24,1961,20.189988769650288
STAT,1828,30,45-49,1858,2.1532244769163347
STAT,1933,15,25-29,1948,67.28756530659096
SIM,1815,59,na,1874,1520
SIM,1951,39,25-29,1990,3
STAT,1943,39,25-29,1982,1.2388689407844864
STAT,1944,40,45-49,1984,0.21540972223582103
SIM,1833,33,25-29,1866,3
SIM,1941,15,25-29,1956,59
STAT,1949,46,35-39,1995,0.18044126790901624
SIM,1873,39,40-44,1912,1
STAT,1904,35,25-29,1939,1.0396587760296905
STAT,1908,40,35-39,1948,0.21771607025204234
SIM,1874,38,na,1912,2586
SIM,1942,55,na,1997,4716
STAT,1771,107,na,1878,0.009889223303471344
STAT,1865,49,na,1914,2293.747404585916
SIM,1866,28,40-44,1894,5
STAT,1857,14,na,1871,2499.060048327876
STAT,1859,41,30-34,1900,1.0616776253689728
SIM,1941,33,25-29,1974,2
STAT,1940,46,45-49,1986,0.2656353612732608
SIM,1955,15,25-29,1970,95
STAT,1790,81,na,1871,213.42251324611658
STAT,1838,29,50-100,1867,0.6948972775377664
STAT,1941,19,50-100,1960,0.4451614591659333
SIM,1844,16,na,1860,2922
STAT,1900,27,35-39,1927,15.451366205934628
STAT,1870,95,na,1965,50.73881167251362
SIM,1982,5,na,1987,6829
STAT,1871,48,25-29,1919,0.0653011261808499
STAT,1840,51,20-24,1891,5.947923598638308E-4
STAT,1803,65,na,1868,839.5554125894412
SIM,1912,17,na,1929,4003
STAT,1818,102,na,1920,0.12971855202882465
STAT,1839,15,25-29,1854,5.94867083291956
STAT,1933,33,25-29,1966,14.371843747365117
SIM,1901,32,45-49,1933,6
SIM,1888,18,20-24,1906,35
SIM,1970,15,20-24,1985,369
STAT,1947,15,25-29,1962,56.36379272122144
STAT,1930,40,45-49,1970,0.25344692313356565
STAT,1943,22,30-34,1965,35.29269341065735
SIM,1898,48,na,1946,3749
SIM,1932,25,na,1957,5491
SIM,1814,77,na,1891,371
STAT,1842,52,na,1894,1648.0962558989233
STAT,1884,18,40-44,1902,0.2080035047743643
STAT,1859,49,na,1908,2025.1049243617306
STAT,1853,39,15-19,1892,0.05534585340986753
SIM,1946,18,50-100,1964,1
SIM,1850,16,na,1866,2200
SIM,1876,21,na,1897,2671
SIM,1931,12,na,1943,6378
SIM,1919,33,15-19,1952,2
STAT,1920,15,15-19,1935,11.83888179563533
STAT,1819,40,na,1859,1946.151812300928
SIM,1899,37,35-39,1936,9
SIM,1968,32,40-44,2000,2
SIM,1771,83,na,1854,48
STAT,1791,101,na,1892,0.12215107485589186
STAT,1981,15,25-29,1996,69.96772439900288
SIM,1904,81,na,1985,2409
STAT,1842,33,30-34,1875,16.062987509333926
STAT,1962,15,20-24,1977,200.578800120616
SIM,1854,8,na,1862,3294
STAT,1894,21,25-29,1915,85.18250843142182
STAT,1964,46,20-24,2010,0.0167495106656596
STAT,1857,103,na,1960,0.31472244709325237
STAT,1924,61,na,1985,4648.4175878906035
STAT,1930,22,20-24,1952,164.41289224131987
STAT,1954,41,45-49,1995,0.24711148089924356
SIM,1926,39,50-100,1965,2
STAT,1829,70,na,1899,1027.8631484693308
STAT,1939,24,30-34,1963,33.30189076994515
SIM,1960,28,50-100,1988,4
SIM,1856,20,15-19,1876,4
SIM,1879,23,20-24,1902,164
STAT,1968,39,15-19,2007,0.02845648042432963
STAT,1901,22,25-29,1923,92.53654304329642
STAT,1976,33,35-39,2009,14.352915339014434
STAT,1929,42,50-100,1971,0.1755852891424676
STAT,1965,42,50-100,2007,0.17590113586982456
SIM,1933,40,40-44,1973,1
STAT,1957,33,40-44,1990,6.065688553758272
STAT,1835,25,35-39,1860,7.997463287701796
STAT,1968,42,40-44,2010,0.37467837984589014
STAT,1925,24,30-34,1949,39.4414903607683
SIM,1876,31,25-29,1907,20
STAT,1918,32,45-49,1950,1.9293170085051274
SIM,1912,33,50-100,1945,2
STAT,1848,20,15-19,1868,4.330022910371794
STAT,1995,20,na,2015,6124.842222507193
SIM,1850,33,30-34,1883,13
STAT,1893,20,50-100,1913,0.5984006519215331
SIM,1948,38,40-44,1986,4
STAT,1961,4,na,1965,5863.550947768606
SIM,1967,45,na,2012,5618
STAT,1914,31,na,1945,4413.543006418898
SIM,1901,31,30-34,1932,10
STAT,1898,48,50-100,1946,0.21336131722784019
SIM,1812,44,50-100,1856,3
SIM,1907,32,40-44,1939,7
STAT,1929,61,na,1990,5062.59874647986
SIM,1919,43,na,1962,5328
STAT,1890,56,na,1946,2876.129126937134
STAT,1969,43,na,2012,5555.37724858038
SIM,1856,39,35-39,1895,16
STAT,1896,19,15-19,1915,8.997441666622597
SIM,1974,27,na,2001,6107
SIM,1856,72,na,1928,1179
SIM,1883,21,20-24,1904,150
STAT,1795,65,na,1860,698.9164245334325
SIM,1839,69,na,1908,1375
SIM,1841,28,40-44,1869,4
SIM,1951,22,30-34,1973,91
SIM,1897,21,20-24,1918,100
STAT,1841,38,40-44,1879,4.538166268666575
STAT,1941,41,35-39,1982,0.2491742003044563
STAT,1956,39,35-39,1995,3.797228539197165
STAT,1867,44,na,1911,2456.7192626455962
SIM,1926,32,45-49,1958,9
STAT,1827,49,15-19,1876,4.932341134177394E-4
STAT,1881,37,30-34,1918,5.932508131075274
STAT,1897,31,20-24,1928,4.188227450373204
SIM,1918,22,45-49,1940,1
STAT,1889,21,20-24,1910,98.3287656822611
SIM,1869,20,25-29,1889,136
SIM,1965,33,40-44,1998,3
STAT,1951,32,30-34,1983,22.069705222357765
STAT,1859,26,35-39,1885,9.08867228323992
SIM,1964,40,na,2004,5836
SIM,1976,24,40-44,2000,7
STAT,1838,17,30-34,1855,1.8239963744416738
STAT,1816,60,na,1876,1162.583707791307
SIM,1862,41,na,1903,2856
STAT,1906,45,30-34,1951,0.09280635147218128
STAT,1945,49,30-34,1994,0.1162094848293593
SIM,1903,68,na,1971,2676
SIM,1824,43,30-34,1867,1
SIM,1981,24,20-24,2005,328
STAT,1853,52,45-49,1905,0.014371916444804718
SIM,1859,35,40-44,1894,8
SIM,1986,28,20-24,2014,3
SIM,1925,35,35-39,1960,1
STAT,1940,44,25-29,1984,0.08669516562474049
SIM,1922,36,25-29,1958,4
STAT,1871,18,na,1889,2901.2527869659098
STAT,1964,1,na,1965,5723.3020389870635
STAT,1936,46,25-29,1982,0.06086273067942748
SIM,1886,51,na,1937,1852
STAT,1949,51,na,2000,5063.497859085542
STAT,1989,15,50-100,2004,0.6196300893527604
SIM,1892,36,40-44,1928,13
STAT,1848,39,35-39,1887,7.585359977857377
STAT,1956,20,15-19,1976,8.161394113274586
STAT,1816,43,30-34,1859,2.511640838025295
STAT,1834,35,50-100,1869,1.4229021088794103
STAT,1869,43,50-100,1912,1.172170300163323
STAT,1933,76,na,2009,3703.7370982201905
STAT,1963,31,50-100,1994,1.2363544174395409
SIM,1879,69,na,1948,1655
STAT,1920,33,15-19,1953,0.16168499503570075
STAT,1978,28,20-24,2006,28.85976966758063
SIM,1976,23,45-49,1999,3
STAT,1917,46,20-24,1963,0.01335459522989959
STAT,1849,52,25-29,1901,0.0027306869736602912
STAT,1953,27,na,1980,5252.436931770419
SIM,1862,46,50-100,1908,1
STAT,1936,15,na,1951,4088.1197644760073
STAT,1919,30,50-100,1949,1.0374561451396345
STAT,1968,23,45-49,1991,1.6266613904790217
SIM,1964,20,15-19,1984,2
STAT,1948,40,na,1988,5111.468424615264
SIM,1980,27,na,2007,5979
SIM,1910,50,na,1960,3339
STAT,1789,96,na,1885,1.314167070879086
STAT,1955,51,na,2006,5779.699787379034
SIM,1837,34,na,1871,2558
STAT,1853,52,na,1905,2132.3224429409115
STAT,1894,74,na,1968,2077.198390662525
STAT,1921,16,50-100,1937,0.49387285915339507
STAT,1892,27,35-39,1919,13.956541424529677
STAT,1936,28,25-29,1964,72.7030885524504
STAT,1962,36,25-29,1998,1.5013210824106316
SIM,1886,20,30-34,1906,31
STAT,1831,47,15-19,1878,3.7059913648493126E-4
STAT,1871,50,45-49,1921,0.016901526345394404
STAT,1869,15,40-44,1884,0.20970768592004524
SIM,1938,49,35-39,1987,1
STAT,1838,87,na,1925,152.6095624881359
STAT,1922,46,25-29,1968,0.07047074198418446
STAT,1850,87,na,1937,181.36861012495322
SIM,1905,24,25-29,1929,213
SIM,1972,28,20-24,2000,3
SIM,1885,38,na,1923,3137
STAT,1785,110,na,1895,1.3637305575005812E-4
SIM,1912,32,20-24,1944,5
STAT,1832,44,25-29,1876,0.53162557794768
SIM,1840,44,25-29,1884,3
SIM,1930,46,25-29,1976,1
SIM,1906,35,30-34,1941,2
STAT,1907,58,na,1965,3589.025860126881
SIM,1882,25,50-100,1907,1
STAT,1881,111,na,1992,0.010902310135062394
SIM,1890,84,na,1974,839
SIM,1944,28,25-29,1972,89
STAT,1904,32,20-24,1936,2.572163983081638
STAT,1943,36,20-24,1979,0.3326933625069099
SIM,1891,38,na,1929,3376
STAT,1884,36,40-44,1920,5.015344071862542
STAT,1912,42,20-24,1954,0.01967554291667584
STAT,1961,43,50-100,2004,0.18174733322022066
SIM,1853,44,50-100,1897,2
STAT,1912,24,20-24,1936,127.47738153004886
STAT,1914,36,25-29,1950,1.1405165183157395
STAT,1965,43,30-34,2008,0.19111937826587944
STAT,1903,36,50-100,1939,0.43769338336168173
STAT,1976,15,na,1991,5678.008524292624
SIM,1808,77,na,1885,531
SIM,1877,15,40-44,1892,1
STAT,1844,87,na,1931,147.36159292500506
STAT,1836,52,na,1888,1982.639500675273
STAT,1951,46,20-24,1997,0.015835921120835945
SIM,1920,24,20-24,1944,144
SIM,1951,36,20-24,1987,1
STAT,1912,36,na,1948,4262.092408271439
STAT,1938,41,na,1979,4402.311022290688
SIM,1879,26,25-29,1905,55
STAT,1840,54,25-29,1894,0.0027632712862986773
SIM,1932,25,30-34,1957,12
SIM,2009,1,na,2010,7172
STAT,1855,87,na,1942,149.9114435505034
SIM,1854,77,na,1931,1059
STAT,1987,21,40-44,2008,5.559618472333634
STAT,1951,17,35-39,1968,5.766502272731836
STAT,1958,31,35-39,1989,14.12721843749331
SIM,1901,16,35-39,1917,3
SIM,1842,27,40-44,1869,2
STAT,1935,44,45-49,1979,0.2701595845493291
STAT,1834,27,40-44,1861,3.584658027520516
SIM,1898,20,20-24,1918,1
SIM,1917,17,na,1934,5665
STAT,1860,35,40-44,1895,4.110221277472873
STAT,1859,31,50-100,1890,0.8457510611547354
STAT,1920,31,na,1951,4798.290616087481
STAT,1897,34,25-29,1931,15.670386969158088
STAT,1900,25,45-49,1925,1.7900526618845636
SIM,1976,27,45-49,2003,5
SIM,1852,30,25-29,1882,9
SIM,1838,27,20-24,1865,22
SIM,1935,42,na,1977,6215
STAT,1923,23,50-100,1946,0.880490178978761
STAT,1830,27,na,1857,1761.137147070584
SIM,1908,30,35-39,1938,16
STAT,1941,9,na,1950,4705.931575824654
STAT,1914,45,50-100,1959,0.26021356659438666
STAT,1818,40,25-29,1858,0.9079148802036385
SIM,1951,18,20-24,1969,353
STAT,1912,27,25-29,1939,74.92678375834836
SIM,1951,61,na,2012,5684
STAT,1965,44,15-19,2009,0.0022917109054244223
SIM,1906,17,30-34,1923,3
STAT,1895,49,25-29,1944,0.04778894067557177
STAT,1893,41,30-34,1934,1.6846305845162508
STAT,1990,18,20-24,2008,223.99510618707467
STAT,1970,28,25-29,1998,95.45109945122864
STAT,1828,88,na,1916,91.11503885609184
STAT,1979,27,20-24,2006,29.130523090350636
STAT,1989,19,30-34,2008,20.134456800188975
SIM,1887,20,45-49,1907,2
SIM,1904,50,na,1954,3859
SIM,1964,30,na,1994,5763
STAT,1968,45,45-49,2013,0.3273871353935587
SIM,1826,40,25-29,1866,4
STAT,1899,43,25-29,1942,0.06999489579848729
STAT,1911,25,20-24,1936,20.70078560191868
SIM,1898,39,40-44,1937,1
STAT,1872,43,15-19,1915,0.015887259920004025
STAT,1849,31,20-24,1880,2.4513278386943234
STAT,1858,36,na,1894,2131.2620028684228
STAT,1946,44,20-24,1990,0.023413759324693476
STAT,1876,24,na,1900,2803.790189356059
STAT,1892,24,30-34,1916,25.603008975683693
STAT,1909,53,na,1962,3817.2565396343084
STAT,1841,22,25-29,1863,64.47574365162981
STAT,1857,32,30-34,1889,15.789865354880176
SIM,1908,43,na,1951,3659
STAT,1893,39,50-100,1932,1.7729062050555566
STAT,1845,17,45-49,1862,0.05563477101708705
STAT,1825,40,na,1865,1982.5071324499243
STAT,1873,13,na,1886,3077.5411976606492
SIM,1907,33,25-29,1940,20
STAT,1924,25,30-34,1949,52.99216969360831
STAT,1860,17,40-44,1877,0.19620256093766408
SIM,1901,34,35-39,1935,13
STAT,1840,26,na,1866,2179.4122842957086
SIM,1823,85,na,1908,388
SIM,1929,22,20-24,1951,290
STAT,1899,25,25-29,1924,67.33527207971386
SIM,1857,31,20-24,1888,1
STAT,1925,27,35-39,1952,20.457840182078932
SIM,1954,44,20-24,1998,1
SIM,1987,27,20-24,2014,61
STAT,1858,46,40-44,1904,0.15456656355146076
STAT,1985,4,na,1989,6454.974018286304
SIM,1900,51,na,1951,3243
SIM,1866,46,40-44,1912,1
STAT,1795,96,na,1891,1.5046276482049625
SIM,1828,69,na,1897,1361
SIM,1939,26,25-29,1965,14
SIM,1925,43,na,1968,5278
SIM,1860,39,50-100,1899,3
STAT,1877,50,40-44,1927,0.012819474806947256
SIM,1842,89,na,1931,137
STAT,1845,20,50-100,1865,0.34608798196550783
SIM,1847,95,na,1942,88
STAT,1912,45,25-29,1957,0.0591656815659107
SIM,1922,33,20-24,1955,8
STAT,1875,21,20-24,1896,82.43284732168641
STAT,1982,28,40-44,2010,7.598242597255261
SIM,1969,40,na,2009,5735
SIM,1887,64,na,1951,2918
STAT,1771,86,na,1857,82.15997895533499
STAT,1797,91,na,1888,23.219676579439668
SIM,1861,39,15-19,1900,2
STAT,1833,28,40-44,1861,2.7954045354579677
STAT,1893,23,30-34,1916,25.902819821110562
STAT,1796,103,na,1899,0.036553990311443844
STAT,1906,18,40-44,1924,0.306995810430625
SIM,1851,31,25-29,1882,24
STAT,1813,47,25-29,1860,0.19106472528046323
SIM,1839,24,30-34,1863,48
SIM,1969,31,40-44,2000,26
SIM,1865,32,30-34,1897,3
SIM,1896,40,45-49,1936,1
SIM,1902,55,na,1957,3561
SIM,1924,21,25-29,1945,154
STAT,1898,27,30-34,1925,39.27571361437428
STAT,1905,43,50-100,1948,0.12165330681134416
STAT,1948,48,40-44,1996,0.21597889308357524
STAT,1925,40,40-44,1965,0.35033002925314444
STAT,1926,20,35-39,1946,13.277428366421828
STAT,1914,33,20-24,1947,2.8228813452476884
SIM,1895,68,na,1963,2374
SIM,1897,26,15-19,1923,1
SIM,1913,31,20-24,1944,1
STAT,1951,35,35-39,1986,3.430405724305711
SIM,1878,87,na,1965,347
STAT,1961,22,na,1983,5462.824268206913
STAT,1897,16,25-29,1913,8.765997007288119
STAT,1921,47,25-29,1968,0.06898522293592317
SIM,1868,21,25-29,1889,3
SIM,1864,17,20-24,1881,27
STAT,1856,17,20-24,1873,18.456709236988075
STAT,1925,22,40-44,1947,4.6432162173087885
STAT,1817,45,na,1862,2056.3266336998
STAT,1831,49,35-39,1880,0.12642841528609725
STAT,1843,31,25-29,1874,12.484170449463882
STAT,1993,18,45-49,2011,0.8291680669436763
STAT,1820,41,30-34,1861,1.4655019555629194
SIM,1947,30,na,1977,5909
STAT,1909,100,na,2009,36.89181237149102
STAT,1905,31,20-24,1936,2.6030959005629
SIM,1848,26,30-34,1874,52
STAT,1834,26,na,1860,2607.4100166952553
SIM,1915,91,na,2006,749
SIM,1907,15,25-29,1922,16
STAT,1889,26,15-19,1915,0.6476382132593579
SIM,1859,38,45-49,1897,3
SIM,1911,32,na,1943,4772
STAT,1880,57,na,1937,2458.263510192269
STAT,1832,22,na,1854,1868.5100300706565
SIM,1893,64,na,1957,2394
SIM,1871,38,25-29,1909,2
SIM,1822,41,na,1863,1681
SIM,1934,20,35-39,1954,42
STAT,1861,87,na,1948,169.02911654107123
STAT,1878,23,35-39,1901,7.009766834314429
SIM,1886,23,35-39,1909,10
STAT,1931,21,20-24,1952,166.9723211220108
SIM,1971,12,na,1983,5819
STAT,1916,21,25-29,1937,112.04948299162376
STAT,1952,32,45-49,1984,2.218259533956155
SIM,1947,24,30-34,1971,1
SIM,1889,68,na,1957,2578
STAT,1984,10,na,1994,6440.220999344857
STAT,1867,51,30-34,1918,0.006444490808529163
STAT,1817,41,25-29,1858,2.032989699188088
STAT,1891,115,na,2006,2.638859630316488E-4
STAT,1842,15,30-34,1857,1.5937353169448196
STAT,1865,40,na,1905,2430.8758197847396
STAT,1970,24,15-19,1994,7.710202438755022
STAT,1839,32,na,1871,2115.106892040665
STAT,1967,48,na,2015,5493.3465394397
STAT,1951,30,40-44,1981,5.487963905628057
STAT,1867,33,30-34,1900,18.733254101763603
SIM,1826,34,na,1860,2013
STAT,1898,45,30-34,1943,0.08601267757484791
STAT,1919,43,15-19,1962,0.001917069111013377
STAT,1858,34,50-100,1892,0.8178207232096204
SIM,1848,44,30-34,1892,4
SIM,1769,85,na,1854,98
SIM,1909,91,na,2000,610
STAT,1941,43,25-29,1984,0.08809635979895651
SIM,1847,33,na,1880,2679
STAT,1950,15,30-34,1965,16.640980664148756
STAT,1940,41,20-24,1981,0.021543339100968117
STAT,1886,79,na,1965,1205.2375666252979
STAT,1863,14,na,1877,2723.975868633037
SIM,1933,23,25-29,1956,164
STAT,1961,34,45-49,1995,2.388454240050767
STAT,1925,23,25-29,1948,127.1625371005603
STAT,1982,25,na,2007,6115.072985268101
SIM,1875,33,30-34,1908,72
STAT,1955,22,na,1977,5613.087641488908
SIM,1942,24,na,1966,4443
SIM,1864,76,na,1940,798
STAT,1863,38,25-29,1901,2.891016210070892
STAT,1930,61,na,1991,5143.999242046026
STAT,1876,53,30-34,1929,0.006987247234739378
STAT,1832,41,20-24,1873,0.13672202407156672
STAT,1964,47,35-39,2011,0.19492633146500482
STAT,1923,41,15-19,1964,0.002073621187828369
STAT,1883,7,na,1890,2941.6875662657344
STAT,1916,37,40-44,1953,1.7693341510225746
SIM,1849,43,30-34,1892,1
SIM,1919,20,50-100,1939,1
STAT,1931,72,na,2003,4199.038481171696
STAT,1805,54,50-100,1859,0.051792943690225926
STAT,1830,47,30-34,1877,0.08931375850218953
SIM,1875,76,na,1951,1096
STAT,1924,28,35-39,1952,20.09714826472513
STAT,1834,88,na,1922,125.28508577450978
STAT,1915,53,na,1968,4182.08675074572
STAT,1959,40,na,1999,5842.59754695856
STAT,1978,10,na,1988,6188.382004789548
SIM,1857,34,25-29,1891,20
STAT,1893,44,35-39,1937,0.1809529852045722
STAT,1867,36,35-39,1903,7.657671282242558
STAT,1970,37,na,2007,5599.382193666707
SIM,1875,36,35-39,1911,16
SIM,1832,34,na,1866,2173
SIM,1911,37,30-34,1948,3
SIM,1932,28,35-39,1960,1
STAT,1946,45,na,1991,4914.229223919387
SIM,1940,20,na,1960,5038
STAT,1972,29,30-34,2001,58.08913323048942
SIM,1886,21,45-49,1907,1
SIM,1924,37,40-44,1961,3
SIM,1793,67,na,1860,1078
STAT,1863,53,20-24,1916,7.32685925545937E-4
SIM,1871,21,na,1892,1895
STAT,1852,14,na,1866,2697.4987801979937
STAT,1899,40,20-24,1939,0.017612464217673766
STAT,1806,51,20-24,1857,0.0026501272948063156
SIM,1825,41,25-29,1866,1
STAT,1843,47,40-44,1890,0.17097797948430013
STAT,1951,15,45-49,1966,0.6868522222095733
SIM,1929,42,na,1971,5226
SIM,1964,38,40-44,2002,7
STAT,1876,38,50-100,1914,1.457406385924237
STAT,1926,40,25-29,1966,0.10185519719857866
STAT,1843,29,40-44,1872,3.6461129570188486
STAT,1977,29,45-49,2006,2.702822487792505
STAT,1921,29,25-29,1950,84.02117769920643
SIM,1902,31,45-49,1933,4
STAT,1867,13,na,1880,2876.5306505514923
STAT,1946,47,25-29,1993,0.07062351881087112
STAT,1945,33,15-19,1978,0.16502850883849848
SIM,1950,27,40-44,1977,18
SIM,1980,29,30-34,2009,3
STAT,1849,34,25-29,1883,8.19348973100258
SIM,1923,17,na,1940,4962
STAT,1896,17,50-100,1913,0.07467763975534997
SIM,1816,41,na,1857,1792
STAT,1865,25,15-19,1890,0.4756255801010534
STAT,1879,20,45-49,1899,0.8452992834285248
SIM,1985,29,45-49,2014,5
STAT,1961,38,30-34,1999,2.7968216054522816
SIM,1914,43,na,1957,3910
SIM,1851,29,40-44,1880,4
STAT,1911,28,25-29,1939,73.87919941735794
STAT,1913,40,15-19,1953,0.001748786049058205
SIM,1982,22,na,2004,6781
STAT,1948,32,25-29,1980,12.442355637555615
STAT,1944,6,na,1950,4928.478518990775
SIM,1812,42,na,1854,1623
STAT,1857,24,50-100,1881,0.3795421064028047
STAT,1917,23,50-100,1940,0.8045832559296997
SIM,1847,17,15-19,1864,14
SIM,1896,13,na,1909,4021
STAT,1955,49,50-100,2004,0.3583103802715825
STAT,1849,87,na,1936,136.5521264139369
SIM,1901,33,na,1934,4128
STAT,1975,28,50-100,2003,1.5212086372450564
SIM,1956,32,25-29,1988,3
STAT,1799,58,na,1857,1374.8714957247498
STAT,1919,49,50-100,1968,0.2813882267002027
SIM,1956,45,na,2001,5373
SIM,1934,3,na,1937,6095
SIM,1896,5,na,1901,4089
STAT,1903,37,30-34,1940,1.8909068474535333
STAT,1878,20,30-34,1898,21.59107012364402
STAT,1935,48,30-34,1983,0.14491427799517073
STAT,1988,1,na,1989,6499.089816570285
STAT,1944,16,15-19,1960,56.381234582509094
SIM,1983,28,50-100,2011,4
STAT,1935,71,na,2006,4568.555887564842
STAT,1966,41,25-29,2007,0.10712393720344875
SIM,1896,22,45-49,1918,5
STAT,1913,38,30-34,1951,2.066490015764037
STAT,1893,26,35-39,1919,14.123372734992945
STAT,1922,26,50-100,1948,1.3036942496662194
STAT,1960,42,35-39,2002,0.3145448457231765
STAT,1987,25,na,2012,6203.8481253657255
SIM,1824,46,35-39,1870,1
SIM,1891,22,30-34,1913,31
STAT,1899,22,20-24,1921,108.95550664133177
STAT,1888,40,45-49,1928,2.0507905488520524
SIM,1983,15,30-34,1998,27
STAT,1902,43,na,1945,3754.469150485407
STAT,1975,15,30-34,1990,18.566917284362866
SIM,1940,61,na,2001,4388
STAT,1944,34,15-19,1978,0.16247522070255854
STAT,1814,42,15-19,1856,0.04727031130274066
STAT,1888,22,45-49,1910,0.9459687321887659
SIM,1921,38,30-34,1959,1
SIM,1907,30,20-24,1937,1
STAT,1912,38,50-100,1950,0.47101567596255217
STAT,1905,54,na,1959,3585.378865630923
SIM,1921,22,15-19,1943,1
SIM,1958,30,na,1988,6186
STAT,1839,17,15-19,1856,6.156647256253989
SIM,1963,49,50-100,2012,1
STAT,1970,26,50-100,1996,1.4447781040205747
STAT,1982,32,15-19,2014,0.21271409258408897
STAT,1937,42,20-24,1979,0.020568889621133322
SIM,1920,38,50-100,1958,1
STAT,1883,22,30-34,1905,20.111711475148017
STAT,1866,34,30-34,1900,18.516097540966868
SIM,1848,36,50-100,1884,1
STAT,1875,24,25-29,1899,67.84346669787357
SIM,1933,25,45-49,1958,5
STAT,1924,90,na,2014,824.1819119412116
SIM,1962,45,na,2007,5439
STAT,1945,23,na,1968,4617.359320998504
STAT,1901,36,na,1937,3856.922129091012
SIM,1957,25,30-34,1982,82
STAT,1832,107,na,1939,0.003212933726562922
STAT,1870,20,25-29,1890,65.51831795971071
STAT,1940,48,35-39,1988,0.15675251332749238
STAT,1920,21,45-49,1941,1.447309524164948
STAT,1951,33,45-49,1984,2.2028867803889893
STAT,1877,53,45-49,1930,0.017141635242528628
STAT,1971,23,15-19,1994,7.8038485943200016
SIM,1965,16,25-29,1981,152
SIM,1865,21,na,1886,3204
STAT,1936,48,15-19,1984,4.2043723539288423E-4
STAT,1820,44,35-39,1864,2.0842920045032924
STAT,1875,79,na,1954,833.7497190784738
STAT,1957,34,25-29,1991,14.316550731641314
STAT,1917,7,na,1924,4948.068759216556
SIM,1981,11,na,1992,6466
SIM,1975,25,40-44,2000,19
STAT,1918,26,15-19,1944,0.8698138036280741
SIM,1972,19,40-44,1991,3
STAT,1953,38,50-100,1991,0.6032595267747826
SIM,1847,30,20-24,1877,2
STAT,1963,32,20-24,1995,3.645311328648389
SIM,1907,25,50-100,1932,4
STAT,1831,46,30-34,1877,0.0908414786230107
STAT,1799,110,na,1909,1.241268574081032E-4
SIM,1927,49,50-100,1976,2
SIM,1874,34,30-34,1908,11
STAT,1942,27,40-44,1969,5.646581066415899
STAT,1896,22,40-44,1918,3.176320848314634
SIM,1878,8,na,1886,3190
SIM,1847,49,40-44,1896,1
STAT,1839,30,20-24,1869,2.693378963632437
STAT,1964,19,40-44,1983,2.03169731037635
STAT,1868,51,45-49,1919,0.01616788366944724
SIM,1965,34,25-29,1999,5
STAT,1880,94,na,1974,132.55902100971414
STAT,1966,22,na,1988,5281.18797759481
SIM,1960,30,25-29,1990,34
STAT,1820,34,na,1854,1600.8592989251488
SIM,1881,76,na,1957,706
SIM,1851,47,40-44,1898,1
STAT,1938,44,50-100,1982,0.13859177930967714
STAT,1834,45,40-44,1879,0.18680362653745486
STAT,1941,16,35-39,1957,4.990548792751415
STAT,1856,19,40-44,1875,0.18817908902889444
SIM,1920,43,na,1963,4119
SIM,1933,20,20-24,1953,190
STAT,1839,49,40-44,1888,0.1348326758056417
SIM,1911,2,na,1913,5225
SIM,1922,19,50-100,1941,1
STAT,1993,15,40-44,2008,2.3236456941612316
SIM,1852,11,na,1863,2467
SIM,1979,17,30-34,1996,43
STAT,1925,43,45-49,1968,0.23209270385008435
SIM,1874,22,25-29,1896,69
STAT,1776,106,na,1882,0.01888568861633997
STAT,1941,40,20-24,1981,0.021882322546704826
SIM,1906,28,50-100,1934,1
STAT,1842,36,35-39,1878,6.45144861505293
SIM,1958,40,40-44,1998,1
STAT,1865,20,20-24,1885,73.68207827648455
SIM,1850,36,35-39,1886,15
STAT,1938,29,40-44,1967,5.326402581462287
STAT,1957,16,25-29,1973,65.95586043285752
STAT,1821,41,45-49,1862,2.9514827403804493
STAT,1949,25,30-34,1974,52.86298782861259
SIM,1825,39,40-44,1864,1
STAT,1964,37,na,2001,5633.83268134444
STAT,1918,44,15-19,1962,0.001877619979440972
SIM,1860,77,na,1937,1332
SIM,1799,55,na,1854,951
SIM,1960,12,na,1972,6321
STAT,1918,90,na,2008,736.7494728140771
STAT,1951,23,na,1974,5033.360840572497
STAT,1811,60,na,1871,1226.5025879381815
SIM,1888,86,na,1974,143
STAT,1866,22,25-29,1888,61.73342538402659
STAT,1869,79,na,1948,781.3258387303057
STAT,1952,30,25-29,1982,13.044019646332263
STAT,1827,44,na,1871,2122.3382772485643
SIM,1966,31,35-39,1997,33
STAT,1925,20,20-24,1945,154.46943121460671
SIM,1842,45,40-44,1887,1
STAT,1925,25,45-49,1950,2.370056523563201
STAT,1817,39,40-44,1856,14.573437467937353
STAT,1956,37,45-49,1993,1.0725234226576896
SIM,1859,21,na,1880,2486
STAT,1940,43,40-44,1983,0.30419847769008623
STAT,1950,18,35-39,1968,5.723993932268248
STAT,1956,19,45-49,1975,0.762325627160476
STAT,1898,67,na,1965,2754.586075891463
STAT,1903,33,45-49,1936,1.6389728771085477
SIM,1873,20,20-24,1893,96
STAT,1994,17,45-49,2011,0.8319077024407441
STAT,1949,43,30-34,1992,0.17804131709631157
STAT,1862,69,na,1931,1429.2880681125241
STAT,1974,22,25-29,1996,139.6539859867667
STAT,1844,30,25-29,1874,10.459859937554397
STAT,1972,22,na,1994,5413.751788823155
STAT,1916,19,40-44,1935,0.3406706488502339
STAT,1958,33,na,1991,5839.748538702578
SIM,1882,25,25-29,1907,60
SIM,1967,20,50-100,1987,3
STAT,1842,18,35-39,1860,0.5390250841240047
SIM,1964,19,45-49,1983,1
STAT,1890,45,25-29,1935,0.08203268052284114
STAT,1922,35,na,1957,4946.762998235577
SIM,1975,11,na,1986,6127
STAT,1867,54,35-39,1921,0.009021073326113108
STAT,1886,33,35-39,1919,12.27576707514246
STAT,1889,43,30-34,1932,1.6236683361646105
STAT,1857,40,15-19,1897,0.01253766812311771
STAT,1872,44,50-100,1916,1.207694123203712
SIM,1855,7,na,1862,2286
STAT,1849,38,50-100,1887,0.9636639398429134
SIM,1975,19,20-24,1994,415
STAT,1993,21,35-39,2014,15.69094522314377
SIM,1939,18,40-44,1957,1
SIM,1838,84,na,1922,73
SIM,1893,34,50-100,1927,2
SIM,1940,16,25-29,1956,123
STAT,1852,50,40-44,1902,0.010068244537126294
STAT,1915,26,35-39,1941,17.736324538181464
STAT,1937,45,25-29,1982,0.062127071434659516
STAT,1984,21,25-29,2005,151.94975645774397
SIM,1949,21,25-29,1970,156
STAT,1850,21,20-24,1871,85.76372746710494
STAT,1970,34,45-49,2004,2.314174282070854
SIM,1881,33,25-29,1914,2
SIM,1878,25,na,1903,2700
STAT,1860,40,20-24,1900,0.14920385637501576
SIM,1894,33,35-39,1927,6
SIM,1917,18,20-24,1935,3
SIM,1878,32,40-44,1910,3
STAT,1853,27,45-49,1880,1.2806015684004288
SIM,1992,21,25-29,2013,13
STAT,1906,73,na,1979,2671.6624086381894
SIM,1872,34,na,1906,2933
SIM,1864,39,na,1903,2721
SIM,1983,21,15-19,2004,16
SIM,1944,57,na,2001,4296
STAT,1987,2,na,1989,6483.277688455242
STAT,1895,33,45-49,1928,2.608501177894269
SIM,1895,39,25-29,1934,10
SIM,1900,39,45-49,1939,3
SIM,1913,0,na,1913,5240
STAT,1810,44,40-44,1854,9.956880828016606
STAT,1901,20,35-39,1921,9.489235170072977
STAT,1964,44,30-34,2008,0.1924744754126929
SIM,1872,27,20-24,1899,21
SIM,1951,35,na,1986,6258
STAT,1864,27,20-24,1891,12.088575172279269
STAT,1872,21,40-44,1893,2.4220125373002546
STAT,1899,17,40-44,1916,0.289182617775959
SIM,1935,34,45-49,1969,3
SIM,1938,44,40-44,1982,1
SIM,1949,29,20-24,1978,3
STAT,1930,44,30-34,1974,0.19350443118956706
STAT,1932,43,50-100,1975,0.18350548388124244
SIM,1953,33,50-100,1986,1
STAT,1956,38,na,1994,5912.95721711228
SIM,1855,37,30-34,1892,4
SIM,1917,89,na,2006,804
SIM,1838,21,45-49,1859,2
SIM,1861,27,45-49,1888,2
STAT,1932,16,25-29,1948,66.40066590345485
SIM,1899,15,25-29,1914,20
SIM,1892,88,na,1980,867
SIM,1915,50,na,1965,4436
STAT,1883,46,30-34,1929,0.10960644539279422
STAT,1915,16,na,1931,4677.336175721299
STAT,1869,43,45-49,1912,1.660574596656631
STAT,1950,47,na,1997,5214.331877768707
SIM,1857,57,na,1914,2111
STAT,1833,31,30-34,1864,16.138094757937754
STAT,1971,15,na,1986,5382.890177940665
STAT,1813,100,na,1913,0.48609784018551394
STAT,1843,53,35-39,1896,0.008499471099981223
SIM,1830,39,na,1869,1932
SIM,1948,25,50-100,1973,2
SIM,1785,78,na,1863,453
STAT,1909,16,na,1925,4386.661784050513
SIM,1925,84,na,2009,1971
SIM,1841,31,30-34,1872,16
STAT,1843,37,na,1880,2508.8219904059747
SIM,1827,41,50-100,1868,6
STAT,1927,35,50-100,1962,0.6033299114295849
STAT,1949,23,40-44,1972,4.526275797952061
SIM,1923,26,35-39,1949,45
STAT,1766,100,na,1866,0.5132350603134377
STAT,1923,11,na,1934,5375.409980032728
STAT,1940,18,40-44,1958,1.638943789192415
SIM,1910,13,na,1923,4015
SIM,1849,21,20-24,1870,94
STAT,1822,69,na,1891,1205.7728178419873
SIM,1946,34,20-24,1980,8
SIM,1877,71,na,1948,1803
STAT,1831,27,25-29,1858,44.097650479439324
STAT,1935,30,na,1965,6048.585326159819
SIM,1865,52,na,1917,2660
STAT,1847,37,30-34,1884,4.254831776734913
STAT,1938,37,25-29,1975,1.155346711045506
STAT,1904,78,na,1982,2086.817092660404
SIM,1955,34,30-34,1989,31
STAT,1881,51,45-49,1932,0.016231482068828088
SIM,1961,24,45-49,1985,10
STAT,1878,19,50-100,1897,0.05871645454106346
STAT,1878,1,na,1879,4138.034440956334
STAT,1957,31,20-24,1988,3.7852613397164445
SIM,1981,6,na,1987,6478
STAT,1847,21,na,1868,2031.4303156219448
STAT,1830,64,na,1894,1090.5015642723135
STAT,1870,46,20-24,1916,0.013691453293417059
SIM,1922,20,45-49,1942,3
STAT,1792,85,na,1877,133.2042080513624
STAT,1861,56,na,1917,1956.8396079065824
STAT,1892,48,na,1940,3213.9546746813185
STAT,1854,38,15-19,1892,0.04552203726699653
STAT,1956,16,50-100,1972,0.5722877222670557
STAT,1943,44,40-44,1987,0.31708013888733877
SIM,1888,49,na,1937,2534
SIM,1880,69,na,1949,2013
STAT,1839,35,15-19,1874,0.05433468180757855
STAT,1894,41,45-49,1935,2.2303708197968106
STAT,1879,51,20-24,1930,8.934613087070905E-4
STAT,1910,44,45-49,1954,0.17947576478387084
STAT,1885,32,na,1917,2746.904750228872
SIM,1946,37,25-29,1983,1
STAT,1951,64,na,2015,4650.554439601172
STAT,1950,21,25-29,1971,126.5004137959285
STAT,1919,46,na,1965,4608.910905348248
STAT,1963,2,na,1965,5769.6754089493
SIM,1874,69,na,1943,1422
SIM,1835,34,40-44,1869,3
STAT,1947,34,30-34,1981,20.84987434033373
SIM,1901,70,na,1971,2756
STAT,1867,36,50-100,1903,1.3292457075325663
STAT,1927,34,45-49,1961,2.230498438621795
SIM,1859,52,na,1911,2002
STAT,1890,23,15-19,1913,4.637645680876146
STAT,1915,31,15-19,1946,0.15168248212587984
SIM,1964,34,40-44,1998,1
STAT,1840,32,15-19,1872,0.13914310382412115
SIM,1923,89,na,2012,1533
SIM,1779,78,na,1857,473
STAT,1989,9,na,1998,6495.651520176768
SIM,1813,92,na,1905,17
SIM,1877,40,40-44,1917,4
STAT,1929,30,na,1959,5550.624219897511
SIM,1896,28,20-24,1924,1
STAT,1956,34,40-44,1990,6.083568167455275
SIM,1868,43,35-39,1911,7
STAT,1837,45,20-24,1882,0.009254357966073464
STAT,1881,70,na,1951,1561.8027296724235
SIM,1932,31,25-29,1963,18
STAT,1901,29,50-100,1930,1.026661142961852
STAT,1914,28,40-44,1942,5.4061336084996325
STAT,1964,27,25-29,1991,96.08448781667411
SIM,1856,17,25-29,1873,8
SIM,1875,2,na,1877,4165
STAT,1888,28,20-24,1916,15.858569469207387
STAT,1961,24,50-100,1985,0.983644508403237
STAT,1809,87,na,1896,81.88525803546865
STAT,1824,31,20-24,1855,6.418054633109111
SIM,1982,18,40-44,2000,7
SIM,1972,27,25-29,1999,99
STAT,1812,49,50-100,1861,0.5508260383803654
STAT,1840,88,na,1928,110.12910534270334
STAT,1827,34,40-44,1861,6.828489736837613
SIM,1971,29,20-24,2000,60
STAT,1891,15,15-19,1906,8.5038852259863
SIM,1811,66,na,1877,1326
STAT,1853,21,na,1874,2533.4101823228343
STAT,1903,39,20-24,1942,0.27074064172680207
STAT,1824,64,na,1888,1092.658407459747
STAT,1803,96,na,1899,2.992789973612018
STAT,1863,35,20-24,1898,0.7852589845553396
STAT,1928,15,20-24,1943,198.0567050879167
SIM,1912,48,na,1960,3606
STAT,1925,46,na,1971,5148.645036895951
SIM,1922,28,40-44,1950,1
SIM,1984,26,na,2010,5967
STAT,1924,31,25-29,1955,12.448083312658973
STAT,1963,35,25-29,1998,1.4898339918280525
STAT,1990,19,35-39,2009,6.930362257428211
SIM,1859,45,50-100,1904,1
STAT,1848,17,25-29,1865,7.463990536893458
STAT,1967,19,20-24,1986,195.31025474579013
STAT,1845,42,45-49,1887,1.0269929030112799
STAT,1953,24,45-49,1977,1.574922221018564
SIM,1911,39,20-24,1950,1
STAT,1838,37,20-24,1875,0.805855085613701
STAT,1830,29,30-34,1859,28.941080486294897
SIM,1932,62,na,1994,4908
STAT,1834,53,25-29,1887,0.0032493527846505234
STAT,1839,52,30-34,1891,0.004695537536959599
STAT,1902,47,20-24,1949,0.010986261962007726
STAT,1896,44,15-19,1940,0.001442033229901347
STAT,1892,49,45-49,1941,0.1885342305449666
SIM,1832,31,20-24,1863,2
SIM,1909,32,50-100,1941,2
STAT,1914,20,45-49,1934,1.2812302268323388
SIM,1819,42,45-49,1861,1
STAT,1883,30,15-19,1913,0.16208387017245635
STAT,1859,18,na,1877,2435.0851016892757
STAT,1915,23,30-34,1938,34.18633835186953
SIM,1874,16,30-34,1890,2
SIM,1853,42,45-49,1895,4
SIM,1900,36,40-44,1936,1
STAT,1941,30,na,1971,4588.88178791275
SIM,1883,71,na,1954,1260
STAT,1892,30,25-29,1922,14.934341732501451
STAT,1884,44,25-29,1928,0.7223175884070732
STAT,1955,47,25-29,2002,0.0845291642985748
STAT,1857,17,35-39,1874,0.5796631023924035
STAT,1836,42,35-39,1878,1.9611688667194613
STAT,1947,42,15-19,1989,0.0020746501833772434
STAT,1965,18,50-100,1983,0.5396163002043155
STAT,1980,31,35-39,2011,14.932012059113738
SIM,1960,41,na,2001,6188
SIM,1841,42,na,1883,1864
STAT,1963,29,30-34,1992,57.63917838333733
STAT,1831,24,20-24,1855,89.08217529633575
STAT,1866,16,30-34,1882,1.7603110123757701
SIM,1849,16,40-44,1865,1
SIM,1939,29,50-100,1968,2
STAT,1962,40,50-100,2002,0.1810316765284598
STAT,1823,50,45-49,1873,0.01437177439664642
STAT,1849,26,40-44,1875,2.7721401766590175
STAT,1897,36,15-19,1933,0.08707107385086099
STAT,1900,22,40-44,1922,3.3369190839855847
SIM,1810,50,na,1860,1378
SIM,1870,30,45-49,1900,5
SIM,1863,57,na,1920,1993
STAT,1876,36,45-49,1912,2.3896338314600833
STAT,1894,43,na,1937,3415.8018433225557
SIM,1912,19,15-19,1931,20
SIM,1958,15,40-44,1973,6
STAT,1929,29,30-34,1958,56.53887179040982
STAT,1852,53,45-49,1905,0.013462811697595509
SIM,1954,31,45-49,1985,2
STAT,1921,16,na,1937,4851.992526802628
STAT,1940,23,20-24,1963,130.72153995516848
STAT,1938,18,50-100,1956,0.42658079139991484
SIM,1828,60,na,1888,1671
STAT,1987,24,45-49,2011,1.8585810432031384
SIM,1844,42,35-39,1886,3
STAT,1818,95,na,1913,5.882759603924112
STAT,1811,91,na,1902,29.836958650147686
STAT,1937,39,30-34,1976,2.0998957883867315
STAT,1791,66,na,1857,834.2602854130322
STAT,1904,19,15-19,1923,9.78210916473233
SIM,1937,29,30-34,1966,1
STAT,1817,103,na,1920,0.09922056129685608
STAT,1873,30,20-24,1903,3.211133020902565
SIM,1919,84,na,2003,1539
SIM,1916,15,35-39,1931,3
STAT,1872,99,na,1971,16.25788813133706
STAT,1966,16,35-39,1982,6.050124422723072
STAT,1883,49,35-39,1932,0.15477247825513749
SIM,1949,16,45-49,1965,2
SIM,1895,36,20-24,1931,3
STAT,1844,19,na,1863,2411.932671533418
STAT,1866,40,25-29,1906,0.6938218699294904
STAT,1983,32,na,2015,6293.692465061986
SIM,1836,32,35-39,1868,22
STAT,1983,23,30-34,2006,47.06095314262141
SIM,1858,46,45-49,1904,1
STAT,1810,47,45-49,1857,0.9183878415523556
SIM,1865,17,35-39,1882,2
SIM,1883,22,50-100,1905,2
STAT,1858,54,25-29,1912,0.0031011340354003894
STAT,1923,33,30-34,1956,20.823475914802785
STAT,1939,60,na,1999,4112.317370562365
STAT,1862,32,35-39,1894,9.863077815490925
SIM,1941,31,35-39,1972,11
SIM,1904,13,na,1917,4427
STAT,1831,77,na,1908,678.1736197556098
SIM,1822,32,50-100,1854,1
STAT,1829,53,50-100,1882,0.01327372166574446
STAT,1843,50,30-34,1893,0.006058504707932923
STAT,1968,39,50-100,2007,0.6221620615506507
SIM,1868,40,30-34,1908,3
SIM,1963,19,30-34,1982,28
SIM,1991,23,30-34,2014,55
STAT,1887,36,20-24,1923,1.0017550124114671
STAT,1972,37,15-19,2009,0.029233241380418593
SIM,1992,15,30-34,2007,48
STAT,1908,15,35-39,1923,0.9449073906166855
SIM,1898,23,25-29,1921,163
SIM,1923,23,30-34,1946,46
SIM,1919,80,na,1999,2239
SIM,1899,2,na,1901,4594
STAT,1973,24,30-34,1997,43.0100941544033
SIM,1863,26,na,1889,2508
STAT,1905,95,na,2000,197.1230788294829
SIM,1860,15,na,1875,2919
SIM,1974,16,35-39,1990,7
STAT,1873,27,30-34,1900,29.67661330626476
SIM,1881,27,30-34,1908,5
STAT,1850,24,25-29,1874,69.72032978776528
STAT,1980,21,na,2001,5871.75805816313
SIM,1935,31,40-44,1966,13
STAT,1933,31,35-39,1964,14.226793944063743
STAT,1886,107,na,1993,0.39460636373025476
SIM,1957,23,40-44,1980,8
STAT,1819,52,45-49,1871,0.02687584344310474
STAT,1903,45,15-19,1948,3.7458820193650145E-4
SIM,1844,84,na,1928,277
SIM,1828,41,40-44,1869,4
SIM,1887,40,35-39,1927,5
STAT,1901,41,30-34,1942,0.12963634940456148
SIM,1854,31,40-44,1885,5
STAT,1867,75,na,1942,1109.2334750596624
STAT,1845,63,na,1908,1202.3621735188513
STAT,1972,21,45-49,1993,1.6686070993576234
SIM,1877,9,na,1886,3485
SIM,1924,67,na,1991,4042
STAT,1965,22,15-19,1987,7.694774242759643
SIM,1969,34,45-49,2003,3
STAT,1890,87,na,1977,705.4788719404736
SIM,1877,43,50-100,1920,2
STAT,1877,28,45-49,1905,1.3281660873271102
SIM,1885,28,45-49,1913,2
SIM,1837,38,25-29,1875,8
SIM,1967,45,35-39,2012,1
STAT,1947,37,35-39,1984,3.2393745303726216
STAT,1927,31,40-44,1958,5.5574189849071045
STAT,1850,19,na,1869,2853.674224295649
SIM,1813,61,na,1874,1157
SIM,1832,34,25-29,1866,20
SIM,1936,37,30-34,1973,3
STAT,1912,47,15-19,1959,4.0894770653691345E-4
SIM,1890,53,na,1943,3052
SIM,1931,33,30-34,1964,4
SIM,1961,21,40-44,1982,5
STAT,1905,34,25-29,1939,9.739566573924932
STAT,1879,40,35-39,1919,2.204082615005848
SIM,1815,41,30-34,1856,3
SIM,1854,15,na,1869,3086
STAT,1824,34,25-29,1858,17.18380414981417
SIM,1997,15,50-100,2012,1
STAT,1854,22,35-39,1876,5.585956819277628
STAT,1854,46,50-100,1900,0.20065767023057712
SIM,1913,34,25-29,1947,22
STAT,1925,45,35-39,1970,0.18108919746628763
SIM,1898,79,na,1977,1708
STAT,1837,37,na,1874,1888.2848025949475
STAT,1839,63,na,1902,1415.0420938489576
SIM,1844,100,na,1944,8
STAT,1816,69,na,1885,831.158805678399
SIM,1945,39,30-34,1984,2
SIM,1955,37,35-39,1992,4
SIM,1879,44,25-29,1923,1
SIM,1839,27,35-39,1866,20
STAT,1841,46,25-29,1887,0.052107077874795106
STAT,1879,54,25-29,1933,0.004150819927031938
STAT,1870,49,25-29,1919,0.06416463541174942
STAT,1918,6,na,1924,5033.507907705094
STAT,1932,28,na,1960,5661.19989469193
STAT,1888,74,na,1962,1766.5803934138223
SIM,1930,67,na,1997,5173
SIM,1919,12,na,1931,5645
STAT,1865,29,50-100,1894,0.6613229593180294
STAT,1946,31,45-49,1977,2.0542660094349703
STAT,1909,18,20-24,1927,30.636321429841235
STAT,1931,24,25-29,1955,137.4207185068037
STAT,1878,39,15-19,1917,0.06698274583620539
STAT,1885,38,45-49,1923,2.2833391920032056
SIM,1804,100,na,1904,1
STAT,1875,114,na,1989,3.939479756498547E-4
STAT,1939,32,15-19,1971,0.1513758783257706
STAT,1873,75,na,1948,1213.2106108020548
STAT,1823,42,25-29,1865,0.6747132806824265
STAT,1907,89,na,1996,730.6658667709214
STAT,1928,37,30-34,1965,2.658123391164047
STAT,1904,101,na,2005,22.05433434785546
SIM,1914,26,25-29,1940,157
STAT,1953,21,40-44,1974,4.711102969915804
SIM,1836,18,20-24,1854,29
STAT,1889,28,na,1917,3383.0442401224914
SIM,1843,32,50-100,1875,3
STAT,1947,27,na,1974,4890.8856418569985
STAT,1963,49,40-44,2012,0.2390309790692484
SIM,1939,35,na,1974,4938
SIM,1795,62,na,1857,1166
STAT,1907,41,35-39,1948,0.21448068732581368
SIM,1897,28,50-100,1925,2
SIM,1814,46,na,1860,1456
STAT,1892,46,40-44,1938,0.14008028130761768
SIM,1808,46,na,1854,1764
SIM,1870,39,na,1909,3008
SIM,1900,20,25-29,1920,206
SIM,1975,31,35-39,2006,2
STAT,1871,32,45-49,1903,2.002128234399216
STAT,1837,48,25-29,1885,0.0427459853541606
STAT,1846,31,40-44,1877,5.353347935208322
SIM,1945,35,na,1980,4733
STAT,1912,73,na,1985,2921.503095012731
SIM,1982,26,25-29,2008,22
STAT,1829,38,25-29,1867,3.2361850178779172
STAT,1844,19,15-19,1863,6.235720627262981
STAT,1943,7,na,1950,4850.198233721695
SIM,1834,60,na,1894,1375
STAT,1835,32,50-100,1867,0.7284675316892982
SIM,1894,30,30-34,1924,44
STAT,1981,34,20-24,2015,4.0069992041895715
STAT,1886,30,30-34,1916,21.424750567610158
STAT,1938,40,15-19,1978,0.001822750839886822
SIM,1823,32,25-29,1855,3
STAT,1959,45,35-39,2004,0.203396810334452
STAT,1921,44,20-24,1965,0.02287061638924454
SIM,1969,24,15-19,1993,5
STAT,1974,26,25-29,2000,99.65988604404218
SIM,1911,36,50-100,1947,1
SIM,1957,27,50-100,1984,2
STAT,1928,18,25-29,1946,62.848761374102665
STAT,1845,44,50-100,1889,0.7065967680072681
STAT,1906,26,25-29,1932,71.43213225669318
STAT,1860,41,35-39,1901,1.6918744138173978
STAT,1816,110,na,1926,1.364695190036139E-4
SIM,1851,37,50-100,1888,3
STAT,1966,36,45-49,2002,1.0132904454626033
STAT,1823,36,30-34,1859,10.89402154962917
SIM,1880,44,50-100,1924,3
STAT,1888,34,15-19,1922,0.19153264609836343
STAT,1920,49,30-34,1969,0.11300781820760587
STAT,1836,40,45-49,1876,1.662978822413003
STAT,1832,36,40-44,1868,3.8883465698616497
SIM,1936,18,25-29,1954,66
SIM,1873,47,25-29,1920,1
SIM,1838,53,na,1891,1475
STAT,1964,45,50-100,2009,0.3435659187316181
SIM,1882,47,35-39,1929,1
SIM,1873,42,30-34,1915,1
STAT,1919,18,15-19,1937,57.71278969506407
SIM,1892,41,20-24,1933,2
SIM,1914,8,na,1922,4366
STAT,1884,41,20-24,1925,0.1819013047458964
SIM,1818,39,na,1857,2176
STAT,1819,49,na,1868,1749.566769449231
SIM,1862,72,na,1934,1513
SIM,1829,76,na,1905,474
STAT,1863,82,na,1945,470.83307166867604
STAT,1976,30,30-34,2006,24.7887101838397
SIM,1904,26,30-34,1930,53
SIM,1935,35,50-100,1970,1
STAT,1878,42,40-44,1920,2.7069406328926777
STAT,1865,42,30-34,1907,1.1956252025580092
STAT,1832,90,na,1922,53.71331646146066
STAT,1978,19,na,1997,5793.198388542726
STAT,1862,38,na,1900,2283.181494241065
SIM,1927,18,15-19,1945,62
STAT,1875,19,45-49,1894,0.07748554052898182
STAT,1915,88,na,2003,960.2351253625789
SIM,1868,29,20-24,1897,1
STAT,1810,52,25-29,1862,0.012969769388171895
STAT,1874,47,35-39,1921,0.16463149794219012
SIM,1844,40,45-49,1884,2
SIM,1831,36,30-34,1867,14
SIM,1961,43,40-44,2004,1
SIM,1966,38,na,2004,5812
SIM,1940,29,na,1969,4644
STAT,1888,43,na,1931,3112.719942858443
STAT,1846,28,15-19,1874,0.5633358227865908
STAT,1940,26,25-29,1966,77.51786082387028
STAT,1964,30,15-19,1994,0.19060856005385066
SIM,1832,53,30-34,1885,1
STAT,1869,70,na,1939,1568.0873919167498
SIM,1831,80,na,1911,350
SIM,1949,18,35-39,1967,12
STAT,1866,19,35-39,1885,0.5953634718650804
STAT,1813,58,na,1871,1160.7484424798363
STAT,1873,41,45-49,1914,1.7717559277121653
STAT,1865,47,25-29,1912,0.05969673636318743
SIM,1842,58,na,1900,1756
SIM,1840,36,40-44,1876,14
SIM,1853,9,na,1862,2855
SIM,1958,39,na,1997,6142
SIM,1975,30,20-24,2005,6
STAT,1983,26,35-39,2009,24.62735953554577
SIM,1937,35,25-29,1972,1
STAT,1954,49,30-34,2003,0.13151231708783817
STAT,1859,23,30-34,1882,16.867545461941244
SIM,1881,41,45-49,1922,3
STAT,1888,48,40-44,1936,0.12935975029035152
STAT,1956,36,30-34,1992,2.869998267191624
STAT,1977,36,20-24,2013,0.4238636023764865
STAT,1858,51,20-24,1909,6.675170984172673E-4
STAT,1847,40,20-24,1887,0.12607022945730018
STAT,1847,45,15-19,1892,3.1084993099597674E-4
STAT,1819,41,50-100,1860,2.293241476854536
SIM,1886,42,40-44,1928,3
SIM,1849,18,30-34,1867,2
STAT,1824,53,30-34,1877,0.007654075956354367
SIM,1807,61,na,1868,993
SIM,1850,53,na,1903,1341
STAT,1852,45,na,1897,2142.327358248595
STAT,1945,33,50-100,1978,1.0617871441742714
SIM,1845,38,na,1883,2069
SIM,1874,3,na,1877,3360
STAT,1891,32,30-34,1923,24.90311233311067
STAT,1890,42,50-100,1932,1.4878900527499137
STAT,1849,56,na,1905,1580.8555057183337
SIM,1887,33,na,1920,3560
SIM,1914,43,40-44,1957,1
STAT,1824,95,na,1919,8.226630302320423
STAT,1947,40,25-29,1987,0.09673900886396018
SIM,1925,12,na,1937,5602
STAT,1941,39,na,1980,4598.686758757262
STAT,1923,36,35-39,1959,3.23605026896107
STAT,1942,30,30-34,1972,19.393440983676232
SIM,1959,35,45-49,1994,3
SIM,1976,20,40-44,1996,5
STAT,1977,19,15-19,1996,70.71858863220864
STAT,1950,43,35-39,1993,0.28510312986815484
SIM,1931,36,35-39,1967,3
STAT,1885,34,50-100,1919,1.045668831579312
STAT,1954,27,30-34,1981,56.14207772091773
STAT,1840,57,na,1897,1612.1290501909068
STAT,1865,18,na,1883,2694.002088691489
SIM,1962,27,30-34,1989,63
STAT,1840,26,20-24,1866,11.818988660434913
STAT,1915,48,45-49,1963,0.2520832605371346
STAT,1971,39,20-24,2010,0.3961181027792607
STAT,1850,52,50-100,1902,0.015464698526872718
STAT,1827,46,50-100,1873,0.31525677014598663
SIM,1805,66,na,1871,1069
STAT,1937,23,15-19,1960,5.983541837412796
STAT,1959,20,30-34,1979,43.56053429848024
SIM,1830,30,40-44,1860,2
SIM,1826,65,na,1891,1175
SIM,1880,21,40-44,1901,5
STAT,1850,43,30-34,1893,1.1749719151877194
STAT,1837,106,na,1943,0.008792139080358946
STAT,1906,48,35-39,1954,0.13122923296827965
SIM,1823,34,15-19,1857,1
STAT,1856,53,50-100,1909,0.013083704018161491
STAT,1841,41,30-34,1882,1.075846342047537
STAT,1870,64,na,1934,1977.7724130258791
STAT,1883,52,25-29,1935,0.0039779693167519515
STAT,1971,37,30-34,2008,2.744566682210417
SIM,1814,46,40-44,1860,1
SIM,1959,29,15-19,1988,1
SIM,1859,41,35-39,1900,1
STAT,1873,49,40-44,1922,0.19754492063294865
STAT,1968,20,40-44,1988,4.865920276410846
SIM,1950,30,30-34,1980,45
STAT,1950,41,50-100,1991,0.1668362733191178
STAT,1906,46,45-49,1952,0.22466599892978462
STAT,1929,35,25-29,1964,1.461393715447399
STAT,1836,83,na,1919,361.285078746588
STAT,1877,25,40-44,1902,3.6204059866086538
STAT,1876,55,na,1931,2466.7385599842833
STAT,1828,32,35-39,1860,11.676618224856227
SIM,1988,19,20-24,2007,457
SIM,1840,22,15-19,1862,2
SIM,1973,16,na,1989,4806
STAT,1855,56,na,1911,1735.5154923666475
STAT,1830,95,na,1925,8.340515543660336
STAT,1914,21,50-100,1935,0.7470621467504223
SIM,1933,47,na,1980,6334
SIM,1903,20,40-44,1923,4
STAT,1925,42,30-34,1967,0.1785678819598425
STAT,1910,78,na,1988,2275.3232697569956
STAT,1935,39,na,1974,6061.509216012409
STAT,1949,26,45-49,1975,2.329819814238117
SIM,1968,29,25-29,1997,94
SIM,1945,23,15-19,1968,11
STAT,1909,84,na,1993,1426.5054416755193
SIM,1857,26,na,1883,2728
SIM,1837,35,20-24,1872,2
SIM,1914,48,35-39,1962,1
STAT,1896,38,20-24,1934,1.1691662732325416
SIM,1875,36,50-100,1911,3
SIM,1832,65,na,1897,1424
SIM,1930,19,35-39,1949,17
STAT,1832,22,15-19,1854,5.073656900979765
STAT,1829,35,20-24,1864,0.9203076871566912
STAT,1919,77,na,1996,2784.0832366887903
STAT,1959,42,30-34,2001,0.20056490462702728
SIM,1890,32,20-24,1922,3
STAT,1975,16,45-49,1991,0.7607488434893839
SIM,1857,26,40-44,1883,1
STAT,1932,36,45-49,1968,1.0582799101837328
STAT,1922,19,35-39,1941,5.571863024255061
STAT,1916,40,30-34,1956,0.15163045437297412
SIM,1930,30,45-49,1960,7
SIM,1965,36,35-39,2001,2
STAT,1826,90,na,1916,43.4100539915954
SIM,1979,23,15-19,2002,19
STAT,1915,84,na,1999,1562.8421735756278
SIM,1990,20,45-49,2010,1
STAT,1980,17,30-34,1997,19.52748983692329
STAT,1832,54,50-100,1886,0.010482558689642932
STAT,1882,32,20-24,1914,3.0469283634217597
STAT,1862,30,45-49,1892,1.7120166509223669
SIM,1906,48,na,1954,3404
STAT,1877,31,35-39,1908,12.206666113356526
SIM,1909,22,35-39,1931,16
STAT,1901,42,45-49,1943,0.16779383377206405
STAT,1911,49,20-24,1960,0.012013237946184125
STAT,1895,115,na,2010,2.899744037685739E-4
SIM,1828,91,na,1919,116
STAT,1841,24,15-19,1865,3.662525637274346
STAT,1815,48,40-44,1863,0.3444098032400781
STAT,1872,18,15-19,1890,6.858952869722023
STAT,1922,30,45-49,1952,2.067426315061642
SIM,1894,18,na,1912,3953
SIM,1970,37,20-24,2007,1
SIM,1984,30,30-34,2014,9
STAT,1982,20,45-49,2002,1.8344972966706203
SIM,1902,86,na,1988,539
SIM,1963,25,25-29,1988,120
STAT,1886,48,na,1934,2704.343688579944
SIM,1801,73,na,1874,656
SIM,1927,47,na,1974,4893
STAT,1955,25,25-29,1980,101.36145137984346
STAT,1863,16,15-19,1879,6.8740617899969525
SIM,1935,2,na,1937,6681
SIM,1967,20,30-34,1987,102
STAT,1848,22,50-100,1870,0.5275732380476101
STAT,1916,66,na,1982,3725.4093898838955
STAT,1958,47,40-44,2005,0.248570263312276
STAT,1818,64,na,1882,844.754041888988
SIM,1840,38,30-34,1878,5
STAT,1989,25,25-29,2014,109.36549728712941
STAT,1852,52,30-34,1904,0.005582267297844794
STAT,1956,42,25-29,1998,0.11332583226757892
SIM,1871,16,15-19,1887,9
SIM,1839,38,na,1877,2150
STAT,1854,22,50-100,1876,0.3903534222974538
STAT,1986,3,na,1989,6468.5977053469705
STAT,1861,15,35-39,1876,0.6122680209655795
STAT,1825,51,25-29,1876,0.004862054242457787
STAT,1966,38,35-39,2004,3.588270651000002
SIM,1983,30,50-100,2013,1
STAT,1834,57,na,1891,1833.990439713752
SIM,1935,77,na,2012,4079
STAT,1886,31,45-49,1917,2.131449192986701
STAT,1810,50,35-39,1860,0.032832411886225585
STAT,1906,23,20-24,1929,115.61248752327597
STAT,1975,38,45-49,2013,1.0682085796069396
STAT,1856,45,25-29,1901,0.051219473615668164
SIM,1974,33,40-44,2007,3
STAT,1941,0,na,1941,5325.685037436458
STAT,1925,28,50-100,1953,1.351513741516863
SIM,1864,45,25-29,1909,1
STAT,1895,30,40-44,1925,6.566945848468897
STAT,1870,15,45-49,1885,0.07591864487466009
STAT,1846,15,50-100,1861,0.06437891950986079
STAT,1921,88,na,2009,1073.6683631913986
STAT,1946,39,40-44,1985,1.969876878140423
STAT,1847,43,25-29,1890,0.4905411799785119
SIM,1921,19,25-29,1940,135
STAT,1899,19,30-34,1918,2.5065055045694966
STAT,1875,16,40-44,1891,0.2186650786663921
STAT,1834,50,20-24,1884,7.183879352549817E-4
STAT,1823,39,35-39,1862,7.793213358688436
STAT,1848,54,30-34,1902,0.006150822343082335
SIM,1914,23,20-24,1937,130
SIM,1882,44,30-34,1926,2
STAT,1972,15,15-19,1987,67.0942435180244
SIM,1889,99,na,1988,308
SIM,1861,24,40-44,1885,4
SIM,1926,62,na,1988,5244
STAT,1832,38,30-34,1870,4.6322065394094265
SIM,1824,39,na,1863,1672
STAT,1844,25,45-49,1869,1.153367230055639
SIM,1974,38,35-39,2012,3
SIM,1888,18,na,1906,2986
SIM,1918,16,15-19,1934,13
STAT,1869,40,40-44,1909,2.5391746157567745
STAT,1874,51,50-100,1925,0.017928474131982133
SIM,1959,32,40-44,1991,1
STAT,1838,43,15-19,1881,0.012570775024812386
STAT,1874,44,30-34,1918,1.3399382306850878
SIM,1893,33,na,1926,3489
STAT,1950,37,40-44,1987,2.1044912491113847
STAT,1853,24,40-44,1877,2.416246752753455
STAT,1803,103,na,1906,0.050020664430640314
STAT,1913,19,25-29,1932,10.175662457865306
STAT,1962,38,50-100,2000,0.6389624128479318
SIM,1948,49,50-100,1997,1
SIM,1976,17,15-19,1993,58
STAT,1905,23,na,1928,3938.1867643345654
STAT,1968,17,15-19,1985,65.41612388361547
SIM,1894,31,45-49,1925,1
SIM,1970,38,50-100,2008,1
STAT,1842,41,15-19,1883,0.011136565716193779
STAT,1932,38,35-39,1970,3.7475876331998395
STAT,1840,29,25-29,1869,41.70566795117241
STAT,1938,10,na,1948,4526.523193755815
STAT,1837,26,15-19,1863,0.424728771371312
STAT,1967,33,25-29,2000,13.572923884493589
SIM,1940,38,35-39,1978,3
SIM,1975,33,25-29,2008,2
SIM,1854,46,na,1900,2397
SIM,1900,20,na,1920,3294
STAT,1890,17,20-24,1907,24.999360256687535
STAT,1780,111,na,1891,0.0011184696396844855
STAT,1883,27,50-100,1910,0.7222717412600981
SIM,1891,27,50-100,1918,3
SIM,1966,47,40-44,2013,1
STAT,1864,33,15-19,1897,0.14612353348802284
STAT,1837,68,na,1905,1106.6108189860563
STAT,1911,47,30-34,1958,0.09747814184867767
SIM,1937,32,20-24,1969,2
STAT,1946,25,15-19,1971,0.9083053096183462
STAT,1861,49,15-19,1910,3.757498967647529E-4
STAT,1872,20,50-100,1892,0.4753679187084414
SIM,1845,26,15-19,1871,1
STAT,1799,89,na,1888,52.537985278783054
SIM,1913,96,na,2009,536
SIM,1961,28,na,1989,5185
SIM,1847,64,na,1911,1921
SIM,1968,26,20-24,1994,32
STAT,1842,83,na,1925,305.49151082016783
STAT,1857,82,na,1939,419.36927034150926
SIM,1933,28,50-100,1961,3
STAT,1942,8,na,1950,4776.092401156451
STAT,1901,44,35-39,1945,0.2005235206328562
STAT,1929,32,20-24,1961,3.575723936865846
STAT,1975,30,50-100,2005,1.2845430809098657
STAT,1806,48,30-34,1854,0.35101948132953165
SIM,1874,60,na,1934,2050
SIM,1913,28,30-34,1941,60
STAT,1875,70,na,1945,1673.299867601545
STAT,1905,28,30-34,1933,41.91383140650734
SIM,1906,41,25-29,1947,2
SIM,1957,48,45-49,2005,1
STAT,1868,29,na,1897,2627.187535102723
SIM,1904,29,35-39,1933,24
STAT,1907,40,20-24,1947,0.018914728779880482
SIM,1869,45,na,1914,1850
STAT,1878,45,45-49,1923,0.2872045540567631
STAT,1806,76,na,1882,388.8620549928472
SIM,1835,37,45-49,1872,2
STAT,1835,19,40-44,1854,0.25598258409233343
STAT,1850,46,35-39,1896,0.1445316361884101
SIM,1830,33,45-49,1863,1
SIM,1898,3,na,1901,4281
STAT,1836,20,25-29,1856,71.60315627987015
STAT,1872,107,na,1979,0.20290264760315477
SIM,1889,18,35-39,1907,1
STAT,1931,18,30-34,1949,18.367378864029625
STAT,1943,69,na,2012,3758.9097105025667
SIM,1949,28,na,1977,5864
STAT,1805,91,na,1896,23.813524260126858
STAT,1902,12,na,1914,4211.111722846616
SIM,1858,21,30-34,1879,33
SIM,1908,74,na,1982,2235
STAT,1793,61,na,1854,939.9999999999999
STAT,1938,34,20-24,1972,2.8281361515101033
SIM,1855,51,45-49,1906,1
STAT,1941,21,15-19,1962,6.352193958726107
SIM,1909,59,na,1968,4367
STAT,1906,43,40-44,1949,0.2609561008489197
STAT,1933,30,20-24,1963,3.7994244425461923
SIM,1881,45,na,1926,1858
SIM,1907,96,na,2003,127
STAT,1959,23,35-39,1982,14.256310397386148
SIM,1963,22,20-24,1985,333
STAT,1879,0,na,1879,4373.130583851436
SIM,1877,43,45-49,1920,6
SIM,1826,35,45-49,1861,3
SIM,1849,24,25-29,1873,87
STAT,1841,44,35-39,1885,1.630644643488847
STAT,1882,104,na,1986,2.375384846310427
STAT,1891,37,25-29,1928,4.106651276275391
SIM,1875,45,na,1920,3020
STAT,1965,9,na,1974,5661.669082869498
STAT,1943,26,50-100,1969,1.2240261385430466
SIM,1932,47,40-44,1979,1
SIM,1941,30,20-24,1971,5
STAT,1922,16,30-34,1938,16.312165021554467
SIM,1908,27,45-49,1935,5
SIM,1896,44,na,1940,3571
SIM,1880,60,na,1940,2591
STAT,1856,42,20-24,1898,0.1396546696320312
STAT,1858,67,na,1925,1427.1494186558618
STAT,1991,21,50-100,2012,1.0922041153046567
STAT,1917,11,na,1928,4911.996711545446
SIM,1860,46,na,1906,2301
STAT,1909,37,50-100,1946,0.4591398208830868
STAT,1915,45,40-44,1960,0.18424004264797597
STAT,1812,76,na,1888,414.63051224183033
STAT,1887,39,25-29,1926,3.6862542638791056
SIM,1917,37,50-100,1954,1
STAT,1877,37,na,1914,2828.220832420815
STAT,1822,33,45-49,1855,5.882883375150331
SIM,1951,26,50-100,1977,2
SIM,1868,41,45-49,1909,8
SIM,1867,23,30-34,1890,33
SIM,1955,28,na,1983,6085
SIM,1954,39,40-44,1993,5
STAT,1879,48,30-34,1927,0.11518016883644161
STAT,1882,35,25-29,1917,3.276296910028722
SIM,1967,23,35-39,1990,32
SIM,1823,54,na,1877,1907
STAT,1858,6,na,1864,2623.6241488008623
SIM,1972,24,20-24,1996,168
SIM,1934,29,na,1963,5628
SIM,1833,39,50-100,1872,2
STAT,1922,66,na,1988,4170.397546774342
STAT,1924,47,40-44,1971,0.2165550136467173
SIM,1914,74,na,1988,2556
STAT,1898,36,na,1934,3692.257152151785
SIM,1825,80,na,1905,733
STAT,1941,35,40-44,1976,1.8369075748739654
STAT,1993,20,20-24,2013,185.3646252262663
SIM,1844,53,na,1897,2027
STAT,1955,22,20-24,1977,170.91457337370434
SIM,1844,20,25-29,1864,120
SIM,1940,33,40-44,1973,13
STAT,1827,37,45-49,1864,2.9154236052738467
SIM,1903,23,45-49,1926,3
SIM,1949,15,30-34,1964,28
SIM,1915,59,na,1974,4101
STAT,1873,33,25-29,1906,12.01986646289583
STAT,1833,53,40-44,1886,0.0075365460888027975
SIM,1920,74,na,1994,2614
SIM,1958,21,35-39,1979,38
STAT,1901,67,na,1968,2920.379566940573
SIM,1894,19,20-24,1913,48
STAT,1860,43,25-29,1903,0.5929612262446405
STAT,1849,29,45-49,1878,1.005517681298363
STAT,1825,39,50-100,1864,1.9179656012786792
STAT,1917,15,45-49,1932,0.12463630757068168
SIM,1857,29,45-49,1886,4
STAT,1883,37,na,1920,2660.115646942745
STAT,1910,41,40-44,1951,0.27465901755343824
STAT,1992,23,40-44,2015,5.586256426180755
SIM,1890,35,25-29,1925,7
SIM,1934,17,45-49,1951,2
STAT,1886,19,20-24,1905,21.46540369284742
STAT,1964,24,20-24,1988,162.04741302692113
STAT,1970,31,40-44,2001,5.765902305455512
STAT,1932,33,40-44,1965,6.00133447309181
SIM,1959,35,20-24,1994,1
SIM,1939,37,45-49,1976,2
SIM,1882,79,na,1961,1289
STAT,1950,15,40-44,1965,1.9096208080780575
STAT,1837,23,35-39,1860,5.4919680284538295
STAT,1900,33,30-34,1933,27.841229437783255
SIM,1905,23,30-34,1928,45
SIM,1873,40,50-100,1913,1
SIM,1954,26,30-34,1980,116
STAT,1940,38,na,1978,4538.560292267732
STAT,1920,32,45-49,1952,1.9882689301552763
SIM,1975,18,15-19,1993,134
SIM,1982,14,na,1996,6821
SIM,1914,29,40-44,1943,1
STAT,1803,71,na,1874,633.7510669455006
STAT,1906,29,40-44,1935,5.005117586154325
STAT,1971,39,30-34,2010,2.738723859831138
STAT,1897,24,45-49,1921,1.0693241763775594
STAT,1883,76,na,1959,1222.6425558775456
SIM,1855,30,40-44,1885,5
SIM,1877,100,na,1977,117
STAT,1921,25,15-19,1946,0.9138114512961188
STAT,1807,85,na,1892,134.0528358073406
STAT,1898,17,15-19,1915,9.256002090702552
STAT,1954,45,20-24,1999,0.01647648786934944
SIM,1919,38,30-34,1957,7
STAT,1915,27,40-44,1942,5.4875096469054565
SIM,1933,49,45-49,1982,1
SIM,1845,23,35-39,1868,5
STAT,1965,48,45-49,2013,0.3248002495668366
STAT,1906,21,30-34,1927,30.066274179643322
STAT,1930,23,15-19,1953,7.846560602355866
STAT,1943,45,45-49,1988,0.27798376014485787
SIM,1950,50,na,2000,4598
STAT,1953,25,50-100,1978,1.3967841574415132
STAT,1940,30,20-24,1970,2.917544678694945
SIM,1957,15,na,1972,5900
STAT,1831,48,40-44,1879,0.15659737491889636
SIM,1924,43,35-39,1967,1
STAT,1854,63,na,1917,1453.6672874619176
STAT,1858,77,na,1935,778.2001466142499
STAT,1877,20,25-29,1897,69.13022774515319
SIM,1967,39,na,2006,5663
STAT,1925,41,35-39,1966,0.28166341568654607
STAT,1941,17,40-44,1958,1.6630505759851262
STAT,1966,25,45-49,1991,2.5031635668470127
STAT,1934,47,45-49,1981,0.34962347857768167
SIM,1829,40,40-44,1869,2
STAT,1816,46,na,1862,1489.748472998545
STAT,1925,49,45-49,1974,0.3020537293633426
STAT,1781,104,na,1885,0.025267571487300213
SIM,1809,96,na,1905,2
SIM,1951,45,45-49,1996,1
SIM,1936,53,na,1989,3833
SIM,1783,86,na,1869,120
SIM,1914,21,30-34,1935,3
STAT,1847,30,40-44,1877,4.000168721792228
STAT,1860,16,na,1876,2476.9408892498386
STAT,1912,27,15-19,1939,0.8036248285737803
STAT,1931,32,20-24,1963,3.689261845114158
STAT,1964,22,30-34,1986,41.91399868135111
SIM,1915,45,35-39,1960,1
STAT,1909,17,15-19,1926,10.282318471372887
SIM,1856,37,50-100,1893,1
STAT,1967,18,15-19,1985,65.40217103472335
STAT,1796,84,na,1880,129.00044726898622
STAT,1846,21,35-39,1867,7.497243544684558
STAT,1953,36,15-19,1989,0.027644968245453493
STAT,1929,34,30-34,1963,23.066690411507885
SIM,1972,22,30-34,1994,99
STAT,1924,25,40-44,1949,6.3037909043720575
STAT,1841,45,na,1886,2061.5320083443894
STAT,1960,37,45-49,1997,1.0556693055952753
SIM,1899,32,20-24,1931,10
SIM,1887,20,35-39,1907,10
SIM,1854,21,35-39,1875,1
SIM,1907,26,45-49,1933,3
SIM,2000,11,na,2011,6485
STAT,1903,40,45-49,1943,0.17256118827565256
SIM,1833,24,50-100,1857,1
STAT,1932,44,30-34,1976,0.19934767465876213
SIM,1907,40,na,1947,4461
SIM,1953,17,25-29,1970,2
SIM,1802,74,na,1876,418
STAT,1835,20,20-24,1855,89.7314701783367
STAT,1914,40,20-24,1954,0.02034601840293535
SIM,1942,63,na,2005,4401
SIM,1820,47,50-100,1867,1
STAT,1794,93,na,1887,9.367466192402587
SIM,1937,34,30-34,1971,2
SIM,1808,79,na,1887,445
SIM,1950,33,35-39,1983,24
STAT,1970,28,15-19,1998,1.023757721685548
STAT,1913,39,25-29,1952,1.1106526299171213
SIM,1804,65,na,1869,793
STAT,1945,17,25-29,1962,54.630890362681484
STAT,1946,26,30-34,1972,50.39259125975622
SIM,1917,17,15-19,1934,9
STAT,1902,36,45-49,1938,0.7049980047347449
SIM,1912,33,15-19,1945,4
SIM,1856,31,na,1887,2164
SIM,1835,46,50-100,1881,1
STAT,1873,20,40-44,1893,2.4703999582823117
SIM,1888,32,45-49,1920,1
STAT,1855,49,40-44,1904,0.1426317690282103
STAT,1891,63,na,1954,2544.985585644373
STAT,1968,24,50-100,1992,0.950931064883694
STAT,1942,33,35-39,1975,11.228999593223763
SIM,1823,36,na,1859,2415
SIM,1870,78,na,1948,1176
STAT,1879,39,na,1918,2810.423727968905
STAT,1895,77,na,1972,1863.0720471584511
STAT,1933,23,40-44,1956,5.147630445652381
STAT,1800,104,na,1904,0.0359904599900673
STAT,1938,32,30-34,1970,18.291211023147326
SIM,1921,36,20-24,1957,1
STAT,1903,29,15-19,1932,0.7404556208670238
STAT,1936,49,20-24,1985,0.012574153590709809
STAT,1919,27,25-29,1946,82.05437033832172
STAT,1859,24,25-29,1883,53.82016399330346
STAT,1914,18,35-39,1932,0.9995703811533337
STAT,1865,47,na,1912,2331.738762816961
SIM,1971,18,30-34,1989,27
SIM,1919,41,na,1960,5347
STAT,1947,42,25-29,1989,0.09647122708395679
STAT,1922,34,20-24,1956,3.1635789917120287
STAT,1903,38,na,1941,3883.899854360774
STAT,1947,38,40-44,1985,2.00285681153015
STAT,1963,18,30-34,1981,17.86503362139752
STAT,1972,16,30-34,1988,18.015302900565416
SIM,1843,20,20-24,1863,126
SIM,1990,8,na,1998,6331
STAT,1957,27,45-49,1984,2.6400380739420544
SIM,1890,66,na,1956,2271
STAT,1918,48,15-19,1966,4.51036661077018E-4
STAT,1765,103,na,1868,0.004417116759692148
STAT,1899,103,na,2002,7.47436354912792
SIM,1930,34,20-24,1964,8
SIM,1932,25,40-44,1957,2
STAT,1974,16,50-100,1990,0.5647372153217887
STAT,1858,33,20-24,1891,2.4232564606745592
STAT,1875,25,na,1900,2865.465941292571
SIM,1830,42,50-100,1872,4
STAT,1870,45,15-19,1915,4.596263369374059E-4
STAT,1948,29,45-49,1977,2.289200990724867
SIM,1867,24,25-29,1891,140
SIM,1828,31,35-39,1859,5
SIM,1941,23,40-44,1964,11
STAT,1782,92,na,1874,14.961051357692519
STAT,1890,20,50-100,1910,0.5784644704475514
STAT,1932,19,40-44,1951,2.1264754529390815
SIM,1863,49,40-44,1912,1
STAT,1907,45,35-39,1952,0.13542871690670202
STAT,1940,48,50-100,1988,0.2749886939738181
STAT,1956,21,na,1977,5596.843877292622
SIM,1904,0,na,1904,4489
SIM,1943,23,na,1966,5084
STAT,1906,7,na,1913,4384.478358122457
SIM,1947,37,na,1984,5975
STAT,1860,54,45-49,1914,0.013126932421791044
STAT,1880,52,20-24,1932,8.978481352332133E-4
STAT,1952,40,40-44,1992,0.3604845132765878
SIM,1906,35,40-44,1941,3
STAT,1868,22,25-29,1890,63.47208086040205
STAT,1915,39,na,1954,4342.692114601406
SIM,1911,29,15-19,1940,2
STAT,1911,25,na,1936,4248.305435427727
STAT,1852,29,na,1881,2350.732885393455
STAT,1908,24,45-49,1932,1.187790159234084
STAT,1895,21,30-34,1916,26.838251912028976
SIM,1791,73,na,1864,555
SIM,1877,28,50-100,1905,3
SIM,1927,27,25-29,1954,121
STAT,1944,38,15-19,1982,0.024546864284329378
STAT,1963,20,50-100,1983,0.9685839151536267
SIM,1901,30,35-39,1931,24
SIM,1928,31,50-100,1959,4
SIM,1878,22,35-39,1900,17
STAT,1933,35,35-39,1968,3.810286241723913
SIM,1925,3,na,1928,5713
STAT,1892,108,na,2000,0.23902416944880128
STAT,1954,47,30-34,2001,0.1322877095651027
STAT,1817,49,20-24,1866,0.033291378183688686
SIM,1946,32,30-34,1978,34
SIM,1840,32,50-100,1872,2
SIM,1941,35,35-39,1976,3
SIM,1815,49,na,1864,1857
STAT,1824,33,na,1857,1800.809379486805
SIM,1916,24,45-49,1940,1
SIM,1908,5,na,1913,4428
SIM,1945,28,30-34,1973,1
STAT,1937,28,30-34,1965,44.08136069849661
SIM,1874,28,na,1902,2474
SIM,1909,28,20-24,1937,35
STAT,1923,46,30-34,1969,0.12060448640555728
STAT,1923,5,na,1928,5446.64747317372
STAT,1828,47,na,1875,1654.7868759611795
STAT,1968,36,na,2004,5592.000807999554
STAT,1999,16,50-100,2015,0.6389281282302194
STAT,1904,33,15-19,1937,0.1349397684395874
STAT,1806,68,na,1874,739.8872040391958
STAT,1802,54,na,1856,1502.104115038485
STAT,1988,24,na,2012,6043.251984077257
SIM,1812,52,na,1864,1401
STAT,1836,34,na,1870,2441.760599484964
STAT,1852,15,25-29,1867,6.538551395369246
STAT,1925,17,na,1942,5129.636054950652
SIM,1934,76,na,2010,2845
SIM,1920,15,20-24,1935,182
STAT,1887,26,na,1913,3097.137638714345
STAT,1877,16,40-44,1893,0.2201043033903806
SIM,1996,8,na,2004,6943
STAT,1969,5,na,1974,5668.197739601092
STAT,1981,28,35-39,2009,24.3206386525161
STAT,1950,18,45-49,1968,0.6814277228271951
STAT,1943,42,40-44,1985,0.31813866097498805
STAT,1832,39,45-49,1871,1.7137070464664959
SIM,1923,39,35-39,1962,9
STAT,1808,109,na,1917,3.6276560148359863E-4
STAT,1884,93,na,1977,177.44669063288157
STAT,1915,39,35-39,1954,2.7919505510701743
SIM,1844,30,na,1874,2586
STAT,1935,21,50-100,1956,1.0349567948164269
STAT,1965,45,40-44,2010,0.23738669400244433
SIM,1848,44,na,1892,1686
STAT,1915,31,25-29,1946,10.909690508162823
STAT,1956,15,35-39,1971,6.411226483562592
SIM,1959,38,25-29,1997,5
STAT,1901,24,35-39,1925,9.373900877589424
STAT,1912,15,20-24,1927,31.81551414372656
STAT,1795,67,na,1862,648.6919827432332
STAT,1816,50,50-100,1866,0.030773467252462522
STAT,1831,67,na,1898,1243.7097209411365
STAT,1901,15,45-49,1916,0.10608330075491976
STAT,1941,55,na,1996,4400.873641979425
STAT,1847,33,45-49,1880,1.5591600362448432
STAT,1868,114,na,1982,2.0560943118007595E-4
STAT,1930,19,30-34,1949,18.09055170878488
STAT,1948,34,na,1982,5084.804155928574
STAT,1944,20,na,1964,4553.611374269696
STAT,1868,12,na,1880,2961.335950292523
STAT,1939,44,40-44,1983,0.2993977269641834
STAT,1890,106,na,1996,0.9824981153143593
STAT,1930,28,20-24,1958,26.776840073236265
STAT,1852,49,15-19,1901,3.692509720768639E-4
SIM,1902,98,na,2000,38
SIM,1963,36,25-29,1999,3
STAT,1910,43,40-44,1953,0.2714467100545598
STAT,1927,72,na,1999,3940.270185415083
SIM,1817,83,na,1900,79
SIM,1855,33,45-49,1888,1
STAT,1936,44,15-19,1980,0.0017502376666889312
STAT,1970,16,20-24,1986,195.9113566786805
STAT,1955,36,25-29,1991,1.5554720401590718
STAT,1848,26,15-19,1874,0.5796642790223608
SIM,1816,66,na,1882,1163
STAT,1893,6,na,1899,3810.694022490732
SIM,1817,37,50-100,1854,2
STAT,1950,40,30-34,1990,0.18179891391884329
STAT,1874,51,na,1925,2556.0253953042834
STAT,1907,20,na,1927,4039.753175931331
STAT,1964,25,35-39,1989,21.9358934742479
STAT,1844,85,na,1929,229.29223866602933
SIM,1957,36,50-100,1993,2
STAT,1848,99,na,1947,2.012286188395547
STAT,1979,30,35-39,2009,14.818043516256239
SIM,1866,32,50-100,1898,1
STAT,1840,71,na,1911,1070.77908680359
STAT,1907,33,40-44,1940,4.210356376292569
SIM,1866,33,20-24,1899,2
SIM,1959,49,25-29,2008,1
STAT,1923,16,35-39,1939,5.698171876576759
SIM,1931,16,35-39,1947,13
STAT,1962,45,15-19,2007,5.692385932589347E-4
SIM,1842,82,na,1924,473
STAT,1881,39,40-44,1920,4.823683956283916
STAT,1889,81,na,1970,1290.7743046886944
STAT,1900,41,na,1941,3730.7033845897986
STAT,1974,19,45-49,1993,0.75226784552639
SIM,1948,32,40-44,1980,14
STAT,1925,46,40-44,1971,0.22095682196322464
SIM,1898,23,15-19,1921,9
SIM,1849,61,na,1910,2123
SIM,1829,43,45-49,1872,5
SIM,1955,38,40-44,1993,1
SIM,1972,25,35-39,1997,65
STAT,1924,28,45-49,1952,2.3125807800994225
STAT,1965,34,40-44,1999,5.739705714988999
SIM,1840,39,45-49,1879,8
STAT,1874,16,15-19,1890,7.028578633611273
STAT,1936,33,na,1969,4239.350261654579
STAT,1935,16,50-100,1951,0.5928487710911324
SIM,1965,24,40-44,1989,3
STAT,1897,21,40-44,1918,3.2253040572607756
SIM,1882,16,15-19,1898,8
STAT,1941,21,25-29,1962,110.22509239007145
SIM,1915,33,40-44,1948,8
SIM,1907,23,40-44,1930,9
SIM,1852,49,na,1901,1785
SIM,1878,10,na,1888,3117
STAT,1916,18,45-49,1934,0.12200356910348181
STAT,1908,69,na,1977,3085.612805341543
STAT,1904,55,na,1959,3517.730030677932
STAT,1941,29,35-39,1970,17.910296561121683
STAT,1852,26,50-100,1878,0.7075479188980838
STAT,1981,17,35-39,1998,6.771382363811622
STAT,1962,34,15-19,1996,0.19343902069155638
STAT,1953,24,20-24,1977,155.64098717173943
SIM,1932,28,45-49,1960,1
STAT,1841,30,50-100,1871,1.0091239801831757
SIM,1960,35,na,1995,6205
SIM,1849,20,15-19,1869,4
SIM,1940,44,30-34,1984,1
STAT,1839,23,45-49,1862,0.7054514188397384
STAT,1873,23,45-49,1896,0.8192470772432471
SIM,1887,41,40-44,1928,6
STAT,1957,24,40-44,1981,5.129467892210936
STAT,1892,80,na,1972,1461.2140808259012
STAT,1879,41,40-44,1920,2.7226838616534144
SIM,1918,29,25-29,1947,63
SIM,1936,45,50-100,1981,2
STAT,1912,48,20-24,1960,0.012234335719111306
SIM,1963,38,35-39,2001,6
STAT,1896,94,na,1990,219.8871598556108
STAT,1963,48,35-39,2011,0.19607513119081993
SIM,1961,24,20-24,1985,314
SIM,1938,25,35-39,1963,1
STAT,1913,27,30-34,1940,45.079921839987826
STAT,1887,5,na,1892,3389.3321037132064
SIM,1859,26,40-44,1885,3
STAT,1857,105,na,1962,0.09760888743128793
STAT,1969,18,25-29,1987,62.453243714888245
STAT,1978,30,50-100,2008,1.3288384735419396
STAT,1884,23,20-24,1907,78.33267355274934
STAT,1956,40,25-29,1996,0.1136403985274086
STAT,1849,30,15-19,1879,0.1304935061997192
SIM,1921,27,30-34,1948,99
STAT,1862,21,50-100,1883,0.4095088430825056
SIM,1897,30,45-49,1927,7
STAT,1889,30,45-49,1919,2.5006481442403348
STAT,1901,1,na,1902,4399.850183810971
STAT,1938,35,35-39,1973,2.8430952913101453
STAT,1905,17,30-34,1922,2.662275712141028
STAT,1836,98,na,1934,2.956392710469557
STAT,1928,34,15-19,1962,0.1851908946027784
SIM,1892,23,20-24,1915,2
STAT,1911,43,50-100,1954,0.1287339808034706
STAT,1832,84,na,1916,226.6402182381567
SIM,1895,4,na,1899,4090
SIM,1977,18,25-29,1995,1
STAT,1923,49,35-39,1972,0.17297553659139664
STAT,1943,17,15-19,1960,55.54469960894819
SIM,1928,36,30-34,1964,7
STAT,1830,48,25-29,1878,0.052457412974083566
STAT,1884,115,na,1999,1.8804116223197157E-4
STAT,1821,38,30-34,1859,11.350666035559545
STAT,1912,42,na,1954,4137.712574607546
STAT,1916,43,35-39,1959,0.23779194381966318
SIM,1879,31,40-44,1910,9
STAT,1878,20,40-44,1898,2.5258784860462997
STAT,1899,17,30-34,1916,2.5200198544448145
SIM,1923,31,25-29,1954,4
STAT,1877,80,na,1957,830.2885787362749
STAT,1916,56,na,1972,4186.984229219946
STAT,1959,29,20-24,1988,27.647406350158303
STAT,1873,17,50-100,1890,0.0577364318971635
SIM,1951,17,15-19,1968,72
STAT,1862,50,na,1912,2127.175145079996
STAT,1940,42,15-19,1982,0.0018706363351792725
STAT,1954,24,15-19,1978,7.614322728903196
STAT,1904,38,20-24,1942,0.274362101413946
STAT,1853,46,na,1899,2246.3439308468937
STAT,1866,64,na,1930,1859.4557091354563
SIM,1962,24,15-19,1986,2
STAT,1856,11,na,1867,2496.624913807049
STAT,1919,21,na,1940,4627.612556130413
SIM,1967,29,20-24,1996,3
STAT,1945,47,20-24,1992,0.014491073134221781
STAT,1861,33,na,1894,2279.7826061473165
STAT,1895,24,35-39,1919,8.711134574835906
STAT,1929,46,25-29,1975,0.0795488164005082
SIM,1859,19,50-100,1878,4
SIM,1935,34,20-24,1969,5
STAT,1806,49,45-49,1855,0.841398637754164
SIM,1927,24,20-24,1951,155
STAT,1837,41,50-100,1878,0.9143505728938623
STAT,1923,41,25-29,1964,0.09642337879412981
STAT,1924,43,na,1967,5088.655325588461
SIM,1905,26,35-39,1931,20
STAT,1927,34,20-24,1961,3.4574444197224348
STAT,1824,97,na,1921,3.3240813581135455
STAT,1966,45,na,2011,5534.041808738595
STAT,1879,20,35-39,1899,7.0738197608071065
STAT,1922,37,25-29,1959,1.2923814086021
SIM,1827,32,50-100,1859,1
SIM,1845,41,50-100,1886,2
SIM,1944,19,25-29,1963,63
STAT,1932,34,50-100,1966,1.2670904122026168
STAT,1950,43,50-100,1993,0.16633280735958308
STAT,1820,83,na,1903,232.99154387450608
STAT,1936,19,25-29,1955,47.651714665819185
SIM,1930,37,25-29,1967,3
STAT,1914,27,25-29,1941,76.61160399080205
STAT,1905,42,20-24,1947,0.018398141200133705
SIM,1922,27,25-29,1949,5
SIM,1964,42,na,2006,5823
SIM,1828,67,na,1895,1434
STAT,1919,24,20-24,1943,139.6039673551407
SIM,1824,53,na,1877,1292
SIM,1868,0,na,1868,3904
STAT,1866,2,na,1868,3613.286481430208
STAT,1945,38,30-34,1983,2.364746270181329
SIM,1777,90,na,1867,36
SIM,1849,29,na,1878,2693
STAT,1944,33,45-49,1977,1.9908888673163376
SIM,1971,19,na,1990,5029
SIM,1914,30,20-24,1944,6
STAT,1882,52,50-100,1934,0.016933418053696303
STAT,1949,42,35-39,1991,0.280872219281627
SIM,1973,18,40-44,1991,3
STAT,1940,17,25-29,1957,50.794242669735546
STAT,1834,22,50-100,1856,0.49770964213747537
SIM,1948,44,35-39,1992,1
SIM,1834,52,na,1886,1641
SIM,1867,15,35-39,1882,1
STAT,1960,40,35-39,2000,0.3154179493544316
SIM,1946,6,na,1952,4720
SIM,1845,15,na,1860,2532
STAT,1964,31,20-24,1995,3.6159762080170097
STAT,1887,30,35-39,1917,13.202847638977744
STAT,1970,39,15-19,2009,0.02851999589283666
STAT,1888,16,50-100,1904,0.0666243678610632
STAT,1914,30,50-100,1944,0.9686404151485132
STAT,1851,109,na,1960,0.0015359302996244253
STAT,1920,37,15-19,1957,0.024253954584313245
STAT,1855,40,40-44,1895,1.9332107158519618
SIM,1920,84,na,2004,1140
SIM,1930,25,30-34,1955,114
SIM,1831,38,40-44,1869,12
STAT,1926,34,na,1960,5269.752631575879
STAT,1901,21,30-34,1922,28.880177546318485
STAT,1960,48,45-49,2008,0.3388490059780147
SIM,1889,3,na,1892,4195
SIM,1952,33,45-49,1985,6
STAT,1825,109,na,1934,5.032355983908641E-4
STAT,1936,28,15-19,1964,0.7797746565925093
STAT,1823,38,40-44,1861,4.998217922615899
SIM,1965,38,45-49,2003,3
STAT,1859,15,35-39,1874,0.5924976503044478
STAT,1974,18,na,1992,5544.862169804129
STAT,1881,10,na,1891,2883.3672582300046
SIM,1969,29,30-34,1998,6
STAT,1851,53,40-44,1904,0.008214329550174477
STAT,1909,86,na,1995,1142.8633392269317
STAT,1929,43,20-24,1972,0.026353470311970606
STAT,1921,16,25-29,1937,57.12463890477482
STAT,1938,41,20-24,1979,0.020933754553952102
STAT,1851,98,na,1949,2.576076361914723
SIM,1870,14,na,1884,3361
STAT,1905,72,na,1977,2726.2828395658694
STAT,1919,48,30-34,1967,0.11124921779856423
STAT,1785,89,na,1874,25.024551161935747
STAT,1922,25,30-34,1947,51.49222651788485
STAT,1848,24,na,1872,2726.593785386658
STAT,1907,17,50-100,1924,0.08318696997405312
STAT,1970,23,45-49,1993,1.6302921332405276
SIM,1920,22,45-49,1942,4
STAT,1900,24,40-44,1924,3.316029390563298
STAT,1781,75,na,1856,295.35237780930004
SIM,1962,36,30-34,1998,3
SIM,1839,62,na,1901,1482
SIM,1952,27,50-100,1979,1
SIM,1925,31,35-39,1956,24
STAT,1915,71,na,1986,3259.6811940455596
STAT,1830,29,na,1859,1744.38522220937
SIM,1876,83,na,1959,585
SIM,1947,28,40-44,1975,18
STAT,1939,28,40-44,1967,5.407214129158427
STAT,1907,36,45-49,1943,0.734115173814218
SIM,1902,73,na,1975,2661
STAT,1939,47,45-49,1986,0.26125201163547
SIM,1906,87,na,1993,1005
STAT,1822,51,20-24,1873,0.0013693052470873733
STAT,1921,46,20-24,1967,0.014407653095069986
STAT,1927,48,50-100,1975,0.3266659308363354
STAT,1934,42,na,1976,5969.168890911764
STAT,1971,28,30-34,1999,57.49174553635588
STAT,1819,49,30-34,1868,0.1810611974756991
STAT,1854,49,25-29,1903,0.04594675534965593
SIM,1898,19,na,1917,4089
SIM,1970,18,15-19,1988,121
STAT,1963,22,15-19,1985,7.8304371707538865
SIM,1961,25,50-100,1986,6
STAT,1869,113,na,1982,6.624117006501771E-4
SIM,1925,27,15-19,1952,2
STAT,1876,36,50-100,1912,1.471720696990891
STAT,1910,46,45-49,1956,0.23483921473831676
STAT,1912,22,45-49,1934,1.2456216939134828
SIM,1895,30,35-39,1925,37
SIM,1892,14,na,1906,4108
STAT,1905,29,25-29,1934,70.15200867960304
SIM,1903,30,45-49,1933,1
STAT,1954,36,30-34,1990,2.6812891439299387
STAT,1913,80,na,1993,2106.014068423468
STAT,1973,39,40-44,2012,2.297001883458492
SIM,1984,30,na,2014,6237
SIM,1809,53,na,1862,1484
SIM,1915,36,45-49,1951,2
STAT,1811,51,45-49,1862,0.04406789291698089
STAT,1938,16,30-34,1954,13.916636073049716
STAT,1962,18,15-19,1980,67.08584813496586
SIM,1927,49,na,1976,4870
SIM,1843,23,25-29,1866,6
SIM,1923,35,na,1958,5396
STAT,1917,27,15-19,1944,0.8544150806160393
STAT,1906,30,20-24,1936,2.632973506174961
SIM,1913,29,25-29,1942,84
STAT,1918,36,20-24,1954,0.32212695990690227
STAT,1905,21,15-19,1926,5.527069957257133
STAT,1923,83,na,2006,1995.5970171148133
SIM,1937,37,35-39,1974,1
SIM,1877,57,na,1934,2582
SIM,1873,43,na,1916,3215
SIM,1931,36,50-100,1967,1
STAT,1902,33,40-44,1935,7.041729377917742
SIM,1853,39,30-34,1892,9
STAT,1874,105,na,1979,0.9323671834793372
STAT,1835,23,25-29,1858,47.919236124197305
STAT,1948,39,50-100,1987,0.570045773648645
SIM,1903,23,20-24,1926,194
STAT,1846,33,na,1879,2620.3226999455774
STAT,1873,54,30-34,1927,0.00682211077244187
STAT,1845,59,na,1904,1309.6128541424223
STAT,1876,42,na,1918,2753.8655221934105
STAT,1858,13,na,1871,2499.149043093984
SIM,1847,20,40-44,1867,5
SIM,1868,24,40-44,1892,3
STAT,1929,37,35-39,1966,3.5837937533504087
SIM,1989,18,na,2007,6739
SIM,1913,36,na,1949,4722
STAT,1992,18,na,2010,6095.171806380095
STAT,1875,39,50-100,1914,1.4494638682624426
SIM,1916,76,na,1992,2757
STAT,1895,13,na,1908,3873.4113740510134
STAT,1922,39,50-100,1961,0.5499220522658549
SIM,1912,62,na,1974,3218
STAT,1911,31,40-44,1942,4.419417152972818
STAT,1933,82,na,2015,2559.6226002868466
SIM,1825,70,na,1895,1003
SIM,1982,16,50-100,1998,1
STAT,1847,50,na,1897,1680.572649662423
SIM,1957,17,45-49,1974,4
STAT,1949,17,45-49,1966,0.6704692547462786
STAT,1839,20,40-44,1859,2.1541717892046797
SIM,1897,45,na,1942,3567
SIM,1899,35,25-29,1934,6
SIM,1893,31,na,1924,3548
STAT,1888,42,45-49,1930,2.027804411257401
STAT,1937,32,15-19,1969,0.14680072396805074
SIM,1864,37,40-44,1901,1
STAT,1827,62,na,1889,1504.1206799681177
SIM,1940,23,25-29,1963,237
STAT,1956,39,45-49,1995,1.0702401610059242
SIM,1945,32,15-19,1977,1
STAT,1977,30,25-29,2007,14.707101868084075
STAT,1882,52,30-34,1934,0.00667408335436543
STAT,1949,19,na,1968,4936.897016095648
STAT,1966,22,40-44,1988,4.862602920752906
SIM,1870,7,na,1877,3463
STAT,1822,85,na,1907,225.23616510746965
STAT,1826,99,na,1925,1.042773700745258
SIM,1963,27,35-39,1990,51
SIM,1913,57,na,1970,4157
STAT,1921,20,45-49,1941,1.4748434518846674
SIM,1880,13,na,1893,3619
STAT,1931,19,25-29,1950,65.12247320817347
STAT,1939,32,25-29,1971,10.887638175415244
STAT,1822,42,50-100,1864,2.1587777699820023
STAT,1919,34,50-100,1953,1.0203719649166088
STAT,1884,26,25-29,1910,48.3984906571086
SIM,1862,70,na,1932,1642
STAT,1944,26,20-24,1970,22.779363775998046
SIM,1892,26,25-29,1918,62
SIM,1919,17,25-29,1936,87
STAT,1914,54,na,1968,4097.0190040698435
STAT,1927,37,25-29,1964,1.412430952737561
STAT,1955,33,20-24,1988,3.8066756746981003
SIM,1890,27,40-44,1917,1
STAT,1901,40,35-39,1941,0.2053182867369915
STAT,1932,23,25-29,1955,139.46858480922188
STAT,1802,53,45-49,1855,0.056675396781358384
STAT,1955,27,35-39,1982,23.10037512824502
SIM,1995,7,na,2002,6767
STAT,1910,40,na,1950,4100.817616395852
STAT,1845,39,30-34,1884,3.6958553104180294
STAT,1897,101,na,1998,19.53571500768174
STAT,1929,18,30-34,1947,17.905504003891938
SIM,1974,22,40-44,1996,12
SIM,1866,84,na,1950,299
SIM,1987,0,na,1987,6572
SIM,1953,38,30-34,1991,1
SIM,1834,25,25-29,1859,86
STAT,1898,42,na,1940,3612.7911047130983
SIM,1952,30,40-44,1982,13
SIM,1827,82,na,1909,148
SIM,1938,22,30-34,1960,1
STAT,1879,82,na,1961,788.9776334030112
SIM,1779,92,na,1871,29
STAT,1965,18,40-44,1983,2.0145680106553345
SIM,1962,29,20-24,1991,47
STAT,1901,48,45-49,1949,0.21248819253505086
SIM,1914,33,25-29,1947,3
STAT,1880,25,50-100,1905,0.7878068330270974
SIM,1789,70,na,1859,959
STAT,1821,47,20-24,1868,0.021715635575145904
STAT,1905,26,20-24,1931,19.662550891886028
SIM,1885,41,30-34,1926,2
SIM,1867,58,na,1925,1927
SIM,1863,44,na,1907,2271
SIM,1935,37,25-29,1972,1
STAT,1882,27,40-44,1909,3.376644563726252
STAT,1944,30,40-44,1974,4.959821966891764
STAT,1837,20,30-34,1857,17.703585010455733
SIM,1985,25,na,2010,6428
SIM,1930,28,35-39,1958,32
STAT,1988,20,50-100,2008,1.0903906050821148
STAT,1873,98,na,1971,25.940032796441823
STAT,1905,45,25-29,1950,0.054811827259451745
STAT,1900,36,35-39,1936,2.4564406818668965
SIM,1924,27,35-39,1951,28
SIM,1979,18,35-39,1997,17
STAT,1906,33,25-29,1939,9.855708168598461
STAT,1971,43,15-19,2014,0.002329039240095093
STAT,1911,27,20-24,1938,20.56129105207264
SIM,1935,18,20-24,1953,412
SIM,1922,61,na,1983,4444
SIM,1952,7,na,1959,4844
STAT,1861,42,45-49,1903,1.4341195852612296
STAT,1950,16,na,1966,5023.965410996933
STAT,1879,16,15-19,1895,7.168809311300167
STAT,1922,28,35-39,1950,19.528298554183603
SIM,1886,20,40-44,1906,2
STAT,1954,40,15-19,1994,0.002283188874175404
STAT,1843,39,20-24,1882,0.8047875709525123
STAT,1881,30,40-44,1911,4.866128069073804
STAT,1910,22,35-39,1932,10.215145194202698
SIM,1886,61,na,1947,1523
SIM,1865,24,15-19,1889,1
STAT,1853,15,40-44,1868,0.2216600281514008
SIM,1856,21,45-49,1877,1
STAT,1925,60,na,1985,4782.602106237734
STAT,1857,24,15-19,1881,3.070495287313666
SIM,1893,10,na,1903,3809
SIM,1896,42,45-49,1938,1
STAT,1897,27,50-100,1924,0.9871309591409853
SIM,1897,24,na,1921,4045
SIM,1892,57,na,1949,3308
STAT,1915,40,15-19,1955,0.0017895289337406031
STAT,1942,42,25-29,1984,0.0895154339198178
SIM,1851,39,20-24,1890,2
STAT,1964,34,25-29,1998,13.676283400385111
STAT,1871,54,20-24,1925,8.23926581574788E-4
STAT,1950,31,40-44,1981,5.446255510122172
STAT,1876,20,30-34,1896,21.376464788292832
STAT,1897,17,20-24,1914,27.357496386992192
STAT,1931,35,25-29,1966,1.5077965106599844
STAT,1921,49,25-29,1970,0.06858087227415136
SIM,1835,26,na,1861,2518
STAT,1954,39,35-39,1993,3.5475518489191114
STAT,1900,27,45-49,1927,1.777990192610587
STAT,1806,100,na,1906,0.36437856687629727
STAT,1928,39,20-24,1967,0.3836419065661284
STAT,1832,100,na,1932,0.7232885059621267
SIM,1838,66,na,1904,1031
STAT,1889,60,na,1949,2713.095193995069
STAT,1843,28,50-100,1871,0.7842457913751264
SIM,1933,24,na,1957,6456
STAT,1848,21,45-49,1869,0.9086744854927459
SIM,1914,24,35-39,1938,26
STAT,1832,48,35-39,1880,0.11345115286287417
SIM,1904,38,35-39,1942,7
STAT,1938,44,25-29,1982,0.08424206246286997
STAT,1916,27,35-39,1943,17.916666467221507
STAT,1838,25,na,1863,2418.201944841698
SIM,1937,38,na,1975,4346
STAT,1960,15,na,1975,5535.4010012319495
SIM,1968,17,20-24,1985,371
STAT,1916,28,50-100,1944,1.1836352575398585
STAT,1925,38,na,1963,5204.126915312771
SIM,1913,26,20-24,1939,38
STAT,1953,27,25-29,1980,92.28585792476481
STAT,1921,41,15-19,1962,0.001998265988081652
STAT,1964,29,na,1993,5463.222820114215
SIM,1840,30,45-49,1870,2
STAT,1960,34,40-44,1994,5.987968231933688
SIM,1905,47,40-44,1952,1
STAT,1970,20,40-44,1990,4.8767811137830535
SIM,1961,27,25-29,1988,100
STAT,1927,18,20-24,1945,193.98737701728305
SIM,1915,42,30-34,1957,1
STAT,1921,24,na,1945,4728.49207399577
STAT,1855,80,na,1935,526.3608261730534
STAT,1906,24,35-39,1930,9.758883007778818
STAT,1859,94,na,1953,18.37329542939657
STAT,1817,63,na,1880,1416.6920463318042
STAT,1822,54,25-29,1876,0.006191789130767528
SIM,1962,37,na,1999,5507
STAT,1832,30,45-49,1862,1.6196872168609562
STAT,1854,48,50-100,1902,0.1975754462554458
STAT,2000,15,15-19,2015,77.9305001829611
STAT,1963,45,30-34,2008,0.13658974576704502
STAT,1877,41,30-34,1918,1.3863580802097069
STAT,1880,30,50-100,1910,1.129798407941199
SIM,1975,26,na,2001,6089
STAT,1850,15,15-19,1865,7.554193269548335
SIM,1883,16,30-34,1899,3
SIM,1912,17,15-19,1929,19
STAT,1859,40,25-29,1899,0.5962947103603461
SIM,1972,15,na,1987,5423
STAT,1920,17,50-100,1937,0.4848860384499582
SIM,1788,74,na,1862,326
SIM,1858,38,40-44,1896,13
STAT,1789,109,na,1898,1.4421374477314108E-4
SIM,1971,22,15-19,1993,1
STAT,1942,17,35-39,1959,5.061507869461787
STAT,1859,21,20-24,1880,72.75248660833364
STAT,1867,25,50-100,1892,0.6939373202956726
STAT,1875,16,30-34,1891,1.9055098952730196
SIM,1855,14,na,1869,2168
STAT,1904,17,15-19,1921,9.834851456951412
SIM,1859,28,na,1887,2212
STAT,1923,37,40-44,1960,2.0010017528621824
STAT,1941,30,15-19,1971,0.15591856377808438
SIM,1988,1,na,1989,6645
STAT,1983,28,45-49,2011,2.831237736496431
SIM,1838,47,40-44,1885,1
STAT,1932,20,20-24,1952,169.41808066278136
SIM,1903,26,25-29,1929,139
STAT,1948,59,na,2007,4745.622205886676
STAT,1932,47,35-39,1979,0.20188708567198027
STAT,1820,38,15-19,1858,0.08079096979347306
SIM,1821,34,na,1855,1755
SIM,1953,8,na,1961,5699
STAT,1822,37,50-100,1859,2.9870765044966907
SIM,1825,48,na,1873,1614
STAT,1907,42,30-34,1949,0.1353914592051397
STAT,1829,50,40-44,1879,0.010791048357851876
STAT,1833,52,35-39,1885,0.006286341517576382
SIM,1914,10,na,1924,4366
STAT,1968,38,20-24,2006,0.3910678144478588
SIM,1918,24,na,1942,3468
STAT,1901,45,40-44,1946,0.15766175149990763
SIM,1867,21,20-24,1888,68
STAT,1855,45,50-100,1900,0.21106338527868354
STAT,1938,19,35-39,1957,4.776033551862074
STAT,1998,15,20-24,2013,229.84959416049227
STAT,1917,39,45-49,1956,0.8122134903309248
STAT,1890,46,na,1936,3182.144906771613
SIM,1813,90,na,1903,24
SIM,1869,40,35-39,1909,1
SIM,1940,20,20-24,1960,6
STAT,1984,17,50-100,2001,0.614084478345461
SIM,1868,27,45-49,1895,3
STAT,1962,40,45-49,2002,0.25646154248357483
STAT,1949,38,15-19,1987,0.026526927264031424
STAT,1966,31,30-34,1997,23.16214176922895
STAT,1927,46,15-19,1973,5.348383185566181E-4
STAT,1935,16,na,1951,5824.3690730226335
STAT,1917,31,35-39,1948,11.088853894068665
SIM,1903,58,na,1961,3180
SIM,1992,17,50-100,2009,1
STAT,1911,34,45-49,1945,1.7546912688261787
STAT,1924,41,40-44,1965,0.3437467378504003
SIM,1889,16,25-29,1905,16
STAT,1933,32,30-34,1965,24.513687571073458
STAT,1939,52,na,1991,4341.7730030371895
SIM,1948,35,45-49,1983,2
STAT,1931,16,20-24,1947,205.3392030187152
SIM,1887,46,na,1933,3611
SIM,1916,21,40-44,1937,10
STAT,1880,39,25-29,1919,3.486505830111104
SIM,1840,48,na,1888,1816
SIM,1891,83,na,1974,1002
STAT,1858,36,25-29,1894,2.6045768286213757
STAT,1918,43,45-49,1961,0.20384377759631023
STAT,1943,29,45-49,1972,2.1214633591592946
STAT,1956,36,40-44,1992,2.3573022098490917
SIM,1793,85,na,1878,254
STAT,1849,26,30-34,1875,23.303711192910736
STAT,1907,17,40-44,1924,0.3105647634247149
SIM,1853,66,na,1919,1426
STAT,1937,19,50-100,1956,0.4196032279711272
SIM,1951,29,45-49,1980,2
SIM,1948,16,40-44,1964,4
SIM,1852,81,na,1933,27
SIM,1908,19,15-19,1927,20
STAT,1837,51,na,1888,1596.1212237018203
STAT,1908,21,40-44,1929,3.582622093825607
STAT,1934,44,40-44,1978,0.40067241635454237
SIM,1858,30,30-34,1888,46
SIM,1879,27,20-24,1906,28
STAT,1871,29,30-34,1900,28.705363509682243
SIM,1941,32,30-34,1973,3
STAT,1943,21,35-39,1964,11.566052107817171
SIM,1834,22,20-24,1856,107
STAT,1965,0,na,1965,5706.789570642477
STAT,1897,89,na,1986,621.2747765812975
SIM,1814,40,45-49,1854,5
SIM,1963,24,30-34,1987,52
STAT,1772,93,na,1865,0.8443912609422082
STAT,1898,104,na,2002,4.166405577173775
SIM,1967,37,50-100,2004,1
STAT,1889,38,na,1927,3334.9170777409045
SIM,1857,26,30-34,1883,5
SIM,1883,32,na,1915,2445
STAT,1893,75,na,1968,1942.0986933809086
SIM,1951,21,35-39,1972,33
STAT,1933,26,45-49,1959,2.6496510473539048
STAT,1955,24,30-34,1979,44.147421952722546
STAT,1868,22,50-100,1890,0.4521448033239218
STAT,1885,24,na,1909,2705.3864716680155
STAT,1852,31,25-29,1883,10.102893447059945
STAT,1900,21,15-19,1921,5.29886038102962
SIM,1855,39,40-44,1894,5
SIM,1909,42,na,1951,4647
STAT,1985,13,na,1998,6446.522898710178
SIM,1889,112,na,2001,3
SIM,1933,22,30-34,1955,1
SIM,1959,27,na,1986,5450
STAT,1972,30,na,2002,5702.8189564387285
SIM,1897,23,20-24,1920,4
STAT,1822,38,25-29,1860,6.661832446153896
STAT,1805,83,na,1888,172.00105025530831
SIM,1866,30,na,1896,2433
SIM,1830,38,25-29,1868,3
STAT,1858,27,35-39,1885,8.892633219846696
STAT,1913,37,na,1950,4286.966808480474
STAT,1856,37,40-44,1893,3.8541691935408693
STAT,1898,21,20-24,1919,107.80595693033025
SIM,1855,78,na,1933,396
SIM,1866,27,35-39,1893,14
SIM,1890,39,35-39,1929,17
STAT,1923,69,na,1992,3984.7715744975967
STAT,1849,21,25-29,1870,54.031708899512125
SIM,1985,26,40-44,2011,1
SIM,1909,35,45-49,1944,1
STAT,1889,23,20-24,1912,97.72987475761605
SIM,1842,22,50-100,1864,1
SIM,1885,44,35-39,1929,8
STAT,1856,75,na,1931,906.3891429621724
SIM,1857,21,25-29,1878,130
STAT,1881,64,na,1945,1935.0173389718002
SIM,1848,23,25-29,1871,57
STAT,1861,37,50-100,1898,1.1779052758859865
STAT,1986,24,40-44,2010,5.543535844806406
STAT,1877,44,35-39,1921,2.1444402312957784
STAT,1948,35,30-34,1983,2.4841187280036143
STAT,1942,29,15-19,1971,0.8543742126085712
STAT,1873,16,20-24,1889,21.016682617255046
SIM,1922,30,50-100,1952,4
STAT,1817,43,25-29,1860,1.9286068475734621
STAT,1945,21,45-49,1966,1.423615671268383
STAT,1867,25,35-39,1892,10.467142749250486
STAT,1882,26,15-19,1908,0.5131753684332341
SIM,1826,48,50-100,1874,2
STAT,1939,37,30-34,1976,2.1699601716934547
STAT,1892,33,20-24,1925,3.893297641594497
SIM,1920,39,30-34,1959,2
STAT,1871,38,20-24,1909,0.8806421724069228
STAT,1869,52,50-100,1921,0.016789102997142872
STAT,1871,32,na,1903,2739.786632582781
STAT,1818,49,15-19,1867,4.797855097090974E-4
STAT,1864,19,50-100,1883,0.05161043709160674
STAT,1848,42,15-19,1890,0.014655261311017595
STAT,1856,65,na,1921,1487.926277158133
STAT,1827,47,15-19,1874,5.066184207289246E-4
SIM,1832,83,na,1915,300
SIM,1979,15,30-34,1994,51
SIM,1938,31,20-24,1969,6
STAT,1890,25,na,1915,3388.115824683994
SIM,1947,37,30-34,1984,2
SIM,1952,62,na,2014,4096
SIM,1909,52,na,1961,4490
STAT,1944,27,50-100,1971,1.2415538331616376
SIM,1964,21,20-24,1985,5
SIM,1832,26,40-44,1858,6
STAT,1916,24,30-34,1940,34.54225966546811
STAT,1870,15,na,1885,2935.2915212263124
STAT,1912,39,30-34,1951,2.0341694057786768
STAT,1861,19,20-24,1880,19.320124056271208
STAT,1977,26,40-44,2003,7.302643258900058
STAT,1973,16,25-29,1989,64.69783587146242
SIM,1942,20,30-34,1962,78
STAT,1987,4,na,1991,6478.999415001608
STAT,1978,35,na,2013,6115.147067702662
STAT,1900,62,na,1962,3111.689890318894
SIM,1855,26,20-24,1881,22
SIM,1984,17,35-39,2001,7
STAT,1837,29,na,1866,1981.8003925565183
STAT,1853,37,15-19,1890,0.0559085480781519
STAT,1866,43,20-24,1909,0.16864909641530237
STAT,1876,23,35-39,1899,6.94009296666466
STAT,1974,25,30-34,1999,59.35213741443079
STAT,1919,31,45-49,1950,1.966773228463109
SIM,1944,65,na,2009,3968
SIM,1981,16,25-29,1997,1
SIM,1907,32,30-34,1939,27
STAT,1956,21,20-24,1977,170.419962171294
SIM,1888,25,20-24,1913,37
SIM,1965,37,na,2002,5551
SIM,1934,41,na,1975,5775
STAT,1847,39,40-44,1886,3.422920671158835
STAT,1959,36,45-49,1995,1.0611991903782432
SIM,1906,20,20-24,1926,204
STAT,1850,49,40-44,1899,0.17256138087680356
STAT,1915,15,25-29,1930,10.517515461930445
STAT,1836,26,45-49,1862,1.3174200630342614
STAT,1777,111,na,1888,9.498137979076928E-4
SIM,1785,88,na,1873,43
STAT,1969,27,15-19,1996,1.022120420683935
SIM,1960,24,40-44,1984,1
SIM,1949,32,35-39,1981,2
STAT,1843,47,na,1890,2246.923073153912
STAT,1882,39,35-39,1921,7.89246146630092
STAT,1859,30,na,1889,2225.7035497607103
STAT,1847,26,20-24,1873,10.928237137151319
STAT,1957,47,35-39,2004,0.204051980472479
STAT,1843,33,25-29,1876,12.227579660074033
STAT,1848,78,na,1926,830.1876473643646
STAT,1934,20,30-34,1954,44.742773378605705
SIM,1827,31,40-44,1858,10
SIM,1851,33,25-29,1884,23
SIM,1889,37,30-34,1926,10
SIM,1804,86,na,1890,100
STAT,1798,86,na,1884,65.8962874896155
SIM,1924,24,30-34,1948,78
STAT,1952,24,40-44,1976,4.662233825374461
SIM,1992,16,45-49,2008,1
STAT,1972,36,20-24,2008,0.40165813554560453
STAT,1900,23,50-100,1923,0.6509996567591826
STAT,1927,25,45-49,1952,2.439727165113412
SIM,1868,11,na,1879,3406
STAT,1938,20,15-19,1958,6.0871195770496005
SIM,1975,22,35-39,1997,25
SIM,1849,32,30-34,1881,39
SIM,1977,32,40-44,2009,15
STAT,1813,70,na,1883,768.4263963189632
STAT,1880,21,35-39,1901,7.159750709230639
SIM,1925,36,40-44,1961,3
STAT,1886,17,45-49,1903,0.07951781347663243
SIM,1933,26,50-100,1959,4
SIM,1843,77,na,1920,527
SIM,1916,30,30-34,1946,6
STAT,1888,115,na,2003,2.4122372321851323E-4
SIM,1955,23,20-24,1978,189
STAT,1979,21,45-49,2000,1.7943789447814926
STAT,1984,16,45-49,2000,0.81900862687614
SIM,1819,39,30-34,1858,5
STAT,1850,19,45-49,1869,0.08120837911781209
STAT,1865,22,20-24,1887,72.62780212040639
SIM,1946,42,na,1988,4618
STAT,1930,39,na,1969,5651.922177249766
STAT,1829,53,45-49,1882,0.012754879146011665
STAT,1967,22,35-39,1989,13.618533480367223
STAT,1835,29,20-24,1864,9.417452738835792
STAT,1947,23,20-24,1970,144.97818829834458
STAT,1868,76,na,1944,1050.450500341834
STAT,1873,77,na,1950,1018.6773729550466
STAT,1844,39,15-19,1883,0.04861313603302264
STAT,1915,18,na,1933,4653.652105131305
SIM,1946,20,15-19,1966,8
SIM,1893,26,40-44,1919,4
SIM,1935,25,45-49,1960,5
SIM,1966,24,35-39,1990,2
STAT,1985,15,35-39,2000,6.891159355751524
SIM,1987,21,45-49,2008,1
STAT,1917,36,40-44,1953,1.803078771532962
STAT,1903,21,40-44,1924,3.4356587979399547
SIM,1839,25,50-100,1864,4
SIM,1965,33,30-34,1998,11
STAT,1859,39,45-49,1898,1.8141771997197929
STAT,1876,28,40-44,1904,3.561065160339829
SIM,1878,25,50-100,1903,7
SIM,1889,80,na,1969,1769
SIM,1927,71,na,1998,3770
SIM,1977,29,25-29,2006,5
STAT,1839,44,15-19,1883,0.011250794449947454
SIM,1843,29,20-24,1872,10
STAT,1969,32,40-44,2001,5.750580389115698
STAT,1834,48,45-49,1882,0.22549816402163816
STAT,1957,33,30-34,1990,24.42059747084061
SIM,1967,9,na,1976,5779
STAT,1899,45,25-29,1944,0.05188301584328954
STAT,1891,24,15-19,1915,4.676000961682595
SIM,1884,28,40-44,1912,3
SIM,1833,25,30-34,1858,4
STAT,1929,22,15-19,1951,7.7689470978852055
SIM,1858,4,na,1862,3380
SIM,1989,23,20-24,2012,348
STAT,1812,53,na,1865,1221.069535078963
STAT,1885,26,40-44,1911,3.4600547341875774
STAT,1993,15,50-100,2008,0.6224049452969765
SIM,1862,48,na,1910,2756
SIM,1850,47,na,1897,1489
SIM,1956,35,30-34,1991,8
STAT,1995,19,25-29,2014,72.34448507128995
SIM,1939,64,na,2003,4259
SIM,1959,17,na,1976,5624
STAT,1845,81,na,1926,364.3968156226534
STAT,1969,21,50-100,1990,0.9520338362661278
SIM,1858,33,35-39,1891,2
STAT,1828,30,50-100,1858,1.1313552266501832
SIM,1916,22,na,1938,4139
SIM,1951,30,25-29,1981,3
STAT,1855,15,15-19,1870,6.077475820778654
STAT,1886,4,na,1890,3202.3655175402773
STAT,1941,45,50-100,1986,0.2810382943798425
STAT,1805,73,na,1878,630.0131049720472
STAT,1903,59,na,1962,3367.221442645281
STAT,1800,54,50-100,1854,0.057383764851725874
SIM,1836,43,50-100,1879,1
STAT,1850,41,50-100,1891,1.092481164249306
STAT,1953,15,45-49,1968,0.6977566368049808
STAT,1881,33,45-49,1914,1.932907791971949
STAT,1929,20,na,1949,5361.433564107777
STAT,1959,31,50-100,1990,1.2729646621421231
SIM,1818,36,45-49,1854,4
STAT,1917,40,25-29,1957,0.08624257254912802
STAT,1908,30,30-34,1938,17.322529730649467
STAT,1895,15,45-49,1910,0.0985828547886821
STAT,1945,62,na,2007,4385.0890625540615
SIM,1910,1,na,1911,4240
SIM,1825,40,20-24,1865,1
STAT,1856,49,35-39,1905,0.12068926389475884
SIM,1863,37,25-29,1900,4
SIM,1982,27,40-44,2009,25
SIM,1863,15,15-19,1878,15
SIM,1856,10,na,1866,2618
STAT,1963,38,20-24,2001,0.3977820725987198
SIM,1817,39,20-24,1856,1
SIM,1845,29,30-34,1874,3
STAT,1834,35,25-29,1869,3.3368681593365266
SIM,1831,47,30-34,1878,1
SIM,1971,38,20-24,2009,1
STAT,1869,6,na,1875,3106.345486713592
STAT,1823,47,30-34,1870,0.09564388079497299
STAT,1880,48,15-19,1928,4.831480608338609E-4
STAT,1845,24,45-49,1869,0.5749958119933173
STAT,1974,27,40-44,2001,7.054212576101832
SIM,1951,26,40-44,1977,8
STAT,1867,22,30-34,1889,19.271594084779725
SIM,1898,35,30-34,1933,15
STAT,1943,26,40-44,1969,5.731893296263498
STAT,1910,31,25-29,1941,10.33743398489343
STAT,1837,29,30-34,1866,23.069623841586935
SIM,1842,35,25-29,1877,5
STAT,1839,32,20-24,1871,2.6380211617502827
STAT,1979,1,na,1980,6256.693534867014
SIM,1904,34,50-100,1938,2
SIM,1875,22,30-34,1897,32
SIM,1847,32,20-24,1879,6
SIM,1918,30,40-44,1948,8
SIM,1973,22,25-29,1995,7
STAT,1860,38,45-49,1898,1.84496260436112
SIM,1837,20,45-49,1857,1
STAT,1892,36,25-29,1928,4.184613964219254
STAT,1817,40,20-24,1857,0.5163763931070356
STAT,1880,47,na,1927,2739.2675903306867
SIM,1827,34,45-49,1861,3
STAT,1937,75,na,2012,2839.6562918980226
STAT,1952,28,50-100,1980,1.3818249700525345
SIM,1954,49,25-29,2003,1
STAT,1852,27,40-44,1879,3.289529460250598
STAT,1849,17,40-44,1866,0.17449818609901604
SIM,1922,18,na,1940,5352
SIM,1870,99,na,1969,86
SIM,1846,32,na,1878,1734
SIM,1908,25,na,1933,3971
STAT,1966,1,na,1967,5675.682476429228
SIM,1933,25,35-39,1958,41
STAT,1920,16,45-49,1936,0.6481025692278862
STAT,1967,41,na,2008,5571.958015816472
SIM,1940,34,50-100,1974,3
STAT,1815,51,na,1866,1591.994536089069
STAT,1898,33,15-19,1931,0.22117314120500287
STAT,1877,38,15-19,1915,0.06707610273814925
STAT,1897,45,15-19,1942,3.5165332722569484E-4
STAT,1845,48,20-24,1893,0.007984655069487421
STAT,1924,78,na,2002,2899.5283731572363
STAT,1868,34,40-44,1902,4.767243160216465
SIM,1881,29,40-44,1910,5
STAT,1925,25,35-39,1950,20.596632887254593
STAT,1968,31,40-44,1999,5.753061350370079
STAT,1873,29,40-44,1902,3.5050103606164025
SIM,1917,42,40-44,1959,1
STAT,1825,71,na,1896,944.1421988184381
SIM,1851,30,20-24,1881,5
SIM,1892,0,na,1892,4350
SIM,1948,20,25-29,1968,2
STAT,1812,49,20-24,1861,0.026913325416401117
STAT,1918,68,na,1986,3710.4729662176405
STAT,1987,15,45-49,2002,0.8234293990062563
SIM,1814,64,na,1878,837
SIM,1909,32,40-44,1941,13
STAT,1977,22,50-100,1999,1.0294001073558476
STAT,1886,31,50-100,1917,1.1199139758425276
SIM,1876,34,40-44,1910,5
STAT,1838,46,na,1884,2030.8043290273797
STAT,1856,36,15-19,1892,0.04967920680820113
SIM,1792,68,na,1860,737
SIM,1827,29,na,1856,1707
SIM,1842,23,30-34,1865,2
STAT,1909,42,40-44,1951,0.27029215771513904
STAT,1884,17,35-39,1901,0.6256496803561611
STAT,1834,23,30-34,1857,21.583861935264903
STAT,1986,27,45-49,2013,2.8531508534783514
SIM,1872,43,50-100,1915,4
STAT,1855,43,45-49,1898,1.2642850888659225
STAT,1943,30,25-29,1973,11.54370213859151
SIM,1892,17,35-39,1909,3
SIM,1836,41,35-39,1877,5
SIM,1860,27,40-44,1887,4
STAT,1856,6,na,1862,2597.229876045236
STAT,1965,22,25-29,1987,133.52193074391204
STAT,1843,30,20-24,1873,3.329004419779196
STAT,1935,32,40-44,1967,6.251460842185547
STAT,1863,19,30-34,1882,1.65052856209199
STAT,1958,24,35-39,1982,14.309473823592228
SIM,1885,98,na,1983,111
STAT,1949,47,40-44,1996,0.22010667116569327
STAT,1918,82,na,2000,1979.4356167103313
SIM,1989,2,na,1991,6754
STAT,1828,41,35-39,1869,1.7701123623894204
SIM,1866,49,45-49,1915,1
STAT,1826,37,40-44,1863,3.5076563151547187
SIM,1840,70,na,1910,908
SIM,1942,23,35-39,1965,16
STAT,1857,15,25-29,1872,6.057549566308391
SIM,1930,39,50-100,1969,1
STAT,1948,38,35-39,1986,3.2876673270205066
SIM,1834,49,50-100,1883,1
STAT,1934,21,na,1955,5668.2585911404
STAT,1952,27,45-49,1979,2.3995617220451697
SIM,1883,20,15-19,1903,9
STAT,1931,56,na,1987,5458.900182849951
STAT,1780,90,na,1870,41.7016636063822
SIM,1926,39,25-29,1965,4
STAT,1881,27,25-29,1908,47.08694261692483
STAT,1918,39,25-29,1957,1.1948638491604548
SIM,1865,46,na,1911,2802
SIM,1876,62,na,1938,2285
STAT,1842,21,15-19,1863,3.22518305610426
SIM,1873,22,20-24,1895,2
STAT,1839,26,50-100,1865,0.6437159262864941
SIM,1879,7,na,1886,3110
SIM,1956,38,35-39,1994,8
STAT,1934,23,35-39,1957,14.605582033383458
SIM,1862,31,35-39,1893,25
STAT,1882,17,25-29,1899,6.387621309621172
SIM,1869,27,na,1896,2001
STAT,1965,31,15-19,1996,0.18883146868587763
STAT,1909,39,50-100,1948,0.45451878281129093
SIM,1888,28,25-29,1916,112
SIM,1832,29,45-49,1861,4
SIM,1917,39,50-100,1956,3
STAT,1848,38,30-34,1886,5.775369288346153
SIM,1863,65,na,1928,1835
SIM,1864,29,na,1893,2602
STAT,1860,25,25-29,1885,40.34374222125736
STAT,1858,24,30-34,1882,16.50371918335495
SIM,1943,32,40-44,1975,2
SIM,1932,60,na,1992,5009
STAT,1826,49,50-100,1875,0.17217225045365728
SIM,1860,26,50-100,1886,1
STAT,1951,15,35-39,1966,5.769559735522482
SIM,1856,38,30-34,1894,13
STAT,1866,46,25-29,1912,0.061787452519951436
STAT,1984,24,30-34,2008,47.23225569379841
SIM,1884,32,25-29,1916,18
STAT,1876,32,25-29,1908,12.219210371003184
SIM,1866,36,25-29,1902,1
SIM,1844,26,45-49,1870,3
STAT,1898,24,25-29,1922,88.72591553574915
STAT,1963,27,20-24,1990,26.878875206053834
STAT,1967,27,50-100,1994,1.4410656116693812
SIM,1866,24,30-34,1890,1
SIM,1848,20,20-24,1868,65
STAT,1780,105,na,1885,0.0297947176431701
SIM,1971,27,20-24,1998,64
SIM,1865,15,25-29,1880,7
SIM,1931,22,20-24,1953,4
STAT,1899,42,20-24,1941,0.017415056185871133
SIM,1930,69,na,1999,4886
STAT,1969,35,45-49,2004,1.014264722055908
SIM,1919,33,50-100,1952,3
STAT,1854,31,35-39,1885,8.537189166250494
SIM,1888,38,40-44,1926,10
STAT,1807,64,na,1871,1181.8407226999439
STAT,1947,26,25-29,1973,85.97205194233631
STAT,1961,22,40-44,1983,5.029842784395737
SIM,1986,21,na,2007,5914
STAT,1859,36,40-44,1895,4.043627940430061
STAT,1928,45,50-100,1973,0.3346097700401323
SIM,1952,29,25-29,1981,88
SIM,1960,27,45-49,1987,3
STAT,1936,79,na,2015,2279.945102732765
STAT,1927,22,40-44,1949,4.779709102394028
SIM,1899,26,35-39,1925,17
SIM,1935,22,40-44,1957,9
SIM,1967,14,na,1981,5779
STAT,1910,18,15-19,1928,10.361352740723285
SIM,1857,59,na,1916,2068
STAT,1845,21,40-44,1866,1.7558115612610743
STAT,1829,47,25-29,1876,0.05876913645881706
STAT,1932,32,15-19,1964,0.1971921119662097
STAT,1872,3,na,1875,3609.6300297073717
STAT,1923,22,20-24,1945,149.25521820009934
STAT,1850,16,40-44,1866,0.23144918280291027
SIM,1909,30,50-100,1939,3
SIM,1853,21,40-44,1874,4
STAT,1869,93,na,1962,75.26653481905657
STAT,1982,15,na,1997,5980.439242512371
SIM,1852,71,na,1923,1055
SIM,1970,6,na,1976,6049
STAT,1893,107,na,2000,0.5199839391907606
SIM,1858,33,na,1891,2633
STAT,1906,42,15-19,1948,0.0016118576015451299
SIM,1977,26,20-24,2003,27
STAT,1869,25,45-49,1894,1.2493025611009139
STAT,1937,37,20-24,1974,0.304368517477275
STAT,1972,39,25-29,2011,1.4956769356362494
STAT,1851,15,30-34,1866,1.5549714107714538
SIM,1972,29,25-29,2001,3
SIM,1900,39,na,1939,3532
SIM,1957,36,na,1993,6243
SIM,1899,57,na,1956,3343
SIM,1859,50,na,1909,2056
SIM,1937,48,na,1985,4243
SIM,1928,24,15-19,1952,16
SIM,1955,26,25-29,1981,122
SIM,1916,33,35-39,1949,19
STAT,1894,24,40-44,1918,3.072059326967434
STAT,1908,33,35-39,1941,9.925312290317281
SIM,1890,9,na,1899,3781
SIM,1908,23,35-39,1931,8
SIM,1915,38,na,1953,4614
SIM,1905,32,20-24,1937,3
SIM,1922,86,na,2008,856
STAT,1838,23,15-19,1861,3.681580433518029
STAT,1995,16,20-24,2011,226.5470623133621
SIM,1852,28,na,1880,2172
STAT,1922,4,na,1926,5388.364448388263
STAT,1893,65,na,1958,2553.1835849857453
SIM,1839,25,25-29,1864,75
SIM,1924,2,na,1926,5460
STAT,1850,17,na,1867,2887.5898562461757
STAT,1907,21,25-29,1928,97.49505968956369
SIM,1926,54,na,1980,5579
SIM,1971,29,30-34,2000,137
STAT,1992,22,15-19,2014,8.846914114341308
SIM,1932,22,15-19,1954,6
SIM,1979,15,na,1994,5699
STAT,1908,20,15-19,1928,5.688567995624712
SIM,1921,15,15-19,1936,98
SIM,1949,49,na,1998,5711
STAT,1878,23,45-49,1901,0.8376451595327272
SIM,1915,21,25-29,1936,211
STAT,1885,29,45-49,1914,1.26894552764036
STAT,1863,99,na,1962,5.386802583332086
STAT,1913,15,15-19,1928,10.76382338073259
STAT,1862,16,45-49,1878,0.07329540023386796
SIM,1941,21,na,1962,3998
SIM,1945,5,na,1950,4846
STAT,1855,48,na,1903,1890.325241696022
SIM,1811,89,na,1900,64
SIM,1916,20,15-19,1936,6
STAT,1815,53,50-100,1868,0.02904844173869542
SIM,1956,20,na,1976,5132
SIM,1829,36,20-24,1865,2
STAT,1775,113,na,1888,6.63252140122772E-4
SIM,1886,23,45-49,1909,6
STAT,1954,22,50-100,1976,0.9418422729477229
SIM,1846,23,15-19,1869,4
SIM,1880,77,na,1957,1184
STAT,1978,20,45-49,1998,1.7791953201068336
SIM,1849,20,50-100,1869,6
STAT,1939,41,15-19,1980,0.0018470019084555675
STAT,1944,29,25-29,1973,82.01990631747975
STAT,1921,78,na,1999,2745.3421147346066
SIM,1824,31,15-19,1855,1
STAT,1886,41,na,1927,2826.2283384168345
SIM,1824,32,na,1856,1759
STAT,1945,26,15-19,1971,0.8942147389203471
STAT,1873,106,na,1979,0.45032905541210055
STAT,1883,26,30-34,1909,28.530262236683427
STAT,1912,49,50-100,1961,0.24962233730839506
SIM,1927,40,35-39,1967,1
SIM,1974,21,15-19,1995,12
STAT,1921,81,na,2002,2265.678687189537
SIM,1973,38,30-34,2011,7
SIM,1887,56,na,1943,3316
STAT,1974,36,30-34,2010,2.832132800213769
SIM,1826,31,25-29,1857,4
SIM,1880,26,20-24,1906,4
STAT,1842,110,na,1952,2.126491313496191E-4
SIM,1872,16,na,1888,3260
STAT,1825,47,40-44,1872,0.23906816393320782
SIM,1881,23,45-49,1904,2
SIM,1882,28,30-34,1910,38
STAT,1959,47,45-49,2006,0.3412627323871646
SIM,1929,8,na,1937,5507
SIM,1983,6,na,1989,7028
SIM,1842,26,35-39,1868,24
SIM,1953,26,15-19,1979,1
STAT,1812,47,50-100,1859,0.5694346792833607
SIM,1847,35,25-29,1882,5
SIM,1886,32,35-39,1918,3
STAT,1882,21,45-49,1903,0.7884044343001553
SIM,1944,18,na,1962,4649
STAT,1970,19,25-29,1989,62.56142133916784
STAT,1911,39,15-19,1950,0.021207811703768578
STAT,1937,43,50-100,1980,0.136611640380879
STAT,1816,49,40-44,1865,0.3387811053483823
STAT,1909,45,45-49,1954,0.23295214819466817
STAT,1783,87,na,1870,41.76083778021368
STAT,1878,32,35-39,1910,12.202664490149273
SIM,1874,1,na,1875,4261
SIM,1887,37,20-24,1924,2
STAT,1916,15,40-44,1931,0.34409878561526286
STAT,1965,38,30-34,2003,2.702580473934899
STAT,1903,60,na,1963,3334.525722437195
STAT,1966,21,15-19,1987,7.700869263793832
SIM,1943,35,45-49,1978,2
SIM,1854,39,25-29,1893,9
SIM,1890,21,45-49,1911,2
STAT,1839,35,25-29,1874,2.785886979769085
STAT,1811,69,na,1880,876.8559367556167
SIM,1979,26,30-34,2005,75
STAT,1857,39,35-39,1896,6.2932347724513145
STAT,1893,21,20-24,1914,100.8274229644707
STAT,1935,35,45-49,1970,1.1026080437974286
STAT,1867,81,na,1948,582.6674967609692
STAT,1958,21,30-34,1979,43.7225391735587
STAT,1855,37,25-29,1892,2.449896044234999
SIM,1888,16,30-34,1904,4
STAT,1846,39,25-29,1885,3.044377922100375
STAT,1980,28,na,2008,6024.695079853581
STAT,1912,18,25-29,1930,10.09592508128346
SIM,1987,26,15-19,2013,3
STAT,1940,29,40-44,1969,5.481505799878144
STAT,1957,37,50-100,1994,0.6581599913049364
STAT,1969,21,40-44,1990,4.864892549380524
STAT,1914,39,40-44,1953,1.7083553466893602
STAT,1933,20,15-19,1953,8.200906362012088
STAT,1809,45,40-44,1854,0.43903490679462764
STAT,1860,51,40-44,1911,0.009838708209428533
STAT,1997,16,30-34,2013,20.54610508708582
STAT,1919,36,15-19,1955,0.023824422169375085
SIM,1919,20,40-44,1939,9
STAT,1861,28,45-49,1889,1.065268041659543
SIM,1900,23,30-34,1923,67
STAT,1858,18,45-49,1876,0.06829202836828328
SIM,1921,23,na,1944,5475
SIM,1890,48,25-29,1938,1
SIM,1849,82,na,1931,741
STAT,1869,34,35-39,1903,11.221192139755509
SIM,1877,34,35-39,1911,26
STAT,1857,48,50-100,1905,0.21797419697997758
SIM,1977,21,40-44,1998,1
SIM,1838,37,25-29,1875,1
SIM,1942,19,15-19,1961,93
STAT,1874,28,30-34,1902,29.64636205147193
STAT,1878,44,na,1922,2747.3497218394264
STAT,1894,27,45-49,1921,1.647178209580985
SIM,1831,25,20-24,1856,2
SIM,1827,40,30-34,1867,1
SIM,1929,24,30-34,1953,95
SIM,1865,37,35-39,1902,18
SIM,1817,45,40-44,1862,1
STAT,1919,40,35-39,1959,0.25247233654071216
STAT,1865,25,25-29,1890,44.34543797435549
STAT,1882,48,25-29,1930,0.06411176612863637
STAT,1895,103,na,1998,6.865080232751477
STAT,1857,35,50-100,1892,1.1139884571531624
STAT,1974,16,40-44,1990,2.108352783233344
STAT,1846,12,na,1858,3100.1597897406587
STAT,1842,39,40-44,1881,3.5220656883722485
SIM,1904,75,na,1979,2716
STAT,1899,49,50-100,1948,0.21446630316016177
STAT,1932,40,na,1972,5826.524994832649
STAT,1946,57,na,2003,4676.453871954207
SIM,1882,29,35-39,1911,34
STAT,1907,41,na,1948,3955.7982414593152
SIM,1831,26,25-29,1857,39
SIM,1874,81,na,1955,450
SIM,1982,16,40-44,1998,8
STAT,1923,25,25-29,1948,87.76929753140683
SIM,1850,39,40-44,1889,2
STAT,1871,23,35-39,1894,6.679165924287293
STAT,1874,29,35-39,1903,11.318224060317682
SIM,1919,19,na,1938,4925
STAT,1871,11,na,1882,3045.200593831495
STAT,1924,34,30-34,1958,21.1795591103948
STAT,1917,73,na,1990,3172.2636759386824
STAT,1848,37,50-100,1885,1.3443239363601722
SIM,1867,39,45-49,1906,4
STAT,1969,22,45-49,1991,1.6274405653111288
SIM,1873,25,25-29,1898,6
SIM,1902,63,na,1965,3228
STAT,1833,69,na,1902,1032.6716839651608
SIM,1978,20,na,1998,5245
SIM,1892,39,45-49,1931,6
SIM,1853,27,15-19,1880,1
STAT,1894,92,na,1986,333.99584617048833
STAT,1907,30,15-19,1937,0.13996027382646392
STAT,1944,8,na,1952,4904.309144021551
SIM,1822,51,na,1873,1499
STAT,1957,16,na,1973,5602.089537100122
SIM,1912,29,30-34,1941,90
STAT,1819,40,30-34,1859,2.5807182074899893
SIM,1875,25,35-39,1900,17
STAT,1973,27,25-29,2000,98.66427928799163
STAT,1846,107,na,1953,0.004875268576514434
SIM,1838,45,na,1883,1631
STAT,1861,24,50-100,1885,0.39618202575082156
SIM,1981,27,25-29,2008,121
STAT,1925,26,50-100,1951,1.360942297493715
STAT,1833,79,na,1912,491.94197863956197
SIM,1854,38,20-24,1892,1
STAT,1941,26,30-34,1967,46.809900336715785
STAT,1956,33,15-19,1989,0.19990415171947734
STAT,1993,5,na,1998,6528.330489488269
STAT,1968,32,25-29,2000,13.579894794166698
SIM,1834,37,40-44,1871,9
STAT,1961,25,45-49,1986,2.589255057437073
STAT,1809,108,na,1917,8.513480104944497E-4
STAT,1885,14,na,1899,2963.126245694749
SIM,1968,37,45-49,2005,1
STAT,1945,30,35-39,1975,11.756267553534002
STAT,1835,35,40-44,1870,3.4495858443023395
STAT,1936,20,40-44,1956,3.7145412803490023
SIM,1838,41,45-49,1879,5
STAT,1845,27,15-19,1872,0.3721275739426108
SIM,1924,77,na,2001,2474
STAT,1873,38,30-34,1911,6.249700301788252
STAT,1910,30,na,1940,4246.690101556063
STAT,1856,15,30-34,1871,1.6790567287343503
STAT,1926,37,45-49,1963,0.9612962127068366
STAT,1937,18,na,1955,4123.783089477946
SIM,1808,48,45-49,1856,1
SIM,1887,44,45-49,1931,6
STAT,1869,22,40-44,1891,2.328882075134471
SIM,1807,84,na,1891,136
SIM,1907,35,35-39,1942,2
STAT,1875,20,15-19,1895,3.9578758159633134
STAT,1900,19,na,1919,4022.7044256133704
SIM,1981,21,50-100,2002,4
STAT,1847,17,30-34,1864,1.530680199312794
SIM,1928,39,35-39,1967,7
SIM,1865,36,30-34,1901,13
STAT,1989,26,50-100,2015,1.6531570675924068
SIM,1872,26,na,1898,2935
STAT,1946,38,25-29,1984,1.2970918756681782
STAT,1971,20,35-39,1991,13.817930437433409
STAT,1918,58,na,1976,4279.035262318533
STAT,1858,49,45-49,1907,0.20803133642457652
STAT,1870,35,50-100,1905,1.4100985269724988
STAT,1904,29,30-34,1933,41.433661717153576
STAT,1893,48,50-100,1941,0.1995499357265634
SIM,1853,12,na,1865,2816
STAT,1879,44,45-49,1923,1.779136081850563
STAT,1950,9,na,1959,5362.16882590481
STAT,1884,38,40-44,1922,4.966563623712479
SIM,1864,15,30-34,1879,3
STAT,1915,96,na,2011,171.26550702866945
SIM,1935,36,na,1971,6265
STAT,1878,28,15-19,1906,0.5447670439979901
SIM,1803,91,na,1894,26
SIM,1934,37,45-49,1971,4
STAT,1950,24,30-34,1974,39.321549629743394
SIM,1924,73,na,1997,3333
STAT,1845,30,30-34,1875,14.282566099335062
STAT,1975,26,30-34,2001,59.93908069469663
STAT,1851,37,40-44,1888,3.508511078783656
SIM,1836,30,50-100,1866,3
STAT,1830,72,na,1902,792.2352831495406
STAT,1969,15,20-24,1984,195.55303583838403
STAT,1864,43,50-100,1907,1.0807480593127092
SIM,1974,31,na,2005,6278
STAT,1866,22,15-19,1888,3.5576535548561243
SIM,1892,38,40-44,1930,5
SIM,1881,38,30-34,1919,4
SIM,1948,31,15-19,1979,2
SIM,1953,30,35-39,1983,3
SIM,1854,83,na,1937,632
STAT,1883,27,35-39,1910,10.894530670721018
STAT,1889,35,15-19,1924,0.08064241959894633
SIM,1900,26,35-39,1926,2
STAT,1914,24,20-24,1938,130.3438661275291
SIM,1891,27,35-39,1918,28
STAT,1822,47,15-19,1869,7.560384421209818E-4
SIM,1922,24,20-24,1946,274
SIM,1875,31,20-24,1906,4
SIM,1874,22,15-19,1896,3
SIM,1912,41,na,1953,3700
SIM,1829,27,30-34,1856,1
STAT,1900,40,40-44,1940,0.2526465010391936
STAT,1993,9,na,2002,6524.740645353287
SIM,1917,30,25-29,1947,17
STAT,1947,17,35-39,1964,5.45481213328487
STAT,1828,43,50-100,1871,1.0002021560896808
STAT,1840,49,na,1889,1773.9798394837333
STAT,1925,70,na,1995,4025.557480354182
SIM,1967,31,50-100,1998,3
STAT,1941,32,50-100,1973,1.0020408376936818
STAT,1926,55,na,1981,5066.0978167986805
STAT,1915,36,30-34,1951,2.1354041638339303
STAT,1985,2,na,1987,6459.236427065411
SIM,1910,21,25-29,1931,106
SIM,1905,35,25-29,1940,2
STAT,1976,39,45-49,2015,1.0805610404115091
STAT,1884,39,45-49,1923,2.2501384889914364
SIM,1831,32,45-49,1863,7
SIM,1940,37,na,1977,4990
SIM,1891,26,30-34,1917,77
SIM,1853,30,30-34,1883,39
SIM,1977,15,20-24,1992,232
STAT,1953,35,na,1988,5420.476610033286
SIM,1955,17,35-39,1972,6
STAT,1858,104,na,1962,0.21037060031645524
SIM,1823,37,30-34,1860,4
STAT,1855,32,50-100,1887,0.7938234266576147
STAT,1846,38,20-24,1884,0.8235803954734937
STAT,1856,27,25-29,1883,38.59357587606803
STAT,1877,20,50-100,1897,0.4924507406069659
STAT,1868,37,45-49,1905,2.210313520820768
SIM,1904,23,15-19,1927,11
STAT,1871,17,15-19,1888,6.857619038138396
STAT,1909,38,20-24,1947,0.28684505460622095
SIM,1958,32,na,1990,6039
STAT,1971,16,15-19,1987,66.35378865578087
SIM,1876,37,45-49,1913,1
SIM,1885,44,na,1929,3036
STAT,1951,36,40-44,1987,2.1213719323866265
SIM,1983,26,30-34,2009,98
STAT,1823,32,45-49,1855,4.818228905361326
SIM,1923,36,30-34,1959,1
STAT,1902,21,25-29,1923,93.6281185900561
SIM,1889,37,na,1926,3772
SIM,1864,27,25-29,1891,43
STAT,1928,0,na,1928,6550.939915447142
STAT,1986,18,20-24,2004,222.86798075095157
SIM,1942,32,25-29,1974,20
STAT,1975,27,35-39,2002,22.956474686823963
SIM,1939,22,25-29,1961,224
STAT,1856,31,45-49,1887,1.570366640268015
STAT,1857,36,30-34,1893,4.813337303529928
STAT,1872,29,25-29,1901,48.66863201496963
SIM,1954,29,35-39,1983,1
STAT,1909,30,25-29,1939,10.271970803178641
STAT,1889,26,25-29,1915,60.383211958056066
STAT,1833,23,15-19,1856,3.299399630626899
SIM,1886,26,15-19,1912,1
SIM,1867,36,40-44,1903,19
STAT,1829,25,15-19,1854,1.6500727328771552
STAT,1854,27,15-19,1881,0.3874928366413528
STAT,1878,26,15-19,1904,0.5485674985630429
STAT,1846,36,20-24,1882,0.8408628953365342
STAT,1936,16,20-24,1952,150.25174306074203
STAT,1946,29,35-39,1975,19.28109753392707
STAT,1871,96,na,1967,41.8551808692595
SIM,1929,40,na,1969,5225
SIM,1860,79,na,1939,1162
STAT,1902,29,20-24,1931,18.992910045198634
SIM,1817,48,45-49,1865,2
STAT,1924,37,35-39,1961,3.2905965391845213
STAT,1832,32,50-100,1864,0.8321115711703275
STAT,1840,39,30-34,1879,4.952813975272098
STAT,1871,20,30-34,1891,20.572772710897834
SIM,1806,48,35-39,1854,1
STAT,1903,38,50-100,1941,0.4334362717683847
STAT,1893,15,35-39,1908,0.8041310314261679
STAT,1840,50,na,1890,1752.0960630578331
SIM,1864,31,45-49,1895,5
SIM,1944,16,20-24,1960,181
STAT,1974,39,35-39,2013,3.747129612831249
SIM,1938,34,25-29,1972,1
STAT,1888,47,15-19,1935,5.40099616435577E-4
SIM,1932,5,na,1937,5809
SIM,1983,27,35-39,2010,34
SIM,1928,66,na,1994,4856
SIM,1880,29,25-29,1909,2
SIM,1814,54,na,1868,1231
STAT,1886,95,na,1981,119.01642509052847
SIM,1881,20,40-44,1901,3
STAT,1841,18,40-44,1859,0.20849829048838575
STAT,1861,25,40-44,1886,2.9368676375557814
SIM,1964,24,25-29,1988,4
SIM,1891,29,35-39,1920,39
STAT,1850,27,na,1877,2620.6988241508743
SIM,1966,37,35-39,2003,9
STAT,1961,18,20-24,1979,202.07838316075546
SIM,1954,38,25-29,1992,1
STAT,1883,29,35-39,1912,10.816665420561232
STAT,1934,32,25-29,1966,14.570505729522303
SIM,1832,37,30-34,1869,3
STAT,1851,39,40-44,1890,3.4363996292538417
SIM,1890,45,na,1935,3206
STAT,1928,32,50-100,1960,1.1930497052417117
SIM,1929,27,35-39,1956,3
STAT,1984,20,na,2004,6009.45209744752
SIM,1977,32,50-100,2009,4
SIM,1861,53,na,1914,1570
SIM,1960,25,na,1985,5844
SIM,1883,38,40-44,1921,6
SIM,1866,15,40-44,1881,1
SIM,1831,87,na,1918,96
SIM,1943,28,20-24,1971,2
STAT,1848,24,50-100,1872,0.5200244840158437
SIM,1810,46,35-39,1856,1
STAT,1809,48,45-49,1857,0.5974694120723205
STAT,1836,23,40-44,1859,2.485716110198794
SIM,1932,37,35-39,1969,4
SIM,1821,37,20-24,1858,2
STAT,1867,38,50-100,1905,1.3163171426353424
STAT,1969,32,50-100,2001,1.2149615289701299
STAT,1913,36,20-24,1949,0.3018244970157443
STAT,1894,7,na,1901,3865.1480345139257
STAT,1876,63,na,1939,2128.6372358697545
STAT,1844,31,na,1875,2190.3595365357814
SIM,1911,17,20-24,1928,39
SIM,1983,18,45-49,2001,6
STAT,1935,28,20-24,1963,28.717320902424635
SIM,1786,72,na,1858,293
SIM,1930,59,na,1989,5533
SIM,1981,26,20-24,2007,54
STAT,1903,17,20-24,1920,29.14175577957946
STAT,1908,42,25-29,1950,0.0763418527958327
SIM,1827,72,na,1899,606
SIM,1906,23,25-29,1929,1
SIM,1976,32,25-29,2008,6
STAT,1804,99,na,1903,0.8234514727164012
SIM,1889,28,40-44,1917,6
STAT,1959,33,40-44,1992,6.017889239651525
SIM,1994,18,20-24,2012,1
STAT,1814,49,30-34,1863,0.26043483249527144
STAT,1869,31,30-34,1900,19.59286823907565
STAT,1960,44,50-100,2004,0.18289890125881583
STAT,1893,24,25-29,1917,82.98247766971028
STAT,1875,38,40-44,1913,5.194695669516157
STAT,1858,15,40-44,1873,0.19463673982289148
STAT,1909,22,na,1931,4097.729363499255
SIM,1979,29,35-39,2008,4
SIM,1832,38,35-39,1870,6
STAT,1846,97,na,1943,5.553727900744862
STAT,1810,84,na,1894,189.41419729037955
SIM,1900,82,na,1982,1259
STAT,1832,35,15-19,1867,0.05041642572192489
SIM,1878,74,na,1952,1286
SIM,1875,38,50-100,1913,7
SIM,1899,23,30-34,1922,64
SIM,1844,20,na,1864,2543
SIM,1931,25,25-29,1956,25
STAT,1786,101,na,1887,0.2360141855832667
SIM,1918,26,20-24,1944,1
STAT,1870,29,15-19,1899,0.5124990587068309
STAT,1981,24,na,2005,5908.413841068778
SIM,1838,34,20-24,1872,2
SIM,1877,31,30-34,1908,50
SIM,1956,26,40-44,1982,19
STAT,1951,39,45-49,1990,0.9631253171464399
STAT,1874,26,30-34,1900,29.853183762214293
STAT,1962,17,na,1979,5442.658912398906
SIM,1913,32,50-100,1945,2
STAT,1824,38,35-39,1862,10.598677447978066
SIM,1978,23,45-49,2001,2
STAT,1905,32,50-100,1937,0.8787703163653977
STAT,1893,11,na,1904,3772.775372243791
STAT,1982,32,50-100,2014,1.368594374875625
SIM,1921,39,25-29,1960,3
STAT,1850,27,30-34,1877,30.506668583544034
STAT,1874,17,40-44,1891,0.21609031288979996
SIM,1911,24,45-49,1935,2
STAT,1829,64,na,1893,1273.4854259061667
STAT,1863,45,na,1908,2292.9714748152455
SIM,1887,1,na,1888,4287
SIM,1844,23,40-44,1867,5
STAT,1869,49,20-24,1918,0.01313128251912269
STAT,1920,85,na,2005,1541.8941105888864
SIM,1894,26,na,1920,3784
STAT,1976,36,40-44,2012,2.3800348942659295
STAT,1834,32,20-24,1866,3.159758052722623
STAT,1825,49,40-44,1874,0.2325298460846526
SIM,1928,21,45-49,1949,1
STAT,1843,90,na,1933,79.10712429561991
SIM,1852,8,na,1860,2531
STAT,1934,19,15-19,1953,70.49669819084811
STAT,1968,27,20-24,1995,26.425180282702485
SIM,1865,39,35-39,1904,15
STAT,1926,34,40-44,1960,5.452665103226498
SIM,1864,24,20-24,1888,83
SIM,1833,49,40-44,1882,1
STAT,1984,27,35-39,2011,24.714530915267726
STAT,1946,35,20-24,1981,0.348224317353162
SIM,1841,65,na,1906,1314
SIM,1853,33,35-39,1886,17
STAT,1819,43,35-39,1862,3.691599716348201
STAT,1948,26,40-44,1974,6.185096601308012
STAT,1891,109,na,2000,0.10332588895035927
SIM,1871,31,na,1902,2110
STAT,1952,39,na,1991,5348.973463890488
SIM,1879,59,na,1938,2299
STAT,1819,37,15-19,1856,0.16598509026585234
SIM,1943,29,50-100,1972,1
STAT,1865,34,15-19,1899,0.14701331639776952
SIM,1901,35,40-44,1936,4
STAT,1822,101,na,1923,0.46883957435763496
SIM,1887,38,25-29,1925,7
SIM,1983,17,40-44,2000,5
SIM,1867,37,45-49,1904,9
STAT,1880,17,15-19,1897,7.259387232301705
SIM,1966,15,45-49,1981,1
SIM,1876,3,na,1879,3414
STAT,1979,26,15-19,2005,1.1271020205912408
SIM,1882,26,30-34,1908,52
STAT,1864,0,na,1864,3941.7049015213124
STAT,1914,15,30-34,1929,2.924666793233361
STAT,1780,80,na,1860,345.9855625493845
SIM,2000,4,na,2004,6491
STAT,1860,16,35-39,1876,0.5920950888063793
SIM,1917,21,35-39,1938,18
STAT,1860,22,20-24,1882,66.07392914997472
STAT,1936,23,45-49,1959,1.2417591207517895
STAT,1909,21,35-39,1930,10.141191620192064
SIM,1812,73,na,1885,348
SIM,1849,35,35-39,1884,17
STAT,1879,38,25-29,1917,3.4522783030288915
STAT,1847,48,30-34,1895,0.07354729757352473
STAT,1956,24,25-29,1980,141.4249344158116
STAT,1958,15,45-49,1973,0.7575739644505822
SIM,1875,34,25-29,1909,30
STAT,1848,27,40-44,1875,3.7997448366692246
STAT,1925,16,45-49,1941,0.6978878761021121
STAT,1947,47,30-34,1994,0.120538662240667
SIM,1898,62,na,1960,3244
STAT,1824,37,30-34,1861,8.17067972268375
STAT,1928,36,na,1964,5491.96643451842
SIM,1923,27,40-44,1950,19
STAT,1867,31,20-24,1898,2.9244168941529405
SIM,1859,30,25-29,1889,22
STAT,1856,18,35-39,1874,0.567882059732473
STAT,1845,33,35-39,1878,8.030154300459866
STAT,1824,87,na,1911,109.01207129885836
SIM,1859,60,na,1919,1647
SIM,1880,67,na,1947,2185
SIM,1934,34,40-44,1968,19
SIM,1917,20,30-34,1937,3
STAT,1899,21,15-19,1920,5.231736880472134
SIM,1910,60,na,1970,3085
SIM,1911,45,na,1956,4619
SIM,1868,96,na,1964,12
SIM,1842,32,20-24,1874,8
STAT,1857,37,35-39,1894,6.357217337260571
STAT,1865,26,na,1891,2493.509615354639
STAT,1957,36,35-39,1993,3.7950571430548905
STAT,1873,54,50-100,1927,0.01730899174982914
STAT,1960,22,25-29,1982,139.29722519972927
STAT,1834,26,35-39,1860,11.629946337938149
STAT,1856,24,20-24,1880,69.45884902617252
STAT,1967,31,25-29,1998,13.589226069090806
STAT,1879,37,20-24,1916,0.9288874629607801
STAT,1908,29,15-19,1937,0.7656302441226656
SIM,1856,27,40-44,1883,7
STAT,1891,105,na,1996,1.9375989283039552
STAT,1991,19,40-44,2010,2.3117611480563727
SIM,1847,27,na,1874,2865
STAT,1950,27,35-39,1977,20.5752115728008
STAT,1782,103,na,1885,0.07262931094446842
STAT,1972,25,20-24,1997,27.112285191577083
STAT,1872,28,20-24,1900,13.54657924484817
STAT,1844,21,25-29,1865,60.21555156530029
STAT,1867,34,25-29,1901,10.941799349134318
STAT,1909,20,30-34,1929,31.046049044967972
SIM,1933,16,45-49,1949,5
STAT,1835,38,45-49,1873,1.5224527169640114
STAT,1960,5,na,1965,5909.80596576239
SIM,1843,38,45-49,1881,2
STAT,1903,24,45-49,1927,1.1390656351146053
SIM,1852,21,25-29,1873,142
STAT,1969,38,15-19,2007,0.028492627755290885
STAT,1882,59,na,1941,2190.701941456357
STAT,1895,39,20-24,1934,1.1463086297770344
STAT,1925,22,30-34,1947,39.689956385858196
SIM,1897,26,25-29,1923,68
STAT,1972,19,35-39,1991,6.19609937927925
STAT,1850,28,35-39,1878,11.605287303562836
SIM,1880,28,20-24,1908,15
SIM,1916,29,15-19,1945,5
SIM,1953,47,na,2000,5554
STAT,1872,26,20-24,1898,13.641084152035841
STAT,1824,32,25-29,1856,24.283586255418278
SIM,1983,24,30-34,2007,108
STAT,1833,91,na,1924,40.776354624730814
STAT,1834,54,30-34,1888,0.005353633248288746
SIM,1783,76,na,1859,649
SIM,1855,27,25-29,1882,36
SIM,1821,67,na,1888,741
STAT,1838,47,25-29,1885,0.05134011018576247
STAT,1852,43,40-44,1895,2.1053283910398477
STAT,1870,48,50-100,1918,0.275914074428529
STAT,1878,49,20-24,1927,0.014157564617557242
SIM,1834,35,40-44,1869,6
SIM,1936,43,na,1979,3929
SIM,1929,75,na,2004,3065
STAT,1868,50,40-44,1918,0.011840458783319923
STAT,1931,8,na,1939,6025.949070185506
STAT,1936,22,40-44,1958,3.711978688153064
STAT,1893,96,na,1989,117.39607062965466
SIM,1872,34,20-24,1906,4
STAT,1876,29,45-49,1905,1.315101209562743
STAT,1916,30,15-19,1946,0.154355682244382
STAT,1841,31,15-19,1872,0.1552231330316858
SIM,1987,17,25-29,2004,75
SIM,1944,22,40-44,1966,6
STAT,1827,33,50-100,1860,1.5117459558499122
STAT,1889,42,25-29,1931,0.9123881782051417
SIM,1823,34,25-29,1857,25
STAT,1845,17,20-24,1862,15.099279889942373
STAT,1826,35,40-44,1861,3.6873197415012777
SIM,1950,20,15-19,1970,8
SIM,1876,50,40-44,1926,1
STAT,1850,37,25-29,1887,3.0109143715674502
STAT,1893,39,45-49,1932,2.8786689324057853
SIM,1883,11,na,1894,2778
SIM,1950,60,na,2010,4280
SIM,1948,58,na,2006,4089
STAT,1866,32,30-34,1898,18.67599394567293
STAT,1829,49,25-29,1878,0.05723405924000691
SIM,1839,44,30-34,1883,2
STAT,1984,22,30-34,2006,47.26439001997495
SIM,1832,32,25-29,1864,4
STAT,1843,52,30-34,1895,0.005940879244948224
STAT,1874,5,na,1879,3253.36664001844
STAT,1911,35,na,1946,4237.006993329219
STAT,1815,41,15-19,1856,0.031879702475662706
STAT,1819,50,45-49,1869,0.027967633371977333
SIM,1853,76,na,1929,744
STAT,1847,27,25-29,1874,39.1222515362034
STAT,1824,47,25-29,1871,0.0782431167769998
SIM,1846,29,25-29,1875,3
STAT,1895,8,na,1903,3905.0174959586675
STAT,1817,37,40-44,1854,19.69741834860786
SIM,1860,25,40-44,1885,1
STAT,1885,27,45-49,1912,1.2780802061301875
STAT,1999,16,40-44,2015,2.3853322587793007
SIM,1938,34,na,1972,4086
STAT,1883,66,na,1949,1850.5937110077646
STAT,1993,20,30-34,2013,47.91246115091382
SIM,1823,46,na,1869,2170
SIM,1870,68,na,1938,2192
SIM,1818,52,45-49,1870,1
SIM,1992,15,40-44,2007,5
STAT,1942,20,15-19,1962,6.4466390479748386
SIM,1865,34,30-34,1899,19
STAT,1876,51,30-34,1927,0.007135242529453543
STAT,1970,33,40-44,2003,5.7589852961074355
STAT,1928,81,na,2009,2565.2857081141633
SIM,1982,30,20-24,2012,11
STAT,1957,21,15-19,1978,8.129028199525209
STAT,1833,30,25-29,1863,9.569078037134506
STAT,1849,40,30-34,1889,0.906644785444804
STAT,1901,20,50-100,1921,0.6631192369479086
SIM,1881,17,25-29,1898,12
SIM,1947,18,25-29,1965,141
SIM,1957,23,50-100,1980,1
STAT,1878,50,50-100,1928,0.018459656927487897
STAT,1835,47,50-100,1882,0.16155390836097974
STAT,1886,19,na,1905,3057.9608606962374
SIM,1963,21,na,1984,5774
SIM,1893,27,45-49,1920,2
SIM,1825,37,40-44,1862,5
SIM,1949,31,30-34,1980,5
STAT,1873,17,25-29,1890,6.678181970617638
STAT,1849,48,40-44,1897,0.1310244035662245
SIM,1964,37,25-29,2001,1
STAT,1852,25,40-44,1877,3.337280767235068
SIM,1909,21,na,1930,4410
STAT,1906,88,na,1994,838.1465159696721
STAT,1870,33,35-39,1903,11.473185918732792
SIM,1802,84,na,1886,86
SIM,1979,35,20-24,2014,1
STAT,1882,30,20-24,1912,3.071420006611229
SIM,1985,27,45-49,2012,1
SIM,1875,49,45-49,1924,2
STAT,1892,15,40-44,1907,0.2657864356994964
STAT,1855,39,25-29,1894,2.425238930263534
STAT,1827,51,35-39,1878,0.010734106935069852
STAT,1975,14,na,1989,5978.271352097285
STAT,1867,49,45-49,1916,0.2489779448885002
STAT,1974,30,20-24,2004,3.750905496060913
STAT,1835,51,40-44,1886,0.00682923194800016
STAT,1856,42,50-100,1898,0.929007132451556
STAT,1863,46,50-100,1909,0.24854111182656446
STAT,1796,74,na,1870,531.0510697650947
SIM,1971,30,45-49,2001,4
STAT,1896,27,20-24,1923,17.882088146546376
SIM,1853,40,45-49,1893,4
SIM,1910,38,na,1948,3610
SIM,1919,30,35-39,1949,27
SIM,1839,37,40-44,1876,3
SIM,1890,30,20-24,1920,5
STAT,1925,39,50-100,1964,0.5801207848345407
STAT,1815,82,na,1897,258.8980231698744
STAT,1771,115,na,1886,2.3521955309574935E-4
SIM,1884,47,45-49,1931,1
STAT,1885,42,40-44,1927,2.5859745666406235
STAT,1918,37,50-100,1955,0.5105989746096958
SIM,1820,93,na,1913,17
STAT,1834,24,35-39,1858,7.020316174398904
STAT,1843,27,40-44,1870,3.699040483953779
STAT,1949,41,na,1990,5187.768178776469
STAT,1973,15,20-24,1988,202.45975202245737
SIM,1814,85,na,1899,85
STAT,1923,36,na,1959,5033.459485908275
STAT,1810,50,25-29,1860,0.013508192182592634
STAT,1850,52,20-24,1902,7.556041924671304E-4
STAT,1801,90,na,1891,33.09131101974069
STAT,1834,21,30-34,1855,21.897176538351857
SIM,1888,26,25-29,1914,115
STAT,1956,31,na,1987,5890.50010857378
STAT,1874,30,15-19,1904,0.16959954735108354
STAT,1852,82,na,1934,439.9001826594024
STAT,1959,49,45-49,2008,0.3392624516631757
SIM,1969,26,na,1995,5790
STAT,1948,41,15-19,1989,0.002110747458538832
STAT,1942,19,na,1961,4436.860255689518
SIM,1842,21,30-34,1863,1
SIM,1951,20,na,1971,5545
STAT,1995,18,20-24,2013,226.41115437459095
STAT,1871,30,45-49,1901,2.0182216256732395
SIM,1955,34,na,1989,6460
SIM,1872,19,25-29,1891,7
SIM,1973,35,25-29,2008,3
STAT,1864,19,25-29,1883,5.969608428431422
STAT,1817,38,50-100,1855,4.298035153628793
STAT,1820,73,na,1893,697.0916655393191
STAT,1821,90,na,1911,48.2182353268603
STAT,1965,35,25-29,2000,1.4640225029993528
SIM,1979,28,30-34,2007,136
STAT,1885,47,50-100,1932,0.28139441408342497
STAT,1970,40,30-34,2010,0.19246889444422197
STAT,1834,47,40-44,1881,0.1656909648181329
SIM,1870,32,45-49,1902,2
STAT,1881,29,25-29,1910,46.750403423366
SIM,1898,36,35-39,1934,15
SIM,1981,15,20-24,1996,411
STAT,1820,35,45-49,1855,5.513795132553884
STAT,1856,44,na,1900,2007.4616544079986
STAT,1896,45,20-24,1941,0.010420756973172322
SIM,1851,85,na,1936,772
STAT,1899,31,30-34,1930,27.717854632687928
STAT,1922,19,na,1941,4887.505863843225
STAT,1835,27,na,1862,1756.8238813542653
SIM,1974,17,na,1991,5994
STAT,1915,2,na,1917,4924.616097230948
SIM,1875,12,na,1887,3511
STAT,1860,41,25-29,1901,0.5999783449757052
STAT,1857,34,30-34,1891,15.55862338940473
STAT,1894,40,40-44,1934,3.370559301905816
SIM,1933,6,na,1939,6681
SIM,1827,27,20-24,1854,1
SIM,1857,40,30-34,1897,2
SIM,1942,19,50-100,1961,1
STAT,1911,79,na,1990,2178.2398970855734
STAT,1837,17,50-100,1854,0.09456445217825986
STAT,1840,15,20-24,1855,18.632271369010045
SIM,1791,63,na,1854,898
STAT,1948,16,25-29,1964,57.247586688666125
SIM,1956,23,15-19,1979,10
STAT,1850,22,25-29,1872,70.73240063588607
STAT,1887,36,na,1923,3061.7050590130525
STAT,1937,20,35-39,1957,10.594793566218202
SIM,1855,47,na,1902,1770
STAT,1847,28,na,1875,1986.3246102788378
STAT,1838,79,na,1917,605.5719827121844
STAT,1838,29,25-29,1867,45.95199617769467
STAT,1853,41,35-39,1894,1.81103819458424
STAT,1859,52,40-44,1911,0.009626596201933185
STAT,1967,21,30-34,1988,41.58308283191109
STAT,1855,27,na,1882,2116.647304219534
STAT,1851,13,na,1864,2291.173442084753
SIM,1944,4,na,1948,4711
SIM,1816,39,40-44,1855,10
SIM,1992,22,30-34,2014,5
STAT,1857,27,40-44,1884,2.7732601007536277
STAT,1864,83,na,1947,409.07190529338874
SIM,1842,29,na,1871,2250
STAT,1843,45,40-44,1888,0.17541563493746093
STAT,1968,47,45-49,2015,0.3258534840719745
SIM,1826,46,45-49,1872,1
STAT,1805,52,na,1857,1424.0311602078302
STAT,1847,42,20-24,1889,0.12288091146160451
SIM,1965,7,na,1972,5618
STAT,1876,47,45-49,1923,0.28023044153099486
STAT,1840,33,20-24,1873,2.6138110155793846
STAT,1948,23,15-19,1971,7.051081614136939
STAT,1818,53,35-39,1871,0.010024474130778366
STAT,1811,44,35-39,1855,5.974782762445752
STAT,1914,43,50-100,1957,0.13419331370224047
SIM,1924,42,na,1966,4916
SIM,1884,29,45-49,1913,4
SIM,1888,44,25-29,1932,5
SIM,1956,16,25-29,1972,53
SIM,1975,21,30-34,1996,54
STAT,1997,18,30-34,2015,20.533779264964593
SIM,1977,28,20-24,2005,36
STAT,1937,40,na,1977,4337.587740862295
STAT,1890,24,20-24,1914,96.56656794640446
SIM,1919,51,na,1970,5187
STAT,1965,42,15-19,2007,0.002299361421222763
SIM,1976,29,45-49,2005,2
STAT,1850,18,40-44,1868,0.22873074088768675
STAT,1990,16,20-24,2006,224.12956384337173
SIM,1943,70,na,2013,3900
SIM,1939,21,20-24,1960,245
STAT,1979,24,15-19,2003,8.480624438034193
STAT,1826,38,45-49,1864,1.5627184821117708
STAT,1891,22,15-19,1913,4.705457946234614
STAT,1818,46,45-49,1864,0.2954827736699142
STAT,1908,91,na,1999,521.5161848813289
STAT,1819,39,15-19,1858,0.13334152956121612
SIM,1866,45,50-100,1911,1
STAT,1860,19,40-44,1879,0.19389810144868286
STAT,1876,26,40-44,1902,3.5859081946132343
STAT,1820,42,35-39,1862,2.239495832133209
STAT,1936,25,45-49,1961,1.9108469197519087
STAT,1868,53,45-49,1921,0.015832538276675086
SIM,1835,26,45-49,1861,2
SIM,1912,3,na,1915,4316
STAT,1976,22,35-39,1998,14.565446682988727
STAT,1872,51,45-49,1923,0.016897480449773957
SIM,1855,24,20-24,1879,147
SIM,1898,26,40-44,1924,1
STAT,1774,95,na,1869,0.10363133410399451
SIM,1955,25,20-24,1980,31
STAT,1858,48,40-44,1906,0.15219232703518643
STAT,1856,38,50-100,1894,1.0756036430612506
SIM,1848,38,45-49,1886,4
STAT,1882,49,na,1931,2483.1033914012996
STAT,1967,15,na,1982,5308.875922095842
STAT,1972,38,20-24,2010,0.4008873210893492
STAT,1994,19,45-49,2013,0.8313504174537714
SIM,1918,34,na,1952,3899
STAT,1850,25,30-34,1875,30.949507996964396
SIM,1823,31,20-24,1854,1
STAT,1844,43,35-39,1887,1.5314619604199753
STAT,1898,36,40-44,1934,6.860366170049297
STAT,1984,25,35-39,2009,24.736046600697524
SIM,1877,78,na,1955,981
STAT,1991,22,20-24,2013,184.5106452709524
SIM,1831,33,na,1864,1678
STAT,1847,83,na,1930,305.46337098036827
SIM,1875,23,35-39,1898,17
SIM,1835,47,na,1882,1985
SIM,1882,23,25-29,1905,132
STAT,1849,34,50-100,1883,0.7329433305655058
STAT,1902,48,25-29,1950,0.052315346561375445
SIM,1834,38,45-49,1872,2
STAT,1873,35,25-29,1908,3.4253293823145734
STAT,1873,41,50-100,1914,1.250651239507038
SIM,1894,40,35-39,1934,1
STAT,1886,40,35-39,1926,2.226566224454439
STAT,1783,102,na,1885,0.06426388893760197
SIM,1826,28,45-49,1854,3
STAT,1823,41,20-24,1864,0.17000794897572696
STAT,1876,54,35-39,1930,0.009987995633822914
SIM,1863,39,25-29,1902,6
SIM,1895,12,na,1907,4007
SIM,1959,20,35-39,1979,16
SIM,1911,55,na,1966,4454
SIM,1921,79,na,2000,2723
STAT,1935,37,na,1972,6074.440903729802
STAT,1849,31,na,1880,1965.4203239345786
STAT,1859,37,45-49,1896,1.8326217222036303
SIM,1863,11,na,1874,2954
STAT,1880,15,15-19,1895,7.2931154040932835
STAT,1970,36,45-49,2006,1.0155438709907705
SIM,1835,44,45-49,1879,3
STAT,1852,28,45-49,1880,1.210506902632937
SIM,1852,43,35-39,1895,1
STAT,1973,23,na,1996,5466.6784349169975
SIM,1867,25,na,1892,2488
SIM,1867,48,na,1915,2157
SIM,1881,41,50-100,1922,2
SIM,1941,54,na,1995,3759
STAT,1817,53,na,1870,1819.807691469854
SIM,1849,33,35-39,1882,23
STAT,1827,44,45-49,1871,1.9238443795199014
STAT,1913,33,50-100,1946,0.9458103963023278
SIM,1878,64,na,1942,2106
SIM,1898,33,30-34,1931,29
SIM,1902,94,na,1996,70
SIM,1839,19,40-44,1858,1
STAT,1928,15,45-49,1943,0.7297592677452541
STAT,1840,18,25-29,1858,5.850982090948668
SIM,1930,38,na,1968,6030
STAT,1874,38,25-29,1912,3.384747517234197
STAT,1821,35,na,1856,1773.719512620633
SIM,1947,15,20-24,1962,319
SIM,1842,24,35-39,1866,21
SIM,1876,53,45-49,1929,1
STAT,1842,24,40-44,1866,1.9936013464223394
SIM,1888,19,35-39,1907,2
STAT,1973,34,50-100,2007,1.2562504885418488
STAT,1910,18,na,1928,4409.549600830638
SIM,1868,43,45-49,1911,6
STAT,1888,38,25-29,1926,3.886472758584458
SIM,1842,29,40-44,1871,10
SIM,1832,28,40-44,1860,5
STAT,1918,21,35-39,1939,11.752584328476223
SIM,1882,38,25-29,1920,5
STAT,1849,43,35-39,1892,1.3933656118913098
STAT,1980,22,45-49,2002,1.8085778913988189
SIM,1971,20,na,1991,5769
SIM,1861,41,35-39,1902,1
SIM,1921,33,50-100,1954,3
SIM,1926,21,35-39,1947,39
STAT,1881,36,15-19,1917,0.06280812784306126
STAT,1947,25,20-24,1972,23.85264370668428
STAT,1956,44,15-19,2000,0.002429005981411512
STAT,1856,40,20-24,1896,0.14123772243242774
STAT,1879,53,20-24,1932,8.749296233226085E-4
SIM,1962,16,na,1978,4871
STAT,1834,29,40-44,1863,3.53336713596982
STAT,1881,26,20-24,1907,13.103433584153475
SIM,1871,28,20-24,1899,1
STAT,1866,28,45-49,1894,1.1834683887012443
STAT,1844,36,45-49,1880,1.9564525904057717
STAT,1984,18,45-49,2002,0.8185172950831874
STAT,1824,35,30-34,1859,8.576238677474636
STAT,1852,46,45-49,1898,0.22313570013551196
STAT,1863,28,20-24,1891,11.796655798692015
STAT,1865,57,na,1922,2092.5404791292494
STAT,1896,48,25-29,1944,0.048903584979708786
SIM,1865,77,na,1942,1217
STAT,1888,45,15-19,1933,5.480391645981997E-4
STAT,1977,27,45-49,2004,2.705500270754087
SIM,1850,24,40-44,1874,4
STAT,1851,65,na,1916,1340.1315350324699
STAT,1855,36,20-24,1891,0.6590688218371356
STAT,1837,30,na,1867,2008.9356999090514
STAT,1834,65,na,1899,1542.260791402247
STAT,1881,31,na,1912,2667.127486281302
SIM,1898,72,na,1970,2724
STAT,1839,50,50-100,1889,0.012275256479570435
STAT,1966,15,30-34,1981,17.578565900604325
SIM,1894,33,45-49,1927,2
STAT,1930,25,50-100,1955,1.4620600018114218
STAT,1829,28,20-24,1857,20.578349866938208
STAT,1871,19,15-19,1890,6.777074191074561
STAT,1845,40,45-49,1885,1.0536480352695474
SIM,1973,32,20-24,2005,4
STAT,1910,46,50-100,1956,0.2443919959534172
SIM,1832,35,30-34,1867,3
SIM,1975,38,40-44,2013,7
SIM,1966,35,35-39,2001,6
SIM,1983,29,35-39,2012,4
STAT,1955,14,na,1969,6015.745567900788
STAT,1870,48,na,1918,2527.5355696555707
STAT,1898,43,30-34,1941,0.12361809182985507
SIM,1863,36,20-24,1899,1
STAT,1844,18,45-49,1862,0.06904419773720226
STAT,1891,15,25-29,1906,8.120110544469789
STAT,1911,49,30-34,1960,0.09690678251275997
SIM,1961,44,na,2005,5548
STAT,1808,49,na,1857,1675.4561475368537
SIM,1837,28,20-24,1865,2
STAT,1870,26,45-49,1896,1.2675537513842359
SIM,1965,21,15-19,1986,18
STAT,1854,25,15-19,1879,0.4319975215611244
STAT,1967,38,40-44,2005,2.2210360741768125
STAT,1959,46,40-44,2005,0.24817555899392524
SIM,1836,64,na,1900,1046
STAT,1825,53,25-29,1878,0.004672601685981583
SIM,1991,10,na,2001,6711
STAT,1883,24,30-34,1907,19.985808665898134
SIM,1939,24,25-29,1963,4
STAT,1832,26,25-29,1858,40.938070152313315
STAT,1876,44,40-44,1920,2.6471184815532705
STAT,1815,39,30-34,1854,15.892399487797787
SIM,1884,44,40-44,1928,6
SIM,1841,30,25-29,1871,24
STAT,1850,48,na,1898,2286.987928676861
STAT,1860,37,40-44,1897,4.07155324296033
STAT,1881,95,na,1976,95.8294202370638
SIM,1970,33,35-39,2003,6
STAT,1880,38,50-100,1918,1.4943765223017282
STAT,1893,46,35-39,1939,0.11552449020835082
STAT,1970,43,35-39,2013,0.3018361497627386
SIM,1823,39,30-34,1862,7
SIM,1840,26,25-29,1866,50
SIM,1922,71,na,1993,3676
SIM,1975,30,30-34,2005,32
SIM,1907,18,na,1925,4664
STAT,1840,36,25-29,1876,2.7603198114787966
STAT,1900,43,45-49,1943,0.16522627430048928
SIM,1897,6,na,1903,4227
SIM,1848,65,na,1913,1096
STAT,1804,102,na,1906,0.12747218953259784
STAT,1832,33,15-19,1865,0.12787642066122096
STAT,1887,19,50-100,1906,0.06302252504656165
SIM,1818,99,na,1917,3
STAT,1947,64,na,2011,4399.18334960102
SIM,1859,81,na,1940,66
SIM,1891,24,30-34,1915,39
STAT,1944,48,30-34,1992,0.11484308713270637
STAT,1855,46,15-19,1901,3.4132426991617193E-4
SIM,1929,35,20-24,1964,3
STAT,1829,46,20-24,1875,0.012406693726481439
SIM,1942,39,na,1981,4995
STAT,1822,37,20-24,1859,1.875461756501287
STAT,1977,30,na,2007,6018.096417475854
SIM,1805,72,na,1877,729
STAT,1845,29,15-19,1874,0.3668030060503379
STAT,1970,14,na,1984,5672.624081613135
STAT,1813,44,50-100,1857,3.65843805365482
SIM,1899,26,na,1925,4194
STAT,1894,43,45-49,1937,0.15307008993025645
STAT,1904,48,50-100,1952,0.22670444982970225
STAT,1969,24,45-49,1993,1.6263340936961026
STAT,1962,15,45-49,1977,0.7390521731453998
STAT,1903,39,30-34,1942,1.8718757111092794
STAT,1983,31,25-29,2014,15.389532983093401
STAT,1975,29,35-39,2004,22.933753396629005
STAT,1827,107,na,1934,0.0038299222138481136
SIM,1801,67,na,1868,1041
SIM,1789,69,na,1858,1089
STAT,1837,38,20-24,1875,0.6725892976571669
STAT,1839,96,na,1935,6.809646879593602
STAT,1978,0,na,1978,6238.386336574604
SIM,1829,37,25-29,1866,1
SIM,1892,37,50-100,1929,4
SIM,1970,15,45-49,1985,2
STAT,1835,82,na,1917,290.79932873488696
SIM,1953,57,na,2010,5287
STAT,1847,45,25-29,1892,0.04476242734990119
STAT,1884,37,50-100,1921,1.3998980646927819
SIM,1830,37,20-24,1867,1
SIM,1884,26,40-44,1910,10
STAT,1886,15,45-49,1901,0.07988726483493667
STAT,1981,22,50-100,2003,1.0653261547089403
SIM,1891,17,40-44,1908,1
SIM,1887,25,na,1912,3825
SIM,1845,38,20-24,1883,1
SIM,1983,23,na,2006,6568
STAT,1921,38,35-39,1959,3.112467942640678
SIM,1983,21,25-29,2004,363
STAT,1979,29,20-24,2008,29.101691003643243
STAT,1938,22,15-19,1960,6.08292018769124
STAT,1880,14,na,1894,3148.80466927184
STAT,1989,18,25-29,2007,71.60965866036022
STAT,1898,18,40-44,1916,0.2845228935361557
STAT,1839,42,15-19,1881,0.011542803687007042
SIM,1859,38,20-24,1897,2
STAT,1973,42,20-24,2015,0.027393077588538668
SIM,1964,31,50-100,1995,4
STAT,1987,24,20-24,2011,183.67344395949576
STAT,1982,27,25-29,2009,107.34900760605437
STAT,1883,17,40-44,1900,0.20651443218449153
STAT,1886,33,45-49,1919,2.11381608766931
STAT,1896,61,na,1957,2902.0646653590466
STAT,1848,14,na,1862,3115.8885140970947
STAT,1949,23,30-34,1972,38.69035612457581
SIM,1955,28,25-29,1983,194
STAT,1781,85,na,1866,63.836462461570754
STAT,1994,16,40-44,2010,2.3299945317407205
STAT,1919,49,35-39,1968,0.16040045544644302
SIM,1862,48,20-24,1910,1
STAT,1860,47,35-39,1907,0.12960814155827904
SIM,1851,33,na,1884,2817
SIM,1933,39,50-100,1972,2
STAT,1844,40,30-34,1884,1.0104088310605914
STAT,1947,20,15-19,1967,6.947574873876555
STAT,1978,29,25-29,2007,104.0098637099121
SIM,1919,29,50-100,1948,6
STAT,1924,22,15-19,1946,7.2469051820096615
SIM,1942,16,na,1958,5043
STAT,1911,43,20-24,1954,0.01935216741779151
STAT,1909,76,na,1985,2476.5305697835684
STAT,1905,62,na,1967,3351.108898620161
STAT,1848,33,25-29,1881,11.430026498141602
SIM,1925,30,30-34,1955,52
STAT,1888,35,20-24,1923,1.0556452922251813
STAT,1990,19,25-29,2009,71.57249235513554
STAT,1950,30,15-19,1980,0.1789407693721396
STAT,1818,48,50-100,1866,0.29882784255543254
SIM,1849,38,40-44,1887,5
STAT,1854,48,20-24,1902,0.009653523814884761
SIM,1858,36,40-44,1894,3
SIM,1856,15,25-29,1871,14
SIM,1918,23,50-100,1941,4
SIM,1975,1,na,1976,6133
STAT,1966,15,50-100,1981,0.5403246616814069
STAT,1987,23,50-100,2010,1.0872700848925172
SIM,1957,23,30-34,1980,60
STAT,1983,27,40-44,2010,7.64226119572769
SIM,1969,31,50-100,2000,7
STAT,1902,45,20-24,1947,0.01114776171746062
STAT,1865,41,25-29,1906,0.6716753924482238
SIM,1849,30,30-34,1879,57
STAT,1870,79,na,1949,795.3889539078634
STAT,1802,52,40-44,1854,0.04199585851858966
SIM,1874,28,45-49,1902,1
SIM,1818,90,na,1908,97
SIM,1923,1,na,1924,5928
SIM,1833,35,25-29,1868,2
SIM,1959,41,na,2000,5911
SIM,1824,37,25-29,1861,2
STAT,1830,29,20-24,1859,13.482734804581291
STAT,1828,35,15-19,1863,0.060378863816387573
SIM,1948,25,30-34,1973,50
SIM,1953,39,35-39,1992,8
STAT,1825,35,25-29,1860,5.040313285847366
STAT,1853,27,20-24,1880,13.530822912678994
STAT,1894,82,na,1976,1320.5751759761565
STAT,1898,96,na,1994,131.39868332831952
SIM,1815,71,na,1886,796
SIM,1852,33,40-44,1885,2
STAT,1877,35,45-49,1912,2.4157982813894052
SIM,1954,9,na,1963,5543
STAT,1843,15,50-100,1858,0.06356653493770072
STAT,1951,16,50-100,1967,0.5150103818655157
STAT,1839,54,30-34,1893,0.00459085281758674
STAT,1848,48,25-29,1896,0.06043259521064401
SIM,1965,37,40-44,2002,1
SIM,1834,62,na,1896,1305
SIM,1889,32,25-29,1921,1
STAT,1841,29,30-34,1870,27.41029946468446
SIM,1849,48,50-100,1897,1
SIM,1861,27,20-24,1888,21
SIM,1879,25,20-24,1904,14
SIM,1847,80,na,1927,826
SIM,1875,20,30-34,1895,32
SIM,1948,38,50-100,1986,1
SIM,1975,33,35-39,2008,2
SIM,1847,29,40-44,1876,1
SIM,1927,39,na,1966,5017
SIM,1923,25,na,1948,5488
STAT,1851,88,na,1939,108.86517718122927
STAT,1924,15,25-29,1939,59.81485973444254
STAT,1949,41,30-34,1990,0.178580223064242
STAT,1849,54,25-29,1903,0.0026698076393385714
STAT,1851,25,25-29,1876,39.84645005050473
SIM,1856,33,25-29,1889,17
STAT,1844,33,40-44,1877,4.292869852764291
SIM,1833,28,35-39,1861,13
STAT,1839,47,40-44,1886,0.1383321963921984
STAT,1831,45,15-19,1876,3.8021786799596815E-4
STAT,1851,43,25-29,1894,0.5055486632672986
SIM,1885,35,45-49,1920,5
STAT,1947,28,25-29,1975,85.8921165039931
STAT,1967,33,35-39,2000,13.419818996250399
STAT,1892,25,35-39,1917,14.051227184217232
STAT,1810,53,30-34,1863,0.02135763496958833
STAT,1898,75,na,1973,2173.7457636800937
STAT,1912,37,30-34,1949,2.0548505626946674
STAT,1966,33,30-34,1999,23.134355528212044
STAT,1773,115,na,1888,3.5781892274436733E-4
SIM,1896,17,20-24,1913,21
SIM,1921,54,na,1975,4967
SIM,1925,68,na,1993,4116
STAT,1882,29,40-44,1911,3.352511052921439
STAT,1888,17,20-24,1905,24.050075364338753
STAT,1955,40,45-49,1995,0.26571182099750157
STAT,1978,36,15-19,2014,0.031187856468193498
SIM,1798,85,na,1883,76
STAT,1841,99,na,1940,1.68381852407608
STAT,1848,40,15-19,1888,0.01503563193225485
STAT,1998,16,25-29,2014,73.45050643185743
STAT,1934,52,na,1986,5810.427146622725
STAT,1971,40,45-49,2011,0.2535107875780759
SIM,1955,20,15-19,1975,1
SIM,1897,48,35-39,1945,1
STAT,1915,17,25-29,1932,10.468875539391792
STAT,1841,21,20-24,1862,78.1774696894965
STAT,1827,37,20-24,1864,1.1273468920937075
STAT,1831,38,25-29,1869,2.8177445472501317
STAT,1892,18,45-49,1910,0.09423716423948145
STAT,1950,19,50-100,1969,0.5108919173431541
SIM,1921,13,na,1934,5566
STAT,1950,63,na,2013,4684.646855828921
SIM,1901,28,50-100,1929,2
STAT,1919,75,na,1994,3048.4371367174276
STAT,1957,44,30-34,2001,0.2014853386055363
STAT,1834,96,na,1930,7.836188744903307
STAT,1858,8,na,1866,2582.4908038452786
SIM,1825,38,50-100,1863,1
STAT,1853,16,45-49,1869,0.07869799892889204
STAT,1839,29,40-44,1868,2.949940192063062
STAT,1893,18,40-44,1911,0.2661050552910033
STAT,1877,28,20-24,1905,14.033389127186753
SIM,1970,30,30-34,2000,6
SIM,1920,37,30-34,1957,4
STAT,1856,39,40-44,1895,3.8153786949423383
STAT,1898,31,15-19,1929,0.223018131086098
STAT,1821,49,20-24,1870,0.021120672371328034
SIM,1844,51,na,1895,2076
STAT,1810,46,40-44,1856,0.6809018942341036
STAT,1762,94,na,1856,5.246700933599998
STAT,1811,50,40-44,1861,0.03261558342360881
STAT,1870,23,40-44,1893,2.3634739460905916
STAT,1899,37,na,1936,3754.3585628103383
SIM,1919,16,20-24,1935,184
SIM,1923,17,25-29,1940,133
SIM,1958,32,35-39,1990,34
SIM,1835,37,20-24,1872,1
SIM,1978,28,15-19,2006,2
STAT,1889,48,35-39,1937,0.11093106616139504
SIM,1969,37,25-29,2006,4
STAT,1959,30,35-39,1989,14.077548633066618
SIM,1965,44,30-34,2009,1
STAT,1842,27,25-29,1869,40.25542892318362
STAT,1917,15,35-39,1932,1.0469451775677434
STAT,1851,18,35-39,1869,0.5259145521781305
STAT,1895,23,na,1918,3541.7790171809943
STAT,1898,46,35-39,1944,0.12352024726634547
STAT,1992,20,15-19,2012,8.853021647539142
SIM,1840,42,25-29,1882,1
STAT,1884,83,na,1967,803.034962273463
SIM,1862,80,na,1942,1131
SIM,1967,30,35-39,1997,21
SIM,1820,41,45-49,1861,6
STAT,1833,29,45-49,1862,1.0267306751843557
STAT,1842,27,45-49,1869,1.0566011141388394
SIM,1841,36,35-39,1877,4
SIM,1997,15,20-24,2012,423
SIM,1929,38,25-29,1967,1
STAT,1805,101,na,1906,0.2344964747034203
STAT,1897,33,20-24,1930,4.153578979291362
SIM,1897,78,na,1975,1731
STAT,1906,24,na,1930,3955.155768242476
SIM,1849,39,na,1888,2626
STAT,1996,18,15-19,2014,76.09135221401344
STAT,1902,10,na,1912,4223.858145316058
STAT,1877,51,45-49,1928,0.017504708320433725
STAT,1879,61,na,1940,2251.7411441992913
STAT,1945,39,35-39,1984,3.1347571231140225
STAT,1919,7,na,1926,5096.649798588131
STAT,1870,42,45-49,1912,1.7006673496684874
STAT,1832,42,25-29,1874,0.5456793013322374
SIM,1968,23,40-44,1991,9
SIM,1815,39,45-49,1854,2
SIM,1885,28,20-24,1913,19
STAT,1936,5,na,1941,4445.111681957051
SIM,1850,27,25-29,1877,43
STAT,1915,86,na,2001,1252.0912805487897
STAT,1832,23,20-24,1855,81.87255678592237
SIM,2006,0,na,2006,7594
SIM,1874,32,30-34,1906,38
STAT,1987,27,25-29,2014,108.90743924088952
STAT,1910,39,20-24,1949,0.2883224465830402
SIM,1966,44,na,2010,5808
STAT,1922,10,na,1932,5305.692620174819
STAT,1833,36,35-39,1869,6.338812165394879
STAT,1989,15,20-24,2004,224.2235200834826
STAT,1926,24,na,1950,5086.829942623142
SIM,1840,23,20-24,1863,8
STAT,1949,16,40-44,1965,1.8778401650516987
STAT,1859,61,na,1920,1717.8454864704502
SIM,1859,42,40-44,1901,5
STAT,1867,28,na,1895,2562.3996662860272
STAT,1962,42,45-49,2004,0.25575163518604155
STAT,1942,6,na,1948,4799.629899454642
SIM,1873,19,40-44,1892,1
SIM,1846,63,na,1909,1065
SIM,1908,35,na,1943,3889
SIM,1968,19,20-24,1987,344
SIM,1904,21,na,1925,4334
STAT,1842,45,25-29,1887,0.045482677864478516
SIM,1970,42,45-49,2012,1
STAT,1955,46,20-24,2001,0.017654025366581113
STAT,1831,42,45-49,1873,1.4343854322411258
STAT,1897,15,20-24,1912,27.484603305028212
STAT,1853,34,45-49,1887,1.7511609737527163
SIM,1838,49,40-44,1887,1
STAT,1865,19,40-44,1884,0.19394907600776437
STAT,1898,39,45-49,1937,0.6643396735421431
STAT,1892,48,40-44,1940,0.13792856290585742
STAT,1907,10,na,1917,4398.307989087107
STAT,1978,26,20-24,2004,28.886627992101634
SIM,1990,24,20-24,2014,171
STAT,1860,44,30-34,1904,1.0548826078407267
STAT,1949,26,35-39,1975,20.24696159362909
STAT,1890,79,na,1969,1482.3462770066187
STAT,1878,75,na,1953,1240.4560527108795
STAT,1885,3,na,1888,3389.471010260588
SIM,1824,34,20-24,1858,1
STAT,1889,38,40-44,1927,6.19641356418527
SIM,1897,38,40-44,1935,1
STAT,1828,32,45-49,1860,2.0106461211090805
STAT,1982,24,20-24,2006,181.0451340153747
STAT,1897,18,25-29,1915,8.721609671395958
SIM,1886,39,na,1925,2021
SIM,1882,25,na,1907,3331
STAT,1839,51,25-29,1890,0.0028224325090805
STAT,1840,18,na,1858,2370.0785944360186
SIM,1872,37,25-29,1909,10
SIM,1919,20,na,1939,4972
SIM,1902,20,35-39,1922,22
SIM,1825,32,35-39,1857,18
STAT,1892,22,30-34,1914,25.764297958740396
STAT,1855,58,na,1913,1682.7288816859204
STAT,1936,23,na,1959,4030.184724819126
STAT,1919,46,30-34,1965,0.11183670783477663
STAT,1943,48,15-19,1991,4.676476830026015E-4
STAT,1911,46,25-29,1957,0.05814772822933281
SIM,1903,80,na,1983,1288
STAT,1899,39,40-44,1938,1.4788322127093483
SIM,1996,10,na,2006,6940
STAT,1870,30,30-34,1900,20.024015201658152
STAT,1822,53,20-24,1875,0.0013158812929230097
STAT,1866,10,na,1876,2916.3048628621636
STAT,1975,16,35-39,1991,6.390291469279705
STAT,1864,37,25-29,1901,2.966844480324957
SIM,1890,36,30-34,1926,12
SIM,1903,25,na,1928,3757
STAT,1819,96,na,1915,5.716244549651429
STAT,1893,36,40-44,1929,6.416278480471418
STAT,1836,44,na,1880,2218.5711424841616
STAT,1832,30,na,1862,1946.4671378093922
STAT,1806,78,na,1884,321.7124161959331
STAT,1879,102,na,1981,6.751798237075722
SIM,1846,26,20-24,1872,9
SIM,1885,42,35-39,1927,4
SIM,1968,26,45-49,1994,6
STAT,1855,52,20-24,1907,6.245497231716139E-4
STAT,1882,36,30-34,1918,6.0364948338994475
STAT,1839,39,50-100,1878,1.1396227000194277
STAT,1846,43,na,1889,2387.4593362814967
STAT,1886,36,15-19,1922,0.06868658278603505
STAT,1893,43,30-34,1936,0.11561600106239507
STAT,1802,64,na,1866,1149.1720753650354
STAT,1903,91,na,1994,486.42418913605263
STAT,1880,6,na,1886,3270.334761726411
SIM,1917,0,na,1917,5949
SIM,1896,38,na,1934,3715
SIM,1896,93,na,1989,532
STAT,1899,36,50-100,1935,1.9504906341399944
SIM,1854,17,15-19,1871,9
SIM,1939,19,na,1958,4370
SIM,1953,36,30-34,1989,6
STAT,1988,27,20-24,2015,30.25909530534284
STAT,1849,62,na,1911,1416.6163204144775
STAT,1867,46,40-44,1913,0.18498975203898202
STAT,1877,32,40-44,1909,5.205989306487966
STAT,1945,44,50-100,1989,0.1534006321450491
SIM,1862,22,45-49,1884,2
SIM,1986,26,20-24,2012,58
STAT,1894,106,na,2000,1.0815307447701366
STAT,1864,44,15-19,1908,0.014038141307879892
STAT,1816,52,20-24,1868,0.0014447802115765186
STAT,1846,17,15-19,1863,7.706839678059634
SIM,1975,26,45-49,2001,3
SIM,1943,56,na,1999,5094
SIM,1852,59,na,1911,1465
STAT,1826,108,na,1934,0.0010085571857000983
STAT,1865,16,50-100,1881,0.052879521165423916
SIM,1806,67,na,1873,875
STAT,1906,57,na,1963,3565.9328626083206
STAT,1844,15,40-44,1859,0.19678047163550563
SIM,1802,53,na,1855,1274
SIM,1984,24,25-29,2008,169
STAT,1861,41,40-44,1902,2.1677357982553365
SIM,1849,51,na,1900,2415
STAT,1806,52,25-29,1858,0.01246785287648126
STAT,1976,24,25-29,2000,142.7887682039929
STAT,1838,44,20-24,1882,0.14272360646695903
SIM,1847,39,50-100,1886,3
STAT,1854,22,45-49,1876,0.6675043266948201
STAT,1971,21,50-100,1992,0.9652660796079784
SIM,1926,37,50-100,1963,3
STAT,1802,102,na,1904,0.13994932425448997
STAT,1988,22,15-19,2010,8.81517335885303
STAT,1971,31,35-39,2002,13.623255831937476
STAT,1881,42,20-24,1923,0.17656176311335742
SIM,1863,43,45-49,1906,3
STAT,1867,53,30-34,1920,0.00631082270789292
STAT,1899,34,35-39,1933,15.874519684407222
STAT,1829,107,na,1936,0.0034548102055241745
STAT,1891,31,25-29,1922,14.668915242443436
SIM,1874,25,40-44,1899,13
STAT,1981,8,na,1989,6342.080917356134
STAT,1866,25,40-44,1891,3.2259791002786162
STAT,1955,49,25-29,2004,0.0840337042265693
STAT,1831,35,20-24,1866,0.778266331889842
SIM,1864,42,50-100,1906,2
STAT,1877,42,35-39,1919,2.1711059279918477
SIM,1834,85,na,1919,315
STAT,1949,44,35-39,1993,0.27993769140310537
STAT,1883,40,30-34,1923,1.3111796443531973
STAT,1932,47,50-100,1979,0.35416762921772715
STAT,1871,65,na,1936,1940.2905186356297
STAT,1943,20,30-34,1963,35.31705798500051
STAT,1930,7,na,1937,5964.796032511528
STAT,1945,36,30-34,1981,2.3692931353839453
SIM,1846,19,30-34,1865,2
STAT,1838,26,20-24,1864,13.022357593801685
STAT,1889,45,30-34,1934,0.13907756222620266
STAT,1924,53,na,1977,4938.743780198767
SIM,1930,83,na,2013,2075
STAT,1811,53,45-49,1864,0.04233506309545615
SIM,1976,26,40-44,2002,10
STAT,1978,25,na,2003,5930.730591561183
STAT,1810,49,45-49,1859,0.8795772988878884
STAT,1898,36,20-24,1934,1.2080644732227843
STAT,1968,44,40-44,2012,0.3734317368267235
STAT,1932,75,na,2007,3814.407765314389
SIM,1922,39,na,1961,5018
STAT,1939,28,50-100,1967,1.1546920168775128
SIM,1867,80,na,1947,582
SIM,1879,28,25-29,1907,93
STAT,1841,24,25-29,1865,63.55319585211944
SIM,1836,33,na,1869,1658
SIM,1951,20,30-34,1971,99
STAT,1950,30,50-100,1980,1.151298098887431
SIM,1883,26,25-29,1909,54
STAT,1848,15,25-29,1863,7.552699315834051
STAT,1939,22,30-34,1961,33.32454761333699
STAT,1838,19,30-34,1857,1.802572975415372
STAT,1926,9,na,1935,5631.451815353531
SIM,1874,35,35-39,1909,2
SIM,1885,33,50-100,1918,2
SIM,1864,39,40-44,1903,5
STAT,1843,22,35-39,1865,7.349486407709335
STAT,1866,35,35-39,1901,7.637486144984439
STAT,1819,45,50-100,1864,0.48682425239901284
STAT,1897,43,15-19,1940,0.0014691489176955046
STAT,1877,33,50-100,1910,1.0952607350283097
SIM,1947,22,30-34,1969,85
STAT,1978,33,45-49,2011,2.5246563797528156
SIM,1936,20,na,1956,3351
STAT,1833,26,40-44,1859,2.8512453752157496
STAT,1962,41,na,2003,5715.399402643864
STAT,1850,70,na,1920,1444.3891840981287
STAT,1864,34,20-24,1898,2.761497110713181
SIM,1841,33,30-34,1874,5
STAT,1879,2,na,1881,3892.1017879726564
STAT,1965,27,30-34,1992,56.696691016529606
SIM,1947,28,50-100,1975,2
STAT,1818,50,30-34,1868,0.0073575782677410065
STAT,1986,26,50-100,2012,1.6445604180783657
STAT,1791,74,na,1865,491.8952724031563
STAT,1890,27,25-29,1917,59.650088066956044
STAT,1795,88,na,1883,41.37100366110647
SIM,1852,40,30-34,1892,2
STAT,1955,37,na,1992,5938.073478853579
SIM,1957,26,35-39,1983,2
STAT,1887,47,20-24,1934,0.015447522288203442
STAT,1949,19,45-49,1968,0.6700201154381554
STAT,1875,26,25-29,1901,50.62160658271577
STAT,1844,25,50-100,1869,0.6645034347919201
STAT,1890,34,15-19,1924,0.19909266595602926
STAT,1842,42,20-24,1884,0.1264401613690633
SIM,1848,35,40-44,1883,4
SIM,1868,65,na,1933,2283
STAT,1852,108,na,1960,0.005045418961498622
SIM,1940,47,50-100,1987,3
STAT,1973,18,25-29,1991,64.65902296686563
STAT,1910,49,15-19,1959,3.9471786828676003E-4
SIM,1836,32,45-49,1868,5
SIM,1864,51,na,1915,2513
STAT,1917,30,30-34,1947,19.19313907889026
STAT,1984,31,40-44,2015,6.541932737901805
STAT,1833,33,30-34,1866,15.796167091408364
STAT,1971,26,30-34,1997,57.54525018925784
SIM,1860,31,25-29,1891,1
STAT,1866,43,na,1909,2454.386096283369
STAT,1766,102,na,1868,0.20155525498460064
SIM,1989,25,50-100,2014,3
STAT,1844,52,45-49,1896,0.01207389186420572
STAT,1856,46,30-34,1902,0.08546946693436638
SIM,1981,18,25-29,1999,158
SIM,1858,39,45-49,1897,5
STAT,1875,44,25-29,1919,0.7554962208877963
STAT,1818,70,na,1888,675.4141117061776
STAT,1842,24,20-24,1866,65.92929165102883
SIM,1895,29,20-24,1924,21
SIM,1850,24,20-24,1874,128
SIM,1883,44,25-29,1927,2
SIM,1937,60,na,1997,3873
STAT,1887,29,20-24,1916,15.064114840993662
STAT,1874,23,25-29,1897,67.42368474139842
STAT,1857,50,30-34,1907,0.005427099882405836
STAT,1880,38,20-24,1918,0.9382571933364376
STAT,1818,43,40-44,1861,2.923984952800774
STAT,1993,16,45-49,2009,0.8296657920808698
STAT,1843,48,45-49,1891,0.23382253398204805
STAT,1864,16,20-24,1880,20.890146566461205
STAT,1897,36,25-29,1933,4.464370874843195
STAT,1910,21,30-34,1931,31.2749584436333
SIM,1859,24,40-44,1883,5
STAT,1818,48,na,1866,1225.2633801978275
SIM,1968,29,15-19,1997,1
STAT,1824,66,na,1890,1014.1394935299902
SIM,1956,20,30-34,1976,46
STAT,1901,110,na,2011,0.0537046805104085
STAT,1824,44,40-44,1868,3.0953074802195535
STAT,1916,42,30-34,1958,0.15121072841700708
STAT,1862,81,na,1943,526.6680783310229
STAT,1958,44,45-49,2002,0.2612888951853691
STAT,1891,37,35-39,1928,10.088236473057496
SIM,1851,64,na,1915,2095
STAT,1950,34,45-49,1984,2.1858824113593296
STAT,1885,78,na,1963,1184.0207204864353
STAT,1841,43,30-34,1884,1.0486296381986895
SIM,1832,44,40-44,1876,1
STAT,1906,48,45-49,1954,0.22121499240956308
STAT,1885,38,20-24,1923,0.882930129619632
STAT,1972,22,15-19,1994,7.89156474507266
STAT,1850,41,30-34,1891,1.1888765637037038
STAT,1877,102,na,1979,6.129855963715543
STAT,1966,30,na,1996,5563.176903182514
STAT,1874,38,45-49,1912,2.3435175719012817
STAT,1997,16,na,2013,6204.486115054127
SIM,1857,29,35-39,1886,27
STAT,1933,31,50-100,1964,1.2871681365341519
SIM,1950,32,30-34,1982,42
SIM,1791,94,na,1885,11
STAT,1842,17,30-34,1859,1.5750164049361983
STAT,1836,45,15-19,1881,3.909911242241837E-4
STAT,1961,34,20-24,1995,3.7022880810122523
STAT,1900,0,na,1900,4702.119082862199
STAT,1932,45,35-39,1977,0.20283728080840294
STAT,1815,46,40-44,1861,0.35471847940191203
STAT,1892,18,50-100,1910,0.07067787317961108
STAT,1914,21,15-19,1935,6.043732071437571
STAT,1972,37,50-100,2009,0.639144878489571
STAT,1951,30,30-34,1981,22.09466514577431
SIM,1922,21,15-19,1943,13
STAT,1907,19,na,1926,4265.417389783097
STAT,1942,32,30-34,1974,19.37153258187236
STAT,1859,48,20-24,1907,0.010893043811843264
STAT,1966,20,na,1986,5284.833885137292
STAT,1848,52,30-34,1900,0.006291078878519763
STAT,1826,41,25-29,1867,0.48894455648031676
STAT,1879,19,20-24,1898,21.24864851710385
STAT,1832,45,30-34,1877,0.08152378333228802
STAT,1911,58,na,1969,3810.8031181673923
STAT,1850,34,40-44,1884,4.574237681403075
STAT,1792,91,na,1883,28.310320357528752
STAT,1904,76,na,1980,2306.034835446459
SIM,1953,22,na,1975,5037
STAT,1932,38,45-49,1970,1.0562489854212458
STAT,1937,16,15-19,1953,51.104515832678985
STAT,1979,36,30-34,2015,2.986346527332372
SIM,1945,16,15-19,1961,97
STAT,1969,44,20-24,2013,0.026370555625662272
STAT,1978,9,na,1987,6189.062801697735
STAT,1832,51,na,1883,1547.6253075506336
SIM,1938,55,na,1993,3940
SIM,1774,92,na,1866,24
STAT,1925,48,na,1973,5121.598660820221
STAT,1955,30,15-19,1985,0.20090189029684505
STAT,1911,19,50-100,1930,0.08613077591732762
STAT,1841,14,na,1855,2712.6285
SIM,1867,89,na,1956,196
STAT,1948,20,30-34,1968,38.10946994662664
STAT,1904,22,50-100,1926,0.6757980931922511
STAT,1915,46,45-49,1961,0.253414473527141
SIM,1867,40,25-29,1907,2
SIM,1935,48,50-100,1983,2
STAT,1865,47,35-39,1912,0.14509623568025126
STAT,1898,29,30-34,1927,38.995002736758764
STAT,1933,19,35-39,1952,6.450541705912558
SIM,1781,74,na,1855,611
STAT,1815,53,30-34,1868,0.011449060128540429
STAT,1965,47,40-44,2012,0.23627465147656532
STAT,1926,46,20-24,1972,0.015772198004341348
SIM,1919,19,25-29,1938,146
STAT,1900,34,35-39,1934,16.078190731944698
SIM,1848,38,25-29,1886,9
STAT,1794,72,na,1866,723.1032231771322
STAT,1887,21,45-49,1908,0.904584838141336
SIM,1800,72,na,1872,770
SIM,1941,19,35-39,1960,6
STAT,1928,18,15-19,1946,65.81913514524302
STAT,1881,45,25-29,1926,0.06475544706917746
SIM,1863,40,40-44,1903,2
STAT,1943,38,20-24,1981,0.3320548970293662
STAT,1923,36,50-100,1959,0.5617250689972695
STAT,1959,42,na,2001,5826.424741496307
SIM,1882,46,na,1928,3101
STAT,1843,15,25-29,1858,7.352530691742394
STAT,1883,97,na,1980,56.26076080281622
STAT,1830,24,15-19,1854,5.679953747184906
STAT,1907,26,30-34,1933,42.904963339632694
STAT,1874,42,30-34,1916,1.3566001016617044
STAT,1864,62,na,1926,1883.3701576677422
SIM,1840,38,40-44,1878,4
SIM,1951,38,20-24,1989,1
SIM,1829,30,na,1859,1877
SIM,1882,42,30-34,1924,2
STAT,1854,35,50-100,1889,1.015543087336057
STAT,1915,40,50-100,1955,0.13689895342746633
STAT,1794,62,na,1856,1177.80910164
SIM,1851,15,25-29,1866,17
STAT,1875,41,20-24,1916,0.19025668281614053
SIM,1936,18,15-19,1954,43
STAT,1837,84,na,1921,240.8907725653026
SIM,1842,17,25-29,1859,10
STAT,1929,40,15-19,1969,0.0023016037398587027
STAT,1952,36,20-24,1988,0.37593301565159515
STAT,1841,39,45-49,1880,2.0453033002391843
STAT,1851,34,na,1885,1929.0974597236175
STAT,1965,40,50-100,2005,0.17638939667764908
STAT,1865,53,50-100,1918,0.015473334549917814
STAT,1950,41,35-39,1991,0.28596609685058016
SIM,1901,8,na,1909,4497
SIM,1963,46,na,2009,6441
SIM,1849,30,na,1879,2716
STAT,1868,16,40-44,1884,0.2076921056688156
SIM,1977,17,50-100,1994,1
STAT,1978,30,40-44,2008,6.28957566477859
STAT,1816,67,na,1883,895.5105907546906
STAT,1920,28,25-29,1948,82.99698706756057
STAT,1849,29,35-39,1878,8.738305748172419
SIM,1888,2,na,1890,3184
STAT,1797,69,na,1866,842.7790006918226
STAT,1898,11,na,1909,4033.8991846617605
STAT,1852,51,na,1903,2039.7483700479245
SIM,1970,24,na,1994,5605
STAT,1899,27,25-29,1926,66.88152584765535
SIM,1869,31,45-49,1900,1
SIM,1902,38,25-29,1940,2
STAT,1903,33,20-24,1936,2.5405342276485743
STAT,1918,80,na,1998,2294.430666999524
STAT,1927,44,15-19,1971,0.002214781876600068
STAT,1849,95,na,1944,10.304949237442358
STAT,1920,35,15-19,1955,0.024295968480132185
SIM,1897,14,na,1911,4198
SIM,1851,54,na,1905,2444
SIM,1905,82,na,1987,1005
STAT,1874,20,20-24,1894,81.90225258057451
STAT,1882,15,50-100,1897,0.055480961106097515
SIM,1940,42,30-34,1982,1
STAT,1824,51,30-34,1875,0.007963766950943483
SIM,1896,60,na,1956,3118
SIM,1936,78,na,2014,1706
STAT,1838,51,45-49,1889,0.012756393077453571
SIM,1882,35,40-44,1917,12
STAT,1851,44,na,1895,1808.0618036929122
STAT,1849,36,25-29,1885,2.307325265235294
STAT,2003,10,na,2013,6882.137157060149
SIM,1823,69,na,1892,1175
SIM,1893,30,25-29,1923,6
SIM,1866,9,na,1875,2787
STAT,1980,25,15-19,2005,1.1368732926275031
STAT,1924,44,45-49,1968,0.2276355164475898
SIM,1981,21,na,2002,5635
STAT,1864,52,na,1916,2206.9021613642976
STAT,1842,18,50-100,1860,0.048127230737097224
SIM,1857,36,25-29,1893,5
STAT,1977,38,20-24,2015,0.42305017383296073
SIM,1915,26,30-34,1941,54
STAT,1892,18,25-29,1910,8.175075647736163
STAT,1885,30,25-29,1915,11.885129258283753
STAT,1964,43,na,2007,5601.199296281565
STAT,1917,48,20-24,1965,0.013284442130911673
STAT,1973,19,50-100,1992,0.558815959049376
SIM,1900,30,40-44,1930,15
STAT,1926,49,25-29,1975,0.07507614804998915
STAT,1848,30,20-24,1878,3.419634743165759
STAT,1930,84,na,2014,2042.3696156523079
STAT,1849,85,na,1934,212.4728848173664
STAT,1932,42,30-34,1974,0.20001316546335263
SIM,1901,32,35-39,1933,41
STAT,1858,45,50-100,1903,0.22331461508739442
SIM,1948,28,35-39,1976,42
SIM,1873,37,40-44,1910,11
STAT,1891,34,30-34,1925,24.68990182663702
STAT,1904,31,15-19,1935,0.23696517891259578
SIM,1884,27,na,1911,2701
STAT,1841,46,35-39,1887,0.1266491488903698
SIM,1904,11,na,1915,4448
STAT,1824,47,45-49,1871,0.320579439582712
SIM,1863,25,45-49,1888,3
STAT,1819,65,na,1884,1177.1551815647276
SIM,1871,20,45-49,1891,1
STAT,1851,40,20-24,1891,0.12720867201120298
SIM,1874,28,25-29,1902,104
SIM,1808,48,na,1856,1700
SIM,1848,35,20-24,1883,3
STAT,1952,21,35-39,1973,13.06927440725509
STAT,1848,48,45-49,1896,0.2476057741970234
STAT,1857,53,35-39,1910,0.007613673807469554
STAT,1951,33,35-39,1984,12.793035859038403
STAT,1897,40,45-49,1937,0.16199580150535356
SIM,1844,44,50-100,1888,2
STAT,1975,40,30-34,2015,0.20283933172221086
STAT,1938,40,50-100,1978,0.1394404290619375
STAT,1881,48,30-34,1929,0.10639700340365782
SIM,1818,78,na,1896,671
STAT,1834,32,na,1866,2533.4233037731647
STAT,1920,60,na,1980,4362.396980764071
SIM,1832,47,45-49,1879,1
SIM,1824,37,45-49,1861,1
STAT,1816,44,35-39,1860,3.8201878382633288
STAT,1869,28,50-100,1897,0.7124089918757033
STAT,1952,46,15-19,1998,5.312176876811315E-4
STAT,1918,40,40-44,1958,0.30768996777474883
STAT,1941,33,40-44,1974,4.739856873537207
STAT,1974,20,25-29,1994,139.75039715845884
STAT,1940,45,40-44,1985,0.19312500035462438
STAT,1836,44,50-100,1880,1.1152257887340473
SIM,1919,10,na,1929,5656
SIM,1959,30,50-100,1989,5
STAT,1899,92,na,1991,371.76178320644453
SIM,1869,21,30-34,1890,27
STAT,1863,49,25-29,1912,0.05691114446960453
STAT,1937,49,na,1986,4257.507193509659
STAT,1962,36,50-100,1998,0.6401909911514025
STAT,1907,19,40-44,1926,0.30889926826424463
SIM,1857,34,50-100,1891,6
STAT,1853,15,na,1868,2781.84416235544
STAT,1817,84,na,1901,229.99006311175302
STAT,1850,37,45-49,1887,2.0846845152645974
SIM,1881,84,na,1965,316
STAT,1972,31,15-19,2003,0.19366075131365118
SIM,1833,45,na,1878,1577
SIM,1934,31,35-39,1965,24
SIM,1837,35,45-49,1872,5
SIM,1954,0,na,1954,5751
STAT,1884,22,50-100,1906,0.4649711822487636
SIM,1928,80,na,2008,3087
STAT,1865,44,30-34,1909,1.1809404381701751
STAT,1831,34,na,1865,2156.976636040397
STAT,1933,16,30-34,1949,18.884581391756832
STAT,1927,19,na,1946,5252.109980012935
SIM,1926,40,40-44,1966,3
STAT,1871,32,50-100,1903,1.0519656759871905
STAT,1941,40,30-34,1981,0.15840898445949667
STAT,1837,30,45-49,1867,1.616447411059198
STAT,1897,35,na,1932,3670.115668311302
STAT,1948,30,25-29,1978,12.456427426947714
SIM,1820,72,na,1892,1224
SIM,1941,16,30-34,1957,12
STAT,1938,35,na,1973,4422.24433305253
SIM,1873,44,30-34,1917,6
STAT,1805,52,45-49,1857,0.0518605740642325
STAT,1912,41,15-19,1953,0.0017207769195200675
SIM,1856,30,20-24,1886,5
STAT,1865,37,40-44,1902,4.558101380225573
STAT,1887,59,na,1946,2513.526909431054
STAT,1900,31,30-34,1931,28.073476383818832
STAT,1971,21,na,1992,5357.11208194299
SIM,1867,79,na,1946,745
SIM,1898,29,25-29,1927,10
STAT,1832,38,40-44,1870,3.8047098622510003
SIM,1819,64,na,1883,449
STAT,1829,35,45-49,1864,2.380001021929078
STAT,1926,31,35-39,1957,12.756860837401605
SIM,1845,30,45-49,1875,5
STAT,1912,75,na,1987,2704.299366497156
STAT,1898,39,25-29,1937,0.9595072328805513
SIM,1848,28,30-34,1876,57
STAT,1842,34,35-39,1876,9.220684412949195
STAT,1915,43,40-44,1958,0.2902034454377095
STAT,1878,21,na,1899,2858.3821968085167
SIM,1956,23,35-39,1979,20
SIM,1891,43,35-39,1934,6
STAT,1883,43,35-39,1926,2.029806310494555
STAT,1873,47,40-44,1920,0.2008168588731773
STAT,1957,6,na,1963,5981.543624105127
SIM,1883,5,na,1888,2874
STAT,1850,44,35-39,1894,1.8389727514447443
STAT,1804,66,na,1870,1028.3811976977227
STAT,1929,18,50-100,1947,0.5503739865835918
STAT,1934,41,35-39,1975,0.3241109929549475
STAT,1849,51,20-24,1900,5.746743702141993E-4
SIM,1850,34,35-39,1884,1
STAT,1861,51,35-39,1912,0.008299112588879302
STAT,1948,23,35-39,1971,12.472308739746643
SIM,1865,13,na,1878,3390
SIM,1969,21,35-39,1990,35
STAT,1983,26,na,2009,6144.964986522975
STAT,1875,19,35-39,1894,0.6508786610357681
STAT,1902,99,na,2001,50.21166912734489
STAT,1931,80,na,2011,2884.177961698796
SIM,1956,30,25-29,1986,33
STAT,1975,33,40-44,2008,6.069285804512184
STAT,1861,44,45-49,1905,1.4165056137854841
STAT,1910,31,50-100,1941,0.924728478723769
SIM,1895,43,na,1938,3519
SIM,1845,19,15-19,1864,6
STAT,1870,109,na,1979,0.03497089027773158
STAT,1824,54,35-39,1878,0.010852569106739113
STAT,1821,99,na,1920,1.1582733277625203
SIM,1860,39,20-24,1899,4
STAT,1964,47,25-29,2011,0.08019826127917588
STAT,1973,3,na,1976,5871.268769172092
STAT,1830,47,20-24,1877,0.011071953943095266
STAT,1905,93,na,1998,327.43566880514425
SIM,1956,29,na,1985,5439
STAT,1896,102,na,1998,11.830452046299616
STAT,1907,29,35-39,1936,16.12962391796142
STAT,1882,71,na,1953,1504.6072750333603
STAT,1922,49,40-44,1971,0.20771060412275566
STAT,1846,54,20-24,1900,7.418700384732747E-4
SIM,1870,21,50-100,1891,1
STAT,1890,31,45-49,1921,2.4690479242041876
SIM,1907,19,35-39,1926,5
STAT,1839,17,25-29,1856,5.878801862391172
STAT,1837,39,na,1876,1849.4743353675087
STAT,1883,12,na,1895,2915.8911304810827
SIM,1793,75,na,1868,653
STAT,1881,15,45-49,1896,0.07305021358269313
SIM,1933,71,na,2004,4826
SIM,1907,73,na,1980,2876
STAT,1867,28,40-44,1895,3.2163239861366053
STAT,1826,49,20-24,1875,0.008412325273798402
SIM,1847,17,25-29,1864,21
STAT,1806,48,40-44,1854,0.620811312936615
SIM,1911,24,na,1935,4701
STAT,1920,25,20-24,1945,23.255569205411838
STAT,1956,49,40-44,2005,0.24896185803619636
STAT,1966,45,35-39,2011,0.19421428740066146
STAT,1917,98,na,2015,91.67850317757744
SIM,1922,40,na,1962,5019
SIM,1872,41,45-49,1913,7
STAT,1859,18,40-44,1877,0.19402993147339923
SIM,1824,44,35-39,1868,3
STAT,1952,39,25-29,1991,1.3998828632973896
SIM,1878,18,15-19,1896,7
SIM,1960,39,25-29,1999,4
STAT,1836,67,na,1903,1442.6556949773899
STAT,1897,79,na,1976,1744.3381782671743
STAT,1896,30,na,1926,3666.6588725721217
STAT,1956,31,50-100,1987,1.2877205044950875
STAT,1853,31,40-44,1884,4.492764816432746
STAT,1877,17,45-49,1894,0.07841606944798069
SIM,1915,29,35-39,1944,39
SIM,1821,44,50-100,1865,2
STAT,1855,25,45-49,1880,1.0978473751720814
STAT,1881,35,50-100,1916,1.3796153093145003
STAT,1852,39,20-24,1891,0.7194521018684046
STAT,1854,108,na,1962,0.0063696424222871315
STAT,1904,22,na,1926,3919.4039469799013
STAT,1892,15,20-24,1907,25.762298432539446
STAT,1966,38,45-49,2004,1.011345859122563
STAT,1930,47,25-29,1977,0.0806274125332455
STAT,1919,52,na,1971,4520.121430420334
STAT,1862,35,15-19,1897,0.05521015239271319
STAT,1864,41,45-49,1905,1.549178356449714
STAT,1924,40,15-19,1964,0.002113305012006554
STAT,1935,44,20-24,1979,0.028667453496090355
SIM,1898,41,na,1939,3855
STAT,1823,49,na,1872,1438.058926824204
STAT,1948,2,na,1950,5311.215249574064
SIM,1964,49,40-44,2013,1
STAT,1885,48,15-19,1933,4.546578305044243E-4
STAT,1905,97,na,2002,107.56719883473653
STAT,1840,43,15-19,1883,0.01140913589578076
STAT,1955,45,50-100,2000,0.36211932189852303
STAT,1891,27,40-44,1918,4.272627248981834
STAT,1946,32,15-19,1978,0.16766248882260174
STAT,1863,20,45-49,1883,0.728115963002307
STAT,1850,80,na,1930,636.8115015520323
SIM,1914,48,45-49,1962,1
STAT,1795,98,na,1893,0.5692371995108472
STAT,1930,21,15-19,1951,7.894644506546709
STAT,1837,19,15-19,1856,6.4445710240033405
SIM,1893,62,na,1955,2433
STAT,1916,34,45-49,1950,1.859003466426871
STAT,1816,41,30-34,1857,2.703427394825295
STAT,1940,48,45-49,1988,0.26423995066939815
SIM,1855,27,50-100,1882,1
STAT,1972,16,na,1988,5440.237759482146
SIM,1879,26,na,1905,2828
STAT,1829,31,na,1860,2097.5340431614045
SIM,1883,42,na,1925,2460
STAT,1851,29,50-100,1880,0.5854474693778683
STAT,1879,92,na,1971,199.5458169075761
SIM,1832,50,na,1882,1936
STAT,1858,52,25-29,1910,0.0031718488587965717
STAT,1981,25,30-34,2006,63.558085948659894
STAT,1814,46,25-29,1860,0.1627882858174332
STAT,1947,32,30-34,1979,20.876796735901678
SIM,1850,31,30-34,1881,19
STAT,1951,21,na,1972,5036.684503850093
STAT,1863,46,20-24,1909,0.012143703013043525
SIM,1853,45,na,1898,2213
SIM,1868,75,na,1943,1235
STAT,1823,44,25-29,1867,0.6474073771921519
STAT,1942,31,35-39,1973,11.24248653426673
STAT,1907,74,na,1981,2611.481483514704
SIM,1853,35,na,1888,2301
SIM,1955,32,30-34,1987,6
SIM,1938,3,na,1941,4244
SIM,1851,10,na,1861,3168
SIM,1941,31,50-100,1972,1
SIM,1960,1,na,1961,6343
SIM,1993,18,40-44,2011,4
STAT,1930,44,20-24,1974,0.02673034229690061
STAT,1831,35,50-100,1866,1.239556640475477
STAT,1920,41,50-100,1961,0.149888152811965
SIM,1968,21,na,1989,5043
STAT,1953,31,45-49,1984,2.2405474977304705
SIM,1864,38,50-100,1902,2
STAT,1785,102,na,1887,0.058795625736650384
STAT,1913,33,15-19,1946,0.14700279637224922
STAT,1950,42,30-34,1992,0.18129567910856806
STAT,1985,18,40-44,2003,2.295101306639147
SIM,1898,26,20-24,1924,19
STAT,1859,44,50-100,1903,0.9580918054736013
STAT,1941,44,30-34,1985,0.15744488999764128
STAT,1922,31,15-19,1953,0.1681726827501597
SIM,1868,40,40-44,1908,4
STAT,1872,44,20-24,1916,0.18154879322345238
STAT,1951,48,20-24,1999,0.01575273335491492
STAT,1842,31,30-34,1873,16.40006277357754
STAT,1942,24,45-49,1966,1.3607736504413048
SIM,1835,41,40-44,1876,9
SIM,1925,37,na,1962,5305
SIM,1831,44,25-29,1875,2
STAT,1863,50,40-44,1913,0.010776223081036781
SIM,1875,16,25-29,1891,13
SIM,1921,44,na,1965,5183
STAT,1843,52,50-100,1895,0.015073139863534242
STAT,1943,36,na,1979,4748.156672289893
STAT,1879,26,45-49,1905,1.3425276694905197
SIM,1817,73,na,1890,263
STAT,1965,38,na,2003,5578.73823344387
SIM,1950,24,45-49,1974,5
SIM,1885,77,na,1962,1677
SIM,1961,31,45-49,1992,1
SIM,1969,17,15-19,1986,65
SIM,1882,20,20-24,1902,6
SIM,1908,89,na,1997,249
STAT,1867,50,25-29,1917,0.0038713222910396004
STAT,1894,32,50-100,1926,1.3592861979925195
SIM,1792,80,na,1872,187
STAT,1840,48,40-44,1888,0.13673028409700447
SIM,1942,41,35-39,1983,2
STAT,1936,54,na,1990,4095.021740065799
SIM,1912,22,50-100,1934,1
SIM,1969,34,20-24,2003,9
STAT,1896,106,na,2002,1.1321978237646682
STAT,1875,33,35-39,1908,12.026525500109797
STAT,1867,16,25-29,1883,6.278977645553162
SIM,1917,9,na,1926,5809
STAT,1890,49,35-39,1939,0.10903442982310589
STAT,1940,35,50-100,1975,0.5078855451947446
STAT,1855,18,20-24,1873,17.83657557389826
STAT,1949,23,50-100,1972,0.885768322359256
SIM,1923,56,na,1979,5010
SIM,1863,18,20-24,1881,35
STAT,1945,44,15-19,1989,0.002005237168033657
STAT,1894,46,15-19,1940,3.356859582664617E-4
SIM,1858,24,25-29,1882,7
STAT,1882,40,15-19,1922,0.01572372017203993
STAT,1884,42,25-29,1926,0.731299466964286
SIM,1906,77,na,1983,2105
STAT,1800,73,na,1873,685.2716062657064
STAT,1827,41,40-44,1868,3.056246788307154
SIM,1883,33,35-39,1916,4
SIM,1838,19,25-29,1857,7
SIM,1984,24,45-49,2008,3
STAT,1939,15,20-24,1954,157.06391102109345
SIM,1890,33,25-29,1923,18
SIM,1804,96,na,1900,13
SIM,1894,30,40-44,1924,10
STAT,1835,54,45-49,1889,0.008871081372678192
SIM,1954,17,na,1971,5518
SIM,1866,53,na,1919,2160
STAT,1953,47,15-19,2000,5.349140108451834E-4
SIM,1862,35,50-100,1897,4
STAT,1929,76,na,2005,3489.612570480492
STAT,1903,81,na,1984,1698.0865214542873
STAT,1921,3,na,1924,5333.62454670665
SIM,1923,66,na,1989,4436
SIM,1956,42,40-44,1998,1
STAT,1927,41,45-49,1968,0.24117555404236582
STAT,1921,35,30-34,1956,2.3517403488727004
SIM,1834,31,na,1865,1974
STAT,1874,53,20-24,1927,8.578149298385419E-4
SIM,1837,28,na,1865,2658
SIM,1897,55,na,1952,3031
STAT,1789,71,na,1860,486.13311401815565
STAT,1957,39,na,1996,5885.030366770773
STAT,1882,33,25-29,1915,11.496894737969129
SIM,1803,70,na,1873,1028
SIM,1819,40,45-49,1859,3
STAT,1886,30,40-44,1916,5.321567764271641
STAT,1948,42,40-44,1990,0.3432929137085985
STAT,1866,25,20-24,1891,12.633820523809378
SIM,1970,38,25-29,2008,3
STAT,1934,77,na,2011,3578.822619243108
STAT,1932,35,40-44,1967,2.325786842746544
STAT,1962,38,25-29,2000,1.498439925796609
STAT,1910,5,na,1915,4587.489398337696
STAT,1966,42,30-34,2008,0.19151023049805338
STAT,1966,18,35-39,1984,6.046494890160588
STAT,1866,33,na,1899,2541.774195531191
SIM,1839,41,25-29,1880,1
STAT,1951,40,25-29,1991,0.10226671438818527
SIM,1849,19,35-39,1868,2
SIM,1834,21,na,1855,2185
SIM,1940,35,40-44,1975,3
SIM,1874,25,20-24,1899,31
STAT,1934,19,50-100,1953,0.5819759267371601
STAT,1884,62,na,1946,2084.017402114351
STAT,1940,40,15-19,1980,0.001875828788335667
STAT,1857,31,25-29,1888,9.359684449684108
SIM,1923,21,30-34,1944,3
SIM,1950,31,35-39,1981,26
STAT,1901,16,50-100,1917,0.07938902936945552
SIM,1834,34,50-100,1868,5
STAT,1866,18,30-34,1884,1.739635617535656
SIM,1969,41,45-49,2010,1
SIM,1904,42,na,1946,4030
STAT,1883,51,20-24,1934,8.371655315627654E-4
SIM,1869,24,35-39,1893,14
STAT,1834,86,na,1920,202.4843366622275
STAT,1976,31,35-39,2007,14.37015435673501
SIM,1824,34,40-44,1858,2
SIM,1940,58,na,1998,4630
SIM,1866,63,na,1929,1821
SIM,1881,35,25-29,1916,3
STAT,1935,47,25-29,1982,0.08647037039906944
STAT,1969,17,50-100,1986,0.5401143159187874
STAT,1830,102,na,1932,0.18391361747568719
STAT,1960,31,35-39,1991,14.009236948801243
SIM,1857,43,35-39,1900,7
STAT,1917,40,na,1957,4485.389788741099
STAT,1922,41,na,1963,4924.465414320549
STAT,1915,21,30-34,1936,34.39583302109486
STAT,1852,50,30-34,1902,0.0056927924824749475
SIM,1865,31,25-29,1896,2
SIM,1924,34,45-49,1958,4
STAT,1793,86,na,1879,73.18231629455315
SIM,1903,19,15-19,1922,15
STAT,1840,28,na,1868,2148.2282778270683
STAT,1916,41,35-39,1957,0.23851170651149325
STAT,1968,35,50-100,2003,0.6245694277135314
STAT,1873,42,15-19,1915,0.016254707173470606
STAT,1893,40,25-29,1933,0.9461782771480978
SIM,1907,16,30-34,1923,7
STAT,1821,102,na,1923,0.17930338588142525
STAT,1821,68,na,1889,931.6351814039853
STAT,1869,41,45-49,1910,1.680225880064026
STAT,1976,24,45-49,2000,1.739341856609548
STAT,1906,45,40-44,1951,0.16413685271278003
SIM,1974,35,40-44,2009,3
STAT,1812,44,15-19,1856,0.03407176298725802
SIM,1881,30,na,1911,2003
STAT,1966,35,40-44,2001,2.2269132799927656
SIM,1849,26,25-29,1875,100
STAT,1868,45,na,1913,2519.4202119529764
STAT,1825,50,20-24,1875,0.0010332587741576
STAT,1925,43,35-39,1968,0.2808134330117762
SIM,1824,41,30-34,1865,1
SIM,1860,43,40-44,1903,3
SIM,1822,43,20-24,1865,1
SIM,1877,41,45-49,1918,4
SIM,1932,22,35-39,1954,16
STAT,1864,49,40-44,1913,0.17272825826879792
SIM,1833,35,na,1868,1777
STAT,1845,108,na,1953,0.0012343159376612036
STAT,1895,44,na,1939,3436.8899609312302
STAT,1817,94,na,1911,13.817577009948018
STAT,1874,35,40-44,1909,5.220905705834479
SIM,1878,41,na,1919,2753
STAT,1974,40,15-19,2014,0.002411636251268945
SIM,1823,49,45-49,1872,1
STAT,1940,33,25-29,1973,11.036012659870279
STAT,1879,51,na,1930,2607.021932734983
SIM,1899,36,na,1935,4175
SIM,1924,31,40-44,1955,5
STAT,1853,49,30-34,1902,0.09436366268073142
STAT,1847,60,na,1907,1467.4876992168684
STAT,1908,59,na,1967,3610.1421755730203
STAT,1865,1,na,1866,3743.1159768712273
STAT,1953,46,30-34,1999,0.12977113210924757
SIM,1849,23,20-24,1872,147
STAT,1830,46,25-29,1876,0.05384235250367958
STAT,1942,42,50-100,1984,0.14726732584560617
SIM,1988,17,20-24,2005,413
STAT,1787,90,na,1877,24.227276782179928
SIM,1911,36,25-29,1947,3
STAT,1815,49,45-49,1864,0.46783082331022346
STAT,1890,46,30-34,1936,0.07721577126031454
STAT,1969,27,na,1996,5423.897855477713
STAT,1903,23,50-100,1926,0.668245299887717
STAT,1980,23,50-100,2003,1.0572989061894222
STAT,1882,81,na,1963,886.3378544331922
SIM,1818,68,na,1886,1465
SIM,1797,68,na,1865,650
SIM,1911,78,na,1989,2907
SIM,1803,69,na,1872,1028
STAT,1776,112,na,1888,0.0011438425621825756
STAT,1835,47,20-24,1882,0.007893513750357739
STAT,1902,30,35-39,1932,16.646215207094553
STAT,1962,32,15-19,1994,0.19368879878366033
SIM,1899,29,40-44,1928,6
STAT,1814,43,20-24,1857,0.5008263555874387
STAT,1924,22,35-39,1946,12.818691341832904
STAT,1863,53,45-49,1916,0.014409489322225908
STAT,1903,36,25-29,1939,1.0264410358082126
SIM,1906,32,35-39,1938,18
STAT,1820,52,50-100,1872,0.014830854020001841
STAT,1914,43,25-29,1957,0.08156848531213198
STAT,1897,48,40-44,1945,0.14714959714588013
STAT,1931,24,50-100,1955,0.9789195958227044
STAT,1825,42,35-39,1867,2.6936055108824615
SIM,1884,37,na,1921,2647
STAT,1861,47,15-19,1908,3.819734455760679E-4
SIM,1871,64,na,1935,1410
STAT,1840,40,45-49,1880,1.4119931205862637
STAT,1970,39,na,2009,5587.461843615338
STAT,1882,26,na,1908,2699.356594365985
STAT,1920,47,30-34,1967,0.113674108742596
STAT,1900,9,na,1909,4154.930400461728
STAT,1926,23,50-100,1949,0.9194895294196804
STAT,1875,30,30-34,1905,20.989752205107326
STAT,1848,45,na,1893,2414.350599004133
SIM,1804,55,na,1859,1109
STAT,1815,72,na,1887,759.1058230913192
SIM,1934,23,50-100,1957,2
SIM,1927,18,na,1945,4798
SIM,1865,23,na,1888,3153
STAT,1961,37,25-29,1998,1.5124541848724367
STAT,1974,33,25-29,2007,14.188314181711776
STAT,1829,40,50-100,1869,1.167651401346657
SIM,1908,46,50-100,1954,1
STAT,1862,32,45-49,1894,1.6983649520799524
STAT,1895,31,45-49,1926,2.63026086468001
STAT,1863,12,na,1875,2748.879031443499
STAT,1878,11,na,1889,3126.000770485256
STAT,1936,42,15-19,1978,0.0017560805593889502
STAT,1958,34,50-100,1992,1.2757703794298083
STAT,1885,45,45-49,1930,0.27437013696916096
SIM,1898,95,na,1993,121
SIM,1969,16,na,1985,5819
STAT,1865,78,na,1943,813.5674228446702
SIM,1941,44,na,1985,3937
STAT,1890,39,40-44,1929,6.1106786044774255
SIM,1848,34,na,1882,1842
SIM,1912,19,na,1931,3998
STAT,1940,23,30-34,1963,33.78848956236628
SIM,1849,16,30-34,1865,5
STAT,1964,44,20-24,2008,0.026588066121118647
SIM,1856,48,45-49,1904,1
STAT,1897,25,na,1922,3707.709536595361
STAT,1908,15,na,1923,4349.232973449428
STAT,1867,59,na,1926,2094.0601309736467
STAT,1841,36,40-44,1877,4.633397843322493
SIM,1922,30,na,1952,4962
SIM,1844,42,45-49,1886,3
STAT,1908,17,35-39,1925,0.9405375161485038
STAT,1885,21,50-100,1906,0.47082850997634146
SIM,1840,17,na,1857,2357
STAT,2003,1,na,2004,6896.745191279163
STAT,1874,45,35-39,1919,0.16705160650590836
STAT,1975,36,45-49,2011,1.0702624999285384
STAT,1868,19,45-49,1887,0.07287275354647649
SIM,1832,27,50-100,1859,1
SIM,1953,32,na,1985,5674
SIM,1880,47,25-29,1927,1
STAT,1814,50,45-49,1864,0.040153815265076324
STAT,1909,55,na,1964,3777.811949459537
SIM,1838,16,20-24,1854,1
SIM,1984,21,40-44,2005,8
STAT,1936,26,50-100,1962,1.1004569988103698
STAT,1939,18,25-29,1957,50.06424102220868
SIM,1883,30,30-34,1913,36
STAT,1861,37,20-24,1898,0.7395579906907978
SIM,1965,17,30-34,1982,23
STAT,1834,51,25-29,1885,0.003380641511956695
STAT,1856,43,25-29,1899,0.5613024697902933
SIM,1833,42,35-39,1875,7
SIM,1891,21,25-29,1912,3
STAT,1897,80,na,1977,1636.3287582688706
SIM,1968,31,na,1999,5329
STAT,1866,74,na,1940,1187.0985200754094
STAT,1957,17,30-34,1974,18.54607938337292
SIM,1835,57,na,1892,1811
STAT,1948,45,45-49,1993,0.29996308745167943
SIM,1861,3,na,1864,2721
STAT,1872,47,25-29,1919,0.06643582854427521
STAT,1942,21,40-44,1963,4.070515166032215
STAT,1818,79,na,1897,309.326935372547
SIM,1847,18,20-24,1865,29
SIM,1918,55,na,1973,3666
STAT,1941,43,35-39,1984,0.24842226114067742
STAT,1883,21,25-29,1904,64.83071894749627
STAT,1973,22,30-34,1995,43.039355945400565
SIM,1882,38,45-49,1920,3
STAT,1924,22,na,1946,4971.504024855514
SIM,1867,44,50-100,1911,1
STAT,1881,41,na,1922,2584.349134763729
STAT,1840,46,50-100,1886,0.201241449694132
SIM,1881,32,20-24,1913,4
STAT,1931,70,na,2001,4444.358856897664
SIM,1811,43,45-49,1854,4
SIM,1852,50,na,1902,1786
SIM,1822,84,na,1906,101
SIM,1934,66,na,2000,4767
SIM,1939,27,30-34,1966,5
STAT,1931,47,40-44,1978,0.2433392207591815
STAT,1839,18,20-24,1857,18.283680565269428
STAT,1866,28,25-29,1894,45.08894318460605
STAT,1952,43,45-49,1995,0.23882002225389867
SIM,1933,81,na,2014,2850
STAT,1903,43,15-19,1946,0.0015649669968949601
STAT,1836,42,45-49,1878,1.620908872135179
SIM,1906,23,na,1929,3909
STAT,1950,45,35-39,1995,0.18385551014856846
STAT,1956,7,na,1963,6002.356901390668
SIM,1864,82,na,1946,536
STAT,1925,40,30-34,1965,0.17906354503709382
SIM,1872,49,40-44,1921,2
STAT,1960,29,50-100,1989,1.50106745610274
SIM,1887,19,20-24,1906,39
STAT,1873,32,20-24,1905,3.1855272997662216
SIM,1879,81,na,1960,522
STAT,1905,6,na,1911,4363.478710474302
SIM,1949,16,35-39,1965,16
STAT,1941,36,45-49,1977,0.8358299856309251
STAT,1847,27,50-100,1874,0.5916162157249579
STAT,1916,31,40-44,1947,4.682140928676779
STAT,1896,40,na,1936,3570.8284817505755
STAT,1848,45,40-44,1893,0.18371825547414306
STAT,1852,53,35-39,1905,0.007986413730046384
SIM,1944,26,50-100,1970,3
STAT,1851,32,35-39,1883,8.35853078115406
SIM,1882,15,na,1897,3536
SIM,1979,8,na,1987,6475
SIM,1848,75,na,1923,412
STAT,1826,53,40-44,1879,0.007175159123606886
STAT,1929,16,30-34,1945,17.996631404736966
SIM,1927,86,na,2013,509
SIM,1839,24,20-24,1863,151
SIM,1938,32,na,1970,3988
STAT,1957,34,35-39,1991,14.155057606177014
STAT,1908,42,45-49,1950,0.17792576921399203
STAT,1909,35,15-19,1944,0.02119960185355264
STAT,1843,24,na,1867,2654.3310745789486
STAT,1972,23,20-24,1995,164.79053793946431
SIM,1994,17,na,2011,6217
SIM,1940,37,40-44,1977,1
STAT,1903,22,45-49,1925,1.1462413049000175
STAT,1904,15,15-19,1919,9.880545611136865
STAT,1835,80,na,1915,385.5425629300437
SIM,1931,28,30-34,1959,147
STAT,1860,49,20-24,1909,0.010928264738532957
STAT,1923,31,30-34,1954,20.921545168214628
STAT,1932,37,40-44,1969,2.321764967010734
SIM,1889,18,25-29,1907,14
SIM,1907,33,35-39,1940,23
STAT,1970,30,na,2000,5575.548681587687
STAT,1864,54,30-34,1918,0.005965080284854187
SIM,1903,28,25-29,1931,7
STAT,1866,114,na,1980,1.5804559560142955E-4
STAT,1962,48,20-24,2010,0.016949922330421825
STAT,1911,41,35-39,1952,0.22326803306563597
STAT,1855,105,na,1960,0.0660927959801391
SIM,1883,22,15-19,1905,3
STAT,1903,47,15-19,1950,3.6916147103378333E-4
SIM,1851,87,na,1938,772
SIM,1942,32,45-49,1974,5
SIM,1951,27,45-49,1978,10
STAT,1943,27,45-49,1970,2.1235651688276804
STAT,1975,39,50-100,2014,0.6571483452403818
STAT,1835,29,na,1864,1731.777422167104
SIM,1937,16,30-34,1953,32
STAT,1953,29,25-29,1982,92.1945175169973
STAT,1873,46,na,1919,2658.9423802279134
SIM,1961,29,25-29,1990,107
STAT,1961,23,45-49,1984,1.682620962616214
SIM,1862,33,50-100,1895,2
SIM,1928,29,40-44,1957,18
STAT,1962,16,15-19,1978,67.12611779114037
STAT,1830,25,50-100,1855,0.8917453685498703
STAT,1906,47,40-44,1953,0.16175897074456372
SIM,1905,38,30-34,1943,3
SIM,1947,38,35-39,1985,1
STAT,1886,16,40-44,1902,0.22319676394914104
STAT,1787,109,na,1896,2.1850715935063439E-4
STAT,1832,109,na,1941,4.8471066202029114E-4
STAT,1934,32,45-49,1966,2.4806553520056025
STAT,1896,39,na,1935,3555.039590013699
STAT,1946,33,20-24,1979,3.180450597728901
STAT,1949,53,na,2002,5019.7427198486
SIM,1925,37,45-49,1962,2
STAT,1838,51,50-100,1889,0.013275297180835645
STAT,1927,39,25-29,1966,1.4094240725501237
STAT,1928,48,30-34,1976,0.13089930854124285
STAT,1999,7,na,2006,6701.30514906566
SIM,1941,9,na,1950,4047
SIM,1884,58,na,1942,2271
STAT,1913,24,25-29,1937,107.02614806450346
SIM,1921,24,25-29,1945,151
STAT,1829,105,na,1934,0.021479717270631922
SIM,1963,38,50-100,2001,1
STAT,1936,33,50-100,1969,0.9267631197771055
STAT,1849,20,20-24,1869,65.51397541975514
STAT,1942,17,na,1959,4439.834447507895
STAT,1939,38,35-39,1977,2.8768613709844115
SIM,1935,39,25-29,1974,3
SIM,1911,22,45-49,1933,2
STAT,1928,37,20-24,1965,0.38446037225746343
STAT,1900,40,20-24,1940,0.0178384331986725
STAT,1942,40,25-29,1982,0.0897639080292221
SIM,1965,34,35-39,1999,6
SIM,1894,16,40-44,1910,1
STAT,1805,50,na,1855,1481.5681929415787
SIM,1900,32,40-44,1932,8
SIM,1835,31,25-29,1866,4
STAT,1914,22,20-24,1936,131.1649817095045
SIM,1932,44,25-29,1976,1
STAT,1950,33,40-44,1983,5.4397219619835075
STAT,1822,54,na,1876,1905.391196152398
SIM,1982,3,na,1985,6833
SIM,1880,44,na,1924,3207
SIM,1904,26,20-24,1930,22
SIM,1939,19,45-49,1958,1
STAT,1838,20,45-49,1858,0.7951889996545881
SIM,1922,22,20-24,1944,289
STAT,1931,79,na,2010,3074.5543681762706
STAT,1827,85,na,1912,222.6301606563489
STAT,1880,37,25-29,1917,3.521952717649678
STAT,1917,37,45-49,1954,0.8171773892738772
STAT,1872,80,na,1952,716.8307463590711
SIM,1891,38,50-100,1929,1
SIM,1830,26,na,1856,2048
STAT,1917,18,na,1935,4784.0410739084255
STAT,1924,44,25-29,1968,0.09767060254686617
STAT,1964,43,50-100,2007,0.17717849885058634
SIM,1960,15,50-100,1975,1
STAT,1812,47,20-24,1859,0.027822542434630452
STAT,1856,25,50-100,1881,0.5920933908944594
STAT,1838,69,na,1907,1271.2008047756015
STAT,1814,67,na,1881,1166.6691217728867
STAT,1946,19,40-44,1965,1.789136209797326
STAT,1935,33,45-49,1968,2.5121949433698707
SIM,1943,33,45-49,1976,6
STAT,1896,30,35-39,1926,15.560627109974867
SIM,1867,8,na,1875,2821
STAT,1907,15,40-44,1922,0.31200769260840555
STAT,1929,43,na,1972,5542.062343904564
STAT,1851,11,na,1862,2312.1198336854527
SIM,1909,75,na,1984,3417
STAT,1864,85,na,1949,282.4795146095183
STAT,1945,35,25-29,1980,1.2810133821431027
SIM,1904,37,30-34,1941,2
SIM,1905,61,na,1966,3509
STAT,1940,26,35-39,1966,17.68177703697651
SIM,1915,27,35-39,1942,26
STAT,1875,77,na,1952,1030.870112941836
STAT,1859,39,na,1898,2144.062486311059
STAT,1924,43,40-44,1967,0.34270940479467
STAT,1917,29,15-19,1946,0.8483084160883736
STAT,1955,6,na,1961,6022.607936725843
SIM,1906,21,25-29,1927,196
STAT,1784,71,na,1855,613.05018
STAT,1881,97,na,1978,52.29272169482788
SIM,1884,6,na,1890,3033
SIM,1833,66,na,1899,946
SIM,1857,20,20-24,1877,91
STAT,1949,40,35-39,1989,0.2816518555017332
SIM,1956,19,50-100,1975,1
STAT,1892,106,na,1998,1.0324191006099082
SIM,1866,26,30-34,1892,68
STAT,1930,41,15-19,1971,0.002335500405961785
SIM,1861,21,25-29,1882,59
SIM,1860,48,na,1908,2301
SIM,1959,40,45-49,1999,1
STAT,1961,39,15-19,2000,0.029435425691240375
STAT,1949,48,45-49,1997,0.30257457276593863
STAT,1869,32,50-100,1901,1.024003644599749
SIM,1991,0,na,1991,6724
STAT,1819,98,na,1917,2.1625942093013246
STAT,1890,44,30-34,1934,1.599287642314208
STAT,1909,43,45-49,1952,0.17876994688578296
STAT,1948,47,45-49,1995,0.29855790460922066
STAT,1876,105,na,1981,1.064463277104391
STAT,1899,23,50-100,1922,0.6427530956722284
STAT,1859,42,50-100,1901,0.9700054905084654
SIM,1932,43,40-44,1975,2
SIM,1907,36,50-100,1943,2
STAT,1853,21,25-29,1874,67.82878780695168
STAT,1851,21,15-19,1872,3.14673797676799
STAT,1898,3,na,1901,4123.235775067705
STAT,1840,53,30-34,1893,0.00469847421153309
SIM,1912,15,15-19,1927,9
SIM,1978,25,45-49,2003,3
STAT,1964,20,na,1984,5329.174187620067
SIM,1951,19,15-19,1970,1
STAT,1903,25,50-100,1928,1.0586455668854031
SIM,1873,74,na,1947,1181
SIM,1951,22,na,1973,5570
STAT,1808,47,na,1855,1718.8990442362774
STAT,1907,27,35-39,1934,16.383636264961527
STAT,1858,26,30-34,1884,23.375949890494546
STAT,1940,15,25-29,1955,50.821174334650706
STAT,1919,45,25-29,1964,0.06669485750697107
STAT,1900,29,45-49,1929,1.7652825638642353
SIM,1800,95,na,1895,7
STAT,1923,28,30-34,1951,51.71401983378088
STAT,1869,16,35-39,1885,0.625417486739
STAT,1922,27,30-34,1949,51.14524041326005
STAT,1848,55,na,1903,2197.0029535630392
STAT,1922,16,20-24,1938,181.43940888936848
STAT,1944,19,30-34,1963,15.128185142812509
STAT,1826,34,50-100,1860,0.7845954067769828
STAT,1879,18,15-19,1897,7.132509464678845
STAT,1975,12,na,1987,5980.483927814123
SIM,1931,31,30-34,1962,29
SIM,1877,16,35-39,1893,1
SIM,1857,49,50-100,1906,1
SIM,1878,40,35-39,1918,8
STAT,1910,71,na,1981,3020.746847061722
STAT,1868,15,35-39,1883,0.6267679441219496
SIM,1930,27,30-34,1957,7
STAT,1923,38,na,1961,5023.7998699479385
SIM,1941,30,30-34,1971,23
SIM,1899,17,25-29,1916,16
STAT,1933,17,35-39,1950,6.485321153769386
STAT,1922,44,15-19,1966,0.0020265365297178115
SIM,1863,13,na,1876,2931
STAT,1917,34,40-44,1951,4.688766472145779
SIM,1858,21,20-24,1879,100
STAT,1969,41,na,2010,5572.192592356717
STAT,1951,34,40-44,1985,5.474695058308426
SIM,1901,23,na,1924,4090
STAT,1872,29,na,1901,2745.7427898357573
SIM,1965,31,30-34,1996,5
STAT,1894,49,20-24,1943,0.009832405394966331
SIM,1953,48,50-100,2001,1
STAT,1973,27,na,2000,5615.463907820409
STAT,1907,97,na,2004,110.54584172915361
SIM,1896,91,na,1987,532
STAT,1880,34,20-24,1914,3.278184049874013
STAT,1907,48,40-44,1955,0.16191485672995698
SIM,1858,32,30-34,1890,9
STAT,1934,3,na,1937,6334.508570879578
SIM,1801,69,na,1870,945
SIM,1925,34,40-44,1959,6
STAT,1933,30,30-34,1963,24.54141153740044
SIM,1973,27,40-44,2000,16
SIM,1862,79,na,1941,1131
SIM,1951,24,40-44,1975,7
STAT,1920,38,na,1958,4746.886117342623
SIM,1915,48,40-44,1963,1
STAT,1907,40,30-34,1947,0.13692618646638488
SIM,1835,49,na,1884,1944
SIM,1931,34,35-39,1965,30
SIM,1941,17,35-39,1958,11
STAT,1942,26,45-49,1968,2.093842529631324
SIM,1915,93,na,2008,246
SIM,1916,45,na,1961,4343
STAT,1842,50,na,1892,1680.7274670632162
SIM,1907,30,30-34,1937,3
SIM,1947,26,40-44,1973,12
SIM,1950,26,45-49,1976,3
STAT,1973,37,40-44,2010,2.3019023315126956
SIM,1895,10,na,1905,4017
STAT,1842,53,40-44,1895,0.007971217025936183
STAT,1789,94,na,1883,3.506649078182406
STAT,1901,42,35-39,1943,0.20301699156461211
SIM,1879,29,20-24,1908,16
SIM,1894,36,na,1930,3776
STAT,1923,34,35-39,1957,12.070036430796915
STAT,1879,23,40-44,1902,2.5032699128391607
SIM,1849,35,50-100,1884,3
STAT,1851,67,na,1918,1257.069543248415
STAT,1943,24,40-44,1967,4.125985703779729
STAT,1971,22,20-24,1993,163.0664678066621
STAT,1896,41,50-100,1937,0.11233094251111689
SIM,1907,38,40-44,1945,4
SIM,1844,25,40-44,1869,5
STAT,1933,38,40-44,1971,2.3517691314690063
STAT,1952,49,20-24,2001,0.015803843057373146
SIM,1947,35,30-34,1982,6
STAT,1980,25,50-100,2005,1.6029206986133175
SIM,1924,40,na,1964,4918
SIM,1888,28,50-100,1916,1
SIM,1962,37,50-100,1999,1
STAT,1939,26,40-44,1965,5.412246349217989
STAT,1860,4,na,1864,2859.223673020512
STAT,1870,48,20-24,1918,0.013481144235473414
SIM,1854,28,na,1882,2799
STAT,1892,89,na,1981,554.7879342797635
SIM,1933,20,30-34,1953,58
SIM,1870,38,20-24,1908,1
STAT,1877,0,na,1877,4383.004800330978
STAT,1916,36,45-49,1952,0.8096215118909043
STAT,1906,42,50-100,1948,0.1233070975077176
STAT,1884,38,na,1922,2673.0103913881185
STAT,1902,21,45-49,1923,1.1405050107767027
STAT,1913,41,45-49,1954,0.18848039380262271
STAT,1956,22,25-29,1978,141.5211524537871
STAT,1954,37,50-100,1991,0.6171103637019533
SIM,1983,25,na,2008,6455
STAT,1942,18,50-100,1960,0.45177564727381586
STAT,1947,45,30-34,1992,0.12110598555523543
STAT,1880,24,na,1904,2874.914143989085
STAT,1849,23,25-29,1872,53.25859902398503
SIM,1901,33,40-44,1934,2
STAT,1957,31,30-34,1988,24.449928592957832
STAT,1880,16,na,1896,3097.013250097305
SIM,1903,8,na,1911,4260
SIM,1921,75,na,1996,3292
STAT,1939,35,30-34,1974,2.17371908367904
STAT,1827,31,25-29,1858,18.641921868651874
STAT,1957,39,40-44,1996,2.341666202566514
STAT,1885,47,na,1932,2577.738711485993
SIM,1863,3,na,1866,3321
SIM,1969,27,30-34,1996,8
STAT,1954,42,15-19,1996,0.00227686881375727
SIM,1924,36,45-49,1960,2
STAT,1804,100,na,1904,0.46160219206063297
STAT,1924,12,na,1936,5443.7673391265935
STAT,1798,63,na,1861,785.5899773419648
SIM,1859,59,na,1918,1709
SIM,1934,10,na,1944,6008
SIM,1965,24,50-100,1989,1
SIM,1908,58,na,1966,3353
STAT,1921,18,25-29,1939,56.83538366858473
STAT,1960,22,45-49,1982,1.696810591945985
STAT,1957,24,50-100,1981,1.0038098366730304
SIM,1814,87,na,1901,54
STAT,1911,29,20-24,1940,20.414335655849786
STAT,1924,41,20-24,1965,0.02427068332703604
STAT,1970,45,20-24,2015,0.016683960146600542
STAT,1857,9,na,1866,2573.7602338576453
STAT,1996,15,45-49,2011,0.8382614332936805
STAT,1862,38,20-24,1900,0.7470309719638278
SIM,1941,52,na,1993,3834
STAT,1875,50,50-100,1925,0.01827030224558656
STAT,1878,22,40-44,1900,2.510897044319316
SIM,1964,22,25-29,1986,3
SIM,1857,23,25-29,1880,61
STAT,1827,93,na,1920,23.73453814708407
STAT,1830,100,na,1930,0.6659878463519151
STAT,1961,15,15-19,1976,67.7024134176132
STAT,1897,19,20-24,1916,27.210783742155513
STAT,1936,26,15-19,1962,0.7805003533330325
SIM,1942,37,na,1979,5013
SIM,1953,32,20-24,1985,1
SIM,1876,31,na,1907,2640
STAT,1940,24,15-19,1964,6.25579685505156
SIM,1991,12,na,2003,6711
SIM,1905,44,35-39,1949,1
SIM,1954,33,20-24,1987,5
STAT,1876,22,30-34,1898,21.249677112906284
SIM,1973,16,40-44,1989,5
SIM,1944,26,15-19,1970,2
STAT,1822,62,na,1884,1570.4141002039444
STAT,1965,16,40-44,1981,2.015777296419539
STAT,1853,38,50-100,1891,1.2163010848123965
STAT,1898,37,50-100,1935,1.914886234508989
STAT,1961,20,na,1981,5466.59556971846
STAT,1836,25,40-44,1861,3.580063938049691
STAT,1832,46,35-39,1878,0.11640215101361762
SIM,1840,46,35-39,1886,1
SIM,1904,29,25-29,1933,92
SIM,1873,66,na,1939,2353
SIM,1825,79,na,1904,733
SIM,1820,48,na,1868,1853
STAT,1945,32,20-24,1977,3.1343710907996174
STAT,1893,34,na,1927,3451.153613251051
STAT,1877,46,50-100,1923,0.2956663478095669
STAT,1884,16,30-34,1900,1.821826865820733
SIM,1865,79,na,1944,830
STAT,1935,25,15-19,1960,1.1121153106017414
SIM,1821,57,na,1878,1204
SIM,1828,36,na,1864,2356
SIM,1885,46,50-100,1931,2
SIM,1868,44,na,1912,3011
SIM,1887,23,40-44,1910,6
SIM,1970,16,15-19,1986,64
SIM,1935,33,50-100,1968,1
STAT,1870,46,na,1916,2566.9657259752876
STAT,1919,42,20-24,1961,0.022081181853242485
STAT,1960,38,na,1998,5820.038339056171
STAT,1911,39,50-100,1950,0.4636798245546034
STAT,1928,16,15-19,1944,66.15411184907387
STAT,1967,17,na,1984,5306.062589478444
STAT,1854,47,25-29,1901,0.04670777185851519
STAT,1828,54,20-24,1882,5.740354759187626E-4
SIM,1930,19,25-29,1949,150
STAT,2011,4,na,2015,7200.327543992747
STAT,1927,33,50-100,1960,1.1727425369988196
STAT,1914,34,15-19,1948,0.14807197476947032
STAT,1922,19,25-29,1941,57.542753018418054
STAT,1909,24,50-100,1933,0.7021225212462646
STAT,1903,19,20-24,1922,28.985474517393502
STAT,1964,48,30-34,2012,0.13440295301273403
STAT,1862,15,40-44,1877,0.2064431205409316
SIM,1870,49,50-100,1919,3
STAT,1896,104,na,2000,4.003739780796743
SIM,1925,14,na,1939,5602
SIM,1989,25,20-24,2014,56
STAT,1856,42,na,1898,2032.4240491738767
SIM,1930,60,na,1990,5533
STAT,1927,74,na,2001,3672.649571955689
SIM,1938,32,25-29,1970,23
SIM,1923,58,na,1981,5010
STAT,1932,63,na,1995,5168.303245391589
SIM,1911,14,na,1925,5167
SIM,1931,53,na,1984,5901
STAT,1978,32,40-44,2010,6.282470450652026
SIM,1946,34,30-34,1980,47
STAT,1924,20,na,1944,5001.166849148658
STAT,1938,42,25-29,1980,0.0845232913160519
SIM,1866,61,na,1927,1889
SIM,1856,54,na,1910,1934
SIM,1946,23,20-24,1969,1
STAT,1963,15,25-29,1978,63.570071148520896
STAT,1814,43,50-100,1857,3.331583954094546
SIM,1938,1,na,1939,4341
SIM,1947,29,45-49,1976,1
STAT,1967,20,35-39,1987,13.627935136612797
STAT,1914,13,na,1927,4709.542415069141
STAT,1912,40,45-49,1952,0.18752243417226228
STAT,1956,38,40-44,1994,2.352778356202645
STAT,1927,48,15-19,1975,5.320287563903139E-4
STAT,1938,23,20-24,1961,127.0226783095648
STAT,1938,29,50-100,1967,1.1374349882547585
SIM,1877,24,na,1901,3337
STAT,1883,46,40-44,1929,0.1938494154594697
STAT,1829,32,40-44,1861,5.625313963994024
STAT,1967,28,45-49,1995,2.500032307598807
SIM,1844,28,45-49,1872,3
SIM,1978,22,na,2000,5209
SIM,1910,83,na,1993,642
SIM,1940,27,na,1967,4771
STAT,1860,47,na,1907,2082.8405797797036
STAT,1854,24,45-49,1878,0.6579533760135339
STAT,1854,33,50-100,1887,0.7565261682435851
STAT,1963,47,30-34,2010,0.1359498884804761
STAT,1836,20,35-39,1856,7.299053664839774
STAT,1931,37,25-29,1968,1.5051891478142991
STAT,1882,50,na,1932,2461.9611230020946
SIM,1858,66,na,1924,1917
STAT,1989,22,45-49,2011,1.8660434020686678
STAT,1933,33,35-39,1966,14.209726907285969
STAT,1907,24,30-34,1931,30.055468155519964
STAT,1928,39,40-44,1967,2.178628720202515
STAT,1953,42,20-24,1995,0.02562217739491073
STAT,1886,64,na,1950,2116.123075309645
STAT,1896,21,45-49,1917,1.0661266221159054
STAT,1785,100,na,1885,0.14971565253122074
STAT,1854,44,20-24,1898,0.12763805014365945
STAT,1972,34,20-24,2006,3.6690304753108256
SIM,1862,24,45-49,1886,4
SIM,1889,31,20-24,1920,6
STAT,1855,22,40-44,1877,2.0714250401800136
SIM,1844,20,35-39,1864,10
STAT,1855,17,15-19,1872,6.006093996008804
SIM,1859,33,30-34,1892,28
STAT,1856,44,30-34,1900,0.9985614352388307
SIM,1828,44,na,1872,2225
STAT,1907,43,35-39,1950,0.2119722027095121
STAT,1937,25,25-29,1962,74.14944186520515
SIM,1915,24,30-34,1939,46
SIM,1810,49,na,1859,1443
STAT,1835,41,25-29,1876,0.4863998519195928
SIM,1879,28,na,1907,2730
STAT,1959,26,15-19,1985,1.0707778993828714
SIM,1843,36,na,1879,1937
STAT,1841,19,50-100,1860,0.05551879959494778
SIM,1818,37,na,1855,2247
STAT,1964,32,25-29,1996,13.693942898259985
STAT,1949,24,35-39,1973,12.670906839273405
SIM,1862,2,na,1864,3943
SIM,1909,25,15-19,1934,1
SIM,1958,29,20-24,1987,28
STAT,1954,29,40-44,1983,6.67188452050252
STAT,1841,89,na,1930,93.402051768226
SIM,1837,32,40-44,1869,1
SIM,1902,7,na,1909,4352
STAT,1800,83,na,1883,187.08727653065768
STAT,1938,34,30-34,1972,18.267622959096524
STAT,1901,33,50-100,1934,1.4748448991584358
SIM,1818,38,45-49,1856,7
STAT,1896,15,50-100,1911,0.07502460296065336
STAT,1802,85,na,1887,123.63285418936414
STAT,1905,47,25-29,1952,0.054017757837922724
SIM,1962,29,40-44,1991,12
STAT,1910,31,45-49,1941,1.759967115532044
STAT,1828,34,45-49,1862,1.888083417644903
STAT,1883,38,50-100,1921,1.3793591582595894
SIM,1957,24,35-39,1981,36
STAT,1922,32,20-24,1954,3.1791158797316785
STAT,1762,104,na,1866,0.042590893435196266
SIM,1845,48,na,1893,1975
STAT,1822,33,20-24,1855,9.118922454776133
STAT,1920,19,15-19,1939,58.42088555832635
SIM,1930,32,20-24,1962,9
SIM,1900,30,na,1930,3572
STAT,1939,29,45-49,1968,2.003157024589837
SIM,1975,20,35-39,1995,18
SIM,1884,22,30-34,1906,1
STAT,1921,34,25-29,1955,11.764113638650786
SIM,1911,22,na,1933,4762
STAT,1867,45,45-49,1912,0.2568224040288483
STAT,1862,18,45-49,1880,0.07243452319046748
STAT,1906,26,35-39,1932,16.293626041983508
STAT,1861,31,25-29,1892,9.866987216853694
STAT,1921,15,20-24,1936,179.10661364992106
SIM,1890,34,30-34,1924,47
STAT,1906,31,25-29,1937,9.937922861318478
SIM,1889,89,na,1978,892
STAT,1900,43,25-29,1943,0.07089293454441276
STAT,1922,64,na,1986,4311.5063477022195
STAT,1951,29,15-19,1980,0.9733761096166551
SIM,1864,25,50-100,1889,1
SIM,1949,30,35-39,1979,3
STAT,1895,18,50-100,1913,0.07340238758411897
STAT,1908,29,50-100,1937,1.079491068835139
STAT,1928,13,na,1941,5752.623863727714
SIM,1881,61,na,1942,1427
SIM,1951,15,50-100,1966,1
STAT,1911,32,45-49,1943,1.769843966344307
STAT,1848,47,na,1895,2379.373440252526
SIM,1948,37,45-49,1985,3
SIM,1875,45,45-49,1920,1
SIM,1916,53,na,1969,4314
STAT,1953,1,na,1954,5609.631113904999
SIM,1853,43,na,1896,2208
SIM,1842,51,na,1893,1943
SIM,1945,25,25-29,1970,99
STAT,1965,19,45-49,1984,0.7192365793323255
STAT,1883,32,15-19,1915,0.16079140600067668
SIM,1933,57,na,1990,6108
STAT,1934,79,na,2013,3204.515751735915
STAT,1822,36,25-29,1858,7.330634366833203
STAT,1886,72,na,1958,1646.0398207937014
SIM,1990,23,25-29,2013,316
STAT,1925,44,40-44,1969,0.3481978822529153
SIM,1973,25,30-34,1998,113
STAT,1905,44,20-24,1949,0.018172173758062377
STAT,1914,21,na,1935,4332.7117316679305
SIM,1901,15,na,1916,4346
SIM,1914,15,25-29,1929,21
STAT,1925,39,15-19,1964,0.026533594343966453
SIM,1972,24,30-34,1996,56
STAT,1922,24,50-100,1946,0.8649814073745217
STAT,1964,24,30-34,1988,41.88550200331465
STAT,1967,25,na,1992,5428.391196180837
SIM,1914,26,35-39,1940,49
SIM,1853,14,na,1867,2770
SIM,1835,92,na,1927,15
SIM,1914,31,25-29,1945,11
STAT,1906,15,25-29,1921,9.580680338748731
SIM,1857,28,na,1885,2686
STAT,1853,77,na,1930,860.6052358428623
STAT,1920,34,45-49,1954,1.9712461652922435
STAT,1836,28,45-49,1864,1.2985698270951478
SIM,1845,21,35-39,1866,7
STAT,1872,105,na,1977,0.7909547939462013
SIM,1973,19,45-49,1992,1
STAT,1976,9,na,1985,6058.725767793053
SIM,1980,34,20-24,2014,7
SIM,1954,27,na,1981,5263
STAT,1932,16,35-39,1948,6.429574459445026
STAT,1957,18,na,1975,5598.728785325083
STAT,1801,68,na,1869,823.0276496019819
STAT,1847,23,15-19,1870,3.089546860249893
STAT,1970,24,50-100,1994,0.9530535632110815
STAT,1844,54,na,1898,1751.4330029174619
STAT,1965,25,30-34,1990,56.74604935446467
STAT,1895,46,na,1941,3389.9184912418946
SIM,1937,19,35-39,1956,9
SIM,1989,20,15-19,2009,6
STAT,1884,19,35-39,1903,0.6222944493785957
SIM,1973,40,50-100,2013,1
SIM,1940,16,35-39,1956,11
STAT,1837,21,35-39,1858,5.571690266678024
SIM,1894,28,na,1922,3631
STAT,1783,89,na,1872,27.35194934036594
STAT,1948,19,50-100,1967,0.4944657673287045
SIM,1890,35,na,1925,3386
STAT,1962,39,30-34,2001,2.770601410058523
STAT,1875,24,50-100,1899,0.48328446918872264
SIM,1899,20,25-29,1919,7
STAT,1921,27,50-100,1948,1.2797352192096665
SIM,1807,74,na,1881,416
SIM,1892,19,35-39,1911,1
STAT,1878,48,25-29,1926,0.0685333578675465
STAT,1898,30,45-49,1928,2.741667346939127
SIM,1938,48,40-44,1986,1
STAT,1832,29,na,1861,1918.3510066247616
SIM,1947,63,na,2010,5191
STAT,1901,22,35-39,1923,9.432952801574482
STAT,1903,69,na,1972,2877.9868206153833
STAT,1852,21,30-34,1873,20.094359564067055
STAT,1980,19,40-44,1999,2.2393584538727795
SIM,1919,35,25-29,1954,4
STAT,1840,59,na,1899,1559.0499017622249
STAT,1882,34,30-34,1916,19.5123557295375
SIM,1904,98,na,2002,160
SIM,1920,61,na,1981,3745
STAT,1838,77,na,1915,748.7451496870179
STAT,1932,30,15-19,1962,0.1974151280855204
SIM,1852,18,na,1870,2278
SIM,1950,24,25-29,1974,129
STAT,1988,21,45-49,2009,1.8638966192141309
STAT,1854,21,40-44,1875,2.009131406314912
SIM,1950,35,35-39,1985,7
STAT,1821,37,na,1858,1741.872347941364
STAT,1929,19,35-39,1948,6.147238269886361
STAT,1894,9,na,1903,3849.2399150511496
STAT,1931,34,20-24,1965,3.6845042298533333
STAT,1825,31,15-19,1856,0.3217798365802175
SIM,1889,34,25-29,1923,33
STAT,1872,72,na,1944,1463.4454026716144
STAT,1804,97,na,1901,2.3358455259986854
STAT,1942,24,25-29,1966,111.71075577386189
SIM,1961,26,20-24,1987,50
STAT,1951,1,na,1952,5591.681109296168
SIM,1855,23,15-19,1878,6
STAT,1961,20,40-44,1981,5.033315173907895
STAT,1953,45,25-29,1998,0.07739021768533504
SIM,1967,45,45-49,2012,1
STAT,1823,54,50-100,1877,0.013812944060551939
STAT,1927,36,20-24,1963,0.3784952697239785
STAT,1953,26,20-24,1979,25.60515546729825
SIM,1864,47,35-39,1911,1
STAT,1813,93,na,1906,13.381497796050786
STAT,1885,32,25-29,1917,11.790356695616307
SIM,1880,36,na,1916,3313
STAT,1954,22,15-19,1976,7.6195031109660425
STAT,1886,19,45-49,1905,0.07909137574410897
STAT,1900,36,50-100,1936,0.42639767519816035
SIM,1833,31,15-19,1864,1
STAT,1845,22,50-100,1867,0.3411360002105647
SIM,1940,30,15-19,1970,2
SIM,1909,83,na,1992,2373
SIM,1893,32,25-29,1925,30
STAT,1856,47,35-39,1903,0.1226882412233434
STAT,1883,49,45-49,1932,0.2609021772663673
STAT,1893,35,45-49,1928,2.9355530356448623
SIM,1890,43,na,1933,3214
STAT,1835,34,50-100,1869,0.7133548055861761
STAT,1938,35,15-19,1973,0.02257239400388841
SIM,1882,29,50-100,1911,2
SIM,1924,34,25-29,1958,24
STAT,1922,35,25-29,1957,1.2946201353907814
STAT,2003,3,na,2006,6890.056894693895
SIM,1920,39,na,1959,4135
SIM,1817,52,na,1869,1363
STAT,1874,29,50-100,1903,0.7503612268482022
STAT,1918,29,30-34,1947,47.76839102761484
STAT,1793,88,na,1881,47.931964833513284
STAT,1923,44,30-34,1967,0.17180681597360797
STAT,1828,31,40-44,1859,5.170708281589496
SIM,1833,22,25-29,1855,119
STAT,1972,37,25-29,2009,1.4988678285918613
STAT,1909,26,50-100,1935,1.1121470575757229
SIM,1885,23,30-34,1908,62
STAT,1932,21,25-29,1953,140.3232515109085
STAT,1920,87,na,2007,1208.911110839544
SIM,1917,26,50-100,1943,3
SIM,1968,27,15-19,1995,5
STAT,1857,42,15-19,1899,0.012397140576433149
STAT,1874,27,50-100,1901,0.7557628050950131
STAT,1918,18,20-24,1936,169.8155550321437
SIM,1930,35,25-29,1965,4
SIM,1830,36,25-29,1866,2
STAT,1897,56,na,1953,3147.4282297946834
SIM,1926,29,30-34,1955,5
STAT,1982,23,25-29,2005,150.44685695523336
STAT,1893,42,na,1935,3367.297482407387
STAT,1916,45,35-39,1961,0.15334577056520496
SIM,1953,44,50-100,1997,1
STAT,1877,23,30-34,1900,21.31659242641891
STAT,1911,45,20-24,1956,0.01214094209489698
SIM,1944,49,na,1993,4483
SIM,1849,22,15-19,1871,6
STAT,1938,37,35-39,1975,2.838178857973887
STAT,1928,32,15-19,1960,0.18543002230391922
SIM,1904,49,50-100,1953,2
SIM,1946,26,25-29,1972,164
SIM,1822,74,na,1896,611
STAT,1906,40,15-19,1946,0.0016301287821414517
STAT,1921,31,20-24,1952,3.144196998305152
STAT,1916,34,25-29,1950,10.919139023837026
STAT,1967,25,40-44,1992,6.754124754475744
STAT,1825,59,na,1884,1469.1495286651516
SIM,1847,21,45-49,1868,2
SIM,1903,25,20-24,1928,40
STAT,1929,49,30-34,1978,0.13257301849640943
SIM,1946,37,35-39,1983,2
SIM,1839,27,25-29,1866,75
SIM,1924,45,35-39,1969,1
STAT,1839,21,45-49,1860,0.715691858291854
STAT,1938,26,25-29,1964,75.32443621803257
STAT,1985,29,50-100,2014,1.6391936928488553
SIM,1948,34,40-44,1982,16
STAT,1907,18,45-49,1925,0.11062536015029482
STAT,1882,37,35-39,1919,7.972703177524331
STAT,1900,111,na,2011,0.02082403633947204
SIM,1822,82,na,1904,250
SIM,1811,90,na,1901,34
SIM,1905,29,40-44,1934,6
SIM,1807,82,na,1889,210
SIM,1914,23,30-34,1937,41
STAT,1836,31,50-100,1867,1.0653784461243314
STAT,1900,26,40-44,1926,4.813425130734481
SIM,1845,70,na,1915,1143
STAT,1906,23,30-34,1929,29.88314955055701
STAT,1947,48,na,1995,4953.718069928341
SIM,1973,1,na,1974,5506
SIM,1940,21,25-29,1961,133
STAT,1911,16,45-49,1927,0.11574379636987796
SIM,1930,18,40-44,1948,4
STAT,1922,18,40-44,1940,1.8624094081588705
STAT,1954,27,20-24,1981,26.154819812196692
STAT,1935,30,40-44,1965,6.258530985728037
STAT,1913,68,na,1981,3405.7722378590056
SIM,1855,28,20-24,1883,3
STAT,1897,35,20-24,1932,1.2008200319745546
STAT,1881,42,50-100,1923,1.1745195322341715
STAT,1852,24,35-39,1876,6.442326352657023
SIM,1962,27,20-24,1989,25
SIM,1836,31,40-44,1867,11
STAT,1839,104,na,1943,0.05289645295453398
STAT,1843,49,15-19,1892,3.929721238958465E-4
SIM,1887,18,15-19,1905,9
STAT,1954,38,30-34,1992,2.676143533146445
STAT,1847,28,20-24,1875,10.771871028714012
STAT,1878,45,20-24,1923,0.01460362194692832
SIM,1856,62,na,1918,1562
STAT,1816,39,50-100,1855,3.7948417706411153
STAT,1976,19,20-24,1995,208.89041439313934
STAT,1815,40,50-100,1855,2.852348337459882
STAT,1955,39,30-34,1994,2.870533877304604
SIM,1867,42,25-29,1909,1
STAT,1834,55,na,1889,1898.6028113465354
STAT,1964,16,25-29,1980,63.00617069741585
SIM,1931,19,40-44,1950,1
SIM,1865,17,25-29,1882,10
SIM,1954,19,na,1973,5510
SIM,1823,40,50-100,1863,3
SIM,1891,49,45-49,1940,1
SIM,1949,35,40-44,1984,1
SIM,1888,19,15-19,1907,13
STAT,1860,45,35-39,1905,0.13151340134898412
STAT,1942,35,35-39,1977,3.011015126296747
SIM,1972,16,25-29,1988,151
STAT,1949,49,50-100,1998,0.313909702949473
SIM,1832,52,na,1884,1829
SIM,1881,18,20-24,1899,27
SIM,1907,98,na,2005,77
STAT,1811,67,na,1878,944.7457845193209
STAT,1871,98,na,1969,21.618063001966057
STAT,1955,42,30-34,1997,0.20354581442429187
STAT,1964,27,35-39,1991,21.916813392809168
STAT,1857,17,25-29,1874,5.986401781532588
STAT,1874,39,na,1913,2755.448402660027
STAT,1873,18,20-24,1891,20.838154973425027
STAT,1896,71,na,1967,2403.258765532952
SIM,1958,5,na,1963,6236
STAT,1980,17,20-24,1997,217.2033085996133
SIM,1972,27,35-39,1999,28
STAT,1981,22,na,2003,5912.433613039567
STAT,1965,28,35-39,1993,21.71399815945651
STAT,1938,12,na,1950,4512.863412825596
SIM,1901,28,15-19,1929,1
STAT,1923,19,40-44,1942,1.8845761408623902
SIM,1890,37,35-39,1927,17
STAT,1902,76,na,1978,2241.337981553038
STAT,1879,16,na,1895,3050.8777210945495
STAT,1857,80,na,1937,556.0009509133733
SIM,1902,29,15-19,1931,3
STAT,1841,23,20-24,1864,77.05887146094375
STAT,1871,47,30-34,1918,0.11062049820065407
STAT,1859,42,25-29,1901,0.5896111842113797
STAT,1936,56,na,1992,4048.063962381098
STAT,1909,40,40-44,1949,0.27335604922928297
STAT,1863,47,na,1910,2259.752758643453
SIM,1843,44,na,1887,1799
STAT,1966,17,50-100,1983,0.5400383274334423
STAT,1910,15,45-49,1925,0.11487986240224832
STAT,1858,29,35-39,1887,8.7653934433945
SIM,1866,29,35-39,1895,16
SIM,1825,36,50-100,1861,1
STAT,1872,48,30-34,1920,0.11076260795559287
STAT,1901,27,40-44,1928,4.842277336966536
STAT,1930,38,50-100,1968,0.6314516241540546
STAT,1794,70,na,1864,874.0334260688242
STAT,1843,48,50-100,1891,0.24333395869354646
STAT,1800,75,na,1875,566.9372502962881
STAT,1908,23,40-44,1931,3.5608014206631027
STAT,1958,39,20-24,1997,0.41077162713842824
SIM,1848,49,35-39,1897,1
SIM,1903,29,30-34,1932,86
SIM,1931,47,35-39,1978,1
STAT,1820,52,na,1872,1400.777483736378
STAT,1856,17,30-34,1873,1.659335690473799
STAT,1937,34,15-19,1971,0.14661141201515263
SIM,1840,25,na,1865,2245
STAT,1850,54,50-100,1904,0.015119920615349567
SIM,1874,20,15-19,1894,2
SIM,1935,32,35-39,1967,27
STAT,1864,53,25-29,1917,0.0035912352926533884
STAT,1840,16,25-29,1856,5.92052042628361
STAT,1866,95,na,1961,31.15575904446708
SIM,1843,34,45-49,1877,2
SIM,1937,15,25-29,1952,113
STAT,1804,52,15-19,1856,1.1321986253669512E-4
STAT,1824,33,30-34,1857,32.69004476025723
SIM,1950,21,20-24,1971,4
STAT,1886,10,na,1896,3153.232721405463
SIM,1965,33,na,1998,5549
STAT,1905,45,50-100,1950,0.2337115428800162
STAT,1808,100,na,1908,0.5413212674503546
SIM,1871,44,50-100,1915,4
STAT,1890,15,na,1905,3577.955044329962
SIM,1848,38,50-100,1886,1
SIM,1923,28,45-49,1951,7
STAT,1966,24,40-44,1990,4.859296912397433
STAT,1916,31,20-24,1947,2.9183604644916126
STAT,1825,37,50-100,1862,2.0391322486913137
STAT,1855,38,20-24,1893,0.6526585592449206
STAT,1863,32,40-44,1895,4.376224686974194
STAT,1849,49,45-49,1898,0.1790969512662287
STAT,1923,47,35-39,1970,0.1739953949042432
STAT,1942,21,20-24,1963,134.6137641975795
SIM,1895,28,15-19,1923,1
SIM,1931,27,25-29,1958,101
STAT,1976,23,50-100,1999,1.0175151495324253
SIM,1869,43,40-44,1912,1
STAT,1844,38,45-49,1882,1.7437793647746285
SIM,1869,26,20-24,1895,2
STAT,1915,28,45-49,1943,2.0267811479341127
STAT,1967,39,45-49,2006,1.0103127646343517
STAT,1813,47,15-19,1860,0.0013268372647652754
STAT,1923,27,25-29,1950,87.17785434249168
STAT,1833,39,40-44,1872,3.800377972240561
STAT,1876,16,45-49,1892,0.07811976048424238
STAT,1931,21,45-49,1952,1.6895833392519803
SIM,1834,23,25-29,1857,5
SIM,1857,46,40-44,1903,1
SIM,1852,38,45-49,1890,3
STAT,1982,28,30-34,2010,63.87384467459001
STAT,1876,49,50-100,1925,0.2868780812953072
STAT,1895,22,35-39,1917,8.766011329290034
STAT,1952,0,na,1952,6042.554575505902
STAT,1887,28,15-19,1915,0.5847184565766674
SIM,1897,39,50-100,1936,2
STAT,1866,97,na,1963,17.001244846030094
SIM,1845,56,na,1901,1827
STAT,1882,46,25-29,1928,0.06511192493579002
SIM,1934,28,20-24,1962,1
STAT,1884,21,20-24,1905,78.81269798141332
STAT,1952,2,na,1954,5485.541477371679
STAT,1948,28,40-44,1976,6.17934579744966
STAT,1947,39,45-49,1986,0.9110666080350568
STAT,1955,38,25-29,1993,1.5524869634763194
SIM,1919,39,35-39,1958,1
STAT,1985,11,na,1996,6448.586281881431
STAT,1898,47,30-34,1945,0.08476659546919713
STAT,1850,19,50-100,1869,0.06090628433835906
STAT,1896,28,25-29,1924,64.25250013881309
STAT,1835,34,45-49,1869,1.3576752835287735
SIM,1974,24,40-44,1998,14
SIM,1858,26,45-49,1884,3
SIM,1990,24,na,2014,5871
STAT,1807,108,na,1915,8.957201871291819E-4
STAT,1890,43,25-29,1933,0.8989773406594227
SIM,1886,30,na,1916,2061
STAT,1981,20,50-100,2001,1.0660616105721148
SIM,1956,28,40-44,1984,20
STAT,1903,15,na,1918,4170.822413916997
STAT,1869,20,40-44,1889,2.352806323188062
STAT,1919,38,15-19,1957,0.02377870117583631
SIM,1841,39,40-44,1880,5
SIM,1938,24,30-34,1962,84
STAT,1837,42,40-44,1879,1.921948192632824
STAT,1921,34,na,1955,4813.835572675344
STAT,1927,32,35-39,1959,12.97011375134326
STAT,1829,48,20-24,1877,0.012082603241369637
SIM,1873,27,25-29,1900,3
SIM,1787,69,na,1856,1120
STAT,1891,96,na,1987,112.21826972388861
SIM,1863,75,na,1938,1131
SIM,1892,21,20-24,1913,1
STAT,1926,28,20-24,1954,25.159025824653817
STAT,1854,106,na,1960,0.027512449958467487
STAT,1867,113,na,1980,5.152492057984075E-4
STAT,1866,36,30-34,1902,5.728284616133027
STAT,1887,43,50-100,1930,1.3564634501381096
STAT,1874,92,na,1966,149.5257057044703
STAT,1900,45,45-49,1945,0.2153036134260968
STAT,1912,46,20-24,1958,0.012298943367388616
STAT,1977,16,na,1993,5740.998551881373
SIM,1959,16,15-19,1975,3
SIM,1848,13,na,1861,2302
STAT,1929,15,25-29,1944,64.12371478212732
STAT,1823,92,na,1915,23.58555644149215
STAT,1944,29,na,1973,4668.1517056870225
STAT,1905,31,45-49,1936,1.679333240664059
STAT,1850,23,30-34,1873,21.850747843558985
STAT,1954,21,na,1975,5228.838254017477
STAT,1818,48,45-49,1866,0.2871472758913072
STAT,1858,34,25-29,1892,9.142324403510287
SIM,1896,62,na,1958,3031
SIM,1874,36,30-34,1910,5
STAT,1845,28,na,1873,1761.5784093670334
SIM,1945,29,35-39,1974,1
SIM,1842,16,40-44,1858,1
STAT,1918,22,50-100,1940,0.8188127478035336
SIM,1959,6,na,1965,6033
STAT,1840,49,25-29,1889,0.04541709752396612
SIM,1840,27,30-34,1867,61
STAT,1899,82,na,1981,1469.8966705964954
STAT,1844,109,na,1953,5.950810405329044E-4
STAT,1937,30,50-100,1967,0.9455784721794864
SIM,1875,4,na,1879,3650
STAT,1948,42,20-24,1990,0.024238640486133133
STAT,1911,56,na,1967,3867.4854136811846
STAT,1943,15,50-100,1958,0.4587848550289961
STAT,1963,32,45-49,1995,2.3516968719610887
STAT,1900,64,na,1964,3027.3192991230603
STAT,1942,44,50-100,1986,0.14677733284469624
STAT,1778,88,na,1866,59.57745878146855
STAT,1879,30,na,1909,2898.663949282403
SIM,1873,12,na,1885,3678
STAT,1927,1,na,1928,5991.023158403956
STAT,1881,34,15-19,1915,0.15716095719421658
STAT,1910,24,35-39,1934,10.151196609894761
SIM,1811,68,na,1879,1220
STAT,1889,26,50-100,1915,0.9131296372062009
SIM,1795,64,na,1859,1063
STAT,1887,36,45-49,1923,2.5906313578970885
STAT,1833,70,na,1903,987.3064168885712
STAT,1937,29,35-39,1966,16.88200560993657
SIM,1816,38,35-39,1854,19
STAT,1886,39,20-24,1925,0.9289187383127472
STAT,1857,22,50-100,1879,0.423133624905641
STAT,1897,38,25-29,1935,4.420949325122467
STAT,1918,45,45-49,1963,0.2681096722309085
SIM,1842,28,35-39,1870,28
SIM,1835,32,30-34,1867,4
STAT,1840,52,25-29,1892,0.002826281862035085
SIM,1866,31,20-24,1897,6
SIM,1877,20,40-44,1897,4
STAT,1916,17,40-44,1933,0.3425074460694781
SIM,1895,36,45-49,1931,6
SIM,1936,22,na,1958,3735
STAT,1990,17,25-29,2007,71.62047004857548
SIM,1958,55,na,2013,5888
SIM,1982,29,na,2011,6262
STAT,1969,20,45-49,1989,1.6285640810536426
SIM,1906,16,35-39,1922,2
SIM,1837,42,50-100,1879,7
STAT,1827,32,30-34,1859,30.23324311528058
STAT,1929,48,25-29,1977,0.07913093806760134
SIM,1955,36,40-44,1991,1
STAT,1825,45,40-44,1870,0.24578973544236152
STAT,1958,31,25-29,1989,14.288393949671521
SIM,1869,80,na,1949,346
STAT,1820,50,na,1870,1457.3752906633406
STAT,1959,45,45-49,2004,0.3428689083715141
SIM,1851,28,45-49,1879,1
STAT,1834,28,35-39,1862,11.463539860170947
STAT,1870,28,45-49,1898,1.2587721876687095
SIM,1896,39,30-34,1935,2
STAT,1893,22,50-100,1915,0.5948514295239886
STAT,1873,21,45-49,1894,0.8242674422116854
SIM,1961,22,35-39,1983,21
STAT,1871,42,na,1913,2650.3282944844486
STAT,1983,17,25-29,2000,70.74673964881305
STAT,1871,21,35-39,1892,6.720096006988977
STAT,1913,25,30-34,1938,45.38575883184979
SIM,1966,31,25-29,1997,27
SIM,1991,17,25-29,2008,88
STAT,1830,42,15-19,1872,0.013264945355119049
STAT,1963,24,15-19,1987,7.825113377893267
SIM,1831,56,na,1887,1348
STAT,1848,37,35-39,1885,7.74453567399942
STAT,1974,34,30-34,2008,24.169437088508232
SIM,1867,35,45-49,1902,7
STAT,1881,28,20-24,1909,13.012653499454313
STAT,1924,20,15-19,1944,7.290144345451619
SIM,1921,25,30-34,1946,103
SIM,1971,19,35-39,1990,13
SIM,1832,33,30-34,1865,39
STAT,1875,36,40-44,1911,5.245716778266752
STAT,1831,24,45-49,1855,0.9014174217236317
SIM,1882,48,na,1930,3038
STAT,1853,22,30-34,1875,20.95375988344473
SIM,1883,36,40-44,1919,5
STAT,1830,27,20-24,1857,14.747274599252124
STAT,1892,29,35-39,1921,13.856791410304012
STAT,1895,49,15-19,1944,3.318673671392197E-4
SIM,1861,22,30-34,1883,38
STAT,1841,26,25-29,1867,47.05098212515617
SIM,1848,11,na,1859,2302
SIM,1878,38,25-29,1916,1
STAT,1953,22,35-39,1975,13.188577939942942
SIM,1971,35,na,2006,5708
STAT,1952,18,20-24,1970,187.43680342997345
SIM,1922,17,30-34,1939,21
SIM,1960,18,20-24,1978,395
STAT,1842,85,na,1927,210.9533619325875
STAT,1914,17,30-34,1931,2.9111412066260334
STAT,1891,17,25-29,1908,8.082557802159313
STAT,1860,20,20-24,1880,73.66271273025922
SIM,1831,27,20-24,1858,10
SIM,1856,37,35-39,1893,7
STAT,1929,21,45-49,1950,1.6470962715933368
STAT,1838,48,30-34,1886,0.0851815649953402
SIM,1928,25,na,1953,5355
SIM,1959,21,40-44,1980,15
STAT,1984,23,35-39,2007,15.479171674645677
SIM,1882,24,30-34,1906,59
SIM,1975,36,40-44,2011,5
STAT,1844,62,na,1906,1528.7556702487984
SIM,1804,88,na,1892,83
STAT,1906,55,na,1961,3612.637462400822
SIM,1969,23,20-24,1992,155
SIM,1937,21,45-49,1958,1
SIM,1834,20,20-24,1854,63
SIM,1939,66,na,2005,3996
SIM,1912,39,25-29,1951,4
STAT,1803,101,na,1904,0.19888490472809728
STAT,1941,48,40-44,1989,0.19444314560650477
STAT,1844,35,40-44,1879,4.341022258648145
STAT,1905,18,35-39,1923,0.9141198449127381
SIM,1874,39,35-39,1913,2
STAT,1967,36,40-44,2003,2.2253066176033
STAT,1866,12,na,1878,2880.217718503533
STAT,1978,35,45-49,2013,1.1080773964164876
SIM,1879,32,45-49,1911,1
STAT,1876,25,35-39,1901,11.589061777769675
STAT,1908,26,45-49,1934,1.9096919626135902
STAT,1887,16,20-24,1903,22.98503098725647
STAT,1970,25,45-49,1995,2.5087302754920726
STAT,1860,18,35-39,1878,0.5851407496822706
STAT,1971,18,15-19,1989,66.31398232788686
STAT,1984,17,40-44,2001,2.2925826099884743
SIM,1820,70,na,1890,1273
SIM,1903,35,na,1938,3872
STAT,1864,50,20-24,1914,7.713098366598174E-4
STAT,1975,39,na,2014,5888.520478360922
STAT,1836,65,na,1901,1537.9804573400013
SIM,1884,25,35-39,1909,15
SIM,1924,0,na,1924,5709
STAT,1845,31,35-39,1876,8.19866382467954
STAT,1909,19,15-19,1928,10.227176505286199
STAT,1979,28,15-19,2007,1.1260540591661279
SIM,1939,17,na,1956,5003
SIM,1895,16,20-24,1911,45
STAT,1904,39,25-29,1943,1.019512637829843
STAT,1824,36,35-39,1860,11.104552717533943
SIM,1947,26,50-100,1973,3
STAT,1866,39,35-39,1905,7.489489653324093
STAT,1888,39,30-34,1927,7.157203408223885
SIM,1852,35,40-44,1887,11
SIM,1992,17,40-44,2009,3
STAT,1803,53,40-44,1856,0.03743813373554297
STAT,1947,36,40-44,1983,2.0067078462297294
SIM,1917,19,15-19,1936,4
STAT,1864,47,20-24,1911,0.01230765173397476
SIM,1853,31,35-39,1884,20
STAT,1963,19,35-39,1982,6.148104775226877
SIM,1900,92,na,1992,296
STAT,1849,49,50-100,1898,0.1863822506726513
STAT,1866,27,40-44,1893,3.2042404807373175
STAT,1969,36,15-19,2005,0.028547412549458962
STAT,1933,37,na,1970,5916.39641334108
STAT,1810,74,na,1884,622.0113679847906
STAT,1973,26,40-44,1999,6.990030286111425
SIM,1833,45,40-44,1878,1
SIM,1920,24,45-49,1944,5
STAT,1843,28,45-49,1871,1.3612019874123924
STAT,1879,39,20-24,1918,0.9195386238152233
STAT,1912,24,45-49,1936,1.2899363111042363
STAT,1949,20,na,1969,4920.926612652201
SIM,1848,37,40-44,1885,5
SIM,1899,59,na,1958,3308
SIM,1832,36,35-39,1868,17
STAT,1934,16,45-49,1950,0.7820677619471609
SIM,1984,5,na,1989,6307
STAT,1790,88,na,1878,48.529633619088244
STAT,1918,20,30-34,1938,35.979135700434
SIM,1907,71,na,1978,2972
STAT,1898,17,35-39,1915,0.8558108556296083
STAT,1848,45,20-24,1893,0.012877448314055465
SIM,1977,17,20-24,1994,393
STAT,1858,31,20-24,1889,2.458926652461889
STAT,1858,46,na,1904,2031.2509191499587
STAT,1855,28,50-100,1883,0.5632802584102073
SIM,1837,59,na,1896,1750
STAT,1819,41,35-39,1860,3.9307358119752753
STAT,1915,25,40-44,1940,5.524738714186902
SIM,1957,21,30-34,1978,117
STAT,1818,45,40-44,1863,0.2174591508236488
STAT,1890,69,na,1959,2197.1998247041647
SIM,1926,20,30-34,1946,55
SIM,1968,20,35-39,1988,14
STAT,1964,8,na,1972,5712.493279262753
STAT,1912,49,25-29,1961,0.058543349053463756
STAT,1875,51,35-39,1926,0.010316248828194267
STAT,1976,36,50-100,2012,0.6675199865744968
STAT,1945,31,50-100,1976,1.0630624368212045
STAT,1779,111,na,1890,0.0011072603354127424
STAT,1861,74,na,1935,1064.7391741600238
STAT,1872,24,20-24,1896,79.3560378669128
STAT,1952,40,na,1992,5352.585638483193
STAT,1850,26,35-39,1876,11.773751408648915
SIM,1898,21,15-19,1919,11
STAT,1834,30,20-24,1864,3.2260642912071162
SIM,1880,24,20-24,1904,10
STAT,1899,68,na,1967,2755.336831033564
STAT,1868,78,na,1946,866.3164079592267
STAT,1877,22,25-29,1899,68.72020387256454
STAT,1987,22,35-39,2009,15.563969203591624
STAT,1884,24,25-29,1908,64.86402962651168
STAT,1778,86,na,1864,90.96260601281838
STAT,1851,50,35-39,1901,0.006925045406892411
STAT,1992,17,35-39,2009,6.950852747310483
STAT,1969,17,20-24,1986,195.44940641810234
SIM,1906,46,na,1952,3463
SIM,1923,25,40-44,1948,1
STAT,1832,27,30-34,1859,23.927671494815307
STAT,1949,21,30-34,1970,38.71590440532134
SIM,1934,20,25-29,1954,321
SIM,1941,23,na,1964,3444
SIM,1908,16,45-49,1924,1
STAT,1880,54,20-24,1934,8.778310489387244E-4
STAT,1955,35,20-24,1990,0.41678906729543364
STAT,1958,17,45-49,1975,0.7571725032796013
SIM,1827,41,35-39,1868,7
STAT,1908,38,na,1946,4050.0370516368566
STAT,1944,35,45-49,1979,0.8738056277054413
SIM,1888,18,30-34,1906,3
STAT,1842,49,35-39,1891,0.10548413912467994
STAT,1823,47,na,1870,1475.3808218949077
STAT,1994,20,25-29,2014,154.44173469320427
SIM,1842,30,20-24,1872,4
STAT,1819,52,50-100,1871,0.0279690980457032
SIM,1888,0,na,1888,3647
STAT,1784,101,na,1885,0.14586357477672343
STAT,1966,27,45-49,1993,2.5009862876417697
STAT,1918,46,15-19,1964,4.534185164247927E-4
STAT,1881,7,na,1888,2934.1636086997078
STAT,1890,40,20-24,1930,0.22620515487939025
STAT,1837,45,45-49,1882,0.18200236642573694
STAT,1876,73,na,1949,1416.9638048567228
SIM,1959,4,na,1963,6033
SIM,1966,17,45-49,1983,1
SIM,1964,18,na,1982,5616
STAT,1926,20,25-29,1946,130.25055328683527
SIM,1947,61,na,2008,5402
STAT,1900,10,na,1910,4148.033215996961
STAT,1912,36,50-100,1948,0.4756418838398577
SIM,1920,36,50-100,1956,1
SIM,1931,45,na,1976,6070
STAT,1792,69,na,1861,1027.5484853785686
STAT,1858,17,40-44,1875,0.19235067138501946
STAT,1970,26,15-19,1996,1.0247104810955028
SIM,1953,28,15-19,1981,2
STAT,1864,31,na,1895,2469.0029653826555
STAT,1902,27,20-24,1929,19.129633114132663
STAT,1817,86,na,1903,153.39634410518872
STAT,1955,34,50-100,1989,1.289469867163565
STAT,1892,26,30-34,1918,36.54896193271396
SIM,1826,48,45-49,1874,1
STAT,1887,33,40-44,1920,5.585106219937469
STAT,1817,38,45-49,1855,6.978722411742821
STAT,1863,27,15-19,1890,0.45783584323417603
STAT,1974,18,40-44,1992,2.1070879604718136
SIM,1895,33,40-44,1928,8
STAT,1900,42,40-44,1942,0.24981473099863796
STAT,1871,48,15-19,1919,4.534796651799887E-4
STAT,1890,37,20-24,1927,1.0869895874401418
STAT,1939,34,25-29,1973,10.873597644893861
STAT,1934,30,25-29,1964,14.58698436861082
STAT,1930,29,25-29,1959,96.50303930623477
SIM,1892,24,25-29,1916,109
SIM,1964,38,30-34,2002,4
STAT,1862,49,50-100,1911,0.23420353217705783
SIM,1969,26,25-29,1995,5
STAT,1851,35,40-44,1886,3.5821357577728823
STAT,1878,43,50-100,1921,1.2637818692254017
STAT,1829,27,15-19,1856,0.9351455856343199
STAT,1897,22,45-49,1919,1.0760605021402723
STAT,1828,78,na,1906,518.5700609143001
SIM,1933,47,45-49,1980,1
SIM,1984,21,20-24,2005,177
STAT,1982,17,na,1999,5977.2700283445865
SIM,1910,27,20-24,1937,15
STAT,1846,34,20-24,1880,3.2343807196988323
SIM,1952,15,na,1967,4837
STAT,1973,5,na,1978,5868.392192705801
STAT,1807,49,40-44,1856,0.683834416918223
STAT,1905,23,15-19,1928,5.49340623724283
STAT,1921,19,30-34,1940,15.942013940275185
SIM,1886,43,50-100,1929,1
STAT,1931,44,35-39,1975,0.30948548413544563
STAT,1927,15,15-19,1942,65.40952975698606
STAT,1833,25,na,1858,2033.1072226045162
SIM,1847,34,20-24,1881,6
SIM,1808,70,na,1878,915
STAT,1820,103,na,1923,0.08422892096628831
STAT,1867,20,30-34,1887,19.551343458160407
SIM,1913,23,15-19,1936,8
SIM,1915,9,na,1924,5039
SIM,1854,34,20-24,1888,10
STAT,1948,45,25-29,1993,0.07321132918200042
STAT,1884,60,na,1944,2174.606287748127
STAT,1861,24,45-49,1885,0.6774712382203112
SIM,1861,38,50-100,1899,2
SIM,1810,44,35-39,1854,4
STAT,1812,55,na,1867,1173.7718991555066
STAT,1877,104,na,1981,2.0745063735885343
STAT,1895,43,40-44,1938,0.2329389245477583
SIM,1891,31,na,1922,3369
STAT,1974,37,35-39,2011,3.7551237786838274
SIM,1887,42,45-49,1929,6
STAT,1976,21,30-34,1997,44.47440517553971
SIM,1981,4,na,1985,6481
STAT,1870,25,40-44,1895,3.4312473473732585
SIM,1883,73,na,1956,1121
STAT,1877,89,na,1966,315.2406560391351
STAT,1944,36,15-19,1980,0.024594062279503386
STAT,1863,38,15-19,1901,0.05638507484886329
SIM,1884,29,na,1913,2596
SIM,1969,32,35-39,2001,44
STAT,1953,38,15-19,1991,0.027591915314912535
SIM,1859,19,15-19,1878,11
STAT,1950,61,na,2011,4803.414068092221
SIM,1846,30,na,1876,1727
SIM,1902,17,20-24,1919,26
STAT,1924,74,na,1998,3483.0481151348117
STAT,1838,53,50-100,1891,0.0128745370918918
STAT,1908,40,25-29,1948,0.07720722438830674
SIM,1947,34,25-29,1981,3
STAT,1862,59,na,1921,1892.8027240584836
STAT,1837,37,15-19,1874,0.049507995106500564
STAT,1861,110,na,1971,0.004244867801359963
STAT,1869,38,na,1907,2619.999687656342
SIM,1812,83,na,1895,59
SIM,1975,39,45-49,2014,2
STAT,1863,35,45-49,1898,2.030752553523437
SIM,1908,30,25-29,1938,13
SIM,1933,65,na,1998,5494
SIM,1961,40,50-100,2001,1
STAT,1870,15,50-100,1885,0.056938983655995076
SIM,1819,62,na,1881,570
SIM,1921,28,35-39,1949,76
STAT,1945,28,15-19,1973,0.8933833123635345
SIM,1925,82,na,2007,1971
SIM,1976,30,25-29,2006,3
STAT,1855,44,15-19,1899,0.011592109760610024
STAT,1929,45,20-24,1974,0.01660937758096217
SIM,1892,16,na,1908,4076
STAT,1908,36,na,1944,4089.8155861269743
STAT,1879,42,45-49,1921,1.8012592925828084
STAT,1913,28,35-39,1941,17.21243590561569
SIM,1848,49,50-100,1897,2
SIM,1959,37,20-24,1996,1
STAT,1939,42,na,1981,4460.3908950470395
STAT,1804,68,na,1872,954.4812723434369
STAT,1791,84,na,1875,119.48890372742414
SIM,1969,33,50-100,2002,1
STAT,1865,16,na,1881,2726.020033324452
STAT,1901,88,na,1989,781.0550604089184
SIM,1974,27,35-39,2001,29
SIM,1873,24,20-24,1897,4
SIM,1897,76,na,1973,1925
SIM,1927,29,25-29,1956,94
STAT,1963,16,30-34,1979,17.875757474214176
STAT,1814,47,30-34,1861,0.26912728703495886
SIM,1865,8,na,1873,3500
STAT,1860,23,25-29,1883,54.493522684350715
STAT,1885,36,35-39,1921,8.180891875530051
STAT,1826,97,na,1923,2.957986431768498
SIM,1843,42,30-34,1885,1
STAT,1835,39,15-19,1874,0.04244042281837452
STAT,1889,39,50-100,1928,1.7289708859757702
STAT,1842,46,30-34,1888,0.07546313528850986
SIM,1898,37,30-34,1935,3
SIM,1913,15,30-34,1928,6
STAT,1942,42,45-49,1984,0.20862871221246115
STAT,1879,45,15-19,1924,4.8681255078230555E-4
SIM,1893,22,40-44,1915,5
SIM,1858,31,50-100,1889,1
STAT,1887,30,50-100,1917,1.19452666983332
STAT,1961,32,35-39,1993,13.88861011822896
SIM,1913,45,50-100,1958,1
SIM,1839,38,50-100,1877,5
SIM,1884,49,50-100,1933,3
STAT,1947,48,35-39,1995,0.1738481309294998
STAT,1887,19,25-29,1906,7.289606868300837
SIM,1862,4,na,1866,3263
SIM,1822,47,30-34,1869,2
SIM,1899,88,na,1987,453
STAT,1955,35,na,1990,5948.359702472846
STAT,1888,41,na,1929,3149.555952447002
SIM,1840,79,na,1919,287
STAT,1865,24,20-24,1889,71.58861101946343
STAT,1962,37,20-24,1999,0.40158366351495134
SIM,1901,36,45-49,1937,1
STAT,1977,25,45-49,2002,2.707855593335582
SIM,1978,24,na,2002,6008
SIM,1982,24,15-19,2006,16
STAT,1859,35,45-49,1894,1.8500263527644938
SIM,1893,36,35-39,1929,23
STAT,1969,42,35-39,2011,0.30168543499740474
STAT,1950,31,20-24,1981,3.3946301494073117
STAT,1907,51,na,1958,3735.1938415217564
STAT,1951,37,45-49,1988,0.9651800588601295
STAT,1843,25,40-44,1868,3.7527363148717376
STAT,1874,24,30-34,1898,20.912531885962416
SIM,1855,24,na,1879,1692
SIM,1911,31,35-39,1942,25
STAT,1874,36,25-29,1910,3.4179917305927443
STAT,1918,14,na,1932,4959.887047699439
STAT,1984,19,na,2003,6028.955207740516
SIM,1882,36,25-29,1918,6
SIM,1949,40,na,1989,5819
STAT,1835,42,30-34,1877,0.8597095333877318
SIM,1962,38,20-24,2000,2
SIM,1906,37,40-44,1943,3
STAT,1908,32,30-34,1940,17.18439908866991
SIM,1899,24,35-39,1923,5
SIM,1932,27,40-44,1959,1
SIM,1935,23,45-49,1958,2
SIM,1851,31,na,1882,2812
SIM,1879,24,15-19,1903,7
SIM,1915,23,25-29,1938,10
STAT,1855,89,na,1944,89.38957342707877
STAT,1825,48,45-49,1873,0.3250188534646562
STAT,1960,15,35-39,1975,6.310477577398986
SIM,1946,4,na,1950,4746
STAT,1840,37,30-34,1877,5.056746763521742
STAT,1965,24,25-29,1989,133.4311512527892
STAT,1861,29,15-19,1890,0.4321744270933892
SIM,1982,29,40-44,2011,25
STAT,1823,33,15-19,1856,0.35527185583344273
STAT,1824,42,20-24,1866,0.22600130793239429
STAT,1929,44,50-100,1973,0.17500107562294764
STAT,1904,36,20-24,1940,0.2770568230114841
STAT,1935,42,35-39,1977,0.327962493509982
SIM,1916,32,30-34,1948,4
STAT,1859,34,40-44,1893,3.9526308318446968
STAT,1936,47,20-24,1983,0.01264829040403728
STAT,1984,31,20-24,2015,4.077561558799877
STAT,1809,52,30-34,1861,0.014388027431972787
STAT,1839,34,20-24,1873,2.5838011448848692
STAT,1924,27,40-44,1951,6.261312107120637
STAT,1929,24,15-19,1953,7.720312138809436
SIM,1851,25,40-44,1876,7
SIM,1841,24,na,1865,2090
SIM,1798,75,na,1873,616
SIM,1942,30,25-29,1972,17
SIM,1881,63,na,1944,1371
STAT,1974,29,40-44,2003,7.047230632522731
STAT,1859,46,35-39,1905,0.12906807063398884
STAT,1889,28,25-29,1917,59.96487938432602
STAT,1899,23,15-19,1922,5.199871945362803
STAT,1860,15,30-34,1875,1.7300854925290698
STAT,1874,53,50-100,1927,0.0175566115355833
STAT,1919,29,25-29,1948,81.4679123929356
SIM,1833,37,50-100,1870,4
SIM,1796,94,na,1890,5
STAT,1868,20,25-29,1888,64.39345118242896
STAT,1856,34,na,1890,2083.0376994045914
STAT,1907,23,25-29,1930,96.90124661725805
SIM,1854,1,na,1855,3802
SIM,1895,19,25-29,1914,23
SIM,1827,29,20-24,1856,2
SIM,1928,38,30-34,1966,5
SIM,1835,23,40-44,1858,3
STAT,1894,26,40-44,1920,4.459287245647839
STAT,1925,47,45-49,1972,0.30383462863319255
SIM,1826,32,na,1858,2155
STAT,1927,23,45-49,1950,1.5945298126232992
SIM,1897,26,50-100,1923,2
SIM,1876,93,na,1969,46
SIM,1976,25,35-39,2001,53
SIM,1858,35,35-39,1893,10
STAT,1823,41,50-100,1864,1.1309224216279683
SIM,1937,24,15-19,1961,12
SIM,1975,25,50-100,2000,4
STAT,1965,2,na,1967,5669.715337437855
SIM,1973,24,25-29,1997,14
SIM,1900,30,20-24,1930,9
STAT,1874,35,20-24,1909,0.9193664805823965
SIM,1880,27,25-29,1907,3
STAT,1924,46,50-100,1970,0.31143773540150305
SIM,1876,20,25-29,1896,159
SIM,1871,32,40-44,1903,2
STAT,1917,96,na,2013,177.50065452078246
STAT,1959,31,40-44,1990,6.025117213675787
STAT,1952,15,50-100,1967,0.5184124287503578
SIM,1970,36,na,2006,5979
STAT,1930,26,20-24,1956,26.801759920782448
STAT,1896,49,30-34,1945,0.08149319289786043
STAT,1941,15,40-44,1956,1.6639323436519977
STAT,1851,38,45-49,1889,1.5812486505635308
SIM,1868,42,na,1910,3034
SIM,1871,35,45-49,1906,1
STAT,1878,25,45-49,1903,1.3469424414491717
STAT,1881,18,50-100,1899,0.054391406112080924
STAT,1925,20,30-34,1945,39.92676926916077
STAT,1980,28,20-24,2008,29.356627733247397
STAT,1836,48,20-24,1884,0.011287463438970817
STAT,1977,24,40-44,2001,5.25665781421063
SIM,1954,36,25-29,1990,2
SIM,1858,74,na,1932,1596
SIM,1847,82,na,1929,575
SIM,1905,16,na,1921,4403
STAT,1839,30,na,1869,2159.491550506211
SIM,1817,50,na,1867,1416
STAT,1915,37,35-39,1952,2.820335978205368
STAT,1991,17,40-44,2008,2.3133108072063893
SIM,1913,48,30-34,1961,1
STAT,1850,32,20-24,1882,2.9109340598486373
SIM,1876,36,40-44,1912,14
STAT,1841,49,40-44,1890,0.14903415872584197
SIM,1848,67,na,1915,960
SIM,1950,44,50-100,1994,1
STAT,1771,99,na,1870,0.42560891296969866
STAT,1953,25,na,1978,5257.009536492367
STAT,1899,39,na,1938,3716.57261381434
STAT,1945,19,25-29,1964,54.59429378479818
SIM,1816,43,25-29,1859,1
STAT,1868,36,40-44,1904,4.876994199956391
SIM,1867,46,35-39,1913,1
SIM,1897,28,25-29,1925,118
STAT,1934,22,30-34,1956,44.59695519917902
STAT,1963,32,na,1995,5652.252808101156
SIM,1923,37,35-39,1960,2
STAT,1893,28,50-100,1921,0.9298465248550508
STAT,1813,79,na,1892,320.1009190541379
STAT,1905,48,30-34,1953,0.09005905194746844
SIM,1877,32,50-100,1909,3
SIM,1886,25,45-49,1911,1
SIM,1825,35,40-44,1860,1
STAT,1905,70,na,1975,2885.5604297895575
SIM,1888,11,na,1899,3110
STAT,1829,42,50-100,1871,1.1291701097545226
STAT,1853,79,na,1932,696.0424641411006
STAT,1931,25,na,1956,5587.567341388946
STAT,1888,76,na,1964,1625.1100396960128
SIM,1942,22,30-34,1964,44
SIM,1866,34,25-29,1900,2
STAT,1942,66,na,2008,3948.395134821218
SIM,1953,19,25-29,1972,76
STAT,1921,27,15-19,1948,0.9076536310329646
STAT,1953,58,na,2011,5060.681149557611
STAT,1941,27,35-39,1968,17.9280409328608
SIM,1838,35,na,1873,1810
SIM,1908,56,na,1964,3423
STAT,1960,20,25-29,1980,139.39339007894907
STAT,1819,42,na,1861,1897.650675831073
STAT,1931,41,30-34,1972,0.19742960126247475
SIM,1917,19,na,1936,5687
STAT,1941,32,na,1973,4583.6978153456985
SIM,1859,32,25-29,1891,26
STAT,1948,57,na,2005,4825.10038463163
STAT,1867,23,35-39,1890,6.268233371099389
STAT,2004,2,na,2006,6940.01710732591
STAT,1856,34,15-19,1890,0.12430925682318171
STAT,1931,38,30-34,1969,2.7833871405859454
STAT,1884,46,35-39,1930,0.16008416017920432
SIM,1892,46,35-39,1938,1
SIM,1948,24,25-29,1972,7
STAT,1873,11,na,1884,3105.676729397099
STAT,1912,25,15-19,1937,0.8090768832829474
STAT,1826,45,35-39,1871,0.10339692508910853
SIM,1913,26,na,1939,4534
STAT,1861,32,30-34,1893,16.750978991255288
STAT,1963,33,50-100,1996,1.2348712367316614
SIM,1871,31,50-100,1902,2
STAT,1950,17,40-44,1967,1.9086088427232333
SIM,1841,16,25-29,1857,7
SIM,1867,42,50-100,1909,2
STAT,1973,34,15-19,2007,0.1952530184502494
SIM,1860,13,na,1873,2919
STAT,1905,15,30-34,1920,2.674645033366391
SIM,1909,33,45-49,1942,5
STAT,1802,87,na,1889,80.97537655708963
SIM,1921,77,na,1998,3129
STAT,1845,19,20-24,1864,14.92193419856672
STAT,1880,78,na,1958,1091.2863694577316
STAT,1827,54,40-44,1881,0.011254658485009715
STAT,1944,43,na,1987,4786.048255722262
SIM,1893,25,45-49,1918,2
SIM,1918,19,30-34,1937,18
SIM,1943,33,na,1976,5242
SIM,1975,24,na,1999,6112
SIM,1980,18,30-34,1998,48
STAT,1865,27,25-29,1892,44.04661130048351
STAT,1972,26,25-29,1998,97.72077340477388
SIM,1893,33,30-34,1926,6
SIM,1843,45,35-39,1888,1
STAT,1904,45,na,1949,3766.3507912341533
SIM,1922,25,25-29,1947,9
STAT,1849,32,15-19,1881,0.1163084046715178
STAT,1972,18,30-34,1990,18.004495332996218
STAT,1831,98,na,1929,2.548698463348962
STAT,1897,58,na,1955,3051.6975553394855
STAT,1927,20,40-44,1947,4.808227568952205
STAT,1835,45,35-39,1880,0.10382582509118753
STAT,1918,92,na,2010,500.6328195246237
STAT,1946,45,15-19,1991,4.927489864102614E-4
STAT,1891,30,na,1921,3430.9977670305793
STAT,1998,6,na,2004,6661.233824430528
STAT,1956,31,15-19,1987,0.20014425285102513
STAT,1885,33,30-34,1918,20.013228648080204
STAT,1965,13,na,1978,5658.555800622239
STAT,1930,9,na,1939,5940.24621268342
SIM,1887,15,na,1902,3867
SIM,1991,20,na,2011,6217
STAT,1919,44,na,1963,4628.161440511491
SIM,1937,2,na,1939,4600
STAT,1943,19,15-19,1962,55.50749088121655
STAT,1875,39,45-49,1914,2.353495404502265
STAT,1895,46,45-49,1941,0.20054505720657692
SIM,1815,40,na,1855,2091
STAT,1874,33,20-24,1907,3.1800446247827403
STAT,1894,29,45-49,1923,1.6354055185653489
SIM,1889,35,30-34,1924,15
STAT,1890,40,50-100,1930,1.5047560015999881
STAT,1853,47,45-49,1900,0.23387065771325932
SIM,1875,78,na,1953,738
SIM,1927,26,20-24,1953,1
SIM,1927,40,na,1967,5008
STAT,1959,40,30-34,1999,0.20112162634386097
SIM,1911,38,50-100,1949,2
STAT,1929,51,na,1980,5425.678293573967
SIM,1994,4,na,1998,6236
SIM,1871,33,45-49,1904,2
STAT,1914,25,25-29,1939,77.1313622678779
SIM,1883,39,45-49,1922,6
STAT,1853,50,45-49,1903,0.014656470844262519
STAT,1885,25,45-49,1910,1.2867511219092473
SIM,1897,47,na,1944,3508
SIM,1897,22,na,1919,4094
STAT,1888,20,35-39,1908,7.963496968188418
STAT,1974,4,na,1978,5926.186351663261
SIM,1969,42,na,2011,5727
SIM,1972,13,na,1985,5833
SIM,1900,33,25-29,1933,2
SIM,1893,24,40-44,1917,4
STAT,1890,28,30-34,1918,35.38451204892518
STAT,1905,39,40-44,1944,1.5623127235619527
STAT,1937,65,na,2002,3733.1593168697577
SIM,1837,18,25-29,1855,15
SIM,1919,36,30-34,1955,3
STAT,1923,24,20-24,1947,148.32085459360982
STAT,1908,35,35-39,1943,2.6416314331252466
STAT,1868,18,50-100,1886,0.054978387864378565
SIM,1894,81,na,1975,1939
STAT,1853,44,40-44,1897,2.209193751198204
STAT,1919,26,20-24,1945,22.834228180091394
STAT,1832,52,50-100,1884,0.010906137542989885
SIM,1931,24,20-24,1955,170
SIM,1989,16,na,2005,6747
STAT,1824,44,20-24,1868,0.2185481908046772
SIM,1854,37,25-29,1891,4
STAT,1866,41,na,1907,2483.4313658342476
SIM,1896,20,35-39,1916,15
SIM,1869,29,25-29,1898,43
STAT,1824,45,25-29,1869,0.08034185735556092
SIM,1866,7,na,1873,2838
STAT,1867,26,na,1893,2580.2757173734053
SIM,1847,37,25-29,1884,7
SIM,1987,19,25-29,2006,99
STAT,1846,37,25-29,1883,3.1082629554388554
SIM,1931,19,50-100,1950,1
STAT,1814,54,50-100,1868,0.03857069223371939
STAT,1923,19,50-100,1942,0.5047970578340909
STAT,1946,36,25-29,1982,1.2995858861201413
STAT,1869,23,45-49,1892,0.7769242477593351
STAT,1885,24,40-44,1909,2.3836754244420804
SIM,1840,52,50-100,1892,1
SIM,1938,27,35-39,1965,41
SIM,1813,99,na,1912,8
SIM,1913,39,40-44,1952,3
SIM,1947,14,na,1961,6076
SIM,1881,21,45-49,1902,1
SIM,1916,35,35-39,1951,6
STAT,1977,8,na,1985,6128.206604454908
STAT,1847,31,45-49,1878,1.5918783759005215
STAT,1839,37,25-29,1876,2.7286278337021894
SIM,1888,23,20-24,1911,180
STAT,1932,21,50-100,1953,0.9995958553133696
STAT,1934,25,35-39,1959,23.340031714995074
SIM,1940,21,50-100,1961,2
STAT,1775,91,na,1866,23.892448946610706
SIM,1987,12,na,1999,6558
STAT,1915,34,30-34,1949,18.36258395073159
STAT,1889,91,na,1980,369.74785241103655
SIM,1909,30,40-44,1939,15
STAT,1941,18,45-49,1959,0.5937564269706842
SIM,1876,39,45-49,1915,3
SIM,1976,20,na,1996,5600
STAT,1959,34,45-49,1993,2.4182115068370704
STAT,1916,33,na,1949,4487.640928281101
SIM,1845,42,40-44,1887,7
STAT,1843,16,na,1859,2960.7740637086677
STAT,1880,8,na,1888,3219.062246973941
STAT,1840,46,20-24,1886,0.009832644511163233
STAT,1872,42,50-100,1914,1.2227115644552766
STAT,1945,16,20-24,1961,170.962262898558
STAT,1931,29,40-44,1960,6.939253200670879
STAT,1949,45,40-44,1994,0.22114261800567908
SIM,1945,26,30-34,1971,52
SIM,1834,42,30-34,1876,2
SIM,1995,19,50-100,2014,2
STAT,1987,19,50-100,2006,0.616831294427916
STAT,1905,41,na,1946,3891.376091022255
STAT,1906,26,na,1932,4029.9933239562215
STAT,1868,39,45-49,1907,2.188067698381161
STAT,1849,36,50-100,1885,0.9838860359489983
STAT,1869,52,na,1921,2393.5876142702205
STAT,1853,23,na,1876,2497.1610154797618
SIM,1897,25,20-24,1922,1
STAT,1872,27,25-29,1899,49.01897984024085
SIM,1842,33,25-29,1875,4
STAT,1854,53,na,1907,1726.013994003539
STAT,1861,35,35-39,1896,6.850257626597657
SIM,1923,34,30-34,1957,32
SIM,1953,16,20-24,1969,331
STAT,1868,22,na,1890,2622.2893266585347
STAT,1925,23,35-39,1948,12.962643417928552
SIM,1867,43,30-34,1910,3
STAT,1869,32,35-39,1901,11.318093134994546
SIM,1885,22,25-29,1907,3
STAT,1950,14,na,1964,5358.14839112099
SIM,1877,32,35-39,1909,29
STAT,1850,35,25-29,1885,3.0740971858989203
SIM,1895,66,na,1961,2470
SIM,1838,27,30-34,1865,62
STAT,1937,26,30-34,1963,44.12238498609854
STAT,1937,42,45-49,1979,0.19383942405083976
STAT,1935,29,50-100,1964,1.5650990074191093
STAT,1786,83,na,1869,224.04798851771915
SIM,1954,28,30-34,1982,65
STAT,1961,26,50-100,1987,1.4911523368034711
SIM,1914,41,na,1955,3921
STAT,1834,33,25-29,1867,11.84947604000829
STAT,1863,31,50-100,1894,0.9283711686153333
STAT,1908,81,na,1989,1820.5912124562344
STAT,1875,22,15-19,1897,3.9344009393106747
STAT,1809,49,15-19,1858,9.897231060994986E-4
SIM,1961,21,na,1982,5282
STAT,1807,54,na,1861,1544.8153916922918
SIM,1933,23,35-39,1956,20
STAT,1859,43,30-34,1902,1.0492606473001553
STAT,1889,25,20-24,1914,16.802024406997
STAT,1817,61,na,1878,1526.3782596787535
STAT,1950,34,25-29,1984,12.839112121328334
STAT,1941,24,30-34,1965,34.26250800927219
SIM,1842,25,30-34,1867,63
STAT,1946,28,30-34,1974,50.34573703468437
STAT,1963,48,15-19,2011,5.602141882410258E-4
STAT,1818,46,na,1864,1257.060943001304
STAT,1849,46,40-44,1895,0.13306841543942535
STAT,1903,31,35-39,1934,16.714668950862137
SIM,1845,43,45-49,1888,7
STAT,1874,27,35-39,1901,11.399699849163465
STAT,1904,20,50-100,1924,0.679830289484517
SIM,1926,23,35-39,1949,20
STAT,1896,25,20-24,1921,18.003406104158685
SIM,1948,21,20-24,1969,1
SIM,1882,27,35-39,1909,12
STAT,1882,15,25-29,1897,6.417299129797482
STAT,1918,23,35-39,1941,11.681002873684092
STAT,1834,25,30-34,1859,30.57148946816334
SIM,1912,20,50-100,1932,1
SIM,1857,49,45-49,1906,1
SIM,1856,34,30-34,1890,23
SIM,1968,46,na,2014,5265
STAT,1866,20,15-19,1886,3.609296991735205
STAT,1850,34,20-24,1884,2.851104784743665
SIM,1942,25,35-39,1967,48
SIM,1971,16,30-34,1987,17
SIM,1864,17,30-34,1881,3
STAT,1902,39,15-19,1941,0.019565060365102332
STAT,1994,15,35-39,2009,6.991731123291271
STAT,1934,17,50-100,1951,0.5851137719477929
SIM,1902,9,na,1911,4346
SIM,1903,89,na,1992,633
STAT,1848,34,30-34,1882,19.2825495751045
SIM,1829,41,45-49,1870,3
SIM,1890,24,15-19,1914,1
STAT,1956,17,35-39,1973,6.40782898231216
SIM,1839,31,na,1870,2344
STAT,1923,81,na,2004,2351.1180986859786
STAT,1826,42,30-34,1868,0.8620170711830006
STAT,1882,24,15-19,1906,3.6954296050531483
STAT,1787,68,na,1855,558.7720000000002
STAT,1858,47,50-100,1905,0.220079413560869
SIM,1872,38,30-34,1910,3
STAT,1864,38,30-34,1902,5.464579116340058
SIM,1978,22,40-44,2000,12
SIM,1926,44,na,1970,5784
SIM,1985,22,40-44,2007,1
SIM,1918,32,40-44,1950,3
STAT,1892,27,na,1919,3451.949162295006
SIM,1969,39,25-29,2008,3
STAT,1796,82,na,1878,196.9573241357527
SIM,1809,94,na,1903,8
SIM,1835,39,20-24,1874,1
STAT,1870,44,45-49,1914,1.679779617226471
SIM,1872,47,na,1919,2742
STAT,1889,31,15-19,1920,0.2034126701239008
STAT,1898,37,25-29,1935,4.490627194106144
STAT,1884,22,25-29,1906,65.27264774578647
STAT,1805,50,45-49,1855,0.054040834641768835
SIM,1832,29,25-29,1861,87
STAT,1889,114,na,2003,7.393289477714549E-4
STAT,1968,15,40-44,1983,2.0171961532832876
STAT,1999,5,na,2004,6703.315993709495
STAT,1866,44,25-29,1910,0.6776191554167438
STAT,1877,45,40-44,1922,0.20756507876374644
SIM,1866,36,45-49,1902,1
STAT,1871,25,20-24,1896,13.560567923718205
STAT,1833,38,35-39,1871,6.205879438687583
STAT,1912,98,na,2010,84.43151583235665
SIM,1858,12,na,1870,3246
SIM,1841,38,35-39,1879,12
STAT,1996,16,15-19,2012,76.13702760870098
SIM,1948,15,35-39,1963,9
STAT,1809,74,na,1883,548.4399152002887
STAT,1854,61,na,1915,1522.371763152641
STAT,1815,52,25-29,1867,0.006949791715751766
STAT,1872,27,na,1899,2765.5083960454695
STAT,1837,43,45-49,1880,1.2625607926171105
STAT,1900,95,na,1995,183.03967734226765
STAT,1893,31,35-39,1924,14.832908873317896
STAT,1879,28,30-34,1907,30.23785140631923
SIM,1957,13,na,1970,6325
STAT,1778,110,na,1888,0.0026945203764635202
STAT,1910,37,20-24,1947,0.29125378639340566
STAT,1816,39,45-49,1855,6.161686995843087
STAT,1788,87,na,1875,86.47256713930537
STAT,1905,19,na,1924,4195.952936848799
STAT,1899,105,na,2004,2.3181197179468382
STAT,1816,50,20-24,1866,0.0015035896647002246
STAT,1877,58,na,1935,2373.9968572105727
STAT,1841,43,50-100,1884,0.9636056113653407
SIM,1864,25,25-29,1889,58
STAT,1765,90,na,1855,2.4279
STAT,1915,49,na,1964,4247.929040094039
STAT,1856,25,25-29,1881,39.1538060583951
STAT,1978,17,20-24,1995,213.5271637526013
SIM,1892,22,25-29,1914,98
STAT,1888,10,na,1898,3513.9704574317666
SIM,1887,28,30-34,1915,2
SIM,1976,15,40-44,1991,3
STAT,1891,18,30-34,1909,2.2674087482307503
SIM,1923,82,na,2005,2489
STAT,1845,35,20-24,1880,0.6123340199113114
STAT,1831,40,45-49,1871,1.4716142517330753
STAT,1942,48,20-24,1990,0.013826853796359008
STAT,1846,66,na,1912,1694.379346858447
SIM,1874,26,25-29,1900,100
SIM,1843,33,40-44,1876,11
SIM,1855,55,na,1910,1582
STAT,1913,14,na,1927,4647.283834483895
SIM,1975,36,na,2011,6059
SIM,1889,38,35-39,1927,17
SIM,1888,42,na,1930,2657
STAT,1882,27,20-24,1909,13.223867875377648
STAT,1821,33,40-44,1854,17.52484465707601
STAT,1931,35,50-100,1966,0.6429522331519656
SIM,1818,41,35-39,1859,2
STAT,1871,42,40-44,1913,2.5792734710916716
STAT,1876,21,50-100,1897,0.48795407641958183
STAT,1989,24,30-34,2013,47.63354006949783
SIM,1824,39,45-49,1863,6
STAT,1957,46,30-34,2003,0.14143813586827286
STAT,1841,42,25-29,1883,0.5932734323645181
STAT,1881,44,20-24,1925,0.1743932174138581
SIM,1966,23,30-34,1989,1
STAT,1895,29,25-29,1924,63.09068797972554
STAT,1827,39,20-24,1866,1.0676508808366285
STAT,1867,41,35-39,1908,1.959959298948
STAT,1892,34,25-29,1926,14.688412314794865
SIM,1892,26,45-49,1918,3
STAT,1920,29,30-34,1949,49.2279948318624
STAT,1835,33,40-44,1868,3.411982308279142
STAT,1992,23,20-24,2015,184.7400082368735
STAT,1820,50,40-44,1870,0.01075865670701128
SIM,1917,72,na,1989,3834
SIM,1890,27,20-24,1917,1
STAT,1867,26,40-44,1893,3.238762004938359
STAT,1863,33,45-49,1896,1.7522827233860543
SIM,1853,37,45-49,1890,5
STAT,1824,31,na,1855,1816.5378500504119
STAT,1958,41,30-34,1999,0.20167372862600627
STAT,1981,23,45-49,2004,1.821106491613814
SIM,1981,29,25-29,2010,9
STAT,1973,29,25-29,2002,98.56662580451209
SIM,1894,50,na,1944,3577
STAT,1841,35,na,1876,2290.6714106285845
STAT,1884,26,45-49,1910,1.2703354682550207
SIM,1926,21,na,1947,5246
STAT,1802,54,40-44,1856,0.04025010538355571
STAT,1851,16,35-39,1867,0.5321649938849102
SIM,1853,35,20-24,1888,1
STAT,1968,34,na,2002,5549.681065057319
STAT,1852,48,45-49,1900,0.2197081999364163
SIM,1842,32,40-44,1874,10
SIM,1861,63,na,1924,1341
SIM,1976,32,45-49,2008,1
SIM,1955,22,15-19,1977,14
SIM,1875,41,35-39,1916,5
SIM,1783,84,na,1867,186
SIM,1916,8,na,1924,4870
STAT,1882,45,20-24,1927,0.013661434723539954
SIM,1810,71,na,1881,452
SIM,1883,17,35-39,1900,1
STAT,1823,46,25-29,1869,0.05771424947898427
STAT,1842,40,20-24,1882,0.1297218580722898
STAT,1819,45,20-24,1864,0.023786202199038715
SIM,1821,44,45-49,1865,3
SIM,1772,92,na,1864,17
SIM,1838,35,25-29,1873,5
STAT,1901,49,na,1950,3561.5566314893626
SIM,1934,30,30-34,1964,11
STAT,1985,16,40-44,2001,2.29647898826759
STAT,1888,40,50-100,1928,1.447616853864881
STAT,1856,96,na,1952,7.560116428630262
STAT,1886,38,15-19,1924,0.06801852048717973
SIM,1842,35,45-49,1877,4
SIM,1833,26,35-39,1859,2
STAT,1834,35,45-49,1869,2.310367058903422
SIM,1817,43,40-44,1860,6
STAT,1840,45,15-19,1885,3.319806423113472E-4
STAT,1854,20,50-100,1874,0.3960198515925253
STAT,1876,103,na,1979,3.4321719694533797
STAT,1947,22,15-19,1969,6.942781872585472
STAT,1977,20,30-34,1997,44.99523317827135
SIM,1940,74,na,2014,2718
STAT,1851,34,35-39,1885,8.186735464840691
STAT,1865,46,30-34,1911,0.10107975951174304
STAT,1900,48,15-19,1948,3.56778893145631E-4
SIM,1917,16,45-49,1933,1
SIM,1966,43,40-44,2009,2
STAT,1813,44,45-49,1857,5.182787257529602
STAT,1855,107,na,1962,0.01695470258794273
STAT,1848,47,40-44,1895,0.18105669398015864
SIM,1827,32,45-49,1859,6
STAT,1959,41,35-39,2000,0.3163603414235439
SIM,1873,28,30-34,1901,1
STAT,1917,25,50-100,1942,1.2128450628708434
STAT,1949,20,25-29,1969,124.4710614623151
STAT,1926,30,30-34,1956,22.005757092352606
SIM,1892,55,na,1947,3433
STAT,1958,26,35-39,1984,22.865243238417378
STAT,1850,19,25-29,1869,7.04482831031551
SIM,1900,16,na,1916,3875
STAT,1819,47,45-49,1866,0.45440347278034876
STAT,1909,16,45-49,1925,0.11345701636798243
SIM,1974,0,na,1974,6422
STAT,1833,48,na,1881,1665.8548259624818
STAT,1914,75,na,1989,2789.3881262445348
SIM,1901,77,na,1978,2077
SIM,1833,44,35-39,1877,4
SIM,1816,42,40-44,1858,6
SIM,1831,28,25-29,1859,4
STAT,1979,35,25-29,2014,1.6146376352073541
STAT,1875,35,35-39,1910,8.515243221053824
SIM,1902,39,30-34,1941,3
SIM,1902,22,35-39,1924,13
SIM,1988,18,25-29,2006,95
STAT,1800,106,na,1906,0.006551495275742649
STAT,1861,53,35-39,1914,0.008126976938495
SIM,1898,36,50-100,1934,3
STAT,1802,56,na,1858,1443.9860748539188
SIM,1975,28,na,2003,6081
STAT,1958,43,40-44,2001,0.39337517776603914
STAT,1828,37,15-19,1865,0.057794432473075634
STAT,1865,43,25-29,1908,0.6638197322947987
STAT,1891,36,30-34,1927,7.638260950745367
STAT,1958,44,25-29,2002,0.11211011458062906
SIM,1957,20,25-29,1977,6
SIM,1883,35,35-39,1918,5
STAT,1929,29,na,1958,5405.542610814663
SIM,1898,47,45-49,1945,1
STAT,1963,9,na,1972,5761.487294669444
SIM,1991,18,30-34,2009,27
STAT,1860,111,na,1971,0.0014068872147087476
SIM,1861,29,20-24,1890,1
STAT,1887,88,na,1975,539.9518499670221
STAT,1983,18,30-34,2001,19.89242719821679
SIM,1863,41,45-49,1904,1
STAT,1809,66,na,1875,930.1606782101616
STAT,1871,73,na,1944,1363.6901417324755
SIM,1880,38,15-19,1918,2
STAT,1861,26,45-49,1887,1.0807316336086952
STAT,1853,29,20-24,1882,12.136868131971305
STAT,1865,30,15-19,1895,0.14947477366911804
SIM,1880,23,15-19,1903,3
STAT,1869,36,20-24,1905,0.8656536034707815
SIM,1928,56,na,1984,5357
STAT,1952,20,30-34,1972,39.90716259621121
STAT,1848,43,20-24,1891,0.16752428299811004
STAT,1969,33,45-49,2002,2.3109124954428717
STAT,1980,7,na,1987,6297.189679830874
SIM,1966,44,25-29,2010,1
SIM,1837,50,na,1887,2036
STAT,1987,21,50-100,2008,1.0879880385160414
STAT,1943,46,15-19,1989,4.701172586064437E-4
STAT,1968,32,45-49,2000,2.3120020214924324
STAT,1855,54,20-24,1909,6.106256916864029E-4
SIM,1867,34,40-44,1901,1
STAT,1824,51,50-100,1875,0.02020559047623076
STAT,1872,38,15-19,1910,0.06474927281946409
SIM,1877,36,20-24,1913,2
SIM,1837,19,30-34,1856,4
STAT,1825,44,35-39,1869,2.5789903220204735
STAT,1876,96,na,1972,61.64961458036908
SIM,1977,33,45-49,2010,6
STAT,1860,25,45-49,1885,1.0589191102857942
STAT,1856,22,20-24,1878,70.4671241800251
SIM,1977,13,na,1990,6240
STAT,1936,39,50-100,1975,0.4749454428796319
STAT,1912,40,na,1952,4184.6155352871065
SIM,1991,20,15-19,2011,7
SIM,1810,63,na,1873,919
STAT,1889,83,na,1972,1095.5916479248049
STAT,1858,32,25-29,1890,9.221273264064921
STAT,1883,42,30-34,1925,1.2964833821077537
STAT,1898,34,20-24,1932,4.179812627204477
STAT,1871,28,25-29,1899,48.39641939753955
SIM,1859,40,40-44,1899,4
SIM,1966,38,50-100,2004,3
SIM,1969,36,20-24,2005,1
STAT,1907,20,20-24,1927,117.70982861970775
STAT,1968,30,35-39,1998,13.441896327763077
STAT,1960,36,na,1996,5831.228939136798
STAT,1901,57,na,1958,3323.034641737352
STAT,1859,19,45-49,1878,0.06888823152560837
STAT,1993,7,na,2000,6526.372136576026
STAT,1812,86,na,1898,97.4110439759614
STAT,1820,53,45-49,1873,0.013969843347023659
SIM,1891,42,30-34,1933,1
STAT,1844,54,45-49,1898,0.011804710333530317
STAT,1850,36,40-44,1886,4.625546219418393
STAT,1861,35,na,1896,2281.8082513730856
STAT,1872,40,35-39,1912,2.119548365433468
STAT,1841,27,30-34,1868,27.808191515839624
STAT,1853,107,na,1960,0.013799089494806925
STAT,1979,18,20-24,1997,215.35801826342987
STAT,1855,30,50-100,1885,0.8104814886244748
SIM,1863,27,30-34,1890,34
SIM,1918,17,45-49,1935,1
SIM,1984,26,45-49,2010,7
SIM,1816,45,45-49,1861,1
STAT,1860,22,40-44,1882,1.9979749640575462
SIM,1943,20,25-29,1963,143
SIM,1866,32,25-29,1898,10
SIM,1915,69,na,1984,3329
STAT,1799,79,na,1878,387.8389507389813
SIM,1929,17,20-24,1946,346
SIM,1880,40,35-39,1920,2
STAT,1825,110,na,1935,1.9546173877099557E-4
STAT,1874,19,40-44,1893,0.214931464840286
STAT,1930,48,30-34,1978,0.13512216057304863
STAT,1835,36,45-49,1871,1.554594290696589
SIM,1915,20,20-24,1935,242
STAT,1963,26,15-19,1989,1.0399825111962466
SIM,1841,35,30-34,1876,4
SIM,1879,49,30-34,1928,1
STAT,1957,49,35-39,2006,0.20285594819442826
STAT,1848,46,25-29,1894,0.061375358076009516
SIM,1829,63,na,1892,1103
STAT,1833,35,30-34,1868,4.8272303427203465
STAT,1823,49,30-34,1872,0.0930012602069191
STAT,1832,86,na,1918,151.1620999383897
SIM,1965,49,35-39,2014,1
STAT,1782,90,na,1872,39.92122319500663
STAT,1855,27,30-34,1882,22.33424729246875
STAT,1901,49,15-19,1950,3.5711671968151457E-4
STAT,1867,29,45-49,1896,1.1877883088525885
SIM,1820,43,45-49,1863,3
SIM,1996,6,na,2002,6947
STAT,1853,48,na,1901,2211.838720494898
STAT,1976,26,45-49,2002,2.6763510241074187
SIM,1863,28,50-100,1891,1
STAT,1935,20,25-29,1955,145.33954191490747
SIM,1988,19,40-44,2007,4
SIM,1934,74,na,2008,3507
STAT,1857,52,30-34,1909,0.005321733101804619
STAT,1845,22,45-49,1867,0.5833425381330447
SIM,1872,41,50-100,1913,4
SIM,1883,32,30-34,1915,44
STAT,1842,22,20-24,1864,66.88633121639486
SIM,1843,36,45-49,1879,4
STAT,1948,22,30-34,1970,38.083178939768494
STAT,1969,7,na,1976,5666.49740724684
SIM,1958,34,35-39,1992,3
STAT,1895,26,20-24,1921,17.68336910880418
STAT,1965,21,20-24,1986,160.7872886270205
STAT,1838,24,20-24,1862,76.35145168272427
STAT,1861,50,30-34,1911,0.005792987288731771
SIM,1874,50,na,1924,2456
SIM,1834,21,25-29,1855,2
SIM,1966,26,35-39,1992,52
STAT,1868,53,na,1921,2349.030960883381
SIM,1853,22,45-49,1875,3
SIM,1974,25,na,1999,6367
SIM,1973,21,20-24,1994,151
STAT,1812,43,45-49,1855,4.039639633462378
SIM,1856,29,40-44,1885,7
STAT,1872,23,15-19,1895,3.8111035122340713
STAT,1897,39,30-34,1936,1.757266562485397
STAT,1962,44,45-49,2006,0.2549006893941433
STAT,1925,17,40-44,1942,1.9492990162766217
STAT,1868,42,35-39,1910,2.005299799074273
STAT,1881,47,25-29,1928,0.06381732252624478
STAT,1821,51,40-44,1872,0.018726039769374814
STAT,1866,66,na,1932,1753.186655058003
STAT,1864,32,20-24,1896,2.7853441151174465
STAT,1848,29,40-44,1877,3.7453763867803733
SIM,1864,22,20-24,1886,127
STAT,1889,47,30-34,1936,0.0773147879848625
STAT,1894,30,na,1924,3568.642514819768
SIM,1832,46,40-44,1878,1
SIM,1890,0,na,1890,3972
STAT,1873,37,25-29,1910,3.3931046562400686
STAT,1861,43,na,1904,2201.4019738316197
SIM,1930,5,na,1935,6439
SIM,1824,36,40-44,1860,8
SIM,1881,37,25-29,1918,1
STAT,1889,15,na,1904,3609.5425707930744
STAT,1891,33,25-29,1924,14.547561879570432
SIM,1878,19,20-24,1897,19
STAT,1931,45,40-44,1976,0.24448451315515954
SIM,1833,68,na,1901,946
STAT,1856,37,20-24,1893,0.6786933468411316
SIM,1876,42,35-39,1918,2
STAT,1834,32,40-44,1866,5.069432883078022
STAT,1824,46,40-44,1870,0.23565420356741237
STAT,1874,53,na,1927,2503.0097157231853
STAT,1977,33,50-100,2010,1.3133133123564862
STAT,1885,45,na,1930,2615.6318705027807
STAT,1908,93,na,2001,341.4635050554501
STAT,1958,23,30-34,1981,43.69368705908868
STAT,1910,19,20-24,1929,30.867781338341768
STAT,1859,84,na,1943,305.81884018706813
SIM,1869,44,45-49,1913,2
STAT,1890,91,na,1981,371.36068012746205
SIM,1919,28,15-19,1947,1
SIM,1831,41,50-100,1872,4
SIM,1859,43,50-100,1902,1
SIM,1838,32,20-24,1870,4
SIM,1857,50,na,1907,2304
SIM,1968,36,50-100,2004,2
STAT,1853,32,45-49,1885,1.787908375045147
STAT,1845,37,45-49,1882,1.4114148684847334
STAT,1959,28,na,1987,5676.8163951760625
STAT,1863,48,20-24,1911,0.011957168341676781
STAT,1881,17,30-34,1898,1.7741824633313745
STAT,1841,43,na,1884,2108.116450397586
SIM,1897,29,30-34,1926,50
STAT,1883,25,50-100,1908,0.7271718699124494
SIM,1850,71,na,1921,676
STAT,1809,46,45-49,1855,0.6072862740896363
STAT,1992,18,50-100,2010,0.6204131416978488
SIM,1813,68,na,1881,970
STAT,1869,39,25-29,1908,3.185428819722024
SIM,1859,5,na,1864,2734
STAT,1889,29,30-34,1918,35.56696305158557
STAT,1941,57,na,1998,4343.9786326337
STAT,1966,37,40-44,2003,2.2230623817410673
SIM,1824,32,20-24,1856,1
STAT,1880,50,35-39,1930,0.010682290482128985
STAT,1821,110,na,1931,1.6900607647341996E-4
STAT,1890,108,na,1998,0.22746653549832002
STAT,1900,32,35-39,1932,16.217034507558225
SIM,1891,25,50-100,1916,1
STAT,1974,34,na,2008,5801.920355329465
STAT,1838,42,20-24,1880,0.1609098016080341
STAT,1948,36,na,1984,5123.5789255536965
STAT,1892,16,25-29,1908,8.216681479961144
STAT,1960,16,50-100,1976,0.5632945347424703
STAT,1916,15,50-100,1931,0.09216929516224392
SIM,1846,24,20-24,1870,62
STAT,1840,33,50-100,1873,0.8859935896119616
STAT,1884,43,30-34,1927,1.3014063719017142
STAT,1875,32,30-34,1907,20.8223789638911
SIM,1877,39,25-29,1916,6
STAT,1846,15,15-19,1861,7.798434694686771
SIM,1895,34,45-49,1929,3
SIM,1848,36,25-29,1884,1
SIM,1960,33,na,1993,6118
STAT,1839,53,25-29,1892,0.002763891158976708
STAT,1846,48,15-19,1894,4.083166925030062E-4
STAT,1873,104,na,1977,1.5924782010328336
SIM,1949,18,na,1967,5508
SIM,1988,15,20-24,2003,391
STAT,1912,16,50-100,1928,0.08772885945077126
STAT,1807,48,35-39,1855,0.5708707247388212
STAT,1887,114,na,2001,6.526353536409394E-4
SIM,1809,86,na,1895,162
STAT,1894,32,35-39,1926,15.023899443253738
SIM,1815,94,na,1909,25
SIM,1885,45,40-44,1930,1
STAT,1884,91,na,1975,271.01379722453817
SIM,1984,22,25-29,2006,169
SIM,1892,47,na,1939,3490
SIM,1968,21,40-44,1989,4
SIM,1928,16,20-24,1944,215
SIM,1854,15,15-19,1869,10
STAT,1937,36,15-19,1973,0.02219273919059719
STAT,1979,32,20-24,2011,3.950679670062678
STAT,1854,43,15-19,1897,0.0111695530568411
STAT,1983,20,15-19,2003,8.725084942501779
STAT,1871,27,45-49,1898,1.2747682874087178
SIM,1891,62,na,1953,2533
SIM,1945,18,15-19,1963,49
SIM,1899,27,40-44,1926,12
STAT,1923,21,15-19,1944,7.166815645499077
SIM,1802,76,na,1878,342
STAT,1837,61,na,1898,1353.1315668143825
STAT,1988,25,20-24,2013,30.285437912378843
STAT,1861,23,40-44,1884,2.039130964623365
STAT,1899,37,40-44,1936,1.4938673228415635
SIM,1874,28,50-100,1902,7
SIM,1891,93,na,1984,225
SIM,1922,47,35-39,1969,1
SIM,1885,30,40-44,1915,10
STAT,1877,30,40-44,1907,5.247835788365703
SIM,1931,21,15-19,1952,10
STAT,1887,34,45-49,1921,2.2360161771862814
SIM,1974,33,20-24,2007,1
STAT,1908,67,na,1975,3225.833366908836
SIM,1809,55,na,1864,1455
STAT,1830,51,na,1881,1429.7953898123524
STAT,1846,33,15-19,1879,0.1721783899468465
SIM,1804,63,na,1867,849
SIM,1878,12,na,1890,3089
STAT,1937,18,15-19,1955,50.84574397729444
SIM,1815,48,35-39,1863,1
STAT,1958,46,45-49,2004,0.3435071676074347
STAT,1878,111,na,1989,0.010477507779518317
STAT,1914,47,35-39,1961,0.147635353707162
STAT,1913,82,na,1995,1816.8861305283906
SIM,1975,32,30-34,2007,45
SIM,1929,49,na,1978,5098
STAT,1858,53,30-34,1911,0.005272952519748134
SIM,1920,21,40-44,1941,12
STAT,1869,18,20-24,1887,19.96960474807967
STAT,1974,15,35-39,1989,6.32663964339755
STAT,1785,99,na,1884,0.24456148931886174
STAT,1832,24,25-29,1856,59.421179859072964
SIM,1861,43,35-39,1904,2
STAT,1876,30,25-29,1906,12.31743012045853
STAT,1818,51,35-39,1869,0.01043147138391942
STAT,1973,31,45-49,2004,2.3954049845243754
STAT,1820,37,45-49,1857,4.374500422610467
STAT,1869,53,40-44,1922,0.011576876214389555
SIM,1860,70,na,1930,1535
SIM,1921,46,na,1967,5151
STAT,1843,24,35-39,1867,7.244326666557717
SIM,1809,63,na,1872,1131
STAT,1841,66,na,1907,1457.2277804628436
SIM,1837,33,45-49,1870,7
SIM,1884,30,25-29,1914,23
STAT,1912,21,40-44,1933,3.7335342159668667
SIM,1951,8,na,1959,6326
SIM,1995,3,na,1998,6767
STAT,1981,24,25-29,2005,149.44879292969094
SIM,1973,37,25-29,2010,3
STAT,1988,24,15-19,2012,8.809180059121537
SIM,1868,73,na,1941,1590
SIM,1982,15,35-39,1997,17
STAT,1869,83,na,1952,443.67596488775416
SIM,1896,36,25-29,1932,2
STAT,1891,30,20-24,1921,3.8864122550208107
SIM,1959,33,35-39,1992,35
STAT,1936,20,50-100,1956,0.7269161547154546
STAT,1871,24,40-44,1895,2.377498551327035
STAT,1864,17,25-29,1881,6.040556625889885
SIM,1876,17,na,1893,2875
STAT,1872,58,na,1930,2291.6443249564823
SIM,1872,17,25-29,1889,11
STAT,1833,51,30-34,1884,0.004433499135805415
STAT,1883,10,na,1893,2924.7171086716785
STAT,1908,48,20-24,1956,0.011516485306817557
SIM,1892,43,30-34,1935,1
STAT,1962,41,40-44,2003,0.3849191981218298
STAT,1821,34,20-24,1855,7.6317549177174495
STAT,1844,51,40-44,1895,0.008847695465821854
SIM,1858,43,na,1901,2515
SIM,1952,38,na,1990,4701
STAT,1838,27,50-100,1865,0.7049845114790763
STAT,1875,17,35-39,1892,0.6543880097826907
SIM,1884,49,45-49,1933,4
STAT,1970,22,40-44,1992,4.873416714176137
SIM,1889,35,na,1924,3784
STAT,1855,7,na,1862,2504.9654330367093
STAT,1893,19,45-49,1912,0.09477614352028982
SIM,1837,81,na,1918,670
STAT,1838,91,na,1929,50.194980282350684
SIM,1857,42,30-34,1899,4
STAT,1876,49,45-49,1925,0.2756646062576702
SIM,1820,40,40-44,1860,4
STAT,1903,83,na,1986,1441.312709434273
SIM,1905,31,50-100,1936,2
STAT,1965,37,25-29,2002,1.461490836522756
SIM,1925,25,50-100,1950,4
STAT,1813,41,40-44,1854,8.789550863403337
STAT,1821,54,45-49,1875,0.024319898640867924
STAT,1849,42,30-34,1891,0.8899742560054131
STAT,1899,36,35-39,1935,11.23661038038069
STAT,1841,48,35-39,1889,0.12344518542148122
SIM,1926,87,na,2013,2023
STAT,1994,11,na,2005,6542.698997466814
SIM,1851,24,35-39,1875,20
STAT,1831,101,na,1932,0.4476924836531321
STAT,1923,38,45-49,1961,0.9103230091407626
STAT,1944,32,40-44,1976,4.954218950252382
SIM,1894,5,na,1899,4199
SIM,1770,89,na,1859,37
SIM,1834,25,45-49,1859,1
SIM,1874,27,40-44,1901,10
STAT,1866,28,50-100,1894,0.6818459799847949
STAT,1972,18,na,1990,5436.974104271764
STAT,1872,5,na,1877,3212.5835767224667
SIM,1877,47,na,1924,3008
STAT,1799,70,na,1869,910.177873342082
SIM,1958,31,30-34,1989,48
STAT,1838,27,25-29,1865,46.61904230162971
STAT,1890,18,15-19,1908,8.346504640844223
STAT,1845,34,40-44,1879,3.4032330292124158
STAT,1894,61,na,1955,2772.1941281078202
STAT,1997,15,25-29,2012,73.06640650585634
SIM,1847,29,na,1876,2792
STAT,1837,25,20-24,1862,11.061695401815777
STAT,1880,30,45-49,1910,2.1502614993551386
STAT,1948,4,na,1952,5241.53462301568
STAT,1934,38,20-24,1972,0.41959499078681495
STAT,1855,41,45-49,1896,1.2792466718258626
STAT,1892,36,45-49,1928,2.897325814359332
STAT,1912,48,40-44,1960,0.17454318280950418
STAT,1982,22,20-24,2004,181.16830753956205
SIM,1821,41,40-44,1862,4
STAT,1847,47,25-29,1894,0.04411394550630707
SIM,1881,32,na,1913,1923
STAT,1821,66,na,1887,1003.7662670083638
STAT,1897,41,15-19,1938,0.001486534864588483
STAT,1775,111,na,1886,0.001688888003267071
SIM,1999,3,na,2002,6976
SIM,1845,25,20-24,1870,1
SIM,1885,42,na,1927,3137
SIM,1990,22,20-24,2012,173
STAT,1830,82,na,1912,292.69503135259765
STAT,1836,47,15-19,1883,3.8109985144699085E-4
STAT,1855,23,45-49,1878,0.688200469316355
STAT,1887,49,20-24,1936,0.008571715627350396
STAT,1939,31,20-24,1970,2.874952882182802
STAT,1932,15,30-34,1947,18.717186757568456
SIM,1862,17,na,1879,3071
SIM,1862,40,45-49,1902,7
SIM,1896,18,25-29,1914,1
STAT,1898,38,40-44,1936,1.4663476370658133
SIM,1846,27,25-29,1873,44
SIM,1857,24,30-34,1881,30
STAT,1893,34,40-44,1927,6.271887651690249
STAT,1987,26,20-24,2013,30.216893205692337
SIM,1895,38,30-34,1933,18
SIM,1925,39,na,1964,5310
SIM,1861,32,na,1893,1918
STAT,1888,18,25-29,1906,7.667199034892388
SIM,1904,20,45-49,1924,2
SIM,1928,82,na,2010,2809
SIM,1864,80,na,1944,662
SIM,1878,16,15-19,1894,7
SIM,1893,32,50-100,1925,5
SIM,1884,80,na,1964,752
STAT,1982,25,25-29,2007,107.44246224157925
SIM,1979,17,na,1996,5679
STAT,1904,14,na,1918,4265.9284039080885
STAT,1979,31,40-44,2010,6.342045152171055
STAT,1897,105,na,2002,2.226312166612588
SIM,1956,22,30-34,1978,4
STAT,1895,105,na,2000,2.129154910411745
SIM,1948,23,50-100,1971,4
SIM,1886,29,20-24,1915,30
SIM,1849,39,45-49,1888,3
SIM,1874,73,na,1947,1111
STAT,1821,36,45-49,1857,4.657494052529032
SIM,1829,39,25-29,1868,5
SIM,1892,24,na,1916,3699
STAT,1825,73,na,1898,840.1310236832875
STAT,1878,29,20-24,1907,14.034845693806748
SIM,1939,48,na,1987,4828
SIM,1872,24,na,1896,3159
STAT,1969,29,15-19,1998,1.0211087716825369
STAT,1890,36,15-19,1926,0.07956580208740506
STAT,1887,38,30-34,1925,6.858676985658624
STAT,1849,24,30-34,1873,16.452717669869255
STAT,1945,7,na,1952,4982.132810819786
STAT,1836,96,na,1932,7.814440473929953
SIM,1859,43,45-49,1902,2
STAT,1928,9,na,1937,5788.602739878162
SIM,1889,27,na,1916,3767
STAT,1888,36,25-29,1924,3.9246448021241007
STAT,1826,47,50-100,1873,0.17671950170081763
SIM,1958,35,40-44,1993,1
STAT,1870,31,35-39,1901,11.568893344185348
STAT,1832,39,25-29,1871,2.475110807933197
STAT,1831,37,20-24,1868,0.7622703974171813
STAT,1873,4,na,1877,3451.825906921304
STAT,1892,17,40-44,1909,0.2645572640675607
STAT,1886,115,na,2001,2.0949826809675177E-4
STAT,1842,26,40-44,1868,2.8712934103336245
SIM,1871,18,25-29,1889,17
SIM,1905,39,na,1944,4120
SIM,1899,34,na,1933,4113
STAT,1829,66,na,1895,1200.7049391607238
STAT,1863,18,25-29,1881,5.90293849417668
STAT,1836,29,15-19,1865,0.5268239063957272
SIM,1840,39,25-29,1879,7
SIM,1909,20,25-29,1929,122
SIM,1837,37,30-34,1874,17
STAT,1884,35,50-100,1919,1.413193066243646
STAT,1864,46,15-19,1910,4.1334652896178283E-4
STAT,1896,96,na,1992,126.26858471679807
STAT,1914,44,30-34,1958,0.14577834119991592
STAT,1975,26,50-100,2001,1.5226243490027693
STAT,1813,48,na,1861,1392.1919772488225
SIM,1850,26,40-44,1876,7
SIM,1875,44,40-44,1919,1
SIM,1908,87,na,1995,405
STAT,1960,28,20-24,1988,27.54243381968059
STAT,1839,50,20-24,1889,5.997682556472294E-4
STAT,1909,20,na,1929,4122.178750546449
SIM,1840,24,25-29,1864,71
STAT,1919,47,50-100,1966,0.2830472828175729
STAT,1939,26,50-100,1965,1.155766630198005
STAT,1876,65,na,1941,2016.0895438611446
SIM,1968,24,45-49,1992,3
STAT,1878,47,20-24,1925,0.014392056483570661
SIM,1914,25,30-34,1939,6
SIM,1874,43,40-44,1917,1
SIM,1858,40,25-29,1898,1
STAT,1852,15,45-49,1867,0.07537233516662722
SIM,1817,81,na,1898,94
SIM,1912,72,na,1984,2152
SIM,1970,31,35-39,2001,11
STAT,1877,48,45-49,1925,0.2797452647856052
STAT,1880,33,15-19,1913,0.17346381965540286
SIM,1825,34,35-39,1859,25
SIM,1845,25,na,1870,2373
SIM,1974,9,na,1983,6402
SIM,1979,25,25-29,2004,5
STAT,1906,25,30-34,1931,42.665394269883805
STAT,1867,44,40-44,1911,2.3908550624647393
SIM,1872,28,15-19,1900,1
SIM,1955,59,na,2014,5917
STAT,1949,29,na,1978,5044.7062940449605
SIM,1859,22,40-44,1881,5
STAT,1866,43,40-44,1909,2.3885844478717235
STAT,1877,46,20-24,1923,0.014446239064288503
SIM,1839,32,50-100,1871,1
SIM,1879,37,50-100,1916,3
STAT,1944,34,50-100,1978,1.0453593854967274
SIM,1959,30,30-34,1989,26
SIM,1861,55,na,1916,1521
STAT,1843,21,30-34,1864,22.59589112205286
SIM,1946,18,30-34,1964,17
STAT,1874,61,na,1935,2207.6943335060146
SIM,1830,35,20-24,1865,1
SIM,1885,33,45-49,1918,5
STAT,1830,74,na,1904,696.1890980933703
STAT,1902,49,30-34,1951,0.08717857045886401
STAT,1949,3,na,1952,5339.4920123418715
SIM,1895,35,na,1930,3622
STAT,1837,28,25-29,1865,39.03340705871897
STAT,1913,17,15-19,1930,10.714044368060474
SIM,1878,34,15-19,1912,3
SIM,1902,11,na,1913,4324
SIM,1854,81,na,1935,632
STAT,1833,54,35-39,1887,0.006042202833484432
STAT,1829,37,30-34,1866,6.116272873622251
STAT,1854,28,20-24,1882,9.947517847589571
STAT,1870,41,40-44,1911,2.570634647687961
STAT,1873,19,25-29,1892,6.6423682497365215
STAT,1959,44,40-44,2003,0.39109090772042693
STAT,1843,40,35-39,1883,1.9192953343075922
SIM,1972,26,30-34,1998,5
SIM,1871,62,na,1933,1570
STAT,1964,26,30-34,1990,57.22453749730961
SIM,1908,43,35-39,1951,1
STAT,1877,33,45-49,1910,2.084528508566774
SIM,1875,47,45-49,1922,1
SIM,1862,28,20-24,1890,21
STAT,1840,81,na,1921,433.80211014421087
STAT,1875,104,na,1979,1.843258126306686
STAT,1865,28,30-34,1893,26.128508754703272
STAT,1854,40,45-49,1894,1.2316114984026183
STAT,1910,44,50-100,1954,0.12668877477851292
STAT,1938,37,na,1975,4414.597150235066
SIM,1879,9,na,1888,3110
STAT,1815,74,na,1889,628.0215962434368
SIM,1985,21,35-39,2006,15
STAT,1822,35,20-24,1857,2.0347686167358643
STAT,1911,87,na,1998,1036.668860203709
STAT,1938,18,30-34,1956,13.878097901770053
STAT,1969,29,na,1998,5418.529524370988
STAT,1832,36,20-24,1868,0.684711753599266
STAT,1916,79,na,1995,2358.1875872866053
SIM,1845,28,25-29,1873,89
SIM,1891,8,na,1899,3656
STAT,1776,110,na,1886,0.0029126509573551146
SIM,1967,7,na,1974,5781
STAT,1846,52,50-100,1898,0.015529836312957197
SIM,1928,64,na,1992,4952
STAT,1839,40,15-19,1879,0.013013616298343546
SIM,1851,21,30-34,1872,41
SIM,1975,35,35-39,2010,7
STAT,1867,47,45-49,1914,0.2531017687572386
SIM,1992,20,30-34,2012,134
SIM,1840,21,20-24,1861,136
STAT,1949,18,40-44,1967,1.8767136292071456
STAT,1966,36,25-29,2002,1.4634975903910812
STAT,1887,71,na,1958,1832.9582458910975
SIM,1921,17,15-19,1938,105
STAT,1932,49,na,1981,5718.9556870456345
STAT,1938,36,30-34,1974,2.140568436697035
SIM,1846,45,25-29,1891,1
STAT,1896,39,15-19,1935,0.08473413617585292
SIM,1918,57,na,1975,3596
SIM,1928,19,25-29,1947,86
SIM,1973,34,20-24,2007,9
STAT,1911,35,15-19,1946,0.021626889888429375
SIM,1812,75,na,1887,265
STAT,1889,20,50-100,1909,0.5835713713285978
SIM,1935,38,na,1973,6234
STAT,1827,53,35-39,1880,0.010316484992190162
STAT,1967,35,35-39,2002,3.598475327602512
STAT,1879,110,na,1989,0.02778123829229363
SIM,1909,98,na,2007,69
SIM,1915,46,na,1961,4518
STAT,1899,33,30-34,1932,27.4885496830234
STAT,1828,38,20-24,1866,0.7769521295943461
STAT,1892,33,40-44,1925,6.246304545660681
STAT,1847,29,25-29,1876,38.56247285010362
STAT,1878,103,na,1981,3.8379367175069006
STAT,1845,42,50-100,1887,0.724936164754094
STAT,1929,78,na,2007,3157.880812078642
STAT,1963,46,50-100,2009,0.3457882627899841
SIM,1862,48,50-100,1910,1
STAT,1995,20,40-44,2015,5.639389434094334
STAT,1871,45,45-49,1916,0.27365915530394
STAT,1838,45,25-29,1883,0.052672619323014536
STAT,1877,15,45-49,1892,0.0787804019428493
STAT,1817,50,35-39,1867,0.02461159927671689
STAT,1845,52,40-44,1897,0.007056342698457162
SIM,1850,43,25-29,1893,1
STAT,1862,37,15-19,1899,0.054690747734412924
STAT,1865,3,na,1868,3331.38654490827
STAT,1830,26,15-19,1856,0.5995606786734566
SIM,1906,43,35-39,1949,1
STAT,1957,41,50-100,1998,0.1860346687745889
SIM,1878,43,na,1921,2764
STAT,1857,58,na,1915,1777.4857318868355
STAT,1948,21,15-19,1969,7.055737632604629
STAT,1816,53,25-29,1869,0.006797970009388947
SIM,1841,63,na,1904,1366
SIM,1853,42,50-100,1895,2
STAT,1882,47,40-44,1929,0.1920795289366544
SIM,1841,55,na,1896,1700
SIM,1956,21,15-19,1977,8
STAT,1856,106,na,1962,0.0421277284182147
SIM,1855,29,25-29,1884,9
SIM,1882,17,na,1899,3459
STAT,1919,32,50-100,1951,1.02918342253029
STAT,1892,31,20-24,1923,3.925774888667527
STAT,1981,21,20-24,2002,180.08887713350776
STAT,1893,16,40-44,1909,0.26745935741146426
SIM,1908,25,35-39,1933,20
STAT,1879,15,45-49,1894,0.07908057242995106
STAT,1905,8,na,1913,4342.0801079000385
SIM,1824,35,25-29,1859,6
STAT,1881,31,45-49,1912,1.949031790111364
STAT,2010,5,na,2015,7168.913593413782
STAT,1893,37,45-49,1930,2.9079360149462796
STAT,1913,49,40-44,1962,0.17664374330450824
STAT,1840,27,15-19,1867,0.45380607133459594
SIM,1921,49,40-44,1970,1
STAT,1977,20,50-100,1997,1.0301107614040583
STAT,1853,45,20-24,1898,0.012066539068199036
STAT,1954,21,45-49,1975,1.6110818823952224
SIM,1927,32,50-100,1959,1
STAT,1862,19,15-19,1881,5.953144956689174
STAT,1831,53,20-24,1884,5.89721554544828E-4
STAT,1971,35,20-24,2006,0.39765082451860745
STAT,1806,49,25-29,1855,0.20535830980146805
STAT,1892,35,na,1927,3440.1302460012976
SIM,1835,20,35-39,1855,16
STAT,1882,28,na,1910,2680.6555555355117
STAT,1926,33,35-39,1959,12.741557191763883
SIM,1962,21,45-49,1983,1
SIM,1896,15,20-24,1911,27
STAT,1938,16,50-100,1954,0.4277653660959535
STAT,1832,54,20-24,1886,5.121771549515405E-4
STAT,1883,48,40-44,1931,0.19087177042248807
SIM,1981,18,na,1999,5711
STAT,1862,73,na,1935,1156.7908101103023
SIM,1827,37,na,1864,1595
STAT,1980,27,15-19,2007,1.1358844277319693
STAT,1991,24,20-24,2015,184.3851993431477
STAT,1849,27,35-39,1876,8.86515231554542
SIM,1846,55,na,1901,1372
SIM,1857,27,35-39,1884,3
STAT,1898,100,na,1998,31.00935904135011
SIM,1906,21,na,1927,3399
STAT,1956,5,na,1961,6004.15801430182
SIM,1850,25,25-29,1875,48
STAT,1864,35,25-29,1899,2.9950209618573815
STAT,1888,15,20-24,1903,24.161815521948657
SIM,1952,32,40-44,1984,10
SIM,1825,31,30-34,1856,26
STAT,1928,67,na,1995,4545.328010083406
STAT,1822,103,na,1925,0.11791577170127171
STAT,1842,43,25-29,1885,0.5047497224500476
STAT,1823,110,na,1933,1.564868973091568E-4
STAT,1928,31,45-49,1959,2.2719607386405407
SIM,1903,21,35-39,1924,1
SIM,1934,33,35-39,1967,15
STAT,1853,25,35-39,1878,11.290430959639687
SIM,1911,76,na,1987,3152
STAT,1839,38,30-34,1877,4.998688887262251
SIM,1926,79,na,2005,3608
SIM,1861,25,35-39,1886,13
SIM,1970,26,na,1996,5585
SIM,1956,25,35-39,1981,3
STAT,1891,39,35-39,1930,9.986702860203765
SIM,1830,71,na,1901,924
STAT,1897,27,na,1924,3682.724722844171
SIM,1847,38,30-34,1885,10
STAT,1979,15,15-19,1994,72.15149565834496
SIM,1809,49,20-24,1858,1
STAT,1823,78,na,1901,442.4592070014894
STAT,1849,45,35-39,1894,0.10959134459189296
SIM,1835,35,35-39,1870,9
STAT,1844,41,35-39,1885,1.57121035691211
STAT,1888,4,na,1892,3568.7241687378587
STAT,1842,25,25-29,1867,40.83978281559595
STAT,1918,24,40-44,1942,4.157939438103457
SIM,1934,15,35-39,1949,6
STAT,1854,84,na,1938,271.0196991566803
STAT,1952,23,35-39,1975,13.060650109390288
STAT,1829,33,45-49,1862,2.180802580803308
SIM,1896,33,20-24,1929,6
SIM,1873,49,35-39,1922,1
SIM,1855,0,na,1855,3456
STAT,1888,33,20-24,1921,3.6514265074046586
SIM,1833,37,na,1870,1714
SIM,1977,30,40-44,2007,15
STAT,1874,32,15-19,1906,0.1682471528267666
STAT,1946,41,50-100,1987,0.15649770755111084
STAT,1948,25,35-39,1973,19.931015476105703
STAT,1819,44,40-44,1863,4.4514241731960835
SIM,1859,25,45-49,1884,1
STAT,1880,18,20-24,1898,21.629452662030396
STAT,1902,30,50-100,1932,1.5060650974988465
SIM,1960,23,35-39,1983,32
STAT,1891,20,15-19,1911,4.733533388108974
SIM,1934,64,na,1998,5096
SIM,1936,31,45-49,1967,1
SIM,1947,19,30-34,1966,31
SIM,1964,26,na,1990,5653
STAT,1853,43,35-39,1896,1.7898569800548976
SIM,1824,63,na,1887,919
STAT,1896,24,15-19,1920,4.997176208933523
STAT,1984,20,30-34,2004,47.2970193444367
STAT,1828,92,na,1920,27.642691681000734
STAT,1865,49,35-39,1914,0.14273216164433955
SIM,1851,40,35-39,1891,3
STAT,1866,46,45-49,1912,0.25315692572093595
STAT,1827,35,35-39,1862,10.89060185642369
STAT,1863,15,20-24,1878,20.65684069475199
STAT,1993,22,30-34,2015,47.87940724472004
SIM,1850,29,45-49,1879,2
STAT,1834,52,30-34,1886,0.005569944539248628
STAT,1866,41,20-24,1907,0.17064489425343066
STAT,1888,48,20-24,1936,0.009067272568988528
STAT,1959,21,25-29,1980,139.94565978081727
SIM,1926,24,40-44,1950,7
SIM,1958,23,45-49,1981,2
STAT,1939,19,30-34,1958,14.07654102747315
SIM,1849,36,40-44,1885,10
SIM,1900,84,na,1984,1018
STAT,1826,66,na,1892,902.4480867353726
STAT,1979,34,45-49,2013,2.5454121504972185
STAT,1905,10,na,1915,4326.679346359124
STAT,1829,51,45-49,1880,0.014583408532528708
STAT,1810,82,na,1892,265.66611088336396
STAT,1842,29,45-49,1871,1.0414827924630825
SIM,1958,38,45-49,1996,3
SIM,1967,21,25-29,1988,135
SIM,1969,18,na,1987,5435
STAT,1976,29,15-19,2005,1.0920617317332535
SIM,1827,44,40-44,1871,6
STAT,1926,15,35-39,1941,5.963560263724995
STAT,1931,64,na,1995,5021.453049462649
SIM,1962,3,na,1965,5594
SIM,1984,29,15-19,2013,2
STAT,1921,57,na,1978,4567.971383162838
STAT,1916,39,15-19,1955,0.022468565367062095
STAT,1918,42,40-44,1960,0.3068382558518391
STAT,1865,40,20-24,1905,0.16703362650452852
STAT,1828,50,45-49,1878,0.013429702248163153
STAT,1917,75,na,1992,2936.416758841578
STAT,1799,62,na,1861,1226.5157731498814
SIM,1926,42,40-44,1968,1
STAT,1786,75,na,1861,678.9406147768436
STAT,1904,38,40-44,1942,1.5580496907276906
STAT,1842,29,50-100,1871,0.600042098330653
STAT,1875,46,na,1921,2690.767758844039
STAT,1900,72,na,1972,2531.504348760516
STAT,1973,33,30-34,2006,23.954805481764307
SIM,1806,75,na,1881,608
STAT,1837,92,na,1929,30.159511806552054
STAT,1896,46,25-29,1942,0.04966649254211635
STAT,1953,40,35-39,1993,0.2929594546681303
STAT,1858,16,25-29,1874,5.994744779868092
STAT,1844,45,50-100,1889,0.20866494097437496
SIM,1983,23,25-29,2006,163
STAT,1936,41,45-49,1977,0.19058966638173525
STAT,1957,15,30-34,1972,18.55591271819967
SIM,1894,35,45-49,1929,1
STAT,1914,41,25-29,1955,0.08181538161826288
STAT,1835,52,45-49,1887,0.009229515961863652
SIM,1920,28,20-24,1948,4
STAT,1921,37,30-34,1958,2.347673592937799
SIM,1889,19,30-34,1908,6
STAT,1935,2,na,1937,6455.849160786347
SIM,1971,43,na,2014,5701
STAT,1964,42,20-24,2006,0.02667682619090997
SIM,1846,27,50-100,1873,3
STAT,1811,48,20-24,1859,0.03678093265749776
STAT,1846,52,20-24,1898,7.587868205777225E-4
SIM,1965,15,30-34,1980,41
STAT,1905,41,15-19,1946,0.0016090583560176598
STAT,1991,23,na,2014,6057.603103687865
SIM,1981,33,30-34,2014,2
STAT,1941,23,25-29,1964,110.15235583260653
STAT,1886,35,45-49,1921,2.4497401934194833
SIM,1946,52,na,1998,4422
STAT,1894,39,na,1933,3460.0070155669437
STAT,1889,41,20-24,1930,0.22694478465735268
STAT,1873,40,15-19,1913,0.016438962091536637
STAT,1831,29,35-39,1860,9.914723699572756
SIM,1872,35,25-29,1907,6
STAT,1858,54,na,1912,1885.1601688897172
STAT,1879,18,50-100,1897,0.058881464128016654
SIM,1844,29,na,1873,2643
SIM,1906,40,30-34,1946,1
STAT,1951,29,50-100,1980,1.3723998300938682
STAT,1880,36,20-24,1916,0.9474725401715113
STAT,1805,81,na,1886,262.6104585217914
STAT,1912,28,20-24,1940,20.706298194129904
STAT,1850,53,25-29,1903,0.0035877657041466634
STAT,1901,46,45-49,1947,0.21580305890066737
STAT,1971,38,25-29,2009,1.4811994112195632
SIM,1865,33,25-29,1898,2
STAT,1920,31,40-44,1951,4.964838698634585
STAT,1956,41,30-34,1997,0.20318237827364413
SIM,1916,14,na,1930,4809
STAT,1827,50,30-34,1877,0.007570600445850395
SIM,1964,32,30-34,1996,54
STAT,1877,9,na,1886,3173.405966280489
SIM,1829,32,na,1861,1826
STAT,1807,62,na,1869,1273.3437659956483
STAT,1940,22,50-100,1962,0.7738014448344359
STAT,1843,51,25-29,1894,0.003570992795070005
SIM,1905,19,25-29,1924,28
STAT,1980,21,40-44,2001,5.4063646294562995
STAT,1857,33,25-29,1890,9.167312130585607
SIM,1880,20,45-49,1900,3
STAT,1895,40,35-39,1935,2.747637627052453
SIM,1866,16,25-29,1882,4
SIM,1939,25,30-34,1964,64
STAT,1903,1,na,1904,4474.142074177837
SIM,1823,67,na,1890,1223
STAT,1960,3,na,1963,5912.702842488282
STAT,1891,107,na,1998,0.49704983844202905
SIM,1912,38,40-44,1950,7
STAT,1939,50,na,1989,4376.277472181784
STAT,1829,97,na,1926,3.9355936045508026
SIM,1906,31,30-34,1937,18
STAT,1782,101,na,1883,0.1849413888313438
SIM,1915,60,na,1975,4021
STAT,1837,24,40-44,1861,1.9470620999890753
SIM,1823,33,20-24,1856,6
SIM,1999,15,30-34,2014,56
STAT,1962,31,45-49,1993,2.373150479536036
STAT,1862,28,na,1890,2316.130753235657
STAT,1887,18,45-49,1905,0.08426175321676162
STAT,1930,42,20-24,1972,0.02681957733328913
SIM,1939,74,na,2013,3505
SIM,1850,49,na,1899,1443
STAT,1950,37,na,1987,5288.966845082215
STAT,1859,53,45-49,1912,0.013127121238746655
STAT,1848,24,15-19,1872,4.20699759136545
STAT,1814,41,20-24,1855,0.5520496362485591
STAT,1983,25,40-44,2008,7.6489143055286934
STAT,1843,46,45-49,1889,0.23873301517982617
STAT,1962,23,50-100,1985,0.9758569708654442
STAT,1886,6,na,1892,3180.0516626224808
STAT,1956,32,30-34,1988,24.52420723453802
STAT,1915,33,25-29,1948,10.819436552148504
STAT,1810,51,30-34,1861,0.022244233670962118
SIM,1883,39,50-100,1922,6
SIM,1917,41,na,1958,5325
SIM,1851,46,45-49,1897,1
SIM,1800,64,na,1864,1092
SIM,1857,21,50-100,1878,1
STAT,1904,30,45-49,1934,2.913125001193007
STAT,1899,15,30-34,1914,2.5317282342086997
SIM,1923,33,25-29,1956,25
STAT,1890,25,25-29,1915,60.05477385065047
STAT,1862,31,40-44,1893,4.240929338383166
SIM,1793,77,na,1870,593
SIM,1856,24,15-19,1880,3
SIM,1982,31,25-29,2013,30
STAT,1834,30,na,1864,2586.586162118417
STAT,1899,2,na,1901,4214.596116307391
SIM,1902,41,40-44,1943,1
STAT,1918,27,45-49,1945,2.121332830430914
SIM,1877,16,na,1893,3369
STAT,1913,43,30-34,1956,0.14372718498911682
STAT,1892,58,na,1950,2860.464903712976
STAT,1937,47,35-39,1984,0.15029592229087305
STAT,1820,40,35-39,1860,2.3728930996393736
STAT,1831,43,15-19,1874,0.013066904776119114
STAT,1961,41,50-100,2002,0.18229745677651207
STAT,1980,24,45-49,2004,1.8073482673234145
SIM,1921,43,30-34,1964,2
STAT,1890,23,na,1913,3324.697655578189
SIM,1858,6,na,1864,3380
SIM,1926,27,45-49,1953,6
SIM,1898,24,20-24,1922,4
STAT,1910,42,35-39,1952,0.21985141761512753
SIM,1799,68,na,1867,525
SIM,1929,28,40-44,1957,10
STAT,1947,41,20-24,1988,0.02389288156968162
SIM,1953,6,na,1959,5700
SIM,1892,35,50-100,1927,5
STAT,1853,23,50-100,1876,0.4762663494427317
SIM,1843,67,na,1910,1233
STAT,1924,24,35-39,1948,12.738444106144474
SIM,1883,7,na,1890,2800
SIM,1963,48,na,2011,6423
SIM,1868,45,45-49,1913,1
SIM,1858,22,25-29,1880,84
STAT,1828,106,na,1934,0.008058432489681095
STAT,1899,30,25-29,1929,16.324450784547835
STAT,1881,66,na,1947,1824.429890598742
STAT,1840,34,25-29,1874,9.802108416348593
STAT,1879,21,40-44,1900,2.518610008551496
STAT,1926,81,na,2007,2480.2604999420287
STAT,1885,43,45-49,1928,1.7103512726164332
STAT,1876,46,40-44,1922,0.20481784914871554
SIM,1882,17,20-24,1899,25
STAT,1930,37,na,1967,5663.980047657045
STAT,1837,47,30-34,1884,0.07276328041669018
STAT,1874,17,20-24,1891,20.945324445909645
STAT,1913,35,15-19,1948,0.022089714053940744
STAT,1812,63,na,1875,950.6004113674377
SIM,1874,59,na,1933,2097
STAT,1887,57,na,1944,2599.102020115051
STAT,1860,42,30-34,1902,1.0679998676552582
SIM,1927,47,50-100,1974,2
SIM,1887,21,40-44,1908,7
SIM,1973,20,na,1993,5090
STAT,1825,81,na,1906,382.498017724883
STAT,1868,35,50-100,1903,1.37420968307152
SIM,1863,67,na,1930,1835
STAT,1846,89,na,1935,108.602450208587
SIM,1966,30,40-44,1996,14
STAT,1964,25,15-19,1989,1.0314482734443118
STAT,1861,66,na,1927,1572.4781723561189
STAT,1970,41,35-39,2011,0.30274976523749003
STAT,1875,54,40-44,1929,0.012209966100642108
SIM,1916,29,50-100,1945,2
SIM,1932,24,35-39,1956,30
STAT,1780,107,na,1887,0.011700841146931476
STAT,1853,40,30-34,1893,1.1561812703103054
STAT,1958,30,40-44,1988,6.053032134588908
STAT,1923,49,50-100,1972,0.303448511841794
STAT,1952,18,na,1970,5088.7505820392935
STAT,1973,36,35-39,2009,3.7226712312264634
SIM,1959,19,20-24,1978,10
SIM,1965,30,25-29,1995,4
STAT,1813,62,na,1875,1035.4977012671286
SIM,1861,40,30-34,1901,1
STAT,1931,26,35-39,1957,22.3840551076523
SIM,1880,42,20-24,1922,1
STAT,1797,67,na,1864,908.0304697839005
SIM,1836,30,25-29,1866,25
STAT,1927,17,na,1944,5280.427831988185
SIM,1948,31,35-39,1979,31
SIM,1955,44,25-29,1999,1
SIM,1926,52,na,1978,5610
SIM,1869,58,na,1927,1607
STAT,1820,34,40-44,1854,14.763040986196431
STAT,1877,49,25-29,1926,0.06770191905608168
STAT,1944,17,45-49,1961,0.6204230757396504
STAT,1894,42,40-44,1936,0.2314351243575254
SIM,1932,38,na,1970,5458
STAT,1960,13,na,1973,5903.308297543096
SIM,1955,18,40-44,1973,6
STAT,1900,20,30-34,1920,28.693989704699444
STAT,1941,20,20-24,1961,132.7371879705832
STAT,1850,50,20-24,1900,7.705646535887241E-4
STAT,1856,18,15-19,1874,6.141915000937023
STAT,1957,30,25-29,1987,14.351249308233918
STAT,1947,44,25-29,1991,0.09615024464071005
SIM,1818,47,50-100,1865,1
STAT,1887,15,40-44,1902,0.2376517930480213
SIM,1867,31,35-39,1898,35
SIM,1868,42,40-44,1910,11
STAT,1929,27,20-24,1956,26.365769286968654
STAT,1940,25,30-34,1965,46.16552266232612
SIM,1901,46,na,1947,3906
STAT,1926,36,50-100,1962,0.5925795481051329
STAT,1859,31,35-39,1890,9.347905478316214
STAT,1864,28,15-19,1892,0.46586831154589153
STAT,1937,22,20-24,1959,125.02997983718693
SIM,1934,36,50-100,1970,2
SIM,1948,19,45-49,1967,2
SIM,1983,20,20-24,2003,355
STAT,1899,90,na,1989,547.0981667758952
SIM,1974,21,35-39,1995,33
STAT,1872,42,20-24,1914,0.18380631711476123
SIM,1986,17,45-49,2003,3
STAT,1828,30,25-29,1858,12.647290786481761
STAT,1983,30,20-24,2013,4.063586007955061
STAT,1961,49,20-24,2010,0.017038356365021094
STAT,1895,48,30-34,1943,0.08099393949099637
SIM,1827,51,na,1878,1349
STAT,1836,44,45-49,1880,1.5799032052339828
SIM,1948,33,na,1981,4297
STAT,1857,52,50-100,1909,0.01350224841350063
STAT,1809,97,na,1906,2.4969093467988195
STAT,1852,45,40-44,1897,0.16301884451839999
SIM,1844,44,45-49,1888,1
STAT,1958,21,50-100,1979,1.0009739907369377
STAT,1972,30,45-49,2002,2.3727356076493002
STAT,1943,43,45-49,1986,0.21135104640891755
SIM,1859,36,35-39,1895,1
STAT,1837,27,45-49,1864,1.031935490933471
SIM,1863,30,50-100,1893,1
STAT,1915,40,na,1955,4327.829429496655
STAT,1883,23,25-29,1906,64.43585454595035
SIM,1830,49,na,1879,1668
SIM,1857,81,na,1938,458
SIM,1966,42,na,2008,5845
SIM,1930,75,na,2005,4004
SIM,1874,23,20-24,1897,140
STAT,1947,18,40-44,1965,1.817688969709429
SIM,1958,47,na,2005,6073
STAT,1955,17,20-24,1972,207.70332457866124
STAT,1986,22,na,2008,6024.833506729137
STAT,1923,35,40-44,1958,2.0044679867452406
SIM,1931,35,40-44,1966,2
SIM,1961,39,20-24,2000,1
STAT,1848,27,20-24,1875,14.880844794873068
SIM,1891,23,25-29,1914,163
STAT,1876,52,35-39,1928,0.010215750816044958
SIM,1856,27,20-24,1883,18
STAT,1901,43,40-44,1944,0.25066153788401324
STAT,1864,41,50-100,1905,1.0935376602425961
SIM,1851,43,40-44,1894,4
STAT,1866,23,20-24,1889,73.781360587552
SIM,1834,22,40-44,1856,8
SIM,1963,17,20-24,1980,413
STAT,1831,26,30-34,1857,26.44103608993931
STAT,1842,28,na,1870,2043.8585722362013
SIM,1965,25,na,1990,5542
SIM,1961,42,45-49,2003,1
SIM,1881,86,na,1967,316
SIM,1907,39,45-49,1946,2
STAT,1989,17,20-24,2006,224.1046973134847
STAT,1899,18,35-39,1917,0.8652748278537746
SIM,1892,78,na,1970,1785
STAT,1895,25,40-44,1920,4.530440932667925
SIM,1924,71,na,1995,3552
SIM,1933,34,na,1967,6304
SIM,1886,41,45-49,1927,2
STAT,1838,38,15-19,1876,0.058098263126713005
STAT,1831,36,na,1867,2135.525919667221
STAT,1953,23,15-19,1976,7.453555988289345
STAT,1847,44,20-24,1891,0.12054991630995934
SIM,1944,49,40-44,1993,1
SIM,1914,24,15-19,1938,12
STAT,1911,48,25-29,1959,0.05784227207254401
STAT,1859,50,40-44,1909,0.009817196412530298
SIM,1927,23,15-19,1950,8
STAT,1854,20,25-29,1874,55.59326095935977
STAT,1991,16,35-39,2007,6.94187574501396
SIM,1865,48,na,1913,2764
STAT,1877,27,na,1904,2864.889707928852
STAT,1878,41,45-49,1919,1.8115447927083144
STAT,1915,18,50-100,1933,0.09027185860028535
STAT,1850,31,15-19,1881,0.1549600937866229
STAT,1965,40,15-19,2005,0.002305743915909083
STAT,1924,40,50-100,1964,0.16166782160486304
STAT,1936,49,40-44,1985,0.17939125092256902
STAT,1951,40,50-100,1991,0.16824523874234582
SIM,1856,85,na,1941,303
SIM,1997,17,20-24,2014,462
STAT,1888,19,na,1907,3407.799256782945
STAT,1915,30,20-24,1945,2.890435604040317
SIM,1919,32,20-24,1951,6
STAT,1932,32,na,1964,5803.614844796186
SIM,1855,44,20-24,1899,1
STAT,1773,88,na,1861,81.85953692113432
SIM,1982,31,50-100,2013,3
STAT,1919,23,15-19,1942,6.7045329455746625
STAT,1954,43,20-24,1997,0.02614261923987706
STAT,1858,32,50-100,1890,0.824883042526421
STAT,1880,23,50-100,1903,0.49728467190263387
STAT,1854,46,20-24,1900,0.009804121083475866
STAT,1877,26,35-39,1903,11.622756995471166
SIM,1947,16,25-29,1963,3
STAT,1862,34,45-49,1896,1.6838242293475323
STAT,1930,20,45-49,1950,1.6736111151726796
STAT,1857,27,na,1884,2209.4169577833204
STAT,1868,52,40-44,1920,0.011610577069352502
STAT,1913,9,na,1922,4684.265945684506
STAT,1981,27,30-34,2008,63.502802426362805
STAT,1923,40,20-24,1963,0.023878400644906095
SIM,1945,22,20-24,1967,246
STAT,1810,54,35-39,1864,0.0302673368041052
STAT,1824,41,15-19,1865,0.01998572619371716
SIM,1959,25,na,1984,5478
STAT,1813,46,30-34,1859,0.32626965860103074
STAT,1885,21,35-39,1906,6.737555189175614
STAT,1869,35,40-44,1904,4.938796606958033
STAT,1822,44,50-100,1866,2.046656674215865
STAT,1943,59,na,2002,4397.894141664422
SIM,1963,37,30-34,2000,1
SIM,1838,43,na,1881,1644
STAT,1787,100,na,1887,0.1791001589376785
SIM,1852,17,40-44,1869,1
STAT,1901,26,na,1927,3871.012484318221
SIM,1893,40,40-44,1933,9
STAT,1844,17,40-44,1861,0.1944692244074395
STAT,1945,46,15-19,1991,4.842362521517137E-4
STAT,1974,31,50-100,2005,1.270730899031883
SIM,1841,86,na,1927,149
SIM,1894,32,40-44,1926,15
STAT,1870,47,15-19,1917,4.529676423136382E-4
STAT,1886,32,40-44,1918,5.279133340255848
STAT,1821,37,25-29,1858,6.406493522977162
STAT,1846,35,na,1881,2596.788689273394
SIM,1950,26,na,1976,4424
SIM,1937,27,20-24,1964,28
STAT,1845,50,na,1895,1471.772983840526
SIM,1921,46,35-39,1967,1
STAT,1885,76,na,1961,1308.4007395450549
STAT,1906,24,15-19,1930,5.517076427989418
STAT,1798,94,na,1892,5.083654907906361
SIM,1878,31,45-49,1909,2
SIM,1889,25,50-100,1914,1
SIM,2007,1,na,2008,6964
SIM,1965,35,40-44,2000,1
STAT,1863,17,45-49,1880,0.07521818583643598
SIM,1949,24,50-100,1973,1
SIM,1877,35,40-44,1912,4
STAT,1931,31,15-19,1962,0.19447749539645717
STAT,1874,84,na,1958,492.7559526272285
STAT,1879,24,45-49,1903,0.8350253263557196
STAT,1913,46,35-39,1959,0.1456645901939759
STAT,1809,51,25-29,1860,0.008740565789263985
STAT,1843,78,na,1921,783.9743641554554
SIM,1913,36,35-39,1949,6
SIM,1904,77,na,1981,2716
SIM,1796,71,na,1867,648
STAT,1905,36,35-39,1941,2.5622338612916264
SIM,1934,19,na,1953,5918
STAT,1777,103,na,1880,0.039932567767458765
STAT,1931,40,15-19,1971,0.002374685241354341
STAT,1912,18,na,1930,4499.656285487863
SIM,1839,43,25-29,1882,1
SIM,1961,23,15-19,1984,15
STAT,1885,40,40-44,1925,2.615287831211445
STAT,1882,28,50-100,1910,0.7185326867490516
SIM,1966,21,na,1987,5910
STAT,1894,84,na,1978,1100.6698853410323
SIM,1944,29,20-24,1973,50
STAT,1845,15,35-39,1860,0.47288635901742515
STAT,1883,45,35-39,1928,0.15964883942145106
STAT,1875,15,na,1890,3026.020611311214
STAT,1872,45,25-29,1917,0.06741244553195623
STAT,1929,42,15-19,1971,0.002295232705530777
SIM,1966,8,na,1974,5943
SIM,1847,16,20-24,1863,38
SIM,1886,21,25-29,1907,130
STAT,1931,23,30-34,1954,42.89561135228169
SIM,1955,29,30-34,1984,4
STAT,1947,29,30-34,1976,51.10522364258079
STAT,1961,47,na,2008,5697.558577610616
STAT,1827,31,na,1858,2378.7506519880335
SIM,1880,45,25-29,1925,1
SIM,1915,15,na,1930,5006
STAT,1851,107,na,1958,0.007388602363279095
STAT,1926,32,na,1958,5276.557198480056
SIM,1858,16,30-34,1874,2
STAT,1942,23,40-44,1965,4.067829069301733
STAT,1960,41,40-44,2001,0.39127070731046826
SIM,1920,82,na,2002,1283
SIM,1909,6,na,1915,5153
SIM,1955,50,na,2005,6310
STAT,1859,53,na,1912,1947.6355388013883
SIM,1823,98,na,1921,20
STAT,1869,60,na,1929,2131.479852465842
SIM,1931,40,20-24,1971,1
STAT,1964,19,50-100,1983,0.5442045043709938
SIM,1835,42,45-49,1877,3
SIM,1984,23,40-44,2007,6
STAT,1900,23,35-39,1923,9.315803997871269
STAT,1894,45,45-49,1939,0.1994630915026583
STAT,1916,25,na,1941,4500.857028931057
STAT,1895,15,na,1910,3811.572483640158
SIM,1853,15,35-39,1868,1
SIM,1815,42,25-29,1857,3
STAT,1918,37,na,1955,4575.333012699678
STAT,1825,29,40-44,1854,12.39862739271854
STAT,1934,40,30-34,1974,0.20604899376989835
STAT,1925,85,na,2010,1690.4160839590445
STAT,1939,16,25-29,1955,50.09429310962575
STAT,1928,44,na,1972,5445.639478356991
STAT,1827,42,45-49,1869,1.9961038768391752
SIM,1900,61,na,1961,3016
STAT,1890,22,20-24,1912,97.1748997075714
STAT,1901,71,na,1972,2651.424036344972
STAT,1924,46,45-49,1970,0.29926427392290383
STAT,1904,35,50-100,1939,0.4433296715030454
SIM,1841,32,25-29,1873,17
STAT,1874,30,na,1904,2841.962537325536
STAT,1903,38,25-29,1941,1.0164576223057873
STAT,1940,47,40-44,1987,0.19222030258246306
SIM,1927,22,35-39,1949,12
STAT,1866,26,25-29,1892,45.40349686740919
STAT,1950,39,15-19,1989,0.026938920666945355
STAT,1958,49,15-19,2007,5.773670172177877E-4
SIM,1963,2,na,1965,6584
SIM,1911,38,25-29,1949,3
SIM,1902,42,na,1944,3920
STAT,1859,16,40-44,1875,0.1963359577490026
STAT,1936,29,20-24,1965,20.152461530516394
STAT,1839,16,20-24,1855,18.500980275051745
SIM,1887,23,na,1910,3458
SIM,1870,34,50-100,1904,1
SIM,1993,19,45-49,2012,2
SIM,1839,93,na,1932,12
STAT,1925,29,45-49,1954,2.3372605429463116
STAT,1898,40,na,1938,3653.7438282463186
SIM,1987,2,na,1989,6565
STAT,1835,49,20-24,1884,0.0076937942355806005
SIM,1908,33,na,1941,3962
SIM,1870,34,45-49,1904,3
STAT,1843,43,40-44,1886,2.294132811313986
STAT,1823,43,20-24,1866,0.16355548310694415
SIM,1807,51,na,1858,1155
STAT,1952,45,45-49,1997,0.3141128890157994
SIM,1933,29,45-49,1962,4
STAT,1913,0,na,1913,5301.166125419806
STAT,1940,62,na,2002,4077.1306580045575
STAT,1960,30,30-34,1990,24.166122784743347
STAT,1944,51,na,1995,4685.54060234098
STAT,1902,28,50-100,1930,1.0394286155576724
STAT,1822,32,15-19,1854,0.6157704639670248
SIM,1934,22,45-49,1956,7
SIM,1970,23,50-100,1993,1
STAT,1985,19,45-49,2004,0.8193919511664018
STAT,1895,28,45-49,1923,1.6620174725334107
STAT,1904,18,20-24,1922,29.303086778411764
STAT,1858,36,45-49,1894,1.803346197659318
STAT,1945,36,na,1981,4890.757676998196
STAT,1861,97,na,1958,8.026894774166077
STAT,1851,19,40-44,1870,0.17427231524542636
STAT,1873,34,20-24,1907,3.1582540866881215
SIM,1767,91,na,1858,63
STAT,1857,30,20-24,1887,2.495835107896582
SIM,1840,43,30-34,1883,3
SIM,1902,96,na,1998,38
STAT,1884,23,40-44,1907,2.3686607204915378
STAT,1972,20,15-19,1992,7.897012745702084
SIM,1974,40,30-34,2014,1
SIM,1805,70,na,1875,931
STAT,1915,18,30-34,1933,2.9368450635533088
STAT,1899,41,15-19,1940,0.0015230800422484706
STAT,1930,45,25-29,1975,0.08100689086885296
SIM,1903,22,15-19,1925,10
STAT,1863,51,45-49,1914,0.014714693438708404
SIM,1860,51,35-39,1911,1
SIM,1908,33,50-100,1941,1
SIM,1876,35,50-100,1911,4
SIM,1881,34,20-24,1915,2
STAT,1926,22,45-49,1948,1.5772005852057778
STAT,1934,44,na,1978,5949.308063257009
SIM,1853,38,25-29,1891,6
STAT,1966,43,35-39,2009,0.3011663950582612
STAT,1849,21,50-100,1870,0.38489610018231507
STAT,1919,22,35-39,1941,11.896074849895154
SIM,1836,31,na,1867,1698
STAT,1962,17,30-34,1979,18.023320528671476
STAT,1950,36,45-49,1986,0.9592447305118427
SIM,1912,18,20-24,1930,56
STAT,1806,53,30-34,1859,0.020536587392573517
STAT,1813,49,35-39,1862,0.44978278693601503
SIM,1913,33,30-34,1946,1
SIM,1999,15,na,2014,6135
STAT,1852,51,35-39,1903,0.008155572143077916
STAT,1946,49,35-39,1995,0.17064825102035655
STAT,1924,51,na,1975,4981.792883274053
STAT,1933,80,na,2013,2966.94499202933
SIM,1928,28,25-29,1956,120
STAT,1814,98,na,1912,2.0255255118739
SIM,1854,50,na,1904,2311
STAT,1966,21,35-39,1987,13.62168590275472
STAT,1901,3,na,1904,4273.400993042998
SIM,1959,43,na,2002,5915
STAT,1898,15,15-19,1913,9.299006826312926
STAT,1895,44,50-100,1939,0.10871653940196362
SIM,1872,32,20-24,1904,4
STAT,1914,44,na,1958,4234.871178090559
STAT,1916,33,40-44,1949,4.643406398021356
SIM,1861,23,50-100,1884,1
SIM,1931,22,na,1953,6206
STAT,1935,46,20-24,1981,0.018059448773097293
SIM,1816,68,na,1884,1163
STAT,1872,20,45-49,1892,0.8128791100184134
SIM,1931,4,na,1935,6461
STAT,1770,91,na,1861,8.256150799024677
STAT,1841,45,30-34,1886,0.08869796514654427
STAT,1980,13,na,1993,6292.153599066824
STAT,1817,53,40-44,1870,0.028352235059663174
STAT,1848,16,na,1864,3041.3795171812303
SIM,1922,35,30-34,1957,8
STAT,1905,33,30-34,1938,16.674933404332087
STAT,1932,43,35-39,1975,0.31453799543832583
STAT,1955,32,15-19,1987,0.20067493524851251
SIM,1788,76,na,1864,164
STAT,1912,43,15-19,1955,0.0017006513665645906
SIM,1918,39,20-24,1957,1
STAT,1830,45,20-24,1875,0.011364262757460915
STAT,1874,54,25-29,1928,0.0040696248127450015
SIM,1923,20,50-100,1943,2
STAT,1951,19,45-49,1970,0.6860283683782706
SIM,1787,91,na,1878,49
SIM,1920,43,15-19,1963,1
STAT,1860,27,50-100,1887,0.6013584846691954
STAT,1869,38,45-49,1907,2.216886740459266
SIM,1830,40,na,1870,1950
STAT,1902,2,na,1904,4346.699769977895
STAT,1832,43,30-34,1875,0.964285332428534
STAT,1841,97,na,1938,4.776407713598691
STAT,1969,46,20-24,2015,0.016612486996960128
STAT,1914,35,30-34,1949,2.1210103740537134
STAT,1956,15,15-19,1971,69.34046856903399
STAT,1972,33,15-19,2005,0.19342842805248092
SIM,1877,38,45-49,1915,6
STAT,1921,45,15-19,1966,4.8131839437218156E-4
SIM,1831,25,na,1856,1912
STAT,1941,45,35-39,1986,0.1602009826247852
SIM,1962,14,na,1976,5585
STAT,1902,32,35-39,1934,16.513477527965758
STAT,1854,30,na,1884,2032.6748357028741
STAT,1972,39,na,2011,5715.004054286897
STAT,1858,23,na,1881,2207.1496942149365
SIM,1889,58,na,1947,3122
STAT,1957,43,25-29,2000,0.11273865340611453
STAT,1844,23,na,1867,2216.8747630053913
SIM,1841,32,na,1873,2000
STAT,1803,52,35-39,1855,0.031237049371852486
SIM,1798,83,na,1881,171
SIM,1910,32,35-39,1942,2
STAT,1924,29,50-100,1953,1.3275253350863123
STAT,1911,26,15-19,1937,0.7979169340278215
SIM,1894,59,na,1953,3116
STAT,1946,18,25-29,1964,55.4506790886055
STAT,1863,78,na,1941,788.450772201708
SIM,1847,19,25-29,1866,14
STAT,1936,27,30-34,1963,43.30069903619728
STAT,1896,43,20-24,1939,0.01668885481058556
SIM,1944,27,30-34,1971,112
STAT,1971,44,20-24,2015,0.026737077902293856
SIM,1878,66,na,1944,1935
STAT,1849,60,na,1909,1478.1943541232026
STAT,1936,25,na,1961,4143.477483452612
SIM,1828,28,20-24,1856,20
STAT,1838,23,na,1861,2385.582433759944
STAT,1785,90,na,1875,20.2523692553546
STAT,1791,76,na,1867,406.9536087883069
STAT,1839,19,25-29,1858,5.809753524434295
STAT,1894,48,15-19,1942,3.305296175818773E-4
STAT,1956,46,na,2002,5849.918406041323
STAT,1990,18,40-44,2008,2.3109297116283836
SIM,1959,49,50-100,2008,1
SIM,1921,46,50-100,1967,1
SIM,1946,21,na,1967,4665
STAT,1913,46,50-100,1959,0.2555373088786547
SIM,1854,30,45-49,1884,2
STAT,1882,42,15-19,1924,0.015547481991316593
STAT,1934,43,35-39,1977,0.3231329151735548
SIM,1942,43,35-39,1985,1
STAT,1881,48,50-100,1929,0.2699494211615205
STAT,1893,42,25-29,1935,0.9355731063373732
STAT,1946,30,15-19,1976,0.1678521081600001
SIM,1832,26,20-24,1858,14
SIM,1839,28,30-34,1867,3
SIM,1969,19,15-19,1988,1
SIM,1888,73,na,1961,1286
STAT,1946,32,na,1978,4934.520449849766
SIM,1856,39,50-100,1895,5
STAT,1868,18,40-44,1886,0.20525269793933604
STAT,1851,51,50-100,1902,0.012033704788796337
SIM,1836,45,50-100,1881,1
STAT,1828,45,50-100,1873,0.23217544339057872
STAT,1846,30,45-49,1876,2.1750849989569194
STAT,1878,44,15-19,1922,0.016415619079441224
STAT,1924,4,na,1928,5545.324848612241
STAT,1974,31,25-29,2005,14.205355500066014
STAT,1981,6,na,1987,6343.793626178158
STAT,1937,73,na,2010,3067.731608537937
SIM,1878,42,50-100,1920,3
STAT,1890,77,na,1967,1655.4933090368809
STAT,1978,27,na,2005,5925.571976854607
SIM,1854,18,20-24,1872,50
SIM,1870,31,40-44,1901,2
SIM,1921,21,20-24,1942,158
STAT,1964,45,25-29,2009,0.0805757197855652
STAT,1861,39,20-24,1900,0.7321146684698893
STAT,1845,38,25-29,1883,2.0174517552073463
SIM,1916,20,35-39,1936,16
SIM,1953,35,25-29,1988,1
SIM,1905,16,20-24,1921,61
SIM,1906,34,35-39,1940,2
STAT,1878,21,25-29,1899,69.18666986184498
STAT,1923,43,25-29,1966,0.09613239957264298
STAT,1941,47,50-100,1988,0.27972176509388486
STAT,1961,36,20-24,1997,0.405298930569967
SIM,1850,40,50-100,1890,2
STAT,1913,21,20-24,1934,124.78798020724133
SIM,1840,17,15-19,1857,8
SIM,1920,6,na,1926,4702
STAT,1842,40,50-100,1882,0.8629323437702293
SIM,1954,18,25-29,1972,63
STAT,1964,30,50-100,1994,1.2263682200074197
STAT,1984,16,25-29,2000,71.04901272120246
SIM,1817,40,35-39,1857,3
STAT,1968,18,45-49,1986,0.7198148320404248
STAT,1814,44,25-29,1858,1.8916032950741342
SIM,1992,16,25-29,2008,92
STAT,1937,44,30-34,1981,0.14840544416030388
STAT,1885,22,na,1907,2722.429352573342
SIM,1908,7,na,1915,4396
SIM,1822,44,25-29,1866,1
STAT,1966,40,30-34,2006,0.19204181853690966
SIM,1960,51,na,2011,5992
SIM,1918,37,30-34,1955,1
SIM,1988,23,na,2011,5787
STAT,1903,35,20-24,1938,0.2760906277712655
STAT,1960,44,45-49,2004,0.2591067775258263
SIM,1831,43,20-24,1874,2
STAT,1996,19,20-24,2015,227.2313158684041
STAT,1784,94,na,1878,4.4221464997677
SIM,1882,37,40-44,1919,17
STAT,1876,11,na,1887,3113.1131927161787
STAT,1982,17,50-100,1999,0.6084121981893813
STAT,1924,49,15-19,1973,5.030035396297046E-4
SIM,1870,5,na,1875,3501
SIM,1832,49,45-49,1881,1
STAT,1825,50,na,1875,1755.7218222681436
STAT,1946,46,30-34,1992,0.11898182295530668
STAT,1789,100,na,1889,0.18457255708060594
STAT,1888,29,15-19,1917,0.6110823802277141
STAT,1867,52,25-29,1919,0.0037961608281376616
STAT,1941,42,30-34,1983,0.15797049495743087
SIM,1939,28,35-39,1967,41
SIM,1871,37,30-34,1908,7
STAT,1861,20,35-39,1881,5.835153459223265
STAT,1931,48,45-49,1979,0.334511718197671
SIM,1914,19,na,1933,4163
STAT,1819,48,25-29,1867,0.10930978178887225
STAT,1800,54,40-44,1854,0.040000409404682864
SIM,1892,40,25-29,1932,2
SIM,1928,33,na,1961,5629
STAT,1960,33,35-39,1993,13.992430902184294
SIM,1890,12,na,1902,3751
STAT,1833,32,25-29,1865,9.366484617563401
STAT,1824,49,45-49,1873,0.3122056004081615
STAT,1935,49,25-29,1984,0.0859635321226027
STAT,1825,41,30-34,1866,1.746256105156054
SIM,1845,79,na,1924,873
SIM,1876,85,na,1961,521
STAT,1952,42,40-44,1994,0.3594866615747514
STAT,1883,20,20-24,1903,78.27281547291676
STAT,1850,16,20-24,1866,22.434037702651846
SIM,2006,2,na,2008,7594
STAT,1836,42,na,1878,2276.1531443206836
STAT,1940,31,25-29,1971,11.049267807923076
SIM,1929,19,50-100,1948,4
STAT,1874,37,40-44,1911,5.171788602790313
SIM,1918,26,na,1944,4096
STAT,1869,50,35-39,1919,0.009759821902070816
SIM,1919,16,50-100,1935,1
STAT,1836,41,40-44,1877,2.4674478214749027
SIM,1913,34,na,1947,4644
SIM,1929,18,na,1947,5357
STAT,1888,29,50-100,1917,0.8615881841687659
STAT,1956,35,35-39,1991,3.811921366135547
STAT,1962,19,20-24,1981,200.33821327003292
SIM,1891,20,20-24,1911,112
SIM,1970,19,20-24,1989,359
STAT,1858,50,25-29,1908,0.0032346493593875736
STAT,1932,40,30-34,1972,0.2005683556800716
SIM,1870,12,na,1882,3382
STAT,1908,20,35-39,1928,10.062225940800923
SIM,1944,40,na,1984,4576
SIM,1827,48,25-29,1875,1
STAT,1851,31,30-34,1882,14.56106396456935
STAT,1973,35,na,2008,5795.117801931767
SIM,1903,27,na,1930,3727
STAT,1973,19,30-34,1992,18.18014956395037
STAT,1988,16,50-100,2004,0.6185583172294643
STAT,1943,40,40-44,1983,0.3190217402049187
STAT,1858,33,40-44,1891,3.887809060345566
STAT,1812,46,15-19,1858,9.429606643762312E-4
STAT,1846,18,20-24,1864,22.887358813394574
STAT,1971,25,25-29,1996,96.70710649189596
SIM,1866,33,40-44,1899,3
STAT,1768,87,na,1855,50.9859
STAT,1878,77,na,1955,1041.5541224176425
STAT,1848,39,50-100,1887,1.3166936551634636
SIM,1844,41,40-44,1885,1
STAT,1871,45,50-100,1916,0.28479105267909016
STAT,1840,31,20-24,1871,2.6686607773841127
STAT,1861,12,na,1873,2632.472657191531
SIM,1964,35,35-39,1999,2
SIM,1833,41,30-34,1874,3
SIM,1894,33,50-100,1927,1
SIM,1979,24,45-49,2003,4
SIM,1790,80,na,1870,96
STAT,1889,69,na,1958,2187.657336860296
STAT,1857,18,30-34,1875,1.673865843990306
SIM,1898,27,25-29,1925,67
STAT,1924,21,30-34,1945,39.246044123299086
STAT,1963,24,na,1987,5368.164985754496
STAT,1890,47,35-39,1937,0.11084036803349707
STAT,1958,33,45-49,1991,2.4297070279345543
SIM,1843,30,35-39,1873,22
SIM,1872,78,na,1950,1190
STAT,1799,93,na,1892,13.12760146657158
STAT,1884,40,25-29,1924,0.7395890978957588
STAT,1989,19,na,2008,6080.177100303561
SIM,1941,0,na,1941,4368
STAT,1806,109,na,1915,2.441877271942478E-4
STAT,1810,51,na,1861,1576.6554619964452
STAT,1889,44,25-29,1933,0.9011821536093719
SIM,1885,11,na,1896,3408
SIM,1849,17,35-39,1866,1
STAT,1886,33,50-100,1919,1.1106491239532932
SIM,1932,21,30-34,1953,106
STAT,1932,18,na,1950,5611.312018203803
STAT,1931,33,na,1964,5716.853817917146
STAT,1930,28,40-44,1958,6.837324171652642
STAT,1862,34,50-100,1896,0.8847211997890401
STAT,1921,26,na,1947,4833.006945685637
SIM,2000,13,na,2013,6484
SIM,1966,33,45-49,1999,11
STAT,1963,34,30-34,1997,23.515592746009446
STAT,1850,39,45-49,1889,2.0418373875707005
SIM,1843,13,na,1856,2359
STAT,1951,31,35-39,1982,12.808401334738969
SIM,1944,41,45-49,1985,1
STAT,1863,37,30-34,1900,5.378131097410026
SIM,1888,38,20-24,1926,4
STAT,1874,51,20-24,1925,8.759841127923781E-4
SIM,1887,77,na,1964,1853
STAT,1957,18,35-39,1975,6.382672629113789
STAT,1826,35,na,1861,1601.6656966833457
STAT,1835,30,35-39,1865,8.222195156837088
SIM,1858,19,35-39,1877,1
STAT,1947,17,na,1964,4784.83160327822
STAT,1869,15,50-100,1884,0.056171687926173434
STAT,1948,44,40-44,1992,0.34215069751085536
STAT,1851,16,50-100,1867,0.04751472279351839
STAT,1962,47,15-19,2009,5.665719841394318E-4
STAT,1992,8,na,2000,6510.172989737344
STAT,1906,18,30-34,1924,2.6752490985330133
STAT,1846,68,na,1914,1579.8232663880492
STAT,1898,20,15-19,1918,5.1761233975850445
STAT,1842,38,45-49,1880,1.7809534225285313
SIM,1876,30,30-34,1906,29
STAT,1827,48,20-24,1875,0.014996448157550845
SIM,1845,34,45-49,1879,4
STAT,1891,71,na,1962,2135.8403673546395
STAT,1895,85,na,1980,1012.6197939045109
STAT,1939,45,25-29,1984,0.06406330808202458
SIM,1954,15,20-24,1969,189
STAT,1845,48,50-100,1893,0.16341926728531284
STAT,1849,23,50-100,1872,0.37938883450141225
STAT,1838,27,15-19,1865,0.5000110507712364
STAT,1951,19,20-24,1970,186.1881366133887
STAT,1822,35,50-100,1857,3.240806967174629
STAT,1824,41,na,1865,1722.7708384638136
STAT,1857,5,na,1862,2656.401754543292
STAT,1900,22,20-24,1922,110.3534123804524
SIM,1827,58,na,1885,1153
STAT,1821,47,50-100,1868,0.44444665717451326
SIM,1874,36,na,1910,2642
STAT,1930,34,25-29,1964,13.749466959213843
STAT,1902,72,na,1974,2613.993444714182
STAT,1857,32,20-24,1889,2.4445374823863832
STAT,1953,41,40-44,1994,0.36341131909548974
STAT,1828,55,na,1883,1443.0324565833394
STAT,1920,21,35-39,1941,12.111694535593472
SIM,1914,18,30-34,1932,4
STAT,1878,28,50-100,1906,0.7680876808431457
SIM,1894,88,na,1982,799
SIM,1949,33,40-44,1982,2
STAT,1847,25,15-19,1872,0.425695502400154
STAT,1926,45,15-19,1971,5.269039287021249E-4
STAT,1846,32,45-49,1878,2.130379843806115
SIM,1939,26,35-39,1965,4
STAT,1898,28,25-29,1926,65.74445595227614
SIM,1964,39,35-39,2003,6
STAT,1861,21,30-34,1882,17.683401148878758
STAT,1952,47,na,1999,5284.742239316169
STAT,1940,19,45-49,1959,0.5851320573055538
STAT,1891,38,40-44,1929,6.212743030881326
STAT,1999,3,na,2002,6706.601834260095
STAT,1837,34,45-49,1871,1.550683631132315
STAT,1876,34,50-100,1910,1.083703212831494
SIM,1830,39,30-34,1869,7
SIM,1958,31,40-44,1989,13
STAT,1965,37,35-39,2002,3.5902403613438585
STAT,1967,0,na,1967,5709.988161664598
STAT,1822,39,30-34,1861,11.734775450437287
STAT,1919,13,na,1932,5044.125397720593
STAT,1831,37,30-34,1868,5.270266898689944
STAT,1900,44,40-44,1944,0.24674648648733422
STAT,1829,72,na,1901,925.1706921235101
SIM,1915,34,25-29,1949,3
SIM,1962,20,50-100,1982,1
SIM,1912,19,35-39,1931,3
SIM,1943,15,45-49,1958,2
SIM,1972,19,30-34,1991,44
STAT,1946,37,40-44,1983,1.9740794342567338
SIM,1854,32,45-49,1886,4
STAT,1957,16,35-39,1973,6.38650395925859
SIM,1903,66,na,1969,2792
SIM,1951,34,35-39,1985,3
STAT,1943,34,35-39,1977,11.385891586913003
SIM,1965,16,35-39,1981,15
STAT,1916,80,na,1996,2212.1686118818193
STAT,1782,84,na,1866,142.0844653277769
STAT,1976,21,40-44,1997,5.202935406595879
STAT,1980,26,20-24,2006,29.383948458380832
STAT,1917,19,45-49,1936,0.6150381080486503
STAT,1863,24,45-49,1887,0.7074286131946642
STAT,1816,48,45-49,1864,0.47410158792642937
SIM,1920,30,na,1950,4312
STAT,1808,94,na,1902,10.190683824439576
STAT,1918,48,50-100,1966,0.2769367425394287
SIM,1879,83,na,1962,374
STAT,1964,19,30-34,1983,17.704790141768235
STAT,1929,23,20-24,1952,161.78215083186348
STAT,1935,15,45-49,1950,0.7921920066961076
STAT,1875,40,15-19,1915,0.01663572310317407
SIM,1928,58,na,1986,5242
SIM,1925,19,45-49,1944,1
STAT,1952,35,15-19,1987,0.027408327096092214
SIM,1924,44,na,1968,4909
SIM,1824,48,45-49,1872,1
STAT,1946,15,20-24,1961,173.62666836937746
SIM,1836,19,na,1855,1940
SIM,1882,87,na,1969,652
SIM,1929,73,na,2002,3349
SIM,1881,15,15-19,1896,12
STAT,1849,17,na,1866,2189.9607447924664
SIM,1936,19,20-24,1955,156
STAT,1928,19,20-24,1947,196.08353488024403
STAT,1873,15,15-19,1888,7.076928570764353
SIM,1907,15,35-39,1922,1
SIM,1954,37,40-44,1991,4
STAT,1835,31,30-34,1866,14.027763121949775
STAT,1947,66,na,2013,4255.205018720232
SIM,1926,20,40-44,1946,10
STAT,1811,98,na,1909,1.672652991005797
STAT,1937,42,na,1979,4325.5809301681475
STAT,1913,42,25-29,1955,0.08040709280830291
STAT,1967,23,40-44,1990,4.861477584401862
STAT,1859,35,35-39,1894,6.563921931673141
STAT,1779,80,na,1859,212.29267906136562
SIM,1977,31,35-39,2008,45
STAT,1858,25,50-100,1883,0.5981105226856082
STAT,1972,27,40-44,1999,6.9169566217817575
SIM,1843,31,30-34,1874,20
SIM,1893,22,30-34,1915,66
STAT,1914,29,45-49,1943,1.9964849075991653
STAT,1776,104,na,1880,0.048090026413891325
STAT,1940,46,na,1986,4490.174106761362
STAT,1966,43,50-100,2009,0.17570432143474402
SIM,1946,29,30-34,1975,4
STAT,1869,42,40-44,1911,2.510714460658389
STAT,1839,39,na,1878,1988.0795178380695
STAT,1885,22,30-34,1907,20.503884066223016
STAT,1938,29,30-34,1967,44.775855312326485
SIM,1917,25,45-49,1942,6
STAT,1781,112,na,1893,1.4309657342767587E-4
STAT,1830,49,50-100,1879,0.2207771158748918
SIM,1920,14,na,1934,4615
STAT,1918,23,45-49,1941,1.3958432208803
SIM,1924,28,na,1952,4943
STAT,1920,4,na,1924,5223.709457274849
STAT,1904,19,35-39,1923,0.9044547669820564
STAT,1922,90,na,2012,795.1820582738982
STAT,1865,48,40-44,1913,0.17602315796981505
SIM,1973,37,35-39,2010,9
SIM,1976,19,15-19,1995,66
SIM,1878,33,45-49,1911,3
STAT,1860,43,35-39,1903,1.6720868935856668
STAT,1917,41,30-34,1958,0.15419666972342416
SIM,1906,36,25-29,1942,2
STAT,1858,69,na,1927,1321.2087625088982
SIM,1863,38,30-34,1901,7
STAT,1839,28,50-100,1867,0.6345053506859387
STAT,1894,20,30-34,1914,26.58288824311515
STAT,1907,34,25-29,1941,9.900806147880449
STAT,1909,25,45-49,1934,1.9367840898347375
STAT,1835,25,na,1860,1782.1736419630865
STAT,1917,47,15-19,1964,4.4404880385719023E-4
SIM,1980,29,na,2009,5969
STAT,1887,50,na,1937,2824.8366458716846
SIM,1889,36,25-29,1925,11
SIM,1828,42,45-49,1870,2
STAT,1923,50,na,1973,4913.228106905572
STAT,1968,19,15-19,1987,65.37230240721932
SIM,1872,17,15-19,1889,8
SIM,1861,61,na,1922,1429
STAT,1895,32,40-44,1927,6.514580722820478
STAT,1927,64,na,1991,4712.002956624084
STAT,1810,52,35-39,1862,0.03152374535880269
SIM,1817,41,30-34,1858,3
SIM,1869,89,na,1958,57
SIM,1921,93,na,2014,478
STAT,1878,73,na,1951,1431.189168850879
SIM,1965,10,na,1975,5617
STAT,1871,46,15-19,1917,4.605540558633591E-4
STAT,1984,20,20-24,2004,182.98359246222452
STAT,1859,23,40-44,1882,1.9732866389085946
STAT,1848,34,20-24,1882,2.9852639102934453
STAT,1853,38,20-24,1891,0.763665130612728
STAT,1940,44,35-39,1984,0.24447104424760435
STAT,1919,16,15-19,1935,11.637799363666282
STAT,1904,37,50-100,1941,0.4391589259687189
SIM,1815,47,40-44,1862,1
SIM,1902,31,35-39,1933,21
STAT,1895,31,50-100,1926,1.3820014627414927
SIM,1973,16,50-100,1989,1
STAT,1831,42,50-100,1873,1.0125073610334423
STAT,1865,52,25-29,1917,0.0036685085483924877
STAT,1937,39,40-44,1976,1.7247707216425074
SIM,1856,34,20-24,1890,3
STAT,1933,24,25-29,1957,141.36427016267902
SIM,1909,39,30-34,1948,5
SIM,1802,82,na,1884,86
STAT,1943,37,15-19,1980,0.024213888655874982
STAT,1969,31,35-39,2000,13.43650293542039
SIM,1886,53,na,1939,1776
SIM,1901,18,20-24,1919,48
STAT,1899,51,na,1950,3420.6918493306594
STAT,1858,19,40-44,1877,0.19009145352483078
SIM,1992,20,20-24,2012,388
SIM,1867,23,40-44,1890,4
STAT,1904,44,25-29,1948,0.07290237175630145
SIM,1833,24,25-29,1857,102
STAT,1864,17,15-19,1881,6.326046913563636
SIM,1941,24,25-29,1965,203
STAT,1836,46,50-100,1882,0.23701267672896406
STAT,1922,46,50-100,1968,0.30047941585788357
STAT,1930,31,45-49,1961,2.345254892202308
SIM,1945,39,40-44,1984,2
STAT,1841,37,na,1878,2243.5905743114886
STAT,1815,80,na,1895,343.2477228358207
SIM,1865,75,na,1940,1352
STAT,1807,47,40-44,1854,0.7126818538882113
SIM,1850,35,40-44,1885,6
STAT,1939,42,20-24,1981,0.021209934450068007
STAT,1841,47,40-44,1888,0.1529022723225271
STAT,1887,25,45-49,1912,1.4457227435818854
STAT,1915,42,35-39,1957,0.2340024285040781
SIM,1962,32,45-49,1994,4
SIM,1857,16,35-39,1873,4
SIM,1891,22,20-24,1913,101
SIM,1948,29,40-44,1977,6
STAT,1868,33,35-39,1901,11.181178395422803
SIM,1963,25,15-19,1988,1
STAT,1888,18,15-19,1906,8.029568100144026
SIM,1876,33,35-39,1909,3
SIM,1915,22,30-34,1937,4
STAT,1926,16,50-100,1942,0.5312998749868774
STAT,1976,35,45-49,2011,1.084742115160958
STAT,1890,54,na,1944,2952.8119864777514
SIM,1804,57,na,1861,1070
STAT,1892,29,45-49,1921,1.594502317802058
STAT,1847,85,na,1932,210.93393031632436
STAT,1877,39,20-24,1916,0.9160482803827199
STAT,1849,16,35-39,1865,0.5265961794845013
SIM,1904,31,45-49,1935,3
SIM,1939,23,30-34,1962,1
STAT,1853,105,na,1958,0.05379158979412204
STAT,1904,41,45-49,1945,0.17301372030178208
STAT,1979,28,na,2007,5975.423319080479
SIM,1958,34,45-49,1992,1
STAT,1937,26,na,1963,4218.43281587342
STAT,1842,35,40-44,1877,4.034543798974219
STAT,1883,22,20-24,1905,77.80856526044914
STAT,1880,49,20-24,1929,0.01437241126730073
SIM,1918,32,na,1950,3922
SIM,1879,67,na,1946,1853
SIM,1915,67,na,1982,3627
SIM,1971,33,50-100,2004,4
STAT,1931,18,40-44,1949,2.1077320848145025
SIM,1875,53,na,1928,2760
STAT,1895,21,na,1916,3563.4831206166
STAT,1899,35,na,1934,3760.3422969132957
SIM,1959,27,15-19,1986,1
STAT,1933,12,na,1945,6123.860391407826
STAT,1933,74,na,2007,4026.157724863415
STAT,1955,25,15-19,1980,1.087149012719238
SIM,1934,16,50-100,1950,1
STAT,1920,24,15-19,1944,6.78386654182404
STAT,1881,93,na,1974,159.17958715364355
STAT,1894,38,50-100,1932,1.8123703552256256
SIM,1856,37,25-29,1893,3
STAT,1954,32,45-49,1986,2.2883475393790165
SIM,1910,52,na,1962,3301
SIM,1914,66,na,1980,3305
STAT,1930,31,20-24,1961,3.6353257637256333
SIM,1837,36,na,1873,2468
STAT,1941,32,35-39,1973,11.07534293055955
SIM,1970,17,30-34,1987,23
STAT,1991,9,na,2000,6499.164636234237
STAT,1954,48,15-19,2002,5.451232998909117E-4
SIM,1846,15,20-24,1861,37
SIM,1951,31,30-34,1982,10
STAT,1948,39,40-44,1987,2.0324917004731193
STAT,1917,16,40-44,1933,0.34822096585512713
STAT,1842,54,na,1896,1611.352753650202
STAT,1848,37,25-29,1885,3.1525933590800306
SIM,1819,41,40-44,1860,3
SIM,1906,15,na,1921,3967
SIM,1912,41,45-49,1953,1
STAT,1905,28,40-44,1933,4.985944729483181
STAT,1965,32,20-24,1997,3.582156028693737
SIM,1835,24,35-39,1859,1
SIM,1948,21,30-34,1969,1
STAT,1852,80,na,1932,583.220891856046
STAT,1963,29,40-44,1992,6.856585237576817
STAT,1840,44,50-100,1884,0.8616881031142101
STAT,1856,19,30-34,1875,1.6398462818797246
SIM,1885,39,20-24,1924,1
SIM,1993,7,na,2000,6962
SIM,1841,37,40-44,1878,9
STAT,1825,50,50-100,1875,0.021147362073812796
STAT,1833,37,40-44,1870,3.881811447146295
STAT,1928,42,45-49,1970,0.24484653585869737
STAT,1881,28,30-34,1909,27.932037359364934
STAT,1978,2,na,1980,6197.858578016185
SIM,1870,22,na,1892,3270
SIM,1936,42,45-49,1978,2
STAT,1981,15,15-19,1996,73.27455636891365
STAT,1881,20,50-100,1901,0.4566317369945774
STAT,1931,48,50-100,1979,0.3481189739594079
STAT,1943,31,30-34,1974,19.66676816247645
STAT,1991,24,30-34,2015,47.65930225116237
SIM,1851,9,na,1860,3204
STAT,1891,42,25-29,1933,0.9147926033158207
STAT,1913,39,50-100,1952,0.4736027597973061
SIM,1983,21,na,2004,6025
STAT,1907,22,30-34,1929,30.244805896982342
STAT,1965,23,30-34,1988,41.53236410520565
SIM,1982,7,na,1989,6829
SIM,1973,23,30-34,1996,1
SIM,1967,24,50-100,1991,3
SIM,1840,56,na,1896,1623
STAT,1803,63,na,1866,904.5572980311724
STAT,1874,24,20-24,1898,80.90679423383857
STAT,1896,28,15-19,1924,0.6891381401879169
STAT,1816,45,40-44,1861,0.3598350119057622
SIM,1979,31,45-49,2010,8
STAT,1951,41,30-34,1992,0.18284689702677698
STAT,1853,21,50-100,1874,0.483179903777302
STAT,1921,33,45-49,1954,2.011632664395212
STAT,2000,6,na,2006,6746.885069580306
SIM,1826,46,50-100,1872,1
STAT,1827,44,50-100,1871,1.3580077934166197
STAT,1866,39,45-49,1905,2.1108954938278433
STAT,1850,89,na,1939,108.14693200302575
STAT,1917,44,35-39,1961,0.2417146703243519
SIM,1878,30,40-44,1908,2
STAT,1937,45,50-100,1982,0.2649029314582366
STAT,1978,37,20-24,2015,0.4277345646696921
STAT,1863,1,na,1864,3655.4162238463596
STAT,1937,45,15-19,1982,4.3143763669216336E-4
STAT,1835,41,na,1876,1590.255267145876
STAT,1918,20,40-44,1938,4.209097756240745
STAT,1829,48,30-34,1877,0.09746632920654794
STAT,1887,34,na,1921,3059.847579809056
SIM,1811,43,na,1854,1751
SIM,1899,28,na,1927,4009
SIM,1906,33,20-24,1939,6
SIM,1897,49,40-44,1946,1
STAT,1904,16,30-34,1920,2.64787833967175
SIM,1815,57,na,1872,1559
SIM,1967,47,na,2014,5624
SIM,1961,4,na,1965,5671
STAT,1903,37,20-24,1940,0.2734932294312391
SIM,1881,22,na,1903,1916
STAT,1889,49,40-44,1938,0.13451064934148105
STAT,1932,33,20-24,1965,3.7406087358868523
STAT,1968,40,30-34,2008,0.1920402565142031
SIM,1923,27,na,1950,5044
STAT,1956,37,25-29,1993,1.5490479079578496
SIM,1885,36,na,1921,3216
STAT,1883,20,na,1903,2686.2910141291427
SIM,1918,18,15-19,1936,99
STAT,1952,20,40-44,1972,4.668626560132208
SIM,1801,65,na,1866,1186
STAT,1839,55,na,1894,1639.799792129399
SIM,1921,39,50-100,1960,3
STAT,1885,49,20-24,1934,0.013524900244099925
SIM,1770,87,na,1857,57
SIM,1859,15,30-34,1874,4
SIM,1940,33,20-24,1973,6
SIM,1848,49,45-49,1897,1
STAT,1880,44,15-19,1924,0.01666473259987747
STAT,1984,23,25-29,2007,151.84948616581025
STAT,1869,45,45-49,1914,0.2663850910785188
SIM,1933,29,20-24,1962,51
STAT,1928,45,25-29,1973,0.07847525496068616
SIM,1892,49,na,1941,3486
STAT,1837,104,na,1941,0.04829937540676868
STAT,1849,33,na,1882,1928.8353837662237
SIM,1895,14,na,1909,4007
SIM,1997,13,na,2010,6607
STAT,1840,16,15-19,1856,6.2003375332756345
SIM,1925,44,35-39,1969,1
SIM,1848,27,25-29,1875,3
SIM,1917,34,35-39,1951,25
STAT,1913,38,40-44,1951,1.6973325511998991
STAT,1857,68,na,1925,1373.5602721325479
STAT,1891,28,50-100,1919,0.9091932179264505
STAT,1868,30,30-34,1898,19.514377937242276
STAT,1853,54,na,1907,2084.7833540091997
SIM,1913,28,40-44,1941,10
STAT,1852,37,na,1889,2233.299520476632
STAT,1955,53,na,2008,5729.755741586512
STAT,1817,49,50-100,1866,0.6813635131825309
STAT,1873,42,na,1915,2720.4191943966503
SIM,1973,34,30-34,2007,72
STAT,1982,29,35-39,2011,24.462008137634953
STAT,1904,41,20-24,1945,0.018359010986823927
SIM,1930,26,15-19,1956,2
STAT,1925,29,20-24,1954,24.695470697338497
STAT,1977,17,15-19,1994,70.76599392234527
STAT,1902,43,50-100,1945,0.11876228158948919
STAT,1927,48,na,1975,5305.969844130606
SIM,1976,10,na,1986,6048
STAT,1902,111,na,2013,0.021502587783632232
STAT,1963,35,15-19,1998,0.02905704950701249
STAT,1806,53,50-100,1859,0.0521052257292014
STAT,1914,38,35-39,1952,2.774497121323784
STAT,1906,43,20-24,1949,0.018425143248104382
STAT,1878,40,40-44,1918,2.7376251059625636
SIM,1925,45,na,1970,5263
STAT,1911,47,20-24,1958,0.012084067618547347
STAT,1880,32,50-100,1912,1.1207893439174692
SIM,1905,15,25-29,1920,13
STAT,1929,35,15-19,1964,0.028502363197451395
STAT,1832,53,25-29,1885,0.0025076288314041166
SIM,1931,14,na,1945,6344
SIM,1962,35,25-29,1997,1
STAT,1820,75,na,1895,604.1909725370862
STAT,1923,91,na,2014,673.4878937364042
SIM,1935,28,na,1963,6041
SIM,1895,25,45-49,1920,2
STAT,1869,69,na,1938,1640.138684318878
STAT,1821,92,na,1913,25.47243522723826
STAT,1914,16,15-19,1930,10.86584995409089
STAT,1922,26,15-19,1948,0.9246466000967908
SIM,1923,42,35-39,1965,3
STAT,1894,23,35-39,1917,8.630412818807809
STAT,1872,22,45-49,1894,0.8080577771296389
STAT,1864,17,50-100,1881,0.05222382196024461
STAT,1895,35,45-49,1930,3.0230398081204046
SIM,1922,16,15-19,1938,61
STAT,1796,76,na,1872,439.3478884966194
SIM,1922,38,35-39,1960,7
SIM,1928,25,20-24,1953,54
STAT,1792,62,na,1854,1334.0
STAT,1923,34,na,1957,4995.36673183551
STAT,1831,49,25-29,1880,0.052016261764239395
SIM,1929,59,na,1988,4881
SIM,1886,40,40-44,1926,2
STAT,1867,32,50-100,1899,0.987243980793552
STAT,1804,104,na,1908,0.02900111054760595
SIM,1884,34,50-100,1918,1
STAT,1960,31,50-100,1991,1.2674846833764681
STAT,1891,39,na,1930,3326.552406138077
STAT,1902,29,na,1931,3863.718143568296
SIM,1945,68,na,2013,3496
STAT,1965,26,35-39,1991,21.734206276705283
SIM,1805,74,na,1879,554
SIM,1925,19,20-24,1944,205
SIM,1809,88,na,1897,97
SIM,1934,30,40-44,1964,1
SIM,1871,48,30-34,1919,1
SIM,1895,22,40-44,1917,2
STAT,1883,25,25-29,1908,48.086242480534004
STAT,1944,22,35-39,1966,11.733083010011624
STAT,1783,85,na,1868,63.760266239290615
STAT,1847,69,na,1916,1129.207644849771
STAT,1917,19,20-24,1936,166.921376086099
STAT,1931,22,25-29,1953,138.2864155020254
SIM,1973,26,35-39,1999,32
SIM,1816,38,45-49,1854,7
STAT,1965,36,na,2001,5589.464868714637
SIM,1893,87,na,1980,534
SIM,1904,46,40-44,1950,1
STAT,1863,48,30-34,1911,0.0964544877198066
SIM,1836,41,50-100,1877,6
SIM,1882,27,25-29,1909,53
STAT,1867,52,35-39,1919,0.009226779883720101
SIM,1891,28,40-44,1919,12
STAT,1976,32,40-44,2008,6.15016632151842
SIM,1831,24,15-19,1855,2
STAT,1878,46,na,1924,2718.6550628523437
STAT,1768,109,na,1877,0.002977969345513474
SIM,1867,26,45-49,1893,1
STAT,1882,41,20-24,1923,0.17982643873717577
SIM,1891,25,25-29,1916,120
STAT,1920,29,20-24,1949,22.933767092545445
SIM,1940,1,na,1941,5319
STAT,1839,15,15-19,1854,6.229818391422327
STAT,1838,22,45-49,1860,0.783811079520934
SIM,1853,10,na,1863,2829
STAT,1838,17,na,1855,2626.361034977968
STAT,1980,15,20-24,1995,217.3184721775743
SIM,1930,36,40-44,1966,3
STAT,1808,47,50-100,1855,1.2278703425947761
SIM,1831,27,30-34,1858,24
STAT,1919,41,40-44,1960,0.31318772408734247
STAT,1941,43,50-100,1984,0.14493272004854177
STAT,1807,51,25-29,1858,0.014196639564196577
SIM,1857,24,na,1881,2552
STAT,1883,28,40-44,1911,3.3703625080240616
SIM,1890,41,20-24,1931,1
STAT,1958,41,40-44,1999,0.39456586897407575
SIM,1882,49,45-49,1931,2
SIM,1832,33,20-24,1865,5
SIM,1901,41,50-100,1942,1
SIM,1966,11,na,1977,5942
STAT,1950,45,50-100,1995,0.32253509396699187
STAT,1954,20,50-100,1974,0.9424924807913625
SIM,1898,5,na,1903,4220
STAT,1822,48,20-24,1870,0.02235964947402555
STAT,1846,37,15-19,1883,0.06062215728222131
STAT,1846,109,na,1955,7.354943675657405E-4
STAT,1906,41,30-34,1947,0.13496045924906191
SIM,1904,24,20-24,1928,211
SIM,1971,37,25-29,2008,1
STAT,1822,93,na,1915,24.012363540886277
SIM,1827,74,na,1901,430
STAT,1819,38,20-24,1857,2.027802701102243
STAT,1939,36,35-39,1975,2.8823929161761406
STAT,1901,50,na,1951,3530.67225222452
STAT,1836,105,na,1941,0.0266837983895229
STAT,1954,25,20-24,1979,26.177589367381927
SIM,1874,17,25-29,1891,13
STAT,1866,17,25-29,1883,6.221620327234129
STAT,1833,41,25-29,1874,0.5586079404332821
SIM,1991,17,35-39,2008,7
STAT,1963,37,25-29,2000,1.4872576907363144
STAT,1963,33,25-29,1996,13.80448443328465
SIM,1962,25,20-24,1987,28
STAT,1874,27,25-29,1901,49.97689680699952
STAT,1879,36,15-19,1915,0.06799299357913964
STAT,1961,49,na,2010,5664.162851927738
SIM,1909,36,50-100,1945,2
STAT,1905,64,na,1969,3260.2466826204727
STAT,1824,33,20-24,1857,5.060970307301511
STAT,1983,17,35-39,2000,6.850404647995374
STAT,1975,30,na,2005,5875.965421964069
STAT,1896,20,40-44,1916,3.195272587416357
STAT,1874,49,45-49,1923,0.27299996674689153
SIM,1865,35,25-29,1900,1
STAT,1879,90,na,1969,293.65888466623
SIM,1906,26,50-100,1932,1
STAT,1797,98,na,1895,0.9672582610192607
SIM,1835,21,30-34,1856,34
SIM,1914,41,30-34,1955,1
STAT,1856,51,20-24,1907,6.528091615604848E-4
STAT,1940,28,35-39,1968,17.665336803595956
STAT,1793,84,na,1877,111.73444353550536
SIM,1841,49,35-39,1890,1
STAT,1969,20,35-39,1989,13.62850886560822
SIM,1869,32,40-44,1901,5
STAT,1907,25,35-39,1932,16.494788232988935
SIM,1913,28,na,1941,4652
STAT,1913,23,45-49,1936,1.3078684198826223
STAT,1905,32,25-29,1937,9.823672940027206
SIM,1827,38,20-24,1865,2
SIM,1946,27,40-44,1973,12
SIM,1841,41,25-29,1882,1
STAT,1930,43,15-19,1973,0.0023284525084663055
STAT,1811,48,45-49,1859,0.7233583148124701
STAT,1855,38,30-34,1893,4.512420805779602
SIM,1913,32,25-29,1945,9
STAT,1926,30,40-44,1956,5.465880557232467
SIM,1875,32,50-100,1907,5
SIM,1777,82,na,1859,269
SIM,1903,18,30-34,1921,7
STAT,1956,34,20-24,1990,3.7918646818601074
STAT,2008,0,na,2008,7152.95765185545
STAT,1938,27,40-44,1965,5.33167963910983
SIM,1843,34,35-39,1877,6
STAT,1971,24,45-49,1995,1.6489383832320035
SIM,1853,28,20-24,1881,13
STAT,1845,28,20-24,1873,9.553068684984515
STAT,1817,55,na,1872,1749.2873912702614
SIM,1937,26,25-29,1963,130
STAT,1805,59,na,1864,1239.8693023720318
STAT,1813,41,na,1854,1492.7239089211057
STAT,1835,34,35-39,1869,7.884557999865391
SIM,1845,43,50-100,1888,4
STAT,1880,110,na,1990,0.0293455937818011
SIM,1904,83,na,1987,1789
STAT,1850,23,20-24,1873,84.53658166666122
STAT,1928,42,20-24,1970,0.025981409070187495
SIM,1839,45,25-29,1884,1
STAT,1945,31,40-44,1976,5.031621047928554
STAT,1982,30,15-19,2012,0.21295466342121736
STAT,1930,68,na,1998,4593.336657614577
STAT,1929,26,25-29,1955,95.1128373162274
SIM,1794,78,na,1872,138
STAT,1937,43,25-29,1980,0.08303844859662288
STAT,1886,100,na,1986,21.024684720405407
SIM,1974,19,40-44,1993,1
STAT,1862,23,50-100,1885,0.4036494072595229
STAT,1911,20,30-34,1931,31.671796895269594
SIM,1963,16,25-29,1979,116
STAT,1871,94,na,1965,72.88762178831958
STAT,1968,31,50-100,1999,1.2154856973627057
STAT,1956,48,25-29,2004,0.08402249698793353
STAT,1962,46,20-24,2008,0.017039432267486974
SIM,1910,41,35-39,1951,1
STAT,1858,54,35-39,1912,0.0075374786343257736
STAT,1951,47,15-19,1998,5.265544713732883E-4
STAT,1946,39,30-34,1985,2.3983107482878845
SIM,1790,64,na,1854,701
STAT,1850,45,40-44,1895,0.17799821064136898
STAT,1906,46,25-29,1952,0.05483373485512954
SIM,1938,19,30-34,1957,14
STAT,1964,17,40-44,1981,2.033059232359397
SIM,1865,38,40-44,1903,2
STAT,1955,12,na,1967,6017.972012934525
SIM,1917,31,30-34,1948,36
STAT,1959,26,na,1985,5682.099520396534
SIM,1836,62,na,1898,1118
STAT,1922,39,45-49,1961,0.8929087859179445
STAT,1973,1,na,1974,5876.968110623146
STAT,1929,29,40-44,1958,6.7256960376701045
SIM,1907,94,na,2001,276
STAT,1882,49,30-34,1931,0.10683618647408598
STAT,1837,31,40-44,1868,3.9784217235263957
STAT,1832,92,na,1924,28.375343169030025
STAT,1833,77,na,1910,608.250019731957
SIM,1930,39,45-49,1969,2
SIM,1889,24,30-34,1913,39
STAT,1906,19,45-49,1925,0.1093398205369769
STAT,1861,24,35-39,1885,5.669364124933055
SIM,1955,8,na,1963,6580
STAT,1884,21,na,1905,2704.8195610134903
STAT,1966,19,40-44,1985,2.014792988970456
STAT,1940,60,na,2000,4170.945168385087
SIM,1930,21,45-49,1951,3
STAT,1888,35,na,1923,3226.412138381783
STAT,1905,34,15-19,1939,0.1354137068927691
STAT,1808,78,na,1886,439.04880564797025
STAT,1939,43,35-39,1982,0.2414572512639996
SIM,1917,7,na,1924,5837
SIM,1937,40,50-100,1977,1
STAT,1893,42,35-39,1935,2.6382155524829143
SIM,1865,42,25-29,1907,1
STAT,1955,16,25-29,1971,66.40865861375991
SIM,1876,91,na,1967,107
SIM,1940,34,35-39,1974,30
STAT,1954,32,20-24,1986,3.5471149826494357
STAT,1878,8,na,1886,3200.9827568250917
STAT,1945,49,40-44,1994,0.20552751824299562
STAT,1872,27,15-19,1899,0.5257515042688053
STAT,1932,34,35-39,1966,14.00487915389531
SIM,1857,40,na,1897,2518
STAT,1948,67,na,2015,4240.438662519683
STAT,1857,84,na,1941,299.00122919653654
SIM,1931,76,na,2007,3739
SIM,1962,32,20-24,1994,5
STAT,1892,72,na,1964,2127.3632335100183
SIM,1954,39,30-34,1993,5
STAT,1804,64,na,1868,1108.002763827588
STAT,1902,41,35-39,1943,0.20597375182044866
STAT,1922,21,45-49,1943,1.492929736925414
SIM,1868,40,na,1908,3060
STAT,1847,16,25-29,1863,5.474313670370732
STAT,1887,22,40-44,1909,2.6950379259409174
STAT,1883,16,35-39,1899,0.621064869613209
STAT,1970,41,50-100,2011,0.17662807982042836
SIM,1928,72,na,2000,3856
STAT,1896,86,na,1982,923.1268845318257
STAT,1822,43,15-19,1865,0.027473361098096193
SIM,1875,0,na,1875,4165
SIM,1930,17,25-29,1947,134
SIM,1890,44,25-29,1934,1
SIM,1928,9,na,1937,6072
STAT,1911,38,30-34,1949,2.0231928723629014
SIM,1888,4,na,1892,3158
STAT,1919,44,45-49,1963,0.20739876620645714
STAT,1980,18,25-29,1998,69.40441220186463
SIM,1845,31,40-44,1876,8
SIM,1957,29,50-100,1986,2
STAT,1894,20,na,1914,3529.57688384768
STAT,1927,26,15-19,1953,0.9936245135335068
STAT,1898,34,na,1932,3690.0171287844987
STAT,1920,15,50-100,1935,0.09773428233325432
SIM,1934,27,na,1961,5864
SIM,1949,36,45-49,1985,2
SIM,1913,37,30-34,1950,1
STAT,1900,47,45-49,1947,0.21218446881234204
STAT,1949,29,50-100,1978,1.3403753182401537
STAT,1780,113,na,1893,1.6873493375196968E-4
STAT,1861,39,45-49,1900,1.893316423891761
STAT,1909,46,50-100,1955,0.240716624522368
SIM,1968,28,30-34,1996,133
STAT,1821,40,40-44,1861,4.538681269366893
STAT,1906,44,35-39,1950,0.20875893651087918
STAT,1922,17,25-29,1939,57.85300683420345
SIM,1932,3,na,1935,5850
STAT,1854,39,na,1893,1900.0895093896138
SIM,1949,17,40-44,1966,4
SIM,1878,26,20-24,1904,28
STAT,1814,63,na,1877,1354.3195124435513
STAT,1906,16,40-44,1922,0.30855821997066224
SIM,1930,13,na,1943,6360
STAT,1950,28,40-44,1978,6.384623630146604
STAT,1900,25,25-29,1925,68.19918769249088
SIM,1917,46,50-100,1963,1
STAT,1966,40,20-24,2006,0.02652829970483712
SIM,1939,20,15-19,1959,11
STAT,1954,37,15-19,1991,0.028225425607867817
SIM,1860,44,na,1904,2308
SIM,1882,24,20-24,1906,156
SIM,1876,54,na,1930,2396
STAT,1950,20,30-34,1970,39.375466324285505
STAT,1847,41,15-19,1888,0.01082307497032963
STAT,1811,93,na,1904,15.047967488767359
SIM,1953,34,45-49,1987,2
STAT,1857,35,25-29,1892,2.612430320642558
SIM,1917,10,na,1927,5798
STAT,1927,29,30-34,1956,54.73924266525868
STAT,1885,16,45-49,1901,0.07537801651005634
STAT,1912,50,na,1962,4041.711973906447
SIM,1987,10,na,1997,6558
STAT,1852,54,40-44,1906,0.00965266164637021
SIM,1971,34,20-24,2005,8
STAT,1797,77,na,1874,418.1896134528347
STAT,1913,20,40-44,1933,3.784486973061522
STAT,1916,38,45-49,1954,0.8017469374616965
SIM,1989,22,15-19,2011,2
SIM,1977,11,na,1988,6241
STAT,1793,63,na,1856,872.4511864
STAT,1856,54,25-29,1910,0.0030328042747317313
STAT,1967,32,30-34,1999,23.15099032380148
STAT,1877,72,na,1949,1516.0357778066834
STAT,1964,46,30-34,2010,0.13511271436921818
STAT,1916,64,na,1980,3851.4616537450665
STAT,1945,34,45-49,1979,2.0194667563523296
STAT,1903,110,na,2013,0.055330187071696645
STAT,1843,92,na,1935,41.790229069431874
STAT,1861,48,20-24,1909,0.011368227292417089
SIM,1904,27,25-29,1931,122
STAT,1934,75,na,2009,3918.6385070873303
SIM,1871,21,40-44,1892,10
STAT,1855,15,50-100,1870,0.0501717770305377
STAT,1928,47,15-19,1975,5.424136879133433E-4
STAT,1820,49,25-29,1869,0.057154771099043725
SIM,1829,26,25-29,1855,6
STAT,1860,18,45-49,1878,0.06965960015114522
STAT,1912,91,na,2003,554.0235513530516
SIM,1850,18,na,1868,2129
STAT,1896,23,45-49,1919,1.0596331656580986
STAT,1971,38,50-100,2009,0.6316107395487615
STAT,1953,16,15-19,1969,63.375355480493695
SIM,1935,29,30-34,1964,125
STAT,1982,21,50-100,2003,1.0724192675545345
STAT,1863,21,40-44,1884,2.1602093648440635
SIM,1893,25,35-39,1918,24
STAT,1910,29,50-100,1939,1.1024352239651698
STAT,1877,52,40-44,1929,0.012570585562475188
SIM,1935,38,20-24,1973,1
STAT,1931,24,15-19,1955,7.9194586184928255
SIM,1962,28,25-29,1990,23
SIM,1915,31,20-24,1946,3
STAT,1954,28,25-29,1982,94.26412364960503
SIM,1830,78,na,1908,514
STAT,1905,37,30-34,1942,1.921442826646935
SIM,1832,36,25-29,1868,6
STAT,1824,36,25-29,1860,4.520366439834956
SIM,1904,49,45-49,1953,1
STAT,1971,21,40-44,1992,4.932509307938003
STAT,1868,68,na,1936,1694.4159646596568
SIM,1937,23,20-24,1960,228
STAT,1885,25,35-39,1910,11.182324223804962
STAT,1941,41,25-29,1982,0.08836301506090855
STAT,1954,52,na,2006,5359.9854784201
STAT,1932,31,30-34,1963,24.19052643885524
STAT,1934,26,50-100,1960,1.5467178497276288
SIM,1867,32,30-34,1899,35
SIM,1934,68,na,2002,4462
STAT,1937,67,na,2004,3598.432628449293
STAT,1917,42,45-49,1959,0.20044444636876693
SIM,1932,30,30-34,1962,8
STAT,1989,19,50-100,2008,0.6188868659830211
SIM,1950,28,45-49,1978,8
STAT,1953,19,30-34,1972,17.004844223434148
STAT,1967,26,45-49,1993,2.5023589609229298
STAT,1932,36,25-29,1968,1.5284759719668577
SIM,1869,20,35-39,1889,18
STAT,1942,28,45-49,1970,2.0918957083487526
SIM,1858,41,40-44,1899,2
STAT,1979,28,25-29,2007,104.98880322188151
STAT,1953,23,50-100,1976,0.9213296472640334
STAT,1769,108,na,1877,0.007325403561908269
STAT,1907,31,20-24,1938,2.6461904336498034
STAT,1833,49,35-39,1882,0.10306069457399471
SIM,1892,41,30-34,1933,4
SIM,1941,21,20-24,1962,3
SIM,1848,21,50-100,1869,1
SIM,1816,74,na,1890,783
STAT,1850,26,25-29,1876,51.61675894690255
SIM,1833,21,20-24,1854,122
STAT,1918,32,35-39,1950,11.204307862295325
STAT,1947,41,na,1988,5024.607297148124
SIM,1903,15,15-19,1918,14
SIM,1940,31,30-34,1971,21
SIM,1898,18,25-29,1916,21
STAT,1931,27,30-34,1958,58.391911808426904
SIM,1943,23,50-100,1966,1
SIM,1819,44,45-49,1863,1
STAT,1851,36,na,1887,1907.9943764725788
SIM,1882,46,40-44,1928,1
STAT,1874,46,40-44,1920,0.20283803120703797
STAT,1869,52,45-49,1921,0.016132851440688198
STAT,1922,36,40-44,1958,1.9667135760067875
SIM,1846,40,na,1886,1586
STAT,1859,32,30-34,1891,16.05080047658105
STAT,1842,59,na,1901,1495.544706516179
SIM,1926,32,35-39,1958,28
SIM,1849,15,25-29,1864,11
SIM,1865,91,na,1956,70
STAT,1885,86,na,1971,603.7976096431266
STAT,1896,16,20-24,1912,27.089723829578926
STAT,1834,53,35-39,1887,0.00789773254238851
SIM,1961,19,30-34,1980,36
STAT,1881,72,na,1953,1405.7650714719987
SIM,1948,24,35-39,1972,1
STAT,1859,26,45-49,1885,1.0458343921229185
SIM,1913,65,na,1978,3819
SIM,1846,18,na,1864,1953
STAT,1850,48,45-49,1898,0.23989659948487815
STAT,1849,15,20-24,1864,17.114878703216867
SIM,1842,28,45-49,1870,3
STAT,1911,23,35-39,1934,10.282580260645902
SIM,1889,27,35-39,1916,20
SIM,1889,38,50-100,1927,5
STAT,1933,21,20-24,1954,170.80476838423758
STAT,1924,38,40-44,1962,2.0345266133043127
STAT,1857,38,40-44,1895,3.915030918768042
STAT,1924,30,30-34,1954,21.30272102208103
SIM,1897,53,na,1950,3190
SIM,1941,15,35-39,1956,5
STAT,1872,109,na,1981,0.042179062968194916
SIM,1932,38,40-44,1970,8
SIM,1927,44,45-49,1971,1
STAT,1943,32,45-49,1975,1.9631162801323176
STAT,1834,52,50-100,1886,0.014132008009355707
STAT,1836,22,35-39,1858,7.01131895336106
STAT,1981,30,45-49,2011,2.591297552740432
SIM,1952,22,35-39,1974,35
STAT,1858,51,30-34,1909,0.0053846377279505924
SIM,1889,33,20-24,1922,4
STAT,1842,81,na,1923,416.1319331526241
STAT,1909,22,40-44,1931,3.610447853598377
SIM,1951,32,45-49,1983,1
STAT,1972,35,50-100,2007,0.640252036757091
SIM,1844,22,35-39,1866,14
STAT,1882,44,25-29,1926,0.7140784379854721
STAT,1986,14,na,2000,6457.0282490426325
STAT,1935,23,50-100,1958,1.0342738360386428
STAT,1854,18,50-100,1872,0.047464886746554615
SIM,1907,32,na,1939,4545
STAT,1860,52,25-29,1912,0.0032769187499502124
STAT,1948,26,na,1974,4971.054749295128
STAT,1944,12,na,1956,4878.705338974589
STAT,1962,49,25-29,2011,0.08110822215454659
STAT,1787,99,na,1886,0.29256127109294405
STAT,1879,39,30-34,1918,6.35760484413512
SIM,1915,83,na,1998,1952
STAT,1899,111,na,2010,0.020404896692462232
SIM,1867,35,35-39,1902,14
STAT,1933,15,35-39,1948,6.5154529016701686
SIM,1783,78,na,1861,519
SIM,1917,22,40-44,1939,9
STAT,1807,93,na,1900,14.29133472218689
SIM,1887,39,30-34,1926,1
SIM,1910,36,na,1946,3643
SIM,1821,40,45-49,1861,1
STAT,1834,28,45-49,1862,1.3191106321819004
STAT,1925,42,40-44,1967,0.34936028602418506
STAT,1908,18,40-44,1926,0.31269112072317445
SIM,1914,28,35-39,1942,19
STAT,1843,22,50-100,1865,0.5135910040473535
STAT,1930,46,40-44,1976,0.2402383803003333
STAT,1822,77,na,1899,710.2076600266206
SIM,1850,45,na,1895,1531
STAT,1964,29,35-39,1993,21.8951211127862
STAT,1910,17,45-49,1927,0.11434858221267101
SIM,1835,40,na,1875,2238
STAT,1939,40,30-34,1979,0.15396767498807976
STAT,1868,29,15-19,1897,0.4994552902285972
STAT,1921,49,50-100,1970,0.2924212213429784
STAT,1827,48,50-100,1875,0.3069272934724858
STAT,1941,25,35-39,1966,17.943648515719907
SIM,1970,25,50-100,1995,4
STAT,1861,31,35-39,1892,9.755685924074823
SIM,1860,37,50-100,1897,2
STAT,1887,37,15-19,1924,0.07262598705088553
SIM,1972,30,50-100,2002,1
STAT,1894,5,na,1899,3887.819978015708
SIM,1945,36,25-29,1981,2
SIM,1938,57,na,1995,3940
STAT,1987,28,20-24,2015,30.18879802185997
SIM,1857,18,25-29,1875,16
SIM,1892,86,na,1978,1025
STAT,1950,23,35-39,1973,12.886638766054444
SIM,1871,17,na,1888,2242
SIM,1900,22,35-39,1922,13
STAT,1895,42,45-49,1937,0.1559302456793182
SIM,1834,43,35-39,1877,3
SIM,1858,35,na,1893,2581
STAT,1842,28,40-44,1870,2.8302096590276404
STAT,1870,34,40-44,1904,4.89174442645162
STAT,1901,19,45-49,1920,0.10502642965081727
STAT,1841,41,20-24,1882,0.1486154131200566
STAT,1873,31,15-19,1904,0.1685118417327943
STAT,1849,18,25-29,1867,5.3744842374846264
STAT,1894,34,50-100,1928,1.3476485321923577
SIM,1851,62,na,1913,2246
STAT,1921,48,40-44,1969,0.20446940463981228
SIM,1850,28,40-44,1878,5
STAT,1880,47,30-34,1927,0.11785771953613082
SIM,1913,2,na,1915,5179
STAT,1835,41,35-39,1876,1.3715952771272983
STAT,1826,43,35-39,1869,1.3372166537525683
STAT,1877,35,na,1912,2855.080788371588
STAT,1949,25,50-100,1974,1.3428713202804305
STAT,1844,47,45-49,1891,0.19647546952315528
SIM,1959,15,45-49,1974,2
STAT,1921,17,20-24,1938,178.27830663714542
STAT,1856,73,na,1929,1045.7559712305595
STAT,1831,38,na,1869,2091.633833788706
STAT,1857,42,25-29,1899,0.5764669983032744
STAT,1937,36,25-29,1973,1.137882124265468
STAT,1951,32,40-44,1983,5.481764257075182
STAT,1980,30,40-44,2010,6.397858801985227
SIM,1939,16,30-34,1955,18
STAT,1850,30,20-24,1880,3.2659547937110833
STAT,1864,60,na,1924,1965.2372302007898
STAT,1831,25,15-19,1856,0.47983361740158814
STAT,1826,30,15-19,1856,0.15147376300574433
SIM,1867,1,na,1868,3961
STAT,1917,49,na,1966,4402.580519895998
STAT,1930,24,20-24,1954,163.38363896092855
STAT,1864,29,30-34,1893,25.763017865667575
STAT,1914,23,50-100,1937,0.7737717958129696
SIM,1896,52,na,1948,3377
STAT,1932,18,35-39,1950,6.397017788374094
STAT,1862,52,35-39,1914,0.008340006019823896
STAT,1954,11,na,1965,5604.996638596515
SIM,1907,6,na,1913,4880
SIM,1945,27,na,1972,4746
STAT,2003,12,na,2015,6880.279103906211
STAT,1943,9,na,1952,4830.235859129258
STAT,1884,41,30-34,1925,1.3168072491004386
STAT,1912,71,na,1983,3111.302611606414
STAT,1815,51,20-24,1866,0.0014770170030482227
SIM,1923,35,35-39,1958,2
STAT,1833,46,30-34,1879,0.08137693065252807
SIM,1876,38,na,1914,2605
STAT,1897,87,na,1984,830.1661692513777
STAT,1919,19,30-34,1938,15.45756237436748
STAT,1940,46,25-29,1986,0.06483303676386205
STAT,1942,48,na,1990,4596.543818813116
STAT,1831,47,35-39,1878,0.12970980712509922
SIM,1884,89,na,1973,226
STAT,1915,35,35-39,1950,2.847121050740223
STAT,1927,38,20-24,1965,0.3777689066811108
SIM,1833,43,na,1876,1604
SIM,1858,44,35-39,1902,8
SIM,1932,33,35-39,1965,2
STAT,1874,31,20-24,1905,3.206572032777171
STAT,1809,51,35-39,1860,0.02124443095217263
SIM,1987,25,20-24,2012,2
STAT,1984,3,na,1987,6447.632194363809
STAT,1809,89,na,1898,48.82674806137066
STAT,1963,26,25-29,1989,96.96383431452334
STAT,1839,61,na,1900,1481.9210323631062
STAT,1967,43,30-34,2010,0.1912264985162246
STAT,1834,25,40-44,1859,3.6366934654075656
STAT,1947,43,30-34,1990,0.1724417264317655
SIM,1898,37,40-44,1935,3
SIM,1889,82,na,1971,1589
STAT,1907,37,40-44,1944,1.6043237843072455
STAT,1943,49,30-34,1992,0.11282113676802748
STAT,1848,44,25-29,1892,0.673099741236888
STAT,1896,19,25-29,1915,8.591393111366962
STAT,1840,23,15-19,1863,3.3413732561713316
STAT,1854,104,na,1958,0.09729102816999556
STAT,1884,15,na,1899,2893.1288469767655
STAT,1920,17,15-19,1937,58.735874009786656
SIM,1868,41,25-29,1909,5
STAT,1971,35,45-49,2006,1.028361907580254
STAT,1979,25,20-24,2004,29.155883198271194
SIM,1945,49,50-100,1994,2
SIM,1843,41,35-39,1884,3
STAT,1928,38,25-29,1966,1.4345473285313608
SIM,1817,51,35-39,1868,1
SIM,1867,42,35-39,1909,6
SIM,1979,17,50-100,1996,2
STAT,1885,32,50-100,1917,1.0546987411654334
SIM,1946,39,35-39,1985,9
STAT,1772,85,na,1857,10.60128760714
STAT,1904,34,20-24,1938,2.5501421418663552
SIM,1884,31,40-44,1915,6
SIM,1852,47,45-49,1899,1
SIM,1912,34,20-24,1946,3
SIM,1900,37,na,1937,3574
STAT,1879,68,na,1947,1841.5068961795891
STAT,1954,46,25-29,2000,0.07891235550851702
STAT,1876,31,40-44,1907,5.194753726363811
SIM,1946,17,15-19,1963,57
STAT,1846,32,50-100,1878,1.1193521144121281
STAT,1938,17,15-19,1955,51.68970436000575
STAT,1859,42,35-39,1901,1.662640135300555
STAT,1935,6,na,1941,6326.757749983588
STAT,1820,46,20-24,1866,0.013021277842041353
SIM,1920,19,20-24,1939,321
STAT,1830,45,50-100,1875,0.23258856856057658
STAT,1917,59,na,1976,4164.354274595623
STAT,1994,15,45-49,2009,0.8323487890345171
SIM,1922,36,50-100,1958,2
SIM,1931,43,50-100,1974,1
STAT,1818,54,40-44,1872,0.012016980313107533
STAT,1913,32,20-24,1945,2.802104247053499
STAT,1912,19,20-24,1931,31.498547219419088
STAT,1860,15,40-44,1875,0.1985344086965495
STAT,1925,19,50-100,1944,0.5193334429767689
SIM,1913,81,na,1994,2345
STAT,1886,31,25-29,1917,12.519390351218878
SIM,1905,30,na,1935,4272
STAT,1953,28,20-24,1981,25.581348203427243
STAT,1951,8,na,1959,5400.909601447628
SIM,1901,31,40-44,1932,3
STAT,1846,45,50-100,1891,0.25642812591876935
STAT,1906,65,na,1971,3251.1779663449056
STAT,1839,71,na,1910,1058.5633356947144
STAT,1984,30,25-29,2014,15.459461645623543
STAT,1875,52,30-34,1927,0.007061191717730887
SIM,1936,38,25-29,1974,3
SIM,1842,25,40-44,1867,10
SIM,1837,21,40-44,1858,10
STAT,1989,19,40-44,2008,2.3105115281952293
STAT,1857,28,50-100,1885,0.5879680343697931
SIM,1962,40,40-44,2002,1
STAT,1885,32,35-39,1917,11.657359468225087
STAT,1877,29,na,1906,2844.413804878931
SIM,1842,20,na,1862,2625
STAT,1938,39,35-39,1977,2.8321367475543284
STAT,1896,35,15-19,1931,0.08640852995411655
STAT,1830,41,45-49,1871,1.458915139661723
STAT,1823,32,50-100,1855,2.5316117821046564
STAT,1928,17,30-34,1945,17.723782474934726
STAT,1965,46,50-100,2011,0.33979745446432136
SIM,1894,31,25-29,1925,4
SIM,1915,37,40-44,1952,3
STAT,1986,20,na,2006,6028.9927955137
SIM,1893,32,35-39,1925,34
STAT,1834,40,na,1874,2373.0785592589887
SIM,1860,23,na,1883,2773
SIM,1896,27,50-100,1923,2
STAT,1842,75,na,1917,792.1970469609698
SIM,1935,26,15-19,1961,2
STAT,1819,73,na,1892,790.7016945101697
STAT,1891,48,45-49,1939,0.18749088049568507
SIM,1961,28,20-24,1989,57
STAT,1911,41,50-100,1952,0.1302574221147037
STAT,1913,44,15-19,1957,0.0017234315025203104
STAT,1824,40,20-24,1864,0.23374513326932236
SIM,1869,68,na,1937,1040
SIM,1846,39,30-34,1885,4
STAT,1838,39,30-34,1877,5.4570925258167025
SIM,1878,29,25-29,1907,1
STAT,1929,40,50-100,1969,0.17607267323293904
STAT,1860,88,na,1948,127.68865521179468
SIM,1825,56,na,1881,1518
STAT,1924,33,35-39,1957,12.292902042897952
SIM,1971,26,25-29,1997,6
STAT,1943,28,50-100,1971,1.2228880586238475
SIM,1905,18,40-44,1923,1
STAT,1965,44,35-39,2009,0.30050057147805437
STAT,1831,44,30-34,1875,1.0739718001478806
STAT,1872,115,na,1987,1.0772191523541664E-4
STAT,1881,37,20-24,1918,0.8580543296354703
STAT,1903,40,50-100,1943,0.12180789725728676
SIM,1826,73,na,1899,776
SIM,1934,33,45-49,1967,1
STAT,1955,19,40-44,1974,2.1414139535512353
SIM,1850,23,25-29,1873,59
STAT,1861,40,25-29,1901,0.6223066681575531
STAT,1930,36,15-19,1966,0.02893689916777057
STAT,1980,33,20-24,2013,3.9807863113763453
SIM,1867,20,25-29,1887,65
STAT,1823,40,15-19,1863,0.015047101294460819
SIM,1951,28,50-100,1979,3
SIM,1975,27,40-44,2002,8
STAT,1940,46,50-100,1986,0.2764408670405375
STAT,1846,41,na,1887,2449.424754137089
SIM,1806,59,na,1865,1247
SIM,1929,19,40-44,1948,5
STAT,1922,6,na,1928,5350.818708563441
STAT,1925,45,45-49,1970,0.30526464673188936
STAT,1900,37,40-44,1937,1.51303373093289
SIM,1886,16,na,1902,2312
STAT,1826,40,30-34,1866,0.8890562538166935
STAT,1926,33,45-49,1959,2.1940224516353917
SIM,1964,18,50-100,1982,1
STAT,1964,51,na,2015,5483.573362043
STAT,1811,45,40-44,1856,0.5519805266045221
STAT,1867,107,na,1974,0.11685839799993351
STAT,1941,22,30-34,1963,34.285818405776084
SIM,1937,38,30-34,1975,3
STAT,1837,46,15-19,1883,3.0455139841172496E-4
STAT,1891,45,40-44,1936,0.13911427386410427
SIM,1831,32,50-100,1863,2
STAT,1877,15,35-39,1892,0.6617554989274738
STAT,1963,0,na,1963,5807.403280437646
STAT,1820,43,40-44,1863,2.690559415790414
STAT,1931,15,25-29,1946,65.77779454386238
SIM,1896,36,na,1932,3769
STAT,1980,33,45-49,2013,2.5681215875408854
SIM,1845,41,45-49,1886,3
STAT,1836,40,25-29,1876,0.7135272480432645
STAT,1853,51,40-44,1904,0.010531677887628186
STAT,1901,16,40-44,1917,0.2963857817195768
STAT,1859,20,25-29,1879,60.87255870279653
STAT,1892,56,na,1948,2950.1966774297866
STAT,1929,38,30-34,1967,2.697727741211543
STAT,1938,27,na,1965,4285.150758374905
STAT,1941,49,20-24,1990,0.01358707877241168
STAT,1852,30,40-44,1882,4.322211385704723
SIM,1864,90,na,1954,128
SIM,1911,94,na,2005,309
SIM,1843,75,na,1918,656
STAT,1880,49,na,1929,2694.6363057397753
SIM,1941,60,na,2001,3608
STAT,1955,28,30-34,1983,60.25872328642166
SIM,1923,32,30-34,1955,33
SIM,1852,44,40-44,1896,2
STAT,1850,33,25-29,1883,10.916355879368483
SIM,1920,51,na,1971,4026
SIM,1958,24,40-44,1982,7
STAT,1883,32,25-29,1915,11.564845532946624
SIM,1941,27,40-44,1968,11
SIM,1901,34,45-49,1935,4
STAT,1877,31,50-100,1908,1.1043972195140765
STAT,1904,46,15-19,1950,3.74985178794812E-4
SIM,1860,30,40-44,1890,5
STAT,1933,27,40-44,1960,7.14546066615238
SIM,1938,17,40-44,1955,4
SIM,1976,25,45-49,2001,4
SIM,1884,34,35-39,1918,16
SIM,1840,18,30-34,1858,3
SIM,1857,18,na,1875,2795
STAT,1924,76,na,2000,3204.1205040839154
STAT,1858,41,15-19,1899,0.012489051690608448
STAT,1915,32,30-34,1947,18.52115468348665
STAT,1844,44,40-44,1888,1.8780670013814316
STAT,1855,47,20-24,1902,0.010163143871155736
STAT,1940,43,20-24,1983,0.02147832723228831
SIM,1859,25,35-39,1884,12
STAT,1876,34,35-39,1910,11.977939686253613
SIM,1963,28,30-34,1991,8
STAT,1958,41,na,1999,5858.636157514635
STAT,1926,26,na,1952,5199.265232868255
STAT,1804,51,45-49,1855,0.06815629450978763
SIM,1891,32,25-29,1923,20
SIM,1963,19,40-44,1982,2
SIM,1945,33,na,1978,4745
STAT,1826,40,40-44,1866,1.7393998501636518
STAT,1993,17,40-44,2010,2.3224143245985247
SIM,1948,39,45-49,1987,1
STAT,1862,30,25-29,1892,10.055789652977799
STAT,1829,93,na,1922,21.40991906244517
STAT,1926,38,15-19,1964,0.02705142021797653
SIM,1945,7,na,1952,4818
SIM,1834,40,30-34,1874,3
SIM,1951,25,45-49,1976,8
SIM,1841,46,30-34,1887,1
SIM,1883,22,25-29,1905,64
STAT,1843,101,na,1944,0.5725528507637524
SIM,1935,50,na,1985,6082
STAT,1870,72,na,1942,1436.8260798272834
SIM,1835,44,50-100,1879,2
STAT,1938,42,50-100,1980,0.13905444612974568
STAT,1842,23,25-29,1865,55.16353960335057
STAT,1951,35,45-49,1986,0.9668519913401921
STAT,1963,30,20-24,1993,3.6494340249271024
SIM,1879,19,15-19,1898,15
STAT,1818,56,na,1874,1061.4712098506113
STAT,1973,32,15-19,2005,0.19550513886655257
STAT,1937,40,20-24,1977,0.020625984094189486
STAT,1928,35,20-24,1963,0.38512635346767776
SIM,1892,44,35-39,1936,1
SIM,1874,29,40-44,1903,14
STAT,1843,35,50-100,1878,1.4683053348575026
STAT,1962,35,20-24,1997,0.4022793065344373
SIM,1927,45,50-100,1972,3
STAT,1952,30,45-49,1982,2.220768293702953
STAT,1884,44,35-39,1928,2.036857924473421
SIM,1913,25,25-29,1938,92
SIM,1800,80,na,1880,409
STAT,1824,62,na,1886,1177.25658354628
STAT,1824,43,25-29,1867,0.8986201276580648
STAT,1898,13,na,1911,4021.6454474305556
STAT,1978,36,50-100,2014,0.6818798665982311
SIM,1878,40,45-49,1918,6
SIM,1966,36,na,2002,5850
STAT,1947,46,35-39,1993,0.1747661962135198
SIM,1868,20,30-34,1888,31
SIM,1847,41,na,1888,2412
STAT,1964,49,35-39,2013,0.19378378835547783
STAT,1824,53,50-100,1877,0.019419845558104682
STAT,1863,36,15-19,1899,0.05693887611438428
SIM,1908,43,45-49,1951,1
STAT,1895,48,na,1943,3337.847279434043
SIM,1869,40,50-100,1909,1
STAT,1842,91,na,1933,44.59230734478657
SIM,1851,35,50-100,1886,1
STAT,1889,52,na,1941,3046.8076056571226
STAT,1901,46,50-100,1947,0.2245814880464329
STAT,1907,82,na,1989,1660.244700339359
STAT,1850,30,50-100,1880,1.1070482884735526
SIM,1832,42,na,1874,2084
STAT,1919,45,50-100,1964,0.2843794638761866
STAT,1922,38,30-34,1960,2.3898642895871025
SIM,1930,38,30-34,1968,7
STAT,1956,45,20-24,2001,0.017636103044495952
STAT,1830,49,30-34,1879,0.08701638791488905
SIM,1947,36,35-39,1983,4
STAT,1967,40,50-100,2007,0.17648826093988035
SIM,1961,40,35-39,2001,1
STAT,1859,16,na,1875,2464.025843899433
SIM,1903,27,20-24,1930,40
STAT,1902,35,na,1937,3908.8095815711304
STAT,1959,37,15-19,1996,0.029865735921202563
STAT,1910,86,na,1996,1160.3130989804297
SIM,1877,2,na,1879,3645
SIM,1921,35,25-29,1956,1
STAT,1952,28,15-19,1980,0.9800609006406615
SIM,1844,18,15-19,1862,12
SIM,1946,44,na,1990,4600
STAT,1836,18,15-19,1854,12.131139514155622
STAT,1841,44,15-19,1885,0.012435803679089568
STAT,1892,19,40-44,1911,0.26313849769460557
STAT,1913,35,25-29,1948,1.132599745179923
STAT,1913,51,na,1964,4087.6034021423297
SIM,1967,12,na,1979,5779
STAT,1855,52,50-100,1907,0.012782450494821702
SIM,1871,31,45-49,1902,1
STAT,1870,37,45-49,1907,2.268038042702797
SIM,1824,33,25-29,1857,3
SIM,1955,11,na,1966,6578
STAT,1860,94,na,1954,18.58922382598892
SIM,1960,28,15-19,1988,3
STAT,1906,28,35-39,1934,16.18074442643988
STAT,1875,37,50-100,1912,1.4642003939512265
SIM,1970,36,50-100,2006,1
STAT,1857,0,na,1857,3554.7936758690635
STAT,1905,25,25-29,1930,71.13636787902372
STAT,1893,47,40-44,1940,0.14021324849162792
STAT,1930,49,35-39,1979,0.1948207504350123
STAT,1881,5,na,1886,2980.8983206657904
STAT,1857,90,na,1947,70.8627434753123
SIM,1776,81,na,1857,356
SIM,1910,15,na,1925,4001
SIM,1883,3,na,1886,2907
STAT,1907,15,50-100,1922,0.08357346876855484
SIM,1936,35,20-24,1971,1
STAT,1936,45,20-24,1981,0.012707820432845095
STAT,1805,54,30-34,1859,0.020413505546275003
STAT,1967,46,35-39,2013,0.19380418215735604
STAT,1934,50,na,1984,5856.603145242943
STAT,1971,23,na,1994,5353.576971358419
SIM,1820,79,na,1899,877
STAT,1896,30,45-49,1926,2.679449986135091
SIM,1835,31,35-39,1866,4
STAT,1825,42,na,1867,1932.5497967853396
STAT,1874,113,na,1987,0.001054582191838401
STAT,1953,10,na,1963,5485.392181011669
SIM,1861,39,na,1900,1847
SIM,1826,57,na,1883,1392
STAT,1907,15,30-34,1922,2.718924070055438
SIM,1953,18,20-24,1971,341
STAT,1869,45,50-100,1914,0.27722109432811803
SIM,1984,20,25-29,2004,6
SIM,1895,51,na,1946,3256
STAT,1915,44,25-29,1959,0.0827066458653501
SIM,1877,17,15-19,1894,15
SIM,1983,15,50-100,1998,1
STAT,1869,17,15-19,1886,6.724346984834209
STAT,1919,9,na,1928,5075.673082267854
SIM,1938,29,35-39,1967,2
STAT,1890,70,na,1960,2142.7751850462423
STAT,1882,88,na,1970,420.02112602485374
STAT,1831,46,20-24,1877,0.011261340741941687
STAT,1909,51,na,1960,3850.530075892331
STAT,1830,41,35-39,1871,1.7651695294389338
STAT,1976,17,45-49,1993,0.770193070557063
SIM,1969,27,20-24,1996,3
STAT,1835,50,25-29,1885,0.002343644654343594
STAT,1965,46,25-29,2011,0.07969191058253182
STAT,1872,34,15-19,1906,0.16360947142079252
STAT,1962,25,50-100,1987,1.479450445214092
STAT,1862,52,45-49,1914,0.014058867270960932
STAT,1899,29,na,1928,3746.29312906793
SIM,1980,5,na,1985,6010
STAT,1857,89,na,1946,94.42322710173795
SIM,1868,19,15-19,1887,7
STAT,1827,31,35-39,1858,18.431637821630922
STAT,1979,34,na,2013,6117.84331006277
STAT,1936,48,25-29,1984,0.06054301232806409
SIM,1895,32,45-49,1927,6
STAT,1892,26,40-44,1918,4.347755812373771
SIM,1854,54,na,1908,2256
STAT,1965,41,30-34,2006,0.19169786968132388
STAT,1870,56,na,1926,2320.540953423082
SIM,1972,31,na,2003,5770
STAT,1873,52,20-24,1925,8.650010186080258E-4
SIM,1870,16,na,1886,3289
STAT,1949,43,40-44,1992,0.3483300847958656
STAT,1887,32,45-49,1919,2.2553253727014626
STAT,1804,51,35-39,1855,0.04043170018929039
SIM,1927,14,na,1941,5242
STAT,1941,7,na,1948,4725.3802262969575
STAT,1866,36,40-44,1902,4.704984716756746
STAT,1899,16,25-29,1915,8.981501483926776
SIM,1869,42,45-49,1911,1
SIM,1885,15,35-39,1900,1
STAT,1902,19,na,1921,4096.238378419593
STAT,1900,30,50-100,1930,1.4790288487331436
SIM,1975,34,40-44,2009,3
STAT,1946,19,50-100,1965,0.4792327968011105
STAT,1994,8,na,2002,6544.9894767584765
SIM,1861,21,35-39,1882,8
STAT,1882,51,25-29,1933,0.004011713180738672
STAT,1884,31,15-19,1915,0.16303979028753315
STAT,1843,76,na,1919,950.6067939106017
STAT,1869,30,35-39,1899,11.409069576047521
SIM,1939,58,na,1997,4532
SIM,1987,18,20-24,2005,3
SIM,1927,28,20-24,1955,44
SIM,1954,10,na,1964,5543
STAT,1919,28,20-24,1947,22.676033524094084
STAT,1902,44,15-19,1946,0.0015426367659264761
STAT,1895,47,15-19,1942,3.373640892303149E-4
STAT,1842,20,20-24,1862,67.85726331278518
SIM,1857,22,20-24,1879,134
STAT,1891,47,30-34,1938,0.07751853636970388
STAT,1853,21,35-39,1874,6.914303613780136
STAT,1907,66,na,1973,3240.8687256636254
STAT,1898,32,20-24,1930,4.215907544611149
STAT,1873,19,50-100,1892,0.05742680324886757
STAT,1934,69,na,2003,4749.876298940136
STAT,1863,16,na,1879,2658.838522198266
STAT,1821,76,na,1897,579.4241985185093
STAT,1939,26,30-34,1965,45.497492114221956
SIM,1922,23,50-100,1945,1
SIM,1884,31,30-34,1915,20
SIM,1846,18,25-29,1864,6
STAT,1838,18,25-29,1856,6.446709041893552
STAT,1846,17,50-100,1863,0.06362276927794815
SIM,1960,30,45-49,1990,7
STAT,1943,25,45-49,1968,2.1254138771976203
SIM,1914,82,na,1996,1206
SIM,1980,20,40-44,2000,12
STAT,1876,31,30-34,1907,20.914194421188796
SIM,1775,80,na,1855,10
STAT,1922,33,na,1955,4908.589462461088
SIM,1906,31,na,1937,3679
SIM,1864,74,na,1938,1053
STAT,1920,39,25-29,1959,1.2409188566419223
STAT,1916,58,na,1974,4125.61932360125
SIM,1834,40,40-44,1874,3
STAT,1852,42,25-29,1894,0.6046888882540697
STAT,1966,29,45-49,1995,2.4985109234584475
SIM,1812,44,na,1856,1594
STAT,1863,40,35-39,1903,1.8457488096271897
STAT,1873,53,25-29,1926,0.004107204564973092
SIM,1956,31,30-34,1987,53
SIM,1868,23,35-39,1891,13
SIM,1911,0,na,1911,5254
STAT,1909,46,15-19,1955,3.920462904081469E-4
SIM,1916,25,40-44,1941,5
STAT,1809,95,na,1904,6.1794967937185525
STAT,1883,14,na,1897,2906.4512813951396
SIM,1848,39,40-44,1887,1
SIM,1864,19,30-34,1883,4
STAT,1959,24,50-100,1983,0.9958995357630301
STAT,1829,35,na,1864,2045.5226857172445
STAT,1820,39,20-24,1859,1.0466557999603883
SIM,1848,24,20-24,1872,3
SIM,1879,30,45-49,1909,2
STAT,1874,37,na,1911,2783.46271682061
STAT,1951,25,na,1976,5174.8539416987305
STAT,1849,22,20-24,1871,64.5765721353939
STAT,1947,25,na,1972,4895.143491512495
SIM,1899,33,50-100,1932,7
STAT,1951,44,35-39,1995,0.2866260180192733
SIM,1958,7,na,1965,6233
STAT,1920,28,50-100,1948,1.2551006518641836
SIM,1945,43,na,1988,4670
STAT,1928,65,na,1993,4715.506822308998
STAT,1948,31,30-34,1979,21.221759483858648
STAT,1810,101,na,1911,0.32490582711062554
STAT,1769,114,na,1883,4.4367502554420405E-4
STAT,1905,22,20-24,1927,115.10607685237602
STAT,1884,85,na,1969,656.6586583858335
SIM,1838,39,50-100,1877,1
STAT,1863,31,45-49,1894,1.7668999769813658
STAT,1914,36,50-100,1950,0.4863372724458916
STAT,1956,19,35-39,1975,6.403536454570856
SIM,1907,16,na,1923,4731
SIM,1913,22,20-24,1935,237
SIM,1958,27,45-49,1985,7
STAT,1926,40,45-49,1966,0.23738832169120766
SIM,1824,30,20-24,1854,7
STAT,1917,35,45-49,1952,0.8249382219600142
STAT,1935,36,15-19,1971,0.03103391651326907
SIM,1907,27,40-44,1934,1
STAT,1826,52,25-29,1878,0.002462393774984824
STAT,1939,33,30-34,1972,18.547746319856103
STAT,1930,27,25-29,1957,96.59864832072317
SIM,1964,19,35-39,1983,7
SIM,1960,23,45-49,1983,2
SIM,1925,29,na,1954,5369
STAT,1977,31,30-34,2008,25.05618728800856
STAT,1874,43,15-19,1917,0.016197724884437728
STAT,1832,39,na,1871,1792.7514758076031
SIM,1865,28,50-100,1893,1
SIM,1937,16,20-24,1953,273
SIM,1946,28,na,1974,4323
STAT,1857,20,15-19,1877,3.4728416035097442
SIM,1860,30,30-34,1890,24
SIM,1848,42,na,1890,1724
SIM,1844,76,na,1920,724
STAT,1965,16,30-34,1981,17.56605859710367
STAT,1991,23,50-100,2014,1.0914833795295835
STAT,1857,74,na,1931,997.4898198234783
SIM,1973,16,30-34,1989,43
STAT,1837,41,45-49,1878,1.2953299819782398
STAT,1967,37,45-49,2004,1.0124681765463943
STAT,1860,78,na,1938,726.7243096480157
STAT,1988,3,na,1991,6492.787156544147
STAT,1965,16,50-100,1981,0.5399402159552453
STAT,1898,47,40-44,1945,0.14991778013880805
SIM,1875,37,na,1912,3131
STAT,1859,7,na,1866,2641.2577413798713
SIM,1838,26,50-100,1864,1
SIM,1947,33,30-34,1980,2
SIM,1886,28,50-100,1914,2
SIM,1871,40,35-39,1911,1
SIM,1883,88,na,1971,233
STAT,1929,16,20-24,1945,200.17564558479162
SIM,1924,23,35-39,1947,27
STAT,1981,18,30-34,1999,19.66295972644897
STAT,1894,41,25-29,1935,0.9569757183416397
STAT,1916,23,35-39,1939,11.352486703655003
STAT,1897,20,45-49,1917,1.0824808919145146
STAT,1813,45,15-19,1858,0.0013699518493821652
STAT,1852,30,30-34,1882,17.40131948726256
SIM,1935,69,na,2004,4885
STAT,1941,34,25-29,1975,11.187254470668382
STAT,1945,18,20-24,1963,170.85970085903762
STAT,1888,27,50-100,1915,0.8677904449290446
SIM,1844,86,na,1930,200
STAT,1934,15,40-44,1949,2.194574438229617
STAT,1866,29,40-44,1895,3.18133917418767
SIM,1838,29,30-34,1867,30
STAT,1994,4,na,1998,6549.1799585248455
STAT,1898,25,20-24,1923,18.42144876928778
STAT,1952,23,45-49,1975,1.5607067400482701
STAT,1974,21,30-34,1995,43.46844120575517
STAT,1982,26,30-34,2008,63.93328882360555
SIM,1941,70,na,2011,3159
SIM,1938,26,30-34,1964,74
SIM,1805,58,na,1863,1318
STAT,1806,102,na,1908,0.10062372869401498
STAT,1867,67,na,1934,1708.0538702138354
STAT,1916,20,30-34,1936,34.96725958079945
STAT,1785,109,na,1894,3.511059338072091E-4
STAT,1891,55,na,1946,2949.2174490446064
STAT,1946,47,50-100,1993,0.30113083927626816
SIM,1885,15,na,1900,3321
SIM,1856,44,25-29,1900,2
STAT,1930,49,45-49,1979,0.32841212170404105
STAT,1924,29,na,1953,4996.34342879937
STAT,1932,11,na,1943,6065.383681867386
STAT,1872,22,50-100,1894,0.47254842568359856
STAT,1961,26,15-19,1987,1.0576014574005534
SIM,1874,52,na,1926,2424
STAT,1850,42,15-19,1892,0.014198971588917354
STAT,1989,12,na,2001,6493.183482428817
SIM,1907,26,na,1933,4372
STAT,1981,20,40-44,2001,5.447574433691799
STAT,1963,50,na,2013,5552.143825965146
SIM,1854,45,50-100,1899,2
STAT,1794,79,na,1873,372.437318908461
SIM,1924,20,30-34,1944,84
SIM,1968,16,15-19,1984,1
STAT,1907,28,50-100,1935,1.082358125346317
STAT,1903,25,15-19,1928,0.7508455486236482
SIM,1892,41,40-44,1933,5
SIM,1975,37,45-49,2012,3
SIM,1893,41,25-29,1934,2
STAT,1808,50,15-19,1858,1.2204950489016182E-4
SIM,1836,35,na,1871,1716
SIM,1825,72,na,1897,891
STAT,1905,47,35-39,1952,0.1312931627365012
STAT,1972,24,50-100,1996,0.9748084425717781
SIM,1795,79,na,1874,336
STAT,1953,44,45-49,1997,0.24065776979447
SIM,1918,59,na,1977,3514
SIM,1934,42,35-39,1976,2
STAT,1959,46,na,2005,5782.8848584074
SIM,1857,25,25-29,1882,55
SIM,1993,20,na,2013,6068
STAT,1853,38,na,1891,2334.021157688485
STAT,1880,92,na,1972,210.78219848291482
STAT,1884,41,40-44,1925,2.5762760477156044
SIM,1911,25,15-19,1936,2
STAT,1965,43,20-24,2008,0.026400875521103928
STAT,1846,44,15-19,1890,0.014083650640934342
STAT,1885,41,25-29,1926,0.742537581085899
STAT,1851,42,40-44,1893,1.7814681270066666
SIM,1905,27,30-34,1932,88
STAT,1920,36,20-24,1956,0.333243859316552
SIM,1871,60,na,1931,1654
STAT,1901,34,na,1935,3824.404841907065
STAT,1895,20,35-39,1915,8.818314345140463
STAT,1787,94,na,1881,3.4026803181084837
STAT,1984,28,50-100,2012,1.6377060679679927
STAT,1943,32,na,1975,4718.307720396785
STAT,1790,98,na,1888,0.6269879433236112
STAT,1895,91,na,1986,417.92479545673086
SIM,1868,67,na,1935,2136
SIM,1966,46,na,2012,5764
STAT,1915,41,20-24,1956,0.020552210782932605
SIM,1964,36,30-34,2000,4
STAT,1772,95,na,1867,0.316447744079226
STAT,1938,17,25-29,1955,49.35698239806946
STAT,1834,40,15-19,1874,0.015587395389372477
STAT,1828,49,na,1877,1612.9247099556974
STAT,1800,77,na,1877,469.03715670497184
STAT,1972,24,na,1996,5410.071062895084
STAT,1874,22,na,1896,2794.1801412422406
STAT,1889,36,na,1925,3367.671867958189
SIM,1927,19,30-34,1946,45
SIM,1873,2,na,1875,3807
STAT,1958,31,na,1989,5846.762551268288
STAT,1937,33,20-24,1970,2.784716209152937
SIM,1946,17,25-29,1963,58
STAT,1980,29,25-29,2009,105.80052733226323
STAT,1861,89,na,1950,100.7891076659011
STAT,1974,41,30-34,2015,0.200501681311924
SIM,1945,33,20-24,1978,3
STAT,1818,72,na,1890,558.7819717041334
SIM,1960,32,35-39,1992,19
STAT,1948,34,35-39,1982,12.286139276700125
SIM,1833,31,25-29,1864,19
SIM,1951,22,40-44,1973,16
STAT,1825,52,40-44,1877,0.014166760788361165
STAT,1848,41,20-24,1889,0.17070861666408765
SIM,1893,66,na,1959,2214
STAT,1931,37,35-39,1968,3.6975878978462013
STAT,1904,37,25-29,1941,1.0298779008118235
STAT,1899,14,na,1913,4069.910180617662
STAT,1939,29,35-39,1968,17.408145941166577
SIM,1936,51,na,1987,3867
STAT,1873,50,20-24,1923,8.821274642233831E-4
SIM,1857,36,50-100,1893,2
SIM,1916,28,45-49,1944,3
SIM,1940,48,40-44,1988,1
STAT,1783,110,na,1893,3.6394246699686026E-4
STAT,1963,23,20-24,1986,163.51408058527295
SIM,1971,23,20-24,1994,1
STAT,1951,42,45-49,1993,0.23768765635806466
SIM,1801,81,na,1882,276
SIM,1889,66,na,1955,2633
SIM,1853,68,na,1921,1228
SIM,1947,29,35-39,1976,2
STAT,1921,30,40-44,1951,5.06431926734212
STAT,1852,106,na,1958,0.021792720453511896
STAT,1952,32,35-39,1984,12.882311526488804
STAT,1849,23,na,1872,1989.2125663166316
STAT,1943,22,40-44,1965,4.128792806012248
SIM,1883,15,25-29,1898,9
STAT,1932,48,40-44,1980,0.24619274039679875
SIM,1874,36,40-44,1910,4
STAT,1825,31,25-29,1856,23.14386196518091
STAT,1855,23,na,1878,2110.1606463479056
STAT,1875,15,25-29,1890,6.789513564568906
STAT,1992,16,na,2008,6098.830558259831
SIM,1896,3,na,1899,4089
STAT,1923,17,30-34,1940,16.511280901776207
SIM,1956,34,35-39,1990,20
SIM,1939,38,40-44,1977,5
STAT,1849,25,25-29,1874,39.42947883406573
STAT,1968,37,50-100,2005,0.6234893886572943
STAT,1926,42,35-39,1968,0.2864256517808326
STAT,1834,24,na,1858,2572.2526215110793
STAT,1906,81,na,1987,1768.6752847314065
STAT,1967,34,40-44,2001,5.742922755137809
STAT,1819,57,na,1876,1505.2335522992503
STAT,1870,28,50-100,1898,0.7252316699565371
STAT,1932,41,50-100,1973,0.18406092911173405
STAT,1852,53,na,1905,1997.4410259146482
SIM,1870,30,25-29,1900,25
SIM,1976,37,50-100,2013,1
STAT,1881,41,15-19,1922,0.015441678439161756
STAT,1888,51,na,1939,2934.988581598945
STAT,1873,2,na,1875,3878.4405614302304
SIM,1996,12,na,2008,6936
SIM,1893,36,50-100,1929,8
SIM,1850,61,na,1911,1157
SIM,1954,49,50-100,2003,1
STAT,1908,28,45-49,1936,1.880499175493939
SIM,1879,17,25-29,1896,13
STAT,1957,28,40-44,1985,7.119323146309042
STAT,1885,36,50-100,1921,1.420068191560161
SIM,1837,24,45-49,1861,1
STAT,1852,33,35-39,1885,9.783625683400341
STAT,1859,22,50-100,1881,0.3889544902010296
STAT,1917,44,na,1961,4458.091214298857
SIM,1859,22,30-34,1881,50
STAT,1939,28,na,1967,4345.8589590216425
STAT,1884,51,35-39,1935,0.00986319688830749
SIM,1822,34,50-100,1856,1
SIM,1855,9,na,1864,2237
SIM,1938,28,50-100,1966,3
STAT,1792,83,na,1875,203.3756078900501
STAT,1965,19,35-39,1984,6.041588385754031
SIM,1902,49,25-29,1951,1
STAT,1771,84,na,1855,125.44149999999999
SIM,1910,93,na,2003,317
STAT,1940,41,30-34,1981,0.15595503912197042
SIM,1860,38,na,1898,2352
STAT,1867,52,na,1919,2307.662650569879
STAT,1974,24,35-39,1998,14.226312866162932
SIM,1857,34,na,1891,2446
SIM,1899,31,25-29,1930,27
STAT,1804,58,na,1862,1338.1861485319653
SIM,1915,28,50-100,1943,1
STAT,1859,51,25-29,1910,0.0032717687654785976
STAT,1851,51,30-34,1902,0.004742926003927597
SIM,1882,23,na,1905,3141
STAT,1934,18,45-49,1952,0.7781076984870531
STAT,1941,31,20-24,1972,2.9578829872617054
STAT,1971,13,na,1984,5740.660928653255
STAT,1956,16,30-34,1972,18.618431016406
SIM,1986,23,50-100,2009,1
STAT,1851,21,25-29,1872,54.60310035718064
SIM,1858,19,na,1877,2983
STAT,1860,30,15-19,1890,0.13351929865218146
STAT,1941,47,na,1988,4543.465082309863
STAT,1949,46,45-49,1995,0.30417242262258304
STAT,1842,16,25-29,1858,5.632877357707594
STAT,1841,54,40-44,1895,0.00910263486403675
STAT,1971,32,40-44,2003,5.8305072532323035
SIM,1973,24,na,1997,5424
SIM,1860,42,25-29,1902,2
SIM,1962,39,25-29,2001,2
SIM,1860,33,35-39,1893,14
STAT,1920,48,na,1968,4671.608893724862
STAT,1978,23,50-100,2001,1.0394042251608544
SIM,1882,34,25-29,1916,26
STAT,1874,34,25-29,1908,11.997491825239969
SIM,1850,38,45-49,1888,1
STAT,1918,16,45-49,1934,0.12617297299185595
SIM,1921,52,na,1973,5033
SIM,1900,53,na,1953,3203
STAT,1897,16,15-19,1913,9.18029773524284
STAT,1917,32,40-44,1949,4.729256478192881
SIM,1925,32,40-44,1957,13
STAT,1938,43,na,1981,4389.0260591414135
SIM,1973,19,35-39,1992,9
STAT,1837,50,35-39,1887,0.006509500272847847
STAT,1820,46,45-49,1866,0.2560851211749772
STAT,1887,49,30-34,1936,0.06914517016827428
STAT,1902,45,na,1947,3705.917193504158
SIM,1865,85,na,1950,194
STAT,1865,40,45-49,1905,1.5741103460195884
STAT,1893,28,35-39,1921,14.025526551022423
STAT,1921,45,25-29,1966,0.06930990652378402
STAT,1973,21,50-100,1994,0.9856586147132342
SIM,1981,32,25-29,2013,1
STAT,1923,44,na,1967,4991.000221139581
STAT,1889,67,na,1956,2287.0717999323756
STAT,1962,39,20-24,2001,0.40072874458310453
SIM,1898,18,35-39,1916,3
SIM,1892,44,45-49,1936,1
STAT,1941,15,30-34,1956,14.499981273786362
STAT,1959,20,40-44,1979,5.096024226456599
STAT,1866,21,20-24,1887,74.85238197274418
STAT,1829,38,15-19,1867,0.06311709143040116
SIM,1848,24,30-34,1872,2
SIM,1870,36,50-100,1906,2
STAT,1869,54,20-24,1923,8.020259992070971E-4
STAT,1882,49,40-44,1931,0.1889499492817418
SIM,1887,40,45-49,1927,2
SIM,1877,54,20-24,1931,1
SIM,1874,21,20-24,1895,156
SIM,1791,71,na,1862,630
SIM,1860,40,35-39,1900,3
SIM,1834,93,na,1927,38
STAT,1871,57,na,1928,2307.3103338181636
SIM,1873,40,45-49,1913,2
STAT,1971,37,20-24,2008,0.3969631853192353
STAT,1953,38,25-29,1991,1.4147125752006255
SIM,1881,25,30-34,1906,72
STAT,1925,21,25-29,1946,127.94179205830216
SIM,1842,25,na,1867,2352
STAT,1813,42,20-24,1855,0.5966841382426508
STAT,1850,48,35-39,1898,0.14231154226569595
STAT,1977,34,35-39,2011,14.506045410499707
STAT,1843,34,30-34,1877,20.62802837922135
SIM,1937,70,na,2007,3285
STAT,1847,38,35-39,1885,5.588288654871968
STAT,1858,75,na,1933,926.810293686366
STAT,1852,74,na,1926,1046.3235744095252
SIM,1967,20,40-44,1987,9
SIM,1855,38,35-39,1893,7
SIM,1961,38,25-29,1999,1
STAT,1894,14,na,1908,3818.8503043358573
STAT,1852,32,30-34,1884,17.04366510231675
STAT,1840,26,30-34,1866,25.369801234392526
STAT,1898,28,na,1926,3709.1111549449956
SIM,1851,34,30-34,1885,51
SIM,1897,24,50-100,1921,1
SIM,1860,32,30-34,1892,4
STAT,1893,20,25-29,1913,84.00347474185229
STAT,1855,21,45-49,1876,0.6981904913770417
SIM,1955,26,na,1981,6267
STAT,1781,106,na,1887,0.009922961636436509
SIM,1828,27,50-100,1855,3
SIM,1856,33,na,1889,2110
SIM,1839,26,30-34,1865,39
SIM,1969,33,40-44,2002,16
STAT,1962,31,na,1993,5703.816092087783
SIM,1835,40,25-29,1875,2
STAT,1957,32,25-29,1989,14.335036974564149
SIM,1914,31,50-100,1945,2
STAT,1867,38,35-39,1905,7.583190921258089
STAT,1975,21,35-39,1996,14.38756249287228
STAT,1886,43,40-44,1929,2.7182893588883497
STAT,1975,31,20-24,2006,3.7875061853077376
SIM,1825,44,30-34,1869,3
SIM,1907,31,25-29,1938,15
STAT,1891,61,na,1952,2665.268886926768
STAT,1912,47,25-29,1959,0.05888851879463414
SIM,1837,42,na,1879,2381
STAT,1880,28,25-29,1908,51.56270055448416
STAT,1884,44,45-49,1928,1.6834659865779373
STAT,1960,41,30-34,2001,0.19998947869112685
STAT,1803,73,na,1876,524.3134021331497
STAT,1879,40,45-49,1919,1.8216774323763203
STAT,1851,45,45-49,1896,0.18901255268259584
STAT,1876,40,20-24,1916,0.19137231445272582
SIM,1949,20,20-24,1969,269
STAT,1974,24,25-29,1998,139.55903740633107
SIM,1858,43,30-34,1901,6
STAT,1807,87,na,1894,86.15310982879137
STAT,1927,48,25-29,1975,0.07661220473710813
STAT,1881,103,na,1984,3.993542858999164
SIM,1875,38,35-39,1913,29
STAT,1827,40,25-29,1867,0.8886115928308722
STAT,1900,87,na,1987,882.1559042038543
STAT,1817,44,30-34,1861,3.3635890376820763
SIM,1965,32,25-29,1997,6
SIM,1916,25,50-100,1941,2
SIM,1924,34,na,1958,4824
STAT,1853,26,40-44,1879,3.4800103798943103
STAT,1862,39,15-19,1901,0.05414030968491066
SIM,1816,80,na,1896,399
STAT,1830,34,20-24,1864,2.811308747045803
STAT,1886,25,40-44,1911,3.6712726100586726
STAT,1840,19,40-44,1859,0.18773782284030216
STAT,1896,38,30-34,1934,8.083507282665549
SIM,1983,31,20-24,2014,2
SIM,1920,29,25-29,1949,7
STAT,1973,32,25-29,2005,14.061614287267593
SIM,1861,26,40-44,1887,3
SIM,1969,18,30-34,1987,27
STAT,1917,20,35-39,1937,11.618181832012032
STAT,1855,28,15-19,1883,0.39950715129255804
STAT,1912,29,25-29,1941,74.39126800853359
STAT,1886,49,25-29,1935,0.06865312951043605
STAT,1830,31,40-44,1861,4.78574349885526
SIM,1861,30,25-29,1891,4
STAT,1818,42,25-29,1860,0.8579442527190695
STAT,1844,50,25-29,1894,0.00300519379434684
STAT,1807,101,na,1908,0.279037225000521
STAT,1876,36,35-39,1912,8.478457559023589
SIM,1991,21,30-34,2012,1
STAT,1949,31,35-39,1980,12.509521379075156
STAT,1892,19,na,1911,3633.5324790340032
STAT,1878,83,na,1961,692.2984886215439
SIM,1875,30,25-29,1905,18
SIM,1826,42,25-29,1868,1
STAT,1873,36,na,1909,2789.8586084912445
STAT,1973,26,30-34,1999,58.760970454805516
STAT,1945,69,na,2014,3871.800741342739
STAT,1911,27,na,1938,4219.677755989871
STAT,1947,18,30-34,1965,15.839860390301457
STAT,1879,46,30-34,1925,0.11697700687768466
STAT,1899,20,20-24,1919,109.60559724431926
SIM,1955,18,30-34,1973,44
STAT,1990,24,25-29,2014,153.06011524850226
SIM,1822,36,30-34,1858,6
SIM,1876,69,na,1945,1813
SIM,1887,40,50-100,1927,4
SIM,1837,31,45-49,1868,1
STAT,1814,40,15-19,1854,0.06172353944055849
SIM,1884,36,35-39,1920,2
STAT,1829,31,45-49,1860,2.3499898952749736
STAT,1853,30,25-29,1883,10.721921997599784
STAT,1857,16,30-34,1873,1.6937595716681193
STAT,1903,36,na,1939,3922.0466274255823
STAT,1828,27,45-49,1855,1.8016019803196937
STAT,1895,44,20-24,1939,0.01634300950268609
STAT,1905,15,na,1920,4238.1764174324335
SIM,1932,23,30-34,1955,53
SIM,1957,31,35-39,1988,26
STAT,1854,17,45-49,1871,0.06366148178981482
SIM,1944,42,na,1986,4563
STAT,1938,42,15-19,1980,0.0018177053109927428
STAT,1781,102,na,1883,0.06434068701036562
STAT,1981,24,50-100,2005,1.0646018559689086
STAT,1968,24,na,1992,5277.554453019078
SIM,1837,29,50-100,1866,1
SIM,1836,27,45-49,1863,2
STAT,1933,29,50-100,1962,1.5243783421009944
STAT,1902,82,na,1984,1548.970458843132
STAT,1947,40,15-19,1987,0.002080408931718918
STAT,1841,90,na,1931,70.09637181101824
STAT,1860,21,25-29,1881,55.28455889843814
SIM,1887,22,45-49,1909,1
SIM,1852,32,25-29,1884,6
SIM,1982,26,35-39,2008,9
SIM,1898,25,25-29,1923,73
STAT,1782,94,na,1876,5.606868723288777
STAT,1847,91,na,1938,44.58819979894477
STAT,1924,23,30-34,1947,39.00700827767875
STAT,1879,22,45-49,1901,0.8402856606329298
SIM,1923,33,50-100,1956,3
STAT,1974,26,35-39,2000,22.73235955988368
STAT,1990,21,45-49,2011,1.8663438005105093
STAT,1833,53,30-34,1886,0.004261318123527454
STAT,1890,17,30-34,1907,2.2475475004938246
SIM,1866,39,na,1905,2480
STAT,1865,8,na,1873,2895.4929857935745
STAT,1891,30,45-49,1921,2.507238125713804
STAT,1963,37,15-19,2000,0.0290068024937357
SIM,1836,48,25-29,1884,1
STAT,1879,37,na,1916,2838.9969696829107
SIM,1868,35,40-44,1903,1
STAT,1882,6,na,1888,2976.91985039585
STAT,1939,69,na,2008,3549.288918370042
SIM,1956,34,25-29,1990,20
STAT,1948,27,35-39,1975,19.913679259603413
STAT,1839,92,na,1931,33.030058545714105
SIM,1945,31,45-49,1976,2
STAT,1933,68,na,2001,4798.039593663574
STAT,1907,47,45-49,1954,0.22498678186530016
SIM,1907,23,50-100,1930,2
SIM,1956,27,35-39,1983,31
STAT,1875,46,45-49,1921,0.2822516145608561
STAT,1987,23,40-44,2010,5.5559497295843405
STAT,1819,88,na,1907,91.39139089483352
STAT,1851,27,50-100,1878,0.5939459133563617
SIM,1883,46,45-49,1929,1
STAT,1866,108,na,1974,0.04841410873081326
STAT,1983,21,30-34,2004,47.09202875327665
STAT,1872,41,15-19,1913,0.016075270171325182
SIM,1913,50,na,1963,4415
STAT,1823,102,na,1925,0.16602143022960217
STAT,1899,46,30-34,1945,0.08657671377779926
SIM,1942,61,na,2003,4489
STAT,1867,36,na,1903,2550.756259192304
STAT,1924,30,20-24,1954,3.298020524234714
STAT,1975,15,50-100,1990,0.5707043086942115
SIM,1888,33,15-19,1921,1
SIM,1977,1,na,1978,6247
STAT,1862,50,45-49,1912,0.014337223504710915
STAT,1948,34,25-29,1982,12.426310167337697
SIM,1826,35,35-39,1861,7
STAT,1937,31,45-49,1968,1.7986595542375081
SIM,1972,34,25-29,2006,1
STAT,1823,52,30-34,1875,0.005665047135020397
STAT,1839,50,45-49,1889,0.011795441913421826
SIM,1857,53,40-44,1910,1
SIM,1925,51,na,1976,5211
SIM,1981,28,40-44,2009,4
SIM,1929,65,na,1994,4224
STAT,1841,16,20-24,1857,20.449627765826506
STAT,1956,18,50-100,1974,0.5719444009106757
STAT,1879,29,15-19,1908,0.5428126153627698
STAT,1866,24,25-29,1890,60.85011590175072
SIM,1978,34,45-49,2012,3
STAT,1901,44,45-49,1945,0.1657329764821688
SIM,1864,19,20-24,1883,24
SIM,1840,19,35-39,1859,1
STAT,1959,23,45-49,1982,1.7035843958045893
STAT,1888,14,na,1902,3492.024547777805
SIM,1929,20,20-24,1949,5
SIM,1848,27,35-39,1875,1
SIM,1836,25,na,1861,1706
SIM,1860,54,na,1914,2214
STAT,1869,31,na,1900,2677.859952741614
STAT,1957,40,na,1997,5889.004541874025
SIM,1899,81,na,1980,1457
SIM,1864,68,na,1932,1491
SIM,1988,15,na,2003,5878
SIM,1842,31,25-29,1873,4
STAT,1856,19,20-24,1875,18.239929504178882
STAT,1870,22,25-29,1892,65.12971697673166
STAT,1922,27,na,1949,4889.870767480225
SIM,1844,34,40-44,1878,13
SIM,1881,28,35-39,1909,21
STAT,1918,47,20-24,1965,0.013568833090719186
STAT,1845,19,45-49,1864,0.05498132350154536
STAT,1836,34,40-44,1870,4.887922097831993
SIM,1985,19,15-19,2004,70
STAT,1941,18,35-39,1959,4.987554910628935
SIM,1883,37,50-100,1920,1
STAT,1910,100,na,2010,37.455093422389986
STAT,1867,30,25-29,1897,11.12499888662855
STAT,1868,51,25-29,1919,0.003946059708732886
STAT,1985,29,15-19,2014,1.1625999542307186
SIM,1941,37,45-49,1978,1
SIM,1882,93,na,1975,442
STAT,1863,22,na,1885,2434.1568350992716
SIM,1929,28,30-34,1957,62
STAT,1844,32,25-29,1876,10.244875391392616
STAT,1933,37,45-49,1970,1.0720633635268757
STAT,1940,52,na,1992,4403.672065506538
STAT,1954,46,na,2000,5465.272538419701
SIM,1884,43,25-29,1927,1
STAT,1876,43,25-29,1919,0.7605457727710914
STAT,1973,28,40-44,2001,6.983531067791884
SIM,1890,20,na,1910,3396
SIM,1957,6,na,1963,6328
SIM,1918,20,45-49,1938,1
STAT,1875,22,25-29,1897,68.27085411007707
SIM,1874,24,25-29,1898,9
SIM,1816,64,na,1880,1206
STAT,1887,44,15-19,1931,0.017619486269651777
STAT,1947,36,30-34,1983,2.4431521836174976
STAT,1880,25,20-24,1905,14.447752786334704
STAT,1986,20,40-44,2006,5.551136998159771
STAT,1897,28,20-24,1925,18.03947598434624
STAT,1864,29,20-24,1893,12.002175862541716
SIM,1812,50,na,1862,1463
SIM,1874,17,35-39,1891,3
STAT,1874,49,35-39,1923,0.16194913304172456
STAT,1803,57,na,1860,1073.5432301833516
STAT,1887,28,na,1915,3075.6807880834153
STAT,1891,65,na,1956,2440.574396211187
STAT,1812,48,15-19,1860,9.121341883995313E-4
STAT,1840,29,35-39,1869,9.513037563902028
STAT,1928,28,na,1956,5323.521373509871
STAT,1873,28,35-39,1901,11.331137756692296
SIM,1854,32,50-100,1886,1
STAT,1823,34,30-34,1857,39.53205896735579
SIM,1831,34,30-34,1865,11
STAT,1916,16,35-39,1932,1.0300458911494326
STAT,1895,47,25-29,1942,0.04858046931602185
SIM,1930,34,na,1964,5992
STAT,1908,25,40-44,1933,5.169505020092525
STAT,1826,50,35-39,1876,0.006226981331982804
SIM,1882,49,35-39,1931,1
SIM,1860,35,35-39,1895,21
STAT,1808,107,na,1915,0.00240461357087859
SIM,1836,24,40-44,1860,4
SIM,1849,22,25-29,1871,84
STAT,1857,54,30-34,1911,0.005203087657709118
STAT,1809,58,na,1867,1210.3762090133105
SIM,1963,25,na,1988,6263
SIM,1994,20,40-44,2014,6
SIM,1955,36,30-34,1991,2
STAT,1849,53,40-44,1902,0.008028634677778675
STAT,1866,17,35-39,1883,0.6024393070170584
STAT,1836,52,40-44,1888,0.00969757975195743
STAT,1814,73,na,1887,785.011488702971
STAT,1852,35,35-39,1887,6.845322600441216
STAT,1950,20,20-24,1970,152.33654007714125
STAT,1834,31,25-29,1865,12.098132478607477
SIM,1852,25,35-39,1877,2
STAT,1961,14,na,1975,5854.70296896513
STAT,1961,28,50-100,1989,1.489765887219149
SIM,1856,26,50-100,1882,1
STAT,1768,115,na,1883,1.8036557498497208E-4
STAT,1898,44,na,1942,3568.4185153417234
STAT,1844,25,35-39,1869,10.023170833888445
STAT,1974,17,35-39,1991,6.323286967251323
SIM,1871,33,20-24,1904,1
STAT,1901,26,45-49,1927,1.800945063473316
SIM,1947,26,30-34,1973,67
STAT,1970,27,20-24,1997,26.484161846163975
STAT,1975,10,na,1985,5982.098986862794
SIM,1834,43,45-49,1877,1
SIM,1982,17,35-39,1999,7
STAT,1856,40,na,1896,2055.4625525845777
STAT,1838,39,20-24,1877,0.7892921114546675
STAT,1870,15,35-39,1885,0.6377167351008739
SIM,1991,18,50-100,2009,1
SIM,1884,33,30-34,1917,44
SIM,1868,43,50-100,1911,7
SIM,1895,37,25-29,1932,6
STAT,1781,77,na,1858,244.35021590366242
STAT,1906,18,50-100,1924,0.08223100065453265
STAT,1934,28,na,1962,5815.895223732086
STAT,1931,34,30-34,1965,23.799113782488128
STAT,1873,25,30-34,1898,29.877949195320962
STAT,1899,19,40-44,1918,0.2876317906792631
STAT,1853,29,45-49,1882,1.1486731047752912
SIM,1854,85,na,1939,319
SIM,1897,18,20-24,1915,61
STAT,1889,18,20-24,1907,25.153987399421556
STAT,1892,87,na,1979,741.3244372840697
STAT,1983,18,50-100,2001,0.6114474330086843
SIM,1898,22,20-24,1920,201
SIM,1924,16,35-39,1940,7
STAT,1849,32,25-29,1881,8.365426782846155
STAT,1989,25,15-19,2014,1.172996151719417
STAT,1924,26,35-39,1950,20.237351861305953
SIM,1857,32,25-29,1889,17
SIM,1861,29,45-49,1890,1
STAT,1894,114,na,2008,8.174009026835579E-4
STAT,1876,33,30-34,1909,20.741174959092003
SIM,1938,20,45-49,1958,2
SIM,1950,52,na,2002,4572
STAT,1985,19,20-24,2004,222.38302025953553
SIM,1920,86,na,2006,735
STAT,1831,25,25-29,1856,44.7377786408625
SIM,1897,48,50-100,1945,2
STAT,1927,70,na,1997,4170.472544046036
SIM,1847,56,na,1903,2174
STAT,1966,26,40-44,1992,6.750622371572747
SIM,1838,29,20-24,1867,13
SIM,1883,43,40-44,1926,5
STAT,1875,43,40-44,1918,2.6630984517086445
STAT,1916,23,25-29,1939,111.36702330641117
STAT,1983,24,35-39,2007,15.412237383330744
SIM,1853,7,na,1860,2905
STAT,1938,15,25-29,1953,49.58630213652184
STAT,1888,20,45-49,1908,0.9516129203759708
STAT,1990,21,20-24,2011,184.44059499360355
SIM,1993,19,20-24,2012,475
SIM,1937,19,25-29,1956,135
SIM,1936,3,na,1939,4196
STAT,1846,74,na,1920,1147.279560507182
SIM,1972,31,20-24,2003,1
STAT,1905,44,30-34,1949,0.13155073389911523
SIM,1875,16,na,1891,3384
STAT,1780,99,na,1879,0.5035766842911255
SIM,1896,20,45-49,1916,1
SIM,1924,23,25-29,1947,245
STAT,1898,25,30-34,1923,39.5421729518081
STAT,1877,27,40-44,1904,3.5960094775546634
STAT,1813,45,25-29,1858,0.19727323063689425
SIM,1829,48,35-39,1877,1
STAT,1944,37,20-24,1981,0.33730213338999665
SIM,1852,32,50-100,1884,1
SIM,1862,38,25-29,1900,7
SIM,1877,102,na,1979,73
SIM,1946,13,na,1959,4694
SIM,1925,27,50-100,1952,4
SIM,1994,15,na,2009,5482
STAT,1929,19,25-29,1948,63.48487246897654
STAT,1836,91,na,1927,52.73644176658308
SIM,1990,16,15-19,2006,138
STAT,1942,40,50-100,1982,0.147676105829476
STAT,1880,22,na,1902,2893.024983191607
STAT,1882,41,50-100,1923,1.1962367218394976
SIM,1884,20,na,1904,2729
STAT,1828,45,20-24,1873,0.01134407748776932
STAT,1909,45,na,1954,3937.7125806007134
SIM,1822,39,35-39,1861,13
STAT,1905,31,na,1936,4036.2412938728767
SIM,1881,16,na,1897,2137
SIM,1870,24,40-44,1894,4
STAT,1862,24,40-44,1886,2.0478385060856708
STAT,1896,19,50-100,1915,0.07427715888225817
STAT,1831,32,15-19,1863,0.14501839395147528
STAT,1830,28,15-19,1858,0.5444164205329306
STAT,1901,8,na,1909,4202.121620082829
SIM,1885,27,40-44,1912,8
STAT,1921,27,25-29,1948,84.62601567522736
STAT,1937,21,15-19,1958,5.987492930709084
STAT,1852,43,na,1895,2163.326792018173
STAT,1867,83,na,1950,427.748893344431
STAT,1920,79,na,1999,2540.153866629389
STAT,1924,33,25-29,1957,12.433150089014541
STAT,1863,44,50-100,1907,1.051686305748032
STAT,1843,35,45-49,1878,2.384088305792529
SIM,1921,21,na,1942,5141
STAT,1825,46,35-39,1871,0.19822900401314403
SIM,1884,41,35-39,1925,5
STAT,1863,33,20-24,1896,2.7161732188840215
STAT,1903,18,15-19,1921,9.729520970103318
STAT,1919,38,25-29,1957,1.219198710616953
SIM,1955,39,35-39,1994,2
SIM,1914,72,na,1986,2682
STAT,1834,37,50-100,1871,1.3936567876288073
SIM,1847,36,30-34,1883,12
STAT,1858,38,50-100,1896,1.0998372344331213
SIM,1851,35,45-49,1886,5
STAT,1852,37,50-100,1889,1.1638131987444809
STAT,1926,57,na,1983,5000.602711489662
STAT,1945,46,25-29,1991,0.06973007839403404
SIM,1952,13,na,1965,4837
SIM,1955,52,na,2007,6271
SIM,1835,71,na,1906,1203
STAT,1916,27,na,1943,4470.527502446133
SIM,1932,33,25-29,1965,4
SIM,1986,22,35-39,2008,18
SIM,1948,36,40-44,1984,6
STAT,1951,20,35-39,1971,12.991431772369621
SIM,1953,28,25-29,1981,105
SIM,1875,47,na,1922,2975
STAT,1881,35,30-34,1916,5.988849879658572
SIM,1929,23,25-29,1952,6
STAT,1918,35,50-100,1953,0.5154481949426031
STAT,1961,19,15-19,1980,67.62120687728482
SIM,1852,22,30-34,1874,52
STAT,1913,42,15-19,1955,0.001729184907064568
STAT,1912,13,na,1925,4605.971520672256
STAT,1996,13,na,2009,6587.067121132426
SIM,1837,73,na,1910,1235
STAT,1937,17,30-34,1954,13.691746390182105
STAT,1851,96,na,1947,6.809175017646199
STAT,1945,28,25-29,1973,83.29550790208569
STAT,1922,48,25-29,1970,0.0701005517348312
STAT,1911,26,50-100,1937,1.1250132953438419
STAT,1876,41,35-39,1917,2.1700372242510024
SIM,1896,28,30-34,1924,4
STAT,1837,43,20-24,1880,0.1339741577879469
SIM,1893,72,na,1965,1950
SIM,1959,15,35-39,1974,14
STAT,1813,56,na,1869,1207.647993201347
STAT,1849,50,25-29,1899,0.0027847527619552165
SIM,1897,86,na,1983,716
SIM,1878,17,na,1895,2978
STAT,1861,95,na,1956,14.709746358226623
SIM,1945,17,30-34,1962,44
STAT,1851,36,35-39,1887,5.728024263682832
STAT,1967,39,20-24,2006,0.3906715144903118
STAT,1840,53,20-24,1893,5.824555023248735E-4
STAT,1844,22,30-34,1866,18.60186875725314
SIM,1805,64,na,1869,1119
SIM,1826,67,na,1893,1175
STAT,1923,43,50-100,1966,0.15815330152860016
STAT,1899,47,45-49,1946,0.20949661457832497
STAT,1950,23,25-29,1973,126.41693729871822
SIM,1870,42,40-44,1912,4
SIM,1986,18,15-19,2004,82
SIM,1818,41,50-100,1859,1
SIM,1932,26,35-39,1958,31
STAT,1869,20,30-34,1889,20.11165881175145
SIM,1956,12,na,1968,5513
STAT,1859,47,40-44,1906,0.15665122977387785
STAT,1848,22,15-19,1870,4.26806700445194
STAT,1947,39,35-39,1986,3.2324783270033977
SIM,1845,43,20-24,1888,1
SIM,1900,22,25-29,1922,111
STAT,1862,42,40-44,1904,2.187945602018934
STAT,1930,53,na,1983,5465.277975064715
STAT,1983,23,20-24,2006,182.07029512835865
STAT,1890,21,15-19,1911,4.6660652804805105
SIM,1927,38,25-29,1965,2
SIM,1909,4,na,1913,5152
STAT,1949,30,20-24,1979,3.3408075972059885
STAT,1880,86,na,1966,556.5072383564366
STAT,1888,28,30-34,1916,34.04087835725129
STAT,1897,29,50-100,1926,0.9800757493850892
SIM,1920,19,30-34,1939,40
STAT,1928,59,na,1987,5086.83446558175
SIM,1843,11,na,1854,2381
SIM,1991,23,20-24,2014,185
STAT,1841,19,25-29,1860,6.421675782557828
SIM,1847,25,na,1872,2707
STAT,1838,70,na,1908,1215.356953421809
STAT,1845,16,40-44,1861,0.1567003618603682
STAT,1908,49,50-100,1957,0.23497573107912145
STAT,1925,30,35-39,1955,12.533588801430984
STAT,1826,43,45-49,1869,1.1052114760827014
STAT,1912,19,30-34,1931,2.8318517092153983
SIM,1889,21,15-19,1910,7
STAT,1947,19,na,1966,4781.626302005166
SIM,1820,41,na,1861,1950
SIM,1877,20,30-34,1897,30
SIM,1885,46,na,1931,3004
STAT,1839,36,30-34,1875,5.1035843418946145
SIM,1801,75,na,1876,472
SIM,1886,15,40-44,1901,2
STAT,1894,35,40-44,1929,6.555873211910623
STAT,1889,41,45-49,1930,2.1387078816410736
STAT,1969,43,40-44,2012,0.374142068671288
STAT,1951,31,na,1982,5300.9501903655955
STAT,1904,49,40-44,1953,0.15669790907045494
STAT,1994,18,na,2012,6127.768861853575
STAT,1842,16,35-39,1858,0.545431343188059
STAT,1815,54,25-29,1869,0.0066782428626065825
SIM,1830,39,40-44,1869,4
SIM,1964,36,40-44,2000,6
SIM,1871,54,na,1925,1738
SIM,1855,39,na,1894,1824
SIM,1891,20,45-49,1911,1
STAT,1842,38,35-39,1880,6.318850113651055
STAT,1863,20,50-100,1883,0.42579882499743266
STAT,1912,26,20-24,1938,20.850751399154394
STAT,1892,25,50-100,1917,0.931550392754472
SIM,1920,26,20-24,1946,2
SIM,1923,28,35-39,1951,39
STAT,1915,28,35-39,1943,17.613447962855815
STAT,1898,26,50-100,1924,1.0011395308119777
STAT,1883,20,45-49,1903,0.7920381297373686
STAT,1971,18,25-29,1989,63.32127643267949
SIM,1850,55,na,1905,1323
SIM,1979,19,30-34,1998,1
STAT,1916,20,20-24,1936,135.2819874347206
SIM,1914,76,na,1990,2421
SIM,1919,27,30-34,1946,114
STAT,1868,45,40-44,1913,0.1917134513675094
SIM,1848,34,25-29,1882,7
SIM,1850,38,35-39,1888,12
SIM,1895,34,20-24,1929,3
STAT,1888,45,na,1933,3082.5047407334228
STAT,1937,49,50-100,1986,0.2621165576258771
STAT,1879,40,50-100,1919,1.2858899485807547
STAT,1890,47,25-29,1937,0.04560289381645854
SIM,1841,18,35-39,1859,1
STAT,1865,26,30-34,1891,26.3107888897975
SIM,1912,49,40-44,1961,1
SIM,1790,85,na,1875,10
STAT,1887,34,20-24,1921,3.465997339589555
SIM,1935,34,na,1969,6189
STAT,1969,10,na,1979,5664.4577123965455
STAT,1852,40,35-39,1892,1.7244864206772168
SIM,1931,20,na,1951,6235
SIM,1958,21,25-29,1979,297
STAT,1773,86,na,1859,124.98278640352171
STAT,1875,112,na,1987,0.0032717485873136965
STAT,1904,24,50-100,1928,0.6715674796751587
SIM,1903,29,na,1932,3677
STAT,1898,35,25-29,1933,4.533275224713355
STAT,1832,82,na,1914,317.878101063262
STAT,1831,27,15-19,1858,0.472967943230279
STAT,1955,47,50-100,2002,0.3604229669823983
STAT,1950,16,35-39,1966,5.727429877016737
SIM,1971,43,45-49,2014,1
SIM,1818,44,40-44,1862,4
SIM,1873,26,30-34,1899,1
STAT,1898,28,35-39,1926,14.996270526695245
SIM,1982,30,na,2012,6597
STAT,1817,45,45-49,1862,0.6933357288926526
SIM,1941,29,50-100,1970,3
SIM,1924,20,20-24,1944,260
STAT,1922,40,15-19,1962,0.0020389457774557212
STAT,1841,44,25-29,1885,0.5782648324567248
STAT,1916,31,na,1947,4525.076089067612
STAT,1930,39,40-44,1969,2.2489119540880407
STAT,1940,31,15-19,1971,0.1536230899974067
STAT,1982,29,45-49,2011,2.8148456246911198
STAT,1816,48,35-39,1864,0.2812467050942029
STAT,1853,54,45-49,1907,0.014051501576851444
SIM,1895,20,na,1915,3451
STAT,1822,46,30-34,1868,0.18559288037744578
STAT,1852,33,45-49,1885,1.6846837544827136
SIM,1860,33,45-49,1893,5
STAT,1873,108,na,1981,0.10425952831069459
SIM,1967,23,45-49,1990,1
STAT,1963,43,45-49,2006,0.2531860184522811
STAT,1837,48,15-19,1885,2.96846873245474E-4
SIM,1904,73,na,1977,2816
STAT,1917,71,na,1988,3378.3542028420056
STAT,1872,51,na,1923,2507.033556073382
STAT,1853,91,na,1944,57.693946814984244
STAT,1856,36,na,1892,2084.3022065759
STAT,1846,10,na,1856,3139.0026567740993
STAT,1930,46,30-34,1976,0.13583571995422017
STAT,1987,16,15-19,2003,74.78987389366281
SIM,1859,37,40-44,1896,2
SIM,1835,78,na,1913,780
SIM,1958,17,40-44,1975,6
STAT,1822,39,40-44,1861,9.638476934854435
SIM,1995,16,15-19,2011,129
STAT,1897,26,30-34,1923,38.99239512971516
STAT,1975,20,20-24,1995,169.96714292757048
SIM,1961,52,na,2013,5424
SIM,1979,16,15-19,1995,77
STAT,1849,54,na,1903,1622.9595247497086
STAT,1887,39,15-19,1926,0.07189503879525744
STAT,1863,36,25-29,1899,2.9194111078354217
SIM,1844,55,na,1899,1962
SIM,1859,41,50-100,1900,2
STAT,1839,39,35-39,1878,6.565269290001969
STAT,1969,46,45-49,2015,0.3267122318747279
STAT,1835,46,40-44,1881,0.11406640917291036
STAT,1919,35,20-24,1954,0.3285688590473423
STAT,1889,27,30-34,1916,35.82299671517392
STAT,1962,23,15-19,1985,7.894681985440954
SIM,1945,32,50-100,1977,2
STAT,1807,56,na,1863,1485.0356903529184
SIM,1964,46,35-39,2010,1
STAT,1831,44,na,1875,1959.8784846634137
SIM,1851,37,35-39,1888,13
STAT,1986,17,15-19,2003,74.62799325483243
STAT,1801,78,na,1879,357.86294492462497
STAT,1792,77,na,1869,509.8728178463961
SIM,1963,39,30-34,2002,2
STAT,1878,21,35-39,1899,7.052722847011274
STAT,1895,113,na,2008,0.0024082452621363346
STAT,1956,22,15-19,1978,8.155763720910047
SIM,1811,64,na,1875,1401
SIM,1828,38,25-29,1866,5
STAT,1888,82,na,1970,1123.1003376448812
STAT,1948,31,20-24,1979,3.285486312550945
STAT,1800,54,30-34,1854,0.02261705395763994
STAT,1906,43,30-34,1949,0.13338201300265928
SIM,1970,23,15-19,1993,7
STAT,1836,49,15-19,1885,3.7145880756526696E-4
SIM,1907,37,45-49,1944,1
SIM,1897,27,30-34,1924,88
STAT,1902,32,45-49,1934,2.8435253168547563
STAT,1893,25,30-34,1918,36.98251479482503
STAT,1853,34,50-100,1887,0.9201015229021756
STAT,1912,65,na,1977,3555.2120883249468
SIM,1974,30,50-100,2004,2
STAT,1875,37,35-39,1912,8.435133733869021
STAT,1986,5,na,1991,6465.428472824896
SIM,1840,18,20-24,1858,22
STAT,1897,29,35-39,1926,14.783169133375619
SIM,1956,31,20-24,1987,8
STAT,1990,15,15-19,2005,75.04518318783049
STAT,1963,21,45-49,1984,1.6556821715683014
SIM,1896,46,na,1942,3487
STAT,1896,42,15-19,1938,0.0014599646323125803
STAT,1977,32,45-49,2009,2.5010824745970996
SIM,1885,31,25-29,1916,2
STAT,1905,20,45-49,1925,1.1717013612369418
STAT,1913,20,15-19,1933,5.99148695007185
STAT,1843,32,40-44,1875,5.231192856118211
STAT,1982,26,40-44,2008,7.605313896431139
SIM,1935,13,na,1948,6445
STAT,1851,40,50-100,1891,0.8462141933347349
SIM,1939,27,na,1966,4968
SIM,1851,32,40-44,1883,14
SIM,1994,17,15-19,2011,1
SIM,1937,4,na,1941,4537
STAT,1912,44,20-24,1956,0.019523264052272223
STAT,1830,37,25-29,1867,2.9115724600053836
STAT,1944,45,na,1989,4768.3382815165705
STAT,1960,44,35-39,2004,0.3134982811034166
SIM,1826,63,na,1889,1206
STAT,1816,45,30-34,1861,0.20345811458539373
STAT,1867,35,30-34,1902,5.797096161607919
SIM,1869,19,20-24,1888,34
SIM,1949,26,na,1975,5781
STAT,1986,1,na,1987,6474.876884257304
SIM,1866,38,50-100,1904,1
STAT,1883,51,50-100,1934,0.017133987200938547
SIM,1813,105,na,1918,1
SIM,1846,37,30-34,1883,1
STAT,1837,46,25-29,1883,0.04385543790225932
STAT,1899,6,na,1905,4130.320888515097
SIM,1953,25,20-24,1978,51
STAT,1817,47,35-39,1864,0.3996786339502855
SIM,1861,34,50-100,1895,1
STAT,1956,46,35-39,2002,0.20529981049064322
STAT,1945,25,20-24,1970,23.131553316227667
SIM,1845,77,na,1922,1024
STAT,1894,38,45-49,1932,2.942746898129196
STAT,1956,44,50-100,2000,0.1858189439995345
SIM,1847,39,35-39,1886,4
STAT,1945,60,na,2005,4485.9896757269225
SIM,1990,21,50-100,2011,1
STAT,1882,57,na,1939,2265.2862080549617
SIM,1984,23,50-100,2007,1
SIM,1854,28,25-29,1882,48
STAT,1883,35,na,1918,2685.3790875771474
SIM,1906,21,15-19,1927,9
SIM,1942,26,50-100,1968,2
SIM,1964,39,45-49,2003,2
SIM,1976,29,na,2005,5619
STAT,1861,36,40-44,1897,4.220021722743696
STAT,1840,96,na,1936,6.888229755662944
SIM,1962,12,na,1974,5585
STAT,1847,18,15-19,1865,5.66570569883429
STAT,1981,29,30-34,2010,63.43995019744674
STAT,1901,65,na,1966,3029.7196904360208
STAT,1899,44,40-44,1943,0.24362081667678656
SIM,1832,26,na,1858,2247
SIM,1966,26,na,1992,5445
STAT,1840,30,15-19,1870,0.1420629653045548
STAT,1914,41,15-19,1955,0.001759470689946638
SIM,1919,40,50-100,1959,1
SIM,1931,21,50-100,1952,1
SIM,1798,81,na,1879,272
STAT,1945,43,20-24,1988,0.02310065232845901
SIM,1954,41,na,1995,5449
STAT,1846,28,25-29,1874,52.52319226145831
STAT,1863,43,15-19,1906,0.013834971432505231
STAT,1782,105,na,1887,0.028522640830164855
STAT,1936,33,15-19,1969,0.1440423690779101
STAT,1812,78,na,1890,343.031114013761
STAT,1896,49,na,1945,3358.4220488096544
STAT,1870,40,25-29,1910,0.7379695827972064
STAT,1976,35,35-39,2011,3.8486816954119965
STAT,1982,33,30-34,2015,26.063379922509068
STAT,1923,21,50-100,1944,0.8858858430859475
STAT,1842,35,30-34,1877,4.912027682995293
STAT,1842,44,na,1886,1793.5594873845228
SIM,1824,38,40-44,1862,4
SIM,1847,27,20-24,1874,1
STAT,1803,105,na,1908,0.01021941424270481
SIM,1943,29,15-19,1972,2
STAT,1935,29,15-19,1964,1.1100482159796703
STAT,1866,42,25-29,1908,0.6860452176637069
SIM,1798,77,na,1875,616
STAT,1921,40,45-49,1961,0.21685047238224972
SIM,1825,41,na,1866,1721
STAT,1876,34,45-49,1910,2.062531933927374
SIM,1871,36,25-29,1907,2
SIM,1884,34,45-49,1918,2
STAT,1816,38,40-44,1854,15.972283326314672
STAT,1839,27,20-24,1866,11.720478162672473
STAT,1965,11,na,1976,5660.36697371447
STAT,1860,73,na,1933,1104.7390247279673
STAT,1855,45,30-34,1900,0.08318784913580934
STAT,1890,44,20-24,1934,0.22092262098319737
SIM,1831,41,na,1872,1661
SIM,1875,43,na,1918,3028
STAT,1864,54,50-100,1918,0.015134542501814728
SIM,1957,33,25-29,1990,2
STAT,1864,54,20-24,1918,7.394727899526483E-4
SIM,1923,25,30-34,1948,9
SIM,1848,31,20-24,1879,1
SIM,1961,23,50-100,1984,2
STAT,1838,37,30-34,1875,5.571607394490581
STAT,1886,46,20-24,1932,0.014649208401282796
STAT,1877,31,25-29,1908,12.345930305491281
STAT,1868,48,45-49,1916,0.2583812775019329
STAT,1992,6,na,1998,6511.931092615206
STAT,1899,49,35-39,1948,0.12225277904557082
SIM,1857,47,35-39,1904,1
STAT,1899,23,25-29,1922,90.22967014519475
SIM,1875,35,30-34,1910,21
STAT,1878,15,50-100,1893,0.059307312712155426
STAT,1892,32,25-29,1924,14.815254610520501
STAT,1949,33,25-29,1982,12.637062666491241
STAT,1915,25,30-34,1940,46.443147606940386
STAT,1872,18,25-29,1890,6.549412890857948
STAT,1966,29,na,1995,5417.767193436182
SIM,1956,24,30-34,1980,54
STAT,1865,29,35-39,1894,9.97519749419039
SIM,1879,39,35-39,1918,1
SIM,1873,17,20-24,1890,1
STAT,1974,21,20-24,1995,168.17151779983482
STAT,1829,62,na,1891,1338.9580370124488
STAT,1909,39,15-19,1948,0.020788803504545837
STAT,1959,6,na,1965,5934.407395464657
STAT,1978,22,35-39,2000,14.878782719461801
SIM,1867,17,na,1884,2618
SIM,1860,20,15-19,1880,5
SIM,1874,42,25-29,1916,1
STAT,1839,24,50-100,1863,0.4095826341164863
STAT,1914,79,na,1993,2281.0570998292214
SIM,1825,42,40-44,1867,1
SIM,1935,75,na,2010,4324
STAT,1902,14,na,1916,4197.478751871752
STAT,1939,48,40-44,1987,0.18899154709281638
SIM,1883,37,35-39,1920,12
SIM,1844,92,na,1936,29
STAT,1899,41,25-29,1940,0.07082321723443875
STAT,1975,23,25-29,1998,141.0477462559959
SIM,1928,31,na,1959,5609
SIM,1841,15,30-34,1856,3
SIM,1953,1,na,1954,5701
STAT,1841,17,35-39,1858,0.6292008281274207
STAT,1865,51,50-100,1916,0.01580107173023978
STAT,1948,24,30-34,1972,38.057286776696614
SIM,1872,27,30-34,1899,59
STAT,1881,53,30-34,1934,0.006519569239684328
SIM,1823,93,na,1916,131
STAT,1952,26,50-100,1978,1.3831109644975492
STAT,1865,17,20-24,1882,19.02263275441917
STAT,1909,24,na,1933,4072.0768654983876
SIM,1826,32,30-34,1858,6
SIM,1820,36,45-49,1856,5
STAT,1843,37,35-39,1880,8.284926140985245
STAT,1817,42,40-44,1859,6.935382796358795
STAT,1864,27,30-34,1891,25.948476484658233
STAT,1852,20,15-19,1872,3.7486037982786793
STAT,1937,32,50-100,1969,0.9445102701454565
STAT,1821,82,na,1903,285.357935277025
SIM,1850,35,30-34,1885,6
SIM,1978,31,40-44,2009,8
STAT,1963,40,40-44,2003,0.38216912371432354
SIM,1858,44,45-49,1902,5
STAT,1957,38,45-49,1995,1.0675754550117078
STAT,1923,13,na,1936,5359.081148202777
STAT,1880,45,50-100,1925,0.30342318610940067
STAT,1959,11,na,1970,5930.728973698435
STAT,1971,15,20-24,1986,198.27101208868166
SIM,1961,9,na,1970,5671
STAT,1950,45,na,1995,5238.873481177655
SIM,1920,45,na,1965,4101
STAT,1955,23,25-29,1978,141.93189041247362
STAT,1966,43,25-29,2009,0.10680066664147629
SIM,1905,22,25-29,1927,4
STAT,1832,43,20-24,1875,0.13320458270252275
STAT,1901,28,na,1929,3844.1942584737435
STAT,1893,23,40-44,1916,3.0302979398148686
SIM,1843,69,na,1912,1177
STAT,1948,46,40-44,1994,0.21711944445310066
SIM,1909,24,35-39,1933,1
STAT,1875,34,30-34,1909,20.644106067495944
STAT,1927,33,na,1960,5364.5492305252
STAT,1882,37,25-29,1919,3.245474247831755
SIM,1869,74,na,1943,734
STAT,1900,32,25-29,1932,16.40205244681728
STAT,1996,17,20-24,2013,227.3836374385205
SIM,1837,33,20-24,1870,5
STAT,1807,60,na,1867,1371.9313569563276
SIM,1963,23,25-29,1986,299
STAT,1958,25,na,1983,5707.6828017734115
STAT,1932,36,35-39,1968,3.7547933854693403
STAT,1870,20,35-39,1890,6.678779870384108
STAT,1803,94,na,1897,6.965939053612678
SIM,1812,81,na,1893,85
SIM,1857,55,na,1912,2167
STAT,1976,28,45-49,2004,2.6738625957468214
STAT,1828,41,50-100,1869,1.0327061604490044
STAT,1851,17,40-44,1868,0.17634352423372246
STAT,1960,30,40-44,1990,6.002481083403604
SIM,1954,25,25-29,1979,8
STAT,1846,49,20-24,1895,0.01214637066291602
SIM,1931,36,25-29,1967,1
STAT,1946,25,25-29,1971,84.6867755954174
SIM,1890,37,25-29,1927,8
STAT,1835,49,45-49,1884,0.15131128089077928
SIM,1918,22,35-39,1940,9
SIM,1928,35,25-29,1963,3
STAT,1914,38,25-29,1952,1.1294235791098095
STAT,1923,36,25-29,1959,1.3173095220965445
SIM,1946,50,na,1996,4491
SIM,1858,8,na,1866,3344
SIM,1922,38,25-29,1960,3
SIM,1843,49,45-49,1892,1
STAT,1933,49,15-19,1982,5.814365807678167E-4
STAT,1942,47,15-19,1989,4.6217958036000073E-4
STAT,1985,17,45-49,2002,0.819941219950352
SIM,1866,29,45-49,1895,3
STAT,1820,42,na,1862,1604.1289431020482
SIM,1895,29,na,1924,3604
SIM,1949,43,45-49,1992,1
STAT,1884,15,50-100,1899,0.05612110924637428
SIM,1924,35,40-44,1959,6
STAT,1786,77,na,1863,561.6995097076995
SIM,1984,28,45-49,2012,7
SIM,1887,38,50-100,1925,3
SIM,1920,35,na,1955,4174
STAT,1866,48,50-100,1914,0.25940800748758325
SIM,1882,56,na,1938,2870
STAT,1962,17,20-24,1979,200.47250739706809
SIM,1826,33,45-49,1859,1
STAT,1833,108,na,1941,0.0012889357232504224
SIM,1843,25,45-49,1868,1
SIM,1866,32,na,1898,2486
STAT,1929,33,25-29,1962,13.540962890127133
SIM,1932,64,na,1996,4809
STAT,1959,42,40-44,2001,0.39239650309941704
STAT,1861,58,na,1919,1897.3213085877248
STAT,1821,43,45-49,1864,2.8242070919705164
SIM,1862,42,45-49,1904,6
STAT,1837,43,50-100,1880,0.891219380469939
STAT,1845,34,na,1879,1700.7488446126256
STAT,1907,29,na,1936,4024.628546905238
SIM,1919,28,25-29,1947,115
STAT,1963,35,50-100,1998,0.6352926839260759
STAT,1904,16,20-24,1920,29.452220482454532
SIM,1787,75,na,1862,665
SIM,1912,16,20-24,1928,1
STAT,1827,29,15-19,1856,1.0016239574025028
STAT,1890,17,na,1907,3561.408222332607
SIM,1870,37,na,1907,3012
STAT,1884,39,50-100,1923,1.3858087133463082
SIM,1905,48,35-39,1953,1
STAT,1980,15,30-34,1995,19.5378435263432
SIM,1984,14,na,1998,6300
SIM,1889,31,45-49,1920,6
SIM,1905,68,na,1973,3124
STAT,1891,92,na,1983,310.7368558873082
SIM,1941,13,na,1954,4025
SIM,1967,25,35-39,1992,28
SIM,1887,27,25-29,1914,4
STAT,1969,29,25-29,1998,95.20412188532322
STAT,1916,35,40-44,1951,1.7861377318511586
STAT,1835,25,45-49,1860,0.9202688682529291
STAT,1934,40,40-44,1974,0.40312588472453165
STAT,1845,24,na,1869,1763.0524656405128
STAT,1940,15,na,1955,4316.5954796862225
SIM,1990,18,na,2008,5934
STAT,1829,33,20-24,1862,3.380412011484564
STAT,1943,5,na,1948,4878.648223048225
STAT,1958,35,na,1993,5885.163591532124
STAT,1959,25,35-39,1984,22.781888188589047
STAT,1832,61,na,1893,1273.0833578302172
SIM,1970,17,20-24,1987,199
STAT,1879,27,25-29,1906,50.97401080022132
SIM,1909,17,45-49,1926,1
STAT,1910,36,15-19,1946,0.02131928529321002
SIM,1864,47,25-29,1911,1
SIM,1861,19,15-19,1880,4
STAT,1972,15,25-29,1987,64.06632495451457
SIM,1880,6,na,1886,3816
STAT,1895,19,20-24,1914,26.48883748373103
STAT,1942,10,na,1952,4759.152257644646
SIM,1998,14,na,2012,6855
STAT,1786,108,na,1894,0.0015951027400181426
SIM,1880,21,na,1901,3162
SIM,1959,19,na,1978,5986
SIM,1833,27,40-44,1860,1
STAT,1933,43,na,1976,5882.126307489248
SIM,1884,21,15-19,1905,4
STAT,1870,52,40-44,1922,0.011913798763374431
SIM,1955,16,50-100,1971,1
STAT,1865,42,20-24,1907,0.16516144217838372
STAT,1937,18,25-29,1955,48.551109385834174
STAT,1818,46,50-100,1864,0.307502411415872
SIM,1917,87,na,2004,1155
SIM,1822,38,20-24,1860,1
STAT,1856,102,na,1958,0.44019698714313626
SIM,1817,59,na,1876,1099
STAT,1953,51,na,2004,5266.784303154777
STAT,1881,16,25-29,1897,6.32329241337593
SIM,1849,43,40-44,1892,2
SIM,1950,25,40-44,1975,32
SIM,1857,44,30-34,1901,1
SIM,1913,47,50-100,1960,1
SIM,1914,35,na,1949,3984
SIM,1952,54,na,2006,4400
STAT,1853,19,15-19,1872,7.024121846519585
STAT,1885,15,30-34,1900,1.843242244872275
SIM,1852,30,35-39,1882,11
STAT,1890,21,na,1911,3345.0714794273713
STAT,1967,21,50-100,1988,0.9519937578230727
STAT,1954,25,30-34,1979,56.190953230137794
STAT,1868,90,na,1958,123.63729681637143
STAT,1918,30,45-49,1948,1.9448251327980852
STAT,1983,26,25-29,2009,107.96766778268864
STAT,1989,23,25-29,2012,153.13959660752533
STAT,1810,76,na,1886,514.600942741522
STAT,1879,48,20-24,1927,0.014278533855271081
STAT,1927,43,na,1970,5365.658809634079
SIM,1982,28,25-29,2010,309
STAT,1880,32,45-49,1912,2.133115216107357
STAT,1859,28,35-39,1887,8.958627492121611
SIM,1883,18,40-44,1901,1
SIM,1926,30,45-49,1956,5
STAT,1884,16,40-44,1900,0.2090621076906867
STAT,1918,8,na,1926,5008.823466134922
SIM,1912,10,na,1922,4212
SIM,1937,33,25-29,1970,4
SIM,1945,18,25-29,1963,62
STAT,1925,27,45-49,1952,2.3540856336548743
STAT,1844,30,35-39,1874,10.341870939722595
STAT,1932,40,20-24,1972,0.027706139690427314
SIM,1962,25,30-34,1987,64
SIM,1976,23,35-39,1999,38
STAT,1923,38,35-39,1961,3.2298400266984673
SIM,1966,27,40-44,1993,13
STAT,1914,3,na,1917,4828.509629663755
STAT,1959,52,na,2011,5671.4790793217735
SIM,1845,18,20-24,1863,22
SIM,1992,13,na,2005,7032
STAT,1833,41,15-19,1874,0.012013074790137314
SIM,1863,26,25-29,1889,52
SIM,1916,1,na,1917,4994
SIM,1946,54,na,2000,4422
SIM,1914,43,30-34,1957,1
STAT,1891,35,25-29,1926,4.145652641063277
SIM,1993,17,45-49,2010,2
STAT,1858,29,45-49,1887,1.0086346649879219
STAT,1863,43,na,1906,2315.4475461941247
STAT,1902,51,na,1953,3527.911112791999
STAT,1862,36,na,1898,2305.606378916911
STAT,1845,22,35-39,1867,4.881655591647999
SIM,1931,38,35-39,1969,2
STAT,1868,23,30-34,1891,19.688656347221084
SIM,1831,36,20-24,1867,4
STAT,1861,54,40-44,1915,0.009822551303598727
STAT,1968,40,40-44,2008,0.37571840023867104
SIM,1977,36,na,2013,6147
STAT,1963,49,30-34,2012,0.13515303047182778
STAT,1798,78,na,1876,283.4858915093569
STAT,1946,46,20-24,1992,0.014749813308935773
STAT,1860,33,40-44,1893,4.016595674393635
STAT,1837,18,20-24,1855,24.20298934673036
STAT,1985,25,50-100,2010,1.6422461444615366
STAT,1905,21,50-100,1926,0.6831978483993474
STAT,1856,47,25-29,1903,0.05047744730823463
SIM,1925,22,25-29,1947,8
SIM,1925,86,na,2011,1534
STAT,1844,23,45-49,1867,0.7230038409428086
SIM,1876,23,30-34,1899,50
STAT,1899,20,na,1919,3761.619269688207
STAT,1960,1,na,1961,5918.44240470606
STAT,1874,90,na,1964,220.04746903034973
STAT,1942,25,40-44,1967,5.65149680049944
STAT,1968,23,35-39,1991,13.612586351003843
STAT,1823,36,20-24,1859,1.5756678543493452
STAT,1999,11,na,2010,6698.089100870585
STAT,1868,30,20-24,1898,3.021154850968939
STAT,1913,16,30-34,1929,2.8845871375533068
SIM,1921,16,30-34,1937,20
SIM,1865,54,na,1919,2620
STAT,1871,50,35-39,1921,0.010026329201923452
STAT,1902,41,na,1943,3798.89963705858
SIM,1886,22,na,1908,2302
STAT,1855,26,25-29,1881,37.78916257600567
STAT,1917,22,25-29,1939,113.29747486641314
STAT,1958,27,40-44,1985,7.0954484941683935
SIM,1883,34,30-34,1917,6
STAT,1848,76,na,1924,1006.6426325755923
STAT,1855,48,35-39,1903,0.11762856163616676
STAT,1958,26,45-49,1984,2.6311057344525937
SIM,1842,43,40-44,1885,4
SIM,1908,25,45-49,1933,2
STAT,1879,24,20-24,1903,82.52100603632044
SIM,1844,22,25-29,1866,116
SIM,1911,35,45-49,1946,1
STAT,1960,33,45-49,1993,2.409415669553594
STAT,1856,21,15-19,1877,3.397844832938071
STAT,1845,20,25-29,1865,48.58382583331544
STAT,1944,21,50-100,1965,0.8201927029554011
SIM,1912,22,15-19,1934,11
STAT,1976,25,40-44,2001,7.2237472664287194
STAT,1825,43,30-34,1868,1.6737155044379033
STAT,1968,20,30-34,1988,41.59361841214165
SIM,1909,21,30-34,1930,87
SIM,1940,33,30-34,1973,48
STAT,1873,73,na,1946,1399.7544547590335
STAT,1974,18,50-100,1992,0.5643984235930501
STAT,1899,43,50-100,1942,0.11515289236399498
STAT,1881,38,35-39,1919,7.834024271836122
SIM,1853,22,35-39,1875,13
SIM,1904,31,20-24,1935,5
SIM,1833,43,30-34,1876,1
STAT,1911,21,45-49,1932,1.2362658261407484
STAT,1839,24,na,1863,2147.52477837233
STAT,1871,18,20-24,1889,20.365388938641527
STAT,1909,31,30-34,1940,17.441137669588468
STAT,1904,22,15-19,1926,5.467205944523457
STAT,1965,20,15-19,1985,7.700086387596824
STAT,1944,20,45-49,1964,1.4030345610553272
SIM,1887,24,20-24,1911,12
STAT,1836,22,25-29,1858,68.7805008427141
STAT,1831,75,na,1906,807.6820525293552
STAT,1932,33,30-34,1965,24.161506506041913
STAT,1883,50,25-29,1933,0.0040567304669671764
SIM,1892,22,na,1914,3727
STAT,1838,48,na,1886,1979.4291485411939
STAT,1818,93,na,1911,12.931102216694423
STAT,1937,19,20-24,1956,151.84045195796628
SIM,1883,40,25-29,1923,1
SIM,1933,27,45-49,1960,11
STAT,1968,43,45-49,2011,0.24891243146790187
STAT,1839,65,na,1904,1340.2244034158302
STAT,1929,30,20-24,1959,3.579767932683808
SIM,1976,20,30-34,1996,53
STAT,1931,31,50-100,1962,1.2512608027334826
SIM,1864,21,15-19,1885,8
STAT,1952,16,na,1968,5091.805208938911
STAT,1872,39,20-24,1911,0.8842711129751937
STAT,1931,48,na,1979,5654.427363359592
SIM,1930,21,20-24,1951,193
SIM,1881,27,20-24,1908,2
SIM,1852,20,40-44,1872,3
SIM,1880,39,20-24,1919,2
STAT,1812,51,40-44,1863,0.023793035983282123
STAT,1872,15,20-24,1887,20.85640263348885
SIM,1812,77,na,1889,265
STAT,1888,72,na,1960,1895.308528061035
STAT,1903,35,45-49,1938,0.7139959661434142
STAT,1834,43,40-44,1877,2.4430692165582677
SIM,1945,19,20-24,1964,149
SIM,1853,20,25-29,1873,4
STAT,1828,52,45-49,1880,0.012907631787868435
STAT,1918,28,15-19,1946,0.863787766997389
STAT,1900,19,40-44,1919,0.29132212394775675
SIM,1924,65,na,1989,4389
SIM,1931,47,na,1978,6044
STAT,1934,43,45-49,1977,0.2670698163589818
STAT,1895,54,na,1949,3145.611607070682
STAT,1864,31,15-19,1895,0.1473424719143002
SIM,1950,59,na,2009,4280
STAT,1775,115,na,1890,2.604692558218578E-4
STAT,1969,26,20-24,1995,26.44101197830864
SIM,1877,21,25-29,1898,133
STAT,1891,32,20-24,1923,3.855421826478876
STAT,1779,95,na,1874,2.200017355164046
STAT,1872,20,na,1892,2756.975664214332
STAT,1834,50,30-34,1884,0.0057949957965877305
SIM,1880,15,20-24,1895,43
SIM,1826,30,40-44,1856,5
STAT,1848,26,50-100,1874,0.8172906137536877
STAT,1972,41,45-49,2013,0.2559348322806738
STAT,1926,19,45-49,1945,0.7028745581976618
STAT,1865,88,na,1953,142.9473718822984
SIM,1832,36,na,1868,2171
SIM,1866,26,40-44,1892,9
SIM,1949,40,40-44,1989,1
STAT,1909,24,40-44,1933,3.5878458225390157
STAT,1861,53,45-49,1914,0.013699761105792843
SIM,1839,40,45-49,1879,1
STAT,1875,40,25-29,1915,0.7735610726332804
STAT,1891,42,15-19,1933,0.019672960525003322
STAT,1889,48,50-100,1937,0.19460478404651563
STAT,1848,49,40-44,1897,0.17810671097570788
STAT,1842,41,25-29,1883,0.5178502712170163
STAT,1808,53,40-44,1861,0.04918185540985983
SIM,1966,26,45-49,1992,6
SIM,1877,29,20-24,1906,19
SIM,1926,28,15-19,1954,2
STAT,1948,49,45-49,1997,0.29680793438127656
STAT,1998,17,40-44,2015,2.3700730987113565
SIM,1873,45,25-29,1918,1
SIM,1893,93,na,1986,78
STAT,1955,20,20-24,1975,171.032565525248
SIM,1984,25,40-44,2009,1
STAT,1907,49,20-24,1956,0.011314103698289899
STAT,1865,45,25-29,1910,0.060574287650179366
STAT,1903,16,50-100,1919,0.08072952070889901
STAT,1869,21,25-29,1890,64.1713269940852
SIM,1945,37,na,1982,4704
STAT,1935,21,30-34,1956,45.2069078947669
SIM,1847,35,na,1882,2594
SIM,1943,21,30-34,1964,65
SIM,1844,15,35-39,1859,1
SIM,1827,32,35-39,1859,20
STAT,1874,86,na,1960,394.77782347752157
STAT,1969,28,30-34,1997,56.70362629840049
STAT,1851,33,30-34,1884,14.261786178179838
STAT,1960,49,15-19,2009,5.725452173345025E-4
SIM,1963,20,20-24,1983,189
STAT,1814,42,na,1856,2016.259218646218
STAT,1972,34,na,2006,5689.030630690655
SIM,1875,84,na,1959,519
SIM,1914,18,50-100,1932,3
SIM,1858,31,15-19,1889,1
STAT,1818,40,35-39,1858,2.560222329028932
STAT,1880,55,na,1935,2529.3125008226148
SIM,1884,51,na,1935,2476
SIM,1919,29,20-24,1948,41
STAT,1816,51,25-29,1867,0.007074679499996823
STAT,1839,52,20-24,1891,5.82091451744438E-4
STAT,1944,18,15-19,1962,56.34741089351821
SIM,1954,18,35-39,1972,8
STAT,1900,22,30-34,1922,28.523800466756928
STAT,1838,41,15-19,1879,0.014172574287982746
STAT,1879,34,15-19,1913,0.1701347312898506
SIM,1899,37,45-49,1936,4
STAT,1913,29,na,1942,4279.176323817087
SIM,1917,25,na,1942,5203
SIM,1827,30,25-29,1857,21
STAT,1909,33,50-100,1942,0.9076986592763604
STAT,1959,18,45-49,1977,0.7538540736936385
STAT,1951,17,45-49,1968,0.6864882386114578
SIM,1867,47,40-44,1914,1
STAT,1976,32,30-34,2008,24.760706848930514
STAT,1891,34,na,1925,3374.4982374154188
SIM,1854,25,20-24,1879,1
SIM,1886,21,35-39,1907,15
SIM,1978,9,na,1987,6040
STAT,1922,2,na,1924,5459.99702126872
STAT,1846,25,20-24,1871,14.88457191177938
STAT,1936,27,20-24,1963,20.17242729532858
STAT,1946,18,35-39,1964,5.3692875692746656
SIM,1918,65,na,1983,3313
SIM,1952,18,15-19,1970,119
SIM,1876,30,20-24,1906,4
SIM,1917,33,50-100,1950,3
STAT,1859,25,30-34,1884,23.891275240047012
STAT,1958,27,50-100,1985,1.5152086706166699
STAT,1861,15,45-49,1876,0.07288903661034422
SIM,1826,40,35-39,1866,9
SIM,1875,33,40-44,1908,21
SIM,1966,27,50-100,1993,4
SIM,1806,81,na,1887,226
STAT,1958,45,40-44,2003,0.24974017596157932
STAT,1858,26,40-44,1884,2.7807334772807013
SIM,1988,25,25-29,2013,11
STAT,1847,59,na,1906,1495.4069469157862
STAT,1911,28,15-19,1939,0.792388996148887
STAT,1844,32,50-100,1876,0.9164487095386983
SIM,1850,41,25-29,1891,1
STAT,1914,28,30-34,1942,45.44610598826155
STAT,1886,87,na,1973,573.5971763899129
SIM,1864,37,na,1901,2751
STAT,1854,42,45-49,1896,1.2178070699682835
SIM,1978,27,20-24,2005,29
SIM,1941,39,20-24,1980,2
STAT,1829,41,na,1870,1934.5164424801624
STAT,1933,39,20-24,1972,0.4136669453525588
STAT,1989,20,20-24,2009,184.53821769842907
SIM,1869,84,na,1953,160
SIM,1977,24,35-39,2001,19
STAT,1922,21,20-24,1943,147.53811644288044
STAT,1867,33,40-44,1900,4.653042789612029
STAT,1916,1,na,1917,5097.014482963844
STAT,1908,60,na,1968,3575.0876950482066
STAT,1871,88,na,1959,234.66963982618506
SIM,1836,56,na,1892,1234
SIM,1922,28,30-34,1950,4
SIM,1800,58,na,1858,1363
STAT,1947,15,15-19,1962,59.02767229308036
STAT,1878,3,na,1881,3682.8653838537475
STAT,1920,69,na,1989,3765.12945527827
SIM,1939,72,na,2011,3726
STAT,1867,73,na,1940,1279.7897448787921
STAT,1967,30,40-44,1997,5.756841697543688
SIM,1899,50,na,1949,3657
STAT,1847,108,na,1955,0.0014094276961538613
STAT,1844,20,40-44,1864,2.207769998120091
SIM,1893,18,35-39,1911,2
SIM,1955,15,15-19,1970,66
STAT,1928,17,20-24,1945,197.14076036422156
SIM,1921,19,35-39,1940,12
SIM,1879,36,na,1915,2834
SIM,1952,46,na,1998,4629
SIM,1858,72,na,1930,1701
STAT,1871,31,40-44,1902,4.999446295727138
SIM,1922,35,20-24,1957,1
STAT,1885,18,35-39,1903,0.6299693207881599
STAT,1932,43,25-29,1975,0.11154254972699802
STAT,1914,35,20-24,1949,0.3067744863467502
STAT,1884,19,45-49,1903,0.07408265881931536
SIM,1982,25,20-24,2007,39
STAT,1913,19,35-39,1932,0.9853090862394537
SIM,1939,68,na,2007,3845
SIM,1910,5,na,1915,4065
STAT,1915,14,na,1929,4755.555369161745
SIM,1944,27,20-24,1971,41
STAT,1909,14,na,1923,4460.020023388859
STAT,1857,30,45-49,1887,1.6101361686293436
SIM,1860,17,na,1877,2813
SIM,1828,35,20-24,1863,2
SIM,1904,24,30-34,1928,65
STAT,1843,39,na,1882,2459.7053639738087
STAT,1894,20,20-24,1914,102.84437489228793
SIM,1831,39,25-29,1870,2
STAT,1823,39,25-29,1862,3.1724087427190018
STAT,1885,37,40-44,1922,5.038984026019524
STAT,1946,49,25-29,1995,0.0702095654256026
SIM,1918,8,na,1926,4319
SIM,1928,28,35-39,1956,30
SIM,1893,37,40-44,1930,16
STAT,1906,46,35-39,1952,0.13327644022889218
SIM,1857,20,45-49,1877,1
SIM,1921,17,25-29,1938,126
SIM,1865,30,45-49,1895,1
STAT,1806,53,20-24,1859,0.0025458580354487123
STAT,1822,49,35-39,1871,0.2571653279603792
STAT,1913,17,25-29,1930,10.230526675166251
STAT,1825,75,na,1900,728.1676217790792
SIM,1844,82,na,1926,338
SIM,1906,36,35-39,1942,6
SIM,1889,33,na,1922,3762
SIM,1943,24,35-39,1967,17
SIM,1892,18,na,1910,4044
SIM,1849,21,30-34,1870,29
SIM,1880,37,30-34,1917,16
SIM,1822,43,na,1865,1649
STAT,1940,18,30-34,1958,14.282223879319416
SIM,1911,4,na,1915,5225
STAT,1947,37,25-29,1984,1.3186627400157405
STAT,1797,83,na,1880,166.8054539728323
STAT,1864,38,na,1902,2415.6554533415165
STAT,1924,45,40-44,1969,0.217574244371903
SIM,1904,52,na,1956,3842
SIM,1950,11,na,1961,4818
STAT,1889,24,50-100,1913,0.5764785139992624
STAT,1842,23,na,1865,2060.3622361916105
STAT,1881,23,15-19,1904,3.660892433351069
STAT,1884,52,na,1936,2442.0842259738397
STAT,1873,15,na,1888,3011.7754250052226
STAT,1956,37,35-39,1993,3.8053295866278547
STAT,1815,58,na,1873,1386.0085266806616
STAT,1894,16,35-39,1910,0.8160308006939081
SIM,1882,39,40-44,1921,2
SIM,1957,25,40-44,1982,14
STAT,1823,40,na,1863,1605.5015229294606
SIM,1862,35,20-24,1897,3
STAT,1934,37,15-19,1971,0.030597429757454508
STAT,1872,37,30-34,1909,6.175926495060171
STAT,1884,4,na,1888,3182.4174889783885
SIM,1886,43,45-49,1929,2
SIM,1962,28,35-39,1990,6
STAT,1777,79,na,1856,200.2108555458
STAT,1935,24,35-39,1959,14.795276701516869
STAT,1982,13,na,1995,6377.925753783395
STAT,1954,35,25-29,1989,1.4497012731236683
STAT,1836,37,45-49,1873,2.227644484457679
SIM,1829,47,20-24,1876,1
SIM,1858,68,na,1926,1780
STAT,1933,31,25-29,1964,14.389105499642353
STAT,1901,41,40-44,1942,0.253627873109308
STAT,1868,24,45-49,1892,0.7683274207702391
STAT,1890,19,20-24,1909,24.86529381249977
SIM,1975,31,25-29,2006,3
SIM,1841,31,20-24,1872,3
SIM,1835,39,45-49,1874,2
SIM,1982,18,30-34,2000,43
SIM,1844,37,45-49,1881,2
STAT,1808,73,na,1881,705.2322453506785
STAT,1815,51,50-100,1866,0.030229613465517453
STAT,1876,21,15-19,1897,3.9475480237803398
SIM,1939,25,50-100,1964,1
SIM,1931,51,na,1982,5972
STAT,1854,35,20-24,1889,0.6376174897130527
STAT,1871,25,50-100,1896,0.7394304310174673
STAT,1823,37,35-39,1860,13.25613553254748
STAT,1874,39,40-44,1913,5.1197368509148
STAT,1879,38,50-100,1917,1.4721151221015438
STAT,1797,93,na,1890,8.701907056231153
STAT,1892,44,40-44,1936,0.2228752793843531
STAT,1949,27,na,1976,5049.704265099802
STAT,1954,28,35-39,1982,21.501589430407137
STAT,1827,39,45-49,1866,2.76104418436964
SIM,1962,47,na,2009,5408
STAT,1868,31,35-39,1899,11.274449942256574
STAT,1922,24,25-29,1946,121.42607728322703
STAT,2000,15,50-100,2015,0.6433446704452472
SIM,1861,30,na,1891,1914
SIM,1935,44,na,1979,6201
STAT,1909,34,35-39,1943,9.988856891103811
SIM,1855,37,20-24,1892,1
STAT,1860,40,30-34,1900,1.0801061594517982
STAT,1830,25,na,1855,1775.536553204189
STAT,1841,68,na,1909,1358.7053904255051
SIM,1930,24,25-29,1954,14
SIM,1928,27,20-24,1955,29
SIM,1892,39,50-100,1931,4
STAT,1910,49,na,1959,3936.55621225965
SIM,1941,31,25-29,1972,11
STAT,1861,17,35-39,1878,0.6050767445420152
STAT,1802,54,50-100,1856,0.05774197356881915
STAT,1887,37,25-29,1924,3.7237319698395615
SIM,1826,36,na,1862,2004
SIM,1917,27,45-49,1944,7
STAT,1861,50,40-44,1911,0.010245448574310015
STAT,1810,80,na,1890,352.22087244571213
STAT,1898,65,na,1963,2857.7188279235365
SIM,1900,86,na,1986,824
STAT,1870,49,15-19,1919,4.455873747465203E-4
STAT,1875,18,40-44,1893,0.21755785032869343
STAT,1940,25,20-24,1965,21.5070580887879
SIM,1899,34,40-44,1933,9
STAT,1930,63,na,1993,5016.81086286368
STAT,1909,27,45-49,1936,1.9075407986120279
SIM,1955,37,25-29,1992,1
STAT,1908,25,50-100,1933,1.1039300525792388
STAT,1874,46,30-34,1920,0.11468879355854682
STAT,1913,84,na,1997,1514.3339700355712
STAT,1928,30,50-100,1958,1.1943989950928868
SIM,1885,67,na,1952,2094
SIM,1932,45,40-44,1977,1
SIM,1831,37,35-39,1868,8
SIM,1882,46,30-34,1928,1
STAT,1912,44,na,1956,4105.688748136372
STAT,1935,17,45-49,1952,0.7885283888026122
STAT,1959,15,40-44,1974,2.1125871125511098
STAT,1961,38,20-24,1999,0.4045211291335199
SIM,1815,88,na,1903,93
SIM,1885,30,30-34,1915,32
STAT,1945,41,45-49,1986,0.2183574780417033
SIM,1896,15,na,1911,3954
STAT,1905,47,50-100,1952,0.2303257190726665
SIM,1980,17,15-19,1997,68
STAT,1941,37,40-44,1978,1.8337310954698653
SIM,1830,27,25-29,1857,82
STAT,1819,51,40-44,1870,0.01988843716243515
STAT,1843,51,35-39,1894,0.008679496464491336
STAT,1975,35,na,2010,5911.305257159079
STAT,1907,41,25-29,1948,0.07605988172647081
SIM,1983,2,na,1985,7034
SIM,1913,59,na,1972,4046
STAT,1969,45,na,2014,5534.8205006082635
SIM,1988,22,20-24,2010,13
STAT,1960,27,15-19,1987,1.0656885375898322
SIM,1957,47,40-44,2004,1
SIM,1934,5,na,1939,6081
STAT,1947,16,50-100,1963,0.48717311585083456
SIM,1876,60,na,1936,2396
SIM,1875,36,45-49,1911,4
STAT,1835,24,30-34,1859,14.684984207590878
STAT,1972,17,15-19,1989,67.05868826555695
SIM,1872,29,20-24,1901,19
SIM,1876,33,25-29,1909,2
STAT,1889,46,25-29,1935,0.08217263204981519
SIM,1929,44,na,1973,5200
STAT,1939,30,15-19,1969,0.15154707818059676
STAT,1981,32,20-24,2013,4.012173241013714
STAT,1915,26,25-29,1941,77.75700000076716
STAT,1948,42,na,1990,5097.319446563407
STAT,1941,16,25-29,1957,51.539299397269865
STAT,1945,37,50-100,1982,0.5453031247313822
STAT,1862,27,45-49,1889,1.0853465973714624
SIM,1843,24,30-34,1867,19
STAT,1897,103,na,2000,7.178346475499304
SIM,1949,21,35-39,1970,13
SIM,1983,15,40-44,1998,4
SIM,1925,17,45-49,1942,5
STAT,1873,27,20-24,1900,13.825396301148961
STAT,1980,18,35-39,1998,6.720427122142538
STAT,1917,17,45-49,1934,0.12405990714914818
STAT,1868,33,25-29,1901,11.308742937771454
SIM,1954,15,30-34,1969,21
SIM,1830,29,15-19,1859,1
STAT,1877,30,30-34,1907,21.127903987313356
STAT,1946,15,30-34,1961,15.609766830264133
STAT,1975,15,40-44,1990,2.130629937240971
STAT,1926,15,45-49,1941,0.7099475189070537
STAT,1949,25,40-44,1974,6.288423813907971
STAT,1912,34,na,1946,4262.107983274395
SIM,1876,26,35-39,1902,26
SIM,1973,20,15-19,1993,7
SIM,1928,25,30-34,1953,140
SIM,1923,26,25-29,1949,167
STAT,1847,35,30-34,1882,4.344117692236102
STAT,1854,42,50-100,1896,0.8596285175142359
STAT,1946,22,20-24,1968,142.79791700144995
SIM,1840,62,na,1902,1533
STAT,1901,20,25-29,1921,93.08866875882752
STAT,1915,47,40-44,1962,0.1833769666307827
STAT,1894,23,25-29,1917,84.66368740398289
SIM,1904,27,35-39,1931,37
STAT,1913,92,na,2005,459.521299204106
SIM,1886,39,25-29,1925,2
STAT,1845,41,40-44,1886,1.563352169124309
STAT,1857,53,na,1910,1904.2169533186884
STAT,1975,37,40-44,2012,2.348053623552197
STAT,1878,43,45-49,1921,1.7903576531998195
SIM,1809,61,na,1870,1179
STAT,1846,19,na,1865,2945.938935371072
STAT,1829,29,50-100,1858,0.9816265151317015
STAT,1950,35,40-44,1985,2.108136752601742
SIM,1944,11,na,1955,4661
STAT,1868,48,50-100,1916,0.2688917019078591
SIM,1968,28,20-24,1996,51
STAT,1853,60,na,1913,1898.8242999724166
SIM,1870,27,45-49,1897,3
SIM,1830,31,45-49,1861,2
STAT,1915,33,50-100,1948,0.9678457069846788
STAT,1860,42,50-100,1902,0.9814052816377223
STAT,1917,81,na,1998,2100.079838733764
STAT,1833,34,25-29,1867,9.167934518210204
SIM,1843,38,na,1881,1912
STAT,1901,28,20-24,1929,18.896936327770284
SIM,1855,35,30-34,1890,15
SIM,1904,34,25-29,1938,19
STAT,1867,36,45-49,1903,2.1582971004875233
SIM,1905,24,15-19,1929,12
SIM,1809,49,45-49,1858,1
SIM,1899,36,30-34,1935,4
STAT,1861,3,na,1864,3115.5650214075317
SIM,1853,41,40-44,1894,3
STAT,1883,44,30-34,1927,1.2805598694900355
STAT,1969,35,na,2004,5597.423032915286
SIM,1940,6,na,1946,5156
SIM,1954,22,20-24,1976,4
STAT,1878,50,35-39,1928,0.010522605772375808
STAT,1878,52,na,1930,2580.6596779458628
SIM,1982,20,na,2002,6792
SIM,1932,30,20-24,1962,3
STAT,1828,86,na,1914,147.2590938392646
STAT,1923,85,na,2008,1631.8418518509488
STAT,1878,39,25-29,1917,3.4343876376255644
STAT,1783,79,na,1862,201.91393477582196
SIM,1923,47,40-44,1970,1
SIM,1841,34,25-29,1875,31
STAT,1854,20,35-39,1874,5.667043412999457
SIM,1817,37,35-39,1854,8
STAT,1832,46,25-29,1878,0.04789117021947419
STAT,1927,36,45-49,1963,0.9788238665282577
STAT,1959,43,35-39,2002,0.31540565297549356
STAT,1882,34,20-24,1916,3.0208417791079443
SIM,1840,20,15-19,1860,3
SIM,1876,21,40-44,1897,4
STAT,1893,26,45-49,1919,1.625177856425174
SIM,1964,34,30-34,1998,4
SIM,1868,34,na,1902,3131
STAT,1924,48,45-49,1972,0.2976922070896794
STAT,1886,28,45-49,1914,1.346826791262814
STAT,1863,53,na,1916,2137.8970293281027
SIM,1961,0,na,1961,5680
SIM,1940,21,15-19,1961,6
SIM,1967,22,30-34,1989,95
STAT,1775,105,na,1880,0.027884792883308508
SIM,1849,20,na,1869,2845
STAT,1935,22,45-49,1957,1.7691920256054938
STAT,1944,4,na,1948,4963.060773087724
SIM,1971,10,na,1981,5818
STAT,1918,66,na,1984,3863.943058122661
SIM,1894,28,45-49,1922,5
SIM,1906,33,30-34,1939,31
SIM,1956,47,na,2003,5321
STAT,1829,36,25-29,1865,3.371535543199315
STAT,1828,48,25-29,1876,0.05234854026741834
STAT,1874,52,25-29,1926,0.004162424026399378
SIM,1889,29,na,1918,3771
SIM,1946,36,20-24,1982,1
STAT,1885,92,na,1977,228.6938584575825
SIM,1927,37,30-34,1964,2
STAT,1878,36,20-24,1914,0.9333092034012275
STAT,1932,21,15-19,1953,8.086729538515552
SIM,1928,37,15-19,1965,4
STAT,1840,28,20-24,1868,11.649877280502078
STAT,1969,34,50-100,2003,1.2133947332927784
SIM,1819,54,na,1873,877
SIM,1890,34,20-24,1924,9
STAT,1846,47,30-34,1893,0.0996035752350622
STAT,1913,30,45-49,1943,1.8222500459446414
STAT,1940,16,40-44,1956,1.6399275988141904
STAT,1920,70,na,1990,3671.8671986710274
SIM,1987,20,50-100,2007,1
STAT,1948,32,na,1980,5091.369908155035
STAT,1959,22,30-34,1981,43.53048270480575
STAT,1855,33,15-19,1888,0.12210566964960722
STAT,1910,42,45-49,1952,0.18170751097020782
STAT,1913,26,50-100,1939,1.1490890335703217
SIM,1900,90,na,1990,375
SIM,1936,47,50-100,1983,1
STAT,1961,24,na,1985,5459.110178660733
SIM,1922,36,35-39,1958,12
STAT,1866,40,15-19,1906,0.014920901425122835
STAT,1964,49,50-100,2013,0.3399521305399416
SIM,1850,25,50-100,1875,1
SIM,1832,48,40-44,1880,1
STAT,1974,28,25-29,2002,99.5672238765566
STAT,1921,42,20-24,1963,0.022946966338790786
STAT,1833,46,na,1879,1709.0187126339774
SIM,1914,45,na,1959,3886
SIM,1829,45,30-34,1874,1
SIM,1873,89,na,1962,194
STAT,1914,36,35-39,1950,2.8017475953382642
SIM,1786,80,na,1866,43
SIM,1816,43,na,1859,1723
SIM,1921,26,50-100,1947,6
STAT,1868,26,35-39,1894,10.735133632685171
STAT,1928,47,50-100,1975,0.33304228414787174
SIM,1919,25,20-24,1944,47
STAT,1919,37,30-34,1956,2.259096334232322
SIM,1875,74,na,1949,1292
SIM,1949,23,25-29,1972,219
STAT,1946,27,15-19,1973,0.907515255668682
STAT,1933,33,na,1966,5880.909926668522
SIM,1936,29,na,1965,3837
SIM,1931,35,30-34,1966,2
STAT,1871,34,45-49,1905,1.9849868117058809
SIM,1893,15,30-34,1908,4
STAT,1850,79,na,1929,719.6911323539084
STAT,1968,21,45-49,1989,1.6277355186609397
SIM,1923,23,20-24,1946,161
STAT,1842,25,50-100,1867,0.6175891420265833
SIM,1961,26,45-49,1987,7
STAT,1894,21,35-39,1915,8.683300187444502
STAT,1935,48,20-24,1983,0.017964580581614428
STAT,1958,48,45-49,2006,0.341702688181636
SIM,1839,29,35-39,1868,15
STAT,1953,26,45-49,1979,2.4233561005246202
SIM,1932,48,45-49,1980,1
SIM,1928,32,20-24,1960,8
STAT,1861,39,50-100,1900,1.166050183216461
SIM,1876,24,45-49,1900,1
STAT,1943,39,15-19,1982,0.024162340463788807
SIM,1969,36,45-49,2005,3
STAT,1964,32,15-19,1996,0.19039323318512044
STAT,1922,17,35-39,1939,5.601904891799273
STAT,1839,34,na,1873,2071.634484380937
SIM,1952,38,50-100,1990,2
SIM,1967,15,40-44,1982,4
SIM,1888,88,na,1976,143
STAT,1944,38,50-100,1982,0.5366836467480037
SIM,1877,42,40-44,1919,11
STAT,1906,31,15-19,1937,0.13817154626452896
STAT,1868,21,40-44,1889,2.327168849227982
SIM,1967,43,35-39,2010,2
SIM,1977,34,50-100,2011,1
SIM,1858,41,na,1899,2530
STAT,1854,38,25-29,1892,2.334038715158171
STAT,1870,93,na,1963,84.28083019512434
STAT,1772,91,na,1863,2.2531258790616193
SIM,1956,43,na,1999,5386
STAT,1829,43,15-19,1872,0.014514806606577684
SIM,1930,17,35-39,1947,12
STAT,1976,23,na,1999,5647.088213577306
SIM,1837,36,25-29,1873,5
SIM,1843,42,na,1885,1803
STAT,1903,67,na,1970,3008.772163310153
SIM,1827,80,na,1907,232
STAT,1824,35,na,1859,1813.0690340495723
SIM,1936,23,15-19,1959,5
SIM,1912,19,25-29,1931,24
STAT,1904,19,25-29,1923,9.340649087427547
STAT,1913,18,20-24,1931,31.922655185922757
SIM,1921,18,20-24,1939,194
STAT,1887,17,50-100,1904,0.06336232420198037
STAT,1928,23,15-19,1951,7.646252457421137
STAT,1946,47,35-39,1993,0.17165438773081496
STAT,1877,33,35-39,1910,12.105682505649972
SIM,1862,42,50-100,1904,4
SIM,1821,37,50-100,1858,2
STAT,1945,27,30-34,1972,49.60936035246116
STAT,1900,25,35-39,1925,15.556193347768513
SIM,1830,24,20-24,1854,70
STAT,1869,29,20-24,1898,13.017459492229202
STAT,1879,49,35-39,1928,0.16518026096408545
STAT,1849,28,40-44,1877,2.732475154201437
STAT,1940,28,25-29,1968,77.445785957162
STAT,1968,37,15-19,2005,0.028517189779915776
SIM,1979,31,na,2010,6248
STAT,1877,66,na,1943,1967.541408146816
STAT,1915,23,20-24,1938,132.26074478813885
STAT,1819,54,45-49,1873,0.025826678981894675
SIM,1885,33,35-39,1918,26
SIM,1839,36,50-100,1875,3
STAT,1897,34,15-19,1931,0.21787265088560356
SIM,1896,7,na,1903,4074
SIM,1860,75,na,1935,1332
STAT,1975,18,45-49,1993,0.7602924623463869
STAT,1892,30,15-19,1922,0.20763907291476424
STAT,1816,98,na,1914,1.6042915335605272
STAT,1883,47,35-39,1930,0.15733597615989442
SIM,1859,40,30-34,1899,1
STAT,1855,23,20-24,1878,68.0111049212184
SIM,1934,16,40-44,1950,2
SIM,1868,38,45-49,1906,4
SIM,1871,23,na,1894,2067
STAT,1850,38,40-44,1888,4.5304760214741835
SIM,1902,16,na,1918,4282
SIM,1908,26,40-44,1934,15
STAT,1914,26,40-44,1940,5.443848381039698
STAT,1937,15,20-24,1952,153.00019512053015
SIM,1954,17,20-24,1971,4
STAT,1835,22,40-44,1857,1.794050854864758
STAT,1866,54,40-44,1920,0.010951354471451373
SIM,1853,44,45-49,1897,2
SIM,1953,27,30-34,1980,6
STAT,1827,36,40-44,1863,6.577933568462134
STAT,1856,44,20-24,1900,0.13793941980723695
STAT,1902,49,20-24,1951,0.010807261200655501
STAT,1970,32,45-49,2002,2.317162459093799
STAT,1993,21,25-29,2014,153.92696842383174
SIM,1900,34,40-44,1934,19
STAT,1847,37,20-24,1884,0.6154019088105737
SIM,1876,31,35-39,1907,20
STAT,1801,99,na,1900,0.7949022330460173
STAT,1842,102,na,1944,0.22560555248276676
STAT,1972,35,15-19,2007,0.029283880642298036
SIM,1917,32,45-49,1949,3
STAT,1835,72,na,1907,787.1042001476558
STAT,1890,48,na,1938,3133.2652237137813
SIM,1843,22,40-44,1865,8
SIM,1899,39,35-39,1938,6
SIM,1850,24,na,1874,1682
STAT,1946,17,20-24,1963,173.53465838900843
STAT,1804,80,na,1884,343.35389077840745
STAT,1888,32,15-19,1920,0.19318663292940105
SIM,1922,26,40-44,1948,12
STAT,1856,67,na,1923,1395.703896759038
STAT,1926,16,40-44,1942,1.9835200156268014
STAT,1923,35,30-34,1958,2.4404251710128424
STAT,1909,32,45-49,1941,1.734876703167817
SIM,1863,23,20-24,1886,5
SIM,1921,30,45-49,1951,10
SIM,1974,28,50-100,2002,3
STAT,1845,44,45-49,1889,1.0010120908788254
SIM,1886,36,20-24,1922,1
STAT,1828,30,35-39,1858,12.504627196902828
SIM,1916,30,na,1946,4599
SIM,1858,22,35-39,1880,10
STAT,1950,38,45-49,1988,0.957403862271092
SIM,1843,27,35-39,1870,1
SIM,1854,75,na,1929,1261
STAT,1956,41,20-24,1997,0.02806723591064549
SIM,1917,15,na,1932,5759
STAT,1824,48,40-44,1872,0.22949849452812676
SIM,1907,63,na,1970,3838
STAT,1941,73,na,2014,3254.588592631542
STAT,1833,31,20-24,1864,2.4984492675163437
SIM,1833,76,na,1909,622
SIM,1981,20,45-49,2001,6
STAT,1881,18,15-19,1899,6.588613660287994
STAT,1971,17,30-34,1988,17.815950640194863
SIM,1835,36,40-44,1871,16
STAT,1985,30,30-34,2015,26.38985735671763
STAT,1835,27,35-39,1862,7.867606353379279
SIM,1836,30,35-39,1866,30
SIM,1859,43,35-39,1902,3
STAT,1908,47,15-19,1955,3.8495267431906026E-4
STAT,1901,38,15-19,1939,0.01949534968779681
STAT,1987,26,45-49,2013,2.8598261230023287
STAT,1762,102,na,1864,0.10845234356547168
STAT,1889,43,20-24,1932,0.22429052469501853
STAT,1938,3,na,1941,4619.690704914191
SIM,1901,31,na,1932,4150
STAT,1939,21,na,1960,4235.539230459431
SIM,1949,65,na,2014,4797
SIM,1957,28,45-49,1985,2
STAT,1949,28,45-49,1977,2.3276535850519564
STAT,1850,45,30-34,1895,0.10064384825941047
STAT,1917,49,15-19,1966,4.4144605184658347E-4
STAT,1956,34,30-34,1990,24.49258119456117
STAT,1857,19,35-39,1876,0.5728547807765353
STAT,1947,44,50-100,1991,0.15818265954362282
SIM,1955,44,50-100,1999,1
STAT,1859,50,30-34,1909,0.005550844710828206
STAT,1906,50,na,1956,3696.0734238693844
STAT,1847,38,na,1885,1861.448701466538
STAT,1904,26,25-29,1930,70.34330072085656
SIM,1975,27,50-100,2002,2
STAT,1921,55,na,1976,4627.800124626626
STAT,1860,113,na,1973,1.8078158835414235E-4
SIM,1916,39,45-49,1955,2
STAT,1923,20,20-24,1943,150.1457598330077
STAT,1966,49,na,2015,5475.832149833843
STAT,1958,38,15-19,1996,0.029957316877152522
SIM,1931,39,40-44,1970,1
STAT,1970,17,50-100,1987,0.5412393020983834
SIM,1973,33,50-100,2006,1
SIM,1834,26,40-44,1860,5
SIM,1912,26,25-29,1938,69
SIM,1935,33,40-44,1968,4
STAT,1978,19,30-34,1997,19.184129140451248
STAT,1932,26,30-34,1958,59.268006622968166
STAT,1933,64,na,1997,5165.5532965234925
STAT,1869,27,45-49,1896,1.2408839966206298
STAT,1927,33,40-44,1960,5.550752080573083
SIM,1867,50,30-34,1917,1
STAT,1875,21,30-34,1896,21.30698125404703
SIM,1914,14,na,1928,4320
STAT,1858,49,50-100,1907,0.21649362772019085
SIM,1903,39,35-39,1942,3
SIM,1918,28,na,1946,4047
SIM,1893,40,30-34,1933,2
STAT,1947,29,50-100,1976,1.2982190747264903
STAT,1962,27,25-29,1989,97.74763900805111
SIM,1899,25,30-34,1924,54
SIM,1834,83,na,1917,389
STAT,1943,16,35-39,1959,5.137106730514257
STAT,1811,109,na,1920,3.663260625880156E-4
STAT,1924,16,50-100,1940,0.5160039016790591
SIM,1883,33,25-29,1916,4
STAT,1875,33,25-29,1908,12.163734492508476
STAT,1934,21,35-39,1955,14.61522649126953
SIM,1928,0,na,1928,6444
SIM,1941,28,na,1969,3848
STAT,1961,44,40-44,2005,0.3862783442015492
STAT,1912,45,15-19,1957,4.1087244640082896E-4
STAT,1864,93,na,1957,39.0964167016943
SIM,1970,27,25-29,1997,117
STAT,1892,38,50-100,1930,1.7670410789967774
SIM,1942,21,35-39,1963,25
SIM,1951,16,35-39,1967,10
SIM,1963,31,na,1994,6521
STAT,1796,80,na,1876,300.7135893864627
SIM,1942,29,45-49,1971,3
STAT,1892,25,na,1917,3475.368318867726
STAT,1913,20,50-100,1933,0.7406041581990819
SIM,1857,31,30-34,1888,7
STAT,1939,27,25-29,1966,76.39385861255258
STAT,1866,46,35-39,1912,0.1501778375014424
SIM,1858,10,na,1868,3296
STAT,1946,44,30-34,1990,0.16949525486097367
STAT,1914,44,40-44,1958,0.28520897721790295
STAT,1778,112,na,1890,0.0010581793480898083
STAT,1849,31,30-34,1880,15.833725926700637
STAT,1856,98,na,1954,2.860175744439869
SIM,1853,49,25-29,1902,1
SIM,1911,27,50-100,1938,2
STAT,1979,18,na,1997,5846.787934549301
SIM,1877,24,40-44,1901,1
SIM,1829,37,na,1866,1778
STAT,1914,33,30-34,1947,18.23368088050401
SIM,1917,62,na,1979,4585
STAT,1852,84,na,1936,313.63932610472744
STAT,1863,33,50-100,1896,0.9206909167736812
STAT,1980,5,na,1985,6299.079262510252
STAT,1794,97,na,1891,1.3445934595100841
SIM,1813,45,50-100,1858,2
SIM,1922,33,30-34,1955,42
STAT,1809,64,na,1873,1002.177601620775
STAT,1866,50,50-100,1916,0.01638698703524249
STAT,1840,20,50-100,1860,0.4220510341867516
STAT,1868,99,na,1967,10.767938611917188
SIM,1909,43,40-44,1952,1
STAT,1863,19,20-24,1882,18.358747981354846
SIM,1940,26,30-34,1966,100
STAT,1917,26,35-39,1943,18.233272099835222
STAT,1958,7,na,1965,5957.788796118841
SIM,1929,34,25-29,1963,21
SIM,1920,66,na,1986,3359
STAT,1864,43,20-24,1907,0.16246539763422718
STAT,1881,46,30-34,1927,0.10805682197417436
SIM,1888,32,na,1920,2860
SIM,1979,26,20-24,2005,28
SIM,1987,20,40-44,2007,7
STAT,1930,16,25-29,1946,64.82344312481861
STAT,1928,75,na,2003,3586.886462880888
SIM,1947,27,25-29,1974,125
STAT,1866,17,na,1883,2772.916081088748
SIM,1909,67,na,1976,4009
STAT,1925,69,na,1994,4127.803164744913
STAT,1955,45,25-29,2000,0.08492700649108081
STAT,1818,104,na,1922,0.02951217894081345
STAT,1844,89,na,1933,87.86914206895312
SIM,1804,61,na,1865,987
STAT,1876,94,na,1970,107.35812622493899
STAT,1890,9,na,1899,3658.7445394513943
STAT,1914,85,na,1999,1384.6202603508655
SIM,1847,24,25-29,1871,131
SIM,1859,75,na,1934,318
STAT,1896,41,45-49,1937,0.15913550234677218
SIM,1856,16,20-24,1872,30
STAT,1969,9,na,1978,5665.080871292388
SIM,1984,29,50-100,2013,1
STAT,1940,37,45-49,1977,0.8232280464526212
STAT,1852,16,40-44,1868,0.20979954893299146
STAT,1910,25,40-44,1935,5.2793808018852
STAT,1949,37,35-39,1986,3.3445646821681625
SIM,1905,30,20-24,1935,5
STAT,1909,39,na,1948,4072.814273624832
STAT,1986,22,50-100,2008,1.0855788212707973
SIM,1850,42,30-34,1892,2
STAT,1877,49,15-19,1926,4.7015182403696527E-4
STAT,1961,15,50-100,1976,0.5589080879276256
STAT,1985,28,na,2013,6172.502654064689
STAT,1970,21,45-49,1991,1.6313686588993537
STAT,1934,29,45-49,1963,2.6807476914345463
STAT,1851,32,25-29,1883,8.453892121085953
SIM,1960,17,15-19,1977,74
STAT,1945,24,15-19,1969,6.728316717736169
SIM,1836,21,45-49,1857,1
SIM,1881,5,na,1886,2237
STAT,1907,16,25-29,1923,9.645593172254404
STAT,1955,30,50-100,1985,1.2925951149825627
STAT,1848,27,30-34,1875,31.94216404569108
STAT,1871,63,na,1934,2048.6067491143635
STAT,1788,85,na,1873,132.0259409596747
SIM,1842,19,na,1861,2573
STAT,1970,37,15-19,2007,0.028580840752993462
SIM,1944,34,20-24,1978,3
SIM,1856,27,30-34,1883,60
SIM,1896,67,na,1963,2799
SIM,1930,44,na,1974,5985
STAT,1889,15,25-29,1904,8.098767785877467
STAT,1848,16,20-24,1864,23.489674414723503
STAT,1953,23,40-44,1976,4.707994154994772
SIM,1831,48,35-39,1879,1
SIM,1974,15,na,1989,6399
STAT,1936,34,20-24,1970,2.732255269837742
SIM,1861,32,35-39,1893,6
STAT,1930,16,na,1946,5505.905466247862
STAT,1899,22,30-34,1921,28.162474219440313
SIM,1821,73,na,1894,519
STAT,1885,40,30-34,1925,1.3367472704165588
STAT,1975,29,45-49,2004,2.638989204934816
SIM,1916,20,25-29,1936,121
STAT,1823,48,35-39,1871,0.13640412939988264
STAT,1954,19,15-19,1973,64.70346737003963
STAT,1852,68,na,1920,1440.805174191132
SIM,1952,31,45-49,1983,6
STAT,1840,42,20-24,1882,0.1328968323913212
STAT,1914,47,45-49,1961,0.24887102447369538
SIM,1772,82,na,1854,197
SIM,1961,23,40-44,1984,11
STAT,1821,48,25-29,1869,0.10279681373654861
SIM,1901,23,45-49,1924,1
SIM,1955,35,35-39,1990,4
SIM,1955,24,25-29,1979,307
SIM,1902,25,50-100,1927,2
SIM,1916,31,35-39,1947,14
STAT,1997,16,20-24,2013,228.53331590587675
STAT,1890,33,20-24,1923,3.795552626200146
STAT,1990,18,30-34,2008,20.138100969961194
STAT,1923,39,40-44,1962,1.9967418826617687
STAT,1858,30,15-19,1888,0.13089801996398845
SIM,1850,30,na,1880,1791
SIM,1898,23,50-100,1921,1
SIM,1957,37,35-39,1994,6
STAT,1853,32,35-39,1885,10.383091931119912
SIM,1955,36,na,1991,6527
STAT,1821,37,15-19,1858,0.12494935709923516
STAT,1927,12,na,1939,5684.28762981642
STAT,1810,45,45-49,1855,0.9593737677897762
STAT,1825,42,25-29,1867,0.9552156845910686
STAT,1839,24,25-29,1863,57.497204171190006
STAT,1944,31,45-49,1975,1.9932800866367837
SIM,1983,29,45-49,2012,2
STAT,1908,20,25-29,1928,98.70966424499468
SIM,1970,24,20-24,1994,173
SIM,1893,19,na,1912,3758
STAT,1858,37,40-44,1895,3.941004490089787
SIM,1946,47,30-34,1993,1
STAT,1822,46,na,1868,2169.2031131919925
SIM,1875,22,na,1897,3147
SIM,1880,52,na,1932,3003
SIM,1797,74,na,1871,384
STAT,1766,117,na,1883,1.819607402129725E-4
STAT,1933,42,25-29,1975,0.1132772211297796
SIM,1959,10,na,1969,6028
SIM,1899,28,35-39,1927,42
STAT,1947,24,25-29,1971,120.39123552295911
STAT,1871,39,25-29,1910,3.27241196778918
STAT,1908,31,35-39,1939,10.008107609145663
STAT,1919,34,15-19,1953,0.15859154516487406
STAT,1938,47,30-34,1985,0.10560998104179199
SIM,1931,20,20-24,1951,8
STAT,1906,34,na,1940,4015.3389570565955
STAT,1908,39,45-49,1947,0.7301103769857556
STAT,1947,35,35-39,1982,3.2449859346310297
STAT,1900,18,35-39,1918,0.8763763562212685
SIM,1901,87,na,1988,1136
STAT,1849,47,50-100,1896,0.18946930151314761
STAT,1893,50,na,1943,3186.088503745801
STAT,1815,39,40-44,1854,13.053383641603766
STAT,1895,17,45-49,1912,0.09812694270203795
SIM,1883,30,20-24,1913,4
STAT,1905,102,na,2007,13.82497374511809
SIM,1905,37,na,1942,4180
SIM,1867,27,na,1894,2342
SIM,1927,34,15-19,1961,1
STAT,1851,100,na,1951,0.8418790258624849
STAT,1887,15,15-19,1902,7.710951613250145
STAT,1918,24,50-100,1942,0.8136868376926278
STAT,1853,43,45-49,1896,1.4793193528903124
STAT,1874,17,30-34,1891,1.883072651542886
STAT,1875,24,35-39,1899,6.915799944642429
STAT,1850,16,30-34,1866,2.0169142268787135
SIM,1895,15,15-19,1910,8
STAT,1917,91,na,2008,601.576904221687
SIM,1992,16,35-39,2008,9
STAT,1962,24,20-24,1986,164.85233351054273
STAT,1845,38,15-19,1883,0.03934746814115839
STAT,1954,48,50-100,2002,0.33470598729967727
STAT,1875,30,20-24,1905,3.249567672565914
STAT,1984,16,35-39,2000,6.879673740399339
SIM,1987,23,45-49,2010,8
STAT,1917,23,30-34,1940,35.14419280752405
SIM,1907,41,40-44,1948,2
SIM,1836,66,na,1902,998
SIM,1859,7,na,1866,2705
SIM,1882,17,30-34,1899,3
STAT,1979,23,45-49,2002,1.7931948500858046
STAT,1923,23,25-29,1946,123.60319841361091
STAT,1939,15,30-34,1954,14.120705370402845
SIM,1797,58,na,1855,1172
SIM,1879,32,20-24,1911,3
STAT,1826,29,45-49,1855,1.9224843222845913
SIM,1831,35,na,1866,1721
STAT,1838,21,na,1859,2420.2119090413566
SIM,1839,15,na,1854,2631
STAT,1939,75,na,2014,2928.1563040718834
SIM,1888,27,20-24,1915,30
STAT,1806,99,na,1905,0.6500143904887832
SIM,1923,24,35-39,1947,1
STAT,1943,42,na,1985,4723.8213156592465
SIM,1912,31,na,1943,3936
STAT,1894,30,25-29,1924,15.317447088531381
STAT,1823,71,na,1894,755.8813517199019
SIM,1947,15,30-34,1962,36
SIM,1894,20,25-29,1914,176
STAT,1942,41,na,1983,4662.321772785829
SIM,1925,23,30-34,1948,57
SIM,1888,38,30-34,1926,14
STAT,1886,46,50-100,1932,0.2998204534089115
SIM,1884,82,na,1966,625
STAT,1902,18,45-49,1920,0.10623763267799916
STAT,1934,46,na,1980,5924.562305024333
STAT,1930,32,na,1962,5633.500322027718
SIM,1939,2,na,1941,5152
SIM,1904,18,15-19,1922,12
SIM,1979,29,25-29,2008,7
STAT,1885,71,na,1956,1571.9203094367897
STAT,1888,47,25-29,1935,0.07777440955172653
SIM,1841,42,50-100,1883,2
SIM,1980,25,na,2005,5701
STAT,1883,40,20-24,1923,0.1811239178908221
STAT,1901,59,na,1960,3268.2982175848347
SIM,1860,2,na,1862,3517
STAT,1841,29,40-44,1870,3.260647704191535
STAT,1842,42,30-34,1884,0.9153168049058089
STAT,1889,85,na,1974,895.8884425508168
SIM,1916,36,50-100,1952,1
STAT,1937,4,na,1941,4533.874860204138
SIM,1847,10,na,1857,3117
STAT,1933,41,40-44,1974,0.3973469611227063
STAT,1897,22,20-24,1919,106.34119994910883
STAT,1952,57,na,2009,5052.709099922288
STAT,1973,25,35-39,1998,22.52485462902417
STAT,1814,94,na,1908,12.461689106248256
STAT,1881,49,35-39,1930,0.15258429437596432
STAT,1847,81,na,1928,416.0936018552898
STAT,1951,23,30-34,1974,39.614753755205626
STAT,1908,36,50-100,1944,0.45641609885506645
STAT,1971,19,20-24,1990,198.03319334446914
SIM,1850,14,na,1864,2218
SIM,1947,24,20-24,1971,3
STAT,1833,42,50-100,1875,0.9072323670034906
STAT,1841,41,na,1882,2162.831651093146
SIM,1975,21,50-100,1996,2
SIM,1948,64,na,2012,3933
SIM,1802,78,na,1880,254
SIM,1976,33,40-44,2009,2
STAT,1827,53,45-49,1880,0.01739064610544784
STAT,1928,24,45-49,1952,1.6110647607443471
STAT,1827,42,35-39,1869,2.415124530004134
SIM,1843,60,na,1903,1495
STAT,1819,48,15-19,1867,7.590950745509833E-4
SIM,1909,11,na,1920,5088
STAT,1918,41,45-49,1959,0.20446078397473816
SIM,1857,34,35-39,1891,30
STAT,1868,40,25-29,1908,0.7191872958476963
STAT,1976,13,na,1989,6055.394148954545
STAT,1939,24,20-24,1963,128.83897745209455
SIM,1948,47,40-44,1995,1
STAT,1968,33,40-44,2001,5.746159745550495
STAT,1776,84,na,1860,150.1242270810393
SIM,1918,31,45-49,1949,2
SIM,1853,19,na,1872,2691
SIM,1867,17,35-39,1884,1
STAT,1859,17,35-39,1876,0.5855385829715953
SIM,1926,41,45-49,1967,2
SIM,1832,26,30-34,1858,30
SIM,1896,83,na,1979,1494
STAT,1900,43,50-100,1943,0.11663031093671444
STAT,1849,34,35-39,1883,8.101065774288283
STAT,1957,42,40-44,1999,0.395513257655558
STAT,1954,42,na,1996,5506.421088528885
STAT,1996,6,na,2002,6593.262299950287
STAT,1832,35,25-29,1867,2.584987328767523
STAT,1917,34,na,1951,4531.479375253424
SIM,1835,42,35-39,1877,4
SIM,1938,24,na,1962,3538
STAT,1936,70,na,2006,3295.7277696739293
STAT,1920,42,15-19,1962,0.0019565009778954256
SIM,1982,10,na,1992,6825
STAT,1834,71,na,1905,1218.139830685797
SIM,1855,45,na,1900,1789
STAT,1966,24,50-100,1990,0.9509387995948568
SIM,1953,29,20-24,1982,53
STAT,1921,29,35-39,1950,19.16517967178052
SIM,1905,33,25-29,1938,6
STAT,1902,26,15-19,1928,0.7423589386896587
STAT,1981,24,15-19,2005,8.612628023275787
STAT,1848,19,25-29,1867,7.376323669874963
STAT,1862,49,30-34,1911,0.09230823279032496
STAT,1816,52,30-34,1868,0.011654559942056037
STAT,1846,50,45-49,1896,0.015218268569693749
STAT,1852,19,45-49,1871,0.07361219038308098
STAT,1914,45,25-29,1959,0.06102728554601024
SIM,1914,36,30-34,1950,3
SIM,1969,16,20-24,1985,1
STAT,1898,81,na,1979,1554.6293417281852
SIM,1861,43,45-49,1904,2
SIM,1864,22,na,1886,2571
SIM,1866,37,40-44,1903,1
SIM,1860,91,na,1951,141
STAT,1986,29,20-24,2015,30.116524858092372
STAT,1882,16,20-24,1898,20.032947258008424
SIM,1857,43,25-29,1900,3
SIM,1840,35,25-29,1875,3
SIM,1959,47,50-100,2006,1
SIM,1961,46,na,2007,5524
STAT,1837,29,20-24,1866,10.747408703170453
SIM,1867,70,na,1937,1213
STAT,1875,49,40-44,1924,0.1999093727322445
STAT,1933,18,50-100,1951,0.5775293226713412
SIM,1877,27,45-49,1904,1
SIM,1837,19,20-24,1856,38
SIM,1941,18,50-100,1959,1
STAT,1892,36,35-39,1928,10.279756516796443
STAT,1872,35,50-100,1907,1.4362226824696689
STAT,1925,47,20-24,1972,0.015449218991379795
STAT,1915,24,35-39,1939,11.164167146297945
STAT,1871,28,15-19,1899,0.5190742521041292
STAT,1940,35,25-29,1975,1.191049682034903
STAT,1906,36,30-34,1942,1.9451955893745652
STAT,1945,29,20-24,1974,23.088558575480636
STAT,1910,55,na,1965,3835.4933087693526
STAT,1892,47,45-49,1939,0.19165692464682274
STAT,1960,19,45-49,1979,0.7503460982397903
SIM,1892,27,40-44,1919,12
STAT,1912,33,20-24,1945,2.760801355317436
STAT,1951,37,20-24,1988,0.37321943119980483
SIM,1872,57,na,1929,2513
SIM,1931,8,na,1939,6396
STAT,1953,39,20-24,1992,0.3783374858386066
SIM,1845,29,20-24,1874,1
STAT,1955,43,15-19,1998,0.002441131849151431
SIM,1970,42,na,2012,5931
STAT,1922,22,50-100,1944,0.8704304532929484
STAT,1886,20,25-29,1906,70.10150590476663
STAT,1901,31,25-29,1932,16.624655439646286
STAT,1991,7,na,1998,6500.789732254981
STAT,1863,68,na,1931,1542.119673011764
STAT,1845,49,25-29,1894,0.03800363474148722
SIM,1986,19,20-24,2005,470
SIM,1966,1,na,1967,5957
SIM,1898,10,na,1908,4194
STAT,1919,39,20-24,1958,0.32605108839657737
SIM,1818,53,na,1871,1936
SIM,1936,27,25-29,1963,9
SIM,1922,49,na,1971,4940
STAT,1964,37,20-24,2001,0.39475081972260734
SIM,1931,23,25-29,1954,293
SIM,1822,47,50-100,1869,1
STAT,1969,25,15-19,1994,1.023010246249235
SIM,1930,22,50-100,1952,2
SIM,1869,53,na,1922,1699
STAT,1926,30,na,1956,5282.524766340625
STAT,1968,32,na,2000,5556.847089488479
SIM,1929,28,na,1957,5063
STAT,1855,33,na,1888,2046.1124110247467
STAT,1860,63,na,1923,1659.5968195476746
STAT,1936,37,25-29,1973,1.1161775708917847
STAT,1844,38,50-100,1882,1.073953736483714
STAT,1928,27,25-29,1955,93.57973716210289
STAT,1839,33,15-19,1872,0.13754556424344502
SIM,1920,33,20-24,1953,3
SIM,1938,21,15-19,1959,9
SIM,1869,25,15-19,1894,1
STAT,1859,35,50-100,1894,1.1393888207878584
STAT,1869,24,40-44,1893,2.314302868584424
STAT,1904,23,20-24,1927,113.85022006219144
STAT,1920,95,na,2015,250.83854068092018
SIM,1926,23,na,1949,5622
SIM,1852,38,50-100,1890,2
STAT,1821,45,20-24,1866,0.022328288227770145
STAT,1884,27,40-44,1911,3.415604824953727
STAT,1875,93,na,1968,128.9981034716258
SIM,1927,24,na,1951,4732
STAT,1853,40,40-44,1893,2.262018314033937
STAT,1966,30,15-19,1996,0.18902264056406792
STAT,1938,31,15-19,1969,0.1492762122321554
STAT,1961,33,40-44,1994,5.943836190491672
STAT,1939,18,35-39,1957,4.847718935167254
STAT,1911,80,na,1991,2043.3632826580344
SIM,1844,31,45-49,1875,1
STAT,1967,17,35-39,1984,6.049026798189913
STAT,1830,32,50-100,1862,0.9913490740095676
STAT,1854,32,na,1886,1990.8966780930289
SIM,1788,78,na,1866,100
SIM,1911,32,40-44,1943,11
STAT,1928,34,na,1962,5450.403742427289
STAT,1865,94,na,1959,35.081820896604
SIM,1796,73,na,1869,527
SIM,1829,41,20-24,1870,1
STAT,1850,19,35-39,1869,0.6821505109758714
SIM,1993,20,35-39,2013,42
STAT,2004,4,na,2008,6935.437434452894
SIM,1842,46,45-49,1888,1
STAT,1825,30,30-34,1855,42.936948555027094
SIM,1946,45,40-44,1991,1
SIM,1947,18,35-39,1965,14
STAT,1931,48,35-39,1979,0.19843915513966762
SIM,1873,23,15-19,1896,8
STAT,1834,35,35-39,1869,8.19721783178396
STAT,1838,40,45-49,1878,1.555757422613996
STAT,1845,55,na,1900,1393.3389337115502
STAT,1946,21,50-100,1967,0.8452871235525946
STAT,1834,46,45-49,1880,0.25423157420210674
STAT,1956,27,30-34,1983,60.09335701087734
STAT,1928,28,30-34,1956,55.6809767456481
STAT,1811,46,na,1857,1570.7087621188782
STAT,1932,27,45-49,1959,2.6120285212478724
SIM,1975,3,na,1978,6133
STAT,1933,44,45-49,1977,0.26313058640111914
STAT,1899,35,30-34,1934,8.506464759938394
SIM,1972,21,15-19,1993,15
STAT,1868,42,50-100,1910,1.169917514872178
SIM,1842,35,35-39,1877,14
STAT,1880,40,na,1920,2855.7312917894774
SIM,1962,30,na,1992,5440
SIM,1854,19,15-19,1873,15
STAT,1846,19,15-19,1865,7.616320473104888
STAT,1874,68,na,1942,1805.484769100133
STAT,1982,17,30-34,1999,19.793680872019326
STAT,1895,17,na,1912,3793.9452606495393
SIM,1889,42,30-34,1931,1
STAT,1814,44,15-19,1858,0.04067964347117941
STAT,1899,24,20-24,1923,108.27342623329001
STAT,1948,15,50-100,1963,0.4950595729723757
STAT,1979,35,15-19,2014,0.03149116341783704
STAT,1864,20,40-44,1884,2.2134436566978866
STAT,1917,37,20-24,1954,0.3159892059667341
STAT,1931,40,25-29,1971,0.11042285634809552
STAT,1903,27,50-100,1930,1.0515117657998294
STAT,1964,21,15-19,1985,7.765480352800284
SIM,1921,20,50-100,1941,2
SIM,1855,31,20-24,1886,1
STAT,1883,43,25-29,1926,0.7198169207157277
STAT,1960,16,40-44,1976,2.1029667744274803
STAT,1891,30,50-100,1921,1.3173623969040265
STAT,1929,44,25-29,1973,0.1063732034982856
STAT,1827,50,40-44,1877,0.013389326383553907
SIM,1846,40,45-49,1886,3
STAT,1904,35,15-19,1939,0.020277035355078226
SIM,1818,41,45-49,1859,2
STAT,1938,45,40-44,1983,0.18766038712512972
SIM,1964,27,30-34,1991,135
STAT,1907,72,na,1979,2801.776327322492
SIM,1873,58,na,1931,2799
SIM,1831,45,30-34,1876,1
SIM,1906,62,na,1968,3052
STAT,1823,45,30-34,1868,0.09835832856564508
STAT,1886,56,na,1942,2482.8692251939983
STAT,1931,17,na,1948,5561.127355085575
STAT,1997,16,50-100,2013,0.6315399869831603
STAT,1954,18,30-34,1972,17.383790494374914
STAT,1928,2,na,1930,5947.0629802208105
STAT,1843,23,30-34,1866,22.27257899795766
STAT,1922,43,30-34,1965,0.16900491273834198
STAT,1962,36,15-19,1998,0.02928108853524005
STAT,1865,23,15-19,1888,3.451921656803599
STAT,1995,19,15-19,2014,75.7636480944607
STAT,1963,44,15-19,2007,0.002332114977296803
STAT,1872,53,20-24,1925,8.413730231150313E-4
SIM,1895,8,na,1903,4026
STAT,1919,60,na,1979,4281.240374005227
STAT,1985,20,35-39,2005,15.51695982131386
SIM,1833,30,30-34,1863,39
STAT,1943,26,na,1969,4606.808467117202
SIM,1930,43,30-34,1973,1
STAT,1797,62,na,1859,1094.1256815815261
STAT,1950,0,na,1950,6011.4337581781265
SIM,1841,34,na,1875,1911
SIM,1969,7,na,1976,5831
STAT,1902,15,40-44,1917,0.29963254894726343
SIM,1851,23,30-34,1874,2
SIM,1975,17,35-39,1992,17
STAT,1835,52,35-39,1887,0.005475136595179082
STAT,1910,39,na,1949,4114.9006947374055
SIM,1923,31,na,1954,5386
STAT,1910,20,35-39,1930,10.276094567975651
STAT,1894,21,50-100,1915,0.6067995250710545
SIM,1866,36,35-39,1902,2
STAT,1882,23,20-24,1905,77.43916813257738
SIM,1938,37,30-34,1975,3
SIM,1933,33,30-34,1966,45
SIM,1897,37,50-100,1934,5
SIM,1934,72,na,2006,3988
STAT,1901,33,45-49,1934,2.806962889919162
STAT,1930,25,15-19,1955,1.0369676863716777
STAT,1955,34,25-29,1989,14.41483628330482
STAT,1964,35,40-44,1999,2.245597312562925
SIM,1937,23,na,1960,3831
SIM,1914,39,35-39,1953,3
SIM,1896,24,45-49,1920,1
SIM,1837,88,na,1925,227
STAT,1906,37,45-49,1943,0.7240999978718194
STAT,1878,42,na,1920,2781.512480647739
SIM,1866,47,45-49,1913,1
STAT,1877,34,40-44,1911,5.161417704276747
SIM,1963,34,25-29,1997,3
STAT,1890,46,50-100,1936,0.19591108855933875
STAT,1910,28,45-49,1938,1.9204684406875696
STAT,1844,33,na,1877,2145.3404393676997
STAT,2000,14,na,2014,6739.197434214671
STAT,1888,24,45-49,1912,0.9400468035158988
SIM,1836,23,35-39,1859,10
STAT,1906,39,35-39,1945,2.543260891625737
SIM,1915,36,na,1951,4705
STAT,1949,35,45-49,1984,0.9442908088199763
SIM,1885,34,40-44,1919,7
STAT,1906,20,15-19,1926,5.584957251001008
SIM,1891,43,25-29,1934,4
STAT,1790,67,na,1857,760.9383739405041
SIM,1949,27,35-39,1976,2
STAT,1862,21,45-49,1883,0.7002600949891703
STAT,1918,35,na,1953,4618.785504730165
STAT,1787,84,na,1871,86.22781048388984
STAT,1857,43,na,1900,2062.3605400530932
SIM,1914,37,45-49,1951,1
STAT,1873,24,25-29,1897,67.04103995286972
STAT,1925,33,30-34,1958,21.57092525258483
SIM,1890,7,na,1897,3806
STAT,1944,44,20-24,1988,0.022718664477174754
SIM,1883,57,na,1940,2124
SIM,1881,21,20-24,1902,139
STAT,1935,43,40-44,1978,0.4067301617311231
SIM,1914,20,15-19,1934,12
STAT,1917,38,50-100,1955,0.5007845482613958
SIM,1919,24,15-19,1943,1
SIM,1940,27,45-49,1967,6
STAT,1881,25,na,1906,2674.5310960365046
SIM,1828,52,na,1880,1894
STAT,1934,41,50-100,1975,0.18909049290068863
STAT,1845,46,20-24,1891,0.008109217588539046
SIM,1825,33,30-34,1858,28
STAT,1986,29,na,2015,6180.644479452486
SIM,1807,53,na,1860,1114
SIM,1903,38,20-24,1941,1
SIM,1803,79,na,1882,460
SIM,1870,21,45-49,1891,6
SIM,1855,34,25-29,1889,5
SIM,1890,14,na,1904,3735
STAT,1862,47,50-100,1909,0.23808264731943374
SIM,1855,46,30-34,1901,1
STAT,1847,34,25-29,1881,8.247658748463724
STAT,1836,31,45-49,1867,2.027655764817807
SIM,1903,49,30-34,1952,1
STAT,1990,20,50-100,2010,1.0918222206915844
STAT,1867,98,na,1965,13.626713173900916
STAT,1957,45,35-39,2002,0.20501236483177093
SIM,1823,39,40-44,1862,2
SIM,1890,23,20-24,1913,93
STAT,1977,23,35-39,2000,14.72585267657251
SIM,1895,82,na,1977,794
SIM,1952,31,na,1983,4650
STAT,1921,26,30-34,1947,50.55047748908573
STAT,1890,20,45-49,1910,0.9891742067749436
STAT,1920,54,na,1974,4562.384109376856
SIM,1803,60,na,1863,1391
STAT,1936,46,15-19,1982,4.2265749987234583E-4
SIM,1995,18,na,2013,6300
STAT,1850,51,25-29,1901,0.003663757353634985
SIM,1874,83,na,1957,347
STAT,1851,20,30-34,1871,17.11292217081096
STAT,1829,25,na,1854,1922.3786757431444
SIM,1985,23,35-39,2008,18
STAT,1917,50,na,1967,4388.623138998928
STAT,1856,36,25-29,1892,2.5471881091041784
SIM,1868,31,30-34,1899,21
SIM,1988,21,na,2009,6217
SIM,1883,26,50-100,1909,1
SIM,1874,21,na,1895,2402
SIM,1833,42,25-29,1875,3
STAT,1928,29,15-19,1957,1.0026930812436663
STAT,1768,89,na,1857,33.394055962490995
SIM,1904,36,na,1940,4129
SIM,1988,16,15-19,2004,82
SIM,1864,36,25-29,1900,5
SIM,1924,75,na,1999,3062
SIM,1948,23,na,1971,3832
STAT,1868,43,na,1911,2544.115969898157
STAT,1849,44,30-34,1893,0.8790435209952143
SIM,1916,36,40-44,1952,4
SIM,1946,60,na,2006,4254
STAT,1914,49,50-100,1963,0.25747651771088703
STAT,1931,45,30-34,1976,0.1382365707784538
STAT,1928,24,20-24,1952,159.2127575656936
SIM,1894,22,45-49,1916,1
SIM,1972,39,40-44,2011,1
STAT,1814,52,20-24,1866,0.001961565744757145
SIM,1889,45,35-39,1934,1
STAT,1953,34,15-19,1987,0.1826303546746151
SIM,1982,31,15-19,2013,4
STAT,1789,105,na,1894,0.005943335072998053
STAT,1877,20,na,1897,2856.0503438399573
STAT,1927,47,30-34,1974,0.1291099933166112
STAT,1874,53,30-34,1927,0.006919706844603608
SIM,1972,28,30-34,2000,3
STAT,1961,36,45-49,1997,1.0481406190612965
SIM,1922,49,50-100,1971,2
SIM,1972,11,na,1983,5835
STAT,1864,23,45-49,1887,0.7248618591908312
STAT,1951,56,na,2007,5055.690500463642
SIM,1813,78,na,1891,353
SIM,1961,37,30-34,1998,4
STAT,1938,74,na,2012,3004.1706432145193
STAT,1932,29,35-39,1961,22.676988576522998
SIM,1937,64,na,2001,3528
SIM,1913,32,na,1945,4718
SIM,1917,46,na,1963,5280
STAT,1931,42,15-19,1973,0.0023681119112329645
SIM,1872,23,45-49,1895,2
SIM,1885,83,na,1968,1356
SIM,1859,44,40-44,1903,4
STAT,1783,104,na,1887,0.025237411709967877
SIM,1940,29,35-39,1969,49
STAT,1855,17,na,1872,2323.114713308244
STAT,1950,53,na,2003,5103.4208747314415
SIM,1870,47,50-100,1917,2
STAT,1886,93,na,1979,197.69487662083904
STAT,1875,23,20-24,1898,81.9307736526938
SIM,1774,86,na,1860,154
SIM,1935,47,30-34,1982,1
STAT,1886,22,45-49,1908,0.8488573241859636
SIM,1894,57,na,1951,3177
SIM,1936,24,20-24,1960,3
SIM,1897,49,na,1946,3441
STAT,1964,39,40-44,2003,2.2369417896605133
STAT,1922,46,35-39,1968,0.17128305516220443
STAT,1825,33,35-39,1858,19.75477860011482
SIM,1913,19,30-34,1932,7
SIM,1833,33,35-39,1866,4
STAT,1952,17,15-19,1969,62.76376020883246
SIM,1991,5,na,1996,6714
SIM,1783,82,na,1865,247
STAT,1871,106,na,1977,0.37529797930132264
STAT,1960,52,na,2012,5647.06395936688
STAT,1929,41,20-24,1970,0.026433238551491763
SIM,1872,30,45-49,1902,1
SIM,1872,73,na,1945,1805
SIM,1883,21,30-34,1904,54
SIM,1787,96,na,1883,13
SIM,1835,22,na,1857,2453
SIM,1976,2,na,1978,6064
STAT,1968,18,na,1986,5303.79851971739
SIM,1930,46,35-39,1976,1
STAT,1953,37,30-34,1990,2.6213708764593737
SIM,1852,40,na,1892,1934
STAT,1818,41,na,1859,1329.7171506106033
STAT,1938,48,45-49,1986,0.2567630878730874
SIM,1849,33,25-29,1882,22
STAT,1885,43,35-39,1928,2.0693869499220185
SIM,1948,31,25-29,1979,25
SIM,1800,54,35-39,1854,1
SIM,1876,87,na,1963,390
SIM,1946,46,25-29,1992,1
STAT,1853,69,na,1922,1461.114063783712
STAT,1905,19,30-34,1924,2.647998473263336
SIM,1936,29,15-19,1965,1
SIM,1948,42,35-39,1990,1
SIM,1829,44,25-29,1873,2
STAT,1921,23,15-19,1944,6.914658022575776
STAT,1864,9,na,1873,2853.8937148460814
SIM,1839,16,15-19,1855,12
SIM,1863,40,na,1903,2354
STAT,1921,28,20-24,1949,23.386717374708187
STAT,1933,44,50-100,1977,0.1857392369273539
STAT,1821,45,na,1866,1629.854373189109
SIM,1930,28,na,1958,5830
STAT,1835,36,50-100,1871,0.9574389862249745
STAT,1907,35,na,1942,4070.2475838373834
STAT,1921,39,30-34,1960,2.3426757038732102
SIM,1963,15,na,1978,6572
STAT,1974,31,15-19,2005,0.19750363955039288
SIM,1843,36,50-100,1879,5
STAT,1949,48,20-24,1997,0.015385148351630299
SIM,1828,42,50-100,1870,2
SIM,1964,18,40-44,1982,1
SIM,1914,34,40-44,1948,7
SIM,1836,20,30-34,1856,1
STAT,1772,108,na,1880,6.471559166513113E-4
STAT,1858,21,25-29,1879,59.55956170801534
STAT,1780,89,na,1869,51.52806574370715
STAT,1965,17,25-29,1982,62.43561071629884
SIM,1786,74,na,1860,165
STAT,1882,26,25-29,1908,47.846430938361145
SIM,1832,29,35-39,1861,25
SIM,1898,31,na,1929,3900
SIM,1866,21,25-29,1887,141
STAT,1927,26,50-100,1953,1.4009488214042296
SIM,1951,27,na,1978,6017
SIM,1973,17,25-29,1990,140
SIM,1985,20,30-34,2005,3
STAT,1872,45,15-19,1917,4.6814159290503474E-4
STAT,1856,33,20-24,1889,2.3841586742891443
STAT,1956,18,40-44,1974,2.1352596159749244
SIM,1864,33,20-24,1897,6
SIM,1866,44,40-44,1910,2
STAT,1847,31,20-24,1878,2.467534122568065
STAT,1961,47,20-24,2008,0.017138813977227593
SIM,1984,18,na,2002,5498
STAT,1801,53,30-34,1854,0.023208829176238788
SIM,1905,8,na,1913,4604
SIM,1824,78,na,1902,30
STAT,1900,15,30-34,1915,2.564210460555869
SIM,1820,43,35-39,1863,4
STAT,1906,34,40-44,1940,4.154710882932097
STAT,1954,26,na,1980,5370.022614965786
SIM,1942,26,40-44,1968,9
SIM,1932,7,na,1939,5759
STAT,1937,71,na,2008,3267.031064127638
SIM,1814,60,na,1874,1007
STAT,1848,18,40-44,1866,0.2394936971802961
SIM,1896,21,40-44,1917,7
SIM,1935,26,50-100,1961,3
STAT,1955,31,20-24,1986,3.8112478015352327
STAT,1975,26,40-44,2001,7.130174776467498
STAT,1926,27,15-19,1953,0.9764380685463382
STAT,1881,47,15-19,1928,4.431754817173688E-4
STAT,1891,24,na,1915,3352.1943038672284
STAT,1893,24,50-100,1917,0.5911275561899898
STAT,1934,26,40-44,1960,7.243000288063781
SIM,1868,32,45-49,1900,2
STAT,1860,16,50-100,1876,0.05286562313439777
STAT,1819,103,na,1922,0.09553973146886068
STAT,1851,48,40-44,1899,0.1340548764769309
STAT,1860,36,45-49,1896,1.8630834036661277
STAT,1888,21,40-44,1909,2.835376620461192
SIM,1877,32,na,1909,3144
STAT,1858,44,40-44,1902,1.9976579614902956
STAT,1860,25,35-39,1885,9.20238313095792
SIM,1983,26,40-44,2009,14
STAT,1917,24,45-49,1941,1.371462152554058
STAT,1912,20,45-49,1932,1.25305378232326
SIM,1857,33,20-24,1890,3
STAT,1803,52,45-49,1855,0.05265674029628584
SIM,1870,3,na,1873,3983
SIM,1936,23,50-100,1959,2
STAT,1942,46,45-49,1988,0.27336412495763257
SIM,1949,3,na,1952,5979
STAT,1812,43,35-39,1855,4.887637805002848
STAT,1877,18,50-100,1895,0.058657964509520225
STAT,1884,20,15-19,1904,3.7840603772204493
SIM,1938,28,40-44,1966,19
STAT,1777,113,na,1890,3.730064000465259E-4
STAT,1889,24,15-19,1913,4.663710641353071
STAT,1941,16,na,1957,4377.590831323301
STAT,1888,20,na,1908,3227.507794079065
STAT,1950,46,40-44,1996,0.22433215117880137
STAT,1830,41,na,1871,1628.3284245364405
STAT,1920,17,na,1937,4763.702623673436
STAT,1871,36,20-24,1907,0.889291637728328
STAT,1925,24,40-44,1949,4.614148876797455
STAT,1908,36,40-44,1944,1.6273463917601425
STAT,1812,54,45-49,1866,0.030884426038278363
STAT,1808,63,na,1871,1216.6825637939069
SIM,1925,24,45-49,1949,2
STAT,1948,52,na,2000,4961.763325613657
SIM,1856,18,40-44,1874,1
SIM,1892,20,15-19,1912,9
SIM,1916,61,na,1977,4172
SIM,1920,20,45-49,1940,3
STAT,1777,85,na,1862,63.22246885916738
STAT,1953,41,na,1994,5396.0437572536475
SIM,1974,21,25-29,1995,271
STAT,1903,32,40-44,1935,7.128595720698989
STAT,1867,23,25-29,1890,61.49088830947501
STAT,1873,21,20-24,1894,81.45786292632367
STAT,1849,33,20-24,1882,2.184859910262952
SIM,1994,16,45-49,2010,5
STAT,1854,31,50-100,1885,0.7724015624017228
STAT,1944,40,35-39,1984,0.2606283722052128
SIM,1901,39,25-29,1940,4
STAT,1851,23,35-39,1874,5.486466444500625
SIM,1862,31,50-100,1893,8
SIM,1950,46,45-49,1996,2
STAT,1932,24,40-44,1956,5.075046669033096
STAT,1932,42,na,1974,5810.396679557625
STAT,1901,30,40-44,1931,7.066576566256805
SIM,1898,93,na,1991,386
STAT,1977,14,na,1991,6122.876978185049
STAT,1966,32,35-39,1998,13.426820483458078
STAT,1923,1,na,1924,5657.036290908568
SIM,1858,44,50-100,1902,4
STAT,1804,89,na,1893,45.67716531416669
SIM,1949,24,30-34,1973,87
STAT,1879,86,na,1965,526.8409395673681
STAT,1975,29,na,2004,5722.380080106887
SIM,1890,26,25-29,1916,11
SIM,1943,46,45-49,1989,2
SIM,1875,23,25-29,1898,151
STAT,1798,84,na,1882,100.6101663149446
STAT,1859,53,35-39,1912,0.007787275321977072
STAT,1986,16,45-49,2002,0.821671764884708
STAT,1935,46,45-49,1981,0.3551691457254774
SIM,1959,48,na,2007,5789
STAT,1966,21,25-29,1987,133.6276932979175
SIM,1849,14,na,1863,3146
SIM,1873,38,50-100,1911,4
STAT,1904,86,na,1990,1064.183379994494
SIM,1928,29,50-100,1957,2
STAT,1870,25,na,1895,2733.626057496506
SIM,1924,59,na,1983,4504
STAT,1983,18,na,2001,6007.089315611347
SIM,1886,68,na,1954,1087
STAT,1929,22,na,1951,5329.633932828012
SIM,1878,41,40-44,1919,5
STAT,1842,51,50-100,1893,0.011677553464543642
STAT,1932,25,25-29,1957,99.60226794043412
STAT,1792,93,na,1885,10.609698875025796
SIM,1827,40,40-44,1867,1
SIM,1892,34,40-44,1926,10
STAT,1936,30,35-39,1966,10.26126117143803
STAT,1884,34,40-44,1918,4.90247963037001
STAT,1903,48,20-24,1951,0.01098691953307352
SIM,1919,17,15-19,1936,61
STAT,1957,35,40-44,1992,2.3507269414466228
STAT,1849,47,35-39,1896,0.1080036738289251
STAT,1930,27,50-100,1957,1.4607882859391874
SIM,1823,35,30-34,1858,6
STAT,1820,39,50-100,1859,1.6670246340769481
SIM,1920,48,30-34,1968,1
SIM,1865,60,na,1925,2481
STAT,1880,19,15-19,1899,7.220456626749253
SIM,1970,20,35-39,1990,4
SIM,1873,29,35-39,1902,2
STAT,1886,24,35-39,1910,7.059125202697863
SIM,1818,40,30-34,1858,1
SIM,1981,22,20-24,2003,340
SIM,1854,23,na,1877,2565
STAT,1912,48,30-34,1960,0.0986903044816989
STAT,1915,24,na,1939,4329.825909829867
SIM,1844,30,30-34,1874,11
STAT,1854,88,na,1942,111.84452686043335
STAT,1896,18,na,1914,3839.659984726811
SIM,1941,43,30-34,1984,1
STAT,1923,30,25-29,1953,12.321759348302573
STAT,1844,41,45-49,1885,1.2986076062739322
SIM,1978,30,35-39,2008,19
STAT,1892,42,20-24,1934,0.2294298087455159
SIM,1903,22,50-100,1925,2
SIM,1932,54,na,1986,5216
SIM,2004,2,na,2006,7412
SIM,1907,34,40-44,1941,14
STAT,1784,98,na,1882,0.6210830459335663
SIM,1868,22,40-44,1890,3
STAT,1823,54,20-24,1877,6.748995736535442E-4
STAT,1855,41,20-24,1896,0.135744747075224
SIM,1894,24,35-39,1918,26
SIM,1922,49,35-39,1971,1
STAT,1873,48,25-29,1921,0.06702808759495894
STAT,1914,30,15-19,1944,0.1505511572538182
SIM,1825,36,35-39,1861,12
SIM,1931,30,25-29,1961,1
SIM,1940,25,25-29,1965,163
SIM,1853,30,40-44,1883,12
SIM,1857,65,na,1922,1750
STAT,1865,109,na,1974,0.01854911322466364
SIM,1950,43,40-44,1993,2
SIM,1840,25,20-24,1865,4
STAT,1824,56,na,1880,1372.974125256872
SIM,1873,15,30-34,1888,2
SIM,1891,15,na,1906,3619
STAT,1829,51,20-24,1880,7.41529275557958E-4
SIM,1965,17,50-100,1982,1
STAT,1919,21,50-100,1940,0.8338219103268314
STAT,1867,18,45-49,1885,0.07153000423537105
STAT,1969,45,50-100,2014,0.3407552895995549
SIM,1976,19,na,1995,5641
SIM,1970,28,30-34,1998,26
STAT,1863,29,25-29,1892,42.381703136763655
SIM,1840,15,na,1855,2443
STAT,1882,19,25-29,1901,6.353365806000041
STAT,1914,49,35-39,1963,0.14677000239811633
STAT,1847,46,30-34,1893,0.0746946529164257
STAT,1853,36,45-49,1889,2.005469722977048
STAT,1955,41,25-29,1996,0.11385621011319459
STAT,1962,20,35-39,1982,13.978765115955884
STAT,1950,49,45-49,1999,0.30666789229497526
STAT,1979,30,45-49,2009,2.5515813863780767
STAT,1940,20,15-19,1960,6.264374642329207
SIM,1979,25,na,2004,6424
STAT,1880,50,45-49,1930,0.01800728964477076
STAT,1891,86,na,1977,820.4075617866977
STAT,1860,48,15-19,1908,3.673684128921315E-4
STAT,1975,25,35-39,2000,22.976459864355018
SIM,1808,54,na,1862,1589
SIM,1870,47,na,1917,2919
STAT,1829,100,na,1929,0.7777392018009159
STAT,1832,25,20-24,1857,11.60882866841797
STAT,1833,40,30-34,1873,1.0130596241835945
STAT,1886,2,na,1888,3598.149110257803
SIM,1912,27,30-34,1939,7
STAT,1912,81,na,1993,1934.0730706501076
STAT,1849,48,na,1897,1721.8694267363987
STAT,1865,15,30-34,1880,1.9016926709108122
SIM,1890,19,25-29,1909,8
STAT,1904,27,30-34,1931,41.73192761604229
STAT,1818,51,45-49,1869,0.01758448030837835
STAT,1962,28,30-34,1990,58.1609243582427
STAT,1844,51,30-34,1895,0.005002668940879194
STAT,1964,45,na,2009,5580.472991455969
SIM,1987,20,na,2007,6113
SIM,1811,58,na,1869,1458
STAT,1819,40,40-44,1859,5.049062805814559
STAT,1969,18,15-19,1987,65.40492443217572
SIM,1899,24,25-29,1923,7
SIM,1795,70,na,1865,776
SIM,1983,25,35-39,2008,62
SIM,1896,37,20-24,1933,3
STAT,1884,28,50-100,1912,0.7268232310002742
STAT,1889,16,30-34,1905,2.2729584393263864
SIM,1851,26,35-39,1877,18
SIM,1832,73,na,1905,925
STAT,1965,15,35-39,1980,6.048843750062834
SIM,1917,22,50-100,1939,3
SIM,1838,76,na,1914,338
SIM,1858,90,na,1948,132
STAT,1950,30,25-29,1980,12.870229876133497
STAT,1831,54,25-29,1885,0.002775154021875753
STAT,1871,23,45-49,1894,0.7981393872913841
STAT,1954,26,15-19,1980,1.011967762030733
STAT,1832,45,50-100,1877,0.20684133403602767
SIM,1867,35,50-100,1902,4
STAT,1837,36,20-24,1873,0.686703310701345
SIM,1910,21,na,1931,3608
SIM,1847,25,30-34,1872,43
SIM,1873,95,na,1968,31
STAT,1862,20,30-34,1882,18.016704262516573
SIM,1863,18,na,1881,2720
STAT,1937,57,na,1994,4094.576066638506
SIM,1951,43,na,1994,6267
SIM,1949,25,45-49,1974,7
STAT,1915,22,15-19,1937,6.351298484428191
STAT,1970,44,15-19,2014,0.00229786812242354
SIM,1923,22,15-19,1945,6
STAT,1939,19,50-100,1958,0.43268047640065993
STAT,1820,51,45-49,1871,0.01453811345327178
STAT,1841,28,35-39,1869,10.578737925776021
STAT,1843,26,35-39,1869,12.001045009026866
STAT,1867,21,na,1888,2577.3156049671197
SIM,1925,76,na,2001,2909
STAT,1866,52,20-24,1918,7.851222516004206E-4
STAT,1888,37,20-24,1925,1.0457140194695045
STAT,1894,35,na,1929,3528.3786834811676
STAT,1899,26,40-44,1925,4.75245089831217
SIM,1885,44,50-100,1929,6
STAT,1978,15,45-49,1993,0.7871788328779171
STAT,1938,46,25-29,1984,0.06299853853858027
SIM,1887,42,20-24,1929,1
STAT,1948,11,na,1959,5188.571288773976
SIM,1914,32,20-24,1946,4
STAT,1942,43,40-44,1985,0.3130492501773899
STAT,1839,25,30-34,1864,25.52354794815691
STAT,1862,36,50-100,1898,1.2014936242498726
SIM,1845,36,20-24,1881,1
STAT,1879,42,20-24,1921,0.19113709065942705
STAT,1881,42,45-49,1923,1.663902675433204
SIM,1916,24,na,1940,4353
SIM,1860,69,na,1929,1636
SIM,1878,33,na,1911,2861
STAT,1854,29,15-19,1883,0.3819484156928948
STAT,1828,40,na,1868,1802.4952696548191
STAT,1873,67,na,1940,1868.1631286447448
STAT,1950,39,na,1989,5277.707328581488
SIM,1991,20,25-29,2011,180
STAT,1830,39,15-19,1869,0.0550194597696903
STAT,1940,33,50-100,1973,0.9872193827841217
SIM,1852,41,45-49,1893,2
STAT,1878,18,20-24,1896,21.30612379578824
STAT,1985,22,25-29,2007,152.11517114065956
STAT,1933,43,30-34,1976,0.20248233766128323
STAT,1891,19,35-39,1910,0.7784367213327013
SIM,1871,26,20-24,1897,1
STAT,1845,33,45-49,1878,1.3827461243664863
STAT,1896,34,45-49,1930,2.6353264762632067
STAT,1927,3,na,1930,5818.844561723602
STAT,1939,25,35-39,1964,17.440562807692913
STAT,1983,24,na,2007,5977.365250476607
SIM,1868,34,35-39,1902,1
SIM,1917,97,na,2014,107
STAT,1924,40,25-29,1964,0.09826867649517237
STAT,1978,17,50-100,1995,0.5900712623992574
STAT,1906,32,20-24,1938,2.6119780553731307
STAT,1970,38,20-24,2008,0.3919406861130222
STAT,1860,22,30-34,1882,17.07857990499583
STAT,1983,20,25-29,2003,151.40017766260831
SIM,1831,30,20-24,1861,1
SIM,1898,87,na,1985,952
STAT,1840,110,na,1950,2.2167883440457972E-4
STAT,1816,77,na,1893,426.87992012535574
STAT,1847,16,50-100,1863,0.04732835071037141
STAT,1928,36,15-19,1964,0.028032560139097922
STAT,1878,15,40-44,1893,0.22141402130106605
STAT,1923,49,45-49,1972,0.29158733270471204
STAT,1833,52,25-29,1885,0.002586380483989321
STAT,1838,46,20-24,1884,0.010833770688497071
STAT,1893,35,50-100,1928,1.807939820233144
STAT,1988,26,15-19,2014,1.170768109935246
SIM,1798,59,na,1857,1185
STAT,1898,33,50-100,1931,1.4230195717149254
SIM,1897,16,30-34,1913,7
STAT,1765,97,na,1862,0.07823205786758347
STAT,1920,46,25-29,1966,0.06780895754185702
SIM,1830,47,na,1877,1701
STAT,1969,19,na,1988,5302.7313546620735
STAT,1978,18,25-29,1996,68.2297492838789
STAT,1899,38,35-39,1937,2.4017343493754084
STAT,1970,30,25-29,2000,13.625597986840665
STAT,1843,45,na,1888,2305.2409364161226
SIM,1853,33,45-49,1886,2
STAT,1914,37,40-44,1951,1.7257239910573212
STAT,1823,49,40-44,1872,0.16448156733390912
STAT,1999,15,35-39,2014,7.157785808466343
STAT,1902,38,20-24,1940,0.26995977943485727
SIM,1831,49,40-44,1880,1
SIM,1883,23,20-24,1906,81
SIM,1925,33,35-39,1958,1
SIM,1919,72,na,1991,3814
STAT,1923,59,na,1982,4662.150706730022
SIM,1931,29,na,1960,5885
STAT,1944,27,na,1971,4672.776610635831
STAT,1957,8,na,1965,5979.928716190711
STAT,1875,26,50-100,1901,0.7655122633386723
STAT,1838,33,45-49,1871,1.8579336523473176
SIM,1922,37,40-44,1959,7
SIM,1847,87,na,1934,470
STAT,1845,71,na,1916,899.4619443802351
STAT,1917,33,35-39,1950,10.997117750788009
STAT,1834,32,30-34,1866,20.409649909635796
STAT,1819,43,45-49,1862,3.0511124432695085
STAT,1826,39,na,1865,1537.4489206651515
SIM,1908,82,na,1990,1028
STAT,1981,4,na,1985,6346.141485297364
STAT,1968,32,35-39,2000,13.42671127287763
STAT,1873,45,20-24,1918,0.014282867227287945
STAT,1924,42,50-100,1966,0.16122031136522946
STAT,1947,33,15-19,1980,0.1701730173048342
SIM,1831,41,45-49,1872,2
STAT,1932,22,20-24,1954,168.41323141252317
SIM,1842,32,30-34,1874,36
SIM,1942,32,na,1974,4923
SIM,1940,22,20-24,1962,260
STAT,1887,81,na,1968,1139.4183162317513
SIM,1865,44,na,1909,2811
STAT,1825,32,20-24,1857,5.661401625015249
STAT,1864,30,50-100,1894,0.9517266241771505
STAT,1922,45,20-24,1967,0.01471392303479207
SIM,1954,40,45-49,1994,1
STAT,1863,26,20-24,1889,11.923940602230672
SIM,1869,37,20-24,1906,1
SIM,1892,37,45-49,1929,5
STAT,1960,39,20-24,1999,0.4073411253523422
STAT,1837,76,na,1913,686.0416289344155
SIM,1844,33,35-39,1877,30
STAT,1856,18,na,1874,2375.6493181836818
STAT,1892,45,25-29,1937,0.047464916213285954
SIM,1901,21,25-29,1922,5
SIM,1976,32,35-39,2008,8
STAT,1869,47,20-24,1916,0.013348776065805135
STAT,1966,14,na,1980,5660.036899234952
SIM,1865,44,35-39,1909,4
STAT,1946,40,45-49,1986,0.22200034679396757
STAT,1840,40,na,1880,1983.5455407454956
SIM,1864,29,25-29,1893,86
STAT,1951,22,25-29,1973,127.3570267741325
SIM,1938,65,na,2003,3673
SIM,1927,1,na,1928,5506
STAT,1834,34,na,1868,2481.3531171311915
STAT,1857,44,35-39,1901,1.6056095029928055
STAT,1898,59,na,1957,3082.7529626402415
STAT,1957,41,35-39,1998,0.3188731506043748
SIM,1949,11,na,1960,5902
STAT,1881,31,20-24,1912,3.0211494300556097
STAT,1862,45,45-49,1907,0.23213953541965907
SIM,1849,25,40-44,1874,7
SIM,1811,74,na,1885,819
SIM,1884,27,45-49,1911,3
SIM,1881,37,na,1918,1943
STAT,1884,37,45-49,1921,2.2730153777310593
STAT,1933,40,35-39,1973,0.32031624478366844
STAT,1851,22,20-24,1873,65.2594767192985
STAT,1873,36,30-34,1909,6.311083423927122
STAT,1775,81,na,1856,262.056940356
STAT,1949,5,na,1954,5293.031586605737
STAT,1865,18,35-39,1883,0.5852945794077444
STAT,1912,32,15-19,1944,0.1460661790506073
STAT,1851,53,50-100,1904,0.01178410827131713
STAT,1861,42,35-39,1903,1.7351689105520496
SIM,1931,24,30-34,1955,58
STAT,1858,47,45-49,1905,0.21147696126085447
STAT,1943,23,35-39,1966,11.558419772969087
STAT,1957,40,20-24,1997,0.02800324080295293
SIM,1946,30,45-49,1976,2
SIM,1966,15,35-39,1981,10
STAT,1895,37,20-24,1932,1.1579630124352474
STAT,1856,29,25-29,1885,38.04136171794867
STAT,1811,83,na,1894,204.40605384771936
SIM,1983,22,30-34,2005,115
STAT,1933,46,35-39,1979,0.20521174709699117
SIM,1820,40,30-34,1860,2
STAT,1836,33,35-39,1869,11.533376738325176
STAT,1960,11,na,1971,5905.197810259834
STAT,1961,40,na,2001,5770.701547192494
STAT,1883,45,na,1928,2565.6033429984095
STAT,1803,88,na,1891,47.84876433622724
SIM,1819,49,25-29,1868,1
STAT,1973,23,15-19,1996,7.96871531840545
STAT,1919,54,na,1973,4477.50700748077
SIM,1881,36,30-34,1917,4
SIM,1891,34,35-39,1925,27
STAT,1844,54,35-39,1898,0.007002794275416116
STAT,1901,32,30-34,1933,28.223331791765734
STAT,1850,58,na,1908,2035.8298957055665
STAT,1875,48,35-39,1923,0.16486545832178073
STAT,1842,52,35-39,1894,0.006589620617470812
STAT,1940,27,40-44,1967,5.48693652383468
STAT,1972,30,35-39,2002,13.77941525769868
STAT,1964,36,15-19,2000,0.028782878268716994
STAT,1859,46,50-100,1905,0.2264222717961117
SIM,1846,71,na,1917,765
STAT,1891,40,na,1931,3329.8268018637696
SIM,1867,46,50-100,1913,1
STAT,1806,53,na,1859,1145.0990808630784
STAT,1941,19,40-44,1960,1.6619365183608807
SIM,1938,61,na,1999,3727
STAT,1958,15,35-39,1973,6.3636224804126424
SIM,1827,43,45-49,1870,3
SIM,1892,28,50-100,1920,4
STAT,1923,24,30-34,1947,38.33750466094693
SIM,1844,45,na,1889,2202
SIM,1876,41,30-34,1917,1
SIM,1961,11,na,1972,5666
STAT,1862,23,35-39,1885,5.776222341815527
STAT,1839,28,35-39,1867,9.570688715751976
SIM,1987,4,na,1991,6565
STAT,1837,39,25-29,1876,2.4862369474582473
STAT,1883,34,35-39,1917,11.336495409162971
STAT,1955,48,40-44,2003,0.250541016804198
STAT,1858,44,na,1902,2052.6902158222824
STAT,1988,17,25-29,2005,71.5265600869206
STAT,1854,17,20-24,1871,17.277729631666105
STAT,1986,28,15-19,2014,1.1653218041586297
STAT,1936,38,30-34,1974,2.064029163339371
STAT,1934,49,20-24,1983,0.01767326467548687
STAT,1825,54,30-34,1879,0.007698056964731952
SIM,1862,17,20-24,1879,23
SIM,1911,86,na,1997,2068
STAT,1846,40,40-44,1886,2.414492609330013
STAT,1862,48,25-29,1910,0.05539362670752488
SIM,1944,38,30-34,1982,5
STAT,1854,94,na,1948,16.282597228953957
STAT,1857,53,25-29,1910,0.0031324829063203454
STAT,1931,54,na,1985,5522.223742845896
STAT,1938,33,na,1971,4388.1184405625245
SIM,1933,30,35-39,1963,21
SIM,1853,41,na,1894,2244
SIM,1914,51,na,1965,3845
STAT,1879,45,25-29,1924,0.07010106570586651
STAT,1868,41,30-34,1909,1.280482699552538
STAT,1893,109,na,2002,0.10809339144984187
SIM,1847,28,35-39,1875,20
STAT,1867,17,30-34,1884,1.755673374362017
STAT,1992,15,25-29,2007,71.82216617407391
STAT,1841,37,25-29,1878,3.0160252419666604
STAT,1914,46,30-34,1960,0.10233308771737404
STAT,1871,20,40-44,1891,2.406750739597293
STAT,1899,29,45-49,1928,1.742920784794932
STAT,1831,51,20-24,1882,6.135490049610917E-4
SIM,1846,30,40-44,1876,7
STAT,1870,44,35-39,1914,2.0323977151873787
STAT,1824,101,na,1925,0.3530740321184194
STAT,1845,30,40-44,1875,3.5475625774708144
SIM,1816,42,30-34,1858,4
STAT,1818,39,20-24,1857,1.1244949990614825
SIM,1831,72,na,1903,828
STAT,1877,37,45-49,1914,2.393070996162186
SIM,1985,19,na,2004,6036
STAT,1807,50,30-34,1857,0.024347507872205635
SIM,1870,45,45-49,1915,1
SIM,1974,24,50-100,1998,2
STAT,1863,90,na,1953,79.55881734057586
STAT,1938,30,45-49,1968,1.8289352991541454
SIM,1854,40,40-44,1894,6
STAT,1853,13,na,1866,2846.1299123219615
SIM,1885,37,45-49,1922,8
SIM,1880,35,50-100,1915,4
STAT,1869,62,na,1931,2042.687510756174
SIM,1826,39,20-24,1865,1
STAT,1801,54,45-49,1855,0.05541251198131909
SIM,1929,50,na,1979,5098
STAT,1814,41,50-100,1855,3.6723301189534254
SIM,1936,28,30-34,1964,2
SIM,1893,56,na,1949,2813
STAT,1828,27,20-24,1855,19.03570787070527
SIM,1976,24,50-100,2000,1
STAT,1876,27,45-49,1903,1.3245681460618046
STAT,1983,31,50-100,2014,1.376660730750189
STAT,1906,35,25-29,1941,1.0557514707177404
SIM,1831,33,25-29,1864,20
SIM,1851,58,na,1909,2363
SIM,1827,27,na,1854,1747
SIM,1823,47,25-29,1870,1
STAT,1964,20,45-49,1984,1.6419968575632038
SIM,1981,25,25-29,2006,214
SIM,1852,29,20-24,1881,20
STAT,1886,21,30-34,1907,21.748553973192024
STAT,1870,31,45-49,1901,1.9920965197350482
STAT,1881,62,na,1943,2034.500721459875
SIM,1890,41,50-100,1931,5
STAT,1838,30,40-44,1868,4.766699960566361
STAT,1814,47,50-100,1861,0.6828270818702388
STAT,1790,100,na,1890,0.23497273054228096
STAT,1838,49,25-29,1887,0.05004131079417488
SIM,1928,17,25-29,1945,1
STAT,1878,18,45-49,1896,0.07850449341163329
STAT,1917,27,50-100,1944,1.2046721713037485
STAT,1935,36,50-100,1971,0.6785141798273221
STAT,1823,33,25-29,1856,25.55275954798081
SIM,1845,39,25-29,1884,4
SIM,1914,35,25-29,1949,1
STAT,1878,98,na,1976,35.60628719141889
SIM,1785,86,na,1871,81
SIM,1836,27,20-24,1863,24
STAT,1894,31,30-34,1925,26.00802791758741
STAT,1920,43,20-24,1963,0.02246421040971752
STAT,1891,16,30-34,1907,2.2789483879881476
STAT,1970,4,na,1974,5681.196891865038
SIM,1892,40,na,1932,3701
STAT,1893,105,na,1998,2.027000605149163
STAT,1967,40,35-39,2007,0.30251010836467157
SIM,1839,23,15-19,1862,5
STAT,1815,47,25-29,1862,0.11759633701884466
SIM,1972,20,45-49,1992,3
STAT,1784,103,na,1887,0.05728285590842771
SIM,1838,39,25-29,1877,4
SIM,1812,59,na,1871,1113
STAT,1946,41,15-19,1987,0.002045721816822886
SIM,1821,35,20-24,1856,1
SIM,1964,16,na,1980,5967
SIM,1943,48,na,1991,5287
STAT,1780,103,na,1883,0.07586849426368258
STAT,1881,34,25-29,1915,11.303727226276644
STAT,1933,34,40-44,1967,6.080958619706255
SIM,1870,90,na,1960,320
STAT,1836,21,40-44,1857,2.5217991410664684
SIM,1957,22,25-29,1979,3
STAT,1903,85,na,1988,1178.591860324581
SIM,1950,39,45-49,1989,3
SIM,1917,16,35-39,1933,3
SIM,1966,22,35-39,1988,15
SIM,1908,66,na,1974,2994
STAT,1942,39,45-49,1981,0.8453766497355688
SIM,1933,30,na,1963,6347
STAT,1871,26,na,1897,2749.4333134127837
SIM,1853,26,45-49,1879,2
STAT,1846,37,na,1883,2543.4161354175717
SIM,1812,44,45-49,1856,5
STAT,1845,26,45-49,1871,0.9172583732162842
STAT,1956,26,25-29,1982,100.99233349273972
STAT,1799,72,na,1871,753.0061600027894
SIM,1850,76,na,1926,168
STAT,1853,45,50-100,1898,0.2469618231512754
SIM,1906,25,25-29,1931,7
SIM,1989,21,20-24,2010,311
STAT,1844,29,20-24,1873,11.840222340272723
SIM,1858,27,40-44,1885,7
SIM,1919,29,na,1948,5046
STAT,1888,66,na,1954,2223.43952853059
STAT,1927,49,20-24,1976,0.01591155762232795
STAT,1857,99,na,1956,2.0063275229229967
STAT,1963,45,20-24,2008,0.016932613738282434
SIM,1899,16,40-44,1915,1
SIM,1933,55,na,1988,6176
STAT,1947,21,20-24,1968,145.0739212878445
SIM,1962,17,25-29,1979,131
SIM,1864,26,20-24,1890,1
SIM,1947,19,40-44,1966,4
STAT,1840,45,25-29,1885,0.04780525231394548
SIM,1868,30,25-29,1898,14
STAT,1903,49,35-39,1952,0.1271014415107143
STAT,1881,19,na,1900,2796.249120093598
STAT,1914,23,na,1937,4294.341553677993
STAT,1954,17,25-29,1971,61.82485867412393
STAT,1851,44,30-34,1895,0.8993749821978709
STAT,1942,20,25-29,1962,111.86393068056935
STAT,1894,34,35-39,1928,14.895270813761261
STAT,1914,48,na,1962,4195.102814301755
SIM,1868,9,na,1877,3406
STAT,1939,19,40-44,1958,1.615340838039623
SIM,1856,89,na,1945,153
STAT,1922,58,na,1980,4618.411268515027
STAT,1870,19,20-24,1889,20.123158507410864
STAT,1982,16,25-29,1998,70.39273509299505
STAT,1983,22,15-19,2005,8.719065670431544
STAT,1906,31,50-100,1937,0.8889904692645
STAT,1932,17,40-44,1949,2.137940791124017
STAT,1907,44,40-44,1951,0.2616341254479507
STAT,1957,46,40-44,2003,0.2501467852869924
STAT,1807,53,35-39,1860,0.0331328808220195
STAT,1888,44,20-24,1932,0.21253366605298707
SIM,1882,4,na,1886,3644
STAT,1852,8,na,1860,2800.16788115198
STAT,1873,39,35-39,1912,8.25147442423621
SIM,1848,45,50-100,1893,1
STAT,1868,37,na,1905,2612.2312107714124
STAT,1986,23,45-49,2009,1.8557271215357038
SIM,1921,48,na,1969,5106
SIM,1843,47,50-100,1890,2
SIM,1927,21,50-100,1948,2
STAT,1876,24,40-44,1900,2.4703774634975604
STAT,1870,41,na,1911,2641.4514854316167
SIM,1906,56,na,1962,3317
SIM,1940,17,40-44,1957,3
SIM,1863,44,25-29,1907,4
STAT,1909,16,35-39,1925,0.9530391140665114
STAT,1894,51,na,1945,3209.6801968914933
SIM,1872,30,50-100,1902,1
STAT,1892,33,30-34,1925,25.147761484613213
STAT,1944,43,15-19,1987,0.001978999397138868
STAT,1940,36,30-34,1976,2.2029011366184825
SIM,1826,42,na,1868,1901
STAT,1949,22,25-29,1971,124.38519121706823
SIM,1939,43,na,1982,4902
SIM,1881,53,na,1934,1677
SIM,1996,4,na,2000,6947
STAT,1820,50,30-34,1870,0.00608316571944166
STAT,1867,27,35-39,1894,10.396608741794962
STAT,1919,33,45-49,1952,1.950502458516058
STAT,1857,50,20-24,1907,6.727810020569459E-4
SIM,1821,38,25-29,1859,1
STAT,1827,31,50-100,1858,1.6676010773348118
STAT,1915,29,40-44,1944,5.44828938819722
STAT,1941,22,na,1963,4356.278391051104
STAT,1868,44,35-39,1912,1.9806705465180592
SIM,1933,32,25-29,1965,22
SIM,1899,32,na,1931,4120
STAT,1832,32,20-24,1864,2.45485115966657
STAT,1853,48,15-19,1901,3.9324327018474013E-4
STAT,1893,17,35-39,1910,0.8004121996145036
STAT,1901,46,20-24,1947,0.010973037309684118
SIM,1944,21,45-49,1965,3
STAT,1872,40,45-49,1912,1.7518097542500783
SIM,1813,84,na,1897,179
SIM,1880,40,45-49,1920,3
STAT,1938,58,na,1996,4128.7086256570865
SIM,1890,22,15-19,1912,4
STAT,1882,22,15-19,1904,3.7187093720337687
SIM,1881,39,35-39,1920,2
STAT,1883,29,na,1912,2675.3461335131556
STAT,1857,41,30-34,1898,1.0380096752757422
STAT,1976,29,50-100,2005,1.5397391822909887
SIM,1965,46,40-44,2011,1
STAT,1916,30,25-29,1946,11.10195915745247
SIM,1893,41,na,1934,3312
SIM,1923,29,40-44,1952,8
STAT,1858,25,35-39,1883,9.021720028131078
SIM,1979,33,20-24,2012,5
SIM,1990,19,40-44,2009,6
STAT,1871,16,45-49,1887,0.07593008622059651
STAT,1815,44,20-24,1859,0.33382575550810906
SIM,1924,30,25-29,1954,34
STAT,1975,34,25-29,2009,14.325041148262022
STAT,1901,23,40-44,1924,3.358032534092809
SIM,1991,22,15-19,2013,7
SIM,1900,68,na,1968,2564
STAT,1898,18,30-34,1916,2.4794136876881403
SIM,1963,35,30-34,1998,1
STAT,1877,41,40-44,1918,2.7123492204657764
STAT,1841,34,20-24,1875,2.855944433661322
STAT,1876,17,40-44,1893,0.2181994808596134
STAT,1867,15,40-44,1882,0.20386518246039065
STAT,1955,35,30-34,1990,2.8816409932036398
SIM,1818,47,na,1865,2104
STAT,1826,33,40-44,1859,3.8812480698024228
STAT,1909,22,50-100,1931,0.7065456196227312
STAT,1834,49,na,1883,2122.357888485442
STAT,1821,61,na,1882,1209.4819365482736
STAT,1922,74,na,1996,3360.4927857934845
STAT,1940,69,na,2009,3599.889826415272
STAT,1877,44,50-100,1921,1.2510938201597819
SIM,1876,44,35-39,1920,5
SIM,1960,45,45-49,2005,1
SIM,1827,33,40-44,1860,1
STAT,1856,26,20-24,1882,10.780559210760677
SIM,1885,41,40-44,1926,6
SIM,1941,69,na,2010,3159
SIM,1834,33,40-44,1867,10
SIM,1889,51,na,1940,3461
STAT,1916,49,45-49,1965,0.25577816086980304
STAT,1911,45,45-49,1956,0.23877185213818133
STAT,1831,51,45-49,1882,0.01206646330630911
STAT,1848,107,na,1955,0.005010831536772956
STAT,1831,69,na,1900,1151.386224767235
SIM,1854,43,45-49,1897,6
STAT,1945,23,45-49,1968,1.4226762399570931
SIM,1818,43,35-39,1861,10
STAT,1961,47,45-49,2008,0.33706332876049405
SIM,1823,77,na,1900,1010
SIM,1904,16,25-29,1920,13
STAT,1992,22,25-29,2014,153.5141924123266
SIM,1868,71,na,1939,1744
STAT,1887,1,na,1888,3841.650369093426
STAT,1852,23,40-44,1875,2.3171464842306566
STAT,1982,19,40-44,2001,2.269884504571847
STAT,1812,84,na,1896,146.0502353071092
STAT,1812,54,20-24,1866,0.0015703946039161557
SIM,1950,20,25-29,1970,138
STAT,1847,24,20-24,1871,64.07340327927322
SIM,1814,42,50-100,1856,6
STAT,1929,45,30-34,1974,0.13398230752782792
STAT,1971,29,15-19,2000,1.035301082113848
STAT,1762,92,na,1854,14.0
SIM,1869,37,na,1906,1956
SIM,1833,32,20-24,1865,3
SIM,1849,37,35-39,1886,6
STAT,1846,43,45-49,1889,1.5459960609071979
STAT,1925,32,25-29,1957,12.662262315268366
STAT,1849,64,na,1913,1347.3463605879133
STAT,1883,33,20-24,1916,3.0391233240671163
STAT,1842,54,25-29,1896,0.002650714220385753
STAT,1862,45,20-24,1907,0.011803705638784067
STAT,1948,6,na,1954,5205.011982959772
STAT,1910,48,20-24,1958,0.011878250258118962
STAT,1857,15,50-100,1872,0.05237073496014821
STAT,1906,27,40-44,1933,5.04114761183897
SIM,1956,26,50-100,1982,8
STAT,1940,20,50-100,1960,0.7743356444380239
SIM,1908,21,35-39,1929,11
STAT,1936,21,45-49,1957,1.2425790876327643
STAT,1908,11,na,1919,4433.2617360222985
SIM,1819,40,50-100,1859,4
STAT,1841,103,na,1944,0.1275977916663645
SIM,1840,32,20-24,1872,3
SIM,1964,26,25-29,1990,122
SIM,1847,72,na,1919,1301
STAT,1880,18,na,1898,3081.331272647363
SIM,1914,27,40-44,1941,7
STAT,1863,74,na,1937,1119.8989268891037
SIM,1939,15,35-39,1954,5
SIM,1871,29,25-29,1900,3
SIM,1953,23,45-49,1976,2
SIM,1845,46,na,1891,2017
SIM,1974,4,na,1978,6402
STAT,1953,48,30-34,2001,0.1290894306484461
STAT,1855,44,25-29,1899,0.5390330678676226
SIM,1950,36,40-44,1986,4
STAT,1956,23,20-24,1979,170.3075035549948
SIM,1844,61,na,1905,1671
STAT,1938,38,40-44,1976,1.7548035291183153
STAT,1967,15,45-49,1982,0.7205039211011534
STAT,1902,20,na,1922,3879.5246716602865
STAT,1840,22,45-49,1862,0.7113807307204131
STAT,1903,46,30-34,1949,0.09001042927880563
STAT,1913,29,30-34,1942,44.757727199636065
SIM,1906,22,20-24,1928,1
SIM,1989,24,25-29,2013,4
STAT,1842,51,20-24,1893,5.705645241150756E-4
SIM,1888,35,50-100,1923,1
STAT,1971,3,na,1974,5749.796636021234
SIM,1828,39,30-34,1867,13
SIM,1869,8,na,1877,2406
STAT,1948,26,50-100,1974,1.3208061487030758
STAT,1942,36,40-44,1978,1.8620196822958217
SIM,1922,47,45-49,1969,1
STAT,1845,23,40-44,1868,1.7306886235412966
SIM,1875,27,35-39,1902,1
STAT,1922,15,15-19,1937,60.86876730591801
STAT,1923,32,15-19,1955,0.1699490548360733
SIM,1877,88,na,1965,536
SIM,1814,42,20-24,1856,3
STAT,1964,32,50-100,1996,1.2249828151302737
SIM,1844,24,45-49,1868,2
STAT,1916,46,40-44,1962,0.18710555129550033
STAT,1974,34,40-44,2008,6.003304303819662
SIM,1890,16,20-24,1906,48
STAT,1836,24,45-49,1860,0.8258425771841453
SIM,1823,38,35-39,1861,8
SIM,1899,18,30-34,1917,8
SIM,1859,30,50-100,1889,3
STAT,1836,75,na,1911,936.8802809796888
SIM,1839,17,20-24,1856,42
SIM,1889,104,na,1993,79
SIM,2005,1,na,2006,6483
SIM,1949,34,35-39,1983,9
SIM,1946,38,40-44,1984,6
STAT,1913,66,na,1979,3546.639502790085
SIM,1953,24,15-19,1977,7
STAT,1840,31,50-100,1871,0.9045858049867829
STAT,1918,17,15-19,1935,11.4347330144344
SIM,1829,34,20-24,1863,6
STAT,1832,28,25-29,1860,39.570900769564105
SIM,1810,73,na,1883,316
SIM,1840,28,25-29,1868,47
STAT,1894,32,45-49,1926,2.5870285863425115
SIM,1888,26,na,1914,2710
STAT,1864,46,25-29,1910,0.05952194975145455
STAT,1972,38,30-34,2010,2.771697793329609
SIM,1829,53,na,1882,1476
SIM,1808,69,na,1877,915
STAT,1948,41,25-29,1989,0.09814975026686608
STAT,1875,106,na,1981,0.5212458734832338
STAT,1938,24,15-19,1962,6.078784504540892
SIM,1832,57,na,1889,1642
SIM,1863,52,45-49,1915,1
STAT,1904,30,na,1934,3986.428441585952
STAT,1815,76,na,1891,525.6968916164872
STAT,1966,48,40-44,2014,0.23572662505047495
STAT,1976,18,15-19,1994,69.94966356188633
SIM,1878,44,45-49,1922,3
STAT,1847,49,35-39,1896,0.10547442262955249
STAT,1957,49,45-49,2006,0.3419571693367451
STAT,1838,53,20-24,1891,6.29049068483473E-4
STAT,1898,102,na,2000,12.311105137902052
SIM,1901,30,50-100,1931,6
STAT,1855,52,45-49,1907,0.01228281075623894
STAT,1829,54,25-29,1883,0.0030519333394367514
STAT,1861,64,na,1925,1667.7936183479205
SIM,1965,49,45-49,2014,2
SIM,1974,32,25-29,2006,23
SIM,1928,19,15-19,1947,65
STAT,1870,41,30-34,1911,1.3139237706556255
STAT,1886,46,45-49,1932,0.28810108762504405
SIM,1911,46,30-34,1957,1
SIM,1938,33,20-24,1971,2
SIM,1942,47,na,1989,4926
SIM,1921,29,30-34,1950,86
SIM,1885,44,45-49,1929,8
SIM,1901,29,20-24,1930,37
STAT,1883,31,30-34,1914,19.794194598779562
STAT,1833,43,35-39,1876,1.5351306172006032
STAT,1856,32,15-19,1888,0.12691783605336865
STAT,1868,42,45-49,1910,1.6573831508183636
SIM,1883,63,na,1946,1715
SIM,1875,24,30-34,1899,2
STAT,1820,53,35-39,1873,0.008287195217414601
SIM,1909,29,15-19,1938,2
STAT,1867,24,30-34,1891,19.072380386806184
STAT,1873,52,na,1925,2523.977933205076
SIM,1833,39,na,1872,1682
SIM,1943,49,50-100,1992,1
STAT,1818,87,na,1905,77.95315770980183
SIM,1841,43,35-39,1884,5
STAT,1877,44,45-49,1921,1.7723829169720162
SIM,1960,42,40-44,2002,1
STAT,1828,39,15-19,1867,0.05546238811407814
STAT,1883,36,25-29,1919,3.2665259817297767
SIM,1891,31,30-34,1922,35
STAT,1878,101,na,1979,10.444861945106542
STAT,1948,41,50-100,1989,0.1614721687788793
STAT,1896,31,40-44,1927,6.637410945044572
SIM,1956,41,50-100,1997,2
SIM,1969,40,50-100,2009,1
SIM,1988,3,na,1991,6642
SIM,1866,22,30-34,1888,42
STAT,1866,43,30-34,1909,1.2208727860646027
SIM,1926,17,15-19,1943,75
SIM,1891,6,na,1897,3670
STAT,1895,107,na,2002,0.5461894558150755
STAT,1900,93,na,1993,304.04212192874496
SIM,1876,42,45-49,1918,2
STAT,1940,39,35-39,1979,2.914607705733178
STAT,1842,45,35-39,1887,0.11054817648059706
STAT,1852,26,45-49,1878,1.228078803846444
SIM,1822,32,45-49,1854,3
STAT,1897,37,30-34,1934,8.22425172252216
SIM,1915,44,40-44,1959,1
STAT,1811,51,35-39,1862,0.026141970410924496
SIM,1854,29,30-34,1883,38
STAT,1846,29,30-34,1875,31.042391114063278
STAT,1935,49,50-100,1984,0.36653895205299636
SIM,1926,77,na,2003,3978
STAT,1889,19,35-39,1908,0.7763906916719204
STAT,1923,46,40-44,1969,0.21330049622286026
STAT,1875,45,30-34,1920,0.11659415607749413
SIM,1882,19,na,1901,3470
SIM,1914,44,50-100,1958,1
SIM,1970,28,na,1998,5919
STAT,1837,54,50-100,1891,0.010635652721218858
STAT,1830,34,45-49,1864,1.8136574329292812
STAT,1858,22,30-34,1880,18.399219492833947
STAT,1906,44,50-100,1950,0.12179262987156
SIM,1854,38,na,1892,2503
STAT,1824,72,na,1896,781.4177376456465
STAT,1836,30,30-34,1866,20.513455837857222
STAT,1839,86,na,1925,175.95885910932492
STAT,1947,10,na,1957,5107.805425665842
SIM,1860,26,45-49,1886,2
STAT,1847,53,30-34,1900,0.004506674845936281
SIM,1944,8,na,1952,4682
STAT,1980,16,15-19,1996,72.72825120506418
SIM,1901,93,na,1994,437
STAT,1864,56,na,1920,2101.7236919757775
STAT,1930,17,30-34,1947,18.188090710707815
STAT,1957,17,50-100,1974,0.5700637995726937
SIM,1856,64,na,1920,1513
SIM,1955,21,20-24,1976,328
STAT,1967,24,35-39,1991,13.609274450541193
STAT,1955,41,50-100,1996,0.18731182836363952
STAT,1995,12,na,2007,6562.11037686877
STAT,1912,29,50-100,1941,1.124962872381266
SIM,1930,35,50-100,1965,2
STAT,1851,47,35-39,1898,0.11050169861581069
STAT,1964,28,40-44,1992,6.800931508778395
STAT,1911,42,40-44,1953,0.27574002441143436
SIM,1881,43,30-34,1924,5
STAT,1872,19,30-34,1891,1.8370744572696098
STAT,1935,47,na,1982,5988.721762056748
STAT,1824,40,50-100,1864,1.5549132481942745
STAT,1837,20,na,1857,2051.1921533705695
SIM,1834,36,45-49,1870,2
STAT,1885,55,na,1940,2380.1642343487915
SIM,1821,36,na,1857,1704
STAT,1927,20,50-100,1947,0.9409447981935429
SIM,1865,41,30-34,1906,3
SIM,1842,35,na,1877,2307
STAT,1826,36,45-49,1862,1.6359270437686984
SIM,1886,18,20-24,1904,28
STAT,1841,25,30-34,1866,28.211859428166097
SIM,1863,34,na,1897,2488
SIM,1849,34,30-34,1883,29
SIM,1891,36,25-29,1927,3
SIM,1959,22,35-39,1981,19
STAT,1890,36,25-29,1926,4.079555169848597
STAT,1958,22,35-39,1980,14.31920923200132
STAT,1810,58,na,1868,1372.7442891709827
SIM,1944,30,35-39,1974,13
STAT,1978,15,20-24,1993,213.64037819821988
STAT,1901,49,25-29,1950,0.05142485047032461
STAT,1773,113,na,1886,9.11140800620781E-4
STAT,1940,34,40-44,1974,4.669514746396342
STAT,1825,57,na,1882,1528.509895059363
STAT,1827,83,na,1910,322.40123366594435
STAT,1819,36,45-49,1855,6.399296518270379
SIM,1789,79,na,1868,450
SIM,1857,49,na,1906,2332
STAT,1774,80,na,1854,10.0
STAT,1852,50,50-100,1902,0.014443696591777643
STAT,1948,45,35-39,1993,0.17794420466855831
SIM,1893,49,50-100,1942,1
SIM,1857,19,30-34,1876,5
SIM,1978,31,50-100,2009,1
STAT,1895,42,50-100,1937,0.11006840839939769
SIM,1892,33,35-39,1925,2
STAT,1851,27,45-49,1878,1.0309017486195595
STAT,1866,70,na,1936,1500.8149765602957
STAT,1927,58,na,1985,5047.416331358675
SIM,1949,19,15-19,1968,117
STAT,1787,107,na,1894,0.001448387825526566
STAT,1904,61,na,1965,3345.5086579031467
SIM,1907,78,na,1985,2310
SIM,1969,22,na,1991,5801
STAT,1836,37,20-24,1873,0.8613938920231681
STAT,1969,19,20-24,1988,195.31847720613573
STAT,1941,26,40-44,1967,5.5683665281729855
SIM,1960,16,45-49,1976,1
STAT,1853,44,na,1897,2270.053475299261
STAT,1855,103,na,1958,0.21310443171219723
SIM,1897,39,25-29,1936,1
STAT,1873,43,30-34,1916,1.345085050619822
STAT,1850,40,25-29,1890,0.6677364100628255
STAT,1881,87,na,1968,461.847890501263
STAT,1892,41,15-19,1933,0.02006539393658001
SIM,1943,17,na,1960,5120
STAT,1966,44,30-34,2010,0.19087303095628208
SIM,1945,26,20-24,1971,25
STAT,1870,21,40-44,1891,2.377957368897171
STAT,1880,40,40-44,1920,2.779169651098549
SIM,1795,85,na,1880,2
SIM,1828,77,na,1905,775
STAT,1852,21,20-24,1873,77.74143386253678
STAT,1840,37,40-44,1877,4.153410284794836
SIM,1968,19,50-100,1987,1
STAT,1833,27,25-29,1860,39.85467481056911
STAT,1884,33,35-39,1917,11.498364460310965
SIM,1974,26,30-34,2000,6
STAT,1784,73,na,1857,507.1871943401102
STAT,1828,45,45-49,1873,0.22310018212608176
STAT,1974,37,45-49,2011,1.058373030754017
SIM,1851,89,na,1940,345
STAT,1907,100,na,2007,35.7867793931296
STAT,1972,2,na,1974,5814.715839600226
STAT,1814,57,na,1871,1607.3282999911064
SIM,1951,12,na,1963,6323
SIM,1865,107,na,1972,3
SIM,1956,53,na,2009,5175
SIM,1836,72,na,1908,572
SIM,1977,19,20-24,1996,383
STAT,1910,16,50-100,1926,0.08597206822665857
STAT,1986,21,25-29,2007,152.44384548017436
SIM,1876,32,40-44,1908,1
STAT,1862,27,20-24,1889,11.467760910409837
SIM,1859,69,na,1928,1038
STAT,1857,46,25-29,1903,0.05191848346130783
SIM,1947,21,25-29,1968,263
STAT,1815,45,35-39,1860,0.29445370700959955
STAT,1917,28,na,1945,4518.007305554687
STAT,2006,2,na,2008,7028.815635999525
SIM,1890,38,30-34,1928,20
SIM,1935,19,15-19,1954,94
STAT,1941,30,50-100,1971,1.003174104419136
STAT,1892,23,15-19,1915,4.757076707952855
STAT,1841,53,35-39,1894,0.007531332882167183
STAT,1776,78,na,1854,423.0
STAT,1909,6,na,1915,4526.22123051446
SIM,1867,64,na,1931,1581
STAT,1903,20,35-39,1923,9.64946181176963
STAT,1978,31,45-49,2009,2.5276886972326396
STAT,1939,21,25-29,1960,107.134713719378
STAT,1889,39,25-29,1928,4.054634441701681
SIM,1841,27,25-29,1868,7
STAT,1953,27,15-19,1980,0.9898090246841811
STAT,1952,16,45-49,1968,0.6910437675242269
STAT,1877,22,35-39,1899,7.005172425137795
SIM,1975,32,na,2007,5971
STAT,1839,45,20-24,1884,0.009947842356620266
SIM,1912,25,na,1937,4004
STAT,1849,37,30-34,1886,4.226886869721017
STAT,1876,39,15-19,1915,0.06631696806092136
STAT,1959,47,20-24,2006,0.01735234298329737
STAT,1882,38,30-34,1920,5.97778242672779
STAT,1836,60,na,1896,1735.6627973744494
STAT,1835,23,50-100,1858,0.3413537621440212
SIM,1938,30,na,1968,4001
SIM,1882,41,na,1923,3229
SIM,1870,27,20-24,1897,17
STAT,1896,49,40-44,1945,0.14412845659361756
STAT,1849,19,30-34,1868,1.5027667574772572
STAT,1942,42,35-39,1984,0.2524238975605599
STAT,1927,19,15-19,1946,64.75787731554475
SIM,1981,21,15-19,2002,15
STAT,1860,29,50-100,1889,0.5927539783024908
STAT,1897,33,45-49,1930,2.6795951874608743
STAT,1919,30,40-44,1949,4.910422939782009
SIM,1903,26,15-19,1929,2
SIM,1869,21,40-44,1890,2
SIM,1939,38,50-100,1977,2
STAT,1920,18,20-24,1938,175.0044137065345
STAT,1868,32,40-44,1900,4.80841085443452
STAT,1925,23,na,1948,5027.333306223754
STAT,1871,4,na,1875,3384.609287264833
STAT,1845,49,na,1894,1484.4119403034572
STAT,1854,50,40-44,1904,0.008700097144631415
SIM,1848,38,na,1886,1776
STAT,1958,10,na,1968,5955.644248922712
SIM,1919,36,20-24,1955,3
SIM,1920,20,na,1940,3848
STAT,1895,18,15-19,1913,8.891477681932233
STAT,1988,19,15-19,2007,74.85688679159485
STAT,1864,38,40-44,1902,4.488387527651262
STAT,1879,35,20-24,1914,0.9377092197530165
SIM,1882,41,25-29,1923,3
STAT,1906,9,na,1915,4366.432786547929
STAT,1958,37,45-49,1995,1.0645598280909558
STAT,1843,16,30-34,1859,2.055850983768623
SIM,1898,56,na,1954,3548
SIM,1822,47,40-44,1869,1
SIM,1879,43,45-49,1922,2
STAT,1881,31,50-100,1912,1.0240675444149399
STAT,1869,28,15-19,1897,0.5052768717702815
SIM,1948,16,50-100,1964,1
SIM,1968,8,na,1976,5398
STAT,1993,17,na,2010,6111.499649114827
SIM,1950,24,35-39,1974,11
STAT,1823,35,15-19,1858,0.11903282628895229
STAT,1820,57,na,1877,1268.7658522499476
STAT,1919,23,na,1942,4599.427160499639
STAT,1876,25,25-29,1901,50.80706967912312
STAT,1992,16,30-34,2008,20.19622757383569
SIM,1884,25,25-29,1909,45
SIM,1872,38,40-44,1910,3
SIM,1890,76,na,1966,1655
SIM,1893,25,50-100,1918,2
SIM,1888,15,15-19,1903,16
STAT,1841,21,45-49,1862,0.7910733312243439
STAT,1963,16,20-24,1979,198.83117080322765
SIM,1855,42,50-100,1897,1
STAT,1905,18,25-29,1923,9.44046403080429
SIM,1946,24,15-19,1970,8
STAT,1860,32,35-39,1892,9.419271722657019
STAT,1814,48,25-29,1862,0.1575297952235139
STAT,1851,54,35-39,1905,0.006639203085701141
STAT,1818,41,40-44,1859,3.0904492400986787
STAT,1856,48,30-34,1904,0.08415660388844304
STAT,1857,111,na,1968,8.591874047237113E-4
STAT,1929,53,na,1982,5378.793449184387
SIM,1904,39,40-44,1943,4
STAT,1824,50,25-29,1874,0.004833687314252011
SIM,1841,59,na,1900,1552
SIM,1857,37,30-34,1894,7
SIM,2000,6,na,2006,6489
STAT,1964,10,na,1974,5711.179481213434
SIM,1971,16,20-24,1987,186
SIM,1965,39,40-44,2004,3
STAT,1807,52,20-24,1859,0.0028981999240831366
SIM,1801,59,na,1860,1430
STAT,1839,48,25-29,1887,0.045949197690481135
STAT,1820,45,15-19,1865,4.4255339271416483E-4
STAT,1969,39,30-34,2008,2.7011803665653913
SIM,1862,35,45-49,1897,8
STAT,1825,37,45-49,1862,3.3109403287301875
STAT,1899,28,30-34,1927,39.67421061558927
STAT,1891,43,20-24,1934,0.22488159961526238
STAT,1859,29,40-44,1888,2.761286683709075
SIM,1900,20,50-100,1920,1
STAT,1864,28,50-100,1892,0.6568453707616647
STAT,1844,31,40-44,1875,4.38295398183076
STAT,1850,95,na,1945,13.687039299099206
STAT,1776,114,na,1890,4.4920446226364645E-4
STAT,1843,14,na,1857,3033.3083542617587
SIM,1845,30,50-100,1875,4
STAT,1983,29,40-44,2012,7.63469722796946
STAT,1879,47,15-19,1926,4.7976000428056226E-4
STAT,1950,32,50-100,1982,1.1499974992997821
STAT,1841,15,50-100,1856,0.05684631240209635
STAT,1844,110,na,1954,2.3113542695338545E-4
SIM,1966,19,45-49,1985,1
STAT,1958,19,45-49,1977,0.7566652825057243
STAT,1963,48,25-29,2011,0.08067091030445604
STAT,1833,42,20-24,1875,0.13638133881600203
STAT,1910,61,na,1971,3647.71485017699
STAT,1924,41,30-34,1965,0.17569863938198715
STAT,1938,23,30-34,1961,32.832419521055726
STAT,1948,15,40-44,1963,1.8482228552051105
SIM,1901,47,45-49,1948,1
STAT,1875,87,na,1962,374.2785305098735
STAT,1935,53,na,1988,5861.339164801541
STAT,1868,17,45-49,1885,0.07373883891370647
SIM,1851,16,30-34,1867,4
SIM,1902,28,20-24,1930,1
STAT,1854,35,45-49,1889,1.6489379566146605
SIM,1833,37,45-49,1870,5
SIM,1887,5,na,1892,3998
STAT,1937,26,20-24,1963,20.555224812526156
STAT,1950,30,na,1980,5266.454601618928
STAT,1894,22,40-44,1916,3.091412104026059
STAT,1909,23,35-39,1932,10.079424673518037
STAT,1987,17,na,2004,6064.044623749408
STAT,1891,25,20-24,1916,16.846302939270284
SIM,1915,29,45-49,1944,1
SIM,1930,47,40-44,1977,1
STAT,1814,47,40-44,1861,0.47597718445259884
STAT,1880,22,40-44,1902,2.5490009013311243
STAT,1872,49,25-29,1921,0.06535337994332102
SIM,1883,28,45-49,1911,1
SIM,1822,80,na,1902,250
STAT,1821,36,50-100,1857,2.8684438188719428
STAT,1922,47,40-44,1969,0.20893525929917733
STAT,1875,28,45-49,1903,1.319481434455721
SIM,1880,49,25-29,1929,1
SIM,1867,29,40-44,1896,3
SIM,1917,23,35-39,1940,16
STAT,1777,91,na,1868,13.436875406419324
STAT,1808,57,na,1865,1443.9785434112543
STAT,1861,46,45-49,1907,0.22706295346731425
STAT,1872,82,na,1954,540.6767498600918
STAT,1907,29,45-49,1936,1.8560373726446056
SIM,1877,30,35-39,1907,1
STAT,1831,48,50-100,1879,0.2246513741354728
SIM,1922,55,na,1977,4824
STAT,1885,49,na,1934,2535.739240372091
SIM,1969,32,na,2001,5563
STAT,1897,30,40-44,1927,6.745926220389342
STAT,1865,53,20-24,1918,7.560261480072126E-4
STAT,1833,24,20-24,1857,66.57657642005545
STAT,1895,4,na,1899,3951.798017471907
STAT,1930,37,20-24,1967,0.3968631823427798
SIM,1875,45,50-100,1920,1
STAT,1902,37,15-19,1939,0.01976397599244983
STAT,1812,50,35-39,1862,0.019850908157075006
STAT,1937,29,25-29,1966,74.01161990461529
SIM,1956,15,40-44,1971,2
STAT,1873,44,15-19,1917,0.016055065559589462
STAT,1980,32,15-19,2012,0.20985345312796255
SIM,1842,42,35-39,1884,5
STAT,1920,89,na,2009,904.7176434216506
STAT,1960,38,15-19,1998,0.02970713253562596
STAT,1862,52,na,1914,2085.876182159001
SIM,1926,29,20-24,1955,2
STAT,1922,29,40-44,1951,6.040601590709487
STAT,1910,29,15-19,1939,0.7819034117296465
STAT,1926,23,40-44,1949,4.698591153494234
STAT,1972,41,20-24,2013,0.027158021858359128
SIM,1930,29,40-44,1959,1
STAT,1923,28,na,1951,4944.250370334298
STAT,1867,45,50-100,1912,0.26726941663514386
SIM,1841,24,20-24,1865,88
SIM,1884,23,50-100,1907,1
SIM,1831,23,20-24,1854,60
STAT,1926,39,20-24,1965,0.37092627303409564
STAT,1873,46,35-39,1919,0.16545701277259367
SIM,1914,20,na,1934,3686
SIM,1975,38,50-100,2013,3
SIM,1934,23,40-44,1957,14
STAT,1855,16,20-24,1871,18.048561485699878
STAT,1967,38,50-100,2005,0.6229261486828963
STAT,1952,29,20-24,1981,25.32865031037471
SIM,1863,16,20-24,1879,15
SIM,1855,42,45-49,1897,1
STAT,1865,54,35-39,1919,0.00871772459354857
SIM,1960,29,20-24,1989,2
STAT,1919,15,45-49,1934,0.12837889746250422
STAT,1793,78,na,1871,314.83039436402987
STAT,1854,57,na,1911,1637.2403125901549
STAT,1941,29,45-49,1970,2.060939544633313
SIM,1943,31,35-39,1974,15
STAT,1865,36,35-39,1901,7.400169231888974
SIM,1938,16,35-39,1954,7
STAT,1985,23,30-34,2008,47.31584271243472
STAT,1841,19,na,1860,2601.251563595327
STAT,2003,5,na,2008,6886.68117195084
SIM,1873,36,35-39,1909,3
SIM,1847,32,45-49,1879,7
SIM,1873,64,na,1937,2415
STAT,1958,16,40-44,1974,2.1206773143821995
SIM,1823,42,30-34,1865,1
STAT,1851,9,na,1860,2348.946769353925
STAT,1847,42,45-49,1889,1.1580190055610424
STAT,1931,23,na,1954,5450.219172058338
SIM,1960,29,na,1989,6252
STAT,1818,110,na,1928,1.2226887638754817E-4
STAT,1889,36,20-24,1925,1.1018638663293345
STAT,1895,79,na,1974,1668.2144819462412
STAT,1933,19,45-49,1952,0.76792148937866
SIM,1881,26,15-19,1907,1
SIM,1873,35,20-24,1908,2
STAT,1866,33,15-19,1899,0.15168523418905824
STAT,1868,35,45-49,1903,2.231305136159316
STAT,1854,53,45-49,1907,0.011633385460301106
SIM,1896,21,na,1917,3657
STAT,1857,43,20-24,1900,0.141711706275235
STAT,1865,35,20-24,1900,0.8102739585710893
SIM,1865,43,20-24,1908,1
SIM,1866,25,35-39,1891,19
SIM,1937,17,na,1954,4152
SIM,1826,41,40-44,1867,7
SIM,1971,19,25-29,1990,168
STAT,1963,19,25-29,1982,63.49382119987345
STAT,1850,17,50-100,1867,0.061630149419210696
STAT,1935,31,35-39,1966,14.606833792929308
STAT,1852,24,25-29,1876,63.19872709763845
SIM,1834,77,na,1911,546
SIM,1868,18,na,1886,3249
SIM,1860,24,25-29,1884,4
SIM,1927,30,na,1957,5037
STAT,1942,24,35-39,1966,11.387525965282858
SIM,1972,16,35-39,1988,13
SIM,1909,73,na,1982,3576
STAT,1895,36,15-19,1931,0.08476093693678728
SIM,1876,35,45-49,1911,4
STAT,1964,16,35-39,1980,6.100885591908811
STAT,1874,107,na,1981,0.23917899166197026
STAT,1900,49,50-100,1949,0.21721791879921792
STAT,1952,7,na,1959,5435.934363658845
SIM,1834,32,35-39,1866,21
STAT,1857,45,40-44,1902,0.15541046940307776
SIM,1887,35,20-24,1922,3
STAT,1828,42,40-44,1870,2.1637629612861833
STAT,1874,41,25-29,1915,0.7621074762638392
STAT,1934,48,15-19,1982,5.909342912765366E-4
SIM,1858,32,20-24,1890,3
STAT,1790,73,na,1863,512.0092360295939
STAT,1891,44,35-39,1935,2.547933709084048
STAT,1947,47,40-44,1994,0.2131840799314519
STAT,1897,46,20-24,1943,0.010475128856336596
STAT,1830,38,50-100,1868,1.2221487178520185
STAT,1950,31,30-34,1981,21.92674621476149
SIM,1836,42,40-44,1878,1
STAT,1834,42,35-39,1876,1.992190677478463
STAT,1826,48,15-19,1874,2.8408925910035555E-4
SIM,1858,34,40-44,1892,11
STAT,1936,22,50-100,1958,0.7264146689263401
STAT,1946,34,50-100,1980,1.0773429522857938
STAT,1826,32,35-39,1858,9.529681525860084
STAT,1841,50,30-34,1891,0.0053684064792832486
SIM,1927,30,40-44,1957,2
STAT,1886,40,50-100,1926,1.2990071734982438
STAT,1931,4,na,1935,6098.137489419794
SIM,1906,7,na,1913,4010
STAT,1855,79,na,1934,594.8655419884426
STAT,1905,15,20-24,1920,29.74994509935617
STAT,1830,46,15-19,1876,3.7390491426213496E-4
SIM,1908,33,40-44,1941,1
STAT,1860,26,na,1886,2259.7344686588244
SIM,1845,20,40-44,1865,1
STAT,1774,106,na,1880,5.396599663831446E-4
SIM,1862,9,na,1871,3172
STAT,1891,26,35-39,1917,13.809671124925291
SIM,1822,41,50-100,1863,2
STAT,1833,95,na,1928,9.355720658240987
STAT,1877,82,na,1959,716.3009144432444
STAT,1878,67,na,1945,1910.1170396512184
STAT,1854,32,40-44,1886,3.618117792027264
SIM,1839,21,na,1860,2594
STAT,1899,101,na,2000,20.34131908482603
SIM,1880,46,na,1926,3197
STAT,1920,48,15-19,1968,4.684214843059686E-4
STAT,1961,21,35-39,1982,14.090177558373894
SIM,1862,0,na,1862,4207
STAT,1849,21,15-19,1870,3.1138090920034855
STAT,1900,21,25-29,1921,91.94734588649277
STAT,1975,32,35-39,2007,14.18174080399725
STAT,1855,70,na,1925,1193.8695868469547
STAT,1887,26,15-19,1913,0.5887976239052544
STAT,1967,41,40-44,2008,0.37525874577102086
STAT,1958,34,40-44,1992,6.038397060343557
SIM,1995,5,na,2000,6767
SIM,1913,15,20-24,1928,45
STAT,1887,41,35-39,1928,2.3525639815342165
STAT,1865,22,45-49,1887,0.7349165634432339
STAT,1845,35,50-100,1880,0.975273719893543
STAT,1883,35,40-44,1918,4.989545171694146
STAT,1916,43,50-100,1959,0.13873085715091174
SIM,1869,24,45-49,1893,2
SIM,1857,21,15-19,1878,10
STAT,1916,34,35-39,1950,10.795969279853834
STAT,1955,38,35-39,1993,3.8137778338687958
SIM,1883,25,40-44,1908,4
SIM,1840,77,na,1917,287
STAT,1880,25,45-49,1905,1.3673828264136723
STAT,1946,53,na,1999,4787.17038971666
STAT,1938,26,35-39,1964,17.181458214763886
SIM,1900,30,30-34,1930,52
STAT,1852,38,15-19,1890,0.052680676481310106
STAT,1815,42,30-34,1857,2.5692232055146453
STAT,1849,70,na,1919,1087.4782263700808
STAT,1963,39,50-100,2002,0.6328439856021627
SIM,1971,39,50-100,2010,1
SIM,1978,17,15-19,1995,128
SIM,1884,22,20-24,1906,5
SIM,1946,26,35-39,1972,45
SIM,1909,17,20-24,1926,48
SIM,1898,34,50-100,1932,1
STAT,1833,45,25-29,1878,0.04904740775710671
STAT,1884,15,35-39,1899,0.6285565400159548
SIM,1924,34,35-39,1958,27
STAT,1839,32,45-49,1871,1.701864547343219
STAT,1988,18,30-34,2006,20.1116955541826
STAT,1944,19,20-24,1963,168.27005895623648
SIM,1934,39,20-24,1973,1
STAT,1921,16,15-19,1937,59.82447777794832
SIM,1953,20,40-44,1973,7
STAT,1883,82,na,1965,844.9583313028622
STAT,1965,27,50-100,1992,1.440258363143243
SIM,1934,12,na,1946,5971
STAT,1842,60,na,1902,1467.622886845522
STAT,1885,19,40-44,1904,0.20941231384338735
SIM,1908,51,na,1959,3557
STAT,1834,107,na,1941,0.004303782195589696
STAT,1945,48,50-100,1993,0.2957594483520397
SIM,1949,42,na,1991,5822
STAT,1814,45,20-24,1859,0.0344622155546624
STAT,1836,19,20-24,1855,23.4574703109424
STAT,1847,44,na,1891,1754.3885190507392
SIM,1980,23,20-24,2003,1
STAT,1787,78,na,1865,242.96120981855913
STAT,1913,25,20-24,1938,21.14379076221053
SIM,1891,35,40-44,1926,8
STAT,1904,47,20-24,1951,0.011165418511196715
STAT,1918,29,20-24,1947,22.253783806442932
STAT,1977,16,45-49,1993,0.7791502435479031
SIM,1877,28,15-19,1905,3
SIM,1844,19,20-24,1863,37
STAT,1861,43,40-44,1904,2.142382784098546
STAT,1837,20,40-44,1857,2.07109255112061
SIM,1819,69,na,1888,369
SIM,1990,6,na,1996,6334
STAT,1944,68,na,2012,3903.970745902228
SIM,1862,32,40-44,1894,8
STAT,1875,25,40-44,1900,3.5967327656559407
STAT,1830,107,na,1937,0.0029583973689430026
STAT,1929,48,35-39,1977,0.19233214307736082
SIM,1803,54,na,1857,1506
STAT,1952,47,20-24,1999,0.015897022018020388
STAT,1896,92,na,1988,349.64273739720267
SIM,1797,80,na,1877,55
STAT,1945,20,40-44,1965,4.255728452949003
SIM,1895,76,na,1971,1402
STAT,1879,50,40-44,1929,0.012868319797608524
STAT,1894,25,45-49,1919,1.6583532074096623
STAT,1808,52,35-39,1860,0.04103498178946975
STAT,1835,19,na,1854,1895.3412136603433
SIM,1879,40,40-44,1919,2
STAT,1872,33,45-49,1905,2.0122174603381673
STAT,1884,36,na,1920,2699.2640860310617
STAT,1880,43,45-49,1923,1.8175270396037202
STAT,1821,106,na,1927,0.007425756579543154
SIM,1955,42,na,1997,6475
SIM,1892,71,na,1963,2630
SIM,1991,19,na,2010,6256
STAT,1902,66,na,1968,3023.6566429126
STAT,1869,46,15-19,1915,4.483121859434307E-4
SIM,1803,85,na,1888,136
SIM,1880,33,45-49,1913,5
SIM,1945,29,25-29,1974,4
SIM,1845,21,na,1866,2301
SIM,1869,36,15-19,1905,1
SIM,1940,12,na,1952,5104
STAT,1899,97,na,1996,97.87169606549953
STAT,1816,40,25-29,1856,1.5643318995143156
STAT,1873,32,45-49,1905,2.0550767577880777
SIM,1849,27,30-34,1876,10
STAT,1942,64,na,2006,4081.9923031523376
SIM,1932,44,35-39,1976,1
SIM,1863,30,35-39,1893,8
SIM,1953,17,15-19,1970,1
SIM,1886,33,40-44,1919,3
SIM,1790,70,na,1860,369
SIM,1974,27,45-49,2001,3
STAT,1773,107,na,1880,0.015043610034350313
SIM,1925,35,na,1960,5347
STAT,1831,60,na,1891,1496.3103815316929
STAT,1884,49,15-19,1933,4.4656524090516453E-4
STAT,1840,35,20-24,1875,0.7467355696767775
STAT,1885,49,50-100,1934,0.27680961403629495
SIM,1958,33,50-100,1991,7
SIM,1896,25,15-19,1921,2
STAT,1945,15,na,1960,4642.641409659041
STAT,1878,33,40-44,1911,5.20349883200785
SIM,1921,25,20-24,1946,47
STAT,1858,42,20-24,1900,0.14280112066803188
STAT,1956,9,na,1965,6000.8564058020875
SIM,1864,84,na,1948,442
STAT,1947,31,25-29,1978,12.25431424205444
SIM,1886,30,50-100,1916,2
SIM,1836,41,na,1877,1652
STAT,1879,109,na,1988,0.06635276288493547
STAT,1922,43,na,1965,4909.60473291301
STAT,1836,33,50-100,1869,1.0434814127894723
SIM,1873,38,25-29,1911,9
STAT,1919,27,15-19,1946,0.8800715310233251
STAT,1910,1,na,1911,4764.69133322353
SIM,1881,32,45-49,1913,2
STAT,1870,22,50-100,1892,0.4639530116832614
SIM,1956,27,na,1983,5228
STAT,1945,17,15-19,1962,57.21286907283343
SIM,1892,32,20-24,1924,9
SIM,1840,27,40-44,1867,9
STAT,1961,30,na,1991,5754.511659869812
STAT,1881,24,20-24,1905,76.22829388787775
STAT,1943,17,50-100,1960,0.4585417311707705
STAT,1876,32,na,1908,2846.8186229373473
STAT,1998,17,na,2015,6236.915074856383
SIM,1826,44,45-49,1870,2
SIM,1903,1,na,1904,4462
SIM,1938,71,na,2009,3084
STAT,1884,32,20-24,1916,3.0820843067672774
STAT,1924,44,35-39,1968,0.2754205961181191
SIM,1885,21,na,1906,3001
SIM,1985,27,20-24,2012,4
SIM,1875,17,30-34,1892,8
SIM,1881,68,na,1949,1107
STAT,1802,60,na,1862,1334.0081911631235
SIM,1847,18,30-34,1865,4
SIM,1873,33,na,1906,3393
SIM,1977,25,40-44,2002,12
STAT,1923,27,35-39,1950,19.88521569949318
SIM,1878,39,20-24,1917,3
STAT,1886,31,na,1917,2916.754235138519
SIM,1926,2,na,1928,6324
STAT,1878,51,40-44,1929,0.012746044368520143
STAT,1892,43,35-39,1935,2.6003025474354047
STAT,1896,47,20-24,1943,0.010269789474453244
SIM,1995,19,30-34,2014,51
SIM,1941,50,na,1991,3865
STAT,1981,31,15-19,2012,0.21149959958585945
SIM,1927,27,15-19,1954,2
SIM,1931,27,35-39,1958,28
STAT,1807,54,40-44,1861,0.03970261278951312
SIM,1884,23,35-39,1907,13
SIM,1858,37,45-49,1895,3
STAT,1958,51,na,2009,5718.295540286267
STAT,1972,14,na,1986,5802.110248306946
STAT,1860,50,35-39,1910,0.008122429579246311
STAT,1944,49,15-19,1993,4.73091427780772E-4
STAT,1891,41,30-34,1932,1.6472123745285907
STAT,1931,37,50-100,1968,0.6418404055595691
STAT,1827,52,na,1879,1898.724342684713
SIM,1993,14,na,2007,6952
SIM,1826,35,50-100,1861,2
STAT,1832,27,40-44,1859,2.8463646384724726
STAT,1889,23,45-49,1912,0.9889229965066572
SIM,1819,60,na,1879,717
STAT,1914,22,30-34,1936,33.90310898234129
SIM,1950,21,30-34,1971,1
STAT,1839,18,30-34,1857,1.643779686054406
SIM,1949,22,40-44,1971,7
STAT,1840,17,20-24,1857,18.41342960490467
SIM,1927,19,50-100,1946,1
STAT,1950,34,35-39,1984,12.694284754490777
SIM,1900,33,35-39,1933,3
STAT,1798,103,na,1901,0.03650445320759488
STAT,1855,30,35-39,1885,8.958078441240612
STAT,1897,49,25-29,1946,0.0490914156118912
STAT,1850,43,50-100,1893,1.0797039196950886
STAT,1847,36,15-19,1883,0.04529854221001123
STAT,1884,50,20-24,1934,8.534823149218741E-4
STAT,1964,19,na,1983,5346.4695200840515
STAT,1848,51,25-29,1899,0.003781493685049133
SIM,1955,31,25-29,1986,4
SIM,1896,39,40-44,1935,2
STAT,1903,36,15-19,1939,0.02001924251769299
STAT,1890,29,25-29,1919,59.22375772104501
STAT,1815,43,15-19,1858,0.0299214615771041
STAT,1843,17,45-49,1860,0.08375990188362842
SIM,1918,50,na,1968,3743
STAT,1946,63,na,2009,4394.347098735724
SIM,1967,0,na,1967,5796
STAT,1967,44,45-49,2011,0.24850335723691205
SIM,1869,27,50-100,1896,3
STAT,1839,40,na,1879,1981.2381079622235
STAT,1987,19,30-34,2006,20.067582191999932
STAT,1942,21,30-34,1963,34.794539355186956
SIM,1872,28,50-100,1900,3
STAT,1887,27,20-24,1914,15.172555938589229
SIM,1872,39,25-29,1911,1
STAT,1842,49,45-49,1891,0.1778161199908542
SIM,1854,69,na,1923,1793
STAT,1916,31,30-34,1947,18.8504038589516
SIM,1932,17,na,1949,4890
STAT,1961,37,15-19,1998,0.02949822353898795
SIM,1875,68,na,1943,1984
STAT,1915,61,na,1976,3936.240969655706
STAT,1946,34,15-19,1980,0.1674462738590185
STAT,1872,30,40-44,1902,5.065791501022647
SIM,1897,71,na,1968,2278
STAT,1951,45,40-44,1996,0.22642620111505968
SIM,1876,29,15-19,1905,1
SIM,1958,22,na,1980,6204
SIM,1879,21,na,1900,3010
STAT,1915,20,25-29,1935,106.38818097759176
STAT,1841,32,30-34,1873,18.834351359568235
STAT,1833,47,45-49,1880,0.19587108125318364
SIM,1923,39,45-49,1962,2
STAT,1853,49,20-24,1902,0.011697975145422
SIM,1889,29,25-29,1918,73
STAT,1898,42,25-29,1940,0.06946473185790011
SIM,1905,37,35-39,1942,1
STAT,1869,87,na,1956,218.38032723359447
SIM,1895,27,20-24,1922,1
STAT,1789,73,na,1862,402.1864738294168
STAT,1927,21,35-39,1948,13.425466275006343
STAT,1861,18,40-44,1879,0.200504292447847
STAT,1832,31,15-19,1863,0.1307962053459925
STAT,1941,47,45-49,1988,0.26878801575966793
SIM,1860,22,35-39,1882,7
STAT,1896,29,20-24,1925,17.754281515036116
STAT,1873,50,45-49,1923,0.017348506138012493
SIM,1850,49,45-49,1899,1
STAT,1909,61,na,1970,3592.857460528638
STAT,1829,44,20-24,1873,0.16414904783403705
STAT,1866,50,30-34,1916,0.0064587147765031785
STAT,1879,53,45-49,1932,0.017206948605669414
SIM,1866,2,na,1868,3138
STAT,1811,49,15-19,1860,0.001205585231662138
STAT,1888,97,na,1985,74.78058634722493
SIM,1923,20,25-29,1943,127
STAT,1796,58,na,1854,1172.0
SIM,1857,35,40-44,1892,4
STAT,1992,17,45-49,2009,0.8274823166051121
STAT,1910,47,15-19,1957,3.9704511239962135E-4
STAT,1952,63,na,2015,4747.904754745443
STAT,1951,15,na,1966,5060.920721921368
SIM,1863,34,20-24,1897,1
STAT,1982,18,35-39,2000,6.812037332511105
SIM,1968,31,35-39,1999,6
STAT,1852,22,35-39,1874,6.535844135998728
STAT,1940,39,50-100,1979,0.5059279302013334
SIM,1967,33,30-34,2000,17
STAT,1891,49,na,1940,3142.5717391945764
STAT,1849,35,40-44,1884,3.5446506743470056
STAT,1959,18,20-24,1977,204.5960367371252
SIM,1837,26,20-24,1863,17
STAT,1837,30,50-100,1867,0.8493198209069214
SIM,1901,25,na,1926,3993
STAT,1835,106,na,1941,0.007567355807307318
STAT,1960,18,50-100,1978,0.562956608492815
SIM,1880,30,40-44,1910,1
STAT,1885,25,50-100,1910,0.7413515122930995
SIM,1990,18,35-39,2008,10
STAT,1892,40,30-34,1932,1.6796990686891529
SIM,1909,31,35-39,1940,23
STAT,1888,25,15-19,1913,0.6196569680962994
STAT,1998,4,na,2002,6663.699169222849
SIM,1841,47,45-49,1888,1
SIM,1835,37,50-100,1872,2
STAT,1898,17,25-29,1915,8.838284875561808
STAT,1841,33,15-19,1874,0.15203278679303164
STAT,1897,44,30-34,1941,0.12153366077239439
SIM,1837,26,na,1863,2609
STAT,1842,30,25-29,1872,9.72138831242502
SIM,1848,69,na,1917,860
STAT,1864,39,25-29,1903,2.9369845102829113
STAT,1855,34,20-24,1889,2.2937618582827133
STAT,1808,88,na,1896,69.99941070224072
SIM,1924,31,30-34,1955,7
STAT,1852,22,na,1874,2394.742118528652
SIM,1842,41,na,1883,2222
STAT,1945,24,50-100,1969,0.8316832499778788
STAT,1915,39,45-49,1954,0.7869048640221362
SIM,1885,40,35-39,1925,5
SIM,1850,30,25-29,1880,8
STAT,1823,41,45-49,1864,1.602140101897426
STAT,1961,41,45-49,2002,0.25825473117345427
STAT,1876,22,20-24,1898,82.21114798937678
STAT,1795,73,na,1868,436.482503547461
STAT,1877,40,35-39,1917,2.1957164571515313
SIM,1782,75,na,1857,184
STAT,1888,43,15-19,1931,0.018598733345361388
SIM,1915,39,50-100,1954,1
SIM,1830,28,30-34,1858,30
STAT,1995,15,40-44,2010,2.337842386869597
STAT,1873,21,na,1894,2795.6005400733407
SIM,1865,69,na,1934,1969
SIM,1825,29,35-39,1854,1
STAT,1905,46,na,1951,3769.3295006890626
SIM,1987,14,na,2001,6554
SIM,1991,9,na,2000,6711
STAT,1840,38,25-29,1878,2.7035861548643765
SIM,1891,21,na,1912,3574
STAT,1844,95,na,1939,11.120689032974544
STAT,1890,33,50-100,1923,1.2865640537147864
SIM,1964,33,25-29,1997,27
SIM,2003,3,na,2006,6670
SIM,1906,25,na,1931,3844
SIM,1997,16,25-29,2013,183
STAT,1890,26,20-24,1916,16.599526829191934
STAT,1878,36,45-49,1914,2.4136241486077483
STAT,1869,31,40-44,1900,4.866557288574162
STAT,1964,15,20-24,1979,197.16600290350783
STAT,1912,23,50-100,1935,0.7261829065464246
STAT,1837,17,15-19,1854,11.454909625161317
STAT,1951,42,50-100,1993,0.16777952165431073
STAT,1982,33,na,2015,6256.565014209188
STAT,1863,25,15-19,1888,0.4644818575541401
SIM,1944,15,15-19,1959,104
STAT,1775,96,na,1871,2.0542644562123815
STAT,1936,15,15-19,1951,50.4060195172339
SIM,1989,25,30-34,2014,137
STAT,1829,26,20-24,1855,29.232300351429256
SIM,1900,44,50-100,1944,1
STAT,1948,42,30-34,1990,0.17546667708110286
SIM,1817,38,40-44,1855,5
STAT,1940,15,35-39,1955,4.921012764784212
STAT,1941,53,na,1994,4446.8236944280825
SIM,1877,31,40-44,1908,14
STAT,1989,16,25-29,2005,71.65264382657926
STAT,1956,33,25-29,1989,14.378011198065849
SIM,1974,29,35-39,2003,34
SIM,1924,50,na,1974,4815
STAT,1838,40,50-100,1878,1.0981817069334865
STAT,1816,42,15-19,1858,0.031279142802442206
STAT,1844,16,45-49,1860,0.06986478110261862
STAT,1890,28,40-44,1918,4.20923631735279
STAT,1832,47,30-34,1879,0.07945702426545045
SIM,1787,81,na,1868,341
STAT,1894,19,15-19,1913,8.756923938658185
STAT,1820,107,na,1927,0.002767791795884796
SIM,1977,28,45-49,2005,4
SIM,1919,35,na,1954,5336
STAT,1845,40,na,1885,1627.1334077544846
STAT,1940,31,na,1971,4521.323072827514
SIM,1843,28,40-44,1871,1
STAT,1862,21,na,1883,2375.0149520533587
STAT,1913,28,25-29,1941,75.46024407959949
STAT,1966,47,35-39,2013,0.19330448684241877
STAT,1854,39,30-34,1893,4.298290734228886
STAT,1921,22,45-49,1943,1.4660958888673274
STAT,1936,64,na,2000,3723.6737158484048
SIM,1921,28,25-29,1949,258
STAT,1972,24,15-19,1996,7.886199392521738
STAT,1838,34,15-19,1872,0.15015914923307874
STAT,1946,16,15-19,1962,58.10626140767394
STAT,1935,47,15-19,1982,6.004881831281344E-4
SIM,1882,72,na,1954,1845
STAT,1938,25,20-24,1963,20.898500139564906
SIM,1945,12,na,1957,4776
STAT,1895,21,40-44,1916,3.139731505639876
SIM,1922,23,15-19,1945,5
SIM,1990,15,30-34,2005,55
STAT,1800,110,na,1910,1.4910837700197435E-4
STAT,1878,54,45-49,1932,0.017005938128175538
SIM,1845,17,15-19,1862,6
SIM,1846,40,50-100,1886,3
STAT,1843,111,na,1954,1.0769536374495125E-4
SIM,1874,35,50-100,1909,1
STAT,1828,49,30-34,1877,0.08682726905608525
STAT,1842,32,15-19,1874,0.13238296341864605
STAT,1866,35,50-100,1901,1.3257418999039303
SIM,1836,49,30-34,1885,1
STAT,1967,42,25-29,2009,0.10698022656441196
SIM,1899,21,20-24,1920,5
STAT,1968,41,25-29,2009,0.10712306588269373
STAT,1897,31,na,1928,3697.4458927980313
STAT,1968,26,15-19,1994,1.0224283991998606
STAT,1914,23,15-19,1937,6.259813107477654
STAT,1845,18,na,1863,1943.4988932761585
STAT,1849,6,na,1855,2380.11987
SIM,1934,29,50-100,1963,4
STAT,1926,29,50-100,1955,1.3668773477840033
STAT,1881,20,35-39,1901,6.534399391584599
STAT,1837,35,15-19,1872,0.050546900261783656
SIM,1954,16,15-19,1970,113
SIM,1906,32,25-29,1938,15
STAT,1870,24,45-49,1894,0.7883930506435729
STAT,1851,18,na,1869,2200.0845525802215
STAT,1914,25,35-39,1939,17.593616950777818
SIM,1966,38,40-44,2004,8
STAT,1782,78,na,1860,400.3466329335758
SIM,1922,25,35-39,1947,2
STAT,1891,23,30-34,1914,25.327478758062515
STAT,1891,43,50-100,1934,1.4959514819673225
SIM,1886,36,45-49,1922,1
STAT,1808,51,20-24,1859,0.003588661981445777
STAT,1923,45,35-39,1968,0.1748143159236224
STAT,1888,107,na,1995,0.45436373832346155
SIM,1939,12,na,1951,5024
STAT,1866,53,35-39,1919,0.009060925464666358
STAT,1992,19,35-39,2011,6.946196454465292
SIM,1908,36,45-49,1944,1
STAT,1964,43,15-19,2007,0.0023160589777469886
STAT,1841,35,35-39,1876,7.564523717863819
STAT,1864,24,15-19,1888,3.4046944570259683
STAT,1827,46,45-49,1873,0.3029340304423594
STAT,1822,42,45-49,1864,3.0582685162383654
STAT,1984,28,40-44,2012,7.669081677789398
SIM,1951,53,na,2004,6127
STAT,1956,15,na,1971,5623.775548040958
SIM,1857,38,45-49,1895,4
STAT,1955,30,na,1985,5912.798342938685
STAT,1971,42,45-49,2013,0.252809048220345
STAT,1898,44,15-19,1942,0.0014755175278805721
SIM,1852,34,45-49,1886,3
STAT,1995,18,45-49,2013,0.8342340046120429
SIM,1872,36,20-24,1908,1
SIM,1794,63,na,1857,829
SIM,1946,25,20-24,1971,3
STAT,1976,20,35-39,1996,14.575502047832082
STAT,1912,28,na,1940,4249.436753625242
STAT,1864,87,na,1951,181.54400464540458
STAT,1996,19,50-100,2015,0.6279419772861575
STAT,1842,46,40-44,1888,0.13346372662659334
SIM,1889,110,na,1999,16
STAT,1883,37,30-34,1920,6.017585161503433
STAT,1901,35,35-39,1936,2.491204436181355
STAT,1969,25,na,1994,5428.619728632496
STAT,1919,19,50-100,1938,0.47512989441659853
SIM,1891,37,30-34,1928,8
SIM,1959,23,40-44,1982,8
SIM,1923,36,40-44,1959,1
STAT,1818,44,45-49,1862,1.8939500499959936
STAT,1844,34,45-49,1878,1.7083596129187664
STAT,1995,7,na,2002,6566.246072587969
STAT,1873,26,15-19,1899,0.5365187332057317
STAT,1870,87,na,1957,244.53464374010574
SIM,1846,48,40-44,1894,1
SIM,1861,1,na,1862,3306
STAT,1933,27,na,1960,5742.913727954798
STAT,1973,32,50-100,2005,1.2578726217035598
SIM,1967,37,na,2004,5700
STAT,1901,39,20-24,1940,0.26624506833204853
STAT,1860,31,20-24,1891,2.5244126861248515
SIM,1923,5,na,1928,5741
STAT,1870,51,35-39,1921,0.00984159895463587
STAT,1891,28,25-29,1919,60.12290539254781
STAT,1835,28,40-44,1863,2.42337691930673
SIM,1830,24,45-49,1854,2
SIM,1861,36,45-49,1897,1
SIM,1858,35,25-29,1893,4
STAT,1838,48,40-44,1886,0.15065169318368463
SIM,1957,15,25-29,1972,91
STAT,1962,15,na,1977,5445.54466988582
STAT,1865,38,25-29,1903,2.9831115528767875
STAT,1965,30,30-34,1995,23.164189869445067
SIM,1871,69,na,1940,987
STAT,1893,13,na,1906,3761.3148483368927
STAT,1977,3,na,1980,6133.84771501998
SIM,1870,84,na,1954,571
STAT,1891,46,25-29,1937,0.0464743601546725
STAT,1915,36,40-44,1951,1.7539358862583512
STAT,1959,32,35-39,1991,14.06164549384927
STAT,1897,47,35-39,1944,0.12129570264495516
STAT,1827,28,45-49,1855,3.0408298870855766
STAT,1946,48,40-44,1994,0.20932524720896106
STAT,1973,21,25-29,1994,138.3667418798359
STAT,1817,37,na,1854,2158.1568187444354
STAT,1769,96,na,1865,2.192823971759214
STAT,1964,33,20-24,1997,3.611638336872433
STAT,1864,36,20-24,1900,0.798137823367258
SIM,1930,50,na,1980,5879
STAT,1834,41,20-24,1875,0.1769731206712843
STAT,1809,106,na,1915,0.00564321140483878
SIM,1840,29,30-34,1869,59
STAT,1906,28,na,1934,4002.073684959598
STAT,1816,52,na,1868,1362.060547295507
SIM,1830,42,45-49,1872,3
SIM,1894,28,20-24,1922,32
STAT,1832,29,30-34,1861,23.23514139847353
SIM,1835,46,45-49,1881,1
SIM,1873,33,30-34,1906,1
STAT,1928,20,35-39,1948,13.647947410445957
SIM,1841,44,40-44,1885,9
STAT,1926,26,45-49,1952,2.3977444054844974
STAT,1949,15,25-29,1964,58.19405836556971
STAT,1951,48,45-49,1999,0.30980374422285384
STAT,1843,19,35-39,1862,0.6953195036153346
SIM,1859,32,35-39,1891,24
SIM,1877,94,na,1971,261
STAT,1829,40,35-39,1869,2.001415561989488
STAT,1849,38,45-49,1887,1.5647017518440143
STAT,1822,52,na,1874,1982.3777028380148
STAT,1883,18,50-100,1901,0.055171423469088536
STAT,1851,40,na,1891,1851.2948041068698
SIM,1936,20,35-39,1956,35
STAT,1865,38,50-100,1903,1.2720537692609613
SIM,1967,32,35-39,1999,16
STAT,1886,28,20-24,1914,14.230557931762966
STAT,1865,51,30-34,1916,0.006227783987941389
STAT,1857,47,30-34,1904,0.08659925247084062
STAT,1927,27,na,1954,5254.651303612268
STAT,1910,32,40-44,1942,4.359053505910663
STAT,1906,101,na,2007,22.649354492397226
STAT,1941,44,40-44,1985,0.30803407196705274
STAT,1948,18,45-49,1966,0.6595185212540449
STAT,1811,52,40-44,1863,0.03133307233805912
SIM,1972,15,20-24,1987,202
SIM,1994,6,na,2000,6230
SIM,1837,40,35-39,1877,4
STAT,1833,44,40-44,1877,1.8824217698095675
STAT,1902,97,na,1999,103.1367503545754
STAT,1838,28,20-24,1866,12.83602787254231
STAT,1826,54,45-49,1880,0.009696891450940994
STAT,1823,43,50-100,1866,1.0879994973190734
STAT,1898,39,50-100,1937,0.40915157565657173
STAT,1817,54,35-39,1871,0.022728398358010847
STAT,1878,30,50-100,1908,1.112909564565005
SIM,1923,17,35-39,1940,12
STAT,1907,39,50-100,1946,0.4454303919108192
SIM,1864,28,40-44,1892,7
SIM,1958,30,35-39,1988,3
SIM,1860,41,40-44,1901,7
SIM,1844,33,50-100,1877,3
STAT,1906,17,25-29,1923,9.536372959194015
STAT,1847,28,30-34,1875,23.12213293137468
STAT,1801,103,na,1904,0.060236758342463045
STAT,1782,111,na,1893,4.1131794291312396E-4
STAT,1853,18,45-49,1871,0.07777366670035839
STAT,1964,18,25-29,1982,62.96837264035029
STAT,1893,29,40-44,1922,4.33845364252145
SIM,1844,39,na,1883,2383
SIM,1956,17,30-34,1973,22
SIM,1903,51,na,1954,3360
STAT,1916,87,na,2003,1122.3096416192864
STAT,1977,35,40-44,2012,2.409015399939402
STAT,1863,37,na,1900,2377.440501391335
SIM,1838,30,45-49,1868,8
SIM,1949,30,25-29,1979,3
STAT,1915,17,35-39,1932,1.0137009000037764
STAT,1856,28,40-44,1884,2.713370945054271
STAT,1967,28,20-24,1995,26.41531547735714
STAT,1991,17,30-34,2008,20.15885051631377
SIM,1897,34,30-34,1931,35
STAT,1808,54,25-29,1862,0.016218048352208338
STAT,1878,48,15-19,1926,4.759256998625753E-4
STAT,1893,115,na,2008,2.7606177880359114E-4
STAT,1894,29,na,1923,3515.1961643294044
SIM,1934,43,na,1977,5758
SIM,1901,17,15-19,1918,13
STAT,1887,48,25-29,1935,0.07355936758258833
STAT,1839,18,na,1857,2367.321512768168
SIM,1876,42,50-100,1918,2
SIM,1970,2,na,1972,6058
SIM,1972,35,30-34,2007,2
STAT,1924,17,45-49,1941,0.6863195894932606
STAT,1911,24,40-44,1935,3.6601605575771403
STAT,1892,40,50-100,1932,1.5435072489218784
STAT,1910,96,na,2006,158.71176031334593
STAT,1954,44,15-19,1998,0.0022692931361497277
STAT,1901,40,50-100,1941,0.11978531084880326
STAT,1978,31,na,2009,6075.245371664181
STAT,1833,22,30-34,1855,19.254814426311086
STAT,1991,13,na,2004,6495.590825474929
STAT,1883,51,na,1934,2442.7570403380237
STAT,1930,35,30-34,1965,2.7486283469107775
SIM,1932,17,45-49,1949,2
STAT,1864,42,15-19,1906,0.014212702861440333
SIM,1990,17,20-24,2007,412
SIM,1852,34,na,1886,1901
STAT,1909,27,20-24,1936,20.155056327917094
STAT,1917,21,40-44,1938,4.136615016034559
SIM,1952,60,na,2012,4146
SIM,1872,18,20-24,1890,34
SIM,1917,27,20-24,1944,29
SIM,1981,18,35-39,1999,14
STAT,1852,99,na,1951,1.785563271466766
STAT,1973,18,35-39,1991,6.260931226877921
STAT,1871,29,20-24,1900,13.372921714288712
STAT,1975,30,15-19,2005,0.19965040106623524
STAT,1972,40,na,2012,5718.863410214063
SIM,1875,90,na,1965,333
STAT,1870,107,na,1977,0.1682276875553556
STAT,1866,47,40-44,1913,0.18227236847830677
STAT,1915,46,50-100,1961,0.26372285845783583
SIM,1878,23,40-44,1901,6
SIM,1925,21,40-44,1946,4
SIM,1975,20,25-29,1995,170
STAT,1895,70,na,1965,2411.453147416796
SIM,1862,39,30-34,1901,18
STAT,1843,44,35-39,1887,1.8234151930228952
STAT,1864,18,20-24,1882,18.786754575067455
STAT,1837,54,20-24,1891,5.196573196569468E-4
STAT,1837,82,na,1919,337.8654589286336
STAT,1862,83,na,1945,386.6385012348675
SIM,1891,16,35-39,1907,2
STAT,1868,74,na,1942,1230.4976414833918
SIM,1855,76,na,1931,396
SIM,1841,22,30-34,1863,43
SIM,1855,20,35-39,1875,18
SIM,1808,60,na,1868,1324
STAT,1948,17,30-34,1965,16.097406360354363
STAT,1947,28,35-39,1975,19.59193967837089
STAT,1857,31,15-19,1888,0.1301320297015612
STAT,1913,35,na,1948,4327.680651727163
SIM,1877,34,45-49,1911,5
SIM,1948,4,na,1952,4521
STAT,1890,32,15-19,1922,0.20081193760164912
STAT,1876,50,25-29,1926,0.004286269354234936
SIM,1896,98,na,1994,91
STAT,1927,43,45-49,1970,0.24044775259177836
SIM,1904,9,na,1913,4453
STAT,1973,40,20-24,2013,0.02746911442665255
STAT,1831,36,25-29,1867,2.876873771330237
STAT,1961,43,35-39,2004,0.3115244332662316
STAT,1938,43,20-24,1981,0.020870582243677535
SIM,1863,71,na,1934,1470
STAT,1831,91,na,1922,45.463949230085326
STAT,1829,87,na,1916,129.066398924153
SIM,1938,35,40-44,1973,2
STAT,1869,34,45-49,1903,1.9322243834256134
STAT,1921,30,na,1951,4894.434057654613
SIM,1907,21,20-24,1928,237
SIM,1849,30,20-24,1879,10
STAT,1858,23,15-19,1881,3.0787696527078343
STAT,1847,20,35-39,1867,5.584372067928508
SIM,1848,41,25-29,1889,2
SIM,2004,10,na,2014,7401
SIM,1933,28,15-19,1961,2
STAT,1925,28,15-19,1953,0.9585626280069962
STAT,1933,22,35-39,1955,14.420137983069566
SIM,1924,13,na,1937,5322
SIM,1851,44,35-39,1895,2
STAT,1823,96,na,1919,4.862519713763151
SIM,1949,49,45-49,1998,1
STAT,1916,17,50-100,1933,0.09174304360184818
SIM,1816,89,na,1905,32
STAT,1953,49,15-19,2002,5.317786606198585E-4
SIM,1855,28,30-34,1883,5
STAT,1844,64,na,1908,1454.0023003089525
STAT,1889,37,50-100,1926,1.7465491260645583
STAT,1860,34,25-29,1894,9.445170810363521
SIM,1898,26,30-34,1924,44
SIM,1837,57,na,1894,1854
SIM,1799,78,na,1877,39
STAT,1827,43,40-44,1870,2.9449180284309135
STAT,1788,106,na,1894,0.005510974113445163
SIM,1973,27,30-34,2000,120
STAT,1924,22,25-29,1946,125.75037828178898
SIM,1965,22,20-24,1987,330
STAT,1939,46,na,1985,4427.0591510157465
STAT,1852,24,50-100,1876,0.4501975616134376
STAT,1865,33,30-34,1898,18.103316988612125
STAT,1922,33,15-19,1955,0.1667814196432562
SIM,1953,16,na,1969,5068
SIM,1849,49,40-44,1898,1
STAT,1808,49,45-49,1857,1.1397664485502415
STAT,1917,45,40-44,1962,0.19094754528404972
SIM,1847,26,15-19,1873,1
STAT,1910,42,50-100,1952,0.12826412502317758
STAT,1830,30,35-39,1860,11.397761397140957
STAT,1960,42,50-100,2002,0.1835094804249175
SIM,1932,22,25-29,1954,153
SIM,1967,30,na,1997,5647
SIM,1842,20,25-29,1862,2
SIM,1924,4,na,1928,5427
STAT,1953,46,20-24,1999,0.016087331022148127
SIM,1875,20,20-24,1895,90
SIM,1868,49,na,1917,2906
STAT,1904,45,30-34,1949,0.09139171524312795
STAT,1957,22,20-24,1979,169.74921618190453
STAT,1967,20,25-29,1987,133.68899780246238
SIM,1822,89,na,1911,3
STAT,1834,20,25-29,1854,109.70722983160628
STAT,1938,28,25-29,1966,75.25440076242802
STAT,1910,35,45-49,1945,0.7603626204617627
STAT,1914,19,40-44,1933,0.33227387343998166
SIM,1884,20,30-34,1904,25
SIM,1955,25,30-34,1980,69
SIM,1927,61,na,1988,4502
STAT,1896,24,na,1920,3582.442724087887
STAT,1865,32,na,1897,2484.7608701901213
STAT,1958,20,15-19,1978,8.100794938986732
SIM,1835,43,40-44,1878,10
STAT,1904,92,na,1996,403.0691731641952
STAT,1906,0,na,1906,4941.475536480845
SIM,1921,70,na,1991,4083
STAT,1878,54,50-100,1932,0.01769770507381543
STAT,1981,28,25-29,2009,106.62298694700408
STAT,1850,64,na,1914,1789.5461842606867
STAT,1897,27,15-19,1924,0.7001237333475119
SIM,1831,66,na,1897,1056
SIM,1946,28,25-29,1974,139
STAT,1840,41,15-19,1881,0.011705254812827696
STAT,1928,49,35-39,1977,0.1887321917683703
STAT,1957,17,40-44,1974,2.1282387026058136
SIM,1881,18,30-34,1899,2
STAT,1958,38,50-100,1996,0.6549757998490915
SIM,1846,34,na,1880,1681
STAT,1980,27,50-100,2007,1.6015264605575361
SIM,1932,48,na,1980,5328
STAT,1813,72,na,1885,635.7326703760149
SIM,1968,21,50-100,1989,1
STAT,1848,26,25-29,1874,54.04559259801399
STAT,1943,35,40-44,1978,1.8908522204859846
SIM,1842,39,45-49,1881,5
STAT,1875,56,na,1931,2432.458181020587
STAT,1870,5,na,1875,3173.755091768725
STAT,1859,32,na,1891,2193.7469941210697
STAT,1908,21,30-34,1929,30.624056256713835
STAT,1867,20,20-24,1887,75.6406030025614
SIM,1964,25,40-44,1989,9
STAT,1839,43,30-34,1882,0.948705593779521
SIM,1832,22,20-24,1854,4
SIM,1793,81,na,1874,339
SIM,1916,21,30-34,1937,79
STAT,1956,25,40-44,1981,7.154750308732703
SIM,1966,20,15-19,1986,6
STAT,1853,33,40-44,1886,4.400423713316767
STAT,1819,63,na,1882,1268.2954507021836
SIM,1907,47,na,1954,4265
STAT,1780,74,na,1854,611.0
STAT,1873,18,30-34,1891,1.8734376657856955
STAT,1895,24,45-49,1919,1.0409532703612565
STAT,1870,37,20-24,1907,0.8770134240410422
SIM,1862,58,na,1920,2461
SIM,1922,19,40-44,1941,6
SIM,1861,33,40-44,1894,4
SIM,2001,5,na,2006,7322
STAT,1886,42,35-39,1928,2.2016099179083817
SIM,1938,39,na,1977,4062
STAT,1880,29,30-34,1909,30.5833795430042
SIM,1848,60,na,1908,1369
SIM,1908,26,50-100,1934,2
SIM,1965,17,40-44,1982,3
SIM,1846,28,20-24,1874,24
STAT,1896,16,45-49,1912,0.09981473243493222
SIM,1951,35,40-44,1986,3
SIM,1961,33,45-49,1994,1
SIM,1856,26,25-29,1882,43
SIM,1901,56,na,1957,3549
STAT,1885,50,35-39,1935,0.010052378161345696
STAT,1852,48,50-100,1900,0.2286454822701819
STAT,1846,99,na,1945,1.9578458284304792
STAT,1891,8,na,1899,3707.78005638748
STAT,1979,20,15-19,1999,8.492252851503586
STAT,1889,34,30-34,1923,24.625007314244822
SIM,1806,65,na,1871,956
STAT,1960,45,40-44,2005,0.24765450581522097
STAT,1841,15,15-19,1856,6.885984702393301
STAT,1953,33,45-49,1986,2.237859646434073
SIM,1821,42,na,1863,1621
STAT,1881,56,na,1937,2270.3759801148885
SIM,1947,16,na,1963,6057
STAT,1830,38,30-34,1868,5.305294274727721
SIM,1800,74,na,1874,691
SIM,1847,43,30-34,1890,8
SIM,1926,48,na,1974,5743
STAT,1834,44,25-29,1878,0.6886051037765001
STAT,1892,21,25-29,1913,83.05200489310208
SIM,1963,38,25-29,2001,5
STAT,1943,41,35-39,1984,0.2564917235783231
SIM,1920,29,na,1949,4342
SIM,1839,49,50-100,1888,1
SIM,1906,93,na,1999,170
STAT,1828,52,50-100,1880,0.013432687974127545
SIM,1869,90,na,1959,34
STAT,1904,28,15-19,1932,0.7492379241430848
SIM,1851,80,na,1931,1178
STAT,1866,25,30-34,1891,27.118861412651412
STAT,1845,39,20-24,1884,0.5345537807523649
SIM,1860,44,45-49,1904,3
STAT,1817,51,30-34,1868,0.016681857226803393
STAT,1879,100,na,1979,17.00651024932393
SIM,1790,79,na,1869,125
SIM,1892,35,25-29,1927,10
STAT,1845,51,45-49,1896,0.009826051470047312
STAT,1888,19,20-24,1907,23.921099740425248
STAT,1973,15,30-34,1988,18.201982168201585
STAT,1876,45,45-49,1921,0.2843498725016214
SIM,1981,15,30-34,1996,46
STAT,1961,40,30-34,2001,0.19864672707442632
STAT,1952,41,45-49,1993,0.23954289679421847
STAT,1850,15,25-29,1865,7.2132775540732545
SIM,1882,16,25-29,1898,9
STAT,1911,27,45-49,1938,1.9459881885638117
STAT,1874,16,25-29,1890,6.711383556896789
SIM,1912,28,15-19,1940,4
SIM,1928,32,45-49,1960,8
SIM,1900,27,40-44,1927,1
STAT,1983,32,30-34,2015,26.218044159983304
STAT,1850,52,30-34,1902,0.006095206926988437
SIM,1815,42,na,1857,2032
STAT,1826,51,40-44,1877,0.007465278858961842
SIM,1917,31,na,1948,5358
SIM,1951,41,35-39,1992,2
STAT,1860,29,45-49,1889,1.0288329273621946
STAT,1835,87,na,1922,109.80536408688108
SIM,1896,19,20-24,1915,2
STAT,1831,33,20-24,1864,2.724178670407715
SIM,1930,27,20-24,1957,6
STAT,1932,71,na,2003,4388.484865611094
SIM,1926,24,50-100,1950,2
SIM,1973,33,25-29,2006,28
STAT,1965,33,35-39,1998,13.41230155289595
STAT,1905,34,50-100,1939,0.8712466357217877
SIM,1872,88,na,1960,401
SIM,1913,34,50-100,1947,2
SIM,1784,70,na,1854,431
SIM,1939,32,20-24,1971,7
STAT,1958,19,na,1977,5575.323022865999
STAT,1930,47,na,1977,5584.053101978736
STAT,1834,39,45-49,1873,2.216371751804328
STAT,1832,45,na,1877,1682.2512415288477
STAT,1861,26,50-100,1887,0.6226550086624333
STAT,1833,21,na,1854,1966.7152232388512
STAT,1947,25,30-34,1972,51.2003900789847
STAT,1956,56,na,2012,5617.9636428243075
STAT,1836,51,35-39,1887,0.00808888690637515
SIM,1850,39,na,1889,1652
STAT,1964,36,50-100,2000,0.6292983044282524
STAT,1949,36,50-100,1985,0.5810901773020954
SIM,1980,28,15-19,2008,2
STAT,1927,40,40-44,1967,0.3629414746865162
STAT,1835,56,na,1891,1271.2098956844616
SIM,1972,36,50-100,2008,1
STAT,1908,24,35-39,1932,9.939927389980737
STAT,1937,11,na,1948,4457.482773607501
STAT,1972,28,15-19,2000,1.0471265296828782
SIM,1874,31,25-29,1905,22
SIM,1898,32,25-29,1930,6
SIM,1888,63,na,1951,1886
SIM,1888,29,40-44,1917,3
STAT,1912,38,15-19,1950,0.021543339253400563
STAT,1857,26,35-39,1883,8.997473651682949
STAT,1848,20,na,1868,2806.3276247728213
SIM,1851,41,30-34,1892,2
STAT,1946,22,na,1968,4689.695017397014
SIM,1936,76,na,2012,1706
STAT,1768,100,na,1868,0.1997883137537842
STAT,1911,30,35-39,1941,10.360802266157553
SIM,1935,40,40-44,1975,1
STAT,1922,12,na,1934,5289.681523849357
SIM,1902,32,na,1934,3947
STAT,1877,51,na,1928,2597.1263159053583
STAT,1966,25,35-39,1991,21.753380364780096
SIM,1865,26,35-39,1891,17
STAT,1883,21,15-19,1904,3.7361483878896733
SIM,1874,25,30-34,1899,78
STAT,1843,41,30-34,1884,1.2030300858502176
STAT,1887,45,20-24,1932,0.01567460326265365
STAT,1904,24,na,1928,3894.867797079402
STAT,1811,100,na,1911,0.5466342114281418
STAT,1889,20,40-44,1909,2.98204949053372
STAT,1879,25,50-100,1904,0.7760710469459274
SIM,1888,37,25-29,1925,1
SIM,1849,76,na,1925,1345
SIM,1867,33,na,1900,2250
SIM,1846,65,na,1911,1020
SIM,1889,26,20-24,1915,2
SIM,1828,32,40-44,1860,11
STAT,1949,32,40-44,1981,5.353849038360846
STAT,1858,45,25-29,1903,0.05237345984646206
STAT,1871,38,50-100,1909,1.4026122009403068
STAT,1925,36,35-39,1961,3.3522068434186965
SIM,1881,90,na,1971,107
SIM,1894,40,50-100,1934,2
SIM,1853,35,50-100,1888,3
STAT,1856,20,45-49,1876,0.7234035693754658
STAT,1899,66,na,1965,2869.3012233193967
SIM,1935,59,na,1994,5683
STAT,1848,7,na,1855,3260.1391799999997
SIM,1866,23,15-19,1889,6
SIM,1907,22,35-39,1929,23
STAT,1779,89,na,1868,31.617016163847524
STAT,1836,69,na,1905,1335.563971488476
STAT,1890,48,30-34,1938,0.07602969000479459
STAT,1919,49,25-29,1968,0.06599332957488148
STAT,1921,25,50-100,1946,1.288417363140886
STAT,1928,46,30-34,1974,0.1315905676892785
SIM,1955,28,35-39,1983,53
STAT,1931,33,25-29,1964,13.970921306760557
SIM,1969,15,15-19,1984,106
STAT,1981,25,20-24,2006,29.60970368533301
STAT,1907,8,na,1915,4413.963711894583
STAT,1923,42,30-34,1965,0.1723803659605446
STAT,1953,30,40-44,1983,5.575090410830422
SIM,1933,36,35-39,1969,6
STAT,1850,101,na,1951,0.5874261970582467
STAT,1888,39,40-44,1927,5.878641671465205
STAT,1880,104,na,1984,2.413655377005959
STAT,1939,23,15-19,1962,6.17002339398875
SIM,1839,36,35-39,1875,14
STAT,1821,44,15-19,1865,0.02548950009775809
STAT,1938,68,na,2006,3580.120471498425
SIM,1961,30,40-44,1991,6
SIM,1908,29,na,1937,4062
STAT,1946,22,45-49,1968,1.4449639306938529
SIM,1959,45,40-44,2004,1
STAT,1905,43,25-29,1948,0.0739461281344582
STAT,1963,34,na,1997,5644.963749924521
SIM,1875,39,40-44,1914,12
STAT,1922,27,20-24,1949,23.826951220259005
STAT,1867,39,40-44,1906,4.669237050466429
SIM,1832,25,25-29,1857,3
STAT,1806,90,na,1896,27.05971560873233
STAT,1901,81,na,1982,1648.199634596627
STAT,1937,48,30-34,1985,0.10363000026649699
STAT,1811,77,na,1888,435.0986972203196
STAT,1890,0,na,1890,4140.587413055209
STAT,1918,10,na,1928,4991.057857512886
STAT,1977,27,20-24,2004,28.586287848690073
SIM,1916,24,35-39,1940,18
STAT,1870,18,15-19,1888,6.776053003636005
STAT,1840,104,na,1944,0.05350687453446793
STAT,1947,31,50-100,1978,1.0962017637469672
SIM,1895,45,na,1940,3476
STAT,1879,31,35-39,1910,12.253176169446274
STAT,1846,22,40-44,1868,2.65799048439704
STAT,1884,67,na,1951,1807.4986397698644
STAT,1963,22,50-100,1985,0.9679157073199397
SIM,1837,29,25-29,1866,100
STAT,1819,49,20-24,1868,0.022445603823552814
SIM,1839,52,na,1891,1823
SIM,1943,17,20-24,1960,169
SIM,1838,39,na,1877,1711
STAT,1907,32,35-39,1939,9.873657687366878
SIM,1915,32,35-39,1947,20
STAT,1842,69,na,1911,1129.3116695062274
STAT,1991,23,25-29,2014,153.22242081295036
STAT,1826,45,na,1871,1443.350205603015
STAT,1805,77,na,1882,431.2152331150041
SIM,1887,87,na,1974,904
SIM,1829,38,30-34,1867,2
STAT,1944,47,25-29,1991,0.06852688651196025
STAT,1917,65,na,1982,3860.3656409962473
STAT,1822,36,15-19,1858,0.14297338286228553
STAT,1935,17,20-24,1952,214.0066477498254
STAT,1975,22,40-44,1997,5.136001806223377
SIM,1887,31,35-39,1918,28
STAT,1923,65,na,1988,4321.824036730064
STAT,1951,18,15-19,1969,62.347511508162405
STAT,1844,47,20-24,1891,0.009990278490480753
STAT,1921,35,20-24,1956,0.3401463502356634
SIM,1819,38,na,1857,1367
SIM,1940,43,na,1983,4949
SIM,1953,39,25-29,1992,3
SIM,1854,22,40-44,1876,5
STAT,1813,53,20-24,1866,0.0022967979160057983
STAT,1930,18,15-19,1948,67.5433927388248
SIM,1866,88,na,1954,17
STAT,1834,26,50-100,1860,0.7710273940335018
SIM,1914,29,na,1943,4116
STAT,1858,110,na,1968,0.0025577181561761506
STAT,1864,30,45-49,1894,1.8113506830024433
STAT,1945,39,25-29,1984,1.2760757913268836
SIM,1967,36,35-39,2003,1
STAT,1829,29,25-29,1858,64.9127566466889
STAT,2005,3,na,2008,6983.401281686592
STAT,1892,37,40-44,1929,6.331770382450048
SIM,1914,17,25-29,1931,21
SIM,1929,38,35-39,1967,5
STAT,1867,42,30-34,1909,1.237229108018225
SIM,1831,43,50-100,1874,3
STAT,1844,28,15-19,1872,0.4612207197203805
STAT,1877,19,45-49,1896,0.07799554014282539
SIM,1828,46,na,1874,2163
STAT,1804,95,na,1899,5.780886661759009
SIM,1857,40,20-24,1897,1
STAT,1865,40,50-100,1905,1.1111367116532511
SIM,1925,18,15-19,1943,100
STAT,1943,27,20-24,1970,22.43756758695142
STAT,1975,19,15-19,1994,69.04840877694801
STAT,1829,56,na,1885,1538.0736579674758
SIM,1951,27,20-24,1978,33
SIM,1863,19,25-29,1882,10
SIM,1993,21,40-44,2014,17
STAT,1892,15,30-34,1907,2.316138847334734
STAT,1822,83,na,1905,326.17511159651445
STAT,1974,35,25-29,2009,1.5312584006167458
STAT,1857,48,45-49,1905,0.20945403327263645
SIM,1811,80,na,1891,477
SIM,1847,46,35-39,1893,1
STAT,1871,41,45-49,1912,1.726107092542235
STAT,1907,26,40-44,1933,5.10384683655282
STAT,1951,46,na,1997,5264.430102121872
STAT,1980,20,45-49,2000,1.8098264566465219
STAT,1834,36,40-44,1870,5.020933615865256
STAT,1855,19,25-29,1874,5.6676831250889315
STAT,1968,36,45-49,2004,1.0132822035979077
SIM,1852,65,na,1917,1360
STAT,1985,21,40-44,2006,5.539002319926786
SIM,1906,26,30-34,1932,3
STAT,1830,52,45-49,1882,0.011772848668104127
STAT,1854,47,15-19,1901,3.2435925660826174E-4
STAT,1853,75,na,1928,1024.9519931983807
STAT,1876,23,50-100,1899,0.48498209496549183
STAT,1960,26,45-49,1986,2.6091324229454185
SIM,1839,83,na,1922,574
SIM,1992,8,na,2000,7039
STAT,1862,41,35-39,1903,1.7715901493084774
STAT,1956,49,30-34,2005,0.14076815363644116
SIM,1910,25,45-49,1935,4
SIM,1911,42,45-49,1953,1
SIM,1938,18,25-29,1956,59
SIM,1950,36,na,1986,4731
SIM,1829,37,50-100,1866,2
STAT,1951,26,35-39,1977,20.730705999194683
STAT,1912,59,na,1971,3835.1710780663902
STAT,1885,47,45-49,1932,0.27039528433531856
STAT,1934,39,50-100,1973,0.6675468418510258
SIM,1859,38,na,1897,2306
SIM,1939,30,30-34,1969,7
SIM,1915,26,40-44,1941,9
STAT,1839,46,35-39,1885,0.11458073625127052
STAT,1878,36,na,1914,2852.511316911951
STAT,1965,49,40-44,2014,0.23488974891890904
STAT,1897,25,25-29,1922,65.71961209292552
STAT,1902,25,45-49,1927,1.8227743421356775
SIM,1870,41,35-39,1911,7
SIM,1820,36,20-24,1856,1
STAT,1971,26,20-24,1997,26.80851352223902
STAT,1842,38,na,1880,1913.4594381938375
STAT,1924,16,30-34,1940,16.787330347661648
SIM,1833,36,30-34,1869,11
SIM,1822,58,na,1880,1236
STAT,1900,16,45-49,1916,0.1048614738343483
STAT,1974,0,na,1974,5968.876470611318
SIM,1784,79,na,1863,99
STAT,1949,29,15-19,1978,0.9506626888794865
SIM,1828,35,45-49,1863,4
SIM,1924,17,50-100,1941,4
STAT,1868,48,20-24,1916,0.013138031558012304
STAT,1893,32,30-34,1925,25.468813454007893
SIM,1901,25,35-39,1926,36
SIM,1978,20,40-44,1998,11
STAT,1892,7,na,1899,3768.476643693224
SIM,1932,16,30-34,1948,42
SIM,1879,35,25-29,1914,6
SIM,1877,26,na,1903,3350
STAT,1939,37,40-44,1976,1.7823188140886632
SIM,1973,30,20-24,2003,7
STAT,1949,40,25-29,1989,0.09988035325978084
SIM,1878,70,na,1948,1464
SIM,1918,88,na,2006,999
STAT,1814,88,na,1902,85.5988576252275
STAT,1826,76,na,1902,521.6457128972072
SIM,2002,4,na,2006,6948
STAT,1917,18,15-19,1935,11.241315231727148
STAT,1985,26,35-39,2011,24.760745212173052
STAT,1849,40,20-24,1889,0.12524222472661528
STAT,1979,36,20-24,2015,0.43193325840498203
STAT,1825,36,30-34,1861,9.09528094722374
SIM,1939,35,25-29,1974,3
SIM,1956,20,20-24,1976,156
STAT,1971,27,50-100,1998,1.4611563804943508
STAT,1859,63,na,1922,1640.3193024447987
STAT,1898,50,na,1948,3406.6061584463405
SIM,1860,60,na,1920,1961
STAT,1857,23,30-34,1880,18.349770562831242
SIM,1884,42,40-44,1926,4
STAT,1876,42,40-44,1918,2.680034884406339
STAT,1908,43,40-44,1951,0.2657972938443021
STAT,1899,34,25-29,1933,16.055629918671528
STAT,1818,38,15-19,1856,0.08705042716222135
STAT,1845,45,15-19,1890,2.722289515781831E-4
STAT,1860,26,40-44,1886,2.8364186389320833
STAT,1979,33,50-100,2012,1.3383166073526611
STAT,1997,5,na,2002,6625.803292050269
SIM,1880,15,na,1895,3529
SIM,1897,17,15-19,1914,16
STAT,1919,46,20-24,1965,0.013864055203361442
STAT,1805,103,na,1908,0.058977173191419305
SIM,1974,25,35-39,1999,2
STAT,1899,30,50-100,1929,1.4602931986850871
STAT,1914,42,20-24,1956,0.020204775008483365
STAT,1880,71,na,1951,1632.7831548315296
SIM,1845,23,45-49,1868,1
STAT,1957,23,35-39,1980,14.369546422768261
SIM,1907,24,25-29,1931,196
SIM,1942,33,40-44,1975,13
STAT,1807,52,50-100,1859,0.05931648943107316
SIM,1811,45,45-49,1856,1
STAT,1891,18,na,1909,3592.8798646362866
SIM,1920,36,25-29,1956,2
SIM,1848,35,30-34,1883,5
SIM,1854,60,na,1914,2022
SIM,1866,25,50-100,1891,5
STAT,1955,39,na,1994,5925.432099492344
STAT,1948,20,20-24,1968,147.43862962868016
STAT,1911,16,20-24,1927,31.412872650748028
STAT,1943,11,na,1954,4814.83967457167
SIM,1815,73,na,1888,598
SIM,1816,58,na,1874,1387
SIM,1969,40,40-44,2009,1
STAT,1894,104,na,1998,3.8245680888103943
STAT,1909,30,na,1939,4203.255763474155
STAT,1928,48,20-24,1976,0.01622718760980289
STAT,1889,17,15-19,1906,8.442309559196103
SIM,1959,48,45-49,2007,1
STAT,1934,33,40-44,1967,6.165324162250366
SIM,1965,23,35-39,1988,34
SIM,1956,39,40-44,1995,2
STAT,1905,40,20-24,1945,0.018606692973058333
STAT,1930,5,na,1935,5999.783959866751
SIM,1943,58,na,2001,5027
SIM,1933,31,40-44,1964,11
STAT,1886,62,na,1948,2224.9174912835774
SIM,1859,29,45-49,1888,2
SIM,1847,19,na,1866,2951
STAT,1934,15,50-100,1949,0.5878322958653572
STAT,1846,90,na,1936,81.50396683254036
STAT,1843,22,25-29,1865,72.09789761691592
SIM,1851,22,25-29,1873,4
STAT,1847,42,50-100,1889,0.8174251780535929
STAT,1925,31,40-44,1956,5.364310477980258
SIM,1839,38,25-29,1877,5
SIM,1927,15,45-49,1942,1
SIM,1778,79,na,1857,164
STAT,1940,32,20-24,1972,2.9142487839047733
SIM,1910,19,15-19,1929,13
STAT,1991,20,20-24,2011,184.63802357222005
SIM,1891,38,45-49,1929,3
STAT,1785,80,na,1865,168.0275260936914
STAT,1835,53,40-44,1888,0.006564014036347788
STAT,1896,55,na,1951,3151.787048827751
SIM,1865,28,25-29,1893,51
STAT,1832,50,20-24,1882,5.544055111831209E-4
STAT,1898,36,30-34,1934,8.352445833240013
STAT,1945,46,na,1991,4829.330972228245
STAT,1951,21,40-44,1972,4.637478704268042
STAT,1970,10,na,1980,5676.256023334687
SIM,1953,36,20-24,1989,1
SIM,1980,26,25-29,2006,10
SIM,1916,55,na,1971,4270
STAT,1912,36,25-29,1948,1.1154346089781315
STAT,1924,47,na,1971,5046.075908951468
STAT,1846,25,45-49,1871,1.4087248246618043
SIM,1937,54,na,1991,4086
STAT,1863,47,25-29,1910,0.0578537642509112
STAT,1866,48,na,1914,2376.3302663568384
STAT,1902,19,15-19,1921,9.625148731947295
STAT,1857,28,25-29,1885,38.8810054972463
STAT,1884,35,25-29,1919,3.314099344091436
STAT,1945,36,20-24,1981,0.3426851153128234
SIM,1911,49,na,1960,4599
SIM,1825,32,25-29,1857,16
STAT,1852,41,40-44,1893,2.1302429025355996
STAT,1841,41,50-100,1882,0.988615555387778
STAT,1931,49,40-44,1980,0.24191290986589936
STAT,1954,38,20-24,1992,0.38706673376713413
STAT,1860,57,na,1917,1869.1751813126239
STAT,1894,108,na,2002,0.2503944259160914
SIM,1875,42,30-34,1917,6
STAT,1885,18,na,1903,2899.631614104791
SIM,1854,25,45-49,1879,2
STAT,1909,49,30-34,1958,0.09408526774925999
SIM,1943,54,na,1997,5154
STAT,1851,26,30-34,1877,23.550150585238082
STAT,1841,52,20-24,1893,6.52584225867166E-4
STAT,1965,27,40-44,1992,6.744469743444014
SIM,1834,34,25-29,1868,28
STAT,1839,35,50-100,1874,1.1879535748278702
SIM,1839,33,30-34,1872,36
STAT,1837,23,45-49,1860,0.6562729608670026
STAT,1883,38,45-49,1921,2.239666342296347
STAT,1826,34,25-29,1860,8.770902388127345
SIM,1948,35,35-39,1983,5
STAT,1791,80,na,1871,278.5411825495724
STAT,1931,30,20-24,1961,3.693434247608432
STAT,1909,41,35-39,1950,0.21885686901978546
STAT,1977,38,45-49,2015,1.0940469802663861
STAT,1821,50,45-49,1871,0.026332070267170715
SIM,1897,37,35-39,1934,24
STAT,1843,38,40-44,1881,4.617937372627766
STAT,1849,43,25-29,1892,0.4941201231847675
SIM,1947,47,na,1994,5871
STAT,1828,71,na,1899,885.9063895670137
SIM,1849,42,50-100,1891,3
SIM,1849,45,na,1894,2545
SIM,1964,47,40-44,2011,2
STAT,1872,15,45-49,1887,0.07684745187929301
SIM,1990,23,15-19,2013,15
STAT,1906,15,35-39,1921,0.9276969857454533
STAT,1902,22,40-44,1924,3.3979170655617597
SIM,1808,91,na,1899,17
SIM,1905,12,na,1917,4552
STAT,1970,15,15-19,1985,65.5968958240703
STAT,1897,19,30-34,1916,2.4463637612406286
SIM,1883,26,na,1909,2479
SIM,1917,41,35-39,1958,4
SIM,1902,2,na,1904,4385
SIM,1986,25,15-19,2011,2
STAT,1985,24,45-49,2009,1.8516890612734744
SIM,1972,38,35-39,2010,4
SIM,1892,30,30-34,1922,2
SIM,1924,28,40-44,1952,2
SIM,1939,33,35-39,1972,21
STAT,1851,24,40-44,1875,1.9451116287646082
STAT,1893,44,na,1937,3337.426364974677
STAT,1929,1,na,1930,6150.835235756815
STAT,1899,31,20-24,1930,4.291191410318199
SIM,1898,25,na,1923,3883
SIM,1978,34,20-24,2012,6
STAT,1930,38,35-39,1968,3.6377390131925296
SIM,1871,33,50-100,1904,2
STAT,1915,30,na,1945,4481.777079279003
STAT,1983,15,25-29,1998,70.78425034659924
STAT,1956,47,40-44,2003,0.2504297293057606
STAT,1833,25,35-39,1858,9.286095450244689
STAT,1982,15,40-44,1997,2.2726104166942966
STAT,1882,18,40-44,1900,0.205630902761674
STAT,1960,23,40-44,1983,5.068912568885413
STAT,1884,30,30-34,1914,20.067959011414928
SIM,1857,71,na,1928,1263
SIM,1932,19,35-39,1951,14
SIM,1818,84,na,1902,312
SIM,1934,31,25-29,1965,22
STAT,1962,29,15-19,1991,1.0473515347825528
STAT,1921,38,25-29,1959,1.2670024620405953
STAT,1874,16,50-100,1890,0.05802347725374676
STAT,1865,16,15-19,1881,6.405473960023551
SIM,1947,5,na,1952,6129
SIM,1889,46,40-44,1935,1
SIM,1851,38,40-44,1889,12
STAT,1961,29,30-34,1990,58.615677095828566
STAT,1978,25,15-19,2003,1.1176318228573434
STAT,1883,18,25-29,1901,6.3814959358906815
STAT,1974,32,20-24,2006,3.7466681693892174
STAT,1945,42,15-19,1987,0.002011931336393704
SIM,1982,32,20-24,2014,7
STAT,1839,49,na,1888,1771.9161917608014
STAT,1819,94,na,1913,13.3049801354285
STAT,1859,54,40-44,1913,0.009411975934502048
STAT,1954,44,50-100,1998,0.17360091222982282
STAT,1924,19,35-39,1943,5.734168647539661
STAT,1863,49,15-19,1912,3.95215951829245E-4
SIM,1862,27,na,1889,2830
SIM,1929,16,25-29,1945,140
SIM,1944,46,50-100,1990,1
STAT,1936,46,50-100,1982,0.259511922922202
STAT,1804,110,na,1914,1.2015152143656368E-4
SIM,1911,28,30-34,1939,114
SIM,1869,18,15-19,1887,3
STAT,1944,25,15-19,1969,0.8813400396702723
STAT,1870,19,na,1889,2866.744645932448
STAT,1893,35,35-39,1928,10.41538728541121
STAT,1913,47,30-34,1960,0.10046688214444613
STAT,1875,27,30-34,1902,30.03181824095587
STAT,1933,58,na,1991,5533.251636169623
SIM,1805,80,na,1885,256
SIM,1896,31,45-49,1927,2
SIM,1903,82,na,1985,1288
STAT,1825,39,35-39,1864,11.04923643688425
STAT,1977,26,50-100,2003,1.559454401423654
SIM,1878,26,45-49,1904,3
SIM,1879,52,na,1931,2497
STAT,1849,106,na,1955,0.009410637953907805
STAT,1903,28,30-34,1931,41.24772785869667
STAT,1829,109,na,1938,5.212007107490165E-4
STAT,1856,18,50-100,1874,0.05070374593905773
SIM,1906,29,35-39,1935,16
STAT,1975,24,30-34,1999,43.872411981181806
STAT,1871,35,15-19,1906,0.06508483632776405
STAT,1885,44,40-44,1929,2.554213420135177
STAT,1894,45,50-100,1939,0.20757684403643206
STAT,1908,46,45-49,1954,0.22883394693629303
SIM,1883,27,30-34,1910,4
STAT,1821,39,na,1860,1709.2614435803148
SIM,1833,39,35-39,1872,15
STAT,1883,15,20-24,1898,20.110150637196796
STAT,1832,76,na,1908,645.4569548113614
SIM,1943,39,30-34,1982,3
SIM,1820,39,25-29,1859,7
SIM,1864,53,na,1917,2478
STAT,1981,20,na,2001,5916.515305718491
STAT,1911,19,25-29,1930,9.962461758477044
SIM,1938,38,45-49,1976,1
STAT,1982,23,15-19,2005,8.670145745747146
STAT,1865,63,na,1928,1857.9176305448912
STAT,1964,38,35-39,2002,3.618376612608911
SIM,1916,46,45-49,1962,1
STAT,1821,38,20-24,1859,1.6417150926505093
STAT,1847,75,na,1922,792.1240750543817
STAT,1923,32,50-100,1955,1.0934457498255894
SIM,1967,34,45-49,2001,1
STAT,1936,39,15-19,1975,0.021723079135111362
STAT,1973,37,30-34,2010,2.802549318913472
STAT,1935,39,30-34,1974,2.9364554786896315
STAT,1825,100,na,1925,0.750931540457527
STAT,1852,90,na,1942,74.3319456219365
SIM,1842,72,na,1914,1234
STAT,1839,26,15-19,1865,0.45655623841353354
STAT,1904,48,35-39,1952,0.12922892130509078
STAT,1900,31,na,1931,3836.9490992918822
STAT,1913,31,15-19,1944,0.1482290694645507
SIM,1914,15,35-39,1929,2
STAT,1888,31,45-49,1919,2.375292329306308
SIM,1839,35,20-24,1874,1
STAT,1836,38,na,1874,2367.745991736513
STAT,1816,83,na,1899,196.05196257666387
STAT,1873,114,na,1987,3.4035035821077756E-4
STAT,1949,34,30-34,1983,21.526919068016205
SIM,1834,31,20-24,1865,5
STAT,1876,47,50-100,1923,0.2916296454533022
SIM,1942,36,45-49,1978,2
STAT,1952,21,25-29,1973,128.20857892236586
STAT,1990,25,30-34,2015,65.09392126608068
SIM,1918,81,na,1999,2059
SIM,1871,38,na,1909,2075
SIM,1919,66,na,1985,4557
SIM,1840,46,na,1886,1884
STAT,1894,38,20-24,1932,1.1379123650584342
STAT,1927,37,15-19,1964,0.0275474155805601
STAT,1957,25,25-29,1982,100.67033245414196
SIM,1842,22,15-19,1864,8
STAT,1920,30,45-49,1950,2.004250918372219
SIM,1885,52,na,1937,2806
STAT,1925,34,45-49,1959,2.152993354993101
STAT,1857,37,na,1894,2117.5774352793146
SIM,1949,31,50-100,1980,1
SIM,1965,20,30-34,1985,97
SIM,1870,53,na,1923,2778
STAT,1808,46,40-44,1854,0.8708553246586643
SIM,1825,48,40-44,1873,1
SIM,1886,37,na,1923,2063
SIM,1957,29,15-19,1986,3
SIM,1950,18,40-44,1968,1
SIM,1933,34,45-49,1967,7
SIM,1956,23,25-29,1979,153
SIM,1891,52,na,1943,3058
STAT,1834,22,15-19,1856,4.026470541352289
STAT,1942,18,40-44,1960,1.6866294933016894
STAT,1859,103,na,1962,0.43946298606265227
STAT,1957,20,30-34,1977,43.90652997548131
STAT,1918,35,15-19,1953,0.023575596095626143
STAT,1966,22,30-34,1988,41.56526183876281
STAT,1880,37,15-19,1917,0.06869057562080048
STAT,1948,23,25-29,1971,122.35239153875618
STAT,1908,7,na,1915,4465.818115448293
SIM,1965,25,25-29,1990,22
SIM,1865,38,na,1903,2893
STAT,1839,21,20-24,1860,70.7279291946747
STAT,1933,16,40-44,1949,2.1670831969197075
STAT,1917,48,45-49,1965,0.26126068532634605
SIM,1838,38,40-44,1876,8
SIM,1847,21,20-24,1868,84
STAT,1926,31,25-29,1957,12.90240212625133
SIM,1974,22,30-34,1996,112
SIM,1841,25,35-39,1866,13
SIM,1971,32,45-49,2003,7
SIM,1891,18,25-29,1909,9
STAT,1817,48,40-44,1865,0.48180271907878996
STAT,1956,28,45-49,1984,2.6483234430606384
STAT,1979,17,25-29,1996,68.85883695992362
SIM,1948,32,30-34,1980,44
STAT,1951,24,45-49,1975,1.5503096212271177
SIM,1833,61,na,1894,1233
SIM,1834,46,na,1880,1812
STAT,1898,39,35-39,1937,2.3570873716083542
SIM,1968,43,50-100,2011,1
SIM,1941,16,40-44,1957,3
STAT,1863,44,20-24,1907,0.1580966372111589
STAT,1858,43,35-39,1901,1.6184737278911736
SIM,1901,20,40-44,1921,17
STAT,1801,84,na,1885,127.00685108216051
STAT,1866,31,25-29,1897,11.000896939826111
SIM,1866,43,35-39,1909,2
SIM,1865,25,20-24,1890,25
SIM,1842,36,40-44,1878,10
SIM,1856,23,20-24,1879,6
STAT,1852,44,45-49,1896,1.392005904315897
STAT,1858,40,30-34,1898,1.045474041517931
SIM,1813,47,na,1860,1354
STAT,1903,42,45-49,1945,0.17062704867303877
STAT,1848,23,20-24,1871,88.51446207781088
SIM,1915,41,50-100,1956,1
SIM,1910,67,na,1977,2596
SIM,1957,34,30-34,1991,5
SIM,1964,28,45-49,1992,6
STAT,1872,46,20-24,1918,0.013945107664354814
SIM,1984,18,40-44,2002,2
STAT,1826,31,20-24,1857,2.693660203529149
SIM,1850,27,35-39,1877,9
SIM,1879,29,30-34,1908,33
STAT,1888,29,na,1917,3214.357808724702
STAT,1907,41,50-100,1948,0.1251307723763447
STAT,1889,37,35-39,1926,10.061720726198196
STAT,1867,45,35-39,1912,0.15235227378882846
SIM,1910,22,40-44,1932,6
STAT,1916,28,40-44,1944,5.54275009681522
STAT,1943,38,45-49,1981,0.8587247561824308
SIM,1904,67,na,1971,3342
SIM,1951,38,45-49,1989,1
STAT,1851,29,35-39,1880,8.830714323816164
STAT,1825,34,40-44,1859,7.911375104199524
STAT,1958,40,35-39,1998,0.31807430239928586
SIM,1833,34,40-44,1867,2
STAT,1906,59,na,1965,3507.195462999064
SIM,1829,30,35-39,1859,21
STAT,1934,36,45-49,1970,1.0871979773722737
SIM,1925,66,na,1991,4228
SIM,1960,21,25-29,1981,3
STAT,1879,17,20-24,1896,21.3632150600116
STAT,1857,25,20-24,1882,11.018506252346047
STAT,1993,17,50-100,2010,0.6220751142443154
SIM,1930,26,45-49,1956,10
STAT,1839,17,35-39,1856,0.5692442054952565
STAT,1876,90,na,1966,251.2233958390538
SIM,1950,24,20-24,1974,151
SIM,1954,40,40-44,1994,2
STAT,1914,81,na,1995,1994.9272352744863
SIM,1867,4,na,1871,2891
SIM,1859,55,na,1914,1866
SIM,1907,17,30-34,1924,5
SIM,1931,19,15-19,1950,74
STAT,1838,30,15-19,1868,0.15652732972193917
SIM,1969,36,50-100,2005,4
SIM,1910,27,30-34,1937,44
STAT,1784,99,na,1883,0.38021461905961057
SIM,1941,16,na,1957,3735
STAT,1917,14,na,1931,4888.799528058753
STAT,1930,45,35-39,1975,0.19689175062641404
SIM,1970,23,35-39,1993,15
STAT,1898,31,25-29,1929,16.0404731895081
STAT,1951,22,20-24,1973,153.31289301707105
STAT,1927,35,35-39,1962,3.475732221884256
SIM,1902,49,50-100,1951,2
SIM,1907,9,na,1916,4842
SIM,1884,2,na,1886,3619
STAT,1907,36,20-24,1943,0.2838703981614206
SIM,1886,35,50-100,1921,2
STAT,1971,21,35-39,1992,13.812955982475936
STAT,1957,18,30-34,1975,18.54014463797023
SIM,1888,68,na,1956,1477
STAT,1902,27,30-34,1929,41.06231114486412
SIM,1926,59,na,1985,5362
STAT,1855,21,na,1876,2140.792057322601
STAT,1859,35,na,1894,2186.4303565615724
STAT,1829,32,15-19,1861,0.18472221472209094
SIM,1860,40,50-100,1900,2
STAT,1942,24,20-24,1966,134.47785004582755
SIM,1797,62,na,1859,952
STAT,1913,20,35-39,1933,10.59804426339857
STAT,1922,26,45-49,1948,2.262799779278545
STAT,1962,32,50-100,1994,1.2461863587479218
SIM,1833,62,na,1895,1215
SIM,1878,16,25-29,1894,9
SIM,1924,7,na,1931,5394
STAT,1931,24,45-49,1955,1.6739524450744439
STAT,1967,32,25-29,1999,13.581344317970734
STAT,1916,34,20-24,1950,2.8815985924714123
SIM,1940,17,15-19,1957,53
STAT,1932,17,15-19,1949,69.36854033758483
SIM,1912,22,35-39,1934,28
SIM,1821,40,50-100,1861,2
STAT,1933,52,na,1985,5734.760260853173
STAT,1844,69,na,1913,1227.486485546042
STAT,1960,28,30-34,1988,59.1206313494335
STAT,1923,19,15-19,1942,61.14776264591106
SIM,1875,93,na,1968,172
SIM,1913,84,na,1997,2101
STAT,1960,20,20-24,1980,167.80231481347198
STAT,1909,31,25-29,1940,10.23170467763018
SIM,1924,34,20-24,1958,8
SIM,1875,20,40-44,1895,2
STAT,1941,15,15-19,1956,53.988659732223695
SIM,1953,39,45-49,1992,2
SIM,1832,36,50-100,1868,4
STAT,1871,102,na,1973,3.921527363861374
SIM,1858,38,na,1896,2507
STAT,1945,31,35-39,1976,11.749801606379554
STAT,1787,105,na,1892,0.00900511435933302
STAT,1912,41,25-29,1953,0.0800161214135957
SIM,1854,24,na,1878,2960
STAT,1849,24,40-44,1873,1.9247571038087437
STAT,1904,22,35-39,1926,9.670669581693828
STAT,1958,3,na,1961,5962.4978089165015
STAT,1855,101,na,1956,0.5799591116161448
STAT,1962,23,35-39,1985,13.964511618631695
SIM,1850,10,na,1860,2254
SIM,1917,39,35-39,1956,9
STAT,1829,101,na,1930,0.4180270435759743
STAT,1901,18,25-29,1919,9.136169076033605
SIM,1941,5,na,1946,4077
STAT,1939,47,20-24,1986,0.013284001095765642
STAT,1867,20,40-44,1887,2.2872566080080254
STAT,1946,40,40-44,1986,0.3336406598032238
SIM,1994,13,na,2007,6223
SIM,1884,54,na,1938,2375
STAT,1946,27,na,1973,4815.743770915975
STAT,1945,39,45-49,1984,0.883524110683457
STAT,1942,13,na,1955,4737.436042041698
SIM,1880,40,na,1920,3265
STAT,1955,24,50-100,1979,1.0107011616445278
SIM,1939,28,30-34,1967,71
STAT,1905,34,45-49,1939,1.6581790911257446
STAT,1899,18,45-49,1917,0.10300888899273193
STAT,1855,22,15-19,1877,3.279418368892045
STAT,1848,15,35-39,1863,0.7313276449901973
STAT,1809,60,na,1869,1163.3707068087751
SIM,1970,29,na,1999,5992
SIM,1935,35,35-39,1970,2
STAT,1920,23,30-34,1943,36.7446964069385
SIM,1917,31,25-29,1948,22
SIM,1953,31,35-39,1984,1
SIM,1857,24,40-44,1881,4
STAT,1961,46,35-39,2007,0.20044993827172233
STAT,1956,39,20-24,1995,0.4138444640159139
SIM,1856,15,35-39,1871,1
STAT,1952,46,25-29,1998,0.0764954107456981
STAT,1964,28,15-19,1992,1.030056443858111
STAT,1943,40,15-19,1983,0.001958690789916916
STAT,1934,30,20-24,1964,3.8495556777168476
STAT,1943,36,30-34,1979,2.300211082281367
SIM,1942,38,30-34,1980,4
STAT,1944,27,35-39,1971,18.727226253006332
SIM,1884,30,35-39,1914,25
SIM,1952,27,35-39,1979,24
STAT,1963,35,45-49,1998,1.0315251348253778
SIM,1930,32,na,1962,5928
STAT,1948,45,20-24,1993,0.015252360957730334
STAT,1831,94,na,1925,15.680418582555347
STAT,1914,32,45-49,1946,1.8288409631016034
STAT,1950,15,50-100,1965,0.5115054492069739
STAT,1915,25,15-19,1940,0.8367666555434542
SIM,1934,46,na,1980,5678
STAT,1963,32,40-44,1995,5.84844181426609
STAT,1965,39,30-34,2004,2.6995535838040925
STAT,1910,16,25-29,1926,9.944104565217987
SIM,1913,34,45-49,1947,3
STAT,1919,41,35-39,1960,0.2521365483331131
STAT,1839,90,na,1929,62.52449448233977
SIM,1896,30,50-100,1926,2
STAT,1954,14,na,1968,5602.082541963059
SIM,1948,52,na,2000,4286
STAT,1866,110,na,1976,0.008990778982454995
STAT,1944,15,40-44,1959,1.7381061090813605
SIM,1951,36,30-34,1987,5
STAT,1935,43,na,1978,6039.255341739387
STAT,1897,52,na,1949,3305.028415972337
STAT,1903,39,40-44,1942,1.5374841165596163
STAT,1922,9,na,1931,5314.514714601057
SIM,1942,30,20-24,1972,2
STAT,1976,15,50-100,1991,0.5779510765317837
STAT,1934,38,30-34,1972,2.901040888236938
SIM,1973,39,30-34,2012,7
SIM,1912,44,50-100,1956,1
STAT,1958,34,25-29,1992,14.261691275518299
SIM,1979,31,50-100,2010,6
STAT,1939,57,na,1996,4222.186592172249
STAT,1905,13,na,1918,4306.936523174716
STAT,1772,98,na,1870,0.07260046713361283
STAT,1871,46,45-49,1917,0.2717271216674942
STAT,1928,47,45-49,1975,0.3200243452279393
STAT,1909,27,na,1936,4136.308495524244
STAT,1940,22,45-49,1962,1.3232004202491614
STAT,1971,26,na,1997,5501.75997676676
SIM,1894,32,na,1926,3777
STAT,1882,49,25-29,1931,0.06357194505783327
STAT,1933,26,20-24,1959,27.99618553249315
STAT,1919,49,45-49,1968,0.2703893388041991
STAT,1864,20,15-19,1884,3.5042580086083204
STAT,1898,109,na,2007,0.12098641152827509
STAT,1924,23,15-19,1947,7.2245122449972525
STAT,1913,28,45-49,1941,1.9806366520113081
SIM,1961,25,35-39,1986,42
STAT,1845,43,na,1888,1565.7808713067004
SIM,1941,26,20-24,1967,3
SIM,1872,53,na,1925,2671
SIM,1925,25,25-29,1950,162
STAT,1908,40,20-24,1948,0.019094260038920445
STAT,1954,37,45-49,1991,1.0020024899167064
SIM,1916,48,30-34,1964,1
SIM,1843,40,na,1883,1839
STAT,1869,25,20-24,1894,13.200117925614695
SIM,1921,28,45-49,1949,6
SIM,1902,33,30-34,1935,22
STAT,1889,65,na,1954,2404.088739805655
STAT,1826,72,na,1898,695.3569472231021
SIM,1876,67,na,1943,1909
SIM,1944,30,30-34,1974,30
STAT,1806,105,na,1911,0.010063461604940916
SIM,1922,32,45-49,1954,11
STAT,1885,51,na,1936,2490.458351011455
STAT,1918,37,35-39,1955,2.941517194642037
SIM,1927,41,35-39,1968,2
STAT,2011,0,na,2011,7252.196118667544
STAT,1968,19,45-49,1987,0.7195628968492104
STAT,1953,25,35-39,1978,21.0686739828353
SIM,1922,45,na,1967,4996
SIM,1962,37,45-49,1999,1
SIM,1847,17,35-39,1864,3
SIM,1842,31,50-100,1873,1
STAT,1810,54,30-34,1864,0.020927701437925925
STAT,1970,44,35-39,2014,0.30130793650065396
STAT,1903,43,25-29,1946,0.07277096049541536
SIM,1901,29,30-34,1930,89
SIM,1926,37,35-39,1963,5
STAT,1937,42,40-44,1979,0.2913180734632817
STAT,1846,60,na,1906,1971.6082043688587
STAT,1861,33,50-100,1894,0.8753430000199622
SIM,1887,23,15-19,1910,9
SIM,1901,21,20-24,1922,5
STAT,1920,91,na,2011,636.3649858147686
STAT,1875,17,45-49,1892,0.07790332006430611
STAT,1780,85,na,1865,120.11733239670008
STAT,1822,106,na,1928,0.009975936486083574
SIM,1789,75,na,1864,773
STAT,1967,39,40-44,2006,2.2185485137737353
SIM,1975,39,40-44,2014,5
STAT,1858,22,40-44,1880,2.1524728700732574
STAT,1860,45,30-34,1905,0.0909321231772322
STAT,1917,25,25-29,1942,80.2027198763171
SIM,1848,71,na,1919,817
SIM,1866,22,40-44,1888,6
STAT,1876,30,35-39,1906,12.178487415254779
STAT,1808,54,50-100,1862,0.06915195665628367
STAT,1908,48,30-34,1956,0.09289964470350463
STAT,1961,19,35-39,1980,6.252263379940888
STAT,1926,44,30-34,1970,0.18124383437748479
SIM,1916,27,25-29,1943,5
STAT,1950,46,15-19,1996,5.24140099455206E-4
SIM,1856,40,25-29,1896,1
SIM,1950,27,25-29,1977,189
SIM,1989,21,50-100,2010,2
STAT,1851,39,na,1890,1849.4743275012486
STAT,1902,31,15-19,1933,0.23316291537098643
SIM,1868,16,na,1884,3312
STAT,1943,30,na,1973,4723.643931196623
STAT,1947,44,na,1991,5000.677887370837
SIM,1857,27,45-49,1884,1
STAT,1858,18,na,1876,2399.7917849919504
STAT,1960,32,15-19,1992,0.19688483626688658
SIM,1885,71,na,1956,1971
SIM,1889,85,na,1974,1237
STAT,1916,46,15-19,1962,4.3716213547330304E-4
STAT,1931,21,40-44,1952,5.04898863415757
SIM,1834,36,na,1870,1964
STAT,1864,20,50-100,1884,0.433159259830589
STAT,1942,27,25-29,1969,79.73737502488991
SIM,1848,21,35-39,1869,15
SIM,1930,23,40-44,1953,8
SIM,1961,45,50-100,2006,2
STAT,1848,40,25-29,1888,0.6991568381548194
SIM,1802,58,na,1860,1082
STAT,1955,41,45-49,1996,0.26535842427557477
SIM,1920,37,40-44,1957,3
SIM,1952,57,na,2009,4339
STAT,1942,47,50-100,1989,0.2837785007265355
SIM,1829,31,50-100,1860,1
STAT,1920,35,25-29,1955,1.2457204127813548
SIM,1970,20,30-34,1990,1
SIM,1932,23,15-19,1955,5
STAT,1930,42,30-34,1972,0.1941504152464395
SIM,1888,23,30-34,1911,62
SIM,1851,91,na,1942,120
STAT,1886,9,na,1895,3158.4757912188866
STAT,1849,27,45-49,1876,1.0201139279829368
STAT,1901,43,15-19,1944,0.0015389811532106278
STAT,1922,23,40-44,1945,4.434155283910894
STAT,1913,64,na,1977,3666.642941778593
STAT,1917,78,na,1995,2544.6845831138608
STAT,1879,87,na,1966,463.973010248794
STAT,1875,73,na,1948,1416.5083776057909
STAT,1998,16,35-39,2014,7.112210303345788
STAT,1864,16,30-34,1880,1.8781119283978323
STAT,1945,29,50-100,1974,1.2589725529989872
SIM,1960,34,30-34,1994,66
SIM,1821,61,na,1882,1073
STAT,1962,20,30-34,1982,42.668935395546804
SIM,1928,50,na,1978,5574
SIM,1898,46,na,1944,3824
STAT,1860,0,na,1860,3609.646255988346
STAT,1896,35,na,1931,3625.2891545887865
STAT,1905,31,40-44,1936,4.176338737312045
STAT,1942,70,na,2012,3612.866329247977
STAT,1829,45,50-100,1874,0.25730695081113003
STAT,1952,34,30-34,1986,22.18129743990609
STAT,1892,21,na,1913,3431.2154735838058
STAT,1902,22,25-29,1924,93.34629795310003
SIM,1846,26,30-34,1872,25
STAT,1934,42,15-19,1976,0.002468211978934957
STAT,1948,24,15-19,1972,7.0486137355719904
SIM,1875,23,45-49,1898,4
STAT,1900,5,na,1905,4196.574330172729
SIM,1902,3,na,1905,4385
STAT,1884,34,na,1918,2697.6264929875574
STAT,1867,23,45-49,1890,0.7490342355497803
STAT,1888,48,na,1936,3014.2877254876985
STAT,1881,69,na,1950,1633.565251155693
SIM,1837,45,50-100,1882,1
STAT,1938,38,15-19,1976,0.022510601911570255
SIM,1910,22,25-29,1932,114
STAT,1923,30,45-49,1953,2.0978021518882413
SIM,1879,25,30-34,1904,33
SIM,1954,48,na,2002,5371
STAT,1854,25,50-100,1879,0.6090896615748568
STAT,1967,28,40-44,1995,6.745010782496545
STAT,1953,46,40-44,1999,0.2295125803299253
STAT,1824,48,25-29,1872,0.07721444615601869
STAT,1888,21,15-19,1909,4.488883735353233
SIM,1924,37,25-29,1961,1
STAT,1956,34,15-19,1990,0.19977021593782532
SIM,1917,34,na,1951,5345
SIM,1913,20,na,1933,4967
SIM,1953,36,40-44,1989,5
SIM,1948,38,na,1986,4397
STAT,1838,26,30-34,1864,27.952867478745343
STAT,1945,36,40-44,1981,1.946042967226625
STAT,1880,20,na,1900,2910.286417824478
STAT,1937,15,50-100,1952,0.4228081181591776
STAT,1852,56,na,1908,1922.9943471425454
SIM,1956,24,15-19,1980,8
STAT,1941,43,45-49,1984,0.20532135399047555
SIM,1921,71,na,1992,3939
STAT,1916,37,25-29,1953,1.163736977902266
SIM,1896,21,15-19,1917,4
STAT,1973,21,45-49,1994,1.6854761669381633
STAT,1959,18,40-44,1977,2.1107919196339915
STAT,1908,27,25-29,1935,72.50849344825991
STAT,1896,31,15-19,1927,0.21795712339560758
STAT,1941,48,15-19,1989,4.543060330007977E-4
SIM,1903,4,na,1907,4334
STAT,1933,38,15-19,1971,0.03016847061677453
STAT,1954,48,45-49,2002,0.32162301764028023
SIM,1901,83,na,1984,1827
SIM,1952,24,30-34,1976,105
STAT,1921,51,na,1972,4716.879453897224
STAT,1904,27,40-44,1931,4.9643059955639215
STAT,1925,65,na,1990,4476.953974089276
STAT,1903,40,20-24,1943,0.01831099144002087
STAT,1865,6,na,1871,2941.611760591836
STAT,1840,49,20-24,1889,0.009461895758864077
SIM,1935,63,na,1998,5202
STAT,1935,21,25-29,1956,145.28721967981807
SIM,1943,21,25-29,1964,141
SIM,1897,72,na,1969,2101
STAT,1820,48,40-44,1868,0.1724172520257977
STAT,1872,39,15-19,1911,0.06441710904990028
STAT,1958,31,20-24,1989,3.7707566323834567
STAT,1909,39,35-39,1948,2.618443987180294
SIM,1937,35,45-49,1972,1
SIM,1923,20,45-49,1943,1
STAT,1958,39,30-34,1997,2.84003696951104
STAT,1952,42,50-100,1994,0.1688456148263875
SIM,1919,25,na,1944,5100
SIM,1915,11,na,1926,5022
STAT,1907,93,na,2000,336.50268866650197
STAT,1944,24,30-34,1968,35.78984128204431
SIM,1842,23,na,1865,2578
SIM,1903,24,35-39,1927,1
STAT,1934,17,25-29,1951,67.67817328132809
STAT,1864,57,na,1921,2070.8073364668135
STAT,1913,41,40-44,1954,0.2832640752883153
STAT,1860,43,na,1903,2134.175117661797
SIM,1840,75,na,1915,371
SIM,1877,84,na,1961,767
SIM,1909,47,na,1956,4537
SIM,1979,26,50-100,2005,2
SIM,1905,33,na,1938,4254
SIM,1846,37,na,1883,1665
SIM,1957,36,25-29,1993,2
SIM,1888,7,na,1895,3131
SIM,1869,18,25-29,1887,4
SIM,1989,21,30-34,2010,88
SIM,1781,79,na,1860,503
STAT,1850,38,25-29,1888,2.9798116261091585
STAT,1925,32,20-24,1957,3.3416148640956918
SIM,1847,54,na,1901,2174
SIM,1932,28,20-24,1960,3
STAT,1821,52,40-44,1873,0.01835756721428971
STAT,1871,16,na,1887,2935.7338853619467
SIM,1933,32,20-24,1965,10
STAT,1897,15,30-34,1912,2.4709812901614425
STAT,1929,35,45-49,1964,1.0118337731777438
STAT,1949,36,25-29,1985,1.3627229155416969
SIM,1829,25,na,1854,2094
SIM,1844,89,na,1933,78
SIM,1848,30,25-29,1878,4
SIM,1913,31,40-44,1944,3
STAT,1924,28,20-24,1952,24.434704578626576
STAT,1926,19,40-44,1945,1.9680492415338071
SIM,1787,84,na,1871,341
STAT,1912,37,40-44,1949,1.6877723682703434
STAT,1934,26,na,1960,5821.307782567395
SIM,1918,18,45-49,1936,2
STAT,1970,41,30-34,2011,0.19221291081461114
STAT,1868,16,15-19,1884,6.738866796358082
STAT,1937,45,45-49,1982,0.2545484198974666
STAT,1914,41,35-39,1955,0.2307105780996984
STAT,1930,12,na,1942,5912.48915954998
SIM,1904,36,45-49,1940,2
SIM,1932,69,na,2001,4074
SIM,1942,17,25-29,1959,73
STAT,1919,46,40-44,1965,0.1977938465478984
SIM,1908,29,40-44,1937,1
SIM,1926,34,30-34,1960,31
SIM,1951,39,35-39,1990,6
STAT,1934,33,50-100,1967,1.3025870718965937
SIM,1873,70,na,1943,2009
STAT,1950,18,20-24,1968,184.93952115977655
STAT,1882,46,20-24,1928,0.013564984994391764
STAT,1860,48,35-39,1908,0.12857905291430627
STAT,1911,25,30-34,1936,44.434835433468194
STAT,1830,77,na,1907,542.2477785864032
SIM,1869,33,na,1902,1933
SIM,1847,40,50-100,1887,3
SIM,1839,67,na,1906,1482
STAT,1839,40,50-100,1879,0.9955415740755444
STAT,1943,39,35-39,1982,3.0433562513482952
STAT,1936,33,35-39,1969,10.243314424740436
STAT,1903,86,na,1989,1049.276761409768
SIM,1943,29,35-39,1972,40
SIM,1899,21,40-44,1920,1
STAT,1875,16,50-100,1891,0.058570988971209055
STAT,1918,34,30-34,1952,19.151568056620285
STAT,1899,31,40-44,1930,6.884674864363321
SIM,1944,33,35-39,1977,24
SIM,1927,46,40-44,1973,1
SIM,1966,31,20-24,1997,8
STAT,1979,19,20-24,1998,215.28264295703767
SIM,1832,88,na,1920,160
SIM,1922,41,35-39,1963,1
STAT,1935,29,35-39,1964,23.607484780305487
STAT,1917,22,20-24,1939,136.38794877101122
SIM,1882,30,25-29,1912,23
STAT,1941,36,20-24,1977,0.32320186161463316
STAT,1918,28,45-49,1946,2.1138657388677973
STAT,1921,38,45-49,1959,0.8772419562510231
STAT,1965,30,na,1995,5560.608806323881
STAT,1940,31,35-39,1971,10.924630189138975
STAT,1836,18,na,1854,2763.9762608064284
SIM,1889,21,na,1910,3635
SIM,1979,20,50-100,1999,1
STAT,1874,39,25-29,1913,3.3673837624707854
STAT,1937,21,35-39,1958,10.590979440534358
SIM,1927,12,na,1939,5252
STAT,1926,47,35-39,1973,0.18355262774507192
STAT,1873,17,35-39,1890,0.6466481570567403
SIM,1852,49,40-44,1901,1
STAT,1828,74,na,1902,736.5660294973628
STAT,1906,48,20-24,1954,0.011248220379901757
STAT,1926,28,30-34,1954,54.00457710557859
STAT,1921,19,40-44,1940,1.8294115086983205
STAT,1874,30,25-29,1904,12.198366917475017
SIM,1827,77,na,1904,356
STAT,1857,87,na,1944,158.35316957928944
STAT,1876,47,na,1923,2671.4994643747345
STAT,1853,73,na,1926,1182.5491020434733
SIM,1934,28,30-34,1962,2
STAT,1932,38,20-24,1970,0.40843430396795666
STAT,1898,29,50-100,1927,0.9905847732107765
SIM,1925,22,20-24,1947,7
STAT,1920,32,20-24,1952,3.08197001999268
STAT,1983,19,30-34,2002,19.885464848697428
SIM,1991,19,30-34,2010,27
STAT,1824,36,50-100,1860,1.9275675972249877
SIM,1919,39,45-49,1958,1
SIM,1877,25,20-24,1902,2
STAT,1936,42,25-29,1978,0.08165774055785889
SIM,1883,17,45-49,1900,1
STAT,1901,27,15-19,1928,0.733402323998173
SIM,1960,18,30-34,1978,49
STAT,1842,49,30-34,1891,0.07293474759029786
SIM,1928,75,na,2003,3688
STAT,1921,30,35-39,1951,11.826158229291263
SIM,1958,37,na,1995,6150
SIM,1825,75,na,1900,733
STAT,1910,37,30-34,1947,2.013701692664839
STAT,1952,37,35-39,1989,3.446233238847476
STAT,1804,93,na,1897,12.707171694805755
SIM,1935,44,25-29,1979,1
SIM,1902,36,35-39,1938,6
STAT,1952,18,30-34,1970,16.851355983675425
STAT,1975,33,na,2008,5865.688472447827
STAT,1967,47,50-100,2014,0.3391447370855319
SIM,1810,45,na,1855,1514
STAT,1907,27,30-34,1934,42.75822836501115
STAT,1864,5,na,1869,2945.5301125833294
STAT,1866,20,25-29,1886,62.6295571202935
STAT,1869,24,50-100,1893,0.45289687611717
STAT,1965,48,20-24,2013,0.016515267553886336
SIM,1814,59,na,1873,1085
SIM,1871,36,na,1907,2103
STAT,1930,36,45-49,1966,1.0272597982895426
STAT,1971,40,na,2011,5657.164086765052
STAT,1972,41,40-44,2013,0.38464023836863587
STAT,1926,20,20-24,1946,156.79613168807737
STAT,1836,53,50-100,1889,0.013639135202177558
SIM,1838,20,15-19,1858,2
SIM,1850,74,na,1924,317
STAT,1996,16,25-29,2012,72.70101421651013
SIM,1902,17,30-34,1919,4
STAT,1937,29,45-49,1966,1.9426140061670039
STAT,1846,40,15-19,1886,0.014824207382165876
STAT,1930,17,40-44,1947,2.087158033613132
STAT,1829,69,na,1898,1075.0919372737671
SIM,1881,17,35-39,1898,1
STAT,1917,49,35-39,1966,0.1545062484069903
SIM,1960,37,35-39,1997,2
STAT,1905,43,35-39,1948,0.20852012950003812
SIM,1945,29,45-49,1974,2
SIM,1983,18,na,2001,6184
STAT,1863,72,na,1935,1274.400081633948
STAT,1878,35,50-100,1913,1.493425276653392
STAT,1915,20,45-49,1935,1.2959381788245052
STAT,1937,0,na,1937,5060.647074994844
STAT,1924,38,50-100,1962,0.5706164984682813
STAT,1912,47,na,1959,4078.4716477230295
STAT,1962,32,25-29,1994,13.930974889202625
SIM,1956,29,20-24,1985,3
STAT,1928,30,na,1958,5463.613715643761
STAT,1948,29,20-24,1977,24.187673966163725
SIM,1909,21,25-29,1930,204
SIM,1940,4,na,1944,5183
STAT,1921,8,na,1929,5244.660881955052
SIM,1954,26,50-100,1980,5
STAT,1867,86,na,1953,239.06902052349096
STAT,1910,35,na,1945,4196.213426918233
STAT,1914,49,na,1963,4182.139946605561
STAT,1825,55,na,1880,1590.2686919943092
SIM,1946,30,40-44,1976,12
SIM,1829,34,30-34,1863,32
STAT,1821,41,na,1862,1700.5202583528207
STAT,1901,6,na,1907,4222.830480417597
SIM,1963,24,50-100,1987,1
SIM,1812,57,na,1869,1162
STAT,1856,25,35-39,1881,8.93095941394164
SIM,1964,12,na,1976,5970
STAT,1779,77,na,1856,282.11529645089996
STAT,1806,49,20-24,1855,0.04278298320434642
SIM,1968,26,na,1994,5100
STAT,1959,22,25-29,1981,139.89947771308954
SIM,1937,32,40-44,1969,2
STAT,1838,73,na,1911,1028.8432693006055
STAT,1836,26,20-24,1862,13.919846745770256
STAT,1952,43,20-24,1995,0.025341917420104745
STAT,1846,49,15-19,1895,4.0487866595213096E-4
STAT,1938,30,40-44,1968,4.548384533182023
STAT,1909,16,50-100,1925,0.08509276227598678
STAT,1968,44,50-100,2012,0.1753954122358523
STAT,1949,33,20-24,1982,3.334964589537559
SIM,1819,36,50-100,1855,1
SIM,1903,21,30-34,1924,2
STAT,1846,17,na,1863,2980.951124159173
SIM,1918,27,35-39,1945,49
STAT,1901,25,50-100,1926,1.0410670503589987
STAT,1905,18,45-49,1923,0.10882377089858249
SIM,1874,20,25-29,1894,73
SIM,1972,20,40-44,1992,8
SIM,1919,31,35-39,1950,24
STAT,1903,47,50-100,1950,0.2266653336228522
STAT,1904,44,50-100,1948,0.11993615923226726
STAT,1920,26,35-39,1946,19.063634537940274
STAT,1815,56,na,1871,1442.0096159938905
SIM,1917,91,na,2008,548
STAT,1975,37,25-29,2012,1.5443757903196857
SIM,1903,45,40-44,1948,1
SIM,1903,29,40-44,1932,11
STAT,1965,28,30-34,1993,56.66947660484166
STAT,1815,47,20-24,1862,0.024499238021747322
STAT,1942,48,30-34,1990,0.11153661649606315
STAT,1841,37,20-24,1878,0.8074819328834348
SIM,1967,22,25-29,1989,271
SIM,1900,66,na,1966,2640
SIM,1934,20,20-24,1954,341
SIM,1868,5,na,1873,3491
SIM,1813,74,na,1887,588
SIM,1879,32,na,1911,2788
SIM,1824,37,na,1861,1695
STAT,1851,43,50-100,1894,0.831709085953649
STAT,1814,82,na,1896,290.9227748342375
STAT,1821,39,45-49,1860,4.07627021939625
STAT,1909,40,15-19,1949,0.0016783181473762666
SIM,1933,16,20-24,1949,224
STAT,1939,71,na,2010,3368.8505307203454
SIM,1844,26,20-24,1870,24
STAT,1925,16,20-24,1941,189.4068076567946
SIM,1877,20,na,1897,3183
STAT,1882,86,na,1968,547.6833492665926
STAT,1830,52,50-100,1882,0.012251744187024188
STAT,1811,63,na,1874,1096.7013923613401
STAT,1815,77,na,1892,479.6353299730505
STAT,1874,35,na,1909,2809.8975995240344
SIM,1854,15,25-29,1869,14
SIM,1907,26,20-24,1933,35
STAT,1906,22,45-49,1928,1.1735022512224391
STAT,1964,20,40-44,1984,4.906785761055995
STAT,1986,17,na,2003,6052.6138967182815
STAT,1884,40,35-39,1924,2.0855617239298745
STAT,1862,55,na,1917,2013.8132585701956
STAT,1878,49,na,1927,2654.355411198265
STAT,1915,46,20-24,1961,0.012885482193777551
STAT,1966,39,25-29,2005,1.4590530484156328
STAT,1866,69,na,1935,1569.775201146669
STAT,1862,16,20-24,1878,19.892375623090427
SIM,1911,29,na,1940,4639
STAT,1920,13,na,1933,5120.09357185981
STAT,1935,30,15-19,1965,0.20551558757258756
STAT,1974,19,20-24,1993,204.16553432597587
STAT,1877,38,50-100,1915,1.466527333600613
STAT,1882,15,35-39,1897,0.6213868795164879
STAT,1924,27,na,1951,5032.310292508415
SIM,1892,40,35-39,1932,7
STAT,1944,40,30-34,1984,0.1654704439593546
SIM,1859,24,15-19,1883,6
SIM,1861,58,na,1919,1487
SIM,1870,16,20-24,1886,30
STAT,1861,17,na,1878,2531.2476965678698
STAT,1922,42,45-49,1964,0.22035906739028407
SIM,1953,47,40-44,2000,1
SIM,1978,23,20-24,2001,178
STAT,1911,16,40-44,1927,0.32408270864446775
SIM,1918,86,na,2004,1513
STAT,1975,23,20-24,1998,169.7938353287359
SIM,1933,61,na,1994,5796
STAT,1949,32,50-100,1981,1.1311415845666364
SIM,1929,24,na,1953,4616
STAT,1846,15,25-29,1861,7.446496526220534
SIM,1908,30,20-24,1938,2
STAT,1931,33,35-39,1964,13.813326939951375
STAT,1826,48,35-39,1874,0.09943132451340125
STAT,1952,48,50-100,2000,0.324454539628713
SIM,1925,10,na,1935,5602
STAT,1925,35,25-29,1960,1.3657136423443839
STAT,1929,32,40-44,1961,5.736797629406401
STAT,1944,48,40-44,1992,0.20311091405669887
SIM,1906,50,na,1956,3400
STAT,1847,27,35-39,1874,8.923761846568494
SIM,1972,34,na,2006,5765
STAT,1879,23,15-19,1902,3.9631022968352836
SIM,1889,35,40-44,1924,13
STAT,1956,18,15-19,1974,69.28154578317339
SIM,1964,18,15-19,1982,55
SIM,1908,38,30-34,1946,2
SIM,1841,92,na,1933,13
SIM,1832,45,na,1877,2001
STAT,1894,41,50-100,1935,1.5743793976979272
SIM,1855,27,35-39,1882,8
STAT,1845,53,40-44,1898,0.006980204760740808
STAT,1845,27,50-100,1872,0.5246767556820504
STAT,1977,10,na,1987,6126.79719782821
STAT,1853,51,25-29,1904,0.0035433682336732534
STAT,1858,25,45-49,1883,1.0381301897002901
STAT,1848,49,25-29,1897,0.059923752758970376
STAT,1905,40,30-34,1945,0.1346962751198306
STAT,1921,35,40-44,1956,1.9316258078488744
SIM,1818,36,20-24,1854,5
SIM,1919,46,na,1965,5295
STAT,1917,37,40-44,1954,1.7944420242173191
SIM,1878,21,50-100,1899,1
SIM,1915,32,na,1947,4607
STAT,1911,49,40-44,1960,0.17138885470499415
STAT,1918,25,40-44,1943,5.762119849999639
STAT,1869,16,30-34,1885,1.816688922813649
STAT,1971,37,40-44,2008,2.254277704280171
SIM,1881,25,na,1906,1818
SIM,1935,32,30-34,1967,38
STAT,1870,44,50-100,1914,1.1857267852325974
STAT,1947,36,15-19,1983,0.02574202794201034
STAT,1899,26,50-100,1925,1.0148695764222513
STAT,1865,111,na,1976,0.0030617972358894102
STAT,1911,41,30-34,1952,0.141750724377059
STAT,1843,95,na,1938,13.340490104900315
SIM,1851,59,na,1910,2363
SIM,1818,41,na,1859,2172
SIM,1951,27,40-44,1978,6
STAT,1812,54,40-44,1866,0.022404295478521248
STAT,1918,31,na,1949,4656.021907783446
SIM,1901,24,25-29,1925,108
STAT,2012,1,na,2013,7236.927961085465
STAT,1891,68,na,1959,2303.046581069409
STAT,1794,77,na,1871,450.17454688029915
STAT,1961,43,30-34,2004,0.19778386305602177
STAT,1844,15,15-19,1859,6.384823256550475
STAT,1941,39,25-29,1980,1.2035249063611189
STAT,1951,25,25-29,1976,90.92271679767629
STAT,1979,6,na,1985,6246.563895551779
SIM,1925,37,40-44,1962,7
STAT,1916,41,45-49,1957,0.19713026642079767
STAT,1930,21,25-29,1951,136.99013691568572
SIM,1862,38,45-49,1900,6
SIM,1926,25,40-44,1951,17
SIM,1925,8,na,1933,5616
STAT,1973,39,50-100,2012,0.6442320110944079
STAT,1890,38,50-100,1928,1.7226777979509822
SIM,1974,11,na,1985,6402
STAT,1942,40,20-24,1982,0.022199676462910017
SIM,1890,3,na,1893,3854
STAT,1849,9,na,1858,2324.3663314346995
STAT,1903,18,35-39,1921,0.8995924573800874
SIM,1876,20,35-39,1896,21
STAT,1926,23,25-29,1949,129.07792665662427
STAT,1897,31,30-34,1928,27.052785237904242
STAT,1902,91,na,1993,479.49387975924026
STAT,1922,16,50-100,1938,0.5013984130673418
SIM,1946,33,45-49,1979,1
SIM,1947,38,30-34,1985,1
STAT,1884,15,45-49,1899,0.07482814566183238
SIM,1968,31,30-34,1999,13
STAT,1831,30,na,1861,2248.453023584652
STAT,1865,38,20-24,1903,0.7986699345901828
STAT,1868,20,35-39,1888,6.56411365453905
SIM,1944,17,35-39,1961,1
STAT,1882,24,50-100,1906,0.45678986779759767
STAT,1852,20,45-49,1872,0.7923501840253513
STAT,1958,18,25-29,1976,65.66370880360526
SIM,1966,18,25-29,1984,77
SIM,1966,2,na,1968,5957
SIM,1777,85,na,1862,195
SIM,1829,37,35-39,1866,4
STAT,1835,44,na,1879,1530.2936363920167
STAT,1788,81,na,1869,307.7663328974671
STAT,1943,27,40-44,1970,5.72931394428018
SIM,1936,47,45-49,1983,1
STAT,1961,41,na,2002,5763.02651413473
SIM,1873,38,20-24,1911,3
STAT,1852,38,35-39,1890,6.63536987796885
SIM,1839,23,35-39,1862,10
SIM,1860,38,35-39,1898,10
SIM,1791,78,na,1869,416
SIM,1934,23,25-29,1957,287
SIM,1940,31,na,1971,4966
STAT,1951,34,15-19,1985,0.17977624050352353
STAT,1939,38,30-34,1977,2.167768511920044
STAT,1931,17,20-24,1948,204.83612197131941
SIM,1823,63,na,1886,1405
STAT,1927,32,30-34,1959,22.361315754964036
STAT,1762,100,na,1862,0.276160227602159
STAT,1867,28,15-19,1895,0.487138452016334
STAT,1961,20,15-19,1981,7.968594526742878
STAT,1823,39,50-100,1862,1.3527735813032171
STAT,1897,49,20-24,1946,0.010227378729556121
SIM,1944,45,na,1989,4550
SIM,1958,36,40-44,1994,1
STAT,1917,46,30-34,1963,0.10772706420094631
STAT,1964,39,15-19,2003,0.028695466638196082
SIM,1949,12,na,1961,5902
STAT,1904,31,25-29,1935,17.043607982379964
SIM,1957,33,20-24,1990,1
STAT,1931,75,na,2006,3759.7153743877057
STAT,1973,26,15-19,1999,1.0586969931514194
STAT,1936,17,35-39,1953,4.63899204481292
STAT,1953,41,35-39,1994,0.2925698185934216
STAT,1870,21,na,1891,2698.896682849946
STAT,1781,109,na,1890,0.0024420695370284693
STAT,1840,55,na,1895,1658.7229736279276
SIM,1979,30,25-29,2009,20
STAT,1870,39,40-44,1909,4.93026541196946
STAT,1942,31,45-49,1973,1.9358911549943043
SIM,1899,20,na,1919,4450
STAT,1871,17,25-29,1888,6.548139254206121
STAT,1903,65,na,1968,3121.4217392865517
STAT,1907,79,na,1986,2051.4728989619866
STAT,1928,44,40-44,1972,0.36675147852311313
STAT,1933,49,50-100,1982,0.3570023604879582
SIM,1912,31,25-29,1943,1
STAT,1925,19,25-29,1944,60.06958036138407
SIM,1933,19,25-29,1952,131
SIM,1865,40,na,1905,2841
STAT,1820,52,25-29,1872,0.0034782458694041472
SIM,1869,54,na,1923,1663
STAT,1848,33,50-100,1881,1.0224656361380204
STAT,1770,86,na,1856,31.438391520000007
SIM,1939,16,15-19,1955,54
SIM,1941,49,50-100,1990,1
SIM,1889,38,45-49,1927,4
STAT,1880,53,35-39,1933,0.010361870416173367
STAT,1848,8,na,1856,3234.481884653399
STAT,1872,30,15-19,1902,0.16634879961879454
SIM,1828,47,50-100,1875,1
STAT,1940,27,15-19,1967,0.8310412060643646
STAT,1880,28,45-49,1908,1.3533878115629483
STAT,1986,16,50-100,2002,0.6162538236635309
STAT,1918,27,50-100,1945,1.2221891826163698
SIM,1865,44,50-100,1909,3
SIM,1920,54,na,1974,4003
STAT,1938,33,45-49,1971,1.8257365268013288
STAT,1953,22,30-34,1975,40.25695942456489
SIM,1961,22,30-34,1983,59
STAT,1957,39,15-19,1996,0.03003887034706276
STAT,1952,12,na,1964,5432.510585410345
STAT,1956,26,na,1982,5747.964793212303
STAT,1821,107,na,1928,0.002884238113060358
SIM,1860,20,45-49,1880,1
STAT,1886,49,50-100,1935,0.29272931817208786
STAT,1896,27,30-34,1923,38.38441976448047
STAT,1851,16,45-49,1867,0.06335296372469118
STAT,1857,44,50-100,1901,0.9367330912134213
SIM,1926,27,50-100,1953,2
STAT,1883,17,na,1900,2851.6423986067216
STAT,1905,15,40-44,1920,0.3069264914743148
STAT,1948,48,25-29,1996,0.07266579523812251
SIM,1978,26,25-29,2004,210
STAT,1883,21,50-100,1904,0.46182309246066316
STAT,1849,30,50-100,1879,0.8395902517466391
STAT,1840,28,15-19,1868,0.4505477437424136
SIM,1803,75,na,1878,708
STAT,1847,24,30-34,1871,16.561490314981647
STAT,1931,30,30-34,1961,23.856794950801426
STAT,1954,34,40-44,1988,5.68355927953822
STAT,1805,78,na,1883,392.2204395844141
STAT,1905,27,20-24,1932,19.595304967835784
STAT,1967,48,30-34,2015,0.13329782340847365
SIM,1857,30,50-100,1887,1
SIM,1889,30,35-39,1919,3
STAT,1985,7,na,1992,6451.682532761392
STAT,1945,67,na,2012,4047.7483110727826
STAT,1895,15,20-24,1910,26.755392169164974
SIM,1921,28,na,1949,4797
SIM,1906,17,15-19,1923,7
STAT,1914,37,15-19,1951,0.022137569891631095
SIM,1834,30,45-49,1864,6
STAT,1801,64,na,1865,955.4057652976124
SIM,1879,41,30-34,1920,2
STAT,1849,40,40-44,1889,1.7738110464711934
SIM,1855,24,30-34,1879,52
SIM,1962,34,40-44,1996,18
SIM,1898,21,25-29,1919,198
SIM,1807,89,na,1896,72
SIM,1878,37,30-34,1915,9
STAT,1925,44,15-19,1969,0.0021378229101229294
STAT,1871,43,40-44,1914,2.563797830265122
SIM,1866,25,45-49,1891,2
STAT,1891,90,na,1981,457.2916633317484
STAT,1915,49,25-29,1964,0.06133529192375502
STAT,1966,36,20-24,2002,0.3918229352379877
SIM,1971,19,45-49,1990,4
STAT,1887,53,na,1940,2740.104411160571
SIM,1857,40,40-44,1897,3
STAT,1964,23,45-49,1987,1.640322589656027
STAT,1840,15,30-34,1855,1.675119463616625
STAT,1826,30,45-49,1856,1.8548390147029779
SIM,1950,31,45-49,1981,3
SIM,1870,30,50-100,1900,1
SIM,1888,26,35-39,1914,33
STAT,1963,19,45-49,1982,0.7319170995392177
SIM,1972,23,45-49,1995,2
SIM,1907,29,25-29,1936,80
STAT,1833,33,40-44,1866,3.9235170242667543
SIM,1887,6,na,1893,3987
STAT,1821,95,na,1916,8.131440713859337
STAT,1859,34,15-19,1893,0.12979519470567782
SIM,1838,42,50-100,1880,4
SIM,1882,42,na,1924,3195
SIM,1914,15,na,1929,4203
SIM,1799,74,na,1873,255
SIM,1924,47,na,1971,4874
SIM,1851,37,30-34,1888,8
STAT,1808,49,30-34,1857,0.46749742509946657
STAT,1982,22,30-34,2004,46.82781024788585
STAT,1879,38,35-39,1917,8.480729808484861
STAT,1901,22,45-49,1923,1.1272082853968879
STAT,1920,31,50-100,1951,1.0489529070492198
SIM,1837,44,30-34,1881,3
STAT,1817,52,50-100,1869,0.041491071566333144
STAT,1935,64,na,1999,5303.540541002909
STAT,1898,43,40-44,1941,0.24185341420555345
SIM,1988,6,na,1994,6634
SIM,1963,34,35-39,1997,4
STAT,1819,37,25-29,1856,8.510507219772425
STAT,1894,27,20-24,1921,17.40406790794658
STAT,1960,16,15-19,1976,68.23375844930553
SIM,1862,25,25-29,1887,51
STAT,1854,25,25-29,1879,40.277731263726274
SIM,1856,36,na,1892,2121
STAT,1946,26,50-100,1972,1.2801161708213828
STAT,1906,31,35-39,1937,9.825821402413968
SIM,1853,27,25-29,1880,64
STAT,1915,12,na,1927,4771.00091448779
STAT,1813,41,15-19,1854,0.0539650128940929
STAT,1857,33,na,1890,2135.7906201174574
SIM,1857,53,na,1910,2211
SIM,1975,33,45-49,2008,2
SIM,1942,68,na,2010,3897
STAT,1970,23,20-24,1993,161.1128940905874
SIM,1844,21,15-19,1865,5
STAT,2009,4,na,2013,7137.399571580935
SIM,1838,23,40-44,1861,2
STAT,1910,20,45-49,1930,1.2279610830460967
SIM,1990,22,30-34,2012,63
STAT,1843,37,30-34,1880,6.2428458295387115
STAT,1977,37,35-39,2014,3.8856199759832917
STAT,1964,32,35-39,1996,13.53947289497337
SIM,1920,22,20-24,1942,261
SIM,1954,36,35-39,1990,7
SIM,1841,33,40-44,1874,2
STAT,1858,50,na,1908,1966.3233072268017
STAT,1921,20,20-24,1941,145.75074737763813
STAT,1828,48,45-49,1876,0.21448360434991243
STAT,1849,43,45-49,1892,1.151618670257914
STAT,1842,31,40-44,1873,4.073515120397348
SIM,1939,70,na,2009,3726
STAT,1981,29,na,2010,6065.337760744388
STAT,1868,37,20-24,1905,0.8546922902532857
STAT,1967,33,45-49,2000,2.310815211321945
SIM,1969,22,35-39,1991,1
STAT,1883,27,45-49,1910,1.2536346901283948
SIM,1844,25,na,1869,2626
SIM,1842,39,30-34,1881,8
SIM,1899,17,20-24,1916,34
STAT,1955,34,35-39,1989,14.252234480113346
STAT,1857,23,na,1880,2202.645998884145
STAT,1991,17,15-19,2008,75.05867080570559
SIM,1833,41,na,1874,1658
SIM,1847,21,40-44,1868,2
STAT,1912,22,20-24,1934,123.09800921968422
STAT,1895,50,na,1945,3281.041855509351
STAT,1935,68,na,2003,4926.209457456939
STAT,1948,39,na,1987,5108.018967171361
SIM,1966,15,20-24,1981,202
STAT,1864,32,30-34,1896,17.99121873221531
SIM,1882,52,na,1934,2972
STAT,1870,103,na,1973,2.114461493428718
SIM,1891,27,45-49,1918,1
SIM,1874,29,25-29,1903,109
STAT,1828,35,25-29,1863,3.095788637449299
SIM,1949,23,20-24,1972,263
STAT,1874,48,15-19,1922,4.6664053186721514E-4
STAT,1834,39,30-34,1873,5.925459955712268
SIM,1996,15,na,2011,6928
STAT,1932,21,35-39,1953,14.30421501532149
SIM,1871,23,25-29,1894,58
SIM,1952,33,20-24,1985,8
STAT,1841,49,15-19,1890,3.4821035846317576E-4
STAT,1984,31,50-100,2015,1.3821555501953726
STAT,1880,50,30-34,1930,0.007386040844296294
STAT,1929,44,35-39,1973,0.2999609949619569
STAT,1820,78,na,1898,458.5639214883274
SIM,1940,21,35-39,1961,16
STAT,1833,104,na,1937,0.046935064625468426
SIM,1961,7,na,1968,5673
SIM,1945,30,25-29,1975,20
STAT,1839,21,40-44,1860,2.13870483575819
STAT,1845,27,25-29,1872,34.695695394081426
STAT,1889,15,45-49,1904,0.09335753488550318
STAT,1839,48,20-24,1887,0.009572749965392414
STAT,1978,5,na,1983,6192.467959390177
STAT,1893,18,15-19,1911,8.634158316556677
STAT,1959,27,30-34,1986,59.40475408856804
STAT,1947,15,45-49,1962,0.6497265861143082
STAT,1896,22,25-29,1918,87.25869012709495
STAT,1863,23,25-29,1886,58.49533105625209
SIM,1835,23,15-19,1858,5
STAT,1878,92,na,1970,190.89226641916926
STAT,1931,27,50-100,1958,1.4833218273265865
STAT,1944,33,20-24,1977,3.086031124434937
STAT,1838,39,15-19,1877,0.05749810806861407
STAT,1958,15,20-24,1973,205.60561529154862
STAT,1995,3,na,1998,6571.436007620332
SIM,1905,33,35-39,1938,5
STAT,1897,34,35-39,1931,15.493622340839385
STAT,1923,53,na,1976,4852.457390945689
SIM,1967,27,30-34,1994,72
SIM,1904,5,na,1909,4461
STAT,1933,33,45-49,1966,2.4468327847984987
SIM,1865,94,na,1959,42
SIM,1867,85,na,1952,324
SIM,1869,34,25-29,1903,15
STAT,1810,46,na,1856,1689.175433396949
SIM,1819,36,na,1855,1405
SIM,1940,29,30-34,1969,98
SIM,1904,29,20-24,1933,21
SIM,1869,22,30-34,1891,1
STAT,1817,47,30-34,1864,0.276349226777534
STAT,1932,29,30-34,1961,59.18270159960709
SIM,1829,68,na,1897,858
STAT,1846,39,35-39,1885,7.478697928147243
STAT,1831,50,35-39,1881,0.0073012489548794305
STAT,1925,44,na,1969,5170.149937806665
STAT,1878,17,35-39,1895,0.6611701325832251
STAT,1940,11,na,1951,4632.151387172286
STAT,1863,36,50-100,1899,1.2448907249757664
SIM,2000,9,na,2009,6484
STAT,1829,44,30-34,1873,1.188296347971472
SIM,1932,38,50-100,1970,2
SIM,1887,38,35-39,1925,17
SIM,1813,48,50-100,1861,2
STAT,1997,16,40-44,2013,2.357749858082931
STAT,1847,15,40-44,1862,0.1777394375732359
STAT,1923,23,35-39,1946,12.59981298646212
SIM,1875,72,na,1947,1644
STAT,1856,47,50-100,1903,0.21523022823542023
SIM,1880,26,30-34,1906,5
SIM,1865,37,45-49,1902,4
SIM,1840,21,30-34,1861,51
STAT,1876,39,35-39,1915,8.352922583022927
STAT,1985,19,40-44,2004,2.294298021181824
SIM,1845,30,20-24,1875,7
SIM,1971,16,40-44,1987,2
STAT,1939,21,45-49,1960,1.3050318607817817
STAT,1870,26,20-24,1896,13.392959813179848
STAT,1907,40,40-44,1947,0.26789012191372086
STAT,1963,20,25-29,1983,135.96979580604008
SIM,1961,31,20-24,1992,2
STAT,1918,43,20-24,1961,0.021630481940730827
STAT,1844,49,40-44,1893,0.1402057387208577
STAT,1932,14,na,1946,6036.739562897445
STAT,1927,41,20-24,1968,0.025591870047612257
SIM,1907,45,na,1952,4389
SIM,1922,66,na,1988,4050
STAT,1968,25,30-34,1993,56.77179502765551
STAT,1972,26,35-39,1998,22.290049142997574
SIM,1844,35,na,1879,2432
SIM,1993,19,40-44,2012,6
STAT,1927,13,na,1940,5675.476983990205
SIM,1884,39,35-39,1923,2
STAT,1963,16,40-44,1979,2.051316513242426
SIM,1931,17,na,1948,6308
SIM,1941,30,40-44,1971,10
SIM,1936,32,25-29,1968,23
STAT,1951,52,na,2003,5163.012219641283
SIM,1902,14,na,1916,4300
STAT,1841,22,35-39,1863,6.572502351073061
STAT,1866,35,45-49,1901,2.1526079658131003
STAT,1908,36,15-19,1944,0.020875583043503752
SIM,1947,21,45-49,1968,3
STAT,1938,42,35-39,1980,0.23834659225084692
SIM,1898,67,na,1965,3022
STAT,1880,15,25-29,1895,6.963981958957394
STAT,1885,8,na,1893,2992.361747318467
STAT,1892,25,45-49,1917,1.6168760609716153
SIM,1849,56,na,1905,2317
STAT,1997,12,na,2009,6619.643744008637
STAT,1930,21,50-100,1951,0.9758523381214937
STAT,1937,30,25-29,1967,10.570513678979854
STAT,1928,32,25-29,1960,13.336966312158797
SIM,1907,35,na,1942,4557
STAT,1920,42,35-39,1962,0.25654617280187175
SIM,1959,11,na,1970,6028
STAT,1886,33,20-24,1919,3.2765777864195935
SIM,1856,31,35-39,1887,15
STAT,1889,45,40-44,1934,0.2459718864566867
STAT,1909,15,25-29,1924,9.863901461582637
STAT,1922,19,20-24,1941,180.02424388756393
SIM,1826,38,35-39,1864,17
STAT,1968,39,35-39,2007,3.584222634415029
SIM,1831,23,30-34,1854,16
STAT,1902,22,50-100,1924,0.6649544643391622
SIM,1871,20,20-24,1891,60
STAT,1989,22,40-44,2011,5.576304943951808
SIM,1802,79,na,1881,254
SIM,1831,60,na,1891,1243
SIM,1902,21,15-19,1923,12
STAT,1870,48,30-34,1918,0.10874789280812827
SIM,1879,44,35-39,1923,3
SIM,1896,33,30-34,1929,32
STAT,1983,28,20-24,2011,29.91482860986828
SIM,1887,83,na,1970,1413
STAT,1839,54,40-44,1893,0.008119359513579807
STAT,1866,18,50-100,1884,0.05347239540522269
SIM,1828,49,35-39,1877,1
SIM,1936,20,30-34,1956,84
STAT,1978,33,20-24,2011,3.9134118907012096
STAT,1896,18,40-44,1914,0.27806614248504424
STAT,1803,76,na,1879,394.54754211102414
STAT,1837,30,20-24,1867,2.5056180198873643
STAT,1852,40,50-100,1892,1.0060874033104021
STAT,1934,26,15-19,1960,1.0970113593933797
STAT,1899,49,30-34,1948,0.0845290643303453
SIM,1931,23,35-39,1954,34
STAT,1855,37,35-39,1892,6.01831735054618
SIM,1906,33,50-100,1939,3
SIM,1942,58,na,2000,4620
STAT,1864,29,15-19,1893,0.46417255089186454
STAT,1885,72,na,1957,1525.9416403857638
STAT,1955,56,na,2011,5636.1286255293535
STAT,1818,38,35-39,1856,10.964395691870976
SIM,1878,32,25-29,1910,4
STAT,1891,28,20-24,1919,16.673882856715036
SIM,1827,37,25-29,1864,1
SIM,1830,76,na,1906,607
STAT,1943,44,50-100,1987,0.148927892804547
STAT,1953,31,20-24,1984,3.4730212355305725
SIM,1930,19,20-24,1949,439
SIM,1971,20,25-29,1991,13
SIM,1929,22,40-44,1951,7
SIM,1836,38,na,1874,1703
STAT,1838,42,30-34,1880,1.1648470224266096
SIM,1975,30,40-44,2005,10
STAT,1854,38,45-49,1892,1.616032130792635
STAT,1881,24,30-34,1905,19.703247936574762
STAT,1928,20,30-34,1948,41.65914381617519
STAT,1849,36,na,1885,1888.028263177463
STAT,1970,26,25-29,1996,95.53993095038739
STAT,1798,80,na,1878,234.53286311674455
SIM,1957,32,50-100,1989,1
STAT,1994,16,15-19,2010,75.59999806001764
SIM,1942,26,15-19,1968,3
STAT,1895,43,15-19,1938,0.0014301700123376456
SIM,1975,16,25-29,1991,73
STAT,1878,39,45-49,1917,2.3778871943963504
STAT,1898,46,45-49,1944,0.20821984510156188
STAT,1926,32,15-19,1958,0.17928402998895596
SIM,1832,29,20-24,1861,27
SIM,1916,39,40-44,1955,2
STAT,1976,28,na,2004,5797.999486406552
STAT,1888,70,na,1958,2006.0381158715343
STAT,1893,28,30-34,1921,36.604002768951354
SIM,1887,35,30-34,1922,16
SIM,1859,28,50-100,1887,1
STAT,1954,43,30-34,1997,0.18924982739201218
SIM,1820,43,50-100,1863,4
STAT,1830,56,na,1886,1295.0397155475616
STAT,1899,39,15-19,1938,0.018970444657717717
STAT,1931,40,45-49,1971,0.25735649496331736
SIM,1959,33,30-34,1992,49
SIM,1853,15,30-34,1868,4
STAT,1881,49,45-49,1930,0.2572135244466177
STAT,1834,24,45-49,1858,0.8389057725983099
STAT,1945,24,25-29,1969,116.75168243616741
STAT,1966,48,15-19,2014,5.507626795756033E-4
SIM,1842,24,45-49,1866,1
SIM,1861,37,na,1898,1859
STAT,1879,35,30-34,1914,6.483234660831273
SIM,1838,35,35-39,1873,14
STAT,1816,94,na,1910,9.870121215368897
STAT,1845,15,30-34,1860,1.3736223057273587
SIM,1849,26,20-24,1875,27
SIM,1874,42,50-100,1916,1
STAT,1838,45,35-39,1883,0.12802372881310733
STAT,1967,16,25-29,1983,62.488101838599945
STAT,1848,31,35-39,1879,12.679387748523045
SIM,1987,24,25-29,2011,9
SIM,1827,34,20-24,1861,9
STAT,1843,22,45-49,1865,0.8782405834574942
STAT,1866,7,na,1873,2986.2569669865593
STAT,1908,39,40-44,1947,1.6032513380534754
SIM,1872,74,na,1946,1805
SIM,1849,25,50-100,1874,3
STAT,1888,33,30-34,1921,23.585456684786035
STAT,1857,37,45-49,1894,1.791767136570057
SIM,1892,20,na,1912,3552
STAT,1892,49,20-24,1941,0.00958648666270647
SIM,1861,34,20-24,1895,3
SIM,1920,25,25-29,1945,20
STAT,1929,41,30-34,1970,0.1913536584601698
SIM,1869,31,20-24,1900,6
SIM,1976,23,na,1999,5234
STAT,1866,42,50-100,1908,1.1286550284166526
SIM,1893,24,15-19,1917,5
STAT,1872,26,30-34,1898,29.28098194368152
STAT,1863,20,20-24,1883,71.95573581017179
STAT,1853,34,20-24,1887,2.7144344205316187
STAT,1885,24,15-19,1909,3.7737638682366073
STAT,1837,35,na,1872,1927.9096917030313
SIM,1853,24,20-24,1877,5
STAT,1842,34,45-49,1876,1.5877485237465265
SIM,1872,29,15-19,1901,4
STAT,1880,2,na,1882,3925.8708906029897
SIM,1992,19,25-29,2011,178
SIM,1949,26,25-29,1975,42
STAT,1887,45,30-34,1932,0.12644179497254204
SIM,1840,39,20-24,1879,2
STAT,1786,106,na,1892,0.010573234286566353
STAT,1915,76,na,1991,2713.222330270948
STAT,1845,24,20-24,1869,56.82370507184617
STAT,1981,2,na,1983,6350.332028761018
STAT,1933,30,40-44,1963,6.095696849072912
STAT,1832,39,20-24,1871,0.6626626433628069
STAT,1928,17,50-100,1945,0.5447882849848817
STAT,1867,38,30-34,1905,5.714075299136234
STAT,1850,4,na,1854,3353.0
SIM,1983,0,na,1983,7037
SIM,1975,27,25-29,2002,105
STAT,1860,49,50-100,1909,0.2236651427931529
STAT,1868,28,30-34,1896,27.822593695504242
SIM,1824,38,25-29,1862,3
STAT,1854,68,na,1922,1245.0179309538548
STAT,1872,17,40-44,1889,0.21264564541789552
SIM,1963,22,40-44,1985,11
SIM,1898,36,45-49,1934,4
STAT,1878,26,25-29,1904,51.14625243054898
STAT,1955,31,30-34,1986,24.6177815042447
SIM,1926,22,15-19,1948,1
STAT,1882,22,na,1904,2665.9182658045515
STAT,1994,21,50-100,2015,1.0997731286200847
STAT,1907,25,na,1932,4079.747889618609
SIM,1976,36,30-34,2012,1
STAT,1918,22,15-19,1940,6.624194367132605
STAT,1856,16,45-49,1872,0.06840847316571046
SIM,1984,10,na,1994,6303
SIM,1886,39,45-49,1925,1
SIM,1917,5,na,1922,5849
STAT,1923,63,na,1986,4454.276811087771
STAT,1984,19,25-29,2003,70.98153744317345
STAT,1874,21,35-39,1895,6.915126334618424
STAT,1846,36,30-34,1882,5.813648147224821
SIM,1938,20,40-44,1958,13
SIM,1847,24,45-49,1871,1
STAT,1955,22,40-44,1977,5.168196336835657
STAT,1816,38,25-29,1854,10.505385157247801
SIM,1945,26,40-44,1971,11
SIM,1919,38,50-100,1957,1
STAT,1970,37,25-29,2007,1.465417473255772
SIM,1912,46,na,1958,3624
STAT,1993,20,40-44,2013,5.6051438924323715
SIM,1848,42,40-44,1890,1
STAT,1896,39,50-100,1935,1.8525961067837908
SIM,1883,1,na,1884,3101
SIM,1963,31,30-34,1994,3
SIM,1923,6,na,1929,5711
STAT,1839,24,45-49,1863,0.7003862776524692
STAT,1864,35,35-39,1899,7.357449579304186
STAT,1937,26,40-44,1963,5.24866769492018
SIM,1864,25,35-39,1889,16
STAT,1794,98,na,1892,0.8130622190311526
SIM,1825,32,45-49,1857,4
SIM,1961,34,25-29,1995,3
SIM,1854,36,30-34,1890,1
SIM,1896,24,40-44,1920,11
SIM,1979,26,40-44,2005,10
SIM,1927,34,25-29,1961,1
SIM,1890,93,na,1983,39
SIM,1907,33,45-49,1940,6
SIM,1918,24,30-34,1942,85
STAT,1820,36,25-29,1856,7.2966520240406805
STAT,1797,63,na,1860,1054.0806816356426
STAT,1911,19,45-49,1930,0.11484103455643688
STAT,1930,80,na,2010,2840.3636374764524
STAT,1850,19,20-24,1869,22.03995852399209
SIM,1886,26,25-29,1912,49
SIM,1874,55,na,1929,2336
SIM,1880,17,40-44,1897,1
STAT,1865,20,na,1885,2528.738791119212
STAT,1986,22,15-19,2008,8.782331653031255
SIM,1853,37,40-44,1890,9
STAT,1956,21,50-100,1977,1.0084619222028164
STAT,1905,39,15-19,1944,0.02004133180604805
SIM,1885,27,35-39,1912,17
STAT,1828,48,50-100,1876,0.22320836077044467
SIM,1922,22,30-34,1944,91
STAT,1810,47,20-24,1857,0.04669768863078476
STAT,1870,29,25-29,1899,47.78337450851713
STAT,1910,92,na,2002,439.4791820748475
SIM,1830,27,45-49,1857,2
STAT,1888,24,40-44,1912,2.8091456137518627
SIM,1850,28,25-29,1878,48
SIM,1862,25,50-100,1887,2
SIM,1815,43,40-44,1858,5
STAT,1873,26,50-100,1899,0.7564580751665541
STAT,1914,16,45-49,1930,0.11960206665187083
SIM,1836,48,50-100,1884,1
SIM,1915,27,30-34,1942,68
SIM,1947,30,35-39,1977,31
STAT,1907,43,45-49,1950,0.17519532858617098
SIM,1874,32,40-44,1906,8
STAT,1922,32,30-34,1954,20.534686847804434
STAT,1934,29,40-44,1963,7.232575366694179
STAT,1968,36,30-34,2004,2.70900543483617
STAT,1842,28,25-29,1870,39.966394943515176
STAT,1835,54,na,1889,1314.4516182973282
SIM,1903,30,20-24,1933,2
SIM,1930,32,30-34,1962,62
STAT,1927,44,25-29,1971,0.10298735038362167
SIM,1836,23,30-34,1859,43
STAT,1867,16,20-24,1883,19.643971546961282
SIM,1875,16,20-24,1891,24
SIM,1885,49,na,1934,2948
STAT,1843,27,15-19,1870,0.5602497954391282
SIM,1902,68,na,1970,2913
STAT,1968,28,35-39,1996,21.723849796824034
SIM,1831,26,35-39,1857,10
SIM,1875,38,30-34,1913,20
STAT,1919,34,25-29,1953,11.406621586823974
STAT,1946,36,35-39,1982,3.1925110885282684
STAT,1874,19,50-100,1893,0.05757091408240962
SIM,1837,23,25-29,1860,73
STAT,1979,24,25-29,2003,147.15822883898224
SIM,1820,38,40-44,1858,13
SIM,1929,25,45-49,1954,6
STAT,1892,22,40-44,1914,3.014092657260359
STAT,1952,22,15-19,1974,7.386131314868231
STAT,1899,108,na,2007,0.2787072933715582
STAT,1941,74,na,2015,3136.121567859754
SIM,1942,33,50-100,1975,2
STAT,1876,48,25-29,1924,0.06785216771978254
STAT,1885,43,50-100,1928,1.2073067772107304
STAT,1805,57,na,1862,1289.9656980306893
STAT,1819,47,40-44,1866,0.32963506130951664
STAT,1890,19,15-19,1909,8.3235517530819
STAT,1928,23,35-39,1951,13.525076941358853
STAT,1877,21,na,1898,2847.6821163325076
STAT,1945,42,na,1987,4865.691458573177
SIM,1862,54,na,1916,2655
SIM,1953,24,25-29,1977,160
STAT,1959,31,15-19,1990,0.19785082269082163
STAT,1962,39,40-44,2001,2.2756615922743673
STAT,1900,18,30-34,1918,2.5456646996942482
SIM,1942,29,40-44,1971,13
STAT,1813,44,na,1857,1438.9906687970215
SIM,1803,96,na,1899,4
STAT,1917,21,50-100,1938,0.8095137606632089
STAT,1836,21,15-19,1857,3.9924372185589023
STAT,1903,15,30-34,1918,2.632139004065931
SIM,1826,35,30-34,1861,5
STAT,1912,25,25-29,1937,75.43511166175257
SIM,1874,26,20-24,1900,30
STAT,1827,44,20-24,1871,0.20414496630058024
STAT,1824,60,na,1884,1268.4047036485326
SIM,1919,36,40-44,1955,3
STAT,1821,48,35-39,1869,0.24985336924205614
STAT,1953,34,25-29,1987,13.135601547201418
SIM,1958,21,20-24,1979,320
SIM,1965,27,20-24,1992,3
SIM,1806,61,na,1867,1097
SIM,1970,39,40-44,2009,4
SIM,1877,20,15-19,1897,5
SIM,1943,50,na,1993,5263
SIM,1926,28,45-49,1954,5
SIM,1863,39,na,1902,2324
STAT,1841,93,na,1934,25.984009741030842
SIM,1960,22,15-19,1982,9
SIM,1914,31,35-39,1945,11
SIM,1932,34,na,1966,5523
SIM,1936,23,35-39,1959,12
STAT,1848,72,na,1920,1341.860827427761
STAT,1800,109,na,1909,3.838942792460911E-4
SIM,1845,33,25-29,1878,19
STAT,1972,28,45-49,2000,2.56253327486966
SIM,1974,36,na,2010,6321
SIM,1980,28,45-49,2008,3
STAT,1836,39,na,1875,2343.2871756418726
STAT,1837,33,25-29,1870,9.203245196629032
SIM,1859,15,25-29,1874,9
STAT,1957,27,20-24,1984,27.894614954953937
STAT,1945,21,20-24,1966,140.68818477021028
SIM,1847,30,30-34,1877,6
STAT,1929,72,na,2001,4069.8120760473785
STAT,1976,20,45-49,1996,1.7417267972965282
STAT,1872,8,na,1880,3137.329844926577
SIM,1977,26,30-34,2003,70
STAT,1946,27,45-49,1973,2.2208758676061167
STAT,1869,20,15-19,1889,3.72489282742172
SIM,1868,22,15-19,1890,6
SIM,1941,17,30-34,1958,31
SIM,1916,24,20-24,1940,136
STAT,1863,19,na,1882,2615.3867675489328
SIM,1817,37,30-34,1854,7
SIM,1870,29,40-44,1899,12
STAT,1933,17,30-34,1950,18.83831416734704
STAT,1795,94,na,1889,3.8056749003364962
SIM,1863,37,35-39,1900,3
STAT,1851,61,na,1912,1481.8183453726353
STAT,1862,29,40-44,1891,2.8966250192791443
STAT,1955,10,na,1965,6019.597195824646
SIM,1837,36,45-49,1873,3
SIM,1897,51,na,1948,3328
STAT,1844,39,25-29,1883,2.4925277597052453
SIM,1801,84,na,1885,165
SIM,1973,20,35-39,1993,15
STAT,1842,24,na,1866,2045.5688353357548
SIM,1954,13,na,1967,5539
SIM,1828,37,40-44,1865,1
STAT,1999,16,15-19,2015,77.39550959438888
STAT,1830,24,25-29,1854,98.56018733413235
SIM,1975,22,45-49,1997,3
STAT,1829,35,40-44,1864,5.226250637238753
STAT,1853,37,25-29,1890,2.8665833859174765
STAT,1859,89,na,1948,96.57619761821411
SIM,1956,25,na,1981,5465
STAT,1834,21,40-44,1855,2.561689013404302
SIM,1842,18,25-29,1860,17
SIM,1852,25,30-34,1877,3
SIM,1892,19,na,1911,3981
STAT,1812,47,30-34,1859,0.22443516733314897
SIM,1827,87,na,1914,64
STAT,1965,5,na,1970,5664.784074047857
SIM,1906,29,30-34,1935,46
STAT,1837,42,15-19,1879,0.011800143216538493
STAT,1875,53,50-100,1928,0.017722276383497
SIM,1863,25,40-44,1888,7
SIM,1959,36,35-39,1995,6
STAT,1894,19,35-39,1913,0.8096660410388504
SIM,1937,28,20-24,1965,2
STAT,1849,48,15-19,1897,3.061315266465003E-4
SIM,1929,14,na,1943,5449
STAT,1871,27,40-44,1898,3.439285891475077
SIM,1938,32,35-39,1970,24
STAT,1829,36,45-49,1865,2.334369919631032
STAT,1899,27,20-24,1926,18.548250786968612
STAT,1965,20,35-39,1985,13.620301111857598
STAT,1872,48,40-44,1920,0.19589419883120907
SIM,1820,44,na,1864,1903
STAT,1855,25,40-44,1880,2.961958675719456
STAT,1859,99,na,1958,2.801537330389956
STAT,1898,49,15-19,1947,3.445678130516662E-4
STAT,1989,25,45-49,2014,2.870562042760376
SIM,1952,18,45-49,1970,5
STAT,1973,31,na,2004,5757.3043157670245
STAT,1961,16,30-34,1977,18.178601037359442
STAT,1847,49,50-100,1896,0.18503227227972094
STAT,1956,22,35-39,1978,14.426326158481968
STAT,1885,19,na,1904,2891.6576271660015
SIM,1930,35,35-39,1965,10
STAT,1907,15,15-19,1922,10.123534898720898
SIM,1831,48,45-49,1879,1
STAT,1924,19,30-34,1943,16.656394943235654
STAT,1844,25,30-34,1869,26.158602432689417
SIM,1963,25,45-49,1988,4
STAT,1854,16,35-39,1870,0.537924923913955
SIM,1859,36,30-34,1895,1
STAT,1887,15,35-39,1902,0.7129553378647977
STAT,1827,57,na,1884,1719.7795484703715
STAT,1931,29,15-19,1960,1.0510063901816853
STAT,1880,41,na,1921,2839.996212371717
STAT,1892,16,20-24,1908,25.70613662195652
STAT,1902,18,40-44,1920,0.2974654438345539
STAT,1944,18,45-49,1962,0.620224540355414
STAT,1863,23,50-100,1886,0.4166928135531947
SIM,1828,38,45-49,1866,2
STAT,1985,28,30-34,2013,64.56083344638228
SIM,1894,36,25-29,1930,9
SIM,1927,25,35-39,1952,2
SIM,1898,33,40-44,1931,7
STAT,1915,100,na,2015,40.41770788205661
SIM,1837,35,40-44,1872,10
SIM,1890,37,50-100,1927,2
STAT,1818,49,25-29,1867,0.06908917094843026
STAT,1967,22,45-49,1989,1.6273720537923801
STAT,1890,73,na,1963,1958.2766359097247
SIM,1861,37,25-29,1898,1
STAT,1919,31,20-24,1950,3.0486500263191934
SIM,1969,30,20-24,1999,8
SIM,1891,88,na,1979,431
STAT,1848,111,na,1959,1.7193816598967817E-4
STAT,1960,19,40-44,1979,2.10096958597467
STAT,1804,107,na,1911,0.002050491939111004
SIM,1887,29,45-49,1916,1
STAT,1816,47,15-19,1863,8.157642973111968E-4
SIM,1902,78,na,1980,1966
STAT,1908,24,20-24,1932,117.38283355765246
STAT,1879,29,45-49,1908,1.3283737442001207
SIM,1987,21,20-24,2008,173
STAT,1886,36,25-29,1922,3.521747994146839
STAT,1910,45,na,1955,3978.402928540381
STAT,1939,30,35-39,1969,10.776998336613977
STAT,1892,85,na,1977,945.5151612347463
STAT,1979,21,20-24,2000,177.328700172479
STAT,1976,36,15-19,2012,0.030531063535862234
STAT,1972,23,30-34,1995,42.59453624134091
SIM,1812,47,na,1859,1565
STAT,1866,29,25-29,1895,44.9248194314141
STAT,1922,35,35-39,1957,3.1803124224488166
STAT,1957,2,na,1959,5987.708663919782
STAT,1833,39,15-19,1872,0.04875121016515799
STAT,1879,107,na,1986,0.31919038304121716
SIM,1932,19,30-34,1951,51
STAT,1839,30,30-34,1869,17.397193330783583
STAT,1965,16,15-19,1981,65.40477139441757
SIM,1992,16,20-24,2008,241
SIM,1863,26,45-49,1889,1
SIM,1927,31,20-24,1958,3
STAT,1967,46,na,2013,5522.356058978314
SIM,1897,24,35-39,1921,1
SIM,1905,24,45-49,1929,6
STAT,1845,37,40-44,1882,3.099329701063633
STAT,1802,81,na,1883,288.20116624754576
STAT,1877,27,35-39,1904,11.58300716654666
STAT,1823,48,45-49,1871,0.2299383892392471
STAT,1955,25,45-49,1980,2.6604764953080133
STAT,1843,15,20-24,1858,23.002614734428306
STAT,1894,18,30-34,1912,2.3583726387596933
SIM,1865,34,40-44,1899,8
STAT,1863,93,na,1956,33.68107718118284
STAT,1838,21,25-29,1859,64.81118762653014
SIM,1973,16,15-19,1989,115
STAT,1966,25,20-24,1991,26.448400330153387
STAT,1996,16,na,2012,6175.002318307772
STAT,1889,24,35-39,1913,8.249406569791503
SIM,1850,64,na,1914,1039
SIM,1846,21,25-29,1867,1
SIM,1870,19,na,1889,3325
STAT,1827,67,na,1894,1287.3877255865036
STAT,1863,32,15-19,1895,0.14370503077225585
SIM,1858,27,25-29,1885,79
STAT,1972,17,45-49,1989,0.738125203036195
SIM,1920,2,na,1922,4743
SIM,1852,76,na,1928,394
STAT,1841,48,50-100,1889,0.21655812462469293
STAT,1887,48,35-39,1935,0.17879013134519015
STAT,1857,34,40-44,1891,3.8645149414560764
STAT,1909,36,30-34,1945,2.0026988625738653
SIM,1937,20,25-29,1957,207
STAT,1955,18,20-24,1973,207.63685951479604
STAT,1885,29,na,1914,2727.514613878385
STAT,1828,26,35-39,1854,24.552076922575864
SIM,1937,11,na,1948,4482
SIM,1952,32,na,1984,4656
SIM,1839,44,40-44,1883,2
STAT,1870,31,50-100,1901,1.0466947750944868
STAT,1870,15,30-34,1885,1.8524153115567186
SIM,1958,24,25-29,1982,167
SIM,1896,27,45-49,1923,5
STAT,1855,26,45-49,1881,0.9918679877035471
STAT,1888,30,50-100,1918,1.252946495243637
SIM,1859,37,35-39,1896,6
SIM,1965,34,45-49,1999,2
STAT,1817,37,15-19,1854,0.25267828322293945
SIM,1895,21,20-24,1916,4
STAT,1879,7,na,1886,3216.6882256049767
SIM,1879,22,na,1901,3000
STAT,1877,38,25-29,1915,3.4391743000103383
STAT,1856,22,30-34,1878,18.21411904008561
SIM,1876,28,30-34,1904,67
SIM,1885,38,25-29,1923,8
SIM,1968,21,15-19,1989,5
STAT,1957,34,45-49,1991,2.437419047353142
STAT,1861,38,na,1899,2249.130220210074
SIM,1864,22,30-34,1886,41
STAT,1881,15,40-44,1896,0.20454064777071068
STAT,1888,27,45-49,1915,1.506209011620798
STAT,1865,20,30-34,1885,19.045110190962227
STAT,1979,27,50-100,2006,1.5884286975022324
STAT,1919,25,35-39,1944,18.843531340800784
STAT,1902,48,na,1950,3623.230165381844
SIM,1928,37,45-49,1965,1
STAT,1943,31,50-100,1974,1.0320664681860534
SIM,1963,18,20-24,1981,392
STAT,1929,20,25-29,1949,135.6133466750694
STAT,1972,37,35-39,2009,3.682059196028725
SIM,1836,26,35-39,1862,19
STAT,1969,23,na,1992,5280.188053286095
STAT,1995,16,30-34,2011,20.367532545574125
SIM,1941,73,na,2014,2785
SIM,1849,33,45-49,1882,5
SIM,1805,77,na,1882,358
STAT,1898,18,15-19,1916,9.231751365224914
STAT,1966,32,45-49,1998,2.3120208269227147
STAT,1962,28,40-44,1990,6.918650587042926
SIM,1929,2,na,1931,5671
STAT,1835,27,30-34,1862,20.532982037891557
SIM,1970,28,40-44,1998,4
STAT,1924,48,na,1972,5032.047817924578
SIM,1849,48,30-34,1897,1
STAT,1995,17,35-39,2012,7.009810076300905
SIM,1886,17,35-39,1903,1
SIM,1859,34,na,1893,2302
STAT,1852,25,15-19,1877,0.5054583412312138
SIM,1900,56,na,1956,3089
SIM,1978,36,40-44,2014,1
STAT,1833,42,na,1875,1792.3666271194402
SIM,1843,27,30-34,1870,5
SIM,1855,41,na,1896,1824
SIM,1918,51,na,1969,3743
STAT,1866,28,20-24,1894,12.504514741670938
STAT,1913,85,na,1998,1362.7491396350101
SIM,1886,23,20-24,1909,139
SIM,1830,38,35-39,1868,6
STAT,1887,21,20-24,1908,89.3951938133497
STAT,1846,27,40-44,1873,3.7463144689822956
STAT,1878,23,20-24,1901,82.77990988341392
STAT,1822,38,35-39,1860,16.365193082973793
STAT,1971,26,40-44,1997,6.845411818958069
SIM,1818,95,na,1913,19
SIM,1954,33,30-34,1987,42
STAT,1826,35,15-19,1861,0.04730090032547054
STAT,1861,17,30-34,1878,1.7576039086997233
STAT,1898,22,35-39,1920,9.10148345996457
STAT,1977,20,na,1997,5716.992363285323
STAT,1836,39,40-44,1875,4.791150168374979
STAT,1907,48,15-19,1955,3.7830542195475836E-4
SIM,1891,18,20-24,1909,21
STAT,1843,49,25-29,1892,0.05658803297804774
STAT,1913,89,na,2002,799.6030218408405
SIM,1918,15,40-44,1933,1
STAT,1881,16,45-49,1897,0.07289096411708287
SIM,1873,20,30-34,1893,30
STAT,1831,106,na,1937,0.009525970132405743
SIM,1889,8,na,1897,4149
STAT,1874,56,na,1930,2409.7199725706587
SIM,1943,26,30-34,1969,73
STAT,1873,71,na,1944,1573.0489786320538
STAT,1967,38,15-19,2005,0.028491428280949246
SIM,1837,20,20-24,1857,138
STAT,1876,17,25-29,1893,6.760287207830991
STAT,1935,26,30-34,1961,61.6999280830125
STAT,1860,38,20-24,1898,0.713417032877545
STAT,1873,100,na,1973,11.852357478564986
STAT,1946,33,30-34,1979,20.54330811772349
STAT,1929,28,20-24,1957,26.353113717710904
STAT,1807,49,15-19,1856,0.0015977426214253694
STAT,1927,20,15-19,1947,7.612242541040586
STAT,1949,45,15-19,1994,5.166879254097497E-4
STAT,1834,31,50-100,1865,1.082230624997471
SIM,1903,33,25-29,1936,21
STAT,1876,21,45-49,1897,0.8344014388844017
STAT,1899,34,45-49,1933,2.733500471907065
SIM,1986,15,50-100,2001,1
STAT,1981,15,45-49,1996,0.8065442106921046
STAT,1936,38,40-44,1974,1.6953113050810114
STAT,1827,47,25-29,1874,0.07295311335389573
SIM,1844,39,40-44,1883,3
SIM,1838,32,30-34,1870,21
STAT,1846,28,45-49,1874,1.3785982399413566
STAT,1901,39,30-34,1940,1.8407937332005475
STAT,1901,53,na,1954,3424.7681637878636
SIM,1954,27,45-49,1981,5
SIM,1953,15,35-39,1968,17
SIM,1985,15,25-29,2000,97
SIM,1907,30,40-44,1937,2
SIM,1899,39,30-34,1938,2
STAT,1883,18,20-24,1901,19.964703120175216
SIM,1953,21,20-24,1974,16
SIM,1887,73,na,1960,2248
STAT,1993,17,25-29,2010,71.95336940314787
STAT,1945,15,35-39,1960,5.292712218868525
SIM,1854,28,45-49,1882,5
STAT,1842,37,15-19,1879,0.05069134965111995
STAT,1900,27,20-24,1927,18.786225966241624
STAT,1812,43,50-100,1855,2.8515103213314847
STAT,1887,33,15-19,1920,0.1834018860117921
STAT,1866,32,40-44,1898,4.638820276268514
STAT,1942,36,15-19,1978,0.023885969639421495
STAT,1822,36,35-39,1858,18.008145326916768
SIM,1870,1,na,1871,4366
SIM,1909,26,na,1935,4927
STAT,1867,47,20-24,1914,0.012869581950636725
SIM,1862,22,20-24,1884,4
STAT,1838,38,50-100,1876,1.270239137814228
STAT,1889,21,30-34,1910,25.41570787855518
SIM,1910,6,na,1916,4065
STAT,1921,23,25-29,1944,119.98513023003028
STAT,1824,104,na,1928,0.04127073038987482
SIM,1983,20,50-100,2003,2
SIM,1847,75,na,1922,1301
SIM,1944,38,40-44,1982,5
STAT,1796,79,na,1875,330.6107164775251
STAT,1941,17,50-100,1958,0.44545986738557647
SIM,1860,42,na,1902,2339
SIM,1954,24,40-44,1978,10
STAT,1959,46,50-100,2005,0.3560275539976294
STAT,1961,39,25-29,2000,1.5092343683468326
SIM,1897,21,30-34,1918,34
STAT,1883,24,40-44,1907,2.33808346906104
STAT,1833,36,45-49,1869,1.786579681062034
SIM,1946,47,na,1993,4564
STAT,1839,33,35-39,1872,9.781305815040295
SIM,1837,47,35-39,1884,1
STAT,1919,1,na,1920,5324.5695748362505
SIM,1852,28,35-39,1880,1
STAT,1878,47,30-34,1925,0.11609591800416696
STAT,1855,28,45-49,1883,0.9776758965753735
STAT,1966,28,25-29,1994,95.2392996951184
SIM,1941,29,25-29,1970,128
STAT,1892,28,15-19,1920,0.6539409295759872
SIM,1858,24,20-24,1882,3
STAT,1844,36,20-24,1880,0.7565283972225572
STAT,1900,67,na,1967,2872.31053199738
STAT,1978,36,25-29,2014,1.5990862626074775
STAT,1818,75,na,1893,455.49700671102715
STAT,1930,33,na,1963,5630.007551828063
STAT,1894,16,30-34,1910,2.3703752257154975
STAT,1829,47,35-39,1876,0.14284165255659997
STAT,1898,47,na,1945,3493.3224862484703
SIM,1841,27,20-24,1868,2
SIM,1917,27,40-44,1944,9
SIM,1951,15,25-29,1966,157
SIM,1913,30,na,1943,4697
STAT,1833,27,20-24,1860,11.052895310782324
STAT,1875,38,15-19,1913,0.06663750347424331
STAT,1993,16,20-24,2009,225.17134124435012
SIM,1809,58,na,1867,1391
STAT,1876,26,15-19,1902,0.543114989200713
STAT,1988,22,25-29,2010,152.96341771480334
STAT,1915,66,na,1981,3660.247936787316
STAT,1905,34,na,1939,3985.39775083103
STAT,1926,29,na,1955,5144.450711467055
SIM,1779,76,na,1855,473
STAT,1854,22,20-24,1876,65.96581784273683
SIM,1876,26,30-34,1902,62
STAT,1976,23,15-19,1999,8.231696612058652
STAT,1818,47,25-29,1865,0.07109256170285065
STAT,1911,28,35-39,1939,16.851800577110236
STAT,1912,16,35-39,1928,0.9825634078942463
SIM,1852,36,20-24,1888,2
STAT,1879,26,40-44,1905,3.6220986340816013
STAT,1878,48,35-39,1926,0.1665741353867471
SIM,1996,0,na,1996,6953
SIM,1904,21,25-29,1925,2
STAT,1954,22,25-29,1976,132.2158044653123
SIM,1918,48,40-44,1966,1
SIM,1921,25,40-44,1946,18
STAT,1909,27,40-44,1936,5.146486793623841
STAT,1933,29,25-29,1962,100.80371590717367
SIM,1883,37,na,1920,2482
SIM,1837,38,45-49,1875,6
SIM,1920,89,na,2009,244
STAT,1845,49,35-39,1894,0.0923699464843339
SIM,1958,33,15-19,1991,1
SIM,1950,55,na,2005,4488
SIM,1980,21,na,2001,5255
SIM,1968,28,50-100,1996,6
STAT,1951,28,na,1979,5167.8710274743735
SIM,1852,27,30-34,1879,60
SIM,1952,36,25-29,1988,1
STAT,1894,66,na,1960,2577.819273769737
STAT,1943,15,25-29,1958,53.06612560859672
STAT,1886,15,na,1901,3088.7328338261577
STAT,1944,36,25-29,1980,1.2610044929818998
STAT,1822,35,30-34,1857,14.06820168225313
SIM,1836,32,20-24,1868,5
SIM,1824,80,na,1904,24
SIM,1859,39,35-39,1898,2
STAT,1828,32,20-24,1860,3.1166563899325292
STAT,1844,27,30-34,1871,25.784313440492053
SIM,1927,22,30-34,1949,52
SIM,1853,49,35-39,1902,1
STAT,1818,46,20-24,1864,0.015024548383910277
SIM,1869,25,35-39,1894,22
STAT,1889,11,na,1900,3679.28024581058
STAT,1866,38,15-19,1904,0.05976846418931771
SIM,1830,36,35-39,1866,8
SIM,1895,70,na,1965,2248
SIM,1830,35,30-34,1865,4
SIM,1852,37,25-29,1889,1
SIM,1855,49,50-100,1904,1
SIM,1847,33,35-39,1880,3
SIM,1905,30,30-34,1935,23
SIM,1951,24,15-19,1975,9
SIM,1917,36,30-34,1953,5
SIM,1933,29,na,1962,6007
STAT,1938,20,25-29,1958,105.62544565378171
SIM,1884,17,25-29,1901,13
SIM,1962,22,25-29,1984,5
STAT,1776,80,na,1856,349.95533841269986
STAT,1844,28,35-39,1872,9.808818179623861
SIM,1818,49,40-44,1867,1
SIM,1891,24,40-44,1915,4
SIM,1828,35,40-44,1863,10
SIM,1928,34,40-44,1962,16
STAT,1866,26,20-24,1892,12.59174990146509
SIM,1851,15,20-24,1866,37
STAT,1834,48,20-24,1882,0.01146600877522155
STAT,1919,22,30-34,1941,36.31170886843075
STAT,1889,39,20-24,1928,1.08554928870095
STAT,1901,15,20-24,1916,28.791013613689817
STAT,1943,24,15-19,1967,6.532137559554333
STAT,1982,25,35-39,2007,24.50756047017191
STAT,1829,38,45-49,1867,2.240656479310389
STAT,1869,37,50-100,1906,1.3721355158447837
SIM,1946,20,25-29,1966,206
SIM,1914,27,15-19,1941,1
SIM,1917,77,na,1994,2843
STAT,1895,40,na,1935,3506.9588060892347
SIM,1947,43,na,1990,5930
STAT,1896,26,50-100,1922,0.9784204144781701
SIM,1858,40,35-39,1898,3
STAT,1865,74,na,1939,1155.5740902522589
SIM,1849,30,40-44,1879,17
SIM,1814,69,na,1883,744
STAT,1843,20,na,1863,2731.9517339938125
STAT,1935,17,40-44,1952,2.207880025548518
SIM,1840,24,35-39,1864,8
STAT,1870,18,35-39,1888,0.6265145212810933
STAT,1895,28,40-44,1923,4.484072361329855
SIM,1877,37,50-100,1914,5
SIM,1840,18,15-19,1858,9
SIM,1956,47,45-49,2003,1
SIM,1896,55,na,1951,3311
STAT,1984,16,20-24,2000,222.2789860262411
STAT,1923,20,30-34,1943,38.809200386493394
STAT,1962,43,50-100,2005,0.18024532720285863
STAT,1855,34,30-34,1889,14.815968730038533
SIM,1895,24,25-29,1919,184
STAT,1967,20,45-49,1987,1.628495522237457
STAT,1881,27,35-39,1908,10.740503051252839
SIM,1943,17,40-44,1960,2
STAT,1887,24,25-29,1911,73.57358203045351
STAT,1906,27,15-19,1933,0.7635228461442607
STAT,1892,19,25-29,1911,8.152594189704887
STAT,1939,26,15-19,1965,0.8197287710607916
STAT,1913,25,40-44,1938,5.398954890249508
SIM,1863,49,na,1912,2218
STAT,1939,32,35-39,1971,10.764823766356074
SIM,1948,38,25-29,1986,5
SIM,1967,38,30-34,2005,1
STAT,1875,52,na,1927,2554.1878971141514
STAT,1860,29,30-34,1889,23.33413921880665
SIM,1975,20,45-49,1995,2
SIM,1932,44,na,1976,5435
SIM,1916,31,45-49,1947,1
SIM,1866,89,na,1955,8
STAT,1772,110,na,1882,2.541480227710641E-4
SIM,1895,9,na,1904,4026
SIM,1977,27,35-39,2004,5
STAT,1954,21,20-24,1975,159.21444960521703
STAT,1832,24,35-39,1856,6.057252265866965
STAT,1842,39,15-19,1881,0.045181023004429326
STAT,1910,25,15-19,1935,0.7996052022496337
SIM,1962,21,20-24,1983,156
STAT,1825,76,na,1901,670.1253806470686
STAT,1957,31,40-44,1988,6.072973938643213
STAT,1908,31,45-49,1939,1.7233382436993032
STAT,1918,46,25-29,1964,0.06529232075276689
STAT,1877,29,35-39,1906,11.500221245988406
STAT,1881,18,45-49,1899,0.07252187481610788
STAT,1877,35,20-24,1912,0.9341499051880847
STAT,1907,15,na,1922,4308.339884636881
SIM,1799,64,na,1863,678
STAT,1869,38,40-44,1907,4.868067548399832
STAT,1968,16,40-44,1984,2.0166918542449657
SIM,1948,34,50-100,1982,1
STAT,1893,37,20-24,1930,1.124451562691221
SIM,1887,26,40-44,1913,1
STAT,1934,21,45-49,1955,1.746473743742396
SIM,1873,23,35-39,1896,20
SIM,1896,36,35-39,1932,4
STAT,1871,39,35-39,1910,8.038877310824974
SIM,1851,42,50-100,1893,1
STAT,1846,25,40-44,1871,3.8006965362142187
STAT,1788,104,na,1892,0.030274385462906638
SIM,1915,31,50-100,1946,2
SIM,1985,24,15-19,2009,1
STAT,1889,48,45-49,1937,0.18699808269708768
SIM,1811,62,na,1873,1401
STAT,1816,49,15-19,1865,7.915439731566453E-4
SIM,1864,23,na,1887,2683
STAT,1828,102,na,1930,0.19458006935982772
STAT,1892,18,20-24,1910,25.57597151697417
SIM,1841,36,45-49,1877,3
SIM,1878,48,na,1926,2628
STAT,1967,36,15-19,2003,0.02854621076880302
STAT,1911,20,50-100,1931,0.7250870038956927
SIM,1863,34,30-34,1897,3
STAT,1843,42,50-100,1885,1.091414252663101
STAT,1970,17,35-39,1987,6.061881306624188
STAT,1907,31,50-100,1938,0.8969691179400483
STAT,1917,34,15-19,1951,0.1539681753930941
SIM,1939,69,na,2008,3726
STAT,1821,54,50-100,1875,0.025309182611811667
STAT,1977,24,15-19,2001,8.322183936428685
SIM,1834,57,na,1891,1417
STAT,1876,37,na,1913,2810.6309425914787
STAT,1860,53,na,1913,1970.5247271157943
STAT,1879,27,45-49,1906,1.3379362248608628
SIM,1877,38,40-44,1915,12
SIM,1780,84,na,1864,27
SIM,1976,16,40-44,1992,2
STAT,1982,19,15-19,2001,73.649642436668
STAT,1929,25,na,1954,5431.420706608428
SIM,1915,39,25-29,1954,3
SIM,1990,19,15-19,2009,141
SIM,1962,10,na,1972,5587
STAT,1844,54,50-100,1898,0.012284901920142074
STAT,1894,49,30-34,1943,0.07931473391734037
STAT,1870,17,30-34,1887,1.83065812336381
STAT,1946,24,40-44,1970,4.315055744048987
STAT,1845,86,na,1931,149.51235529193238
STAT,1965,22,35-39,1987,13.610904722182191
STAT,1945,32,na,1977,4860.012273950841
SIM,1893,15,na,1908,3688
SIM,1973,22,35-39,1995,1
STAT,1907,39,25-29,1946,1.0445852056109142
STAT,1865,23,35-39,1888,6.105933104327291
STAT,1884,88,na,1972,448.34041491044707
STAT,1972,35,na,2007,5737.117436364115
STAT,1906,30,na,1936,4082.5681408812393
STAT,1888,36,35-39,1924,9.64112659512042
SIM,1985,18,30-34,2003,28
STAT,1871,112,na,1983,0.002355664948281422
STAT,1911,102,na,2013,15.085745998461116
STAT,1979,31,35-39,2010,14.809893592322302
SIM,1873,17,na,1890,3570
SIM,1894,27,35-39,1921,21
STAT,1917,31,45-49,1948,1.9094365029588012
SIM,1969,10,na,1979,5830
SIM,1850,32,45-49,1882,1
SIM,1871,29,35-39,1900,1
STAT,1908,63,na,1971,3449.1747669529077
SIM,1854,34,na,1888,2497
SIM,1851,25,15-19,1876,1
SIM,1907,66,na,1973,3526
SIM,1853,31,30-34,1884,29
STAT,1827,42,20-24,1869,0.21181264088079835
SIM,1968,4,na,1972,5402
STAT,1834,45,15-19,1879,4.364567043887332E-4
STAT,1836,48,30-34,1884,0.09105220170458025
SIM,1916,4,na,1920,4917
SIM,1978,33,35-39,2011,23
STAT,1920,81,na,2001,2221.5235781279443
SIM,1855,46,40-44,1901,1
STAT,1980,20,20-24,2000,178.85529365368942
SIM,1971,29,40-44,2000,18
STAT,1871,41,50-100,1912,1.2184285324206026
SIM,1890,72,na,1962,1738
SIM,1951,21,45-49,1972,7
SIM,1821,35,30-34,1856,2
STAT,1897,36,50-100,1933,1.9036900558568215
STAT,1823,97,na,1920,3.042235458915914
SIM,1974,40,40-44,2014,1
STAT,1900,44,25-29,1944,0.0704448911980921
STAT,1886,27,35-39,1913,11.745748159169837
SIM,1815,44,45-49,1859,3
STAT,1882,34,40-44,1916,4.84655925993776
STAT,1895,25,35-39,1920,14.592878611208045
STAT,1965,38,50-100,2003,0.6225772012017091
STAT,1816,42,45-49,1858,3.3898768632185354
SIM,1844,33,30-34,1877,42
STAT,1845,31,30-34,1876,14.135027191528932
SIM,1885,29,35-39,1914,3
STAT,1885,40,15-19,1925,0.01605702540737587
SIM,1818,43,30-34,1861,5
STAT,1813,53,30-34,1866,0.0185275025034223
STAT,1969,22,20-24,1991,160.83108915978147
SIM,1890,34,40-44,1924,13
SIM,1968,24,20-24,1992,284
STAT,1854,49,35-39,1903,0.11167614260178564
SIM,1977,22,20-24,1999,2
STAT,1958,38,na,1996,5869.052913511311
SIM,1926,49,na,1975,5714
STAT,1926,32,50-100,1958,1.1535066246300572
STAT,1891,32,40-44,1923,6.18553758204615
STAT,1913,10,na,1923,4676.4900642146695
STAT,1978,20,20-24,1998,175.82818522534672
STAT,1819,41,30-34,1860,2.4955863185238965
STAT,1876,42,15-19,1918,0.01645455147154204
STAT,1966,40,40-44,2006,0.3757214562680845
SIM,1957,24,45-49,1981,7
STAT,1843,43,15-19,1886,0.01408523696686182
STAT,1927,22,15-19,1949,7.567092954997445
SIM,1835,35,30-34,1870,10
SIM,1855,51,na,1906,1701
SIM,1867,28,30-34,1895,3
STAT,1863,47,35-39,1910,0.14061678952882206
SIM,1823,42,na,1865,2227
STAT,1854,89,na,1943,85.58678728940936
STAT,1928,31,20-24,1959,3.5217141790490736
STAT,1811,46,50-100,1857,0.778593564157689
STAT,1833,34,45-49,1867,1.5608576841197033
SIM,1778,81,na,1859,30
SIM,1827,56,na,1883,1237
SIM,1935,22,15-19,1957,11
STAT,1842,88,na,1930,105.64318713754811
STAT,1856,44,40-44,1900,1.953641969647219
STAT,1895,71,na,1966,2346.995004786345
STAT,1857,3,na,1860,2984.709133684018
SIM,1909,57,na,1966,4415
STAT,1899,85,na,1984,1102.490898879389
SIM,1864,44,40-44,1908,1
STAT,1859,28,30-34,1887,23.380343285843963
STAT,1836,40,na,1876,2335.229660744555
STAT,1993,19,25-29,2012,71.90516870442514
STAT,1880,39,35-39,1919,8.564811792530634
SIM,1888,78,na,1966,1042
STAT,1825,47,15-19,1872,5.585700068495841E-4
STAT,1949,24,45-49,1973,1.5141336412005693
SIM,1968,17,30-34,1985,41
STAT,1862,30,20-24,1892,2.6537577044263028
SIM,1925,31,45-49,1956,5
SIM,1852,34,20-24,1886,4
SIM,1919,21,20-24,1940,3
STAT,1830,45,30-34,1875,0.09167171618413925
STAT,1854,38,50-100,1892,0.9952771435432114
STAT,1877,36,25-29,1913,3.472953080739071
STAT,1906,1,na,1907,4580.550163296284
SIM,1869,87,na,1956,107
STAT,1895,32,25-29,1927,15.386358023468963
STAT,1940,49,25-29,1989,0.06429318026786889
STAT,1825,29,15-19,1854,1.8778730567100583
SIM,1835,42,20-24,1877,1
STAT,1927,46,na,1973,5333.989856114107
STAT,1977,36,30-34,2013,2.9305536732547437
SIM,1914,48,na,1962,3868
STAT,1881,40,30-34,1921,1.2926420968976091
STAT,1843,25,15-19,1868,0.5683824661731252
STAT,1851,30,45-49,1881,1.4694935844326955
STAT,1833,29,20-24,1862,10.848425683476009
STAT,1946,37,na,1983,4961.218385560465
SIM,1841,34,45-49,1875,6
STAT,1852,51,45-49,1903,0.013747964450593989
STAT,1959,40,50-100,1999,0.18481446704555865
STAT,1989,23,45-49,2012,1.8654276077459837
STAT,1836,18,35-39,1854,1.1216463420854366
SIM,1833,40,45-49,1873,1
SIM,1826,37,30-34,1863,12
STAT,1844,34,20-24,1878,2.6480890137788107
STAT,1844,59,na,1903,1625.5573774254783
STAT,1848,50,40-44,1898,0.01134666564170828
STAT,1869,47,30-34,1916,0.10768012294565496
SIM,1872,43,na,1915,2861
STAT,1862,23,30-34,1885,17.631404196921242
STAT,1855,23,40-44,1878,2.0565522083915218
STAT,1889,46,45-49,1935,0.3366795370210745
SIM,1941,39,40-44,1980,1
STAT,1978,34,25-29,2012,14.819017046433876
STAT,1881,43,35-39,1924,2.0011087701014474
STAT,1848,27,15-19,1875,0.5755022894989804
STAT,1867,32,na,1899,2571.222544060383
STAT,1875,109,na,1984,0.05352555868395638
STAT,1843,18,25-29,1861,7.22337519621918
STAT,1919,24,50-100,1943,0.8261079481087851
SIM,1988,25,45-49,2013,1
STAT,1853,40,na,1893,2324.3332696275684
SIM,1851,18,25-29,1869,10
STAT,1860,17,15-19,1877,6.366072119137699
STAT,1933,39,40-44,1972,2.3491351500417594
STAT,1826,50,50-100,1876,0.01092390436065162
STAT,1963,29,na,1992,5510.740220612723
STAT,1825,40,45-49,1865,2.3191410886579455
STAT,1872,45,35-39,1917,0.16384969565469507
SIM,1915,65,na,1980,3707
SIM,1966,22,45-49,1988,3
STAT,1818,37,30-34,1855,8.787325974781648
STAT,1984,28,15-19,2012,1.161544854625377
SIM,1839,57,na,1896,1695
SIM,1877,32,30-34,1909,37
SIM,1981,25,35-39,2006,52
STAT,1861,113,na,1974,2.1504025704111019E-4
STAT,1872,23,na,1895,2732.1550166153806
SIM,1835,43,na,1878,2101
STAT,1801,108,na,1909,7.688191200973383E-4
STAT,1814,51,25-29,1865,0.009605956237841934
STAT,1970,31,15-19,2001,0.18933880856291405
SIM,1883,90,na,1973,189
STAT,1885,18,30-34,1903,1.8299109171948933
STAT,1939,47,na,1986,4416.080044321226
SIM,1987,27,50-100,2014,7
STAT,1968,45,20-24,2013,0.016646804126338618
STAT,1928,16,25-29,1944,63.16862080219283
SIM,1831,42,35-39,1873,3
STAT,1999,1,na,2000,6713.112047866805
STAT,1905,21,25-29,1926,95.90730393994951
SIM,1827,41,30-34,1868,5
SIM,1857,86,na,1943,120
STAT,1868,19,40-44,1887,0.2040437595484733
SIM,1882,17,15-19,1899,8
STAT,1878,22,50-100,1900,0.49136932035158587
STAT,1899,37,15-19,1936,0.019163314898326914
STAT,1827,35,30-34,1862,8.206270909791844
STAT,1873,40,na,1913,2751.2564534391827
STAT,1874,17,15-19,1891,7.011358615958926
SIM,1956,44,40-44,2000,1
SIM,1816,60,na,1876,1339
SIM,1911,51,na,1962,4550
STAT,1830,48,35-39,1878,0.12750065782084405
STAT,1885,19,50-100,1904,0.05609257042487947
STAT,1958,40,45-49,1998,0.2628888656689861
SIM,1965,42,40-44,2007,1
STAT,1949,42,45-49,1991,0.23214129078616005
SIM,1986,27,35-39,2013,3
STAT,1860,35,15-19,1895,0.05272587694882586
STAT,1829,33,40-44,1862,5.42344430283381
STAT,1834,27,15-19,1861,0.5429256412168244
STAT,1947,23,50-100,1970,0.8579099571790518
STAT,1969,18,35-39,1987,6.0473456890113555
STAT,1871,24,35-39,1895,6.65792617664806
SIM,1868,37,35-39,1905,1
SIM,1941,26,na,1967,3988
SIM,1962,27,50-100,1989,1
STAT,1780,95,na,1875,3.585494542771375
STAT,1845,16,35-39,1861,0.47010105836281246
SIM,1871,26,na,1897,2196
SIM,1967,33,na,2000,5668
STAT,1958,22,45-49,1980,1.711100609339358
STAT,1853,32,20-24,1885,2.771395723591898
STAT,1869,32,30-34,1901,19.513125265342612
STAT,1907,21,35-39,1928,9.938412071521228
STAT,1865,42,40-44,1907,2.3391886500469683
STAT,1823,42,35-39,1865,1.902618895846345
STAT,1879,24,40-44,1903,2.495309514516332
STAT,1913,54,na,1967,4032.3035006360997
SIM,1926,24,15-19,1950,14
STAT,1892,32,50-100,1924,1.3252890299384257
STAT,1818,44,20-24,1862,0.20097278826050424
STAT,1855,50,30-34,1905,0.005137783978847698
SIM,1814,45,50-100,1859,1
STAT,1868,26,30-34,1894,28.01669226366593
SIM,1990,2,na,1992,6342
STAT,1853,25,30-34,1878,29.465914495679225
STAT,1876,38,30-34,1914,6.326537550016633
STAT,1983,32,40-44,2015,6.512145763551847
STAT,1833,47,50-100,1880,0.2038387181219316
SIM,1848,61,na,1909,1328
STAT,1943,21,45-49,1964,1.3821069647552524
SIM,1861,32,20-24,1893,1
SIM,1915,21,35-39,1936,29
STAT,1978,27,35-39,2005,23.74809162424958
STAT,1964,45,35-39,2009,0.19584376534395884
SIM,1976,38,30-34,2014,1
STAT,1969,42,30-34,2011,0.19153717779346635
SIM,1837,33,40-44,1870,12
SIM,1894,34,25-29,1928,24
STAT,1969,41,50-100,2010,0.17626095173502115
SIM,1867,52,na,1919,2061
SIM,1961,26,na,1987,5201
SIM,1884,38,30-34,1922,2
SIM,1861,25,30-34,1886,41
STAT,1882,37,45-49,1919,2.247088118159493
STAT,1904,31,50-100,1935,1.5246249412129123
STAT,1918,24,15-19,1942,6.582725759109375
STAT,1875,31,45-49,1906,2.088173220844981
SIM,1959,19,30-34,1978,1
STAT,1886,34,25-29,1920,12.361686657154271
STAT,1907,49,40-44,1956,0.16141453982266143
STAT,1872,52,25-29,1924,0.004082642030067556
SIM,1815,41,40-44,1856,4
STAT,1885,41,na,1926,2672.527577424592
STAT,1968,38,30-34,2006,2.70380663424818
STAT,1895,22,30-34,1917,26.75746877377378
STAT,1909,29,50-100,1938,1.0911597263220625
STAT,1854,46,30-34,1900,0.07908657381309465
STAT,1881,50,25-29,1931,0.003999376134271572
STAT,1968,42,15-19,2010,0.00230040464111863
STAT,1860,22,na,1882,2267.6302247642748
STAT,1862,38,30-34,1900,5.164902923132192
STAT,1879,54,35-39,1933,0.01008879853556457
STAT,1827,45,25-29,1872,0.07493310364117478
STAT,1831,43,25-29,1874,0.6076110315086356
STAT,1885,36,30-34,1921,6.164454076954079
SIM,1862,46,30-34,1908,1
SIM,1870,38,30-34,1908,11
STAT,1877,33,20-24,1910,3.231179782465908
STAT,1883,49,50-100,1932,0.2715151467431484
STAT,1993,1,na,1994,6537.870824315369
SIM,1840,42,na,1882,1973
STAT,1892,23,45-49,1915,1.005513201128369
STAT,1986,29,50-100,2015,1.6421933861352254
STAT,1832,37,50-100,1869,1.0788085363589794
SIM,1890,37,45-49,1927,5
SIM,1973,29,na,2002,5407
STAT,1893,16,15-19,1909,8.678100581778668
STAT,1841,41,40-44,1882,2.1048465247536856
STAT,1923,47,30-34,1970,0.12030538727927155
SIM,1866,90,na,1956,7
STAT,1928,63,na,1991,4860.024959977112
STAT,1775,84,na,1859,138.90704970805444
SIM,1947,20,40-44,1967,11
SIM,1971,22,25-29,1993,3
STAT,1856,92,na,1948,36.67019636486278
STAT,1822,36,na,1858,2383.5826670509555
SIM,1879,53,na,1932,2466
STAT,1899,33,na,1932,3757.0041025595806
STAT,1855,53,35-39,1908,0.007207792772527466
STAT,1805,53,25-29,1858,0.012399553566737222
SIM,1976,24,15-19,2000,13
STAT,1909,80,na,1989,1983.8692047439893
STAT,1846,37,35-39,1883,7.635635364527838
SIM,1919,24,25-29,1943,10
STAT,1984,18,20-24,2002,222.14563855082253
STAT,1868,29,35-39,1897,10.621955868924712
STAT,1816,40,na,1856,1590.032285747231
SIM,1900,12,na,1912,3923
STAT,1939,20,40-44,1959,3.90123636176732
SIM,1893,18,30-34,1911,5
SIM,1871,44,30-34,1915,3
SIM,1912,77,na,1989,1579
STAT,1839,37,na,1876,2029.7985584849707
STAT,1856,47,45-49,1903,0.20681732063102792
STAT,1895,37,30-34,1932,8.006048975564253
SIM,1885,26,30-34,1911,1
SIM,1770,85,na,1855,120
SIM,1974,21,na,1995,5673
SIM,1919,93,na,2012,322
STAT,1963,22,25-29,1985,135.87599280014564
STAT,1877,26,30-34,1903,30.333223333712347
SIM,1841,31,40-44,1872,5
STAT,1872,27,35-39,1899,11.18119957005169
SIM,1893,69,na,1962,2030
STAT,1827,36,na,1863,2305.1504575030312
STAT,1869,67,na,1936,1771.6526231598555
STAT,1863,44,30-34,1907,1.1444821587666631
SIM,1885,33,20-24,1918,5
STAT,1833,31,40-44,1864,4.008446425996465
STAT,1823,45,40-44,1868,0.17395605185162089
SIM,1882,73,na,1955,1845
SIM,1933,20,40-44,1953,8
STAT,1885,43,20-24,1928,0.1814905647397373
SIM,1933,39,na,1972,6377
STAT,1871,37,na,1908,2704.959502369095
STAT,1820,108,na,1928,0.0010750380114396137
STAT,1862,88,na,1950,133.7049380877254
STAT,1978,16,35-39,1994,6.610650345421591
STAT,1944,46,na,1990,4757.80025391442
SIM,1893,36,30-34,1929,16
SIM,1868,39,50-100,1907,6
STAT,1880,36,30-34,1916,6.550737353572908
STAT,1940,32,na,1972,4518.700705445275
SIM,1979,2,na,1981,6478
STAT,1925,20,40-44,1945,4.670920289581591
SIM,1942,43,na,1985,4971
STAT,1873,40,25-29,1913,0.7644116862032057
SIM,1864,47,45-49,1911,2
STAT,1966,6,na,1972,5666.493498891231
SIM,1840,40,35-39,1880,2
SIM,1877,35,35-39,1912,5
SIM,1844,15,30-34,1859,7
STAT,1805,88,na,1893,56.41638097722803
STAT,1861,46,50-100,1907,0.2362994122033258
SIM,1828,47,35-39,1875,1
SIM,1925,89,na,2014,1072
STAT,1945,11,na,1956,4952.796713379683
SIM,1869,32,25-29,1901,12
SIM,1966,41,50-100,2007,1
STAT,1978,31,20-24,2009,3.9181122164077458
STAT,1863,51,20-24,1914,7.48204779515348E-4
STAT,1889,43,40-44,1932,3.176636403507586
STAT,1837,50,50-100,1887,0.011419523301121398
SIM,1794,64,na,1858,829
SIM,1848,43,45-49,1891,1
SIM,1853,60,na,1913,1865
SIM,1798,78,na,1876,616
STAT,1842,32,50-100,1874,0.8517469475723716
STAT,1841,62,na,1903,1625.0177581283003
SIM,1954,44,na,1998,5421
SIM,1988,22,40-44,2010,1
STAT,1892,100,na,1992,27.172575478012078
SIM,1947,1,na,1948,6270
STAT,1853,28,35-39,1881,10.054569023729625
SIM,1935,18,30-34,1953,46
STAT,1832,40,35-39,1872,1.5793234688392412
STAT,1869,35,35-39,1904,7.979828237946567
SIM,1867,46,30-34,1913,1
SIM,1818,39,50-100,1857,3
STAT,1867,44,15-19,1911,0.014679080453476002
STAT,1852,41,15-19,1893,0.013079005684071018
STAT,1914,15,50-100,1929,0.08989752659688434
SIM,1909,28,30-34,1937,89
SIM,1928,28,na,1956,5485
STAT,1851,37,15-19,1888,0.04500714460980993
SIM,1868,19,35-39,1887,2
SIM,1924,14,na,1938,5306
STAT,1915,45,na,1960,4293.08573842033
SIM,1861,28,35-39,1889,18
STAT,1893,34,15-19,1927,0.20595418938817248
STAT,1840,50,35-39,1890,0.0070054454038049946
STAT,1817,49,30-34,1866,0.2685504407428737
STAT,1831,36,35-39,1867,7.067213882021844
STAT,1810,79,na,1889,387.23888479799456
SIM,1866,35,na,1901,2500
STAT,1843,39,30-34,1882,5.564226697034935
SIM,1919,17,35-39,1936,8
STAT,1840,45,na,1885,1867.260535123834
SIM,1835,38,35-39,1873,15
SIM,1899,30,na,1929,4296
SIM,1965,45,45-49,2010,1
STAT,1836,33,30-34,1869,19.884288134322382
STAT,1853,35,25-29,1888,2.9267374731769618
STAT,1869,42,25-29,1911,0.7167964558621405
SIM,1870,72,na,1942,1756
STAT,1859,46,30-34,1905,0.08924135165505884
STAT,1927,18,30-34,1945,17.4402800658035
SIM,1854,37,35-39,1891,12
STAT,1822,51,30-34,1873,0.011045728584376066
STAT,1913,102,na,2015,15.548284328616422
STAT,1999,14,na,2013,6694.606693982946
SIM,1888,14,na,1902,3101
STAT,1998,9,na,2007,6658.6362802828835
SIM,1986,24,30-34,2010,6
SIM,1877,42,25-29,1919,2
STAT,1906,20,na,1926,4003.819083349962
SIM,1973,38,50-100,2011,2
STAT,1948,53,na,2001,4939.336155381885
STAT,1868,93,na,1961,67.32672412989805
STAT,1827,38,35-39,1865,10.06447957422362
STAT,1851,19,15-19,1870,5.654513997775816
STAT,1797,96,na,1893,2.5566908201622187
STAT,1987,9,na,1996,6474.076855677237
SIM,1851,39,30-34,1890,11
SIM,1913,88,na,2001,1505
STAT,1957,45,45-49,2002,0.345592271663198
STAT,1843,46,20-24,1889,0.012138967334227707
STAT,1859,53,20-24,1912,6.674807662843022E-4
STAT,1911,33,50-100,1944,0.9259937564702467
SIM,1861,35,25-29,1896,2
SIM,1853,17,na,1870,2705
STAT,1836,40,20-24,1876,0.17646373026533527
STAT,1821,41,50-100,1862,2.083399575474774
SIM,1821,38,35-39,1859,6
STAT,1986,16,30-34,2002,20.048795139312347
STAT,1806,50,35-39,1856,0.0315449473074546
SIM,1876,27,50-100,1903,2
SIM,1858,48,na,1906,2480
STAT,1808,53,na,1861,1562.7468970974996
STAT,1987,13,na,2000,6470.516840380132
SIM,1994,16,30-34,2010,28
STAT,1964,42,30-34,2006,0.19311702112447413
STAT,1811,96,na,1907,4.42121480866447
STAT,1937,32,25-29,1969,10.55857237051648
STAT,1918,87,na,2005,1164.0440271006355
STAT,1978,24,30-34,2002,45.38528122107217
SIM,1989,7,na,1996,6752
SIM,1912,13,na,1925,4197
STAT,1835,19,50-100,1854,0.06856674692243873
STAT,1920,48,45-49,1968,0.276368908355547
SIM,1842,17,20-24,1859,25
SIM,1945,32,25-29,1977,15
STAT,1852,6,na,1858,2844.768338670539
SIM,1934,32,50-100,1966,1
STAT,1915,47,25-29,1962,0.061696922872107436
STAT,1933,36,50-100,1969,0.6608606328636029
SIM,1849,29,25-29,1878,106
STAT,1885,39,35-39,1924,8.059762759991141
STAT,1836,92,na,1928,37.9037901553139
STAT,1881,46,40-44,1927,0.19110875917045997
SIM,1845,36,30-34,1881,9
SIM,1948,16,15-19,1964,101
SIM,1886,36,40-44,1922,1
SIM,1838,29,15-19,1867,2
STAT,1951,31,45-49,1982,2.205532626431174
STAT,1878,36,40-44,1914,5.300083751431257
STAT,1891,14,na,1905,3671.5548874365504
SIM,1848,28,50-100,1876,5
STAT,1970,34,20-24,2004,3.587148423540197
SIM,1822,41,30-34,1863,2
SIM,1979,16,45-49,1995,1
SIM,1890,17,na,1907,3708
STAT,1835,33,15-19,1868,0.11204155583351975
SIM,1967,21,20-24,1988,151
STAT,1925,23,45-49,1948,1.5489952476912252
SIM,1813,43,30-34,1856,1
SIM,1893,39,35-39,1932,25
STAT,1967,36,na,2003,5592.597700568037
STAT,1974,27,15-19,2001,1.0684179234829263
SIM,1901,30,45-49,1931,5
STAT,1870,21,15-19,1891,3.7647112131684386
SIM,1872,35,35-39,1907,14
SIM,1822,56,na,1878,1317
SIM,1899,53,na,1952,3512
STAT,1876,52,45-49,1928,0.01722083706589693
STAT,1900,15,na,1915,4063.1845226890428
STAT,1858,28,15-19,1886,0.41513850990367146
STAT,1904,29,na,1933,3926.725052745808
SIM,1918,26,30-34,1944,2
STAT,1814,41,30-34,1855,3.9963592558659866
STAT,1957,12,na,1969,5976.939309713895
STAT,1930,3,na,1933,6052.448016851719
SIM,1857,22,na,1879,2453
STAT,1945,3,na,1948,5055.344673343583
STAT,1962,31,20-24,1993,3.6785660731972114
SIM,1909,20,20-24,1929,133
STAT,1867,26,15-19,1893,0.4905368726333217
SIM,1898,29,20-24,1927,3
STAT,1892,20,40-44,1912,3.0320764505849938
STAT,1904,30,20-24,1934,4.515568181949527
STAT,1873,33,35-39,1906,11.884280326322694
STAT,1987,22,30-34,2009,47.50762967526401
STAT,1853,41,30-34,1894,1.1498107115108953
STAT,1843,20,45-49,1863,0.890989256546959
SIM,1939,18,15-19,1957,56
STAT,1809,93,na,1902,13.583370742195106
STAT,1850,46,50-100,1896,0.2535497838577828
SIM,1867,21,na,1888,2364
STAT,1869,98,na,1967,17.51869609155208
SIM,1845,21,30-34,1866,22
STAT,1806,74,na,1880,470.0275469665615
STAT,1852,44,20-24,1896,0.14770997147788686
STAT,1803,108,na,1911,6.384281669941643E-4
STAT,1826,104,na,1930,0.03672541293986448
STAT,1847,39,15-19,1886,0.043909191727039366
STAT,1890,25,35-39,1915,13.69845749028026
STAT,1890,32,25-29,1922,14.443303266624925
SIM,1874,30,40-44,1904,10
STAT,1825,45,na,1870,1870.581790779974
SIM,1819,39,40-44,1858,6
STAT,1837,36,30-34,1873,4.7478030628931815
STAT,1859,49,35-39,1908,0.12601544652774332
SIM,1875,19,25-29,1894,17
STAT,1969,26,50-100,1995,1.4417750785689776
SIM,1940,39,25-29,1979,4
SIM,1956,15,na,1971,5168
STAT,1880,15,50-100,1895,0.060207324669416334
STAT,1936,41,20-24,1977,0.02022404797130615
SIM,1856,69,na,1925,1396
SIM,1851,20,45-49,1871,3
SIM,1886,12,na,1898,2384
STAT,1914,28,na,1942,4344.990528389295
STAT,1840,22,na,1862,2181.235976237595
STAT,1965,40,25-29,2005,0.10721708492899694
STAT,1886,67,na,1953,1929.7033388565653
SIM,1973,33,35-39,2006,29
SIM,1933,23,45-49,1956,2
STAT,1840,31,30-34,1871,17.23753252153435
STAT,1867,19,25-29,1886,6.168680320293249
STAT,1805,50,20-24,1855,0.002747839153862732
STAT,1847,50,25-29,1897,0.0027645826221230955
STAT,1968,27,30-34,1995,56.72241429585072
STAT,1931,28,na,1959,5580.027514389517
STAT,1882,53,na,1935,2388.113501395828
SIM,1828,34,50-100,1862,2
SIM,1944,23,20-24,1967,4
STAT,1885,46,25-29,1931,0.06649214190902836
STAT,1932,39,25-29,1971,1.5238340950956741
STAT,1936,23,20-24,1959,122.71629214700222
STAT,1819,37,na,1856,1957.5188806805652
STAT,1837,54,30-34,1891,0.004191902223426394
STAT,1841,44,45-49,1885,1.3477301291000292
SIM,1888,44,50-100,1932,4
STAT,1925,41,45-49,1966,0.23279521574596237
STAT,1823,74,na,1897,628.4597702016159
SIM,1873,69,na,1942,2009
STAT,1971,31,30-34,2002,23.487374984437547
SIM,1864,47,50-100,1911,1
STAT,1831,33,30-34,1864,17.596136168214198
SIM,1925,31,na,1956,5250
STAT,1936,19,35-39,1955,4.614114081469955
STAT,1831,52,35-39,1883,0.007017701681487279
STAT,1827,51,30-34,1878,0.007421868220313454
STAT,1868,32,15-19,1900,0.15789701837268502
STAT,1864,42,25-29,1906,0.6608906389176532
SIM,1897,2,na,1899,4294
SIM,1834,29,30-34,1863,58
SIM,1842,77,na,1919,854
SIM,1936,72,na,2008,2590
STAT,1898,41,40-44,1939,0.2447155138638093
STAT,1859,68,na,1927,1404.8792056118925
STAT,1911,47,40-44,1958,0.1723993579914389
SIM,1942,12,na,1954,5057
STAT,1931,48,20-24,1979,0.017009071062329757
SIM,1946,26,na,1972,4283
SIM,1959,23,15-19,1982,5
STAT,1855,54,na,1909,1781.7386778858372
STAT,1843,74,na,1917,1113.5407308620806
STAT,1864,112,na,1976,9.915932302131214E-4
STAT,1906,21,40-44,1927,3.51736873953115
STAT,1826,29,30-34,1855,43.60233389611303
SIM,1881,33,35-39,1914,4
STAT,1925,22,50-100,1947,0.9086529462075117
SIM,1891,4,na,1895,3693
STAT,1861,23,15-19,1884,3.228291351243528
STAT,1893,49,na,1942,3213.958653873455
STAT,1896,43,30-34,1939,0.1208127947430765
SIM,1944,19,35-39,1963,9
SIM,1841,47,50-100,1888,1
SIM,1843,18,na,1861,2286
STAT,1851,92,na,1943,33.0277697885988
SIM,1905,49,50-100,1954,1
STAT,1979,34,40-44,2013,6.330192905812229
STAT,1877,42,30-34,1919,1.3784142484101058
SIM,1928,22,25-29,1950,1
SIM,1829,35,35-39,1864,5
STAT,1921,86,na,2007,1400.00168734239
SIM,1848,40,40-44,1888,9
STAT,1819,92,na,1911,27.726532003062363
STAT,1826,47,30-34,1873,0.06965166045940298
STAT,1807,59,na,1866,1399.3730627161924
STAT,1993,21,45-49,2014,1.8750187595854606
STAT,1868,27,50-100,1895,0.7092702106189492
SIM,1979,29,45-49,2008,3
STAT,1981,20,35-39,2001,15.25533986175133
STAT,1940,43,15-19,1983,0.0018676807297696896
SIM,1994,19,35-39,2013,8
STAT,1954,27,50-100,1981,1.426169596709192
SIM,1967,29,30-34,1996,8
SIM,1918,33,20-24,1951,2
STAT,1883,48,15-19,1931,4.459617054743776E-4
STAT,1913,5,na,1918,4731.215286103793
STAT,1784,108,na,1892,0.002126778108825481
SIM,1928,21,50-100,1949,1
SIM,1845,24,35-39,1869,1
SIM,1937,67,na,2004,3285
STAT,1991,23,35-39,2014,15.619125332954043
STAT,1795,84,na,1879,96.44015405241768
STAT,1836,43,25-29,1879,0.6866230579606113
STAT,1799,98,na,1897,1.4591951952437205
STAT,1899,9,na,1908,4102.297673234157
SIM,1830,24,40-44,1854,1
STAT,1876,45,20-24,1921,0.014458468642005734
STAT,1906,49,25-29,1955,0.053536847251309076
STAT,1884,18,15-19,1902,6.748970584781047
SIM,1955,23,50-100,1978,1
SIM,1869,37,30-34,1906,4
STAT,1837,24,35-39,1861,5.452535698009532
STAT,1833,50,45-49,1883,0.011025152590648861
SIM,1979,21,35-39,2000,1
SIM,1841,82,na,1923,415
SIM,1895,34,40-44,1929,12
STAT,1856,37,15-19,1893,0.04944124340758984
SIM,1898,13,na,1911,4155
SIM,1885,42,30-34,1927,3
STAT,1887,34,40-44,1921,5.5607551568185425
SIM,1825,30,45-49,1855,4
STAT,1959,21,20-24,1980,168.46713926692948
SIM,1876,8,na,1884,3060
STAT,1826,54,20-24,1880,4.930622958783439E-4
STAT,1959,29,30-34,1988,59.345957924304166
STAT,1970,44,50-100,2014,0.17578689852003165
STAT,1863,29,35-39,1892,9.66724077969942
STAT,1831,40,20-24,1871,0.15615745484698368
SIM,1953,53,na,2006,5481
STAT,1969,25,25-29,1994,95.38140781355152
SIM,1945,31,na,1976,4683
SIM,1864,19,15-19,1883,6
STAT,1896,25,30-34,1921,38.644832271778164
STAT,1832,46,45-49,1878,0.19622076857797696
STAT,1863,21,25-29,1884,59.344458125694004
SIM,1970,16,25-29,1986,80
SIM,1969,32,30-34,2001,82
STAT,1941,37,25-29,1978,1.2060925190949339
STAT,1962,16,25-29,1978,64.09676076289489
STAT,1856,19,15-19,1875,6.105739121581508
STAT,1930,20,20-24,1950,165.39387318988193
SIM,1840,46,45-49,1886,1
SIM,1912,31,50-100,1943,2
SIM,1984,22,20-24,2006,181
SIM,1871,21,25-29,1892,143
SIM,1872,42,25-29,1914,1
STAT,1814,44,35-39,1858,5.334117877468059
STAT,1782,108,na,1890,0.007019504341444169
STAT,1777,96,na,1873,1.1552978772348563
SIM,1932,13,na,1945,5675
STAT,1859,108,na,1967,0.016386885462213743
SIM,1944,26,25-29,1970,132
SIM,1946,32,40-44,1978,11
SIM,1904,39,50-100,1943,1
STAT,1990,17,35-39,2007,6.93500793602446
STAT,1884,24,na,1908,2679.7963808333116
SIM,1845,39,35-39,1884,9
SIM,1891,57,na,1948,2749
STAT,1806,53,40-44,1859,0.03632090656088748
STAT,1898,37,20-24,1935,1.2022778443960478
STAT,1900,41,20-24,1941,0.01774014343174781
SIM,1823,32,35-39,1855,5
SIM,1980,25,40-44,2005,10
STAT,1938,32,40-44,1970,4.543246309594192
SIM,1903,46,45-49,1949,1
SIM,1928,15,35-39,1943,12
STAT,1901,28,40-44,1929,4.825232520740412
STAT,1937,12,na,1949,4450.841124274826
STAT,1825,33,50-100,1858,1.787312142027929
SIM,1840,43,40-44,1883,7
STAT,1891,35,45-49,1926,2.870349933595511
STAT,1972,20,25-29,1992,137.03123128109695
STAT,1962,34,25-29,1996,13.91300971852252
SIM,1955,30,na,1985,6518
SIM,1910,65,na,1975,2743
STAT,1986,19,35-39,2005,6.895489229553347
STAT,1955,37,50-100,1992,0.6626783713980745
SIM,1862,38,50-100,1900,3
STAT,1936,26,25-29,1962,72.7707496311254
SIM,1989,10,na,1999,6751
STAT,1852,19,30-34,1871,1.7961378105203953
STAT,1859,53,50-100,1912,0.013661105809073126
STAT,1884,36,15-19,1920,0.06433678299471869
SIM,1957,21,40-44,1978,13
STAT,1907,46,na,1953,3831.7311566740623
STAT,1835,102,na,1937,0.18272246119103783
SIM,1855,25,35-39,1880,1
SIM,1851,81,na,1932,913
SIM,1921,31,25-29,1952,12
STAT,1882,50,40-44,1932,0.012037457127654652
SIM,1822,44,35-39,1866,7
SIM,1877,17,35-39,1894,1
STAT,1837,31,25-29,1868,9.396371556513822
STAT,1949,21,40-44,1970,4.529264619363923
STAT,1864,51,35-39,1915,0.008913577525693023
STAT,1847,25,35-39,1872,9.053300522704667
STAT,1894,22,15-19,1916,4.894231479830539
STAT,1915,90,na,2005,697.9103204246193
STAT,1837,39,35-39,1876,6.107590970509632
STAT,1944,49,45-49,1993,0.2791241773247441
STAT,1959,44,15-19,2003,0.0024011722789807426
STAT,1913,31,25-29,1944,10.661305442174749
STAT,1869,17,35-39,1886,0.6217337777421073
SIM,1902,47,na,1949,3778
STAT,1946,30,25-29,1976,12.072683183339292
STAT,1840,34,35-39,1874,9.691538967466084
SIM,1868,34,30-34,1902,2
SIM,1911,17,30-34,1928,3
STAT,1955,41,na,1996,5921.547411350356
SIM,1897,82,na,1979,1366
STAT,1858,28,na,1886,2183.6723724777507
STAT,1842,25,20-24,1867,11.326095272922972
STAT,1890,22,30-34,1912,25.11746025650647
SIM,1845,31,25-29,1876,13
SIM,1868,44,25-29,1912,3
STAT,1991,18,na,2009,6085.595469085352
STAT,1903,17,30-34,1920,2.619966258731528
STAT,1966,43,45-49,2009,0.2489144560791838
STAT,1847,43,35-39,1890,1.3832733769133705
STAT,1987,25,35-39,2012,24.863347248094538
STAT,1836,36,35-39,1872,7.98621446172107
STAT,1862,112,na,1974,7.219145367741739E-4
SIM,1878,30,25-29,1908,4
SIM,1850,25,20-24,1875,10
SIM,1819,49,35-39,1868,1
STAT,1798,58,na,1856,914.0674890471
STAT,1837,25,na,1862,2039.754223098655
SIM,1844,18,35-39,1862,1
SIM,1918,29,35-39,1947,18
SIM,1914,79,na,1993,2143
SIM,1830,27,50-100,1857,1
SIM,1855,43,35-39,1898,4
SIM,1938,27,na,1965,3760
STAT,1852,47,25-29,1899,0.05405287562174228
SIM,1954,30,25-29,1984,30
STAT,1840,41,25-29,1881,0.5442943124443583
STAT,1828,45,40-44,1873,0.16184216586928266
SIM,1858,17,na,1875,3101
STAT,1902,7,na,1909,4248.366773971411
STAT,1863,54,25-29,1917,0.0034759908213675035
SIM,1927,24,50-100,1951,1
STAT,1924,25,50-100,1949,1.3461529097010954
STAT,1847,36,50-100,1883,0.9903907295058143
STAT,1950,56,na,2006,5020.028388196807
STAT,1886,46,na,1932,2746.5320936267926
STAT,1862,33,25-29,1895,9.933507277477874
STAT,1858,4,na,1862,2803.0907981887653
STAT,1960,38,50-100,1998,0.6495058610734312
STAT,1873,29,15-19,1902,0.5308623536470332
STAT,1980,23,25-29,2003,148.42360494673648
STAT,1854,58,na,1912,1611.142702007468
SIM,1976,22,25-29,1998,301
STAT,1936,44,25-29,1980,0.08138604606545385
SIM,1937,7,na,1944,4520
STAT,1968,22,25-29,1990,133.58250962176967
SIM,1829,28,45-49,1857,1
SIM,1855,36,50-100,1891,2
STAT,1850,16,15-19,1866,7.509699071190695
STAT,1921,36,45-49,1957,0.8789286915153722
SIM,1925,64,na,1989,4483
STAT,1896,46,35-39,1942,0.12071717059136025
SIM,1914,39,30-34,1953,5
STAT,1900,36,na,1936,3820.828981029234
SIM,1878,38,35-39,1916,5
SIM,1860,37,30-34,1897,7
STAT,1847,18,45-49,1865,0.06236328621183856
STAT,1936,16,30-34,1952,13.508262855273431
SIM,1868,49,30-34,1917,1
STAT,1914,6,na,1920,4771.370080254208
STAT,1932,36,20-24,1968,0.4092196295429174
STAT,1852,37,30-34,1889,5.052062330845784
SIM,1795,81,na,1876,271
SIM,1939,22,35-39,1961,25
STAT,1840,16,35-39,1856,0.5732838127678332
STAT,1849,41,45-49,1890,1.165246955859807
SIM,1886,35,na,1921,2100
SIM,1856,33,50-100,1889,3
SIM,1857,41,45-49,1898,1
SIM,1944,16,30-34,1960,21
STAT,1858,46,15-19,1904,3.611365270943279E-4
SIM,1869,47,45-49,1916,1
STAT,1964,22,40-44,1986,4.903400661807015
STAT,1837,21,30-34,1858,17.007088255708535
SIM,1824,35,20-24,1859,1
STAT,1820,45,na,1865,1552.7903811523333
STAT,1906,39,30-34,1945,1.9163943504783638
STAT,1839,52,40-44,1891,0.008304504388821798
SIM,1807,56,na,1863,1015
SIM,1977,18,na,1995,6225
STAT,1989,20,40-44,2009,5.58015458769495
STAT,1961,35,50-100,1996,0.6460555453218976
STAT,1911,83,na,1994,1616.9441245016658
SIM,1870,26,35-39,1896,1
SIM,1870,95,na,1965,183
STAT,1850,49,15-19,1899,4.0318045745839733E-4
STAT,1837,29,40-44,1866,2.744293841537518
STAT,1872,87,na,1959,294.9379342162997
STAT,1831,25,45-49,1856,1.1742512257473101
SIM,1918,36,25-29,1954,1
STAT,1898,44,45-49,1942,0.15990920085716773
STAT,1956,52,na,2008,5737.221243021573
STAT,1862,26,35-39,1888,9.500259240487964
STAT,1873,0,na,1873,4357.780952505662
STAT,1830,27,30-34,1857,31.655451754893633
SIM,1939,23,na,1962,4985
SIM,1868,50,50-100,1918,2
SIM,1882,21,35-39,1903,1
STAT,1985,16,15-19,2001,74.51253841707329
STAT,1906,46,20-24,1952,0.01142369529436895
STAT,1976,25,25-29,2001,102.00909861971775
SIM,1969,35,35-39,2004,9
STAT,1886,31,20-24,1917,3.3039104581338425
SIM,1884,21,na,1905,2695
SIM,1972,22,40-44,1994,10
SIM,1977,15,30-34,1992,29
SIM,1931,9,na,1940,6385
SIM,1982,27,15-19,2009,3
SIM,1837,22,na,1859,2560
STAT,1863,19,40-44,1882,0.18940492451195637
STAT,1967,34,50-100,2001,1.2133436521548304
STAT,1832,43,40-44,1875,1.8865822669158359
STAT,1873,15,35-39,1888,0.6543335055486961
STAT,1896,28,35-39,1924,14.655956310561045
STAT,1872,54,na,1926,2426.4819925368447
STAT,1837,66,na,1903,1186.8533377071603
SIM,1984,25,25-29,2009,10
SIM,1894,31,20-24,1925,2
SIM,1862,35,40-44,1897,17
STAT,1890,41,35-39,1931,2.5650189151419767
STAT,1921,19,50-100,1940,0.4900208206690701
SIM,1956,21,45-49,1977,2
SIM,1908,83,na,1991,782
STAT,1926,86,na,2012,1532.5954666920675
SIM,1872,32,30-34,1904,33
STAT,1886,24,30-34,1910,21.547350908642446
SIM,1871,26,30-34,1897,3
SIM,1894,39,30-34,1933,5
STAT,1945,16,50-100,1961,0.4724453625397667
SIM,1817,43,15-19,1860,1
SIM,1894,24,30-34,1918,66
STAT,1854,35,40-44,1889,3.620907288325248
SIM,1895,37,45-49,1932,7
STAT,1969,15,30-34,1984,17.581039370596127
STAT,1896,20,25-29,1916,87.7793251663808
STAT,1887,37,45-49,1924,2.5782222336927623
SIM,1835,74,na,1909,1007
SIM,1839,88,na,1927,152
STAT,1880,52,30-34,1932,0.007242641356169019
SIM,1875,7,na,1882,3650
STAT,1842,32,45-49,1874,1.6210667811929245
STAT,1865,45,45-49,1910,0.2481863196140575
STAT,1886,39,30-34,1925,6.422458086645559
STAT,1820,40,45-49,1860,1.9611995392663943
SIM,1873,45,45-49,1918,1
STAT,1948,21,45-49,1969,1.4913859432666705
STAT,1863,26,30-34,1889,25.595083615061466
STAT,1953,44,40-44,1997,0.36168059311870043
SIM,1818,39,25-29,1857,7
STAT,1909,30,20-24,1939,2.7108086584234705
SIM,1903,43,40-44,1946,1
STAT,1802,53,20-24,1855,0.0028817999457053755
SIM,1886,56,na,1942,1683
STAT,1840,18,50-100,1858,0.05058484936647181
STAT,1926,47,50-100,1973,0.32200375169504264
STAT,1944,15,na,1959,4573.875885652474
STAT,1862,30,50-100,1892,0.8995341669657333
STAT,1902,46,35-39,1948,0.12913901134274877
STAT,1975,27,30-34,2002,59.91210810838405
SIM,1983,27,30-34,2010,79
SIM,1852,22,na,1874,1938
STAT,1877,48,40-44,1925,0.20293385291362984
SIM,1911,82,na,1993,2690
STAT,1912,40,20-24,1952,0.01989857465199579
STAT,1971,41,25-29,2012,0.10862812722480371
SIM,1825,44,na,1869,1638
STAT,1836,61,na,1897,1700.5850522395112
STAT,1922,93,na,2015,433.01660946183154
STAT,1897,16,35-39,1913,0.8488112235437486
SIM,1966,33,20-24,1999,12
SIM,1909,78,na,1987,2798
STAT,1967,31,20-24,1998,3.5862438080495638
STAT,1876,108,na,1984,0.12798030945440036
STAT,1958,33,20-24,1991,3.76623308038868
SIM,1795,60,na,1855,1268
SIM,1923,22,45-49,1945,1
STAT,1973,23,45-49,1996,1.6843639362163385
SIM,1917,30,20-24,1947,4
SIM,1896,1,na,1897,4124
SIM,1901,48,35-39,1949,1
STAT,1837,46,45-49,1883,0.17968547630113735
STAT,1991,20,30-34,2011,47.724651457024336
SIM,1818,72,na,1890,1063
SIM,1892,46,50-100,1938,2
SIM,1943,28,na,1971,5394
STAT,1954,45,na,1999,5477.377542789269
STAT,1924,20,45-49,1944,1.5409329778576235
STAT,1987,0,na,1987,6525.671800795409
STAT,1876,16,na,1892,3020.394673379681
SIM,1838,72,na,1910,642
SIM,1911,72,na,1983,3753
STAT,1811,51,20-24,1862,0.0022407404028493166
STAT,1911,44,35-39,1955,0.21926222417479863
SIM,1896,86,na,1982,1093
STAT,1840,76,na,1916,760.0086555088564
STAT,1870,11,na,1881,3026.8082061441755
STAT,1915,22,45-49,1937,1.342487174890945
SIM,1930,65,na,1995,5448
SIM,1895,33,50-100,1928,3
SIM,1955,33,45-49,1988,6
SIM,1837,55,na,1892,1923
STAT,1833,21,50-100,1854,0.5714492135144755
SIM,1886,66,na,1952,1207
STAT,1899,64,na,1963,2966.386369419355
STAT,1973,39,15-19,2012,0.02946591691358227
SIM,1812,42,50-100,1854,2
STAT,1874,43,50-100,1917,1.239125863112185
STAT,1901,40,45-49,1941,0.16969585752208985
STAT,1944,25,na,1969,4676.844581498114
STAT,1929,48,na,1977,5480.411020218183
SIM,1855,40,30-34,1895,1
STAT,1821,36,40-44,1857,10.227403700959801
SIM,1912,41,40-44,1953,1
STAT,1929,34,50-100,1963,1.2104865176154258
SIM,1838,62,na,1900,1282
SIM,1888,47,na,1935,2569
STAT,1807,104,na,1911,0.03261658755428636
STAT,1944,46,40-44,1990,0.20418351160493836
STAT,1894,3,na,1897,3921.945935590031
STAT,1886,46,40-44,1932,0.20899536506959282
STAT,1954,18,40-44,1972,1.9948612837971818
SIM,1959,30,25-29,1989,16
STAT,1827,54,35-39,1881,0.009203575885134315
STAT,1870,36,35-39,1906,8.08576464441892
STAT,1891,35,50-100,1926,1.7677827243924786
STAT,1765,95,na,1860,0.20874999814305578
STAT,1823,38,15-19,1861,0.06411708892551243
SIM,1837,26,30-34,1863,39
STAT,1882,53,45-49,1935,0.01609595575772025
STAT,1810,56,na,1866,1428.2094425681257
SIM,1972,31,40-44,2003,2
SIM,1860,7,na,1867,3053
STAT,1765,108,na,1873,4.2690712424673364E-4
STAT,1981,26,45-49,2007,2.801182719340884
SIM,1912,36,na,1948,3787
STAT,1897,83,na,1980,1294.8515782246013
STAT,1975,34,20-24,2009,3.780427954970877
STAT,1954,49,na,2003,5419.763905329057
STAT,1847,40,30-34,1887,0.9126388195897402
STAT,1863,36,45-49,1899,2.021329861675088
STAT,1954,40,25-29,1994,0.10616827555842832
STAT,1947,33,45-49,1980,2.08381666556182
STAT,1904,41,40-44,1945,0.26001946677168686
STAT,1929,58,na,1987,5213.3571992699035
STAT,1864,17,35-39,1881,0.5849069143240664
STAT,1822,57,na,1879,1795.5780331518965
STAT,1868,17,na,1885,2851.0122777589236
STAT,1870,113,na,1983,7.417454277119987E-4
STAT,1873,49,na,1922,2596.0550095007343
STAT,1844,53,25-29,1897,0.0029150516665508454
STAT,1910,103,na,2013,8.835838774951972
STAT,1963,49,15-19,2012,5.584831263993611E-4
STAT,1986,8,na,1994,6462.648735540062
STAT,1899,39,50-100,1938,0.4147628512304408
SIM,1929,40,40-44,1969,1
STAT,1870,40,20-24,1910,0.18250860883010342
SIM,1835,20,na,1855,2515
SIM,1840,21,na,1861,1966
SIM,1923,77,na,2000,3535
SIM,1973,30,30-34,2003,53
SIM,1872,17,35-39,1889,2
SIM,1877,105,na,1982,13
STAT,1995,20,15-19,2015,8.928113226775263
STAT,1866,91,na,1957,79.04062154308619
SIM,1863,19,35-39,1882,1
STAT,1970,33,na,2003,5565.797155121615
STAT,1937,43,45-49,1980,0.1935331577608394
STAT,1929,6,na,1935,5903.3679394698975
STAT,1898,16,50-100,1914,0.0765993377586006
STAT,1934,8,na,1942,6228.850384419148
STAT,1840,86,na,1926,177.98941274348275
STAT,1830,34,40-44,1864,4.510389963079225
STAT,1895,44,40-44,1939,0.23146675054461643
STAT,1963,40,50-100,2003,0.17949923476587432
STAT,1839,48,50-100,1887,0.1959222748679559
SIM,1868,37,na,1905,3134
STAT,1913,33,na,1946,4326.479405011543
STAT,1858,18,20-24,1876,18.534460225744336
SIM,1879,26,35-39,1905,17
STAT,1838,42,na,1880,2129.8105732740883
STAT,1829,29,35-39,1858,14.8065604195418
STAT,1853,44,35-39,1897,1.77854508394095
STAT,1838,17,40-44,1855,0.2093110677062932
STAT,1861,45,25-29,1906,0.05581279257819329
STAT,1859,16,15-19,1875,6.370400369071775
SIM,1926,26,na,1952,5638
SIM,1888,37,na,1925,2765
SIM,1941,47,na,1988,3906
SIM,1923,87,na,2010,1875
STAT,1855,22,50-100,1877,0.405366964947954
STAT,1869,35,15-19,1904,0.06335483288964279
SIM,1866,18,20-24,1884,34
SIM,1850,41,na,1891,1578
SIM,1837,29,35-39,1866,28
SIM,1855,5,na,1860,2332
STAT,1990,24,45-49,2014,1.8644594275711155
SIM,1877,28,25-29,1905,97
STAT,1895,25,15-19,1920,0.6861721618854209
STAT,1948,46,25-29,1994,0.07304953214450821
STAT,1924,70,na,1994,3955.1708512244327
STAT,1818,42,na,1860,1312.9652598184223
STAT,1925,48,50-100,1973,0.31531498351006887
SIM,1910,11,na,1921,4030
STAT,1854,80,na,1934,503.96853167557504
SIM,1856,91,na,1947,107
STAT,1914,31,40-44,1945,4.566736546321164
STAT,1855,19,35-39,1874,0.5488015845847611
STAT,1838,24,30-34,1862,19.73508137326102
STAT,1890,47,45-49,1937,0.18684519156741566
STAT,1938,17,45-49,1955,0.5689564545986914
STAT,1988,25,30-34,2013,65.0085690246626
STAT,1869,34,na,1903,2644.1276067656836
STAT,1908,32,na,1940,4125.14840546553
SIM,1875,19,na,1894,3353
STAT,1811,47,35-39,1858,0.43639952408983484
STAT,1965,45,15-19,2010,5.54641342090163E-4
STAT,1948,48,50-100,1996,0.3098388791038968
STAT,1930,34,45-49,1964,2.340871993927437
SIM,1846,24,30-34,1870,22
STAT,1835,75,na,1910,641.6162748478354
STAT,1884,48,30-34,1932,0.108986546078458
STAT,1848,46,20-24,1894,0.012786533528958232
SIM,1960,48,50-100,2008,1
STAT,1988,18,40-44,2006,2.307899581828079
SIM,1885,38,50-100,1923,4
STAT,1784,78,na,1862,315.7540418536056
SIM,1922,31,40-44,1953,17
STAT,1928,28,40-44,1956,6.623643394584477
SIM,1845,43,40-44,1888,8
STAT,1977,20,25-29,1997,144.60693358045154
STAT,1880,25,40-44,1905,3.6891570880614735
STAT,1889,34,na,1923,3365.628764412927
STAT,1837,43,40-44,1880,1.8974817921406082
STAT,1927,23,na,1950,5175.117771804661
STAT,1860,47,30-34,1907,0.0896147721225417
SIM,1957,42,na,1999,6204
STAT,1832,22,50-100,1854,0.6271517286866525
STAT,1858,50,35-39,1908,0.007861995050069324
SIM,1840,22,50-100,1862,1
SIM,1974,35,50-100,2009,2
STAT,1824,38,na,1862,1758.9145643160123
SIM,1895,27,30-34,1922,2
SIM,1906,81,na,1987,1779
STAT,1854,90,na,1944,64.23117212495598
SIM,1917,29,50-100,1946,3
STAT,1937,44,40-44,1981,0.29034878977312206
STAT,1824,30,35-39,1854,31.525824223271343
STAT,1877,52,25-29,1929,0.0042293558572533835
STAT,1835,48,35-39,1883,0.09091849576813206
STAT,1946,48,15-19,1994,4.890772691924252E-4
SIM,2006,7,na,2013,7585
STAT,1860,76,na,1936,881.1883368094545
STAT,1909,33,25-29,1942,10.147059579473149
STAT,1947,30,40-44,1977,5.191329281357845
STAT,1956,1,na,1957,6012.9323369105605
STAT,1874,36,20-24,1910,0.9151006201124939
STAT,1880,18,30-34,1898,1.9445786519513628
STAT,1981,23,40-44,2004,5.44201979514041
STAT,1905,32,45-49,1937,1.6724983543745566
STAT,1912,43,25-29,1955,0.07908028326366842
STAT,1963,33,45-49,1996,2.350238819900474
STAT,1885,82,na,1967,904.2251148929805
SIM,1846,27,35-39,1873,11
STAT,1923,35,15-19,1958,0.02571329504721239
STAT,1895,18,25-29,1913,8.490211210794161
STAT,1856,16,na,1872,2403.883672067903
STAT,1913,49,15-19,1962,4.1271867941020265E-4
SIM,1889,16,35-39,1905,1
SIM,1821,42,40-44,1863,1
STAT,1931,45,15-19,1976,5.71225017756225E-4
SIM,1832,30,35-39,1862,1
STAT,1916,18,20-24,1934,33.111775312234414
STAT,1932,33,15-19,1965,0.1970698528567906
STAT,1973,20,40-44,1993,5.038529025193558
STAT,1870,33,30-34,1903,19.780515264765565
STAT,1939,24,na,1963,4231.262775335014
STAT,1880,52,50-100,1932,0.018375957773554177
SIM,1969,27,40-44,1996,1
SIM,1975,17,50-100,1992,1
STAT,1838,27,35-39,1865,10.633775273129846
STAT,1813,42,40-44,1855,8.450863261007177
STAT,1948,43,20-24,1991,0.02420034343416505
SIM,1931,27,na,1958,5911
STAT,1869,54,40-44,1923,0.011442237144016206
STAT,1963,34,40-44,1997,5.840899753768416
STAT,1931,22,45-49,1953,1.6844976934008318
STAT,1967,17,50-100,1984,0.5400915783436833
SIM,1879,19,45-49,1898,1
STAT,1981,31,50-100,2012,1.3607803731538266
SIM,1882,0,na,1882,4117
SIM,1955,30,40-44,1985,2
STAT,1850,20,35-39,1870,7.314956600422465
STAT,1900,46,na,1946,3613.6960285842556
STAT,1873,30,30-34,1903,20.74149339169222
SIM,1810,49,35-39,1859,1
STAT,1893,46,30-34,1939,0.07987693319357568
STAT,1958,42,20-24,2000,0.02781871713295334
STAT,1910,66,na,1976,3391.9520825262402
SIM,1891,67,na,1958,2249
STAT,1886,36,na,1922,2881.760906848005
STAT,1863,33,40-44,1896,4.35775701879516
STAT,1778,82,na,1860,212.0433869273685
STAT,1972,10,na,1982,5805.82509455459
SIM,1925,54,na,1979,5150
SIM,1923,37,30-34,1960,1
STAT,1909,58,na,1967,3699.848683607711
STAT,1813,53,50-100,1866,0.047007795486423684
SIM,1823,73,na,1896,1111
SIM,1950,47,50-100,1997,1
SIM,1959,0,na,1959,6041
STAT,1906,43,15-19,1949,0.0016021864559358587
STAT,1964,25,na,1989,5473.396250734675
STAT,1940,21,40-44,1961,3.955430387454226
SIM,1888,42,35-39,1930,4
STAT,1846,18,30-34,1864,2.0576696989751784
SIM,1854,18,30-34,1872,6
STAT,1886,49,45-49,1935,0.281287130301596
STAT,1915,44,20-24,1959,0.020454332034491284
SIM,1937,16,40-44,1953,3
SIM,1869,44,40-44,1913,6
STAT,1966,35,50-100,2001,0.6245745078547772
STAT,1887,27,30-34,1914,32.56833045861865
SIM,1910,55,na,1965,3187
SIM,1881,30,30-34,1911,2
STAT,1942,44,na,1986,4640.1177274512065
STAT,1854,28,30-34,1882,21.35263496899178
SIM,1872,33,50-100,1905,3
SIM,1908,17,25-29,1925,1
SIM,1807,79,na,1886,266
STAT,1853,94,na,1947,19.89851851981186
SIM,1837,45,na,1882,2254
SIM,1953,42,25-29,1995,3
SIM,1985,21,na,2006,5954
STAT,1871,42,15-19,1913,0.015835908829471057
STAT,1902,21,20-24,1923,112.7098998176552
SIM,1838,17,na,1855,2246
STAT,1904,15,25-29,1919,9.43464316250832
STAT,1983,30,na,2013,6300.810370822509
SIM,1933,41,45-49,1974,3
SIM,1955,55,na,2010,6131
STAT,1785,95,na,1880,1.741291669528298
STAT,1864,47,15-19,1911,4.102546969251487E-4
STAT,1947,40,35-39,1987,0.27279360211178305
STAT,1915,37,30-34,1952,2.1251755778891646
SIM,1908,62,na,1970,3104
SIM,1862,28,30-34,1890,56
STAT,1961,45,30-34,2006,0.1389037917791856
STAT,1872,77,na,1949,1001.6595266072978
STAT,1860,54,20-24,1914,6.674711654217881E-4
SIM,1828,28,30-34,1856,55
SIM,1870,41,na,1911,2974
SIM,1939,13,na,1952,5015
SIM,1912,15,25-29,1927,8
STAT,1818,53,30-34,1871,0.006931207824425699
STAT,1836,71,na,1907,1214.7590500558742
STAT,1921,33,40-44,1954,5.002735143999087
STAT,1888,17,na,1905,3426.173120864651
SIM,1855,74,na,1929,572
SIM,1910,21,20-24,1931,107
SIM,1822,46,na,1868,1593
STAT,1862,19,25-29,1881,5.684483486189373
STAT,1854,35,na,1889,1948.7765669075575
STAT,1877,45,35-39,1922,0.1697377984459004
STAT,1910,36,50-100,1946,0.4661170422702576
SIM,1808,96,na,1904,4
SIM,1822,77,na,1899,425
SIM,1870,33,25-29,1903,22
STAT,1823,105,na,1928,0.016603939353047985
STAT,1830,37,45-49,1867,2.0159025709137817
STAT,1971,34,35-39,2005,13.597796192269959
SIM,1858,18,15-19,1876,9
STAT,1861,38,35-39,1899,6.752154321001357
SIM,1955,40,35-39,1995,1
STAT,1870,43,25-29,1913,0.7253199154591233
STAT,1976,30,50-100,2006,1.300854129105755
STAT,1770,96,na,1866,0.709860976137893
STAT,1917,17,50-100,1934,0.09304493036186114
SIM,1836,38,30-34,1874,1
SIM,1845,46,45-49,1891,1
STAT,1973,32,45-49,2005,2.3940156496333507
SIM,1913,53,na,1966,4323
STAT,1859,16,50-100,1875,0.05258997589419857
STAT,1961,27,na,1988,5609.653046442212
SIM,1872,22,na,1894,3181
SIM,1971,43,40-44,2014,1
STAT,1867,53,na,1920,2282.7629705702293
SIM,1842,56,na,1898,1788
STAT,1941,27,30-34,1968,46.788835881564246
STAT,1811,44,30-34,1855,3.7933320455386097
STAT,1974,31,35-39,2005,14.0451166757124
STAT,1957,47,na,2004,5814.3620956218265
STAT,1815,54,45-49,1869,0.02736224530003644
STAT,1913,42,45-49,1955,0.1874004011461338
SIM,1844,29,25-29,1873,8
STAT,1853,63,na,1916,1776.4871927046925
STAT,1968,15,15-19,1983,65.45080823042103
STAT,1828,38,30-34,1866,5.3717750346098505
STAT,1821,40,25-29,1861,1.2957708648863824
STAT,1951,4,na,1955,5404.367576939727
STAT,1935,20,20-24,1955,174.96031593347536
STAT,1941,34,20-24,1975,2.952355187155522
STAT,1906,51,na,1957,3682.176187795636
STAT,1945,42,25-29,1987,0.09355480089400338
SIM,1913,32,45-49,1945,1
SIM,1974,5,na,1979,6402
STAT,1936,42,50-100,1978,0.13434015297654558
STAT,1963,43,40-44,2006,0.3805090914014091
STAT,1972,18,50-100,1990,0.5534167522284175
STAT,1836,29,25-29,1865,49.11896635062342
SIM,1943,20,20-24,1963,160
STAT,1890,37,15-19,1927,0.07918468189540642
SIM,1988,18,35-39,2006,8
STAT,1949,17,20-24,1966,181.96539232462885
SIM,1957,17,20-24,1974,386
STAT,1821,33,35-39,1854,40.92387839661246
SIM,1982,31,35-39,2013,31
STAT,1882,27,15-19,1909,0.5114203086731924
STAT,1782,97,na,1879,1.2863459957726748
STAT,1944,43,35-39,1987,0.2594962778190468
STAT,1972,7,na,1979,5807.91569389319
SIM,1869,64,na,1933,1359
SIM,1885,40,na,1925,3198
STAT,1844,50,20-24,1894,6.260820696939134E-4
STAT,1855,75,na,1930,875.9646923244181
SIM,1843,45,30-34,1888,1
STAT,1913,42,50-100,1955,0.13228263572408033
STAT,1804,83,na,1887,181.99966735862145
STAT,1810,44,15-19,1854,0.06113204310655867
SIM,1976,15,15-19,1991,66
STAT,1939,37,50-100,1976,0.49988066717773283
SIM,1942,32,20-24,1974,6
STAT,1959,24,na,1983,5527.124124784637
STAT,1943,30,20-24,1973,3.046422960808253
STAT,1961,35,35-39,1996,3.7218709589279166
STAT,1963,30,40-44,1993,5.855056159963935
SIM,1844,58,na,1902,1807
STAT,1844,31,15-19,1875,0.14392600514939813
SIM,1970,32,na,2002,5988
STAT,1890,114,na,2004,7.425538758156504E-4
SIM,1824,68,na,1892,801
SIM,1958,27,na,1985,5904
STAT,1813,45,45-49,1858,0.8082722714445478
STAT,1853,47,40-44,1900,0.16965532442370265
STAT,1852,102,na,1954,0.2764093177367434
SIM,1812,47,45-49,1859,1
STAT,1857,51,45-49,1908,0.013106322860498999
STAT,1837,24,15-19,1861,3.0825306695736354
STAT,1958,45,25-29,2003,0.08402473144509744
SIM,1988,15,30-34,2003,48
STAT,1869,28,25-29,1897,47.11000651437788
SIM,1920,32,35-39,1952,6
SIM,1984,18,15-19,2002,134
STAT,1884,46,50-100,1930,0.28083335443307433
STAT,1923,32,45-49,1955,2.0810741818693064
SIM,1900,34,25-29,1934,34
STAT,1834,90,na,1924,71.94994815539097
STAT,1969,45,35-39,2014,0.1942416151823805
STAT,1974,39,30-34,2013,2.8235318068173747
STAT,1844,43,30-34,1887,0.9723104524400219
STAT,1903,34,35-39,1937,9.476665320055766
STAT,1835,45,30-34,1880,0.07178814188765985
STAT,1950,5,na,1955,5365.119035170854
SIM,1985,18,50-100,2003,3
STAT,1824,45,20-24,1869,0.016737887729851138
STAT,1908,42,20-24,1950,0.018880243405789195
SIM,1824,58,na,1882,1116
SIM,1939,44,na,1983,4896
STAT,1994,17,50-100,2011,0.623930776830558
STAT,1912,32,35-39,1944,10.387234036858523
STAT,1885,50,45-49,1935,0.016945437448359246
SIM,1911,34,35-39,1945,3
STAT,1890,44,40-44,1934,3.1289366375498973
SIM,1971,31,25-29,2002,26
STAT,1855,85,na,1940,233.25976471253483
STAT,1823,43,na,1866,1545.1245883851795
SIM,1841,21,50-100,1862,1
STAT,1983,25,15-19,2008,1.1584903419125216
STAT,1935,45,35-39,1980,0.21116022541548274
STAT,1835,52,20-24,1887,4.692974395996471E-4
SIM,1934,70,na,2004,4139
STAT,1941,49,40-44,1990,0.1938423162865807
SIM,1870,45,40-44,1915,1
SIM,1855,20,na,1875,1793
STAT,1891,37,na,1928,3360.3730663570204
SIM,1991,17,na,2008,6273
SIM,1871,57,na,1928,1738
STAT,1880,40,15-19,1920,0.01706320702697806
SIM,1931,32,45-49,1963,1
STAT,1887,33,50-100,1920,1.1800007535377286
SIM,1873,38,na,1911,3265
STAT,1783,83,na,1866,97.34889832194408
STAT,1862,45,40-44,1907,0.16839952723559218
STAT,1958,49,50-100,2007,0.3545036463692187
STAT,1884,55,na,1939,2357.6504014467782
STAT,1903,41,25-29,1944,0.07363213395392959
STAT,1914,59,na,1973,3955.841871579305
STAT,1977,4,na,1981,6132.130237659774
STAT,1934,32,20-24,1966,3.8452069078092896
STAT,1831,48,15-19,1879,3.658814094774781E-4
STAT,1940,39,30-34,1979,2.196211076700552
STAT,1821,62,na,1883,1165.2148976706071
SIM,1873,48,na,1921,3122
SIM,1871,67,na,1938,1216
STAT,1874,43,45-49,1917,1.7554283111060014
SIM,1882,43,45-49,1925,8
STAT,1868,51,20-24,1919,8.220958110011691E-4
STAT,1929,16,40-44,1945,2.065187292707832
STAT,1808,76,na,1884,530.6895606492388
SIM,1943,45,35-39,1988,1
STAT,1950,35,25-29,1985,1.3865762394624952
SIM,1869,23,na,1892,1979
STAT,1818,41,15-19,1859,0.018974363500740773
SIM,1887,52,na,1939,3467
STAT,1868,47,35-39,1915,0.1545037893275131
SIM,1910,86,na,1996,317
SIM,1853,41,25-29,1894,1
STAT,1852,23,na,1875,2377.547870117615
STAT,1871,92,na,1963,115.89866193721619
STAT,1837,17,25-29,1854,10.937957176207389
SIM,1922,92,na,2014,410
STAT,1871,54,30-34,1925,0.006646340845393094
STAT,1986,27,na,2013,6186.767865118177
STAT,1961,48,35-39,2009,0.19939695357846746
STAT,1992,23,15-19,2015,8.843994632683573
STAT,1864,54,40-44,1918,0.01054981139333446
STAT,1795,61,na,1856,811.3321366340001
STAT,1850,35,20-24,1885,0.8230295632149842
STAT,1856,41,35-39,1897,1.6015436507798024
SIM,1805,54,na,1859,1460
STAT,1873,18,na,1891,2968.6030241811627
STAT,1821,72,na,1893,772.3760243159863
STAT,1955,31,na,1986,5909.546303850069
STAT,1868,18,15-19,1886,6.65971673093777
SIM,1899,84,na,1983,983
SIM,1845,17,25-29,1862,6
SIM,1836,60,na,1896,1195
SIM,1970,33,30-34,2003,9
SIM,1796,76,na,1872,351
STAT,2004,9,na,2013,6930.168086514304
STAT,1873,52,40-44,1925,0.012340680719220537
SIM,1932,1,na,1933,5940
STAT,1877,30,15-19,1907,0.1723267102120084
STAT,1845,41,25-29,1886,0.44632924677497404
STAT,1886,17,20-24,1903,21.581138916724342
STAT,1822,54,35-39,1876,0.01504948762248037
STAT,1874,89,na,1963,260.1864295110139
SIM,1911,7,na,1918,5201
SIM,1878,34,50-100,1912,3
STAT,1921,41,25-29,1962,0.09291936223993244
STAT,1870,52,na,1922,2436.669893952354
STAT,1941,41,45-49,1982,0.20594283278435105
STAT,1837,56,na,1893,1476.9563487940911
STAT,1892,46,15-19,1938,3.2729010171069075E-4
SIM,1984,1,na,1985,6322
SIM,1882,43,50-100,1925,3
STAT,1928,7,na,1935,5812.525848320549
STAT,1815,51,40-44,1866,0.02107210842457726
STAT,1883,41,45-49,1924,1.6974910275547312
STAT,1920,45,40-44,1965,0.2019896892538794
STAT,1910,41,15-19,1951,0.001686317953453549
SIM,1925,41,na,1966,5295
STAT,1894,37,35-39,1931,10.492956283229066
SIM,1871,36,45-49,1907,1
SIM,1870,30,20-24,1900,5
SIM,1837,86,na,1923,294
STAT,1963,46,45-49,2009,0.33227210974128923
STAT,1811,54,25-29,1865,0.01012744103196034
SIM,1786,79,na,1865,43
STAT,1980,35,40-44,2015,2.475121318613289
STAT,1870,42,na,1912,2626.3159684200955
STAT,1848,53,45-49,1901,0.015172259907534569
SIM,1868,92,na,1960,84
SIM,1891,41,45-49,1932,2
STAT,1936,23,40-44,1959,3.7107537351859765
STAT,1960,22,20-24,1982,167.6865511511656
STAT,1861,35,30-34,1896,5.16179643942913
SIM,1869,15,20-24,1884,36
STAT,1842,57,na,1899,1546.4617678425511
STAT,1974,25,50-100,1999,1.507714308347183
SIM,1896,15,30-34,1911,3
STAT,1946,45,45-49,1991,0.2907221466779572
SIM,1837,76,na,1913,1113
STAT,1839,68,na,1907,1211.9367307029622
STAT,1846,52,30-34,1898,0.0061208801261304
STAT,1894,44,25-29,1938,0.06526205276049825
SIM,1933,48,50-100,1981,1
STAT,1888,15,30-34,1903,2.1722487106133705
STAT,1962,40,20-24,2002,0.02721391267664259
STAT,1924,42,20-24,1966,0.024235733543045108
STAT,1862,26,50-100,1888,0.6298361068908218
STAT,1932,47,na,1979,5752.674469557712
SIM,1855,19,na,1874,2057
STAT,1922,47,15-19,1969,4.8816608325342233E-4
STAT,1858,17,50-100,1875,0.05152248873486078
STAT,1944,21,25-29,1965,115.13863961364832
STAT,1845,34,35-39,1879,7.947202806536116
SIM,1912,67,na,1979,2861
STAT,1913,43,40-44,1956,0.28119597940093694
STAT,1936,30,30-34,1966,17.69107854392674
STAT,1889,40,35-39,1929,2.6020008871737366
SIM,1781,91,na,1872,30
STAT,1881,39,15-19,1920,0.06187816897182364
SIM,1918,33,40-44,1951,1
SIM,1968,27,25-29,1995,191
SIM,1963,28,na,1991,6508
SIM,1969,15,25-29,1984,136
STAT,1917,92,na,2009,491.5063780562449
SIM,1798,57,na,1855,1251
STAT,1878,40,25-29,1918,0.7815783133373913
STAT,1902,43,30-34,1945,0.12924130671922773
SIM,1942,33,na,1975,4928
SIM,1911,31,30-34,1942,40
STAT,1868,54,25-29,1922,0.003819271904645885
STAT,1840,53,40-44,1893,0.00830969817690083
STAT,1873,48,20-24,1921,0.013964185567006892
STAT,1809,104,na,1913,0.031000827403988122
STAT,1943,33,25-29,1976,11.523512427524558
SIM,1853,34,35-39,1887,5
SIM,1900,31,20-24,1931,1
STAT,1844,46,35-39,1890,0.11743163341279388
STAT,1899,10,na,1909,4095.4878590965877
SIM,1962,8,na,1970,5587
STAT,1950,32,20-24,1982,3.3926612639206564
STAT,1851,49,30-34,1900,0.07515916959934203
SIM,1952,21,25-29,1973,3
STAT,1951,46,30-34,1997,0.12774309231371905
STAT,1911,52,na,1963,3949.584027797823
SIM,1907,12,na,1919,4804
SIM,1900,35,na,1935,3612
SIM,1812,44,40-44,1856,8
SIM,1864,41,35-39,1905,6
STAT,1961,32,30-34,1993,23.94486295227302
STAT,1918,31,25-29,1949,11.37844656309497
SIM,1912,44,45-49,1956,1
SIM,1819,57,na,1876,818
SIM,1957,32,na,1989,6275
STAT,1923,88,na,2011,1114.1567138176797
STAT,1862,48,45-49,1910,0.2269600002894108
STAT,1973,40,30-34,2013,0.19885249890821088
SIM,1852,46,35-39,1898,1
STAT,1867,22,na,1889,2558.8104789234562
STAT,1911,22,25-29,1933,101.18398171488941
SIM,1820,42,25-29,1862,2
SIM,1842,87,na,1929,187
STAT,1903,31,30-34,1934,28.81717133060708
SIM,1826,39,na,1865,1945
SIM,1868,27,20-24,1895,28
STAT,1809,51,50-100,1860,0.03726880161436175
STAT,1854,102,na,1956,0.28748043237497056
STAT,1832,105,na,1937,0.019975889831950568
SIM,1972,22,50-100,1994,2
STAT,1861,42,20-24,1903,0.1521787819850672
STAT,1904,44,45-49,1948,0.16990955939927632
STAT,1940,46,20-24,1986,0.013506883289196496
SIM,1997,16,35-39,2013,19
STAT,1906,34,50-100,1940,0.8777920740505035
SIM,1832,52,45-49,1884,1
STAT,1812,42,25-29,1854,1.8334174337712452
SIM,1820,35,35-39,1855,24
SIM,1948,19,20-24,1967,144
STAT,1899,15,40-44,1914,0.2905262023925897
STAT,1935,42,30-34,1977,0.20822022922502162
STAT,1971,19,50-100,1990,0.5472544773231625
SIM,1972,34,45-49,2006,1
STAT,1947,48,30-34,1995,0.12020356475963795
STAT,1964,22,50-100,1986,0.9595696709487314
SIM,1957,9,na,1966,6328
STAT,1956,47,15-19,2003,5.851156980179899E-4
SIM,1866,3,na,1869,2973
STAT,1819,44,35-39,1863,3.583686842985054
SIM,1927,66,na,1993,3877
SIM,1921,43,40-44,1964,2
SIM,1978,30,30-34,2008,37
SIM,1884,85,na,1969,386
STAT,1878,6,na,1884,3251.967305438899
STAT,1989,16,35-39,2005,6.938123321969806
SIM,1914,34,50-100,1948,1
STAT,1824,52,45-49,1876,0.019034536235352777
STAT,1899,54,na,1953,3310.784235141465
STAT,1874,40,40-44,1914,2.6842148593116297
STAT,1888,48,15-19,1936,3.0224215310378826E-4
STAT,1829,26,30-34,1855,62.74797876932163
STAT,1869,88,na,1957,190.16995656155876
STAT,1929,19,45-49,1948,0.7318139441606495
SIM,1924,37,50-100,1961,2
STAT,1868,44,30-34,1912,1.2575086583877515
SIM,1890,31,35-39,1921,34
SIM,1964,31,45-49,1995,6
SIM,1827,44,35-39,1871,2
SIM,1944,14,na,1958,4656
STAT,1882,31,35-39,1913,11.462031184888673
STAT,1960,32,na,1992,5794.571329859126
STAT,1894,41,20-24,1935,0.23667141723741875
STAT,1857,56,na,1913,1833.2448314903638
SIM,1876,44,30-34,1920,3
SIM,1937,19,45-49,1956,1
SIM,1882,40,40-44,1922,3
SIM,1926,31,25-29,1957,27
STAT,1901,33,20-24,1934,4.351008730638497
STAT,1839,15,35-39,1854,0.5760096157860237
SIM,1840,65,na,1905,1295
SIM,1870,48,45-49,1918,1
STAT,1960,45,15-19,2005,5.786315364357188E-4
SIM,1954,42,40-44,1996,1
STAT,1864,33,50-100,1897,0.94015325237373
STAT,1893,49,35-39,1942,0.11279218901302418
STAT,1978,19,40-44,1997,2.201457530107424
STAT,1806,95,na,1901,4.563304146548251
STAT,1819,51,25-29,1870,0.006691436750222357
SIM,1986,16,na,2002,5929
STAT,1937,40,40-44,1977,0.29212670495494164
SIM,1970,36,35-39,2006,3
STAT,1871,31,25-29,1902,11.807862070954533
STAT,1930,66,na,1996,4783.323164836971
STAT,1883,70,na,1953,1584.2002612761507
STAT,1926,51,na,1977,5163.613825136674
STAT,1832,36,15-19,1868,0.049879670445131516
STAT,1853,15,50-100,1868,0.05937320738818544
STAT,1855,49,15-19,1904,3.3325151660642817E-4
SIM,1932,45,25-29,1977,1
STAT,1953,54,na,2007,5195.531633909429
STAT,1990,21,40-44,2011,5.577202625814161
SIM,1908,52,na,1960,3531
STAT,1983,20,na,2003,5985.5612595202765
STAT,1930,31,40-44,1961,5.832421236003174
STAT,1914,49,30-34,1963,0.10148097304070888
STAT,1872,29,50-100,1901,0.7359789062897343
STAT,1946,42,40-44,1988,0.3327171141641605
STAT,1888,18,35-39,1906,0.7424146493033995
STAT,1924,45,25-29,1969,0.07320254893842805
STAT,1881,51,50-100,1932,0.01689174571846225
STAT,1878,108,na,1986,0.14311064047620145
STAT,1962,43,25-29,2005,0.10956088585121007
STAT,1894,34,30-34,1928,25.680411159672374
STAT,1876,50,50-100,1926,0.01827617640323851
STAT,1844,38,na,1882,2060.8636912612915
STAT,1925,11,na,1936,5530.2029380282
STAT,1879,51,30-34,1930,0.00720725429016795
STAT,1872,42,30-34,1914,1.330597881885901
SIM,1871,33,40-44,1904,4
SIM,1853,38,na,1891,2231
STAT,1900,22,15-19,1922,5.282910811282721
STAT,1871,21,30-34,1892,20.51249448685491
STAT,1895,29,50-100,1924,0.9540727489957632
STAT,1956,31,45-49,1987,2.4508229107807997
SIM,1886,29,30-34,1915,70
STAT,1916,37,50-100,1953,0.4962389045563393
STAT,1878,29,30-34,1907,30.126202489659125
STAT,1850,42,45-49,1892,1.5388134379120566
STAT,1873,9,na,1882,3155.1432645888635
STAT,1895,47,45-49,1942,0.1990449801786717
SIM,1863,16,30-34,1879,2
SIM,1880,42,30-34,1922,4
STAT,1909,40,50-100,1949,0.1283913288922768
STAT,1855,16,30-34,1871,1.6226414931495061
SIM,1953,37,na,1990,5660
STAT,1929,30,40-44,1959,5.7432857101507295
STAT,1945,40,50-100,1985,0.15433996209026607
STAT,1948,22,50-100,1970,0.871867744276441
SIM,1982,17,20-24,1999,242
STAT,1977,19,na,1996,5735.546323080218
STAT,2002,7,na,2009,6837.640510089871
SIM,1933,25,30-34,1958,64
SIM,1912,37,35-39,1949,2
STAT,1974,17,20-24,1991,204.30239404811994
STAT,1953,43,35-39,1996,0.2916869233961207
STAT,1850,85,na,1935,282.2066035921644
STAT,1865,25,35-39,1890,10.11516750508901
STAT,1923,28,50-100,1951,1.3136842419188763
SIM,1823,32,na,1855,2534
SIM,1816,70,na,1886,1061
STAT,1900,15,50-100,1915,0.0788179284598036
SIM,1903,42,35-39,1945,1
STAT,1914,39,15-19,1953,0.021914765097462905
SIM,1924,16,20-24,1940,173
SIM,1990,4,na,1994,6340
STAT,1869,30,45-49,1899,1.9645757912776176
STAT,1900,24,15-19,1924,5.249838871434194
SIM,1973,6,na,1979,5500
SIM,1884,23,45-49,1907,1
STAT,1899,87,na,1986,864.4001479101156
SIM,1944,15,35-39,1959,8
SIM,1959,9,na,1968,6029
SIM,1873,25,35-39,1898,3
SIM,1948,50,na,1998,4284
STAT,1923,42,40-44,1965,0.33725468038240425
STAT,1851,54,20-24,1905,5.690745710061526E-4
SIM,1894,76,na,1970,2443
SIM,1937,30,40-44,1967,2
SIM,1835,41,na,1876,2186
SIM,1944,26,45-49,1970,2
STAT,1952,35,na,1987,5369.670543508332
STAT,1960,41,15-19,2001,0.0024022761905850695
SIM,1918,36,45-49,1954,1
SIM,1916,2,na,1918,4948
SIM,1892,31,50-100,1923,2
STAT,1847,21,25-29,1868,54.388924771982005
STAT,1944,34,25-29,1978,11.685953105905377
SIM,1918,25,35-39,1943,3
STAT,1904,37,35-39,1941,2.5299571604211866
SIM,1827,46,na,1873,1404
STAT,1878,18,na,1896,3035.2698506378038
SIM,1855,21,25-29,1876,54
SIM,1848,16,na,1864,2231
STAT,1870,37,40-44,1907,4.980390830399591
SIM,1919,34,40-44,1953,2
STAT,1850,33,50-100,1883,0.9765155627873888
STAT,1920,16,40-44,1936,1.8146876351247285
STAT,1962,30,25-29,1992,13.946730245372947
STAT,1904,48,45-49,1952,0.21784303846774555
SIM,1952,34,25-29,1986,25
SIM,1870,101,na,1971,33
STAT,1897,19,50-100,1916,0.07519559212714588
STAT,1940,29,15-19,1969,0.8302186787092484
STAT,1911,104,na,2015,5.105417877580262
STAT,1904,51,na,1955,3585.441907433437
STAT,1886,13,na,1899,3138.844385433585
SIM,1969,12,na,1981,5827
STAT,1942,42,20-24,1984,0.022138225875928112
SIM,1954,60,na,2014,5002
SIM,1869,33,20-24,1902,3
SIM,1932,67,na,1999,4517
STAT,1963,17,45-49,1980,0.7324077306891135
SIM,1965,39,25-29,2004,2
STAT,1973,19,25-29,1992,64.63639230882724
SIM,1889,32,35-39,1921,5
STAT,1951,15,30-34,1966,16.75919762923017
STAT,1961,39,45-49,2000,1.0449574877680325
STAT,1786,78,na,1864,510.9050230448321
SIM,1920,10,na,1930,4675
SIM,1873,15,na,1888,3515
STAT,1926,84,na,2010,1912.9634297328307
STAT,1952,16,30-34,1968,16.86147135570102
STAT,1930,27,35-39,1957,22.03409309192872
STAT,1949,43,15-19,1992,0.002138634591179882
STAT,1916,16,20-24,1932,33.28029277038097
STAT,1831,39,na,1870,2070.0272562856735
STAT,1871,47,na,1918,2571.0589576984917
SIM,1806,84,na,1890,105
STAT,1811,52,25-29,1863,0.010541968181203875
STAT,1902,34,20-24,1936,2.509223418970294
SIM,1960,27,40-44,1987,1
STAT,1863,22,20-24,1885,70.92616093481253
SIM,1802,70,na,1872,643
STAT,1905,16,45-49,1921,0.10937761330312958
STAT,1918,89,na,2007,871.140284504602
STAT,1960,35,20-24,1995,0.40891727295523367
STAT,1893,31,50-100,1924,1.3420063402138454
STAT,1972,39,20-24,2011,0.4004383272897294
SIM,1907,76,na,1983,2676
STAT,1980,33,40-44,2013,6.38666907107322
STAT,1915,18,25-29,1933,10.441447085478583
SIM,1912,15,na,1927,4120
SIM,1808,75,na,1883,623
STAT,1866,48,30-34,1914,0.10224224425759473
SIM,1875,9,na,1884,3566
STAT,1987,28,50-100,2015,1.6461342960540635
STAT,1952,27,40-44,1979,6.4739442123473365
SIM,1920,23,25-29,1943,237
SIM,1953,29,na,1982,5245
STAT,1908,22,20-24,1930,118.12229968332576
STAT,1947,26,20-24,1973,23.842625596327473
SIM,1888,16,40-44,1904,1
STAT,1810,77,na,1887,468.0655794894067
STAT,1844,17,15-19,1861,6.30983154151521
SIM,1897,26,35-39,1923,19
SIM,1926,19,35-39,1945,15
STAT,1917,32,15-19,1949,0.1552977729300502
STAT,1999,12,na,2011,6697.084387505454
STAT,1912,23,25-29,1935,101.94154577230726
SIM,1959,39,40-44,1998,7
SIM,1847,35,35-39,1882,13
SIM,1827,54,na,1881,1271
SIM,1975,30,na,2005,6003
SIM,1941,19,30-34,1960,14
SIM,1852,17,15-19,1869,7
SIM,1878,46,na,1924,2707
SIM,1945,24,40-44,1969,6
STAT,1890,18,na,1908,3552.077332790096
STAT,1962,16,45-49,1978,0.7388674101021135
STAT,1829,25,25-29,1854,153.84622083074768
SIM,1960,31,25-29,1991,34
STAT,1877,107,na,1984,0.28978814300192623
STAT,1889,26,35-39,1915,13.773374023371744
SIM,1958,18,50-100,1976,5
STAT,1937,24,40-44,1961,3.77814567609767
SIM,1915,41,45-49,1956,4
SIM,1837,25,25-29,1862,12
SIM,1956,27,20-24,1983,31
STAT,1872,21,na,1893,2748.8977255181835
STAT,1792,98,na,1890,0.9122182216977707
STAT,1958,16,25-29,1974,65.70312479148018
STAT,1899,31,na,1930,3788.3444113994788
SIM,1805,49,50-100,1854,1
SIM,1894,84,na,1978,1314
SIM,1816,62,na,1878,1242
SIM,1966,16,25-29,1982,1
STAT,1825,78,na,1903,552.658704484943
STAT,1918,19,35-39,1937,5.241443995916486
STAT,1957,36,30-34,1993,2.859646091614266
STAT,2005,8,na,2013,6976.978862907953
STAT,1869,18,30-34,1887,1.7953513520566835
STAT,1983,29,25-29,2012,107.81226885926895
STAT,1877,52,na,1929,2570.999225167351
STAT,1931,2,na,1933,6179.2057397822155
STAT,1858,40,40-44,1898,2.045424441208886
STAT,1907,41,45-49,1948,0.17726859470780765
STAT,1912,92,na,2004,452.6538621619838
STAT,1948,27,20-24,1975,24.21163756033959
STAT,1934,45,20-24,1979,0.017861136524065117
STAT,1950,31,15-19,1981,0.1788423519489849
SIM,1933,0,na,1933,6944
STAT,1936,45,30-34,1981,0.10250974769779629
STAT,1866,60,na,1926,2040.037373750595
SIM,1886,33,na,1919,2134
STAT,1943,22,15-19,1965,6.536581680121631
SIM,1907,68,na,1975,3407
STAT,1853,42,na,1895,2298.2811482242428
STAT,1903,36,35-39,1939,2.521514294312075
STAT,1954,44,35-39,1998,0.2975610416872927
SIM,1911,36,35-39,1947,7
SIM,1840,44,na,1884,1916
SIM,1853,62,na,1915,1759
SIM,1857,76,na,1933,770
STAT,1823,39,20-24,1862,0.8493505650492044
SIM,1926,44,25-29,1970,1
SIM,1951,22,15-19,1973,13
SIM,1911,41,na,1952,4717
SIM,1955,26,20-24,1981,32
SIM,1915,55,na,1970,4297
STAT,1952,5,na,1957,5437.56551151083
STAT,1966,41,na,2007,5571.408642621137
STAT,1981,29,15-19,2010,1.1429982180326628
STAT,1910,34,25-29,1944,10.207215860781016
SIM,1932,23,50-100,1955,5
STAT,1918,44,25-29,1962,0.08730932321282202
SIM,1930,30,30-34,1960,53
STAT,1968,26,35-39,1994,21.74406708249227
STAT,1976,32,50-100,2008,1.2993845789123335
SIM,1915,29,30-34,1944,90
STAT,1878,20,15-19,1898,3.998895515914787
STAT,1839,35,35-39,1874,6.843699342451248
STAT,1944,48,na,1992,4732.8070267569
STAT,1905,24,50-100,1929,0.6768773591860842
STAT,1907,29,30-34,1936,42.09530361711553
SIM,1910,32,na,1942,3740
SIM,1916,22,20-24,1938,219
STAT,1871,53,35-39,1924,0.009725584987042988
STAT,1957,37,15-19,1994,0.03010295559000611
STAT,1871,39,na,1910,2677.735288143736
STAT,1923,30,na,1953,5042.022313855057
STAT,1922,30,30-34,1952,20.699747578907136
STAT,1800,100,na,1900,0.572849622341687
STAT,1933,31,45-49,1964,2.4497716298164
STAT,1919,28,40-44,1947,5.790204957248172
SIM,1819,67,na,1886,401
SIM,1948,33,20-24,1981,6
SIM,1870,74,na,1944,1594
STAT,1947,46,45-49,1993,0.29460587320636844
SIM,1829,80,na,1909,187
STAT,1982,24,50-100,2006,1.0713364885687382
SIM,1979,21,15-19,2000,1
STAT,1856,15,40-44,1871,0.19267864868338916
SIM,1924,19,25-29,1943,2
STAT,1835,21,na,1856,1768.472237839297
STAT,1962,35,30-34,1997,2.781321851720912
STAT,1918,41,20-24,1959,0.021695954360263458
STAT,1898,40,50-100,1938,0.11557611369105172
STAT,1949,29,35-39,1978,20.217819943181443
STAT,1857,101,na,1958,0.8565103473228927
SIM,1908,36,30-34,1944,4
STAT,1847,110,na,1957,2.6173884514381384E-4
STAT,1905,29,20-24,1934,19.45525365498957
STAT,1928,61,na,1989,4983.238434501522
SIM,1895,26,25-29,1921,10
SIM,1952,31,20-24,1983,7
STAT,1841,21,30-34,1862,20.2070647233935
STAT,1847,23,50-100,1870,0.38189706006528973
STAT,1916,19,25-29,1935,10.554706273510613
STAT,1952,41,20-24,1993,0.0254186238316233
SIM,1918,20,na,1938,3899
SIM,1927,28,40-44,1955,19
STAT,1856,90,na,1946,69.41512038520698
SIM,1941,31,45-49,1972,2
STAT,1889,40,50-100,1929,1.5180405508556836
STAT,1887,26,25-29,1913,54.89714936019798
STAT,1895,20,45-49,1915,1.0537609168803896
STAT,1912,78,na,1990,2343.5327718142744
SIM,1888,16,na,1904,2989
STAT,1965,46,20-24,2011,0.016602482145820448
STAT,1923,45,45-49,1968,0.2946869892889998
STAT,1924,41,15-19,1965,0.0021104943163405858
STAT,1826,32,45-49,1858,1.6409560393597076
STAT,1975,19,35-39,1994,6.384222606714814
STAT,1955,23,45-49,1978,1.7289040369719453
STAT,1904,97,na,2001,106.11382178407428
SIM,1963,23,45-49,1986,3
STAT,1873,110,na,1983,0.019361595213253827
STAT,1894,56,na,1950,3025.877023353931
STAT,1807,57,na,1864,1455.914140465098
STAT,1931,19,20-24,1950,203.73762784059215
SIM,1834,32,45-49,1866,9
STAT,1844,41,50-100,1885,0.9166641900371332
SIM,1864,54,na,1918,2434
STAT,1915,43,na,1958,4309.030588219469
STAT,1859,90,na,1949,72.47850478851731
STAT,1958,48,30-34,2006,0.1401560179962071
STAT,1901,25,15-19,1926,0.7383779661785723
STAT,1949,23,na,1972,4915.90897241545
STAT,1945,18,40-44,1963,1.7627383292263725
SIM,1860,22,45-49,1882,2
SIM,1923,35,45-49,1958,1
STAT,1942,45,25-29,1987,0.06686715548404171
STAT,1875,21,na,1896,2829.0616057620405
SIM,1888,30,20-24,1918,4
STAT,1841,60,na,1901,1695.6546672513184
SIM,1902,27,25-29,1929,5
SIM,1913,29,20-24,1942,25
STAT,1913,23,40-44,1936,3.9083084175560536
STAT,1850,106,na,1956,0.015674878316681424
STAT,1852,22,45-49,1874,0.781012882936374
STAT,1838,19,40-44,1857,0.206852644769205
STAT,1896,90,na,1986,514.546974158153
STAT,1897,33,30-34,1930,26.828982290689602
SIM,1856,22,25-29,1878,2
SIM,1905,19,20-24,1924,45
SIM,1979,32,25-29,2011,6
SIM,1864,15,40-44,1879,1
STAT,1914,18,na,1932,4600.8365519908
SIM,1856,59,na,1915,1707
STAT,1907,56,na,1963,3642.409416847646
SIM,1953,18,40-44,1971,6
STAT,1902,37,25-29,1939,1.013352826484299
SIM,1961,28,40-44,1989,16
SIM,1851,28,na,1879,2906
STAT,1948,42,15-19,1990,0.002107707982198537
SIM,1891,36,na,1927,3382
STAT,1930,24,30-34,1954,42.230885449988044
STAT,1863,40,50-100,1903,1.0768334298114306
SIM,1961,24,na,1985,4875
STAT,1988,20,na,2008,6051.538335310475
SIM,1902,30,25-29,1932,35
STAT,1953,28,40-44,1981,6.532061659866221
STAT,1971,24,40-44,1995,4.927529149908895
SIM,1990,24,50-100,2014,1
STAT,1970,21,20-24,1991,161.21928125943893
STAT,1901,20,45-49,1921,1.133933851974798
SIM,1871,22,20-24,1893,147
STAT,1860,23,50-100,1883,0.38818584112175847
STAT,1901,36,25-29,1937,1.0093972666037385
STAT,1930,35,40-44,1965,2.2576137938114016
SIM,1837,22,20-24,1859,87
SIM,1938,6,na,1944,4203
STAT,1936,40,25-29,1976,0.08188440353062906
SIM,1960,16,30-34,1976,27
STAT,1902,40,25-29,1942,0.07344782038193494
STAT,1955,43,45-49,1998,0.2645576455777495
SIM,1830,66,na,1896,1108
STAT,1879,45,50-100,1924,0.29890315727115796
STAT,1911,43,30-34,1954,0.14009286177002014
STAT,1937,27,45-49,1964,1.9445386233810968
SIM,1935,38,40-44,1973,6
SIM,1944,48,35-39,1992,1
SIM,1930,33,35-39,1963,30
STAT,1926,37,40-44,1963,2.1109129357273093
STAT,1935,47,35-39,1982,0.21017104128524752
STAT,1849,19,50-100,1868,0.0461915917607391
STAT,1957,39,35-39,1996,3.7835318143613015
STAT,1848,22,25-29,1870,74.06072342083775
SIM,1897,23,30-34,1920,1
STAT,1926,76,na,2002,3321.0615776178693
STAT,1808,47,30-34,1855,0.4839488984943567
SIM,1853,5,na,1858,2981
STAT,1915,35,45-49,1950,0.8024545429103431
SIM,1929,4,na,1933,5608
STAT,1855,37,50-100,1892,1.0446808448585587
STAT,1889,23,30-34,1912,25.260908449453392
STAT,1966,23,20-24,1989,160.75539510031092
STAT,1927,38,40-44,1965,2.1452770815930355
STAT,1836,30,na,1866,2545.314544000009
STAT,1813,77,na,1890,395.7812075101471
STAT,1816,42,na,1858,1550.7464662963941
STAT,1936,26,45-49,1962,1.9100443640456122
SIM,1947,66,na,2013,4950
STAT,1775,86,na,1861,90.97946278353996
STAT,1961,37,35-39,1998,3.715434899429082
STAT,1825,46,50-100,1871,0.347750308841426
SIM,1904,43,35-39,1947,1
STAT,1837,87,na,1924,127.57746000116194
STAT,1884,30,40-44,1914,4.984562290835695
SIM,1936,17,na,1953,4054
SIM,1910,88,na,1998,317
STAT,1833,73,na,1906,835.7903074427549
SIM,1943,47,35-39,1990,1
STAT,1823,50,50-100,1873,0.01495638892381102
STAT,1944,31,20-24,1975,3.0897376986035865
SIM,1897,0,na,1897,4532
SIM,1934,37,40-44,1971,7
STAT,1837,32,20-24,1869,2.4541193233392145
SIM,1872,48,50-100,1920,3
STAT,1822,81,na,1903,444.3065516633328
STAT,1936,15,35-39,1951,4.660545478404533
SIM,1980,18,50-100,1998,1
STAT,1910,31,20-24,1941,2.7280846187236576
SIM,1911,33,30-34,1944,5
STAT,1826,95,na,1921,7.320597239307452
SIM,1957,29,35-39,1986,31
SIM,1845,32,20-24,1877,1
STAT,1922,33,35-39,1955,11.86036117391552
STAT,1918,27,40-44,1945,5.7232911634902655
STAT,1820,55,na,1875,1320.0298008055809
STAT,1951,48,30-34,1999,0.12707204436012448
SIM,1862,7,na,1869,3233
SIM,1950,27,50-100,1977,3
SIM,1902,37,na,1939,3964
SIM,1829,31,25-29,1860,10
STAT,1904,45,40-44,1949,0.16163493409743737
SIM,1936,30,25-29,1966,1
SIM,1974,23,20-24,1997,288
STAT,1824,69,na,1893,908.0442306892602
STAT,1903,33,30-34,1936,16.40993180635344
SIM,1854,37,50-100,1891,1
SIM,1892,30,40-44,1922,1
STAT,1828,28,50-100,1856,0.9289861131724513
STAT,1918,16,30-34,1934,3.078621166916511
SIM,1926,27,40-44,1953,8
SIM,1868,24,15-19,1892,3
STAT,1904,34,30-34,1938,16.4719916736834
STAT,1920,20,25-29,1940,119.16394422825242
STAT,1827,34,na,1861,2314.8324492171846
STAT,1928,30,25-29,1958,13.352049869207088
SIM,1912,45,40-44,1957,1
STAT,1846,37,50-100,1883,1.3254206348761113
SIM,1936,38,35-39,1974,5
STAT,1926,26,30-34,1952,54.381328863703274
STAT,1937,68,na,2005,3522.7935745992904
STAT,1921,32,35-39,1953,11.73185590429808
SIM,1971,29,50-100,2000,6
SIM,1842,37,30-34,1879,5
STAT,1936,48,35-39,1984,0.1471531564489718
STAT,1912,44,30-34,1956,0.14133145260308547
SIM,1820,39,45-49,1859,4
SIM,1884,20,40-44,1904,4
SIM,1878,38,na,1916,2801
STAT,1925,25,30-34,1950,53.753362092575635
STAT,1842,47,30-34,1889,0.07450248957628712
SIM,1912,34,30-34,1946,26
STAT,1920,17,25-29,1937,56.08516310028172
SIM,1908,1,na,1909,4575
STAT,1834,37,30-34,1871,6.049803324539267
SIM,1934,26,30-34,1960,7
SIM,1875,18,20-24,1893,30
STAT,1875,20,50-100,1895,0.48923068870288766
STAT,1928,38,35-39,1966,3.524052009388778
STAT,1849,69,na,1918,1137.4462396791882
STAT,1965,49,25-29,2014,0.07902832612384325
STAT,1919,44,40-44,1963,0.31169618515828923
STAT,1949,26,30-34,1975,52.840785373724565
STAT,1831,49,20-24,1880,0.010836721706386155
STAT,1830,44,35-39,1874,1.6887008153185559
STAT,1914,23,35-39,1937,11.072673102101167
SIM,1931,28,50-100,1959,4
SIM,1968,16,35-39,1984,4
STAT,1849,50,50-100,1899,0.011873876443769004
SIM,1855,10,na,1865,2216
SIM,1923,39,30-34,1962,7
SIM,1922,34,45-49,1956,1
SIM,1918,34,25-29,1952,4
STAT,1830,105,na,1935,0.018393351668774455
STAT,1902,17,na,1919,4118.324106345478
STAT,1924,25,15-19,1949,0.9547604520647388
STAT,1870,46,30-34,1916,0.11044438581275424
STAT,1973,8,na,1981,5865.86914436513
SIM,1922,23,35-39,1945,15
SIM,1927,44,40-44,1971,2
SIM,1957,26,30-34,1983,3
SIM,1934,29,35-39,1963,30
STAT,1855,31,25-29,1886,8.966687247048956
SIM,1893,39,50-100,1932,4
STAT,1917,48,30-34,1965,0.10716116255672078
SIM,1865,15,35-39,1880,1
SIM,1809,89,na,1898,71
STAT,1856,18,45-49,1874,0.06760499458541029
SIM,1856,20,50-100,1876,1
STAT,1959,14,na,1973,5927.64552540211
STAT,1910,19,30-34,1929,2.7751432068835076
STAT,1952,44,25-29,1996,0.10229016925869815
STAT,1855,20,15-19,1875,3.3270229017456723
STAT,1831,38,50-100,1869,1.2015382289969951
STAT,1884,31,50-100,1915,1.0489918047165157
STAT,1914,34,45-49,1948,1.81318315684884
STAT,1963,30,na,1993,5658.64527215084
SIM,1820,67,na,1887,1324
STAT,1938,31,na,1969,4393.388927412761
SIM,1955,53,na,2008,6271
STAT,1894,38,40-44,1932,6.461985818440703
SIM,1960,25,20-24,1985,51
SIM,1913,29,na,1942,4634
STAT,1797,73,na,1870,610.982443582217
STAT,1785,85,na,1870,58.33485667688889
STAT,1844,15,50-100,1859,0.05270904208484368
STAT,1865,48,15-19,1913,4.1126871489402734E-4
STAT,1983,26,20-24,2009,29.942668824258366
STAT,1825,105,na,1930,0.0207393392814429
STAT,1819,47,na,1866,1794.969811887033
STAT,1857,15,35-39,1872,0.586552340227845
STAT,1961,22,50-100,1983,0.9843137280500753
SIM,1860,96,na,1956,4
SIM,1902,24,20-24,1926,9
STAT,1880,72,na,1952,1544.8251262807553
STAT,1968,37,35-39,2005,3.5918692528009966
STAT,1952,25,20-24,1977,25.375816474949527
STAT,1884,86,na,1970,584.6100703877397
STAT,1867,18,20-24,1885,19.41324705276338
STAT,1940,24,45-49,1964,1.3223007967930407
STAT,1944,17,50-100,1961,0.4653173068047378
STAT,1847,65,na,1912,1300.3490114534452
STAT,1838,18,na,1856,2610.891768481947
STAT,1845,17,30-34,1862,1.3574886888082829
STAT,1901,51,na,1952,3497.3073994409983
STAT,1884,65,na,1949,1926.930725267927
SIM,1784,75,na,1859,134
STAT,1950,15,15-19,1965,61.96037261864935
STAT,1888,79,na,1967,1387.7532059115042
SIM,1980,23,40-44,2003,1
STAT,1920,33,25-29,1953,11.629116500015252
SIM,1927,45,na,1972,4938
SIM,1901,26,25-29,1927,127
SIM,1839,15,50-100,1854,1
SIM,1881,58,na,1939,1577
SIM,1976,37,35-39,2013,2
STAT,1894,24,15-19,1918,4.86359274014937
STAT,1956,36,15-19,1992,0.030239448890235287
SIM,1981,21,25-29,2002,314
SIM,1892,22,35-39,1914,14
STAT,1896,109,na,2005,0.11626283130606446
SIM,1901,15,15-19,1916,19
STAT,1976,17,30-34,1993,18.792714742343787
STAT,1936,24,25-29,1960,101.90474997501879
SIM,1934,35,20-24,1969,2
STAT,1853,101,na,1954,0.5681236843424018
STAT,1768,105,na,1873,0.0193092143864172
STAT,1783,81,na,1864,148.6318762994181
STAT,1871,54,50-100,1925,0.016863030035245842
STAT,1910,68,na,1978,3257.228772681284
STAT,1951,27,25-29,1978,90.8436312184558
SIM,1958,8,na,1966,6233
STAT,1951,16,15-19,1967,62.38493688060042
STAT,1813,42,na,1855,1474.5864241239592
STAT,1942,22,20-24,1964,134.5693416553943
STAT,1873,32,30-34,1905,20.576099777574775
STAT,1951,32,15-19,1983,0.18000837653377252
SIM,1926,32,30-34,1958,48
STAT,1868,48,40-44,1916,0.18743590961011736
STAT,1924,23,50-100,1947,0.8930176856249326
SIM,1820,75,na,1895,1118
SIM,1944,24,25-29,1968,5
SIM,1872,84,na,1956,670
STAT,1858,43,45-49,1901,1.3376708499583625
STAT,1860,21,50-100,1881,0.39382080548076986
STAT,1941,29,30-34,1970,46.74252638794853
SIM,1950,22,20-24,1972,2
SIM,1841,29,na,1870,2163
SIM,1907,38,35-39,1945,5
STAT,1879,20,30-34,1899,21.59220473839266
STAT,1941,25,45-49,1966,2.0647773572506374
STAT,1843,18,50-100,1861,0.06244991704615038
SIM,1881,32,30-34,1913,22
STAT,1955,40,40-44,1995,0.3993339134618481
SIM,1946,16,na,1962,4685
STAT,1879,17,30-34,1896,1.9206427731604352
SIM,1933,20,na,1953,6021
STAT,1891,48,50-100,1939,0.1951176278564171
STAT,1926,35,20-24,1961,0.37236151862975336
SIM,1844,66,na,1910,1501
SIM,1866,43,45-49,1909,1
STAT,1847,102,na,1949,0.2255847712044664
SIM,1868,68,na,1936,2136
STAT,1909,82,na,1991,1711.5101446496951
SIM,1917,22,15-19,1939,10
STAT,1975,16,30-34,1991,18.562275555041772
STAT,1892,45,50-100,1937,0.20238513028161925
STAT,1926,29,35-39,1955,20.617568621148695
STAT,1925,42,15-19,1967,0.0021449596950940354
SIM,1917,33,25-29,1950,13
SIM,1849,28,20-24,1877,22
STAT,1916,28,na,1944,4454.791245637526
SIM,1855,29,na,1884,1960
STAT,1911,34,40-44,1945,4.3637468374795025
STAT,1872,19,40-44,1891,0.21081183136932657
SIM,1891,21,35-39,1912,2
STAT,1879,5,na,1884,3267.922927467753
STAT,1884,33,45-49,1917,1.9799518538688379
STAT,1871,19,50-100,1890,0.05594721645316905
SIM,1899,19,20-24,1918,60
STAT,1909,22,15-19,1931,5.715953404709458
STAT,1925,34,20-24,1959,3.337305569027822
SIM,1953,34,40-44,1987,2
STAT,1795,63,na,1858,753.0294523093407
STAT,1945,34,40-44,1979,5.0222177701509025
SIM,1933,34,20-24,1967,5
SIM,1944,12,na,1956,4659
SIM,1958,38,40-44,1996,4
STAT,1824,93,na,1917,18.08324740438152
STAT,1928,53,na,1981,5294.4765306272675
SIM,1969,28,45-49,1997,4
STAT,1938,60,na,1998,4052.925222211363
STAT,1847,45,35-39,1892,0.108797567573334
STAT,1884,22,35-39,1906,6.653736839204352
SIM,1968,27,45-49,1995,3
SIM,1952,22,30-34,1974,91
SIM,1907,19,30-34,1926,4
STAT,1922,0,na,1922,6014.416283098403
SIM,1851,36,na,1887,2810
SIM,1839,25,35-39,1864,21
STAT,1824,106,na,1930,0.007512685174080426
SIM,1933,28,35-39,1961,60
SIM,1898,1,na,1899,4358
STAT,1863,95,na,1958,20.276708571414783
STAT,1897,49,50-100,1946,0.20932034304404182
STAT,1846,91,na,1937,59.90541562191718
STAT,1916,32,20-24,1948,2.906482737401133
STAT,1981,16,50-100,1997,0.6047569309795736
STAT,1944,22,30-34,1966,35.81419079524604
SIM,1823,31,30-34,1854,4
STAT,1870,49,35-39,1919,0.1559557126439783
STAT,1915,39,30-34,1954,2.103786630975808
STAT,1883,21,35-39,1904,6.6086876796093375
SIM,1893,46,na,1939,3323
STAT,1938,40,35-39,1978,0.23900818718085795
SIM,1983,21,35-39,2004,47
SIM,1929,28,15-19,1957,1
SIM,1788,70,na,1858,406
SIM,1903,27,40-44,1930,10
STAT,1876,28,50-100,1904,0.7604532415410405
STAT,1928,35,30-34,1963,2.6627279235442027
SIM,1830,29,50-100,1859,3
STAT,1920,19,45-49,1939,0.6430475920365188
STAT,1929,33,45-49,1962,2.305373793350438
STAT,1974,22,na,1996,5521.179044603102
SIM,1886,20,15-19,1906,4
STAT,1907,4,na,1911,4466.841202097031
STAT,1915,15,20-24,1930,32.9043653508159
STAT,1925,28,35-39,1953,20.38582858463801
SIM,1989,14,na,2003,6748
SIM,1800,79,na,1879,409
STAT,1878,106,na,1984,0.6181389901651588
STAT,1900,69,na,1969,2747.4569050481778
SIM,1868,47,na,1915,2982
STAT,1869,57,na,1926,2245.980306187513
SIM,1820,36,40-44,1856,9
SIM,1943,23,25-29,1966,125
STAT,1953,40,30-34,1993,0.1859971369036405
SIM,1887,47,50-100,1934,1
SIM,1958,27,30-34,1985,74
STAT,1874,87,na,1961,347.6689858019488
SIM,1968,24,40-44,1992,12
STAT,1792,63,na,1855,1285.1756000000003
STAT,1841,19,20-24,1860,20.090406986193855
STAT,1796,77,na,1873,399.61765893987007
STAT,1910,76,na,1986,2514.343370301038
STAT,1890,23,50-100,1913,0.5732566396509797
STAT,1855,15,25-29,1870,5.803203381115863
STAT,1944,19,50-100,1963,0.46500559632471733
STAT,1925,26,15-19,1951,0.9652498418457096
SIM,1936,35,30-34,1971,2
SIM,1857,84,na,1941,328
STAT,1879,47,50-100,1926,0.29457289008148696
SIM,1900,33,na,1933,3674
SIM,1986,14,na,2000,6744
STAT,1935,12,na,1947,6254.469717390937
STAT,1935,23,25-29,1958,145.19134593660766
SIM,1919,25,50-100,1944,2
STAT,1925,37,25-29,1962,1.3633519768386484
STAT,1912,103,na,2015,9.100719010261232
STAT,1917,19,40-44,1936,1.7221071213096026
STAT,1838,30,50-100,1868,1.0070908813296555
STAT,1922,13,na,1935,5281.48251748739
STAT,1902,37,50-100,1939,0.43211232958335277
SIM,1846,30,50-100,1876,1
SIM,1863,15,25-29,1878,14
STAT,1934,71,na,2005,4508.402572616987
STAT,1948,30,na,1978,5097.1280368528305
STAT,1952,28,25-29,1980,91.3769815980408
SIM,1839,36,na,1875,2185
SIM,1852,47,40-44,1899,1
SIM,1906,83,na,1989,1384
STAT,1952,31,25-29,1983,13.036845435526779
SIM,1960,28,25-29,1988,199
SIM,1865,28,na,1893,2983
STAT,1868,34,15-19,1902,0.15654516713386782
SIM,1901,17,35-39,1918,5
STAT,1822,59,na,1881,1725.845955995041
STAT,1968,34,30-34,2002,23.118667466708356
STAT,1806,54,45-49,1860,0.04907368463748151
STAT,1844,47,40-44,1891,0.14252796759189337
STAT,1910,44,20-24,1954,0.019044718140205044
STAT,1918,32,30-34,1950,19.316952089079713
STAT,1935,43,50-100,1978,0.19103519425475915
SIM,1854,6,na,1860,3339
SIM,1876,19,20-24,1895,38
STAT,1920,30,20-24,1950,3.1067433329974983
STAT,1951,32,50-100,1983,1.1581670427276718
SIM,1979,23,35-39,2002,42
SIM,1780,82,na,1862,86
SIM,1834,59,na,1893,1375
SIM,1925,19,40-44,1944,3
SIM,1892,10,na,1902,4122
SIM,1912,15,45-49,1927,2
STAT,1835,77,na,1912,538.7357936764996
STAT,1925,13,na,1938,5513.40389310028
SIM,1902,29,45-49,1931,6
STAT,1943,45,40-44,1988,0.201656015649982
STAT,1820,45,35-39,1865,0.15489381803739485
SIM,1867,54,na,1921,2061
SIM,1981,16,20-24,1997,1
STAT,1973,16,20-24,1989,202.40913708445186
STAT,1870,23,15-19,1893,3.7417814899706334
STAT,1941,38,20-24,1979,0.3225816110951641
SIM,1839,41,35-39,1880,2
STAT,1821,54,40-44,1875,0.017642231540336104
SIM,1834,67,na,1901,1231
STAT,1848,95,na,1943,14.126877869030256
STAT,1904,15,45-49,1919,0.10875667156577375
STAT,1951,18,35-39,1969,5.764656992004561
STAT,1951,24,20-24,1975,153.20865795745854
STAT,1991,17,50-100,2008,0.6196366726786758
STAT,1861,69,na,1930,1407.9717251939762
SIM,1845,11,na,1856,2570
STAT,1832,44,45-49,1876,1.2390305766241174
SIM,1857,22,40-44,1879,5
SIM,1819,59,na,1878,753
SIM,1866,32,35-39,1898,9
SIM,1911,9,na,1920,5201
STAT,1884,57,na,1941,2291.4234400778123
STAT,1883,72,na,1955,1425.9248951280344
STAT,1926,38,25-29,1964,1.3869999209052426
SIM,1960,19,35-39,1979,14
STAT,1847,42,30-34,1889,0.8895509310103523
STAT,1850,77,na,1927,889.8450721074032
STAT,1952,19,35-39,1971,5.7992559313290775
STAT,1895,49,na,1944,3309.7426053412073
SIM,1908,21,na,1929,3940
STAT,1894,64,na,1958,2665.041890474895
STAT,1918,97,na,2015,131.7988705840667
STAT,1941,46,15-19,1987,4.567051533996704E-4
SIM,1831,24,50-100,1855,3
SIM,1990,22,na,2012,5878
STAT,1926,41,25-29,1967,0.10171972978630456
STAT,1919,39,50-100,1958,0.5193065345314718
STAT,1869,43,20-24,1912,0.17620861057309906
STAT,1882,51,45-49,1933,0.01643688053625485
SIM,1946,2,na,1948,4815
SIM,1943,38,na,1981,5334
STAT,1930,38,45-49,1968,1.025288403631308
SIM,1970,0,na,1970,6068
STAT,1954,41,30-34,1995,0.18982265994051667
STAT,1921,17,40-44,1938,1.8392751643533383
STAT,1947,18,15-19,1965,58.977512913339304
STAT,1915,48,20-24,1963,0.01281779339510672
SIM,1909,44,30-34,1953,1
STAT,1879,21,15-19,1900,3.9873882790377686
STAT,1931,42,45-49,1973,0.2566441103614282
SIM,1901,23,20-24,1924,103
SIM,1934,38,25-29,1972,2
STAT,1868,19,20-24,1887,19.77766928906918
STAT,1965,7,na,1972,5663.084765716805
SIM,1818,74,na,1892,989
SIM,1840,44,45-49,1884,4
SIM,1888,33,25-29,1921,20
STAT,1873,94,na,1967,87.45960724935011
SIM,1976,34,30-34,2010,4
STAT,1902,25,na,1927,3917.9330772555163
SIM,1806,49,na,1855,1499
SIM,1887,21,15-19,1908,5
SIM,1955,29,25-29,1984,4
STAT,1849,22,40-44,1871,1.9526971689290336
STAT,1947,29,25-29,1976,85.8483115245761
STAT,1926,27,na,1953,5181.483745771844
STAT,1879,32,25-29,1911,12.342531596556967
SIM,1855,42,30-34,1897,1
SIM,1887,32,25-29,1919,24
STAT,1817,54,20-24,1871,0.0019481485019035287
SIM,1955,18,15-19,1973,128
STAT,1856,39,na,1895,2053.4413069772277
STAT,1892,38,30-34,1930,7.670648246546227
STAT,1949,15,na,1964,4942.8257527324
SIM,1847,77,na,1924,1161
STAT,1940,45,15-19,1985,4.512262569642977E-4
SIM,2005,6,na,2011,6473
SIM,1858,69,na,1927,1780
STAT,1841,47,15-19,1888,3.572479994549683E-4
STAT,1802,109,na,1911,3.396207619774614E-4
STAT,1959,22,na,1981,5530.884487418923
STAT,1848,21,40-44,1869,2.715395590627107
STAT,1902,33,15-19,1935,0.2312339994688977
STAT,1960,30,na,1990,5801.124750268134
SIM,1865,31,35-39,1896,1
STAT,1871,50,30-34,1921,0.0069324904736168666
SIM,1856,21,40-44,1877,8
SIM,1902,43,25-29,1945,2
STAT,1911,21,na,1932,4192.941798064739
STAT,1915,35,na,1950,4428.50613225437
SIM,1900,30,15-19,1930,1
STAT,1955,20,40-44,1975,5.171764239755493
STAT,1914,50,na,1964,4168.881422443234
STAT,1964,30,35-39,1994,13.554785478587606
STAT,1873,35,35-39,1908,8.414528159849555
STAT,1895,33,20-24,1928,4.043377787308625
STAT,1857,31,35-39,1888,9.254105618339038
SIM,1866,80,na,1946,565
SIM,1963,20,40-44,1983,9
SIM,1955,4,na,1959,6584
SIM,1947,12,na,1959,6078
STAT,1858,32,35-39,1890,9.117255734417718
STAT,1880,35,35-39,1915,8.73405724925719
SIM,1881,35,35-39,1916,6
SIM,1923,50,na,1973,5190
STAT,1860,84,na,1944,309.4129135563818
SIM,1813,97,na,1910,8
STAT,1804,60,na,1864,1286.2170900801505
SIM,1837,53,na,1890,1951
SIM,1890,22,25-29,1912,99
SIM,1969,34,30-34,2003,48
STAT,1820,42,30-34,1862,1.421834340032743
STAT,1903,34,50-100,1937,0.8574005983733077
SIM,1919,20,15-19,1939,13
SIM,1961,24,30-34,1985,99
STAT,1805,53,45-49,1858,0.050803726861107526
SIM,1928,20,25-29,1948,160
STAT,1978,21,25-29,1999,146.00789919956372
STAT,1837,26,35-39,1863,9.032740976081824
SIM,1978,34,40-44,2012,12
STAT,1877,28,30-34,1905,30.123075927252156
SIM,1793,71,na,1864,750
SIM,1829,58,na,1887,1277
STAT,1856,20,30-34,1876,18.478517945839318
STAT,1869,2,na,1871,3729.010089476913
STAT,1934,39,35-39,1973,3.8456804873820314
SIM,1936,6,na,1942,4153
STAT,1851,30,na,1881,2010.909596159298
STAT,1868,72,na,1940,1400.2569848985115
STAT,1956,36,na,1992,5924.32647890331
SIM,1962,39,35-39,2001,6
SIM,1888,45,na,1933,2614
STAT,1888,43,50-100,1931,1.4228029969509086
STAT,1900,25,20-24,1925,18.913677891698548
STAT,1953,24,30-34,1977,40.229589341835
STAT,1854,45,35-39,1899,0.1151946829206228
STAT,1894,47,30-34,1941,0.08062842454571091
STAT,1916,81,na,1997,2062.382675171301
STAT,1871,24,15-19,1895,3.7639848268699785
SIM,1885,28,30-34,1913,48
SIM,1924,35,25-29,1959,2
SIM,1918,17,40-44,1935,8
SIM,1905,64,na,1969,3405
STAT,1916,35,25-29,1951,1.174789128995428
STAT,1848,20,50-100,1868,0.5352315709341875
STAT,1814,48,45-49,1862,0.6454345832652031
SIM,1962,42,35-39,2004,1
STAT,1856,45,45-49,1901,0.20985756733375896
STAT,1887,31,15-19,1918,0.18493179430907436
STAT,1963,18,50-100,1981,0.5491300201614696
SIM,1851,17,20-24,1868,42
STAT,1867,21,45-49,1888,0.7599073297584855
STAT,1909,38,30-34,1947,1.9832201295844278
STAT,1825,48,20-24,1873,0.016526383006739663
SIM,1958,53,na,2011,5921
STAT,1843,17,20-24,1860,22.73244194186737
STAT,1959,48,25-29,2007,0.08305969278055428
SIM,1898,77,na,1975,2046
SIM,1885,40,45-49,1925,4
SIM,1949,16,30-34,1965,36
SIM,1831,62,na,1893,1204
SIM,1864,45,45-49,1909,1
STAT,1970,31,50-100,2001,1.2181986872469202
STAT,1968,18,40-44,1986,2.0154820198280095
SIM,1917,38,30-34,1955,3
SIM,1930,63,na,1993,5448
SIM,1892,72,na,1964,2470
STAT,1974,16,15-19,1990,68.40851519217665
STAT,1845,34,15-19,1879,0.11175424987748389
SIM,1923,85,na,2008,2202
SIM,1982,16,15-19,1998,134
STAT,1840,78,na,1918,626.7862866875657
STAT,1927,34,30-34,1961,22.332478946530703
SIM,1910,28,35-39,1938,4
STAT,1960,29,35-39,1989,22.641652033626258
SIM,1951,17,25-29,1968,79
SIM,1822,48,45-49,1870,1
SIM,1919,33,35-39,1952,28
SIM,1928,59,na,1987,5185
STAT,1910,47,25-29,1957,0.0571745438111467
STAT,1852,17,30-34,1869,1.8174847282573252
STAT,1874,25,na,1899,2838.6800493961955
STAT,1919,41,15-19,1960,0.0019228718089584922
STAT,1863,16,35-39,1879,0.6355764232224327
STAT,1889,49,15-19,1938,3.1427695385239296E-4
SIM,1922,68,na,1990,3783
STAT,1964,25,45-49,1989,2.524165367874289
SIM,1889,33,40-44,1922,13
STAT,1875,34,15-19,1909,0.1683806820598733
STAT,1902,28,35-39,1930,15.678429994314595
SIM,1972,25,45-49,1997,9
STAT,1943,17,25-29,1960,53.038004276652956
SIM,1835,43,25-29,1878,3
STAT,1843,44,20-24,1887,0.15991820821582578
STAT,1900,98,na,1998,70.76746054412114
STAT,1964,46,40-44,2010,0.2389596762102197
STAT,1831,43,45-49,1874,1.4161257056886956
STAT,1876,54,30-34,1930,0.00690598554939936
STAT,1827,43,25-29,1870,0.8407594087900593
SIM,1860,17,30-34,1877,7
STAT,1890,15,40-44,1905,0.2591136093089569
STAT,1820,39,30-34,1859,7.236481221812631
SIM,1806,63,na,1869,1041
STAT,1868,70,na,1938,1555.6832543629844
STAT,1882,22,25-29,1904,64.5281121400847
SIM,1907,32,50-100,1939,1
SIM,1890,35,45-49,1925,3
STAT,1817,80,na,1897,427.6728029994422
SIM,1894,28,40-44,1922,15
SIM,1990,15,40-44,2005,6
SIM,1950,25,25-29,1975,218
STAT,1872,46,40-44,1918,0.19895019494646543
STAT,1886,28,40-44,1914,3.633697533272325
STAT,1908,86,na,1994,1124.974509320717
STAT,1922,25,40-44,1947,6.1253621251227885
STAT,1993,18,20-24,2011,225.0362586149557
SIM,1804,82,na,1886,172
SIM,1930,25,40-44,1955,18
STAT,1969,21,15-19,1990,7.701952848720065
SIM,1949,49,30-34,1998,1
STAT,1942,25,25-29,1967,79.80679185031606
SIM,1844,80,na,1924,487
SIM,1895,15,na,1910,3951
STAT,1957,20,50-100,1977,1.0051862348275258
SIM,1871,16,35-39,1887,1
SIM,1821,34,25-29,1855,2
SIM,1861,33,25-29,1894,7
SIM,1954,39,50-100,1993,1
STAT,1849,38,20-24,1887,0.6050447193347881
SIM,1884,23,na,1907,2555
STAT,1888,40,20-24,1928,0.21761560963128826
STAT,1869,46,25-29,1915,0.0645570085509459
SIM,1839,34,na,1873,2182
SIM,1880,46,40-44,1926,1
SIM,1988,18,na,2006,6169
STAT,1908,30,na,1938,4158.306934580672
STAT,1835,43,50-100,1878,0.779930711318742
SIM,1959,38,35-39,1997,8
STAT,1846,111,na,1957,1.2140389647472487E-4
STAT,1864,28,45-49,1892,1.1400752594867734
SIM,1833,21,40-44,1854,3
SIM,1945,23,35-39,1968,35
SIM,1842,31,35-39,1873,5
SIM,1938,51,na,1989,4019
STAT,1899,29,20-24,1928,18.4156829663616
STAT,1819,61,na,1880,1366.4921800145921
STAT,1951,6,na,1957,5402.368142523009
STAT,1819,44,15-19,1863,0.027330311484264992
STAT,1917,47,na,1964,4428.537995904868
SIM,1925,24,20-24,1949,168
STAT,1938,17,na,1955,4192.231484214155
STAT,1894,1,na,1895,4037.9956324470445
STAT,1850,6,na,1856,3138.325657026
SIM,1938,24,50-100,1962,1
STAT,1987,24,30-34,2011,47.475329974216066
STAT,1878,21,20-24,1899,83.28718707879632
STAT,1980,29,35-39,2009,24.133036113240564
STAT,1838,35,40-44,1873,4.67232800800777
SIM,1906,39,25-29,1945,2
SIM,1855,72,na,1927,706
STAT,1917,24,20-24,1941,135.53413650747916
SIM,1857,38,20-24,1895,1
SIM,1980,32,30-34,2012,35
STAT,1859,27,25-29,1886,39.55913901828739
STAT,1908,49,35-39,1957,0.13394382105441813
STAT,1770,112,na,1882,3.6572673213581554E-4
STAT,1827,88,na,1915,111.49080303444951
STAT,1925,21,45-49,1946,1.5584875262648077
SIM,1935,34,30-34,1969,30
STAT,1858,38,30-34,1896,4.774345460367229
STAT,1834,31,35-39,1865,11.961663488075176
STAT,1841,38,na,1879,2220.414283678849
SIM,1883,33,50-100,1916,1
SIM,1867,27,25-29,1894,44
STAT,1867,48,25-29,1915,0.0612835049970483
SIM,1962,36,40-44,1998,3
STAT,1981,27,na,2008,6071.3469079175065
STAT,1954,36,40-44,1990,2.2023040558889666
STAT,1853,33,25-29,1886,10.39307018959481
STAT,1980,32,35-39,2012,14.923351492119453
STAT,1868,27,na,1895,2646.099705044541
SIM,1846,35,40-44,1881,1
STAT,1877,25,50-100,1902,0.7731252713018062
STAT,1950,31,na,1981,5263.558051588037
SIM,1845,39,50-100,1884,4
STAT,1943,3,na,1946,4921.471332971325
STAT,1830,49,40-44,1879,0.15389675189489033
SIM,1816,41,35-39,1857,4
STAT,1858,94,na,1952,17.993185940076426
STAT,1981,20,15-19,2001,8.624437436656194
STAT,1892,32,35-39,1924,14.648136020543763
SIM,1905,10,na,1915,4572
SIM,1876,26,na,1902,2547
SIM,1884,77,na,1961,986
SIM,1921,20,15-19,1941,2
STAT,1895,36,25-29,1931,4.345923869426033
STAT,1897,75,na,1972,2133.061992607619
SIM,1940,39,50-100,1979,1
SIM,1942,39,35-39,1981,2
STAT,1837,26,50-100,1863,0.5988411754789509
STAT,1916,85,na,2001,1431.4390951938105
STAT,1840,38,45-49,1878,1.8718978679541167
STAT,1937,23,35-39,1960,10.58399054746127
SIM,1813,43,na,1856,1410
SIM,1868,38,40-44,1906,7
STAT,1889,24,na,1913,3343.3834541392353
STAT,1809,102,na,1911,0.13626179383791723
SIM,1956,26,15-19,1982,1
STAT,1839,99,na,1938,1.5019308317653566
STAT,1970,43,30-34,2013,0.19163286514676572
STAT,1928,46,40-44,1974,0.23273042506881103
STAT,1995,1,na,1996,6577.815013437241
STAT,1776,79,na,1855,384.7481099999999
STAT,1914,20,30-34,1934,32.727562790037965
STAT,1948,26,15-19,1974,0.936783233567162
STAT,1826,41,na,1867,1513.4603818715775
STAT,1949,38,25-29,1987,1.3601077400224888
SIM,1957,38,25-29,1995,2
STAT,1862,39,35-39,1901,6.81921729297861
STAT,1858,2,na,1860,3149.5276245735076
STAT,1893,71,na,1964,2234.388992421405
SIM,1922,76,na,1998,2934
SIM,1804,80,na,1884,172
SIM,1870,39,35-39,1909,8
SIM,1914,25,na,1939,4171
SIM,1925,62,na,1987,4720
STAT,1938,35,45-49,1973,0.8013198918415066
SIM,1845,23,30-34,1868,26
SIM,1936,37,50-100,1973,2
STAT,1837,23,30-34,1860,16.763743224573158
STAT,1805,50,40-44,1855,0.03920250373827532
STAT,1934,36,30-34,1970,2.9066189250996755
STAT,1846,29,40-44,1875,3.6927105247097405
STAT,1872,103,na,1975,2.550292651026512
SIM,1967,24,25-29,1991,286
SIM,1842,54,na,1896,1876
STAT,1786,104,na,1890,0.05808377317545089
STAT,1877,87,na,1964,421.2341103824851
SIM,1852,41,50-100,1893,2
STAT,1835,37,25-29,1872,2.221970654659722
STAT,1919,47,45-49,1966,0.27198354582513745
STAT,1809,69,na,1878,831.7214500360012
SIM,1925,19,na,1944,5171
STAT,1866,42,35-39,1908,1.9345737395472387
STAT,1919,27,35-39,1946,18.71655210569141
SIM,1864,32,25-29,1896,20
STAT,1995,18,30-34,2013,20.355313850977705
SIM,1939,19,50-100,1958,1
SIM,1927,27,35-39,1954,35
SIM,1983,22,40-44,2005,14
SIM,1868,90,na,1958,84
STAT,1853,52,50-100,1905,0.014956536750199239
STAT,1864,35,50-100,1899,1.2771321608379798
SIM,1874,42,35-39,1916,6
SIM,1817,55,na,1872,1233
SIM,1909,23,25-29,1932,109
SIM,1981,15,50-100,1996,1
STAT,1856,23,35-39,1879,5.924281524921211
STAT,1856,32,25-29,1888,9.128505097634852
STAT,1938,64,na,2002,3854.345663992165
STAT,1871,9,na,1880,3093.703878450558
SIM,1953,37,45-49,1990,1
SIM,1969,45,na,2014,5697
STAT,1898,20,35-39,1918,9.15578809359861
STAT,1843,19,na,1862,2908.7647274185056
STAT,1932,39,50-100,1971,0.649790954859032
STAT,1900,28,25-29,1928,67.50117640689726
SIM,1846,38,45-49,1884,1
SIM,1963,42,na,2005,6473
STAT,1971,21,15-19,1992,7.8090016850318404
STAT,1770,110,na,1880,9.312770408308275E-4
SIM,1983,19,25-29,2002,4
STAT,1924,17,na,1941,5056.996133976543
STAT,1972,19,45-49,1991,0.7376307418201837
SIM,1984,28,30-34,2012,145
STAT,1962,46,30-34,2008,0.13745141520407184
SIM,1885,34,25-29,1919,17
STAT,1978,15,30-34,1993,19.2071674272351
SIM,1843,37,25-29,1880,6
SIM,1961,27,35-39,1988,25
SIM,1877,53,na,1930,2840
STAT,1897,21,na,1918,3660.6049104070353
STAT,1877,34,25-29,1911,12.190411645139687
STAT,1953,27,35-39,1980,21.050348218449617
STAT,1858,48,15-19,1906,3.5558925017824136E-4
SIM,1861,27,30-34,1888,54
STAT,1945,37,45-49,1982,0.8854090303433939
SIM,1847,85,na,1932,470
STAT,1848,24,45-49,1872,0.8892418337844328
STAT,1849,44,15-19,1893,0.01055908208169434
STAT,1924,29,25-29,1953,87.78626869834537
STAT,1908,46,30-34,1954,0.09386070374693012
STAT,1961,18,30-34,1979,18.167695505539676
STAT,1838,38,45-49,1876,2.062488095718037
STAT,1864,39,45-49,1903,2.033497261820618
SIM,1956,33,50-100,1989,3
STAT,1939,16,na,1955,4254.856406331673
SIM,1898,43,35-39,1941,1
STAT,1960,26,30-34,1986,59.1756519237818
STAT,1853,27,30-34,1880,29.04430300213172
STAT,1902,79,na,1981,1913.9774498059676
SIM,1893,17,25-29,1910,22
STAT,1957,33,50-100,1990,1.2815364260413429
STAT,1905,44,na,1949,3821.558174283474
SIM,1965,33,50-100,1998,2
SIM,1811,93,na,1904,4
STAT,1826,43,50-100,1869,0.7801492749992297
SIM,1854,29,40-44,1883,6
SIM,1822,79,na,1901,340
STAT,1885,17,25-29,1902,6.523023593593765
STAT,1979,31,15-19,2010,0.2082579983757475
STAT,1961,38,40-44,1999,2.2971978159198483
SIM,1931,17,15-19,1948,1
STAT,1864,25,40-44,1889,3.1197462935195315
SIM,1834,43,50-100,1877,1
STAT,1931,27,15-19,1958,1.0520476598236437
STAT,1946,29,45-49,1975,2.218677744167599
SIM,1772,87,na,1859,102
SIM,1903,83,na,1986,1288
SIM,1921,40,na,1961,5224
STAT,1923,17,15-19,1940,61.47745362683375
STAT,1886,16,50-100,1902,0.05978483294819736
SIM,1969,37,35-39,2006,13
STAT,1860,21,35-39,1881,5.635575066823395
STAT,1809,47,25-29,1856,0.1478678487174711
STAT,1844,60,na,1904,1595.208221188945
STAT,1854,39,40-44,1893,3.5304447261170107
STAT,1941,22,40-44,1963,4.011001334890015
STAT,1831,40,40-44,1871,2.2116647879821807
SIM,1932,29,25-29,1961,13
STAT,1893,35,20-24,1928,1.135130615435775
STAT,1962,34,na,1996,5693.15659158175
SIM,1872,25,40-44,1897,11
STAT,1967,34,15-19,2001,0.18858421362738276
SIM,1951,17,na,1968,5895
STAT,1829,30,15-19,1859,0.199801892360994
STAT,1880,0,na,1880,4411.07324402499
SIM,1926,35,35-39,1961,6
SIM,1963,36,na,1999,6492
SIM,1940,19,15-19,1959,2
STAT,1875,28,20-24,1903,13.941627174866463
SIM,1886,46,35-39,1932,1
SIM,1888,21,30-34,1909,23
STAT,1884,38,15-19,1922,0.06371102789954528
STAT,1936,21,20-24,1957,122.79732500887938
STAT,1932,19,15-19,1951,68.99653107630515
SIM,1859,22,15-19,1881,2
STAT,1854,20,20-24,1874,66.92338762782404
STAT,1859,24,20-24,1883,64.78892648067438
SIM,1849,19,30-34,1868,6
SIM,1967,29,50-100,1996,1
STAT,1863,30,15-19,1893,0.14486015223177495
STAT,1838,52,25-29,1890,0.0030523704651918156
STAT,1893,111,na,2004,0.017842364923352783
STAT,1980,26,30-34,2006,63.07349582001591
STAT,1935,28,30-34,1963,61.64256047707976
STAT,1941,45,30-34,1986,0.11076753650751144
STAT,1882,35,45-49,1917,2.268428986305072
STAT,1972,12,na,1984,5804.257626283911
SIM,1944,21,20-24,1965,287
STAT,1947,20,25-29,1967,120.55631287958313
STAT,1878,46,35-39,1924,0.16917273153549114
SIM,1987,17,35-39,2004,7
STAT,1862,51,25-29,1913,0.003466186564656752
STAT,1810,49,50-100,1859,0.9153567129325484
SIM,1833,31,na,1864,1781
SIM,1791,90,na,1881,39
SIM,1896,96,na,1992,264
STAT,1901,17,20-24,1918,28.65786499346215
SIM,1828,39,40-44,1867,11
SIM,1938,37,na,1975,4074
SIM,1837,30,15-19,1867,1
STAT,1918,35,35-39,1953,2.9694531398733375
STAT,1930,43,na,1973,5631.172037135947
STAT,1890,18,45-49,1908,0.09187124878238953
STAT,1935,48,40-44,1983,0.256294673004164
STAT,1962,38,na,2000,5725.56148122329
SIM,1935,37,35-39,1972,4
SIM,1977,28,30-34,2005,90
SIM,1863,20,15-19,1883,5
STAT,1913,31,na,1944,4362.570182940198
STAT,1828,49,40-44,1877,0.1535622772196092
STAT,1823,107,na,1930,0.0026705872524330028
STAT,1949,58,na,2007,4865.349839929922
SIM,1819,36,35-39,1855,4
SIM,1914,24,45-49,1938,5
STAT,1945,17,35-39,1962,5.289907451882381
STAT,1877,40,45-49,1917,1.8147627909490214
STAT,1977,38,30-34,2015,2.9249297036739743
SIM,1955,20,25-29,1975,5
STAT,1976,28,30-34,2004,60.64374535628679
SIM,1883,28,20-24,1911,13
STAT,1862,43,50-100,1905,1.0214800978949332
STAT,1899,32,45-49,1931,2.757105710362589
STAT,1928,16,45-49,1944,0.7281683925415691
SIM,1783,79,na,1862,456
STAT,1906,24,45-49,1930,1.1661559231750953
STAT,1843,47,25-29,1890,0.057525301060906794
STAT,1881,38,na,1919,2609.499116577181
STAT,1790,86,na,1876,74.09483440761716
STAT,1871,90,na,1961,170.5606878973325
STAT,1910,105,na,2015,2.7403713980711073
STAT,1824,49,50-100,1873,0.32490548870472025
SIM,1917,67,na,1984,4282
STAT,1883,112,na,1995,0.004343585019890911
SIM,1913,100,na,2013,206
STAT,1949,35,20-24,1984,0.36514189794929003
STAT,1927,37,35-39,1964,3.46972179873178
STAT,1855,48,50-100,1903,0.20635410464372494
STAT,1953,41,15-19,1994,0.0022312285150431223
SIM,1827,27,30-34,1854,2
SIM,1830,34,35-39,1864,5
SIM,1970,20,na,1990,6021
STAT,1861,27,25-29,1888,40.87914229766732
SIM,1888,42,50-100,1930,3
SIM,1878,36,50-100,1914,1
STAT,1967,23,15-19,1990,7.696546377975092
SIM,1912,44,na,1956,3636
SIM,1943,28,30-34,1971,8
STAT,1836,49,35-39,1885,0.13001069225688605
SIM,1836,49,40-44,1885,1
SIM,1838,42,25-29,1880,2
SIM,1986,17,40-44,2003,4
STAT,1828,30,20-24,1858,3.337663825814701
STAT,1987,27,35-39,2014,24.84172083516133
STAT,1837,40,15-19,1877,0.012106410550208549
SIM,2001,1,na,2002,7338
STAT,1986,17,35-39,2003,6.900111531466937
STAT,1822,34,35-39,1856,29.050406358750337
STAT,1864,88,na,1952,141.4627192997922
SIM,1823,34,35-39,1857,25
SIM,1845,26,35-39,1871,11
SIM,1952,25,35-39,1977,1
STAT,1972,35,35-39,2007,3.688437440488755
SIM,1867,24,20-24,1891,152
SIM,1936,74,na,2010,2274
STAT,1867,45,20-24,1912,0.013058766802135477
STAT,1917,15,30-34,1932,3.0411265230168136
SIM,1912,8,na,1920,4233
SIM,1975,23,15-19,1998,1
STAT,1919,28,na,1947,4653.674422164024
STAT,1876,28,15-19,1904,0.5393523094111462
STAT,1891,38,15-19,1929,0.07969700472241449
STAT,1959,24,25-29,1983,139.80436222663437
SIM,1949,19,35-39,1968,17
STAT,1810,48,na,1858,1646.5085562578065
STAT,1950,19,25-29,1969,59.09317703269685
SIM,1901,52,na,1953,3652
STAT,1827,37,30-34,1864,7.794371956295179
STAT,1851,38,20-24,1889,0.6114431359530428
SIM,1929,30,25-29,1959,16
STAT,1988,20,25-29,2008,153.06901715203904
STAT,1945,31,15-19,1976,0.165226721488756
STAT,1874,54,20-24,1928,8.478385422045198E-4
STAT,1862,22,na,1884,2357.962344697617
SIM,1903,23,30-34,1926,72
STAT,1928,49,45-49,1977,0.3181485513945816
STAT,1883,28,15-19,1911,0.5104688401944458
SIM,1836,30,20-24,1866,6
SIM,1928,39,45-49,1967,2
STAT,1864,48,50-100,1912,0.2498965365470454
SIM,1892,38,15-19,1930,3
SIM,1891,28,15-19,1919,1
STAT,1812,45,30-34,1857,0.2320213233508401
SIM,1941,21,50-100,1962,1
SIM,1927,43,na,1970,4988
STAT,1965,40,45-49,2005,0.2498849793427471
SIM,1835,37,30-34,1872,5
SIM,1865,50,na,1915,2692
SIM,1942,36,30-34,1978,2
SIM,1843,39,na,1882,1852
SIM,1882,19,15-19,1901,6
SIM,1881,66,na,1947,1166
STAT,1969,34,25-29,2003,13.564401055694505
STAT,1920,67,na,1987,3936.22952515053
SIM,1847,19,20-24,1866,26
SIM,1871,59,na,1930,1738
SIM,1962,20,25-29,1982,158
STAT,1947,43,40-44,1990,0.33737472947264957
STAT,1939,22,50-100,1961,0.7629247075887511
STAT,1972,16,40-44,1988,2.067329923462087
STAT,1878,24,25-29,1902,68.54660110052215
STAT,1933,21,50-100,1954,1.0107390170233788
STAT,1835,34,20-24,1869,2.1045012861484294
STAT,1846,34,30-34,1880,20.891655962914296
STAT,1959,16,50-100,1975,0.5657299425463537
STAT,1860,27,30-34,1887,23.672861111563527
SIM,1955,43,40-44,1998,1
SIM,1948,36,25-29,1984,3
SIM,1858,30,40-44,1888,15
SIM,1938,24,40-44,1962,10
STAT,1863,113,na,1976,2.9642310050479945E-4
SIM,1951,38,30-34,1989,5
STAT,1808,84,na,1892,169.6213463653853
STAT,1943,38,30-34,1981,2.295796791127392
STAT,1850,24,45-49,1874,0.8492788990464201
SIM,1850,51,na,1901,1410
SIM,1843,34,20-24,1877,1
SIM,1873,30,50-100,1903,1
STAT,1831,61,na,1892,1466.069948720937
STAT,1835,30,50-100,1865,0.7439025025495731
SIM,1900,15,20-24,1915,30
STAT,1877,45,15-19,1922,4.849647295538363E-4
STAT,1950,28,50-100,1978,1.363414460829799
STAT,1954,20,25-29,1974,132.3070806328678
STAT,1957,10,na,1967,5978.553411521046
STAT,1847,57,na,1904,1546.3193181021768
STAT,1919,24,30-34,1943,36.08439125993935
STAT,1944,25,35-39,1969,18.743529581214904
STAT,1972,24,35-39,1996,13.9495071805055
STAT,1950,16,20-24,1966,185.0505349001887
SIM,1982,32,40-44,2014,16
SIM,1899,51,na,1950,3657
STAT,1952,24,15-19,1976,7.381109598672288
STAT,1893,47,15-19,1940,3.276007724401658E-4
STAT,1824,34,45-49,1858,2.9255742060951886
STAT,1883,19,na,1902,2836.349625009688
SIM,1891,22,40-44,1913,4
SIM,1897,41,na,1938,3696
STAT,1930,1,na,1931,6231.538899065221
STAT,1908,3,na,1911,4531.442793540865
SIM,1927,24,30-34,1951,55
SIM,1845,35,25-29,1880,5
STAT,1857,64,na,1921,1562.4551028481114
STAT,1978,28,50-100,2006,1.5736650591926518
STAT,1975,22,50-100,1997,1.0050884892146759
STAT,1783,109,na,1892,9.370059138458336E-4
STAT,1895,27,50-100,1922,0.9609407725855442
STAT,1903,63,na,1966,3217.0852752832147
STAT,1974,32,40-44,2006,6.011056069156181
STAT,1872,24,30-34,1896,20.511697292554057
SIM,1872,36,40-44,1908,2
STAT,1885,110,na,1995,0.03183929724137932
SIM,1925,33,na,1958,5346
SIM,1932,26,20-24,1958,30
STAT,1946,26,40-44,1972,5.994552785207158
STAT,1883,22,40-44,1905,2.3528124841305074
STAT,1939,19,25-29,1958,50.04671853785089
SIM,1909,28,50-100,1937,4
STAT,1936,50,na,1986,4166.849126084859
STAT,1837,35,25-29,1872,2.591677113444483
STAT,1853,96,na,1949,8.549039297859066
STAT,1934,48,25-29,1982,0.08509460882644908
SIM,1983,9,na,1992,7024
SIM,1825,32,50-100,1857,2
STAT,1857,35,45-49,1892,1.8087837661806665
STAT,1834,39,na,1873,2381.273028459912
STAT,1855,52,na,1907,1822.367471903305
STAT,1875,33,50-100,1908,1.088099010769466
STAT,1787,97,na,1884,0.7806539475256242
SIM,1935,40,na,1975,6247
STAT,1899,35,15-19,1934,0.08962751277074897
SIM,1993,19,na,2012,6068
STAT,1954,39,45-49,1993,0.9998693580784006
SIM,1862,20,20-24,1882,1
STAT,1906,29,na,1935,3987.506136746347
SIM,1899,25,50-100,1924,1
SIM,1910,40,25-29,1950,1
STAT,1839,19,20-24,1858,18.175989686740003
SIM,1880,49,45-49,1929,1
STAT,1821,33,15-19,1854,0.5754751003119517
STAT,1912,20,20-24,1932,123.83248204723583
STAT,1930,34,50-100,1964,1.2299496841321416
STAT,1913,26,45-49,1939,1.9944541538018064
SIM,1949,43,na,1992,5801
STAT,1924,26,20-24,1950,24.605168239350338
SIM,1965,20,50-100,1985,2
SIM,1964,35,na,1999,5880
STAT,1970,15,35-39,1985,6.065095382620298
STAT,1841,24,35-39,1865,6.478460045581856
STAT,1842,34,na,1876,1973.2815109441278
SIM,1866,38,30-34,1904,5
SIM,1959,35,30-34,1994,7
STAT,1789,78,na,1867,250.38487979909306
STAT,1804,62,na,1866,1193.7889640514718
STAT,1864,36,40-44,1900,4.532471439921031
STAT,1832,27,na,1859,1944.8711179302222
SIM,1828,45,35-39,1873,1
SIM,1972,36,na,2008,5753
SIM,1921,26,45-49,1947,3
STAT,1871,43,20-24,1914,0.18102026405262192
STAT,1944,17,40-44,1961,1.737185034510975
STAT,1960,38,25-29,1998,1.5231655175669312
STAT,1856,37,na,1893,2074.318399006403
STAT,1853,44,15-19,1897,0.013563738480125096
SIM,1920,20,20-24,1940,266
STAT,1778,80,na,1858,323.7469247126955
STAT,1922,48,na,1970,4854.989029989007
STAT,1926,45,50-100,1971,0.32351928399247576
STAT,1946,39,50-100,1985,0.5524844154250389
SIM,1828,42,na,1870,2315
STAT,1911,27,30-34,1938,44.135406344859085
SIM,1980,31,na,2011,5818
STAT,1956,37,20-24,1993,0.41472736416198464
SIM,1838,25,40-44,1863,1
SIM,1828,44,30-34,1872,2
STAT,1915,32,40-44,1947,4.600360662762453
STAT,1894,25,20-24,1919,17.52214281930115
STAT,1905,2,na,1907,4452.5112995195195
STAT,1843,23,15-19,1866,4.125118198067281
STAT,1971,27,45-49,1998,2.5361041027223674
STAT,1872,49,45-49,1921,0.2677673229298633
SIM,1954,34,35-39,1988,28
STAT,1920,44,50-100,1964,0.1491743189106702
SIM,1934,34,15-19,1968,3
STAT,1891,113,na,2004,0.002191580056570928
STAT,1863,54,45-49,1917,0.014241906961408419
STAT,1971,32,15-19,2003,0.1914602846461549
SIM,1824,35,na,1859,1693
STAT,1812,48,35-39,1860,0.3192472350898819
SIM,1815,42,50-100,1857,2
STAT,1928,39,na,1967,5475.287708495063
STAT,1836,46,30-34,1882,0.09341542005957162
SIM,1954,26,40-44,1980,17
STAT,1921,30,15-19,1951,0.16630045489211862
STAT,1876,20,40-44,1896,2.500772412264403
STAT,1966,26,25-29,1992,95.32793408298181
SIM,1983,28,na,2011,6716
STAT,1902,25,30-34,1927,41.34089134657832
SIM,1890,44,35-39,1934,2
STAT,1847,46,40-44,1893,0.13210459251650017
SIM,1843,43,50-100,1886,4
STAT,1893,2,na,1895,3888.447571297346
STAT,1900,13,na,1913,4129.1055627574415
SIM,1950,32,na,1982,4656
STAT,1897,36,35-39,1933,10.966996235847057
STAT,1843,64,na,1907,1744.2357431503096
SIM,1911,19,na,1930,5139
SIM,1838,33,35-39,1871,18
STAT,1872,25,35-39,1897,11.257056499308371
SIM,1904,38,45-49,1942,4
STAT,1853,71,na,1924,1328.9528394263773
STAT,1819,90,na,1909,52.485144549186266
SIM,1910,25,30-34,1935,87
STAT,1882,44,35-39,1926,2.0136244062862545
STAT,1846,35,35-39,1881,7.795866069225234
SIM,1929,55,na,1984,4965
SIM,1869,36,25-29,1905,3
STAT,1962,49,35-39,2011,0.19713804194829368
SIM,1864,23,35-39,1887,9
SIM,1883,20,50-100,1903,1
SIM,1844,23,15-19,1867,3
STAT,1837,39,50-100,1876,1.0601772760526593
SIM,1915,3,na,1918,5112
SIM,1880,22,30-34,1902,2
SIM,1899,22,na,1921,4146
SIM,1869,27,35-39,1896,14
STAT,1986,24,15-19,2010,8.776360681866496
STAT,1906,29,15-19,1935,0.7580658054313909
STAT,1939,49,20-24,1988,0.01320613812155971
STAT,1912,47,35-39,1959,0.1431318179590834
STAT,1917,18,35-39,1935,1.0393731021873982
SIM,1839,45,45-49,1884,1
SIM,1919,48,na,1967,5252
SIM,1925,18,35-39,1943,16
STAT,1939,16,20-24,1955,156.72151169506745
STAT,1862,36,30-34,1898,5.215631414364854
STAT,1898,15,45-49,1913,0.10235558552123708
STAT,1974,24,na,1998,5517.425280548945
SIM,1914,70,na,1984,3058
SIM,1947,16,20-24,1963,5
STAT,1896,76,na,1972,2000.3721100009705
SIM,1854,35,35-39,1889,3
SIM,1928,36,40-44,1964,4
SIM,1923,32,40-44,1955,7
STAT,1852,53,30-34,1905,0.0055220346337010486
STAT,1858,49,na,1907,1983.2092501982743
SIM,1854,34,30-34,1888,47
SIM,1879,31,50-100,1910,2
STAT,1888,25,na,1913,3259.461045806604
SIM,1957,57,na,2014,5913
STAT,1841,28,50-100,1869,0.7013357154079963
STAT,1868,35,20-24,1903,0.8628094064998341
STAT,1854,27,na,1881,2038.2532136156135
STAT,1946,34,35-39,1980,11.907641087612188
SIM,1875,27,na,1902,3356
STAT,1926,34,15-19,1960,0.17905282806485623
STAT,1886,69,na,1955,1786.4569238596034
SIM,1835,21,15-19,1856,5
SIM,1883,78,na,1961,1019
SIM,1896,26,40-44,1922,14
STAT,1888,26,40-44,1914,4.077651462199141
STAT,1873,46,50-100,1919,0.29025887295400055
SIM,1905,27,15-19,1932,2
STAT,1861,24,20-24,1885,66.95079343592994
STAT,1806,72,na,1878,568.134360426263
SIM,1938,25,45-49,1963,2
SIM,1886,24,25-29,1910,5
SIM,1922,20,30-34,1942,49
SIM,1937,5,na,1942,4537
STAT,1864,34,na,1898,2437.901539724223
SIM,1977,31,20-24,2008,9
SIM,1882,11,na,1893,3564
STAT,1906,49,50-100,1955,0.2282751697513897
SIM,1907,39,40-44,1946,7
STAT,1959,49,na,2008,5734.731507705004
STAT,1900,40,15-19,1940,0.001551168188012328
SIM,1830,28,40-44,1858,4
SIM,1991,3,na,1994,6718
STAT,1928,37,50-100,1965,0.6123358905610046
STAT,1908,43,50-100,1951,0.12484109230016341
STAT,1966,27,na,1993,5423.134769274372
SIM,1844,37,40-44,1881,6
STAT,1891,15,35-39,1906,0.7862700569976775
SIM,1876,35,20-24,1911,2
SIM,1886,21,20-24,1907,143
STAT,1811,73,na,1884,635.6869149192589
SIM,1896,11,na,1907,4044
SIM,1826,61,na,1887,1320
STAT,1865,22,30-34,1887,18.77260422975861
STAT,1955,28,15-19,1983,1.085682020918032
SIM,1836,33,25-29,1869,17
SIM,1907,31,45-49,1938,4
STAT,1958,37,30-34,1995,2.8460959343474794
STAT,1925,29,40-44,1954,6.305857534624496
SIM,1934,1,na,1935,6216
SIM,1866,15,15-19,1881,11
STAT,1814,45,40-44,1859,0.49166092280610624
STAT,1934,73,na,2007,4233.375442276035
SIM,1903,26,35-39,1929,39
STAT,1972,21,30-34,1993,42.6226625570206
SIM,1837,24,na,1861,2551
STAT,1848,41,na,1889,2484.3587316017606
SIM,1891,25,45-49,1916,5
SIM,1963,28,15-19,1991,1
SIM,1880,24,30-34,1904,3
STAT,1933,36,15-19,1969,0.030226477672750572
STAT,1775,94,na,1869,5.481483078784902
STAT,1836,37,40-44,1873,4.891690507343518
STAT,1968,27,50-100,1995,1.4409118081239898
STAT,1848,29,15-19,1877,0.5672677451460044
STAT,1836,23,15-19,1859,3.935311639820863
STAT,1892,44,na,1936,3309.3211377163893
STAT,1968,23,30-34,1991,41.55120733191941
SIM,1828,42,30-34,1870,1
SIM,1904,49,na,1953,3896
SIM,1868,46,50-100,1914,3
STAT,1828,33,25-29,1861,11.436609784440634
SIM,1859,38,30-34,1897,4
SIM,1875,41,na,1916,3097
SIM,1853,23,25-29,1876,4
STAT,1858,15,15-19,1873,6.315266818255425
SIM,1869,24,30-34,1893,50
SIM,1979,24,40-44,2003,16
STAT,1845,23,25-29,1868,47.54482608021445
SIM,1974,13,na,1987,6404
STAT,1826,37,15-19,1863,0.0449961797106288
SIM,1854,32,30-34,1886,31
STAT,1951,19,40-44,1970,1.9208798985691087
SIM,1839,42,40-44,1881,4
SIM,1913,21,25-29,1934,1
SIM,1976,23,30-34,1999,106
STAT,1850,53,20-24,1903,7.474512232304102E-4
SIM,1839,41,50-100,1880,1
STAT,1840,53,na,1893,1699.541160434209
STAT,1934,15,25-29,1949,67.9926159445898
SIM,1901,18,40-44,1919,2
SIM,1862,23,na,1885,2880
STAT,1903,37,40-44,1940,1.553115533579303
SIM,1936,25,na,1961,4011
SIM,1815,43,na,1858,1995
SIM,1862,23,25-29,1885,80
STAT,1829,38,na,1867,1983.5735444238476
STAT,1876,23,45-49,1899,0.8293193507915494
STAT,1883,25,45-49,1908,1.2621397595001558
STAT,1832,31,25-29,1863,9.40745496755967
STAT,1944,43,50-100,1987,0.1513934428182701
SIM,1933,29,40-44,1962,14
STAT,1830,46,na,1876,1534.2362892281842
STAT,1966,31,50-100,1997,1.2154955839161465
STAT,1933,19,30-34,1952,18.737288150321962
STAT,1970,35,na,2005,5609.0817195447435
SIM,1926,18,na,1944,6110
SIM,1911,37,40-44,1948,3
SIM,1930,28,45-49,1958,3
STAT,1852,27,15-19,1879,0.4982260170417243
STAT,1982,18,45-49,2000,0.8109566750479474
STAT,1922,28,45-49,1950,2.247123189299215
SIM,1918,22,30-34,1940,42
SIM,1941,28,20-24,1969,18
STAT,1824,91,na,1915,35.85528115126987
STAT,1874,19,15-19,1893,6.973758137030051
STAT,1854,23,25-29,1877,54.40435943873793
SIM,1847,31,na,1878,2641
SIM,1931,48,na,1979,6049
STAT,1957,48,15-19,2005,5.813844126098661E-4
STAT,1981,18,15-19,1999,73.21229055094243
STAT,1883,49,20-24,1932,0.013266212906831117
SIM,1840,31,25-29,1871,4
SIM,1938,30,35-39,1968,27
STAT,1933,28,20-24,1961,27.97015512712401
SIM,1923,52,na,1975,5156
STAT,1921,16,35-39,1937,5.531377047350509
STAT,1974,35,45-49,2009,1.0602063966942845
STAT,1845,45,na,1890,1531.1807768699646
STAT,1964,49,45-49,2013,0.32666409991526285
SIM,2002,0,na,2002,6952
SIM,1827,33,25-29,1860,2
STAT,1863,25,25-29,1888,43.30644159215382
STAT,1833,37,15-19,1870,0.04979583795707944
SIM,1978,27,na,2005,5739
SIM,1838,30,30-34,1868,46
SIM,1854,4,na,1858,3366
SIM,1892,28,30-34,1920,43
SIM,1967,35,na,2002,5710
STAT,1908,25,25-29,1933,73.00041487614905
STAT,1970,24,25-29,1994,133.78964522808124
STAT,1928,24,30-34,1952,41.1528092390048
STAT,1907,70,na,1977,2965.464472692163
STAT,1907,46,15-19,1953,3.8420707655592557E-4
STAT,1815,54,na,1869,1500.162148003964
STAT,1850,39,50-100,1889,1.2575208400617286
SIM,1857,21,35-39,1878,16
SIM,1864,89,na,1953,128
STAT,1871,46,25-29,1917,0.06631983928782913
SIM,1969,24,35-39,1993,23
STAT,1872,22,30-34,1894,20.64091299529529
SIM,1910,34,20-24,1944,5
STAT,1918,62,na,1980,4106.013476477411
STAT,1884,28,30-34,1912,28.611861042573114
STAT,1893,38,25-29,1931,4.179106605995543
STAT,1937,28,50-100,1965,1.1197928356389246
STAT,1941,51,na,1992,4485.584921999067
STAT,1865,30,50-100,1895,0.9617150041363268
STAT,1917,34,50-100,1951,0.9906253797902532
SIM,1871,25,25-29,1896,84
SIM,1900,39,30-34,1939,3
STAT,1952,43,na,1995,5329.335552157101
SIM,1847,32,30-34,1879,41
STAT,1873,36,40-44,1909,5.183672433476094
SIM,1948,28,na,1976,4052
STAT,1820,42,50-100,1862,1.306550471757587
STAT,1890,102,na,1992,10.266224324789244
STAT,1942,69,na,2011,3704.630014712404
STAT,1888,43,25-29,1931,0.8648410427986173
STAT,1907,38,20-24,1945,0.2811094060858145
SIM,1879,22,25-29,1901,1
STAT,1917,27,25-29,1944,79.66226491384755
STAT,1781,100,na,1881,0.16383545237208513
STAT,1891,99,na,1990,39.82688626564783
STAT,1846,32,30-34,1878,21.33005887209255
SIM,1832,34,45-49,1866,6
SIM,1925,34,50-100,1959,2
SIM,1947,19,25-29,1966,84
SIM,1873,60,na,1933,2663
SIM,1925,27,25-29,1952,174
SIM,1954,31,30-34,1985,49
STAT,1896,47,40-44,1943,0.14651565747493006
SIM,1861,27,na,1888,1796
SIM,1878,49,50-100,1927,1
STAT,1879,33,na,1912,2863.4150503170904
SIM,1932,81,na,2013,2159
STAT,1929,38,15-19,1967,0.028424337771451865
STAT,1870,24,20-24,1894,77.91259215464362
SIM,1870,36,30-34,1906,15
STAT,1857,32,40-44,1889,3.9219517729999303
STAT,1916,15,15-19,1931,11.164776213244386
STAT,1946,31,30-34,1977,20.567982300237333
STAT,1807,47,15-19,1854,0.0016651431184251328
STAT,1839,32,30-34,1871,17.039623751933004
STAT,1809,83,na,1892,184.51151050367582
STAT,1888,29,45-49,1917,1.495443853852417
STAT,1811,45,15-19,1856,0.001289673043260017
SIM,1851,50,na,1901,2532
SIM,1795,83,na,1878,87
SIM,1865,32,40-44,1897,1
SIM,1975,28,20-24,2003,5
STAT,1828,72,na,1900,838.1826123610383
SIM,1814,47,50-100,1861,1
SIM,1916,25,25-29,1941,81
SIM,1849,31,45-49,1880,2
STAT,1942,36,na,1978,4679.591976783687
SIM,1796,68,na,1864,780
STAT,1863,51,40-44,1914,0.010674387772920981
STAT,1849,21,35-39,1870,5.507862548950406
SIM,1895,23,20-24,1918,1
SIM,1977,34,25-29,2011,28
STAT,1959,45,20-24,2004,0.017434012951702677
STAT,1956,20,35-39,1976,14.436285480432755
SIM,1880,25,35-39,1905,20
STAT,1840,24,na,1864,2150.0258755683644
STAT,1887,17,35-39,1904,0.7096581625449433
STAT,1851,16,na,1867,2226.2323368332645
STAT,1778,107,na,1885,0.010948755520196422
STAT,1887,23,20-24,1910,88.8507145868464
STAT,1957,32,45-49,1989,2.44056636415163
SIM,1906,36,20-24,1942,1
STAT,1862,27,40-44,1889,2.9282319591492394
SIM,1888,46,45-49,1934,2
SIM,1870,27,40-44,1897,7
STAT,1840,35,40-44,1875,4.240567911509406
STAT,1866,15,na,1881,2805.871910606786
STAT,1931,77,na,2008,3433.680958179521
SIM,1865,35,45-49,1900,2
STAT,1858,54,45-49,1912,0.01270603539443578
SIM,1965,32,45-49,1997,1
STAT,1834,61,na,1895,1705.3179291041733
STAT,1923,39,25-29,1962,1.3133089432749205
STAT,1845,20,20-24,1865,58.485401873844395
SIM,1939,20,35-39,1959,11
STAT,1812,58,na,1870,1106.0641761822515
STAT,1902,47,40-44,1949,0.15673733123346953
SIM,1914,23,40-44,1937,3
SIM,1951,48,na,1999,6219
STAT,1875,18,15-19,1893,7.05897496270222
STAT,1894,46,25-29,1940,0.04833881825593501
STAT,1964,24,40-44,1988,4.900066915699764
SIM,1876,38,25-29,1914,2
STAT,1854,26,30-34,1880,23.805047508378742
STAT,1833,52,45-49,1885,0.010596975686284173
SIM,1814,81,na,1895,206
SIM,1933,2,na,1935,6785
STAT,1988,26,35-39,2014,24.898819653676668
STAT,1938,16,40-44,1954,1.5969910884398513
STAT,1822,33,30-34,1855,58.90134996087168
STAT,1962,42,20-24,2004,0.027138582258613837
STAT,1873,54,40-44,1927,0.012065551261135503
SIM,1966,30,50-100,1996,3
STAT,1901,29,na,1930,3830.2013913728983
STAT,1858,19,25-29,1877,5.889440325518974
STAT,1824,43,35-39,1867,2.534012126366938
SIM,1903,52,na,1955,3294
STAT,1827,53,30-34,1880,0.007133112477081787
STAT,1819,49,40-44,1868,0.32022393543804617
STAT,1945,65,na,2010,4199.297549816031
STAT,1877,47,35-39,1924,0.16727877450594758
STAT,1829,52,25-29,1881,0.0031754012190763413
SIM,1829,35,na,1864,1800
SIM,1897,19,na,1916,4136
STAT,1868,38,25-29,1906,3.1765265083915475
SIM,1871,32,35-39,1903,2
STAT,1848,45,15-19,1893,4.292478995541041E-4
STAT,1859,33,na,1892,2184.489381805878
STAT,1863,35,40-44,1898,4.459334987311762
STAT,1879,42,40-44,1921,2.70708288312614
SIM,1862,26,30-34,1888,2
SIM,1878,33,30-34,1911,27
SIM,1871,17,40-44,1888,2
STAT,1865,45,50-100,1910,0.25828203388603704
STAT,1994,20,20-24,2014,185.91757163413388
STAT,1997,17,45-49,2014,0.8418175410490737
STAT,1863,17,40-44,1880,0.21061097155734165
SIM,1834,81,na,1915,389
SIM,1853,39,40-44,1892,9
SIM,1920,56,na,1976,3947
STAT,1885,37,15-19,1922,0.06464003608738994
SIM,1834,26,25-29,1860,68
SIM,1830,33,30-34,1863,10
SIM,1846,43,35-39,1889,5
SIM,1896,65,na,1961,2888
STAT,1971,28,na,1999,5496.644528368523
SIM,1887,42,40-44,1929,8
SIM,1881,36,40-44,1917,3
STAT,1882,29,15-19,1911,0.5077650919892233
STAT,1834,20,45-49,1854,1.3363682537423867
STAT,1845,39,40-44,1884,3.0356282755027952
STAT,1954,24,na,1978,5223.558904463744
SIM,1850,20,na,1870,2110
SIM,1913,82,na,1995,2345
STAT,1966,35,15-19,2001,0.028566821017674437
SIM,1991,20,45-49,2011,2
STAT,1917,24,na,1941,4451.141711400997
STAT,1879,25,na,1904,2895.3159707993027
STAT,1969,43,15-19,2012,0.0022971118631482388
STAT,1828,41,na,1869,1779.5771170737469
STAT,1847,49,45-49,1896,0.17779974075623356
SIM,1859,65,na,1924,1343
SIM,1871,23,50-100,1894,1
SIM,1845,27,40-44,1872,4
STAT,1896,23,30-34,1919,27.067118958956794
SIM,1872,30,30-34,1902,2
STAT,1831,25,50-100,1856,0.676535584230244
STAT,1878,45,30-34,1923,0.11780254601209088
STAT,1880,16,30-34,1896,1.9544752959247769
STAT,1780,87,na,1867,78.67282758802993
SIM,1947,32,35-39,1979,1
STAT,1844,52,20-24,1896,6.139267282583049E-4
SIM,1967,31,na,1998,5708
SIM,1866,19,25-29,1885,5
STAT,1861,21,15-19,1882,3.275153716579145
STAT,1959,26,25-29,1985,99.83507386483525
STAT,1834,50,40-44,1884,0.010249000811337939
STAT,1902,70,na,1972,2766.7107529450814
SIM,1804,51,na,1855,1209
SIM,1948,54,na,2002,4262
STAT,1821,35,35-39,1856,17.471985752016227
STAT,1808,103,na,1911,0.07317674931948798
STAT,1882,37,50-100,1919,1.38393005987741
SIM,1880,49,50-100,1929,2
STAT,1858,37,25-29,1895,2.5921009056122792
STAT,1895,43,35-39,1938,0.18753102976513805
STAT,1859,47,15-19,1906,3.660072384721085E-4
STAT,1983,20,45-49,2003,1.8442393573315563
SIM,1952,47,45-49,1999,2
STAT,1894,28,25-29,1922,62.53491574960286
STAT,1906,23,40-44,1929,3.495945504914918
SIM,1853,20,20-24,1873,3
STAT,1837,27,40-44,1864,2.7841304258473216
SIM,1892,24,20-24,1916,112
STAT,1855,42,25-29,1897,0.5457358391023448
SIM,1870,35,25-29,1905,13
STAT,1817,89,na,1906,72.62981499674599
STAT,1887,20,na,1907,3077.0221647594567
STAT,1880,31,25-29,1911,12.580378129879444
STAT,1771,111,na,1882,0.0015251684123094736
SIM,1874,28,20-24,1902,26
STAT,1896,41,30-34,1937,0.12224249653034676
SIM,1910,34,na,1944,3652
SIM,1865,73,na,1938,1476
STAT,1884,24,20-24,1908,78.08357565085157
STAT,1912,49,20-24,1961,0.012196531621739254
STAT,1920,43,40-44,1963,0.31816158377887827
SIM,1972,24,40-44,1996,6
STAT,1923,32,na,1955,5001.816998008162
STAT,1943,24,50-100,1967,0.8074336602663095
SIM,1886,45,30-34,1931,1
STAT,1951,38,50-100,1989,0.593831895933888
SIM,1821,63,na,1884,893
SIM,1886,27,30-34,1913,25
STAT,1919,21,25-29,1940,117.05190754459228
STAT,1928,27,35-39,1955,21.345481287709173
STAT,1876,50,45-49,1926,0.01756179820133538
SIM,1956,23,45-49,1979,1
SIM,1993,18,35-39,2011,7
STAT,1845,53,20-24,1898,4.892667078510039E-4
STAT,1898,107,na,2005,0.5820058933410306
STAT,1861,36,15-19,1897,0.054134395949495144
STAT,1835,31,15-19,1866,0.11441543240117366
STAT,1864,33,35-39,1897,10.391312694685816
STAT,1787,103,na,1890,0.04407706673102991
SIM,1910,101,na,2011,28
STAT,1944,47,45-49,1991,0.28076988467834274
SIM,1982,29,15-19,2011,6
STAT,1878,71,na,1949,1608.3754208717262
STAT,1974,29,15-19,2003,1.0673604512873862
STAT,1953,52,na,2005,5244.979816139718
STAT,1844,37,25-29,1881,2.544832441679813
SIM,1927,21,25-29,1948,273
STAT,1858,41,50-100,1899,0.9554123845161911
STAT,1985,18,35-39,2003,6.8853035212665565
STAT,1887,39,45-49,1926,2.552273573703893
SIM,1941,3,na,1944,4127
STAT,1849,46,15-19,1895,3.109072513069089E-4
STAT,1890,20,30-34,1910,25.267325328837497
SIM,1846,25,35-39,1871,9
STAT,1947,21,30-34,1968,37.498247625349165
SIM,1911,97,na,2008,143
SIM,1946,34,40-44,1980,14
STAT,1878,27,30-34,1905,30.34307009182815
SIM,1845,65,na,1910,1520
STAT,1963,40,15-19,2003,0.0023463953971570844
SIM,1895,39,45-49,1934,6
SIM,1797,64,na,1861,851
SIM,1919,79,na,1998,2562
SIM,1967,26,25-29,1993,7
STAT,1948,23,45-49,1971,1.490401790956044
SIM,1936,27,35-39,1963,2
STAT,1766,107,na,1873,0.0194799863719903
STAT,1828,54,30-34,1882,0.004630552667704198
STAT,1909,29,na,1938,4106.745524389781
SIM,1836,36,30-34,1872,7
STAT,1845,104,na,1949,0.044946149957175725
STAT,1916,50,na,1966,4309.845827187486
STAT,1984,31,15-19,2015,0.21482184134841953
STAT,1858,71,na,1929,1201.7023036957949
SIM,1846,36,50-100,1882,2
STAT,1851,5,na,1856,2424.3696974400004
SIM,1827,30,20-24,1857,5
STAT,1850,33,35-39,1883,10.793217529727912
STAT,1993,21,na,2014,6085.457185171023
STAT,1838,43,35-39,1881,1.648342759960198
STAT,1836,40,50-100,1876,1.1738674006923693
STAT,1873,24,45-49,1897,0.8166418715376137
STAT,1962,11,na,1973,5809.338556163329
STAT,1925,67,na,1992,4315.384340451021
STAT,1870,27,25-29,1897,48.127349686164
SIM,1921,29,15-19,1950,2
STAT,1954,17,35-39,1971,5.986499184630362
STAT,1938,34,40-44,1972,4.537387409119334
SIM,1867,6,na,1873,2844
SIM,1912,69,na,1981,2647
STAT,1871,29,40-44,1900,3.4147046713743845
SIM,1898,27,20-24,1925,16
SIM,1962,17,35-39,1979,15
STAT,1789,103,na,1892,0.029090666277425112
STAT,1880,10,na,1890,3168.5935859430556
STAT,1835,46,15-19,1881,2.665100777317251E-4
STAT,1868,53,20-24,1921,8.050443497046297E-4
STAT,1828,36,30-34,1864,5.604637723662442
SIM,1976,30,20-24,2006,1
STAT,1828,51,25-29,1879,0.0032134160015965443
STAT,1820,38,25-29,1858,4.142372851793542
STAT,1834,103,na,1937,0.13097189280906868
SIM,1896,57,na,1953,3151
STAT,1831,27,45-49,1858,1.1574495136144687
STAT,1913,29,15-19,1942,0.8064004191862532
SIM,1893,22,15-19,1915,10
STAT,1899,19,15-19,1918,9.332623970197133
STAT,1871,40,15-19,1911,0.016015416467027116
STAT,1942,11,na,1953,4751.87075469045
STAT,1891,20,50-100,1911,0.5851092624286954
SIM,1891,34,na,1925,3313
SIM,1987,20,25-29,2007,161
STAT,1853,43,30-34,1896,1.1363629623571352
STAT,1850,21,40-44,1871,2.593364470797419
STAT,1869,50,30-34,1919,0.006748219712087976
STAT,1854,44,30-34,1898,0.9239884778451963
STAT,1848,53,50-100,1901,0.015789436555807834
SIM,1898,32,45-49,1930,1
SIM,1880,42,na,1922,3260
STAT,1838,25,35-39,1863,10.78813676270058
STAT,1885,22,15-19,1907,3.797537110560668
STAT,1896,24,50-100,1920,0.6176979955777604
SIM,1909,22,20-24,1931,139
STAT,1889,55,na,1944,2941.4657767358917
SIM,1876,57,na,1933,2396
SIM,1843,31,15-19,1874,3
STAT,1849,28,15-19,1877,0.4138556073729589
STAT,1969,31,20-24,2000,3.586394787052377
SIM,1808,73,na,1881,696
STAT,1947,60,na,2007,4625.833464106887
STAT,1913,47,15-19,1960,4.1515205573819657E-4
STAT,1973,15,50-100,1988,0.5594870430600036
STAT,1938,19,45-49,1957,0.5685753174972331
SIM,1824,37,20-24,1861,2
STAT,1931,59,na,1990,5331.93619177237
STAT,1837,89,na,1926,76.07220942123853
STAT,1973,31,40-44,2004,5.957139646961086
SIM,1866,27,na,1893,2467
STAT,1877,44,30-34,1921,1.3614844543379927
SIM,1848,41,45-49,1889,3
STAT,1852,58,na,1910,1864.505469117359
STAT,1981,22,35-39,2003,15.244815489581104
STAT,1874,34,35-39,1908,11.862158078382333
SIM,1980,23,na,2003,5982
STAT,1869,39,50-100,1908,1.3583255822036826
STAT,1889,18,50-100,1907,0.06951174191752395
SIM,1825,73,na,1898,808
SIM,1843,30,na,1873,2043
SIM,1929,31,30-34,1960,6
SIM,1888,43,40-44,1931,7
STAT,1832,22,35-39,1854,8.974540187096014
STAT,1934,24,na,1958,5662.5355763883945
SIM,1896,34,35-39,1930,41
STAT,1964,27,45-49,1991,2.521969821071492
SIM,1977,29,35-39,2006,1
SIM,1821,41,35-39,1862,3
STAT,1814,92,na,1906,25.969179833388605
SIM,1843,29,30-34,1872,23
SIM,1952,59,na,2011,4209
SIM,1906,35,50-100,1941,1
STAT,1861,37,30-34,1898,5.1132354230282555
SIM,1845,73,na,1918,1143
STAT,1857,31,50-100,1888,0.837264525716836
STAT,1835,29,30-34,1864,20.214834871476892
SIM,1897,18,50-100,1915,1
STAT,1858,51,40-44,1909,0.009523243567324483
SIM,1959,32,25-29,1991,2
STAT,1824,31,40-44,1855,10.296958393519988
STAT,1923,36,20-24,1959,0.3526839312573729
STAT,1894,43,20-24,1937,0.01624273183584481
STAT,1864,15,35-39,1879,0.6503939314873622
SIM,1840,73,na,1913,658
SIM,1874,22,na,1896,2586
SIM,1866,51,40-44,1917,1
STAT,1794,67,na,1861,977.4805306937058
STAT,1854,29,35-39,1883,8.122927707580711
STAT,1927,4,na,1931,5790.332223371156
SIM,1969,38,40-44,2007,8
STAT,1967,15,20-24,1982,195.5448035036576
SIM,1854,19,35-39,1873,1
STAT,1896,26,35-39,1922,14.758200557307163
STAT,1881,91,na,1972,243.11450498896642
STAT,1921,29,na,1950,4782.053791578074
STAT,1959,23,20-24,1982,168.3559693010848
SIM,1863,42,25-29,1905,1
STAT,1932,24,50-100,1956,0.9931598900708408
SIM,1963,30,25-29,1993,2
SIM,1862,29,35-39,1891,12
SIM,1962,6,na,1968,5590
SIM,1882,34,35-39,1916,26
SIM,1909,49,na,1958,4536
SIM,1877,39,50-100,1916,4
STAT,1856,109,na,1965,0.004326001057049055
STAT,1865,47,45-49,1912,0.2445907969485844
SIM,1904,26,na,1930,4097
STAT,1834,53,45-49,1887,0.013313320552894928
STAT,1819,37,50-100,1856,3.6290371966794748
STAT,1931,46,20-24,1977,0.01709889335476547
STAT,1880,19,35-39,1899,0.6676041235969217
STAT,1855,41,40-44,1896,1.9225587248076172
STAT,1847,16,45-49,1863,0.06310446761382855
SIM,1937,13,na,1950,4466
STAT,1835,23,na,1858,1756.3086212082862
STAT,1955,30,25-29,1985,14.449773071517411
SIM,1984,27,25-29,2011,116
SIM,1832,31,40-44,1863,2
STAT,1947,42,na,1989,5017.371862640228
STAT,1873,39,45-49,1912,2.3256591551368513
STAT,1810,46,15-19,1856,0.001590890938671773
STAT,1888,34,35-39,1922,13.620500198291634
STAT,1938,37,45-49,1975,0.7999342063735246
STAT,1874,52,35-39,1926,0.010117002944033929
SIM,1885,73,na,1958,1798
SIM,1923,27,50-100,1950,3
SIM,1889,83,na,1972,1413
STAT,1870,42,20-24,1912,0.18046297428340363
STAT,1832,58,na,1890,1347.3180537503576
STAT,1881,32,25-29,1913,11.401340956127703
SIM,1902,90,na,1992,248
STAT,1832,38,15-19,1870,0.04880677960636983
STAT,1896,44,35-39,1940,0.18908659405949244
SIM,1881,39,45-49,1920,1
STAT,1846,19,35-39,1865,0.7042057334218313
SIM,1878,36,35-39,1914,4
SIM,1839,65,na,1904,1482
STAT,1819,42,15-19,1861,0.029036067042429975
STAT,1806,103,na,1909,0.04925732767029422
SIM,1870,32,20-24,1902,4
SIM,1955,21,30-34,1976,106
STAT,1976,27,25-29,2003,101.92036998363831
STAT,1956,15,45-49,1971,0.7632411066327327
STAT,1962,45,25-29,2007,0.08197042570951318
STAT,1984,21,45-49,2005,1.8509338993036448
STAT,1865,53,na,1918,2206.001234041244
SIM,1954,5,na,1959,5549
STAT,1895,40,30-34,1935,1.7444486728014932
STAT,1873,51,35-39,1924,0.010194232157013212
STAT,1861,16,50-100,1877,0.054344790138531975
STAT,1850,50,50-100,1900,0.0157708892857051
SIM,1885,44,30-34,1929,6
STAT,1924,22,45-49,1946,1.5317934259193609
SIM,1837,78,na,1915,880
STAT,1915,27,50-100,1942,1.1718388490759215
STAT,1861,19,30-34,1880,1.7369603096258024
SIM,1932,22,45-49,1954,1
SIM,1832,47,na,1879,1981
STAT,1866,31,45-49,1897,1.8729229017321403
SIM,1848,30,na,1878,1933
SIM,1832,86,na,1918,160
STAT,1812,44,25-29,1856,1.5843368730933869
STAT,1896,37,na,1933,3591.183252087652
STAT,1959,42,15-19,2001,0.002409188214329046
SIM,1836,39,35-39,1875,5
STAT,1980,25,25-29,2005,105.99754553193465
STAT,1884,39,20-24,1923,0.8700919577368439
STAT,1961,39,50-100,2000,0.6435653621810999
SIM,1969,21,30-34,1990,97
STAT,1801,74,na,1875,522.8441107187754
STAT,1944,44,40-44,1988,0.32176542774332717
STAT,1875,19,30-34,1894,1.8906475732951795
STAT,1919,59,na,1978,4323.218828833199
STAT,1850,18,15-19,1868,7.421495343363215
SIM,1869,43,35-39,1912,2
STAT,1847,34,45-49,1881,1.4041790446873625
STAT,1963,42,35-39,2005,0.30681941532951873
SIM,1819,37,40-44,1856,4
SIM,1949,25,20-24,1974,50
SIM,1827,28,35-39,1855,1
STAT,1845,76,na,1921,638.4126020526164
STAT,1837,45,40-44,1882,0.13202883518503655
STAT,1889,63,na,1952,2538.2963893978554
SIM,1820,41,50-100,1861,4
STAT,1815,53,40-44,1868,0.020248750933617915
SIM,1856,44,35-39,1900,2
SIM,1828,73,na,1901,1104
SIM,1944,20,15-19,1964,1
STAT,1844,91,na,1935,48.46886479883234
STAT,1840,32,35-39,1872,9.894911973669796
SIM,1850,12,na,1862,2230
SIM,1853,36,35-39,1889,18
STAT,1901,49,45-49,1950,0.2106990419539058
STAT,1845,36,35-39,1881,5.059991355364347
SIM,1892,39,20-24,1931,2
STAT,1819,46,35-39,1865,0.27350109909386544
STAT,1859,32,15-19,1891,0.13091604562664783
SIM,1820,44,25-29,1864,1
STAT,1954,16,na,1970,5252.685604417159
SIM,1946,59,na,2005,4300
STAT,1977,22,25-29,1999,144.50717197558475
SIM,1830,53,50-100,1883,1
SIM,1878,60,na,1938,2333
STAT,1869,53,35-39,1922,0.009467071692477819
STAT,1891,37,45-49,1928,2.8433463289711893
STAT,1898,39,20-24,1937,0.25688934702575955
STAT,1913,62,na,1975,3768.831314439351
STAT,1990,15,35-39,2005,6.938684953341784
STAT,1871,22,15-19,1893,3.7876964650427922
SIM,1952,44,40-44,1996,2
STAT,1987,11,na,1998,6472.587903458247
STAT,1945,57,na,2002,4605.8423401516775
SIM,1986,6,na,1992,6755
STAT,1876,47,20-24,1923,0.014249006042329792
STAT,1822,53,50-100,1875,0.026931702728861
STAT,1903,24,na,1927,3863.2758515379664
STAT,1949,16,15-19,1965,60.929204296831934
SIM,1817,39,30-34,1856,1
STAT,1927,42,50-100,1969,0.169996419214885
STAT,1890,40,na,1930,3292.011631514592
STAT,1894,10,na,1904,3842.850176792165
STAT,1936,1,na,1937,4616.813962318031
SIM,1849,35,na,1884,2748
STAT,1835,47,30-34,1882,0.0636743418963387
SIM,1958,17,15-19,1975,134
SIM,1875,24,15-19,1899,1
STAT,1987,28,40-44,2015,7.7085495474244645
SIM,1904,16,35-39,1920,1
SIM,1979,27,45-49,2006,5
STAT,1849,29,30-34,1878,22.805344714757254
STAT,1978,25,35-39,2003,23.768765958336555
SIM,1965,3,na,1968,5623
STAT,1929,22,25-29,1951,134.8089994106078
SIM,1998,0,na,1998,6874
SIM,2010,3,na,2013,7249
STAT,1891,45,na,1936,3241.58362402142
STAT,1852,16,25-29,1868,6.500039327650522
STAT,1982,23,35-39,2005,15.336191023906533
SIM,1906,32,45-49,1938,5
STAT,1803,52,30-34,1855,0.021598188413035933
SIM,1860,16,25-29,1876,16
SIM,1990,23,35-39,2013,37
SIM,1967,23,20-24,1990,321
STAT,1874,23,50-100,1897,0.48029414292910555
STAT,1912,45,50-100,1957,0.2522758940121318
STAT,1853,46,35-39,1899,0.1397824034178259
STAT,1980,34,na,2014,6168.28942842533
SIM,1916,82,na,1998,1451
STAT,1846,15,na,1861,3016.3794292995217
STAT,1979,36,40-44,2015,2.452866034356297
SIM,1862,41,25-29,1903,5
STAT,1874,35,15-19,1909,0.06697372555486904
SIM,1832,49,50-100,1881,3
SIM,1893,60,na,1953,2584
STAT,1793,82,na,1875,170.59566442171013
STAT,1831,54,35-39,1885,0.006745166093458138
SIM,1883,18,15-19,1901,7
STAT,1828,39,35-39,1867,6.98573906094267
STAT,1886,36,50-100,1922,1.5017382792881266
SIM,1894,36,50-100,1930,3
SIM,1828,29,35-39,1857,22
STAT,1814,42,35-39,1856,6.198319136500513
STAT,1936,20,15-19,1956,5.880751014637575
STAT,1971,33,30-34,2004,23.459198580516265
SIM,1937,22,25-29,1959,6
STAT,1919,26,50-100,1945,1.24510442926395
STAT,1875,36,15-19,1911,0.06729200174092319
STAT,1867,24,15-19,1891,3.532407424451836
STAT,1948,16,na,1964,4862.435336421466
SIM,1944,0,na,1944,4804
SIM,1920,64,na,1984,3498
SIM,1862,85,na,1947,263
STAT,1845,32,15-19,1877,0.11409936738977168
SIM,1921,18,na,1939,5193
SIM,1829,44,45-49,1873,7
STAT,1813,41,35-39,1854,7.076161821332439
SIM,1850,27,20-24,1877,11
SIM,1980,34,30-34,2014,60
STAT,1929,40,25-29,1969,0.10702456675551207
STAT,1842,27,20-24,1869,11.16403643219775
STAT,1972,34,30-34,2006,23.699165018142676
STAT,1857,39,30-34,1896,4.742069366092573
STAT,1861,83,na,1944,380.8721906766889
SIM,1962,31,na,1993,5546
SIM,1857,29,30-34,1886,57
STAT,1996,18,na,2014,6171.297870196995
SIM,1822,42,35-39,1864,5
STAT,1985,15,30-34,2000,20.017177537221503
STAT,1995,19,35-39,2014,7.005114288648513
SIM,1858,9,na,1867,3344
STAT,1856,68,na,1924,1345.500427592615
STAT,1892,48,15-19,1940,3.2226272649420054E-4
STAT,1858,49,20-24,1907,0.010577864965394469
STAT,1820,35,20-24,1855,2.1320949021204663
STAT,1841,25,40-44,1866,3.355998893552513
STAT,1958,30,50-100,1988,1.2788624242285167
SIM,1991,15,na,2006,6707
SIM,1874,31,45-49,1905,3
STAT,1823,41,na,1864,1585.1083654328643
SIM,1976,16,20-24,1992,207
STAT,1980,34,50-100,2014,1.3484479463946162
SIM,1929,34,35-39,1963,22
STAT,1860,26,25-29,1886,40.0540741521087
SIM,1955,42,35-39,1997,2
SIM,1900,87,na,1987,716
STAT,1916,6,na,1922,4891.945684192953
STAT,1848,44,35-39,1892,1.8980688881228116
STAT,1882,76,na,1958,1186.8038027518223
STAT,1975,25,45-49,2000,2.6439034422757657
SIM,1871,30,15-19,1901,1
SIM,1959,48,30-34,2007,1
STAT,1994,14,na,2008,6539.297379526323
STAT,1967,35,30-34,2002,2.711518040032858
STAT,1830,25,30-34,1855,35.10412639837237
STAT,1910,38,35-39,1948,2.659143078783192
STAT,1890,71,na,1961,2085.498804349957
STAT,1812,89,na,1901,46.12199947713518
STAT,1968,16,20-24,1984,195.47505221173566
STAT,1881,27,50-100,1908,0.7120602140013413
STAT,1892,83,na,1975,1156.2806979467255
STAT,1895,23,15-19,1918,4.940454099364022
SIM,1983,25,45-49,2008,8
STAT,1947,42,35-39,1989,0.2720384862882401
STAT,1909,17,25-29,1926,9.818284280913222
STAT,1851,84,na,1935,263.8001911806839
STAT,1982,11,na,1993,6379.967180592021
STAT,1891,19,45-49,1910,0.0926710210841558
SIM,1896,43,50-100,1939,1
STAT,1816,51,35-39,1867,0.017195401736011622
STAT,1876,18,30-34,1894,1.8964707374555796
SIM,1879,32,40-44,1911,7
STAT,1834,92,na,1926,38.009279716846194
STAT,1971,41,50-100,2012,0.1787107888271262
STAT,1845,18,35-39,1863,0.46457957668822536
STAT,1986,25,20-24,2011,30.17260684234627
SIM,1853,18,35-39,1871,1
SIM,1888,90,na,1978,120
STAT,1872,16,50-100,1888,0.05729611529079297
SIM,1986,25,35-39,2011,61
SIM,1918,15,20-24,1933,33
STAT,1940,23,40-44,1963,3.952820234144875
STAT,1979,20,35-39,1999,15.021525101565716
SIM,1943,25,25-29,1968,3
SIM,1917,17,25-29,1934,13
STAT,1874,38,20-24,1912,0.9062001303929702
STAT,1872,51,50-100,1923,0.01758483555783374
STAT,1892,15,15-19,1907,8.623820249161387
STAT,1820,51,20-24,1871,7.3922613584732E-4
STAT,1860,43,45-49,1903,1.3819822080531003
SIM,1878,91,na,1969,21
STAT,1851,35,15-19,1886,0.04595160124674542
STAT,1967,18,25-29,1985,62.450614576430695
STAT,1898,46,50-100,1944,0.2166898045464263
STAT,1895,41,15-19,1936,0.0014470946818404724
STAT,1865,84,na,1949,346.38756862124126
STAT,1888,31,30-34,1919,23.782202676127273
STAT,1869,33,15-19,1902,0.1584843614880104
SIM,1894,37,30-34,1931,19
STAT,1914,33,40-44,1947,4.5289567358790395
SIM,1877,37,35-39,1914,20
SIM,1801,86,na,1887,79
STAT,1869,37,35-39,1906,7.904755814133215
SIM,1833,42,45-49,1875,6
STAT,1861,91,na,1952,55.59555399801252
SIM,1963,38,45-49,2001,2
STAT,1886,37,30-34,1923,6.487754449425849
SIM,1975,18,25-29,1993,160
STAT,1853,30,20-24,1883,2.8295523364455475
STAT,1881,31,40-44,1912,4.847052847043032
SIM,1928,36,50-100,1964,2
SIM,1922,33,40-44,1955,14
SIM,1923,21,na,1944,5553
STAT,1836,27,25-29,1863,49.831984692398606
SIM,1844,27,25-29,1871,76
STAT,1805,51,25-29,1856,0.012920816390990972
STAT,1892,21,45-49,1913,1.0116750091963738
STAT,1910,14,na,1924,4506.107634623778
STAT,1851,17,15-19,1868,5.721717329527887
SIM,1852,55,na,1907,1687
SIM,1882,38,20-24,1920,2
STAT,1904,39,20-24,1943,0.2729546238336924
STAT,1912,33,40-44,1945,4.429357229498352
STAT,1935,25,25-29,1960,103.6892097269925
STAT,1914,15,40-44,1929,0.33561751424215375
SIM,1823,35,40-44,1858,11
STAT,1871,26,35-39,1897,11.11620656287872
SIM,1920,33,40-44,1953,4
STAT,1848,10,na,1858,3183.7714735699956
STAT,1898,71,na,1969,2500.899477067332
STAT,1825,42,45-49,1867,2.226268805666364
SIM,1975,35,30-34,2010,6
SIM,1896,31,30-34,1927,6
SIM,1942,31,50-100,1973,1
SIM,1912,39,20-24,1951,1
STAT,1994,2,na,1996,6553.504574250965
SIM,1880,21,25-29,1901,148
STAT,1856,42,40-44,1898,1.9779351271132342
SIM,1833,24,45-49,1857,2
STAT,1966,38,20-24,2004,0.39107099532679057
STAT,1915,31,35-39,1946,10.786627345042284
STAT,1920,75,na,1995,3106.2243180763144
STAT,1897,22,40-44,1919,3.2155958920484204
STAT,1852,49,25-29,1901,0.05317218427075968
SIM,1883,47,na,1930,2398
STAT,1930,29,20-24,1959,26.763183884798917
SIM,1917,32,20-24,1949,4
STAT,1980,22,20-24,2002,178.73190474907727
STAT,1977,27,40-44,2004,7.299357069433552
SIM,1891,65,na,1956,2354
STAT,1863,38,45-49,1901,2.0016699190871416
STAT,2013,2,na,2015,7258.627208814307
STAT,1851,32,45-49,1883,1.439290655022268
SIM,1917,13,na,1930,5775
STAT,1847,88,na,1935,105.63345599197889
STAT,1832,35,50-100,1867,1.102286259419131
STAT,1981,28,45-49,2009,2.7985782244673647
STAT,1821,52,20-24,1873,0.0012867454154934877
SIM,1832,55,na,1887,1729
STAT,1836,42,20-24,1878,0.17199956015201423
STAT,1942,49,35-39,1991,0.16081483033271882
SIM,1923,31,35-39,1954,5
STAT,1880,37,35-39,1917,8.651889209059492
SIM,1919,30,30-34,1949,39
SIM,1841,32,50-100,1873,3
SIM,1863,47,na,1910,2256
STAT,1842,41,35-39,1883,1.4602820775072254
STAT,1987,15,50-100,2002,0.6175720492546923
STAT,1971,39,40-44,2010,2.2494786428089935
STAT,1841,43,40-44,1884,2.0515982287168484
STAT,1842,23,35-39,1865,5.623238650732005
STAT,1931,49,25-29,1980,0.08139125876051016
STAT,1860,36,50-100,1896,1.1474303591192174
STAT,1842,30,45-49,1872,1.6550842087299646
SIM,1969,33,15-19,2002,1
SIM,1822,48,na,1870,1519
STAT,1831,41,25-29,1872,0.6233812986243641
STAT,1827,40,20-24,1867,0.21976416017464984
SIM,1848,35,15-19,1883,1
SIM,1850,23,35-39,1873,6
STAT,1897,37,40-44,1934,6.755072635924438
SIM,1990,20,30-34,2010,58
STAT,1951,26,20-24,1977,25.205002725973163
STAT,1941,21,35-39,1962,11.23608101048521
SIM,1889,36,45-49,1925,6
STAT,1936,59,na,1995,3953.9134302984758
SIM,1858,28,30-34,1886,38
STAT,1863,32,35-39,1895,10.21932521688135
STAT,1866,25,15-19,1891,0.48860079765609316
SIM,1869,28,40-44,1897,6
SIM,1866,37,25-29,1903,2
STAT,1958,52,na,2010,5694.62179674948
STAT,1957,41,na,1998,5881.172165833331
SIM,1968,26,40-44,1994,9
SIM,1860,73,na,1933,1444
SIM,1824,33,35-39,1857,4
SIM,1968,22,20-24,1990,1
STAT,1854,47,35-39,1901,0.11352583552392836
SIM,1845,96,na,1941,1
SIM,1850,41,35-39,1891,7
STAT,1787,74,na,1861,354.97063746987897
STAT,1791,70,na,1861,718.6677187842614
STAT,1877,31,20-24,1908,3.258133751515536
STAT,1862,35,25-29,1897,2.8307747388054727
STAT,1941,48,35-39,1989,0.15900724560565313
STAT,1982,20,30-34,2002,46.86013817624305
SIM,1949,28,25-29,1977,6
SIM,1895,72,na,1967,2042
SIM,1983,29,30-34,2012,13
STAT,1905,37,15-19,1942,0.020245089628139395
SIM,1978,24,25-29,2002,4
STAT,1857,38,15-19,1895,0.050221977002836614
SIM,1869,40,30-34,1909,2
STAT,1961,15,25-29,1976,64.64704855122882
STAT,1909,32,20-24,1941,2.6891925465683277
SIM,1959,15,50-100,1974,1
STAT,1831,51,30-34,1882,0.00494929512351586
STAT,1898,42,45-49,1940,0.1618976406312115
SIM,1870,17,25-29,1887,7
SIM,1849,18,15-19,1867,14
STAT,1862,17,25-29,1879,6.320926411564516
SIM,1908,42,50-100,1950,2
STAT,1914,17,50-100,1931,0.08948178119143031
SIM,1816,48,na,1864,1630
SIM,1920,0,na,1920,5038
STAT,1975,29,30-34,2004,59.852809787840805
STAT,1821,38,40-44,1859,9.322984767884895
SIM,1861,43,30-34,1904,2
SIM,1828,41,25-29,1869,2
STAT,1858,16,20-24,1874,18.754740426639803
STAT,1988,23,30-34,2011,47.579692144299955
STAT,1851,30,50-100,1881,0.772106793834037
STAT,1896,45,na,1941,3464.2346522100465
STAT,1897,108,na,2005,0.2676692809922397
STAT,1773,82,na,1855,291.34799999999996
STAT,1980,19,50-100,1999,0.5998280114241457
SIM,1850,29,na,1879,1685
SIM,1883,39,na,1922,2405
SIM,1945,8,na,1953,4797
STAT,1983,22,na,2005,5981.431933335887
STAT,1940,26,45-49,1966,2.034643781052607
SIM,1834,23,20-24,1857,5
STAT,1988,25,50-100,2013,1.6514038744597634
SIM,1949,27,50-100,1976,2
SIM,1868,43,20-24,1911,1
SIM,1842,85,na,1927,387
STAT,1830,28,35-39,1858,11.578147846971477
STAT,1925,36,20-24,1961,0.36534336294607095
STAT,1886,38,na,1924,2853.732204034568
STAT,1854,100,na,1954,0.864919010461568
STAT,1863,10,na,1873,2783.3205925084226
SIM,1817,78,na,1895,144
STAT,1914,18,45-49,1932,0.11899645189961171
STAT,1832,103,na,1935,0.0977753967357502
STAT,1900,7,na,1907,4172.101876033207
SIM,1832,78,na,1910,500
STAT,1885,50,50-100,1935,0.017634743349499854
SIM,1860,28,20-24,1888,1
STAT,1829,51,40-44,1880,0.010579150586830016
SIM,1876,65,na,1941,2172
STAT,1903,32,na,1935,3922.563707318034
SIM,1918,18,25-29,1936,117
STAT,1841,22,50-100,1863,0.4592944179133866
STAT,1830,40,25-29,1870,0.6352253109613205
STAT,1986,28,25-29,2014,108.64997163420244
STAT,1852,28,20-24,1880,12.790203399922946
SIM,1907,14,na,1921,4796
SIM,1907,28,20-24,1935,1
SIM,1917,21,na,1938,5290
STAT,1957,29,20-24,1986,27.867006114750275
STAT,1912,36,45-49,1948,0.7723000292155067
SIM,1866,58,na,1924,1967
STAT,1900,49,30-34,1949,0.08561357733746544
STAT,1804,50,25-29,1854,0.016972563630976597
SIM,1845,42,35-39,1887,4
STAT,1806,97,na,1903,1.8438648252693148
STAT,1834,29,15-19,1863,0.5351572181287774
STAT,1911,50,na,1961,3980.9717351067493
STAT,1867,17,50-100,1884,0.053965359141873934
STAT,1815,50,35-39,1865,0.017578721899432194
STAT,1837,58,na,1895,1432.033949588131
STAT,1891,16,40-44,1907,0.2615186778994271
SIM,1833,28,30-34,1861,42
SIM,1887,32,50-100,1919,4
STAT,1852,46,20-24,1898,0.011345883488317368
STAT,1910,35,30-34,1945,2.032826061647256
STAT,1879,32,50-100,1911,1.1040931902020592
STAT,1837,42,35-39,1879,1.547293671160499
SIM,1920,36,45-49,1956,4
STAT,1848,48,20-24,1896,0.01259012458951182
SIM,1895,46,50-100,1941,1
STAT,1978,22,30-34,2000,45.41615896360107
SIM,1965,29,20-24,1994,6
STAT,1887,46,50-100,1933,0.3185419709234985
STAT,1862,32,20-24,1894,2.632596519479856
STAT,1875,33,45-49,1908,2.070898130054513
STAT,1914,36,45-49,1950,0.7896661384955133
SIM,1844,24,20-24,1868,89
STAT,1860,19,15-19,1879,6.291300641984824
STAT,1968,31,15-19,1999,0.18891714149193628
STAT,1925,18,20-24,1943,188.447730944273
SIM,1854,31,25-29,1885,13
STAT,1860,40,40-44,1900,2.113180672028268
SIM,1986,22,30-34,2008,55
SIM,1849,66,na,1915,1925
SIM,1933,20,50-100,1953,1
STAT,1830,46,35-39,1876,0.1308668303225803
STAT,1944,2,na,1946,5029.039386068271
SIM,1943,22,20-24,1965,1
STAT,1858,34,20-24,1892,2.4126910625060187
STAT,1887,18,40-44,1905,0.2359329663799293
STAT,1816,96,na,1912,4.240519416599213
SIM,1846,40,30-34,1886,2
SIM,1898,26,15-19,1924,3
SIM,1881,80,na,1961,606
SIM,1890,32,40-44,1922,6
STAT,1943,44,25-29,1987,0.09052479815610696
STAT,1891,34,40-44,1925,6.132579478535274
STAT,1884,27,25-29,1911,48.23296781906131
SIM,1933,36,20-24,1969,1
SIM,1909,0,na,1909,5357
SIM,1934,13,na,1947,5971
STAT,1803,78,na,1881,326.4161196675232
SIM,1978,27,50-100,2005,2
STAT,1845,84,na,1929,224.16672463848658
STAT,1859,48,30-34,1907,0.08787055016350226
STAT,1935,22,20-24,1957,174.83961410076682
SIM,1866,16,20-24,1882,16
STAT,1860,37,15-19,1897,0.052229843793449145
STAT,1833,96,na,1929,6.042205072711775
STAT,1978,37,30-34,2015,2.9573171478814415
STAT,1925,20,50-100,1945,0.9140744871641416
SIM,1812,78,na,1890,203
STAT,1968,19,25-29,1987,62.42209390021049
SIM,1976,19,25-29,1995,86
STAT,1905,41,50-100,1946,0.12309295524051428
STAT,1773,111,na,1884,0.002320105242586548
STAT,2003,6,na,2009,6885.579302963327
STAT,1836,24,20-24,1860,81.61352493856185
SIM,1861,8,na,1869,2259
STAT,1901,46,40-44,1947,0.15654865953431832
STAT,1837,48,45-49,1885,0.17513980262703285
SIM,1922,36,45-49,1958,4
STAT,1836,45,25-29,1881,0.056302768787707215
STAT,1846,31,25-29,1877,12.643718983599031
STAT,1826,38,20-24,1864,0.6042778211849672
STAT,1882,32,40-44,1914,4.888411891095291
SIM,1941,49,na,1990,3862
STAT,1850,34,15-19,1884,0.1502073165306646
STAT,1933,31,na,1964,5887.973377406183
STAT,1923,8,na,1931,5402.809984550455
STAT,1887,36,40-44,1923,5.688774357788413
SIM,1973,41,na,2014,5377
SIM,1977,16,35-39,1993,7
STAT,1894,40,15-19,1934,0.0206941491111894
STAT,1858,109,na,1967,0.00610885895573372
STAT,1825,45,15-19,1870,5.742745999754047E-4
SIM,1823,38,45-49,1861,3
SIM,1861,30,20-24,1891,1
STAT,1934,16,na,1950,5762.49564957714
STAT,1937,48,15-19,1985,4.2822278076601355E-4
STAT,1942,60,na,2002,4292.300432956806
SIM,1892,27,25-29,1919,67
STAT,1976,24,20-24,2000,171.889684442166
SIM,1917,35,25-29,1952,2
SIM,1893,38,30-34,1931,5
STAT,1831,104,na,1935,0.05233065620703842
STAT,1967,11,na,1978,5663.539545395958
SIM,1956,20,40-44,1976,6
SIM,1992,15,15-19,2007,138
STAT,1841,46,45-49,1887,0.21349427926042133
STAT,1838,22,30-34,1860,20.02155879819532
STAT,1851,18,30-34,1869,1.5276565838767946
SIM,1895,36,40-44,1931,9
SIM,1818,37,25-29,1855,2
STAT,1872,21,25-29,1893,66.53661628306865
STAT,1965,23,40-44,1988,4.858754307555142
STAT,1834,47,15-19,1881,3.8712809698591164E-4
SIM,1984,24,20-24,2008,181
STAT,1897,25,45-49,1922,1.7249702019239037
STAT,1981,25,40-44,2006,7.560680878306915
STAT,1838,40,30-34,1878,1.1950800954618666
STAT,1909,35,25-29,1944,1.0869612706899716
STAT,1876,36,30-34,1912,6.388675349974451
STAT,1832,66,na,1898,1116.6417734067252
SIM,1955,24,35-39,1979,32
STAT,1890,23,35-39,1913,8.203301553263865
SIM,1846,22,30-34,1868,15
STAT,1810,52,45-49,1862,0.05314002781647104
SIM,1858,91,na,1949,78
SIM,1884,36,30-34,1920,2
SIM,1862,44,30-34,1906,1
STAT,1865,44,40-44,1909,2.310458547911999
STAT,1969,16,35-39,1985,6.050975732283301
STAT,1947,24,35-39,1971,12.27239320881005
SIM,1824,30,30-34,1854,43
STAT,1892,75,na,1967,1904.7885109409442
STAT,1849,91,na,1940,44.91351119228507
STAT,1937,20,30-34,1957,32.33966365813754
SIM,1905,87,na,1992,552
STAT,1831,24,40-44,1855,2.6937092780100347
STAT,1842,20,30-34,1862,17.539530470350233
SIM,1873,44,40-44,1917,8
STAT,1838,40,na,1878,2185.0888350315176
STAT,1856,39,15-19,1895,0.048943639284157535
STAT,1948,20,40-44,1968,4.458319559964732
STAT,1949,22,45-49,1971,1.515163777567899
STAT,1875,83,na,1958,583.7808909550309
STAT,1989,22,50-100,2011,1.0912534930820255
STAT,1885,38,30-34,1923,6.104497107269519
STAT,1880,34,30-34,1914,21.174592383625775
SIM,1857,43,45-49,1900,4
SIM,1899,82,na,1981,1457
STAT,1876,68,na,1944,1823.1073575172018
SIM,1947,33,40-44,1980,1
STAT,1978,18,35-39,1996,6.606684547528611
SIM,1872,33,35-39,1905,29
SIM,1884,18,30-34,1902,5
SIM,1866,41,50-100,1907,4
STAT,1864,30,30-34,1894,18.135834705148223
STAT,1939,33,40-44,1972,4.60696560289729
SIM,1957,22,45-49,1979,1
SIM,1877,103,na,1980,30
SIM,1864,42,40-44,1906,5
STAT,1975,28,15-19,2003,1.078918921999262
STAT,1949,40,45-49,1989,0.23278566123668734
STAT,1907,19,15-19,1926,10.022677634385296
SIM,1915,19,15-19,1934,11
STAT,1895,27,35-39,1922,14.494542873039746
SIM,1829,66,na,1895,1019
STAT,1865,76,na,1941,986.4898073467201
SIM,1829,44,50-100,1873,4
SIM,1942,46,50-100,1988,1
STAT,1824,44,15-19,1868,0.019004191531187386
STAT,1841,28,45-49,1869,1.217296388652236
STAT,1934,46,50-100,1980,0.3647500300646256
SIM,1965,49,30-34,2014,1
STAT,1891,31,35-39,1922,14.50344738541014
SIM,1935,16,30-34,1951,26
STAT,1933,15,45-49,1948,0.7756490112514114
SIM,1920,33,na,1953,4239
STAT,1936,25,40-44,1961,5.155406607447429
STAT,1885,41,20-24,1926,0.18363832885141854
STAT,1965,34,50-100,1999,1.2126639677136988
STAT,1963,48,45-49,2011,0.3305266492608833
STAT,1866,47,25-29,1913,0.061325282375102194
STAT,1931,50,na,1981,5619.084497596033
SIM,1942,66,na,2008,4200
SIM,1873,91,na,1964,153
SIM,1977,34,na,2011,6047
STAT,1865,26,40-44,1891,3.1298531962235137
STAT,1898,32,30-34,1930,27.231577735125786
STAT,1942,43,25-29,1985,0.0893739995342245
STAT,1927,16,30-34,1943,17.52903977857453
SIM,1918,29,na,1947,3896
STAT,1920,24,35-39,1944,11.999645244387553
STAT,1957,49,30-34,2006,0.14026039840229917
STAT,1846,69,na,1915,1517.1200809451077
STAT,1845,16,15-19,1861,5.084366890679969
STAT,1940,48,20-24,1988,0.013435930204951471
SIM,1941,15,45-49,1956,2
SIM,1944,9,na,1953,4671
STAT,1906,42,45-49,1948,0.17468505530318237
STAT,1885,39,50-100,1924,1.3990421705998881
STAT,1962,46,na,2008,5664.520520628237
STAT,1894,17,50-100,1911,0.07268137271531658
STAT,1852,35,30-34,1887,5.15807780549865
STAT,1816,53,20-24,1869,0.001416243818019868
STAT,1911,24,25-29,1935,100.55055240357822
SIM,1860,35,30-34,1895,16
SIM,1970,15,40-44,1985,4
STAT,1876,14,na,1890,3070.904798448287
STAT,1902,15,15-19,1917,9.722005700248559
SIM,1924,24,50-100,1948,2
STAT,1839,42,50-100,1881,0.8830244175303279
STAT,1862,54,30-34,1916,0.00563795672897059
SIM,1848,39,na,1887,1795
STAT,1907,17,na,1924,4288.415281814336
STAT,1918,25,20-24,1943,22.56604452746999
SIM,1896,88,na,1984,946
STAT,1790,94,na,1884,4.464189703966945
STAT,1865,41,35-39,1906,1.8940523777069405
STAT,1868,19,na,1887,2817.526260729964
STAT,1886,15,20-24,1901,21.681408035528516
STAT,1922,91,na,2013,661.3449660458186
STAT,1932,41,45-49,1973,0.26075298365551103
SIM,1988,4,na,1992,6639
STAT,1882,40,25-29,1922,0.7311529391678817
SIM,1876,34,na,1910,2623
SIM,1940,32,45-49,1972,1
SIM,1848,34,35-39,1882,5
SIM,1879,3,na,1882,3157
SIM,1982,17,na,1999,6367
STAT,1907,25,45-49,1932,1.8980568654297107
STAT,1871,45,40-44,1916,0.19851884468349937
STAT,1906,21,50-100,1927,0.68833052748201
STAT,1944,15,20-24,1959,168.47213504981292
SIM,1870,43,na,1913,2986
STAT,1879,23,35-39,1902,7.010135198864647
STAT,1979,30,30-34,2009,25.547266299301857
STAT,1801,97,na,1898,2.2548612592091146
STAT,1911,48,50-100,1959,0.24663302293810713
STAT,1932,32,45-49,1964,2.4146731117568727
STAT,1914,96,na,2010,168.61306101393757
SIM,1873,41,35-39,1914,2
STAT,1968,44,15-19,2012,0.002292750654282538
SIM,1997,1,na,1998,6625
STAT,1921,20,na,1941,4786.670338838768
STAT,1934,31,50-100,1965,1.3041515848254743
SIM,1919,70,na,1989,4017
STAT,1892,37,25-29,1929,4.16456966333064
SIM,1887,23,35-39,1910,18
STAT,1883,41,na,1924,2621.410820161777
SIM,1863,61,na,1924,1946
STAT,1965,26,45-49,1991,2.5009572026915783
SIM,1840,41,40-44,1881,6
SIM,1808,50,na,1858,1660
STAT,1842,43,20-24,1885,0.12483057811483511
STAT,1887,51,na,1938,2798.1419395681964
STAT,1782,99,na,1881,0.48207662406807955
SIM,1909,26,30-34,1935,5
STAT,1900,43,20-24,1943,0.017532661455424595
STAT,1889,32,na,1921,3394.692768737507
STAT,1856,34,50-100,1890,0.799801026657044
SIM,1861,80,na,1941,18
SIM,1968,45,35-39,2013,1
SIM,1821,47,45-49,1868,1
SIM,1913,51,na,1964,4381
SIM,1951,32,20-24,1983,1
STAT,1856,50,25-29,1906,0.0031633777490505358
SIM,1922,14,na,1936,5435
SIM,1960,32,30-34,1992,30
STAT,1961,29,na,1990,5604.1008631692985
SIM,1847,36,40-44,1883,11
STAT,1943,35,25-29,1978,1.2436625650708268
SIM,1973,26,45-49,1999,4
SIM,1897,27,40-44,1924,17
SIM,1962,21,40-44,1983,8
STAT,1924,47,25-29,1971,0.07285963019243702
SIM,1883,16,na,1899,2721
STAT,1844,33,15-19,1877,0.14096785206870246
STAT,1904,82,na,1986,1593.6819286374198
SIM,1868,28,25-29,1896,58
STAT,1840,48,15-19,1888,3.1946301200500715E-4
STAT,1832,41,40-44,1873,1.9363999411813997
STAT,1848,64,na,1912,1847.05397811663
STAT,1943,41,20-24,1984,0.022494984693439097
SIM,1849,38,50-100,1887,1
STAT,1844,18,20-24,1862,18.738599033513687
STAT,1805,52,50-100,1857,0.053970156649394765
SIM,1919,15,35-39,1934,1
STAT,1943,32,20-24,1975,3.042981474671463
STAT,1881,60,na,1941,2122.937196602154
STAT,1855,22,35-39,1877,5.8008005894602555
SIM,1831,39,50-100,1870,2
STAT,1849,25,45-49,1874,1.034922055991171
SIM,1855,47,50-100,1902,1
STAT,1889,27,40-44,1916,4.261397149166
STAT,1926,42,30-34,1968,0.1818488883635592
SIM,1986,15,20-24,2001,444
STAT,1852,89,na,1941,99.04587147150689
SIM,1815,48,30-34,1863,1
STAT,1954,21,40-44,1975,4.814402417410156
SIM,1868,39,na,1907,3038
STAT,1865,49,30-34,1914,0.09868909457793411
STAT,1898,49,na,1947,3436.405275749601
STAT,1937,9,na,1946,4471.736254945036
STAT,1896,14,na,1910,3923.7388708084136
STAT,1813,47,45-49,1860,0.7828346451101637
SIM,1863,16,na,1879,2809
STAT,1859,51,20-24,1910,6.816185246036506E-4
STAT,1956,28,na,1984,5742.620427515015
STAT,1962,15,40-44,1977,2.069346588020456
SIM,1894,53,na,1947,3434
STAT,1908,21,15-19,1929,5.671900491397534
SIM,1916,21,15-19,1937,10
STAT,1907,48,35-39,1955,0.1324070093134882
SIM,1903,21,na,1924,4158
STAT,1960,34,15-19,1994,0.1966309366140632
STAT,1829,32,35-39,1861,13.13618860023993
STAT,1839,36,40-44,1875,4.191880805235389
STAT,1818,43,15-19,1861,0.01795232636254744
STAT,1905,36,na,1941,3985.3831870090935
SIM,1917,75,na,1992,3230
STAT,1807,48,30-34,1855,0.39471632949768065
STAT,1821,97,na,1918,3.2856187160764105
STAT,1907,22,40-44,1929,3.5382546623372497
STAT,1875,30,40-44,1905,5.213521079849297
STAT,1923,49,30-34,1972,0.11960022810328001
SIM,1841,15,40-44,1856,1
STAT,1926,5,na,1931,5687.8945859817495
SIM,1926,25,20-24,1951,50
STAT,1959,2,na,1961,5940.523853049618
STAT,1867,52,50-100,1919,0.01618640808972014
SIM,1852,24,na,1876,2057
STAT,1865,22,na,1887,2492.556464632397
SIM,1852,18,20-24,1870,45
STAT,1934,44,15-19,1978,0.0024599996576512248
STAT,1923,41,35-39,1964,0.2719035592563213
STAT,1939,36,45-49,1975,0.812395837344809
STAT,1958,47,25-29,2005,0.083631115977368
SIM,1863,44,45-49,1907,2
SIM,1979,11,na,1990,6470
SIM,1883,30,40-44,1913,4
STAT,1895,24,30-34,1919,26.589962368801878
STAT,1848,51,45-49,1899,0.01549362009432339
STAT,1983,31,35-39,2014,15.215936435470875
STAT,1925,35,50-100,1960,0.5823654783542872
STAT,1881,46,na,1927,2511.473593015238
SIM,1774,90,na,1864,93
SIM,1858,15,na,1873,3160
STAT,1891,39,30-34,1930,7.525166216418586
STAT,1891,101,na,1992,17.00227893922412
STAT,1878,94,na,1972,120.05042236477904
STAT,1893,101,na,1994,17.78677165603582
STAT,1928,31,40-44,1959,5.650145791602709
STAT,1952,32,30-34,1984,22.209939035252876
SIM,1865,96,na,1961,23
SIM,1785,82,na,1867,204
SIM,1893,41,20-24,1934,1
SIM,1984,12,na,1996,6304
STAT,1837,20,50-100,1857,0.40530189859108656
STAT,1869,19,35-39,1888,0.6144313230906961
STAT,1933,38,35-39,1971,3.7998555554986653
STAT,1936,28,na,1964,4137.886301907499
STAT,1889,86,na,1975,797.591562634141
STAT,1917,42,20-24,1959,0.021269768586636924
SIM,1831,41,30-34,1872,3
SIM,1944,43,na,1987,4559
STAT,1845,22,na,1867,1788.6452017852475
SIM,1939,24,20-24,1963,2
SIM,1947,36,45-49,1983,2
STAT,1990,19,20-24,2009,223.91670789990917
SIM,1832,24,na,1856,2196
SIM,1880,73,na,1953,1565
SIM,1840,35,50-100,1875,1
SIM,1902,34,35-39,1936,3
STAT,1832,89,na,1921,71.57194923443753
SIM,1817,47,na,1864,1433
SIM,1877,19,35-39,1896,2
STAT,1921,74,na,1995,3297.8324222137403
STAT,1823,41,30-34,1864,1.2307096968252236
STAT,1918,40,15-19,1958,0.0018891173549586873
STAT,1887,30,30-34,1917,22.762564043764577
STAT,1975,35,50-100,2010,0.6596910857706899
STAT,1863,41,na,1904,2342.848613292722
STAT,1967,38,35-39,2005,3.588624475291077
STAT,1960,25,50-100,1985,1.5038626936619823
STAT,1920,21,30-34,1941,36.96986875328123
STAT,1900,44,na,1944,3663.7682099395465
STAT,1901,35,20-24,1936,0.2715062193395171
STAT,1908,28,30-34,1936,42.65010226133544
STAT,1959,47,40-44,2006,0.24756008360762025
STAT,1841,40,35-39,1881,1.7163883838070633
STAT,1952,40,15-19,1992,0.0022132588694707667
STAT,1957,45,na,2002,5841.727781575793
STAT,1918,29,50-100,1947,1.2134539677343958
SIM,1891,34,50-100,1925,2
SIM,1855,23,50-100,1878,1
STAT,1989,13,na,2002,6492.0796412368045
STAT,1871,23,30-34,1894,20.387559055145058
SIM,1913,19,15-19,1932,13
SIM,1876,88,na,1964,285
STAT,1881,42,30-34,1923,1.2781536114125558
SIM,1858,0,na,1858,4064
STAT,1850,40,45-49,1890,1.5562566278074825
STAT,1824,50,45-49,1874,0.019804691251467204
STAT,1987,23,15-19,2010,8.79601397415582
STAT,1947,8,na,1955,5108.980423724758
SIM,1975,38,35-39,2013,10
STAT,1905,19,15-19,1924,9.859453322392511
STAT,1895,49,45-49,1944,0.19580191141528946
SIM,1896,34,na,1930,3666
SIM,1917,93,na,2010,328
SIM,1919,56,na,1975,5027
SIM,1988,26,na,2014,6603
STAT,1857,19,45-49,1876,0.06819698507621218
STAT,1800,78,na,1878,426.62212662414123
SIM,1970,31,30-34,2001,12
SIM,1920,30,50-100,1950,1
STAT,1875,15,45-49,1890,0.07826527025075873
STAT,1896,68,na,1964,2591.400072768988
STAT,1770,94,na,1864,1.894152876579446
STAT,1885,44,25-29,1929,0.729215191833604
STAT,1918,54,na,1972,4393.057458269881
STAT,1879,53,30-34,1932,0.0070577653669322855
SIM,1916,28,30-34,1944,46
STAT,1865,29,45-49,1894,1.1478469332512595
SIM,1848,31,30-34,1879,4
STAT,1878,40,na,1918,2813.0422614522713
SIM,1877,34,30-34,1911,46
STAT,1871,48,45-49,1919,0.26755322765120987
SIM,1874,53,na,1927,2368
STAT,1820,54,25-29,1874,0.003342286960526719
SIM,1850,30,45-49,1880,5
STAT,1816,40,45-49,1856,3.64590255978518
SIM,2006,5,na,2011,7590
STAT,1932,12,na,1944,6056.3462601814035
STAT,1824,47,20-24,1871,0.01630065008892163
STAT,1850,54,na,1904,2155.6157419374076
STAT,1912,30,50-100,1942,0.9473383553507505
SIM,1975,8,na,1983,6127
SIM,1839,29,45-49,1868,3
SIM,1909,29,35-39,1938,47
STAT,1969,19,40-44,1988,2.015076489343926
SIM,1891,11,na,1902,3656
SIM,1944,61,na,2005,4160
SIM,1861,35,na,1896,1877
SIM,1895,30,30-34,1925,55
SIM,1898,25,35-39,1923,25
STAT,1972,9,na,1981,5806.463805573202
STAT,1947,11,na,1958,5107.192489014763
STAT,1929,47,50-100,1976,0.3383461322216392
STAT,1898,35,35-39,1933,11.13626392593028
STAT,1892,34,20-24,1926,3.8763228638771463
STAT,1915,7,na,1922,4813.209218300146
SIM,1835,66,na,1901,1347
STAT,1853,49,40-44,1902,0.1668911055889141
STAT,1780,101,na,1881,0.19318956100790244
SIM,1871,38,45-49,1909,5
SIM,1894,18,25-29,1912,21
STAT,1976,17,50-100,1993,0.577644802917797
SIM,1887,20,30-34,1907,37
STAT,1881,34,45-49,1915,1.9244803139989515
SIM,1830,74,na,1904,783
STAT,1869,34,30-34,1903,19.34606167646036
STAT,1841,91,na,1932,51.52083328109842
STAT,1954,24,45-49,1978,1.6094552372393283
STAT,1855,52,30-34,1907,0.0050380342471298975
SIM,1791,68,na,1859,771
STAT,1879,16,25-29,1895,6.845285717415148
STAT,1886,18,25-29,1904,6.880098501460011
SIM,1889,52,na,1941,3414
STAT,1837,22,15-19,1859,3.1272771508167745
STAT,1804,53,30-34,1857,0.026853902780969705
SIM,1960,35,35-39,1995,9
STAT,1863,27,na,1890,2408.26485172987
STAT,1833,65,na,1898,1189.1821752399762
STAT,1981,0,na,1981,6391.856810262209
STAT,1919,50,na,1969,4556.043250910869
STAT,1949,48,40-44,1997,0.2194947746198526
STAT,1902,41,30-34,1943,0.13077075173867767
STAT,1907,45,30-34,1952,0.09363928421877034
STAT,1966,41,45-49,2007,0.24966788504765558
STAT,1823,44,35-39,1867,1.8256191843597027
STAT,1839,39,45-49,1878,1.8504061026214988
STAT,1952,35,35-39,1987,3.4522029739585656
STAT,1966,22,15-19,1988,7.698327976936778
SIM,1928,24,45-49,1952,3
STAT,1910,32,25-29,1942,10.295360628574915
STAT,1922,43,40-44,1965,0.3306507531238888
SIM,1904,20,40-44,1924,10
SIM,1974,22,15-19,1996,12
STAT,1859,54,25-29,1913,0.0031666460841523513
SIM,1792,64,na,1856,903
SIM,1868,25,20-24,1893,2
STAT,1879,56,na,1935,2457.7974975453553
STAT,1946,47,45-49,1993,0.289360253199979
SIM,1904,57,na,1961,3698
STAT,1842,46,25-29,1888,0.044903683375263695
SIM,1902,31,30-34,1933,42
SIM,1921,49,na,1970,5105
STAT,1942,27,50-100,1969,1.2058080046955582
SIM,1842,36,25-29,1878,7
STAT,1802,59,na,1861,1360.691348507353
STAT,1958,27,15-19,1985,1.0746634389785676
SIM,1814,50,na,1864,1373
STAT,1834,36,25-29,1870,3.30239831125058
STAT,1970,20,15-19,1990,7.720774469452249
SIM,1881,35,na,1916,1936
STAT,1964,43,35-39,2007,0.3036932122382838
STAT,1926,45,35-39,1971,0.18441653052310483
STAT,1806,51,40-44,1857,0.03780848126991203
STAT,1830,28,50-100,1858,0.7675933235447487
STAT,1829,25,50-100,1854,2.3265000197456933
STAT,1830,43,30-34,1873,1.088120883198323
SIM,1966,27,15-19,1993,2
SIM,1971,25,na,1996,5527
STAT,1816,73,na,1889,602.5582479883835
STAT,1863,52,25-29,1915,0.003555253463437733
STAT,1913,22,35-39,1935,10.535185347805747
STAT,1903,55,na,1958,3468.455196248904
STAT,1870,111,na,1981,0.005772447118743166
SIM,1850,43,na,1893,1528
STAT,1933,35,30-34,1968,2.8711215005069555
STAT,1817,58,na,1875,1648.3816989684185
STAT,1950,37,25-29,1987,1.3841784972314146
SIM,1968,25,25-29,1993,175
SIM,1946,24,na,1970,4327
SIM,1926,17,35-39,1943,10
STAT,1981,19,na,2000,5935.716798414742
STAT,1983,21,50-100,2004,1.0781143283090169
SIM,1942,18,30-34,1960,18
STAT,1856,100,na,1956,1.108773442379052
SIM,1825,42,na,1867,1730
STAT,1934,18,30-34,1952,18.9858317030982
SIM,1831,44,35-39,1875,3
STAT,1785,93,na,1878,4.646364197600503
STAT,1944,30,15-19,1974,0.16286900681735828
STAT,1928,34,45-49,1962,2.2677148151654096
STAT,1826,45,30-34,1871,0.0714915881720711
STAT,1883,46,15-19,1929,4.529188141974241E-4
STAT,1843,41,na,1884,2418.5159582753768
STAT,1953,31,na,1984,5385.107679787991
STAT,1930,43,35-39,1973,0.30531831384030966
STAT,1829,91,na,1920,42.451372269778396
STAT,1850,37,20-24,1887,0.8061135970183211
SIM,1767,94,na,1861,11
SIM,1941,35,30-34,1976,2
SIM,1893,91,na,1984,78
SIM,1936,34,45-49,1970,5
STAT,1964,23,na,1987,5323.740276298622
SIM,1950,46,30-34,1996,1
STAT,1858,40,na,1898,2101.77258500298
STAT,1886,0,na,1886,4042.847997437002
SIM,1845,22,15-19,1867,5
SIM,1921,22,35-39,1943,1
SIM,1936,48,na,1984,3885
STAT,1829,54,45-49,1883,0.012504449207831576
SIM,1878,69,na,1947,1641
STAT,1883,34,50-100,1917,1.0256685890027173
SIM,1852,78,na,1930,339
STAT,1927,19,35-39,1946,5.987519649530133
SIM,1935,19,35-39,1954,10
STAT,1846,103,na,1949,0.14836325919861754
STAT,1866,44,20-24,1910,0.16758323412595766
SIM,1918,35,40-44,1953,2
STAT,1942,46,30-34,1988,0.11212562424066533
STAT,1957,4,na,1961,5983.757413293798
STAT,1820,49,45-49,1869,0.23417580028963916
STAT,1822,52,35-39,1874,0.015660487021759553
SIM,1910,57,na,1967,3187
SIM,1931,25,na,1956,6110
STAT,1970,33,15-19,2003,0.18911167007887414
STAT,1887,8,na,1895,3362.05297315284
STAT,1910,23,50-100,1933,0.7116409215564419
STAT,1936,18,50-100,1954,0.4131104489654105
SIM,1920,29,35-39,1949,3
STAT,1930,17,50-100,1947,0.5590600516254906
STAT,1872,40,30-34,1912,1.3456808483822682
STAT,1874,33,na,1907,2807.4031499339103
STAT,1916,24,50-100,1940,0.7908027337837004
STAT,1809,91,na,1900,26.932970945546625
SIM,1920,24,40-44,1944,7
STAT,1846,53,35-39,1899,0.00875699397235403
SIM,1948,17,20-24,1965,1
STAT,1893,32,15-19,1925,0.20773271395818302
STAT,1912,49,na,1961,4054.566054038041
STAT,1883,29,30-34,1912,28.22947499081105
STAT,1973,34,45-49,2007,2.3909283639194254
STAT,1846,38,na,1884,2517.142646738707
STAT,1883,40,40-44,1923,2.5652658840593587
STAT,1912,24,40-44,1936,3.854721825344135
STAT,1835,53,25-29,1888,0.002208453303447752
STAT,1872,49,50-100,1921,0.2786595525574938
SIM,1959,17,30-34,1976,23
STAT,1876,45,na,1921,2710.7709210067587
SIM,1891,2,na,1893,3725
STAT,1929,17,45-49,1946,0.7357596724532833
SIM,1880,40,30-34,1920,1
SIM,1938,43,45-49,1981,1
STAT,1901,24,30-34,1925,28.612997473830994
SIM,1988,16,35-39,2004,8
SIM,1858,20,35-39,1878,1
SIM,1828,26,30-34,1854,44
STAT,1933,16,25-29,1949,67.14087841422258
SIM,1788,79,na,1867,27
SIM,1882,23,50-100,1905,1
STAT,1861,40,20-24,1901,0.1539038016182606
STAT,1912,29,35-39,1941,16.96860311217217
SIM,1937,44,na,1981,4332
STAT,1832,80,na,1912,421.4436749783411
STAT,1866,38,na,1904,2507.5992512199814
SIM,1935,32,na,1967,6174
SIM,1790,83,na,1873,76
STAT,1956,49,15-19,2005,5.816860951314937E-4
STAT,1970,25,40-44,1995,6.768477634123846
SIM,1839,26,40-44,1865,6
SIM,1964,33,45-49,1997,5
SIM,1941,16,25-29,1957,67
SIM,1864,34,50-100,1898,1
SIM,1984,21,15-19,2005,4
STAT,1811,49,35-39,1860,0.4219551868225205
SIM,1893,41,50-100,1934,5
STAT,1884,46,30-34,1930,0.11068676213088924
STAT,1840,51,40-44,1891,0.008485704004283301
SIM,1879,28,35-39,1907,22
SIM,1827,43,30-34,1870,3
STAT,1867,42,15-19,1909,0.01486161196050387
SIM,1965,16,45-49,1981,1
STAT,1843,44,50-100,1887,1.0638037126350433
STAT,1894,87,na,1981,776.5888584379097
SIM,1942,33,25-29,1975,17
STAT,1873,21,40-44,1894,2.4631616864045442
STAT,1950,34,20-24,1984,3.388286140201687
STAT,1907,46,50-100,1953,0.23590334317375178
SIM,1898,22,30-34,1920,71
SIM,1901,39,45-49,1940,2
SIM,1884,29,20-24,1913,26
STAT,1896,99,na,1995,44.81342097693834
STAT,1944,35,40-44,1979,1.9187921251045819
SIM,1928,85,na,2013,1862
STAT,1853,26,15-19,1879,0.5270759030401009
SIM,1947,58,na,2005,5556
STAT,1857,16,40-44,1873,0.1943658602348524
STAT,1889,42,35-39,1931,2.5728365483545144
SIM,1915,26,25-29,1941,90
STAT,1876,29,20-24,1905,13.895345763999043
STAT,1969,44,30-34,2013,0.19089988859171067
SIM,1881,89,na,1970,182
STAT,1861,15,na,1876,2561.3313215736684
SIM,1879,46,50-100,1925,1
STAT,1890,45,45-49,1935,0.33610612450973554
STAT,1941,40,40-44,1981,0.30992028080400313
STAT,1957,16,45-49,1973,0.7602979495227912
STAT,1978,30,15-19,2008,0.20653502255990747
STAT,1887,33,35-39,1920,13.042295794878694
SIM,1895,33,35-39,1928,27
STAT,1813,44,40-44,1857,7.789125490991828
STAT,1855,44,45-49,1899,1.2562948071042899
STAT,1907,26,25-29,1933,72.07323236645361
STAT,1934,33,25-29,1967,14.561472015970002
STAT,1870,45,25-29,1915,0.0661862476512119
SIM,1900,33,20-24,1933,1
STAT,1919,43,35-39,1962,0.25137566961822194
SIM,1821,44,40-44,1865,4
STAT,1921,41,50-100,1962,0.15286733691769058
SIM,1906,52,na,1958,3381
STAT,1933,49,25-29,1982,0.08372693737394206
SIM,1930,46,45-49,1976,4
STAT,1922,46,45-49,1968,0.28873429258519395
STAT,1965,27,25-29,1992,95.2410506378105
STAT,1861,60,na,1921,1829.7619547573963
STAT,1911,46,35-39,1957,0.1413312853169179
SIM,1867,23,na,1890,2218
SIM,1871,35,40-44,1906,1
STAT,1890,39,15-19,1929,0.07838772329347568
SIM,1878,15,na,1893,3068
STAT,1939,39,15-19,1978,0.022814894172742357
SIM,1933,47,40-44,1980,1
STAT,1872,52,na,1924,2481.8127984992843
STAT,1939,34,20-24,1973,2.869580064895626
STAT,1942,21,15-19,1963,6.444318257917567
STAT,1966,48,50-100,2014,0.3381685693347877
STAT,1920,46,45-49,1966,0.2778283701224763
SIM,1860,50,na,1910,2249
STAT,1888,16,35-39,1904,0.7461930582957172
SIM,1897,42,35-39,1939,1
STAT,1900,46,25-29,1946,0.05217768440689929
SIM,1908,26,15-19,1934,1
STAT,1847,31,40-44,1878,3.958846978896115
SIM,1874,21,30-34,1895,47
SIM,1904,23,45-49,1927,2
STAT,1838,36,50-100,1874,1.296894589845334
STAT,1877,27,15-19,1904,0.5446449107374356
STAT,1819,43,30-34,1862,2.3437611140179127
STAT,1905,67,na,1972,3093.3112625790586
STAT,1808,46,25-29,1854,0.29299805087522074
STAT,1946,44,40-44,1990,0.33161008613681464
SIM,1909,9,na,1918,5120
STAT,1833,30,35-39,1863,9.461137210534897
SIM,1824,35,50-100,1859,4
SIM,1898,15,na,1913,4139
STAT,1945,33,35-39,1978,11.735706069680557
STAT,1971,23,35-39,1994,13.803840935758403
STAT,1925,47,40-44,1972,0.2204088490447557
STAT,1892,52,na,1944,3097.920949971486
SIM,1933,51,na,1984,6256
STAT,1915,74,na,1989,2949.415888493189
SIM,1885,27,15-19,1912,1
STAT,1941,29,na,1970,4468.938097382458
STAT,1779,106,na,1885,0.011456586004564426
SIM,1847,100,na,1947,7
SIM,1865,39,30-34,1904,12
STAT,1857,50,40-44,1907,0.009598341922998735
STAT,1969,1,na,1970,5676.481098476547
STAT,1956,33,45-49,1989,2.447882804603783
SIM,1811,70,na,1881,1108
SIM,1964,47,na,2011,5717
STAT,1951,36,na,1987,5331.3910529294935
SIM,1855,31,40-44,1886,1
STAT,1880,19,na,1899,3072.8576116475847
STAT,1960,23,25-29,1983,139.25125711541332
STAT,1850,23,na,1873,2622.891776517966
STAT,1916,31,15-19,1947,0.15375060796998405
STAT,1899,16,45-49,1915,0.10353313742024348
SIM,1896,16,35-39,1912,3
SIM,1902,45,na,1947,3817
SIM,1948,32,50-100,1980,4
STAT,1935,44,30-34,1979,0.20752743159063622
SIM,1858,39,20-24,1897,1
STAT,1884,111,na,1995,0.012153435552341569
SIM,1844,40,50-100,1884,1
STAT,1961,34,30-34,1995,23.913984025760662
STAT,1975,40,40-44,2015,0.3968463206802359
STAT,1829,46,na,1875,1822.2323268899684
STAT,1838,71,na,1909,1156.2176840683042
STAT,1846,16,30-34,1862,2.082124896976423
STAT,1965,29,15-19,1994,1.0204938101021301
STAT,1927,31,25-29,1958,13.125700920194202
STAT,1948,7,na,1955,5191.06255084544
STAT,1947,31,45-49,1978,2.086319498719792
STAT,1878,42,25-29,1920,0.7728180493204613
SIM,1953,33,35-39,1986,14
SIM,1841,30,35-39,1871,29
SIM,1843,16,na,1859,2328
STAT,1884,49,35-39,1933,0.15629796608804983
STAT,1882,45,na,1927,2561.3376426472487
SIM,1954,36,na,1990,5436
SIM,1854,16,30-34,1870,5
SIM,1891,40,40-44,1931,2
STAT,1947,36,50-100,1983,0.562814267051892
SIM,1857,30,na,1887,2650
SIM,1801,63,na,1864,1287
STAT,1852,43,15-19,1895,0.01292603860361229
STAT,1864,49,15-19,1913,4.035703575791653E-4
SIM,1938,29,na,1967,4094
STAT,1897,18,35-39,1915,0.8445131991596259
SIM,1812,55,na,1867,1287
STAT,1922,49,15-19,1971,4.85304741789013E-4
SIM,1829,41,40-44,1870,1
STAT,1825,53,na,1878,1654.4449827966203
STAT,1902,44,35-39,1946,0.20227823179909885
STAT,1973,37,15-19,2010,0.029528779811625296
STAT,1843,41,15-19,1884,0.014450812866305618
STAT,1916,59,na,1975,4089.6026669062103
SIM,1810,44,30-34,1854,3
SIM,1869,20,45-49,1889,1
SIM,1853,33,30-34,1886,26
SIM,1863,30,na,1893,2528
SIM,1847,23,na,1870,2896
STAT,1920,44,na,1964,4715.8943976060345
STAT,1806,48,15-19,1854,0.0014504925022814229
STAT,1996,17,30-34,2013,20.442744163480317
STAT,1866,21,30-34,1887,19.347606583212716
SIM,1948,36,na,1984,4400
SIM,1891,29,30-34,1920,79
STAT,1815,46,na,1861,1707.362390375772
SIM,1970,34,35-39,2004,2
STAT,1930,40,30-34,1970,0.1946893318265909
STAT,1926,16,15-19,1942,64.35813787999015
STAT,1819,39,na,1858,1929.626651521729
STAT,1845,33,30-34,1878,13.844505862955025
STAT,1961,47,30-34,2008,0.13825309429964314
STAT,1827,36,15-19,1863,0.08438166524249241
STAT,1867,88,na,1955,147.9214799329264
STAT,1910,37,na,1947,4156.736397663538
SIM,1934,16,15-19,1950,130
SIM,1928,21,40-44,1949,6
SIM,1787,94,na,1881,13
STAT,1762,99,na,1861,0.4511095226929319
STAT,1846,50,30-34,1896,0.006242069487001886
STAT,1901,20,na,1921,3845.8708019357505
STAT,1833,38,30-34,1871,4.676245498529404
SIM,1815,40,35-39,1855,3
STAT,1912,27,45-49,1939,1.9666346953843308
STAT,1835,46,na,1881,1497.0345726062567
STAT,1845,53,na,1898,1427.6264969664971
STAT,1854,27,50-100,1881,0.5463408213076244
STAT,1861,43,25-29,1904,0.6116395993271198
STAT,1963,45,40-44,2008,0.24157194661145334
SIM,1952,18,25-29,1970,135
SIM,1963,41,50-100,2004,1
SIM,1843,61,na,1904,1495
STAT,1860,23,20-24,1883,65.59951833867788
STAT,1834,33,50-100,1867,1.0599872239245625
STAT,1898,36,15-19,1934,0.08800470779721767
STAT,1951,37,40-44,1988,2.119441483928154
STAT,1970,28,45-49,1998,2.50534501118835
SIM,1777,87,na,1864,113
SIM,1935,31,25-29,1966,17
STAT,1876,30,50-100,1906,1.101847753874229
STAT,1902,56,na,1958,3398.2849543539005
STAT,1853,52,30-34,1905,0.005894921665958053
STAT,1901,27,35-39,1928,15.597326271406418
STAT,1911,21,20-24,1932,122.17341975325654
STAT,1971,36,35-39,2007,3.645651964479428
SIM,1844,97,na,1941,15
SIM,1894,22,na,1916,3485
STAT,1892,112,na,2004,0.006480273333127486
STAT,1872,43,35-39,1915,2.083216811457917
STAT,1907,23,20-24,1930,116.65010429459821
STAT,1934,47,na,1981,5909.869390507871
STAT,1820,46,40-44,1866,0.1857702233269975
STAT,1915,92,na,2007,474.24100645089027
STAT,1907,48,na,1955,3772.8734333496227
STAT,1883,43,45-49,1926,1.677637817543042
STAT,1954,46,45-49,2000,0.3233214594093033
SIM,1957,19,20-24,1976,4
SIM,1917,44,na,1961,5300
STAT,1956,23,50-100,1979,1.0077964471556657
SIM,1941,18,15-19,1959,90
STAT,1814,61,na,1875,1459.1765837925836
STAT,1829,60,na,1889,1420.9298095540241
STAT,1884,26,na,1910,2730.502199441619
SIM,1966,19,50-100,1985,3
SIM,1880,43,35-39,1923,4
STAT,1840,54,45-49,1894,0.011321736618715987
STAT,1933,18,15-19,1951,69.9580661093465
STAT,1876,99,na,1975,21.879790111312904
STAT,1922,70,na,1992,3816.0033030740765
STAT,1835,50,20-24,1885,4.8825932576418933E-4
STAT,1830,54,na,1884,1347.3192390683737
SIM,1960,54,na,2014,5910
SIM,1818,43,na,1861,2148
SIM,1842,33,50-100,1875,1
SIM,1841,38,30-34,1879,9
STAT,1894,33,na,1927,3525.2464117705194
STAT,1811,46,30-34,1857,0.30687238275715945
STAT,1917,55,na,1972,4289.553410361822
SIM,1891,43,45-49,1934,9
STAT,1777,98,na,1875,0.4329644607910156
SIM,1907,37,na,1944,4513
STAT,1820,47,na,1867,1513.5471166106338
SIM,1837,32,35-39,1869,4
SIM,1915,23,20-24,1938,11
STAT,1944,18,25-29,1962,53.80448973509773
STAT,1900,21,45-49,1921,1.1200311433183188
SIM,1962,46,45-49,2008,1
STAT,1834,33,20-24,1867,3.1271177520379965
SIM,1926,28,25-29,1954,162
SIM,1978,27,30-34,2005,65
SIM,1939,46,30-34,1985,1
SIM,1869,23,15-19,1892,3
SIM,1973,24,20-24,1997,11
STAT,1965,24,20-24,1989,160.62494811097815
STAT,1918,31,50-100,1949,1.01785158637112
STAT,1864,26,na,1890,2467.61200393868
SIM,1986,18,25-29,2004,92
STAT,1842,24,15-19,1866,3.1562102170673625
STAT,1913,44,45-49,1957,0.18677687597242623
SIM,1926,31,50-100,1957,2
STAT,1843,72,na,1915,1267.1647094576472
STAT,1890,42,40-44,1932,3.167844355349854
STAT,1955,38,20-24,1993,0.41564810420046555
SIM,1850,24,15-19,1874,6
SIM,1953,30,30-34,1983,7
STAT,1791,79,na,1870,306.23391553104483
STAT,1919,40,30-34,1959,0.1602922554492771
STAT,1886,30,15-19,1916,0.17474789665108684
STAT,1918,28,25-29,1946,80.53613692571224
STAT,1949,19,20-24,1968,181.84349589189532
SIM,1830,30,25-29,1860,5
STAT,1958,19,50-100,1977,0.5674989618792933
STAT,1876,44,15-19,1920,0.016252455354004443
STAT,1964,40,30-34,2004,0.19365306924191597
SIM,1980,31,25-29,2011,30
SIM,1865,42,na,1907,2808
SIM,1904,71,na,1975,2930
STAT,1980,1,na,1981,6308.284575470979
SIM,1961,21,25-29,1982,144
SIM,1884,30,50-100,1914,2
SIM,1842,33,20-24,1875,2
STAT,1882,48,20-24,1930,0.01335661856651504
SIM,1809,80,na,1889,346
STAT,1972,31,25-29,2003,13.928957588239141
STAT,1933,46,20-24,1979,0.01758957896560721
SIM,1826,28,20-24,1854,24
STAT,1854,41,25-29,1895,0.5255305885163339
SIM,1871,38,50-100,1909,1
SIM,1959,46,na,2005,5844
STAT,1836,29,50-100,1865,0.7427889717897723
SIM,1931,74,na,2005,3890
STAT,1953,21,25-29,1974,129.42164656534706
SIM,1979,33,50-100,2012,5
STAT,1863,38,50-100,1901,1.2327826170190532
STAT,1881,15,na,1896,2824.3875125413347
STAT,1839,51,35-39,1890,0.006860079084351492
STAT,1979,33,35-39,2012,14.792127045649249
STAT,1944,38,45-49,1982,0.8714135784613073
SIM,1951,35,25-29,1986,2
SIM,1901,36,40-44,1937,5
STAT,1931,44,50-100,1975,0.18055778425545188
STAT,1871,104,na,1975,1.3271492117738413
STAT,1872,111,na,1983,0.006962259426866289
STAT,1847,34,na,1881,1921.530754268453
STAT,1924,44,20-24,1968,0.02415509556215001
STAT,1823,33,45-49,1856,4.350404228095998
STAT,1939,37,25-29,1976,1.1722773276981908
STAT,1929,48,20-24,1977,0.01648561286642496
SIM,1892,41,na,1933,3698
STAT,1878,26,na,1904,2885.522933849964
SIM,1881,21,40-44,1902,5
STAT,1858,100,na,1958,1.565727905294909
SIM,1903,20,25-29,1923,102
STAT,1932,35,15-19,1967,0.029835170080003512
SIM,1869,4,na,1873,2516
SIM,1900,25,50-100,1925,1
STAT,1956,30,40-44,1986,6.09831272150126
STAT,1893,48,30-34,1941,0.07864997487064541
STAT,2012,3,na,2015,7229.909763482461
SIM,1987,5,na,1992,6564
SIM,1915,63,na,1978,3793
SIM,1905,56,na,1961,3640
SIM,1898,69,na,1967,2947
STAT,1945,30,30-34,1975,20.268566329049065
STAT,1912,19,50-100,1931,0.08704460451242618
STAT,1848,19,na,1867,2987.9542551749296
STAT,1906,45,15-19,1951,3.8349699698894804E-4
STAT,1845,51,50-100,1896,0.0102257552418653
SIM,1893,77,na,1970,1432
SIM,1964,30,40-44,1994,16
STAT,1850,51,35-39,1901,0.008904965879945326
STAT,1917,45,25-29,1962,0.06424403342720938
SIM,1915,28,15-19,1943,2
SIM,1976,7,na,1983,6052
STAT,1779,79,na,1858,233.39894572310607
SIM,1941,18,na,1959,3484
STAT,1879,45,45-49,1924,0.2872196467094684
STAT,1971,20,30-34,1991,42.1780018652734
STAT,1874,41,45-49,1915,1.7762020958624118
STAT,1897,30,25-29,1927,15.93275767743948
STAT,1968,33,25-29,2001,13.571475259394315
SIM,1858,60,na,1918,2232
STAT,1812,80,na,1892,271.5844009407012
STAT,1895,46,40-44,1941,0.14548014306124238
SIM,1900,64,na,1964,2820
SIM,1856,34,na,1890,2115
SIM,1820,36,na,1856,1998
STAT,1914,8,na,1922,4747.971168776307
STAT,1902,5,na,1907,4273.286577977428
SIM,1955,32,na,1987,6517
STAT,1832,35,na,1867,1868.7408273409608
STAT,1933,62,na,1995,5309.5159058219315
SIM,1882,41,45-49,1923,6
SIM,1947,37,25-29,1984,1
SIM,1951,25,na,1976,5998
SIM,1830,43,na,1873,1804
SIM,1940,33,na,1973,4889
STAT,1923,55,na,1978,4802.315832174603
STAT,1908,43,25-29,1951,0.07588380167905771
STAT,1910,43,15-19,1953,0.001666595419470778
STAT,1907,28,15-19,1935,0.7676637071497707
STAT,1849,110,na,1959,4.0460405690525257E-4
STAT,1857,53,45-49,1910,0.012834478686127663
STAT,1864,52,40-44,1916,0.01079037759944697
STAT,1958,44,20-24,2002,0.027726157723653475
STAT,1950,58,na,2008,4946.454294916246
SIM,1976,33,25-29,2009,5
SIM,1826,42,50-100,1868,2
STAT,1864,7,na,1871,2899.3499056152973
STAT,1866,24,35-39,1890,6.202914571846358
STAT,1818,42,50-100,1860,1.4114566649558777
STAT,1892,21,50-100,1913,0.5916228349380629
SIM,1966,24,na,1990,5895
STAT,1895,18,na,1913,3784.005124066638
SIM,1935,18,na,1953,5593
SIM,1845,42,na,1887,2096
STAT,1901,41,15-19,1942,0.0015571934966134905
STAT,1938,25,50-100,1963,1.1395530816072184
STAT,1949,46,na,1995,5141.586306522658
STAT,1881,45,35-39,1926,0.1573917132147177
STAT,1952,48,35-39,2000,0.18494965670173183
SIM,1867,26,20-24,1893,10
STAT,1902,16,20-24,1918,28.979640060834093
STAT,1951,33,30-34,1984,22.056022005119896
STAT,1822,53,40-44,1875,0.018773239049463594
STAT,1843,12,na,1855,3061.0395000000003
STAT,1999,16,na,2015,6277.069990546178
SIM,1847,28,45-49,1875,3
STAT,1883,47,20-24,1930,0.013485941306699854
STAT,1977,38,40-44,2015,2.402420702807884
SIM,1901,32,30-34,1933,63
STAT,1907,24,50-100,1931,0.688083136793015
STAT,1898,18,na,1916,3928.817652110315
STAT,1839,20,35-39,1859,6.032523862669547
STAT,1935,43,15-19,1978,0.002497192264240196
STAT,1906,86,na,1992,1092.8947679056344
STAT,1940,47,15-19,1987,4.491124789000043E-4
STAT,1909,19,na,1928,4352.447330478702
STAT,1931,49,15-19,1980,5.652166039077886E-4
STAT,1839,28,45-49,1867,1.1013000692844899
SIM,1910,38,40-44,1948,1
STAT,1916,45,30-34,1961,0.10602764702846397
STAT,1848,26,45-49,1874,1.418557319618276
STAT,1906,32,40-44,1938,4.190589033352521
STAT,1859,36,50-100,1895,1.134102056659403
STAT,1902,38,40-44,1940,1.533049749545384
SIM,1961,32,50-100,1993,1
SIM,1905,34,40-44,1939,1
SIM,1842,15,na,1857,2696
STAT,1854,17,30-34,1871,1.5533404714815147
SIM,1949,39,25-29,1988,2
SIM,1892,97,na,1989,27
STAT,1872,25,na,1897,2784.2705130654963
SIM,1881,1,na,1882,2964
SIM,1914,32,40-44,1946,7
STAT,1898,42,35-39,1940,0.19588307390965315
SIM,1921,17,35-39,1938,10
SIM,1846,29,na,1875,1817
STAT,1792,94,na,1886,6.495045457313291
STAT,1968,30,na,1998,5563.131653618072
SIM,1950,35,30-34,1985,8
SIM,1965,30,45-49,1995,2
STAT,1872,47,45-49,1919,0.27220235543067733
STAT,1960,17,20-24,1977,203.78048210712362
SIM,1940,22,40-44,1962,7
STAT,1777,114,na,1891,1.4487941584207117E-4
STAT,1892,45,20-24,1937,0.009888524672373432
STAT,1955,2,na,1957,6028.815300585623
SIM,1930,40,na,1970,6047
STAT,1863,48,na,1911,2241.810321739822
STAT,1972,0,na,1972,5852.738230183484
STAT,1913,17,35-39,1930,0.99062158673167
SIM,1862,17,30-34,1879,2
STAT,1997,15,35-39,2012,7.0750179191958775
STAT,1957,46,15-19,2003,5.844546144178102E-4
STAT,1838,41,25-29,1879,0.6590246603764996
STAT,1839,82,na,1921,370.0230945569525
STAT,1863,15,30-34,1878,1.8571367504962164
STAT,1942,35,30-34,1977,2.2688558599080344
STAT,1932,28,25-29,1960,99.46786528841432
STAT,1857,42,50-100,1899,0.9483811847955753
SIM,1940,64,na,2004,4135
SIM,1934,54,na,1988,5558
STAT,1964,46,na,2010,5568.140146144851
STAT,1954,22,na,1976,5227.112737393653
SIM,1940,28,25-29,1968,6
STAT,1831,51,40-44,1882,0.008753298797271535
SIM,1803,51,30-34,1854,1
STAT,1988,17,35-39,2005,6.9259146372942695
SIM,1896,63,na,1959,2992
STAT,1958,36,na,1994,5880.337757387061
STAT,1932,22,40-44,1954,5.092559566338128
STAT,1929,45,40-44,1974,0.23696044427956453
SIM,1917,28,25-29,1945,4
SIM,1814,83,na,1897,103
STAT,1967,29,25-29,1996,95.20011400993872
STAT,1920,34,40-44,1954,4.902297841512625
STAT,1888,20,30-34,1908,24.307865168319562
STAT,1953,62,na,2015,4856.053695846348
STAT,1966,44,15-19,2010,0.002292769303125482
STAT,1894,48,35-39,1942,0.11568546368542698
SIM,1981,30,na,2011,6402
SIM,1955,16,na,1971,5854
STAT,1889,112,na,2001,0.006140146897420085
STAT,1830,54,50-100,1884,0.011775641584512256
STAT,1837,25,30-34,1862,23.744249336570018
STAT,1971,18,na,1989,5378.316010909324
SIM,1829,33,na,1862,1824
SIM,1957,25,15-19,1982,1
STAT,1888,23,50-100,1911,0.5514887279175694
STAT,1912,30,15-19,1942,0.14724027975553466
STAT,1826,28,50-100,1854,1.8544945952136394
SIM,1962,29,15-19,1991,2
STAT,1927,46,45-49,1973,0.31555487354559303
SIM,1910,16,20-24,1926,35
STAT,1859,26,20-24,1885,11.050275358853572
STAT,1909,28,25-29,1937,72.41954904228491
SIM,1867,50,na,1917,2113
STAT,1978,15,40-44,1993,2.2041012680404712
STAT,1938,46,20-24,1984,0.013124696141101481
STAT,1822,50,na,1872,2062.474815999993
STAT,1877,34,15-19,1911,0.16948894151374042
STAT,1929,23,na,1952,5313.16536397557
STAT,1900,17,25-29,1917,9.074447691114472
STAT,1844,54,30-34,1898,0.0048419320396648965
STAT,1954,29,15-19,1983,1.010511226903276
STAT,1816,40,35-39,1856,4.411247735305861
STAT,1945,28,35-39,1973,18.999654831198168
SIM,1953,28,35-39,1981,27
STAT,1875,46,50-100,1921,0.29373303568770354
SIM,1887,11,na,1898,3963
SIM,1899,16,15-19,1915,16
SIM,1838,22,35-39,1860,4
SIM,1916,25,na,1941,4484
STAT,1824,34,50-100,1858,1.5371660987984217
SIM,1912,11,na,1923,4209
STAT,1899,21,45-49,1920,1.105843109351226
STAT,1945,20,25-29,1965,116.91176933148209
STAT,1865,18,45-49,1883,0.06967791321030861
STAT,1964,33,40-44,1997,5.794417750102837
SIM,1875,5,na,1880,3650
STAT,1825,49,25-29,1874,0.07823434012971375
STAT,1886,32,15-19,1918,0.17335444895468702
STAT,1827,81,na,1908,439.1658814217475
STAT,1871,35,35-39,1906,8.197730008933984
SIM,1952,38,45-49,1990,2
STAT,1860,37,25-29,1897,2.6779662075659383
SIM,1942,27,20-24,1969,26
SIM,1808,71,na,1879,777
STAT,1842,86,na,1928,170.73932254737838
STAT,1919,38,35-39,1957,2.9950351449139734
SIM,1945,38,na,1983,4679
SIM,1941,24,na,1965,3482
SIM,1953,20,25-29,1973,241
STAT,1864,50,50-100,1914,0.015786140698622976
SIM,1793,88,na,1881,115
SIM,1927,82,na,2009,999
SIM,1895,19,35-39,1914,3
STAT,1938,43,40-44,1981,0.29559095912685035
SIM,1919,16,40-44,1935,1
SIM,1927,38,35-39,1965,6
STAT,1944,0,na,1944,5539.698328422142
STAT,1910,27,35-39,1937,16.74850752768256
STAT,1970,33,25-29,2003,13.60176708032853
SIM,1874,31,35-39,1905,20
STAT,1919,41,50-100,1960,0.14709968263623163
SIM,1859,3,na,1862,3187
STAT,1887,19,35-39,1906,0.7058524112991383
STAT,1882,38,15-19,1920,0.06298430498596265
STAT,1914,21,35-39,1935,10.690458068751827
STAT,1919,30,25-29,1949,11.597603685142488
STAT,1856,48,15-19,1904,3.477542684961645E-4
SIM,1880,32,na,1912,3284
SIM,1884,46,na,1930,2579
STAT,1918,48,45-49,1966,0.2661118540172774
STAT,1974,40,na,2014,5832.345118704652
STAT,1943,25,20-24,1968,22.457101020447123
STAT,1821,44,35-39,1865,3.3423104667941024
STAT,1934,27,20-24,1961,28.352814697663696
STAT,1903,42,40-44,1945,0.25643257734359703
SIM,1931,24,40-44,1955,5
SIM,1886,18,30-34,1904,4
SIM,1889,93,na,1982,444
STAT,1923,24,40-44,1947,4.484996698970574
STAT,1855,52,40-44,1907,0.0089102423709758
STAT,1881,45,45-49,1926,0.2653174590492187
SIM,1982,29,50-100,2011,5
STAT,1957,30,45-49,1987,2.443326543724872
SIM,1880,47,45-49,1927,3
SIM,1951,25,20-24,1976,36
STAT,1843,31,50-100,1874,1.116763402284496
SIM,1800,75,na,1875,645
SIM,1825,67,na,1892,1003
STAT,1906,35,20-24,1941,0.28265686452405153
SIM,1975,28,30-34,2003,8
SIM,1821,53,na,1874,1257
SIM,1927,30,25-29,1957,1
STAT,1885,41,50-100,1926,1.2215940773334737
STAT,1958,23,15-19,1981,8.092534934756827
STAT,1838,45,50-100,1883,0.2245901978644711
SIM,1836,27,30-34,1863,54
SIM,1942,35,50-100,1977,1
STAT,1811,105,na,1916,0.015097025178546808
STAT,1901,39,na,1940,3799.8152056274885
STAT,1834,51,na,1885,2055.070506575385
SIM,1922,21,35-39,1943,35
STAT,1864,31,25-29,1895,10.597537334328905
STAT,1860,99,na,1959,3.2852862192810246
SIM,1884,18,20-24,1902,40
STAT,1960,34,na,1994,5787.098739908536
STAT,1899,19,50-100,1918,0.07704421091100144
STAT,1903,32,15-19,1935,0.23408648793906423
SIM,1961,42,na,2003,5574
STAT,1879,21,50-100,1900,0.4928787068082054
SIM,1917,42,na,1959,5329
STAT,1828,27,30-34,1855,40.86069789138656
SIM,1888,34,40-44,1922,1
STAT,1868,38,50-100,1906,1.3545294725100487
STAT,1944,41,15-19,1985,0.0019849895493296204
SIM,1842,31,na,1873,2416
SIM,1925,36,35-39,1961,1
STAT,1875,20,45-49,1895,0.8365844458056754
STAT,1942,21,na,1963,4420.915322063383
SIM,1905,41,na,1946,4067
SIM,1846,45,na,1891,1493
STAT,1928,39,15-19,1967,0.027947427173361926
SIM,1961,36,45-49,1997,4
STAT,1874,16,45-49,1890,0.07736463633832903
STAT,1876,41,45-49,1917,1.793538868244334
SIM,1884,41,45-49,1925,6
STAT,1908,37,20-24,1945,0.28519214040101465
STAT,1834,47,25-29,1881,0.05574649240202552
SIM,1847,20,35-39,1867,19
STAT,1953,36,45-49,1989,0.9813962560015831
SIM,1900,10,na,1910,3940
SIM,1955,20,35-39,1975,1
SIM,1996,2,na,1998,6953
STAT,1890,5,na,1895,3695.415310257685
STAT,1853,33,15-19,1886,0.14449967046147685
STAT,1962,45,50-100,2007,0.34951278986596035
SIM,1964,26,45-49,1990,4
SIM,1893,16,20-24,1909,34
STAT,1838,65,na,1903,1463.862485688973
SIM,1905,4,na,1909,4699
STAT,1837,50,20-24,1887,5.579571866408897E-4
STAT,1967,17,30-34,1984,17.570982921142015
SIM,1975,17,30-34,1992,40
SIM,1902,92,na,1994,248
SIM,1950,38,35-39,1988,8
STAT,1931,37,20-24,1968,0.4029850365707567
STAT,1898,30,40-44,1928,6.818260526610957
STAT,1887,110,na,1997,0.03712662917554259
STAT,1955,38,45-49,1993,1.0749045417802356
STAT,1920,46,35-39,1966,0.16481344013292895
STAT,1824,37,15-19,1861,0.08608954740392531
STAT,1922,60,na,1982,4533.639259595542
SIM,1920,26,30-34,1946,7
STAT,1958,41,50-100,1999,0.1853218042766869
STAT,1966,49,20-24,2015,0.01647183917604966
STAT,1947,20,35-39,1967,12.289220797808204
STAT,1942,38,35-39,1980,3.002772450547622
SIM,1786,70,na,1856,407
STAT,1813,73,na,1886,578.2433649939118
SIM,1909,71,na,1980,3576
STAT,1956,26,45-49,1982,2.6507881034265957
STAT,1912,26,30-34,1938,44.756741357666534
STAT,1902,19,25-29,1921,9.190772174528075
SIM,1910,19,25-29,1929,15
STAT,1849,30,45-49,1879,1.5979298438333844
STAT,1842,54,20-24,1896,5.522321550071269E-4
SIM,1973,27,50-100,2000,4
STAT,1971,15,30-34,1986,17.825396852749044
STAT,1892,21,35-39,1913,8.466121777060675
STAT,1970,27,30-34,1997,56.849019928913094
STAT,1931,21,na,1952,5483.618240741966
STAT,1897,44,na,1941,3530.561487642618
STAT,1893,30,na,1923,3508.9365907664583
STAT,1782,106,na,1888,0.01787428332903941
STAT,1921,25,45-49,1946,2.2362839490012867
SIM,1821,37,na,1858,1661
SIM,1850,38,50-100,1888,3
SIM,1930,18,15-19,1948,67
STAT,1955,49,45-49,2004,0.3443047633671471
STAT,1968,44,25-29,2012,0.10661289830371476
STAT,1871,99,na,1970,14.85463581117095
STAT,1827,43,15-19,1870,0.018080848708438513
STAT,1848,51,35-39,1899,0.00919113057724241
STAT,1888,23,35-39,1911,7.891802772817615
STAT,1814,90,na,1904,49.15855171604848
STAT,1938,49,25-29,1987,0.06247395767725177
SIM,1847,46,na,1893,2348
STAT,1922,18,15-19,1940,60.42853136594274
STAT,1978,18,45-49,1996,0.7865099194603866
SIM,1966,16,na,1982,5925
STAT,1901,55,na,1956,3366.5578961054775
STAT,1985,24,na,2009,6009.739606616262
SIM,1953,25,30-34,1978,125
STAT,1832,47,15-19,1879,3.283345343514779E-4
STAT,1905,69,na,1974,2958.851173353524
STAT,1923,27,45-49,1950,2.2881936794731694
STAT,1856,94,na,1950,17.596727717078874
STAT,1875,107,na,1982,0.25748503658324784
STAT,1925,33,50-100,1958,1.1319922244986318
SIM,1931,27,45-49,1958,4
STAT,1881,42,40-44,1923,2.5006518885986213
SIM,1879,36,40-44,1915,2
STAT,1877,53,30-34,1930,0.0070309758179578075
STAT,1916,48,35-39,1964,0.1522031151329361
SIM,1896,23,35-39,1919,6
SIM,1896,32,25-29,1928,4
STAT,1885,16,20-24,1901,20.457597794093154
STAT,1945,25,30-34,1970,49.65254868548584
SIM,1918,32,25-29,1950,13
STAT,1896,42,25-29,1938,0.06788835086843263
STAT,1856,33,40-44,1889,3.825081598099841
SIM,1920,62,na,1982,3680
STAT,1908,38,35-39,1946,2.603800333934106
SIM,1916,38,35-39,1954,3
STAT,1888,32,25-29,1920,13.894856848563043
STAT,1943,22,na,1965,4484.209647477371
STAT,1947,36,na,1983,5043.219481647575
STAT,1848,23,40-44,1871,2.6765424951053465
STAT,1808,54,20-24,1862,0.00337876023098651
STAT,1870,44,30-34,1914,1.2903497397023114
STAT,1872,36,50-100,1908,1.4295586092230101
SIM,1932,8,na,1940,5737
STAT,1933,41,15-19,1974,0.0024395824330110034
STAT,1852,40,45-49,1892,1.4252904921074232
SIM,1857,29,na,1886,2484
SIM,1853,15,na,1868,2692
STAT,1842,38,50-100,1880,1.09684838647874
STAT,1938,46,45-49,1984,0.25811901431263956
SIM,1919,19,45-49,1938,1
SIM,1922,30,25-29,1952,31
STAT,1958,28,20-24,1986,27.774387733810542
SIM,1963,41,35-39,2004,1
SIM,1892,3,na,1895,4162
STAT,1860,34,20-24,1894,2.492613277784915
SIM,1845,25,30-34,1870,3
SIM,1836,22,25-29,1858,5
SIM,1888,12,na,1900,3101
STAT,1932,43,na,1975,5801.216252803928
STAT,1845,45,35-39,1890,0.09528021338093394
STAT,1949,25,15-19,1974,0.9524329811094072
SIM,1880,36,50-100,1916,2
STAT,1804,109,na,1913,3.093419876845694E-4
STAT,1789,101,na,1890,0.11566608434570336
STAT,1953,35,30-34,1988,2.625911744321708
STAT,1934,28,35-39,1962,23.30853682812567
STAT,1876,18,20-24,1894,21.09435069625937
SIM,1961,35,30-34,1996,6
SIM,1943,18,25-29,1961,78
SIM,1868,33,50-100,1901,1
SIM,1923,17,45-49,1940,3
SIM,1855,45,45-49,1900,1
STAT,1855,13,na,1868,2405.047691416715
STAT,1952,45,40-44,1997,0.2278649430104229
STAT,1859,27,na,1886,2231.811666663726
SIM,1839,59,na,1898,1589
SIM,1946,46,45-49,1992,2
STAT,1840,30,25-29,1870,10.217811328129178
STAT,1851,39,25-29,1890,2.2602091962680415
STAT,1821,41,30-34,1862,2.267228954756579
STAT,1949,47,35-39,1996,0.17999377356460186
SIM,1805,79,na,1884,358
SIM,1963,49,45-49,2012,2
SIM,1835,45,na,1880,2066
SIM,1848,41,35-39,1889,6
STAT,1870,77,na,1947,983.4398524942877
SIM,1831,31,na,1862,1706
STAT,1848,40,50-100,1888,1.1502257587664402
STAT,1877,56,na,1933,2448.4683001285143
STAT,1783,100,na,1883,0.16363989575655652
SIM,1860,28,na,1888,2601
STAT,1946,51,na,1997,4828.898286671376
SIM,1977,21,25-29,1998,4
SIM,1840,20,25-29,1860,118
SIM,1869,29,35-39,1898,10
STAT,1843,106,na,1949,0.012182740507712146
STAT,1850,27,15-19,1877,0.5496389533815746
STAT,1970,30,20-24,2000,3.5958424830700637
STAT,1969,21,25-29,1990,133.64649597450185
SIM,1951,28,25-29,1979,168
STAT,1925,43,30-34,1968,0.1782857447063459
STAT,1897,26,40-44,1923,4.638419358549629
STAT,1903,45,45-49,1948,0.22100722516057109
STAT,1823,51,na,1874,1392.7461615188556
STAT,1834,44,20-24,1878,0.17030018913136394
STAT,1827,65,na,1892,1372.4530183222046
STAT,1812,46,35-39,1858,0.3300365107779187
STAT,1975,15,15-19,1990,69.13132924895515
STAT,1821,49,40-44,1870,0.30132158078756194
STAT,1880,115,na,1995,1.7900182222595475E-4
STAT,1980,19,15-19,1999,72.65918115352267
STAT,1939,44,50-100,1983,0.1406227231504073
SIM,1819,35,30-34,1854,4
STAT,1993,3,na,1996,6531.530555406422
STAT,1960,18,na,1978,5530.697236538988
STAT,1943,28,25-29,1971,80.86684062822142
SIM,1942,28,35-39,1970,22
SIM,1869,21,25-29,1890,48
STAT,1864,114,na,1978,1.1939674925673171E-4
STAT,1970,38,30-34,2008,2.7098415880641786
SIM,1973,27,na,2000,5012
SIM,1896,8,na,1904,4074
STAT,1876,101,na,1977,9.340581940624588
SIM,1944,29,50-100,1973,3
STAT,1981,31,35-39,2012,15.040414241540697
STAT,1914,30,25-29,1944,10.828320503892085
SIM,1884,62,na,1946,2069
STAT,1936,29,50-100,1965,1.0988731002563228
SIM,1983,15,15-19,1998,68
SIM,1966,28,20-24,1994,44
STAT,1919,35,30-34,1954,2.271694647522593
STAT,1814,40,25-29,1854,2.870144392295814
STAT,1935,18,25-29,1953,68.22563082363678
SIM,1875,15,15-19,1890,9
STAT,1899,20,30-34,1919,28.330507579215357
SIM,1878,93,na,1971,5
STAT,1771,113,na,1884,5.989569536612693E-4
SIM,1858,28,20-24,1886,18
SIM,1949,27,30-34,1976,7
STAT,1831,86,na,1917,174.07674897497125
STAT,1769,86,na,1855,97.116
STAT,1922,40,25-29,1962,0.09481097231949052
STAT,1936,22,25-29,1958,101.97408057180128
SIM,1944,22,25-29,1966,142
SIM,1927,35,30-34,1962,2
STAT,1828,82,na,1910,309.67048706653986
STAT,1845,23,15-19,1868,2.739974632333587
STAT,1961,33,15-19,1994,0.19518174311347714
STAT,1867,15,15-19,1882,6.614696810896091
STAT,1861,40,50-100,1901,1.023794834726959
STAT,1918,45,40-44,1963,0.19449311798334473
STAT,1927,45,30-34,1972,0.12971765817691996
STAT,1910,24,30-34,1934,30.985623461166117
SIM,1800,91,na,1891,30
STAT,1869,36,30-34,1905,5.985048806253039
SIM,1980,30,30-34,2010,1
STAT,1840,47,na,1887,1820.0226768843545
STAT,1920,43,30-34,1963,0.16262134652720725
SIM,1945,18,35-39,1963,5
STAT,1838,81,na,1919,468.4156398983579
SIM,1888,15,25-29,1903,25
SIM,1883,20,45-49,1903,1
STAT,1926,39,40-44,1965,2.1064190790389232
STAT,1917,38,25-29,1955,1.174397032201459
SIM,1842,20,35-39,1862,1
SIM,1977,25,25-29,2002,110
SIM,1837,84,na,1921,388
SIM,1882,41,35-39,1923,2
STAT,1936,52,na,1988,4133.995880829024
SIM,1902,76,na,1978,2319
STAT,2000,10,na,2010,6743.512257826983
STAT,1940,20,25-29,1960,108.70122641142264
SIM,1925,33,30-34,1958,4
STAT,1863,40,20-24,1903,0.16187692390713085
STAT,1771,89,na,1860,43.55007833510381
STAT,1917,33,30-34,1950,18.95974292395258
SIM,1934,39,40-44,1973,3
STAT,1902,17,35-39,1919,0.8947404999448343
STAT,1878,15,15-19,1893,7.184093933609276
SIM,1941,65,na,2006,3355
STAT,1926,17,20-24,1943,191.78871702234625
SIM,1877,36,30-34,1913,15
SIM,1933,53,na,1986,6175
STAT,1823,41,40-44,1864,2.4078299354656085
STAT,1921,27,35-39,1948,19.30314284725822
STAT,1936,31,15-19,1967,0.14421537566886355
SIM,1911,5,na,1916,5225
SIM,1882,28,15-19,1910,4
STAT,1866,31,35-39,1897,10.876804952655153
STAT,1965,3,na,1968,5667.560845609628
STAT,1835,25,20-24,1860,9.723551333718435
STAT,1901,30,15-19,1931,0.23204992328914775
STAT,1862,27,30-34,1889,24.615880703444905
SIM,1831,41,40-44,1872,6
SIM,1932,18,25-29,1950,84
STAT,1874,28,15-19,1902,0.534138801977612
SIM,1838,31,25-29,1869,17
STAT,1851,63,na,1914,1414.9440411114397
STAT,1969,29,35-39,1998,21.716002457836826
STAT,1927,33,15-19,1960,0.18227377605226286
STAT,1855,77,na,1932,735.5074243774517
STAT,1960,18,35-39,1978,6.305115183307269
STAT,1789,74,na,1863,365.81675100102274
SIM,1970,21,15-19,1991,16
SIM,1934,17,20-24,1951,398
SIM,1838,35,50-100,1873,2
STAT,1846,51,25-29,1897,0.0036791892123519067
SIM,1854,2,na,1856,3802
SIM,1832,34,50-100,1866,2
STAT,1972,38,40-44,2010,2.2765621178033593
SIM,1977,28,40-44,2005,10
SIM,1987,20,15-19,2007,8
STAT,1819,52,30-34,1871,0.011023651049747495
STAT,1924,18,25-29,1942,59.38224622565673
SIM,1896,23,50-100,1919,2
SIM,1902,28,40-44,1930,1
STAT,1920,40,15-19,1960,0.001961931771410504
STAT,1907,16,20-24,1923,30.17653008583645
STAT,1874,41,35-39,1915,2.1490611294011783
STAT,1870,53,20-24,1923,8.260688784616514E-4
STAT,1943,37,50-100,1980,0.5294035896096587
SIM,1820,52,na,1872,1741
STAT,1949,44,30-34,1993,0.177729744791393
SIM,1912,20,15-19,1932,14
SIM,1959,37,40-44,1996,3
STAT,1928,24,40-44,1952,4.814351252712529
STAT,1944,30,50-100,1974,1.0478929903701613
STAT,1922,18,50-100,1940,0.4988595415895039
STAT,1873,20,35-39,1893,6.918086465229401
STAT,1972,30,30-34,2002,23.756603943759398
STAT,1899,26,15-19,1925,0.7197973785807212
SIM,1883,46,50-100,1929,3
STAT,1857,79,na,1936,628.3632644471015
STAT,1937,18,35-39,1955,4.7012024448483585
STAT,1971,29,35-39,2000,22.01783146641631
STAT,1915,17,45-49,1932,0.12067865621299188
STAT,1856,36,45-49,1892,1.763611631954587
SIM,1927,20,na,1947,5141
SIM,1938,37,50-100,1975,1
STAT,1956,23,40-44,1979,5.149839470295092
STAT,1964,47,20-24,2011,0.016707971879208763
STAT,1910,26,20-24,1936,20.433210155560015
SIM,1926,47,30-34,1973,1
STAT,1962,21,15-19,1983,7.899895055879264
STAT,1880,76,na,1956,1205.9247512723682
SIM,1859,16,20-24,1875,33
STAT,1826,37,25-29,1863,2.307076567396155
SIM,1870,70,na,1940,1985
STAT,1861,15,20-24,1876,19.78208851349143
SIM,1938,39,25-29,1977,2
STAT,1849,65,na,1914,1309.8362379091454
SIM,1911,10,na,1921,5197
SIM,1874,84,na,1958,347
SIM,1967,19,25-29,1986,75
STAT,1863,29,50-100,1892,0.6409064366489159
STAT,1918,47,30-34,1965,0.10945524954759867
STAT,1925,24,15-19,1949,7.3049829416261085
SIM,1882,2,na,1884,4117
SIM,1864,21,25-29,1885,133
SIM,1908,27,20-24,1935,40
STAT,1974,29,50-100,2003,1.5049119117713128
SIM,1853,42,30-34,1895,6
STAT,1995,15,25-29,2010,72.43136381267564
SIM,1886,37,50-100,1923,1
SIM,1978,34,30-34,2012,50
STAT,2004,0,na,2004,6985.397835875386
STAT,1884,9,na,1893,2958.4551062429105
STAT,1877,83,na,1960,657.0198507639217
SIM,1790,75,na,1865,144
SIM,1983,26,15-19,2009,5
SIM,1928,83,na,2011,2478
STAT,1836,37,30-34,1873,5.955597555992772
STAT,1975,26,15-19,2001,1.079923017141832
STAT,1810,49,40-44,1859,0.6380662433570794
SIM,1919,20,25-29,1939,224
SIM,1933,24,15-19,1957,1
SIM,1829,48,45-49,1877,1
SIM,1968,23,25-29,1991,156
STAT,1894,45,30-34,1939,0.08181367489671419
STAT,1905,47,20-24,1952,0.011253700074521063
STAT,1949,20,45-49,1969,1.516209782191889
STAT,1857,95,na,1952,11.950171827834168
STAT,1841,85,na,1926,243.7302224839175
SIM,1844,37,30-34,1881,4
SIM,1922,45,20-24,1967,1
STAT,1890,48,15-19,1938,3.14172008017999E-4
STAT,1856,14,na,1870,2462.7750271573864
STAT,1900,26,15-19,1926,0.7290324224765226
SIM,1851,31,50-100,1882,3
STAT,1871,25,30-34,1896,29.10815152923164
SIM,1937,40,35-39,1977,1
STAT,1886,60,na,1946,2321.6310772440347
SIM,1777,93,na,1870,8
SIM,1903,34,30-34,1937,43
STAT,1965,17,20-24,1982,195.3316972384404
SIM,1973,17,20-24,1990,377
STAT,1929,40,35-39,1969,0.3017977693026154
SIM,1833,31,50-100,1864,2
STAT,1959,19,25-29,1978,65.37396519292311
SIM,1953,16,40-44,1969,6
STAT,1914,45,20-24,1959,0.012714018415159088
STAT,1955,17,50-100,1972,0.5739773843512229
SIM,2002,9,na,2011,6943
STAT,1945,16,40-44,1961,1.7637964490596465
STAT,1920,37,45-49,1957,0.8610152853473458
STAT,1820,86,na,1906,130.2190632191365
STAT,1931,44,45-49,1975,0.25579019509488976
STAT,1894,109,na,2003,0.1110599436708232
STAT,1944,37,30-34,1981,2.3320756971359895
SIM,1854,59,na,1913,2022
STAT,1847,38,45-49,1885,1.5750463497259652
SIM,1938,33,40-44,1971,5
STAT,1826,50,45-49,1876,0.010496911373565917
STAT,1852,48,na,1900,2094.527401242215
STAT,1878,22,15-19,1900,3.9751773440094773
STAT,1927,48,35-39,1975,0.18621022172619103
SIM,1870,27,30-34,1897,38
STAT,1892,48,25-29,1940,0.046405871270611423
STAT,1949,46,20-24,1995,0.015466394957593851
STAT,1929,48,45-49,1977,0.3242170407355626
SIM,1943,41,25-29,1984,1
SIM,1875,58,na,1933,2485
STAT,1975,25,na,2000,5733.036104700014
SIM,1919,28,35-39,1947,33
STAT,1920,18,40-44,1938,1.8054988172945756
SIM,1979,24,50-100,2003,1
SIM,1983,26,na,2009,6674
STAT,1955,30,35-39,1985,14.286777175417116
STAT,1894,42,15-19,1936,0.0014209371632515847
SIM,1910,98,na,2008,75
SIM,1952,37,30-34,1989,2
SIM,1927,26,40-44,1953,1
SIM,1954,15,na,1969,5172
STAT,1940,35,20-24,1975,0.31888032169870517
SIM,1958,29,na,1987,5951
STAT,1951,47,50-100,1998,0.32330471701232516
SIM,1834,37,25-29,1871,4
STAT,1995,18,40-44,2013,2.335855780935427
STAT,1856,21,25-29,1877,58.96037858277789
STAT,1955,49,20-24,2004,0.01750702253052255
SIM,1957,49,50-100,2006,1
STAT,1921,22,40-44,1943,4.381140194453771
STAT,1919,26,40-44,1945,5.830599124084827
SIM,1835,29,na,1864,2482
STAT,1847,30,35-39,1877,9.341162306420769
STAT,1956,29,25-29,1985,100.84697423639271
SIM,1855,38,45-49,1893,3
SIM,1954,48,40-44,2002,1
SIM,1928,29,15-19,1957,2
SIM,1849,80,na,1929,884
SIM,1865,4,na,1869,3542
STAT,1845,42,30-34,1887,0.7889011221988551
SIM,1927,68,na,1995,3770
SIM,1849,10,na,1859,3224
SIM,1923,54,na,1977,5079
STAT,1936,49,15-19,1985,4.191380843355203E-4
SIM,1959,44,na,2003,5888
STAT,1851,48,15-19,1899,3.1321206487727716E-4
SIM,1933,46,35-39,1979,1
SIM,1850,66,na,1916,955
SIM,1963,30,35-39,1993,2
STAT,1889,19,45-49,1908,0.09242744616966764
SIM,1964,29,25-29,1993,119
STAT,1925,46,35-39,1971,0.18068899033988725
STAT,1888,56,na,1944,2766.915695048799
SIM,1855,30,35-39,1885,15
SIM,1881,25,40-44,1906,5
STAT,1884,51,45-49,1935,0.016626531874253718
SIM,1897,20,25-29,1917,3
SIM,1924,30,35-39,1954,32
STAT,1869,27,40-44,1896,3.3478671101944397
STAT,1779,85,na,1864,73.70258489488346
SIM,1901,35,35-39,1936,8
STAT,1829,38,50-100,1867,1.3799689609487045
STAT,1823,44,45-49,1867,1.5088768658757872
SIM,1965,19,15-19,1984,63
SIM,1923,75,na,1998,3535
STAT,1966,29,30-34,1995,56.66673390514863
SIM,1878,40,30-34,1918,3
SIM,1917,83,na,2000,1713
STAT,1922,31,35-39,1953,11.959298351516686
SIM,1831,44,45-49,1875,5
STAT,1927,40,25-29,1967,0.10361798078482114
SIM,1940,25,45-49,1965,8
SIM,1951,16,30-34,1967,39
STAT,1848,38,15-19,1886,0.060851599254821864
STAT,1909,35,na,1944,4153.295354657254
SIM,1935,48,35-39,1983,1
STAT,1951,36,35-39,1987,3.4275927916117817
STAT,1853,48,25-29,1901,0.05662707807617247
STAT,1921,24,30-34,1945,37.21530307043879
SIM,1837,38,50-100,1875,4
STAT,1868,79,na,1947,775.1452691855977
STAT,1848,43,na,1891,2438.0164478787788
STAT,1957,19,15-19,1976,69.00748395506125
STAT,1828,31,15-19,1859,0.1697940224440214
STAT,1935,41,25-29,1976,0.11647090968446026
STAT,1887,82,na,1969,1054.3835272913755
STAT,1873,25,40-44,1898,3.554191977186998
STAT,1917,26,30-34,1943,47.585432176217296
STAT,1916,30,35-39,1946,10.976727171290362
STAT,1993,18,30-34,2011,20.231704946738606
STAT,1818,77,na,1895,382.4599703084716
STAT,1872,44,40-44,1916,2.571283411774454
STAT,1922,79,na,2001,2639.8655019120647
SIM,1911,30,25-29,1941,24
SIM,1864,58,na,1922,2197
SIM,1930,31,35-39,1961,18
STAT,1898,45,na,1943,3544.6748688148255
SIM,1901,11,na,1912,4489
STAT,1894,31,na,1925,3554.653436161672
STAT,1909,97,na,2006,113.95930342654484
STAT,1922,17,na,1939,4913.857876292919
SIM,1873,62,na,1935,2590
SIM,1950,37,20-24,1987,1
STAT,1824,50,35-39,1874,0.011748545674028587
SIM,1859,19,25-29,1878,9
SIM,1966,29,35-39,1995,51
STAT,1970,39,45-49,2009,1.0124597337894783
STAT,1845,51,na,1896,1457.864729143233
STAT,1942,37,20-24,1979,0.3275907991897731
STAT,1941,20,na,1961,4359.2857803564
SIM,1787,92,na,1879,49
SIM,1883,61,na,1944,1845
STAT,1812,43,30-34,1855,3.1031141800231485
STAT,1968,14,na,1982,5659.990861834223
SIM,1820,43,30-34,1863,3
SIM,1860,27,25-29,1887,46
STAT,1939,27,20-24,1966,21.186305637785054
STAT,1852,27,25-29,1879,46.452612854085295
SIM,1961,30,25-29,1991,15
STAT,1954,42,35-39,1996,0.29855440234417646
STAT,1943,16,30-34,1959,14.922072200599269
STAT,1938,22,35-39,1960,10.759775985008098
SIM,1829,40,35-39,1869,1
STAT,1979,14,na,1993,6239.446343522671
STAT,1850,102,na,1952,0.301807831524586
STAT,1902,20,50-100,1922,0.6689219613662235
STAT,1903,30,25-29,1933,16.97189415885031
SIM,1947,27,20-24,1974,32
STAT,1851,101,na,1952,0.452501557610827
SIM,1968,20,20-24,1988,154
STAT,1949,6,na,1955,5276.3056067920625
STAT,1830,85,na,1915,171.96915361665884
STAT,1870,42,50-100,1912,1.200471066914122
SIM,1882,98,na,1980,101
SIM,1895,46,na,1941,3471
SIM,1935,43,40-44,1978,1
STAT,1917,35,20-24,1952,0.31899019374530224
SIM,1891,32,na,1923,3357
STAT,1876,39,na,1915,2782.34319232294
STAT,1854,21,15-19,1875,3.180796944896661
STAT,1866,13,na,1879,2867.141530061527
SIM,1904,41,35-39,1945,1
SIM,1934,79,na,2013,2701
SIM,1837,18,35-39,1855,1
SIM,1914,35,45-49,1949,2
SIM,1930,24,na,1954,6111
STAT,1953,30,25-29,1983,13.167437894162292
STAT,1972,33,35-39,2005,13.755315327764214
SIM,1841,30,na,1871,2016
SIM,1934,38,na,1972,5815
STAT,1839,66,na,1905,1299.8166376528432
SIM,1845,44,na,1889,2028
SIM,1948,60,na,2008,4045
STAT,1927,43,40-44,1970,0.36136496172853366
STAT,1961,31,25-29,1992,14.055215405506882
STAT,1873,7,na,1880,3205.3976918624785
SIM,1961,38,35-39,1999,2
STAT,1928,27,45-49,1955,2.4562265808911405
SIM,1980,33,35-39,2013,29
STAT,1906,35,45-49,1941,0.7309768632933021
SIM,1948,39,30-34,1987,3
SIM,1969,3,na,1972,5831
STAT,1953,38,35-39,1991,3.475326741884029
STAT,1964,41,na,2005,5618.153336936639
SIM,1991,1,na,1992,6724
STAT,1953,33,40-44,1986,5.5653396858710105
STAT,1851,47,na,1898,1775.7944774488221
SIM,1920,87,na,2007,496
SIM,1986,18,na,2004,6278
SIM,1903,37,35-39,1940,6
STAT,1904,20,15-19,1924,5.499826408772517
SIM,1967,16,20-24,1983,195
STAT,1812,110,na,1922,1.213216356741706E-4
STAT,1944,23,na,1967,4548.968268315756
STAT,1948,37,na,1985,5118.916468731445
SIM,1881,20,35-39,1901,5
STAT,1947,52,na,1999,4883.941836487861
SIM,1922,7,na,1929,5538
STAT,1989,17,na,2006,6084.252868288991
STAT,1850,40,35-39,1890,1.8829448709608376
STAT,1871,28,35-39,1899,11.039193910673427
STAT,1933,60,na,1993,5431.687520333325
SIM,1913,76,na,1989,2772
SIM,1860,40,45-49,1900,3
STAT,1870,47,35-39,1917,0.15853880847021862
STAT,1983,31,45-49,2014,2.620096245666073
STAT,1957,42,15-19,1999,0.0024283240840024542
SIM,1880,41,25-29,1921,3
STAT,1897,20,20-24,1917,106.97569210951792
SIM,1939,27,25-29,1966,10
SIM,1961,33,40-44,1994,9
STAT,1949,49,25-29,1998,0.07362051613328144
STAT,1859,43,na,1902,2109.3850018657986
STAT,1940,38,25-29,1978,1.1877891748908613
STAT,1968,41,20-24,2009,0.026492801578298267
SIM,1868,30,45-49,1898,4
STAT,1952,29,40-44,1981,6.467536592398654
STAT,1872,41,25-29,1913,0.7475000130428633
STAT,1846,54,40-44,1900,0.010584012137566275
STAT,1896,30,30-34,1926,26.827528487586715
STAT,1841,29,15-19,1870,0.49385163995820613
SIM,1965,15,na,1980,4922
SIM,1978,17,35-39,1995,15
STAT,1870,98,na,1968,19.616822457439095
SIM,1879,30,20-24,1909,4
SIM,1916,6,na,1922,4885
STAT,1916,31,50-100,1947,0.989225559271512
SIM,1810,53,na,1863,1352
SIM,1840,26,45-49,1866,2
STAT,1986,25,na,2011,6192.153868666841
SIM,1814,67,na,1881,744
STAT,1810,46,25-29,1856,0.22908848599626352
STAT,1862,47,na,1909,2180.9773961839287
STAT,1976,5,na,1981,6062.059215411154
STAT,1850,15,45-49,1865,0.08315015675193228
STAT,1873,28,45-49,1901,1.3038751094243313
SIM,1831,52,na,1883,1495
SIM,1950,20,35-39,1970,14
SIM,1889,41,45-49,1930,4
STAT,1895,26,30-34,1921,37.95786359847906
SIM,1881,28,45-49,1909,3
STAT,1799,73,na,1872,684.9118129537369
SIM,1890,10,na,1900,3764
SIM,1855,35,40-44,1890,13
STAT,1932,25,45-49,1957,2.6143024702938598
SIM,1898,32,35-39,1930,6
SIM,1857,51,na,1908,2305
STAT,1850,52,40-44,1902,0.01077995272693058
STAT,1931,41,40-44,1972,0.3862624185810209
STAT,1815,39,15-19,1854,0.16744867324422505
SIM,1969,29,na,1998,5783
SIM,1944,16,na,1960,4299
STAT,1867,94,na,1961,45.94392735125593
STAT,1874,108,na,1982,0.11209840981213223
SIM,1880,44,40-44,1924,6
STAT,1907,0,na,1907,4985.825052710211
SIM,1962,17,45-49,1979,2
SIM,1894,24,na,1918,3471
STAT,1832,26,45-49,1858,1.0745186845771508
STAT,1954,17,45-49,1971,0.7126783423184023
SIM,1888,37,45-49,1925,4
STAT,1914,48,25-29,1962,0.06057254095743277
STAT,1897,60,na,1957,2995.6829396329053
SIM,1797,70,na,1867,602
STAT,1889,20,25-29,1909,81.92174054967128
SIM,1906,28,25-29,1934,73
STAT,1879,53,40-44,1932,0.012482328807643807
SIM,1907,18,15-19,1925,19
STAT,1970,42,15-19,2012,0.0023055391931207625
STAT,1881,54,35-39,1935,0.009319468298848894
STAT,1923,39,15-19,1962,0.025614184662223715
SIM,1878,17,30-34,1895,4
STAT,1846,95,na,1941,13.744689529813073
STAT,1765,93,na,1858,0.5570166874362937
STAT,1878,18,30-34,1896,1.9155100286866662
STAT,1834,20,35-39,1854,11.183291345872183
SIM,1963,35,40-44,1998,1
STAT,1847,35,40-44,1882,3.568085163261518
SIM,1952,49,45-49,2001,1
STAT,1871,32,30-34,1903,20.045961866085236
STAT,1912,39,na,1951,4198.986393473316
SIM,1839,15,40-44,1854,1
STAT,1942,20,35-39,1962,11.403140247142089
STAT,1955,35,40-44,1990,2.366865081043314
STAT,1862,43,20-24,1905,0.1535558346368784
SIM,1866,21,35-39,1887,17
SIM,1839,27,20-24,1866,23
STAT,1870,105,na,1975,0.6557849171423201
STAT,1899,62,na,1961,3049.058775919613
SIM,1970,24,40-44,1994,5
SIM,1910,26,25-29,1936,2
STAT,1942,32,15-19,1974,0.15800111944863535
SIM,1818,70,na,1888,1294
SIM,1907,16,25-29,1923,10
SIM,1996,17,na,2013,6922
STAT,1957,17,25-29,1974,65.93739279193629
STAT,1837,80,na,1917,447.9429699084222
SIM,1922,10,na,1932,5506
SIM,1871,25,35-39,1896,25
SIM,1811,48,na,1859,1634
STAT,1841,48,na,1889,1983.8000798636313
STAT,1847,42,40-44,1889,1.7403676645542883
STAT,1951,38,25-29,1989,1.392603702794965
STAT,1897,21,50-100,1918,0.6311750082023253
SIM,1951,23,na,1974,6301
STAT,1978,7,na,1985,6190.610357713643
STAT,1839,18,40-44,1857,0.1886304632964419
STAT,1922,42,50-100,1964,0.15554757653563545
SIM,1783,89,na,1872,72
STAT,1852,85,na,1937,258.45762306986177
STAT,1927,36,40-44,1963,2.1494019578367425
STAT,1894,30,20-24,1924,4.042327318501054
STAT,1902,26,25-29,1928,69.21459578220384
STAT,1842,65,na,1907,1300.4688019630173
SIM,1870,43,20-24,1913,4
STAT,1882,51,35-39,1933,0.009750691857134368
SIM,1903,77,na,1980,1721
STAT,1962,24,40-44,1986,4.984883438260842
STAT,1956,38,15-19,1994,0.030181416941443513
STAT,1992,2,na,1994,6518.642790628152
SIM,1945,17,na,1962,4193
SIM,1852,20,na,1872,2165
STAT,1867,41,50-100,1908,1.1434652880005258
SIM,1901,4,na,1905,4572
STAT,1986,24,25-29,2010,152.289929006092
STAT,1871,30,na,1901,2761.8094268913223
STAT,1952,49,40-44,2001,0.22546815218964464
STAT,1852,24,20-24,1876,76.07887787392409
STAT,1912,48,15-19,1960,4.0781083191274083E-4
STAT,1858,21,35-39,1879,6.0713585789702895
SIM,1827,31,na,1858,1631
SIM,1926,29,40-44,1955,2
SIM,1865,17,20-24,1882,38
STAT,1904,23,40-44,1927,3.442657221434331
STAT,1925,48,25-29,1973,0.07395009333083553
STAT,1961,19,na,1980,5484.336890323831
SIM,1961,47,na,2008,5508
STAT,1883,30,45-49,1913,1.9847627739895997
STAT,1920,39,35-39,1959,3.0483919932529333
SIM,1948,0,na,1948,4725
SIM,1924,49,na,1973,4845
STAT,1812,104,na,1916,0.0292835423633036
STAT,1853,40,15-19,1893,0.01388806429140453
STAT,1970,36,40-44,2006,2.2300355142736508
SIM,1944,34,40-44,1978,10
STAT,1936,34,40-44,1970,4.383558639226788
SIM,1894,20,45-49,1914,2
STAT,1849,28,na,1877,1973.2788168265176
STAT,1921,18,45-49,1939,0.6551627919031605
SIM,1845,50,na,1895,1955
STAT,1803,52,50-100,1855,0.05479870930308609
STAT,1896,33,50-100,1929,1.3907266233295434
STAT,1837,19,45-49,1856,0.07093637556308881
SIM,1817,40,50-100,1857,2
STAT,1918,29,40-44,1947,5.682385730144696
STAT,1897,36,45-49,1933,3.091022754107367
SIM,1874,57,na,1931,2204
STAT,1829,83,na,1912,290.82446330510805
STAT,1864,46,35-39,1910,0.14467140710578022
STAT,1895,96,na,1991,123.31245467278963
STAT,1999,8,na,2007,6700.433979396282
STAT,1910,21,15-19,1931,5.792454489956457
STAT,1932,16,na,1948,5639.869956558303
STAT,1964,21,na,1985,5327.255684912524
STAT,1776,109,na,1885,0.004647822549914811
SIM,1958,43,na,2001,6099
SIM,1869,36,35-39,1905,6
STAT,1887,55,na,1942,2674.2215401782273
STAT,1847,54,35-39,1901,0.006442114780263686
STAT,1887,45,na,1932,2938.7800170810306
SIM,1909,15,20-24,1924,44
SIM,1819,42,30-34,1861,1
STAT,1828,66,na,1894,1087.8100778036564
STAT,1908,40,na,1948,4015.470383737474
SIM,1855,42,40-44,1897,4
STAT,1849,38,na,1887,1849.2230686793503
STAT,1779,91,na,1870,15.664248300230556
SIM,1887,41,35-39,1928,9
STAT,1863,25,35-39,1888,9.878173060491816
SIM,1965,17,25-29,1982,96
STAT,1879,41,35-39,1920,2.1919381197971677
SIM,1869,19,30-34,1888,5
SIM,1870,33,na,1903,3017
STAT,1782,95,na,1877,3.432412895022923
STAT,1907,44,15-19,1951,0.001606349308713874
STAT,1965,41,40-44,2006,0.3750485353080197
SIM,1879,46,45-49,1925,1
STAT,1864,34,40-44,1898,4.430473481193236
STAT,1890,24,40-44,1914,2.9200259104305424
STAT,1895,33,30-34,1928,26.117165844473348
STAT,1902,93,na,1995,313.9493376844736
SIM,1920,25,na,1945,4392
SIM,1982,30,40-44,2012,20
SIM,1886,64,na,1950,1330
STAT,1924,27,15-19,1951,0.9483266923981862
STAT,1810,53,25-29,1863,0.012708675231320245
SIM,1922,45,45-49,1967,1
SIM,1932,27,15-19,1959,3
STAT,1803,90,na,1893,27.479057798526235
STAT,1963,41,20-24,2004,0.026947657494240548
STAT,1886,20,45-49,1906,0.8539220904078945
STAT,1910,25,50-100,1935,1.1273936486295628
STAT,1952,47,30-34,1999,0.128235972866099
STAT,1910,17,30-34,1927,2.7901059732463036
STAT,1782,89,na,1871,49.32808994811149
STAT,1913,40,50-100,1953,0.1337821229770208
STAT,1930,16,45-49,1946,0.747244150335643
STAT,1830,35,25-29,1865,3.0030535216969825
STAT,1870,51,30-34,1921,0.0068047627026930485
STAT,1866,5,na,1871,3033.821410494422
STAT,1857,17,20-24,1874,18.72863910391331
STAT,1939,18,45-49,1957,0.5771092901190884
STAT,1841,24,45-49,1865,0.7741556640433604
STAT,1849,47,20-24,1896,0.009257458095182398
STAT,1958,15,na,1973,5582.018447493983
STAT,1958,29,35-39,1987,22.832333069512625
SIM,1902,49,35-39,1951,1
STAT,1919,34,na,1953,4667.551032344266
STAT,1979,34,50-100,2013,1.337419935225735
STAT,1838,44,na,1882,2076.693128880385
SIM,1866,38,20-24,1904,3
STAT,1825,31,50-100,1856,2.070319220236863
STAT,1886,35,30-34,1921,6.549369439575633
SIM,1968,34,25-29,2002,2
STAT,1933,38,50-100,1971,0.6595923878455128
SIM,1963,17,50-100,1980,1
STAT,1860,44,25-29,1904,0.5892137112947744
SIM,1865,40,45-49,1905,5
SIM,1866,29,30-34,1895,33
SIM,1894,35,30-34,1929,2
STAT,1881,30,25-29,1911,11.49298655499744
SIM,1959,37,50-100,1996,1
STAT,1878,37,50-100,1915,1.4793754685673786
STAT,1848,19,20-24,1867,23.077051786419513
STAT,1891,15,45-49,1906,0.09360356087149457
STAT,1964,29,20-24,1993,26.620732904838203
STAT,1850,31,45-49,1881,1.8975301198964782
STAT,1922,85,na,2007,1602.4198862985093
STAT,1853,11,na,1864,2872.1498332039514
STAT,1953,26,40-44,1979,6.538140718496025
STAT,1903,44,30-34,1947,0.12946010157973983
STAT,1801,101,na,1902,0.23950465433505294
SIM,1934,15,30-34,1949,24
STAT,1869,24,15-19,1893,3.663935305984209
SIM,1823,34,45-49,1857,4
STAT,1867,57,na,1924,2165.3541468899416
SIM,1868,45,30-34,1913,1
SIM,1925,26,30-34,1951,3
STAT,1840,45,35-39,1885,0.11619332276890576
SIM,1961,26,40-44,1987,19
SIM,1903,28,45-49,1931,1
SIM,1845,32,30-34,1877,7
STAT,1938,39,20-24,1977,0.30866304258821353
SIM,1965,31,na,1996,5576
STAT,1890,36,35-39,1926,10.021673253844849
STAT,1838,44,40-44,1882,2.0214006122609156
STAT,1894,25,na,1919,3564.5207060959733
STAT,1915,10,na,1925,4785.442040076603
SIM,1881,27,na,1908,2036
STAT,1933,34,15-19,1967,0.19968452446483245
STAT,1948,19,25-29,1967,57.193218630893604
STAT,1858,29,30-34,1887,22.876038536290924
SIM,1825,46,na,1871,1634
STAT,1770,88,na,1858,20.591092945100172
STAT,1837,32,30-34,1869,15.851756808616187
SIM,1929,20,30-34,1949,1
STAT,1871,50,20-24,1921,8.593996772955305E-4
STAT,1923,61,na,1984,4567.203581404239
SIM,1892,28,20-24,1920,20
STAT,1974,30,40-44,2004,6.017854324847732
STAT,1823,50,30-34,1873,0.005894863402137136
SIM,1956,19,25-29,1975,77
STAT,1842,34,50-100,1876,0.8342407446153801
STAT,1921,22,na,1943,4758.2797321077815
STAT,1874,53,40-44,1927,0.012238159190093453
SIM,1877,39,35-39,1916,16
STAT,1814,68,na,1882,1123.9690319160002
SIM,1965,21,na,1986,4861
STAT,1954,47,na,2001,5451.718662524427
SIM,1976,23,20-24,1999,325
SIM,1856,28,na,1884,2117
SIM,1846,44,40-44,1890,1
SIM,2000,7,na,2007,6487
STAT,1968,23,20-24,1991,160.75408755396887
STAT,1884,16,50-100,1900,0.05599876522821719
STAT,1869,39,35-39,1908,7.825197962899352
STAT,1948,42,50-100,1990,0.16123964885583775
STAT,1855,40,35-39,1895,1.5563607370497192
SIM,1956,58,na,2014,5006
STAT,1942,28,30-34,1970,47.444618452272536
SIM,1843,28,25-29,1871,5
SIM,1836,67,na,1903,930
SIM,1913,55,na,1968,4273
SIM,1935,39,na,1974,6223
SIM,1879,78,na,1957,781
STAT,1878,24,50-100,1902,0.48829326300619696
STAT,1884,28,20-24,1912,13.329361869720936
SIM,1896,35,40-44,1931,5
STAT,1937,37,na,1974,4343.908144740007
STAT,1808,99,na,1907,0.9656622142646847
STAT,1916,47,20-24,1963,0.013082350708991181
SIM,1871,22,30-34,1893,48
SIM,1895,39,50-100,1934,2
STAT,1873,32,40-44,1905,5.110776386648627
SIM,1988,19,15-19,2007,143
STAT,1849,20,40-44,1869,1.9810428162588294
STAT,1915,47,50-100,1962,0.26306882576886054
SIM,1877,43,30-34,1920,4
STAT,1954,57,na,2011,5212.354216904567
STAT,1931,37,45-49,1968,1.0421566746048825
STAT,1812,52,20-24,1864,0.001634636333129944
SIM,1950,28,30-34,1978,138
STAT,1809,51,20-24,1860,0.0018209512910389806
SIM,1901,34,20-24,1935,2
SIM,1881,32,40-44,1913,7
STAT,1823,37,50-100,1860,2.3010469639731554
STAT,1824,41,45-49,1865,2.16595292417709
STAT,1835,28,25-29,1863,34.22136545434847
SIM,1897,10,na,1907,4198
STAT,1863,22,30-34,1885,18.332769406377174
STAT,1950,17,15-19,1967,61.92753795838755
STAT,1832,23,40-44,1855,2.475701396996692
STAT,1946,15,50-100,1961,0.4798083091179899
STAT,1872,53,30-34,1925,0.006787075468609223
SIM,1902,12,na,1914,4324
STAT,1887,39,na,1926,3016.3723946187765
SIM,1832,41,45-49,1873,5
SIM,1961,29,45-49,1990,1
SIM,1889,18,20-24,1907,33
STAT,1887,39,50-100,1926,1.5718867858963308
SIM,1800,54,na,1854,1492
SIM,1888,39,na,1927,2746
SIM,1864,79,na,1943,662
STAT,1838,47,45-49,1885,0.21035184217386077
SIM,1881,41,30-34,1922,1
STAT,1969,41,25-29,2010,0.10713901055161469
SIM,1985,23,na,2008,6017
STAT,1946,19,15-19,1965,58.05107786615037
STAT,1857,40,45-49,1897,1.3587696874465143
STAT,1842,45,45-49,1887,0.18635264009321376
SIM,1817,38,25-29,1855,4
SIM,1895,25,na,1920,3682
SIM,1840,23,40-44,1863,2
STAT,1824,36,na,1860,1794.8745325153095
STAT,1922,38,na,1960,4933.221198645762
STAT,1948,41,35-39,1989,0.276771741163095
SIM,1978,21,50-100,1999,3
STAT,1895,29,35-39,1924,14.39094766174771
SIM,1813,101,na,1914,8
STAT,1862,63,na,1925,1737.7917375678578
STAT,1792,67,na,1859,1107.1055794438596
STAT,1849,102,na,1951,0.22723061688937374
SIM,1993,10,na,2003,6960
STAT,1918,42,25-29,1960,0.08760079163277033
STAT,1919,17,50-100,1936,0.4776916568454712
STAT,1881,52,45-49,1933,0.016068193359215686
SIM,1923,26,20-24,1949,47
STAT,1953,29,45-49,1982,2.4198681403156233
STAT,1904,20,na,1924,3942.7893430354793
SIM,1954,19,15-19,1973,2
STAT,1833,32,50-100,1865,0.8378728303412987
SIM,1850,45,45-49,1895,1
STAT,1901,44,20-24,1945,0.017586429161848553
SIM,1908,28,35-39,1936,22
SIM,1865,42,50-100,1907,3
SIM,1918,84,na,2002,1720
STAT,1834,54,25-29,1888,0.0031856329765435265
STAT,1984,17,15-19,2001,74.38611486271316
STAT,1853,5,na,1858,3011.5882925617857
SIM,1869,33,30-34,1902,35
STAT,1848,41,30-34,1889,1.2357819215271444
STAT,1869,43,30-34,1912,1.2755970941533743
SIM,1992,17,15-19,2009,83
SIM,1955,57,na,2012,6057
SIM,1815,68,na,1883,1032
STAT,1886,38,35-39,1924,8.567240820166013
SIM,1816,85,na,1901,69
STAT,1970,40,25-29,2010,0.10750514868798076
SIM,1856,41,30-34,1897,2
SIM,1889,40,30-34,1929,3
STAT,1869,42,na,1911,2579.880593909187
STAT,1921,15,40-44,1936,1.8478207050071356
STAT,1810,50,20-24,1860,0.0028142068359817266
SIM,1823,43,35-39,1866,1
SIM,1912,26,35-39,1938,21
STAT,1944,32,25-29,1976,11.701042590233683
SIM,1929,23,35-39,1952,2
STAT,1902,77,na,1979,2137.5416196273172
SIM,1949,24,15-19,1973,14
STAT,1849,81,na,1930,419.12938239789725
STAT,1949,37,30-34,1986,2.52019164955561
STAT,1959,17,35-39,1976,6.3344024010333015
SIM,1834,34,20-24,1868,5
SIM,1894,38,35-39,1932,10
SIM,1972,32,25-29,2004,2
SIM,1899,20,35-39,1919,2
STAT,1974,33,45-49,2007,2.4155865392844005
STAT,1847,9,na,1856,2339.7332440112996
STAT,1792,73,na,1865,744.9332315831816
STAT,1911,44,na,1955,4043.9870443511804
STAT,1826,34,20-24,1860,2.314671506714678
SIM,1909,18,25-29,1927,14
SIM,1931,15,50-100,1946,2
STAT,1829,50,25-29,1879,0.0036306330640972035
SIM,1909,49,45-49,1958,2
STAT,1909,56,na,1965,3754.8806309263173
STAT,1815,43,35-39,1858,3.9234513751695177
STAT,1915,26,20-24,1941,21.56434558239237
STAT,1878,78,na,1956,988.3098756796524
SIM,1880,16,na,1896,3606
SIM,1924,38,30-34,1962,1
STAT,1875,37,20-24,1912,0.9193108507853031
STAT,1958,38,25-29,1996,1.5359931495031827
SIM,1785,90,na,1875,30
SIM,1944,37,na,1981,4603
SIM,1891,30,45-49,1921,5
SIM,1967,17,35-39,1984,7
STAT,1830,32,20-24,1862,2.9246251443709625
SIM,1819,45,35-39,1864,1
STAT,1972,42,25-29,2014,0.10965473905723362
STAT,1855,40,25-29,1895,0.551922017127355
SIM,1905,29,50-100,1934,2
SIM,1915,40,na,1955,4553
SIM,1852,30,na,1882,2079
STAT,1814,84,na,1898,207.4216530120763
STAT,1890,27,45-49,1917,1.565660861055388
STAT,1835,52,na,1887,1367.5614809311176
STAT,1868,40,20-24,1908,0.17786352705205818
STAT,1870,54,35-39,1924,0.009525386121514837
SIM,1923,38,na,1961,5366
STAT,1830,26,35-39,1856,12.750905224564125
STAT,1876,12,na,1888,3098.9796588212475
SIM,1885,47,na,1932,2989
STAT,1916,38,30-34,1954,2.143466847868239
STAT,1861,18,25-29,1879,6.21205237524132
STAT,1871,53,25-29,1924,0.004001383497148169
STAT,1938,47,50-100,1985,0.2679525958353332
SIM,1877,12,na,1889,3452
SIM,1883,37,20-24,1920,1
STAT,1968,26,25-29,1994,95.32715870812468
SIM,1958,18,20-24,1976,400
STAT,1948,16,20-24,1964,179.10080709409587
SIM,1868,48,35-39,1916,1
SIM,1918,22,20-24,1940,117
STAT,1926,18,35-39,1944,5.9204285613018905
SIM,1860,24,20-24,1884,6
STAT,1885,32,45-49,1917,2.0073298746092716
SIM,1893,32,45-49,1925,7
SIM,1856,40,50-100,1896,1
STAT,1823,53,35-39,1876,0.008031951445993507
SIM,1956,16,20-24,1972,186
STAT,1810,106,na,1916,0.006913324029130703
SIM,1786,75,na,1861,165
SIM,1903,25,40-44,1928,12
STAT,1950,48,35-39,1998,0.18248551150661385
STAT,1837,35,35-39,1872,6.366611095829918
STAT,1871,39,50-100,1910,1.3954168003494838
STAT,1963,41,30-34,2004,0.1950776042220347
STAT,1870,41,15-19,1911,0.015782869234659443
STAT,1844,50,na,1894,1826.8386906939256
STAT,1920,36,30-34,1956,2.3040171662163083
STAT,2004,5,na,2009,6933.980992591659
STAT,1822,50,25-29,1872,0.006704760613550015
STAT,1877,41,15-19,1918,0.016652951092775505
SIM,1811,91,na,1902,21
STAT,1903,35,40-44,1938,1.5678656599980714
STAT,1884,47,15-19,1931,4.53961704877981E-4
SIM,1982,20,25-29,2002,5
SIM,1957,37,30-34,1994,3
SIM,1863,63,na,1926,1835
SIM,1935,39,45-49,1974,3
STAT,1990,22,25-29,2012,153.16424924751988
SIM,1845,35,35-39,1880,14
SIM,1913,47,45-49,1960,1
SIM,1952,32,25-29,1984,23
STAT,1904,26,35-39,1930,16.045264229068735
STAT,1941,16,20-24,1957,161.24225758747622
STAT,1963,42,50-100,2005,0.17900236566250724
SIM,1899,92,na,1991,47
STAT,1927,39,45-49,1966,0.975851245466277
SIM,1981,21,35-39,2002,36
STAT,1858,38,20-24,1896,0.6905422972763848
STAT,1905,47,45-49,1952,0.22132275973298632
STAT,1859,42,45-49,1901,1.3741744488248657
SIM,1911,35,40-44,1946,5
STAT,1928,3,na,1931,5897.940240004186
SIM,1935,55,na,1990,5915
STAT,1910,39,40-44,1949,1.637327810267758
STAT,1910,38,50-100,1948,0.4615834753032599
STAT,1844,42,25-29,1886,0.550095036827188
STAT,1812,50,30-34,1862,0.013725485062386087
SIM,1964,20,na,1984,5932
STAT,1926,27,25-29,1953,91.03920313815186
SIM,1871,34,na,1905,2128
STAT,1961,44,15-19,2005,0.002371624688166834
SIM,1810,47,na,1857,1464
SIM,1971,41,30-34,2012,1
STAT,1785,87,na,1872,38.20737632231498
STAT,1898,61,na,1959,3019.9710942914317
SIM,1880,11,na,1891,3619
STAT,1873,35,45-49,1908,2.371615476820967
SIM,1893,19,25-29,1912,1
STAT,1915,48,30-34,1963,0.10339686289387517
SIM,1858,19,30-34,1877,2
STAT,1879,40,20-24,1919,0.19330372144538863
SIM,1978,36,50-100,2014,1
STAT,1874,31,30-34,1905,20.71203285410421
SIM,1860,71,na,1931,1444
SIM,1882,31,30-34,1913,6
STAT,1859,64,na,1923,1598.0810804068449
STAT,1984,24,50-100,2008,1.0813246523870792
STAT,1966,33,15-19,1999,0.18869204363318015
STAT,1880,41,50-100,1921,1.2981428449939652
STAT,1816,52,40-44,1868,0.020612196884120845
STAT,1848,27,na,1875,2744.016165715727
STAT,1911,42,15-19,1953,0.0016929549875792924
STAT,1889,16,40-44,1905,0.2608313067141181
STAT,1957,35,15-19,1992,0.030155101413715166
STAT,1930,16,35-39,1946,6.276852025770651
SIM,1830,51,na,1881,1604
STAT,1872,31,na,1903,2776.563123773143
SIM,1863,40,35-39,1903,1
SIM,1881,35,45-49,1916,5
STAT,1894,30,45-49,1924,2.607823489766662
STAT,1931,34,40-44,1965,5.911321876231713
STAT,1957,35,na,1992,5907.801641086631
STAT,1858,45,20-24,1903,0.010911137976987187
STAT,1912,21,25-29,1933,102.56624591398591
STAT,1950,45,30-34,1995,0.12712295267368684
STAT,1970,17,na,1987,5317.338258868712
STAT,1842,49,na,1891,1695.1608351950542
SIM,1871,0,na,1871,3811
SIM,1892,35,20-24,1927,3
SIM,1950,22,na,1972,4797
STAT,1857,42,35-39,1899,1.625574944507239
STAT,1864,37,45-49,1901,2.0541715851294255
SIM,1822,54,na,1876,1390
STAT,1825,107,na,1932,0.003335727379583399
STAT,1940,32,40-44,1972,4.675544256265842
SIM,1868,38,30-34,1906,7
SIM,1872,37,45-49,1909,5
SIM,1904,78,na,1982,2716
STAT,1885,19,25-29,1904,6.488041955281161
SIM,1822,43,40-44,1865,10
SIM,1841,14,na,1855,2457
STAT,1884,35,20-24,1919,0.887285459981657
STAT,1982,1,na,1983,6394.276621291937
SIM,1899,76,na,1975,2177
STAT,1873,26,na,1899,2822.1451565405746
STAT,1872,51,40-44,1923,0.01225783326424982
STAT,1901,47,25-29,1948,0.05227660071635865
STAT,1909,42,50-100,1951,0.12695226396508089
SIM,1875,41,50-100,1916,5
STAT,1952,61,na,2013,4868.275708878547
SIM,1963,46,40-44,2009,1
STAT,1941,38,30-34,1979,2.230299369936672
STAT,1890,33,30-34,1923,24.51640252885654
STAT,1951,29,35-39,1980,20.700868090678497
STAT,1819,40,15-19,1859,0.030999620305213797
STAT,1817,45,50-100,1862,0.721539214984633
SIM,1942,22,15-19,1964,7
SIM,1821,34,35-39,1855,3
SIM,1842,79,na,1921,760
STAT,1970,22,25-29,1992,133.8806686195252
SIM,1960,17,25-29,1977,82
SIM,1826,47,na,1873,1767
STAT,1953,47,45-49,2000,0.31559953203343477
STAT,1823,51,45-49,1874,0.014088841704150932
STAT,1814,43,40-44,1857,7.093225338691391
STAT,1900,38,na,1938,3783.6666752474616
STAT,1920,24,50-100,1944,0.8385497308781188
SIM,1887,41,25-29,1928,2
SIM,1855,12,na,1867,2206
SIM,1867,17,30-34,1884,2
SIM,1905,19,na,1924,4353
SIM,1879,39,45-49,1918,2
SIM,1850,42,40-44,1892,5
SIM,1930,18,na,1948,5890
STAT,1874,103,na,1977,3.0062516774471604
STAT,1914,42,40-44,1956,0.28616110245362514
SIM,1926,7,na,1933,6246
STAT,1836,47,35-39,1883,0.13338506046034213
STAT,1875,44,45-49,1919,1.7607936055628837
STAT,1934,22,15-19,1956,8.259829788341715
SIM,1901,28,35-39,1929,34
STAT,1861,31,45-49,1892,1.6798726895295937
SIM,1971,42,35-39,2013,1
STAT,1841,64,na,1905,1545.5573472881463
STAT,1859,17,30-34,1876,1.700850200257385
SIM,1870,34,30-34,1904,42
STAT,1880,66,na,1946,2004.9047976297836
STAT,1869,46,35-39,1915,0.15690939736692674
STAT,1990,4,na,1994,6499.4914183073315
SIM,1883,44,45-49,1927,5
STAT,1955,46,40-44,2001,0.2518640854418715
STAT,1825,50,40-44,1875,0.014741157938439714
STAT,1834,51,20-24,1885,7.043003478446315E-4
STAT,1940,28,20-24,1968,21.478036604598365
STAT,1901,82,na,1983,1525.1944958666807
STAT,1842,42,40-44,1884,1.790777474957954
STAT,1858,21,45-49,1879,0.7255083151363261
STAT,1935,32,50-100,1967,1.3207857136463095
STAT,1948,49,30-34,1997,0.12174155964042814
STAT,1952,17,25-29,1969,59.931273475437074
STAT,1893,14,na,1907,3754.9582262432036
SIM,1866,21,45-49,1887,1
SIM,1867,42,45-49,1909,5
STAT,1818,52,25-29,1870,0.004207247145605292
STAT,1864,43,30-34,1907,1.1761081847740942
SIM,1869,26,30-34,1895,4
STAT,1789,68,na,1857,575.8452559549761
STAT,1894,15,50-100,1909,0.07301906097281607
STAT,1847,20,30-34,1867,17.045798324428308
SIM,1844,47,35-39,1891,1
STAT,1959,43,20-24,2002,0.02766188802088706
SIM,1909,16,35-39,1925,1
SIM,1845,28,35-39,1873,23
STAT,1975,38,30-34,2013,2.8558508551899333
STAT,1840,33,40-44,1873,4.193529786596255
STAT,1928,24,50-100,1952,0.9421431708365652
SIM,1823,40,30-34,1863,3
STAT,1911,60,na,1971,3740.8549439703465
SIM,1927,41,50-100,1968,1
STAT,1845,30,15-19,1875,0.11649369623990542
SIM,1864,64,na,1928,1806
SIM,1902,47,50-100,1949,1
SIM,1944,15,25-29,1959,128
SIM,1941,59,na,2000,3608
STAT,1880,82,na,1962,833.4047924420306
STAT,1876,6,na,1882,3238.560404856199
SIM,1982,31,na,2013,6630
SIM,1958,19,35-39,1977,16
SIM,1987,19,na,2006,6147
STAT,1849,54,45-49,1903,0.010938795284090688
SIM,1830,41,35-39,1871,3
SIM,1894,28,30-34,1922,85
SIM,1888,9,na,1897,3117
STAT,1912,55,na,1967,3950.473492997468
SIM,1930,81,na,2011,2824
SIM,1908,37,25-29,1945,1
STAT,1867,52,20-24,1919,7.90866876087088E-4
SIM,1933,36,30-34,1969,6
STAT,1779,75,na,1854,341.00000000000006
STAT,1860,46,15-19,1906,3.7309944754943474E-4
STAT,1886,28,30-34,1914,30.546304472894693
SIM,1815,84,na,1899,319
SIM,1967,1,na,1968,5787
SIM,1989,20,35-39,2009,23
STAT,1925,36,30-34,1961,2.525950160093866
STAT,1841,17,45-49,1858,0.07490484661327218
SIM,1855,20,30-34,1875,40
STAT,1822,41,35-39,1863,3.801652591622142
STAT,1851,36,20-24,1887,0.6242740216461027
STAT,1896,46,50-100,1942,0.21177240719438356
STAT,1972,40,35-39,2012,0.3100728803834709
STAT,1946,41,25-29,1987,0.09512605812901982
STAT,1823,35,na,1858,1650.6494378720754
SIM,1913,44,40-44,1957,1
STAT,1967,41,15-19,2008,0.0023039679010757905
STAT,1778,90,na,1868,39.02123906121813
SIM,1828,32,na,1860,2360
SIM,1876,40,45-49,1916,2
STAT,1884,29,50-100,1913,0.7241775944394331
SIM,1920,21,25-29,1941,248
SIM,1831,36,na,1867,1692
SIM,1876,38,50-100,1914,1
SIM,1895,41,na,1936,3519
STAT,1873,41,30-34,1914,1.361002822450126
STAT,1901,42,30-34,1943,0.1288935331224734
SIM,1870,41,30-34,1911,4
STAT,1896,45,40-44,1941,0.1486694603729539
SIM,1986,24,na,2010,6695
STAT,1893,42,20-24,1935,0.23137829807196042
STAT,1905,44,40-44,1949,0.2573732830186217
SIM,1910,63,na,1973,2989
STAT,1844,34,na,1878,2123.179072629031
STAT,1967,13,na,1980,5661.72735716169
SIM,1958,18,30-34,1976,43
STAT,1963,20,na,1983,5375.525675109669
SIM,1816,69,na,1885,1163
STAT,1986,17,25-29,2003,71.26008157887632
STAT,1781,94,na,1875,3.1126698742287573
SIM,1934,27,25-29,1961,5
STAT,1863,64,na,1927,1754.1951388553093
STAT,1851,40,40-44,1891,1.8016619244264434
STAT,1846,41,20-24,1887,0.168308185964724
STAT,1863,6,na,1869,2872.690939945881
STAT,1829,67,na,1896,1161.297803057469
STAT,1912,45,na,1957,4097.6672486244215
SIM,1896,26,na,1922,3567
STAT,1901,4,na,1905,4252.461328177088
STAT,1815,40,30-34,1855,3.1040261387531123
STAT,1871,20,15-19,1891,3.8102960192534754
STAT,1869,26,na,1895,2676.3513276006765
STAT,1897,29,45-49,1926,1.7011006913259223
STAT,1909,41,na,1950,4036.510831786958
STAT,1862,37,35-39,1899,6.888547459128833
STAT,1868,40,45-49,1908,1.6761703853959553
SIM,1918,25,25-29,1943,12
STAT,1878,53,35-39,1931,0.010206975520488328
STAT,1884,63,na,1947,2034.5011486401145
STAT,1836,53,20-24,1889,6.664072838201928E-4
STAT,1829,50,35-39,1879,0.00882445545317301
STAT,1852,27,na,1879,2375.560045352475
STAT,1947,37,20-24,1984,0.35304622896158316
SIM,1877,22,na,1899,3368
STAT,1870,32,25-29,1902,11.653258686825675
STAT,1862,34,30-34,1896,16.858998195397614
STAT,1941,19,15-19,1960,53.92390233211775
SIM,1892,38,25-29,1930,1
STAT,1903,38,45-49,1941,0.7037707500596968
SIM,1794,68,na,1862,829
STAT,1862,53,na,1915,2063.3695781535052
STAT,2008,5,na,2013,7100.307464816462
STAT,1961,42,25-29,2003,0.11064869484457256
STAT,1872,54,45-49,1926,0.01635456052484514
STAT,1851,43,45-49,1894,1.178254541810776
SIM,1847,25,40-44,1872,7
SIM,1970,27,45-49,1997,4
STAT,1897,33,40-44,1930,6.663893092047988
STAT,1809,51,45-49,1860,0.035812040698022865
SIM,1898,11,na,1909,4179
STAT,1859,29,25-29,1888,38.99310915054311
SIM,1867,29,25-29,1896,51
STAT,1911,40,25-29,1951,0.07961475792278466
STAT,1975,30,35-39,2005,14.197779766041135
STAT,1862,46,25-29,1908,0.05625778046520721
SIM,1914,56,na,1970,3763
SIM,1886,7,na,1893,2402
STAT,1984,23,na,2007,6003.32453834768
STAT,1962,27,45-49,1989,2.5656232474240857
SIM,1829,30,30-34,1859,30
STAT,1946,32,35-39,1978,11.92301682649718
STAT,1940,35,45-49,1975,0.8246540826587438
STAT,1863,18,35-39,1881,0.5715813548167823
STAT,1824,40,30-34,1864,1.6921114796892927
SIM,1955,37,20-24,1992,1
STAT,1823,49,15-19,1872,3.843024043050767E-4
STAT,1894,100,na,1994,28.465160879623408
SIM,1872,34,40-44,1906,9
STAT,1884,38,25-29,1922,3.266637756739227
STAT,1852,33,50-100,1885,0.8851728146877881
SIM,1868,45,na,1913,3010
STAT,1775,116,na,1891,1.0116886365376778E-4
STAT,1936,36,na,1972,4268.815899380252
SIM,1889,31,40-44,1920,13
STAT,1873,96,na,1969,50.2230363724472
SIM,1878,77,na,1955,986
SIM,1983,30,35-39,2013,10
SIM,1911,38,45-49,1949,2
STAT,1847,45,45-49,1892,0.18340161365365573
SIM,1912,26,45-49,1938,2
STAT,1836,27,50-100,1863,0.7535714088055245
SIM,1876,11,na,1887,2972
STAT,1807,98,na,1905,1.5885496686761527
STAT,1825,53,45-49,1878,0.019144687629896965
STAT,1843,51,20-24,1894,7.439568670097711E-4
STAT,1951,35,20-24,1986,0.37386594029775533
SIM,1860,33,50-100,1893,1
STAT,1904,26,45-49,1930,1.8463300951453991
STAT,1928,17,40-44,1945,2.03387675853152
SIM,1801,55,na,1856,1489
STAT,1890,44,na,1934,3215.133794493552
STAT,1883,32,35-39,1915,11.434392109797729
STAT,1919,81,na,2000,2180.19508000395
STAT,1950,47,20-24,1997,0.015685220757499188
STAT,1810,87,na,1897,100.31510099422664
SIM,1879,88,na,1967,241
STAT,1803,54,20-24,1857,0.002571936128328956
STAT,1974,18,15-19,1992,68.36747621246433
STAT,1891,24,50-100,1915,0.5779977132260142
STAT,1937,47,na,1984,4282.609321757783
SIM,1929,30,35-39,1959,21
STAT,1839,45,na,1884,1865.088375178349
SIM,1970,9,na,1979,6045
STAT,1836,44,30-34,1880,1.2136280668737662
STAT,1875,41,40-44,1916,2.694613628757412
STAT,1961,35,na,1996,5789.12103536535
STAT,1814,46,45-49,1860,0.6669797879693331
STAT,1948,46,50-100,1994,0.31147509064683415
STAT,1852,17,20-24,1869,20.21579320247944
STAT,1952,35,50-100,1987,0.5992456212251696
SIM,1905,25,50-100,1930,2
STAT,1861,53,30-34,1914,0.005619224052070045
SIM,1979,32,35-39,2011,6
SIM,1911,42,40-44,1953,1
STAT,1951,26,30-34,1977,54.10326785496136
STAT,1925,45,20-24,1970,0.015521931778818759
STAT,1924,40,35-39,1964,0.2771071003381188
SIM,1883,41,40-44,1924,3
STAT,1903,47,35-39,1950,0.12920662379297504
SIM,1954,32,35-39,1986,21
STAT,1936,15,25-29,1951,48.13122939805073
SIM,1878,32,50-100,1910,1
SIM,1898,91,na,1989,746
STAT,1986,21,20-24,2007,183.51250469016034
SIM,1903,93,na,1996,191
SIM,1954,1,na,1955,5557
SIM,1944,37,45-49,1981,2
SIM,1901,25,30-34,1926,82
SIM,1846,61,na,1907,1163
SIM,1932,40,35-39,1972,1
SIM,1986,19,40-44,2005,7
STAT,1990,16,50-100,2006,0.6193704461474735
SIM,1844,44,30-34,1888,1
STAT,1812,53,35-39,1865,0.0186922564862487
SIM,1960,35,50-100,1995,2
SIM,1925,48,40-44,1973,1
STAT,1958,16,15-19,1974,68.80840219545131
SIM,1885,63,na,1948,2438
STAT,1860,41,20-24,1901,0.14838174312638938
STAT,1814,52,30-34,1866,0.015823296422097476
STAT,1858,48,25-29,1906,0.05120489467863314
STAT,1898,17,45-49,1915,0.10188222584145602
STAT,1936,37,45-49,1973,0.7728144381311004
STAT,1832,87,na,1919,120.03026545607835
STAT,1837,28,35-39,1865,8.903496475141184
STAT,1914,45,45-49,1959,0.2500423526756175
STAT,1842,42,15-19,1884,0.010994797234626628
STAT,1968,30,20-24,1998,3.5878343605988072
STAT,1840,36,45-49,1876,1.9111788838990664
STAT,1963,44,25-29,2007,0.10844333920162726
SIM,1926,81,na,2007,3608
SIM,1890,42,45-49,1932,11
SIM,1928,69,na,1997,4461
STAT,1804,91,na,1895,25.195652283357216
STAT,1824,46,na,1870,1626.1954536217293
SIM,1880,31,20-24,1911,6
STAT,1908,55,na,1963,3718.679214107942
SIM,1895,16,30-34,1911,5
STAT,1849,51,40-44,1900,0.008198687363102686
STAT,1875,11,na,1886,3120.3660529267127
SIM,1865,42,35-39,1907,7
SIM,1860,17,20-24,1877,35
SIM,1983,21,45-49,2004,4
STAT,1890,59,na,1949,2740.518054775478
SIM,1870,37,35-39,1907,16
STAT,1825,46,20-24,1871,0.016991058107969245
STAT,1971,30,25-29,2001,13.786264148629261
STAT,1865,15,40-44,1880,0.2182270365090043
STAT,1865,47,50-100,1912,0.25454025267760516
STAT,1999,15,45-49,2014,0.8521172002736949
STAT,1959,46,25-29,2005,0.08349831826381651
STAT,1850,30,30-34,1880,21.09560062768245
STAT,1925,39,35-39,1964,3.3420264207628745
STAT,1984,30,35-39,2014,15.285076290802746
STAT,1901,23,15-19,1924,5.31633699604406
STAT,1791,72,na,1863,594.5664414501874
STAT,1882,42,45-49,1924,1.6849582425115546
SIM,1980,20,15-19,2000,16
SIM,1937,40,na,1977,4347
STAT,1880,51,25-29,1931,0.004353466723321864
STAT,1839,33,50-100,1872,0.8849629247684051
STAT,1944,19,40-44,1963,1.7360213151025774
SIM,1916,41,na,1957,4395
STAT,1860,50,45-49,1910,0.013692095557355738
SIM,1933,39,35-39,1972,8
SIM,1956,28,15-19,1984,1
SIM,1982,25,50-100,2007,4
STAT,1879,41,25-29,1920,0.777312662609367
STAT,1918,33,na,1951,4617.5034552065945
SIM,1928,77,na,2005,3505
STAT,1854,12,na,1866,2326.534606713083
STAT,1877,77,na,1954,1037.6551641389246
STAT,1887,16,30-34,1903,2.066450837691413
STAT,1847,51,30-34,1898,0.004602129700988383
STAT,1948,28,15-19,1976,0.9359122275051226
SIM,1843,41,45-49,1884,2
STAT,1896,48,45-49,1944,0.20036885686779163
STAT,1972,22,35-39,1994,13.95899768666821
STAT,1921,37,na,1958,4846.130044556869
STAT,1873,44,35-39,1917,2.1052203244111896
STAT,1901,45,35-39,1946,0.12892900269210938
STAT,1876,92,na,1968,170.71023683134018
SIM,1983,19,15-19,2002,2
STAT,1881,30,35-39,1911,11.363343713332817
SIM,1841,36,50-100,1877,1
STAT,1953,49,35-39,2002,0.1861226881327341
SIM,1909,25,25-29,1934,94
SIM,1891,32,35-39,1923,20
STAT,1840,42,30-34,1882,0.9620574878219809
STAT,1841,21,40-44,1862,2.363967592095914
STAT,1913,16,50-100,1929,0.08866557021784387
SIM,1871,18,35-39,1889,1
SIM,1884,0,na,1884,4017
STAT,1856,52,45-49,1908,0.01270942357844578
STAT,1856,78,na,1934,687.9238166135717
STAT,1878,50,30-34,1928,0.0072756302736027055
STAT,1914,38,20-24,1952,0.30238113461843413
STAT,1855,24,50-100,1879,0.3995667929712251
STAT,1984,24,15-19,2008,8.747915430724076
STAT,1835,41,45-49,1876,1.1336254574514282
SIM,1881,44,35-39,1925,1
STAT,1919,18,na,1937,4680.726597242449
SIM,1863,24,50-100,1887,1
STAT,1894,95,na,1989,161.1354335426256
SIM,1891,59,na,1950,2686
STAT,1835,79,na,1914,435.72008829849875
SIM,1854,86,na,1940,101
STAT,1869,111,na,1980,0.005155052353520593
SIM,1923,29,15-19,1952,1
STAT,1895,36,35-39,1931,10.676024025209875
STAT,1927,69,na,1996,4276.398945936893
SIM,1921,16,50-100,1937,1
STAT,1950,30,35-39,1980,12.725051495733032
SIM,1907,49,35-39,1956,2
SIM,1800,70,na,1870,894
STAT,1833,36,50-100,1869,1.1003134701335517
STAT,1839,25,40-44,1864,3.0362053551149852
STAT,1915,29,15-19,1944,0.8251877827430683
STAT,1868,41,na,1909,2574.2231051309896
STAT,1872,31,20-24,1903,3.1451110387664176
STAT,1881,38,50-100,1919,1.359857684175044
STAT,1908,32,15-19,1940,0.14016207966956443
STAT,1863,16,50-100,1879,0.056747884416540384
SIM,1838,39,45-49,1877,5
STAT,1986,27,40-44,2013,7.697713830460217
STAT,1879,39,40-44,1918,5.221883274198638
SIM,1870,103,na,1973,10
SIM,1961,23,25-29,1984,297
STAT,1856,36,35-39,1892,6.257321174178004
STAT,1906,5,na,1911,4410.1965569424
SIM,1978,22,25-29,2000,308
SIM,1937,21,40-44,1958,1
STAT,1880,109,na,1989,0.07008907254006808
STAT,1886,16,25-29,1902,6.915113740006747
STAT,1829,98,na,1927,2.379814096735824
SIM,1890,23,30-34,1913,32
SIM,1844,22,20-24,1866,124
STAT,1894,110,na,2004,0.04649968781553697
STAT,1915,37,na,1952,4386.843745633102
STAT,1969,24,50-100,1993,0.9510726056515132
SIM,1924,9,na,1933,5379
STAT,1983,17,45-49,2000,0.8155242117593424
STAT,1820,41,25-29,1861,0.8185686632131423
STAT,1890,27,50-100,1917,0.9020431591769704
SIM,1894,16,25-29,1910,12
SIM,1919,32,30-34,1951,48
STAT,1945,18,50-100,1963,0.47216193765334735
STAT,1926,82,na,2008,2295.1586588313544
STAT,1873,32,na,1905,2812.243358432476
STAT,1946,29,na,1975,4810.977363476842
STAT,1833,41,35-39,1874,1.575214321797852
STAT,1877,46,na,1923,2708.4780375435844
SIM,1800,85,na,1885,108
STAT,1817,46,25-29,1863,0.16681173199904945
STAT,1891,21,30-34,1912,25.482686131549524
STAT,1939,49,30-34,1988,0.10652951023799197
SIM,1846,39,na,1885,1620
SIM,1835,51,na,1886,1909
SIM,1887,39,40-44,1926,2
STAT,1953,23,25-29,1976,129.3362423726312
STAT,1940,42,50-100,1982,0.14310366918412412
SIM,1955,46,45-49,2001,2
SIM,1958,28,25-29,1986,12
STAT,1974,30,na,2004,5815.982288375156
STAT,1929,21,40-44,1950,4.922024360349006
STAT,1836,22,20-24,1858,82.79823920560759
SIM,1903,22,25-29,1925,205
STAT,1994,17,20-24,2011,225.77979583835764
SIM,1949,22,15-19,1971,10
STAT,1865,34,35-39,1899,10.454588008557986
STAT,1967,30,50-100,1997,1.2162843952455804
STAT,1780,108,na,1888,0.0073325661215475485
STAT,1910,40,20-24,1950,0.01950010097366655
STAT,1960,21,50-100,1981,0.9926144964676514
SIM,1825,39,35-39,1864,1
STAT,1879,31,30-34,1910,21.12526895130831
STAT,1882,23,30-34,1905,20.01623087567111
STAT,1976,18,25-29,1994,66.79288179187648
STAT,1985,18,na,2003,6039.624661991731
STAT,1882,113,na,1995,0.0014630434450830971
SIM,1935,33,25-29,1968,6
STAT,1882,41,30-34,1923,1.3017870236819777
SIM,1870,48,na,1918,2889
SIM,1949,15,25-29,1964,82
STAT,1840,40,40-44,1880,2.122061173297299
STAT,1887,76,na,1963,1525.6778031822716
STAT,1901,42,20-24,1943,0.017805112983926178
STAT,1953,30,15-19,1983,0.1830729901577421
STAT,1894,17,15-19,1911,8.804138729817756
STAT,1817,39,35-39,1856,23.54693604242674
SIM,1932,48,30-34,1980,1
STAT,1895,75,na,1970,2039.97421560311
STAT,1888,37,40-44,1925,5.938409117831805
SIM,1952,25,25-29,1977,4
STAT,1977,25,20-24,2002,28.6111741626997
STAT,1850,39,20-24,1889,0.7895453095991357
SIM,1841,41,35-39,1882,5
SIM,1815,47,na,1862,1920
STAT,1826,44,25-29,1870,0.4671003254947213
STAT,1917,19,30-34,1936,15.006932887450276
SIM,1916,19,na,1935,4444
STAT,1847,52,45-49,1899,0.011107194381928812
STAT,1930,47,50-100,1977,0.34378633086564325
STAT,1927,15,25-29,1942,62.45764120445441
SIM,1934,44,na,1978,5746
STAT,1809,53,50-100,1862,0.03575717041044471
STAT,1944,25,25-29,1969,82.17264104090073
STAT,1876,53,25-29,1929,0.0041577007938231846
SIM,1808,65,na,1873,1065
STAT,1963,15,35-39,1978,6.155488055434798
STAT,1862,84,na,1946,323.99146487978186
SIM,1890,41,30-34,1931,6
STAT,1862,53,25-29,1915,0.0033942928203231667
SIM,1891,26,na,1917,3259
STAT,1952,3,na,1955,5440.230904768589
STAT,1820,53,na,1873,1373.3082447540721
SIM,1831,27,40-44,1858,4
STAT,1861,18,15-19,1879,6.505647937618946
STAT,1866,39,30-34,1905,5.643469652231257
STAT,1965,49,15-19,2014,5.488073631551717E-4
SIM,1882,77,na,1959,1501
STAT,1830,79,na,1909,438.560520274632
SIM,1936,24,30-34,1960,1
SIM,1851,36,25-29,1887,2
SIM,1900,38,50-100,1938,1
STAT,1940,36,na,1976,4547.286903711463
STAT,1950,26,50-100,1976,1.3646833215472403
STAT,1927,33,25-29,1960,13.109954799092018
SIM,1908,3,na,1911,4490
SIM,1930,1,na,1931,6468
SIM,1968,28,40-44,1996,18
STAT,1843,36,25-29,1879,3.4077741736234755
SIM,1823,41,45-49,1864,4
SIM,1889,34,45-49,1923,5
STAT,1833,23,35-39,1856,5.836144452856639
STAT,1782,74,na,1856,584.9135325243
STAT,1890,28,na,1918,3353.4388268700122
STAT,1828,45,na,1873,1697.735537884596
STAT,1959,43,30-34,2002,0.2002480120777165
SIM,1874,39,30-34,1913,3
SIM,1787,86,na,1873,286
STAT,1958,46,20-24,2004,0.017466466812387907
SIM,1873,31,30-34,1904,28
STAT,1814,50,40-44,1864,0.029128530369116577
STAT,1885,19,15-19,1904,6.794681405744007
STAT,1835,28,15-19,1863,0.3670401633080546
STAT,1933,28,30-34,1961,60.03874751531829
STAT,1843,29,35-39,1872,11.744394105409011
SIM,1941,28,30-34,1969,38
STAT,1920,21,20-24,1941,143.02971923172697
STAT,1881,67,na,1948,1764.5521015892919
SIM,1925,19,30-34,1944,19
STAT,1828,50,50-100,1878,0.013975995198016539
STAT,1806,107,na,1913,0.0016186130114098892
STAT,1824,49,20-24,1873,0.015874861640158576
STAT,1852,20,50-100,1872,0.4633626983720243
STAT,1872,34,25-29,1906,11.767533550272873
SIM,1880,34,25-29,1914,26
STAT,1927,54,na,1981,5181.913351995607
STAT,1893,40,na,1933,3405.4674177438746
STAT,1989,20,50-100,2009,1.0920068480767846
STAT,1839,44,35-39,1883,1.475260319174159
STAT,1867,29,20-24,1896,12.55015897326263
STAT,1875,44,20-24,1919,0.1868431537896092
SIM,1851,29,35-39,1880,15
SIM,1977,25,15-19,2002,1
SIM,1972,38,45-49,2010,1
STAT,1861,31,na,1892,2298.800176800436
SIM,1846,35,na,1881,1691
STAT,1883,19,50-100,1902,0.05501970205454856
STAT,1775,92,na,1867,14.62647939613614
SIM,1831,31,25-29,1862,24
SIM,1897,35,35-39,1932,27
STAT,1777,108,na,1885,0.0038594174881131657
SIM,1847,44,35-39,1891,4
SIM,1977,35,40-44,2012,6
STAT,1878,18,40-44,1896,0.2198126350055085
STAT,1931,40,50-100,1971,0.1816634076888207
STAT,1864,41,40-44,1905,2.328234601716404
SIM,1883,8,na,1891,2796
STAT,1948,41,45-49,1989,0.22875223975893136
STAT,1855,38,40-44,1893,3.7063226340000637
STAT,1833,44,15-19,1877,0.011557463704187563
STAT,1960,8,na,1968,5907.26511204199
STAT,1798,89,na,1887,34.929274796009786
SIM,1869,30,50-100,1899,1
STAT,1879,16,35-39,1895,0.6628288077756505
SIM,1887,31,30-34,1918,38
STAT,1899,48,25-29,1947,0.050725393541953656
SIM,1917,42,50-100,1959,2
SIM,1829,27,na,1856,2033
SIM,1926,44,50-100,1970,2
STAT,1889,35,35-39,1924,10.157278107148297
STAT,1933,54,na,1987,5680.694567491859
STAT,1969,35,40-44,2004,2.2272266276915222
STAT,1856,84,na,1940,292.893067670084
SIM,1894,30,na,1924,3799
SIM,1888,37,35-39,1925,4
SIM,1872,41,40-44,1913,6
STAT,1885,29,40-44,1914,3.4235762635226363
STAT,1973,36,45-49,2009,1.0492263546302867
STAT,1856,51,30-34,1907,0.005265993708363485
STAT,1964,38,45-49,2002,1.0198311554029837
STAT,1933,46,30-34,1979,0.14188926507133306
STAT,1820,49,35-39,1869,0.13891784782311117
STAT,1879,41,na,1920,2797.689409964761
STAT,1974,40,45-49,2014,0.26136106038166046
STAT,1907,38,30-34,1945,1.9435643871575385
STAT,1823,31,25-29,1854,31.415844280099865
SIM,1860,34,na,1894,2395
SIM,1900,37,30-34,1937,1
SIM,1926,17,25-29,1943,103
SIM,1915,32,45-49,1947,6
STAT,1827,28,40-44,1855,8.204066128981166
SIM,1835,28,40-44,1863,1
STAT,1813,46,40-44,1859,0.5770388992664893
STAT,1980,30,na,2010,6183.2393187438465
SIM,1976,27,20-24,2003,54
SIM,1821,46,40-44,1867,1
STAT,1831,92,na,1923,32.67675886963153
STAT,1769,92,na,1861,15.613031002554443
STAT,1803,54,30-34,1857,0.020746950667355404
STAT,1838,54,45-49,1892,0.012227419683033836
STAT,1890,31,40-44,1921,6.140282488576438
SIM,1878,44,na,1922,2711
SIM,1968,42,na,2010,5321
STAT,1918,17,25-29,1935,10.918691122496483
SIM,1835,40,50-100,1875,4
SIM,1924,5,na,1929,5408
SIM,1972,18,na,1990,5816
SIM,1986,23,15-19,2009,16
STAT,1833,28,na,1861,1990.4398778254201
STAT,1978,23,15-19,2001,8.408779213506342
STAT,1882,19,45-49,1901,0.07323763139724945
SIM,1893,19,15-19,1912,1
STAT,1907,32,45-49,1939,1.7001867448233297
SIM,1887,43,25-29,1930,1
STAT,1937,22,30-34,1959,32.31735313216548
SIM,1915,38,30-34,1953,6
STAT,1870,16,15-19,1886,6.856585713989554
STAT,1866,31,50-100,1897,0.984078128733727
SIM,1926,35,25-29,1961,2
STAT,1929,24,45-49,1953,1.6318584393282
STAT,1875,37,30-34,1912,6.356030042510829
SIM,1883,37,30-34,1920,8
SIM,1989,20,na,2009,6226
STAT,1829,48,40-44,1877,0.17237846621118202
SIM,1902,31,20-24,1933,5
SIM,1945,22,30-34,1967,77
STAT,1879,43,25-29,1922,0.7682215090862995
STAT,1900,26,50-100,1926,1.0278904144603849
SIM,1837,22,30-34,1859,31
STAT,1902,62,na,1964,3213.084338274807
STAT,1817,43,20-24,1860,0.4769672909778582
STAT,1918,35,25-29,1953,1.2087849605100451
STAT,1834,45,na,1879,2233.863016686987
STAT,1838,59,na,1897,1683.4481444192443
STAT,1959,46,35-39,2005,0.2029473033836128
SIM,1831,37,50-100,1868,1
SIM,1926,32,20-24,1958,5
STAT,1832,33,45-49,1865,1.5658828921679842
SIM,1870,49,40-44,1919,1
STAT,1942,20,45-49,1962,1.362639508169259
STAT,1964,15,50-100,1979,0.5448580414353541
SIM,1776,86,na,1862,44
SIM,1961,19,40-44,1980,6
STAT,1916,54,na,1970,4235.553490089385
STAT,1952,32,20-24,1984,3.438473174593081
SIM,1863,30,30-34,1893,8
STAT,1849,47,30-34,1896,0.07467682587072932
STAT,1841,30,30-34,1871,19.229582567816045
SIM,1960,32,20-24,1992,4
STAT,1938,38,na,1976,4410.1384071133325
SIM,1877,31,15-19,1908,4
STAT,1856,33,30-34,1889,15.399863869113275
SIM,1867,39,40-44,1906,8
SIM,1995,17,30-34,2012,49
SIM,1838,36,40-44,1874,1
STAT,1851,50,45-49,1901,0.011673647955344495
STAT,1918,32,20-24,1950,2.990589999719201
SIM,1864,33,30-34,1897,41
STAT,1910,43,25-29,1953,0.07749668182957115
STAT,1882,26,35-39,1908,10.913741876719618
SIM,1881,42,45-49,1923,1
STAT,1953,19,40-44,1972,1.9513756444146981
STAT,1893,27,25-29,1920,61.705866842308936
SIM,1958,48,35-39,2006,1
STAT,1990,18,15-19,2008,74.98141276126572
SIM,1924,18,na,1942,5228
SIM,1855,43,50-100,1898,3
STAT,1827,28,na,1855,2269.7989169094512
STAT,1996,17,50-100,2013,0.6283629100592513
STAT,1868,112,na,1980,0.0017075918841621145
SIM,1871,37,40-44,1908,9
STAT,1926,78,na,2004,3005.352720358593
STAT,1995,15,15-19,2010,75.85463292050169
SIM,1807,48,na,1855,1245
SIM,1890,26,35-39,1916,4
SIM,1948,24,20-24,1972,7
STAT,1929,17,na,1946,5421.284596989691
STAT,1933,22,45-49,1955,1.7231612786580794
STAT,1865,50,45-49,1915,0.015328292652458808
STAT,1870,83,na,1953,451.66170641381217
STAT,1911,75,na,1986,2663.6582247316423
STAT,1934,44,25-29,1978,0.1143899764409461
SIM,1873,23,50-100,1896,1
SIM,1841,20,30-34,1861,29
STAT,1862,50,20-24,1912,7.29011392312505E-4
STAT,1871,61,na,1932,2145.429766188734
SIM,1888,5,na,1893,3158
STAT,1957,9,na,1966,5979.211124744768
STAT,1861,28,40-44,1889,2.8740606292979347
STAT,1871,47,40-44,1918,0.19564286422376645
STAT,1866,43,15-19,1909,0.014665139610798834
SIM,1919,35,35-39,1954,8
STAT,1909,25,na,1934,4162.989501034409
STAT,1941,32,45-49,1973,1.9071099931895412
STAT,1820,49,na,1869,1475.275793967416
STAT,1862,49,40-44,1911,0.16325588248369136
STAT,1863,37,40-44,1900,4.417382569777106
SIM,1950,20,45-49,1970,2
STAT,1853,18,40-44,1871,0.21776631971632607
STAT,1927,29,40-44,1956,6.511617509163673
STAT,1855,30,30-34,1885,15.444307152785898
STAT,1844,19,50-100,1863,0.0514781455593976
STAT,1895,36,50-100,1931,1.8531820688010672
SIM,1861,18,40-44,1879,1
STAT,1954,46,35-39,2000,0.19180086601866972
STAT,1888,45,45-49,1933,0.32334337926557916
STAT,1892,3,na,1895,3823.8539699184585
STAT,1816,48,30-34,1864,0.19446200743415196
STAT,1916,30,45-49,1946,1.890128929833994
STAT,1932,37,na,1969,5835.014965150484
STAT,1832,51,45-49,1883,0.010689476713599547
STAT,1840,43,45-49,1883,1.2364650158956263
SIM,1868,14,na,1882,3383
SIM,1889,87,na,1976,1067
SIM,1935,61,na,1996,5464
SIM,1934,48,na,1982,5656
STAT,1850,15,35-39,1865,0.6984614461245092
SIM,1811,85,na,1896,210
STAT,1897,42,30-34,1939,0.12304490817823208
SIM,1800,69,na,1869,1002
SIM,1824,51,na,1875,1390
STAT,1979,20,na,1999,5825.834362528912
STAT,1938,22,45-49,1960,1.2857594959333611
SIM,1873,32,45-49,1905,1
SIM,1864,36,35-39,1900,14
SIM,1840,33,45-49,1873,2
STAT,1838,46,40-44,1884,0.1545617891492641
STAT,1977,28,25-29,2005,103.0273346098729
STAT,1873,42,45-49,1915,1.7616037662463746
STAT,1901,45,25-29,1946,0.05304507485804547
STAT,1824,108,na,1932,0.001133381175644127
SIM,1829,82,na,1911,73
SIM,1947,40,40-44,1987,2
STAT,1976,38,35-39,2014,3.8381459013537698
STAT,1895,48,40-44,1943,0.1432454794955106
STAT,1895,21,15-19,1916,4.970729315934932
SIM,1970,30,25-29,2000,5
SIM,1985,28,25-29,2013,155
SIM,1841,51,na,1892,1762
SIM,1978,20,15-19,1998,12
STAT,1846,44,25-29,1890,0.6548897110649124
STAT,1886,98,na,1984,46.0145597336638
STAT,1889,32,30-34,1921,24.837657421898268
SIM,1847,52,na,1899,2211
STAT,1875,47,25-29,1922,0.06837324285906962
STAT,1933,9,na,1942,6152.609757990852
STAT,1822,88,na,1910,112.79586218775667
STAT,1967,41,50-100,2008,0.17625353155283033
STAT,1923,15,50-100,1938,0.5098767832482992
SIM,1966,47,na,2013,5733
STAT,1892,23,na,1915,3410.3169725869416
STAT,1881,25,50-100,1906,0.71689106429979
SIM,1902,39,na,1941,3943
SIM,1899,61,na,1960,3233
STAT,1892,33,15-19,1925,0.2051140997441989
SIM,1864,48,na,1912,2591
SIM,1909,39,40-44,1948,5
STAT,1891,40,45-49,1931,2.156224837404991
STAT,1958,49,25-29,2007,0.08314091973459331
STAT,1814,53,45-49,1867,0.037812662585105086
STAT,1877,40,50-100,1917,1.2810090252342952
SIM,1885,40,50-100,1925,2
SIM,1897,32,30-34,1929,31
STAT,1922,23,na,1945,4815.858493449191
STAT,1926,37,na,1963,5305.105704113093
STAT,1901,38,35-39,1939,2.4555276188370496
SIM,1924,30,45-49,1954,7
STAT,1959,29,50-100,1988,1.50755733159642
STAT,1804,52,25-29,1856,0.016303673786018005
STAT,1859,29,15-19,1888,0.4182193480735445
SIM,1860,98,na,1958,3
STAT,1944,22,20-24,1966,138.55861074705334
SIM,1916,51,na,1967,4314
STAT,1876,50,20-24,1926,8.929728237869788E-4
STAT,1856,54,35-39,1910,0.007371399353246872
STAT,1988,21,30-34,2009,47.61111029224296
STAT,1884,42,20-24,1926,0.18085901026970239
SIM,1968,37,40-44,2005,1
SIM,1838,43,30-34,1881,2
SIM,1959,36,na,1995,5934
STAT,1830,41,50-100,1871,1.0298224485748337
STAT,1927,8,na,1935,5721.787535624816
STAT,1817,38,20-24,1855,2.698558455598424
SIM,1816,38,30-34,1854,10
SIM,1928,38,50-100,1966,2
SIM,1946,47,50-100,1993,1
STAT,1886,7,na,1893,3171.5291241666523
STAT,1840,14,na,1854,2457.0
STAT,1844,28,na,1872,2199.11742137041
STAT,1814,53,na,1867,1739.6854039913646
SIM,1895,56,na,1951,3062
SIM,1884,32,20-24,1916,7
SIM,1875,95,na,1970,123
STAT,1937,25,35-39,1962,16.913442715553888
STAT,1898,24,na,1922,3665.6277555972365
SIM,1877,24,25-29,1901,9
STAT,1838,53,30-34,1891,0.00507432896463565
STAT,1775,88,na,1863,59.58849940142079
STAT,1913,21,30-34,1934,32.25480183439681
STAT,1924,48,30-34,1972,0.1221042613279448
SIM,1913,86,na,1999,2101
SIM,1921,21,30-34,1942,58
SIM,1903,6,na,1909,4283
STAT,1958,56,na,2014,5576.249696259644
STAT,1988,22,na,2010,6047.363492781861
STAT,1910,48,30-34,1958,0.09581788186933388
SIM,1935,29,40-44,1964,14
STAT,1941,24,50-100,1965,0.7843981622055001
SIM,1952,22,20-24,1974,295
STAT,1834,28,30-34,1862,29.917696370058433
STAT,1905,11,na,1916,4320.059526959194
STAT,1800,102,na,1902,0.15819334675781796
STAT,1897,9,na,1906,4003.8660786206688
STAT,1921,45,50-100,1966,0.295529742401536
STAT,1891,22,45-49,1913,0.9946024360682174
STAT,1853,48,35-39,1901,0.13763526060180092
SIM,1945,25,35-39,1970,26
STAT,1865,4,na,1869,3142.830066466462
SIM,1901,21,na,1922,4370
STAT,1987,17,30-34,2004,20.081034235862116
STAT,1926,42,20-24,1968,0.02512026728476738
SIM,1923,60,na,1983,4878
SIM,1816,43,50-100,1859,3
STAT,1869,31,15-19,1900,0.15980641190364459
STAT,1890,26,40-44,1916,4.23860118359042
SIM,1867,2,na,1869,3709
STAT,1950,38,30-34,1988,2.559614939467277
SIM,1922,43,45-49,1965,1
STAT,1811,88,na,1899,70.6864388496676
STAT,1879,105,na,1984,1.2442674683169068
SIM,1814,43,45-49,1857,7
STAT,1809,62,na,1871,1079.7703759343856
STAT,1807,51,35-39,1858,0.034505721511176125
STAT,1867,84,na,1951,358.4407401558328
STAT,1919,96,na,2015,184.27206744531338
SIM,1864,45,50-100,1909,1
SIM,1868,26,25-29,1894,8
SIM,1917,36,na,1953,5405
STAT,1850,20,50-100,1870,0.5111780193283911
STAT,1817,97,na,1914,3.7141540471567764
STAT,1863,70,na,1933,1415.8564375955934
STAT,1843,28,20-24,1871,14.382446105442096
STAT,1858,52,20-24,1910,6.608018764071896E-4
SIM,1860,34,25-29,1894,18
STAT,1867,37,25-29,1904,3.1023016412575517
STAT,1960,34,25-29,1994,14.142586755729281
STAT,1820,46,30-34,1866,0.10503830403839913
SIM,1854,44,25-29,1898,2
STAT,1852,54,na,1906,1974.2107867832617
SIM,1875,37,25-29,1912,8
STAT,1830,42,25-29,1872,0.6168199178170927
STAT,1842,38,30-34,1880,4.761371001769197
SIM,1842,28,30-34,1870,60
STAT,1852,34,25-29,1886,9.793027848626094
SIM,1850,38,30-34,1888,9
SIM,1876,27,15-19,1903,1
STAT,1813,49,45-49,1862,0.7582052683494179
STAT,1912,24,na,1936,4186.545949309738
STAT,1849,49,20-24,1898,0.009106624986254674
SIM,1927,23,25-29,1950,149
SIM,1840,35,35-39,1875,7
STAT,1934,41,20-24,1975,0.028425368755692137
SIM,1913,39,na,1952,4658
STAT,1943,47,30-34,1990,0.11348632663513261
SIM,1953,20,15-19,1973,14
STAT,1832,30,40-44,1862,4.028004866640234
SIM,1953,18,50-100,1971,1
STAT,1856,45,50-100,1901,0.2183941459852696
STAT,1944,64,na,2008,4203.001780697795
STAT,1915,36,15-19,1951,0.02249947179774385
SIM,1835,82,na,1917,422
STAT,1878,25,30-34,1903,30.548927442550287
STAT,1963,21,40-44,1984,4.947681639502103
SIM,1868,23,20-24,1891,91
STAT,1896,97,na,1993,92.04853557269863
STAT,1823,66,na,1889,931.7932075606225
STAT,1962,49,50-100,2011,0.34583644968204263
SIM,1940,17,na,1957,4755
STAT,1941,44,15-19,1985,0.0018912300439303063
STAT,1897,45,35-39,1942,0.12307876829388922
STAT,1854,51,50-100,1905,0.012363035208591208
STAT,1937,31,40-44,1968,4.473091694789606
STAT,1903,32,25-29,1935,16.83655950090926
STAT,1930,47,20-24,1977,0.016797378394643823
STAT,1881,20,30-34,1901,19.94567210875964
STAT,1969,21,na,1990,5283.67470319803
SIM,1886,25,30-34,1911,51
SIM,1926,75,na,2001,4163
STAT,1961,33,25-29,1994,14.038354201275732
SIM,1856,26,35-39,1882,12
STAT,1945,20,15-19,1965,6.7375424120607486
SIM,1840,30,40-44,1870,11
SIM,1790,81,na,1871,96
SIM,1923,29,25-29,1952,108
STAT,1825,49,35-39,1874,0.19015291195633768
SIM,1939,39,30-34,1978,5
STAT,1916,44,50-100,1960,0.13848807815089761
SIM,1833,49,35-39,1882,1
STAT,1923,41,45-49,1964,0.22472868045317054
STAT,1840,20,20-24,1860,71.32239670819854
STAT,1977,35,15-19,2012,0.030902825169336567
STAT,1880,29,40-44,1909,3.6381078733487273
STAT,1936,34,30-34,1970,17.648304898881783
SIM,1932,40,45-49,1972,1
STAT,1837,47,40-44,1884,0.12868877669685086
SIM,1825,38,20-24,1863,1
SIM,1975,4,na,1979,6133
STAT,1953,4,na,1957,5490.166913069629
STAT,1838,49,45-49,1887,0.2050303723981589
STAT,1921,49,20-24,1970,0.0142876823902622
STAT,1888,42,40-44,1930,3.0475538056330262
STAT,1936,6,na,1942,4431.0651290420665
STAT,1943,16,na,1959,4506.147972281449
SIM,1877,21,20-24,1898,144
SIM,1911,32,25-29,1943,22
SIM,1857,14,na,1871,2899
SIM,1929,6,na,1935,5549
STAT,1979,17,35-39,1996,6.667599088062434
STAT,1919,30,15-19,1949,0.1612468577691029
SIM,1885,57,na,1942,2644
STAT,1851,39,35-39,1890,5.5523401712383835
SIM,1927,35,na,1962,5012
STAT,1811,44,50-100,1855,3.4857645747376687
STAT,1987,15,40-44,2002,2.305602877882474
STAT,1924,40,45-49,1964,0.22902941459653592
SIM,1966,22,na,1988,5504
STAT,1910,49,45-49,1959,0.23288373830348347
SIM,1845,47,40-44,1892,1
STAT,1841,33,35-39,1874,10.811538632415992
SIM,1843,26,25-29,1869,76
STAT,1852,52,25-29,1904,0.0033216796824061725
STAT,1934,49,30-34,1983,0.14256432977271188
SIM,1805,85,na,1890,50
SIM,1943,52,na,1995,5242
SIM,1992,2,na,1994,7039
STAT,1869,21,20-24,1890,77.24969747963625
STAT,1838,28,na,1866,2366.486972203297
SIM,1880,32,35-39,1912,37
STAT,1860,18,30-34,1878,1.6996945892532678
STAT,1881,28,40-44,1909,3.322712092458121
SIM,1818,48,na,1866,2056
STAT,1896,1,na,1897,4148.90324587953
STAT,1922,54,na,1976,4741.476717234235
STAT,1926,68,na,1994,4302.299142685538
STAT,1874,49,30-34,1923,0.1119762576523903
SIM,1846,49,45-49,1895,1
STAT,1864,26,50-100,1890,0.6614277165833299
SIM,1844,16,15-19,1860,10
SIM,1864,95,na,1959,38
STAT,1988,17,45-49,2005,0.8245134945341867
SIM,1881,20,50-100,1901,1
STAT,1877,93,na,1970,145.18172143850663
STAT,1840,109,na,1949,5.707341067546656E-4
SIM,1944,34,30-34,1978,29
STAT,1872,46,na,1918,2614.5225530327994
STAT,1905,75,na,1980,2441.0463378237505
SIM,1929,16,35-39,1945,15
STAT,1884,45,25-29,1929,0.06633149703531432
STAT,1990,25,40-44,2015,7.743379279986779
SIM,1889,56,na,1945,3199
STAT,1851,46,25-29,1897,0.04580618581304089
STAT,1919,23,25-29,1942,116.33897959665711
STAT,1932,78,na,2010,3305.5473494622524
STAT,1947,15,na,1962,4787.368573506377
STAT,1966,17,25-29,1983,62.46444581355745
STAT,1900,47,30-34,1947,0.08703159576423988
STAT,1887,41,30-34,1928,1.4936202193702217
STAT,1962,27,35-39,1989,22.296177170810303
SIM,1902,43,na,1945,3871
SIM,1772,89,na,1861,56
STAT,1848,80,na,1928,657.2756979379318
STAT,1884,32,na,1916,2720.9219404496494
STAT,1789,84,na,1873,88.86249776032572
STAT,1835,26,25-29,1861,34.771199528685884
STAT,1896,32,20-24,1928,4.120234872610158
STAT,1894,89,na,1983,581.1789101892944
STAT,1904,25,na,1929,3981.8240870003997
SIM,1820,39,35-39,1859,12
STAT,1837,48,50-100,1885,0.18226413328201418
STAT,1812,82,na,1894,204.8452468858868
STAT,1890,75,na,1965,1812.6854888352511
STAT,1898,20,25-29,1918,89.81757852929923
SIM,1881,22,25-29,1903,68
STAT,1832,28,45-49,1860,1.038634016802628
STAT,1866,46,na,1912,2413.401583965431
STAT,1872,32,35-39,1904,11.735266438367047
STAT,1941,19,25-29,1960,51.49035250240027
STAT,1827,59,na,1886,1652.9911394162657
SIM,1891,35,15-19,1926,2
SIM,1923,42,45-49,1965,1
STAT,1904,18,50-100,1922,0.08097756324608031
STAT,1909,72,na,1981,2888.2902660503255
SIM,1815,74,na,1889,598
SIM,1840,28,45-49,1868,1
STAT,1853,52,20-24,1905,7.307754401808306E-4
SIM,1974,17,25-29,1991,93
STAT,1953,15,na,1968,5141.267521424741
SIM,1899,38,25-29,1937,2
STAT,1883,35,15-19,1918,0.0640058349644632
STAT,1878,43,30-34,1921,1.375292037174996
STAT,1957,29,na,1986,5718.988439521744
STAT,1911,36,30-34,1947,2.0430642084586825
STAT,1935,40,20-24,1975,0.028842995129429443
STAT,1887,49,40-44,1936,0.12228980486440194
STAT,1904,23,30-34,1927,29.427644239531965
STAT,1982,21,35-39,2003,15.346317922521377
SIM,1959,34,25-29,1993,3
STAT,1971,42,40-44,2013,0.37994254905710323
STAT,1992,20,45-49,2012,1.871281604854888
STAT,1937,16,na,1953,4144.770470481638
SIM,1956,23,na,1979,5085
STAT,1893,4,na,1897,3837.432982286073
SIM,1886,43,30-34,1929,1
STAT,1897,19,40-44,1916,0.28073027887459406
STAT,1842,52,45-49,1894,0.011108217596822068
SIM,1855,43,na,1898,1771
SIM,1862,39,40-44,1901,17
SIM,1990,21,35-39,2011,17
STAT,1915,29,25-29,1944,76.93722786956474
STAT,1888,47,35-39,1935,0.1890350251235604
STAT,1950,30,45-49,1980,2.1911802662473323
SIM,1906,57,na,1963,3317
STAT,1980,33,30-34,2013,25.712872196102236
STAT,1845,29,50-100,1874,0.517169445816436
SIM,1889,25,35-39,1914,2
STAT,1840,25,50-100,1865,0.6491263519906302
STAT,1960,31,20-24,1991,3.739265685814431
SIM,1837,40,30-34,1877,7
SIM,1830,31,30-34,1861,28
SIM,1866,43,na,1909,2416
STAT,1905,20,40-44,1925,3.5013998528959127
STAT,1861,16,25-29,1877,6.285881994692043
STAT,1887,23,30-34,1910,22.965851254935032
SIM,1896,47,35-39,1943,1
STAT,1814,102,na,1916,0.18280002799697184
SIM,1895,23,30-34,1918,1
STAT,1846,26,50-100,1872,0.8057982267969327
SIM,1867,19,20-24,1886,14
SIM,1879,29,40-44,1908,2
STAT,1827,40,50-100,1867,1.4619093854678324
SIM,1814,40,40-44,1854,4
STAT,1900,29,30-34,1929,40.03696616840378
STAT,1873,109,na,1982,0.04624327118692548
STAT,1832,53,35-39,1885,0.006094931248944702
SIM,1857,20,40-44,1877,3
STAT,1829,40,30-34,1869,1.2706794689597423
SIM,1970,27,35-39,1997,31
SIM,1948,27,25-29,1975,12
SIM,1957,19,50-100,1976,1
STAT,1957,0,na,1957,6026.862253501551
STAT,1890,29,45-49,1919,1.5544707897897116
SIM,1974,22,50-100,1996,1
SIM,1887,21,na,1908,3534
STAT,1897,40,40-44,1937,0.24346081832817615
STAT,1951,48,40-44,1999,0.22473898712957768
STAT,1976,37,20-24,2013,0.4187267946334492
STAT,1915,42,45-49,1957,0.19340334170096485
STAT,1950,64,na,2014,4617.7500987276835
SIM,1810,68,na,1878,729
SIM,1828,49,50-100,1877,1
STAT,1832,35,35-39,1867,6.3501772364065685
STAT,1941,26,15-19,1967,0.8433744431486964
STAT,1963,44,35-39,2007,0.30579855503215475
STAT,1903,40,na,1943,3850.751151099925
SIM,1870,17,na,1887,3300
STAT,1825,53,20-24,1878,9.734587299886406E-4
STAT,1960,39,30-34,1999,2.8163187980191817
SIM,1903,2,na,1905,4388
SIM,1949,17,15-19,1966,99
STAT,1825,46,30-34,1871,0.13706119699840388
SIM,1929,48,50-100,1977,1
STAT,1983,29,15-19,2012,1.1563370497739631
STAT,1831,51,50-100,1882,0.012557302471027208
STAT,1938,21,30-34,1959,32.854099649012625
SIM,1844,25,25-29,1869,70
STAT,1904,16,40-44,1920,0.3038549035508422
SIM,1858,95,na,1953,37
STAT,1875,39,20-24,1914,0.9100583959816153
SIM,1840,32,30-34,1872,20
SIM,1974,32,35-39,2006,23
STAT,1873,22,25-29,1895,67.46337238915999
STAT,1859,19,20-24,1878,18.696269795176267
SIM,1958,46,50-100,2004,1
STAT,1897,43,45-49,1940,0.15921900277681839
STAT,1957,23,45-49,1980,1.7171157458177921
STAT,1851,14,na,1865,2280.771514657688
SIM,1804,90,na,1894,83
SIM,1853,48,na,1901,2172
STAT,1852,31,20-24,1883,2.6661885587666374
STAT,1805,108,na,1913,7.527426715273884E-4
SIM,1815,78,na,1893,436
STAT,1914,21,45-49,1935,1.2774762222677205
STAT,1975,38,20-24,2013,0.41305888453029904
STAT,1860,22,15-19,1882,3.1631343981181828
STAT,1901,17,30-34,1918,2.576462444406559
SIM,1888,61,na,1949,2083
STAT,1962,17,40-44,1979,2.0682499791830646
STAT,1865,31,30-34,1896,18.25433187439922
STAT,1876,61,na,1937,2229.2427227563207
SIM,1927,20,20-24,1947,11
STAT,1835,19,35-39,1854,0.7679477078137418
STAT,1832,32,30-34,1864,15.856483918408541
STAT,1949,19,50-100,1968,0.5025150865786164
SIM,1906,36,na,1942,3655
STAT,1880,100,na,1980,17.964143144804872
STAT,1961,30,20-24,1991,3.711261200931631
STAT,1837,20,15-19,1857,3.278891982125586
SIM,1867,28,na,1895,2413
STAT,1851,43,20-24,1894,0.1250281656313035
SIM,1863,14,na,1877,2904
SIM,1946,21,30-34,1967,2
STAT,1933,49,35-39,1982,0.20350297483744192
STAT,1802,67,na,1869,1027.5547948367848
STAT,1836,25,25-29,1861,50.55535331622328
STAT,1875,51,45-49,1926,0.01739024800042674
STAT,1910,46,40-44,1956,0.1703579386717476
STAT,1926,15,30-34,1941,17.32272298321917
SIM,1987,25,na,2012,6506
STAT,1936,37,35-39,1973,2.7419575034605654
STAT,1888,93,na,1981,227.63288037149545
SIM,1822,33,25-29,1855,26
SIM,2000,2,na,2002,6497
STAT,1813,51,50-100,1864,0.048926996743344886
STAT,1834,32,15-19,1866,0.166468374128275
STAT,1947,25,50-100,1972,1.3006365748215356
STAT,1987,18,45-49,2005,0.8227296812923401
SIM,1941,49,35-39,1990,1
SIM,1995,18,45-49,2013,1
STAT,1830,38,40-44,1868,4.357557306107036
STAT,1832,50,30-34,1882,0.004472204291363729
STAT,1854,42,30-34,1896,0.9354780946418346
STAT,1958,19,40-44,1977,2.1186633062219564
SIM,1814,42,30-34,1856,4
STAT,1919,20,20-24,1939,141.32162204480093
STAT,1883,46,na,1929,2547.490183396839
STAT,1849,54,20-24,1903,5.562099508078506E-4
STAT,1912,43,50-100,1955,0.1300998200353381
STAT,1911,39,35-39,1950,2.671219968231541
STAT,1817,66,na,1883,1266.7630342070129
STAT,1868,27,15-19,1895,0.5030506876644234
STAT,1915,68,na,1983,3514.868313225565
SIM,1885,94,na,1979,323
STAT,1957,32,20-24,1989,3.783065888139409
SIM,1966,19,40-44,1985,3
SIM,1880,47,na,1927,3192
STAT,1840,23,25-29,1863,57.98046757770284
SIM,1916,10,na,1926,4870
STAT,1988,24,35-39,2012,15.582121928797399
STAT,2006,7,na,2013,7020.5956349210255
STAT,1828,52,30-34,1880,0.005294316772208899
STAT,1891,24,35-39,1915,8.271146308181832
STAT,1803,53,na,1856,1161.8380975011369
SIM,1922,37,50-100,1959,1
SIM,1870,15,25-29,1885,11
SIM,1922,21,45-49,1943,3
STAT,1807,67,na,1874,1056.7661078589492
SIM,1986,19,30-34,2005,58
SIM,1921,24,35-39,1945,15
SIM,1836,27,40-44,1863,6
STAT,1914,37,50-100,1951,0.4840077169108757
STAT,1901,35,30-34,1936,1.8771688437881042
STAT,1903,28,40-44,1931,4.906707032473667
SIM,1949,37,na,1986,5853
STAT,1964,15,na,1979,5352.890113752027
SIM,1945,23,na,1968,4173
STAT,1847,32,25-29,1879,9.253552321222585
SIM,1836,34,30-34,1870,6
STAT,1913,24,35-39,1937,10.90998831406982
STAT,1869,24,25-29,1893,63.5776568280899
STAT,1925,21,20-24,1946,154.0168357811479
STAT,1851,36,30-34,1887,4.316172742823802
SIM,1911,28,40-44,1939,12
SIM,1918,19,40-44,1937,1
SIM,1855,32,25-29,1887,10
STAT,1922,75,na,1997,3228.156579888937
STAT,1852,36,15-19,1888,0.05378615906573913
SIM,1876,25,25-29,1901,113
STAT,1828,34,30-34,1862,18.90410790867993
SIM,1854,42,35-39,1896,7
STAT,1826,41,20-24,1867,0.12092177357775556
SIM,1883,39,20-24,1922,1
SIM,1882,16,35-39,1898,1
STAT,1891,42,35-39,1933,2.5796167686054017
SIM,1916,16,25-29,1932,28
SIM,1847,41,30-34,1888,3
STAT,1846,42,35-39,1888,1.8946492990030703
STAT,1887,26,50-100,1913,0.83016806250308
SIM,1944,27,40-44,1971,16
STAT,1832,25,40-44,1857,2.964252863372136
STAT,1935,43,25-29,1978,0.11611943253182697
STAT,1830,48,na,1878,1495.4236412281955
STAT,1962,24,30-34,1986,42.610508964804055
STAT,1859,23,50-100,1882,0.3861617969613863
STAT,1958,26,30-34,1984,59.674011080230265
SIM,1908,25,30-34,1933,49
STAT,1896,35,25-29,1931,4.430400446489488
STAT,1859,39,40-44,1898,3.9837565861272655
STAT,1901,76,na,1977,2206.9345049967988
STAT,1828,27,40-44,1855,4.860667098616363
STAT,1906,28,20-24,1934,19.67302548174362
SIM,1914,28,20-24,1942,20
STAT,1815,41,45-49,1856,3.4549625132342814
STAT,1980,30,15-19,2010,0.21009078870023223
STAT,1874,16,35-39,1890,0.649863065646119
STAT,1883,51,40-44,1934,0.01194356111947447
SIM,1985,25,20-24,2010,1
STAT,1813,67,na,1880,859.3742747931997
STAT,1976,35,30-34,2011,2.9000531884726612
STAT,1972,25,50-100,1997,1.4783782536136898
SIM,1824,82,na,1906,9
SIM,1970,24,30-34,1994,56
STAT,1897,38,na,1935,3617.555531363438
SIM,1962,19,na,1981,5563
STAT,1805,104,na,1909,0.027410231012444036
SIM,1839,81,na,1920,685
STAT,1900,91,na,1991,464.362618915172
STAT,1916,75,na,1991,2883.707056665517
STAT,1936,27,40-44,1963,5.1509223780708
SIM,1878,18,35-39,1896,1
STAT,1887,44,35-39,1931,2.3103549756855255
STAT,1992,22,35-39,2014,15.648867828569726
SIM,1879,57,na,1936,2336
SIM,1939,33,45-49,1972,5
STAT,1862,15,25-29,1877,6.396049988017574
STAT,1838,108,na,1946,0.0015866573608454204
STAT,1890,34,45-49,1924,2.4379459322104915
STAT,1912,61,na,1973,3757.0658232385385
SIM,1971,41,na,2012,5714
STAT,1830,52,na,1882,1401.7571028291393
STAT,1839,41,30-34,1880,1.0695920083468138
SIM,1846,66,na,1912,977
STAT,1857,45,15-19,1902,3.631082680805087E-4
SIM,1878,13,na,1891,3085
STAT,1838,51,40-44,1889,0.009253790224018175
STAT,1841,108,na,1949,0.0016285674165527583
STAT,1970,15,25-29,1985,62.63655156560997
SIM,1896,37,40-44,1933,14
STAT,1908,16,25-29,1924,9.737145396267472
SIM,1945,31,40-44,1976,9
STAT,1826,46,15-19,1872,2.9159307634881685E-4
STAT,1894,15,25-29,1909,8.445873090471439
SIM,1872,44,45-49,1916,8
STAT,1821,93,na,1914,17.874007798953105
SIM,1862,24,30-34,1886,55
STAT,1884,19,30-34,1903,1.8076172426983999
STAT,1861,53,50-100,1914,0.014257039500240778
STAT,1827,31,45-49,1858,3.1738214248420342
STAT,1848,26,35-39,1874,12.3277668913057
SIM,1895,44,35-39,1939,1
STAT,1831,96,na,1927,6.736808799895158
STAT,1762,97,na,1859,1.203715134067623
SIM,1907,31,20-24,1938,6
STAT,1882,61,na,1943,2106.354047162575
STAT,1939,15,40-44,1954,1.6204088775942473
STAT,1992,15,45-49,2007,0.8279210568107478
SIM,1883,51,45-49,1934,1
STAT,1854,24,30-34,1878,16.806667510208694
SIM,1907,43,na,1950,4429
STAT,1979,15,45-49,1994,0.794182510270412
STAT,1865,52,35-39,1917,0.008916513922875234
STAT,1812,54,50-100,1866,0.03214074162094791
STAT,1888,44,30-34,1932,1.5385589043872911
STAT,1980,3,na,1983,6302.166953750174
SIM,1892,19,30-34,1911,4
STAT,1849,23,45-49,1872,0.6487548822779966
STAT,1864,44,45-49,1908,1.5213834574283442
SIM,1895,26,35-39,1921,3
STAT,1937,78,na,2015,2460.83242972154
STAT,1841,31,45-49,1872,1.9007511097528016
SIM,1970,17,40-44,1987,2
SIM,1873,34,35-39,1907,4
SIM,1947,15,40-44,1962,6
SIM,1863,38,40-44,1901,7
STAT,1854,17,40-44,1871,0.17825219235795658
SIM,1845,81,na,1926,754
STAT,1848,19,45-49,1867,0.08502965050287634
STAT,1887,26,35-39,1913,12.522006472264707
STAT,1976,32,15-19,2008,0.20195714427528164
STAT,1916,42,15-19,1958,0.0018163452148311342
STAT,1861,62,na,1923,1753.538457478633
STAT,1909,47,30-34,1956,0.0946399915230451
SIM,1879,94,na,1973,58
SIM,1917,73,na,1990,3697
STAT,1942,21,50-100,1963,0.7965783683322184
SIM,1933,24,25-29,1957,5
STAT,1828,37,35-39,1865,7.279470613521892
SIM,1830,32,25-29,1862,3
SIM,1895,19,na,1914,3855
SIM,1901,20,15-19,1921,10
STAT,1814,48,50-100,1862,0.6716895482609876
STAT,1871,68,na,1939,1754.5638937598267
STAT,1937,53,na,1990,4191.516444160558
SIM,1924,24,15-19,1948,13
STAT,1899,106,na,2005,1.2038227507269723
SIM,1884,31,na,1915,2758
STAT,1900,60,na,1960,3183.289671636471
SIM,1965,20,40-44,1985,14
STAT,1901,23,50-100,1924,0.6571492717030171
STAT,1918,70,na,1988,3535.5908656935662
STAT,1906,20,25-29,1926,96.9117808722643
STAT,1788,102,na,1890,0.13306877318976099
STAT,1880,32,30-34,1912,21.35744631306568
SIM,1835,38,50-100,1873,3
SIM,1937,26,35-39,1963,41
STAT,1916,24,15-19,1940,6.397593379799172
STAT,1918,47,40-44,1965,0.19358201123788385
STAT,1853,21,45-49,1874,0.8262376039771683
SIM,1955,37,na,1992,6518
STAT,1819,48,35-39,1867,0.26568350008452946
STAT,1856,31,40-44,1887,3.905349380770012
STAT,1840,21,35-39,1861,5.996185626250592
STAT,1951,21,15-19,1972,7.341918028952983
STAT,1868,48,30-34,1916,0.10598011731237564
STAT,1845,45,25-29,1890,0.039201001681148546
STAT,1965,27,15-19,1992,1.0215048498390837
SIM,1929,22,50-100,1951,2
STAT,1925,24,25-29,1949,126.75816023258051
STAT,1947,49,50-100,1996,0.30403690560774455
SIM,1899,28,30-34,1927,89
STAT,1875,25,15-19,1900,0.5447544586087122
SIM,1822,87,na,1909,3
STAT,1943,48,45-49,1991,0.2759123652022959
STAT,1894,38,30-34,1932,7.867420657417074
STAT,1864,21,20-24,1885,72.6740026082735
STAT,1869,35,50-100,1904,1.3851668531051542
SIM,1874,31,50-100,1905,4
SIM,1872,21,20-24,1893,80
STAT,1961,47,40-44,2008,0.2445137365727462
SIM,1920,33,30-34,1953,11
STAT,1871,32,20-24,1903,3.103453009305622
STAT,1855,44,na,1899,1940.0778838874048
STAT,1968,39,na,2007,5575.018284433355
STAT,1921,31,30-34,1952,20.30913725405075
SIM,1853,45,25-29,1898,1
STAT,1975,17,na,1992,5603.842335585529
STAT,1937,43,na,1980,4318.74651229848
SIM,1952,37,40-44,1989,1
STAT,1907,26,15-19,1933,0.7730191541658965
SIM,1879,84,na,1963,337
STAT,1925,31,15-19,1956,0.1761514678632938
SIM,1924,45,na,1969,4901
STAT,1845,38,35-39,1883,4.95599188007406
STAT,1880,30,20-24,1910,3.333070982324056
SIM,1939,30,40-44,1969,3
SIM,1979,21,na,2000,6426
STAT,1957,35,25-29,1992,1.546134100860197
STAT,1931,52,na,1983,5574.781198981947
STAT,1952,20,na,1972,5070.5136452787765
STAT,1845,14,na,1859,2014.7757091219225
SIM,1873,93,na,1966,109
SIM,1894,61,na,1955,2987
SIM,1853,38,35-39,1891,15
STAT,1981,24,35-39,2005,15.234450775824373
SIM,1883,25,15-19,1908,4
SIM,1889,22,30-34,1911,1
SIM,1930,55,na,1985,5749
STAT,1817,50,45-49,1867,0.0414881244371988
SIM,1949,34,30-34,1983,9
SIM,1982,19,na,2001,6803
STAT,1850,8,na,1858,3089.1227893467976
SIM,1862,42,30-34,1904,4
SIM,1915,26,15-19,1941,1
STAT,1891,82,na,1973,1228.6122203334091
STAT,1939,37,15-19,1976,0.022863567708694073
SIM,1836,37,35-39,1873,9
STAT,1959,16,20-24,1975,204.71884970413873
STAT,1866,50,40-44,1916,0.011422850905872837
SIM,1903,87,na,1990,942
STAT,1831,32,35-39,1863,10.312722681007648
STAT,1902,39,45-49,1941,0.6945595603610154
SIM,1934,39,30-34,1973,2
STAT,1851,36,50-100,1887,0.9942907425131776
STAT,1896,33,35-39,1929,15.371403735884819
STAT,1932,1,na,1933,6383.158816548451
SIM,1910,39,45-49,1949,1
STAT,1844,105,na,1949,0.024524472511541696
STAT,1875,49,15-19,1924,4.6707758096784055E-4
STAT,1944,44,30-34,1988,0.1644633726801194
STAT,1985,21,15-19,2006,8.769183340433585
STAT,1911,38,na,1949,4176.328342315228
SIM,1945,3,na,1948,4846
STAT,1917,39,na,1956,4482.362838379618
STAT,1798,82,na,1880,153.61116614522464
SIM,1993,21,15-19,2014,20
STAT,1932,18,20-24,1950,206.68460180628915
SIM,1853,79,na,1932,572
SIM,1874,47,na,1921,2483
STAT,1803,84,na,1887,115.8462592715815
STAT,1929,26,35-39,1955,21.695180502992955
SIM,1966,26,30-34,1992,128
STAT,1824,52,na,1876,1486.0870298697807
SIM,1872,26,50-100,1898,1
SIM,1940,18,20-24,1958,1
STAT,1903,29,35-39,1932,15.74732930378409
STAT,1855,108,na,1963,0.007946330008916997
STAT,1819,99,na,1918,1.2607707980805807
STAT,1828,50,20-24,1878,6.828662419232613E-4
SIM,1847,79,na,1926,1042
SIM,1888,35,45-49,1923,1
SIM,1905,39,20-24,1944,1
SIM,1950,16,25-29,1966,1
SIM,1853,29,50-100,1882,1
STAT,1803,74,na,1877,476.89974117824903
STAT,1880,17,35-39,1897,0.6712036511814593
SIM,1961,47,50-100,2008,1
STAT,1897,23,25-29,1920,88.06467603182546
SIM,1843,23,20-24,1866,5
STAT,1808,52,45-49,1860,0.06917325492010092
STAT,1835,23,20-24,1858,57.685366151002235
SIM,1911,26,30-34,1937,76
STAT,1837,50,30-34,1887,0.004500854472329404
STAT,1935,16,35-39,1951,6.639907466437465
STAT,1861,43,15-19,1904,0.013153540648969494
STAT,1922,37,20-24,1959,0.3460099150762266
STAT,1926,39,30-34,1965,2.5645498831514257
SIM,1932,49,50-100,1981,1
STAT,1942,16,25-29,1958,52.28676111973033
SIM,1892,66,na,1958,2971
STAT,1889,30,40-44,1919,6.21886916800902
STAT,1978,3,na,1981,6195.503391756538
STAT,1913,39,20-24,1952,0.29735557908751103
STAT,1975,17,15-19,1992,69.09469448364625
STAT,2009,6,na,2015,7134.758973556075
SIM,1842,42,45-49,1884,4
STAT,1848,23,30-34,1871,22.87893777154305
SIM,1969,37,na,2006,5735
STAT,1907,19,25-29,1926,9.570360862126323
STAT,1835,85,na,1920,170.85535823321806
SIM,1905,15,35-39,1920,1
STAT,1948,16,45-49,1964,0.6599144107721769
STAT,1938,31,25-29,1969,10.73662068855203
SIM,1930,37,20-24,1967,1
SIM,1916,18,15-19,1934,11
SIM,1994,0,na,1994,6249
STAT,1908,18,15-19,1926,10.145709699325295
SIM,1907,34,25-29,1941,22
STAT,1843,40,45-49,1883,1.5863003377321347
STAT,1912,33,30-34,1945,17.832691045292286
STAT,1981,31,25-29,2012,15.212008280344488
STAT,1886,91,na,1977,301.9387908208301
STAT,1858,42,na,1900,2078.215018942131
STAT,1854,43,25-29,1897,0.5193841824546702
SIM,1915,19,25-29,1934,13
SIM,1976,15,na,1991,5658
SIM,1946,31,25-29,1977,4
SIM,1892,76,na,1968,2167
STAT,1981,25,na,2006,6076.6324296477715
SIM,1931,29,20-24,1960,28
STAT,1967,24,30-34,1991,41.541098050755785
STAT,1854,27,35-39,1881,8.240841354278318
SIM,1836,77,na,1913,163
SIM,1852,21,20-24,1873,138
SIM,1896,22,20-24,1918,212
SIM,1948,59,na,2007,4089
STAT,1848,16,40-44,1864,0.24234005575160178
STAT,1937,34,45-49,1971,1.7952981533579866
STAT,1912,26,40-44,1938,5.324128842262165
SIM,1956,37,25-29,1993,3
STAT,1881,98,na,1979,37.049916248002496
SIM,1813,42,35-39,1855,1
SIM,1898,22,40-44,1920,8
STAT,1844,47,30-34,1891,0.08058824350735824
STAT,1851,24,15-19,1875,3.0794427416798236
STAT,1858,33,15-19,1891,0.12766659863616583
STAT,1909,26,35-39,1935,16.775293199166747
SIM,1946,24,35-39,1970,16
SIM,1846,31,20-24,1877,4
STAT,1843,48,40-44,1891,0.1696204143271948
STAT,1801,89,na,1890,44.09352816829323
STAT,1862,16,na,1878,2575.61099826145
STAT,1964,21,25-29,1985,134.7488434550811
STAT,1919,24,na,1943,4584.800982129247
SIM,1945,34,45-49,1979,1
SIM,1972,21,25-29,1993,267
STAT,1844,21,20-24,1865,72.48771935817429
STAT,1966,22,50-100,1988,0.9515857680089469
SIM,1857,45,na,1902,2444
STAT,1923,29,20-24,1952,24.00423296136953
STAT,1892,43,45-49,1935,2.1491537729864816
SIM,1897,30,40-44,1927,16
STAT,1830,41,30-34,1871,1.12068913767303
STAT,1938,24,35-39,1962,10.75246058009242
SIM,1917,26,35-39,1943,42
STAT,1862,26,na,1888,2349.7520574222754
SIM,1879,33,25-29,1912,1
STAT,1933,16,15-19,1949,70.31410728703706
SIM,1862,27,35-39,1889,17
STAT,1834,66,na,1900,1495.761628541469
STAT,1838,31,20-24,1869,2.940374674864094
SIM,1941,16,15-19,1957,48
STAT,1957,20,40-44,1977,5.136501286268699
STAT,1948,37,25-29,1985,1.3396745172887712
SIM,1960,29,30-34,1989,5
STAT,1949,27,15-19,1976,0.9516045444256757
STAT,1952,29,30-34,1981,54.3686809735881
STAT,1953,42,30-34,1995,0.18548228105613396
SIM,1905,72,na,1977,2688
SIM,1926,40,na,1966,5837
SIM,1917,69,na,1986,3991
STAT,1864,11,na,1875,2809.150189104031
STAT,1933,23,na,1956,5590.751386804804
SIM,1957,27,15-19,1984,2
SIM,1872,24,25-29,1896,3
STAT,1825,34,15-19,1859,0.2597911405654833
STAT,1860,32,45-49,1892,1.6219441098551437
STAT,1875,98,na,1973,30.02501146809575
SIM,1875,64,na,1939,2129
STAT,1945,35,35-39,1980,3.1468866126689266
STAT,1845,42,20-24,1887,0.10897733403389556
STAT,1910,8,na,1918,4550.566866578577
SIM,1916,20,na,1936,4420
STAT,1974,39,na,2013,5828.409180024433
STAT,1963,24,45-49,1987,1.6540104952782817
SIM,1839,26,na,1865,2341
STAT,1853,45,30-34,1898,0.09733674488110096
STAT,1948,34,20-24,1982,3.27934627534677
STAT,1817,48,15-19,1865,0.0011257063411051938
SIM,1838,24,25-29,1862,5
STAT,1946,20,na,1966,4692.932583359143
STAT,1873,20,50-100,1893,0.4834442540143407
STAT,1793,89,na,1882,38.79133913976231
SIM,1941,57,na,1998,3680
STAT,1849,35,15-19,1884,0.045470742975936125
SIM,1953,35,35-39,1988,3
SIM,1913,23,45-49,1936,6
STAT,1871,35,25-29,1906,3.3370766529570366
SIM,1979,13,na,1992,6470
STAT,1982,27,20-24,2009,29.77109582315399
STAT,1892,34,50-100,1926,1.3139424343194734
STAT,1983,27,50-100,2010,1.6319786460857217
STAT,1893,39,40-44,1932,6.321276841381736
SIM,1906,26,na,1932,3827
SIM,1848,31,40-44,1879,2
STAT,1905,23,45-49,1928,1.161152705709812
STAT,1862,19,50-100,1881,0.04914538045158557
SIM,1981,29,20-24,2010,3
SIM,1814,52,na,1866,1299
STAT,1883,25,na,1908,2712.8860646958246
SIM,1874,21,40-44,1895,6
SIM,1937,23,30-34,1960,72
STAT,1888,22,20-24,1910,93.48493871414041
STAT,1890,65,na,1955,2383.050279890334
SIM,1949,37,35-39,1986,1
STAT,1897,30,15-19,1927,0.22152051241196583
SIM,1860,65,na,1925,1683
STAT,1857,22,45-49,1879,0.7235584710189968
SIM,1972,7,na,1979,5837
SIM,1864,34,45-49,1898,4
STAT,1906,27,50-100,1933,1.076519768636862
STAT,1920,18,30-34,1938,15.733631923492506
STAT,1866,53,45-49,1919,0.015274131476286888
STAT,1923,39,na,1962,5018.173214093603
SIM,1956,34,20-24,1990,6
SIM,1804,68,na,1872,670
STAT,1856,34,45-49,1890,1.522201963356689
STAT,1834,42,45-49,1876,1.646548443077928
STAT,1866,21,40-44,1887,2.2634220047994917
SIM,1853,35,30-34,1888,15
STAT,1849,7,na,1856,2361.3883266231
STAT,1865,32,45-49,1897,1.8157654449347722
STAT,1879,10,na,1889,3141.338343735869
STAT,1943,53,na,1996,4577.414003693654
SIM,1875,49,40-44,1924,2
SIM,1964,14,na,1978,5967
STAT,1961,29,40-44,1990,6.972746620240031
SIM,1959,15,30-34,1974,43
STAT,1866,77,na,1943,924.6073189554128
STAT,1872,1,na,1873,4055.7478553314677
SIM,1956,16,45-49,1972,2
STAT,1849,44,na,1893,1767.1883758775712
SIM,1841,20,na,1861,2216
STAT,1929,23,30-34,1952,41.81693787140439
SIM,1856,23,30-34,1879,2
STAT,1867,49,40-44,1916,0.18061450900862808
STAT,1912,6,na,1918,4666.439489730328
STAT,1884,96,na,1980,79.96504861461725
STAT,1973,29,20-24,2002,27.335478242703314
STAT,1843,43,na,1886,2357.332469502419
STAT,1977,21,20-24,1998,174.01573089649335
STAT,1960,37,40-44,1997,2.318147063907061
SIM,1785,84,na,1869,156
SIM,1949,47,na,1996,5739
STAT,1864,24,25-29,1888,59.079235225511304
STAT,1966,21,45-49,1987,1.6277487583841457
SIM,1934,17,na,1951,5183
SIM,1964,37,20-24,2001,1
SIM,1811,54,na,1865,1458
SIM,1899,39,na,1938,4076
STAT,1878,28,35-39,1906,11.58560458443193
STAT,2010,1,na,2011,7179.390059967955
STAT,1971,25,35-39,1996,22.05883233499004
SIM,1836,36,na,1872,1682
SIM,1886,28,35-39,1914,20
SIM,1974,21,45-49,1995,4
STAT,1851,78,na,1929,619.5927946810251
STAT,1908,20,45-49,1928,1.2024044526241175
STAT,1961,27,30-34,1988,58.673749744741926
SIM,1948,29,15-19,1977,1
STAT,1783,105,na,1888,0.01581552879628557
STAT,1905,38,na,1943,3946.6203872636647
STAT,1935,39,40-44,1974,2.4118875151140866
SIM,1977,37,30-34,2014,6
STAT,1773,90,na,1863,53.61525357026077
SIM,1820,36,30-34,1856,10
STAT,1902,38,30-34,1940,1.866476901574479
STAT,1958,30,15-19,1988,0.19876748370705447
STAT,1867,27,30-34,1894,27.133205572565476
STAT,1943,57,na,2000,4471.548680843499
STAT,1926,30,50-100,1956,1.1548111928932565
STAT,1862,57,na,1919,1957.2447644466401
STAT,1796,87,na,1883,68.37854214741103
STAT,1840,53,50-100,1893,0.011920922142268572
STAT,1841,51,35-39,1892,0.00769085233124939
STAT,1874,8,na,1882,3177.157578148237
STAT,1945,19,45-49,1964,0.6293289079668914
SIM,1953,19,45-49,1972,2
SIM,1985,23,30-34,2008,53
SIM,1934,30,50-100,1964,1
SIM,1910,38,30-34,1948,2
STAT,1839,42,45-49,1881,1.250951261752726
STAT,1905,42,na,1947,3869.078506020698
STAT,1966,19,15-19,1985,65.37283413438217
SIM,1974,19,15-19,1993,1
STAT,1998,2,na,2000,6668.0994053446
SIM,1944,63,na,2007,4110
STAT,1957,29,30-34,1986,59.817335174835556
SIM,1847,42,45-49,1889,4
STAT,1969,37,30-34,2006,2.706943093260008
SIM,1943,39,40-44,1982,2
SIM,1896,32,na,1928,3854
SIM,1839,32,45-49,1871,4
STAT,1876,43,50-100,1919,1.2512204570164325
STAT,1842,17,15-19,1859,5.8643541086840365
STAT,1898,55,na,1953,3224.972170031392
STAT,1979,35,35-39,2014,3.966454706386374
STAT,1845,35,30-34,1880,4.233620677144238
STAT,1910,29,25-29,1939,72.90156521738602
SIM,1846,8,na,1854,2109
STAT,1956,27,50-100,1983,1.526543409368204
SIM,1899,27,50-100,1926,6
SIM,1881,33,na,1914,1954
STAT,1943,23,30-34,1966,35.28104682183182
STAT,1819,52,20-24,1871,0.0013665683625279953
STAT,1830,70,na,1900,880.1721232624918
STAT,1968,47,40-44,2015,0.23638184924679587
STAT,1878,44,25-29,1922,0.7633262362132638
STAT,1977,30,20-24,2007,3.881255101696862
STAT,1981,21,30-34,2002,46.54880249582927
STAT,1911,37,45-49,1948,0.76053163860637
SIM,1923,69,na,1992,4436
STAT,1950,35,na,1985,5298.128654190361
SIM,1917,23,30-34,1940,54
SIM,1861,43,50-100,1904,4
STAT,1972,19,na,1991,5435.071163335267
STAT,1974,24,20-24,1998,168.00172172194607
SIM,1890,22,50-100,1912,1
STAT,1912,36,35-39,1948,2.740132372722364
STAT,1919,45,35-39,1964,0.162105558076367
SIM,1902,28,30-34,1930,4
SIM,1922,20,na,1942,4924
SIM,1951,23,30-34,1974,1
SIM,1950,63,na,2013,4125
STAT,1884,23,15-19,1907,3.7499930365705927
STAT,1919,29,45-49,1948,2.1383224400663896
STAT,1943,49,40-44,1992,0.199534902674554
STAT,1949,19,30-34,1968,16.348494140507352
STAT,1838,34,25-29,1872,10.800125513125545
STAT,1967,27,35-39,1994,21.736602178929452
STAT,1838,96,na,1934,7.437848902332791
STAT,1953,45,35-39,1998,0.18810122543888033
STAT,1847,43,50-100,1890,0.8070193555369708
STAT,1882,22,50-100,1904,0.4596674660251206
STAT,1877,25,na,1902,2884.3260604007824
SIM,1980,26,35-39,2006,4
STAT,1935,37,30-34,1972,2.9427201437908783
SIM,1890,31,na,1921,3399
STAT,1880,17,50-100,1897,0.05992888632351802
STAT,1977,23,30-34,2000,44.94935362951381
SIM,1920,36,35-39,1956,5
STAT,1909,49,40-44,1958,0.16639873769449678
STAT,1781,88,na,1869,33.837434918875395
STAT,1842,71,na,1913,1027.1627568221168
STAT,1898,29,15-19,1927,0.7025733548272538
STAT,1992,21,50-100,2013,1.093922815644829
STAT,1909,23,30-34,1932,30.766546018268386
SIM,1849,37,30-34,1886,4
SIM,1943,37,30-34,1980,5
STAT,1912,29,45-49,1941,1.9525787890624045
SIM,1965,29,30-34,1994,6
STAT,1981,17,na,1998,5939.6957293074565
SIM,1971,31,na,2002,5640
SIM,1911,30,50-100,1941,2
STAT,1892,40,40-44,1932,3.2862580920558138
STAT,1934,47,40-44,1981,0.2536251672792774
STAT,1844,24,25-29,1868,58.92779906462574
STAT,1876,37,15-19,1913,0.06699120473893078
STAT,1819,45,30-34,1864,0.19187535730439353
SIM,1852,24,25-29,1876,74
SIM,1959,31,20-24,1990,2
SIM,1846,34,25-29,1880,11
STAT,1787,89,na,1876,29.936088943753774
STAT,1837,53,35-39,1890,0.0061340070092202135
SIM,1987,19,45-49,2006,1
STAT,1822,32,25-29,1854,44.28899825342371
SIM,1927,29,45-49,1956,4
SIM,1807,70,na,1877,712
SIM,1902,61,na,1963,3387
SIM,1914,20,25-29,1934,201
SIM,1902,34,25-29,1936,2
SIM,1837,25,35-39,1862,5
STAT,1952,35,25-29,1987,1.4052995076821329
STAT,1813,46,na,1859,1428.3052145459535
SIM,1888,27,40-44,1915,6
SIM,1943,38,45-49,1981,2
SIM,1952,36,na,1988,4728
SIM,1854,65,na,1919,1860
SIM,2005,8,na,2013,6472
STAT,1917,21,15-19,1938,6.548965569827953
STAT,1906,47,15-19,1953,3.779412026689433E-4
SIM,1939,27,15-19,1966,1
STAT,1864,22,35-39,1886,6.109817251720819
STAT,1975,22,15-19,1997,8.131164941661583
SIM,1877,35,50-100,1912,1
STAT,1994,18,35-39,2012,6.985789826898638
STAT,1882,24,45-49,1906,0.7811106441713404
STAT,1863,50,25-29,1913,0.0036256451205346906
SIM,1870,27,na,1897,3062
SIM,1864,85,na,1949,348
SIM,1862,5,na,1867,3263
SIM,1929,35,40-44,1964,3
STAT,1885,10,na,1895,2981.7482513512327
STAT,1922,44,na,1966,4901.012924630417
STAT,1827,38,50-100,1865,1.747028016677692
STAT,1909,48,45-49,1957,0.23009242327317392
STAT,1908,18,na,1926,4317.776961590101
STAT,1824,83,na,1907,245.63617946681404
SIM,1948,39,40-44,1987,4
SIM,1960,35,25-29,1995,2
SIM,1916,35,30-34,1951,8
STAT,1829,25,35-39,1854,35.09222965906546
STAT,1857,24,35-39,1881,5.431246906932963
STAT,1935,38,45-49,1973,1.0995896462795873
STAT,1877,22,45-49,1899,0.8370961420406073
STAT,1873,18,40-44,1891,0.2149846587424392
STAT,1890,96,na,1986,109.5732953232135
SIM,1881,18,40-44,1899,2
STAT,1899,38,30-34,1937,1.8097514705031625
STAT,1904,38,15-19,1942,0.019986645663995297
SIM,1909,37,30-34,1946,4
STAT,1893,24,20-24,1917,99.89463513333057
STAT,1858,11,na,1869,2521.996791572392
STAT,1804,54,35-39,1858,0.03806529287083745
STAT,1889,34,40-44,1923,6.1164607123384584
STAT,1838,32,35-39,1870,10.902378010706753
STAT,1932,37,15-19,1969,0.029783577498769007
STAT,1953,36,na,1989,5416.03181921306
STAT,1973,6,na,1979,5867.453249954968
STAT,1908,35,30-34,1943,1.990518381797327
STAT,1809,48,40-44,1857,0.43341848836226016
STAT,1919,42,30-34,1961,0.1598485528934102
STAT,1837,24,50-100,1861,0.3810297928855637
SIM,1959,18,35-39,1977,5
STAT,1956,19,20-24,1975,206.89521681030467
SIM,1895,77,na,1972,1238
STAT,1899,30,35-39,1929,16.140308205228205
STAT,1893,18,na,1911,3674.496015239738
STAT,1950,42,15-19,1992,0.002177726029533309
STAT,1894,62,na,1956,2739.3159057484613
SIM,1964,27,50-100,1991,3
SIM,1917,48,45-49,1965,1
STAT,1907,77,na,1984,2291.0973708249808
SIM,1828,27,35-39,1855,23
STAT,1833,50,na,1883,1624.3647093955788
SIM,1939,54,na,1993,4644
STAT,1845,78,na,1923,526.504877694045
STAT,1867,28,50-100,1895,0.6868349471230616
STAT,1911,15,35-39,1926,0.9743722010396626
STAT,1971,22,30-34,1993,42.148904054732974
SIM,1832,53,na,1885,1829
STAT,1876,32,20-24,1908,3.224691922076254
SIM,1881,64,na,1945,1268
SIM,1845,13,na,1858,2555
STAT,1946,38,20-24,1984,0.34727105075850634
STAT,1793,80,na,1873,260.4647215183637
STAT,1863,97,na,1960,11.064705135323612
STAT,1920,24,25-29,1944,117.71559892425365
STAT,1973,33,40-44,2006,5.949993221572149
SIM,1879,31,35-39,1910,29
SIM,1826,34,25-29,1860,17
SIM,1817,48,40-44,1865,1
STAT,1845,19,40-44,1864,0.15394774324056798
SIM,1866,40,40-44,1906,2
SIM,1957,25,25-29,1982,124
STAT,1843,26,30-34,1869,31.320484342793296
SIM,1862,43,25-29,1905,3
STAT,1867,39,15-19,1906,0.0598969256271182
STAT,1973,18,45-49,1991,0.7453488174852875
SIM,1863,15,35-39,1878,3
SIM,1985,13,na,1998,6442
SIM,1925,21,15-19,1946,8
SIM,1846,32,35-39,1878,3
STAT,1929,80,na,2009,2795.41670090056
SIM,1960,21,na,1981,6300
STAT,1949,25,25-29,1974,88.80106423112078
STAT,1821,44,25-29,1865,1.1852616753849277
SIM,1851,26,30-34,1877,46
SIM,1976,28,35-39,2004,21
STAT,1855,15,35-39,1870,0.5619240068531633
STAT,1901,86,na,1987,1018.4507991178162
SIM,1945,54,na,1999,4478
STAT,1863,43,35-39,1906,1.8141105023368693
STAT,1833,22,40-44,1855,2.25256651169751
SIM,1916,28,40-44,1944,4
STAT,1902,36,40-44,1938,1.548107012370352
STAT,1893,31,45-49,1924,2.5541411148833126
STAT,1924,49,50-100,1973,0.3088444327745371
SIM,1907,28,30-34,1935,3
STAT,1930,28,15-19,1958,1.0355684089256005
SIM,1826,53,na,1879,1512
STAT,1897,21,35-39,1918,9.032113310226743
SIM,1838,44,45-49,1882,4
STAT,1934,25,30-34,1959,60.91312026077293
SIM,1847,83,na,1930,470
STAT,1931,39,20-24,1970,0.40212713429953445
STAT,1866,18,15-19,1884,6.4772908074704025
SIM,1948,31,45-49,1979,6
STAT,1856,26,40-44,1882,2.7527586479235318
STAT,1898,32,40-44,1930,6.763891406259081
STAT,1889,20,15-19,1909,4.721091850541489
STAT,1939,40,40-44,1979,0.3012310522023834
STAT,1827,50,na,1877,1975.4414925468884
STAT,1966,37,15-19,2003,0.028517421733875697
STAT,1836,41,15-19,1877,0.015149335338146767
SIM,1950,18,15-19,1968,52
STAT,1893,17,30-34,1910,2.3250069074761957
SIM,1951,4,na,1955,6328
STAT,1878,41,20-24,1919,0.19222851629595905
SIM,1856,50,na,1906,1967
STAT,1961,28,45-49,1989,2.5857611335167543
STAT,1987,20,20-24,2007,183.92529224794603
SIM,1816,91,na,1907,7
SIM,1868,78,na,1946,830
STAT,1835,38,40-44,1873,3.343158010810359
SIM,1843,38,40-44,1881,6
SIM,1943,15,20-24,1958,338
SIM,1910,36,40-44,1946,2
STAT,1979,32,30-34,2011,25.518406037961583
SIM,1869,21,15-19,1890,1
STAT,1821,37,35-39,1858,15.737937622383779
STAT,1847,28,40-44,1875,2.7505401666930025
STAT,1831,65,na,1896,1325.8889505449408
STAT,1953,47,50-100,2000,0.3284374785597976
SIM,1867,38,na,1905,2207
STAT,1813,52,35-39,1865,0.02733750613470585
SIM,1786,69,na,1855,450
SIM,1964,19,20-24,1983,211
SIM,1859,32,45-49,1891,6
SIM,1856,60,na,1916,1707
STAT,1935,80,na,2015,3046.2008897949527
SIM,1890,5,na,1895,3854
STAT,1916,28,15-19,1944,0.8394946260744238
SIM,1942,25,30-34,1967,84
STAT,1863,53,50-100,1916,0.014995638015790297
SIM,1888,92,na,1980,38
STAT,1939,73,na,2012,3163.3397585370626
STAT,1966,15,15-19,1981,65.45134059613683
SIM,1864,26,40-44,1890,1
SIM,1829,38,40-44,1867,2
STAT,1849,75,na,1924,797.903339247964
STAT,1911,17,25-29,1928,10.016176459513234
STAT,1882,16,40-44,1898,0.2066774306727574
SIM,1924,23,20-24,1947,278
STAT,1900,45,20-24,1945,0.010947641776115073
STAT,1930,41,35-39,1971,0.3062424693348347
STAT,1934,35,50-100,1969,0.6701298178608533
SIM,1938,76,na,2014,2648
STAT,1918,44,50-100,1962,0.1436379179311047
STAT,1858,52,50-100,1910,0.013524411201666989
STAT,1928,32,na,1960,5457.441575037858
SIM,1922,82,na,2004,1714
SIM,1938,21,25-29,1959,195
STAT,1935,15,20-24,1950,215.0009538460381
STAT,1947,28,45-49,1975,2.2544463795688405
SIM,1983,15,25-29,1998,104
STAT,1960,15,30-34,1975,18.330435198254854
STAT,1977,33,25-29,2010,14.681379432267224
STAT,1975,15,25-29,1990,66.01147836194443
SIM,1829,33,50-100,1862,5
SIM,1887,21,50-100,1908,1
SIM,1915,34,na,1949,4699
STAT,1959,38,30-34,1997,2.8316666383909794
SIM,1875,34,20-24,1909,8
STAT,1831,54,45-49,1885,0.011370422827406593
SIM,1862,50,na,1912,2722
SIM,1942,18,40-44,1960,2
SIM,1955,28,45-49,1983,6
STAT,1867,34,20-24,1901,2.887578730771609
SIM,1825,36,30-34,1861,14
SIM,1839,34,35-39,1873,19
STAT,1828,76,na,1904,628.7912533400382
SIM,1871,43,35-39,1914,4
STAT,1877,49,35-39,1926,0.16455327714404414
STAT,1916,23,20-24,1939,134.06406354072774
STAT,1942,18,15-19,1960,54.72510114704654
SIM,1838,21,20-24,1859,68
SIM,1938,29,20-24,1967,1
STAT,1893,29,15-19,1922,0.6570941238109342
STAT,1977,26,35-39,2003,23.522343233670515
STAT,1897,43,50-100,1940,0.1123898839909806
STAT,1982,16,45-49,1998,0.8114434684236669
STAT,1934,18,40-44,1952,2.1787020855696078
SIM,1903,44,50-100,1947,1
STAT,1883,15,na,1898,2864.8915450746745
SIM,1864,27,na,1891,2702
STAT,1965,30,40-44,1995,5.753616860355207
STAT,1842,20,40-44,1862,2.0519002725064577
SIM,1979,19,15-19,1998,1
SIM,1947,20,50-100,1967,5
STAT,1926,45,25-29,1971,0.07587422893528531
STAT,1874,36,50-100,1910,1.4574946954331611
STAT,1846,17,35-39,1863,0.7125751479362301
SIM,1854,17,35-39,1871,1
STAT,1945,32,30-34,1977,20.245669314769895
STAT,1843,38,15-19,1881,0.059238853878996
STAT,1911,24,15-19,1935,5.794657075579961
STAT,1921,21,50-100,1942,0.8599545126326019
SIM,1878,21,25-29,1899,146
SIM,1953,32,30-34,1985,4
SIM,1903,44,35-39,1947,1
SIM,1875,27,30-34,1902,2
STAT,1919,55,na,1974,4453.194144430149
STAT,1882,21,40-44,1903,2.35599211676841
STAT,1917,36,35-39,1953,2.91331270375658
STAT,1962,13,na,1975,5807.47971596349
SIM,1834,22,15-19,1856,4
SIM,1848,49,30-34,1897,1
STAT,1816,48,50-100,1864,0.4933870754385535
SIM,1841,21,45-49,1862,1
STAT,1958,46,na,2004,5806.4821719694055
SIM,1957,22,20-24,1979,5
SIM,1937,24,45-49,1961,5
SIM,1961,20,20-24,1981,294
SIM,1972,41,35-39,2013,1
STAT,1839,22,25-29,1861,58.3318422798629
SIM,1951,58,na,2009,5909
STAT,1927,30,20-24,1957,3.4658241197117112
STAT,1986,29,30-34,2015,64.64599226481789
STAT,1821,41,20-24,1862,0.31319079182593434
STAT,1921,34,35-39,1955,11.631412437402354
SIM,1865,21,30-34,1886,1
SIM,1940,70,na,2010,3519
STAT,1865,33,40-44,1898,4.496576415626178
SIM,1851,33,20-24,1884,5
SIM,1890,21,40-44,1911,7
STAT,1834,53,50-100,1887,0.013854879332292243
STAT,1944,47,35-39,1991,0.16655840639731623
SIM,1929,38,45-49,1967,1
SIM,1967,5,na,1972,5784
STAT,1901,45,na,1946,3673.7693235985575
STAT,1949,22,20-24,1971,149.73538560844898
SIM,1928,24,35-39,1952,28
STAT,1970,37,50-100,2007,0.6248810302109653
STAT,1818,83,na,1901,175.65133483900942
STAT,1994,15,30-34,2009,20.309314581533947
STAT,1901,19,40-44,1920,0.29407407453374845
SIM,1875,41,45-49,1916,6
STAT,1818,36,15-19,1854,0.10442057342593673
STAT,1953,20,20-24,1973,155.85439807854726
SIM,1885,26,na,1911,3314
STAT,1860,30,50-100,1890,0.8590580852111468
SIM,1935,30,20-24,1965,6
STAT,1799,67,na,1866,1017.9028903524229
STAT,1894,58,na,1952,2933.8433923652888
SIM,1958,27,50-100,1985,2
STAT,1771,95,na,1866,3.03035959052762
STAT,1909,45,40-44,1954,0.16898901582438317
STAT,1812,51,na,1863,1270.4062695600144
SIM,1981,24,na,2005,5638
STAT,1867,41,45-49,1908,1.6199091626428035
STAT,1804,69,na,1873,919.547257775667
SIM,1859,30,na,1889,2299
SIM,1852,26,15-19,1878,1
STAT,1880,45,na,1925,2779.535248929061
SIM,1874,78,na,1952,919
SIM,1986,21,25-29,2007,311
STAT,1977,12,na,1989,6125.143072867146
SIM,1839,31,30-34,1870,3
SIM,1866,12,na,1878,2763
SIM,1875,29,20-24,1904,1
STAT,1949,1,na,1950,5497.4866506105145
STAT,1888,113,na,2001,0.0020033695422976127
STAT,1935,35,40-44,1970,2.4212199652125213
STAT,1834,35,na,1869,2482.2617228947083
SIM,1917,25,20-24,1942,46
SIM,1937,18,na,1955,4397
STAT,1911,35,50-100,1946,0.4728423964338913
STAT,1903,26,30-34,1929,41.53548409756196
SIM,1951,26,35-39,1977,37
SIM,1836,46,na,1882,1591
STAT,1943,26,35-39,1969,18.462843755809196
STAT,1804,51,30-34,1855,0.027955632689640547
STAT,1856,21,50-100,1877,0.42000559012467226
STAT,1947,46,na,1993,4979.877894382641
SIM,1976,25,30-34,2001,139
STAT,1875,102,na,1977,5.446551990420273
STAT,1877,53,20-24,1930,8.716086047317892E-4
STAT,1853,49,na,1902,2193.2150384683328
STAT,1786,94,na,1880,7.155242878629335
STAT,1843,33,20-24,1876,3.22690060643808
STAT,1925,18,30-34,1943,16.942242613757763
STAT,1854,40,20-24,1894,0.1306900342425586
SIM,1847,22,25-29,1869,9
SIM,1943,35,40-44,1978,4
STAT,1876,35,25-29,1911,3.4674422631414465
STAT,1885,44,15-19,1929,0.01568204818357336
STAT,1927,27,50-100,1954,1.396157576435027
SIM,1935,27,50-100,1962,5
STAT,1908,28,40-44,1936,5.073529320653062
STAT,1911,38,40-44,1949,1.6617700029620128
STAT,1973,15,40-44,1988,2.088752135356293
STAT,1776,115,na,1891,1.7447550518782292E-4
STAT,1844,26,15-19,1870,0.4679158694191731
SIM,1796,90,na,1886,85
STAT,1862,31,15-19,1893,0.139262246495094
STAT,1967,26,20-24,1993,26.439898872290218
STAT,1849,34,na,1883,1908.910514251918
STAT,1964,41,35-39,2005,0.304612448779354
STAT,1821,34,30-34,1855,49.29537118594946
STAT,1909,25,20-24,1934,20.464040640198263
SIM,1829,64,na,1893,1103
SIM,1889,77,na,1966,2022
SIM,1884,35,25-29,1919,7
STAT,1885,26,50-100,1911,0.7388828117571636
SIM,1824,40,35-39,1864,2
SIM,1893,26,50-100,1919,1
SIM,1983,22,50-100,2005,2
STAT,1867,63,na,1930,1922.5671789892408
SIM,1851,13,na,1864,3152
SIM,1975,20,na,1995,5686
STAT,1920,59,na,1979,4405.171193048573
STAT,1961,25,40-44,1986,6.985731035540441
SIM,1821,47,na,1868,1471
SIM,1939,17,20-24,1956,1
STAT,1898,35,45-49,1933,3.138730464617221
STAT,1846,64,na,1910,1797.083807857817
STAT,1950,25,na,1975,5138.351267688831
SIM,1842,46,na,1888,2072
SIM,1872,12,na,1884,3309
STAT,1939,43,45-49,1982,0.19956476336985204
SIM,1981,33,40-44,2014,1
SIM,1924,55,na,1979,4691
STAT,1966,29,40-44,1995,6.740906134568659
SIM,1891,81,na,1972,1200
SIM,1911,29,35-39,1940,39
STAT,1863,40,30-34,1903,1.1718481467780608
STAT,1924,15,45-49,1939,0.6895083303990153
STAT,1927,40,15-19,1967,0.002228343821617655
STAT,1969,17,40-44,1986,2.0164272697748213
SIM,1933,22,na,1955,6470
SIM,1989,25,40-44,2014,13
SIM,1903,56,na,1959,3259
STAT,1832,39,50-100,1871,1.0554328850135384
SIM,1888,34,30-34,1922,4
SIM,1850,72,na,1922,621
STAT,1888,62,na,1950,2479.453635476964
STAT,1892,29,30-34,1921,36.163635590178615
SIM,1858,38,50-100,1896,4
SIM,1840,39,50-100,1879,3
STAT,1828,53,25-29,1881,0.002810535433390453
STAT,1941,58,na,1999,4310.052159512831
STAT,1898,14,na,1912,4014.848866624398
STAT,1969,38,45-49,2007,1.0114881650221461
SIM,1871,40,30-34,1911,1
SIM,1981,15,40-44,1996,4
STAT,1880,54,40-44,1934,0.012523722478158406
STAT,1899,45,20-24,1944,0.010808962138226694
STAT,1819,68,na,1887,1052.5764391721536
STAT,1949,32,15-19,1981,0.17580793854065546
STAT,1889,33,45-49,1922,2.4702392747313535
SIM,1838,41,40-44,1879,5
STAT,1859,37,na,1896,2165.8609130257287
STAT,1955,16,35-39,1971,6.430348393340716
SIM,1845,9,na,1854,2570
STAT,1944,37,40-44,1981,1.9154740465308353
SIM,1864,21,50-100,1885,2
SIM,1847,43,40-44,1890,12
SIM,1948,49,35-39,1997,1
STAT,1877,46,30-34,1923,0.11653299080578176
STAT,1868,48,na,1916,2463.2064977656123
STAT,1873,63,na,1936,2102.784448877242
STAT,1916,26,25-29,1942,78.81718347751267
SIM,1954,21,na,1975,5149
SIM,1890,41,na,1931,3281
STAT,1971,24,na,1995,5351.703219418443
STAT,1917,16,15-19,1933,11.29852623449614
SIM,1896,20,30-34,1916,68
SIM,1969,20,na,1989,5408
SIM,1945,58,na,2003,4332
STAT,1969,39,50-100,2008,0.6222546668920385
STAT,1888,25,25-29,1913,57.77435191406932
STAT,1912,96,na,2008,163.46961177361942
STAT,1870,37,30-34,1907,6.063589553118404
SIM,1850,30,35-39,1880,14
SIM,1864,29,45-49,1893,3
SIM,1906,18,20-24,1924,22
STAT,1842,23,45-49,1865,0.6719593886668391
STAT,1965,33,45-49,1998,2.3095207510569775
SIM,1897,33,45-49,1930,3
STAT,1942,62,na,2004,4195.756353073854
STAT,1906,92,na,1998,413.94387352439037
SIM,1838,31,na,1869,1838
STAT,1839,43,40-44,1882,1.8561011866069754
SIM,1963,16,35-39,1979,10
STAT,1852,64,na,1916,1638.947661997942
STAT,1831,102,na,1933,0.2300154442513062
STAT,1857,21,30-34,1878,18.61613860659809
SIM,1924,26,25-29,1950,23
SIM,1832,22,30-34,1854,1
SIM,1848,28,15-19,1876,1
STAT,1880,33,25-29,1913,12.476302868209274
SIM,1804,99,na,1903,1
SIM,1807,80,na,1887,210
STAT,1970,27,40-44,1997,6.762590337824432
STAT,1833,21,45-49,1854,0.9771781178764698
SIM,1896,25,25-29,1921,134
STAT,1856,29,45-49,1885,0.998487564279674
STAT,1842,30,35-39,1872,9.611729400033793
STAT,1947,25,40-44,1972,6.09064613029299
STAT,1893,19,20-24,1912,25.722250523196855
STAT,1953,32,50-100,1985,1.1765540162225117
SIM,1864,31,40-44,1895,11
SIM,1909,43,25-29,1952,1
SIM,1865,71,na,1936,1671
SIM,1955,25,40-44,1980,9
STAT,1882,30,na,1912,2711.5072958825244
STAT,1900,48,25-29,1948,0.05137620340863506
STAT,1994,0,na,1994,6596.357899759037
SIM,1977,17,40-44,1994,5
STAT,1861,39,40-44,1900,4.157538621071137
STAT,1959,28,35-39,1987,22.751146456961052
SIM,1928,21,30-34,1949,51
SIM,1928,32,40-44,1960,17
STAT,1904,40,35-39,1944,0.2104924462021584
STAT,1870,29,35-39,1899,10.899358743317848
STAT,1896,21,20-24,1917,105.35948867930519
STAT,1958,41,15-19,1999,0.002422507422468043
STAT,1854,99,na,1953,1.5429277529328507
SIM,1909,27,35-39,1936,28
SIM,1969,33,25-29,2002,28
STAT,1866,20,50-100,1886,0.4461430664089947
STAT,1879,35,na,1914,2865.9592679150437
STAT,1866,29,15-19,1895,0.4818397174328946
STAT,1900,35,25-29,1935,4.654406310191678
STAT,1940,26,na,1966,4411.918404606123
SIM,1885,27,25-29,1912,53
STAT,1877,27,25-29,1904,50.78052593812088
STAT,1932,40,40-44,1972,0.3924032549344359
STAT,1944,47,50-100,1991,0.29219103204978963
STAT,1928,40,20-24,1968,0.026053527443490192
SIM,1835,33,20-24,1868,1
SIM,1909,38,45-49,1947,1
SIM,1852,45,na,1897,1877
STAT,1891,23,40-44,1914,2.962990409202912
SIM,1890,62,na,1952,2543
STAT,1920,0,na,1920,5830.630707877679
STAT,1913,35,35-39,1948,2.782299564783769
STAT,1921,34,50-100,1955,1.0523511854586443
SIM,1877,80,na,1957,847
SIM,1882,67,na,1949,2216
SIM,1839,45,50-100,1884,1
STAT,1943,30,45-49,1973,1.9653364834162401
SIM,1928,38,na,1966,5690
SIM,1921,46,45-49,1967,1
STAT,1983,29,na,2012,6136.120478134783
STAT,1860,52,20-24,1912,6.826914380852856E-4
STAT,1929,27,40-44,1956,6.732359425419684
SIM,1937,27,40-44,1964,9
STAT,1948,38,30-34,1986,2.4773184349667474
STAT,1913,46,45-49,1959,0.24554888027038457
SIM,2007,6,na,2013,6952
STAT,1902,45,30-34,1947,0.08992527452610492
SIM,1891,29,20-24,1920,34
SIM,1898,42,na,1940,3850
STAT,1930,30,35-39,1960,13.627318886344794
STAT,1833,81,na,1914,380.52176008089
SIM,1935,17,35-39,1952,18
STAT,1908,65,na,1973,3346.609797036737
SIM,1925,87,na,2012,1305
STAT,1822,35,40-44,1857,11.555060256753745
SIM,1872,8,na,1880,3395
SIM,1889,21,25-29,1910,162
STAT,1895,25,50-100,1920,0.9674601103139512
STAT,1916,60,na,1976,4049.8926250105515
STAT,1885,21,45-49,1906,0.8051167213822921
SIM,1939,22,45-49,1961,3
SIM,1924,24,na,1948,4459
SIM,1962,30,20-24,1992,8
SIM,1921,35,35-39,1956,2
STAT,1924,46,20-24,1970,0.01521682806508818
STAT,1827,33,20-24,1860,4.459872259221072
SIM,1830,35,40-44,1865,3
STAT,1877,15,30-34,1892,1.9222421982170559
STAT,1980,22,30-34,2002,46.19805657236879
SIM,1924,27,30-34,1951,72
STAT,1862,94,na,1956,22.337061880669356
STAT,1863,33,30-34,1896,17.544426999271224
SIM,1967,28,35-39,1995,2
STAT,1872,29,45-49,1901,1.2774259816919926
STAT,1887,30,na,1917,3111.0788849662104
STAT,1811,49,25-29,1860,0.17360441796941783
STAT,1880,48,35-39,1928,0.16910196385785145
STAT,1917,40,45-49,1957,0.2010008337213784
STAT,1991,24,na,2015,6055.482942601572
SIM,1903,62,na,1965,3044
SIM,1907,24,20-24,1931,206
SIM,1916,29,na,1945,4440
STAT,1806,49,50-100,1855,0.8756250215806713
STAT,1909,46,25-29,1955,0.0564547128447652
STAT,1987,23,25-29,2010,152.63095857358235
STAT,1959,39,45-49,1998,1.0579764010980186
STAT,1830,54,30-34,1884,0.004641213796113139
STAT,1947,62,na,2009,4521.787430410145
SIM,1971,16,50-100,1987,1
STAT,1895,81,na,1976,1458.9580000268443
STAT,1899,95,na,1994,179.35551234661764
STAT,1916,27,30-34,1943,46.75915065226174
STAT,1849,13,na,1862,2267.197570306768
SIM,1882,36,50-100,1918,5
STAT,1828,51,na,1879,1561.9449498525667
SIM,1911,24,40-44,1935,7
SIM,1927,72,na,1999,3547
SIM,1837,36,35-39,1873,15
STAT,1945,46,35-39,1991,0.16948283114020038
SIM,1916,19,20-24,1935,176
STAT,1973,13,na,1986,5861.940057784653
STAT,1967,35,20-24,2002,0.3921831614435854
STAT,1878,47,40-44,1925,0.20532666451947393
STAT,1983,18,15-19,2001,74.06668070627893
STAT,1891,51,na,1942,3085.8808476010017
STAT,1922,36,15-19,1958,0.025228981848363155
STAT,1806,48,na,1854,1243.4781110110503
STAT,1895,65,na,1960,2681.855818565495
SIM,1991,18,15-19,2009,66
STAT,1942,17,30-34,1959,14.70247550501045
STAT,1946,22,40-44,1968,4.3179914795270475
STAT,1950,39,25-29,1989,1.3812317628150281
STAT,1967,46,30-34,2013,0.13400174874521698
STAT,1917,43,25-29,1960,0.08586795971858585
STAT,1844,20,15-19,1864,3.4952756414948936
SIM,1919,3,na,1922,5779
STAT,1929,27,na,1956,5410.89807532138
STAT,1808,105,na,1913,0.01495029149937347
STAT,1911,69,na,1980,3228.6844135398132
STAT,1873,78,na,1951,920.7926641877965
SIM,1874,32,na,1906,2586
SIM,1959,28,30-34,1987,71
STAT,1828,35,na,1863,1882.034429257719
SIM,1849,15,20-24,1864,30
SIM,1965,25,20-24,1990,6
STAT,1940,40,45-49,1980,0.20329293066310794
STAT,1858,73,na,1931,1069.3170878602584
STAT,1903,24,40-44,1927,3.4038743823073436
STAT,1914,4,na,1918,4804.8499324784025
STAT,1952,20,15-19,1972,7.391230385756233
SIM,1976,15,25-29,1991,76
STAT,1927,17,35-39,1944,6.019802616905061
SIM,1879,63,na,1942,2114
STAT,1844,39,35-39,1883,6.123044730102502
SIM,1935,28,45-49,1963,5
SIM,1957,11,na,1968,6328
STAT,1848,30,30-34,1878,22.088257000153057
STAT,1838,23,25-29,1861,63.88384014448218
STAT,1957,25,20-24,1982,27.91889912051686
STAT,1774,85,na,1859,3.4717440667644923
STAT,1818,46,30-34,1864,0.12119801914474775
STAT,1960,49,25-29,2009,0.08244657997302483
STAT,1979,2,na,1981,6253.0020856814435
STAT,1778,99,na,1877,0.4712086877122149
SIM,1898,98,na,1996,81
STAT,1971,38,45-49,2009,1.0255467593988628
STAT,1927,28,45-49,1955,2.414756822318462
STAT,1841,17,na,1858,2632.1671775398067
SIM,1856,30,30-34,1886,37
SIM,1820,83,na,1903,476
STAT,1954,33,25-29,1987,13.43262321004844
STAT,1796,72,na,1868,641.8950587509681
STAT,1900,32,45-49,1932,2.7924795433581573
SIM,1846,23,25-29,1869,118
SIM,1783,74,na,1857,707
STAT,1968,15,25-29,1983,62.49705680785115
STAT,1953,18,45-49,1971,0.6971637108305568
SIM,1956,38,30-34,1994,6
STAT,1903,25,25-29,1928,70.00585354920692
SIM,1936,33,na,1969,3984
SIM,1951,33,25-29,1984,2
STAT,1874,23,35-39,1897,6.873008380875777
STAT,1978,36,35-39,2014,3.928251821915874
SIM,1864,32,50-100,1896,2
STAT,1821,51,25-29,1872,0.006300349779900837
STAT,1950,28,15-19,1978,0.9670032264481035
SIM,1878,31,20-24,1909,3
STAT,1861,20,45-49,1881,0.6972825438817968
STAT,1820,71,na,1891,783.3940651243115
STAT,1915,19,na,1934,4640.854561842191
SIM,1932,59,na,1991,5009
SIM,1911,25,25-29,1936,149
SIM,1987,21,50-100,2008,1
SIM,1841,61,na,1902,1469
STAT,1908,19,20-24,1927,30.22535342226027
STAT,1845,82,na,1927,314.4088604555378
STAT,1983,15,20-24,1998,221.45066892638712
STAT,1900,21,35-39,1921,9.372891459447724
STAT,1975,32,45-49,2007,2.442013739682967
SIM,1861,23,20-24,1884,126
STAT,1849,96,na,1945,6.6552453660173985
STAT,1939,20,50-100,1959,0.7634513983555905
STAT,1960,48,40-44,2008,0.24580910919715585
STAT,1840,38,50-100,1878,1.152858985612003
SIM,1861,6,na,1867,2316
STAT,1927,44,na,1971,5356.268906717221
STAT,1847,30,na,1877,1999.0644993881378
SIM,1914,46,na,1960,3887
STAT,1876,47,30-34,1923,0.11494197782086389
STAT,1871,42,25-29,1913,0.7363697113900132
STAT,1935,7,na,1942,6309.802039213631
STAT,1932,43,20-24,1975,0.02758579222042442
STAT,1959,18,50-100,1977,0.5653905552702286
SIM,1842,18,15-19,1860,12
STAT,1853,23,20-24,1876,80.48424186229916
SIM,1835,36,25-29,1871,7
SIM,1815,53,na,1868,1731
STAT,1871,52,50-100,1923,0.017247555882002077
STAT,1850,45,15-19,1895,4.158833200598844E-4
STAT,1839,35,na,1874,2072.3930562435644
STAT,1838,23,50-100,1861,0.4550779798953135
STAT,1856,107,na,1963,0.020810255284029695
SIM,1854,39,45-49,1893,6
STAT,1840,51,na,1891,1735.538755261937
STAT,1810,47,50-100,1857,0.9557459894695766
STAT,1924,38,15-19,1962,0.02609888680449578
SIM,1899,24,na,1923,4376
STAT,1817,51,na,1868,1893.336221179805
SIM,1874,88,na,1962,219
SIM,1873,34,50-100,1907,1
STAT,1882,107,na,1989,0.3318179072819501
STAT,1959,25,30-34,1984,59.456469980177985
STAT,1899,7,na,1906,4119.251628533876
STAT,1951,25,50-100,1976,1.3749554671079003
SIM,1846,23,50-100,1869,1
SIM,1885,16,na,1901,3388
STAT,1906,17,20-24,1923,29.834831344604144
SIM,1892,45,na,1937,3572
SIM,1914,17,20-24,1931,61
SIM,1896,59,na,1955,3151
STAT,1815,42,40-44,1857,5.026573334954073
STAT,1896,24,25-29,1920,86.71243556133902
SIM,1899,31,35-39,1930,26
STAT,1790,105,na,1895,0.006489511916937592
STAT,1980,30,50-100,2010,1.3517161375410844
STAT,1888,16,45-49,1904,0.0888324904814176
SIM,1960,15,na,1975,5554
STAT,1832,56,na,1888,1401.75587084092
STAT,1835,49,40-44,1884,0.10976479349523699
SIM,1919,21,na,1940,5583
STAT,1835,30,45-49,1865,1.415814449076065
SIM,1987,9,na,1996,6558
STAT,1915,43,15-19,1958,0.0017817557368218322
STAT,1827,36,25-29,1863,4.326477577669458
STAT,1851,7,na,1858,2386.360276345808
STAT,1874,20,30-34,1894,21.16983480612381
STAT,1846,39,45-49,1885,2.1078538708200143
STAT,1954,18,na,1972,5249.534463695138
STAT,1776,100,na,1876,0.3118167187561104
STAT,1919,17,30-34,1936,15.540905062331221
SIM,1895,37,35-39,1932,23
SIM,1961,16,na,1977,5659
STAT,1991,24,50-100,2015,1.0911013603467485
SIM,1903,46,na,1949,3606
SIM,1967,25,30-34,1992,77
SIM,1888,41,30-34,1929,1
STAT,1977,18,30-34,1995,18.999864749279887
SIM,1862,40,50-100,1902,2
STAT,1887,37,35-39,1924,9.147572108459332
SIM,1906,11,na,1917,4007
STAT,1846,20,25-29,1866,74.0792729708237
STAT,1924,49,25-29,1973,0.07243257004200268
SIM,1835,20,45-49,1855,1
STAT,1852,17,na,1869,2617.4862317825036
STAT,1859,20,35-39,1879,6.205202337047411
SIM,1885,15,30-34,1900,5
STAT,1950,39,50-100,1989,0.5889826910486942
SIM,1843,30,45-49,1873,6
SIM,1904,32,25-29,1936,2
STAT,1904,35,na,1939,3972.551811502733
STAT,1908,49,na,1957,3816.6641376293856
STAT,1785,69,na,1854,450.00000000000006
SIM,1860,40,na,1900,2349
STAT,1919,65,na,1984,4007.633434827373
SIM,1846,76,na,1922,161
STAT,1938,28,20-24,1966,20.870299839510764
SIM,1973,25,na,1998,5053
SIM,1845,37,50-100,1882,2
STAT,1832,101,na,1933,0.38876033906958385
STAT,1880,45,30-34,1925,0.11959024629993308
SIM,1941,1,na,1942,4173
STAT,1902,48,35-39,1950,0.127155357508694
STAT,1959,36,40-44,1995,2.3302901527564184
STAT,1976,25,15-19,2001,1.094095332526569
STAT,1917,41,50-100,1958,0.1416942367322127
SIM,1867,20,35-39,1887,7
SIM,1964,33,35-39,1997,31
SIM,1902,38,35-39,1940,1
STAT,1941,33,15-19,1974,0.1556458652352028
SIM,1931,58,na,1989,5712
STAT,1890,16,50-100,1906,0.06925411038430604
STAT,1836,101,na,1937,0.5193061534101581
STAT,1862,52,30-34,1914,0.005766518445379277
SIM,1928,54,na,1982,5476
STAT,1841,32,40-44,1873,4.678153742782365
STAT,1811,94,na,1905,10.29070304686845
STAT,1899,16,20-24,1915,28.098899145500116
SIM,1885,24,20-24,1909,2
STAT,1834,46,50-100,1880,0.26457319712496297
STAT,1859,31,45-49,1890,1.6096552553598835
STAT,1959,47,na,2006,5768.5433039585505
STAT,1948,39,15-19,1987,0.026072782963292112
STAT,1877,24,20-24,1901,82.20777650576801
STAT,1956,33,35-39,1989,14.215824788094586
SIM,1867,31,45-49,1898,4
STAT,1857,48,na,1905,1996.772137394954
STAT,1953,17,30-34,1970,17.01624320055929
SIM,1817,40,45-49,1857,2
SIM,1866,37,na,1903,2505
STAT,1848,33,35-39,1881,11.301093856618875
STAT,1966,19,na,1985,5301.985315329364
STAT,1903,16,35-39,1919,0.9041707994609928
STAT,1921,43,45-49,1964,0.21590853655099607
SIM,1828,30,25-29,1858,4
SIM,1935,27,30-34,1962,145
STAT,1906,82,na,1988,1636.679048231902
STAT,1957,28,25-29,1985,100.53448856281973
SIM,1837,33,30-34,1870,39
STAT,1903,27,45-49,1930,1.8250909614503774
STAT,1912,19,40-44,1931,0.3249666025368081
SIM,1878,23,15-19,1901,7
SIM,1930,22,25-29,1952,279
SIM,1949,16,na,1965,5297
SIM,1911,27,45-49,1938,5
STAT,1806,64,na,1870,858.8927732267965
SIM,1920,19,40-44,1939,5
SIM,1893,67,na,1960,2214
SIM,1844,10,na,1854,3075
SIM,1946,28,20-24,1974,40
SIM,1910,48,35-39,1958,1
SIM,1848,24,na,1872,2106
STAT,1853,26,25-29,1879,49.142461515791894
SIM,1856,33,35-39,1889,15
STAT,1858,19,50-100,1877,0.05091734124089557
STAT,1893,43,15-19,1936,0.0013887808919778566
SIM,1878,62,na,1940,2176
STAT,1911,32,20-24,1943,2.743394498405255
STAT,1965,34,na,1999,5547.16431752547
STAT,1927,27,30-34,1954,54.960635360428604
SIM,1841,45,na,1886,1831
SIM,1862,30,25-29,1892,29
STAT,1865,27,na,1892,2484.981812470127
STAT,1935,45,50-100,1980,0.3704353657469329
STAT,1961,26,25-29,1987,98.60655480468417
STAT,1979,24,na,2003,5817.857066991877
STAT,1803,106,na,1909,0.004231859437904061
STAT,1883,29,20-24,1912,13.15122029234202
STAT,1897,44,40-44,1941,0.23777531559991538
STAT,1854,30,25-29,1884,8.7247151023869
STAT,1935,36,25-29,1971,1.591193342251214
STAT,1937,22,na,1959,4106.169654153645
STAT,1945,43,30-34,1988,0.16722863251342343
STAT,1917,40,20-24,1957,0.02132880853735128
SIM,1918,76,na,1994,2414
STAT,1837,43,30-34,1880,0.9698563867573042
STAT,1982,25,45-49,2007,2.8200873359690606
SIM,1849,18,25-29,1867,16
SIM,1968,36,na,2004,5318
SIM,1962,4,na,1966,5594
STAT,1829,33,30-34,1862,21.834907785195604
SIM,1965,28,25-29,1993,6
SIM,1914,62,na,1976,3564
STAT,1972,29,50-100,2001,1.475630384118235
SIM,1878,34,25-29,1912,28
SIM,1845,43,30-34,1888,6
SIM,1943,36,25-29,1979,4
STAT,1895,2,na,1897,4004.332967957685
SIM,1859,25,30-34,1884,27
STAT,1978,33,30-34,2011,25.277684338076458
SIM,1854,20,25-29,1874,9
SIM,1936,41,35-39,1977,1
SIM,1940,54,na,1994,4820
STAT,1903,22,20-24,1925,113.27678652999252
SIM,1861,15,15-19,1876,4
SIM,1828,49,45-49,1877,1
SIM,1938,43,35-39,1981,1
SIM,1861,26,25-29,1887,44
STAT,1814,50,50-100,1864,0.04178719073265428
SIM,1911,22,20-24,1933,125
STAT,1828,40,25-29,1868,0.6379111292770311
STAT,1845,16,25-29,1861,4.854912796189003
STAT,1825,86,na,1911,156.93929549527968
STAT,1853,15,15-19,1868,7.192075976980925
SIM,1927,17,30-34,1944,42
STAT,1949,18,25-29,1967,58.144607357951806
STAT,1903,30,50-100,1933,1.518209827459058
SIM,1843,49,40-44,1892,1
STAT,1861,13,na,1874,2620.5212313278817
STAT,1922,22,25-29,1944,122.19101426935143
STAT,1951,40,20-24,1991,0.025291768397644406
STAT,1820,35,50-100,1855,3.395820024270834
SIM,1972,18,20-24,1990,1
STAT,1845,52,25-29,1897,0.002374096590344563
STAT,1971,35,40-44,2006,2.2581826752524474
SIM,1879,47,na,1926,2579
SIM,1875,33,na,1908,3093
SIM,1935,65,na,2000,5101
SIM,1789,71,na,1860,959
SIM,1951,30,20-24,1981,1
SIM,1904,26,50-100,1930,1
STAT,1920,28,35-39,1948,18.93156240990498
STAT,1928,41,35-39,1969,0.296671747342444
STAT,1950,36,20-24,1986,0.3709243362589214
SIM,1887,98,na,1985,5
STAT,1964,18,20-24,1982,196.99845903759768
SIM,1947,33,na,1980,6007
SIM,1971,26,35-39,1997,2
SIM,1979,31,40-44,2010,16
SIM,1916,72,na,1988,3053
STAT,1839,51,na,1890,1715.739237569287
STAT,1895,44,30-34,1939,0.1183091754911663
STAT,1968,24,15-19,1992,7.693031429263239
STAT,1880,51,na,1931,2646.445451795381
STAT,1924,36,25-29,1960,1.3407339178269435
STAT,1846,33,25-29,1879,12.383848946742523
SIM,1983,7,na,1990,7027
STAT,1954,21,30-34,1975,41.153246592020956
SIM,1838,41,na,1879,1636
SIM,1880,20,20-24,1900,168
STAT,1943,46,25-29,1989,0.06769694162994042
SIM,1859,24,na,1883,2099
SIM,1962,32,40-44,1994,10
STAT,1939,32,45-49,1971,1.853640389147277
SIM,1904,20,30-34,1924,76
STAT,1769,104,na,1873,0.0474980671164437
SIM,1816,38,na,1854,1812
STAT,1967,31,45-49,1998,2.313590688180552
SIM,1952,47,50-100,1999,1
STAT,1985,19,30-34,2004,19.993167673276034
STAT,1855,23,30-34,1878,17.57929496197561
STAT,1964,45,45-49,2009,0.33013663254814707
SIM,1960,31,na,1991,6099
STAT,1989,23,35-39,2012,15.610682432507282
SIM,1854,36,40-44,1890,2
SIM,1918,23,15-19,1941,12
SIM,1885,32,na,1917,3252
STAT,1952,36,30-34,1988,2.599166037703243
SIM,1801,61,na,1862,1287
STAT,1954,40,50-100,1994,0.1746639361111081
SIM,1796,84,na,1880,227
SIM,1831,26,50-100,1857,1
SIM,1824,33,na,1857,1736
STAT,1941,27,na,1968,4473.365634280487
SIM,1805,75,na,1880,491
STAT,1963,26,35-39,1989,22.117391795618087
SIM,1854,22,15-19,1876,8
SIM,1932,36,25-29,1968,4
SIM,1851,44,na,1895,2625
SIM,1951,35,15-19,1986,4
SIM,1883,68,na,1951,1421
SIM,1913,25,35-39,1938,27
STAT,1854,43,na,1897,1869.3579776235663
STAT,1965,38,15-19,2003,0.028475468103077304
SIM,1854,39,50-100,1893,3
STAT,1853,98,na,1951,3.234309295211464
STAT,1905,25,35-39,1930,16.226162366827232
SIM,1854,33,25-29,1887,23
STAT,1928,42,40-44,1970,0.36797582055240874
SIM,1958,32,20-24,1990,7
STAT,1856,32,50-100,1888,0.8165845261303567
STAT,1976,18,na,1994,5673.183577370633
STAT,1891,39,20-24,1930,1.0884100469077993
STAT,1911,46,50-100,1957,0.2479354540602698
SIM,1828,46,40-44,1874,1
STAT,1846,22,15-19,1868,4.2080512930916445
STAT,1928,31,30-34,1959,22.747613037732076
STAT,1949,15,20-24,1964,182.0618723726553
STAT,1943,35,15-19,1978,0.02425583314751749
STAT,1930,64,na,1994,4945.170803741987
SIM,1871,33,30-34,1904,16
SIM,1864,70,na,1934,1339
SIM,1909,36,25-29,1945,3
SIM,1966,6,na,1972,5943
STAT,1899,19,25-29,1918,8.911448860621222
STAT,1863,17,na,1880,2643.1779633025185
SIM,1900,25,25-29,1925,69
STAT,1971,44,na,2015,5622.733965364629
SIM,1957,15,20-24,1972,221
SIM,1915,21,45-49,1936,1
SIM,1848,34,45-49,1882,1
STAT,1963,16,50-100,1979,0.5494596467179161
SIM,1940,38,na,1978,4977
STAT,1950,26,25-29,1976,90.24344288367755
SIM,1937,34,na,1971,4364
SIM,1945,36,35-39,1981,8
STAT,1961,45,na,2006,5724.374519957353
STAT,1816,38,15-19,1854,0.20489228885819
SIM,1848,23,35-39,1871,6
STAT,1956,30,30-34,1986,24.551943098169115
SIM,1824,38,15-19,1862,1
STAT,1851,105,na,1956,0.028802238555446856
SIM,1813,89,na,1902,37
STAT,1959,37,25-29,1996,1.5312975447018269
STAT,1917,45,15-19,1962,4.461387493945932E-4
SIM,1904,31,40-44,1935,11
STAT,1954,32,40-44,1986,5.690898174183814
STAT,1893,39,na,1932,3402.11864057913
STAT,1956,41,40-44,1997,0.3975174763215133
SIM,1924,36,20-24,1960,3
STAT,1915,21,50-100,1936,0.7874504750782605
STAT,1948,47,20-24,1995,0.015180910979978514
SIM,1863,23,30-34,1886,3
SIM,1913,24,na,1937,4568
STAT,1816,42,50-100,1858,2.392854249532524
SIM,1993,19,30-34,2012,56
STAT,1894,27,30-34,1921,37.35833548707602
SIM,1947,32,45-49,1979,1
SIM,1913,28,50-100,1941,4
SIM,1863,32,na,1895,2523
STAT,1900,44,15-19,1944,0.001514943997912682
SIM,1903,19,35-39,1922,3
STAT,1800,94,na,1894,10.784223216888735
SIM,1962,21,30-34,1983,50
STAT,1937,36,35-39,1973,2.795276047511478
STAT,1969,46,40-44,2015,0.23700480527941145
SIM,1882,23,35-39,1905,12
SIM,1969,22,25-29,1991,4
STAT,1789,99,na,1888,0.30150046894803156
STAT,1937,47,45-49,1984,0.2533559829371273
STAT,1883,106,na,1989,0.6920078689789154
STAT,1931,15,35-39,1946,6.369261844644166
STAT,1956,44,35-39,2000,0.3185033870590199
SIM,1926,21,20-24,1947,322
STAT,1862,50,50-100,1912,0.01492043257192363
STAT,1878,40,15-19,1918,0.016808136893272208
STAT,1857,106,na,1963,0.05068927133194213
STAT,1822,47,35-39,1869,0.2646136778320864
STAT,1873,43,40-44,1916,2.6316003351435566
SIM,1907,27,25-29,1934,14
STAT,1906,40,45-49,1946,0.1766651943612874
SIM,1945,64,na,2009,4041
SIM,1934,46,30-34,1980,1
STAT,1951,43,25-29,1994,0.10182249731284948
STAT,1971,33,20-24,2004,3.63187962328591
STAT,1942,19,20-24,1961,163.42536152728192
STAT,1946,37,15-19,1983,0.025323471003445324
STAT,1921,45,35-39,1966,0.16846158005637063
STAT,1821,56,na,1877,1358.9305230695163
STAT,1829,36,na,1865,2024.642721117485
STAT,1787,95,na,1882,2.0830528371396513
SIM,1926,71,na,1997,4346
STAT,1962,42,30-34,2004,0.196459733471249
SIM,1881,43,40-44,1924,4
STAT,1906,42,35-39,1948,0.21135481323542168
STAT,1951,26,na,1977,5172.680503043216
STAT,1858,50,45-49,1908,0.013253077351640857
SIM,1940,30,45-49,1970,6
STAT,1931,26,45-49,1957,2.575735370052563
SIM,1998,9,na,2007,6865
STAT,1918,21,20-24,1939,138.78890619385822
STAT,1818,73,na,1891,525.5344443877377
STAT,1898,30,na,1928,3751.7994197741964
STAT,1971,44,30-34,2015,0.1935531911147435
SIM,1949,41,45-49,1990,1
STAT,1898,42,50-100,1940,0.1142806871768986
SIM,1914,42,35-39,1956,2
SIM,1964,30,30-34,1994,58
STAT,1923,26,50-100,1949,1.3228488882190599
SIM,1999,13,na,2012,6971
STAT,1973,32,35-39,2005,13.902996888224303
SIM,1887,27,35-39,1914,2
STAT,1879,27,35-39,1906,11.627140946237292
STAT,1865,34,50-100,1899,0.9458780817460881
SIM,1958,33,na,1991,6016
STAT,1940,67,na,2007,3763.480855129733
STAT,1974,14,na,1988,5917.243857312647
SIM,1840,28,50-100,1868,4
STAT,1842,21,50-100,1863,0.39866297001204243
STAT,1905,36,45-49,1941,0.7221597414896066
STAT,1926,46,30-34,1972,0.12722905919301997
STAT,1852,45,25-29,1897,0.0548474612801423
SIM,1981,32,35-39,2013,2
STAT,1852,33,na,1885,2305.383816759443
SIM,1882,9,na,1891,3564
STAT,1877,16,15-19,1893,7.141598266706136
STAT,1914,27,20-24,1941,21.246692954496027
SIM,1887,42,na,1929,3675
SIM,1876,37,30-34,1913,2
STAT,1912,14,na,1926,4598.18742880232
SIM,1803,71,na,1874,1028
STAT,1932,30,45-49,1962,2.417404007133054
STAT,1965,22,45-49,1987,1.6264604411071113
STAT,1920,65,na,1985,4083.603458066129
SIM,1844,19,30-34,1863,7
STAT,1893,48,20-24,1941,0.009749997245631964
STAT,1846,36,40-44,1882,4.775098919536429
SIM,1889,20,40-44,1909,4
STAT,1872,23,25-29,1895,66.13136177415632
STAT,1972,29,na,2001,5553.7592979696165
SIM,1939,38,na,1977,4911
STAT,1799,77,na,1876,468.7908945944384
SIM,1922,27,20-24,1949,2
SIM,1943,60,na,2003,4962
SIM,1900,29,35-39,1929,2
STAT,1967,47,15-19,2014,5.523525279969771E-4
STAT,1866,24,45-49,1890,0.7412288438279112
SIM,1926,50,na,1976,5699
STAT,1876,43,na,1919,2737.3423290602504
STAT,1942,52,na,1994,4531.7986092567035
STAT,1920,25,30-34,1945,49.91875238098826
STAT,1874,46,15-19,1920,4.739202352025655E-4
STAT,1944,9,na,1953,4895.039999739351
SIM,1828,63,na,1891,1554
STAT,1868,37,30-34,1905,5.909263302300531
STAT,1889,33,50-100,1922,1.297922322779013
SIM,1839,63,na,1902,1482
SIM,1977,28,50-100,2005,2
STAT,1909,10,na,1919,4488.049378609298
STAT,1870,29,50-100,1899,0.7225918266778953
STAT,1882,45,40-44,1927,0.1949031278147852
STAT,1925,17,25-29,1942,60.39345809649665
STAT,1837,34,40-44,1871,3.8563996479059215
STAT,1804,105,na,1909,0.012748598185622101
STAT,1929,27,50-100,1956,1.4376722462981308
SIM,1924,29,20-24,1953,45
STAT,1921,40,40-44,1961,0.3259009984853797
SIM,1810,78,na,1888,175
SIM,1902,99,na,2001,20
STAT,1916,29,20-24,1945,21.627919066590977
SIM,1823,42,40-44,1865,2
STAT,1979,21,50-100,2000,1.0493444521359456
STAT,1859,58,na,1917,1818.0146832018133
STAT,1853,18,na,1871,2732.9779316220006
STAT,1922,24,45-49,1946,1.4791181502517963
STAT,1842,28,15-19,1870,0.4286582937922485
SIM,1933,17,25-29,1950,1
STAT,1836,19,30-34,1855,2.108925117440282
STAT,1915,97,na,2012,124.85084196882974
SIM,1850,28,15-19,1878,1
SIM,1970,31,20-24,2001,2
STAT,1954,24,35-39,1978,13.468598027364497
STAT,1939,45,20-24,1984,0.013346523139666656
STAT,1856,47,na,1903,1971.63576615961
STAT,1877,53,50-100,1930,0.017838922070554347
STAT,1818,52,na,1870,1148.9105938838184
STAT,1870,26,30-34,1896,28.748375868910998
STAT,1924,33,20-24,1957,3.2811513543583635
STAT,1849,17,50-100,1866,0.04674057419609501
SIM,1958,35,25-29,1993,2
SIM,1904,23,35-39,1927,20
STAT,1940,42,na,1982,4523.981049220713
SIM,1904,34,45-49,1938,4
STAT,1936,75,na,2011,2788.0283218373984
SIM,1880,23,25-29,1903,87
SIM,1909,24,30-34,1933,3
STAT,1943,43,20-24,1986,0.022427101020254088
SIM,1956,48,na,2004,5325
STAT,1892,19,15-19,1911,8.537904121331152
STAT,1955,19,na,1974,5635.192001324038
STAT,1855,35,50-100,1890,1.054602305429762
STAT,1811,48,40-44,1859,0.5247412855209788
SIM,1903,16,30-34,1919,4
STAT,1909,31,50-100,1940,0.9152705318478865
SIM,1886,31,25-29,1917,22
SIM,1868,1,na,1869,3707
STAT,1855,26,35-39,1881,8.619685063306527
STAT,1962,19,50-100,1981,0.5536242805530165
STAT,1831,55,na,1886,1650.4832536960812
SIM,1962,24,35-39,1986,1
SIM,1978,27,40-44,2005,14
SIM,1904,47,na,1951,3940
STAT,1846,30,20-24,1876,3.3715493191343655
SIM,1901,36,na,1937,4099
SIM,1962,33,25-29,1995,28
STAT,1927,60,na,1987,4954.7698351102235
STAT,1940,17,20-24,1957,158.91132507222483
STAT,1954,35,45-49,1989,1.0037382080271426
STAT,1870,73,na,1943,1351.3349280775597
STAT,1877,18,35-39,1895,0.6569693242274024
STAT,1939,26,na,1965,4349.90342963206
SIM,1853,70,na,1923,1118
STAT,1911,23,30-34,1934,31.386660352438636
STAT,1861,8,na,1869,2707.9105185368735
SIM,1895,0,na,1895,4367
SIM,1960,39,35-39,1999,6
STAT,1876,46,25-29,1922,0.06891067768179551
STAT,1964,42,40-44,2006,0.37782504331522154
SIM,1863,26,35-39,1889,17
SIM,1943,34,35-39,1977,1
STAT,1856,50,35-39,1906,0.0076887654398631825
STAT,1952,39,35-39,1991,3.4388966604277704
STAT,1932,43,45-49,1975,0.2599661029100598
STAT,1842,18,na,1860,2254.930494170478
STAT,1996,17,40-44,2013,2.3458887680160165
STAT,1905,98,na,2003,76.21243604639918
STAT,1868,22,20-24,1890,76.40794221570336
STAT,1811,46,20-24,1857,0.03804203232822047
STAT,1878,31,25-29,1909,12.392319769772522
STAT,1905,22,30-34,1927,29.752254124494534
SIM,1951,34,30-34,1985,5
STAT,1932,32,35-39,1964,14.022962950963244
SIM,1898,25,45-49,1923,2
STAT,1844,36,30-34,1880,5.230567241376035
STAT,1935,34,35-39,1969,14.579536006729077
SIM,1876,22,20-24,1898,2
SIM,1819,44,40-44,1863,1
SIM,1859,28,35-39,1887,28
STAT,1928,34,35-39,1962,13.169517928361676
SIM,1940,32,35-39,1972,15
STAT,1950,23,20-24,1973,152.18120958490138
SIM,1777,89,na,1866,71
STAT,1978,24,50-100,2002,1.039040433682048
SIM,1917,31,50-100,1948,4
STAT,1865,43,na,1908,2389.2077467675385
STAT,1905,33,40-44,1938,4.141788619468078
STAT,1928,45,45-49,1973,0.3215305613158101
STAT,1957,31,50-100,1988,1.2830756554338574
STAT,1765,89,na,1854,3.0
STAT,1962,6,na,1968,5812.941687833501
SIM,1830,45,na,1875,1749
SIM,1839,30,25-29,1869,15
SIM,1852,36,30-34,1888,3
STAT,1829,36,35-39,1865,8.282380350532627
SIM,1935,25,40-44,1960,19
SIM,1841,38,20-24,1879,1
SIM,1948,34,na,1982,4286
STAT,1868,102,na,1970,2.842665848950495
SIM,1882,83,na,1965,1026
STAT,1833,38,20-24,1871,0.6763535098137768
SIM,1841,49,30-34,1890,1
STAT,1842,55,na,1897,1591.1577685756206
STAT,1965,18,na,1983,5301.393278465245
SIM,1859,37,25-29,1896,2
STAT,1928,43,25-29,1971,0.10488927410675287
STAT,1959,34,20-24,1993,3.7484141370609905
STAT,1813,42,30-34,1855,4.319474232242394
SIM,1979,34,45-49,2013,1
SIM,1852,20,15-19,1872,3
STAT,1822,38,45-49,1860,4.612492163486684
STAT,1941,49,30-34,1990,0.10960243137447101
SIM,1913,22,30-34,1935,78
SIM,1851,5,na,1856,3353
STAT,1844,81,na,1925,452.30766487371193
STAT,1943,34,30-34,1977,19.6300141855257
SIM,1874,29,15-19,1903,1
STAT,1820,34,25-29,1854,34.86785163825873
STAT,1921,42,30-34,1963,0.1661160796069833
SIM,1849,25,na,1874,2831
STAT,1841,24,50-100,1865,0.4527226278017004
SIM,1922,19,15-19,1941,121
STAT,1833,49,30-34,1882,0.07125910878744059
STAT,1976,22,20-24,1998,172.00662908317685
STAT,1922,21,40-44,1943,4.461327889673333
STAT,1887,86,na,1973,704.0661036062572
STAT,1916,23,45-49,1939,1.3565865685326028
STAT,1843,99,na,1942,1.9002701257416017
SIM,1826,37,na,1863,2008
SIM,1882,20,30-34,1902,1
SIM,1887,24,30-34,1911,3
STAT,1873,46,45-49,1919,0.27891324971354153
STAT,1822,44,30-34,1866,2.227244032710613
STAT,1891,35,na,1926,3392.2869365562065
STAT,1971,36,25-29,2007,1.4840474182746688
STAT,1961,24,35-39,1985,14.075951267754242
STAT,1971,8,na,1979,5744.508725388721
STAT,1925,75,na,2000,3405.4294076365013
STAT,1882,48,45-49,1930,0.2626801551726764
STAT,1824,32,35-39,1856,24.00966327526901
STAT,1879,24,30-34,1903,21.329768239346205
SIM,1848,40,na,1888,1755
STAT,1890,50,na,1940,3079.9414960530808
STAT,1926,49,35-39,1975,0.18247675057399118
SIM,1890,48,45-49,1938,1
STAT,1927,25,40-44,1952,6.582309350571987
SIM,1971,15,na,1986,5810
SIM,1828,43,25-29,1871,5
SIM,1804,53,na,1857,1158
SIM,1965,24,15-19,1989,9
STAT,1818,49,35-39,1867,0.1679250699719719
STAT,1907,21,45-49,1928,1.187609083429031
SIM,1924,23,45-49,1947,6
STAT,1966,37,50-100,2003,0.6234944600136862
STAT,1926,30,15-19,1956,0.17948679280854277
SIM,1889,23,45-49,1912,2
STAT,1869,54,30-34,1923,0.0064696761541653
STAT,1930,41,50-100,1971,0.17866576800033832
SIM,1930,21,40-44,1951,7
SIM,1909,33,20-24,1942,5
STAT,1954,30,20-24,1984,3.551126622923946
SIM,1817,63,na,1880,839
SIM,1794,74,na,1868,334
SIM,1897,20,na,1917,4124
SIM,1798,88,na,1886,37
SIM,1952,3,na,1955,4848
SIM,1821,38,50-100,1859,1
SIM,1900,22,20-24,1922,114
STAT,1906,39,na,1945,3955.8720032501133
STAT,1956,48,20-24,2004,0.017504687689031177
STAT,1962,45,35-39,2007,0.19923367560998453
STAT,1943,20,50-100,1963,0.8085407924732934
SIM,1890,40,35-39,1930,3
SIM,1951,20,50-100,1971,5
STAT,1887,6,na,1893,3378.6218142654725
STAT,1969,32,15-19,2001,0.1888356725000751
SIM,1854,55,na,1909,2197
SIM,1963,17,40-44,1980,2
STAT,1902,44,25-29,1946,0.07173260482473018
STAT,1919,49,na,1968,4570.533087249608
SIM,1992,18,na,2010,7014
STAT,1938,15,45-49,1953,0.5715999092634657
SIM,1914,87,na,2001,157
STAT,1881,16,35-39,1897,0.6122842120251841
SIM,1975,38,25-29,2013,5
SIM,1888,44,35-39,1932,5
STAT,1807,48,20-24,1855,0.048931778194944035
SIM,1970,34,25-29,2004,2
STAT,1955,17,40-44,1972,2.1428494226652854
STAT,1918,64,na,1982,3994.6827215888006
STAT,1960,46,20-24,2006,0.017320598057980682
STAT,1857,20,25-29,1877,60.26174406672439
SIM,1852,29,na,1881,2010
STAT,1914,19,15-19,1933,10.781100060647043
STAT,1910,49,50-100,1959,0.24235697471779744
STAT,1931,23,40-44,1954,5.018236763627592
STAT,1872,20,20-24,1892,80.33241606860253
SIM,1878,22,30-34,1900,54
STAT,1906,61,na,1967,3435.76960225057
STAT,1847,17,40-44,1864,0.1756518331529654
STAT,1882,40,35-39,1922,2.0617726635044096
STAT,1967,38,25-29,2005,1.4608330525246613
STAT,1948,63,na,2011,4534.026520281749
SIM,1950,16,na,1966,4816
SIM,1931,72,na,2003,4370
STAT,1878,4,na,1882,3474.4152031276253
SIM,1900,38,25-29,1938,2
STAT,1808,74,na,1882,641.4580934036164
STAT,1880,46,45-49,1926,0.28950456214505
STAT,1956,34,50-100,1990,1.2853139652330081
STAT,1850,22,35-39,1872,7.210290927209048
STAT,1888,31,na,1919,3250.438238918622
SIM,1795,59,na,1854,1335
STAT,1841,33,na,1874,2313.733811152198
STAT,1953,15,40-44,1968,1.9537190581495587
STAT,1864,98,na,1962,9.099904015937913
SIM,1959,15,na,1974,5278
SIM,1883,12,na,1895,2778
STAT,1934,19,25-29,1953,67.31522911204588
STAT,1918,36,30-34,1954,2.2271559537472667
STAT,1836,50,25-29,1886,0.0033945666018158687
STAT,1883,77,na,1960,1166.021979114856
STAT,1818,36,na,1854,1372.341753372525
STAT,1852,49,35-39,1901,0.1292379491844629
SIM,1956,31,40-44,1987,18
STAT,1866,36,15-19,1902,0.060355496328496586
STAT,1838,50,na,1888,1930.1238100384755
SIM,1925,47,50-100,1972,1
SIM,1800,60,na,1860,1249
SIM,1893,49,30-34,1942,1
STAT,1891,20,25-29,1911,82.1376296797515
STAT,1880,43,40-44,1923,2.731531411824188
SIM,1942,19,25-29,1961,138
STAT,1905,28,50-100,1933,1.0647313825951237
STAT,1983,9,na,1992,6415.3233064947035
SIM,1860,49,35-39,1909,1
STAT,1963,37,35-39,2000,3.6535381923466743
SIM,1974,29,30-34,2003,78
STAT,1930,20,30-34,1950,42.75048442569013
STAT,1982,31,30-34,2013,26.094684159852466
STAT,1919,15,40-44,1934,0.35946100030693706
STAT,1861,24,30-34,1885,17.305229007995777
STAT,1870,19,30-34,1889,1.8091564800452657
STAT,1898,8,na,1906,4054.4611243639138
SIM,1939,7,na,1946,5079
SIM,1821,68,na,1889,723
STAT,1915,31,45-49,1946,1.857394839285794
STAT,1851,32,na,1883,1969.5787858536512
SIM,1793,73,na,1866,750
STAT,1871,43,30-34,1914,1.310429280711058
STAT,1873,51,25-29,1924,0.004194198330847361
STAT,1909,41,30-34,1950,0.13895011879882316
SIM,1926,36,30-34,1962,2
STAT,1856,63,na,1919,1570.9893875656162
STAT,1943,37,35-39,1980,3.0498489796858603
SIM,1842,19,20-24,1861,39
STAT,1877,5,na,1882,3275.3016640056994
STAT,1944,26,30-34,1970,48.89656364402723
STAT,1952,22,50-100,1974,0.912995323261159
SIM,1920,31,na,1951,4320
SIM,1875,70,na,1945,1768
SIM,1969,36,40-44,2005,7
SIM,1899,46,30-34,1945,1
STAT,1962,31,30-34,1993,23.76075777660483
SIM,1832,71,na,1903,1153
SIM,1927,15,40-44,1942,4
STAT,1892,26,15-19,1918,0.6585030131646764
SIM,1988,8,na,1996,6634
STAT,1960,44,30-34,2004,0.19903704004194891
STAT,1928,86,na,2014,1585.1339998833237
STAT,1929,37,45-49,1966,1.010084055780508
STAT,1947,42,45-49,1989,0.22484019783795037
STAT,1854,40,50-100,1894,0.8693728199105485
SIM,1899,38,50-100,1937,1
STAT,1925,34,na,1959,5174.673182447569
STAT,1850,50,na,1900,2248.4229959584304
SIM,1971,37,35-39,2008,3
STAT,1926,31,20-24,1957,3.404988591622581
SIM,1888,43,na,1931,2638
SIM,1888,31,50-100,1919,1
STAT,1958,21,na,1979,5555.286747116751
SIM,1912,30,30-34,1942,5
STAT,1878,48,50-100,1926,0.29221862519116454
STAT,1849,43,50-100,1892,0.8129072943231549
SIM,1915,88,na,2003,1754
SIM,1876,25,50-100,1901,3
STAT,1786,73,na,1859,820.6529477539256
SIM,1915,37,25-29,1952,1
SIM,1910,59,na,1969,3125
STAT,1957,24,15-19,1981,8.12082064379054
STAT,1835,34,30-34,1869,13.593488415246789
STAT,1927,40,50-100,1967,0.17046828989703092
STAT,1904,30,30-34,1934,29.167159066900467
SIM,1867,75,na,1942,960
SIM,1870,79,na,1949,1176
STAT,1995,17,na,2012,6148.838853935844
STAT,1948,31,40-44,1979,5.271148003055858
STAT,1939,48,25-29,1987,0.06358594058294563
SIM,1990,14,na,2004,6329
STAT,1854,53,40-44,1907,0.00843913385164039
STAT,1853,29,40-44,1882,3.099084941312068
SIM,1934,31,20-24,1965,1
STAT,1923,57,na,1980,4740.230931225296
SIM,1873,30,25-29,1903,2
STAT,1970,19,35-39,1989,6.057820525079459
SIM,1843,65,na,1908,1317
SIM,1902,23,25-29,1925,3
SIM,1941,27,25-29,1968,137
SIM,1843,34,30-34,1877,10
STAT,1818,45,25-29,1863,0.07316382587576546
STAT,1765,104,na,1869,0.0027680745597962785
STAT,1941,68,na,2009,3737.36859840578
STAT,1844,29,30-34,1873,25.4153799427268
SIM,1889,28,15-19,1917,1
STAT,1992,19,30-34,2011,20.177047207796985
STAT,1805,63,na,1868,1086.912807567375
SIM,1847,40,25-29,1887,1
SIM,1868,17,15-19,1885,8
SIM,1981,26,50-100,2007,3
STAT,1952,21,20-24,1973,154.33799486427483
STAT,1809,45,15-19,1854,0.0010257816300626125
SIM,1977,34,35-39,2011,30
SIM,1877,17,25-29,1894,16
SIM,1852,29,30-34,1881,46
SIM,1920,15,30-34,1935,15
SIM,1924,20,40-44,1944,8
SIM,1976,16,30-34,1992,21
STAT,1846,33,50-100,1879,1.1077892070702515
SIM,1960,21,20-24,1981,3
SIM,1907,23,15-19,1930,10
SIM,1916,29,25-29,1945,92
SIM,1897,33,50-100,1930,2
SIM,1911,20,30-34,1931,1
STAT,1854,32,15-19,1886,0.11881056523183736
STAT,1873,39,50-100,1912,1.4323201603945936
SIM,1772,93,na,1865,6
STAT,1831,71,na,1902,1047.2406163269534
STAT,1978,26,30-34,2004,62.00598304529477
STAT,1841,35,50-100,1876,1.3130768233438879
STAT,1916,20,40-44,1936,4.090721218788344
STAT,1907,37,25-29,1944,1.055205378389048
STAT,1776,89,na,1865,52.11928946462035
SIM,1852,35,25-29,1887,7
STAT,1832,28,50-100,1860,0.598400798697723
STAT,1848,34,40-44,1882,4.789479061052705
STAT,1978,23,na,2001,5768.569983204236
STAT,1966,27,20-24,1993,26.425395220613815
SIM,1936,34,35-39,1970,21
STAT,1952,14,na,1966,5430.500741199103
SIM,1926,28,na,1954,5515
SIM,1905,26,45-49,1931,2
STAT,1923,6,na,1929,5429.436067158491
SIM,1986,26,30-34,2012,149
STAT,1977,16,40-44,1993,2.1816212124498455
SIM,1931,26,50-100,1957,6
STAT,1874,24,40-44,1898,2.4464982086119322
SIM,1913,61,na,1974,3984
STAT,1908,29,25-29,1937,71.38431977274789
STAT,1899,41,35-39,1940,0.19971385658599108
STAT,1868,25,25-29,1893,47.22064755370265
SIM,1921,30,40-44,1951,10
STAT,1883,45,50-100,1928,0.28006967744893463
STAT,1848,40,35-39,1888,1.9715470993665758
STAT,1901,100,na,2001,32.87575557027212
SIM,1856,38,na,1894,2101
STAT,1968,16,30-34,1984,17.57402831497896
STAT,1849,50,35-39,1899,0.0067684963647200395
STAT,1991,16,45-49,2007,0.8264136260535295
SIM,1878,25,35-39,1903,34
STAT,1957,43,na,2000,5863.4244067354275
STAT,1885,49,30-34,1934,0.10910085793131911
STAT,1895,35,40-44,1930,6.638301235174086
STAT,1938,36,50-100,1974,0.49310987004920526
SIM,1901,98,na,1999,33
STAT,1920,37,50-100,1957,0.5302795763888869
STAT,1906,45,na,1951,3824.6494703477865
STAT,1881,53,40-44,1934,0.01153047780749792
SIM,1959,21,na,1980,5211
SIM,1981,20,40-44,2001,6
STAT,1987,26,40-44,2013,7.715723503686616
STAT,1970,41,20-24,2011,0.026551934073927287
STAT,1861,49,45-49,1910,0.22169262568612938
STAT,1974,24,45-49,1998,1.6999997848723039
SIM,1833,44,50-100,1877,3
STAT,1869,17,25-29,1886,6.420881679984454
STAT,1902,41,20-24,1943,0.01806442847282108
STAT,1984,23,20-24,2007,182.79701259455413
STAT,1912,15,30-34,1927,2.860348367175911
STAT,1823,52,40-44,1875,0.010019174253289334
STAT,1826,31,na,1857,1642.9021968812021
STAT,1969,34,35-39,2003,13.411392306408692
SIM,1876,36,na,1912,2583
SIM,1831,46,na,1877,1644
SIM,1884,87,na,1971,285
STAT,1885,20,na,1905,2738.6729165194174
SIM,1817,44,30-34,1861,1
STAT,1933,27,25-29,1960,100.90358575587423
SIM,1856,40,35-39,1896,3
STAT,1813,98,na,1911,1.4874169770375603
STAT,1830,52,40-44,1882,0.008540303771784887
STAT,1913,30,40-44,1943,4.531758957464514
STAT,1816,45,15-19,1861,8.407353022591341E-4
SIM,1838,25,na,1863,1949
SIM,1846,16,25-29,1862,6
STAT,1961,25,na,1986,5614.536632164772
STAT,1894,28,50-100,1922,0.9456682259767871
STAT,1909,44,35-39,1953,0.21493020392714976
STAT,1861,25,15-19,1886,0.44481251295031293
STAT,1784,90,na,1874,31.48593379491387
STAT,1871,46,35-39,1917,0.16119405545119903
SIM,1979,33,30-34,2012,33
SIM,1984,26,20-24,2010,34
STAT,1935,74,na,2009,4133.708335301861
STAT,1785,91,na,1876,12.398095410742979
STAT,1883,93,na,1976,171.25833934988984
STAT,1895,40,20-24,1935,0.2409748958031714
STAT,1820,43,15-19,1863,0.016519168706332785
SIM,1857,17,15-19,1874,9
STAT,1888,15,na,1903,3442.091620857876
SIM,1934,34,25-29,1968,33
STAT,1885,33,15-19,1918,0.16323502112255378
STAT,1770,92,na,1862,5.0542503961469265
STAT,1884,40,45-49,1924,1.723719746458244
STAT,1892,54,na,1946,3028.854313247919
SIM,1938,18,20-24,1956,153
STAT,1984,20,40-44,2004,5.533145088783837
SIM,1922,24,50-100,1946,2
STAT,1838,16,25-29,1854,6.523327532292879
STAT,1810,72,na,1882,751.8411059278703
STAT,1823,109,na,1932,4.0289101029622525E-4
STAT,1976,26,20-24,2002,28.27829721042565
STAT,1776,95,na,1871,3.626633859652297
STAT,1863,79,na,1942,705.4742129352003
STAT,1923,16,45-49,1939,0.6783536691477575
SIM,1867,59,na,1926,1875
STAT,1937,33,30-34,1970,17.9871629340504
STAT,1857,27,15-19,1884,0.4200328195613578
STAT,1889,96,na,1985,109.09741605776007
STAT,1963,23,30-34,1986,42.26460158785004
SIM,1821,33,40-44,1854,4
STAT,1908,26,20-24,1934,20.17778550448497
SIM,1856,81,na,1937,461
STAT,1869,50,20-24,1919,8.365561936159478E-4
SIM,1809,49,40-44,1858,1
STAT,1831,26,40-44,1857,3.145347015788197
STAT,1845,53,30-34,1898,0.0039467512972646696
STAT,1904,42,25-29,1946,0.07380889855304179
STAT,1876,30,45-49,1906,2.097065092899299
SIM,1884,30,45-49,1914,6
STAT,1914,24,50-100,1938,0.7713112015022844
STAT,1881,36,na,1917,2635.129018053944
STAT,1905,17,50-100,1922,0.08183222861290264
STAT,1914,40,na,1954,4278.711725797968
SIM,1892,40,45-49,1932,6
STAT,1849,17,15-19,1866,5.661842699994033
STAT,1929,34,40-44,1963,5.729399543530204
SIM,1992,20,40-44,2012,11
STAT,1960,47,35-39,2007,0.20157249400390786
SIM,1850,19,na,1869,2096
STAT,1947,38,50-100,1985,0.5617341809417454
SIM,1955,38,50-100,1993,1
STAT,1847,53,40-44,1900,0.007970482770606092
SIM,1945,33,30-34,1978,3
STAT,1835,35,15-19,1870,0.044251252298252275
STAT,1897,41,25-29,1938,0.06912386658674492
STAT,1938,23,50-100,1961,0.7516580375875169
SIM,1848,20,30-34,1868,23
STAT,1932,48,15-19,1980,5.752161995445687E-4
STAT,1835,48,na,1883,1459.1626736000771
STAT,1896,10,na,1906,3948.3979239125215
STAT,1898,92,na,1990,363.84818466401856
STAT,1920,29,40-44,1949,5.856015857735275
STAT,1926,34,25-29,1960,12.878289644401754
SIM,1916,26,20-24,1942,2
STAT,1929,64,na,1993,4866.916640950974
SIM,1856,34,40-44,1890,6
STAT,1842,35,15-19,1877,0.05175508702055935
SIM,1959,26,40-44,1985,1
SIM,1881,39,50-100,1920,2
STAT,1901,47,50-100,1948,0.22290161851584556
SIM,1895,30,20-24,1925,9
SIM,1969,39,45-49,2008,4
STAT,1893,103,na,1996,6.535701896624215
SIM,1978,10,na,1988,6039
STAT,1841,95,na,1936,11.820932221474761
STAT,1907,34,20-24,1941,2.6128570208495248
SIM,1930,31,50-100,1961,2
SIM,1930,71,na,2001,4720
STAT,1948,34,45-49,1982,2.1156021207850357
STAT,1831,37,40-44,1868,4.328787215238701
SIM,1847,21,na,1868,2770
STAT,1869,45,40-44,1914,0.19324206589427756
STAT,1874,82,na,1956,591.2047631360251
STAT,1896,15,35-39,1911,0.8402757088424024
SIM,1797,69,na,1866,602
SIM,1832,22,na,1854,2441
SIM,1834,88,na,1922,164
SIM,1895,38,40-44,1933,20
STAT,1887,38,40-44,1925,5.63344396397668
STAT,1881,23,35-39,1904,6.475571152121137
SIM,1915,34,20-24,1949,1
STAT,1961,21,30-34,1982,43.0090119522641
SIM,1956,34,45-49,1990,4
STAT,1922,31,50-100,1953,1.0820166394411597
SIM,1877,45,40-44,1922,1
SIM,1803,65,na,1868,1162
STAT,1879,28,40-44,1907,3.5970048738332725
STAT,1841,40,25-29,1881,0.6086715736356261
STAT,1952,24,25-29,1976,128.07913183086356
SIM,1976,19,35-39,1995,7
STAT,1929,70,na,1999,4307.5826590289
STAT,1916,36,20-24,1952,0.31306747107053345
SIM,1906,73,na,1979,2319
STAT,1915,3,na,1918,4883.93876826782
STAT,1936,41,30-34,1977,0.14640451871399637
STAT,1799,107,na,1906,0.0021183345620544316
STAT,1901,24,na,1925,3799.127225664895
SIM,1941,24,20-24,1965,210
STAT,1898,47,15-19,1945,3.5027489273897674E-4
SIM,1943,45,50-100,1988,1
STAT,1902,49,40-44,1951,0.15418358713742214
STAT,1869,36,na,1905,2645.7327233325004
STAT,1839,31,35-39,1870,9.98656254205552
STAT,1930,45,45-49,1975,0.33190323630753715
SIM,1796,78,na,1874,351
STAT,1858,19,15-19,1877,6.16778851706864
SIM,1882,24,40-44,1906,5
STAT,1968,19,35-39,1987,6.044329453403722
STAT,1969,31,30-34,2000,23.165400900999753
STAT,1902,30,20-24,1932,4.443112894017916
STAT,1951,45,15-19,1996,5.290327353796027E-4
STAT,1935,31,30-34,1966,25.183127063179665
SIM,1936,31,30-34,1967,3
STAT,1875,42,na,1917,2752.980400498765
STAT,1863,41,15-19,1904,0.013998694847942727
STAT,1905,48,15-19,1953,3.7214452917997114E-4
STAT,1834,25,15-19,1859,0.5508068319089153
STAT,1834,82,na,1916,425.80340217208555
SIM,1818,64,na,1882,1664
SIM,1976,29,40-44,2005,17
SIM,1902,20,20-24,1922,214
SIM,1977,31,30-34,2008,61
STAT,1859,43,15-19,1902,0.012603732392442477
STAT,1863,32,25-29,1895,10.335916107241989
SIM,1851,60,na,1911,2308
STAT,1855,81,na,1936,460.13410702395976
SIM,1847,31,35-39,1878,35
STAT,1974,21,40-44,1995,5.08525051490383
SIM,1880,57,na,1937,2781
SIM,1823,94,na,1917,82
STAT,1896,22,50-100,1918,0.6215892523295552
STAT,1818,42,20-24,1860,0.2121797641361171
SIM,1902,21,50-100,1923,1
STAT,1883,1,na,1884,3772.9052013356127
STAT,1920,48,50-100,1968,0.28761103296884283
SIM,1929,39,na,1968,5231
SIM,1953,2,na,1955,5701
SIM,1866,19,15-19,1885,6
SIM,1973,37,45-49,2010,2
STAT,1876,31,15-19,1907,0.1705836188720821
STAT,1982,28,na,2010,6106.821345586504
SIM,1852,32,20-24,1884,4
STAT,1878,33,15-19,1911,0.17087078778263268
SIM,1838,19,na,1857,2151
SIM,1909,16,na,1925,4939
STAT,1865,49,20-24,1914,0.012234185731035742
SIM,1908,31,na,1939,4011
STAT,1987,26,50-100,2013,1.647666269789053
STAT,1860,45,20-24,1905,0.011272577670566835
STAT,1815,50,25-29,1865,0.0072323883656412735
STAT,1820,38,35-39,1858,10.175988677170666
STAT,1916,23,na,1939,4402.862338619149
STAT,1930,32,25-29,1962,13.767220955342646
STAT,1827,39,40-44,1866,6.06298434120428
SIM,1835,39,40-44,1874,4
STAT,1933,24,20-24,1957,170.17486806066938
SIM,1981,23,45-49,2004,5
STAT,1911,26,35-39,1937,16.96936367704121
SIM,1977,32,na,2009,5998
SIM,1926,34,na,1960,5781
STAT,1913,33,45-49,1946,1.8000907653647256
SIM,1845,42,25-29,1887,4
SIM,1921,33,45-49,1954,2
SIM,1901,18,30-34,1919,7
SIM,1943,31,30-34,1974,27
STAT,1844,32,20-24,1876,2.7036580854438066
STAT,1872,49,20-24,1921,0.013615288123307227
STAT,1865,23,50-100,1888,0.4266899943386428
SIM,1902,39,40-44,1941,3
STAT,1846,85,na,1931,283.39526649073116
STAT,1965,37,45-49,2002,1.0119010174686525
SIM,1960,24,25-29,1984,3
SIM,1871,9,na,1880,2445
SIM,1837,43,35-39,1880,2
STAT,1860,15,15-19,1875,6.4417322477974395
STAT,1957,18,20-24,1975,206.22111653429997
STAT,1894,39,50-100,1933,1.8030728953033182
SIM,1912,19,45-49,1931,3
STAT,1850,48,30-34,1898,0.0983982663219752
STAT,1884,41,15-19,1925,0.01581750561482991
SIM,1939,47,50-100,1986,1
SIM,1950,26,20-24,1976,44
SIM,1918,15,30-34,1933,3
STAT,1837,42,25-29,1879,0.5487066229222227
STAT,1942,26,20-24,1968,22.123518488943756
STAT,1944,70,na,2014,3719.968703401463
STAT,1934,16,20-24,1950,212.25323326870935
STAT,1912,18,35-39,1930,0.9775881184907378
SIM,1965,18,20-24,1983,1
STAT,1829,43,35-39,1872,1.9032538833087451
SIM,1864,33,na,1897,2657
STAT,1926,17,50-100,1943,0.5299981902931594
STAT,1942,46,na,1988,4620.817460893512
STAT,1850,26,50-100,1876,0.7805611997534159
STAT,1975,31,na,2006,5872.733640981988
SIM,1863,33,35-39,1896,17
STAT,1886,43,15-19,1929,0.01668942163052523
STAT,1994,19,40-44,2013,2.3277817349288594
SIM,1849,40,35-39,1889,1
SIM,1850,29,20-24,1879,28
SIM,1858,79,na,1937,964
STAT,1878,47,na,1925,2698.3195229822086
STAT,1895,43,25-29,1938,0.06650290113212909
STAT,1842,29,20-24,1871,11.00429640190316
STAT,1976,29,25-29,2005,101.819493767461
STAT,1835,42,15-19,1877,0.010326841973852184
STAT,1867,45,30-34,1912,0.1053407149719664
STAT,1935,27,35-39,1962,23.63087356029233
STAT,1970,44,25-29,2014,0.10685086055637842
STAT,1861,93,na,1954,28.03905380878897
STAT,1855,33,35-39,1888,8.68332543592013
STAT,1830,45,40-44,1875,0.1621301423723579
STAT,1851,29,30-34,1880,23.046513824981627
STAT,1952,46,35-39,1998,0.18592634743864936
SIM,1935,40,50-100,1975,1
STAT,1872,56,na,1928,2363.5323980244266
STAT,1985,29,35-39,2014,24.7251068286823
SIM,1943,27,35-39,1970,4
SIM,1923,23,na,1946,5163
STAT,1943,41,30-34,1984,0.1628441255773469
STAT,1904,19,45-49,1923,0.10767316659620477
STAT,1828,97,na,1925,3.565554072062422
STAT,1762,109,na,1871,0.004116340324403366
STAT,1939,22,40-44,1961,3.89854497214458
SIM,1969,23,30-34,1992,55
STAT,1810,54,20-24,1864,0.0025943432494768895
STAT,1850,23,40-44,1873,2.556257451159312
SIM,1841,39,na,1880,1889
SIM,1825,77,na,1902,733
SIM,1935,30,na,1965,6191
SIM,1984,29,25-29,2013,180
SIM,1906,40,40-44,1946,1
STAT,1841,79,na,1920,621.5675947180104
SIM,1948,28,30-34,1976,116
SIM,1895,22,25-29,1917,86
SIM,1960,22,50-100,1982,4
STAT,1893,35,30-34,1928,7.848187898272261
STAT,1924,30,40-44,1954,5.291257563285766
SIM,1885,78,na,1963,1569
STAT,1869,53,25-29,1922,0.0038950237427432073
SIM,1900,97,na,1997,131
SIM,1947,22,40-44,1969,10
STAT,1969,33,20-24,2002,3.5820924029754804
STAT,1814,99,na,1913,1.180861118167365
STAT,1898,76,na,1974,2081.6441556729683
SIM,1891,63,na,1954,2405
STAT,1826,87,na,1913,97.0061177997162
STAT,1827,32,na,1859,2357.4978443470022
STAT,1909,37,35-39,1946,2.64506539384425
STAT,1861,32,15-19,1893,0.13662695098041103
STAT,1831,29,45-49,1860,1.140888207899271
SIM,1906,88,na,1994,1005
STAT,1905,60,na,1965,3428.217695695053
STAT,1861,48,30-34,1909,0.09170369676493549
SIM,1976,31,na,2007,5966
SIM,2001,10,na,2011,7320
STAT,1870,22,20-24,1892,78.40341113486072
STAT,1910,18,25-29,1928,9.893751786279534
SIM,1932,30,40-44,1962,3
SIM,1892,29,na,1921,3900
STAT,1887,22,25-29,1909,74.03706693712209
STAT,1880,39,45-49,1919,2.4139725742610807
STAT,1797,94,na,1891,5.950886159474237
STAT,1989,24,40-44,2013,5.572513700653139
STAT,1885,26,15-19,1911,0.5240534580375249
STAT,1925,81,na,2006,2435.5104293948475
SIM,1939,38,25-29,1977,3
STAT,1839,18,50-100,1857,0.05052600466774042
STAT,1852,46,30-34,1898,0.09152345675186827
STAT,1867,54,50-100,1921,0.015825540015471047
STAT,1870,34,15-19,1904,0.1606334988753256
SIM,1893,26,15-19,1919,1
STAT,1825,39,30-34,1864,8.325805014525699
STAT,1917,47,50-100,1964,0.27264619460221956
SIM,1833,39,30-34,1872,14
STAT,1930,46,15-19,1976,5.613041549412697E-4
STAT,1867,30,35-39,1897,10.999507008405548
STAT,1881,11,na,1892,2878.9557063249126
STAT,1839,20,50-100,1859,0.42156006769644816
SIM,1959,29,45-49,1988,1
SIM,1877,37,na,1914,3136
STAT,1804,87,na,1891,76.6032270545257
SIM,1990,22,40-44,2012,7
SIM,1889,25,na,1914,3939
STAT,1813,41,25-29,1854,2.5093729319802374
SIM,1830,43,25-29,1873,2
STAT,1921,46,40-44,1967,0.20554917616821694
SIM,1918,4,na,1922,4363
STAT,1969,46,na,2015,5522.58854730192
SIM,1809,68,na,1877,1011
SIM,1809,84,na,1893,162
SIM,1897,31,25-29,1928,26
SIM,1891,23,45-49,1914,1
SIM,1854,33,50-100,1887,5
STAT,1819,54,40-44,1873,0.018735285752829796
STAT,1898,21,30-34,1919,27.86534225155716
STAT,1976,21,15-19,1997,8.237132222301673
STAT,1894,80,na,1974,1530.7232810499586
STAT,1889,31,25-29,1920,14.630359718461815
SIM,1873,21,35-39,1894,20
SIM,1909,2,na,1911,5175
STAT,1945,44,45-49,1989,0.21731756282823766
SIM,1834,32,na,1866,1949
STAT,1957,20,na,1977,5578.664201464828
STAT,1884,0,na,1884,4017.6644739189896
STAT,1920,35,35-39,1955,3.060187305422024
STAT,1947,47,15-19,1994,4.980932259169485E-4
STAT,1911,30,30-34,1941,17.862693835225752
STAT,1961,7,na,1968,5860.561037504913
STAT,1982,22,40-44,2004,5.478253638029055
STAT,1883,23,45-49,1906,0.7849075266064378
SIM,1950,29,25-29,1979,3
SIM,1918,18,35-39,1936,13
STAT,1896,66,na,1962,2698.583822913902
STAT,1936,44,35-39,1980,0.22949989800962078
STAT,1854,37,na,1891,1919.4074920445908
STAT,1935,33,20-24,1968,3.894095704265965
SIM,1889,39,50-100,1928,1
STAT,1936,21,na,1957,4032.8459639784264
SIM,1916,66,na,1982,3836
STAT,1865,21,35-39,1886,6.194567752417404
STAT,1916,39,25-29,1955,1.1520244828498873
SIM,1924,39,25-29,1963,4
SIM,1858,64,na,1922,2037
SIM,1876,36,25-29,1912,8
STAT,1880,20,25-29,1900,70.44300297498748
SIM,1963,24,40-44,1987,8
STAT,1874,66,na,1940,1936.4040072817463
STAT,1955,24,40-44,1979,5.164682560253285
STAT,1970,9,na,1979,5676.880480187508
SIM,1944,44,35-39,1988,1
SIM,1868,15,25-29,1883,16
STAT,1868,36,25-29,1904,3.207725622785268
STAT,1860,68,na,1928,1421.3897611319628
STAT,1822,43,25-29,1865,1.277511205739522
STAT,1991,24,40-44,2015,5.575527545731102
SIM,1967,36,30-34,2003,1
STAT,1951,40,45-49,1991,0.2383474222346717
STAT,1891,29,na,1920,3379.6128753170337
STAT,1930,30,50-100,1960,1.232930674743629
STAT,1994,16,na,2010,6131.447180784376
STAT,1836,24,na,1860,2531.160280114808
SIM,1911,20,na,1931,5110
STAT,1816,39,20-24,1855,2.3826241484264337
SIM,1984,15,20-24,1999,438
SIM,1854,71,na,1925,1667
STAT,1845,44,40-44,1889,1.504404561952203
STAT,1919,18,45-49,1937,0.6352534729393815
SIM,1843,49,na,1892,1722
STAT,1902,33,25-29,1935,16.631395622052136
STAT,1979,18,40-44,1997,2.221821947425591
SIM,1910,33,25-29,1943,1
SIM,1833,72,na,1905,756
SIM,1875,45,30-34,1920,1
STAT,1832,54,40-44,1886,0.0073070604600060955
STAT,1942,29,25-29,1971,79.6584545433247
STAT,1976,15,20-24,1991,209.141271611518
SIM,1973,34,40-44,2007,20
STAT,1835,50,50-100,1885,0.009993040471656446
STAT,1941,45,20-24,1986,0.013731513298381957
SIM,1917,34,30-34,1951,44
STAT,1894,26,25-29,1920,62.97117765027068
SIM,1917,11,na,1928,5787
SIM,1907,17,20-24,1924,38
STAT,1990,23,na,2013,6053.305057956447
SIM,1821,41,25-29,1862,3
SIM,1866,74,na,1940,987
STAT,1911,35,25-29,1946,1.1088694908796068
STAT,1961,17,35-39,1978,6.256454503735483
STAT,1924,58,na,1982,4786.842195205117
SIM,1969,26,35-39,1995,2
SIM,1853,44,40-44,1897,4
STAT,1961,23,20-24,1984,166.28426735136088
SIM,1897,46,50-100,1943,1
SIM,1871,32,25-29,1903,3
STAT,1854,49,45-49,1903,0.18825406869485237
SIM,1944,22,na,1966,4271
STAT,1915,19,20-24,1934,32.57655057987045
SIM,1923,19,20-24,1942,209
STAT,1876,17,50-100,1893,0.05844627530329201
STAT,1825,44,50-100,1869,1.5046158932497042
SIM,1900,22,45-49,1922,2
SIM,1962,35,na,1997,5545
STAT,1950,20,40-44,1970,4.606424910715237
STAT,1823,76,na,1899,536.5031657087587
STAT,1903,41,50-100,1944,0.1211367357433991
SIM,1783,80,na,1863,381
STAT,1915,41,na,1956,4322.073416355428
SIM,1881,82,na,1963,491
STAT,1817,54,30-34,1871,0.01571506400041724
SIM,1898,36,na,1934,3870
SIM,1818,79,na,1897,588
STAT,1960,49,50-100,2009,0.3515430587538675
STAT,1841,18,15-19,1859,6.765024613453896
STAT,1899,58,na,1957,3177.5419378883703
STAT,1877,19,40-44,1896,0.2183875655063052
SIM,1857,82,na,1939,458
STAT,1882,92,na,1974,207.44006991147032
STAT,1844,44,15-19,1888,0.01153072682786392
STAT,1901,16,25-29,1917,9.182666250388408
STAT,1865,30,25-29,1895,10.750902125628732
STAT,1870,25,25-29,1895,48.453861429164576
STAT,1930,23,35-39,1953,13.879392089506188
STAT,1980,25,35-39,2005,24.17797584508806
STAT,1862,78,na,1940,760.9652452456684
SIM,1928,35,45-49,1963,7
STAT,1808,68,na,1876,1009.7421700062172
SIM,1875,30,35-39,1905,22
SIM,1845,75,na,1920,1143
STAT,1903,34,na,1937,3922.0609597961584
SIM,1807,58,na,1865,993
SIM,1971,34,30-34,2005,54
STAT,1909,34,30-34,1943,17.22143592996537
STAT,1973,41,50-100,2014,0.18248629292059376
STAT,1886,41,25-29,1927,0.7852419453896801
SIM,1958,25,20-24,1983,57
STAT,1965,15,45-49,1980,0.720100313018582
SIM,1837,21,25-29,1858,107
STAT,1828,35,50-100,1863,1.3201013556817829
STAT,1909,43,20-24,1952,0.018969821660763473
STAT,1925,18,na,1943,5116.196408486681
STAT,1820,35,30-34,1855,14.741106601521814
STAT,1900,19,50-100,1919,0.07803269279611669
STAT,1893,55,na,1948,3016.212111975791
SIM,1939,35,20-24,1974,1
STAT,1944,29,35-39,1973,18.70869088344084
SIM,1952,29,35-39,1981,22
STAT,1826,40,15-19,1866,0.01067935515714387
STAT,1844,35,25-29,1879,2.8552029707706725
STAT,1924,33,45-49,1957,2.116766630008664
SIM,1971,21,na,1992,5788
STAT,1847,16,35-39,1863,0.5300776261669248
STAT,1941,48,25-29,1989,0.06542012324616932
SIM,1908,15,na,1923,4330
STAT,1910,15,20-24,1925,31.178400924789788
STAT,1981,17,45-49,1998,0.8061167987185326
STAT,1943,44,35-39,1987,0.25527019616433555
STAT,1880,36,40-44,1916,5.380514621295892
SIM,1861,68,na,1929,1081
STAT,1985,26,30-34,2011,64.62091694101936
STAT,1900,32,20-24,1932,4.328558427657251
SIM,1964,43,na,2007,5806
STAT,1818,39,30-34,1857,7.774654232115836
SIM,1870,64,na,1934,2305
STAT,1884,59,na,1943,2215.9786083663253
STAT,1773,84,na,1857,190.82317692852
STAT,1900,42,na,1942,3709.326454196096
STAT,1904,33,35-39,1937,9.595999325592425
SIM,1842,83,na,1925,387
STAT,1860,12,na,1872,2560.8215074883637
STAT,1843,44,30-34,1887,1.1576687486432296
STAT,1891,45,15-19,1936,3.250330768711526E-4
STAT,1961,10,na,1971,5858.4514881115365
SIM,1829,26,35-39,1855,2
STAT,1847,86,na,1933,170.7235951801234
STAT,1918,20,15-19,1938,6.663718083218029
SIM,1943,33,20-24,1976,10
SIM,1846,20,20-24,1866,64
STAT,1828,42,15-19,1870,0.013284808054499025
SIM,1938,31,50-100,1969,6
SIM,2008,5,na,2013,7732
STAT,1795,68,na,1863,624.949856174831
SIM,1926,39,35-39,1965,8
STAT,1883,32,50-100,1915,1.0345257857980268
STAT,1907,48,50-100,1955,0.23227972420464763
STAT,1970,20,50-100,1990,0.9543603656726777
SIM,1826,39,30-34,1865,6
SIM,1839,43,45-49,1882,1
STAT,1821,52,30-34,1873,0.010379745967499642
STAT,1775,101,na,1876,0.1808055696462536
SIM,1891,32,50-100,1923,6
STAT,1802,107,na,1909,0.002251196612532333
STAT,1852,30,15-19,1882,0.14193135970272788
STAT,1893,20,35-39,1913,8.563112326742031
SIM,1915,48,50-100,1963,2
STAT,1841,48,20-24,1889,0.010581016280071453
STAT,1918,39,35-39,1957,2.9352550904616983
STAT,1881,17,40-44,1898,0.20359471702313206
STAT,1935,24,30-34,1959,45.16126428189813
STAT,1845,20,na,1865,1814.6094459571918
STAT,1908,17,30-34,1925,2.732037596177276
STAT,1852,18,50-100,1870,0.05553625130751197
STAT,1830,48,45-49,1878,0.214929680026934
SIM,1912,33,35-39,1945,27
STAT,1913,32,30-34,1945,18.09947652270005
SIM,1928,25,50-100,1953,3
STAT,1859,36,15-19,1895,0.05187161829521638
STAT,1839,40,25-29,1879,0.6051331174575658
STAT,1911,33,35-39,1944,10.23481081676248
SIM,1921,32,30-34,1953,11
SIM,1943,24,30-34,1967,53
SIM,1981,22,30-34,2003,125
STAT,1945,41,40-44,1986,0.32816585243632385
STAT,1940,42,35-39,1982,0.24528717231237315
STAT,1824,33,40-44,1857,8.119687921677714
STAT,1880,54,50-100,1934,0.01796627475694739
STAT,1978,29,35-39,2007,23.724586827074404
SIM,1937,69,na,2006,3285
STAT,1881,108,na,1989,0.14891294942762523
SIM,1807,49,30-34,1856,1
SIM,1905,23,40-44,1928,5
SIM,1837,37,40-44,1874,17
STAT,1936,16,50-100,1952,0.4152129131835613
SIM,1832,33,40-44,1865,12
STAT,1966,18,30-34,1984,17.563628331019437
SIM,1862,46,40-44,1908,1
STAT,1950,23,45-49,1973,1.5399129300836465
STAT,1955,27,45-49,1982,2.658162383587153
STAT,1868,33,20-24,1901,2.9844164142395875
SIM,1865,49,na,1914,2739
STAT,1854,46,40-44,1900,0.13987212202183588
SIM,1859,29,40-44,1888,6
SIM,1963,27,45-49,1990,3
STAT,1912,32,50-100,1944,0.9397842361065546
STAT,1782,80,na,1862,331.2138094814528
STAT,1946,25,45-49,1971,2.2228092915788333
SIM,1919,77,na,1996,3177
SIM,1887,34,35-39,1921,23
SIM,1901,42,na,1943,3994
STAT,1962,34,35-39,1996,13.756068604271201
STAT,1880,22,15-19,1902,4.035502234452674
STAT,1911,85,na,1996,1322.2093798682513
SIM,1933,46,50-100,1979,2
STAT,1898,24,35-39,1922,9.04450659166736
STAT,1829,37,40-44,1866,5.023662810479014
SIM,1894,55,na,1949,3351
SIM,1917,37,35-39,1954,5
STAT,1838,20,20-24,1858,78.58419878938851
SIM,1926,20,15-19,1946,9
STAT,1859,74,na,1933,1020.2338653140138
SIM,1929,17,40-44,1946,1
SIM,1977,33,20-24,2010,7
SIM,1999,8,na,2007,6974
SIM,1886,19,25-29,1905,10
STAT,1848,12,na,1860,3144.3746251009884
SIM,1897,22,35-39,1919,1
STAT,1925,46,50-100,1971,0.3169801135194869
STAT,1912,30,na,1942,4333.468843254713
SIM,1982,28,20-24,2010,84
STAT,1897,91,na,1988,436.9954728538124
STAT,1984,23,45-49,2007,1.8497124844968054
STAT,1922,29,15-19,1951,0.9148982878681439
STAT,1838,75,na,1913,891.7303795133469
STAT,1889,22,35-39,1911,8.301374617677071
STAT,1977,19,45-49,1996,0.7784102842255114
STAT,1932,46,25-29,1978,0.08326862058877815
STAT,1972,15,45-49,1987,0.7385165651195486
STAT,1871,34,40-44,1905,4.936469495180535
STAT,1939,32,na,1971,4455.184773040236
STAT,1861,46,40-44,1907,0.16471685422945329
STAT,1939,25,45-49,1964,2.0068872365329624
STAT,1904,19,na,1923,4163.037070738324
SIM,1836,35,50-100,1871,2
STAT,1879,34,35-39,1913,12.09882591022954
STAT,1874,30,35-39,1904,12.060767265436656
STAT,1974,28,20-24,2002,27.612974064486952
STAT,1941,37,50-100,1978,0.5143000882795102
SIM,1931,0,na,1931,6858
STAT,1869,11,na,1880,2986.0196837217354
STAT,1836,49,na,1885,2088.5107202485647
SIM,1828,57,na,1885,1765
SIM,1890,19,na,1909,3624
SIM,1944,47,na,1991,4534
SIM,1833,87,na,1920,8
STAT,1886,23,50-100,1909,0.4948739107006904
STAT,1900,37,15-19,1937,0.019409181387343676
SIM,1871,48,40-44,1919,1
SIM,1922,41,na,1963,5017
SIM,1812,88,na,1900,33
SIM,1882,30,35-39,1912,28
STAT,1801,95,na,1896,5.580462077819108
STAT,1924,33,na,1957,5087.603028779827
SIM,1869,85,na,1954,160
SIM,1940,2,na,1942,5246
SIM,1967,39,35-39,2006,5
STAT,1855,27,40-44,1882,2.656815634315163
SIM,1846,20,na,1866,1794
STAT,1894,23,20-24,1917,101.91848206709189
STAT,1970,16,30-34,1986,17.613253919317128
STAT,1863,48,40-44,1911,0.17058892837844306
STAT,1941,21,45-49,1962,1.3426764531563802
SIM,1863,27,40-44,1890,4
SIM,1826,29,50-100,1855,1
STAT,1852,110,na,1962,9.369633758816015E-4
STAT,1857,33,45-49,1890,1.5607517214839073
STAT,1867,34,45-49,1901,1.8628614284132565
STAT,1862,7,na,1869,2760.8689676628437
STAT,1893,42,45-49,1935,2.1804889258607028
STAT,1766,103,na,1869,0.1263086316411997
STAT,1890,16,45-49,1906,0.0923388138457414
STAT,1966,46,25-29,2012,0.07972871528366318
STAT,1872,15,40-44,1887,0.21517291758669257
SIM,1825,40,40-44,1865,2
STAT,1894,35,15-19,1929,0.08409867521191733
STAT,1840,22,40-44,1862,2.125821876034968
SIM,1932,65,na,1997,4713
STAT,1915,21,40-44,1936,4.023871634897982
SIM,1875,34,45-49,1909,7
STAT,1886,11,na,1897,3148.4082753417124
STAT,1829,41,15-19,1870,0.015010178301984626
STAT,1862,42,15-19,1904,0.01343328168406636
STAT,1836,51,30-34,1887,0.005592887515587686
SIM,1853,28,30-34,1881,31
SIM,1853,64,na,1917,1606
STAT,1878,52,20-24,1930,8.844266111586714E-4
STAT,1824,67,na,1891,980.8554353523363
SIM,1915,27,20-24,1942,28
STAT,1911,23,na,1934,4167.4038512289135
STAT,1854,52,35-39,1906,0.00697643662710766
SIM,1894,86,na,1980,943
STAT,1857,15,45-49,1872,0.06982764661353097
STAT,1911,27,40-44,1938,5.250216677031912
SIM,1922,35,na,1957,5030
STAT,1819,38,30-34,1857,14.020039986997295
STAT,1979,28,35-39,2007,23.947882335997935
SIM,1942,24,50-100,1966,5
SIM,1931,28,15-19,1959,2
STAT,1845,28,30-34,1873,20.505938424991985
SIM,1949,33,25-29,1982,4
SIM,1797,60,na,1857,1052
STAT,1847,41,35-39,1888,1.4191756063278638
STAT,1968,20,na,1988,5284.790899549087
STAT,1923,28,15-19,1951,0.9317320132400779
STAT,1892,104,na,1996,3.6508968104371284
STAT,1950,10,na,1960,5361.57898733396
STAT,1952,45,na,1997,5309.615233823629
SIM,1878,44,40-44,1922,6
SIM,1892,51,na,1943,3433
STAT,1953,41,25-29,1994,0.10375211902014661
STAT,1878,16,na,1894,3050.7174053277913
SIM,1848,18,na,1866,2209
STAT,1949,45,50-100,1994,0.31724665270169183
SIM,1981,9,na,1990,6472
STAT,1891,97,na,1988,81.80599644601756
SIM,1839,40,40-44,1879,5
SIM,1927,76,na,2003,2689
STAT,1883,62,na,1945,2063.6771298122035
SIM,1840,28,20-24,1868,12
SIM,1878,26,40-44,1904,9
STAT,1922,17,45-49,1939,0.6668933159404357
SIM,1971,32,40-44,2003,14
SIM,1975,23,25-29,1998,5
STAT,1843,47,35-39,1890,0.13981844148950523
STAT,1850,75,na,1925,1059.7756582331208
SIM,1827,38,30-34,1865,11
STAT,1872,23,50-100,1895,0.4710882510482362
SIM,1970,35,30-34,2005,2
STAT,1959,15,15-19,1974,68.54590405032536
STAT,1939,38,20-24,1977,0.31353739703400885
STAT,1832,28,20-24,1860,10.974196267770335
STAT,1896,34,40-44,1930,6.553801104973046
SIM,1781,85,na,1866,175
STAT,1821,46,45-49,1867,0.4330537807962813
SIM,1930,30,na,1960,5940
STAT,1882,52,40-44,1934,0.011803750704030867
STAT,1817,40,40-44,1857,7.313461192737514
SIM,1917,22,25-29,1939,243
STAT,1807,83,na,1890,194.12823273041283
STAT,1794,83,na,1877,179.56344979345482
SIM,1855,23,35-39,1878,11
STAT,1899,89,na,1988,646.8945961192048
SIM,1952,36,35-39,1988,6
STAT,1847,23,35-39,1870,5.464946289898833
STAT,1944,36,35-39,1980,3.097733569997018
STAT,1826,33,15-19,1859,0.12745115098086027
STAT,1923,46,15-19,1969,4.983652263691192E-4
SIM,1909,53,na,1962,4490
STAT,1861,29,25-29,1890,40.29422523216821
STAT,1929,33,na,1962,5540.91628583134
STAT,1845,46,30-34,1891,0.06541435279327124
STAT,1831,49,na,1880,1844.9171721183798
STAT,1880,42,35-39,1922,2.2123349847529683
SIM,1863,31,15-19,1894,1
SIM,1811,69,na,1880,1220
STAT,1858,26,15-19,1884,0.42116472327765836
STAT,1977,15,35-39,1992,6.546499883380583
STAT,1912,43,35-39,1955,0.22299789486010604
STAT,1977,30,45-49,2007,2.503911095387248
STAT,1867,52,45-49,1919,0.01555371463944486
STAT,1878,34,20-24,1912,3.2291799650855153
STAT,1980,18,45-49,1998,0.800050699643736
SIM,1874,26,na,1900,2499
SIM,1896,36,50-100,1932,1
STAT,1855,31,15-19,1886,0.12466800749858255
STAT,1829,32,50-100,1861,1.1884956982024206
SIM,1838,28,35-39,1866,2
STAT,1786,88,na,1874,77.78372748069108
SIM,1947,27,na,1974,5761
SIM,1862,33,20-24,1895,5
STAT,1827,46,40-44,1873,0.21975553374759466
SIM,1846,36,45-49,1882,1
STAT,1830,33,35-39,1863,10.742736725009138
STAT,1866,62,na,1928,1955.054306525727
STAT,1880,24,35-39,1904,7.093513487855647
SIM,1977,36,25-29,2013,3
STAT,1893,92,na,1985,325.07439270575094
STAT,1955,39,15-19,1994,0.030245092292470632
STAT,1876,24,15-19,1900,3.9110279516495545
SIM,1843,39,25-29,1882,5
SIM,1969,14,na,1983,5822
STAT,1824,36,45-49,1860,3.1297927332087823
STAT,1947,32,40-44,1979,5.185464735303952
STAT,1917,48,40-44,1965,0.18952470036897315
SIM,1869,79,na,1948,490
SIM,1956,35,50-100,1991,1
SIM,1959,22,30-34,1981,61
STAT,1960,40,45-49,2000,0.26069338607975023
SIM,1873,13,na,1886,3659
SIM,1972,30,35-39,2002,3
STAT,1835,39,25-29,1874,2.1760359573710293
STAT,1897,54,na,1951,3231.3444193005926
SIM,1955,32,40-44,1987,2
SIM,1979,18,45-49,1997,1
STAT,1813,83,na,1896,181.7693426773047
SIM,1842,21,na,1863,2621
SIM,1941,17,20-24,1958,281
STAT,1959,33,15-19,1992,0.1976134728507484
STAT,1935,33,na,1968,6038.006467780347
STAT,1891,27,15-19,1918,0.6471241806121383
STAT,1788,83,na,1871,201.5766347980256
STAT,1870,50,25-29,1920,0.004087744139739551
STAT,1905,32,35-39,1937,9.712860239652544
STAT,1963,30,30-34,1993,23.57258675324714
STAT,1838,49,20-24,1887,0.010425273568429802
SIM,1993,19,50-100,2012,2
STAT,1839,47,15-19,1886,3.2320579459461566E-4
STAT,1850,44,45-49,1894,1.5199136081625457
STAT,1899,42,40-44,1941,0.24665019409264802
STAT,1852,70,na,1922,1322.8372070602543
STAT,1967,23,25-29,1990,133.55268134270034
STAT,1933,17,20-24,1950,209.53764153802945
SIM,1913,32,35-39,1945,12
STAT,1928,38,45-49,1966,0.9932459821654314
SIM,1936,38,45-49,1974,2
STAT,1809,49,25-29,1858,0.14252024599571414
STAT,1845,29,na,1874,1748.930276387779
STAT,1800,57,na,1857,1403.1086955824123
STAT,1975,33,15-19,2008,0.19930121638843143
SIM,1967,15,15-19,1982,120
SIM,1953,27,na,1980,5661
STAT,1772,96,na,1868,0.19372297997042054
STAT,1913,27,50-100,1940,1.1451591490755106
STAT,1966,25,na,1991,5427.855978110549
STAT,1921,53,na,1974,4676.119543848318
STAT,1948,30,35-39,1978,12.31591680850307
STAT,1929,49,15-19,1978,5.478219288727559E-4
STAT,1839,29,na,1868,2130.322935581967
SIM,1938,22,na,1960,4114
SIM,1883,26,20-24,1909,16
STAT,1878,19,25-29,1897,6.791537945973839
STAT,1886,45,35-39,1931,0.1721226107323453
STAT,1896,37,45-49,1933,3.038644077562484
SIM,1877,29,30-34,1906,49
STAT,1922,7,na,1929,5336.478514424491
STAT,1907,27,20-24,1934,19.91970735274283
STAT,1889,46,50-100,1935,0.35037497523971933
SIM,1789,65,na,1854,1139
SIM,1861,36,40-44,1897,2
STAT,1943,38,40-44,1981,1.8856759988168017
SIM,1815,90,na,1905,38
STAT,1853,36,40-44,1889,4.403816351799933
SIM,1851,30,40-44,1881,8
STAT,1815,45,50-100,1860,0.516555930156928
STAT,1868,97,na,1965,22.11777094352531
STAT,1885,48,25-29,1933,0.06547078212888968
SIM,1978,19,na,1997,6025
STAT,1918,16,40-44,1934,0.35328441028712954
SIM,1934,60,na,1994,5238
STAT,1908,19,50-100,1927,0.0835261993691871
STAT,1954,28,45-49,1982,2.474189959857397
SIM,1935,71,na,2006,4752
STAT,1946,49,20-24,1995,0.014626993479309134
STAT,1877,109,na,1986,0.06024067440963482
SIM,1977,24,30-34,2001,52
SIM,1890,56,na,1946,2983
STAT,1857,30,40-44,1887,4.00425233691847
STAT,1861,44,20-24,1905,0.15030971001042406
SIM,1832,36,45-49,1868,5
STAT,1987,5,na,1992,6477.638825124458
STAT,1879,32,15-19,1911,0.17160393568287624
STAT,1875,26,20-24,1901,14.038888052198788
SIM,1951,38,40-44,1989,4
SIM,1956,30,35-39,1986,29
STAT,1896,19,45-49,1915,0.09903621184301088
SIM,1971,33,25-29,2004,30
STAT,1824,54,45-49,1878,0.01829433075442767
SIM,1841,25,50-100,1866,1
STAT,1932,49,20-24,1981,0.017203178577127998
SIM,1882,30,50-100,1912,3
SIM,1884,56,na,1940,2334
STAT,1868,15,20-24,1883,20.25057413334427
STAT,1918,46,35-39,1964,0.1586966145421654
SIM,1898,21,35-39,1919,20
STAT,1923,39,50-100,1962,0.5600191484243814
STAT,1937,40,30-34,1977,0.1493141866849186
SIM,1929,71,na,2000,3639
STAT,1985,25,25-29,2010,108.59804893828928
STAT,1849,39,25-29,1888,2.2365573483172225
SIM,1857,39,25-29,1896,1
SIM,1822,32,40-44,1854,8
STAT,1801,70,na,1871,763.8845205694176
STAT,1906,76,na,1982,2368.251049251121
STAT,1826,62,na,1888,1031.2563282700992
STAT,1843,30,40-44,1873,5.3409673120381145
STAT,1973,22,40-44,1995,5.035053038743424
SIM,1880,94,na,1974,146
STAT,1854,33,20-24,1887,2.2318631368373616
SIM,1896,81,na,1977,1651
SIM,1818,37,50-100,1855,1
STAT,1838,36,45-49,1874,2.105768570129132
SIM,1849,31,na,1880,2785
STAT,1971,34,50-100,2005,1.2302596111668886
SIM,1934,24,20-24,1958,153
STAT,1833,75,na,1908,724.4053883505014
STAT,1855,59,na,1914,1653.6849811880209
STAT,1877,62,na,1939,2194.0905676913576
STAT,1930,24,40-44,1954,4.9404723524100795
SIM,1881,31,35-39,1912,1
STAT,1890,29,20-24,1919,16.424522270302262
STAT,1848,46,50-100,1894,0.2616977091980481
STAT,1868,18,25-29,1886,6.359168146439516
STAT,1868,25,50-100,1893,0.7140821326183474
SIM,1872,25,30-34,1897,56
SIM,1908,16,20-24,1924,25
STAT,1840,25,45-49,1865,1.1266774908183799
STAT,1937,43,35-39,1980,0.23415949545546738
STAT,1833,26,15-19,1859,0.43184432426215735
SIM,1933,76,na,2009,4243
STAT,1966,43,20-24,2009,0.02641306843160211
STAT,1862,41,30-34,1903,1.1247655274049628
SIM,1938,17,15-19,1955,87
STAT,1864,26,45-49,1890,1.1480287586423434
SIM,1838,25,30-34,1863,34
STAT,1861,26,20-24,1887,11.418999251074661
SIM,1862,13,na,1875,3138
SIM,1882,49,50-100,1931,2
STAT,1885,47,40-44,1932,0.19615115523723498
STAT,1930,58,na,1988,5297.181709335821
STAT,1966,2,na,1968,5672.333823768135
STAT,1981,33,45-49,2014,2.586765423597614
STAT,1838,18,45-49,1856,0.07431363389931527
STAT,1873,31,35-39,1904,11.983417033549902
SIM,1853,3,na,1856,3213
SIM,1941,71,na,2012,3055
STAT,1874,45,45-49,1919,0.2816012791459532
SIM,1872,26,45-49,1898,7
SIM,1809,90,na,1899,71
STAT,1846,26,25-29,1872,53.28562686123542
SIM,1880,26,na,1906,3470
STAT,1874,97,na,1971,39.36481662118723
STAT,1871,36,30-34,1907,6.148479984900091
STAT,1939,33,50-100,1972,0.9733427922167727
STAT,1865,19,15-19,1884,6.292954584307511
SIM,1873,19,15-19,1892,15
SIM,1890,19,20-24,1909,25
STAT,1934,15,15-19,1949,71.20609984812859
STAT,1956,20,45-49,1976,1.725090853967008
STAT,1974,35,20-24,2009,0.409964570544425
STAT,1942,25,15-19,1967,0.8559651996618323
STAT,1872,62,na,1934,2117.9788771070216
STAT,1887,92,na,1979,266.6714661856294
SIM,1844,87,na,1931,154
STAT,1984,8,na,1992,6441.702505890739
STAT,1821,43,40-44,1864,4.2444542596164645
STAT,1902,46,na,1948,3679.753418118017
STAT,1864,25,30-34,1889,26.22582625203063
STAT,1882,19,20-24,1901,19.876697157679793
STAT,1850,26,45-49,1876,1.3548067048448167
STAT,1922,29,50-100,1951,1.2899497351726732
SIM,1852,82,na,1934,27
SIM,1938,8,na,1946,4194
SIM,1960,43,20-24,2003,1
STAT,1962,38,35-39,2000,3.681008027011547
STAT,1985,21,50-100,2006,1.0839535661272446
SIM,1963,43,45-49,2006,2
SIM,1938,30,45-49,1968,4
STAT,1813,103,na,1916,0.06571155048746011
STAT,1963,33,35-39,1996,13.64876750269554
STAT,1881,21,15-19,1902,3.6833264665458656
SIM,1924,17,15-19,1941,112
SIM,1949,22,na,1971,5445
SIM,1950,25,15-19,1975,3
SIM,1874,20,35-39,1894,8
SIM,1885,37,40-44,1922,13
SIM,1867,44,na,1911,2201
STAT,1834,40,50-100,1874,1.1924356601515123
STAT,1825,49,na,1874,1777.140678784983
SIM,1970,38,35-39,2008,3
STAT,1888,29,35-39,1917,12.995938179141955
SIM,1967,19,na,1986,5407
STAT,1838,35,30-34,1873,5.688525311140161
STAT,1982,26,15-19,2008,1.1518867050007517
SIM,1878,47,45-49,1925,1
STAT,1908,25,15-19,1933,0.7829636205907968
SIM,1849,44,45-49,1893,1
STAT,1895,19,30-34,1914,2.381457759968907
STAT,1975,33,50-100,2008,1.2822964399843417
STAT,1893,38,35-39,1931,10.266227359250589
STAT,1839,29,15-19,1868,0.4467924577550107
STAT,1872,18,45-49,1890,0.07549753970030496
STAT,1933,47,15-19,1980,5.848647125254881E-4
SIM,1802,80,na,1882,152
STAT,1867,16,na,1883,2798.479683811139
STAT,1872,16,25-29,1888,6.627252006201677
STAT,1866,20,35-39,1886,6.384306533072277
SIM,1967,35,25-29,2002,2
STAT,1969,36,25-29,2005,1.463703518303139
STAT,1961,51,na,2012,5624.976176760608
STAT,1974,20,35-39,1994,14.245819619393359
STAT,1916,17,15-19,1933,11.113142930446822
SIM,1963,23,35-39,1986,34
STAT,1854,36,25-29,1890,2.3569631077867905
SIM,1839,38,20-24,1877,1
STAT,1949,25,na,1974,5054.100377203
SIM,1891,20,40-44,1911,4
STAT,1889,59,na,1948,2764.7123740179854
SIM,1883,40,50-100,1923,2
STAT,1831,47,45-49,1878,0.2186536745632011
SIM,1937,15,35-39,1952,8
STAT,1880,21,30-34,1901,21.854501304387366
STAT,1887,40,25-29,1927,0.8388966808904846
STAT,1901,92,na,1993,385.7475405328694
SIM,1843,34,na,1877,2040
STAT,1827,49,45-49,1876,0.2910083718532803
SIM,1935,21,30-34,1956,2
STAT,1826,93,na,1919,16.09166404243176
STAT,1875,40,50-100,1915,1.2726327243970514
STAT,1908,71,na,1979,2928.746736584656
SIM,1862,36,25-29,1898,6
STAT,1809,46,20-24,1855,0.030878964261168915
STAT,1909,22,25-29,1931,99.18486372191857
SIM,1929,24,40-44,1953,13
STAT,1835,54,20-24,1889,4.5107195132228326E-4
SIM,1822,35,45-49,1857,3
STAT,1818,67,na,1885,755.3534277493244
STAT,1890,47,20-24,1937,0.0095006033216056
STAT,1913,58,na,1971,3927.644705650543
STAT,1927,21,30-34,1948,40.980039967154575
STAT,1896,16,40-44,1912,0.2794813187806771
SIM,1846,35,30-34,1881,2
SIM,1828,36,25-29,1864,5
SIM,1865,18,na,1883,3279
STAT,1896,41,na,1937,3551.1532168161334
SIM,1820,46,na,1866,1900
STAT,1944,33,30-34,1977,19.933429651579047
STAT,1853,39,45-49,1892,1.9647775623901942
SIM,1952,33,30-34,1985,50
SIM,1955,22,na,1977,5792
STAT,1929,15,35-39,1944,6.2090973516344174
STAT,1917,76,na,1993,2812.000780769461
SIM,1857,36,20-24,1893,3
STAT,1963,5,na,1968,5764.6572047850705
STAT,1971,40,20-24,2011,0.02690079911758503
SIM,1865,28,20-24,1893,13
STAT,1802,52,na,1854,1562.7953279649157
STAT,1819,39,45-49,1858,4.733623736479548
STAT,1828,46,25-29,1874,0.05374129710011456
STAT,1914,71,na,1985,3209.1974244737034
SIM,1856,13,na,1869,2565
SIM,1906,21,35-39,1927,19
STAT,1985,22,20-24,2007,183.11684521908265
SIM,1951,22,25-29,1973,283
STAT,1900,101,na,2001,20.759152775896727
STAT,1895,59,na,1954,2919.456247795703
STAT,1853,28,50-100,1881,0.6665850320570462
STAT,1830,31,15-19,1861,0.1571526751855678
SIM,1971,35,45-49,2006,7
STAT,1847,24,na,1871,1987.9867300217804
STAT,1911,45,40-44,1956,0.17321076715582714
SIM,1883,29,25-29,1912,44
STAT,1979,25,30-34,2004,62.58394713834059
STAT,1929,33,35-39,1962,13.388218527332421
SIM,1905,35,na,1940,4202
STAT,1875,29,25-29,1904,50.087915952768725
SIM,1850,6,na,1856,2345
STAT,1868,45,15-19,1913,4.4792824808503255E-4
STAT,1861,47,25-29,1908,0.055004221980707056
STAT,1891,37,50-100,1928,1.7511518233331769
STAT,1950,49,40-44,1999,0.22246416573312355
STAT,1833,49,50-100,1882,0.1807979036465427
SIM,1860,23,15-19,1883,1
STAT,1918,43,30-34,1961,0.1565858774948289
SIM,1854,26,25-29,1880,66
SIM,1927,19,na,1946,4389
SIM,1835,49,45-49,1884,1
STAT,1822,40,20-24,1862,0.3426277220562021
STAT,1853,103,na,1956,0.1734413865229232
SIM,1964,38,50-100,2002,2
STAT,1942,2,na,1944,4897.561734295848
STAT,1838,34,50-100,1872,0.9661182504645813
STAT,1857,28,20-24,1885,10.782867640537113
SIM,1846,34,50-100,1880,1
STAT,1883,20,40-44,1903,2.3668507033419504
SIM,1851,69,na,1920,1616
STAT,1849,36,20-24,1885,0.6177413368556861
STAT,1942,15,na,1957,4442.18849645782
SIM,1827,39,45-49,1866,5
STAT,1935,49,45-49,1984,0.3522116971766055
SIM,1904,27,45-49,1931,3
STAT,1943,22,25-29,1965,113.42464104341458
STAT,1866,104,na,1970,0.7394855321664159
STAT,1990,17,na,2007,6083.224193697847
STAT,1864,39,20-24,1903,0.7863203186142856
STAT,1852,23,15-19,1875,3.6684372334995374
SIM,1843,36,20-24,1879,1
STAT,1867,48,35-39,1915,0.14895296503758151
SIM,1961,22,na,1983,5254
STAT,1926,24,20-24,1950,154.89039633762098
SIM,1959,25,35-39,1984,61
STAT,1951,36,50-100,1987,0.5949736985948636
SIM,1859,18,na,1877,2536
SIM,1937,33,35-39,1970,3
STAT,1921,30,25-29,1951,11.961081258770857
STAT,1893,24,45-49,1917,1.010828082569439
STAT,1921,49,45-49,1970,0.28099107634479925
STAT,1918,19,45-49,1937,0.6239813124763921
SIM,1926,19,45-49,1945,1
SIM,1857,18,20-24,1875,40
STAT,1965,28,20-24,1993,26.400518285394536
STAT,1835,36,20-24,1871,0.6011363284954964
STAT,1849,18,20-24,1867,16.81423655258753
STAT,1982,30,25-29,2012,15.316663055839271
SIM,1875,48,35-39,1923,1
SIM,1987,25,30-34,2012,6
SIM,1829,33,35-39,1862,15
STAT,1954,40,na,1994,5521.7056379754395
SIM,1911,35,na,1946,4834
SIM,1926,65,na,1991,5148
SIM,1981,14,na,1995,6461
STAT,1919,71,na,1990,3507.2339040156658
STAT,1961,36,40-44,1997,2.3016148009234576
SIM,1939,28,20-24,1967,35
STAT,1854,51,20-24,1905,6.040571187985078E-4
STAT,1935,28,40-44,1963,7.332815665113046
STAT,1811,57,na,1868,1301.5829487692656
STAT,1864,23,40-44,1887,2.166107586033087
SIM,1879,21,30-34,1900,1
SIM,1918,61,na,1979,3477
STAT,1845,29,45-49,1874,0.897642148949153
STAT,1840,38,20-24,1878,0.723832461237376
STAT,1970,45,30-34,2015,0.1345839402017113
SIM,1953,31,25-29,1984,2
STAT,1916,38,na,1954,4424.601069847741
STAT,1837,62,na,1899,1323.5115168168159
SIM,1849,41,40-44,1890,3
SIM,1954,18,45-49,1972,1
STAT,1971,15,50-100,1986,0.54791167711055
SIM,1883,43,na,1926,2412
STAT,1895,28,na,1923,3572.3968020011566
SIM,1798,73,na,1871,716
SIM,1833,31,35-39,1864,24
SIM,1929,45,45-49,1974,1
STAT,1974,38,25-29,2012,1.5270665696378272
STAT,1856,32,na,1888,2126.749398896869
STAT,1864,28,35-39,1892,9.907658889159158
SIM,1923,18,15-19,1941,2
STAT,1825,38,25-29,1863,4.643061740715035
STAT,1862,44,35-39,1906,1.7398048038043434
STAT,1955,45,35-39,2000,0.20641980952658803
SIM,1864,29,20-24,1893,24
STAT,1934,24,50-100,1958,1.0202985177190265
SIM,1872,23,40-44,1895,7
STAT,1847,55,na,1902,1591.0112017378615
STAT,1821,45,30-34,1866,0.18011485170474262
STAT,1984,17,na,2001,6032.996639793553
STAT,1850,44,na,1894,2347.1805820899763
STAT,1883,17,15-19,1900,6.700655499328245
SIM,1891,17,15-19,1908,14
SIM,1836,52,na,1888,1355
SIM,1853,29,45-49,1882,2
SIM,1928,28,45-49,1956,4
SIM,1942,27,na,1969,4811
SIM,1853,33,na,1886,2353
SIM,1909,31,30-34,1940,43
SIM,1963,45,35-39,2008,1
STAT,1945,31,25-29,1976,11.883853493541897
STAT,1917,86,na,2003,1297.6753210439
SIM,1861,38,30-34,1899,3
SIM,1931,43,na,1974,6082
STAT,1865,80,na,1945,644.1171431151175
STAT,1909,38,40-44,1947,1.6289379849212393
SIM,1870,44,35-39,1914,2
SIM,1847,32,40-44,1879,13
STAT,1915,18,15-19,1933,10.934933351195756
STAT,1969,24,40-44,1993,4.859980661297199
SIM,1889,31,na,1920,3771
SIM,1809,54,20-24,1863,1
SIM,1920,22,30-34,1942,87
SIM,1860,18,na,1878,2885
SIM,1963,40,40-44,2003,1
STAT,1825,31,35-39,1856,22.88279526873068
SIM,1912,73,na,1985,2152
SIM,1909,94,na,2003,286
SIM,1856,44,na,1900,2029
STAT,1884,34,15-19,1918,0.1609860179802131
STAT,1929,74,na,2003,3793.3930608012183
STAT,1851,28,25-29,1879,38.994305307798264
STAT,1936,45,40-44,1981,0.18129823112958948
SIM,1844,56,na,1900,1902
SIM,1927,10,na,1937,5259
STAT,1871,19,45-49,1890,0.0745962886042254
STAT,1919,41,25-29,1960,0.08941353314485155
STAT,1978,32,25-29,2010,14.838152098873035
STAT,1922,44,35-39,1966,0.26572958389294493
SIM,1894,1,na,1895,4248
STAT,1961,18,40-44,1979,2.0848176001398815
STAT,1853,38,30-34,1891,5.2799099547733235
SIM,1964,37,na,2001,5840
STAT,1839,32,40-44,1871,4.232371909649673
STAT,1873,16,na,1889,2994.036067751943
STAT,1903,21,15-19,1924,5.439232582720306
SIM,1834,30,50-100,1864,2
STAT,1889,26,45-49,1915,1.584903471079895
STAT,1857,54,na,1911,1882.070910151592
STAT,1970,23,30-34,1993,41.643950508916895
STAT,1943,37,na,1980,4743.835849718112
STAT,1886,42,na,1928,2810.034050037703
STAT,1889,44,45-49,1933,2.1003358185671663
STAT,1890,43,35-39,1933,2.5350194286176633
STAT,1882,49,15-19,1931,4.414714729394832E-4
STAT,1955,23,35-39,1978,14.468195798849795
SIM,1846,38,35-39,1884,3
STAT,1886,44,20-24,1930,0.19071535128623174
SIM,1897,26,45-49,1923,2
STAT,1901,61,na,1962,3201.737623561328
SIM,1973,19,na,1992,5109
SIM,1852,51,na,1903,1745
STAT,1888,36,50-100,1924,1.673540906888977
SIM,1917,38,40-44,1955,4
STAT,1910,10,na,1920,4534.426631150711
STAT,1967,42,20-24,2009,0.026457475724938524
STAT,1806,70,na,1876,686.7185840065694
STAT,1913,87,na,2000,1068.4537705138491
SIM,1843,37,35-39,1880,23
SIM,1976,25,na,2001,5542
SIM,1979,15,40-44,1994,3
STAT,1834,29,na,1863,2551.648694545083
SIM,1985,17,15-19,2002,1
SIM,1805,60,na,1865,1256
STAT,1912,22,30-34,1934,31.817983486836344
STAT,1839,50,40-44,1889,0.008556693448034308
STAT,1838,38,35-39,1876,7.317739460883114
STAT,1869,29,30-34,1898,27.94235356195518
STAT,1880,97,na,1977,55.49147921555379
STAT,1841,50,50-100,1891,0.013620667643657028
SIM,1873,44,na,1917,3190
SIM,1878,24,20-24,1902,4
STAT,1877,39,30-34,1916,6.333472933044635
SIM,1872,53,35-39,1925,2
STAT,1893,44,50-100,1937,0.1055702827362594
STAT,1839,44,50-100,1883,0.860685712527637
STAT,1822,42,40-44,1864,4.596221313834997
STAT,1823,45,na,1868,1513.6713576143866
SIM,1929,45,na,1974,5186
SIM,1928,60,na,1988,5135
SIM,1869,25,25-29,1894,86
SIM,1841,32,45-49,1873,1
STAT,1849,50,na,1899,1692.8339527142723
SIM,1811,60,na,1871,1401
STAT,1827,48,30-34,1875,0.12097134399383734
SIM,1874,6,na,1880,3046
STAT,1980,17,50-100,1997,0.6002300983642787
STAT,1835,37,35-39,1872,5.458404888162815
STAT,1986,18,30-34,2004,20.0367676586008
SIM,1994,18,30-34,2012,1
STAT,1965,44,45-49,2009,0.24836415193824596
SIM,1896,29,35-39,1925,2
STAT,1831,44,40-44,1875,2.101179065146501
SIM,1876,43,25-29,1919,1
STAT,1888,46,na,1934,3060.742257263845
STAT,1985,19,50-100,2004,0.6145439633748012
STAT,1912,40,30-34,1952,0.14404837494221107
SIM,1868,94,na,1962,21
STAT,1868,43,25-29,1911,0.7068595790171921
STAT,1797,88,na,1885,57.91058451341384
SIM,1885,39,30-34,1924,13
SIM,1905,22,35-39,1927,1
STAT,1833,32,45-49,1865,1.5946612030740106
STAT,1967,25,15-19,1992,1.022967179861952
STAT,1859,37,20-24,1896,0.7086450144577263
STAT,1873,33,50-100,1906,1.0752293891249551
STAT,1893,21,40-44,1914,3.048867675421578
STAT,1862,24,15-19,1886,3.2420768712915495
SIM,1873,7,na,1880,3753
STAT,1866,31,na,1897,2562.977256830739
SIM,1943,46,40-44,1989,1
STAT,1831,30,15-19,1861,0.14806154600727892
STAT,1931,38,15-19,1969,0.029326879441585067
SIM,1912,34,40-44,1946,7
SIM,1895,31,na,1926,3609
STAT,1900,11,na,1911,4141.686725176486
STAT,1958,35,20-24,1993,0.412361048572098
STAT,1805,54,40-44,1859,0.03610322461825046
SIM,1978,31,15-19,2009,4
STAT,1948,35,50-100,1983,0.5722514833689625
SIM,1870,24,15-19,1894,4
STAT,1813,52,na,1865,1307.0211501205083
STAT,1878,54,40-44,1932,0.012336511037662598
STAT,1851,21,35-39,1872,5.566108820900377
STAT,1923,86,na,2009,1452.7961638658624
STAT,1961,22,15-19,1983,7.963097143188455
STAT,1936,48,45-49,1984,0.24805817766816518
SIM,1858,22,45-49,1880,1
STAT,1880,26,25-29,1906,51.92241706609725
SIM,1867,13,na,1880,2720
STAT,1856,29,20-24,1885,10.55000926607949
SIM,1975,14,na,1989,6123
STAT,1959,32,30-34,1991,24.24318714165214
STAT,1911,48,45-49,1959,0.23699264458056188
STAT,1897,23,na,1920,3638.309267373765
SIM,1842,52,na,1894,1919
SIM,1952,42,na,1994,4698
SIM,1874,94,na,1968,59
STAT,1889,38,15-19,1927,0.07948753048890424
STAT,1953,43,50-100,1996,0.1701738765933331
STAT,1930,42,40-44,1972,0.37984683391979823
STAT,1935,46,40-44,1981,0.2576481258167212
SIM,1882,27,45-49,1909,5
STAT,1946,18,45-49,1964,0.6392007826754169
SIM,1840,17,35-39,1857,2
SIM,1848,41,50-100,1889,5
SIM,1921,27,50-100,1948,2
STAT,1852,39,30-34,1891,4.974225170644803
SIM,1967,32,30-34,1999,27
STAT,1874,30,50-100,1904,1.0911970319709192
SIM,1899,86,na,1985,868
SIM,1963,42,30-34,2005,2
SIM,1937,19,20-24,1956,302
STAT,1880,44,25-29,1924,0.7749100141398956
STAT,1852,104,na,1956,0.07706460830439132
STAT,1904,34,40-44,1938,4.091381116779191
STAT,1982,32,45-49,2014,2.604744148906812
SIM,1808,49,na,1857,1696
STAT,1833,25,50-100,1858,0.6156377482493077
STAT,1951,19,30-34,1970,16.739095591659442
STAT,1865,22,40-44,1887,2.1961540988690103
SIM,1824,44,45-49,1868,3
SIM,1860,39,30-34,1899,13
SIM,1823,45,50-100,1868,1
SIM,1830,42,40-44,1872,2
STAT,1853,54,50-100,1907,0.014623088057656523
STAT,1864,53,35-39,1917,0.008728696979947433
STAT,1887,42,15-19,1929,0.01783858115042782
SIM,1943,28,40-44,1971,2
STAT,1861,27,35-39,1888,9.32450756365055
STAT,1971,21,25-29,1992,135.50403810079433
SIM,1807,64,na,1871,869
STAT,1879,34,50-100,1913,1.0946403850615511
STAT,1915,24,45-49,1939,1.334082971851857
SIM,1833,35,20-24,1868,1
STAT,1929,19,20-24,1948,198.61434437917552
SIM,1848,30,35-39,1878,3
STAT,1846,70,na,1916,1450.4729957891889
STAT,1874,27,45-49,1901,1.3117645559867837
STAT,1898,31,35-39,1929,15.859533925724756
SIM,1875,79,na,1954,645
STAT,1937,16,45-49,1953,0.5625151952821209
STAT,1858,44,15-19,1902,0.012264976825911371
SIM,1861,39,45-49,1900,1
STAT,1816,44,45-49,1860,3.1573907098687957
STAT,1981,30,40-44,2011,6.44430544656662
STAT,1890,18,35-39,1908,0.7717186327531627
SIM,1890,25,na,1915,3333
STAT,1766,96,na,1862,3.6542627276383577
SIM,1984,19,20-24,2003,389
STAT,1844,44,na,1888,1929.8047176796842
STAT,1859,80,na,1939,568.6784847277961
STAT,1873,47,15-19,1920,4.6919787390696386E-4
SIM,1863,35,50-100,1898,1
SIM,1939,60,na,1999,4532
SIM,1949,30,20-24,1979,1
SIM,1825,43,45-49,1868,2
STAT,1816,63,na,1879,1039.5470695375318
STAT,1958,17,20-24,1975,205.4966587078372
SIM,1936,27,na,1963,3992
STAT,1953,56,na,2009,5135.954265361675
STAT,1897,32,35-39,1929,15.62741805576758
STAT,1930,39,15-19,1969,0.028849019786325134
STAT,1986,20,15-19,2006,8.78839460124483
SIM,1875,31,40-44,1906,9
STAT,1867,46,15-19,1913,4.322186834227993E-4
STAT,1983,0,na,1983,6466.450017111933
STAT,1840,52,35-39,1892,0.006869435150654963
STAT,1839,53,45-49,1892,0.011324276374849455
STAT,1882,24,na,1906,2649.229154124022
STAT,1889,41,40-44,1930,3.214228802170829
SIM,1813,64,na,1877,1099
STAT,1922,48,20-24,1970,0.014604282292672341
SIM,1940,17,50-100,1957,1
STAT,1825,35,20-24,1860,1.3494455741823257
STAT,1912,76,na,1988,2589.7182023386713
STAT,1926,26,40-44,1952,6.4690411477910565
SIM,1879,24,35-39,1903,21
SIM,1910,23,20-24,1933,220
STAT,1862,40,25-29,1902,0.6317282368592382
STAT,1977,34,30-34,2011,25.009361367122686
STAT,1904,10,na,1914,4292.737974706213
SIM,1966,17,20-24,1983,369
STAT,1792,88,na,1880,70.60680600169033
STAT,1907,21,na,1928,4027.916699125853
STAT,1913,42,35-39,1955,0.22673935509675297
STAT,1836,54,35-39,1890,0.007622288486177093
STAT,1902,23,20-24,1925,112.02341773227471
SIM,1847,35,45-49,1882,6
SIM,1978,25,50-100,2003,1
STAT,1817,43,45-49,1860,4.494898201954724
STAT,1854,54,25-29,1908,0.0028063132687890582
STAT,1890,40,30-34,1930,1.6375285935698507
SIM,1970,19,50-100,1989,1
STAT,1833,44,na,1877,1747.0245298809868
STAT,1894,33,25-29,1927,15.13118087958922
SIM,1907,39,30-34,1946,2
SIM,1862,44,na,1906,2812
SIM,1883,22,35-39,1905,7
STAT,1892,79,na,1971,1557.6646776670445
STAT,1853,54,40-44,1907,0.01019329266001267
STAT,1900,38,20-24,1938,0.26511357473516944
STAT,1828,29,na,1857,1899.8171532757501
SIM,1994,20,15-19,2014,6
SIM,1949,49,40-44,1998,1
SIM,1897,7,na,1904,4217
SIM,1963,26,na,1989,6280
STAT,1966,26,15-19,1992,1.0224367154581513
STAT,1840,29,na,1869,2132.80399879227
STAT,1950,19,na,1969,5019.194148878974
STAT,1851,25,20-24,1876,11.050614338415087
STAT,1903,20,30-34,1923,29.454122680566954
STAT,1889,23,40-44,1912,2.95520253628312
SIM,1984,17,30-34,2001,26
SIM,1924,61,na,1985,4389
SIM,1937,75,na,2012,2819
STAT,1973,22,50-100,1995,0.9853333473703787
STAT,1885,45,20-24,1930,0.013951024443131448
STAT,1912,25,35-39,1937,17.206703216348384
SIM,1933,29,30-34,1962,129
STAT,1830,51,35-39,1881,0.007123677750566321
STAT,1944,41,na,1985,4800.534949091405
SIM,1975,20,20-24,1995,167
STAT,1892,47,50-100,1939,0.1994531382031926
SIM,1916,35,na,1951,4438
SIM,1928,25,40-44,1953,17
SIM,1930,39,na,1969,6029
STAT,1886,47,25-29,1933,0.06979023189219728
SIM,1943,32,15-19,1975,1
STAT,1828,43,20-24,1871,0.1503571897293626
SIM,1877,43,na,1920,3082
SIM,1849,62,na,1911,2123
SIM,1920,25,35-39,1945,6
STAT,1855,3,na,1858,2859.38628262818
STAT,1925,71,na,1996,3917.954328904315
STAT,1925,29,30-34,1954,53.00954260820727
STAT,1893,36,15-19,1929,0.08230795540982117
STAT,1867,15,50-100,1882,0.0546067320228956
STAT,1990,20,35-39,2010,15.623974149414753
STAT,1968,29,na,1997,5417.72312659991
SIM,1812,43,35-39,1855,4
STAT,1836,34,15-19,1870,0.16050798250192275
STAT,1855,28,na,1883,2101.449776575237
SIM,1921,50,na,1971,5079
STAT,1826,49,30-34,1875,0.06785942136387292
SIM,1979,6,na,1985,6475
STAT,1932,17,50-100,1949,0.5726625726509695
STAT,1887,24,na,1911,3039.623347260658
SIM,1949,63,na,2012,5061
SIM,1889,29,20-24,1918,19
STAT,1904,49,15-19,1953,3.661163021574603E-4
STAT,1847,21,15-19,1868,3.1343951895776567
STAT,1884,16,15-19,1900,6.783318467288959
STAT,1807,52,na,1859,1607.2327762489576
SIM,1854,18,na,1872,3015
STAT,1981,32,30-34,2013,25.91560804959111
SIM,1834,49,30-34,1883,1
STAT,1841,70,na,1911,1247.4594595325611
SIM,1847,44,50-100,1891,3
STAT,1909,24,15-19,1933,5.680170542963276
STAT,1876,25,20-24,1901,14.090322525026563
SIM,1893,27,20-24,1920,17
SIM,1984,29,na,2013,5837
STAT,1926,53,na,1979,5118.993555083778
SIM,1828,26,na,1854,2380
STAT,1917,47,35-39,1964,0.15541721237871556
STAT,1943,1,na,1944,5067.096812175154
STAT,1947,35,45-49,1982,0.914591848579053
SIM,1908,36,40-44,1944,6
SIM,1889,41,50-100,1930,2
STAT,1885,97,na,1982,60.206984198204914
SIM,1961,5,na,1966,5671
SIM,1866,26,15-19,1892,1
SIM,1869,22,20-24,1891,2
STAT,1944,19,na,1963,4568.389690732445
STAT,1935,32,15-19,1967,0.20528342051810297
STAT,1865,25,45-49,1890,1.1639532958421457
STAT,1927,38,na,1965,5391.469013164697
SIM,1895,15,25-29,1910,9
STAT,1880,23,20-24,1903,84.03612779835557
STAT,1893,24,na,1917,3428.3430217381924
STAT,1946,28,50-100,1974,1.278925939287612
STAT,1816,41,40-44,1857,5.289137987951168
STAT,1958,37,40-44,1995,2.3376697861371474
SIM,1882,21,na,1903,3496
STAT,1967,20,20-24,1987,160.93534480824852
STAT,1848,37,45-49,1885,2.1827796302220124
SIM,1846,33,40-44,1879,1
STAT,1868,49,50-100,1917,0.26662763377779497
SIM,1878,27,25-29,1905,51
STAT,1899,45,45-49,1944,0.2125762473177964
SIM,1937,0,na,1937,4714
STAT,1885,27,20-24,1912,13.5041822250372
SIM,1811,46,25-29,1857,1
SIM,1896,26,30-34,1922,98
SIM,1884,25,20-24,1909,13
SIM,1954,28,50-100,1982,1
SIM,1819,52,na,1871,957
SIM,1824,41,40-44,1865,5
SIM,1845,18,30-34,1863,3
STAT,1830,30,30-34,1860,19.650478506775865
SIM,1894,29,50-100,1923,3
STAT,1969,27,45-49,1996,2.5013381999972686
STAT,1989,17,40-44,2006,2.312060349678755
SIM,1997,17,40-44,2014,5
STAT,1945,47,40-44,1992,0.2067393020138649
STAT,1858,98,na,1956,3.4267472346414176
STAT,1911,54,na,1965,3912.3484696857754
STAT,1915,34,50-100,1949,0.9636258997022258
STAT,1970,26,35-39,1996,21.79260030189953
STAT,1835,70,na,1905,874.4714983137383
SIM,1923,34,50-100,1957,2
SIM,1879,42,35-39,1921,3
SIM,1930,61,na,1991,5448
SIM,1955,35,45-49,1990,1
STAT,1809,47,35-39,1856,0.35940102481502506
STAT,1888,26,30-34,1914,34.278357501734384
STAT,1839,35,45-49,1874,1.928880974777918
STAT,1886,29,50-100,1915,0.7731391278351466
STAT,1837,18,30-34,1855,2.1759504104178315
STAT,1841,20,35-39,1861,6.667909788888904
SIM,1771,86,na,1857,15
SIM,1901,73,na,1974,2465
STAT,1785,107,na,1892,0.002327326763607124
STAT,1880,41,20-24,1921,0.19514566015699653
STAT,1946,15,40-44,1961,1.7912847896361563
STAT,1822,39,15-19,1861,0.12364228457152336
SIM,1792,85,na,1877,44
STAT,1814,48,20-24,1862,0.032818708869133614
SIM,1978,29,na,2007,5987
STAT,1973,25,45-49,1998,2.5919371844932364
STAT,1896,17,25-29,1913,8.637715408370392
SIM,1941,42,na,1983,3935
STAT,1933,38,na,1971,5910.420852963605
SIM,1856,37,45-49,1893,2
SIM,1833,38,25-29,1871,5
SIM,1851,33,45-49,1884,5
STAT,1947,17,45-49,1964,0.6493822765045286
STAT,1864,36,na,1900,2439.3814668425916
STAT,1932,53,na,1985,5630.31269617582
SIM,1850,31,40-44,1881,5
STAT,1869,46,50-100,1915,0.27526391340216155
SIM,1883,40,35-39,1923,1
STAT,1882,2,na,1884,3573.6411822738605
STAT,1838,33,40-44,1871,4.620500622369309
STAT,1862,32,na,1894,2324.105675654702
STAT,1875,40,35-39,1915,2.181359039493974
SIM,1923,21,40-44,1944,1
SIM,1955,17,45-49,1972,1
STAT,1879,97,na,1976,52.5333383519814
STAT,1843,33,45-49,1876,2.081767887052741
STAT,1962,35,40-44,1997,2.2844669358559986
SIM,1917,24,15-19,1941,2
STAT,1886,42,30-34,1928,1.3977809378895072
STAT,1864,50,30-34,1914,0.006221899118787315
SIM,1846,51,na,1897,1452
STAT,1887,15,25-29,1902,7.362961498035359
STAT,1870,36,na,1906,2693.3533729678975
STAT,1843,51,45-49,1894,0.014631151162602512
SIM,1825,52,na,1877,1586
SIM,1834,26,na,1860,1959
SIM,1954,15,40-44,1969,2
STAT,1909,42,15-19,1951,0.0016595068397638026
STAT,1840,40,50-100,1880,0.9967010234400111
STAT,1900,36,30-34,1936,1.8509737087986065
STAT,1865,43,45-49,1908,1.547128241750319
SIM,1987,23,40-44,2010,14
STAT,1886,17,30-34,1903,1.9402350432994941
SIM,1919,31,25-29,1950,20
SIM,1842,37,20-24,1879,1
SIM,1857,32,35-39,1889,17
STAT,1854,74,na,1928,904.141403053275
STAT,1895,17,40-44,1912,0.2747555063793738
SIM,1901,26,15-19,1927,2
STAT,1960,27,25-29,1987,99.36056200684327
STAT,1892,44,15-19,1936,0.0013683824705798579
SIM,1960,19,45-49,1979,2
SIM,1909,28,40-44,1937,12
STAT,1966,47,30-34,2013,0.13365624512761692
STAT,1937,29,20-24,1966,20.525639475803438
SIM,1978,23,30-34,2001,59
SIM,1967,10,na,1977,5779
STAT,1807,106,na,1913,0.005937335041889638
STAT,1840,27,35-39,1867,9.6511302554428
STAT,1951,27,15-19,1978,0.9743404681615888
SIM,1852,4,na,1856,2556
STAT,1952,19,45-49,1971,0.6903874829601203
STAT,1890,13,na,1903,3636.003729178789
SIM,1967,29,40-44,1996,1
STAT,1946,45,35-39,1991,0.17246229064260626
STAT,1823,37,45-49,1860,3.736211418465087
STAT,1980,21,25-29,2001,148.52161303733752
STAT,1849,32,35-39,1881,8.271063346964993
STAT,1887,20,50-100,1907,0.530551517471694
SIM,1823,57,na,1880,1869
STAT,1846,79,na,1925,722.7224935501647
SIM,1867,29,50-100,1896,2
STAT,1976,31,45-49,2007,2.4744574636860466
STAT,1834,37,20-24,1871,0.8750194388900224
STAT,1943,19,35-39,1962,5.1322280180363435
STAT,1968,37,25-29,2005,1.4621539146731573
STAT,1924,36,50-100,1960,0.5717136632396735
SIM,1890,35,50-100,1925,4
STAT,1857,49,25-29,1906,0.050690545262532534
STAT,1858,32,45-49,1890,1.5699387035317935
STAT,1959,29,40-44,1988,7.0596186556897695
STAT,1940,4,na,1944,4711.536934547315
SIM,1866,32,45-49,1898,2
SIM,1923,83,na,2006,2489
STAT,1846,39,50-100,1885,1.2981788787375552
STAT,1896,20,15-19,1916,5.0586603007752515
SIM,1831,37,45-49,1868,3
STAT,1924,45,15-19,1969,5.08350610845285E-4
STAT,1846,24,35-39,1870,7.336909646349945
SIM,1887,30,25-29,1917,17
STAT,1827,32,15-19,1859,0.2465930992598506
STAT,1985,27,15-19,2012,1.1637517836100566
STAT,1869,22,50-100,1891,0.4557499500135966
STAT,1936,23,30-34,1959,31.719318467050662
STAT,1918,18,30-34,1936,15.26713173211569
STAT,1881,114,na,1995,4.8611936483043564E-4
SIM,1839,32,na,1871,2245
SIM,1925,29,35-39,1954,3
SIM,1905,44,45-49,1949,1
STAT,1866,93,na,1959,51.751965626924864
STAT,1917,29,35-39,1946,18.0410433830904
STAT,1959,21,45-49,1980,1.7047093183118307
STAT,1826,30,50-100,1856,0.9745764254380752
STAT,1823,82,na,1905,264.21995496163015
STAT,1970,31,na,2001,5572.482129812817
STAT,1896,39,35-39,1935,10.672648347946629
STAT,1943,63,na,2006,4201.802799844361
STAT,1876,43,20-24,1919,0.18809196771218636
SIM,1985,19,35-39,2004,12
SIM,1818,42,25-29,1860,3
STAT,1813,45,35-39,1858,0.47948355152537914
STAT,1898,25,40-44,1923,4.703819293188517
STAT,1932,47,30-34,1979,0.13959049917279592
STAT,1979,23,40-44,2002,5.358611325394259
STAT,1879,30,25-29,1909,12.441742619548709
SIM,1875,17,na,1892,3344
STAT,1879,49,45-49,1928,0.2784467252369922
STAT,1860,27,20-24,1887,11.028437883790906
STAT,1883,31,na,1914,2705.376281106807
STAT,1875,22,35-39,1897,6.959366790287576
STAT,1903,23,35-39,1926,9.56258912215605
SIM,1890,33,35-39,1923,23
STAT,1976,19,30-34,1995,18.780125728250464
STAT,1815,87,na,1902,97.75948183655933
SIM,1928,23,na,1951,5853
STAT,1904,72,na,1976,2689.4471038066176
SIM,1825,29,30-34,1854,3
SIM,1909,20,45-49,1929,1
STAT,1925,37,15-19,1962,0.026590201394100083
STAT,1919,33,40-44,1952,4.8507102565907845
SIM,1916,44,20-24,1960,1
STAT,1952,46,50-100,1998,0.32616793423056
STAT,1882,33,35-39,1915,11.367207811336359
STAT,1874,39,15-19,1913,0.06567593250786592
SIM,1978,21,20-24,1999,325
STAT,1867,47,na,1914,2412.875760296278
STAT,1910,28,40-44,1938,5.18136517696583
STAT,1821,87,na,1908,107.75070257036425
STAT,1855,51,35-39,1906,0.007360459392123417
SIM,1924,39,na,1963,4894
STAT,1950,41,na,1991,5274.247286050924
STAT,1853,22,15-19,1875,3.8808588902549666
SIM,1802,89,na,1891,37
STAT,1885,25,30-34,1910,29.183776121519692
STAT,1826,54,50-100,1880,0.010091341256100835
STAT,1987,28,na,2015,6195.476693087938
STAT,1914,34,35-39,1948,10.529872597662804
STAT,1872,35,30-34,1907,6.234580017342076
SIM,1909,22,na,1931,4638
STAT,1876,28,25-29,1904,50.287064834140544
SIM,1916,45,50-100,1961,2
STAT,1872,93,na,1965,101.65272932944286
STAT,1887,61,na,1948,2416.7493889253096
SIM,1861,22,15-19,1883,6
SIM,1959,27,25-29,1986,229
SIM,1903,31,na,1934,3961
STAT,1917,44,30-34,1961,0.15346231675255648
SIM,1922,34,35-39,1956,2
SIM,1867,24,45-49,1891,3
STAT,1859,38,35-39,1897,6.46991927158734
STAT,1824,48,15-19,1872,5.362109849823404E-4
SIM,1848,49,na,1897,1645
SIM,1946,27,15-19,1973,5
SIM,1828,34,35-39,1862,25
STAT,1924,15,20-24,1939,187.13259849571494
STAT,2001,13,na,2014,6785.952284860839
SIM,1877,27,40-44,1904,1
STAT,1867,103,na,1970,1.4687985452651529
STAT,1833,100,na,1933,0.7470516923846623
STAT,1928,21,15-19,1949,7.693108868683834
STAT,1953,17,50-100,1970,0.5230401559728288
STAT,1956,32,na,1988,5887.083618510808
STAT,1920,31,25-29,1951,11.726124672669982
SIM,1935,23,20-24,1958,160
STAT,1841,42,45-49,1883,1.3827098497332293
STAT,1908,47,25-29,1955,0.05543323127705675
STAT,1927,23,20-24,1950,157.5786986807228
SIM,1822,37,35-39,1859,14
SIM,1893,25,30-34,1918,50
STAT,1937,21,25-29,1958,103.89669549773345
STAT,1919,28,50-100,1947,1.2364783935900194
STAT,1895,22,20-24,1917,103.51979531236213
STAT,1963,19,20-24,1982,198.642340754548
STAT,1830,53,25-29,1883,0.0028169904030425426
STAT,1877,31,na,1908,2876.3416983607967
STAT,1871,26,50-100,1897,0.7369681276821792
STAT,1836,55,na,1891,1881.7595231197415
SIM,1856,46,50-100,1902,1
STAT,1770,114,na,1884,1.4362647926916976E-4
STAT,1873,47,na,1920,2639.053491223808
STAT,1891,33,45-49,1924,2.476749119426221
STAT,1974,36,50-100,2010,0.6524213910350041
STAT,1891,46,20-24,1937,0.009682158817202568
SIM,1884,25,na,1909,2773
STAT,1797,57,na,1854,1251.0
SIM,1971,19,20-24,1990,405
STAT,1859,12,na,1871,2547.4690992629394
SIM,1935,18,40-44,1953,6
STAT,1934,37,25-29,1971,1.568813478609574
STAT,1837,21,20-24,1858,65.79734092097087
STAT,1933,45,25-29,1978,0.08461697861923925
SIM,1921,36,40-44,1957,1
SIM,1880,63,na,1943,2415
SIM,1864,43,35-39,1907,3
SIM,1884,28,25-29,1912,49
SIM,1912,4,na,1916,4290
STAT,1893,61,na,1954,2725.8133512755994
SIM,1845,21,20-24,1866,69
SIM,1838,48,50-100,1886,1
SIM,1817,57,na,1874,1144
STAT,1808,47,20-24,1855,0.05999366732293373
SIM,1831,34,40-44,1865,3
STAT,1877,100,na,1977,15.439954603702514
SIM,1846,14,na,1860,2052
STAT,1864,37,50-100,1901,1.2651171895898319
STAT,1852,79,na,1931,659.1258214547785
SIM,1942,37,25-29,1979,1
SIM,1938,53,na,1991,3990
STAT,1833,45,20-24,1878,0.010218210426048344
STAT,1930,27,na,1957,5497.898804955628
STAT,1940,16,15-19,1956,53.20979152526115
SIM,1867,35,30-34,1902,12
SIM,1981,26,40-44,2007,18
STAT,1898,39,na,1937,3666.2915602808844
STAT,1859,24,45-49,1883,0.655595430513175
STAT,1843,19,30-34,1862,2.0197376421638427
SIM,1944,53,na,1997,4416
STAT,1850,38,15-19,1888,0.05811690055157389
STAT,1933,79,na,2012,3162.7846154158815
SIM,1852,14,na,1866,2454
SIM,1931,34,45-49,1965,6
STAT,1958,45,15-19,2003,5.835045934282128E-4
SIM,1860,49,na,1909,2265
STAT,1897,85,na,1982,1058.8274983178076
STAT,1923,34,45-49,1957,2.07839046065291
STAT,1881,35,40-44,1916,4.919002640927733
STAT,1927,18,40-44,1945,2.0013436938916684
STAT,1913,36,40-44,1949,1.7140033620019428
STAT,1984,29,20-24,2013,30.018913542402547
STAT,1842,107,na,1949,0.003629045429287921
STAT,1977,17,25-29,1994,67.57237170637782
STAT,1989,20,30-34,2009,47.698853950920864
SIM,1918,39,na,1957,3813
SIM,1950,39,40-44,1989,3
SIM,1898,43,50-100,1941,1
STAT,1808,53,15-19,1861,1.1491078051210454E-4
SIM,1799,58,na,1857,931
STAT,1874,49,50-100,1923,0.28410504967338984
STAT,1964,17,15-19,1981,65.96550847157731
SIM,1853,26,40-44,1879,10
SIM,1913,29,45-49,1942,4
STAT,1865,40,40-44,1905,2.3657044776442095
STAT,1956,26,20-24,1982,28.008199655184388
SIM,1821,39,40-44,1860,2
SIM,1858,70,na,1928,1780
SIM,1914,16,15-19,1930,21
SIM,1950,57,na,2007,4367
SIM,1912,42,na,1954,3701
STAT,1942,39,40-44,1981,1.8563648560143085
STAT,1971,16,45-49,1987,0.7303662655883633
SIM,1911,66,na,1977,3974
STAT,1919,16,25-29,1935,11.112593222513778
STAT,1900,39,35-39,1939,2.420069771250373
SIM,1907,99,na,2006,47
STAT,1869,32,20-24,1901,3.0209609162302296
STAT,1905,29,45-49,1934,1.8413091727674495
STAT,1778,84,na,1862,138.88131286353044
SIM,1877,32,20-24,1909,6
SIM,1962,47,40-44,2009,1
SIM,1982,25,na,2007,6454
STAT,1905,91,na,1996,500.0915127418816
SIM,1868,27,30-34,1895,64
STAT,1803,68,na,1871,750.7049711971306
SIM,1969,43,na,2012,5715
STAT,1806,79,na,1885,292.6199623993351
STAT,1877,23,15-19,1900,3.9480593310306418
STAT,1920,47,40-44,1967,0.20104346467636758
SIM,1960,16,40-44,1976,3
STAT,1913,15,45-49,1928,0.11847904460770324
SIM,1866,68,na,1934,1589
STAT,1845,26,40-44,1871,2.4747350659725655
SIM,1973,10,na,1983,5491
SIM,1892,22,45-49,1914,1
SIM,1885,23,15-19,1908,8
STAT,1895,47,35-39,1942,0.1180775307790772
SIM,1995,16,25-29,2011,166
STAT,1823,34,40-44,1857,9.81913558303015
STAT,1960,24,20-24,1984,167.57254366417945
STAT,1927,79,na,2006,2885.083088588945
STAT,1969,26,30-34,1995,56.75639748868314
STAT,1937,63,na,2000,3847.571033875443
STAT,1851,23,50-100,1874,0.38340091451117225
STAT,1952,16,40-44,1968,1.9349230195927212
SIM,1906,25,20-24,1931,2
STAT,1851,111,na,1962,2.5352732979471766E-4
STAT,1953,16,25-29,1969,60.51526785946149
SIM,1915,7,na,1922,5076
STAT,1901,30,na,1931,3888.4371985489815
SIM,1980,31,50-100,2011,3
STAT,1934,48,50-100,1982,0.3628339596390931
STAT,1955,42,40-44,1997,0.39822852332586983
STAT,1881,41,35-39,1922,2.0247899438647097
SIM,1993,21,50-100,2014,2
STAT,1972,27,15-19,1999,1.0476293917909376
SIM,1871,52,na,1923,1794
SIM,1886,82,na,1968,253
SIM,1788,80,na,1868,27
SIM,1843,71,na,1914,954
STAT,1982,16,20-24,1998,220.22580160942064
SIM,1922,26,15-19,1948,1
STAT,1986,6,na,1992,6464.394004269244
STAT,1972,31,50-100,2003,1.246005902393491
STAT,1914,26,15-19,1940,0.8245151560545153
SIM,1871,36,35-39,1907,2
SIM,1966,39,20-24,2005,2
STAT,1955,20,30-34,1975,44.2079557589092
STAT,1853,16,20-24,1869,21.358641203731562
STAT,1856,43,35-39,1899,1.582812604826869
STAT,1855,45,40-44,1900,0.14712561720724646
STAT,1998,17,15-19,2015,76.90040436739413
STAT,1938,27,15-19,1965,0.8075262869157536
STAT,1908,34,na,1942,4089.8305315771777
STAT,1906,16,15-19,1922,10.011611835739863
SIM,1880,35,30-34,1915,17
SIM,1893,28,35-39,1921,30
STAT,1940,57,na,1997,4282.380755119804
STAT,1837,109,na,1946,5.151880224630376E-4
STAT,1967,45,25-29,2012,0.07991318513641078
SIM,1872,28,35-39,1900,20
SIM,1927,41,na,1968,4996
STAT,1893,18,50-100,1911,0.07127812247702921
STAT,1858,0,na,1858,3538.7809286667434
SIM,1839,19,15-19,1858,11
STAT,1871,16,40-44,1887,0.21260429311771706
STAT,1879,46,40-44,1925,0.20688495392925416
STAT,1968,34,20-24,2002,3.579159663177768
STAT,1937,15,30-34,1952,13.755360240717584
STAT,1834,43,15-19,1877,0.014999658551572393
SIM,1842,40,50-100,1882,2
SIM,1817,88,na,1905,24
SIM,1943,21,50-100,1964,1
STAT,1873,50,40-44,1923,0.012585018000504116
SIM,1976,34,20-24,2010,1
STAT,1846,21,30-34,1867,22.884668123343783
SIM,1873,40,40-44,1913,2
STAT,1854,31,30-34,1885,14.718666795548687
SIM,1867,81,na,1948,493
STAT,1931,19,45-49,1950,0.7506911823010857
STAT,1842,16,45-49,1858,0.06493229073007334
STAT,1848,74,na,1922,1179.1811082938366
STAT,1880,28,50-100,1908,0.7797437155776608
STAT,1988,23,50-100,2011,1.089278784442528
STAT,1946,21,35-39,1967,12.09605732227491
STAT,1883,39,25-29,1922,3.218160667889693
STAT,1790,84,na,1874,113.12767223803641
STAT,1885,28,35-39,1913,11.067874348792115
STAT,1947,48,20-24,1995,0.014901268910119305
STAT,1831,40,na,1871,2062.934237806964
STAT,1950,35,15-19,1985,0.027043156926412064
SIM,1935,26,25-29,1961,187
SIM,1887,36,na,1923,3729
SIM,1968,27,35-39,1995,52
SIM,1886,15,15-19,1901,13
STAT,1908,44,20-24,1952,0.01864835474585983
STAT,1843,45,15-19,1888,4.0984926975018063E-4
STAT,1846,45,30-34,1891,0.10106776324535396
STAT,1860,33,15-19,1893,0.13189565122341512
SIM,1908,39,45-49,1947,1
STAT,1852,42,20-24,1894,0.14954671621011684
STAT,1942,44,20-24,1986,0.02206456679595582
STAT,1911,31,15-19,1942,0.1451233708026335
STAT,1940,27,50-100,1967,1.1717164606114165
SIM,1892,82,na,1974,1451
STAT,1901,28,30-34,1929,40.56282075803789
SIM,1828,31,30-34,1859,9
SIM,1903,29,50-100,1932,4
STAT,1867,31,40-44,1898,4.691857705457437
SIM,1934,23,na,1957,5101
SIM,1940,23,na,1963,4398
STAT,1933,42,20-24,1975,0.028014796981432357
STAT,1917,45,na,1962,4449.3812075999895
STAT,1860,43,50-100,1903,0.975516849947896
STAT,1903,17,40-44,1920,0.30065187774148966
SIM,1926,24,25-29,1950,237
STAT,1976,39,40-44,2015,2.37280689125448
STAT,1914,31,30-34,1945,18.38578324038534
SIM,1976,21,na,1997,5593
STAT,1822,45,45-49,1867,0.4589874796626132
SIM,1854,45,30-34,1899,1
SIM,1954,21,35-39,1975,17
STAT,1875,48,30-34,1923,0.11399268827368678
STAT,1862,22,25-29,1884,57.07408983704379
SIM,1883,48,30-34,1931,1
STAT,1837,37,50-100,1874,1.082424665292231
STAT,1856,2,na,1858,3117.842639812116
STAT,1918,24,25-29,1942,114.22534634346162
STAT,1859,35,30-34,1894,4.946037171514278
STAT,1859,21,40-44,1880,2.1999243678463496
STAT,1898,28,45-49,1926,1.725622289112429
STAT,1934,57,na,1991,5650.389270950557
SIM,1858,38,25-29,1896,7
SIM,1922,31,30-34,1953,80
STAT,1826,52,20-24,1878,5.129987270518028E-4
SIM,1867,21,40-44,1888,4
SIM,1981,29,45-49,2010,1
STAT,1828,41,30-34,1869,1.1238272947194545
STAT,1784,84,na,1868,112.06224936403471
STAT,1987,16,25-29,2003,71.4146566521964
STAT,1880,29,na,1909,2898.4289023007054
STAT,1913,39,45-49,1952,0.7689891022110908
STAT,1966,33,50-100,1999,1.2140374263076583
STAT,1868,23,na,1891,2614.186452639161
STAT,1978,13,na,1991,6185.659512126113
SIM,1800,100,na,1900,1
SIM,1869,36,50-100,1905,1
SIM,1934,29,45-49,1963,2
STAT,1954,47,40-44,2001,0.2339633867312072
STAT,1837,24,25-29,1861,53.48895673788935
STAT,1957,14,na,1971,5974.728045385238
STAT,1836,32,25-29,1868,11.78671624241141
STAT,1934,34,20-24,1968,3.8402481881971653
STAT,1916,49,40-44,1965,0.18554754703802337
STAT,1860,9,na,1869,2613.4748846386037
SIM,1844,32,25-29,1876,16
SIM,1885,27,50-100,1912,1
SIM,1916,21,50-100,1937,1
STAT,1891,30,40-44,1921,6.235257812168135
STAT,1959,35,35-39,1994,3.768240994079462
STAT,1817,82,na,1899,322.57648308721673
STAT,1830,50,20-24,1880,6.84420144433221E-4
SIM,1887,67,na,1954,2781
STAT,1908,21,50-100,1929,0.7011002650635922
STAT,1872,101,na,1973,6.940566408529845
STAT,1860,74,na,1934,1032.2239551448238
STAT,1927,26,25-29,1953,92.64159893447597
SIM,1964,26,20-24,1990,34
SIM,1958,29,30-34,1987,73
STAT,1906,38,50-100,1944,0.44374464478579106
SIM,1918,33,30-34,1951,5
STAT,1884,22,45-49,1906,0.795100691349773
SIM,1891,39,25-29,1930,8
SIM,1845,24,25-29,1869,4
SIM,1835,26,20-24,1861,25
SIM,1836,41,30-34,1877,3
STAT,1973,29,45-49,2002,2.587119537111049
STAT,1832,25,na,1857,1970.6988065435335
SIM,1876,4,na,1880,3181
STAT,1909,87,na,1996,1006.4854569569819
SIM,1928,31,35-39,1959,27
SIM,1905,66,na,1971,3195
SIM,1867,38,35-39,1905,26
STAT,1802,83,na,1885,188.76210627106144
SIM,1872,68,na,1940,1911
SIM,1921,20,25-29,1941,7
STAT,1952,42,25-29,1994,0.10263164887293595
STAT,1851,49,20-24,1900,0.00931725277449611
SIM,1919,25,30-34,1944,105
STAT,1799,83,na,1882,186.98904868897435
SIM,1912,37,45-49,1949,2
STAT,1891,49,25-29,1940,0.045375182399603996
STAT,1874,29,na,1903,2799.399426781512
SIM,1959,2,na,1961,6034
SIM,1988,21,35-39,2009,17
STAT,1904,37,45-49,1941,0.7130626273233827
STAT,1913,20,25-29,1933,103.96600086783538
STAT,1963,14,na,1977,5757.167459789551
SIM,1893,36,na,1929,3377
STAT,1926,29,45-49,1955,2.3724656004721743
STAT,1963,27,40-44,1990,6.8633783019407275
SIM,1831,40,35-39,1871,3
SIM,1875,48,na,1923,2945
STAT,1781,73,na,1854,357.0
STAT,1855,50,na,1905,1858.449137389633
SIM,1908,19,25-29,1927,18
SIM,1886,35,35-39,1921,3
SIM,1917,30,45-49,1947,4
STAT,1827,29,25-29,1856,93.38743527457888
STAT,1984,13,na,1997,6437.38771361556
STAT,1977,16,50-100,1993,0.5843626826609273
SIM,1958,3,na,1961,6241
SIM,1971,27,40-44,1998,21
STAT,1890,15,30-34,1905,2.2579899339638403
STAT,1879,3,na,1882,3671.8088267734042
STAT,1853,30,50-100,1883,0.9591226055058166
SIM,1882,42,40-44,1924,8
STAT,1956,40,35-39,1996,0.3204537034621144
STAT,1937,26,50-100,1963,1.120834970060728
STAT,1930,27,45-49,1957,2.535465207307746
STAT,1878,35,35-39,1913,8.603495793439404
SIM,1910,81,na,1991,1009
STAT,1922,69,na,1991,3912.9264922880507
SIM,1952,11,na,1963,4844
STAT,1973,19,15-19,1992,67.69125353723629
SIM,1895,62,na,1957,2693
STAT,1882,35,50-100,1917,1.3970734113516452
SIM,1845,46,35-39,1891,1
STAT,1992,12,na,2004,6506.918510591462
STAT,1848,52,40-44,1900,0.011126370888501111
STAT,1921,82,na,2003,2096.5910867645816
STAT,1837,100,na,1937,0.7687670279497046
STAT,1953,21,na,1974,5116.646530964985
SIM,1823,88,na,1911,388
SIM,1844,29,35-39,1873,2
STAT,1843,68,na,1911,1533.3643300582937
SIM,1826,68,na,1894,1092
SIM,1921,59,na,1980,4917
STAT,1874,42,40-44,1916,2.6541290311297683
SIM,1962,31,35-39,1993,4
STAT,1855,48,45-49,1903,0.19828814648167786
STAT,1871,12,na,1883,3031.3753831355
STAT,1910,36,25-29,1946,1.0930977662972572
STAT,1941,27,20-24,1968,21.79744001973057
STAT,1851,47,30-34,1898,0.07640403157973605
STAT,1877,27,50-100,1904,0.7679154805349838
SIM,1932,36,50-100,1968,2
SIM,1971,30,20-24,2001,6
STAT,1836,29,35-39,1865,11.204006432425082
STAT,1934,40,15-19,1974,0.0024750631636573164
STAT,1937,37,40-44,1974,1.728450365698391
STAT,1824,98,na,1922,2.0100387564376803
SIM,1858,16,15-19,1874,10
SIM,1988,23,25-29,2011,307
STAT,1849,59,na,1908,1506.317298078325
STAT,1901,36,15-19,1937,0.019686828538500033
STAT,1856,40,30-34,1896,1.0224382777532117
STAT,1885,114,na,1999,5.596912910287899E-4
SIM,1928,30,20-24,1958,8
SIM,1900,26,30-34,1926,4
SIM,1831,83,na,1914,248
STAT,1846,48,na,1894,2296.620792209057
SIM,1955,29,15-19,1984,1
STAT,1886,25,15-19,1911,0.5560441248775327
SIM,1906,42,na,1948,3542
STAT,1819,39,50-100,1858,2.9153303460253053
SIM,1814,49,50-100,1863,1
SIM,1894,20,20-24,1914,194
STAT,1954,31,35-39,1985,13.297052618780617
STAT,1902,15,na,1917,4137.458440760669
SIM,1899,35,45-49,1934,6
STAT,1886,20,20-24,1906,84.38847032895696
STAT,1871,24,25-29,1895,65.31374482459493
STAT,1960,30,15-19,1990,0.19710750487009568
STAT,1768,91,na,1859,16.544660053859985
STAT,1859,29,50-100,1888,0.5896632931171335
STAT,1837,46,35-39,1883,0.1065930793102922
STAT,1860,49,30-34,1909,0.0881546656282842
STAT,1977,35,na,2012,6054.291071512842
STAT,1940,21,30-34,1961,33.81080100903602
SIM,1868,49,40-44,1917,1
SIM,1820,77,na,1897,1003
SIM,1980,1,na,1981,6017
STAT,1844,52,50-100,1896,0.01256503320753743
STAT,1914,34,na,1948,4357.9466861110595
STAT,1933,23,15-19,1956,8.149575056924736
SIM,1868,63,na,1931,2366
STAT,1869,73,na,1942,1327.442241809235
STAT,1909,19,35-39,1928,0.945605736677148
SIM,1862,31,30-34,1893,48
STAT,1881,3,na,1884,3349.3105585620247
SIM,1932,37,30-34,1969,5
SIM,1861,19,25-29,1880,3
STAT,1872,38,35-39,1910,8.15546426475909
SIM,1941,23,15-19,1964,11
SIM,1837,32,50-100,1869,2
SIM,1877,35,25-29,1912,2
SIM,1972,32,na,2004,5767
SIM,1880,38,35-39,1918,24
STAT,1985,30,na,2015,6334.936556920503
STAT,1869,35,25-29,1904,3.248374669382604
SIM,1930,20,35-39,1950,16
STAT,1942,34,50-100,1976,1.0152622312040167
STAT,1830,27,40-44,1857,3.765638395258153
STAT,1924,37,30-34,1961,2.4795256507741987
SIM,1919,15,na,1934,5534
STAT,1853,19,25-29,1872,6.707127901640873
STAT,1815,46,15-19,1861,8.287807971142328E-4
STAT,1947,29,15-19,1976,0.9207633261663799
STAT,1823,40,35-39,1863,1.9730510193807553
STAT,1926,22,na,1948,5118.874989719254
STAT,1909,30,45-49,1939,1.7488218886542237
SIM,1935,24,35-39,1959,19
STAT,1820,53,30-34,1873,0.005730003547729968
STAT,1951,44,30-34,1995,0.18197609895904693
SIM,1825,83,na,1908,473
STAT,1919,36,45-49,1955,0.8457668864304488
STAT,1826,110,na,1936,1.5215328505670085E-4
SIM,1960,6,na,1966,6328
SIM,1773,81,na,1854,33
STAT,1902,44,50-100,1946,0.11801170396984367
STAT,1868,51,50-100,1919,0.01682556026565597
STAT,1811,53,20-24,1864,0.0021526304085805296
STAT,1848,49,15-19,1897,4.161368253008072E-4
STAT,1920,34,na,1954,4737.847724371198
SIM,1954,23,25-29,1977,9
STAT,1877,37,40-44,1914,5.2549510287659436
STAT,1919,5,na,1924,5126.545408083588
STAT,1946,23,25-29,1969,118.58309041127984
STAT,1872,33,40-44,1905,5.0041894747363385
STAT,1935,20,45-49,1955,1.7704134005267451
STAT,1975,27,20-24,2002,27.911157829482946
SIM,1794,80,na,1874,78
STAT,1916,35,15-19,1951,0.022912556747100986
SIM,1944,26,35-39,1970,37
STAT,1931,16,40-44,1947,2.118459073930534
STAT,1951,47,35-39,1998,0.18429422035489515
SIM,1836,21,na,1857,1919
STAT,1916,69,na,1985,3495.4109129405097
SIM,1983,27,20-24,2010,34
STAT,1857,85,na,1942,246.39495293169787
STAT,1858,9,na,1867,2562.1666012190162
STAT,1873,53,45-49,1926,0.016828129961173544
STAT,1933,70,na,2003,4571.898276861875
STAT,1992,15,20-24,2007,224.69781999683144
STAT,1866,48,20-24,1914,0.012674658848121747
STAT,1927,24,35-39,1951,13.301262847005205
STAT,1962,41,25-29,2003,0.10989251120761558
SIM,1818,36,30-34,1854,6
SIM,1838,56,na,1894,1432
STAT,1979,30,na,2009,6132.670935700736
SIM,1918,30,na,1948,3940
SIM,1827,36,40-44,1863,8
SIM,1899,55,na,1954,3425
STAT,1886,39,40-44,1925,5.275151143253947
SIM,1894,39,40-44,1933,2
SIM,1963,20,30-34,1983,60
STAT,1851,94,na,1945,15.848856283442801
SIM,1857,20,na,1877,2611
STAT,1907,33,15-19,1940,0.1382583015945716
STAT,1835,20,40-44,1855,2.713342966141158
STAT,1911,22,50-100,1933,0.7207863818523658
SIM,1981,0,na,1981,6487
STAT,1945,26,45-49,1971,2.188326776570393
STAT,1842,47,20-24,1889,0.009235846157055005
STAT,1901,31,20-24,1932,4.387304128157601
STAT,1929,21,50-100,1950,0.9632142306154503
STAT,1862,19,35-39,1881,0.5504283630390302
STAT,1914,101,na,2015,25.546698440540176
SIM,1937,30,30-34,1967,6
SIM,1943,20,45-49,1963,2
SIM,1909,34,35-39,1943,24
SIM,1849,22,35-39,1871,9
STAT,1819,36,40-44,1855,14.052232414329998
SIM,1835,29,25-29,1864,63
SIM,1870,19,35-39,1889,1
STAT,1841,36,15-19,1877,0.05943718064059612
STAT,1971,43,25-29,2014,0.10830031743129985
SIM,1880,33,40-44,1913,12
STAT,1877,17,20-24,1894,21.28212552722776
SIM,1904,30,35-39,1934,37
STAT,1827,103,na,1930,0.11655147469433134
SIM,1927,28,50-100,1955,6
STAT,1867,78,na,1945,841.8769483323612
STAT,1950,27,30-34,1977,53.6974564657367
STAT,1910,33,20-24,1943,2.705515653178999
SIM,1872,37,50-100,1909,6
STAT,1850,13,na,1863,2989.431076192284
SIM,1914,77,na,1991,2143
SIM,1843,20,40-44,1863,3
STAT,1915,37,20-24,1952,0.3073769248273826
STAT,1853,17,35-39,1870,0.657169650565579
SIM,1908,77,na,1985,1823
STAT,1844,13,na,1857,2526.6747060958396
SIM,1978,26,35-39,2004,59
STAT,1892,38,20-24,1930,1.1094519878671878
STAT,1882,55,na,1937,2330.7577483938403
STAT,1942,47,25-29,1989,0.06655391501032734
STAT,1846,46,45-49,1892,0.24466525866952882
SIM,1932,39,20-24,1971,1
SIM,1822,72,na,1894,740
STAT,1840,20,na,1860,2212.899127446754
STAT,1846,23,20-24,1869,87.26981001360184
SIM,1861,17,35-39,1878,1
SIM,1913,26,40-44,1939,11
STAT,1908,45,50-100,1953,0.23983568602491098
SIM,1968,24,30-34,1992,91
STAT,1888,77,na,1965,1549.8511937576907
STAT,1983,24,45-49,2007,1.8417140465384632
SIM,1918,36,35-39,1954,3
STAT,1883,36,20-24,1919,0.8745486200974827
STAT,1831,25,35-39,1856,10.204660173152673
STAT,1929,30,30-34,1959,23.122596428186363
STAT,1865,12,na,1877,2814.829390414977
STAT,1905,26,40-44,1931,5.020728141249798
STAT,1924,39,20-24,1963,0.35786523349695265
SIM,1854,23,20-24,1877,155
SIM,1950,47,25-29,1997,1
SIM,1953,26,45-49,1979,3
STAT,1880,4,na,1884,3494.0390687370314
STAT,1962,16,35-39,1978,6.206487394772113
STAT,1884,42,50-100,1926,1.2031055671205844
SIM,1892,42,50-100,1934,1
STAT,1806,52,35-39,1858,0.03030380938057754
SIM,1854,49,na,1903,2309
SIM,1982,24,35-39,2006,41
STAT,1933,39,30-34,1972,2.860054931374451
SIM,1813,95,na,1908,8
STAT,1920,9,na,1929,5152.116387337489
STAT,1899,23,35-39,1922,9.197795722529039
STAT,1842,45,50-100,1887,0.19393308615138397
SIM,1940,25,20-24,1965,45
STAT,1897,48,15-19,1945,3.4380718090364976E-4
SIM,1886,37,25-29,1923,4
SIM,1904,24,40-44,1928,8
STAT,1946,43,45-49,1989,0.2210360413954191
SIM,1903,15,25-29,1918,23
STAT,1836,26,30-34,1862,29.87935391930583
STAT,1815,52,45-49,1867,0.02847484130523803
STAT,1932,25,20-24,1957,27.622692833267358
STAT,1844,17,25-29,1861,6.025073042791827
STAT,1926,43,50-100,1969,0.16684035860896984
SIM,1852,17,25-29,1869,12
SIM,1987,26,45-49,2013,9
SIM,1889,62,na,1951,2944
STAT,1859,18,15-19,1877,6.295578055290753
SIM,1894,23,25-29,1917,100
SIM,1899,32,40-44,1931,12
SIM,1970,16,35-39,1986,9
STAT,1891,66,na,1957,2398.3036476688094
SIM,1805,69,na,1874,931
STAT,1904,15,35-39,1919,0.913556210412717
SIM,1907,92,na,1999,487
SIM,1890,30,30-34,1920,29
SIM,1982,8,na,1990,6829
STAT,1964,4,na,1968,5716.150748692194
STAT,1979,26,45-49,2005,2.7582496957770557
STAT,1909,16,30-34,1925,2.768351762213048
SIM,1917,16,30-34,1933,10
STAT,1884,81,na,1965,946.0978431449149
SIM,1874,63,na,1937,1850
STAT,1834,20,na,1854,2541.4730589973747
STAT,1932,22,na,1954,5530.939868058585
STAT,1789,90,na,1879,24.96754024848498
SIM,1903,31,50-100,1934,2
SIM,1869,48,na,1917,1806
SIM,1872,31,25-29,1903,29
STAT,1866,17,45-49,1883,0.07171895183326153
SIM,1850,45,50-100,1895,2
STAT,1828,44,35-39,1872,1.687382375913849
SIM,1835,27,35-39,1862,1
SIM,1822,34,30-34,1856,7
STAT,1935,19,50-100,1954,0.5882247545263377
SIM,1943,19,50-100,1962,1
STAT,1988,25,40-44,2013,7.733226031191158
SIM,1876,21,15-19,1897,3
SIM,1905,41,40-44,1946,2
SIM,1958,27,40-44,1985,9
STAT,1941,3,na,1944,4794.819139436529
STAT,1944,41,50-100,1985,0.15185168942737703
STAT,1882,30,30-34,1912,19.83905286873855
STAT,1910,41,na,1951,4078.2221113295104
STAT,1857,46,20-24,1903,0.010816351225658518
STAT,1996,16,35-39,2012,7.039636994934144
STAT,1769,110,na,1879,0.0028767979761238956
STAT,1919,40,na,1959,4656.501419112492
STAT,1936,26,35-39,1962,16.598963853179214
SIM,1990,20,na,2010,5847
STAT,1967,42,na,2009,5563.9343962737
SIM,1830,25,25-29,1855,85
STAT,1878,37,25-29,1915,3.4693046457382133
STAT,1800,88,na,1888,64.9519142262438
STAT,1803,99,na,1902,0.6600876100985688
STAT,1980,15,40-44,1995,2.242047707155765
SIM,1988,20,20-24,2008,189
STAT,1899,80,na,1979,1703.8068679101866
STAT,1965,34,15-19,1999,0.18847857351823644
STAT,1960,32,50-100,1992,1.26674954226011
STAT,1868,21,15-19,1889,3.6843043429697944
STAT,1950,29,20-24,1979,24.991188359516435
STAT,1832,42,35-39,1874,1.538756949821497
STAT,1865,37,15-19,1902,0.058471278374046864
STAT,1943,42,15-19,1985,0.001953268967713448
SIM,1828,94,na,1922,37
STAT,1928,35,40-44,1963,2.187058609111884
STAT,1836,86,na,1922,201.92236905719062
SIM,1868,33,25-29,1901,18
SIM,1968,30,25-29,1998,3
STAT,1824,47,50-100,1871,0.3336199586110422
STAT,1827,27,35-39,1854,37.19888290362256
SIM,1928,33,25-29,1961,25
STAT,1947,21,na,1968,4764.442367957953
SIM,1851,38,na,1889,2671
SIM,1862,34,35-39,1896,29
SIM,1835,76,na,1911,886
SIM,1867,18,15-19,1885,5
SIM,1840,42,35-39,1882,2
SIM,1924,30,na,1954,4828
STAT,1818,98,na,1916,1.4373533712045088
SIM,1844,26,30-34,1870,61
STAT,1925,40,na,1965,5201.808716456622
SIM,1868,30,20-24,1898,4
SIM,1941,39,30-34,1980,2
STAT,1846,48,35-39,1894,0.14291096286101806
STAT,1989,23,na,2012,6054.328673214951
SIM,1904,16,na,1920,4344
STAT,1883,50,35-39,1933,0.00986010887337723
STAT,1857,1,na,1858,3353.5923538148745
SIM,1931,31,40-44,1962,9
SIM,1954,20,20-24,1974,293
STAT,1984,27,30-34,2011,64.50030626407013
STAT,1850,41,40-44,1891,2.325985231971235
STAT,1795,90,na,1885,27.09662105569206
SIM,1836,24,15-19,1860,6
STAT,1881,38,45-49,1919,2.208001786425755
SIM,1936,35,40-44,1971,4
STAT,1904,41,na,1945,3860.8495297558734
STAT,1895,49,50-100,1944,0.20376673459583466
SIM,1901,43,30-34,1944,1
SIM,1862,75,na,1937,1280
STAT,1922,20,35-39,1942,12.530177073171048
STAT,1774,91,na,1865,0.7378609742685768
SIM,1843,23,45-49,1866,1
STAT,1905,18,20-24,1923,29.534777360223163
STAT,1900,19,15-19,1919,9.452362100110474
SIM,1950,34,50-100,1984,3
STAT,1822,32,na,1854,2341.457881578218
STAT,1871,18,30-34,1889,1.8309340133367582
SIM,1984,20,na,2004,6285
STAT,1854,34,35-39,1888,8.275345245614767
STAT,1791,104,na,1895,0.014278206887557546
SIM,1914,38,25-29,1952,4
STAT,1839,97,na,1936,4.260455570217738
STAT,1946,20,20-24,1966,142.89649860938644
SIM,1979,21,25-29,2000,10
SIM,1877,74,na,1951,1287
STAT,1896,36,30-34,1932,8.162901636135642
SIM,1856,75,na,1931,898
STAT,1837,31,na,1868,1988.183394128992
SIM,1818,39,35-39,1857,20
STAT,1846,43,40-44,1889,2.323451982230322
SIM,1898,73,na,1971,2601
STAT,1931,22,35-39,1953,14.096584847774036
SIM,1936,58,na,1994,3729
SIM,1945,37,40-44,1982,5
SIM,1810,84,na,1894,61
STAT,1847,30,50-100,1877,0.8451409731730638
STAT,1833,48,25-29,1881,0.04294917368869407
SIM,1854,43,40-44,1897,5
STAT,1980,24,na,2004,5865.829578111145
STAT,1879,66,na,1945,1975.0381693756403
STAT,1992,18,25-29,2010,71.76113453980817
STAT,1840,19,15-19,1859,6.091421610296792
SIM,1839,25,45-49,1864,3
SIM,1841,76,na,1917,767
STAT,1879,52,35-39,1931,0.010318852315432869
STAT,1967,39,30-34,2006,2.7010666530613348
STAT,1863,36,35-39,1899,7.17170941395986
STAT,1886,23,25-29,1909,69.47039232737711
STAT,1907,49,30-34,1956,0.09126709978846766
STAT,1802,54,25-29,1856,0.013542091425491874
STAT,1887,34,30-34,1921,22.387724347374817
STAT,1961,46,50-100,2007,0.3516464620717871
SIM,1870,16,30-34,1886,4
STAT,1940,24,35-39,1964,11.065568952273345
STAT,1824,51,40-44,1875,0.014084678713587123
SIM,1975,39,30-34,2014,9
STAT,1890,21,25-29,1911,80.966903715612
SIM,1895,34,30-34,1929,32
STAT,1780,91,na,1871,25.528924426555047
SIM,1895,20,50-100,1915,1
STAT,1895,25,25-29,1920,63.975964114786166
STAT,1901,34,25-29,1935,16.415238726704803
STAT,1906,38,25-29,1944,1.0406319358314287
STAT,1945,23,40-44,1968,4.25138908437006
STAT,1835,23,45-49,1858,0.5837149110250676
SIM,1953,23,40-44,1976,7
STAT,1948,46,15-19,1994,5.072879951059865E-4
STAT,1983,21,40-44,2004,5.509163816846508
SIM,1974,28,25-29,2002,180
STAT,1923,31,40-44,1954,5.196579535177434
SIM,1874,44,50-100,1918,2
SIM,1966,37,30-34,2003,8
STAT,1840,24,30-34,1864,17.91140362128842
STAT,1968,40,15-19,2008,0.0023067900315417323
SIM,1937,9,na,1946,4503
STAT,1974,20,na,1994,5524.990631770129
STAT,1864,67,na,1931,1633.4743628886515
STAT,1878,32,30-34,1910,21.038183546220267
STAT,1870,67,na,1937,1803.5406699376344
STAT,1866,44,50-100,1910,1.114792797065237
STAT,1872,36,45-49,1908,2.3211752227436895
STAT,1971,18,35-39,1989,6.131397270668503
STAT,1890,81,na,1971,1296.4046188627365
SIM,1886,32,30-34,1918,7
STAT,1954,25,40-44,1979,6.684308680474018
STAT,1903,96,na,1999,143.52381439592781
SIM,1962,25,40-44,1987,9
SIM,1804,84,na,1888,121
STAT,1885,66,na,1951,1886.679756273969
SIM,1897,29,na,1926,3763
STAT,1862,16,30-34,1878,1.788408129308075
STAT,1781,107,na,1888,0.006218422368705668
STAT,1939,44,15-19,1983,0.0018382056657020394
STAT,1976,17,40-44,1993,2.156541121976642
STAT,1950,41,45-49,1991,0.23635138787937876
SIM,1970,33,20-24,2003,1
STAT,1879,33,40-44,1912,5.203772276838771
SIM,1926,15,15-19,1941,115
SIM,1927,74,na,2001,2979
SIM,1926,11,na,1937,6199
SIM,1888,20,na,1908,2846
STAT,1882,43,40-44,1925,2.517102177378154
STAT,1827,73,na,1900,964.5981532667795
STAT,1964,26,50-100,1990,1.4536671758052992
STAT,1975,23,45-49,1998,1.718134079656804
STAT,1926,20,45-49,1946,1.5866110621158056
SIM,1841,43,45-49,1884,5
STAT,1843,34,15-19,1877,0.16824954670778913
SIM,1945,20,20-24,1965,1
STAT,1769,94,na,1863,5.851207452673437
STAT,1971,31,20-24,2002,3.63624180586039
SIM,1903,42,50-100,1945,1
SIM,1800,83,na,1883,174
STAT,1976,16,15-19,1992,69.99165228200349
SIM,1853,22,30-34,1875,49
STAT,1995,18,50-100,2013,0.6256755034590322
SIM,1987,22,35-39,2009,20
SIM,1890,43,40-44,1933,11
SIM,1929,37,50-100,1966,1
SIM,1959,38,na,1997,5910
STAT,1974,32,na,2006,5809.4120836876455
SIM,1887,33,40-44,1920,32
STAT,1873,45,40-44,1918,0.20376889785704558
SIM,1826,76,na,1902,569
STAT,1979,22,35-39,2001,15.011162033802815
STAT,1863,38,35-39,1901,7.101955635514694
STAT,1852,72,na,1924,1190.674280175522
STAT,1863,26,40-44,1889,3.0447150252979287
STAT,1854,28,40-44,1882,2.5400459516973175
SIM,1862,28,40-44,1890,11
STAT,1847,50,35-39,1897,0.006719471718800035
STAT,1838,52,35-39,1890,0.0074189560666505835
STAT,1813,44,30-34,1857,3.9812414200666812
SIM,1951,10,na,1961,6323
SIM,1821,44,30-34,1865,6
STAT,1872,36,35-39,1908,8.235565363194109
SIM,1955,24,na,1979,5741
STAT,1845,22,30-34,1867,14.900818873162306
SIM,1894,18,35-39,1912,2
SIM,1917,50,na,1967,5183
STAT,1822,42,30-34,1864,2.3492581666062144
STAT,1856,86,na,1942,195.3507259681628
STAT,1872,24,40-44,1896,2.3996056984141845
SIM,1871,38,35-39,1909,10
STAT,1895,16,35-39,1911,0.8262908840800693
SIM,1978,24,35-39,2002,1
SIM,1973,35,na,2008,5394
SIM,1936,22,20-24,1958,125
SIM,1872,47,40-44,1919,1
STAT,1886,18,35-39,1904,0.6661997285956682
STAT,1837,36,40-44,1873,3.899656240224174
STAT,1880,22,25-29,1902,70.0251927952922
STAT,1949,33,45-49,1982,2.151483120709046
STAT,1858,28,25-29,1886,38.705864049171325
STAT,1825,38,15-19,1863,0.09055617981875347
STAT,1880,107,na,1987,0.33716392412872975
SIM,1964,42,35-39,2006,2
STAT,1853,19,35-39,1872,0.6494509906771508
STAT,1859,37,30-34,1896,4.899505969630657
STAT,1861,38,25-29,1899,2.7486214497452917
SIM,1919,30,20-24,1949,5
STAT,1899,46,15-19,1945,3.577547141577909E-4
SIM,1877,26,35-39,1903,1
STAT,1877,48,na,1925,2666.8741659654834
STAT,1885,99,na,1984,29.311503022175994
STAT,1894,37,25-29,1931,4.27140188748616
SIM,1884,33,15-19,1917,1
STAT,1881,85,na,1966,589.0594734109582
SIM,1910,28,na,1938,3780
STAT,1844,43,20-24,1887,0.13431315785794454
STAT,1973,34,35-39,2007,13.885067797543398
STAT,1856,53,40-44,1909,0.009120236683815529
STAT,1816,51,45-49,1867,0.02898653431458112
SIM,1827,32,30-34,1859,33
STAT,1953,30,50-100,1983,1.177884650131957
STAT,1873,34,na,1907,2788.1660534451257
STAT,1900,73,na,1973,2448.6988415125606
STAT,1833,43,45-49,1876,1.2687876498208526
SIM,1856,42,50-100,1898,2
STAT,1827,51,20-24,1878,9.200663423543919E-4
STAT,1859,49,25-29,1908,0.05184635461965976
STAT,1878,54,30-34,1932,0.006975317001509763
STAT,1979,16,40-44,1995,2.223155641615815
SIM,1823,47,45-49,1870,1
STAT,1917,22,45-49,1939,1.3801018298707468
SIM,1909,63,na,1972,4151
STAT,1871,43,na,1914,2634.42632471754
SIM,1806,88,na,1894,36
STAT,1823,100,na,1923,0.601196672027259
STAT,1808,46,15-19,1854,0.0020347069917493904
STAT,1994,19,30-34,2013,20.284954310011063
STAT,1833,26,na,1859,2018.8541555290162
SIM,1939,32,50-100,1971,2
STAT,1895,49,35-39,1944,0.11615367642523622
STAT,1977,27,30-34,2004,61.36129423477345
STAT,1906,78,na,1984,2143.118869377947
STAT,1928,22,20-24,1950,160.21573591803548
SIM,1884,41,50-100,1925,4
SIM,1963,11,na,1974,6578
STAT,1859,41,15-19,1900,0.01275288529272983
STAT,1912,88,na,2000,916.5258426971949
SIM,1985,27,30-34,2012,7
STAT,1902,64,na,1966,3125.9645304733504
SIM,1866,28,25-29,1894,50
SIM,1967,25,na,1992,5507
STAT,1877,45,25-29,1922,0.0698349792273206
STAT,1830,39,35-39,1869,6.929950229235231
STAT,1964,36,35-39,2000,3.625333921694156
SIM,1901,67,na,1968,3095
STAT,1873,22,50-100,1895,0.4805768587854049
STAT,1984,22,50-100,2006,1.082060328432445
SIM,1863,76,na,1939,924
STAT,1969,45,25-29,2014,0.07991654944002471
STAT,1847,18,na,1865,2191.4549254445265
SIM,1916,90,na,2006,100
SIM,1962,15,25-29,1977,148
SIM,1938,12,na,1950,4178
STAT,1865,51,40-44,1916,0.011014427859090587
SIM,1874,42,45-49,1916,2
STAT,1835,48,25-29,1883,0.037406466452847356
STAT,1933,48,40-44,1981,0.24962641141001185
SIM,1894,43,25-29,1937,1
STAT,1771,105,na,1876,0.02518166107352522
STAT,1958,31,45-49,1989,2.4326253035267285
SIM,1815,92,na,1907,38
STAT,1896,28,45-49,1924,1.6864622995925274
STAT,1805,50,30-34,1855,0.022165901687480064
STAT,1861,30,15-19,1891,0.13772517782868507
STAT,1876,33,15-19,1909,0.16917241051352008
STAT,1850,35,45-49,1885,2.128430772518365
SIM,1895,37,50-100,1932,3
SIM,1972,36,35-39,2008,2
STAT,1895,46,30-34,1941,0.08225746421975604
SIM,1896,71,na,1967,2548
SIM,1941,48,40-44,1989,1
STAT,1813,81,na,1894,247.60107982416326
STAT,1855,32,40-44,1887,3.757275700430949
STAT,1876,29,30-34,1905,29.826761852806616
SIM,1826,28,30-34,1854,58
STAT,1948,21,35-39,1969,12.480544540011747
STAT,1860,26,15-19,1886,0.4295986943465112
SIM,1880,36,35-39,1916,8
SIM,1967,24,15-19,1991,16
SIM,1979,33,40-44,2012,9
SIM,1854,46,35-39,1900,1
STAT,1968,22,15-19,1990,7.698265360558771
STAT,1975,39,15-19,2014,0.030056684870186576
STAT,1884,18,na,1902,2872.2041699413803
SIM,1879,16,na,1895,3042
SIM,1947,46,50-100,1993,2
STAT,1965,40,35-39,2005,0.30234064984929104
STAT,1968,22,na,1990,5281.145021661556
STAT,1871,15,35-39,1886,0.6415918182339442
SIM,1966,31,45-49,1997,7
STAT,1830,31,25-29,1861,11.303131546736873
STAT,1959,24,15-19,1983,8.05682631679586
SIM,1957,33,45-49,1990,1
SIM,1841,38,50-100,1879,4
STAT,1840,46,40-44,1886,0.14027905624102796
STAT,1881,34,35-39,1915,11.17621926200612
STAT,1829,54,35-39,1883,0.007417893608207412
STAT,1821,33,25-29,1854,41.39077335474428
SIM,1835,26,30-34,1861,62
STAT,1864,47,40-44,1911,0.17558915791424043
SIM,1886,29,40-44,1915,8
SIM,1863,41,30-34,1904,2
SIM,1776,84,na,1860,144
STAT,1960,40,na,2000,5817.445780027558
SIM,1927,15,50-100,1942,1
SIM,1956,21,35-39,1977,17
SIM,1962,51,na,2013,5352
SIM,1993,1,na,1994,6969
STAT,1891,41,40-44,1932,3.2226992894349356
SIM,1836,38,40-44,1874,1
STAT,1777,81,na,1858,147.3782141303074
STAT,1801,80,na,1881,296.06630732024246
STAT,1892,69,na,1961,2308.84012042661
SIM,1836,42,25-29,1878,1
STAT,1885,31,15-19,1916,0.16459670075766056
SIM,1883,40,45-49,1923,2
STAT,1853,41,20-24,1894,0.15883271357863438
STAT,1890,37,40-44,1927,6.1728051425737025
STAT,1969,33,30-34,2002,23.137610750196718
SIM,1884,29,30-34,1913,68
SIM,1893,39,25-29,1932,10
STAT,1950,48,na,1998,5199.8360351485135
STAT,1845,25,35-39,1870,8.028948869575267
STAT,1848,18,15-19,1866,7.770714821673932
STAT,1918,15,15-19,1933,11.487860451662925
STAT,1973,20,30-34,1993,43.0690684860506
STAT,1834,36,15-19,1870,0.06440848560861501
STAT,1875,40,45-49,1915,1.8028963647289205
SIM,1851,75,na,1926,1616
STAT,1929,31,na,1960,5547.571376576567
STAT,1885,39,25-29,1924,3.2809138756006093
SIM,1916,33,na,1949,4432
SIM,1977,33,30-34,2010,56
STAT,1947,1,na,1948,5349.380738763328
STAT,1828,38,40-44,1866,4.412161953076365
STAT,1838,27,45-49,1865,1.2236295414956926
STAT,1805,94,na,1899,8.2132334442589
STAT,1854,4,na,1858,2597.6362679567746
STAT,1829,42,40-44,1871,2.404099114584829
SIM,1832,45,45-49,1877,1
STAT,1871,2,na,1873,3802.9165717773453
STAT,1937,20,20-24,1957,125.11629521707086
SIM,1873,0,na,1873,4304
STAT,1891,26,50-100,1917,0.9155360162907294
STAT,1824,45,45-49,1869,0.32917844619465736
SIM,1976,29,30-34,2005,110
STAT,1835,40,15-19,1875,0.010595306601979973
SIM,1856,2,na,1858,3081
STAT,1807,50,40-44,1857,0.04306088161154972
SIM,1883,17,20-24,1900,31
STAT,1818,53,20-24,1871,8.592406711915668E-4
STAT,1946,17,50-100,1963,0.47955404430073895
STAT,1868,87,na,1955,195.34354919353217
STAT,1985,16,25-29,2001,71.14983714111828
SIM,1829,41,na,1870,1675
STAT,1954,15,25-29,1969,61.85763889270235
SIM,1831,48,50-100,1879,2
STAT,1864,73,na,1937,1223.909722405652
STAT,1886,43,25-29,1929,0.7760580539883418
SIM,1846,27,45-49,1873,1
SIM,1975,12,na,1987,6126
STAT,1931,48,30-34,1979,0.1372065014915343
SIM,1827,44,25-29,1871,2
STAT,1813,47,35-39,1860,0.464393434187335
STAT,1918,79,na,1997,2445.8795273319165
SIM,1881,48,45-49,1929,1
STAT,1977,31,15-19,2008,0.20436718797999054
STAT,1888,43,35-39,1931,2.4387587395164845
STAT,1914,65,na,1979,3667.0741813247664
SIM,1981,22,40-44,2003,12
STAT,1849,27,20-24,1876,10.778513201054013
SIM,1945,46,na,1991,4640
SIM,1941,32,na,1973,3983
SIM,1945,23,25-29,1968,221
SIM,1929,40,30-34,1969,1
STAT,1882,46,45-49,1928,0.2667780280987365
STAT,1869,51,25-29,1920,0.003977523354873712
SIM,1893,27,30-34,1920,46
STAT,1937,23,25-29,1960,103.82813499305507
SIM,1792,79,na,1871,235
STAT,1918,93,na,2011,401.19712891064296
SIM,1857,27,20-24,1884,2
STAT,1873,15,45-49,1888,0.07789683146622321
STAT,1864,17,45-49,1881,0.06963176261365947
SIM,1871,35,30-34,1906,2
STAT,1873,48,45-49,1921,0.274628972395555
STAT,1910,27,50-100,1937,1.1103712551874936
STAT,1892,32,45-49,1924,2.522324298356271
SIM,1873,30,35-39,1903,4
SIM,1886,29,na,1915,1941
STAT,1819,44,25-29,1863,1.2708593991406298
STAT,1893,25,15-19,1918,0.6663143394231869
STAT,1968,33,15-19,2001,0.18869050885674993
SIM,1882,36,45-49,1918,4
STAT,1862,47,30-34,1909,0.0938371348536474
SIM,1868,28,35-39,1896,15
STAT,1793,76,na,1869,380.54357856068566
SIM,1880,24,na,1904,3509
SIM,1884,38,na,1922,2677
SIM,1922,29,na,1951,5101
STAT,1841,50,40-44,1891,0.009494537061470139
STAT,1909,0,na,1909,5087.553915094318
STAT,1873,40,35-39,1913,2.1555587536456593
SIM,1890,46,45-49,1936,1
STAT,1974,5,na,1979,5924.941852529411
STAT,1853,16,30-34,1869,1.9202315642677164
STAT,1878,29,40-44,1907,3.58372345075899
STAT,1861,35,20-24,1896,0.7465816625431809
SIM,1841,40,40-44,1881,1
STAT,1992,19,20-24,2011,224.42830327415976
STAT,1977,20,15-19,1997,8.333595100369292
SIM,1867,37,30-34,1904,14
STAT,1917,30,na,1947,4607.350344846444
SIM,1817,40,na,1857,1566
STAT,1924,89,na,2013,974.5213152438861
SIM,1935,9,na,1944,6489
STAT,1910,51,na,1961,3909.321728788811
SIM,1935,29,50-100,1964,6
SIM,1881,40,35-39,1921,3
SIM,1814,75,na,1889,466
SIM,1810,61,na,1871,1086
SIM,1867,38,50-100,1905,5
STAT,1923,38,30-34,1961,2.4337444894051763
STAT,1878,65,na,1943,2036.3297274903503
STAT,1958,47,15-19,2005,5.807711549570101E-4
STAT,1875,17,20-24,1892,21.142965316518524
SIM,1931,38,30-34,1969,1
STAT,1812,64,na,1876,915.8084363113891
STAT,1885,27,30-34,1912,28.987117995052174
SIM,1863,44,35-39,1907,5
SIM,1919,33,25-29,1952,21
STAT,1840,16,45-49,1856,0.06824806030380842
STAT,1877,42,20-24,1919,0.19041158107036496
STAT,1872,27,45-49,1899,1.2866217078938944
SIM,1861,10,na,1871,2225
SIM,1873,38,45-49,1911,6
STAT,1833,40,40-44,1873,1.9820070450515095
SIM,1850,58,na,1908,1241
STAT,1832,31,35-39,1863,9.301337276653987
STAT,1800,63,na,1863,1182.2460193832183
STAT,1871,45,30-34,1916,0.11224663668790871
STAT,1920,22,50-100,1942,0.8438322675309105
STAT,1823,54,40-44,1877,0.009628566876602263
STAT,1952,53,na,2005,5172.333578667825
STAT,1804,77,na,1881,456.2822661280764
STAT,1827,54,25-29,1881,0.0037866140402444183
STAT,1847,25,45-49,1872,1.041764160242524
STAT,1881,31,30-34,1912,19.51434292223752
STAT,1817,95,na,1912,9.192004930097823
STAT,1895,41,25-29,1936,0.06728989821144886
SIM,1968,35,30-34,2003,2
STAT,1840,49,45-49,1889,0.18608394286238872
STAT,1947,30,30-34,1977,20.900407529179645
SIM,1970,36,25-29,2006,1
STAT,1849,52,na,1901,1659.9676949422005
STAT,1870,33,20-24,1903,3.0623573981706302
SIM,1919,87,na,2006,1218
SIM,1878,38,45-49,1916,1
STAT,1866,42,45-49,1908,1.5989279615055245
STAT,1804,50,15-19,1854,1.1786492703518555E-4
SIM,1955,30,30-34,1985,6
STAT,1974,27,50-100,2001,1.5064028818569253
SIM,1984,18,25-29,2002,167
STAT,1835,45,20-24,1880,0.00889935676171407
STAT,1880,27,30-34,1907,30.80353819691992
STAT,1880,18,40-44,1898,0.22314837879181287
STAT,1865,90,na,1955,82.09321909546343
STAT,1826,42,15-19,1868,0.010354560147531769
SIM,1972,33,30-34,2005,25
STAT,1773,99,na,1872,0.6474415955004673
STAT,1974,21,50-100,1995,0.9951567289383753
STAT,1924,20,35-39,1944,12.895174954647032
STAT,1827,29,35-39,1856,21.301617343801922
STAT,1891,20,35-39,1911,8.37291256536114
STAT,1813,101,na,1914,0.261272728121312
STAT,1840,41,35-39,1881,1.5348514300932494
STAT,1990,17,45-49,2007,0.8255960298967369
SIM,1844,25,50-100,1869,1
SIM,1899,9,na,1908,4531
SIM,1930,16,na,1946,6333
STAT,1979,27,40-44,2006,7.4383246534611525
STAT,1815,44,40-44,1859,4.72798861573591
STAT,1867,35,15-19,1902,0.06108052227580568
SIM,1949,53,na,2002,5597
STAT,1839,74,na,1913,880.1175861540169
SIM,1835,29,35-39,1864,18
STAT,1990,2,na,1992,6503.78322323213
SIM,1899,68,na,1967,2847
SIM,1909,19,30-34,1928,5
SIM,1937,59,na,1996,3873
STAT,1830,40,15-19,1870,0.01366076028788207
STAT,1819,86,na,1905,147.70573087434292
STAT,1831,27,35-39,1858,10.058647327789313
STAT,1836,24,30-34,1860,21.09520539981589
SIM,1845,36,40-44,1881,10
SIM,1891,40,na,1931,3371
STAT,1851,28,15-19,1879,0.4182321774200199
STAT,1818,69,na,1887,701.07339807575
SIM,1933,45,na,1978,6364
SIM,1895,54,na,1949,3165
SIM,1840,31,35-39,1871,1
STAT,1814,55,na,1869,1672.271721298227
SIM,1957,44,45-49,2001,3
STAT,1884,18,50-100,1902,0.055715210944584134
STAT,1876,38,20-24,1914,0.9150451742253622
STAT,1884,48,20-24,1932,0.013510729352724921
SIM,1820,35,25-29,1855,11
STAT,1896,25,40-44,1921,4.597074314645432
STAT,1996,11,na,2007,6589.175489265016
SIM,1861,19,35-39,1880,1
SIM,1844,24,30-34,1868,31
SIM,1823,34,50-100,1857,3
STAT,1838,57,na,1895,1740.7625343105599
STAT,1875,45,15-19,1920,4.8179362740687624E-4
SIM,1858,39,30-34,1897,13
STAT,1972,43,30-34,2015,0.1960071731854098
STAT,1846,46,35-39,1892,0.14514040788765276
SIM,1872,37,na,1909,2899
STAT,1857,37,20-24,1894,0.6928472106468258
STAT,1891,28,45-49,1919,1.5780710955596011
STAT,1834,43,na,1877,2283.5994863651927
SIM,1830,42,30-34,1872,3
SIM,1914,38,50-100,1952,1
SIM,1869,41,25-29,1910,1
STAT,1807,53,45-49,1860,0.055852570450683516
STAT,1901,90,na,1991,567.6801161313796
STAT,1931,18,50-100,1949,0.5645709568571714
SIM,1892,89,na,1981,693
SIM,1951,6,na,1957,6327
SIM,1829,35,45-49,1864,3
SIM,1818,48,50-100,1866,2
STAT,1829,51,30-34,1880,0.00598166926812307
SIM,1880,88,na,1968,444
SIM,1987,27,40-44,2014,24
STAT,1852,32,15-19,1884,0.13901420315053886
STAT,1869,33,50-100,1902,1.0196823492195384
SIM,2004,9,na,2013,7404
SIM,1814,41,35-39,1855,4
SIM,1992,0,na,1992,7048
STAT,1928,57,na,1985,5172.027159260567
SIM,1949,16,20-24,1965,314
STAT,1982,32,35-39,2014,15.126780730283901
STAT,1822,42,na,1864,2267.674568985507
STAT,1826,56,na,1882,1202.7014968624235
STAT,1859,16,25-29,1875,6.082908439465019
STAT,1845,34,25-29,1879,8.037871361594918
SIM,1906,30,35-39,1936,3
STAT,1842,18,20-24,1860,17.41564406437075
STAT,1981,20,25-29,2001,149.6537132594834
STAT,1868,47,25-29,1915,0.0635672726818603
STAT,1814,51,35-39,1865,0.023347810535913747
STAT,1932,76,na,2008,3652.7913082980185
SIM,1930,3,na,1933,6468
SIM,1819,46,40-44,1865,1
STAT,1853,44,25-29,1897,0.6307137972019345
SIM,1986,15,30-34,2001,54
STAT,1850,110,na,1960,6.739308630815926E-4
SIM,1898,39,25-29,1937,1
STAT,1831,52,25-29,1883,0.002887282948390531
SIM,1853,34,25-29,1887,4
STAT,1986,25,30-34,2011,64.76637386718916
SIM,1891,31,40-44,1922,9
SIM,1837,71,na,1908,1401
STAT,1809,46,30-34,1855,0.24909030248808822
SIM,1861,28,25-29,1889,61
SIM,1912,83,na,1995,283
STAT,1833,48,15-19,1881,2.982579021710324E-4
STAT,1847,106,na,1953,0.0093424761098716
STAT,1899,18,20-24,1917,27.956618093666055
STAT,1916,13,na,1929,4828.555593971802
STAT,1901,49,35-39,1950,0.12499095726554892
SIM,1852,34,30-34,1886,17
STAT,1853,28,25-29,1881,44.07977097525632
SIM,1858,18,25-29,1876,13
SIM,1960,15,15-19,1975,127
SIM,1981,25,45-49,2006,5
STAT,1863,51,30-34,1914,0.0060355183313864314
SIM,1837,26,40-44,1863,5
STAT,1893,49,25-29,1942,0.04640592872564626
SIM,1969,21,20-24,1990,290
STAT,1844,22,15-19,1866,3.4452636731310062
STAT,1950,44,25-29,1994,0.10092732364123852
SIM,1923,46,na,1969,5281
SIM,1952,32,50-100,1984,3
SIM,1857,3,na,1860,3261
SIM,1959,52,na,2011,5726
STAT,1883,50,45-49,1933,0.01662132636337853
SIM,1858,54,na,1912,2405
STAT,1952,15,15-19,1967,62.79703824330874
STAT,1960,20,45-49,1980,1.69798199780421
SIM,1852,22,15-19,1874,7
STAT,1869,47,40-44,1916,0.19044253113778414
SIM,1964,31,35-39,1995,29
STAT,1961,45,20-24,2006,0.01721947895701573
STAT,1829,45,45-49,1874,0.24724935053402486
SIM,1975,29,15-19,2004,1
SIM,1977,36,35-39,2013,7
STAT,1971,20,20-24,1991,163.17904195994427
STAT,1946,17,40-44,1963,1.7903355340875842
SIM,1847,40,35-39,1887,3
STAT,1841,77,na,1918,768.5225456821194
STAT,1883,31,40-44,1914,4.916563558776354
STAT,1893,41,15-19,1934,0.020235804251308113
SIM,1949,23,45-49,1972,4
STAT,1956,31,35-39,1987,14.232899148922757
SIM,1927,15,30-34,1942,45
STAT,1859,51,na,1910,1988.88796423835
SIM,1831,30,30-34,1861,3
SIM,1882,33,40-44,1915,1
STAT,1870,40,50-100,1910,1.2140789834218955
SIM,1798,63,na,1861,1076
STAT,1844,34,30-34,1878,17.104654470049933
STAT,1834,27,25-29,1861,50.62022808393217
SIM,1997,16,45-49,2013,2
STAT,1849,39,15-19,1888,0.04362080470159298
SIM,1842,27,25-29,1869,8
SIM,1843,36,30-34,1879,11
STAT,1894,28,35-39,1922,14.264176353149553
STAT,1839,40,35-39,1879,1.7064103178948402
SIM,1861,20,15-19,1881,6
SIM,1895,39,35-39,1934,19
STAT,1969,36,35-39,2005,3.595675947552283
STAT,1821,42,15-19,1863,0.026641410372737713
STAT,1993,19,15-19,2012,75.30356864834285
SIM,1863,35,45-49,1898,1
STAT,1874,52,45-49,1926,0.01705437636759612
SIM,1838,42,35-39,1880,7
STAT,1857,40,50-100,1897,0.9591315413313775
STAT,1963,40,25-29,2003,0.10910737868078074
STAT,1976,27,15-19,2003,1.0931436763712896
SIM,1959,26,30-34,1985,8
STAT,1812,52,50-100,1864,0.03345555562679986
STAT,1984,25,20-24,2009,30.074813758132507
STAT,1938,56,na,1994,4190.119481886885
STAT,1847,22,40-44,1869,1.9656068924427894
STAT,1835,28,50-100,1863,0.5175038228131387
STAT,1983,20,35-39,2003,15.433370245667861
STAT,1884,50,na,1934,2490.3676214279144
STAT,1939,20,30-34,1959,33.34755346353747
STAT,1888,64,na,1952,2358.2128653077557
STAT,1870,36,25-29,1906,3.291498547377095
STAT,1862,39,na,1901,2271.468773175608
STAT,1853,20,15-19,1873,3.937194024647672
STAT,1887,39,35-39,1926,9.05550586402777
SIM,1862,37,30-34,1899,11
STAT,1783,77,na,1860,244.05855557902572
STAT,1870,24,30-34,1894,20.138600017234513
STAT,1781,86,na,1867,51.66284907014922
STAT,1844,21,na,1865,2249.0552522314515
SIM,1816,41,45-49,1857,4
SIM,1898,8,na,1906,4203
STAT,1979,36,50-100,2015,0.6879466793815879
STAT,1870,69,na,1939,1669.6596064251107
SIM,1859,27,30-34,1886,6
SIM,1895,31,25-29,1926,21
STAT,1915,82,na,1997,1875.0858962159473
SIM,1991,20,35-39,2011,21
SIM,1896,28,na,1924,3867
STAT,1799,81,na,1880,285.49406961106416
STAT,1829,26,40-44,1855,7.464312937567647
SIM,1894,16,na,1910,4032
STAT,1855,53,25-29,1908,0.002965491853629285
STAT,1855,35,45-49,1890,1.7123584338682147
SIM,1902,84,na,1986,625
SIM,1847,70,na,1917,1505
STAT,1876,41,50-100,1917,1.2660274327798002
STAT,1909,43,na,1952,3989.3013349724993
STAT,1819,41,20-24,1860,0.34473565341899215
STAT,1848,35,na,1883,2633.8243881240624
STAT,1887,31,25-29,1918,13.301131500187898
STAT,1903,19,50-100,1922,0.08009985820603363
STAT,1892,25,20-24,1917,17.083895719481124
STAT,1855,41,30-34,1896,0.982673913338123
STAT,1909,103,na,2012,8.7029580344182
SIM,1928,27,40-44,1955,7
STAT,1821,45,50-100,1866,0.4569856143017727
STAT,1866,19,20-24,1885,19.235910573217232
STAT,1846,37,45-49,1883,2.1520863275831617
STAT,1906,14,na,1920,4331.959956709803
STAT,1845,31,20-24,1876,2.188340622775718
SIM,1947,20,30-34,1967,80
SIM,1880,24,40-44,1904,1
SIM,1945,24,50-100,1969,5
SIM,1904,32,na,1936,4164
STAT,1846,18,40-44,1864,0.2361260404430447
SIM,1985,11,na,1996,6449
SIM,1908,46,na,1954,3612
STAT,1875,7,na,1882,3220.55867861012
SIM,1989,22,45-49,2011,2
STAT,1861,26,30-34,1887,24.51121239038241
STAT,1845,50,25-29,1895,0.00242110212590517
STAT,1795,100,na,1895,0.18603053313710155
STAT,1919,40,20-24,1959,0.022142474099230963
SIM,1939,20,45-49,1959,1
SIM,1905,17,na,1922,4496
STAT,1898,53,na,1951,3304.423487810273
STAT,1831,78,na,1909,613.0079166332932
SIM,1885,21,15-19,1906,6
SIM,1841,22,na,1863,2005
STAT,1892,5,na,1897,3790.5815381993784
SIM,1876,38,35-39,1914,3
SIM,1864,32,35-39,1896,24
STAT,1811,44,20-24,1855,0.524003834949471
SIM,1845,36,na,1881,2137
SIM,1804,97,na,1901,7
STAT,1880,68,na,1948,1869.3542576880625
STAT,1865,30,35-39,1895,10.629630122450527
SIM,1874,19,20-24,1893,1
STAT,1830,93,na,1923,18.3335825864884
SIM,1853,31,20-24,1884,3
SIM,1780,78,na,1858,206
SIM,1860,16,15-19,1876,12
SIM,1988,18,45-49,2006,2
STAT,1855,50,50-100,1905,0.013035534524228789
STAT,1867,30,50-100,1897,0.9951795882101291
STAT,1899,27,na,1926,3773.261334177822
STAT,1771,97,na,1868,1.1356707494832123
STAT,1855,16,40-44,1871,0.18620476893196672
STAT,1894,34,20-24,1928,3.9757607954212397
SIM,1854,18,40-44,1872,1
STAT,1900,37,25-29,1937,0.9951615416920565
STAT,1958,45,50-100,2003,0.3582721213280921
STAT,1807,96,na,1903,4.19890996950108
STAT,1936,27,50-100,1963,1.0999617931609054
STAT,1871,21,20-24,1892,79.35912206712418
STAT,1887,90,na,1977,392.4434325208199
STAT,1806,50,25-29,1856,0.012978492475529234
STAT,1888,18,45-49,1906,0.08838267997043324
STAT,1835,36,30-34,1871,4.156200876230445
STAT,1892,37,15-19,1929,0.08122388638368983
STAT,1895,34,na,1929,3554.0065637085822
STAT,1899,48,na,1947,3513.1139925920743
SIM,1870,47,30-34,1917,1
STAT,1827,38,25-29,1865,4.096980478096039
SIM,1829,32,40-44,1861,8
STAT,1941,12,na,1953,4683.942118129518
SIM,1983,31,40-44,2014,4
SIM,1830,29,35-39,1859,25
SIM,1958,21,45-49,1979,5
STAT,1946,42,30-34,1988,0.17006108806532266
STAT,1955,15,40-44,1970,2.1439855849463156
SIM,1865,41,40-44,1906,4
STAT,1945,26,na,1971,4745.164372629649
STAT,1842,46,15-19,1888,3.118308747994364E-4
STAT,1968,4,na,1972,5668.544580005554
SIM,1834,26,15-19,1860,1
STAT,1868,38,35-39,1906,7.803328898346083
SIM,1914,6,na,1920,4390
STAT,1856,32,35-39,1888,9.025534008671665
SIM,1951,56,na,2007,5958
SIM,1953,30,20-24,1983,1
STAT,1879,45,35-39,1924,0.17038453642111465
STAT,1919,15,30-34,1934,3.1324457349434156
STAT,1888,21,50-100,1909,0.5548682635509978
STAT,1970,0,na,1970,5722.122194697097
SIM,1891,27,20-24,1918,33
STAT,1915,36,50-100,1951,0.49192020758536276
SIM,1828,28,40-44,1856,8
SIM,1854,37,45-49,1891,7
STAT,1980,14,na,1994,6290.895168347012
STAT,1836,48,40-44,1884,0.16103447213781283
STAT,1827,30,15-19,1857,0.27290236443460253
SIM,1835,38,25-29,1873,7
STAT,1996,19,40-44,2015,2.344317285280986
SIM,1885,29,25-29,1914,6
STAT,1938,49,50-100,1987,0.26638201586416854
STAT,1959,42,50-100,2001,0.18430288492850969
STAT,1866,21,na,1887,2568.9031353308014
STAT,1945,30,20-24,1975,3.137915934810771
SIM,1875,30,45-49,1905,4
STAT,1934,67,na,2001,4965.726557553137
SIM,1913,68,na,1981,3594
STAT,1846,43,30-34,1889,1.1875817484118512
SIM,1934,25,15-19,1959,1
STAT,1877,29,25-29,1906,50.41758801312667
SIM,1886,33,25-29,1919,3
SIM,1932,28,na,1960,5510
STAT,1926,25,15-19,1951,0.9830625450191172
SIM,1854,43,30-34,1897,1
STAT,1878,33,25-29,1911,12.28980028193008
STAT,1883,27,20-24,1910,13.245891156065243
STAT,1971,34,25-29,2005,13.752931598116557
SIM,1886,38,30-34,1924,4
STAT,1893,20,45-49,1913,1.0232650757964927
STAT,1950,41,20-24,1991,0.025079963133905883
STAT,1967,45,15-19,2012,5.549522122905346E-4
STAT,1928,16,35-39,1944,6.116615630612442
SIM,1880,38,50-100,1918,5
STAT,1849,73,na,1922,920.5893384340602
STAT,1922,20,25-29,1942,122.92007544849412
STAT,1829,29,45-49,1858,1.7037923288705734
SIM,1886,72,na,1958,952
SIM,1900,39,40-44,1939,3
SIM,1949,20,40-44,1969,15
SIM,1891,34,45-49,1925,3
STAT,1844,18,30-34,1862,1.6846787673001893
STAT,1794,101,na,1895,0.14281871686158154
STAT,1834,24,20-24,1858,82.90448940826307
STAT,1772,104,na,1876,0.004196172252372156
STAT,1833,27,45-49,1860,1.0460823529875867
STAT,1863,27,50-100,1890,0.6455200895704364
STAT,1878,30,20-24,1908,3.2832464177056773
SIM,1897,31,35-39,1928,30
STAT,1889,48,20-24,1937,0.009508377447138193
SIM,1860,36,na,1896,2423
STAT,1823,33,35-39,1856,25.264520077385342
SIM,2008,3,na,2011,7735
STAT,1930,43,45-49,1973,0.2523460228883511
SIM,1837,30,25-29,1867,5
SIM,1986,18,35-39,2004,8
STAT,1868,44,20-24,1912,0.17370990769245576
STAT,1894,25,30-34,1919,37.61178670171859
SIM,1852,18,30-34,1870,4
STAT,1828,42,25-29,1870,0.6177435332765755
STAT,1844,37,35-39,1881,6.251534335113738
STAT,1883,34,45-49,1917,1.9520789395069118
SIM,1848,48,25-29,1896,1
STAT,1857,17,na,1874,2424.933540995266
SIM,1963,39,50-100,2002,1
STAT,1908,104,na,2012,4.879183209612577
STAT,1878,86,na,1964,503.99383236883676
STAT,1857,41,40-44,1898,2.0308207336622695
STAT,1922,38,15-19,1960,0.02518056539117152
SIM,1930,20,25-29,1950,147
SIM,1943,34,na,1977,5377
SIM,1883,29,15-19,1912,1
SIM,1831,33,35-39,1864,24
STAT,1876,8,na,1884,3187.786050475702
SIM,1971,36,40-44,2007,5
STAT,1829,30,25-29,1859,14.37065624225961
SIM,1837,38,35-39,1875,18
SIM,1969,24,25-29,1993,145
STAT,1904,16,50-100,1920,0.08138968651632028
STAT,1874,72,na,1946,1492.0436963471038
SIM,1981,22,na,2003,5610
SIM,1986,27,25-29,2013,14
STAT,1833,110,na,1943,1.9445184398081603E-4
STAT,1858,49,30-34,1907,0.0853281075629095
STAT,1917,15,20-24,1932,33.82630067589698
SIM,1801,57,na,1858,1430
STAT,1893,46,20-24,1939,0.009902099522698809
STAT,1872,38,50-100,1910,1.4156543768083467
STAT,1951,28,40-44,1979,6.429979780963427
STAT,1897,32,50-100,1929,1.413889500105941
STAT,1844,46,25-29,1890,0.04831472868800401
STAT,1829,38,35-39,1867,7.949883624043296
SIM,1830,26,30-34,1856,56
SIM,1827,35,35-39,1862,9
STAT,1852,16,15-19,1868,6.807245800906331
STAT,1925,38,40-44,1963,2.070733259128705
SIM,1981,31,30-34,2012,6
STAT,1978,27,25-29,2005,104.11291000397563
STAT,1875,29,15-19,1904,0.5372163444380701
SIM,1951,35,50-100,1986,1
SIM,1868,32,na,1900,3153
STAT,1812,51,25-29,1863,0.008005133539532631
SIM,1842,24,20-24,1866,156
STAT,1958,42,45-49,2000,0.2621611669958385
SIM,1865,37,20-24,1902,2
STAT,1931,13,na,1944,5977.176719967175
STAT,1935,27,na,1962,5896.323981438549
SIM,1940,72,na,2012,3115
STAT,1822,45,35-39,1867,0.2722807086540158
SIM,1869,17,na,1886,2184
SIM,1873,54,na,1927,2849
STAT,1943,35,50-100,1978,0.5303206486064799
STAT,1950,49,30-34,1999,0.1257858135681573
STAT,1928,25,25-29,1953,94.2146128261397
SIM,1838,33,50-100,1871,1
STAT,1939,46,50-100,1985,0.272555148430368
SIM,1980,22,25-29,2002,3
SIM,1837,29,45-49,1866,6
SIM,1877,68,na,1945,1803
SIM,1862,32,25-29,1894,18
STAT,1804,56,na,1860,1392.254994847896
STAT,1819,35,35-39,1854,29.390094233036205
STAT,1954,31,25-29,1985,13.44875688213403
SIM,1840,40,25-29,1880,1
SIM,1835,37,na,1872,2353
STAT,1903,41,35-39,1944,0.2076346996764911
SIM,1911,49,45-49,1960,1
STAT,1888,39,15-19,1927,0.07541115586518686
SIM,1831,23,na,1854,1800
SIM,1828,44,40-44,1872,6
SIM,1958,17,25-29,1975,176
STAT,1843,33,50-100,1876,1.0938102389875168
SIM,1955,39,30-34,1994,2
SIM,1901,27,40-44,1928,10
SIM,1936,25,25-29,1961,8
STAT,1861,51,20-24,1912,7.113525336225636E-4
STAT,1960,26,na,1986,5657.638680561662
STAT,1977,29,na,2006,5860.7960711953
STAT,1973,31,30-34,2004,23.983577149849783
STAT,1818,37,20-24,1855,1.2709638035022786
STAT,1860,47,20-24,1907,0.011109269682536482
STAT,1854,32,25-29,1886,8.545393493122976
STAT,1854,53,50-100,1907,0.01210660789982009
STAT,1947,39,30-34,1986,2.4357324977199677
STAT,1978,21,na,1999,5772.379124814525
SIM,1990,16,35-39,2006,14
STAT,1832,40,25-29,1872,0.5600651403418686
SIM,1851,33,50-100,1884,2
SIM,1848,55,na,1903,1512
SIM,1942,30,45-49,1972,4
STAT,1921,35,na,1956,4854.524749927872
SIM,1818,89,na,1907,132
STAT,1859,38,50-100,1897,1.1230715060572765
STAT,1957,40,40-44,1997,0.3966111108429938
STAT,1903,49,45-49,1952,0.21425671539079633
SIM,1963,18,45-49,1981,2
STAT,1860,21,45-49,1881,0.6734335517123703
SIM,1948,28,20-24,1976,48
SIM,1909,23,15-19,1932,5
SIM,1870,38,40-44,1908,12
STAT,1922,44,50-100,1966,0.15503003319482084
STAT,1988,10,na,1998,6485.324058404685
STAT,1848,105,na,1953,0.0311540253437219
SIM,1947,23,35-39,1970,1
STAT,1866,47,15-19,1913,4.2586966174995377E-4
STAT,1871,40,25-29,1911,0.7447168159788867
STAT,1860,38,30-34,1898,4.932499262828353
STAT,1920,50,na,1970,4642.409111780423
STAT,1855,44,35-39,1899,1.520015286157797
SIM,1854,34,40-44,1888,10
STAT,1892,28,25-29,1920,60.97085216746124
STAT,1954,30,na,1984,5506.214316621045
STAT,1846,34,40-44,1880,5.189155531293514
STAT,1979,31,25-29,2010,14.978857652417272
SIM,1988,15,40-44,2003,3
SIM,1904,30,25-29,1934,33
SIM,1774,82,na,1856,277
SIM,1849,40,45-49,1889,4
STAT,1908,94,na,2002,267.966900227315
STAT,1872,17,na,1889,2936.304896168415
STAT,1889,39,45-49,1928,2.8073311268807863
STAT,1850,32,40-44,1882,4.670226199994405
STAT,1959,47,30-34,2006,0.1399755615515253
SIM,1890,22,35-39,1912,10
STAT,1944,17,30-34,1961,15.138326125824275
STAT,1908,40,45-49,1948,0.17994264332181145
SIM,1831,24,45-49,1855,1
STAT,1832,27,15-19,1859,0.43110509694797294
SIM,1876,35,30-34,1911,13
SIM,1969,15,35-39,1984,13
SIM,1837,92,na,1929,64
STAT,1838,47,50-100,1885,0.21890852691971713
STAT,1870,27,35-39,1897,10.977819272707656
STAT,1842,36,50-100,1878,1.1198653040659987
SIM,1994,2,na,1996,6244
STAT,1811,47,25-29,1858,0.17954723095657232
STAT,1907,22,50-100,1929,0.69241779251638
STAT,1791,85,na,1876,96.70236978660435
SIM,1817,42,50-100,1859,4
STAT,1875,44,50-100,1919,1.2429131297767786
STAT,1959,18,na,1977,5554.609244165588
STAT,1901,47,na,1948,3620.54672498289
STAT,1939,23,35-39,1962,10.913848528855306
STAT,1895,37,40-44,1932,6.575849594754327
SIM,1965,48,na,2013,5459
STAT,1871,48,35-39,1919,0.15871801662452767
STAT,1880,31,15-19,1911,0.1749108262415402
STAT,1882,22,35-39,1904,6.577840668927162
STAT,1821,89,na,1910,64.2498605250777
STAT,1969,42,20-24,2011,0.02645858957093333
STAT,1868,35,30-34,1903,5.965384291928294
SIM,1840,59,na,1899,1584
SIM,1825,59,na,1884,1412
STAT,1885,35,na,1920,2737.743207661861
STAT,1851,55,na,1906,1639.686165220845
SIM,1855,25,na,1880,2016
SIM,1821,45,na,1866,1505
STAT,1881,21,na,1902,2640.5524938120357
STAT,1857,44,45-49,1901,1.3270385496884798
SIM,1832,42,40-44,1874,1
STAT,1855,69,na,1924,1248.7261255420153
SIM,1851,11,na,1862,3168
SIM,1897,39,45-49,1936,1
STAT,1766,113,na,1879,0.0011798371759524058
STAT,1961,40,15-19,2001,0.002386147040892894
STAT,1855,19,45-49,1874,0.06533350986963009
STAT,1893,86,na,1979,858.2615317950432
SIM,1854,40,na,1894,2506
STAT,1877,17,30-34,1894,1.9133524835348914
STAT,1877,26,20-24,1903,14.131290162793034
STAT,1872,52,35-39,1924,0.009923088367659509
SIM,1976,24,25-29,2000,173
SIM,1880,33,30-34,1913,45
STAT,1963,37,na,2000,5682.833992965004
SIM,1850,36,50-100,1886,4
STAT,1890,57,na,1947,2833.8212674798883
SIM,1985,15,15-19,2000,73
SIM,1886,30,20-24,1916,6
SIM,1900,29,na,1929,3726
STAT,1889,49,na,1938,3134.3118578023937
STAT,1889,31,35-39,1920,14.465326774291851
STAT,1872,33,30-34,1905,20.146978491771648
STAT,1896,35,50-100,1931,1.8892044388543094
STAT,1881,43,25-29,1924,0.7096400998776599
STAT,1824,42,40-44,1866,3.20086630050278
SIM,1966,35,20-24,2001,1
STAT,1878,38,30-34,1916,6.3900517337687015
STAT,1934,30,45-49,1964,2.483460870565324
SIM,1896,27,35-39,1923,34
STAT,1955,18,45-49,1973,0.7650582821176406
STAT,1817,44,15-19,1861,0.040403474787871915
STAT,1862,38,40-44,1900,4.2422454443742135
STAT,1977,16,30-34,1993,19.011269807754772
SIM,1887,36,45-49,1923,7
STAT,1978,20,30-34,1998,45.44751234795672
SIM,1842,31,45-49,1873,1
SIM,1956,41,na,1997,5393
SIM,1907,4,na,1911,4880
SIM,1887,42,30-34,1929,6
STAT,1803,82,na,1885,176.8735668775689
SIM,1995,14,na,2009,6763
SIM,1790,67,na,1857,549
SIM,1865,44,45-49,1909,6
STAT,1924,64,na,1988,4468.744620206087
STAT,1961,48,25-29,2009,0.08203760293015401
SIM,1820,60,na,1880,1545
SIM,1824,74,na,1898,307
SIM,1913,5,na,1918,5155
STAT,1943,71,na,2014,3567.8146424247184
STAT,1879,42,30-34,1921,1.383666306868419
STAT,1997,3,na,2000,6629.0511373193485
STAT,1834,31,45-49,1865,2.0597292667420923
STAT,1875,115,na,1990,1.366999475504996E-4
STAT,1879,36,45-49,1915,2.4137509850054353
STAT,1923,41,50-100,1964,0.1586320092770694
STAT,1888,27,35-39,1915,13.0894912232674
STAT,1820,40,na,1860,1645.4068217931515
STAT,1883,18,45-49,1901,0.07356189795878473
STAT,1911,35,35-39,1946,2.7240047642657874
STAT,1882,9,na,1891,2924.709345337871
STAT,1892,23,50-100,1915,0.5880194382697661
STAT,1858,88,na,1946,123.59449416344339
STAT,1971,19,40-44,1990,2.043083878833376
STAT,1916,44,25-29,1960,0.08417902842478418
SIM,1827,28,25-29,1855,2
SIM,1957,26,na,1983,6293
STAT,1796,95,na,1891,3.3864398141455245
SIM,1940,30,35-39,1970,26
SIM,1813,44,45-49,1857,1
SIM,1919,62,na,1981,4750
STAT,1859,53,30-34,1912,0.005384344648755521
STAT,1931,9,na,1940,6014.560026442855
SIM,1921,18,40-44,1939,3
STAT,1955,43,35-39,1998,0.32009339135532466
STAT,1887,40,15-19,1927,0.018040790041256118
SIM,1928,13,na,1941,6024
STAT,1828,26,25-29,1854,107.63762476142122
STAT,1770,106,na,1876,0.006038419455741606
SIM,1910,49,na,1959,3339
STAT,1862,18,na,1880,2545.359654056243
STAT,1901,31,45-49,1932,2.8303781115880096
STAT,1834,48,30-34,1882,0.09249246736369958
SIM,1893,43,30-34,1936,1
STAT,1843,25,na,1868,2710.0685852114084
STAT,1818,40,50-100,1858,1.4936664064298601
STAT,1940,49,na,1989,4452.784994964791
SIM,1876,28,20-24,1904,27
STAT,1975,6,na,1981,5985.090972789567
STAT,1972,42,50-100,2014,0.18039973086341057
STAT,1920,33,35-39,1953,11.497938089434468
STAT,1866,38,25-29,1904,3.064491787685239
SIM,1828,88,na,1916,255
STAT,1848,56,na,1904,2167.167653453653
SIM,1874,38,25-29,1912,1
STAT,1850,60,na,1910,1963.3385619289431
STAT,1843,46,30-34,1889,0.097920999538776
STAT,1894,49,40-44,1943,0.14027564485008467
SIM,1839,40,na,1879,2153
STAT,1864,24,50-100,1888,0.4208522681069278
SIM,1853,18,25-29,1871,11
SIM,1829,35,50-100,1864,6
STAT,1900,34,20-24,1934,4.291499038360176
STAT,1942,34,25-29,1976,11.349500457595639
STAT,1879,17,40-44,1896,0.22040163849319197
STAT,1921,42,40-44,1963,0.32499887688516765
SIM,1836,26,25-29,1862,89
STAT,1883,87,na,1970,496.89350358191075
STAT,1944,42,20-24,1986,0.0227945071592026
STAT,1838,48,15-19,1886,3.519896414021164E-4
STAT,1894,18,20-24,1912,26.23206281643184
STAT,1929,20,35-39,1949,13.82409863583247
STAT,1879,29,35-39,1908,11.54403959329375
STAT,1873,55,na,1928,2436.7794549367613
STAT,1875,36,na,1911,2823.2509479270043
SIM,1952,52,na,2004,4470
STAT,1907,46,25-29,1953,0.055325865109730844
STAT,1923,47,na,1970,4957.9142853770545
STAT,1812,43,na,1855,1394.3957463830936
SIM,1804,76,na,1880,344
SIM,1862,38,na,1900,2840
SIM,1971,31,35-39,2002,29
STAT,1932,30,35-39,1962,14.038822341825178
STAT,1917,18,25-29,1935,10.734002155616995
STAT,1943,46,35-39,1989,0.1645411792331621
STAT,1957,47,20-24,2004,0.017490170394157893
STAT,1845,18,25-29,1863,4.797890350570113
STAT,1934,37,50-100,1971,0.6689709933268245
SIM,1862,44,40-44,1906,5
STAT,1976,20,20-24,1996,172.12537514353133
SIM,1950,34,25-29,1984,30
STAT,1777,101,na,1878,0.10168325220877023
SIM,1944,51,na,1995,4462
STAT,1860,42,15-19,1902,0.012828828148398305
STAT,1939,19,15-19,1958,52.4120389805499
SIM,1947,19,15-19,1966,66
STAT,1911,24,50-100,1935,0.7162741338292969
STAT,1839,105,na,1944,0.023252751754283596
SIM,1948,30,50-100,1978,3
STAT,1871,36,40-44,1907,5.050116448258528
SIM,1777,79,na,1856,423
STAT,1881,18,35-39,1899,0.6091838613225733
SIM,1962,31,25-29,1993,5
STAT,1960,38,35-39,1998,3.741747934039036
STAT,1882,39,20-24,1921,0.8601672118418582
STAT,1895,9,na,1904,3897.637012891306
STAT,1837,19,na,1856,2185.105759885204
STAT,1845,49,45-49,1894,0.15570933814223262
STAT,1965,20,45-49,1985,1.6275832802135657
SIM,1937,20,35-39,1957,22
SIM,1890,39,20-24,1929,1
STAT,1920,20,15-19,1940,6.867333655261805
STAT,1933,42,45-49,1975,0.26400900640755365
STAT,1861,54,25-29,1915,0.0033047835904365915
SIM,1869,70,na,1939,978
STAT,1854,29,50-100,1883,0.5385235322942035
STAT,1952,41,30-34,1993,0.18400873028588774
STAT,1962,47,50-100,2009,0.3478754904911875
STAT,1855,28,35-39,1883,8.496350751249707
STAT,1899,114,na,2013,9.098269354556049E-4
STAT,1970,34,30-34,2004,23.170268823359272
STAT,1835,38,na,1873,1633.1746786053975
SIM,1898,40,40-44,1938,1
STAT,1900,52,na,1952,3429.7258625203754
SIM,1916,12,na,1928,4840
SIM,1973,20,45-49,1993,4
SIM,1907,61,na,1968,3911
STAT,1937,24,50-100,1961,0.739363199798846
STAT,1955,45,45-49,2000,0.34796482128829637
STAT,1851,47,50-100,1898,0.1938515506974063
STAT,1923,47,20-24,1970,0.014913891536987318
STAT,1885,15,50-100,1900,0.05665702469638035
SIM,2003,8,na,2011,6668
STAT,1903,46,40-44,1949,0.15919199859481542
STAT,1953,40,20-24,1993,0.0256932986242945
STAT,1842,34,20-24,1876,2.4611325335613805
STAT,1818,91,na,1909,25.639659470845203
STAT,1985,28,40-44,2013,7.679964738395523
SIM,1905,17,45-49,1922,1
STAT,1832,41,na,1873,1764.1747810441527
STAT,1891,74,na,1965,1932.54528273137
STAT,1939,30,45-49,1969,1.8557367797283368
STAT,1870,17,20-24,1887,20.362320228047682
STAT,1912,44,40-44,1956,0.2765088333003323
SIM,1810,82,na,1892,105
STAT,1928,41,25-29,1969,0.10520675915297642
STAT,1980,23,35-39,2003,15.12994557671156
STAT,1903,49,na,1952,3621.6938552011
SIM,1959,29,35-39,1988,7
SIM,1858,27,50-100,1885,5
SIM,1951,31,na,1982,6255
STAT,1844,50,45-49,1894,0.01231294690336715
STAT,1938,45,15-19,1983,4.3845847977970373E-4
STAT,1778,76,na,1854,473.0
STAT,1891,49,15-19,1940,3.1510517085213185E-4
SIM,1856,42,na,1898,2071
STAT,1885,43,30-34,1928,1.313833848671225
STAT,1950,27,na,1977,5133.881873234333
SIM,1882,36,na,1918,3276
STAT,1818,47,35-39,1865,0.17279442254921382
SIM,1884,17,15-19,1901,8
SIM,1947,30,45-49,1977,6
SIM,1890,87,na,1977,429
STAT,1844,27,20-24,1871,12.012096797871187
SIM,1861,35,35-39,1896,5
SIM,1974,18,20-24,1992,1
STAT,1880,34,40-44,1914,5.259432444485348
SIM,1852,27,20-24,1879,24
SIM,1811,46,na,1857,1682
STAT,1856,49,20-24,1905,0.01034479442628845
STAT,1828,58,na,1886,1359.792738643205
STAT,1911,46,na,1957,4027.1663444258156
STAT,1833,36,20-24,1869,0.6908413059699664
STAT,1934,48,35-39,1982,0.2068271763180522
STAT,1876,48,35-39,1924,0.16491846487200235
STAT,1968,47,na,2015,5508.0726819078
STAT,1898,46,20-24,1944,0.010587450152723586
STAT,1966,18,20-24,1984,195.35937370188856
STAT,1853,35,35-39,1888,7.189707072168741
STAT,1892,41,35-39,1933,2.63107459610308
SIM,1896,50,na,1946,3408
STAT,1913,18,40-44,1931,0.32934207179332436
STAT,1891,84,na,1975,1024.020817810209
STAT,1995,15,na,2010,6152.099035777874
SIM,1941,36,25-29,1977,1
STAT,1940,29,50-100,1969,1.170556748151601
STAT,1854,16,25-29,1870,5.555355704992485
STAT,1883,33,na,1916,2682.995177656209
SIM,1855,68,na,1923,981
STAT,1830,43,40-44,1873,2.1288611300689833
STAT,1868,66,na,1934,1817.2813862087783
SIM,1900,23,50-100,1923,1
STAT,1828,68,na,1896,1014.2638208568666
SIM,1923,36,50-100,1959,1
STAT,1837,52,40-44,1889,0.00765105138594082
STAT,1929,10,na,1939,5853.581931395893
SIM,1971,31,50-100,2002,2
STAT,1937,61,na,1998,3945.116334458735
SIM,1863,28,35-39,1891,14
STAT,1888,101,na,1989,15.542141695606091
STAT,1882,33,50-100,1915,1.0284472913322402
STAT,1965,36,15-19,2001,0.02853021990316626
STAT,1891,37,20-24,1928,1.0994757816028031
SIM,1870,35,na,1905,3015
STAT,1933,36,25-29,1969,1.5497937558742005
STAT,1955,40,30-34,1995,0.20411081045623147
SIM,1967,38,40-44,2005,3
SIM,1914,31,na,1945,4058
SIM,1920,7,na,1927,4701
STAT,1863,35,na,1898,2400.0193419157144
STAT,1857,28,45-49,1885,1.0205260464525636
STAT,1886,103,na,1989,4.959825420503367
SIM,1960,31,15-19,1991,3
STAT,1863,54,35-39,1917,0.008448588887189882
STAT,1924,47,50-100,1971,0.3106653698177073
SIM,1876,40,na,1916,2614
STAT,1897,0,na,1897,4531.160158883703
SIM,1880,17,30-34,1897,4
SIM,1853,49,45-49,1902,1
STAT,1944,31,na,1975,4790.805780010954
SIM,1931,20,40-44,1951,1
STAT,1846,20,50-100,1866,0.527705376186402
STAT,1931,34,na,1965,5713.02352585914
STAT,1962,48,40-44,2010,0.24181888251637879
SIM,1873,75,na,1948,1181
STAT,1872,17,30-34,1889,1.853054836198657
STAT,1840,82,na,1922,374.293136674628
STAT,1874,45,20-24,1919,0.014318709652515318
STAT,1931,36,15-19,1967,0.02938326831057947
STAT,1949,41,50-100,1990,0.16410074515839
SIM,1915,35,50-100,1950,1
STAT,1803,53,25-29,1856,0.01259600751389951
STAT,1932,24,15-19,1956,8.034662585697607
STAT,1821,79,na,1900,427.5669593066229
STAT,1977,19,35-39,1996,6.538647598950033
STAT,1901,46,30-34,1947,0.08851583102220376
SIM,1812,63,na,1875,756
STAT,1843,49,35-39,1892,0.13754035932067904
STAT,2002,0,na,2002,6890.409938238721
STAT,1916,67,na,1983,3654.2540705371143
STAT,1960,35,30-34,1995,2.8272161365057795
SIM,1865,28,45-49,1893,2
STAT,1920,30,30-34,1950,20.06721487138503
STAT,1843,18,15-19,1861,7.564768148965526
STAT,1881,40,20-24,1921,0.17856317555646442
STAT,1885,46,35-39,1931,0.16161284654861766
STAT,1883,23,na,1906,2662.10673006912
STAT,1802,65,na,1867,1107.1123774066748
STAT,1925,28,na,1953,5086.627443476094
STAT,1927,29,50-100,1956,1.3905335677840749
STAT,1901,68,na,1969,2858.9931884434827
STAT,1941,43,20-24,1984,0.021787272056607406
STAT,1840,100,na,1940,0.8516532680664043
STAT,1945,46,45-49,1991,0.2856996292380463
STAT,1981,32,40-44,2013,6.437025437145436
STAT,1891,20,na,1911,3393.4389215939045
STAT,1919,32,na,1951,4707.857831722627
SIM,1850,80,na,1930,27
STAT,1795,78,na,1873,271.7361878049927
STAT,1870,16,50-100,1886,0.056603613042261254
STAT,1908,17,20-24,1925,30.388319751481927
SIM,1902,30,15-19,1932,5
SIM,1880,2,na,1882,4248
STAT,1879,26,30-34,1905,30.448799520160996
STAT,1955,31,40-44,1986,6.114665935897721
STAT,1922,41,30-34,1963,0.1695164667841649
STAT,1816,47,25-29,1863,0.11747015666382202
SIM,1837,39,na,1876,2428
SIM,1838,23,na,1861,1917
STAT,1871,86,na,1957,305.9956900919905
STAT,1963,29,50-100,1992,1.4642002420759292
SIM,1920,27,na,1947,4426
STAT,1846,27,30-34,1873,31.493007156731796
SIM,1886,17,25-29,1903,13
SIM,1875,66,na,1941,2129
SIM,1878,21,na,1899,2604
STAT,1881,25,45-49,1906,1.2442955412894154
STAT,1910,29,na,1939,4149.182574038949
STAT,1968,45,30-34,2013,0.13428421498269114
STAT,1832,48,20-24,1880,0.009724384886589952
STAT,1864,38,15-19,1902,0.057576989778781305
STAT,1923,20,40-44,1943,4.540179053448367
STAT,1964,35,15-19,1999,0.028806499598387676
STAT,1861,54,na,1915,2008.9574718066146
STAT,1866,51,35-39,1917,0.009252842866394934
STAT,1967,36,25-29,2003,1.4636418997388898
SIM,1941,42,45-49,1983,1
STAT,1974,34,15-19,2008,0.19713453751208365
STAT,1871,39,45-49,1910,2.2657391459675487
STAT,1860,37,na,1897,2191.3147504164554
STAT,1893,37,30-34,1930,7.774353917076504
STAT,1931,31,45-49,1962,2.3814318650642354
SIM,1887,26,30-34,1913,4
SIM,1854,27,30-34,1881,3
STAT,1907,31,na,1938,4103.061703350655
SIM,1863,22,na,1885,2644
STAT,1926,41,15-19,1967,0.002187521216772573
SIM,1975,36,25-29,2011,5
SIM,1876,19,30-34,1895,4
STAT,1846,87,na,1933,182.13254029198688
STAT,1973,36,na,2009,5790.365805334183
SIM,1835,58,na,1893,1758
SIM,1849,72,na,1921,1500
STAT,1906,34,15-19,1940,0.13643103313655436
STAT,1907,43,20-24,1950,0.018590508063426766
STAT,1821,50,50-100,1871,0.027403205283880915
SIM,1977,28,na,2005,5883
STAT,1967,26,na,1993,5426.111271878446
SIM,1899,90,na,1989,274
STAT,1868,19,30-34,1887,1.7780955480390686
STAT,1878,48,45-49,1926,0.280796399260489
SIM,1909,84,na,1993,2373
SIM,1923,67,na,1990,4436
SIM,1938,35,50-100,1973,1
SIM,1870,42,25-29,1912,1
STAT,1914,44,15-19,1958,0.0017510913097003946
STAT,1933,33,20-24,1966,3.792779322913447
SIM,1925,30,50-100,1955,2
STAT,1980,20,30-34,2000,46.22994974557523
SIM,1844,19,na,1863,2802
SIM,1842,35,50-100,1877,5
STAT,1866,75,na,1941,1101.1763291923517
STAT,1826,54,30-34,1880,0.003977369039552069
SIM,1842,93,na,1935,31
SIM,1943,19,30-34,1962,38
SIM,1875,47,30-34,1922,1
SIM,1972,40,na,2012,5722
STAT,1845,15,20-24,1860,15.27873331707339
STAT,1932,30,na,1962,5810.17849304639
STAT,1942,50,na,1992,4567.813229360801
SIM,1824,64,na,1888,869
SIM,1935,20,25-29,1955,5
STAT,1845,46,40-44,1891,0.11569149976711869
SIM,1907,29,na,1936,4441
STAT,1877,36,35-39,1913,8.53151864652746
STAT,1855,50,20-24,1905,6.369153928504743E-4
SIM,1926,32,na,1958,5755
SIM,1839,38,45-49,1877,3
STAT,1908,16,na,1924,4339.751645567309
STAT,1862,42,25-29,1904,0.6246475565903529
SIM,1865,88,na,1953,194
SIM,1903,79,na,1982,1405
SIM,1898,27,45-49,1925,3
SIM,1853,15,20-24,1868,24
SIM,1859,39,25-29,1898,1
SIM,1941,33,20-24,1974,1
STAT,1910,23,25-29,1933,99.90014213265584
STAT,1959,40,15-19,1999,0.002415875562752994
SIM,1826,44,30-34,1870,2
STAT,1870,40,45-49,1910,1.7199452314430765
STAT,1842,37,25-29,1879,2.5990834266794205
SIM,1936,10,na,1946,4129
STAT,1830,52,30-34,1882,0.004828863356545585
SIM,1979,35,50-100,2014,3
STAT,1899,41,45-49,1940,0.16506378798989593
SIM,1850,37,25-29,1887,8
STAT,1918,44,35-39,1962,0.24620290260220717
STAT,1867,47,30-34,1914,0.10381462389302283
STAT,1938,70,na,2008,3411.382147870882
STAT,1935,19,30-34,1954,19.136915904654593
STAT,1820,45,25-29,1865,0.0637277416351638
STAT,1822,36,45-49,1858,5.075554488003585
SIM,1914,40,35-39,1954,3
STAT,1944,34,35-39,1978,11.554133568750316
STAT,1950,24,50-100,1974,0.9002187246857731
STAT,1852,53,20-24,1905,6.845497733142212E-4
STAT,1866,35,20-24,1901,0.8323784906473698
STAT,1830,46,45-49,1876,0.2206040850933788
STAT,1852,44,30-34,1896,1.0692917320093518
SIM,1825,81,na,1906,733
SIM,1905,30,40-44,1935,8
STAT,1927,20,25-29,1947,132.089816972481
SIM,1866,20,na,1886,2330
STAT,1913,27,na,1940,4309.980561720059
SIM,1838,26,35-39,1864,2
SIM,1849,17,20-24,1866,38
SIM,1883,53,na,1936,2264
SIM,1790,77,na,1867,125
SIM,1855,1,na,1856,3073
SIM,1851,18,15-19,1869,7
STAT,1951,44,na,1995,5286.4186149997695
STAT,1909,29,30-34,1938,42.95420004918252
SIM,1917,29,30-34,1946,161
STAT,1812,47,40-44,1859,0.396934923308255
STAT,1803,92,na,1895,14.516469031552857
STAT,1818,44,30-34,1862,1.4548682035186429
SIM,2009,4,na,2013,7160
STAT,1876,17,15-19,1893,7.079793581043165
STAT,1934,45,30-34,1979,0.14407982929515542
SIM,1952,34,35-39,1986,25
SIM,1906,44,na,1950,3484
STAT,1952,31,15-19,1983,0.18125730269548684
STAT,1912,47,45-49,1959,0.24127934993751793
STAT,1906,40,35-39,1946,0.21375062162372122
STAT,1851,76,na,1927,751.2861989005644
STAT,1869,40,na,1909,2609.1247803702454
SIM,1927,18,35-39,1945,9
STAT,1877,91,na,1968,221.73560675779558
SIM,1820,47,40-44,1867,1
STAT,1905,41,45-49,1946,0.1743816870904417
STAT,1952,44,35-39,1996,0.28844727747773985
SIM,1828,37,30-34,1865,2
SIM,1973,31,45-49,2004,7
STAT,1898,49,25-29,1947,0.049617806410383825
STAT,1953,43,25-29,1996,0.10343902367752698
STAT,1972,37,45-49,2009,1.037779945587445
STAT,1928,32,35-39,1960,13.186523065434406
SIM,1929,30,na,1959,5207
STAT,1919,18,35-39,1937,5.33613016134869
STAT,1973,24,50-100,1997,0.9846634345001685
SIM,1868,86,na,1954,97
SIM,1868,22,50-100,1890,1
STAT,1890,28,15-19,1918,0.6375231079469624
SIM,1851,21,na,1872,2694
STAT,1954,41,40-44,1995,0.37137976909870174
STAT,1879,17,na,1896,3043.403070677869
SIM,1877,5,na,1882,3609
STAT,1947,28,na,1975,4888.5380167489075
STAT,1931,42,50-100,1973,0.18116054797128106
STAT,1858,34,na,1892,2129.969006066872
SIM,1889,69,na,1958,2477
SIM,1881,41,na,1922,1867
STAT,1884,43,15-19,1927,0.015632510079810986
SIM,1915,16,na,1931,5005
STAT,1937,19,40-44,1956,1.5665190986971413
STAT,1840,37,15-19,1877,0.05327990509764607
SIM,1950,47,na,1997,4656
SIM,1807,62,na,1869,921
STAT,1931,42,35-39,1973,0.31051865266474454
STAT,1820,94,na,1914,11.72982279786188
STAT,1944,66,na,2010,4065.4441630711653
STAT,1910,47,35-39,1957,0.13896590649884652
SIM,1840,69,na,1909,1015
STAT,1932,21,45-49,1953,1.7093088474563012
SIM,1940,15,na,1955,5061
STAT,1831,40,50-100,1871,1.0387865276583352
STAT,1874,48,25-29,1922,0.06719629256245781
STAT,1983,28,30-34,2011,64.21304543034822
STAT,1851,34,50-100,1885,0.7406942895222011
STAT,1853,32,30-34,1885,17.901122660589287
STAT,1878,45,40-44,1923,0.20834499834607711
SIM,1893,85,na,1978,869
STAT,1917,31,20-24,1948,2.959773684508115
STAT,1882,20,50-100,1902,0.46241010390890996
STAT,1902,108,na,2010,0.29370048434865725
SIM,1859,43,30-34,1902,1
SIM,1983,24,50-100,2007,7
STAT,1921,21,35-39,1942,12.305947635443559
SIM,1914,85,na,1999,515
SIM,1925,48,na,1973,5209
SIM,1836,54,na,1890,1275
STAT,1918,18,50-100,1936,0.469276494717768
STAT,1978,34,35-39,2012,14.651856015540575
STAT,1965,49,na,2014,5473.304373423505
SIM,1832,61,na,1893,1525
SIM,1930,30,40-44,1960,12
STAT,1856,22,na,1878,2186.362837043231
STAT,1814,47,15-19,1861,0.0011120952903382534
STAT,1878,17,25-29,1895,6.828155946543178
STAT,1955,25,na,1980,5768.973087072255
STAT,1866,46,50-100,1912,0.2634548341311407
STAT,1821,54,30-34,1875,0.009975280468860542
SIM,1945,30,35-39,1975,17
SIM,1975,33,20-24,2008,1
STAT,1899,17,50-100,1916,0.0774596109251729
SIM,1886,45,40-44,1931,1
STAT,1854,53,30-34,1907,0.004771659803460694
STAT,1970,43,20-24,2013,0.026471807643984435
SIM,1861,32,30-34,1893,8
STAT,1910,20,20-24,1930,121.35270721506953
STAT,1972,27,na,1999,5559.261606052365
STAT,1940,40,35-39,1980,0.24596803268493422
STAT,1913,70,na,1983,3245.2512993462788
SIM,1925,58,na,1983,5040
SIM,1943,69,na,2012,4041
STAT,1991,21,45-49,2012,1.8676689660074284
SIM,1918,17,30-34,1935,32
STAT,1896,18,30-34,1914,2.4231477164857695
STAT,1940,73,na,2013,3208.4383312142813
SIM,1967,31,25-29,1998,5
SIM,1826,40,50-100,1866,2
STAT,1880,39,50-100,1919,1.48671037074232
STAT,1959,31,25-29,1990,14.230326482599038
STAT,1920,41,20-24,1961,0.02253220640779303
STAT,1827,42,30-34,1869,1.5333393092071
STAT,1896,49,15-19,1945,3.367484472303436E-4
STAT,1805,53,35-39,1858,0.030137804112163404
STAT,1937,30,35-39,1967,10.451276488138294
STAT,1799,60,na,1859,1321.4777453833362
STAT,1904,40,25-29,1944,0.07464555789179819
SIM,1872,90,na,1962,174
STAT,1856,16,35-39,1872,0.5746312810574642
SIM,1961,30,50-100,1991,2
STAT,1881,22,40-44,1903,2.319548260371004
STAT,1920,42,25-29,1962,0.09097728939597936
STAT,1967,33,20-24,2000,3.5819416050931774
SIM,1900,72,na,1972,2349
SIM,1919,29,40-44,1948,15
STAT,1841,53,45-49,1894,0.012695675412240029
STAT,1912,17,50-100,1929,0.08751392374511685
STAT,1932,48,25-29,1980,0.082831201731659
SIM,1954,28,na,1982,5272
SIM,1864,16,35-39,1880,1
STAT,1810,47,30-34,1857,0.3766946743470993
STAT,1888,54,na,1942,2840.686724873914
STAT,1968,18,30-34,1986,17.56348547262292
SIM,1885,8,na,1893,3415
SIM,1909,30,25-29,1939,22
STAT,1888,40,30-34,1928,1.575347756192255
SIM,1914,31,45-49,1945,3
STAT,1933,15,na,1948,5715.200485705549
SIM,1919,40,35-39,1959,1
STAT,1840,39,na,1879,1990.3949184134842
SIM,1862,29,50-100,1891,1
STAT,1877,33,30-34,1910,20.870980326610308
STAT,1886,73,na,1959,1592.1978582555391
SIM,1830,33,40-44,1863,1
SIM,1885,33,30-34,1918,35
SIM,1835,42,30-34,1877,4
SIM,1965,38,30-34,2003,5
STAT,1831,31,40-44,1862,4.462316035553172
STAT,1953,2,na,1955,5493.792231402861
SIM,1844,17,20-24,1861,34
SIM,1874,71,na,1945,1184
SIM,1910,96,na,2006,159
STAT,1820,42,20-24,1862,0.19640955178607875
SIM,1928,15,25-29,1943,131
STAT,1853,67,na,1920,1578.2729769057098
STAT,1918,41,30-34,1959,0.15705984087171146
STAT,1890,29,50-100,1919,0.8955960878558531
STAT,1841,46,20-24,1887,0.010855641730301163
SIM,1949,19,25-29,1968,135
STAT,1890,110,na,2000,0.04224184644069551
STAT,1904,40,50-100,1944,0.12280398156618669
STAT,1911,93,na,2004,357.29625397479936
SIM,1931,33,na,1964,6119
STAT,1912,8,na,1920,4643.555160344718
SIM,1859,15,15-19,1874,8
STAT,1890,41,25-29,1931,0.9096158621288539
STAT,1831,43,35-39,1874,1.7133977690549547
SIM,1896,34,50-100,1930,6
STAT,1876,54,20-24,1930,8.561139427667988E-4
STAT,1854,41,na,1895,1891.4800090469769
STAT,1904,5,na,1909,4342.972452905006
STAT,1824,32,50-100,1856,2.172272520312677
STAT,1953,13,na,1966,5482.9789589517995
STAT,1942,31,20-24,1973,3.000780433256329
STAT,1955,48,15-19,2003,5.853757153190886E-4
STAT,1887,43,40-44,1930,2.888025950450154
STAT,1994,20,na,2014,6105.808317430129
STAT,1938,46,na,1984,4363.121344138784
STAT,1793,97,na,1890,1.0115754294476476
SIM,1901,13,na,1914,4475
SIM,1834,42,na,1876,1838
STAT,1880,46,35-39,1926,0.1717399947322476
STAT,1927,42,35-39,1969,0.2913827521696688
SIM,1829,28,35-39,1857,2
SIM,1969,42,35-39,2011,2
STAT,1839,20,na,1859,2210.3248906128324
STAT,1979,19,45-49,1998,0.7932299177291304
STAT,1930,30,25-29,1960,13.782791112589505
SIM,1958,10,na,1968,6235
STAT,1821,48,45-49,1869,0.4211813932780151
STAT,1991,3,na,1994,6505.927930853768
SIM,1897,66,na,1963,2607
STAT,1900,49,40-44,1949,0.15141574806834174
STAT,1789,82,na,1871,135.67487668006606
STAT,1892,49,30-34,1941,0.07733098955052795
STAT,1940,34,15-19,1974,0.15333599353792646
STAT,1910,6,na,1916,4572.992931838949
STAT,1922,33,45-49,1955,2.0422855941733595
STAT,1929,42,45-49,1971,0.24874582699797554
SIM,1940,21,45-49,1961,4
STAT,1922,62,na,1984,4431.666893570508
SIM,1952,31,30-34,1983,45
STAT,1898,32,na,1930,3721.882400118863
SIM,1930,33,45-49,1963,4
STAT,1967,40,45-49,2007,0.2500250370479761
STAT,1842,50,35-39,1892,0.006720090728722886
STAT,1914,11,na,1925,4723.892137337756
STAT,1771,87,na,1858,66.49207096855261
STAT,1847,45,50-100,1892,0.19086201796339608
SIM,1990,23,45-49,2013,8
SIM,1839,94,na,1933,12
SIM,1857,37,na,1894,2514
STAT,1966,48,25-29,2014,0.07930989192292577
SIM,1885,34,na,1919,3158
STAT,1836,52,25-29,1888,0.0032627370874079697
SIM,1841,43,na,1884,1855
STAT,1847,18,35-39,1865,0.5238517012366932
STAT,1859,19,na,1878,2420.7424504403266
STAT,1869,20,50-100,1889,0.4604317992883853
STAT,1906,31,45-49,1937,1.6919496132380814
SIM,1889,26,40-44,1915,2
STAT,1864,51,25-29,1915,0.003667300430706856
STAT,1822,33,40-44,1855,14.630159834753261
STAT,1941,46,25-29,1987,0.0657655968713817
SIM,1937,41,40-44,1978,1
STAT,1945,43,40-44,1988,0.3271755382049135
SIM,1890,33,50-100,1923,1
STAT,1982,23,45-49,2005,1.8326267450094096
SIM,1920,70,na,1990,3117
STAT,1837,107,na,1944,0.003414954740202218
STAT,1951,41,15-19,1992,0.002196359279120791
STAT,1929,41,40-44,1970,0.3743751010411443
SIM,1839,16,35-39,1855,1
STAT,1944,31,30-34,1975,19.95737132049291
STAT,1905,46,15-19,1951,3.779500723878525E-4
STAT,1916,41,20-24,1957,0.020918090893267002
STAT,1976,31,20-24,2007,3.835599703422385
STAT,1863,30,25-29,1893,10.418997669767004
STAT,1921,20,30-34,1941,37.67319148906414
STAT,1853,57,na,1910,2000.8267860072026
STAT,1867,16,45-49,1883,0.07238013116170769
SIM,1997,16,na,2013,5760
STAT,1922,52,na,1974,4786.603457147478
STAT,1860,45,50-100,1905,0.23071208052310616
SIM,1872,42,35-39,1914,2
SIM,1837,42,40-44,1879,9
SIM,1867,15,na,1882,2626
STAT,1927,41,30-34,1968,0.1852628822196089
SIM,1837,49,na,1886,2086
STAT,1972,34,40-44,2006,5.886496190595791
STAT,1872,60,na,1932,2210.0440134529763
STAT,1842,94,na,1936,15.379791165733232
SIM,1924,63,na,1987,4389
STAT,1982,20,40-44,2002,5.4820355913212415
STAT,1911,32,30-34,1943,17.720255900044812
SIM,1938,48,50-100,1986,2
STAT,1832,52,40-44,1884,0.00760232389545381
STAT,1946,43,na,1989,4932.4810482779585
STAT,1820,36,35-39,1856,17.924665652862153
STAT,1824,45,50-100,1869,0.3425687553077597
STAT,1951,43,15-19,1994,0.002189731271254479
STAT,1840,51,50-100,1891,0.012173416483235661
SIM,1888,84,na,1972,518
SIM,1935,41,30-34,1976,1
STAT,1858,16,45-49,1874,0.06910367227618781
STAT,1916,77,na,1993,2633.6381942350786
STAT,1831,57,na,1888,1586.3859972873445
SIM,1980,34,40-44,2014,17
STAT,1864,42,35-39,1906,1.863640532495363
STAT,1810,62,na,1872,1224.618103150136
STAT,1954,44,45-49,1998,0.24593462636367291
STAT,1854,47,45-49,1901,0.19137212247354607
STAT,1901,34,50-100,1935,1.468414575398105
STAT,1910,44,30-34,1954,0.1378671963850351
SIM,1961,31,30-34,1992,10
STAT,1952,22,25-29,1974,128.16627009132145
SIM,1950,31,20-24,1981,6
SIM,1907,19,20-24,1926,53
SIM,1990,20,40-44,2010,9
STAT,1842,109,na,1951,5.474862422430398E-4
SIM,1960,22,25-29,1982,156
SIM,1903,30,30-34,1933,7
STAT,1891,44,45-49,1935,2.1058708532198036
STAT,1886,113,na,1999,0.0017398887798815022
STAT,1933,25,na,1958,5747.913326192969
SIM,1859,49,na,1908,2073
SIM,1889,15,na,1904,4096
STAT,1965,50,na,2015,5455.952505908479
SIM,1964,25,50-100,1989,2
STAT,1806,58,na,1864,1037.3244992962416
SIM,1917,85,na,2002,1349
STAT,1938,42,45-49,1980,0.19699379924831736
STAT,1867,19,15-19,1886,6.460226021836686
SIM,1875,19,15-19,1894,11
SIM,1860,57,na,1917,2085
STAT,1881,49,20-24,1930,0.013078654281759845
STAT,1852,47,35-39,1899,0.13137851846192394
STAT,1837,40,25-29,1877,0.5629480529867289
STAT,1978,31,30-34,2009,25.308044891172923
STAT,1868,28,20-24,1896,12.961667155092565
STAT,1901,37,40-44,1938,1.527326480161962
STAT,1877,29,50-100,1906,0.762427044841822
STAT,1825,61,na,1886,1387.6230804734937
STAT,1864,106,na,1970,0.15797787196322338
STAT,1809,54,na,1863,1310.0248171311903
STAT,1865,47,20-24,1912,0.012436820655807163
STAT,1931,40,35-39,1971,0.311380580516688
STAT,1948,24,na,1972,4835.472615681491
STAT,1980,32,25-29,2012,15.093609977949495
STAT,1943,43,30-34,1986,0.16235270682105776
SIM,1870,89,na,1959,320
STAT,1921,45,45-49,1966,0.2839780916991333
STAT,1975,27,na,2002,5728.04944683275
SIM,1961,32,35-39,1993,20
STAT,2015,0,na,2015,7356.212565690455
STAT,1840,50,25-29,1890,0.0028822403656235613
STAT,1828,54,40-44,1882,0.008189572471508678
STAT,1949,42,20-24,1991,0.024633216952995047
STAT,1964,48,15-19,2012,5.5538363537845E-4
SIM,1890,23,na,1913,3404
STAT,1827,45,35-39,1872,0.1821290731879477
STAT,1847,71,na,1918,1027.0681414419798
STAT,1890,49,20-24,1939,0.009345808612199082
STAT,1834,53,na,1887,1975.2609229864486
STAT,1924,34,50-100,1958,1.1114542352977257
STAT,1964,32,45-49,1996,2.331418920607463
STAT,1880,43,30-34,1923,1.3961626384816304
STAT,1970,37,35-39,2007,3.5998863812373205
SIM,1866,19,na,1885,2662
SIM,1895,46,45-49,1941,2
STAT,1821,45,40-44,1866,0.3185502330032574
SIM,1937,73,na,2010,2934
SIM,1875,56,na,1931,2593
STAT,1928,14,na,1942,5742.9019293980145
STAT,1797,109,na,1906,2.1183826661610831E-4
SIM,1829,25,30-34,1854,2
STAT,1810,48,35-39,1858,0.5331271877804725
STAT,1953,32,35-39,1985,13.004199744975733
STAT,1823,80,na,1903,350.3035548821285
STAT,1976,34,25-29,2010,14.50693963033699
SIM,1969,27,na,1996,5776
SIM,1903,31,35-39,1934,5
STAT,1926,32,25-29,1958,12.894918733018105
STAT,1849,50,45-49,1899,0.011409750998907538
SIM,1934,32,25-29,1966,17
STAT,1844,75,na,1919,861.0653686588078
STAT,1851,44,15-19,1895,0.010803303855192634
STAT,1954,43,40-44,1997,0.37025904715927427
STAT,1908,26,na,1934,4104.756762664515
STAT,1886,40,20-24,1926,0.1952755918954107
STAT,1870,49,45-49,1919,0.2628967723762042
SIM,1871,30,25-29,1901,24
STAT,1798,64,na,1862,756.8373841712488
STAT,1831,34,45-49,1865,1.7392928437808042
STAT,1841,49,25-29,1890,0.05014233338656489
SIM,1906,34,na,1940,3697
STAT,1932,45,20-24,1977,0.01738605327628811
STAT,1922,30,40-44,1952,5.1414885366742205
SIM,1884,48,na,1932,2501
STAT,1876,45,30-34,1921,0.11663164272904973
STAT,1890,32,35-39,1922,14.280380351023407
SIM,1884,45,30-34,1929,1
SIM,1849,29,15-19,1878,1
STAT,1827,51,50-100,1878,0.01883069039463026
STAT,1950,51,na,2001,5147.905403804146
SIM,1889,29,45-49,1918,2
STAT,1831,40,30-34,1871,1.130444164932365
STAT,1816,44,20-24,1860,0.335040311433497
STAT,1960,48,30-34,2008,0.13898552461667119
STAT,1978,16,25-29,1994,68.27070559017773
STAT,1953,31,30-34,1984,22.433093408792143
STAT,1976,19,50-100,1995,0.5772578455960601
STAT,1854,44,40-44,1898,1.8077432254902572
SIM,1887,23,50-100,1910,1
SIM,1777,80,na,1857,269
STAT,1879,23,50-100,1902,0.4898767309122397
STAT,1968,40,50-100,2008,0.17646942451769881
STAT,1866,85,na,1951,293.2311469915858
STAT,1870,1,na,1871,4006.7285719989013
SIM,1843,24,na,1867,2012
SIM,1850,41,45-49,1891,6
STAT,1896,51,na,1947,3297.8372933624046
SIM,1899,47,na,1946,3841
SIM,1950,40,45-49,1990,2
STAT,1966,35,na,2001,5596.635533518266
STAT,1878,16,20-24,1894,21.414558145537363
STAT,1880,37,45-49,1917,2.4385151445393314
STAT,1897,36,na,1933,3653.0863316103387
STAT,1930,48,15-19,1978,5.583555649416444E-4
STAT,1963,20,35-39,1983,13.860434203577151
STAT,1845,18,50-100,1863,0.041480311661847305
STAT,1988,6,na,1994,6488.567735641708
STAT,1845,16,na,1861,1966.597182702269
STAT,1897,41,35-39,1938,0.1949218705001373
STAT,1768,98,na,1866,0.5331038357152569
STAT,1887,46,45-49,1933,0.3060908194682802
SIM,1941,11,na,1952,4039
SIM,1949,39,na,1988,5820
SIM,1878,19,40-44,1897,2
SIM,1878,28,30-34,1906,1
STAT,1960,49,35-39,2009,0.20039099501214283
SIM,1893,2,na,1895,3888
STAT,1936,69,na,2005,3379.4364095381907
STAT,1842,41,45-49,1883,1.2069252247568143
STAT,1969,31,na,2000,5560.899516802671
STAT,1942,40,45-49,1982,0.20920781719126957
STAT,1870,48,40-44,1918,0.1923309836183286
STAT,1966,45,20-24,2011,0.01664693952860537
STAT,1847,15,30-34,1862,1.5488721799642182
SIM,1864,93,na,1957,79
STAT,1865,54,45-49,1919,0.014695592865780581
SIM,1980,13,na,1993,6008
STAT,1953,49,50-100,2002,0.32651237190428
SIM,1813,58,na,1871,1197
SIM,1787,78,na,1865,665
STAT,1896,29,na,1925,3611.7445642831103
STAT,1962,32,35-39,1994,13.773831124772707
STAT,1832,46,20-24,1878,0.009977327594471726
STAT,1812,48,45-49,1860,0.5381596241155565
SIM,1912,31,35-39,1943,2
STAT,1892,15,na,1907,3670.0963753377864
SIM,1857,33,40-44,1890,5
SIM,1918,27,45-49,1945,9
STAT,1854,15,20-24,1869,17.48307371549296
SIM,1992,16,na,2008,6561
STAT,1931,69,na,2000,4557.241734665323
STAT,1911,16,30-34,1927,2.8241492056034905
STAT,1845,9,na,1854,2075.0
SIM,1965,38,na,2003,5544
STAT,1844,30,50-100,1874,0.9356800132270047
STAT,1942,33,20-24,1975,2.9971805758170653
STAT,1936,24,35-39,1960,10.387925301260063
STAT,1903,16,na,1919,4161.73002105466
STAT,1792,103,na,1895,0.040300248454916254
STAT,1993,13,na,2006,6521.152770660892
STAT,1845,37,na,1882,1668.062895183103
SIM,1958,39,35-39,1997,1
SIM,1917,60,na,1977,4753
STAT,1904,46,35-39,1950,0.13124492322777873
STAT,1960,19,30-34,1979,18.308448519346044
STAT,1892,47,30-34,1939,0.07861182340368088
STAT,1988,15,25-29,2003,71.56448425406134
STAT,1838,21,15-19,1859,3.7350228117041007
SIM,1845,57,na,1902,1828
STAT,1928,26,50-100,1954,1.4199919486247523
SIM,1910,18,30-34,1928,4
STAT,1913,37,45-49,1950,0.7768073223870189
STAT,1906,106,na,2012,1.340414951140871
STAT,1907,45,20-24,1952,0.011608176159210858
STAT,1881,49,50-100,1930,0.26767644703534044
SIM,1946,67,na,2013,3792
STAT,1933,35,20-24,1968,0.4152675698015361
STAT,1861,48,40-44,1909,0.16218670306886795
SIM,1837,23,15-19,1860,4
SIM,1840,38,na,1878,2022
STAT,1922,35,45-49,1957,0.8963637673939935
STAT,1981,10,na,1991,6340.622322460609
SIM,1930,35,45-49,1965,3
SIM,1889,91,na,1980,581
SIM,1909,36,35-39,1945,7
STAT,1865,37,na,1902,2453.1755308987913
STAT,1904,31,35-39,1935,16.851353187642307
SIM,1912,39,45-49,1951,1
SIM,1909,29,45-49,1938,2
SIM,1863,86,na,1949,62
SIM,1960,18,40-44,1978,4
SIM,1838,20,25-29,1858,72
STAT,1852,44,50-100,1896,0.9825924002307708
STAT,1927,26,35-39,1953,21.131492526996954
STAT,1921,45,na,1966,4800.230918515541
STAT,1938,6,na,1944,4565.022273962206
STAT,1945,48,45-49,1993,0.2841988189157779
SIM,1939,19,30-34,1958,36
STAT,1851,45,na,1896,1801.8989317968392
SIM,1953,22,35-39,1975,27
STAT,1904,39,45-49,1943,0.7058859691496298
STAT,1863,51,50-100,1914,0.015313257214455528
SIM,1974,20,50-100,1994,1
STAT,1938,21,50-100,1959,0.7521543775670995
STAT,1934,29,30-34,1963,60.799900721302265
SIM,1942,29,30-34,1971,52
STAT,1883,30,50-100,1913,1.0428414510825292
STAT,1957,48,25-29,2005,0.08371942515293959
SIM,1793,86,na,1879,254
STAT,1902,18,30-34,1920,2.592198764363747
STAT,1842,49,50-100,1891,0.1850493177882642
STAT,1913,44,35-39,1957,0.2259849399785975
SIM,1800,93,na,1893,17
SIM,1921,44,35-39,1965,1
STAT,1900,83,na,1983,1375.9425607870435
STAT,1945,22,35-39,1967,11.909482987091653
SIM,1950,33,20-24,1983,7
STAT,1818,59,na,1877,1000.2414268984398
SIM,1935,26,35-39,1961,51
STAT,1959,37,35-39,1996,3.7617247490211345
STAT,1835,52,50-100,1887,0.00960495388352085
STAT,1930,21,35-39,1951,13.964445324073521
STAT,1788,75,na,1863,610.8448697078802
STAT,1814,45,na,1859,1965.732208919467
SIM,1961,30,na,1991,5557
STAT,1817,108,na,1925,0.001266380640839342
STAT,1849,33,40-44,1882,3.505331892251121
STAT,1881,75,na,1956,1186.6903495749925
STAT,1962,46,40-44,2008,0.24309589090221412
STAT,1952,18,40-44,1970,1.9337622391500677
STAT,1945,40,35-39,1985,0.2645467659337985
SIM,1907,30,na,1937,4614
STAT,1918,42,50-100,1960,0.1441174304899409
STAT,1930,36,35-39,1966,3.6447335517372577
STAT,1902,31,50-100,1933,1.500161322316651
STAT,1877,38,na,1915,2814.1928570920104
STAT,1899,27,45-49,1926,1.7554674392064444
SIM,1923,16,15-19,1939,72
SIM,1927,32,35-39,1959,7
SIM,1935,19,45-49,1954,5
STAT,1920,32,30-34,1952,19.9071979849356
SIM,1836,25,20-24,1861,16
STAT,1935,34,50-100,1969,1.3190824487300918
SIM,1864,5,na,1869,3247
SIM,1951,31,15-19,1982,1
STAT,1852,19,na,1871,2586.7430500662076
STAT,1908,39,30-34,1947,1.951946824153994
STAT,1825,92,na,1917,29.459807505977988
STAT,1810,45,30-34,1855,0.3935058508874183
STAT,1979,16,na,1995,5850.2975889159825
STAT,1968,12,na,1980,5662.085641010485
SIM,1886,16,20-24,1902,32
STAT,1915,16,15-19,1931,10.990585068929676
STAT,1823,35,50-100,1858,2.6024901003856202
SIM,1955,17,20-24,1972,233
SIM,1951,27,30-34,1978,79
STAT,1943,27,30-34,1970,48.16288823169577
STAT,1917,41,15-19,1958,0.0018522123802132118
SIM,1887,20,20-24,1907,113
STAT,1903,22,30-34,1925,29.279424956588546
STAT,1888,34,50-100,1922,1.2323137544431382
STAT,1927,19,45-49,1946,0.7127998262125341
STAT,1776,102,na,1878,0.122455192790156
STAT,1929,41,na,1970,5558.837385341482
STAT,1947,17,20-24,1964,176.24238527913354
STAT,1938,29,15-19,1967,0.8067270335741418
STAT,1880,43,50-100,1923,1.2829602595731977
STAT,1875,67,na,1942,1890.523522509581
SIM,1920,48,na,1968,4089
STAT,1918,28,35-39,1946,18.370243985130084
STAT,1884,28,na,1912,2711.5853850551725
STAT,1887,17,25-29,1904,7.328910311876815
SIM,1902,24,30-34,1926,4
SIM,1910,18,na,1928,3878
STAT,1960,43,25-29,2003,0.111368737931841
STAT,1919,32,35-39,1951,11.375344111927717
SIM,1919,31,na,1950,5310
STAT,1908,43,15-19,1951,0.0016319098225195114
STAT,1849,18,45-49,1867,0.06195369628544002
SIM,1957,2,na,1959,6330
SIM,1795,77,na,1872,531
SIM,1877,16,20-24,1893,31
SIM,1927,84,na,2011,863
SIM,1888,30,na,1918,2824
SIM,1948,9,na,1957,4469
STAT,1917,34,25-29,1951,11.074087911161577
STAT,1895,67,na,1962,2585.069819740391
STAT,1903,15,40-44,1918,0.30204875021259897
SIM,1866,31,40-44,1897,13
SIM,1878,22,20-24,1900,169
STAT,2008,7,na,2015,7098.177531623905
STAT,1828,39,50-100,1867,1.2126093323218852
SIM,1862,15,20-24,1877,30
STAT,1823,48,20-24,1871,0.01169178294739697
SIM,1919,1,na,1920,5835
SIM,1908,93,na,2001,92
STAT,1868,20,45-49,1888,0.784391001770756
SIM,1882,69,na,1951,2112
SIM,1944,47,40-44,1991,1
STAT,1943,31,15-19,1974,0.1604091660004176
STAT,1944,24,40-44,1968,4.186952735350112
SIM,1925,34,25-29,1959,14
STAT,1869,16,20-24,1885,20.206941497687293
SIM,1926,28,35-39,1954,40
STAT,1950,22,15-19,1972,7.287723454509805
SIM,1909,33,30-34,1942,42
SIM,1900,26,20-24,1926,3
SIM,1877,90,na,1967,423
SIM,1952,24,40-44,1976,12
STAT,1845,92,na,1937,28.065661903001182
STAT,1953,48,40-44,2001,0.2283069265089237
STAT,1964,19,15-19,1983,65.92131896903832
STAT,1958,39,40-44,1997,2.332693193864737
SIM,1930,32,40-44,1962,13
STAT,1968,28,45-49,1996,2.499765481557447
STAT,1970,35,35-39,2005,3.6061222818965537
SIM,1876,20,45-49,1896,4
SIM,1899,33,45-49,1932,4
STAT,1950,37,15-19,1987,0.026996392444533075
STAT,1967,48,40-44,2015,0.23574986906245388
STAT,1910,25,25-29,1935,74.55200978214708
STAT,1953,16,35-39,1969,5.859691545885892
STAT,1858,31,40-44,1889,3.9450373797849547
SIM,1811,77,na,1888,620
SIM,1851,7,na,1858,3292
SIM,1950,38,50-100,1988,2
SIM,1916,39,30-34,1955,3
SIM,1972,19,15-19,1991,115
STAT,1911,15,na,1926,4484.854015596653
SIM,1884,21,35-39,1905,9
STAT,1922,32,40-44,1954,5.100490072630903
SIM,1831,77,na,1908,682
STAT,1960,50,na,2010,5691.941695721871
SIM,1860,20,35-39,1880,11
SIM,1861,43,na,1904,1759
SIM,1932,32,15-19,1964,2
STAT,1878,39,50-100,1917,1.4644862125024567
STAT,1835,21,45-49,1856,0.65166689102656
STAT,1882,37,20-24,1919,0.868912428946961
STAT,1798,108,na,1906,4.659168648342303E-4
STAT,1904,33,na,1937,3971.449138916602
STAT,1915,49,15-19,1964,4.2593917244658605E-4
SIM,1920,20,30-34,1940,86
STAT,1879,19,40-44,1898,0.21921966968828893
SIM,1784,81,na,1865,41
SIM,1842,60,na,1902,1678
SIM,1846,74,na,1920,405
STAT,1912,46,40-44,1958,0.17546491855577304
STAT,1960,46,30-34,2006,0.1397194858301145
STAT,1859,22,45-49,1881,0.6651121529010834
STAT,1863,66,na,1929,1653.9417920519618
SIM,1935,26,na,1961,5858
STAT,1901,34,15-19,1935,0.2282286699968676
SIM,1829,51,na,1880,1539
STAT,1849,36,45-49,1885,1.597536382149167
STAT,1956,25,15-19,1981,1.083645181574505
STAT,1970,32,30-34,2002,23.20018742778326
STAT,1880,58,na,1938,2419.078789839805
STAT,1952,43,30-34,1995,0.1834534425770875
STAT,1924,47,15-19,1971,5.059692326484487E-4
STAT,1896,15,25-29,1911,8.677847493883606
SIM,1910,22,15-19,1932,4
SIM,1942,26,25-29,1968,109
STAT,1917,3,na,1920,5020.780054461705
STAT,1904,106,na,2010,1.3052009719415294
STAT,1910,32,15-19,1942,0.1431411691610193
STAT,1933,72,na,2005,4319.537961420659
STAT,1826,30,35-39,1856,10.771784659604048
STAT,1972,27,50-100,1999,1.4770923439465358
STAT,1912,20,30-34,1932,32.007827696720064
STAT,1774,83,na,1857,5.30064380357
STAT,1815,62,na,1877,1236.4510610483944
STAT,1970,21,30-34,1991,41.67144912732011
SIM,1950,36,25-29,1986,1
STAT,1859,25,50-100,1884,0.606906829194015
STAT,1942,36,25-29,1978,1.2246986566201365
STAT,1854,18,25-29,1872,5.490106341743329
STAT,1893,32,na,1925,3480.956170384179
STAT,1887,24,50-100,1911,0.5241030753373209
STAT,1923,16,na,1939,4998.300988147295
STAT,1924,32,15-19,1956,0.1729710886464353
SIM,1906,13,na,1919,3996
STAT,1938,19,20-24,1957,154.3113721950405
SIM,1865,57,na,1922,2540
SIM,1895,24,50-100,1919,1
STAT,1902,40,15-19,1942,0.0015795231244589486
STAT,1897,46,na,1943,3482.3098229724455
SIM,1960,33,50-100,1993,3
STAT,1959,34,30-34,1993,24.211923500859346
STAT,1930,33,30-34,1963,23.453288738571022
STAT,1824,39,25-29,1863,4.220700097379561
STAT,1871,37,45-49,1908,2.28877464471969
STAT,1896,22,15-19,1918,5.028656472431436
SIM,1908,45,30-34,1953,1
STAT,1850,47,25-29,1897,0.059019649962030234
STAT,1962,37,40-44,1999,2.2805165127261953
SIM,1847,60,na,1907,2032
SIM,1878,25,25-29,1903,120
STAT,1768,111,na,1879,0.0011694940918586681
SIM,1946,19,20-24,1965,4
SIM,1979,23,25-29,2002,322
STAT,1916,37,15-19,1953,0.02269700058229705
STAT,1959,27,40-44,1986,7.06661287252674
SIM,1844,95,na,1939,15
SIM,1967,27,40-44,1994,8
STAT,1888,85,na,1973,842.377512345392
SIM,1916,36,25-29,1952,3
SIM,1953,45,40-44,1998,1
STAT,1955,41,35-39,1996,0.3210622689266088
STAT,1962,49,45-49,2011,0.3323184131066984
STAT,1876,84,na,1960,562.5687233959796
STAT,1934,33,15-19,1967,0.20245489247712986
STAT,1933,46,na,1979,5847.409082402923
SIM,1849,26,45-49,1875,3
SIM,1956,15,15-19,1971,61
SIM,1901,24,15-19,1925,5
STAT,1945,45,40-44,1990,0.20771233443259118
SIM,1867,22,45-49,1889,1
SIM,1832,39,25-29,1871,6
SIM,1883,86,na,1969,394
STAT,1852,20,35-39,1872,6.630719437622249
STAT,1916,46,25-29,1962,0.06295139994579783
SIM,1902,21,25-29,1923,187
SIM,1833,56,na,1889,1382
STAT,1867,32,45-49,1899,1.8789482331090022
SIM,1835,27,na,1862,2689
SIM,1857,36,45-49,1893,7
SIM,1948,44,na,1992,4368
SIM,1846,43,na,1889,1521
SIM,1838,46,50-100,1884,2
SIM,1913,92,na,2005,955
STAT,1832,49,25-29,1881,0.041934252808973775
STAT,1907,35,50-100,1942,0.45423234482525243
STAT,1948,48,15-19,1996,5.046231576980828E-4
STAT,1908,36,25-29,1944,1.0703479446505877
STAT,1831,88,na,1919,107.70818516722078
STAT,1828,80,na,1908,410.56199739812354
STAT,1941,39,15-19,1980,0.02347300637445366
STAT,1943,48,50-100,1991,0.2871359185694601
STAT,1956,43,15-19,1999,0.002433264193750575
STAT,1946,33,na,1979,4931.461047170859
SIM,1888,74,na,1962,1286
STAT,1901,27,25-29,1928,68.37951664037742
STAT,1942,43,15-19,1985,0.0019220216237269346
SIM,1929,61,na,1990,4762
STAT,1918,25,30-34,1943,48.43866770300283
STAT,1946,29,20-24,1975,23.442526073220318
STAT,1960,16,25-29,1976,65.15441433521329
SIM,1847,48,na,1895,2301
STAT,1828,28,25-29,1856,61.431765098995996
STAT,1926,28,40-44,1954,6.42422387913034
SIM,1836,28,25-29,1864,4
STAT,1850,29,25-29,1879,50.51289775684925
SIM,1904,45,45-49,1949,1
STAT,1922,42,35-39,1964,0.2666166802430335
STAT,1833,36,na,1869,1903.5039800512516
SIM,1962,39,45-49,2001,3
STAT,1849,15,40-44,1864,0.17657207953975376
SIM,1903,15,35-39,1918,3
STAT,1952,25,30-34,1977,54.469924510969406
STAT,1828,89,na,1917,69.72396118384717
STAT,1875,23,40-44,1898,2.477461786363442
STAT,1929,44,45-49,1973,0.2479181911762839
STAT,1949,45,25-29,1994,0.07440312323577268
STAT,1904,36,40-44,1940,1.573352497237788
SIM,1960,25,30-34,1985,128
SIM,1918,34,35-39,1952,1
STAT,1948,15,15-19,1963,59.96822840764297
STAT,1924,37,20-24,1961,0.35862870696198834
STAT,1856,47,20-24,1903,0.010516135346430696
STAT,1898,1,na,1899,4245.241603201237
STAT,1869,19,25-29,1888,6.34546644766357
STAT,1936,17,45-49,1953,0.5522608553950155
SIM,1862,18,25-29,1880,10
SIM,1918,78,na,1996,2253
SIM,1845,23,20-24,1868,69
STAT,1920,44,25-29,1964,0.09067458657449595
SIM,1925,31,20-24,1956,7
STAT,1820,39,40-44,1859,5.943757308398192
STAT,1837,22,50-100,1859,0.38656087896646524
STAT,1837,23,20-24,1860,64.8558831161838
SIM,1934,52,na,1986,5615
SIM,1876,73,na,1949,1524
STAT,1882,105,na,1987,1.29349206420988
STAT,1936,42,35-39,1978,0.2302660472613806
SIM,1922,32,35-39,1954,51
STAT,1887,112,na,1999,0.005420154254590099
SIM,1980,19,20-24,1999,8
STAT,1843,108,na,1951,0.0018379165956316308
SIM,1899,30,40-44,1929,1
STAT,1934,26,25-29,1960,102.28097737049103
SIM,1911,25,35-39,1936,39
STAT,1780,79,na,1859,380.3836566172856
STAT,1845,47,45-49,1892,0.15828835326545562
SIM,1869,27,25-29,1896,39
STAT,1940,28,na,1968,4407.816273464219
STAT,1791,95,na,1886,2.886559435051647
SIM,1890,37,20-24,1927,1
SIM,1936,47,35-39,1983,1
SIM,1964,27,na,1991,5469
STAT,1846,54,na,1900,2164.6952617763914
SIM,1912,36,40-44,1948,3
STAT,1910,22,20-24,1932,120.63294238014274
STAT,1903,25,35-39,1928,15.968292733887457
STAT,1914,32,35-39,1946,10.620803678937033
SIM,1984,21,50-100,2005,4
STAT,1862,92,na,1954,40.563714027754884
SIM,1852,39,na,1891,1944
STAT,1858,55,na,1913,1861.5335723001872
SIM,1922,51,na,1973,4901
SIM,1926,25,30-34,1951,119
STAT,1830,53,35-39,1883,0.006846851743153534
SIM,1918,14,na,1932,4266
STAT,1952,29,na,1981,5198.055999171336
SIM,1820,48,45-49,1868,1
STAT,1913,95,na,2008,221.6948642275263
STAT,1884,21,40-44,1905,2.3831759279711737
STAT,1928,47,35-39,1975,0.18984495082360833
STAT,1950,27,20-24,1977,25.015948024156273
STAT,1947,47,50-100,1994,0.3058294976222367
STAT,1982,15,15-19,1997,73.73808854603072
STAT,1972,19,20-24,1991,200.19302358138702
STAT,2007,6,na,2013,7061.528915977752
SIM,1934,35,30-34,1969,5
STAT,1803,61,na,1864,974.5919008464332
STAT,1933,0,na,1933,6962.885286655583
STAT,1903,18,45-49,1921,0.10709432032226443
STAT,1926,35,30-34,1961,2.574473038215449
SIM,1853,56,na,1909,1994
SIM,1827,60,na,1887,1026
STAT,1904,43,30-34,1947,0.13134888676825307
STAT,1960,23,15-19,1983,8.024951261217725
STAT,1903,43,35-39,1946,0.20520628313026074
STAT,1884,105,na,1989,1.3807038094481767
STAT,1908,33,20-24,1941,2.6492077908177145
SIM,1902,51,na,1953,3690
STAT,1824,54,20-24,1878,9.302202431543743E-4
SIM,1920,23,35-39,1943,28
SIM,1951,21,20-24,1972,327
SIM,1828,34,na,1862,2341
SIM,1821,36,45-49,1857,1
STAT,1970,24,35-39,1994,13.638194893290956
STAT,1837,33,15-19,1870,0.1279569822804123
STAT,1834,30,40-44,1864,5.1758128717093905
STAT,1909,39,45-49,1948,0.7380024366448391
SIM,1959,27,35-39,1986,59
SIM,2011,0,na,2011,7170
STAT,1935,17,30-34,1952,19.240096598492503
SIM,1858,40,45-49,1898,3
SIM,1898,42,40-44,1940,1
STAT,1934,63,na,1997,5309.529908642752
STAT,1935,36,35-39,1971,3.9088623871525647
SIM,1904,36,35-39,1940,3
STAT,1943,21,20-24,1964,136.58610533307626
SIM,1917,39,45-49,1956,3
STAT,1847,49,20-24,1896,0.00904066512731105
STAT,1953,23,na,1976,5113.270101457352
SIM,1891,50,na,1941,3120
STAT,1954,37,35-39,1991,3.5551202334643826
SIM,1928,39,20-24,1967,1
SIM,1895,64,na,1959,2617
STAT,1912,23,35-39,1935,10.391676176403047
SIM,1931,64,na,1995,5073
STAT,1836,49,45-49,1885,0.21916088092750613
STAT,1918,18,40-44,1936,1.7519660063139835
SIM,1847,17,na,1864,2962
STAT,1836,108,na,1944,0.0016669926562988644
STAT,1970,15,na,1985,5320.157569969763
STAT,1864,20,25-29,1884,60.80689054321027
STAT,1929,37,20-24,1966,0.3905830764962212
STAT,1910,16,15-19,1926,10.41408530520711
SIM,1852,30,50-100,1882,1
SIM,1911,43,35-39,1954,1
SIM,1877,19,25-29,1896,8
SIM,1838,20,50-100,1858,1
SIM,1845,26,na,1871,2256
SIM,1943,29,45-49,1972,8
STAT,1912,41,35-39,1953,0.22563685780701087
STAT,1854,16,50-100,1870,0.048029002165113646
STAT,1923,23,45-49,1946,1.505638148684557
SIM,1966,36,25-29,2002,1
SIM,1916,33,20-24,1949,6
SIM,1923,36,na,1959,5397
SIM,1931,23,45-49,1954,3
STAT,1805,49,15-19,1854,0.0014615204851074098
SIM,1962,37,35-39,1999,8
SIM,1952,27,45-49,1979,2
STAT,1912,49,45-49,1961,0.2398651127912564
SIM,1815,82,na,1897,382
SIM,1920,49,45-49,1969,1
STAT,1944,27,45-49,1971,2.15494372270175
SIM,1935,57,na,1992,5807
SIM,1845,26,25-29,1871,54
STAT,1839,21,30-34,1860,18.28153109412295
SIM,1849,23,40-44,1872,8
STAT,1860,20,40-44,1880,2.2274482191843057
STAT,1863,23,15-19,1886,3.371044473560158
SIM,1877,48,45-49,1925,1
SIM,1844,49,45-49,1893,1
STAT,1829,54,na,1883,1600.1680303426328
STAT,1850,44,20-24,1894,0.1612826461543464
STAT,1944,15,30-34,1959,15.1463526324748
STAT,1961,46,25-29,2007,0.08247083091386428
SIM,1952,26,na,1978,4806
STAT,1813,54,45-49,1867,0.044275573654150614
STAT,1934,23,20-24,1957,172.48059644433803
STAT,1932,61,na,1993,5299.33232559275
STAT,1824,36,20-24,1860,1.2102399473948735
SIM,1861,41,50-100,1902,1
STAT,1923,30,35-39,1953,12.182767808672955
STAT,1979,30,20-24,2009,3.9551477253001437
SIM,1943,36,35-39,1979,10
STAT,1860,48,25-29,1908,0.05290109552234511
STAT,1921,47,50-100,1968,0.294145327649085
SIM,1816,45,50-100,1861,2
STAT,1886,26,20-24,1912,14.32983447473831
STAT,1831,39,15-19,1870,0.054388321759886
SIM,1870,36,40-44,1906,16
SIM,1942,23,20-24,1965,152
SIM,1908,79,na,1987,1679
SIM,1904,65,na,1969,3419
STAT,1889,15,35-39,1904,0.7842034383324548
STAT,1837,26,25-29,1863,39.60002189699093
STAT,1872,50,35-39,1922,0.01011955892620126
STAT,1844,11,na,1855,2549.7741
STAT,1848,25,na,1873,2783.848719241318
STAT,1894,93,na,1987,267.657591204106
STAT,1959,9,na,1968,5932.09327684848
SIM,1848,8,na,1856,2350
SIM,1871,23,15-19,1894,4
SIM,1879,49,na,1928,2548
SIM,1997,15,40-44,2012,6
STAT,1902,27,40-44,1929,4.884650411638285
STAT,1933,29,15-19,1962,1.081167038702319
SIM,1917,28,na,1945,5498
STAT,1972,26,45-49,1998,2.564918094675399
STAT,1862,54,40-44,1916,0.009971262295571019
SIM,1894,26,20-24,1920,20
STAT,1923,19,25-29,1942,58.38820480719859
STAT,1909,27,30-34,1936,43.26341175188388
SIM,1809,74,na,1883,683
SIM,1917,27,30-34,1944,82
STAT,1960,28,40-44,1988,7.032814476479983
STAT,1838,30,25-29,1868,11.258153871178994
STAT,1955,34,45-49,1989,2.4541523429768417
SIM,1847,21,30-34,1868,25
SIM,1931,30,35-39,1961,1
STAT,1989,15,40-44,2004,2.3132862294503274
SIM,1941,29,15-19,1970,1
SIM,1924,46,50-100,1970,1
SIM,1837,18,na,1855,2768
SIM,1931,19,25-29,1950,97
SIM,1930,26,35-39,1956,48
STAT,1942,27,15-19,1969,0.8552206717155494
SIM,1904,29,45-49,1933,4
SIM,1900,36,50-100,1936,2
STAT,1897,116,na,2013,1.0521264486950977E-4
SIM,1886,32,20-24,1918,2
STAT,1827,63,na,1890,1449.0698630812838
STAT,1888,21,25-29,1909,77.89239870075153
STAT,1962,17,50-100,1979,0.5539953954204637
STAT,1963,37,45-49,2000,1.0297413660661854
SIM,1837,36,50-100,1873,4
SIM,1925,27,na,1952,5076
STAT,1919,16,35-39,1935,1.0760320636778273
STAT,1878,32,20-24,1910,3.2570656610548543
STAT,1762,115,na,1877,2.493128717269666E-4
STAT,1970,17,45-49,1987,0.7216524027978447
STAT,1900,36,20-24,1936,0.2677174594260857
STAT,1799,91,na,1890,26.029276207972398
SIM,1846,30,25-29,1876,15
SIM,1921,65,na,1986,4498
STAT,1888,17,40-44,1905,0.24812164280024485
STAT,1961,19,45-49,1980,0.7443169311363484
SIM,1910,27,40-44,1937,7
STAT,1914,32,na,1946,4395.579886382776
STAT,1946,43,35-39,1989,0.2674357641318767
STAT,1918,46,na,1964,4521.982968069864
SIM,1966,30,na,1996,5758
SIM,1971,37,45-49,2008,1
STAT,1907,39,15-19,1946,0.020373118213315854
STAT,1961,39,35-39,2000,3.7075252259932547
STAT,1850,26,20-24,1876,14.314873616048303
SIM,1896,21,25-29,1917,97
STAT,1915,72,na,1987,3164.3355191197265
STAT,1893,22,45-49,1915,1.0171959057279443
STAT,1887,30,20-24,1917,3.5240288469594336
SIM,1864,17,na,1881,2954
STAT,1858,24,na,1882,2191.302359410472
SIM,1874,61,na,1935,1956
SIM,1878,75,na,1953,1286
STAT,1935,29,45-49,1964,2.716515539931048
STAT,1878,32,na,1910,2875.398768031969
STAT,1952,48,25-29,2000,0.07609357227513558
SIM,1858,17,20-24,1875,1
STAT,1859,72,na,1931,1160.9852371710028
SIM,1836,39,50-100,1875,1
STAT,1876,53,na,1929,2527.4405560044333
SIM,1989,21,40-44,2010,11
STAT,1790,78,na,1868,318.7560481550897
STAT,1902,34,30-34,1936,16.207687636752976
SIM,1977,20,30-34,1997,1
STAT,1863,45,45-49,1908,0.24052425140794298
SIM,1954,36,45-49,1990,4
SIM,1869,24,20-24,1893,144
STAT,1943,22,50-100,1965,0.8079829953811326
SIM,1971,8,na,1979,5818
STAT,1909,43,30-34,1952,0.13732501101039732
SIM,1943,17,30-34,1960,17
SIM,1814,42,na,1856,1489
STAT,1847,40,na,1887,1834.7268079829194
STAT,1818,53,50-100,1871,0.01758579170745322
STAT,1955,27,20-24,1982,28.086116223009324
SIM,1905,29,25-29,1934,82
SIM,1963,27,20-24,1990,47
STAT,1790,103,na,1893,0.031764021910306764
SIM,1849,42,45-49,1891,2
SIM,1869,2,na,1871,2921
STAT,1951,37,30-34,1988,2.580404566233895
STAT,1936,21,30-34,1957,31.740263584501726
SIM,1958,33,25-29,1991,35
SIM,1950,27,15-19,1977,2
STAT,1811,45,25-29,1856,0.18571307292585412
SIM,1858,21,40-44,1879,4
STAT,1946,36,45-49,1982,0.8998019334706895
STAT,1879,72,na,1951,1521.8122042612995
STAT,1887,24,15-19,1911,4.239993391357624
SIM,1988,17,40-44,2005,2
SIM,1895,24,15-19,1919,10
STAT,1827,40,na,1867,2233.672782510264
STAT,1925,8,na,1933,5558.391966595096
STAT,1949,36,15-19,1985,0.02657793246658954
SIM,1838,23,30-34,1861,22
STAT,1942,38,50-100,1980,0.5212318789190149
STAT,1922,31,na,1953,4949.536106521707
STAT,1961,26,35-39,1987,22.492095343063667
SIM,1881,51,na,1932,1726
SIM,1819,36,25-29,1855,3
SIM,1877,35,na,1912,3202
STAT,1863,52,35-39,1915,0.008641241144165753
STAT,1813,59,na,1872,1137.986165522807
STAT,1862,108,na,1970,0.026627738321368798
SIM,1812,94,na,1906,6
SIM,1860,44,50-100,1904,3
STAT,1899,24,40-44,1923,3.274023471433404
STAT,1935,33,30-34,1968,25.152916366556333
SIM,1941,38,25-29,1979,1
SIM,1941,19,20-24,1960,137
SIM,1932,75,na,2007,3510
SIM,1920,17,na,1937,3963
SIM,1962,41,na,2003,5492
STAT,1789,92,na,1881,9.356944052244407
STAT,1896,20,na,1916,3626.520264734101
STAT,1936,47,40-44,1983,0.18044893608493684
STAT,1876,21,35-39,1897,6.9826220162949495
STAT,1836,46,40-44,1882,0.16521404839426784
STAT,1849,104,na,1953,0.05169708204097496
STAT,1980,26,40-44,2006,7.503035477807998
SIM,1945,37,50-100,1982,1
SIM,1944,21,30-34,1965,85
SIM,1875,30,50-100,1905,1
SIM,1922,39,50-100,1961,1
STAT,1946,33,40-44,1979,5.102631459152231
SIM,1847,24,35-39,1871,14
SIM,1820,38,na,1858,1985
SIM,1893,21,na,1914,3719
SIM,1966,18,na,1984,5562
STAT,1903,40,30-34,1943,0.13255565318851573
STAT,1833,30,50-100,1863,0.8559956938055983
STAT,1842,40,na,1882,1887.8697342832816
SIM,1843,55,na,1898,1609
STAT,1900,46,15-19,1946,3.623447287750872E-4
STAT,1911,20,15-19,1931,5.865953186209272
STAT,1830,50,30-34,1880,0.005520988960766346
STAT,1876,20,na,1896,2838.287370623974
STAT,1902,3,na,1905,4310.796029877877
SIM,1897,35,na,1932,3735
STAT,1836,88,na,1924,124.93737414031565
STAT,1832,74,na,1906,756.0882310170499
STAT,1855,18,40-44,1873,0.18401773658841253
STAT,1815,93,na,1908,16.21663431500323
STAT,1955,37,15-19,1992,0.030309617491488194
STAT,1989,18,45-49,2007,0.8254714029684004
SIM,1863,4,na,1867,3121
SIM,1811,47,40-44,1858,1
STAT,1793,66,na,1859,780.1193738210101
STAT,1873,39,20-24,1912,0.8992945710771046
SIM,1916,43,na,1959,4362
SIM,1910,34,30-34,1944,15
SIM,1862,69,na,1931,1758
STAT,1919,42,na,1961,4643.61182831307
STAT,1834,22,na,1856,2609.591829460303
SIM,1863,55,na,1918,2057
SIM,1867,69,na,1936,1213
STAT,1909,36,40-44,1945,1.644937039988961
STAT,1862,39,45-49,1901,1.9219807652438117
STAT,1920,28,na,1948,4723.7621224123
STAT,1922,19,45-49,1941,0.6633169038001769
STAT,1881,15,30-34,1896,1.782425573803093
STAT,1854,31,20-24,1885,2.2786978776455618
SIM,1951,24,25-29,1975,180
STAT,1914,39,50-100,1953,0.4791363945268002
STAT,1812,74,na,1886,501.1745426539529
STAT,1943,24,25-29,1967,113.3475253880511
STAT,1839,24,35-39,1863,5.861126808201173
SIM,1894,29,25-29,1923,125
SIM,1949,38,30-34,1987,2
STAT,1804,53,40-44,1857,0.04749367921057162
STAT,1889,71,na,1960,2076.441436528806
STAT,1911,19,35-39,1930,0.9646648690035049
SIM,1907,39,na,1946,4442
SIM,1869,32,50-100,1901,4
STAT,1933,38,25-29,1971,1.5468195762783636
SIM,1870,39,45-49,1909,2
SIM,1859,21,20-24,1880,1
STAT,1921,32,25-29,1953,11.865703051388113
STAT,1907,29,20-24,1936,19.610871662399372
SIM,1917,36,40-44,1953,6
SIM,1918,24,40-44,1942,13
STAT,1972,23,40-44,1995,4.983014834327453
STAT,1889,16,na,1905,3601.673767988746
SIM,1873,21,na,1894,3121
STAT,1886,29,25-29,1915,51.12595400141856
STAT,1815,47,50-100,1862,0.5014177183259889
SIM,1823,47,50-100,1870,2
SIM,1918,31,30-34,1949,12
STAT,1895,116,na,2011,1.006211181076951E-4
STAT,1903,48,40-44,1951,0.15674671258031034
STAT,1926,19,50-100,1945,0.5271559186482461
STAT,1817,74,na,1891,767.2635568455726
STAT,1883,33,40-44,1916,4.875889690819845
SIM,1911,22,30-34,1933,43
STAT,1976,23,25-29,1999,142.8387617706127
STAT,1923,16,20-24,1939,184.1052228234307
STAT,1964,43,45-49,2007,0.251002874090945
SIM,1875,87,na,1962,333
SIM,1862,31,20-24,1893,7
SIM,1926,22,25-29,1948,6
STAT,1906,68,na,1974,3067.9721591207403
STAT,1828,41,20-24,1869,0.15524341270005226
STAT,1913,34,40-44,1947,4.457132779655122
STAT,1813,60,na,1873,1115.6702568169048
SIM,1816,56,na,1872,1431
SIM,1868,39,25-29,1907,7
STAT,1902,54,na,1956,3437.7052577084823
SIM,1931,16,20-24,1947,235
SIM,1943,26,40-44,1969,8
STAT,1918,22,25-29,1940,114.94492152966468
STAT,1895,38,50-100,1933,1.8351575722711209
STAT,1941,45,na,1986,4564.849206060759
STAT,1965,23,50-100,1988,0.9508326146864878
STAT,1971,11,na,1982,5742.498381701691
STAT,1933,19,20-24,1952,208.41393412167756
SIM,1938,32,45-49,1970,3
SIM,1956,19,na,1975,5145
STAT,1893,47,25-29,1940,0.04717455052712954
STAT,1944,45,25-29,1989,0.0688494129086395
SIM,1933,35,na,1968,6412
STAT,1981,17,20-24,1998,218.78014316077898
STAT,1802,75,na,1877,572.0125466250763
SIM,1943,33,30-34,1976,52
SIM,1927,39,40-44,1966,1
STAT,1989,25,35-39,2014,24.946203597682455
SIM,1846,22,na,1868,1781
SIM,1892,35,na,1927,3745
SIM,1952,18,35-39,1970,9
STAT,1912,16,45-49,1928,0.11697181260102837
STAT,1913,41,30-34,1954,0.14478424704531584
STAT,1983,25,50-100,2008,1.6333993948467533
SIM,1896,49,na,1945,3404
STAT,1944,18,35-39,1962,5.209887104253527
SIM,1891,33,40-44,1924,2
SIM,1892,90,na,1982,591
STAT,1925,47,30-34,1972,0.12462369525155298
STAT,1919,39,40-44,1958,1.8515815224467158
SIM,1863,25,30-34,1888,70
STAT,1941,5,na,1946,4753.098065965294
STAT,1922,26,35-39,1948,19.66453368845915
SIM,1970,7,na,1977,6049
STAT,1939,17,15-19,1956,52.4471727121837
STAT,1957,48,50-100,2005,0.3569703292120688
STAT,1861,18,50-100,1879,0.05370649384559404
SIM,1868,18,20-24,1886,23
STAT,1967,28,30-34,1995,56.70123920566173
SIM,1856,73,na,1929,1105
STAT,1901,24,20-24,1925,110.6984994285903
SIM,1832,30,na,1862,2319
SIM,1883,44,50-100,1927,2
STAT,1857,43,40-44,1900,2.007069026073235
STAT,1839,17,45-49,1856,0.06776715476522105
STAT,1866,33,50-100,1899,0.975937022982017
STAT,1869,48,45-49,1917,0.26044146353174497
STAT,1944,56,na,2000,4569.149001925867
SIM,1972,26,na,1998,5786
STAT,1935,26,40-44,1961,7.339639944899577
SIM,1865,43,40-44,1908,9
SIM,1953,29,40-44,1982,21
SIM,1903,69,na,1972,2676
STAT,1929,47,15-19,1976,5.510518697021366E-4
SIM,1837,28,40-44,1865,2
SIM,1851,15,45-49,1866,1
SIM,1925,18,25-29,1943,133
SIM,1802,64,na,1866,884
STAT,1984,26,25-29,2010,108.3986111713768
STAT,1899,41,50-100,1940,0.11651561471780077
STAT,1917,25,15-19,1942,0.8602117130721612
STAT,1853,36,na,1889,2370.1391468991314
STAT,1887,33,25-29,1920,13.191093572305313
STAT,1893,53,na,1946,3090.5203584853293
STAT,1977,17,35-39,1994,6.543030696697384
SIM,1816,40,40-44,1856,3
STAT,1863,16,25-29,1879,6.563839955614784
STAT,1932,20,na,1952,5563.940605192048
STAT,1936,34,na,1970,4236.509896979271
SIM,1891,94,na,1985,99
STAT,1966,20,50-100,1986,0.9522427023471334
STAT,1818,107,na,1925,0.002086626473300176
STAT,1820,48,50-100,1868,0.2473462445479577
SIM,1871,16,25-29,1887,9
STAT,1829,28,40-44,1857,5.254572554980959
STAT,1861,109,na,1970,0.010138450408082261
STAT,1946,40,30-34,1986,0.17053313825321773
STAT,1843,15,45-49,1858,0.08475537991693427
SIM,1872,20,25-29,1892,2
STAT,1909,46,35-39,1955,0.13721631732679185
SIM,1875,32,45-49,1907,8
SIM,1884,17,na,1901,2896
STAT,1862,36,40-44,1898,4.283911805588456
STAT,1961,23,30-34,1984,42.980630688057
SIM,1895,33,25-29,1928,18
STAT,1994,20,45-49,2014,1.8812892424109116
STAT,1945,29,40-44,1974,5.895541042370358
STAT,1906,18,15-19,1924,9.960917228269036
SIM,1915,29,20-24,1944,34
STAT,1863,42,40-44,1905,2.266972651149446
STAT,1906,25,50-100,1931,1.0838232322251182
STAT,1885,49,40-44,1934,0.19295523598380704
STAT,1974,37,20-24,2011,0.40925563775294554
SIM,1789,81,na,1870,199
STAT,1840,27,50-100,1867,0.6398383615973935
STAT,1923,49,20-24,1972,0.014826475106976284
SIM,1829,74,na,1903,520
STAT,1873,35,50-100,1908,1.4606236054202097
SIM,1848,21,45-49,1869,1
SIM,1842,30,40-44,1872,8
SIM,1914,18,15-19,1932,9
STAT,1933,45,15-19,1978,5.876174176004918E-4
SIM,1954,33,40-44,1987,10
STAT,1982,28,15-19,2010,1.1508156991726295
STAT,1900,39,25-29,1939,0.9851456834227797
SIM,1976,33,na,2009,5972
STAT,1982,28,50-100,2010,1.6225786254769288
STAT,1905,83,na,1988,1481.810052405683
STAT,1968,25,40-44,1993,6.753403893243027
SIM,1858,31,35-39,1889,3
STAT,1898,40,25-29,1938,0.07025214797929573
STAT,1895,38,45-49,1933,2.979746516934637
STAT,1855,25,30-34,1880,24.899400876434402
STAT,1891,4,na,1895,3752.1977535869673
STAT,1962,52,na,2014,5555.394999854697
SIM,1903,91,na,1994,368
STAT,1978,36,na,2014,6110.132647107153
STAT,1907,48,25-29,1955,0.05447602613925867
SIM,1841,30,50-100,1871,5
STAT,1862,40,na,1902,2273.704627818453
STAT,1956,22,45-49,1978,1.7239007462185643
STAT,1866,54,na,1920,2239.8259588386686
STAT,1961,16,40-44,1977,2.0860690546608907
STAT,1900,31,15-19,1931,0.22897727253697112
SIM,1881,35,50-100,1916,3
SIM,1964,22,45-49,1986,2
SIM,1871,42,40-44,1913,4
SIM,1905,26,20-24,1931,22
SIM,1964,6,na,1970,5977
STAT,1867,39,na,1906,2512.9888795065417
STAT,1915,20,35-39,1935,10.8449554824783
STAT,1840,47,45-49,1887,0.1909136667033162
STAT,1902,85,na,1987,1161.7999194559543
STAT,1947,24,45-49,1971,1.4665125117884819
STAT,1922,16,40-44,1938,1.8718878639810552
SIM,1885,39,40-44,1924,11
STAT,1929,35,35-39,1964,3.590001777566272
STAT,1868,23,15-19,1891,3.646548278080508
STAT,1847,31,30-34,1878,15.93840627711995
SIM,1853,36,25-29,1889,7
STAT,1812,102,na,1914,0.12871359723253917
STAT,1967,22,20-24,1989,160.82431853944973
SIM,1953,12,na,1965,5699
STAT,1880,49,40-44,1929,0.20504639277824818
SIM,1864,22,40-44,1886,3
SIM,1975,22,20-24,1997,181
SIM,1982,15,na,1997,6001
STAT,1845,36,25-29,1881,2.0597871603173914
STAT,1875,19,20-24,1894,21.029579927833925
SIM,1914,22,35-39,1936,1
SIM,1966,24,20-24,1990,4
STAT,1921,68,na,1989,3930.082131987458
STAT,1941,18,30-34,1959,14.487659763574358
STAT,1983,12,na,1995,6412.885789636453
STAT,1980,17,40-44,1997,2.2408595788143124
STAT,1908,32,50-100,1940,0.9017974854242619
SIM,1938,45,na,1983,4038
STAT,1973,21,35-39,1994,14.104773125676894
STAT,1909,21,20-24,1930,119.75960802582605
STAT,1829,75,na,1904,754.1626292520391
STAT,1878,42,15-19,1920,0.01661974410613226
SIM,1876,23,15-19,1899,7
STAT,1854,34,25-29,1888,8.369757533094775
STAT,1912,31,20-24,1943,2.783831505074875
SIM,1845,37,45-49,1882,8
SIM,1983,18,30-34,2001,49
STAT,1991,11,na,2002,6497.669914156876
SIM,1910,37,35-39,1947,1
SIM,1836,39,45-49,1875,2
STAT,1856,22,40-44,1878,2.1308184894113884
SIM,1879,28,45-49,1907,4
SIM,1899,26,20-24,1925,21
SIM,1829,34,40-44,1863,8
STAT,1964,23,35-39,1987,13.72690900877621
SIM,1908,23,20-24,1931,106
STAT,1897,18,45-49,1915,0.10053726698707559
SIM,1917,21,20-24,1938,148
SIM,1972,23,35-39,1995,30
STAT,1859,25,15-19,1884,0.4304493452613186
STAT,1837,37,45-49,1874,1.7575336172670408
SIM,1963,25,35-39,1988,35
STAT,1828,39,45-49,1867,1.9689145438976825
SIM,1791,84,na,1875,172
STAT,1930,40,40-44,1970,0.38090120074387923
SIM,1855,24,40-44,1879,6
SIM,1937,28,45-49,1965,1
STAT,1867,49,na,1916,2373.562425184212
STAT,1902,95,na,1997,189.0040271625659
STAT,1864,19,45-49,1883,0.06881391612214234
STAT,1832,50,50-100,1882,0.011346832346297103
STAT,1883,36,45-49,1919,2.2616638311359574
STAT,1825,42,50-100,1867,1.5714838583200263
STAT,1958,24,20-24,1982,168.9837881336441
STAT,1893,29,50-100,1922,0.9264618835045786
SIM,1983,25,20-24,2008,60
STAT,1863,27,45-49,1890,1.1204181629042425
STAT,1869,44,15-19,1913,0.015225650574896403
STAT,1881,106,na,1987,0.6432009519027682
STAT,1957,51,na,2008,5740.2917101114535
STAT,1809,75,na,1884,498.84449366872644
STAT,1818,38,na,1856,1350.5628920974418
STAT,1889,31,50-100,1920,1.3087493768187943
STAT,1829,35,30-34,1864,6.362922076819568
STAT,1975,25,20-24,2000,27.93545639674685
SIM,1859,49,40-44,1908,1
STAT,1877,69,na,1946,1761.7050077510912
SIM,1800,62,na,1862,1203
SIM,1894,37,40-44,1931,17
STAT,1850,51,45-49,1901,0.015011228176695087
STAT,1902,37,35-39,1939,2.4893623189468155
SIM,1861,74,na,1935,531
STAT,1816,57,na,1873,1233.751274118293
SIM,1872,23,30-34,1895,27
STAT,1872,91,na,1963,155.25390795147075
STAT,1894,17,na,1911,3746.835706996249
STAT,1929,28,45-49,1957,2.4941453285529436
STAT,1842,49,20-24,1891,0.009041497969780992
STAT,1947,31,35-39,1978,12.116083494686132
SIM,1923,20,35-39,1943,21
STAT,1975,19,25-29,1994,65.93230003566127
STAT,1964,40,40-44,2004,0.3788737981169074
SIM,1865,98,na,1963,23
SIM,1972,16,45-49,1988,4
STAT,1892,36,na,1928,3424.168041659855
STAT,1831,49,45-49,1880,0.21312218547088055
SIM,1975,37,na,2012,6058
STAT,1886,37,40-44,1923,5.328782973640978
STAT,1864,23,30-34,1887,18.515768293590188
STAT,1894,36,20-24,1930,1.149088679171885
SIM,1881,19,na,1900,2123
SIM,1837,35,30-34,1872,12
SIM,1888,30,30-34,1918,33
STAT,1792,81,na,1873,310.5129972222703
SIM,1965,23,na,1988,4905
STAT,1828,44,25-29,1872,0.598385362987841
STAT,1897,25,35-39,1922,14.990603657445924
SIM,1855,31,30-34,1886,3
SIM,1955,24,45-49,1979,5
SIM,1818,48,25-29,1866,1
STAT,1979,29,40-44,2008,7.430962532956102
STAT,1992,17,20-24,2009,224.5787458810805
STAT,1881,54,na,1935,2330.8444752615696
SIM,1959,21,25-29,1980,301
SIM,1868,47,40-44,1915,1
STAT,1834,40,35-39,1874,2.043897077626092
STAT,1854,29,45-49,1883,0.9347060710926759
SIM,1872,48,45-49,1920,3
SIM,1962,27,40-44,1989,8
STAT,1854,41,15-19,1895,0.011301733841188787
SIM,1850,37,na,1887,1594
STAT,1831,24,na,1855,2197.513425268828
SIM,1970,14,na,1984,6042
STAT,1917,45,50-100,1962,0.27392942224014843
SIM,1816,43,45-49,1859,5
STAT,1904,66,na,1970,3110.9353459285726
STAT,1784,82,na,1866,171.09615694084545
STAT,1964,16,45-49,1980,0.7262957692333278
SIM,1867,18,25-29,1885,8
STAT,1859,18,25-29,1877,6.011462806915993
STAT,1829,36,50-100,1865,1.4376849205615785
SIM,1976,20,15-19,1996,8
SIM,1879,35,35-39,1914,15
SIM,1980,21,20-24,2001,292
STAT,1862,54,50-100,1916,0.014304567862171448
SIM,1866,27,20-24,1893,12
STAT,1865,105,na,1970,0.34783869047924626
STAT,1846,77,na,1923,893.593126933983
SIM,1830,27,na,1857,2035
STAT,1868,16,25-29,1884,6.43474622207616
SIM,1888,26,45-49,1914,2
STAT,1895,88,na,1983,691.3765207355628
SIM,1877,37,25-29,1914,8
STAT,1963,25,40-44,1988,6.869353341039652
SIM,1932,50,na,1982,5314
SIM,1846,26,40-44,1872,3
STAT,1847,24,40-44,1871,1.9374821092200727
STAT,1830,25,40-44,1855,4.175882474249354
STAT,1845,43,15-19,1888,0.009355657250667502
STAT,1851,24,na,1875,1995.8151293338572
SIM,1881,29,na,1910,1933
STAT,1857,46,45-49,1903,0.21272156603177397
SIM,1873,29,20-24,1902,1
STAT,1849,29,20-24,1878,10.624289409710824
STAT,1954,27,40-44,1981,6.678494595256345
SIM,1857,29,20-24,1886,23
SIM,1866,49,30-34,1915,1
STAT,1912,41,50-100,1953,0.13163942472392776
STAT,1838,26,40-44,1864,3.3251899815093995
STAT,1940,16,50-100,1956,0.43926621429236073
STAT,1888,49,50-100,1937,0.18401428092272623
STAT,1861,44,na,1905,2187.489113357002
SIM,1942,0,na,1942,5281
SIM,1971,25,40-44,1996,8
STAT,1858,27,20-24,1885,10.811925293621092
STAT,1848,37,20-24,1885,0.8440453825663187
STAT,1808,50,35-39,1858,0.04271736272558865
SIM,1847,69,na,1916,1616
SIM,1850,27,na,1877,1813
SIM,1862,34,25-29,1896,25
STAT,1976,34,na,2010,5936.19070575207
STAT,1998,16,45-49,2014,0.8466915459074449
SIM,1957,29,25-29,1986,116
SIM,1901,39,35-39,1940,9
STAT,1938,26,45-49,1964,1.9770720461512068
SIM,1969,21,50-100,1990,2
STAT,1902,31,na,1933,3907.0874947928596
STAT,1914,22,40-44,1936,3.9662292372808943
SIM,1936,37,40-44,1973,3
STAT,1891,19,20-24,1910,25.150920179156742
STAT,1954,34,30-34,1988,22.88213648576903
STAT,1949,29,25-29,1978,88.6360092223852
SIM,1922,22,40-44,1944,12
STAT,1860,90,na,1950,73.33029359181253
STAT,1938,33,35-39,1971,10.602774988009712
STAT,1873,21,30-34,1894,21.054970375981473
SIM,1951,22,50-100,1973,1
STAT,1833,59,na,1892,1367.5646079159974
STAT,1869,37,25-29,1906,3.2178146933263774
SIM,1923,91,na,2014,893
SIM,1946,33,35-39,1979,22
SIM,1906,21,45-49,1927,2
SIM,1862,29,45-49,1891,4
STAT,1847,49,na,1896,1695.0046882886859
SIM,1856,37,20-24,1893,1
STAT,1895,98,na,1993,63.69047651162645
STAT,1838,33,30-34,1871,18.60223861027898
STAT,1895,34,15-19,1929,0.21209213582913322
SIM,1842,40,35-39,1882,3
SIM,1929,31,40-44,1960,2
STAT,1988,27,40-44,2015,7.726499586123742
STAT,1884,46,20-24,1930,0.013721499945537546
STAT,1990,15,45-49,2005,0.8260337699724579
STAT,1829,85,na,1914,200.82521475553483
SIM,1958,45,na,2003,6100
SIM,1991,19,20-24,2010,236
STAT,1896,27,40-44,1923,4.566096417262115
STAT,1949,66,na,2015,4393.381588809162
SIM,1950,5,na,1955,4822
STAT,1909,24,25-29,1933,98.56394923669006
SIM,1946,26,45-49,1972,6
STAT,1928,37,40-44,1965,2.1832766297012554
SIM,1846,33,30-34,1879,2
STAT,1890,38,45-49,1928,2.797113035853639
STAT,1882,16,na,1898,2853.8931536514488
SIM,1816,87,na,1903,49
SIM,1946,30,na,1976,4576
SIM,1888,51,na,1939,2483
STAT,1819,46,25-29,1865,0.11252616534882805
STAT,1983,19,20-24,2002,221.18504704130024
SIM,1886,39,50-100,1925,1
STAT,1848,22,35-39,1870,7.549572152834308
STAT,1963,32,30-34,1995,23.54595724987114
SIM,1845,34,40-44,1879,11
SIM,1864,25,45-49,1889,1
SIM,1859,40,na,1899,2306
STAT,1929,32,30-34,1961,23.09647527033078
STAT,1895,27,25-29,1922,63.54485495367627
SIM,1847,31,50-100,1878,3
SIM,1948,11,na,1959,4469
STAT,1880,35,na,1915,2909.2984506070893
SIM,1853,33,20-24,1886,2
STAT,1948,45,na,1993,5070.433702063392
STAT,1967,25,25-29,1992,95.37739247483564
STAT,1912,34,25-29,1946,10.415794619169942
SIM,1895,23,na,1918,3914
STAT,1884,39,30-34,1923,6.015735176407705
SIM,1896,24,30-34,1920,69
STAT,1879,19,50-100,1898,0.05871954010166461
SIM,1846,36,35-39,1882,12
STAT,1888,24,30-34,1912,24.012421923344935
SIM,1892,39,30-34,1931,17
SIM,1866,41,35-39,1907,2
SIM,1917,24,25-29,1941,5
STAT,1947,21,40-44,1968,4.386814382006212
STAT,1971,23,25-29,1994,135.41462019203757
STAT,1864,42,na,1906,2378.665407865547
STAT,1946,39,15-19,1985,0.025269560656118375
SIM,1843,39,35-39,1882,11
STAT,1887,36,30-34,1923,6.926041337034204
SIM,1962,34,30-34,1996,49
STAT,1839,31,50-100,1870,0.9035335120603875
SIM,1894,47,na,1941,3606
STAT,1942,17,20-24,1959,163.5349116021453
SIM,1945,35,40-44,1980,2
STAT,1861,36,25-29,1897,2.7756177788516583
SIM,1918,45,na,1963,3767
SIM,1934,23,15-19,1957,13
SIM,1955,21,40-44,1976,7
STAT,1906,47,na,1953,3769.2410421978807
STAT,1844,52,na,1896,1791.3707399122961
STAT,1978,11,na,1989,6187.639398948973
STAT,1969,20,30-34,1989,41.599809389494084
SIM,1833,79,na,1912,407
STAT,1845,33,20-24,1878,2.1433630209298533
STAT,1787,80,na,1867,201.0060813314725
STAT,1880,90,na,1970,310.19475262995905
SIM,1984,17,20-24,2001,226
STAT,1802,98,na,1900,1.550715991420298
STAT,1850,37,50-100,1887,1.2839094037837235
STAT,1867,105,na,1972,0.45553723030612386
STAT,1857,20,35-39,1877,6.142937361038058
STAT,1813,51,40-44,1864,0.03410546355284185
STAT,1834,33,45-49,1867,2.017395051535553
STAT,1885,15,15-19,1900,6.863055647001077
STAT,1979,33,25-29,2012,14.960888409631576
STAT,1840,15,40-44,1855,0.19222683135678612
SIM,1901,34,na,1935,4087
STAT,1921,14,na,1935,5193.420321929964
STAT,1952,33,50-100,1985,1.1648035623757722
STAT,1856,25,45-49,1881,1.0276863571127126
SIM,1863,45,na,1908,2297
SIM,1882,27,20-24,1909,15
STAT,1776,97,na,1873,1.359133089804505
STAT,1926,23,15-19,1949,7.438669436642317
SIM,1937,32,30-34,1969,8
STAT,1838,36,35-39,1874,7.471299249248123
SIM,1869,39,40-44,1908,1
STAT,1826,41,50-100,1867,0.8043926523790323
SIM,1842,33,45-49,1875,1
STAT,1835,46,25-29,1881,0.038377483161279084
STAT,1989,7,na,1996,6497.275737753705
SIM,1893,15,15-19,1908,16
SIM,1869,47,50-100,1916,1
STAT,1932,42,15-19,1974,0.002402560716397737
STAT,1813,50,na,1863,1359.830708620703
SIM,1920,34,25-29,1954,4
SIM,1909,21,15-19,1930,12
STAT,1791,64,na,1855,898.8522000000002
STAT,1831,46,40-44,1877,0.16066178834134723
SIM,1833,25,na,1858,2039
SIM,1878,37,40-44,1915,8
STAT,1937,42,30-34,1979,0.14890087235433178
STAT,1975,28,25-29,2003,100.5941104444201
SIM,1911,90,na,2001,969
SIM,1871,24,40-44,1895,1
SIM,1872,26,35-39,1898,28
SIM,1888,33,35-39,1921,16
STAT,1900,24,50-100,1924,0.6489294778506883
SIM,1878,31,na,1909,2853
SIM,1895,29,40-44,1924,7
STAT,1864,16,40-44,1880,0.21552104955537899
SIM,1803,59,na,1862,1391
SIM,1831,44,na,1875,1661
SIM,1854,28,50-100,1882,1
SIM,1931,26,15-19,1957,3
STAT,1868,36,50-100,1904,1.3678333501420683
STAT,1846,28,50-100,1874,0.7942685050926359
STAT,1865,68,na,1933,1591.2449734645943
STAT,1860,23,45-49,1883,0.6637977630256117
SIM,1895,36,30-34,1931,9
STAT,1955,22,30-34,1977,44.177457521340706
STAT,1887,29,40-44,1916,3.846541871452005
SIM,1839,23,45-49,1862,1
SIM,1937,25,40-44,1962,12
STAT,1923,26,15-19,1949,0.9382320488463746
SIM,1963,22,30-34,1985,103
SIM,1907,21,50-100,1928,1
SIM,1888,23,40-44,1911,8
SIM,1951,41,na,1992,6264
SIM,1816,77,na,1893,546
STAT,1969,17,na,1986,5306.285971959253
STAT,1864,48,45-49,1912,0.24012859414478968
STAT,1863,24,40-44,1887,2.114011747463746
STAT,1878,96,na,1974,68.93807231221871
STAT,1864,26,35-39,1890,9.976777621412046
STAT,1937,35,40-44,1972,1.7314444726321792
STAT,1871,23,20-24,1894,78.87576953377314
STAT,1853,38,40-44,1891,4.336707637238571
SIM,1818,58,na,1876,1789
SIM,1908,26,25-29,1934,133
SIM,1881,21,30-34,1902,41
SIM,1861,38,40-44,1899,2
STAT,1809,49,35-39,1858,0.3464033791795948
STAT,1996,15,50-100,2011,0.6286960749702605
SIM,1937,28,na,1965,4372
SIM,1824,31,50-100,1855,2
SIM,1876,36,50-100,1912,5
STAT,1929,25,40-44,1954,6.757894138559069
SIM,1844,41,na,1885,2343
STAT,1860,30,35-39,1890,9.494985167352818
SIM,1898,45,45-49,1943,1
STAT,1888,5,na,1893,3555.0916424132797
STAT,1880,19,45-49,1899,0.07947666665544893
STAT,1963,12,na,1975,5759.298204309006
STAT,1892,91,na,1983,390.2296130679151
SIM,1955,31,35-39,1986,3
SIM,1867,15,20-24,1882,28
STAT,1872,26,40-44,1898,3.4831785283538856
STAT,1862,28,25-29,1890,41.05370530155276
SIM,1959,17,40-44,1976,7
STAT,1878,35,25-29,1913,3.5022530523464006
STAT,1836,25,50-100,1861,0.7645103653071792
SIM,1958,44,50-100,2002,3
SIM,1924,27,20-24,1951,32
STAT,1862,61,na,1923,1819.9247477958932
STAT,1926,16,25-29,1942,61.45369794324062
SIM,1979,18,20-24,1997,407
SIM,1914,15,45-49,1929,1
STAT,1854,37,30-34,1891,4.341990941739927
SIM,1923,28,30-34,1951,126
STAT,1919,43,25-29,1962,0.08914370770842471
STAT,1906,15,45-49,1921,0.11044009688872465
STAT,1839,39,20-24,1878,0.7155219451224947
SIM,1904,26,40-44,1930,13
STAT,1922,23,30-34,1945,37.90291504636216
STAT,1959,0,na,1959,5979.368901447605
STAT,1967,32,15-19,1999,0.18882772295095338
SIM,1930,23,30-34,1953,54
SIM,1829,41,30-34,1870,3
SIM,1929,34,45-49,1963,2
STAT,1830,28,45-49,1858,1.3322985842251263
SIM,1903,15,na,1918,4108
STAT,1943,61,na,2004,4308.328738805314
STAT,1819,38,40-44,1857,11.515502159470365
STAT,1838,29,45-49,1867,1.20612130231939
STAT,1844,15,25-29,1859,6.096680431629213
STAT,1966,10,na,1976,5663.660781915013
SIM,1891,36,45-49,1927,2
STAT,1832,95,na,1927,9.058121795424317
STAT,1793,102,na,1895,0.055203879466275196
STAT,1859,15,20-24,1874,19.143317241808386
STAT,1890,16,35-39,1906,0.7756461800129991
STAT,1989,22,30-34,2011,47.66594740831858
STAT,1904,24,25-29,1928,94.2746329489946
SIM,1859,31,15-19,1890,1
SIM,1977,4,na,1981,6245
SIM,1952,45,50-100,1997,1
STAT,1868,46,20-24,1914,0.01334298797654309
STAT,1970,25,na,1995,5439.926820462869
STAT,1916,27,20-24,1943,21.78361060950905
STAT,1857,70,na,1927,1261.0980767311614
STAT,1936,44,na,1980,4232.806712253975
STAT,1975,16,20-24,1991,206.46727763592764
STAT,1882,15,45-49,1897,0.07397461480813003
SIM,1883,19,20-24,1902,1
SIM,1983,16,20-24,1999,1
SIM,1877,14,na,1891,3447
SIM,1801,78,na,1879,381
SIM,1827,43,20-24,1870,1
SIM,1901,36,30-34,1937,5
STAT,1867,25,20-24,1892,12.72626033760053
STAT,1871,33,15-19,1904,0.16281202644674064
SIM,1934,16,25-29,1950,171
SIM,1870,28,25-29,1898,68
SIM,1980,24,25-29,2004,6
STAT,1861,29,35-39,1890,9.191088335780252
SIM,1839,30,35-39,1869,18
STAT,1915,28,30-34,1943,45.967807030828126
SIM,1912,24,25-29,1936,6
STAT,1874,27,20-24,1901,13.860090716862361
SIM,1991,21,na,2012,6694
SIM,1879,42,50-100,1921,5
SIM,1820,34,20-24,1854,3
STAT,1897,15,na,1912,3915.4558833917636
STAT,1945,33,25-29,1978,11.86959714278336
STAT,1933,27,50-100,1960,1.5258885982757588
SIM,1859,24,25-29,1883,130
SIM,1957,26,20-24,1983,2
STAT,1965,46,45-49,2011,0.326515469809781
SIM,1823,45,45-49,1868,1
SIM,1884,39,25-29,1923,2
STAT,1870,52,25-29,1922,0.004008380861145365
STAT,1877,21,15-19,1898,3.9722531295920205
SIM,1933,12,na,1945,6642
SIM,1901,29,40-44,1930,9
STAT,1906,22,35-39,1928,9.82036016921671
STAT,1828,47,30-34,1875,0.0891372190825005
SIM,1967,22,15-19,1989,14
STAT,1835,39,35-39,1874,5.345563534614297
STAT,1954,3,na,1957,5612.120139241984
SIM,1941,27,50-100,1968,2
SIM,1956,1,na,1957,5526
STAT,1819,43,20-24,1862,0.32376280199231766
STAT,1959,15,25-29,1974,65.45247301296985
SIM,1850,19,25-29,1869,9
STAT,1827,48,40-44,1875,0.21394931873316164
STAT,1969,39,40-44,2008,2.2186419135145874
STAT,1836,38,25-29,1874,3.1841561085238914
STAT,1842,19,25-29,1861,5.53392951282838
SIM,1839,43,50-100,1882,2
STAT,1927,85,na,2012,1751.268961024685
STAT,1959,22,15-19,1981,8.062307754872627
SIM,1837,32,25-29,1869,5
STAT,1944,45,50-100,1989,0.2935662487786653
STAT,1945,40,15-19,1985,0.0020175159917442077
STAT,1907,105,na,2012,2.6183105611849538
STAT,1973,41,45-49,2014,0.25852224904500304
SIM,1902,30,na,1932,3961
SIM,1827,38,40-44,1865,11
STAT,1884,49,25-29,1933,0.06430544825588934
SIM,1967,15,25-29,1982,145
STAT,1940,59,na,1999,4211.8421557171005
SIM,1930,73,na,2003,4478
STAT,1893,40,50-100,1933,1.5566158655234372
STAT,1957,36,20-24,1993,0.4136078123992439
SIM,1929,41,35-39,1970,1
SIM,1979,35,40-44,2014,6
STAT,1847,94,na,1941,15.378374481981886
SIM,1953,33,25-29,1986,10
STAT,1829,32,25-29,1861,13.28605758790236
STAT,1816,88,na,1904,67.79747861262912
STAT,1984,1,na,1985,6453.891021692481
STAT,1851,47,20-24,1898,0.009471574513314159
STAT,1949,26,20-24,1975,24.616852034847227
STAT,1865,29,20-24,1894,12.128138812202364
SIM,1864,72,na,1936,1339
STAT,1979,28,45-49,2007,2.755685119341917
STAT,1882,18,15-19,1900,6.671988126190221
SIM,1904,33,30-34,1937,3
SIM,1933,66,na,1999,5326
STAT,1875,26,45-49,1901,1.3286865236701455
STAT,1917,88,na,2005,995.1937561903328
SIM,1934,38,35-39,1972,3
STAT,1855,22,25-29,1877,56.90540859512963
STAT,1837,45,30-34,1882,0.07465181816350946
STAT,1985,18,25-29,2003,71.10715361385903
SIM,1876,18,na,1894,2891
SIM,1874,92,na,1966,59
STAT,1936,32,20-24,1968,2.7357832938424176
STAT,1980,29,45-49,2009,2.776990782263541
SIM,1978,35,na,2013,5969
STAT,1857,53,50-100,1910,0.013356559153118954
STAT,1932,28,50-100,1960,1.5041772837055465
STAT,1887,25,40-44,1912,3.900515791064394
STAT,1932,51,na,1983,5679.389935731262
STAT,1937,38,45-49,1975,0.7863302147548796
STAT,1905,34,35-39,1939,9.629702607654442
SIM,1982,18,15-19,2000,137
SIM,1913,34,35-39,1947,27
STAT,1895,24,20-24,1919,102.87174340196627
SIM,1813,80,na,1893,265
STAT,1774,102,na,1876,0.0034991663034940022
STAT,1910,28,30-34,1938,43.55661329310497
STAT,1951,22,45-49,1973,1.5513643698160082
SIM,1894,3,na,1897,4210
SIM,1833,32,40-44,1865,2
STAT,1919,21,15-19,1940,6.745618477967363
SIM,1895,25,40-44,1920,8
STAT,1826,45,20-24,1871,0.008862593903049098
STAT,1926,38,35-39,1964,3.407248935657085
STAT,1851,18,20-24,1869,16.992049013622836
STAT,1957,42,50-100,1999,0.18576677885155352
STAT,1877,15,na,1892,3045.937480093643
SIM,1968,25,35-39,1993,53
SIM,1993,18,25-29,2011,101
STAT,1860,16,20-24,1876,19.130310671296407
STAT,1880,16,40-44,1896,0.22428405929305206
SIM,1854,24,25-29,1878,2
STAT,1825,32,40-44,1857,9.083004167814076
SIM,1863,22,25-29,1885,3
STAT,1884,24,45-49,1908,0.7901232228334234
STAT,1859,41,na,1900,2134.347519400652
SIM,1934,8,na,1942,6025
SIM,1921,34,na,1955,5212
SIM,1970,22,20-24,1992,168
STAT,1907,18,30-34,1925,2.699259336454272
STAT,1963,47,na,2010,5602.6409908652895
SIM,1915,18,30-34,1933,5
STAT,1846,31,15-19,1877,0.17579148347970566
SIM,1957,50,na,2007,6114
STAT,1815,45,45-49,1860,0.49636481969563273
SIM,1891,30,50-100,1921,2
STAT,1963,35,35-39,1998,3.6598670313180754
SIM,1895,87,na,1982,404
SIM,1832,40,na,1872,2146
STAT,1858,37,15-19,1895,0.050555165712879484
SIM,1822,32,30-34,1854,30
STAT,1953,46,na,1999,5348.007801350112
STAT,1867,28,25-29,1895,45.41885237590492
STAT,1846,23,na,1869,2707.694852455013
SIM,1849,19,na,1868,2994
STAT,1951,11,na,1962,5399.019503435678
SIM,1973,39,20-24,2012,1
STAT,1835,24,15-19,1859,2.7198150514414405
STAT,1885,37,25-29,1922,3.314270534341219
STAT,1946,68,na,2014,4023.415705048782
STAT,1940,18,15-19,1958,53.17787041794332
STAT,1817,47,20-24,1864,0.03425816987665831
STAT,1948,38,20-24,1986,0.358309464065362
STAT,1869,34,20-24,1903,2.9950966548330635
SIM,1828,34,25-29,1862,21
STAT,1879,30,15-19,1909,0.1729833125048288
SIM,1845,38,40-44,1883,13
STAT,1976,19,40-44,1995,2.1550964809575226
SIM,1897,31,50-100,1928,7
SIM,1860,35,20-24,1895,2
STAT,1925,31,50-100,1956,1.1333518391522923
STAT,1990,16,40-44,2006,2.3123168945815387
SIM,1891,71,na,1962,2008
SIM,1901,17,25-29,1918,18
STAT,1914,25,45-49,1939,2.0244991914705697
SIM,1904,86,na,1990,1169
SIM,1854,31,15-19,1885,2
STAT,1881,37,40-44,1918,4.87272577380888
STAT,1927,16,40-44,1943,2.0115292351075036
STAT,2000,12,na,2012,6741.691630900589
SIM,1912,21,20-24,1933,113
SIM,1887,30,15-19,1917,3
STAT,1969,23,35-39,1992,13.61461250830933
SIM,1902,74,na,1976,2480
SIM,1906,67,na,1973,2896
STAT,1990,23,30-34,2013,47.64216134538263
SIM,1927,21,15-19,1948,14
STAT,1937,45,35-39,1982,0.15100330014968766
SIM,1833,42,50-100,1875,4
STAT,1952,28,35-39,1980,20.843034079585088
SIM,1833,28,20-24,1861,11
STAT,1869,23,30-34,1892,19.845642546625605
SIM,1845,45,30-34,1890,1
SIM,1869,35,40-44,1904,2
SIM,1893,37,25-29,1930,9
STAT,1965,39,20-24,2004,0.39045267018390223
STAT,1967,48,20-24,2015,0.01652452417459607
STAT,1940,22,35-39,1962,11.07309737954869
STAT,1841,35,45-49,1876,2.1320436729497936
SIM,1843,24,15-19,1867,3
SIM,1886,27,40-44,1913,3
STAT,1930,26,40-44,1956,6.843687322626224
SIM,1950,14,na,1964,4817
STAT,1985,22,45-49,2007,1.8529488524775668
SIM,1968,45,25-29,2013,1
SIM,1939,31,35-39,1970,4
SIM,1896,18,na,1914,3953
STAT,1925,32,45-49,1957,2.1557734071800896
SIM,1945,38,45-49,1983,5
STAT,1939,29,30-34,1968,45.43200712748428
SIM,1960,28,35-39,1988,50
STAT,1848,42,50-100,1890,1.1211274083681093
STAT,1977,22,15-19,1999,8.327845909781136
STAT,1988,26,45-49,2014,2.865109567774886
SIM,1861,20,na,1881,1751
SIM,1878,44,30-34,1922,2
STAT,1878,27,40-44,1905,3.609521375733762
STAT,1896,84,na,1980,1152.233586416704
STAT,1852,35,20-24,1887,0.746043814153616
SIM,1933,32,45-49,1965,1
SIM,1815,61,na,1876,1445
SIM,1935,47,na,1982,6166
SIM,1943,34,50-100,1977,3
STAT,1937,29,na,1966,4212.361184138034
STAT,1801,58,na,1859,1153.8877005434888
SIM,1928,31,25-29,1959,28
SIM,1818,44,25-29,1862,2
SIM,1940,48,na,1988,4886
SIM,1857,90,na,1947,9
SIM,1831,35,50-100,1866,5
SIM,1896,49,45-49,1945,1
STAT,1925,25,20-24,1950,25.04199268897487
SIM,1870,25,20-24,1895,23
SIM,1903,38,40-44,1941,3
STAT,1956,45,40-44,2001,0.2516083936567266
STAT,1940,15,45-49,1955,0.5858347444092498
SIM,1868,48,50-100,1916,1
STAT,1848,15,45-49,1863,0.08706279874911846
STAT,1862,25,20-24,1887,11.634228661580481
SIM,1950,39,30-34,1989,5
STAT,1840,22,30-34,1862,18.171408264255735
STAT,1868,49,25-29,1917,0.06253156187808677
SIM,1993,12,na,2005,6956
STAT,1942,39,30-34,1981,2.260110688301422
STAT,1888,49,45-49,1937,0.1768215405907396
STAT,1897,47,45-49,1944,0.2044698984593032
SIM,1933,25,20-24,1958,31
SIM,1983,28,25-29,2011,116
STAT,1904,21,20-24,1925,114.54789683434733
SIM,1823,38,20-24,1861,1
SIM,1878,85,na,1963,477
STAT,1905,27,45-49,1932,1.854564089489428
SIM,1913,27,45-49,1940,2
SIM,1905,27,na,1932,4045
STAT,1934,32,na,1966,5962.201738871396
STAT,1826,38,30-34,1864,4.177920865606781
SIM,1909,26,40-44,1935,2
STAT,1833,38,50-100,1871,1.0772385365338264
STAT,1951,18,25-29,1969,59.533809801644274
STAT,1836,35,20-24,1871,0.8794698927423878
STAT,1909,31,15-19,1940,0.14225613098013268
SIM,1834,38,30-34,1872,10
SIM,1866,34,45-49,1900,2
SIM,1893,52,na,1945,3026
STAT,1857,39,20-24,1896,0.6858740116501046
SIM,1829,44,35-39,1873,7
STAT,1859,47,25-29,1906,0.05270508624258877
STAT,1962,25,25-29,1987,97.83273499711166
STAT,1931,17,45-49,1948,0.7547386911804547
STAT,1903,71,na,1974,2731.6760204713937
STAT,1919,15,50-100,1934,0.09628417309687819
SIM,1820,37,25-29,1857,6
SIM,1840,37,45-49,1877,5
SIM,1919,22,35-39,1941,1
STAT,1808,90,na,1898,40.19994830030158
STAT,1930,74,na,2004,3854.386256290227
STAT,1856,28,15-19,1884,0.4109621193689333
SIM,1858,85,na,1943,345
SIM,1881,20,na,1901,1958
STAT,1831,24,30-34,1855,23.025678485928186
STAT,1918,25,na,1943,4631.10200094383
STAT,1821,58,na,1879,1306.1558475411298
STAT,1846,24,25-29,1870,71.97452055319476
STAT,1965,19,30-34,1984,17.549376103676703
SIM,1973,19,30-34,1992,24
SIM,1899,29,25-29,1928,88
SIM,1889,44,40-44,1933,3
STAT,1986,28,35-39,2014,24.782992630237974
STAT,1859,82,na,1941,428.9314268391743
STAT,1979,25,40-44,2004,7.444800222587561
STAT,1902,22,15-19,1924,5.379480997201137
STAT,1880,89,na,1969,366.7775207571673
STAT,1832,37,45-49,1869,1.7516621064188962
SIM,1864,28,15-19,1892,1
STAT,1896,34,30-34,1930,26.385749494067316
SIM,1834,30,35-39,1864,15
SIM,1958,29,40-44,1987,10
STAT,1902,15,25-29,1917,9.283258052301344
STAT,1830,83,na,1913,249.03664047604428
SIM,1849,38,25-29,1887,1
STAT,1921,28,40-44,1949,5.97167431124651
SIM,1943,21,15-19,1964,7
SIM,1970,25,25-29,1995,203
STAT,1901,109,na,2010,0.12826836205882278
SIM,1884,36,20-24,1920,1
STAT,1851,22,40-44,1873,1.9733471632465294
SIM,1870,54,50-100,1924,1
STAT,1857,49,15-19,1906,3.5201738220841725E-4
STAT,1914,18,20-24,1932,32.295643539010236
STAT,1898,28,20-24,1926,18.232907240084728
SIM,1818,37,35-39,1855,6
STAT,1872,21,15-19,1893,3.8344580423817924
STAT,1884,31,35-39,1915,11.594281921006404
SIM,1892,31,35-39,1923,19
STAT,1880,99,na,1979,27.015780351612708
STAT,1976,39,30-34,2015,2.8888751038487586
STAT,1918,15,na,1933,4888.964958207978
SIM,1978,32,20-24,2010,1
SIM,1862,60,na,1922,2363
STAT,1822,48,40-44,1870,0.31899765343244685
STAT,1916,49,30-34,1965,0.1049123982859889
STAT,1931,24,35-39,1955,14.008337776640527
STAT,1876,36,20-24,1912,0.9240325379355853
SIM,1868,25,30-34,1893,4
SIM,1913,31,30-34,1944,7
STAT,1925,35,15-19,1960,0.026636262251816832
SIM,1771,84,na,1855,48
SIM,1983,29,20-24,2012,4
SIM,1814,44,40-44,1858,2
STAT,1826,48,25-29,1874,0.040908887386986496
STAT,1957,39,25-29,1996,1.5401746178107092
STAT,1988,12,na,2000,6483.573137644749
SIM,1883,23,40-44,1906,5
SIM,1966,27,25-29,1993,185
STAT,1834,76,na,1910,864.601136080196
STAT,1949,48,30-34,1997,0.12410685877670152
STAT,1884,27,15-19,1911,0.5173211574142738
SIM,1859,71,na,1930,857
SIM,1814,65,na,1879,814
SIM,1907,38,25-29,1945,3
SIM,1972,20,30-34,1992,105
STAT,1865,49,50-100,1914,0.25039299138148435
SIM,1833,35,45-49,1868,3
STAT,1850,38,na,1888,2438.307530284495
STAT,1825,35,45-49,1860,3.4897913930439497
STAT,1936,35,25-29,1971,1.1181110687061664
STAT,1929,62,na,1991,5002.556325346611
SIM,1935,49,40-44,1984,1
STAT,1828,90,na,1918,52.32643838925361
STAT,1830,29,40-44,1859,3.4427448618736296
STAT,1882,0,na,1882,4015.3111098497857
STAT,1887,28,45-49,1915,1.4309259281797764
STAT,1935,21,15-19,1956,8.372799506162016
SIM,1955,27,15-19,1982,1
SIM,1822,35,35-39,1857,7
SIM,1873,49,50-100,1922,1
SIM,1812,49,35-39,1861,1
SIM,1828,31,20-24,1859,3
SIM,1879,25,40-44,1904,4
STAT,1967,43,50-100,2010,0.17572164689957573
STAT,1975,29,20-24,2004,27.8835326158832
STAT,1993,20,50-100,2013,1.0968971233322613
STAT,1813,91,na,1904,26.532699297485987
STAT,1928,44,30-34,1972,0.18745701027099368
STAT,1916,20,50-100,1936,0.8005325863803981
STAT,1938,30,30-34,1968,18.311897625969337
STAT,1894,39,25-29,1933,4.228412127408173
SIM,1924,20,50-100,1944,2
STAT,1847,34,35-39,1881,8.15462375602601
SIM,1855,27,45-49,1882,1
STAT,1883,39,15-19,1922,0.06276555264634047
SIM,1968,22,30-34,1990,1
SIM,1844,34,25-29,1878,23
STAT,1913,22,25-29,1935,103.34935973003186
STAT,1869,26,35-39,1895,10.820729510807794
SIM,1854,21,20-24,1875,2
STAT,1814,76,na,1890,590.7237010089215
SIM,1988,21,25-29,2009,158
STAT,1923,17,50-100,1940,0.5075187769937592
STAT,1841,28,20-24,1869,12.861941038906165
STAT,1837,48,35-39,1885,0.10389649322867427
STAT,1985,15,20-24,2000,222.65008079478795
STAT,1842,16,20-24,1858,17.622627247398373
SIM,1921,22,25-29,1943,7
STAT,1949,30,40-44,1979,5.359904020094172
STAT,1920,17,35-39,1937,5.430724636823521
STAT,1836,34,25-29,1870,11.54446043236803
SIM,1844,35,20-24,1879,2
STAT,1897,69,na,1966,2585.5359162455034
SIM,1958,36,30-34,1994,3
SIM,1972,29,45-49,2001,1
STAT,1876,74,na,1950,1323.9543007059274
STAT,1938,25,na,1963,4288.881274485148
SIM,1974,34,45-49,2008,4
STAT,1846,21,20-24,1867,88.53663176996281
STAT,1852,38,25-29,1890,2.7010816261785666
STAT,1937,39,na,1976,4334.660534220608
SIM,1936,44,30-34,1980,1
SIM,1925,37,30-34,1962,6
STAT,1965,24,na,1989,5275.161113295927
SIM,1946,30,30-34,1976,31
STAT,1958,34,15-19,1992,0.19828690193961415
STAT,1968,20,15-19,1988,7.703579915515181
STAT,1990,19,45-49,2009,0.825042973023461
STAT,1897,15,40-44,1912,0.28355524132238574
STAT,1951,15,20-24,1966,186.41173058816068
SIM,1877,99,na,1976,117
STAT,1941,29,20-24,1970,21.775865890124344
SIM,1793,65,na,1858,1218
STAT,1836,27,35-39,1863,11.366645483716626
STAT,1861,75,na,1936,987.6733527343216
SIM,1860,38,25-29,1898,4
STAT,1987,16,35-39,2003,6.91507903111416
SIM,1995,16,35-39,2011,20
STAT,1852,28,30-34,1880,27.4545417823894
STAT,1978,37,40-44,2015,2.429022458869685
STAT,1923,26,na,1949,4978.742910031266
SIM,1844,27,35-39,1871,21
SIM,1855,34,35-39,1889,4
STAT,1828,36,40-44,1864,4.603426086497679
STAT,1862,24,25-29,1886,56.25744821329275
SIM,1860,28,30-34,1888,3
SIM,1865,67,na,1932,2126
STAT,1905,31,30-34,1936,16.814032949743936
STAT,1917,37,30-34,1954,2.1847200917056906
SIM,1888,29,15-19,1917,1
STAT,1958,27,25-29,1985,100.1973461276123
SIM,1836,36,40-44,1872,7
STAT,1830,43,50-100,1873,0.9998948634475329
SIM,1863,46,50-100,1909,1
SIM,1846,53,na,1899,1394
STAT,1946,21,25-29,1967,118.66139400910004
STAT,1897,22,30-34,1919,27.4867365069463
STAT,1927,49,40-44,1976,0.22700487992327908
STAT,1975,20,40-44,1995,5.1395474834086885
SIM,1894,92,na,1986,625
STAT,1966,34,45-49,2000,2.309039280469437
SIM,1870,24,25-29,1894,77
SIM,1829,37,45-49,1866,1
SIM,1947,29,30-34,1976,8
STAT,1860,19,25-29,1879,6.007378430426249
STAT,1968,25,50-100,1993,1.442166220166118
STAT,1870,38,na,1908,2667.1571673482345
SIM,1850,68,na,1918,768
STAT,1855,46,50-100,1901,0.209573277778616
SIM,1935,23,30-34,1958,52
SIM,1954,21,25-29,1975,133
STAT,1951,25,15-19,1976,0.9751886980182004
STAT,1891,26,45-49,1917,1.5890801820400957
STAT,1881,23,50-100,1904,0.45252074843071194
STAT,1927,23,30-34,1950,40.730442874608684
STAT,1875,48,20-24,1923,0.014131325515597185
STAT,1956,48,45-49,2004,0.34425884481955943
STAT,1973,17,15-19,1990,67.73662949249378
STAT,1844,42,na,1886,1979.891918702744
SIM,1894,37,na,1931,3723
SIM,1881,74,na,1955,780
STAT,1884,17,20-24,1901,20.214443563007823
STAT,1877,70,na,1947,1684.3133067605859
STAT,1848,89,na,1937,111.62227761102532
STAT,1855,5,na,1860,2544.8639709542467
STAT,1915,39,20-24,1954,0.304283312800251
SIM,1887,23,25-29,1910,148
SIM,1862,26,40-44,1888,1
SIM,1832,39,na,1871,2123
STAT,1878,55,na,1933,2491.502956769808
STAT,1905,24,40-44,1929,3.4588430537969352
STAT,1873,17,45-49,1890,0.076981909196218
STAT,1858,41,35-39,1899,1.637626788511423
STAT,1827,94,na,1921,16.231101257264914
SIM,1801,88,na,1889,41
SIM,1831,54,na,1885,1426
SIM,1965,13,na,1978,5617
SIM,1884,7,na,1891,3025
STAT,1830,36,30-34,1866,5.47415810367495
STAT,1977,34,20-24,2011,3.871870969031535
STAT,1914,28,15-19,1942,0.8188029467147516
SIM,1908,30,45-49,1938,4
SIM,1913,24,40-44,1937,6
SIM,1902,27,35-39,1929,2
SIM,1934,62,na,1996,5238
STAT,1960,40,20-24,2000,0.027662966444986427
SIM,1935,16,40-44,1951,1
STAT,1863,45,25-29,1908,0.05870422356189999
STAT,1955,28,50-100,1983,1.5307441864693774
STAT,1888,46,40-44,1934,0.23290495928488822
STAT,1904,12,na,1916,4279.783692177361
STAT,1878,112,na,1990,0.0038799259058334284
STAT,1851,25,45-49,1876,1.0458664742631507
STAT,1931,21,30-34,1952,43.158476647153904
STAT,1879,23,25-29,1902,68.7688883019526
SIM,1877,34,20-24,1911,5
STAT,1837,38,40-44,1875,3.819505470328916
STAT,1985,25,15-19,2010,1.164764908940266
STAT,1925,28,25-29,1953,89.37256813602842
STAT,1863,56,na,1919,2058.215411034845
SIM,1902,20,na,1922,3690
STAT,1862,17,35-39,1879,0.6120551121417613
STAT,1930,29,45-49,1959,2.5329557174343944
SIM,1880,34,na,1914,3294
SIM,1892,17,20-24,1909,29
STAT,1954,46,50-100,2000,0.3364735182225036
STAT,1935,58,na,1993,5681.061193531104
STAT,1953,39,40-44,1992,2.148505933449487
SIM,1847,38,na,1885,2533
SIM,1933,31,50-100,1964,2
SIM,1962,46,50-100,2008,1
SIM,1878,6,na,1884,3252
SIM,1880,21,15-19,1901,7
STAT,1840,25,35-39,1865,9.791227521372033
STAT,1876,30,na,1906,2869.7017555948614
STAT,1887,102,na,1989,9.023050260705169
SIM,1933,28,25-29,1961,203
STAT,1871,26,25-29,1897,48.734047003794416
STAT,1861,6,na,1867,2751.041521095326
STAT,1866,3,na,1869,3408.7744665812584
SIM,1923,15,na,1938,5645
SIM,1870,17,35-39,1887,2
STAT,1919,11,na,1930,5059.494576329913
STAT,1865,36,45-49,1901,2.085720737757445
SIM,1840,34,40-44,1874,5
SIM,1965,21,35-39,1986,27
SIM,1956,31,50-100,1987,5
SIM,1971,28,45-49,1999,8
SIM,1863,47,40-44,1910,1
STAT,1847,27,45-49,1874,1.0268581323441355
SIM,1984,16,25-29,2000,86
STAT,1862,71,na,1933,1300.0055803703194
STAT,1916,44,na,1960,4378.066926373147
STAT,1938,23,40-44,1961,3.840972292626904
STAT,1863,35,30-34,1898,5.429207860128827
STAT,1947,50,na,1997,4922.754971187258
SIM,1895,33,na,1928,3561
STAT,1962,22,20-24,1984,164.96449031055533
SIM,1928,7,na,1935,6082
SIM,1948,21,na,1969,4452
SIM,1968,15,40-44,1983,2
STAT,1858,34,45-49,1892,1.5564975150716844
STAT,1886,15,30-34,1901,1.9492496582748813
STAT,1963,28,45-49,1991,2.5426840499993024
STAT,1886,48,30-34,1934,0.11635510933763268
SIM,1834,20,40-44,1854,4
STAT,1947,27,15-19,1974,0.9216755593439535
SIM,1926,88,na,2014,1558
STAT,1979,20,25-29,1999,147.36000840637925
SIM,1844,72,na,1916,1170
STAT,1948,31,50-100,1979,1.1136688132109414
STAT,1893,22,na,1915,3449.940247285819
SIM,1985,9,na,1994,6448
STAT,1964,20,30-34,1984,41.94293432321353
STAT,1969,24,30-34,1993,41.54284690942106
STAT,1832,34,40-44,1866,3.8502562760022285
STAT,1855,47,40-44,1902,0.14499418026034708
STAT,1812,95,na,1907,5.837184723639876
SIM,1889,21,35-39,1910,15
STAT,1863,28,40-44,1891,3.012213525436904
SIM,1974,27,20-24,2001,32
SIM,1900,29,25-29,1929,7
SIM,1873,36,45-49,1909,1
SIM,1898,30,25-29,1928,24
STAT,1873,24,35-39,1897,6.834002490756554
STAT,1911,7,na,1918,4605.074602869037
STAT,1946,10,na,1956,5029.330874389783
SIM,1999,1,na,2000,6976
STAT,1854,26,40-44,1880,2.831777653738197
STAT,1896,37,35-39,1933,10.781155886485967
STAT,1840,18,45-49,1858,0.06744646582196238
STAT,1871,52,40-44,1923,0.012022726258775264
SIM,1879,32,30-34,1911,24
STAT,1877,39,40-44,1916,5.202062284063633
SIM,1864,102,na,1966,3
SIM,1934,20,45-49,1954,4
STAT,1957,21,35-39,1978,14.37903502000455
STAT,1879,20,20-24,1899,83.53632526899803
STAT,1962,8,na,1970,5811.3722993733245
SIM,1943,47,50-100,1990,2
STAT,1881,27,45-49,1908,1.2359107171699137
STAT,1820,47,25-29,1867,0.0597659189127369
STAT,1883,64,na,1947,1962.7670740567632
STAT,1959,49,30-34,2008,0.13915510742328663
SIM,1973,33,45-49,2006,5
SIM,1870,58,na,1928,2534
SIM,1856,11,na,1867,2594
STAT,1871,31,15-19,1902,0.1641701775299971
STAT,1959,17,25-29,1976,65.41778778394607
SIM,1844,39,30-34,1883,3
STAT,1856,30,35-39,1886,9.214931171506084
SIM,1972,15,40-44,1987,2
STAT,1963,7,na,1970,5762.927936751956
STAT,1946,9,na,1955,5029.884161647565
STAT,1824,52,35-39,1876,0.01129167405366277
STAT,1995,16,40-44,2011,2.33725792627288
STAT,1831,33,40-44,1864,4.3706007550942525
SIM,1817,38,50-100,1855,1
STAT,1903,18,na,1921,4140.656763992918
SIM,1885,38,35-39,1923,24
STAT,1845,40,30-34,1885,0.8093766909094556
STAT,1794,81,na,1875,274.156697380739
SIM,1845,59,na,1904,1827
STAT,1858,65,na,1923,1521.4495899738988
SIM,1824,33,45-49,1857,2
STAT,1875,69,na,1944,1750.1855173800502
STAT,1826,35,25-29,1861,2.425245864414057
SIM,1915,71,na,1986,3329
SIM,1830,24,30-34,1854,26
STAT,1923,48,25-29,1971,0.07138766507883326
STAT,1840,20,30-34,1860,18.435187173930107
SIM,1816,39,25-29,1855,5
SIM,1968,15,20-24,1983,168
STAT,1845,48,40-44,1893,0.1139144078977107
STAT,1877,38,35-39,1915,8.448539034956427
SIM,1920,58,na,1978,3803
STAT,1850,42,35-39,1892,1.861840019511587
SIM,1864,30,35-39,1894,14
SIM,1909,16,25-29,1925,21
STAT,1879,48,40-44,1927,0.2037070750853408
STAT,1864,18,na,1882,2676.360575934807
STAT,1960,6,na,1966,5908.860396807868
SIM,1840,36,na,1876,2048
STAT,1816,44,50-100,1860,2.2287463770500375
STAT,1988,21,50-100,2009,1.0899980644642855
STAT,1944,23,15-19,1967,6.630979589202511
STAT,1885,46,15-19,1931,4.617506008472032E-4
STAT,1938,25,40-44,1963,5.336321230015232
STAT,1827,44,30-34,1871,1.4778320137257475
STAT,1837,95,na,1932,9.627673209339548
SIM,1971,38,40-44,2009,2
SIM,1891,43,50-100,1934,2
SIM,1834,35,25-29,1869,5
STAT,1867,26,50-100,1893,0.691626509019088
SIM,1853,40,30-34,1893,2
SIM,1921,81,na,2002,2405
STAT,1939,41,35-39,1980,0.24218810832475635
STAT,1843,16,15-19,1859,7.654674659718243
SIM,1967,17,25-29,1984,87
SIM,1977,26,50-100,2003,3
STAT,1964,15,40-44,1979,2.0341371826766115
SIM,1835,44,30-34,1879,3
STAT,1889,6,na,1895,3716.259214086233
STAT,1963,38,40-44,2001,2.2589280078970555
STAT,1813,51,20-24,1864,0.002390569968102251
SIM,1840,28,na,1868,2115
STAT,1895,34,35-39,1929,15.082551392482904
SIM,1968,26,30-34,1994,73
STAT,1889,110,na,1999,0.04205838915946382
STAT,1993,15,na,2008,6114.740033300672
STAT,1845,39,na,1884,1633.7787129252963
STAT,1895,23,25-29,1918,85.72817723917788
SIM,1855,43,45-49,1898,3
STAT,1877,16,50-100,1893,0.05895649549996038
STAT,1792,101,na,1893,0.1602359977762508
STAT,1983,26,45-49,2009,2.833872625922052
STAT,1847,43,45-49,1890,1.1432774236202503
SIM,1972,16,na,1988,5087
STAT,1866,106,na,1972,0.20911546605500478
STAT,1985,14,na,1999,6445.233594130435
SIM,1870,29,30-34,1899,69
STAT,1896,32,30-34,1928,26.61360455209138
SIM,1881,10,na,1891,2169
STAT,1874,31,40-44,1905,5.144540003913367
SIM,1840,26,50-100,1866,2
SIM,1841,25,45-49,1866,3
STAT,1845,90,na,1935,53.12710301039138
STAT,1880,40,25-29,1920,0.7934390737625612
SIM,1838,40,35-39,1878,5
SIM,1979,16,35-39,1995,7
STAT,1866,37,20-24,1903,0.8245476615919467
SIM,1947,41,35-39,1988,1
SIM,1886,41,na,1927,1974
SIM,1863,37,45-49,1900,2
STAT,1973,41,25-29,2014,0.11092304149212127
STAT,1837,18,40-44,1855,0.24969923737919544
STAT,1823,36,40-44,1859,8.947915184009355
SIM,1870,44,25-29,1914,1
STAT,1949,15,45-49,1964,0.6708247449033454
SIM,1997,8,na,2005,6607
STAT,1862,29,30-34,1891,24.350180215198996
STAT,1848,44,45-49,1892,1.5687566496139547
STAT,1882,50,30-34,1932,0.006806225771705973
STAT,2005,10,na,2015,6975.374249865604
STAT,1862,44,25-29,1906,0.6169755853285059
SIM,1853,54,na,1907,1994
SIM,1860,42,45-49,1902,4
SIM,1946,34,50-100,1980,2
STAT,1807,73,na,1880,711.0615341225167
STAT,1821,80,na,1901,378.3283482728722
SIM,1892,20,45-49,1912,2
STAT,1911,13,na,1924,4557.616214707267
STAT,1812,50,20-24,1862,0.0017015064756641654
SIM,1851,16,15-19,1867,14
SIM,1980,11,na,1991,6008
SIM,1849,41,na,1890,2592
STAT,1996,0,na,1996,6643.215561091897
STAT,1938,8,na,1946,4542.63529699617
STAT,1834,29,25-29,1863,49.89593120289319
STAT,1914,26,50-100,1940,1.1625151356187282
SIM,1986,25,25-29,2011,214
SIM,1843,22,15-19,1865,6
STAT,1911,44,50-100,1955,0.1279203820447926
STAT,1894,19,25-29,1913,8.361729788418101
SIM,1870,66,na,1936,2305
STAT,1853,43,50-100,1896,1.04422542257727
SIM,1906,20,40-44,1926,10
SIM,1915,30,35-39,1945,14
SIM,1856,41,40-44,1897,3
SIM,1971,30,30-34,2001,46
STAT,1884,20,45-49,1904,0.7998447148857
STAT,1899,28,15-19,1927,0.7148106499821334
STAT,1937,39,50-100,1976,0.4837403568026221
STAT,1850,93,na,1943,30.08596579443851
STAT,1879,18,45-49,1897,0.07850861883735553
SIM,1831,40,25-29,1871,2
STAT,1844,28,25-29,1872,43.002386067002924
SIM,1852,28,25-29,1880,3
SIM,1877,41,30-34,1918,2
STAT,1894,48,na,1942,3296.401110685139
STAT,1838,34,35-39,1872,10.678298261770466
STAT,1890,34,na,1924,3336.175756012048
STAT,1869,41,30-34,1910,1.290692543681103
STAT,1835,22,15-19,1857,2.8402878279672983
SIM,1900,46,30-34,1946,1
STAT,1833,25,45-49,1858,1.0685518949023027
STAT,1878,36,30-34,1914,6.452813355463646
SIM,1935,73,na,2008,4497
STAT,1819,50,30-34,1869,0.011471469970147094
SIM,1981,27,45-49,2008,5
STAT,1903,26,na,1929,3936.374899645879
SIM,1877,49,40-44,1926,1
SIM,1872,24,35-39,1896,1
SIM,1897,37,45-49,1934,11
SIM,1888,31,35-39,1919,17
STAT,1928,18,35-39,1946,6.085643651920974
SIM,1946,65,na,2011,3974
STAT,1823,40,25-29,1863,0.6996901634617773
STAT,1879,51,40-44,1930,0.012746714175521126
STAT,1815,60,na,1875,1332.1822647537995
STAT,1869,29,40-44,1898,3.3239392772371565
STAT,1887,48,45-49,1935,0.3013890781331565
STAT,1912,86,na,1998,1195.0968942168956
STAT,1984,22,15-19,2006,8.75386704924592
STAT,1973,27,45-49,2000,2.589682689018857
STAT,1830,30,50-100,1860,1.031211624762469
STAT,1864,24,35-39,1888,6.022395251728997
SIM,1882,59,na,1941,2734
STAT,1823,51,35-39,1874,0.008357787463266483
STAT,1933,56,na,1989,5615.553816226715
SIM,1982,20,35-39,2002,1
SIM,1977,26,40-44,2003,10
STAT,1899,79,na,1978,1816.2703265288533
SIM,1795,75,na,1870,597
SIM,1936,18,35-39,1954,4
SIM,1873,23,na,1896,3088
STAT,1828,45,30-34,1873,0.09150888834798657
SIM,1959,20,20-24,1979,161
SIM,1964,49,50-100,2013,3
STAT,1870,30,15-19,1900,0.16332300009546696
STAT,1949,31,na,1980,5177.254210167391
STAT,1968,36,20-24,2004,0.3918197482429548
STAT,1869,49,40-44,1918,0.18733962332570075
SIM,1991,23,40-44,2014,6
SIM,1787,88,na,1875,226
SIM,1826,35,20-24,1861,1
SIM,1861,41,na,1902,1818
SIM,1862,35,30-34,1897,15
SIM,1837,24,40-44,1861,4
SIM,1894,25,25-29,1919,3
SIM,1846,34,35-39,1880,13
SIM,1887,15,40-44,1902,1
STAT,1937,30,na,1967,4325.418500051182
SIM,1802,62,na,1864,920
SIM,1878,42,30-34,1920,2
STAT,1868,17,30-34,1885,1.7992280352959322
STAT,1948,22,na,1970,4838.762415246796
SIM,1876,17,30-34,1893,6
STAT,1848,36,15-19,1884,0.062128545332663654
STAT,1862,9,na,1871,2717.5838897769936
STAT,1918,33,15-19,1951,0.15689105543588766
STAT,1854,35,30-34,1889,4.408428244684102
STAT,1848,87,na,1935,187.19696411477423
STAT,1907,30,35-39,1937,9.95302355102059
STAT,1889,37,45-49,1926,2.835872926489626
SIM,1821,37,40-44,1858,10
STAT,1978,25,25-29,2003,104.20354739573946
SIM,1842,29,25-29,1871,92
SIM,1877,30,20-24,1907,1
STAT,1870,18,25-29,1888,6.470254240564413
STAT,1886,25,25-29,1911,51.843343340622
SIM,1913,94,na,2007,733
STAT,1821,40,15-19,1861,0.027866041966190386
STAT,1849,37,15-19,1886,0.04453616955901844
SIM,1847,46,45-49,1893,2
STAT,1913,38,15-19,1951,0.021773364788483268
SIM,1861,34,30-34,1895,6
STAT,1853,34,30-34,1887,17.533195675529395
STAT,1879,52,25-29,1931,0.004245470624079773
SIM,1924,32,na,1956,4941
STAT,1870,38,25-29,1908,3.259484637279258
STAT,1877,51,50-100,1928,0.018216764222194377
SIM,1984,8,na,1992,6303
STAT,1831,36,45-49,1867,1.9918780354888803
STAT,1990,21,30-34,2011,47.67362074341599
SIM,1842,70,na,1912,1234
STAT,1851,21,50-100,1872,0.38896642015207794
SIM,1832,84,na,1916,300
STAT,1910,45,35-39,1955,0.13961995887690853
STAT,1786,86,na,1872,118.75985820387706
STAT,1839,46,45-49,1885,0.1931503836971581
SIM,1898,18,20-24,1916,49
STAT,1810,85,na,1895,156.08866341911022
STAT,1850,30,40-44,1880,5.239812146888663
STAT,1832,29,15-19,1861,0.4186277752667763
STAT,1870,51,20-24,1921,8.435656555206203E-4
SIM,1964,29,na,1993,5645
SIM,1937,31,25-29,1968,3
STAT,1984,30,45-49,2014,2.6320017288513617
SIM,1830,58,na,1888,1402
STAT,1871,22,25-29,1893,65.72519597443396
STAT,1896,35,35-39,1931,10.883545830329775
STAT,1933,48,na,1981,5816.692025006657
SIM,2010,1,na,2011,7251
STAT,1862,52,50-100,1914,0.014630753373208719
STAT,1850,69,na,1919,1510.7567271205337
STAT,1895,39,40-44,1934,6.5096665935210245
STAT,1816,46,20-24,1862,0.024844670682381245
STAT,1895,57,na,1952,3018.851559858924
SIM,1973,30,40-44,2003,15
SIM,1890,20,35-39,1910,12
SIM,1902,49,45-49,1951,1
STAT,1820,44,20-24,1864,0.18279777641106526
SIM,1867,46,na,1913,2202
STAT,1963,31,25-29,1994,13.82106474091887
STAT,1887,14,na,1901,3329.2055725189684
STAT,1861,77,na,1938,829.3040691722558
STAT,1882,20,35-39,1902,6.617087812450571
SIM,1938,18,45-49,1956,1
SIM,1811,87,na,1898,111
STAT,1845,41,15-19,1886,0.00959847906632793
STAT,1985,23,15-19,2008,8.763396634392969
STAT,1934,46,35-39,1980,0.20791939887663966
SIM,1836,23,na,1859,1629
STAT,1874,43,35-39,1917,2.123926527074932
STAT,1983,23,40-44,2006,5.505528368675326
STAT,1904,108,na,2012,0.30217823178377007
STAT,1855,51,25-29,1906,0.0030283032622006436
STAT,1871,30,30-34,1901,20.207094156331305
STAT,1871,38,40-44,1909,5.000997795574633
STAT,1936,13,na,1949,4373.647153365561
STAT,1984,27,20-24,2011,30.048654354302734
STAT,1973,40,40-44,2013,0.38904625587046865
STAT,1846,28,35-39,1874,11.980508297919616
STAT,1861,19,40-44,1880,0.19932332216532928
SIM,1854,28,35-39,1882,12
STAT,1933,20,35-39,1953,14.506176738572178
STAT,1970,40,15-19,2010,0.0023119388358708664
SIM,1808,59,na,1867,1406
SIM,1929,22,30-34,1951,104
STAT,1866,49,15-19,1915,4.189309055147871E-4
STAT,1881,24,40-44,1905,2.3050274851235932
SIM,1834,41,50-100,1875,1
STAT,1964,18,45-49,1982,0.7258600568478885
SIM,1929,63,na,1992,4544
STAT,1862,17,50-100,1879,0.054647767744867855
STAT,1915,51,na,1966,4218.540369644614
SIM,1932,73,na,2005,3700
STAT,1895,20,20-24,1915,104.1374533659132
SIM,1882,43,35-39,1925,11
SIM,1899,36,50-100,1935,1
STAT,1881,52,35-39,1933,0.009531979124687584
STAT,1905,49,20-24,1954,0.011070341905169642
STAT,1824,40,40-44,1864,3.310542433728376
STAT,1976,36,25-29,2012,1.5654107018474845
STAT,1840,23,35-39,1863,5.910389518417512
SIM,1893,34,20-24,1927,9
SIM,1881,33,45-49,1914,1
SIM,1896,25,35-39,1921,31
SIM,1963,21,25-29,1984,300
STAT,1992,21,40-44,2013,5.589945181255356
STAT,1900,21,na,1921,3798.7181208541733
STAT,1853,26,na,1879,2513.117367022768
SIM,1842,62,na,1904,1602
STAT,1938,28,45-49,1966,1.9752337961958486
SIM,1946,28,45-49,1974,6
STAT,1862,41,20-24,1903,0.15537301841855491
STAT,1848,41,40-44,1889,2.4177535222450097
STAT,1872,18,35-39,1890,0.6341794509809165
SIM,1924,78,na,2002,2339
SIM,1795,67,na,1862,852
SIM,1958,20,na,1978,6210
STAT,1858,57,na,1915,1809.242650836978
STAT,1855,17,45-49,1872,0.06610999208189854
STAT,1981,29,50-100,2010,1.611556462838812
STAT,1874,34,45-49,1908,2.0425950107293027
STAT,1882,48,50-100,1930,0.2733654491714211
SIM,1881,31,25-29,1912,1
STAT,1863,42,20-24,1905,0.1600625381092194
STAT,1969,38,35-39,2007,3.588775554518747
SIM,1811,79,na,1890,560
STAT,1952,27,na,1979,5203.205899266813
SIM,1969,30,30-34,1999,54
SIM,1918,12,na,1930,4297
SIM,1841,22,40-44,1863,6
STAT,1864,39,50-100,1903,1.2523843478007353
STAT,1923,45,20-24,1968,0.01498408476978581
STAT,1942,4,na,1946,4833.308045786148
STAT,1877,35,30-34,1912,6.458625889721772
SIM,1885,35,30-34,1920,11
STAT,1881,41,25-29,1922,0.7180379994649624
STAT,1863,53,30-34,1916,0.005910332913999549
STAT,1868,3,na,1871,3504.778930243887
SIM,1824,30,40-44,1854,12
SIM,1831,36,40-44,1867,13
SIM,1849,40,50-100,1889,2
SIM,1926,63,na,1989,5244
STAT,1861,85,na,1946,263.0065525361656
STAT,1861,28,30-34,1889,24.16049499228216
SIM,1827,62,na,1889,935
STAT,1826,52,45-49,1878,0.010088974582472692
STAT,1885,34,20-24,1919,3.0848763949038056
STAT,1885,45,30-34,1930,0.11253825967629068
STAT,1873,33,45-49,1906,2.046404333870212
SIM,1911,33,na,1944,4861
STAT,1895,31,30-34,1926,26.33503093624446
SIM,1971,33,35-39,2004,33
STAT,1859,23,15-19,1882,3.1240485777673697
STAT,1859,44,20-24,1903,0.1440268754637891
SIM,1882,34,45-49,1916,6
STAT,1883,56,na,1939,2302.935033061117
SIM,1851,48,30-34,1899,1
STAT,1828,48,35-39,1876,0.1272360366561403
STAT,1886,21,na,1907,2887.691986621264
STAT,1853,37,35-39,1890,7.041934929790728
STAT,1954,42,50-100,1996,0.17418045152445086
STAT,1993,16,30-34,2009,20.24384944255523
SIM,1781,83,na,1864,296
STAT,1898,48,20-24,1946,0.010424820472738097
SIM,1817,48,30-34,1865,1
SIM,1842,26,20-24,1868,28
STAT,1981,9,na,1990,6341.319867646051
SIM,1980,25,30-34,2005,79
SIM,1850,4,na,1854,2449
SIM,1812,43,25-29,1855,1
STAT,1848,53,35-39,1901,0.009000493178034127
SIM,1907,20,na,1927,4757
SIM,1863,39,50-100,1902,4
STAT,1884,33,20-24,1917,3.069077910992721
SIM,1892,33,20-24,1925,1
STAT,1829,52,na,1881,1664.8221413822394
STAT,1960,36,35-39,1996,3.7489424579051995
STAT,1819,37,35-39,1856,20.90657413127029
STAT,1813,54,25-29,1867,0.010806241611438576
STAT,1955,21,25-29,1976,142.02561184970529
SIM,1897,34,40-44,1931,11
STAT,1844,16,30-34,1860,1.7047010054870742
SIM,1867,23,15-19,1890,6
SIM,1861,37,35-39,1898,3
SIM,1877,44,35-39,1921,12
STAT,1812,53,25-29,1865,0.007690528305308388
STAT,1869,33,25-29,1902,11.398912451756294
STAT,1869,49,na,1918,2461.9411425734634
SIM,1986,22,20-24,2008,170
STAT,1891,46,45-49,1937,0.19041578284531774
STAT,1988,23,40-44,2011,5.566214183538116
STAT,1940,50,na,1990,4438.668452190247
STAT,1935,17,50-100,1952,0.5913962916019593
STAT,1934,30,na,1964,5968.944742336865
STAT,1957,17,15-19,1974,69.05374222833508
SIM,1956,24,50-100,1980,2
SIM,1965,17,15-19,1982,64
STAT,1824,77,na,1901,534.843677628006
SIM,1770,91,na,1861,16
SIM,1875,97,na,1972,48
SIM,1974,31,40-44,2005,6
SIM,1975,24,20-24,1999,1
STAT,1987,19,40-44,2006,2.3028373925233465
SIM,1995,19,40-44,2014,7
STAT,1980,34,25-29,2014,15.074145490963529
STAT,1874,95,na,1969,72.13829061262676
STAT,1837,54,40-44,1891,0.007413777472322626
STAT,1869,44,35-39,1913,1.9964632921420755
STAT,1967,24,20-24,1991,160.7149765780517
STAT,1829,27,45-49,1856,2.2884929491387758
STAT,1809,48,30-34,1857,0.24506372518228192
SIM,1837,44,40-44,1881,6
STAT,1978,15,50-100,1993,0.5903841246584378
SIM,1845,67,na,1912,1469
SIM,1869,34,35-39,1903,18
STAT,1854,38,35-39,1892,5.7337068359850445
STAT,1889,102,na,1991,10.221637883574257
SIM,1837,27,45-49,1864,3
STAT,1844,40,15-19,1884,0.012137043876005883
SIM,1811,43,30-34,1854,3
SIM,1832,49,na,1881,1930
SIM,1877,33,25-29,1910,20
SIM,1949,34,20-24,1983,1
STAT,1845,27,35-39,1872,7.914067075391867
STAT,1831,45,35-39,1876,0.13307636599223094
STAT,1842,36,20-24,1878,0.7031170936019762
SIM,1986,16,35-39,2002,18
STAT,1827,47,35-39,1874,0.1773165967466929
STAT,1836,39,30-34,1875,5.833190425750003
SIM,1943,17,50-100,1960,2
SIM,1828,38,35-39,1866,13
STAT,1978,22,20-24,2000,175.70688466592964
STAT,1866,44,na,1910,2438.874376154859
STAT,1860,44,15-19,1904,0.012671263454773422
SIM,1853,27,35-39,1880,20
STAT,1874,26,15-19,1900,0.5378651108112924
SIM,1882,26,15-19,1908,1
STAT,1910,42,30-34,1952,0.13958154812563808
SIM,1937,50,na,1987,4196
SIM,1874,16,na,1890,2749
STAT,1970,22,50-100,1992,0.9537019703983746
SIM,1876,29,25-29,1905,6
STAT,1831,47,na,1878,1892.8011556241815
STAT,1892,39,15-19,1931,0.08040640409562268
STAT,1920,39,45-49,1959,0.8591822967700463
STAT,1854,50,25-29,1904,0.002927135465125866
SIM,1883,84,na,1967,465
SIM,1959,23,25-29,1982,138
SIM,1965,36,45-49,2001,1
STAT,1835,38,30-34,1873,4.070270522754809
SIM,1948,42,na,1990,4369
SIM,1879,71,na,1950,1655
STAT,1843,48,30-34,1891,0.09590686996084306
SIM,1822,33,35-39,1855,23
SIM,1834,75,na,1909,799
STAT,1852,25,25-29,1877,47.12692600538237
STAT,1768,113,na,1881,4.592782101511201E-4
STAT,1830,33,25-29,1863,10.865299146020039
STAT,1834,26,20-24,1860,14.1400311770395
STAT,1929,31,25-29,1960,13.55722668697278
STAT,1857,20,50-100,1877,0.42927589657776694
STAT,1950,47,30-34,1997,0.12652744276112632
SIM,1843,38,30-34,1881,8
STAT,1937,41,25-29,1978,0.08328979427439163
SIM,1860,25,25-29,1885,8
STAT,1861,45,15-19,1906,3.8758851449244394E-4
STAT,1877,115,na,1992,1.5384980997259747E-4
STAT,1858,43,20-24,1901,0.14194431394402374
STAT,1849,54,50-100,1903,0.011383763209154367
STAT,1875,27,15-19,1902,0.5410835700037311
SIM,1963,5,na,1968,6583
STAT,1870,35,20-24,1905,0.8853425267999017
SIM,1895,24,35-39,1919,17
STAT,1898,86,na,1984,960.6321116571343
SIM,1988,25,35-39,2013,2
STAT,1872,69,na,1941,1700.5925138434613
STAT,1983,15,45-49,1998,0.8159566116465524
STAT,1952,47,40-44,1999,0.22679750530988357
STAT,1969,35,30-34,2004,2.71163219353488
SIM,1854,44,35-39,1898,4
STAT,1855,34,40-44,1889,3.680051319217035
STAT,1890,35,40-44,1925,6.231429020992815
STAT,1894,72,na,1966,2228.560805370103
STAT,1855,46,35-39,1901,0.11946359518768637
STAT,1876,39,25-29,1915,3.400251399519817
STAT,1887,24,35-39,1911,7.499914130262209
SIM,1886,15,25-29,1901,18
STAT,1844,48,25-29,1892,0.047572585041349445
STAT,1835,54,30-34,1889,0.0036386469393357326
STAT,1939,21,35-39,1960,10.921055236008158
STAT,1871,18,40-44,1889,0.21010719023418767
SIM,1863,34,40-44,1897,1
SIM,1889,46,na,1935,3616
SIM,1960,48,na,2008,6089
SIM,1980,3,na,1983,6011
SIM,1854,25,30-34,1879,5
SIM,1792,70,na,1862,633
STAT,1824,85,na,1909,169.62100757459072
SIM,1824,44,50-100,1868,2
STAT,1846,25,30-34,1871,31.950164410003712
STAT,1979,32,na,2011,6125.742973865424
STAT,1826,44,15-19,1870,0.010045168961102082
STAT,1974,41,40-44,2015,0.3922728094362258
STAT,1816,49,25-29,1865,0.11398242708033622
SIM,1847,15,na,1862,3034
STAT,1846,44,35-39,1890,1.8467185612638388
SIM,1838,54,na,1892,1476
SIM,1921,32,na,1953,5256
STAT,1919,33,30-34,1952,19.529067734690397
STAT,1886,45,25-29,1931,0.07081615912955683
STAT,1994,16,25-29,2010,72.1882204540038
SIM,1880,31,30-34,1911,34
STAT,1842,100,na,1942,0.8169626484721526
STAT,1872,31,30-34,1903,20.31504126489792
SIM,1924,86,na,2010,766
SIM,1884,23,20-24,1907,139
STAT,1816,100,na,1916,0.524293228819309
STAT,1883,43,50-100,1926,1.184214926636862
SIM,1817,39,40-44,1856,2
SIM,1865,26,45-49,1891,2
SIM,1943,1,na,1944,5658
STAT,1864,45,40-44,1909,0.17817034577972135
STAT,1947,49,25-29,1996,0.0713050718219142
STAT,1957,25,45-49,1982,2.6423364072147506
STAT,1815,49,50-100,1864,0.4868612288825759
STAT,1896,20,50-100,1916,0.625298007805198
STAT,1829,44,40-44,1873,2.3248500651543162
STAT,1871,52,20-24,1923,8.427144901406163E-4
SIM,1831,42,45-49,1873,3
SIM,1858,77,na,1935,1314
SIM,1981,24,40-44,2005,11
STAT,1774,104,na,1878,0.0013741761057857924
SIM,1901,48,45-49,1949,1
SIM,1900,41,na,1941,3501
SIM,1820,38,30-34,1858,12
SIM,1894,27,50-100,1921,2
SIM,1794,82,na,1876,5
SIM,1977,35,30-34,2012,5
SIM,1947,21,35-39,1968,31
STAT,1869,48,50-100,1917,0.2710356921116338
STAT,1924,31,na,1955,5093.713653464553
STAT,1896,74,na,1970,2174.5100717737087
STAT,1835,43,20-24,1878,0.11724448825022755
STAT,1941,35,na,1976,4616.48071242446
STAT,1857,26,45-49,1883,1.0353401568348102
STAT,1990,15,na,2005,6086.449585926918
STAT,1920,22,15-19,1942,6.826602258425254
SIM,1872,45,40-44,1917,1
SIM,1883,76,na,1959,1086
STAT,1972,25,40-44,1997,6.922978304463742
STAT,1892,60,na,1952,2758.610167947094
SIM,1917,38,na,1955,5319
STAT,1874,40,30-34,1914,1.3719778158162859
SIM,1858,36,25-29,1894,1
STAT,1867,33,15-19,1900,0.1527950928242097
SIM,1879,39,na,1918,2771
SIM,1866,72,na,1938,1352
STAT,2007,8,na,2015,7059.622431690264
SIM,1831,39,45-49,1870,5
SIM,1853,28,40-44,1881,5
STAT,1811,59,na,1870,1251.0353919748086
STAT,1938,34,50-100,1972,0.9586425666785908
SIM,1880,15,30-34,1895,5
STAT,1841,101,na,1942,0.5073358166657135
STAT,1872,15,30-34,1887,1.8750782070773606
STAT,1858,30,45-49,1888,1.6028832291396076
SIM,1935,0,na,1935,6930
STAT,1870,54,25-29,1924,0.003919015964733474
SIM,1882,40,30-34,1922,5
STAT,1825,30,na,1855,2096.944657904988
STAT,1947,27,50-100,1974,1.2995052668217548
STAT,1813,53,40-44,1866,0.032767648994922995
SIM,1868,84,na,1952,308
STAT,1845,28,40-44,1873,2.439325448957214
SIM,1893,54,na,1947,2892
STAT,1897,13,na,1910,3978.980176402286
SIM,1887,38,45-49,1925,7
STAT,1972,28,35-39,2000,22.2693242119452
STAT,1846,21,na,1867,2747.000160305941
STAT,1867,2,na,1869,3625.119026766116
STAT,1847,37,40-44,1884,3.4947492702314134
STAT,1899,44,15-19,1943,0.001495753391447089
STAT,1882,53,35-39,1935,0.009548448344162408
STAT,1902,35,35-39,1937,2.5130040945344727
SIM,1954,35,40-44,1989,2
STAT,1971,41,15-19,2012,0.002336088913544501
STAT,1993,19,35-39,2012,6.962575298209517
STAT,1956,24,45-49,1980,1.7227286928216714
SIM,1827,34,30-34,1861,35
SIM,1976,26,25-29,2002,115
SIM,1866,30,45-49,1896,7
STAT,1878,51,25-29,1929,0.004288388726117354
SIM,1843,29,40-44,1872,2
SIM,1965,25,45-49,1990,1
SIM,1848,27,20-24,1875,1
STAT,1917,61,na,1978,4079.5450326635187
SIM,1907,16,15-19,1923,8
STAT,1894,16,20-24,1910,26.36556700055005
STAT,1926,43,15-19,1969,0.0021809198797461925
STAT,1863,44,40-44,1907,2.2391295116902152
STAT,1927,22,25-29,1949,131.30636839938734
STAT,1847,40,40-44,1887,1.7855381132893156
STAT,1879,38,45-49,1917,2.390274259763035
SIM,1838,24,35-39,1862,1
SIM,1893,83,na,1976,953
SIM,1966,34,na,2000,5873
SIM,1855,37,40-44,1892,3
STAT,1857,72,na,1929,1135.1034252200436
STAT,1852,34,15-19,1886,0.1361570037661513
SIM,1853,32,25-29,1885,16
SIM,1871,44,40-44,1915,8
SIM,1882,91,na,1973,442
STAT,1904,3,na,1907,4381.09358364469
SIM,1986,22,na,2008,6287
SIM,1964,24,45-49,1988,5
STAT,1946,35,40-44,1981,1.9774990319722683
STAT,1853,35,15-19,1888,0.05708176623610471
SIM,1958,12,na,1970,6233
SIM,1928,79,na,2007,3087
SIM,1980,28,35-39,2008,58
STAT,1769,112,na,1881,0.001129762548300431
STAT,1968,18,50-100,1986,0.5398611240303187
STAT,1877,36,15-19,1913,0.0677349088261463
STAT,1888,25,35-39,1913,13.1782946296916
SIM,1828,35,30-34,1863,10
SIM,1889,38,na,1927,3743
STAT,1945,23,30-34,1968,36.34063964304503
STAT,1952,33,15-19,1985,0.18103985911237833
SIM,1853,24,30-34,1877,1
SIM,1855,40,40-44,1895,1
STAT,1879,19,na,1898,3027.0819239074535
SIM,1831,26,45-49,1857,1
SIM,1835,89,na,1924,54
STAT,1893,23,15-19,1916,4.797477357028081
STAT,1843,32,15-19,1875,0.17178019506211556
SIM,1925,17,na,1942,4923
STAT,1810,93,na,1903,16.64056804040487
STAT,1956,49,50-100,2005,0.35715556243595165
SIM,1935,22,25-29,1957,171
SIM,1856,44,45-49,1900,2
SIM,1907,21,40-44,1928,11
STAT,1786,110,na,1896,2.4064091291782605E-4
STAT,1797,100,na,1897,0.3161064844906538
SIM,1935,24,na,1959,5868
STAT,1916,48,50-100,1964,0.26700774973674435
STAT,1884,94,na,1978,139.25306494106013
STAT,1929,22,35-39,1951,13.742105408808728
SIM,1931,10,na,1941,6378
STAT,1982,18,20-24,2000,220.09368586068692
SIM,1860,34,15-19,1894,1
STAT,1926,35,na,1961,5314.29546974848
SIM,1953,23,30-34,1976,58
STAT,1814,86,na,1900,138.3439042096665
SIM,1990,18,20-24,2008,192
STAT,1895,101,na,1996,18.683167689056646
STAT,1845,24,30-34,1869,14.687611287118575
STAT,1966,39,50-100,2005,0.6221671221107903
STAT,1827,45,15-19,1872,5.203683418259704E-4
STAT,1861,33,20-24,1894,2.5823902144309523
STAT,1835,29,40-44,1864,2.4046966359931696
SIM,1850,39,25-29,1889,1
STAT,1920,36,40-44,1956,1.8924278873403626
STAT,1842,39,25-29,1881,2.316553986023915
SIM,1876,26,20-24,1902,29
STAT,1930,43,50-100,1973,0.17812660388133264
SIM,1900,70,na,1970,2564
STAT,1797,81,na,1878,254.6778446219933
STAT,1969,40,20-24,2009,0.026532032486773063
SIM,1839,36,45-49,1875,6
STAT,1843,53,50-100,1896,0.014910500684406705
SIM,1939,35,45-49,1974,2
SIM,1833,23,na,1856,2099
SIM,1910,35,35-39,1945,1
SIM,1880,34,35-39,1914,25
STAT,1844,45,20-24,1889,0.010195355825861533
STAT,1860,29,20-24,1889,10.87063805822083
SIM,1839,33,40-44,1872,13
STAT,1842,15,15-19,1857,5.9340513691086345
STAT,1876,35,15-19,1911,0.06762742832789176
STAT,1904,35,45-49,1939,0.7198346694993308
STAT,1855,37,45-49,1892,1.6962489520304447
STAT,1840,44,40-44,1884,1.8346071932381445
STAT,1949,28,20-24,1977,24.593963679694852
SIM,1988,22,30-34,2010,6
STAT,1836,22,na,1858,2567.9029854236283
SIM,1826,29,35-39,1855,24
STAT,1870,15,20-24,1885,20.604324361747878
STAT,1884,50,40-44,1934,0.01217634721968448
SIM,1958,24,15-19,1982,9
STAT,1961,12,na,1973,5856.8698116618725
SIM,1900,49,50-100,1949,1
SIM,1913,30,25-29,1943,25
STAT,1917,43,50-100,1960,0.1412666425200088
SIM,1912,35,45-49,1947,1
STAT,1981,33,na,2014,6217.2350117708975
SIM,1844,74,na,1918,959
SIM,1836,24,25-29,1860,119
STAT,1860,32,20-24,1892,2.514138326492322
SIM,1845,35,50-100,1880,3
STAT,1894,102,na,1996,11.301026502645268
STAT,1876,23,20-24,1899,81.9571155420896
STAT,1986,23,30-34,2009,47.40242980482203
STAT,1900,41,50-100,1941,0.11801051710072807
STAT,1962,36,45-49,1998,1.039478519381604
SIM,1928,45,40-44,1973,1
SIM,1998,10,na,2008,6865
STAT,1947,46,20-24,1993,0.014979960223054808
STAT,1995,19,45-49,2014,0.8339420227104286
STAT,1833,29,30-34,1862,23.286459713528295
SIM,1938,31,40-44,1969,14
STAT,1957,22,40-44,1979,5.132957710597527
STAT,1846,41,30-34,1887,1.2184048908879148
STAT,1905,30,25-29,1935,17.245970804987152
SIM,1878,54,na,1932,2475
SIM,1829,29,na,1858,1823
STAT,1845,43,35-39,1888,1.2267604712810514
STAT,1861,44,30-34,1905,1.0881115780252602
SIM,1826,38,25-29,1864,6
SIM,1841,29,30-34,1870,7
STAT,1937,37,50-100,1974,0.48477237358384656
SIM,1957,28,20-24,1985,48
STAT,1867,49,30-34,1916,0.10212315715205038
SIM,1968,30,15-19,1998,1
SIM,1840,22,25-29,1862,4
STAT,1845,32,25-29,1877,8.20654282520599
STAT,1898,27,15-19,1925,0.7076309255204581
STAT,1951,46,40-44,1997,0.22592579921059538
STAT,1928,15,30-34,1943,17.806129753152817
STAT,1943,23,20-24,1966,136.49597337778332
SIM,1853,43,35-39,1896,3
STAT,1876,26,25-29,1902,50.63788213709164
SIM,1874,17,20-24,1891,39
STAT,1814,54,40-44,1868,0.02688641089265159
SIM,1852,19,35-39,1871,2
STAT,1882,90,na,1972,305.27635462036267
STAT,1950,37,50-100,1987,0.5902392329362277
SIM,1972,31,30-34,2003,3
STAT,1774,93,na,1867,0.27652399018299617
SIM,1910,40,na,1950,3552
SIM,1918,68,na,1986,3006
STAT,1975,18,20-24,1993,206.34341576881422
STAT,1906,17,45-49,1923,0.10992934910068734
STAT,1832,22,25-29,1854,88.03955047653668
STAT,1972,40,25-29,2012,0.10995911521267526
STAT,1791,102,na,1893,0.06275877923946013
STAT,1911,91,na,2002,545.6974947149
STAT,1895,19,40-44,1914,0.27328204892354
STAT,1837,35,50-100,1872,1.1051389069527666
STAT,1861,21,na,1882,2347.9361366631474
SIM,1890,54,na,1944,3052
SIM,1875,49,30-34,1924,1
SIM,1978,36,30-34,2014,1
STAT,1834,42,20-24,1876,0.17472025284513895
STAT,1936,46,45-49,1982,0.2493681348136162
SIM,1951,23,20-24,1974,5
SIM,1894,68,na,1962,2704
STAT,1874,32,50-100,1906,1.0824957770793981
SIM,1968,18,25-29,1986,78
STAT,1863,87,na,1950,177.7858191201565
STAT,1979,24,35-39,2003,15.00095617740904
STAT,1917,17,20-24,1934,33.66986557003952
SIM,1925,17,20-24,1942,343
STAT,1969,33,na,2002,5554.22843708198
SIM,1852,25,20-24,1877,1
STAT,1829,47,45-49,1876,0.24079021397401346
STAT,1838,88,na,1926,118.91642328200531
STAT,1834,39,20-24,1873,0.8570349096443574
STAT,1844,25,20-24,1869,12.186466211081617
SIM,1830,27,35-39,1857,24
SIM,1944,20,na,1964,4623
STAT,1866,17,20-24,1883,19.464527441141442
STAT,1844,19,35-39,1863,0.5765553370872314
SIM,1968,29,35-39,1997,23
SIM,1884,26,25-29,1910,93
SIM,1987,24,35-39,2011,1
SIM,1866,10,na,1876,2763
STAT,1956,21,40-44,1977,5.153240047538628
STAT,1893,39,30-34,1932,7.69610850293375
STAT,1942,23,50-100,1965,0.7960527133565035
SIM,1896,34,25-29,1930,35
STAT,1989,19,15-19,2008,74.96784420292596
STAT,1931,20,25-29,1951,139.1115110112833
SIM,1876,28,na,1904,2528
STAT,1800,86,na,1886,99.16830130690172
STAT,1981,15,35-39,1996,6.774972625054817
SIM,1836,44,25-29,1880,2
STAT,1819,42,25-29,1861,1.3501770272978637
SIM,1977,29,45-49,2006,1
SIM,1808,67,na,1875,988
STAT,1873,27,40-44,1900,3.5302416586117378
STAT,1888,34,25-29,1922,13.7758946310525
STAT,1819,53,35-39,1872,0.015629005974749078
STAT,1895,23,50-100,1918,0.6106866091624914
STAT,1823,42,45-49,1865,1.5725172375023886
STAT,1823,39,45-49,1862,2.1964993240885256
SIM,1882,31,40-44,1913,6
SIM,1887,35,40-44,1922,14
SIM,1930,57,na,1987,5624
SIM,1939,32,40-44,1971,10
SIM,1827,42,25-29,1869,2
STAT,1879,15,40-44,1894,0.22142565664904482
STAT,1879,54,45-49,1933,0.017006831793385472
STAT,1992,16,15-19,2008,75.19783907097712
STAT,1885,90,na,1975,336.5542031671654
SIM,1881,27,40-44,1908,1
STAT,1873,30,40-44,1903,5.151857533545826
SIM,1827,53,35-39,1880,1
STAT,1824,43,45-49,1867,2.094364645201074
STAT,1879,35,40-44,1914,5.325070599398856
SIM,1858,21,na,1879,2780
STAT,1808,49,20-24,1857,0.057954228396849154
STAT,1818,38,25-29,1856,4.4633122629374435
STAT,1889,24,45-49,1913,0.9857782213777659
STAT,1842,48,15-19,1890,3.0394219382461356E-4
STAT,1793,99,na,1892,0.35660888867479856
SIM,1886,39,35-39,1925,3
STAT,1809,53,20-24,1862,0.0017470930859689571
STAT,1878,39,35-39,1917,8.436780310193688
STAT,1873,65,na,1938,1991.6036743776222
SIM,1865,36,na,1901,2901
SIM,1953,45,na,1998,5567
STAT,1857,23,40-44,1880,2.1466879790170665
STAT,1938,23,na,1961,4171.61282232668
SIM,1968,33,30-34,2001,7
STAT,1852,95,na,1947,12.535212142736652
STAT,1993,17,15-19,2010,75.35404742046124
SIM,1838,21,30-34,1859,18
SIM,1965,22,40-44,1987,13
STAT,1882,39,na,1921,2628.9644388738425
STAT,1815,101,na,1916,0.31662855332061635
STAT,1901,14,na,1915,4161.066713015832
STAT,1905,28,na,1933,3972.2313939817222
STAT,1862,45,30-34,1907,0.09521655529562044
STAT,1883,52,45-49,1935,0.0162986244256624
STAT,1913,79,na,1992,2245.0260835146983
STAT,1955,25,35-39,1980,23.120485580928655
STAT,1904,43,na,1947,3815.6945007786694
STAT,1833,45,45-49,1878,0.200958130752533
STAT,1892,27,20-24,1919,16.96877398502942
STAT,1945,49,15-19,1994,4.8020407813414247E-4
STAT,1881,36,35-39,1917,7.910968260426964
SIM,1834,96,na,1930,11
SIM,1887,18,45-49,1905,3
SIM,1830,82,na,1912,361
SIM,1975,27,15-19,2002,3
STAT,1871,33,35-39,1904,11.57808490445662
SIM,1864,30,50-100,1894,2
STAT,1808,52,20-24,1860,0.0035172842819616345
SIM,1868,76,na,1944,1114
STAT,1849,21,na,1870,2018.0882766756176
STAT,1921,32,50-100,1953,1.061438800744248
SIM,1831,23,40-44,1854,2
STAT,1872,34,35-39,1906,11.634793771840108
STAT,1880,24,25-29,1904,69.58682291801512
SIM,1891,28,na,1919,3251
STAT,1847,73,na,1920,913.9214518130816
STAT,1856,30,50-100,1886,0.8337202205186319
SIM,1849,22,45-49,1871,2
STAT,1969,43,25-29,2012,0.10681569450242556
SIM,1968,11,na,1979,5394
STAT,1908,34,50-100,1942,0.8940766553516156
STAT,1850,33,45-49,1883,1.858529630971228
STAT,1968,42,25-29,2010,0.10696880866782263
STAT,1913,17,na,1930,4559.64691567531
STAT,1968,39,25-29,2007,1.4590411808234118
STAT,1965,31,35-39,1996,13.428410817019842
STAT,1832,45,15-19,1877,3.368748538776633E-4
SIM,1877,29,40-44,1906,7
STAT,1896,82,na,1978,1382.4409038650313
STAT,1989,21,na,2010,6058.32650895911
STAT,1845,47,na,1892,1508.9982681936856
SIM,1916,34,50-100,1950,1
STAT,1822,65,na,1887,1404.2166296385774
STAT,1873,57,na,1930,2368.3297396067214
STAT,1865,20,40-44,1885,2.228033803801737
STAT,1845,25,15-19,1870,0.3775294340674222
STAT,1829,53,30-34,1882,0.00523166229871039
STAT,1933,43,15-19,1976,0.0024322204446012613
STAT,1830,60,na,1890,1196.4059893006809
STAT,1836,30,15-19,1866,0.16731505225222157
STAT,1976,32,na,2008,5943.855810670124
STAT,1865,17,40-44,1882,0.1962541413242679
SIM,1830,80,na,1910,453
STAT,1949,44,20-24,1993,0.024551256451386446
SIM,1903,32,30-34,1935,3
STAT,1962,33,40-44,1995,5.894714822017366
STAT,1860,92,na,1952,38.73848018389181
STAT,1856,54,45-49,1910,0.012426073178150213
SIM,1952,50,na,2002,4524
STAT,1861,47,35-39,1908,0.13369081866329685
SIM,1817,39,na,1856,1597
SIM,1919,42,35-39,1961,1
STAT,1975,36,30-34,2011,2.861342001974289
SIM,1858,23,na,1881,2931
SIM,1870,45,30-34,1915,1
SIM,1896,40,na,1936,3699
STAT,1959,18,30-34,1977,18.394043137822205
STAT,1964,31,na,1995,5606.767113460582
SIM,1914,33,45-49,1947,1
STAT,1964,34,45-49,1998,2.3284123586713
STAT,1833,42,40-44,1875,1.9315748011696372
SIM,1821,78,na,1899,68
STAT,1896,31,25-29,1927,15.676462614332632
STAT,1967,42,45-49,2009,0.249332946543304
STAT,1949,56,na,2005,4937.717576822483
SIM,1822,85,na,1907,3
SIM,1951,39,45-49,1990,2
STAT,1880,21,20-24,1901,84.5511031260695
STAT,1928,49,20-24,1977,0.01617704560008859
SIM,1929,16,45-49,1945,1
SIM,1889,24,40-44,1913,6
STAT,1974,25,15-19,1999,1.0693480541832836
STAT,1848,58,na,1906,2101.2521167120444
STAT,1940,2,na,1942,4774.171805680406
STAT,1880,41,30-34,1921,1.4126848638287226
STAT,1918,4,na,1922,5068.827134276239
STAT,1943,39,45-49,1982,0.8577629844555066
STAT,1805,61,na,1866,1171.0661353206146
STAT,1888,103,na,1991,5.710918592869266
SIM,1850,35,na,1885,1652
SIM,1905,24,35-39,1929,23
STAT,1886,27,50-100,1913,0.7787046759275157
STAT,1882,44,45-49,1926,1.664263450580368
STAT,1839,30,40-44,1869,4.321186513968665
STAT,1839,27,40-44,1866,2.992761969888484
SIM,1957,24,na,1981,5494
STAT,1871,15,15-19,1886,6.939121152631454
STAT,1921,22,30-34,1943,37.44974498279679
SIM,1950,3,na,1953,4845
SIM,1868,19,25-29,1887,14
SIM,1919,64,na,1983,4688
STAT,1827,96,na,1923,6.9733996708213
STAT,1844,50,50-100,1894,0.012813812519069726
SIM,1987,21,30-34,2008,58
STAT,1827,52,25-29,1879,0.004329555151695404
STAT,1971,32,25-29,2003,13.770690067959572
STAT,1954,39,20-24,1993,0.3866332190253149
STAT,1879,36,50-100,1915,1.4865738989994663
SIM,1931,80,na,2011,2980
SIM,1841,42,40-44,1883,2
SIM,1873,32,35-39,1905,4
STAT,1871,15,50-100,1886,0.05728497315734412
STAT,1917,49,45-49,1966,0.26045338980868765
SIM,1842,48,na,1890,1992
STAT,1921,66,na,1987,4092.635550778493
SIM,1869,72,na,1941,805
SIM,1825,41,45-49,1866,4
STAT,1894,27,na,1921,3540.5007862303396
SIM,1909,17,30-34,1926,5
STAT,1875,43,15-19,1918,0.01635056722671372
STAT,1809,110,na,1919,1.2843634288649597E-4
STAT,1979,21,30-34,2000,45.83536069832605
SIM,1872,40,35-39,1912,4
SIM,1955,27,50-100,1982,1
STAT,1913,25,na,1938,4339.22088504313
STAT,1922,34,40-44,1956,5.0755630973013695
SIM,1855,66,na,1921,1140
STAT,1979,17,45-49,1996,0.7937616491327448
STAT,1967,43,15-19,2010,0.00229701516000231
STAT,1946,12,na,1958,5027.973045581653
STAT,1817,49,40-44,1866,0.4749569769627025
STAT,1904,32,40-44,1936,4.126712380800019
SIM,1910,19,35-39,1929,1
SIM,1950,23,50-100,1973,1
SIM,1890,44,45-49,1934,3
STAT,1885,68,na,1953,1759.122348080627
STAT,1930,29,na,1959,5492.457231024346
SIM,1912,32,40-44,1944,15
STAT,1864,40,35-39,1904,1.8847657936246378
SIM,1904,38,20-24,1942,1
STAT,1832,50,40-44,1882,0.007909518318830414
SIM,1940,23,45-49,1963,6
STAT,1822,38,50-100,1860,2.840728187031043
STAT,1977,18,50-100,1995,0.584012117410227
STAT,1788,96,na,1884,2.412580401920347
STAT,1928,22,40-44,1950,4.844679790204559
STAT,1908,27,15-19,1935,0.7776875330112976
STAT,1937,32,35-39,1969,10.439469879663903
STAT,1797,59,na,1856,1202.4168546771
STAT,1880,27,na,1907,2919.293640440704
SIM,1928,5,na,1933,6081
STAT,1853,42,25-29,1895,0.6385566004532293
SIM,1890,89,na,1979,211
STAT,1932,23,45-49,1955,1.6988979615974766
STAT,1843,53,20-24,1896,7.285261209162434E-4
SIM,1985,7,na,1992,6448
STAT,1917,33,20-24,1950,2.9352879959604836
STAT,1869,15,15-19,1884,6.804265174340081
SIM,1900,27,na,1927,3745
STAT,1922,28,20-24,1950,23.743080351963698
STAT,1968,45,na,2013,5533.996796152115
STAT,1889,21,40-44,1910,2.973312085526457
STAT,1897,43,35-39,1940,0.19264213837307845
STAT,1923,49,na,1972,4928.853917997187
SIM,1930,28,20-24,1958,31
SIM,1897,21,40-44,1918,5
STAT,1878,114,na,1992,4.671779983954973E-4
SIM,1982,27,na,2009,6155
STAT,1972,41,30-34,2013,0.19660045926703132
STAT,1951,49,35-39,2000,0.1832139964056236
STAT,1814,78,na,1892,487.17539245104456
STAT,1926,41,50-100,1967,0.1673453608545857
STAT,1921,12,na,1933,5210.2880067223105
STAT,1855,38,na,1893,1994.7472065431211
STAT,1927,43,30-34,1970,0.18470380982541534
STAT,1907,39,35-39,1946,2.566086541445505
SIM,1915,39,35-39,1954,6
SIM,1847,27,40-44,1874,1
SIM,1888,15,35-39,1903,2
SIM,1961,47,35-39,2008,1
SIM,1873,85,na,1958,351
STAT,1908,30,15-19,1938,0.1412887223846252
STAT,1957,53,na,2010,5690.688200832601
SIM,1877,15,15-19,1892,17
SIM,1945,32,35-39,1977,26
SIM,1825,36,na,1861,1780
SIM,1842,22,35-39,1864,15
SIM,1804,66,na,1870,756
SIM,1851,31,45-49,1882,6
STAT,1871,50,50-100,1921,0.01758904603225216
STAT,1990,20,25-29,2010,153.2699873303033
STAT,1956,32,50-100,1988,1.2869736266024803
SIM,1951,33,na,1984,6264
STAT,1953,47,35-39,2000,0.1872200616367684
STAT,1841,31,35-39,1872,11.038414376376075
STAT,1843,31,45-49,1874,2.1254529400489166
STAT,1886,42,20-24,1928,0.1930868595420763
STAT,1934,17,15-19,1951,70.87679591761106
STAT,1954,45,40-44,1999,0.23506455113423497
STAT,1889,18,40-44,1907,0.2595105662652354
STAT,1934,20,15-19,1954,8.28683686397571
STAT,1963,22,35-39,1985,13.850872150596269
STAT,1970,17,25-29,1987,62.603358577838826
SIM,1942,17,15-19,1959,53
STAT,1793,100,na,1893,0.19990424472443183
SIM,1971,22,35-39,1993,1
STAT,1988,16,30-34,2004,20.123768011900125
STAT,1933,29,35-39,1962,22.99326645789626
SIM,1941,29,35-39,1970,44
STAT,1975,23,na,1998,5576.28094475507
STAT,1843,39,40-44,1882,4.5702340795685235
SIM,1851,39,40-44,1890,11
STAT,1881,33,30-34,1914,19.352904186057604
STAT,1888,111,na,1999,0.015590719282065898
STAT,1915,23,50-100,1938,0.7826543511784065
SIM,1815,39,30-34,1854,3
SIM,1818,80,na,1898,588
STAT,1948,35,15-19,1983,0.026173667828115817
SIM,1878,41,25-29,1919,3
STAT,1890,30,35-39,1920,14.395168077694615
STAT,1983,10,na,1993,6414.617620930989
SIM,1846,15,30-34,1861,4
SIM,1946,44,45-49,1990,1
STAT,1856,53,na,1909,1865.3165622950955
STAT,1843,35,na,1878,2561.468600189172
STAT,1914,88,na,2002,945.3636437918786
STAT,1860,108,na,1968,0.019216452481985582
STAT,1860,39,na,1899,2169.2601421503155
SIM,1951,19,na,1970,6310
STAT,1796,93,na,1889,8.315452163939572
SIM,1830,37,na,1867,1995
SIM,1889,60,na,1949,3029
STAT,1817,41,50-100,1858,3.3445959357050126
STAT,1879,48,na,1927,2677.035537292555
STAT,1953,33,30-34,1986,22.40618176364197
STAT,1839,107,na,1946,0.003739986102007744
STAT,1850,49,25-29,1899,0.05805803423554572
STAT,1814,49,15-19,1863,0.0010761760869695883
SIM,1855,58,na,1913,1509
STAT,1938,44,45-49,1982,0.1963383545846755
SIM,1889,30,50-100,1919,1
SIM,1961,33,30-34,1994,26
STAT,1819,35,15-19,1854,0.23333892074148313
STAT,1896,16,30-34,1912,2.435479966570376
STAT,1891,22,35-39,1913,8.323251307950683
SIM,1936,22,40-44,1958,6
SIM,1925,19,50-100,1944,3
STAT,1899,43,45-49,1942,0.16313326464980557
SIM,1977,26,na,2003,5959
STAT,1849,15,50-100,1864,0.04729608123263573
STAT,1885,50,20-24,1935,8.616324453276297E-4
SIM,2012,1,na,2013,7652
SIM,1942,20,15-19,1962,9
SIM,1909,86,na,1995,1777
STAT,1949,47,25-29,1996,0.07405458037643475
STAT,1847,32,50-100,1879,0.8277705447309007
STAT,1887,99,na,1986,34.17906164925706
STAT,1914,40,40-44,1954,0.28816153875908757
SIM,1981,2,na,1983,6483
STAT,1882,36,15-19,1918,0.06360292237545233
SIM,1959,46,40-44,2005,3
STAT,1884,49,na,1933,2511.7538326775507
STAT,1871,84,na,1955,381.9393816068555
STAT,1979,22,15-19,2001,8.486394205915687
SIM,1885,43,25-29,1928,2
STAT,1950,17,na,1967,5022.558700681853
STAT,1882,46,50-100,1928,0.2776300152264526
STAT,1969,28,40-44,1997,6.74529474394937
SIM,1892,58,na,1950,3216
SIM,1933,14,na,1947,6592
STAT,1831,29,50-100,1860,0.6573137445790715
STAT,1902,33,na,1935,3874.7648452515864
SIM,1987,22,15-19,2009,8
STAT,1868,56,na,1924,2261.4801640880014
STAT,1877,43,25-29,1920,0.7653055283656399
SIM,1919,27,40-44,1946,14
STAT,1850,46,20-24,1896,0.012388426411880238
SIM,1889,27,45-49,1916,3
STAT,1850,15,na,1865,2921.9085720809157
STAT,1889,26,na,1915,3406.645348280194
SIM,1976,29,50-100,2005,2
STAT,1953,36,35-39,1989,3.4820089988473453
STAT,1772,83,na,1855,16.186
SIM,1973,12,na,1985,5489
SIM,1905,48,na,1953,3834
STAT,1895,16,15-19,1911,8.936729535811912
SIM,1818,52,50-100,1870,1
SIM,1818,66,na,1884,1598
STAT,1865,23,45-49,1888,0.7296398625177114
SIM,1942,72,na,2014,3609
SIM,1909,32,25-29,1941,23
STAT,1834,22,35-39,1856,7.1222241453785085
STAT,1817,64,na,1881,1364.8411174360606
SIM,1860,67,na,1927,1636
STAT,1975,39,35-39,2014,3.785775634259251
STAT,1832,43,na,1875,1719.5479487568286
STAT,1989,5,na,1994,6499.22535977899
SIM,1975,29,35-39,2004,32
STAT,1817,42,15-19,1859,0.042581017829852456
STAT,1876,51,na,1927,2580.9736996577317
SIM,1873,23,45-49,1896,2
SIM,1969,18,40-44,1987,1
STAT,1849,83,na,1932,307.692003561996
STAT,1954,15,45-49,1969,0.7130562121969318
SIM,1948,13,na,1961,4465
STAT,1840,39,15-19,1879,0.05218482769839379
SIM,1846,18,35-39,1864,1
STAT,1854,19,30-34,1873,1.535096009370433
STAT,1863,33,na,1896,2397.8887563510502
STAT,1959,30,na,1989,5826.205953114469
STAT,1921,1,na,1922,5491.4455676895195
STAT,1856,23,25-29,1879,58.11674709535003
SIM,1937,23,50-100,1960,5
STAT,1886,83,na,1969,894.6681238328732
SIM,1896,94,na,1990,532
STAT,1915,46,30-34,1961,0.10394288584961191
SIM,1878,26,30-34,1904,62
STAT,1940,30,40-44,1970,4.680832103357194
SIM,1864,23,25-29,1887,75
STAT,1956,38,50-100,1994,0.6598754415445454
STAT,1839,33,45-49,1872,1.6842842865691636
SIM,1962,15,45-49,1977,1
STAT,1887,21,30-34,1908,23.106586520660496
SIM,1814,44,na,1858,1467
STAT,1937,17,40-44,1954,1.5711840746229744
STAT,1849,16,45-49,1865,0.062690009752234
STAT,1909,12,na,1921,4474.505700892067
STAT,1865,14,na,1879,2789.3287576874727
STAT,1961,43,20-24,2004,0.0273214950571934
STAT,1929,23,50-100,1952,0.957347582567934
STAT,1856,46,15-19,1902,3.5317931783365833E-4
STAT,1965,40,na,2005,5576.253162498835
SIM,1898,34,35-39,1932,21
SIM,1895,21,30-34,1916,1
STAT,1863,47,45-49,1910,0.23703973058955918
STAT,1964,38,20-24,2002,0.39435212139468756
SIM,1930,49,na,1979,5901
SIM,1863,43,30-34,1906,2
SIM,1991,23,na,2014,6262
STAT,1893,44,20-24,1937,0.0158700428053616
SIM,1978,23,50-100,2001,1
STAT,1860,32,50-100,1892,0.8522079168666242
SIM,1915,36,30-34,1951,2
SIM,1910,32,30-34,1942,1
STAT,1828,29,30-34,1857,33.16710604475743
SIM,1987,23,50-100,2010,3
STAT,1878,15,25-29,1893,6.85988055489028
SIM,1966,21,15-19,1987,1
STAT,1817,41,45-49,1858,4.7381775891599585
STAT,1927,46,35-39,1973,0.18719356931343542
STAT,1807,52,40-44,1859,0.04134765064338772
STAT,1834,45,25-29,1879,0.06284981778500326
STAT,1834,84,na,1918,303.5886261810324
SIM,1837,21,15-19,1858,7
STAT,1854,51,30-34,1905,0.004872727244638081
STAT,1818,60,na,1878,980.6266925169615
SIM,1883,22,na,1905,2493
STAT,1819,45,na,1864,1841.5509368775438
SIM,1839,50,na,1889,1850
SIM,1956,3,na,1959,5523
STAT,1917,63,na,1980,3978.675904172068
STAT,1902,32,30-34,1934,28.47030429298296
STAT,1951,42,na,1993,5304.066490669857
SIM,1930,34,40-44,1964,8
SIM,1820,59,na,1879,1594
STAT,1901,39,40-44,1940,1.51195461849395
STAT,1939,7,na,1946,4609.478089838839
STAT,1897,45,50-100,1942,0.21591532429424037
SIM,1872,39,50-100,1911,2
STAT,1787,82,na,1869,131.65224755832907
STAT,1900,108,na,2008,0.2844322562725448
SIM,1938,35,na,1973,4080
STAT,1958,21,15-19,1979,8.0978786528087
SIM,1812,61,na,1873,947
SIM,1836,29,30-34,1865,28
STAT,1852,48,40-44,1900,0.15938154150343048
STAT,1838,18,35-39,1856,0.6242346404100663
STAT,1907,36,30-34,1943,1.96265363054534
STAT,1911,42,25-29,1953,0.07872240166475412
SIM,1949,29,na,1978,5845
STAT,1869,101,na,1970,5.138990233686516
STAT,1966,28,15-19,1994,1.021486070159106
STAT,1862,20,15-19,1882,3.3368849933956257
SIM,1966,18,15-19,1984,61
STAT,1902,33,50-100,1935,1.4877507508254217
STAT,1868,26,20-24,1894,13.052091544109834
SIM,1971,6,na,1977,5819
SIM,1892,40,50-100,1932,3
SIM,1935,46,35-39,1981,1
STAT,1928,25,45-49,1953,2.4728904285237414
STAT,1936,43,40-44,1979,0.2855696870744677
STAT,1913,29,50-100,1942,1.1369744822632755
SIM,1898,21,na,1919,3560
STAT,1883,16,45-49,1899,0.07393628030293739
STAT,1979,23,50-100,2002,1.0486519990711471
SIM,1841,23,50-100,1864,1
STAT,1951,13,na,1964,5397.291954869577
SIM,1944,43,40-44,1987,1
STAT,1950,46,25-29,1996,0.07547623719220742
SIM,1907,24,45-49,1931,2
STAT,1788,98,na,1886,0.9041491319386104
SIM,1850,23,50-100,1873,1
SIM,1961,36,35-39,1997,9
STAT,1842,23,50-100,1865,0.3929587217955648
SIM,1876,42,na,1918,2581
STAT,1906,33,45-49,1939,1.6779524108557249
STAT,1924,80,na,2004,2566.7181636673236
STAT,1988,19,35-39,2007,6.921275050189722
STAT,1799,109,na,1908,3.195768837262255E-4
STAT,1917,24,30-34,1941,35.032434274396124
STAT,1812,54,30-34,1866,0.012667849336094574
STAT,1854,72,na,1926,1028.8766693084121
STAT,1966,31,15-19,1997,0.1889186781117577
SIM,1936,25,45-49,1961,2
STAT,1830,62,na,1892,1146.5665834519305
STAT,1798,74,na,1872,414.1779162934781
STAT,1935,72,na,2007,4434.925627853571
STAT,1958,18,15-19,1976,68.76712331936686
SIM,1925,24,30-34,1949,54
STAT,1912,16,25-29,1928,10.147306791152303
STAT,1913,31,35-39,1944,10.541044104813565
STAT,1835,69,na,1904,914.6521680564583
STAT,1905,21,35-39,1926,9.776560066313603
STAT,1868,40,50-100,1908,1.1831790921830638
SIM,1912,29,50-100,1941,3
STAT,1822,43,35-39,1865,3.602444222288109
SIM,1863,24,na,1887,2478
SIM,1899,37,na,1936,4135
SIM,1909,40,na,1949,4721
STAT,1853,41,50-100,1894,1.0565828136644195
STAT,1867,54,20-24,1921,7.732348847905013E-4
SIM,1830,43,35-39,1873,2
SIM,1941,26,30-34,1967,6
STAT,1841,54,na,1895,1861.7165498065872
STAT,1860,35,25-29,1895,2.7033991771375954
STAT,1933,26,30-34,1959,60.094622533836265
STAT,1959,33,25-29,1992,14.213255208045323
STAT,1843,80,na,1923,620.6877433091544
STAT,1967,28,na,1995,5421.066160435635
STAT,1911,28,45-49,1939,1.9391383101400677
STAT,1783,75,na,1858,294.9998404887353
STAT,1941,36,30-34,1977,2.234587724558247
SIM,1921,31,35-39,1952,10
SIM,1906,75,na,1981,2211
SIM,1838,33,25-29,1871,18
STAT,1905,73,na,1978,2637.1061278836705
STAT,1904,29,50-100,1933,1.0525336970085344
SIM,1963,47,45-49,2010,1
STAT,1904,48,20-24,1952,0.011076765088217812
STAT,1896,19,35-39,1915,0.8319043336133598
SIM,1853,46,na,1899,2199
SIM,1900,23,15-19,1923,11
STAT,1950,24,15-19,1974,7.282768644292795
SIM,1950,36,50-100,1986,1
STAT,1891,47,15-19,1938,3.2032426054019606E-4
STAT,1945,28,na,1973,4740.752394718608
STAT,1932,47,20-24,1979,0.01730460797590312
SIM,1891,73,na,1964,1881
STAT,1968,25,20-24,1993,26.44818520512393
SIM,1866,46,25-29,1912,1
STAT,1914,43,45-49,1957,0.19010719495628395
STAT,1899,40,40-44,1939,0.2494460925864508
SIM,1887,69,na,1956,2606
SIM,1918,24,20-24,1942,260
STAT,1959,30,20-24,1989,3.7574990512609014
STAT,1866,40,45-49,1906,1.6170525784178202
STAT,1869,71,na,1940,1491.7842594260803
SIM,1975,26,30-34,2001,9
SIM,1979,30,35-39,2009,21
SIM,1884,19,15-19,1903,9
SIM,1845,30,30-34,1875,43
STAT,1867,71,na,1938,1438.2322158009688
SIM,1923,49,35-39,1972,1
SIM,1849,19,20-24,1868,39
STAT,1896,100,na,1996,29.79868427861514
STAT,1974,20,45-49,1994,1.702330780725358
STAT,1849,28,50-100,1877,0.5835106898871076
STAT,1836,18,25-29,1854,11.5836692602944
STAT,1867,17,15-19,1884,6.537005160186971
SIM,1949,8,na,1957,5903
STAT,1805,52,30-34,1857,0.021271625314157647
SIM,1879,41,40-44,1920,5
STAT,1820,84,na,1904,195.23992402051982
STAT,1949,35,30-34,1984,2.524557249773097
STAT,1921,47,45-49,1968,0.28264779087618935
STAT,1831,110,na,1941,2.168057651008977E-4
STAT,1878,34,na,1912,2850.7807516392672
SIM,1887,36,50-100,1923,3
SIM,1967,30,20-24,1997,4
SIM,1994,16,20-24,2010,234
SIM,1819,40,30-34,1859,2
SIM,1923,40,35-39,1963,2
SIM,1875,17,15-19,1892,15
STAT,1915,49,35-39,1964,0.14907883604126382
SIM,1879,38,40-44,1917,1
STAT,1852,41,na,1893,2188.927658114979
SIM,1849,27,na,1876,2953
SIM,1830,38,50-100,1868,1
SIM,1980,32,40-44,2012,9
STAT,1884,103,na,1987,4.451833158393496
STAT,1926,43,na,1969,5274.376435596681
STAT,1831,50,25-29,1881,0.003003942396837516
STAT,1837,30,30-34,1867,16.184399482457827
SIM,1887,34,na,1921,3685
STAT,1916,36,na,1952,4468.058486167127
STAT,1885,48,35-39,1933,0.15913037483572992
SIM,1912,60,na,1972,3378
STAT,1796,101,na,1897,0.1453406699665912
SIM,1957,35,30-34,1992,1
STAT,1992,23,50-100,2015,1.093200945714698
SIM,1929,25,35-39,1954,47
SIM,2011,2,na,2013,7169
STAT,1934,43,30-34,1977,0.20515397644255076
SIM,1844,18,25-29,1862,17
STAT,1918,48,na,1966,4498.228514017191
SIM,1902,53,na,1955,3604
STAT,1825,51,45-49,1876,0.01992091686109891
SIM,1892,36,25-29,1928,10
STAT,1928,55,na,1983,5239.767486377246
STAT,1955,47,45-49,2002,0.3463347734020467
STAT,1862,106,na,1968,0.11501341354900974
STAT,1940,40,50-100,1980,0.14350089182156184
STAT,1932,20,40-44,1952,5.1229446769331215
STAT,1965,42,35-39,2007,0.3015037452920212
STAT,1871,28,50-100,1899,0.7318624407931731
STAT,1920,52,na,1972,4605.806345394557
SIM,1779,90,na,1869,95
STAT,1859,1,na,1860,3387.584454854329
SIM,1880,30,25-29,1910,3
STAT,1827,42,na,1869,2177.294637225441
STAT,1860,52,45-49,1912,0.013426264439480085
STAT,1892,36,50-100,1928,1.7843965509616375
STAT,1940,33,45-49,1973,1.878901417542377
STAT,1892,30,45-49,1922,2.5425990995183487
SIM,1915,26,na,1941,4619
STAT,1891,43,40-44,1934,3.1850078231714347
STAT,1884,36,25-29,1920,3.2987219231348526
STAT,1972,32,40-44,2004,5.894097127482296
STAT,1912,42,40-44,1954,0.2786655654440869
STAT,1872,30,25-29,1902,11.964558430282976
SIM,1803,81,na,1884,329
STAT,1941,39,35-39,1980,2.956531499698526
STAT,1982,30,35-39,2012,15.143888493380997
SIM,1873,31,na,1904,3361
SIM,1865,34,na,1899,2952
STAT,1878,52,30-34,1930,0.007134374399307939
SIM,1881,42,35-39,1923,4
STAT,1865,99,na,1964,7.149741756223568
STAT,1868,29,25-29,1897,46.56722539836944
STAT,1968,46,35-39,2014,0.19378349762357344
STAT,1838,50,35-39,1888,0.007718715854055665
STAT,1951,33,20-24,1984,3.4146442222314723
STAT,1863,23,35-39,1886,5.962873464031704
STAT,1894,47,40-44,1941,0.1425990315769473
STAT,1874,47,20-24,1921,0.014111271768042045
STAT,1815,49,30-34,1864,0.19188993109762711
STAT,1897,28,40-44,1925,4.606284567348902
STAT,1991,20,40-44,2011,5.583172565279538
SIM,1886,19,na,1905,2297
STAT,1873,42,35-39,1915,2.1313983292023195
SIM,1798,94,na,1892,7
STAT,1841,52,40-44,1893,0.009310201260555682
STAT,1911,25,40-44,1936,5.285835870890022
STAT,1980,31,20-24,2011,3.9855675592373365
STAT,1910,20,na,1930,4164.775279418456
SIM,1940,25,na,1965,4664
STAT,1977,36,40-44,2013,2.4070400073114513
SIM,1864,43,50-100,1907,4
STAT,1836,51,20-24,1887,6.933331887492035E-4
SIM,1970,44,40-44,2014,2
STAT,1888,41,35-39,1929,2.4676190745167843
STAT,1941,30,35-39,1971,11.087868685143652
STAT,1966,47,20-24,2013,0.016568956620762382
STAT,1915,40,35-39,1955,0.2346519650418006
STAT,1868,41,15-19,1909,0.015381174658402845
SIM,1938,19,15-19,1957,44
STAT,1858,15,50-100,1873,0.052134828346099345
STAT,1986,16,20-24,2002,223.00176182708984
STAT,1851,41,45-49,1892,1.192198037016466
SIM,1876,71,na,1947,1524
STAT,1927,77,na,2004,3222.0782844473865
SIM,1819,65,na,1884,426
STAT,1845,61,na,1906,1259.1892504122186
STAT,1822,40,30-34,1862,2.4803267286984942
SIM,1869,31,30-34,1900,33
SIM,1810,44,50-100,1854,3
STAT,1962,44,40-44,2006,0.383086042080316
SIM,1860,19,20-24,1879,1
SIM,1899,18,15-19,1917,20
STAT,1881,53,50-100,1934,0.016541386375311516
STAT,1957,45,20-24,2002,0.017572489056535027
STAT,1897,114,na,2011,8.737938598402926E-4
STAT,1992,19,na,2011,6093.038496247862
STAT,1852,19,20-24,1871,19.978352486873586
STAT,1894,70,na,1964,2358.759987052528
STAT,1847,104,na,1951,0.05132263681627682
STAT,1909,42,25-29,1951,0.07716706289521122
STAT,1907,85,na,1992,1245.260778292728
STAT,1858,46,25-29,1904,0.052003703219946025
STAT,1830,103,na,1933,0.0900293940266984
STAT,1930,38,20-24,1968,0.39646235052861367
SIM,1871,23,35-39,1894,6
STAT,1897,31,40-44,1928,6.719482189605414
STAT,1852,22,20-24,1874,77.18325036740379
SIM,1962,25,na,1987,5319
STAT,1853,17,50-100,1870,0.05867585078640065
STAT,1917,19,50-100,1936,0.4612785810364876
SIM,1916,89,na,2005,100
SIM,1929,24,50-100,1953,2
STAT,1841,16,40-44,1857,0.21097627175979866
SIM,1959,54,na,2013,5650
STAT,1867,4,na,1871,3226.368839245579
SIM,1904,63,na,1967,3419
STAT,1964,17,na,1981,5350.053456694047
STAT,1831,42,30-34,1873,1.1018462482484022
STAT,1960,34,50-100,1994,1.265115961558354
STAT,1821,47,40-44,1868,0.3098097221654949
STAT,1925,43,20-24,1968,0.02462806124573856
STAT,1921,48,15-19,1969,4.7773185216789924E-4
STAT,1899,17,na,1916,3993.1611803929673
STAT,1906,30,40-44,1936,4.224273583534499
STAT,1877,40,20-24,1917,0.19256998785644375
STAT,1852,46,50-100,1898,0.23221240620033193
STAT,1960,33,30-34,1993,24.123856704869265
SIM,1914,30,40-44,1944,9
SIM,1952,18,na,1970,4149
SIM,1933,46,25-29,1979,1
STAT,1830,30,20-24,1860,3.0422255147220145
STAT,1931,0,na,1931,6806.6549254866695
SIM,1810,51,na,1861,1376
SIM,1955,47,na,2002,6407
STAT,1851,42,15-19,1893,0.01093764083493862
STAT,1815,41,35-39,1856,4.1802256950524095
SIM,1951,36,40-44,1987,4
STAT,1826,29,20-24,1855,20.31294944431977
STAT,1812,45,40-44,1857,0.41035176119898026
STAT,1935,32,25-29,1967,14.764912552333767
STAT,1868,53,50-100,1921,0.016476573704937422
STAT,1938,41,40-44,1979,0.2964856712899466
SIM,1861,42,25-29,1903,1
SIM,1943,32,25-29,1975,2
STAT,1870,60,na,1930,2169.844444007551
SIM,1861,12,na,1873,2225
SIM,1816,54,na,1870,1462
SIM,1860,22,20-24,1882,76
SIM,1854,40,25-29,1894,2
STAT,1943,36,40-44,1979,1.8893017216651866
STAT,1833,57,na,1890,1414.1244805200347
SIM,1869,15,na,1884,2182
SIM,1970,39,na,2009,5964
STAT,1917,5,na,1922,4977.092831347858
STAT,1914,46,15-19,1960,4.2286364251678494E-4
STAT,1878,88,na,1966,386.515414910118
STAT,1933,25,50-100,1958,1.5272169884116658
STAT,1837,33,35-39,1870,9.09943102664652
SIM,1972,30,25-29,2002,3
STAT,1913,40,25-29,1953,0.08131854585013323
STAT,1838,34,na,1872,2284.778412542101
STAT,1925,46,25-29,1971,0.07434061241823728
SIM,1918,27,25-29,1945,159
STAT,1932,8,na,1940,6096.300679994458
STAT,1910,74,na,1984,2733.223961323079
STAT,1875,42,45-49,1917,1.7826887311742639
SIM,1845,33,35-39,1878,21
STAT,1888,95,na,1983,137.0397256517448
STAT,1882,37,na,1919,2655.6928057111645
STAT,1834,48,50-100,1882,0.23467097030829662
STAT,1974,7,na,1981,5923.16450269235
SIM,1842,48,50-100,1890,1
STAT,1791,87,na,1878,63.3368117138143
SIM,1823,41,35-39,1864,2
SIM,1878,52,na,1930,2545
SIM,1944,44,50-100,1988,1
STAT,1841,39,30-34,1880,5.46810921632942
STAT,1828,27,na,1855,1900.455415564551
STAT,1922,40,35-39,1962,0.26735674638888995
STAT,1936,44,50-100,1980,0.13389317171765663
SIM,1774,84,na,1858,208
STAT,1917,46,40-44,1963,0.19052555120897205
STAT,1897,34,45-49,1931,2.6679121524435456
STAT,1884,45,15-19,1929,4.6063501237568195E-4
STAT,1836,54,25-29,1890,0.0031360272312385396
SIM,1949,18,20-24,1967,201
STAT,1915,24,20-24,1939,131.8401556197126
STAT,1936,17,25-29,1953,47.90863887483396
SIM,1913,45,na,1958,4490
STAT,1939,47,30-34,1986,0.1071576048733411
SIM,1904,34,na,1938,4075
STAT,1846,40,25-29,1886,0.6893255972322874
SIM,1890,41,40-44,1931,10
STAT,1876,19,15-19,1895,7.0418260994257125
STAT,1986,19,25-29,2005,71.21234530534764
STAT,1972,35,45-49,2007,1.0395776391703748
SIM,1797,79,na,1876,116
STAT,1986,22,25-29,2008,152.39353901116579
STAT,1832,72,na,1904,860.3980950380987
STAT,1918,95,na,2013,241.52901104820745
STAT,1912,45,45-49,1957,0.24241494741304126
SIM,1941,55,na,1996,3759
STAT,1858,50,50-100,1908,0.013792185560242663
STAT,1894,31,15-19,1925,0.21213073917938763
STAT,1962,47,45-49,2009,0.3342777519981826
STAT,1857,19,na,1876,2396.4519499192397
SIM,1813,46,45-49,1859,1
SIM,1840,53,45-49,1893,1
STAT,1882,41,40-44,1923,2.5468896306805338
STAT,1820,39,na,1859,1641.7488833821142
SIM,1903,38,na,1941,3812
SIM,1819,43,35-39,1862,4
SIM,1994,19,25-29,2013,74
STAT,1970,35,50-100,2005,0.6259634799373079
STAT,1921,44,40-44,1965,0.3239175292470345
STAT,1951,36,25-29,1987,1.395281360604227
STAT,1968,28,25-29,1996,95.23852504119242
SIM,1844,15,20-24,1859,40
SIM,1903,18,40-44,1921,1
STAT,1850,25,15-19,1875,0.5576175955280256
STAT,1847,52,35-39,1899,0.006589013625584137
STAT,1973,25,20-24,1998,27.386381455062743
STAT,1826,32,20-24,1858,2.543608281922699
STAT,1903,21,25-29,1924,94.38312461127475
SIM,1928,44,na,1972,5658
SIM,1834,32,20-24,1866,5
SIM,1852,16,na,1868,2402
STAT,1961,22,25-29,1983,138.17794670978296
STAT,1888,47,50-100,1935,0.331621443066959
SIM,1825,50,na,1875,1621
STAT,1819,108,na,1927,0.0012194011481266246
SIM,1834,29,20-24,1863,27
STAT,1766,98,na,1864,1.3694874046228465
STAT,1943,47,na,1990,4676.893468728601
SIM,1946,32,na,1978,4546
STAT,1951,23,50-100,1974,0.9069312740736175
STAT,1941,47,20-24,1988,0.013667187760690626
SIM,1885,88,na,1973,850
STAT,1863,20,30-34,1883,18.598890658786548
STAT,1954,39,na,1993,5517.979333314284
STAT,1874,41,na,1915,2742.963183490305
STAT,1968,43,30-34,2011,0.19120608909613535
STAT,1854,54,35-39,1908,0.006820900374914438
STAT,1969,22,50-100,1991,0.9517196651001596
STAT,1947,15,35-39,1962,5.457704334542872
STAT,1940,36,15-19,1976,0.023210646881748818
STAT,1963,39,na,2002,5670.735984981803
SIM,1937,36,na,1973,4363
STAT,1902,42,15-19,1944,0.001561819153717972
SIM,1829,72,na,1901,762
SIM,1917,81,na,1998,2034
STAT,1835,83,na,1918,247.42370086079123
STAT,1838,21,50-100,1859,0.4616839606540929
STAT,1885,33,na,1918,2735.3128121829072
STAT,1981,34,40-44,2015,6.428724348271886
SIM,1863,6,na,1869,3075
SIM,1878,29,35-39,1907,1
SIM,1923,24,20-24,1947,10
SIM,1852,61,na,1913,1424
SIM,1925,49,45-49,1974,2
STAT,1832,53,45-49,1885,0.01027431266246916
STAT,1890,88,na,1978,614.3451112632034
SIM,1863,53,na,1916,2101
STAT,1931,44,na,1975,5708.029702648367
STAT,1976,33,20-24,2009,3.830998363059931
SIM,1955,15,35-39,1970,9
SIM,1901,32,20-24,1933,9
STAT,1916,43,20-24,1959,0.020854965851609737
SIM,1953,43,na,1996,5588
STAT,1897,40,30-34,1937,0.1244396813496507
SIM,1927,29,na,1956,4830
STAT,1991,23,45-49,2014,1.8664365078790128
STAT,1849,52,45-49,1901,0.011188231447717068
SIM,1968,32,25-29,2000,6
STAT,1858,23,35-39,1881,5.445883021712091
STAT,1974,36,15-19,2010,0.029840483195213385
STAT,1924,34,15-19,1958,0.17274802779427148
STAT,1889,40,na,1929,3321.0747424925044
STAT,1964,31,40-44,1995,5.801377316707602
STAT,1880,26,50-100,1906,0.7851834362731173
STAT,1919,73,na,1992,3293.281298737114
STAT,1771,103,na,1874,0.06412192696663105
SIM,1874,40,45-49,1914,2
STAT,1880,44,35-39,1924,2.185162909483434
STAT,1865,53,40-44,1918,0.010785972625735139
STAT,1876,22,na,1898,2821.4529753502757
SIM,1879,44,45-49,1923,4
STAT,1887,45,40-44,1932,0.22362433118996838
SIM,1956,30,45-49,1986,4
SIM,1888,24,25-29,1912,6
STAT,1939,65,na,2004,3849.5060190860004
STAT,1861,23,na,1884,2314.3408154835547
SIM,1871,20,30-34,1891,16
SIM,1900,21,15-19,1921,1
STAT,1863,89,na,1952,106.01057635190261
SIM,1929,19,15-19,1948,112
STAT,1804,51,50-100,1855,0.07092875383098528
STAT,1824,35,15-19,1859,0.0903626786547595
SIM,1785,76,na,1861,499
SIM,1910,46,50-100,1956,1
SIM,1934,77,na,2011,2701
STAT,1948,30,45-49,1978,2.1207296395291477
SIM,1907,74,na,1981,2876
STAT,1856,51,40-44,1907,0.009313410342988982
STAT,1841,19,45-49,1860,0.07402506612659703
SIM,1805,62,na,1867,1217
SIM,1866,23,35-39,1889,15
STAT,1881,52,na,1933,2383.9944692800655
STAT,1932,29,na,1961,5658.3126827456335
SIM,1902,82,na,1984,1172
STAT,1841,22,45-49,1863,0.7853934247061533
STAT,1902,46,50-100,1948,0.2265467220676726
STAT,1953,19,50-100,1972,0.5226897776488247
STAT,1909,66,na,1975,3340.941067492909
STAT,1944,43,25-29,1987,0.09202346582092774
STAT,1854,109,na,1963,0.0028251911999812346
STAT,1956,11,na,1967,5999.476288040057
SIM,1821,55,na,1876,1257
SIM,1889,23,35-39,1912,16
STAT,1916,25,20-24,1941,21.931397776584276
SIM,1898,52,na,1950,3699
SIM,1901,38,30-34,1939,2
SIM,1918,16,35-39,1934,1
STAT,1941,17,25-29,1958,51.52486839343862
STAT,1897,98,na,1995,66.59679014514087
STAT,1825,84,na,1909,235.30207767482588
SIM,1936,31,na,1967,3995
SIM,1928,36,na,1964,5698
STAT,1848,17,45-49,1865,0.0860402193711743
STAT,1967,30,15-19,1997,0.18904127929238562
STAT,1951,39,30-34,1990,2.5749112234614633
SIM,1857,78,na,1935,700
SIM,1910,26,na,1936,3818
SIM,1970,29,35-39,1999,2
STAT,1961,48,45-49,2009,0.3361262927065399
STAT,1841,23,na,1864,2390.8830506021463
STAT,1856,76,na,1932,834.1408643766574
STAT,1962,29,35-39,1991,22.27410941351537
STAT,1931,15,45-49,1946,0.7582453172109018
SIM,1924,25,20-24,1949,24
STAT,1865,16,35-39,1881,0.5922507467827117
STAT,1922,24,35-39,1946,12.377882490780939
STAT,1920,2,na,1922,5293.153117218174
STAT,1872,15,na,1887,2971.2025853668238
SIM,1961,34,35-39,1995,2
SIM,1912,28,35-39,1940,20
SIM,1855,30,25-29,1885,13
STAT,1951,24,30-34,1975,39.60088859139131
SIM,1950,15,20-24,1965,154
STAT,1900,33,15-19,1933,0.22708298372388638
SIM,2007,4,na,2011,6952
STAT,1957,27,30-34,1984,59.8765983494102
STAT,1953,60,na,2013,4967.791174497659
SIM,1837,30,na,1867,2602
SIM,1793,94,na,1887,7
STAT,1942,36,50-100,1978,0.5222340883833605
SIM,1903,33,35-39,1936,28
STAT,1904,28,35-39,1932,15.934103254627894
STAT,1908,47,50-100,1955,0.23636114058488486
SIM,1837,34,50-100,1871,2
STAT,1847,30,25-29,1877,9.44773435567014
STAT,1903,4,na,1907,4324.2645436467155
STAT,1931,33,45-49,1964,2.3785750031890567
SIM,1905,79,na,1984,1352
STAT,1870,53,50-100,1923,0.016906875709794354
SIM,1906,29,20-24,1935,19
STAT,1925,59,na,1984,4829.4965174219005
STAT,1859,17,20-24,1876,18.918473086575965
STAT,1902,29,40-44,1931,4.849738900739752
SIM,1826,78,na,1904,322
STAT,1928,42,30-34,1970,0.18808280596590157
SIM,1920,32,25-29,1952,7
SIM,1888,22,na,1910,3016
STAT,1848,18,50-100,1866,0.0641500818593086
SIM,1907,26,30-34,1933,97
STAT,1798,97,na,1895,1.3664825198336163
STAT,1909,48,35-39,1957,0.13649550552183112
STAT,1873,20,25-29,1893,67.8658972893508
SIM,1852,47,na,1899,1811
STAT,1949,34,15-19,1983,0.17558121933055562
STAT,1843,54,25-29,1897,0.0034562559769991965
STAT,1870,46,40-44,1916,0.1953313927283885
STAT,1963,26,45-49,1989,2.5450503971377563
STAT,1811,43,25-29,1854,2.402076157260455
STAT,1980,24,40-44,2004,5.400906038597821
STAT,1877,113,na,1990,0.0012777268308232564
STAT,1912,32,25-29,1944,10.505740576090794
SIM,1867,60,na,1927,1821
STAT,1871,0,na,1871,4272.922876597646
SIM,1936,42,30-34,1978,1
STAT,1915,27,25-29,1942,77.49107106076453
SIM,1851,73,na,1924,1616
SIM,1834,73,na,1907,799
STAT,1888,19,40-44,1907,0.2467910172948439
STAT,1900,15,15-19,1915,9.547480332752816
STAT,1826,58,na,1884,1155.9940455417714
SIM,1954,54,na,2008,5242
STAT,1911,5,na,1916,4632.086761338893
SIM,1917,48,35-39,1965,1
STAT,1854,2,na,1856,2918.680761183444
SIM,1913,25,45-49,1938,3
STAT,1927,44,35-39,1971,0.29041325327825346
SIM,1867,17,20-24,1884,26
STAT,1905,25,45-49,1930,1.8671460612230515
SIM,1935,44,35-39,1979,1
STAT,1925,44,50-100,1969,0.16354344067370763
STAT,1864,71,na,1935,1375.4340500380729
STAT,1954,35,35-39,1989,3.561278587995532
STAT,1918,39,45-49,1957,0.8272949200137864
STAT,1998,15,40-44,2013,2.371329737479138
STAT,1912,21,50-100,1933,0.7306329721322203
STAT,1958,25,25-29,1983,100.28457475386352
STAT,1940,20,35-39,1960,11.080741774981309
SIM,1820,81,na,1901,669
SIM,1956,36,20-24,1992,1
STAT,1931,67,na,1998,4764.338034669805
SIM,1904,31,30-34,1935,37
SIM,1814,73,na,1887,519
SIM,1854,42,na,1896,2461
SIM,1942,21,20-24,1963,231
STAT,1796,62,na,1858,1045.535157723166
STAT,1874,21,25-29,1895,67.83685863523486
STAT,1913,19,45-49,1932,0.11729867901013535
SIM,1923,27,25-29,1950,194
STAT,1874,10,na,1884,3127.345901159386
SIM,1858,42,45-49,1900,4
STAT,1937,33,40-44,1970,4.467725593279633
SIM,1925,23,15-19,1948,9
STAT,1864,18,40-44,1882,0.19382061542154824
STAT,1893,88,na,1981,658.2051024393971
STAT,1782,82,na,1864,216.9339462355958
STAT,1905,43,45-49,1948,0.17234218514327296
SIM,1865,65,na,1930,2203
STAT,1961,44,25-29,2005,0.11028054063438139
SIM,1943,13,na,1956,5464
SIM,1966,25,25-29,1991,147
SIM,1926,39,45-49,1965,1
STAT,1934,21,20-24,1955,172.59449001220614
STAT,1829,34,25-29,1863,12.366911097812803
STAT,1948,36,20-24,1984,0.35899841105915575
SIM,1842,17,na,1859,2602
SIM,1881,3,na,1884,2399
SIM,1879,14,na,1893,3054
STAT,1952,37,25-29,1989,1.4028693881683358
STAT,1871,53,na,1924,2432.416239726466
SIM,1843,78,na,1921,370
SIM,1826,48,40-44,1874,1
STAT,1980,27,45-49,2007,2.779742046408632
STAT,1943,45,30-34,1988,0.11402045765822535
STAT,1942,15,20-24,1957,163.6216196070236
SIM,1965,46,na,2011,5479
STAT,1821,53,35-39,1874,0.014716637600231383
STAT,1873,88,na,1961,281.58573471022
SIM,1940,62,na,2002,4263
SIM,1965,27,30-34,1992,8
STAT,1841,15,na,1856,2663.450220455378
SIM,1865,103,na,1968,8
STAT,1887,104,na,1991,3.053640311590067
SIM,1837,34,25-29,1871,5
SIM,1916,31,20-24,1947,3
STAT,1918,77,na,1995,2731.5730845190346
STAT,1887,68,na,1955,1976.4530561199688
SIM,1892,1,na,1893,4198
SIM,1847,26,35-39,1873,18
SIM,1848,23,45-49,1871,1
STAT,1842,96,na,1938,6.60764965682291
SIM,1884,32,45-49,1916,1
STAT,1914,30,35-39,1944,10.7061752082492
SIM,1944,36,30-34,1980,2
STAT,1891,53,na,1944,3021.8751962712377
SIM,1863,78,na,1941,702
SIM,1921,19,45-49,1940,2
SIM,1848,22,na,1870,1813
SIM,1897,17,35-39,1914,1
STAT,1876,49,40-44,1925,0.19997364639098025
STAT,1903,41,15-19,1944,0.0015834868574547446
STAT,1889,17,35-39,1906,0.7805767648435393
STAT,1860,54,30-34,1914,0.005384267201800775
SIM,1884,49,40-44,1933,2
SIM,1874,30,na,1904,2611
SIM,1812,86,na,1898,59
STAT,1876,32,45-49,1908,2.0803430002223515
STAT,1891,39,50-100,1930,1.7335272591436592
STAT,1953,34,35-39,1987,12.98742972924928
STAT,1917,23,15-19,1940,6.509077791125872
SIM,1866,20,30-34,1886,46
SIM,1901,23,30-34,1924,31
STAT,1908,31,20-24,1939,2.671307045457528
SIM,1962,35,35-39,1997,1
STAT,1900,75,na,1975,2266.646486580525
STAT,1820,61,na,1881,1151.8203356022593
SIM,1959,28,na,1987,5735
STAT,1839,26,35-39,1865,9.709618280129208
SIM,1927,6,na,1933,5311
STAT,1903,45,35-39,1948,0.13110598121023123
SIM,1888,25,40-44,1913,10
STAT,1834,49,35-39,1883,0.13206720414644418
STAT,1858,20,30-34,1878,18.666305344744835
STAT,1911,67,na,1978,3375.4066272946948
SIM,1806,86,na,1892,55
SIM,1976,17,35-39,1993,7
STAT,1922,21,30-34,1943,38.13518498321778
STAT,1965,16,na,1981,5304.575548504382
STAT,1915,29,na,1944,4378.8717597400855
STAT,1957,28,15-19,1985,1.0782794494104626
SIM,1868,22,na,1890,3021
SIM,1930,21,30-34,1951,74
STAT,1950,40,15-19,1990,0.0021837708925476523
STAT,1960,24,na,1984,5503.330437701456
STAT,1934,22,50-100,1956,1.020992674813246
STAT,1899,93,na,1992,297.92245782598053
SIM,1911,45,35-39,1956,1
STAT,1968,17,35-39,1985,6.048381191383257
SIM,1963,13,na,1976,6578
STAT,1912,35,30-34,1947,2.07436572748191
SIM,1953,27,40-44,1980,2
STAT,1948,33,15-19,1981,0.1728845806401614
SIM,1940,56,na,1996,4738
STAT,1878,63,na,1941,2150.007322662356
SIM,1900,5,na,1905,3964
SIM,1905,31,45-49,1936,7
STAT,1908,47,na,1955,3839.1670691121153
STAT,1955,32,45-49,1987,2.457321266639551
SIM,1905,28,20-24,1933,24
STAT,1991,5,na,1996,6502.740408716211
STAT,1841,37,50-100,1878,1.2860887731570376
STAT,1920,26,25-29,1946,83.57599837498417
SIM,1963,32,45-49,1995,1
STAT,1944,40,20-24,1984,0.022857779431007322
STAT,1856,43,50-100,1899,0.9234330896568468
STAT,1947,40,45-49,1987,0.2254643021456624
STAT,1887,35,25-29,1922,3.759096703574575
STAT,1961,28,35-39,1989,22.471182552687207
STAT,1837,41,20-24,1878,0.13745139593103126
SIM,1879,34,30-34,1913,4
STAT,1936,11,na,1947,4386.973420849829
SIM,1881,20,25-29,1901,63
STAT,1913,31,50-100,1944,0.9537001907009838
SIM,1826,31,45-49,1857,3
STAT,1916,40,15-19,1956,0.0018213869684133178
SIM,1970,26,30-34,1996,118
STAT,1919,37,40-44,1956,1.8555317060030374
STAT,1933,40,45-49,1973,0.26474183425487874
SIM,1956,31,na,1987,5295
STAT,1919,19,40-44,1938,1.7738187038369806
STAT,1778,97,na,1875,1.2573466091280645
SIM,1856,31,25-29,1887,14
STAT,1893,45,25-29,1938,0.04786802373940847
STAT,1855,15,na,1870,2350.7246986824034
SIM,1908,27,30-34,1935,101
STAT,1876,76,na,1952,1130.2325260288083
STAT,1931,28,20-24,1959,27.189889000190185
STAT,1826,41,45-49,1867,1.1395562608025072
STAT,1830,31,na,1861,1767.582704634505
STAT,1915,44,45-49,1959,0.19275984333334045
STAT,1962,26,30-34,1988,58.215051781948716
SIM,1886,27,na,1913,2137
SIM,1927,19,40-44,1946,8
STAT,1819,76,na,1895,630.6983780802025
STAT,1914,67,na,1981,3534.7324517849906
SIM,1913,22,40-44,1935,14
STAT,1963,23,40-44,1986,4.944416708422561
STAT,1888,30,15-19,1918,0.1947394945389758
STAT,1908,18,25-29,1926,9.6878405718447
STAT,1965,37,20-24,2002,0.39128566603020115
STAT,1905,38,20-24,1943,0.2765313989826387
SIM,1808,81,na,1889,248
STAT,1868,33,na,1901,2634.698889680862
STAT,1963,27,50-100,1990,1.4656508776534714
STAT,1909,2,na,1911,4618.574424257974
STAT,1852,31,45-49,1883,1.7200361583477608
SIM,1945,48,na,1993,4618
STAT,1868,10,na,1878,2998.4394502279833
STAT,1931,30,40-44,1961,5.925648962324638
SIM,1931,21,45-49,1952,4
STAT,1839,76,na,1915,751.3382615025619
STAT,1848,31,25-29,1879,12.824045157447273
SIM,1971,27,50-100,1998,6
STAT,1902,31,25-29,1933,16.7701319824619
STAT,1905,22,40-44,1927,3.480632417665434
STAT,1884,71,na,1955,1521.9676727221713
STAT,1860,61,na,1921,1738.0341141944396
SIM,2004,7,na,2011,7405
SIM,1988,20,50-100,2008,1
SIM,1901,35,25-29,1936,2
SIM,1823,81,na,1904,583
SIM,1884,60,na,1944,2216
SIM,1907,82,na,1989,1795
SIM,1840,81,na,1921,129
SIM,1916,18,25-29,1934,13
SIM,1858,25,50-100,1883,1
STAT,1867,43,50-100,1910,1.130091752508881
STAT,1923,21,45-49,1944,1.5148647339562866
STAT,1838,28,40-44,1866,3.2776116748989264
STAT,1938,47,15-19,1985,4.364045126127729E-4
SIM,1860,31,45-49,1891,1
STAT,1967,19,40-44,1986,2.0149916592409887
SIM,1975,19,40-44,1994,5
SIM,1956,33,15-19,1989,1
STAT,1916,28,25-29,1944,78.27114105696032
SIM,1924,28,25-29,1952,14
SIM,1961,37,40-44,1998,4
STAT,1901,16,15-19,1917,9.616659703607503
SIM,1880,25,50-100,1905,4
SIM,1864,24,40-44,1888,3
STAT,1880,47,40-44,1927,0.20844257796692564
STAT,1953,37,40-44,1990,2.153089578677139
SIM,1902,36,25-29,1938,2
STAT,1863,31,20-24,1894,2.738831088084774
STAT,1856,24,40-44,1880,2.1003297847105356
STAT,1801,54,20-24,1855,0.0028175854619104865
STAT,1945,27,40-44,1972,5.901381965858253
SIM,1943,21,na,1964,5045
SIM,1846,28,40-44,1874,8
STAT,1887,22,50-100,1909,0.5274047205509104
SIM,1859,23,20-24,1882,133
STAT,1844,21,45-49,1865,0.7334990740078989
SIM,1848,21,25-29,1869,118
STAT,1897,24,30-34,1921,27.314664759218022
STAT,1960,42,na,2002,5801.342596789043
STAT,1895,0,na,1895,4410.941125355451
STAT,1917,30,50-100,1947,1.00721151024438
STAT,1834,46,30-34,1880,0.10427803561830301
STAT,1823,58,na,1881,1212.500545950577
STAT,1913,32,40-44,1945,4.495622504889481
STAT,1851,48,25-29,1899,0.04510257491214666
SIM,1904,34,35-39,1938,24
SIM,1851,20,50-100,1871,2
STAT,1884,40,50-100,1924,1.2167433469543794
STAT,1935,38,35-39,1973,3.9013609640046516
STAT,1812,66,na,1878,849.9980391223412
STAT,1821,50,30-34,1871,0.010800611882459617
STAT,1918,36,40-44,1954,1.8292971502677406
STAT,1773,103,na,1876,0.0975430763706674
STAT,1799,59,na,1858,1347.9102656935877
STAT,1960,16,na,1976,5534.01715098164
SIM,1966,22,20-24,1988,168
STAT,1924,7,na,1931,5491.927502968922
STAT,1921,23,35-39,1944,12.230995811255713
STAT,1829,31,20-24,1860,3.642665383277697
STAT,1968,2,na,1970,5672.287686347133
STAT,1843,20,50-100,1863,0.5210463687112281
STAT,1926,17,30-34,1943,17.242611296470326
STAT,1958,22,20-24,1980,169.09875575665242
SIM,1943,38,35-39,1981,11
STAT,1927,47,40-44,1974,0.2283432935418094
STAT,1985,26,na,2011,6178.247089356414
STAT,1923,18,20-24,1941,183.17299111514131
SIM,1891,42,na,1933,3321
STAT,1843,58,na,1901,1984.283670516514
SIM,1961,18,na,1979,5656
STAT,1924,19,20-24,1943,185.26826137028317
STAT,1901,37,na,1938,3838.447472092665
SIM,1921,8,na,1929,5566
SIM,1796,82,na,1878,227
STAT,1925,49,30-34,1974,0.12389322470289331
SIM,1914,64,na,1978,3461
SIM,1921,32,40-44,1953,5
SIM,1931,18,20-24,1949,3
STAT,1932,29,20-24,1961,27.57135038769679
SIM,1957,17,50-100,1974,1
SIM,1932,19,20-24,1951,424
SIM,1937,26,45-49,1963,5
SIM,1968,34,na,2002,5341
STAT,1905,40,40-44,1945,0.26352739745683346
STAT,1917,32,na,1949,4570.61112310146
STAT,1937,36,45-49,1973,0.7878421475725013
STAT,1843,89,na,1932,105.40870415683281
SIM,1819,73,na,1892,266
SIM,1940,29,20-24,1969,45
STAT,1958,40,20-24,1998,0.027895935447848314
SIM,1930,24,35-39,1954,1
STAT,1943,48,35-39,1991,0.1636768270431018
STAT,1966,32,20-24,1998,3.5838104021562156
SIM,1944,39,35-39,1983,1
STAT,1903,42,30-34,1945,0.13106991273352595
STAT,1850,91,na,1941,59.654150504278626
SIM,1945,36,45-49,1981,1
STAT,1896,48,50-100,1944,0.20851945409283634
STAT,1806,66,na,1872,797.1723606298988
STAT,1904,25,30-34,1929,42.01505071576714
STAT,1974,23,15-19,1997,8.045504347783405
STAT,1949,17,50-100,1966,0.5028519410597089
SIM,1937,38,50-100,1975,1
SIM,1892,27,na,1919,3770
SIM,1912,25,30-34,1937,1
STAT,1819,84,na,1903,221.458018207154
SIM,1960,13,na,1973,6317
SIM,1927,37,40-44,1964,1
STAT,1942,18,25-29,1960,52.25539374795229
SIM,1915,18,na,1933,4916
SIM,1933,34,30-34,1967,41
SIM,1837,31,20-24,1868,2
SIM,1951,48,35-39,1999,1
SIM,1950,18,25-29,1968,63
STAT,1883,15,40-44,1898,0.20747392835452155
SIM,1920,35,30-34,1955,2
SIM,1933,16,30-34,1949,27
STAT,1868,25,15-19,1893,0.5064635487074277
SIM,1915,49,na,1964,4456
STAT,1898,21,40-44,1919,3.2598879118292676
STAT,1848,33,na,1881,2662.955404450199
SIM,1931,56,na,1987,5808
STAT,1788,67,na,1855,1097.3125999999997
SIM,1935,47,40-44,1982,2
SIM,1934,17,30-34,1951,47
STAT,1925,34,30-34,1959,21.556472732665597
STAT,1929,38,50-100,1967,0.6214593063651906
STAT,1943,24,na,1967,4481.160902843301
STAT,1925,16,30-34,1941,17.028467638953476
STAT,1899,22,40-44,1921,3.2946485439283126
STAT,1975,24,15-19,1999,8.125636688650802
STAT,1936,39,35-39,1975,2.7361202356805228
SIM,1967,23,na,1990,4978
STAT,1911,34,30-34,1945,17.568542142954787
SIM,1911,24,30-34,1935,40
SIM,1868,15,15-19,1883,10
STAT,1901,21,50-100,1922,0.6611762975836512
STAT,1921,41,35-39,1962,0.2620226093799068
STAT,1989,21,25-29,2010,153.24071879401515
STAT,1808,92,na,1900,21.236583468398685
STAT,1898,24,45-49,1922,1.080790181177684
SIM,1956,37,50-100,1993,1
SIM,1905,15,45-49,1920,1
SIM,1900,24,20-24,1924,106
SIM,1930,42,50-100,1972,1
SIM,1978,5,na,1983,6040
STAT,1944,16,35-39,1960,5.2130144458349355
STAT,1814,109,na,1923,4.436083212873469E-4
SIM,1843,44,25-29,1887,1
STAT,1857,25,40-44,1882,2.81351716366158
SIM,1898,31,30-34,1929,40
STAT,1961,25,30-34,1986,58.72482924719423
SIM,1963,16,45-49,1979,1
STAT,1901,33,30-34,1934,28.104229331604476
STAT,1957,46,50-100,2003,0.3588554347057121
STAT,1955,16,45-49,1971,0.7655175240416956
STAT,1972,15,35-39,1987,6.203540296372538
SIM,1839,73,na,1912,1288
STAT,1814,52,40-44,1866,0.027985003537640198
SIM,1877,22,25-29,1899,3
SIM,1920,15,40-44,1935,2
STAT,1918,40,50-100,1958,0.14451746709393812
STAT,1912,38,35-39,1950,2.7134811832492836
SIM,1941,67,na,2008,3355
STAT,1970,16,40-44,1986,2.021193153282888
STAT,1762,107,na,1869,0.010481741966128392
SIM,1906,3,na,1909,4046
STAT,1869,22,25-29,1891,63.978171299833036
SIM,1920,38,35-39,1958,3
STAT,1822,96,na,1918,7.055027023234052
STAT,1950,25,20-24,1975,25.037726113745
STAT,1864,46,45-49,1910,0.24387465735261724
STAT,1837,44,25-29,1881,0.48669122286616023
STAT,1912,15,40-44,1927,0.3282367109577209
SIM,1885,100,na,1985,20
STAT,1893,16,50-100,1909,0.07164088188536723
SIM,1973,18,25-29,1991,86
STAT,1803,51,25-29,1854,0.01311281714787735
SIM,1978,33,na,2011,5886
STAT,2000,9,na,2009,6744.254125780819
STAT,1929,26,45-49,1955,2.496466503164121
STAT,1928,24,na,1952,5228.782684934337
STAT,1919,34,35-39,1953,11.277952956678757
STAT,1892,30,50-100,1922,1.3359418915001988
STAT,1889,33,35-39,1922,14.345657663106449
STAT,1860,36,30-34,1896,4.980945138643142
SIM,1897,33,35-39,1930,25
SIM,1964,36,50-100,2000,1
STAT,1802,96,na,1898,4.098906672314354
STAT,1841,15,35-39,1856,0.6366788168649068
STAT,1863,34,25-29,1897,10.247424119629486
STAT,1924,35,20-24,1959,0.35924994128811066
STAT,1890,36,45-49,1926,2.8245856381905705
STAT,1934,42,25-29,1976,0.11477184935513522
SIM,1916,15,20-24,1931,58
STAT,1812,97,na,1909,2.3585935201492587
STAT,1965,18,25-29,1983,62.41563132086966
SIM,1857,39,na,1896,2521
STAT,1858,47,30-34,1905,0.08674139775132278
SIM,1875,35,na,1910,3147
STAT,1950,43,20-24,1993,0.02500427870717361
STAT,1905,15,50-100,1920,0.08221243308146473
SIM,1986,21,15-19,2007,15
STAT,1944,26,40-44,1970,5.816589789329688
STAT,1835,44,25-29,1879,0.46803110339588994
STAT,1908,15,20-24,1923,30.529508316885178
SIM,1913,14,na,1927,5061
STAT,1896,40,15-19,1936,0.0014765140331006244
STAT,1875,91,na,1966,197.01841568259107
SIM,1847,91,na,1938,225
SIM,1865,25,40-44,1890,10
SIM,1889,109,na,1998,34
STAT,1918,17,na,1935,4866.355162413319
STAT,1902,46,25-29,1948,0.05313147841629378
SIM,1879,37,35-39,1916,16
STAT,1905,50,na,1955,3648.267027929693
STAT,1966,16,20-24,1982,195.4766421724849
SIM,1860,81,na,1941,1009
SIM,1974,16,20-24,1990,222
STAT,1907,17,25-29,1924,9.62196146898238
SIM,1843,47,na,1890,1729
STAT,1866,30,30-34,1896,18.826114239086216
STAT,1913,35,45-49,1948,0.784184755656151
STAT,1885,104,na,1989,2.6187608115261494
STAT,1785,70,na,1855,433.53000000000003
SIM,1854,73,na,1927,1565
STAT,1826,89,na,1915,57.843052435235286
STAT,1960,32,25-29,1992,14.16084836770721
STAT,1971,34,na,2005,5627.6531653069915
SIM,1964,32,50-100,1996,4
STAT,1945,24,35-39,1969,11.901385914205715
STAT,1833,21,35-39,1854,8.177437288277734
SIM,1910,16,30-34,1926,6
SIM,1928,32,30-34,1960,53
STAT,1802,53,30-34,1855,0.02324651870168444
SIM,1899,45,na,1944,3895
STAT,1851,45,20-24,1896,0.009610808128254692
SIM,1841,21,35-39,1862,14
STAT,1970,38,40-44,2008,2.2257558957118873
STAT,1971,17,40-44,1988,2.04445343365514
STAT,1800,61,na,1861,1273.780442440378
STAT,1840,42,40-44,1882,1.882223585945773
STAT,1897,27,35-39,1924,14.889587804746974
SIM,1884,91,na,1975,175
STAT,1926,12,na,1938,5605.137669161506
SIM,1953,24,35-39,1977,16
STAT,1902,16,30-34,1918,2.605391374625865
STAT,1793,74,na,1867,459.9727909889442
STAT,1884,2,na,1886,3575.735684673428
SIM,1835,22,20-24,1857,132
STAT,1935,35,30-34,1970,2.94781766869618
STAT,1939,48,15-19,1987,4.415686640051382E-4
STAT,1911,37,35-39,1948,2.698377941979051
STAT,1904,41,30-34,1945,0.1329032729453785
STAT,1916,22,15-19,1938,6.437895725949895
STAT,1854,10,na,1864,2355.684483011819
SIM,1924,22,15-19,1946,5
STAT,1901,15,30-34,1916,2.5884330646750047
STAT,1877,19,30-34,1896,1.9030915664029535
STAT,1861,34,25-29,1895,9.74269519545869
STAT,1998,13,na,2011,6654.974778026404
STAT,1941,26,50-100,1967,1.189105558527237
SIM,1943,35,30-34,1978,5
STAT,1947,22,45-49,1969,1.4675102492605452
SIM,1923,13,na,1936,5667
STAT,1854,36,50-100,1890,1.005052527243876
SIM,1958,15,25-29,1973,156
SIM,1955,22,45-49,1977,4
STAT,1820,46,50-100,1866,0.26650214261559574
STAT,1900,18,20-24,1918,28.315303194440155
SIM,1870,80,na,1950,1176
STAT,1921,21,15-19,1942,6.9570312062825534
STAT,1901,48,30-34,1949,0.0871561739692648
STAT,1973,28,15-19,2001,1.0577126336263392
SIM,1826,55,na,1881,1474
STAT,1945,42,35-39,1987,0.26381447805212804
STAT,1899,25,45-49,1924,1.7673771067259283
STAT,1936,42,na,1978,4246.937270583467
SIM,1981,28,15-19,2009,1
SIM,1948,26,20-24,1974,2
STAT,1853,88,na,1941,136.6821495230772
STAT,1962,43,35-39,2005,0.30894991640796093
SIM,1905,18,15-19,1923,18
SIM,1839,35,40-44,1874,12
SIM,1904,47,45-49,1951,1
STAT,1939,25,20-24,1964,21.20474976238062
STAT,1915,41,40-44,1956,0.2910818503563598
SIM,1779,82,na,1861,268
STAT,1831,23,25-29,1854,130.92981690375333
SIM,1860,44,30-34,1904,2
STAT,1942,30,15-19,1972,0.1581798121770353
STAT,1888,35,40-44,1923,5.994806908801371
STAT,1896,8,na,1904,3962.4521974158233
STAT,1930,31,30-34,1961,23.481458044291855
STAT,1892,19,50-100,1911,0.07048350902836717
STAT,1840,30,na,1870,2162.0065847056885
SIM,1838,34,40-44,1872,1
STAT,1898,63,na,1961,2945.300548945922
STAT,1976,11,na,1987,6057.332340841641
SIM,1895,35,25-29,1930,1
STAT,1942,45,15-19,1987,4.643548596154828E-4
SIM,1869,18,35-39,1887,1
SIM,1871,65,na,1936,1303
SIM,1994,15,15-19,2009,122
STAT,1833,88,na,1921,96.60285190223733
SIM,1954,25,35-39,1979,4
SIM,1885,65,na,1950,2257
SIM,1894,39,na,1933,3795
SIM,1904,94,na,1998,528
STAT,1946,25,35-39,1971,19.31700214820081
STAT,1827,27,50-100,1854,2.466164237798395
STAT,1986,15,15-19,2001,74.6675618358761
SIM,1881,72,na,1953,837
STAT,1933,27,15-19,1960,1.082238189578092
STAT,1886,21,15-19,1907,4.028063197561881
STAT,1955,29,20-24,1984,28.058317843429798
SIM,1869,15,30-34,1884,4
SIM,1860,0,na,1860,3725
STAT,1918,19,25-29,1937,54.13038978236844
STAT,1898,115,na,2013,3.0898950925281366E-4
SIM,1966,28,30-34,1994,111
SIM,1985,23,20-24,2008,178
SIM,1855,38,50-100,1893,2
STAT,1930,72,na,2002,4135.249756661857
STAT,1853,15,25-29,1868,6.867502373956047
STAT,1983,22,35-39,2005,15.422723053682738
STAT,1929,29,15-19,1958,1.0186614192615886
SIM,1870,48,35-39,1918,2
STAT,1864,43,40-44,1907,2.3010044545438757
SIM,1872,43,40-44,1915,7
STAT,1944,27,25-29,1971,82.10116637382433
STAT,1807,48,50-100,1855,1.0014703540723557
STAT,1820,37,40-44,1857,9.605977228841049
STAT,1977,23,20-24,2000,173.9008994644147
STAT,1958,28,30-34,1986,59.61852713951202
STAT,1855,91,na,1946,49.30753899318226
STAT,1897,21,25-29,1918,88.60433839594975
STAT,1936,36,30-34,1972,2.0679978184540095
SIM,1859,29,30-34,1888,33
STAT,1847,38,50-100,1885,0.9700349405395406
STAT,1839,23,30-34,1862,18.019950764414922
STAT,1908,24,na,1932,4028.530839139732
SIM,1902,22,na,1924,3908
SIM,1903,17,35-39,1920,2
SIM,1978,28,45-49,2006,6
SIM,1952,27,25-29,1979,90
STAT,1966,19,25-29,1985,62.4226016308803
STAT,1912,18,45-49,1930,0.11637951635320624
STAT,1889,30,30-34,1919,25.037306041978155
SIM,1878,4,na,1882,3316
SIM,1963,19,15-19,1982,69
SIM,1818,38,40-44,1856,13
SIM,1929,32,45-49,1961,1
STAT,1821,43,50-100,1864,1.9935579415605098
STAT,1826,28,15-19,1854,1.3153023592772533
SIM,1834,28,15-19,1862,1
STAT,1901,36,35-39,1937,2.4796452475974733
SIM,1922,30,35-39,1952,32
STAT,1955,19,15-19,1974,69.48123204959657
SIM,1897,30,30-34,1927,54
STAT,1798,66,na,1864,702.4507167362539
STAT,1901,18,35-39,1919,0.884654973699304
SIM,1967,41,na,2008,5644
SIM,1948,29,25-29,1977,68
SIM,1859,73,na,1932,644
STAT,1988,14,na,2002,6481.174436025308
STAT,1817,41,na,1858,2140.2655923594766
STAT,1851,49,40-44,1900,0.1329261344169951
STAT,1860,39,35-39,1899,6.5123749219056695
STAT,1835,41,20-24,1876,0.12029243803319156
SIM,1869,34,50-100,1903,2
STAT,1865,21,50-100,1886,0.43288389080714085
STAT,1836,28,40-44,1864,3.503501718341404
STAT,1965,25,50-100,1990,1.4415122063169317
SIM,1847,42,35-39,1889,2
STAT,1944,29,45-49,1973,2.1528108559464973
SIM,1901,69,na,1970,2896
SIM,1871,73,na,1944,609
STAT,1918,37,25-29,1955,1.1974129843034533
STAT,1864,40,na,1904,2405.628723485781
SIM,1923,79,na,2002,3338
SIM,1912,21,na,1933,3793
STAT,1919,31,30-34,1950,19.691975998150518
SIM,1844,28,40-44,1872,5
STAT,1852,18,15-19,1870,6.727292603023703
SIM,1927,31,30-34,1958,13
SIM,1867,91,na,1958,129
STAT,1961,5,na,1966,5862.319602069576
STAT,1861,52,25-29,1913,0.003380142212570493
SIM,1963,29,20-24,1992,3
SIM,1921,35,45-49,1956,1
STAT,1879,113,na,1992,0.0014073664723742846
SIM,1836,23,20-24,1859,109
SIM,1928,35,35-39,1963,9
STAT,1922,37,45-49,1959,0.8948137269430448
SIM,1938,21,35-39,1959,24
STAT,1901,107,na,2008,0.6170357621524231
SIM,1926,19,25-29,1945,130
STAT,1806,89,na,1895,36.05654462308433
STAT,1909,45,30-34,1954,0.09554986426466659
STAT,1986,29,40-44,2015,7.690094978168405
STAT,1958,43,50-100,2001,0.18476255407194042
STAT,1946,41,35-39,1987,0.26824525448883
STAT,1909,18,40-44,1927,0.3160711260722304
STAT,1920,35,50-100,1955,0.531198152813192
STAT,1839,42,35-39,1881,1.5135500277083278
STAT,1965,15,20-24,1980,195.43526424802337
STAT,1911,18,30-34,1929,2.809848897344832
SIM,1863,33,50-100,1896,3
SIM,1899,49,50-100,1948,1
STAT,1933,37,20-24,1970,0.4145494667784401
SIM,1952,29,45-49,1981,2
STAT,1934,24,25-29,1958,143.2294909558327
SIM,1873,21,50-100,1894,2
STAT,1890,33,40-44,1923,6.089485008553995
STAT,1840,92,na,1932,33.41122324384832
SIM,1857,47,na,1904,2392
SIM,1864,104,na,1968,2
STAT,1861,31,20-24,1892,2.6039320878641647
STAT,1902,43,20-24,1945,0.017853153781885792
SIM,1835,25,25-29,1860,7
SIM,1930,37,45-49,1967,1
STAT,1902,19,35-39,1921,0.8899421900654324
STAT,1912,32,na,1944,4298.91356509242
STAT,1967,32,50-100,1999,1.2149103818736746
STAT,1871,76,na,1947,1087.7391139618608
SIM,1900,95,na,1995,229
SIM,1942,24,25-29,1966,217
STAT,1913,16,40-44,1929,0.3310182093086335
STAT,1863,58,na,1921,1995.6137136848458
SIM,1947,28,25-29,1975,173
STAT,1862,18,40-44,1880,0.20281671425326137
STAT,1906,36,15-19,1942,0.02049535823028977
SIM,1915,37,50-100,1952,1
SIM,1879,31,25-29,1910,26
SIM,1793,63,na,1856,1293
SIM,1898,60,na,1958,3362
STAT,1996,18,45-49,2014,0.8375491119040432
STAT,1881,83,na,1964,720.3671892032726
STAT,1874,47,50-100,1921,0.28881068408448973
SIM,1939,37,30-34,1976,6
STAT,1910,34,15-19,1944,0.14191565161261732
STAT,1855,33,50-100,1888,0.7856232306602416
SIM,1837,20,30-34,1857,43
STAT,1882,68,na,1950,1722.6071982732176
STAT,1923,24,na,1947,4871.0764650485435
SIM,1849,21,40-44,1870,3
STAT,1907,47,20-24,1954,0.01144000629170909
STAT,1927,16,50-100,1943,0.5388023426662237
SIM,1882,32,50-100,1914,2
STAT,1823,89,na,1912,59.49053155906348
SIM,1882,47,50-100,1929,1
STAT,1884,37,30-34,1921,6.076896436032843
SIM,1932,35,20-24,1967,1
SIM,1806,78,na,1884,448
STAT,1897,67,na,1964,2703.0313121359873
SIM,1926,37,25-29,1963,3
SIM,1892,37,30-34,1929,9
STAT,1839,84,na,1923,263.8184719961446
STAT,1945,21,30-34,1966,36.36463634292244
STAT,1840,45,45-49,1885,0.1958687438230964
SIM,1921,16,40-44,1937,1
SIM,1953,21,30-34,1974,2
STAT,1917,36,25-29,1953,1.1859316903428303
STAT,1939,28,25-29,1967,76.35718956041858
STAT,1907,37,50-100,1944,0.4499590293999534
STAT,1894,26,50-100,1920,0.9522654846877083
STAT,1950,7,na,1957,5363.509619638969
SIM,1887,100,na,1987,5
SIM,1935,49,na,1984,6097
SIM,1842,42,50-100,1884,4
STAT,1902,87,na,1989,910.9009636636939
STAT,1907,37,15-19,1944,0.02058024926810445
SIM,2002,11,na,2013,6942
STAT,1834,42,50-100,1876,1.1622694859008462
SIM,1847,23,30-34,1870,3
SIM,1925,36,25-29,1961,1
STAT,1971,1,na,1972,5755.3780623859875
SIM,1889,28,50-100,1917,5
STAT,1887,22,15-19,1909,4.266703698060586
STAT,1928,16,na,1944,5365.349907446856
STAT,1855,43,30-34,1898,0.9711809326638073
STAT,1932,26,15-19,1958,1.067832268870966
STAT,1973,11,na,1984,5863.816329482772
STAT,1898,22,25-29,1920,89.28485424100552
SIM,1947,31,50-100,1978,1
SIM,1878,83,na,1961,696
STAT,1775,103,na,1878,0.07100511151835756
SIM,1884,9,na,1893,3012
STAT,1908,34,25-29,1942,9.994780754332657
SIM,1940,26,15-19,1966,1
STAT,1929,39,20-24,1968,0.38975157637086016
STAT,1939,31,50-100,1970,0.9745118560095205
STAT,1833,46,15-19,1879,3.362680251337857E-4
STAT,1946,22,30-34,1968,36.909953247076736
SIM,1848,20,40-44,1868,1
STAT,1874,50,45-49,1924,0.01739204169177513
STAT,1809,54,25-29,1863,0.008214217830685624
STAT,1886,75,na,1961,1473.8234119172896
STAT,1870,91,na,1961,128.7218586210398
STAT,1865,32,35-39,1897,10.544868967142973
SIM,1916,34,25-29,1950,15
SIM,1894,90,na,1984,799
SIM,1996,9,na,2005,6943
STAT,1932,44,15-19,1976,0.0023945668322925126
STAT,1901,32,15-19,1933,0.23019954661936362
SIM,1885,19,30-34,1904,1
STAT,1887,32,20-24,1919,3.4959280802380635
SIM,1895,32,20-24,1927,8
STAT,1866,33,35-39,1899,10.786823053073427
SIM,1844,38,50-100,1882,1
STAT,1970,19,45-49,1989,0.7211689765130394
STAT,1957,41,45-49,1998,0.2635491148525681
STAT,1967,3,na,1970,5670.737449374966
SIM,1853,77,na,1930,744
SIM,1971,39,45-49,2010,3
STAT,1867,30,45-49,1897,1.8940514860273319
SIM,1950,61,na,2011,4182
STAT,1948,37,50-100,1985,0.5712619153167913
SIM,1848,43,35-39,1891,1
SIM,1944,16,40-44,1960,1
STAT,1853,54,20-24,1907,7.144831581411814E-4
STAT,1813,52,25-29,1865,0.011247430981923656
SIM,1860,26,30-34,1886,45
SIM,1839,42,na,1881,2078
STAT,1944,24,20-24,1968,138.4644068952648
SIM,1845,17,35-39,1862,1
SIM,1896,38,45-49,1934,1
SIM,1860,9,na,1869,3014
STAT,1831,52,45-49,1883,0.011829839960872385
STAT,1927,25,30-34,1952,55.33350635716901
STAT,1986,26,35-39,2012,24.80605690505138
SIM,1804,74,na,1878,375
STAT,1836,38,50-100,1874,1.3577828746823353
SIM,1893,32,20-24,1925,7
STAT,1878,19,45-49,1897,0.07828860605475128
STAT,1954,48,35-39,2002,0.1907933158153022
STAT,1911,15,25-29,1926,10.062713076105062
STAT,1852,26,30-34,1878,27.853076061717292
STAT,1982,33,40-44,2015,6.47372962340444
STAT,1857,47,15-19,1904,3.5784784917452546E-4
STAT,1816,59,na,1875,1185.8379907907122
STAT,1888,38,45-49,1926,2.690900032006175
STAT,1820,48,30-34,1868,0.0974882595036375
STAT,1882,31,25-29,1913,11.59279993848309
STAT,1871,54,40-44,1925,0.011754685440319471
STAT,1865,107,na,1972,0.08923062579206498
SIM,1938,43,na,1981,4049
STAT,1843,35,20-24,1878,0.9218881733516413
STAT,1859,42,20-24,1901,0.14581782161428142
STAT,1902,24,15-19,1926,5.345804511204862
SIM,1830,29,na,1859,2013
SIM,1890,31,25-29,1921,29
STAT,1939,30,na,1969,4460.223402673993
STAT,1992,4,na,1996,6514.341179969931
STAT,1977,35,25-29,2012,1.5844719323510805
SIM,1969,39,na,2008,5723
SIM,1932,52,na,1984,5265
SIM,1882,32,45-49,1914,6
STAT,1833,24,40-44,1857,2.013174251799217
STAT,1979,29,50-100,2008,1.5868565419390501
SIM,1985,26,25-29,2011,2
SIM,1939,18,25-29,1957,62
SIM,1851,26,20-24,1877,17
SIM,1884,69,na,1953,1552
SIM,1935,25,30-34,1960,135
SIM,1864,36,45-49,1900,5
STAT,1940,39,20-24,1979,0.3176512162343594
STAT,1942,28,na,1970,4536.063394549456
STAT,1843,26,20-24,1869,14.591223867571102
STAT,1970,41,na,2011,5583.798727339051
SIM,1867,42,20-24,1909,1
STAT,1850,48,50-100,1898,0.2496551048166188
STAT,1835,91,na,1926,36.11620396111037
STAT,1968,37,na,2005,5586.912087264278
SIM,1895,22,15-19,1917,6
STAT,1851,20,40-44,1871,2.0019925690158824
SIM,1857,34,45-49,1891,4
SIM,1908,43,30-34,1951,1
STAT,1985,20,45-49,2005,1.854228049549464
SIM,1841,24,40-44,1865,3
STAT,1874,32,45-49,1906,2.0602339110301666
STAT,1837,17,35-39,1854,1.0591220606266138
STAT,1977,26,25-29,2003,103.12321692700014
SIM,1791,82,na,1873,217
SIM,1887,47,35-39,1934,1
STAT,1927,31,na,1958,5370.992490104421
SIM,1851,35,20-24,1886,2
SIM,1880,28,40-44,1908,6
STAT,1876,54,50-100,1930,0.017521798001559973
SIM,1907,51,na,1958,4184
SIM,1909,32,na,1941,4748
STAT,1893,29,25-29,1922,61.26484346064867
STAT,1960,25,15-19,1985,1.0666162921735443
STAT,1872,37,40-44,1909,5.072659917985536
STAT,1770,104,na,1874,0.01537607428693516
STAT,1796,85,na,1881,104.40006197479055
STAT,1841,46,na,1887,2035.288705878165
SIM,1941,24,45-49,1965,1
STAT,1968,35,15-19,2003,0.02856658866191241
STAT,1933,24,45-49,1957,1.7219897280137197
STAT,1974,39,20-24,2013,0.40838438619450934
SIM,1925,70,na,1995,3842
STAT,1914,49,20-24,1963,0.012580286379725875
STAT,1943,26,25-29,1969,80.94209929707424
SIM,1783,87,na,1870,95
STAT,1898,41,30-34,1939,0.12508099157655772
SIM,1972,37,40-44,2009,2
STAT,1963,39,45-49,2002,1.0275491817998983
SIM,1889,42,40-44,1931,4
SIM,1835,34,25-29,1869,4
STAT,1872,28,40-44,1900,3.4590472012635054
STAT,1879,47,35-39,1926,0.1679161430644585
STAT,1905,107,na,2012,0.6535738347463186
STAT,1936,16,40-44,1952,1.5501285861711323
SIM,1951,26,25-29,1977,145
SIM,1968,36,35-39,2004,5
STAT,1920,15,35-39,1935,1.0946241649402473
SIM,1893,0,na,1893,4058
SIM,1874,30,30-34,1904,31
STAT,1949,64,na,2013,4542.035236587894
STAT,1845,16,50-100,1861,0.0419733010057391
STAT,1910,41,25-29,1951,0.0784137795985192
STAT,1960,42,20-24,2002,0.02758639300804716
STAT,1865,50,35-39,1915,0.009093054975999578
SIM,1888,53,na,1941,2428
STAT,1866,83,na,1949,424.641851133979
SIM,1919,24,35-39,1943,1
STAT,1842,52,20-24,1894,5.648246450024777E-4
STAT,1962,20,20-24,1982,165.07837477784113
SIM,1880,37,40-44,1917,14
SIM,1952,24,20-24,1976,296
STAT,1892,46,25-29,1938,0.04712981390482014
STAT,1899,70,na,1969,2625.4722296607397
SIM,1932,38,25-29,1970,3
STAT,1934,35,15-19,1969,0.030650432133693336
STAT,1874,19,na,1893,2967.8684993098377
STAT,1825,30,40-44,1855,10.664856078747304
STAT,1933,47,35-39,1980,0.20470282196419057
SIM,1894,24,20-24,1918,198
SIM,1915,31,40-44,1946,6
STAT,1868,23,50-100,1891,0.4507476758816507
SIM,1802,93,na,1895,8
STAT,1839,45,40-44,1884,0.1419225454390119
STAT,1926,33,30-34,1959,21.967269450158614
SIM,1837,61,na,1898,1692
STAT,1809,77,na,1886,412.70282174267425
STAT,1837,72,na,1909,914.4977155362973
STAT,1964,37,40-44,2001,2.241714104876906
SIM,1953,20,na,1973,5038
SIM,1934,33,30-34,1967,22
STAT,1987,15,30-34,2002,20.091681420597336
SIM,1806,55,na,1861,1356
SIM,1812,47,35-39,1859,1
STAT,1788,110,na,1898,1.2542669591752916E-4
STAT,1850,24,50-100,1874,0.4966543458516827
SIM,1860,59,na,1919,2001
STAT,1867,39,25-29,1906,3.071078355142064
SIM,1926,34,20-24,1960,5
STAT,1892,23,35-39,1915,8.414557176772638
SIM,1874,39,na,1913,2576
STAT,1810,44,25-29,1854,2.842639814601789
SIM,1942,2,na,1944,5186
SIM,1877,48,50-100,1925,2
SIM,1833,30,40-44,1863,13
STAT,1938,72,na,2010,3223.080172893839
STAT,1928,23,25-29,1951,132.6799668009627
STAT,1907,31,40-44,1938,4.245478475059814
STAT,1920,48,35-39,1968,0.16394765772761138
STAT,1978,16,45-49,1994,0.7869820381696975
STAT,1835,110,na,1945,1.7222879589059206E-4
STAT,1851,49,50-100,1900,0.19069309923464828
SIM,1875,39,25-29,1914,8
STAT,1849,34,45-49,1883,1.3949566700098925
SIM,1852,24,15-19,1876,8
SIM,1944,27,50-100,1971,6
SIM,1993,20,45-49,2013,6
STAT,1978,24,20-24,2002,175.5874242785019
STAT,1818,109,na,1927,3.1479332763715705E-4
STAT,1816,109,na,1925,3.5135428800394893E-4
SIM,1883,21,40-44,1904,6
STAT,1851,22,na,1873,2024.786683495835
STAT,1945,50,na,1995,4773.934934802736
STAT,1886,24,20-24,1910,83.36279393410324
SIM,1861,24,25-29,1885,116
SIM,1936,23,25-29,1959,117
SIM,1837,23,35-39,1860,16
STAT,1915,20,na,1935,4395.327641356748
SIM,1821,38,45-49,1859,3
STAT,1957,38,20-24,1995,0.41281406554637795
STAT,1876,114,na,1990,4.177857398023859E-4
STAT,1844,24,15-19,1868,3.3959672983958282
STAT,1865,36,50-100,1901,1.2845475894627738
STAT,1861,46,na,1907,2164.6419113256175
STAT,1953,15,30-34,1968,17.025265399452426
SIM,1902,25,35-39,1927,24
SIM,1837,47,na,1884,2172
STAT,1855,53,45-49,1908,0.012150279228179125
STAT,1968,27,40-44,1995,6.747529708249242
SIM,1979,20,40-44,1999,5
SIM,1928,67,na,1995,4656
STAT,1895,15,30-34,1910,2.4054221458908107
STAT,1827,53,50-100,1880,0.018098062188488757
STAT,1853,24,25-29,1877,66.37822082142132
STAT,1918,34,20-24,1952,2.9649857619851323
SIM,1970,12,na,1982,6043
STAT,1904,68,na,1972,2987.373604394472
STAT,1910,82,na,1992,1737.6422637007922
STAT,1885,32,20-24,1917,3.111515952370837
STAT,1923,32,35-39,1955,12.08562186263239
SIM,1861,15,25-29,1876,4
SIM,1901,19,25-29,1920,23
STAT,1891,40,35-39,1931,2.608857964479842
SIM,1966,38,25-29,2004,7
STAT,1883,95,na,1978,103.10108013297872
SIM,1847,45,40-44,1892,1
SIM,1856,42,45-49,1898,4
SIM,1991,22,35-39,2013,24
SIM,1986,24,20-24,2010,9
STAT,1987,24,50-100,2011,1.0868895403628054
SIM,1828,32,25-29,1860,24
STAT,1939,45,45-49,1984,0.2624816117855263
SIM,1912,38,na,1950,3712
STAT,1899,47,20-24,1946,0.010652370637056645
SIM,1939,15,20-24,1954,166
STAT,1889,36,40-44,1925,6.257273316216017
SIM,1975,39,na,2014,6040
STAT,1810,54,na,1864,1485.7081810958832
STAT,1870,20,50-100,1890,0.4667212195730736
STAT,1956,42,na,1998,5893.962991004549
STAT,1823,32,30-34,1855,48.241681646293515
STAT,1925,36,na,1961,5214.133258859907
STAT,1862,48,35-39,1910,0.13463728849497428
STAT,1892,38,na,1930,3390.8637560076736
SIM,1956,17,15-19,1973,61
STAT,1977,32,20-24,2009,3.8768705215523225
SIM,1878,23,25-29,1901,149
SIM,1960,23,30-34,1983,101
STAT,1858,39,15-19,1897,0.050046350456917056
STAT,1952,23,30-34,1975,39.86647111663037
SIM,1831,32,30-34,1863,32
STAT,1911,36,na,1947,4217.347280880172
SIM,1811,56,na,1867,1458
SIM,1990,16,na,2006,5507
STAT,1899,38,20-24,1937,0.261755239187163
STAT,1838,53,40-44,1891,0.008974433028263725
STAT,1869,28,35-39,1897,10.745763912272928
STAT,1824,54,na,1878,1428.3741784748597
STAT,1888,7,na,1895,3534.3600145816868
STAT,1948,17,15-19,1965,59.936449444362886
SIM,1897,36,40-44,1933,4
SIM,1893,35,25-29,1928,1
STAT,1895,32,na,1927,3584.6973110748377
STAT,1905,28,15-19,1933,0.7551619202009943
STAT,1881,43,45-49,1924,1.6539192593806045
STAT,1960,45,25-29,2005,0.08332301065365459
STAT,1916,91,na,2007,590.7783895483028
STAT,1856,41,25-29,1897,0.5679449379656634
STAT,1943,55,na,1998,4530.114531530527
SIM,1933,30,45-49,1963,3
STAT,1839,15,45-49,1854,0.06857256060299462
STAT,1950,28,25-29,1978,90.15953597437941
STAT,1970,31,25-29,2001,13.618103907947903
SIM,1838,31,50-100,1869,1
STAT,1824,38,20-24,1862,1.155106663309604
STAT,1888,44,40-44,1932,3.0101235059879357
STAT,1848,42,45-49,1890,1.588263833072862
STAT,1843,29,25-29,1872,51.4880549517127
STAT,1893,17,20-24,1910,25.860937429137152
SIM,1822,37,50-100,1859,4
STAT,1975,31,40-44,2006,6.076575509987617
STAT,1962,40,30-34,2002,0.1970050601838671
STAT,2001,8,na,2009,6790.500709750104
STAT,1889,19,20-24,1908,25.08481393407315
SIM,1855,80,na,1935,247
SIM,1851,29,25-29,1880,54
SIM,1819,42,na,1861,1210
STAT,1953,18,35-39,1971,5.856176255986723
STAT,1863,43,25-29,1906,0.643326128645263
STAT,1879,44,30-34,1923,1.366672006594156
SIM,1977,6,na,1983,6245
STAT,1887,37,na,1924,3047.039491780383
STAT,1839,22,na,1861,2178.698572736524
SIM,1874,33,35-39,1907,5
SIM,1887,44,30-34,1931,5
SIM,1908,13,na,1921,4357
STAT,1885,35,25-29,1920,3.3457465632074492
STAT,1976,37,30-34,2013,2.8950382604762934
SIM,1985,15,na,2000,6010
SIM,1900,27,25-29,1927,8
STAT,1925,30,45-49,1955,2.158211497703028
STAT,1966,30,35-39,1996,13.442005661856173
SIM,1897,19,20-24,1916,1
SIM,1871,43,25-29,1914,2
STAT,1881,51,30-34,1932,0.006657658753139548
SIM,1889,100,na,1989,308
STAT,1908,37,30-34,1945,1.9717920339223247
STAT,1901,26,20-24,1927,19.028766894108013
STAT,1870,39,30-34,1909,6.0025622213509005
SIM,1880,4,na,1884,3846
STAT,1898,44,35-39,1942,0.19347722232524886
SIM,1918,43,na,1961,3785
SIM,1854,38,40-44,1892,8
SIM,1970,40,30-34,2010,1
SIM,1948,40,35-39,1988,1
SIM,1849,9,na,1858,3250
STAT,1925,50,na,1975,5089.586228378853
STAT,1908,45,15-19,1953,3.906115383602107E-4
STAT,1936,77,na,2013,2546.2565131322854
STAT,1916,33,50-100,1949,0.9810418697298222
STAT,1893,26,20-24,1919,17.171612404288634
STAT,1918,31,15-19,1949,0.15819981475510916
STAT,1910,47,50-100,1957,0.2437859038034528
SIM,1832,38,20-24,1870,1
SIM,1824,31,45-49,1855,2
STAT,1832,32,40-44,1864,3.938498766116883
STAT,1892,43,20-24,1935,0.22805322989304286
SIM,1914,33,na,1947,4054
SIM,1875,43,50-100,1918,5
STAT,1842,73,na,1915,914.005643914939
STAT,1984,21,na,2005,6007.2886946924455
SIM,1848,40,30-34,1888,3
STAT,1807,110,na,1917,1.35130432756476E-4
STAT,1907,107,na,2014,0.6716719453221547
SIM,1877,25,30-34,1902,8
SIM,1975,30,50-100,2005,4
SIM,1840,32,40-44,1872,4
STAT,1996,15,40-44,2011,2.3471325839862485
SIM,1929,32,na,1961,5208
STAT,1855,46,na,1901,1919.8147652738578
SIM,1854,22,50-100,1876,1
STAT,1909,44,50-100,1953,0.1253930261028806
SIM,1871,7,na,1878,2463
STAT,1846,47,40-44,1893,0.1761583889322943
STAT,1817,39,25-29,1856,9.585327942030256
STAT,1868,64,na,1932,1927.435529435805
STAT,1941,31,40-44,1972,4.745549826829686
STAT,1842,54,45-49,1896,0.010860565302978641
SIM,1861,18,30-34,1879,3
SIM,1888,20,15-19,1908,3
SIM,1977,22,30-34,1999,1
STAT,1863,8,na,1871,2827.652710122611
STAT,1960,17,30-34,1977,18.320721350730242
SIM,1905,70,na,1975,2966
STAT,1817,48,25-29,1865,0.16210184814773693
STAT,1848,50,30-34,1898,0.006415638061638729
STAT,1882,14,na,1896,2901.6188702254585
SIM,1948,23,15-19,1971,12
STAT,1984,28,25-29,2012,108.29782387708742
STAT,1846,38,40-44,1884,4.676954921411902
STAT,1992,22,45-49,2014,1.8699906428557924
STAT,1846,22,50-100,1868,0.5201547314630005
STAT,1931,18,15-19,1949,68.38837574608736
STAT,1933,21,40-44,1954,5.1648760012251405
STAT,1878,16,40-44,1894,0.2209313387346296
STAT,1924,38,25-29,1962,1.3381609409732595
SIM,1909,38,35-39,1947,6
STAT,1822,73,na,1895,975.8892877363643
STAT,1932,15,50-100,1947,0.5753232464807158
STAT,1853,18,30-34,1871,1.897677853306095
STAT,1892,20,30-34,1912,25.918022433178237
SIM,1831,35,35-39,1866,16
SIM,1909,18,na,1927,4973
SIM,1871,21,15-19,1892,7
STAT,1907,34,45-49,1941,1.6856304246287006
STAT,1946,38,45-49,1984,0.898075140766383
STAT,1987,18,35-39,2005,6.910930603286573
SIM,1976,17,na,1993,5678
STAT,1944,49,35-39,1993,0.16558213932178667
STAT,1811,81,na,1892,278.43617031251205
STAT,1779,93,na,1872,5.870401870068704
SIM,1970,20,20-24,1990,5
STAT,1876,19,50-100,1895,0.05813283991032688
STAT,2000,15,35-39,2015,7.205461643987275
SIM,1899,31,45-49,1930,6
STAT,1867,36,20-24,1903,0.8345783864986319
STAT,1886,27,25-29,1913,51.49399119617276
STAT,1930,34,35-39,1964,13.594370635082912
SIM,1817,92,na,1909,11
SIM,1985,29,30-34,2014,133
SIM,1812,44,30-34,1856,2
SIM,1878,30,50-100,1908,1
STAT,1926,36,35-39,1962,3.4138002945988637
SIM,1820,50,na,1870,1741
STAT,1951,20,45-49,1971,1.5524353657890813
SIM,1925,56,na,1981,5096
STAT,1839,48,45-49,1887,0.1882640755080427
STAT,1933,44,30-34,1977,0.20212799357037597
STAT,1959,44,50-100,2003,0.18368966591917457
SIM,1974,32,45-49,2006,3
SIM,1828,48,40-44,1876,1
SIM,1875,36,20-24,1911,2
STAT,1977,29,30-34,2006,61.300561574725876
SIM,1890,26,45-49,1916,1
SIM,1936,20,20-24,1956,272
SIM,1894,27,25-29,1921,75
SIM,1976,27,30-34,2003,123
STAT,1823,35,35-39,1858,14.992723761385735
STAT,1837,41,na,1878,1819.647189117536
STAT,1936,30,20-24,1966,2.7388773515477918
SIM,1960,26,35-39,1986,1
STAT,1821,46,25-29,1867,0.10569448117343318
SIM,1871,11,na,1882,2403
STAT,1891,76,na,1967,1777.7842168082034
STAT,1970,23,na,1993,5291.18598170706
STAT,1839,20,25-29,1859,59.17859612150906
SIM,1926,26,35-39,1952,33
SIM,1949,15,15-19,1964,72
SIM,1954,38,45-49,1992,3
SIM,1928,15,45-49,1943,4
STAT,1882,26,45-49,1908,1.2558453254468829
STAT,1875,24,45-49,1899,0.8264164108238846
STAT,1877,25,25-29,1902,51.12503769999149
STAT,1874,64,na,1938,2053.778744062876
STAT,1916,47,30-34,1963,0.10553095848022827
STAT,1989,16,45-49,2005,0.8259669091072294
SIM,1857,61,na,1918,1934
SIM,1838,37,45-49,1875,1
SIM,1887,91,na,1978,411
SIM,1885,25,25-29,1910,5
SIM,1978,30,20-24,2008,5
SIM,1901,16,20-24,1917,50
STAT,1958,36,15-19,1994,0.03001491793287256
SIM,1934,36,35-39,1970,6
STAT,1863,107,na,1970,0.06722868907966247
STAT,1975,15,na,1990,5606.813554292355
STAT,1863,21,15-19,1884,3.4199790648019746
SIM,1814,42,40-44,1856,7
STAT,1883,37,15-19,1920,0.06340368250883392
STAT,1952,26,35-39,1978,20.86243163472015
STAT,1948,47,na,1995,5046.681158033745
SIM,1944,30,20-24,1974,5
STAT,1896,115,na,2011,2.9692586742444154E-4
STAT,1994,17,30-34,2011,20.29855206645776
SIM,1935,28,35-39,1963,34
SIM,1972,34,35-39,2006,1
STAT,1898,31,50-100,1929,1.4348901663816658
SIM,1929,21,25-29,1950,283
SIM,1950,37,30-34,1987,4
STAT,1904,44,35-39,1948,0.20557684875457458
STAT,1959,39,na,1998,5838.65468946128
SIM,1851,38,25-29,1889,6
STAT,1850,28,20-24,1878,14.110049997012458
STAT,1980,35,30-34,2015,3.01344217378218
SIM,1839,28,na,1867,2446
SIM,1925,25,na,1950,5103
STAT,1943,29,30-34,1972,48.11521876262143
STAT,1928,20,20-24,1948,161.17167424168446
STAT,1843,38,25-29,1881,3.0373372260168394
STAT,1835,19,25-29,1854,7.930888661372728
STAT,1884,29,15-19,1913,0.5136237662597133
SIM,1809,66,na,1875,1063
SIM,1902,22,30-34,1924,35
STAT,1908,78,na,1986,2206.0258400858224
STAT,1933,17,na,1950,5688.769632342526
STAT,1859,45,25-29,1904,0.05347985918799432
STAT,1943,33,50-100,1976,1.0308283595553314
SIM,1834,36,30-34,1870,3
STAT,1875,46,20-24,1921,0.014351777556222947
STAT,1874,6,na,1880,3227.762644561495
SIM,1838,46,45-49,1884,2
SIM,1951,29,30-34,1980,5
STAT,1949,39,40-44,1988,2.065578267129266
STAT,1918,26,35-39,1944,18.498400191316964
STAT,1953,45,50-100,1998,0.3299832916250945
STAT,1827,28,30-34,1855,68.96663786595893
STAT,1844,49,30-34,1893,0.0792752075544799
SIM,1873,77,na,1950,951
SIM,1995,18,35-39,2013,8
STAT,1942,37,30-34,1979,2.264932432290636
SIM,1872,92,na,1964,64
STAT,1953,32,15-19,1985,0.1828661760791477
STAT,1969,15,na,1984,5309.099423016494
SIM,1990,15,50-100,2005,1
STAT,1927,28,35-39,1955,20.985094358219236
STAT,1958,23,na,1981,5551.62086283438
SIM,1886,10,na,1896,2392
STAT,1837,31,15-19,1868,0.1306421075467379
SIM,1957,39,40-44,1996,2
SIM,1867,77,na,1944,882
STAT,1934,27,30-34,1961,60.86013735872579
STAT,1838,26,na,1864,2400.83925487774
STAT,1853,3,na,1856,3383.7935351200003
SIM,1835,28,30-34,1863,4
SIM,1898,83,na,1981,1343
SIM,1942,27,30-34,1969,58
STAT,1920,45,30-34,1965,0.11420912357479732
STAT,1944,21,15-19,1965,6.635358203025999
STAT,1893,46,50-100,1939,0.20266296220727859
SIM,1900,19,na,1919,3834
STAT,1826,36,30-34,1862,4.373643627440515
SIM,1964,43,40-44,2007,1
SIM,1978,25,40-44,2003,15
SIM,1844,43,na,1887,2240
SIM,1865,11,na,1876,3444
STAT,1866,53,20-24,1919,7.76650782505652E-4
STAT,1894,19,na,1913,3726.742195200947
STAT,1935,47,50-100,1982,0.36870005416373225
STAT,1978,35,40-44,2013,2.4332301313205464
STAT,1917,39,30-34,1956,2.171449130105173
SIM,1855,35,na,1890,1810
STAT,1982,17,15-19,1999,73.69901252076752
STAT,1884,40,na,1924,2661.9154510650073
SIM,1957,17,30-34,1974,47
SIM,1968,17,40-44,1985,6
SIM,1932,16,15-19,1948,120
SIM,1969,20,15-19,1989,6
STAT,1892,45,45-49,1937,0.19447431117632244
STAT,1924,16,15-19,1940,62.50528527170086
STAT,1903,24,30-34,1927,29.09613066759626
STAT,1906,39,20-24,1945,0.2771796402778586
STAT,1938,54,na,1992,4238.725111869827
SIM,1833,22,50-100,1855,1
SIM,1927,37,na,1964,5011
STAT,1921,29,45-49,1950,2.205339064642561
STAT,1935,16,25-29,1951,68.57285502947978
STAT,1837,53,25-29,1890,0.002523705715469523
STAT,1927,42,15-19,1969,0.002222175576955861
SIM,1925,39,30-34,1964,1
STAT,1901,29,25-29,1930,67.89079543430314
STAT,1830,34,30-34,1864,18.158930638901865
SIM,1944,29,na,1973,4202
STAT,1949,17,30-34,1966,16.359453141853635
SIM,1780,76,na,1856,269
STAT,1967,38,na,2005,5581.865053139496
STAT,1803,54,50-100,1857,0.05263895734235188
STAT,1860,17,25-29,1877,6.078775520570325
STAT,1990,24,35-39,2014,15.60258029378876
SIM,1955,33,35-39,1988,26
STAT,1829,49,50-100,1878,0.24403967098107754
STAT,1833,49,20-24,1882,0.008833774143557236
STAT,1881,40,40-44,1921,2.528997979606486
STAT,1974,16,na,1990,5548.190587038472
STAT,1975,34,45-49,2009,2.4388645563712834
SIM,1929,43,35-39,1972,1
STAT,1940,65,na,2005,3904.3870120317038
SIM,1847,20,25-29,1867,109
STAT,1920,23,20-24,1943,142.15856824952903
SIM,1944,33,25-29,1977,21
STAT,1841,34,40-44,1875,4.582002287096406
SIM,1845,28,na,1873,2145
SIM,1910,71,na,1981,2305
SIM,1798,86,na,1884,45
SIM,1867,20,45-49,1887,1
STAT,1895,32,15-19,1927,0.2139236648492455
STAT,1852,4,na,1856,3039.3621574000003
SIM,1991,17,20-24,2008,236
STAT,1909,26,25-29,1935,73.54378696062238
SIM,1903,39,45-49,1942,2
STAT,1869,50,50-100,1919,0.017121516084787437
SIM,1919,49,50-100,1968,1
STAT,1947,33,35-39,1980,12.101548551436137
SIM,1829,43,30-34,1872,2
SIM,1884,15,na,1899,2922
STAT,1820,92,na,1912,24.444028016934244
SIM,1896,22,30-34,1918,65
SIM,1972,42,na,2014,5723
STAT,1983,17,20-24,2000,221.33331557340304
STAT,1853,21,20-24,1874,81.65256328547504
SIM,1958,34,30-34,1992,3
SIM,1813,42,25-29,1855,2
STAT,1880,28,35-39,1908,11.761420722126346
STAT,1869,42,15-19,1911,0.015414978574952257
SIM,1902,33,20-24,1935,3
SIM,1882,21,25-29,1903,2
STAT,1896,29,40-44,1925,4.533461671394696
SIM,1861,21,20-24,1882,73
STAT,1856,27,45-49,1883,1.0129817607227305
STAT,1873,26,35-39,1899,11.410187094733423
STAT,1959,20,15-19,1979,8.0678736292134
SIM,1857,1,na,1858,3677
STAT,1909,74,na,1983,2692.1194512391185
SIM,1864,27,45-49,1891,1
STAT,1888,33,na,1921,3223.5479334949164
STAT,1886,46,30-34,1932,0.11817027673027415
STAT,1894,29,40-44,1923,4.412274122598179
STAT,1871,17,35-39,1888,0.6340561247826657
STAT,1888,22,30-34,1910,24.16369082757502
SIM,1868,53,na,1921,2814
STAT,1919,88,na,2007,1033.1590689452253
STAT,1808,61,na,1869,1310.883207902384
STAT,1874,29,20-24,1903,13.76103005389996
SIM,1863,21,20-24,1884,152
SIM,1993,17,20-24,2010,441
STAT,1903,107,na,2010,0.6357118937371512
SIM,1960,34,20-24,1994,10
SIM,1967,20,15-19,1987,12
STAT,1921,92,na,2013,530.2634237235455
STAT,1836,36,25-29,1872,3.25097433029303
STAT,1970,2,na,1972,5684.948352899447
SIM,1922,24,40-44,1946,10
STAT,1886,52,na,1938,2607.1931568538685
STAT,1907,62,na,1969,3443.904442405111
STAT,1851,26,15-19,1877,0.4243032989394015
STAT,1981,33,25-29,2014,15.193759340646247
STAT,1825,33,45-49,1858,3.4016586138902047
STAT,1910,29,35-39,1939,16.6288028090616
SIM,1922,26,50-100,1948,1
STAT,1867,27,20-24,1894,12.640503014610214
STAT,1882,23,40-44,1905,2.341642477703202
SIM,1883,30,na,1913,2506
STAT,1875,21,40-44,1896,2.492643729282001
SIM,1858,46,na,1904,2482
STAT,1832,26,50-100,1858,0.6190754670697263
STAT,1985,17,20-24,2002,222.5320918374724
STAT,1855,21,20-24,1876,68.99836440276101
SIM,1882,29,20-24,1911,32
STAT,1783,98,na,1881,0.43664744180870635
STAT,1901,36,50-100,1937,0.43042560591700085
STAT,1952,34,20-24,1986,3.4340389725396134
STAT,1914,24,40-44,1938,3.941399952924873
SIM,1978,33,25-29,2011,19
STAT,1898,94,na,1992,228.82083734947588
SIM,1876,39,40-44,1915,5
SIM,1899,28,20-24,1927,39
STAT,1959,39,35-39,1998,3.753716530568756
STAT,1969,22,30-34,1991,41.571110463072685
SIM,1881,23,30-34,1904,48
STAT,1842,32,35-39,1874,9.41417672770047
STAT,1941,34,45-49,1975,1.9046506135118189
STAT,1917,20,45-49,1937,1.3883363033583351
STAT,1851,53,na,1904,1680.0358904370296
SIM,1849,37,20-24,1886,2
STAT,1827,31,20-24,1858,4.919667722922015
SIM,1844,33,20-24,1877,6
STAT,1826,106,na,1932,0.006685281861960726
STAT,1944,46,30-34,1990,0.1154495558410123
STAT,1871,22,na,1893,2715.374658589805
STAT,1888,87,na,1975,660.4600972285856
SIM,1876,23,50-100,1899,1
SIM,1866,41,na,1907,2458
SIM,1964,27,15-19,1991,5
STAT,1951,17,20-24,1968,186.31294541977002
SIM,1864,33,40-44,1897,10
SIM,1985,18,40-44,2003,3
STAT,1906,20,35-39,1926,9.878954030699784
SIM,1878,20,20-24,1898,83
SIM,1923,22,35-39,1945,14
SIM,1865,40,50-100,1905,2
STAT,1865,38,45-49,1903,2.0654345139518866
STAT,1926,44,20-24,1970,0.02503668625224815
SIM,1888,33,50-100,1921,1
STAT,1935,29,na,1964,5890.488064117035
SIM,1857,16,na,1873,2837
SIM,1902,32,50-100,1934,3
SIM,1974,29,20-24,2003,34
STAT,1905,81,na,1986,1745.798577140977
STAT,1967,27,25-29,1994,95.29443216970976
STAT,1879,70,na,1949,1690.7309072456542
SIM,1885,22,20-24,1907,4
STAT,1868,39,40-44,1907,4.804783736486496
SIM,1905,20,25-29,1925,181
STAT,1925,33,15-19,1958,0.1759401494459257
SIM,1969,31,25-29,2000,46
STAT,1957,27,na,1984,5724.6544460279165
SIM,1858,37,30-34,1895,13
SIM,1808,49,35-39,1857,2
SIM,1817,61,na,1878,978
STAT,1881,36,50-100,1917,1.373213894279281
STAT,1840,16,na,1856,2398.2467408272064
STAT,1951,23,15-19,1974,7.337073162588749
SIM,1850,32,35-39,1882,3
STAT,1821,43,20-24,1864,0.29968518647025894
STAT,1861,42,50-100,1903,1.0123197043422887
SIM,1835,31,20-24,1866,2
SIM,1912,52,na,1964,3565
STAT,1831,32,25-29,1863,10.430379130323383
STAT,1822,49,45-49,1871,0.43350726652886173
STAT,1936,33,25-29,1969,10.360179004708165
SIM,1914,20,35-39,1934,25
STAT,1961,31,50-100,1992,1.2573002138695877
SIM,1889,45,45-49,1934,1
SIM,1918,29,45-49,1947,2
SIM,1928,27,50-100,1955,1
STAT,1891,22,na,1913,3373.3118221555146
STAT,1906,12,na,1918,4346.029708540654
STAT,1842,21,45-49,1863,0.6817136527453507
SIM,1859,26,25-29,1885,47
STAT,1816,42,35-39,1858,4.101477313403456
STAT,1883,104,na,1987,2.4471160211584624
SIM,1895,44,25-29,1939,1
SIM,1907,29,35-39,1936,26
SIM,1835,80,na,1915,636
STAT,1956,46,45-49,2002,0.34607682291605
STAT,1839,53,na,1892,1680.152313499283
SIM,1913,37,na,1950,4705
SIM,1879,23,40-44,1902,10
SIM,1874,16,15-19,1890,12
SIM,1835,53,50-100,1888,1
STAT,1931,36,na,1967,5756.588855866946
SIM,1784,83,na,1867,7
STAT,1987,21,25-29,2008,152.7317448927246
STAT,1866,52,40-44,1918,0.011201077020866321
SIM,1887,25,25-29,1912,5
STAT,1835,60,na,1895,1188.657207384975
STAT,1879,25,25-29,1904,51.31983522692762
SIM,1942,22,50-100,1964,1
SIM,1923,44,na,1967,5302
STAT,1981,19,45-49,2000,0.8055767907484728
STAT,1851,23,45-49,1874,0.6556155388332755
STAT,1872,25,50-100,1897,0.7463060176671806
SIM,1870,26,25-29,1896,6
STAT,1859,39,30-34,1898,4.850194621346581
SIM,1968,31,20-24,1999,2
STAT,1929,23,40-44,1952,4.89204579100725
SIM,1853,23,na,1876,2616
STAT,1826,39,35-39,1865,5.433257359865257
STAT,1894,15,15-19,1909,8.845044042353619
STAT,1909,23,20-24,1932,119.03018828900682
SIM,1913,28,15-19,1941,1
STAT,1941,43,na,1984,4581.803406228477
STAT,1930,51,na,1981,5512.916671331359
SIM,1943,44,na,1987,5339
SIM,1855,36,35-39,1891,5
SIM,1917,23,20-24,1940,143
STAT,1915,22,35-39,1937,11.23449705038897
SIM,1937,23,40-44,1960,7
STAT,1887,37,50-100,1924,1.5878679707381376
SIM,1870,8,na,1878,3463
SIM,1862,38,35-39,1900,16
STAT,1956,27,15-19,1983,1.082702615075474
SIM,1933,37,na,1970,6401
STAT,1862,26,25-29,1888,41.649647094563804
SIM,1822,62,na,1884,1163
STAT,1872,38,na,1910,2716.570188667248
SIM,1834,39,35-39,1873,4
STAT,1887,44,25-29,1931,0.8193060568192942
STAT,1823,48,50-100,1871,0.23929181484920242
STAT,1946,16,35-39,1962,5.372510594254267
STAT,1826,80,na,1906,340.6025524108676
STAT,1926,66,na,1992,4480.247951595444
STAT,1882,17,45-49,1899,0.07363250743998608
STAT,1897,46,40-44,1943,0.1494451658759518
STAT,1898,33,45-49,1931,2.7083275886919944
STAT,1847,36,35-39,1883,5.7055566209907225
SIM,1838,43,40-44,1881,3
STAT,1973,38,na,2011,5779.253624913152
SIM,1908,21,20-24,1929,118
SIM,1818,43,20-24,1861,3
SIM,1954,16,35-39,1970,16
SIM,1978,20,25-29,1998,285
STAT,1814,100,na,1914,0.6619553170110801
SIM,1885,96,na,1981,155
SIM,1933,27,20-24,1960,54
STAT,1852,37,20-24,1889,0.7307101584679625
STAT,1981,30,20-24,2011,4.016710842935472
SIM,1957,31,45-49,1988,5
STAT,1946,0,na,1946,5692.3009585048785
STAT,1852,29,35-39,1881,9.504224816331213
SIM,1913,39,50-100,1952,1
STAT,1897,49,45-49,1946,0.20113844071467643
SIM,1894,49,35-39,1943,1
SIM,1946,31,35-39,1977,4
SIM,1925,28,40-44,1953,8
STAT,1967,46,20-24,2013,0.01661178764932273
SIM,1944,19,45-49,1963,1
STAT,1860,28,15-19,1888,0.4234518039394256
SIM,1828,38,50-100,1866,3
STAT,1903,27,35-39,1930,15.860688614432341
STAT,1844,38,40-44,1882,3.8291697912677463
STAT,1863,29,45-49,1892,1.112410324551686
SIM,1875,89,na,1964,333
SIM,1933,19,35-39,1952,14
STAT,1804,54,na,1858,1448.2475596776767
STAT,1917,28,40-44,1945,5.621404921004623
STAT,1975,37,15-19,2012,0.030120808118821504
SIM,1929,29,20-24,1958,43
STAT,1936,19,45-49,1955,0.5492991936410072
SIM,1972,24,na,1996,5399
STAT,1908,96,na,2004,153.87802209491826
STAT,1809,46,na,1855,1490.2757454029665
STAT,1866,16,15-19,1882,6.554272759086456
STAT,1873,23,30-34,1896,20.92673088686195
SIM,1911,27,35-39,1938,40
STAT,1963,29,15-19,1992,1.0384856541654865
STAT,1837,51,35-39,1888,0.006381848972497303
STAT,1925,19,35-39,1944,5.816535639005393
SIM,1987,27,na,2014,6015
STAT,1838,106,na,1944,0.010517253583636166
STAT,1875,49,25-29,1924,0.06725922768537192
STAT,1912,63,na,1975,3664.1701811410035
STAT,1927,62,na,1989,4843.32523745586
SIM,1889,20,30-34,1909,44
STAT,1884,15,20-24,1899,20.308362815879555
SIM,1870,97,na,1967,138
STAT,1862,23,20-24,1885,68.21270610334305
STAT,1892,42,40-44,1934,3.249424305827466
STAT,1918,23,30-34,1941,35.65522081800436
SIM,1962,17,na,1979,4959
STAT,1880,25,30-34,1905,31.012519514462806
STAT,1819,53,na,1872,1629.2204176827663
STAT,1825,39,na,1864,1979.5950424038094
STAT,1886,49,35-39,1935,0.1668652470217079
STAT,1921,26,40-44,1947,6.013334461483624
STAT,1885,1,na,1886,3808.3791600345826
STAT,1910,26,30-34,1936,43.860476993473426
STAT,1856,45,na,1901,2000.6191178381052
SIM,1920,9,na,1929,4692
SIM,1848,53,na,1901,1573
SIM,1899,14,na,1913,4525
STAT,1875,5,na,1880,3271.855028196233
SIM,1958,37,35-39,1995,5
STAT,1822,46,40-44,1868,0.32823864733206976
SIM,1976,22,15-19,1998,16
STAT,1866,52,na,1918,2290.9004674891826
SIM,1926,23,30-34,1949,53
STAT,1826,47,20-24,1873,0.008634503682293413
STAT,1818,48,40-44,1866,0.20830344740575038
STAT,1962,28,na,1990,5560.623071296885
SIM,1903,36,40-44,1939,2
SIM,1897,33,na,1930,3728
STAT,1984,15,25-29,1999,71.06677941605646
STAT,1877,16,25-29,1893,6.819302689156627
STAT,1928,45,35-39,1973,0.19073846884308238
SIM,1866,25,20-24,1891,24
STAT,1938,31,35-39,1969,10.615509782411294
SIM,1907,2,na,1909,4894
STAT,1891,25,40-44,1916,4.301614155166241
SIM,1856,39,20-24,1895,1
STAT,1884,18,25-29,1902,6.444394033250951
STAT,1923,37,50-100,1960,0.5612138991844818
SIM,1852,38,40-44,1890,7
SIM,1830,46,40-44,1876,1
STAT,1975,21,45-49,1996,1.7192686097108627
STAT,1854,19,na,1873,2210.7985869262716
STAT,1982,8,na,1990,6382.20069045
STAT,1914,27,45-49,1941,2.0108568781396357
STAT,1980,16,na,1996,5898.537596001688
SIM,1964,4,na,1968,5979
SIM,1927,51,na,1978,4821
STAT,1848,39,20-24,1887,0.8266974721168222
STAT,1824,30,25-29,1854,31.885498060588162
STAT,1961,45,40-44,2006,0.24566455690633343
STAT,1858,25,20-24,1883,10.968872835823536
STAT,1836,33,20-24,1869,3.0784231887005062
STAT,1937,76,na,2013,2719.3400548103027
SIM,1790,69,na,1859,487
SIM,1854,22,25-29,1876,135
STAT,1837,39,45-49,1876,1.7214105172133158
SIM,1845,39,45-49,1884,3
SIM,1839,32,35-39,1871,21
SIM,1860,29,35-39,1889,1
STAT,1852,31,50-100,1883,0.9037478064344214
STAT,1904,22,25-29,1926,94.8685264124867
STAT,1925,6,na,1931,5585.78478701514
STAT,1947,19,20-24,1966,176.1243226201437
SIM,1955,19,20-24,1974,254
STAT,1830,37,35-39,1867,7.152453302929618
SIM,1912,22,25-29,1934,214
SIM,1832,30,25-29,1862,4
STAT,1925,27,20-24,1952,24.873244431562227
SIM,1844,36,25-29,1880,2
SIM,1928,23,30-34,1951,2
SIM,1936,66,na,2002,3351
STAT,1905,39,50-100,1944,0.4381763354687675
STAT,1838,31,30-34,1869,18.99259902682285
STAT,1857,22,35-39,1879,6.055041463697562
STAT,1971,32,50-100,2003,1.2318481836140158
SIM,1855,33,30-34,1888,6
SIM,1882,34,na,1916,3260
STAT,1808,48,15-19,1856,0.0019654905445686665
STAT,1840,61,na,1901,1499.0223033819777
SIM,1908,24,25-29,1932,222
STAT,1857,41,na,1898,2086.766568871317
STAT,1949,43,50-100,1992,0.163605534270027
STAT,1815,47,45-49,1862,0.48181832947588926
SIM,1871,42,na,1913,2027
STAT,1785,79,na,1864,184.7329244518744
STAT,1954,32,30-34,1986,22.911683039376694
SIM,1970,23,25-29,1993,169
STAT,1846,22,25-29,1868,73.01931357527455
SIM,1867,39,30-34,1906,9
STAT,1973,23,35-39,1996,14.095465511423747
STAT,1827,34,25-29,1861,16.127758994914856
STAT,1897,16,45-49,1913,0.10104893646181384
STAT,1959,36,30-34,1995,2.8371112844681767
STAT,1840,17,40-44,1857,0.1899690680358593
STAT,1847,33,30-34,1880,15.610819573236244
STAT,1869,18,na,1887,2844.8693813081904
SIM,1909,35,30-34,1944,3
STAT,1878,26,50-100,1904,0.7734460856240193
STAT,1806,80,na,1886,266.15833919956293
STAT,1807,65,na,1872,1138.585352249126
STAT,1849,31,40-44,1880,3.9328460424284466
STAT,1868,22,45-49,1890,0.7731675842240079
SIM,1989,19,20-24,2008,230
STAT,1962,23,25-29,1985,136.99078726021352
STAT,1915,47,15-19,1962,4.284504963849113E-4
STAT,1795,86,na,1881,63.16506919477128
STAT,1837,27,na,1864,2010.5685066805672
STAT,1848,20,35-39,1868,7.659162883614369
SIM,1863,24,25-29,1887,65
STAT,1937,39,15-19,1976,0.02212534136122568
SIM,1846,31,30-34,1877,42
STAT,1943,18,40-44,1961,1.711341741338215
STAT,1861,107,na,1968,0.04877107943209512
SIM,1918,92,na,2010,648
SIM,1884,27,30-34,1911,48
SIM,1936,62,na,1998,3621
SIM,1917,26,25-29,1943,159
STAT,1926,47,25-29,1973,0.07551879465305272
SIM,1877,28,35-39,1905,24
STAT,1843,27,na,1870,2671.291710867504
STAT,1832,35,45-49,1867,1.7897829002793768
STAT,1855,24,25-29,1879,56.09118053808963
STAT,1859,20,45-49,1879,0.7415022245967878
STAT,1817,72,na,1889,902.8055183475717
STAT,1899,25,na,1924,3798.860378028209
STAT,1817,45,20-24,1862,0.03525436043414945
SIM,1977,16,na,1993,5823
SIM,1851,42,na,1893,2642
SIM,1929,84,na,2013,1796
STAT,1954,16,50-100,1970,0.534658461107912
SIM,1886,26,50-100,1912,3
STAT,1948,39,25-29,1987,1.3368225260067608
SIM,1956,39,25-29,1995,1
STAT,1903,43,50-100,1946,0.1197199665141039
STAT,1969,25,35-39,1994,21.75644127053638
STAT,1858,26,na,1884,2215.3708907830846
STAT,1853,34,na,1887,2396.353712492363
STAT,1855,60,na,1915,1622.8106825892407
STAT,1887,27,40-44,1914,3.8742317308888476
SIM,1962,32,30-34,1994,35
STAT,1836,19,40-44,1855,0.2420078100095811
SIM,1951,18,40-44,1969,5
STAT,1865,35,40-44,1900,4.601390221354444
STAT,1941,37,15-19,1978,0.023523083933920365
SIM,1888,42,25-29,1930,2
SIM,1873,35,40-44,1908,14
STAT,1965,32,40-44,1997,5.7471171087067825
STAT,1889,18,na,1907,3583.436401128958
SIM,1840,35,45-49,1875,3
STAT,1944,58,na,2002,4502.183046978101
STAT,1889,44,50-100,1933,1.4825899853282711
STAT,1834,38,15-19,1872,0.06308467925459099
SIM,1910,24,15-19,1934,11
STAT,1864,21,30-34,1885,18.784545985513706
STAT,1876,27,30-34,1903,30.041473890465692
SIM,1893,29,30-34,1922,3
SIM,1920,19,na,1939,3927
STAT,1841,37,45-49,1878,2.088223158701744
STAT,1855,50,40-44,1905,0.009086659251538244
STAT,1895,18,35-39,1913,0.8221068932589681
STAT,1870,28,40-44,1898,3.3961289031048447
SIM,1856,20,35-39,1876,8
STAT,1848,103,na,1951,0.15248868578689925
SIM,1818,46,25-29,1864,1
SIM,1834,50,na,1884,1717
SIM,1972,21,35-39,1993,30
STAT,1842,42,na,1884,1840.1105056136917
SIM,1921,63,na,1984,4654
STAT,1869,25,30-34,1894,28.334435175865867
SIM,1888,28,45-49,1916,2
STAT,1973,28,50-100,2001,1.4913090883734668
SIM,1857,31,40-44,1888,2
STAT,1815,91,na,1906,32.154179483873406
STAT,1952,20,50-100,1972,0.9136256163977503
SIM,1869,37,40-44,1906,3
STAT,1939,42,40-44,1981,0.30039721910549383
STAT,1825,36,15-19,1861,0.09583151547162215
SIM,1824,43,na,1867,1577
SIM,1956,17,na,1973,5136
SIM,1972,28,na,2000,5780
STAT,1850,20,25-29,1870,71.75916285745174
STAT,1928,47,na,1975,5409.539684731726
STAT,1944,54,na,1998,4622.151396412369
SIM,1959,39,50-100,1998,1
STAT,1887,41,20-24,1928,0.206325919669639
STAT,1885,29,30-34,1914,28.77994163635306
STAT,1913,48,na,1961,4128.838003151461
SIM,1835,35,na,1870,2402
SIM,1945,25,na,1970,4522
STAT,1888,47,45-49,1935,0.3186590419069047
SIM,1872,21,30-34,1893,29
STAT,1939,39,na,1978,4469.753471750614
STAT,1802,73,na,1875,691.4062472082189
STAT,1964,21,35-39,1985,13.735973255277209
SIM,1961,32,na,1993,5536
STAT,2000,0,na,2000,6798.002239873337
STAT,1949,31,45-49,1980,2.154067226778606
SIM,1881,26,35-39,1907,22
STAT,1870,18,50-100,1888,0.05593878617882746
SIM,1840,50,na,1890,1729
SIM,1930,26,na,1956,5659
SIM,1878,39,40-44,1917,11
STAT,1890,26,na,1916,3376.8333989877965
STAT,1879,22,20-24,1901,83.04085622881364
STAT,1940,17,45-49,1957,0.5855242930031451
SIM,1879,26,45-49,1905,3
SIM,1896,47,45-49,1943,1
SIM,1887,22,20-24,1909,115
SIM,1905,89,na,1994,144
STAT,1971,42,30-34,2013,0.194199337948944
SIM,1901,75,na,1976,2465
STAT,1921,43,na,1964,4818.059344421863
SIM,1867,98,na,1965,16
STAT,1843,45,25-29,1888,0.05901834400548722
SIM,1883,28,30-34,1911,33
STAT,1927,24,25-29,1951,130.4843677121603
SIM,1863,84,na,1947,81
SIM,1975,21,15-19,1996,7
STAT,1925,57,na,1982,4910.379396590757
STAT,1847,26,na,1873,2015.1583986313565
STAT,1922,15,35-39,1937,5.627932158909365
SIM,1871,28,na,1899,2190
SIM,1963,26,50-100,1989,3
STAT,1833,32,35-39,1865,9.26082907916891
STAT,1863,49,45-49,1912,0.23317760784089464
STAT,1878,43,20-24,1921,0.18998028461619773
SIM,1781,87,na,1868,73
STAT,1904,42,50-100,1946,0.1214275420175299
STAT,1814,47,na,1861,1916.0214122365699
STAT,1966,37,na,2003,5586.9575302547155
STAT,1889,29,50-100,1918,0.9035027453668911
SIM,1841,32,35-39,1873,14
SIM,1837,43,25-29,1880,1
SIM,1789,67,na,1856,1089
STAT,1980,16,35-39,1996,6.724461196348623
STAT,1799,100,na,1899,0.4768747726879954
STAT,1967,21,15-19,1988,7.70162861415308
STAT,2000,15,45-49,2015,0.8577928939269963
STAT,1868,95,na,1963,40.53208740641709
STAT,1888,28,40-44,1916,4.049401649450839
STAT,1864,81,na,1945,557.2262295968421
STAT,1911,36,40-44,1947,1.6780915265764076
SIM,1827,29,30-34,1856,2
STAT,1892,102,na,1994,10.787853858291841
STAT,1968,42,50-100,2010,0.17598094218602664
SIM,1887,22,30-34,1909,35
STAT,1887,35,50-100,1922,1.6029481452636765
STAT,1894,26,15-19,1920,0.6753953567191437
STAT,1882,32,30-34,1914,19.680855356502416
STAT,1906,36,50-100,1942,0.448103002853227
STAT,1879,22,30-34,1901,21.464137470377867
SIM,1987,19,35-39,2006,6
STAT,1941,20,40-44,1961,4.013770359602223
STAT,1960,39,40-44,1999,2.313212032948899
STAT,1829,43,25-29,1872,0.6749384621283189
STAT,1860,101,na,1961,1.402503633420724
STAT,1832,48,50-100,1880,0.19902573613225802
SIM,1862,43,35-39,1905,13
SIM,1938,20,na,1958,3621
STAT,1864,50,40-44,1914,0.011004019908705146
STAT,1802,100,na,1902,0.5067843824613745
SIM,1875,43,45-49,1918,8
SIM,1947,29,na,1976,6003
STAT,1877,22,20-24,1899,82.72565347423533
STAT,1934,18,na,1952,5733.316786093356
STAT,1874,49,20-24,1923,0.013881354768168677
STAT,1893,94,na,1987,204.43634976079133
SIM,1872,45,na,1917,2818
SIM,1969,23,40-44,1992,8
STAT,1909,20,15-19,1929,5.750058037968135
STAT,1805,86,na,1891,91.17951596902459
STAT,1847,47,50-100,1894,0.18809696341634252
STAT,1889,44,35-39,1933,2.5412367640407
STAT,1860,47,50-100,1907,0.2273697105004182
STAT,1852,48,30-34,1900,0.0901176007366791
SIM,1911,99,na,2010,27
STAT,1962,44,30-34,2006,0.19580606576995283
STAT,1915,38,50-100,1953,0.4871356727984654
STAT,1920,83,na,2003,1885.5989532980368
STAT,1766,105,na,1871,0.04960333076553744
STAT,1861,27,15-19,1888,0.438447936416939
STAT,1880,33,35-39,1913,12.335568051409211
SIM,1968,2,na,1970,5402
STAT,1901,29,35-39,1930,15.4858492607252
STAT,1792,105,na,1897,0.008233495850815545
STAT,1836,18,50-100,1854,0.10014697627420285
SIM,1890,32,30-34,1922,28
STAT,1934,49,40-44,1983,0.25213856623826003
STAT,1993,11,na,2004,6523.240041131433
SIM,1985,0,na,1985,6457
SIM,1884,44,25-29,1928,2
STAT,1976,29,35-39,2005,23.224964771727535
STAT,1815,50,45-49,1865,0.0296327025891607
SIM,1869,41,na,1910,1914
STAT,1909,18,50-100,1927,0.08466188818168859
SIM,1918,16,na,1934,4183
STAT,1834,101,na,1935,0.520751427832578
STAT,1826,64,na,1890,957.1497947678254
SIM,1851,67,na,1918,1825
STAT,1822,40,50-100,1862,2.279219151099801
SIM,1863,33,25-29,1896,13
STAT,1845,53,50-100,1898,0.010013658224216949
STAT,1941,61,na,2002,4185.415237434379
STAT,1913,44,50-100,1957,0.13184250030860686
STAT,1801,72,na,1873,631.975096699985
STAT,1858,30,50-100,1888,0.8421928779084193
STAT,1889,57,na,1946,2858.8393024102334
STAT,1858,17,15-19,1875,6.241092065004362
SIM,1866,17,15-19,1883,12
STAT,1867,43,45-49,1910,1.6009633206420142
SIM,1967,34,30-34,2001,6
SIM,1876,59,na,1935,2396
SIM,1834,28,na,1862,1927
SIM,1840,19,20-24,1859,26
SIM,1935,24,25-29,1959,171
STAT,1928,33,30-34,1961,22.720324082128442
SIM,1980,15,na,1995,6001
STAT,1885,43,na,1928,2641.2707104395154
STAT,1866,102,na,1968,2.1850691119306958
SIM,1936,33,30-34,1969,1
STAT,1903,6,na,1909,4294.133376194221
STAT,1963,21,30-34,1984,42.292510038821305
STAT,1818,100,na,1918,0.46973671815784035
STAT,1850,24,35-39,1874,7.10712285729632
SIM,1912,59,na,1971,3452
STAT,1870,25,15-19,1895,0.5196903447815685
STAT,1890,40,40-44,1930,3.2037533936309956
STAT,1914,73,na,1987,3013.426007850133
SIM,1835,37,40-44,1872,5
SIM,1859,63,na,1922,1517
STAT,1891,36,15-19,1927,0.08047977041336747
SIM,1860,40,20-24,1900,3
STAT,1881,23,25-29,1904,63.524856028980416
STAT,1880,12,na,1892,3159.0316567563054
STAT,1913,56,na,1969,3986.064915505395
STAT,1798,99,na,1897,0.48172365461415523
STAT,1794,85,na,1879,117.60804244351036
STAT,1876,44,25-29,1920,0.755739123487178
SIM,1880,25,25-29,1905,68
SIM,1913,23,35-39,1936,21
SIM,1951,47,40-44,1998,1
STAT,1944,16,25-29,1960,53.83678698351172
STAT,1905,23,35-39,1928,9.71701398071661
STAT,1943,47,40-44,1990,0.20071135417287408
STAT,1947,41,40-44,1988,0.33839591521822227
STAT,1969,34,15-19,2003,0.18859215292488843
STAT,1855,29,40-44,1884,2.6188007270287033
STAT,1896,37,50-100,1933,1.87143122969809
STAT,1933,37,30-34,1970,2.8661566027419436
STAT,1969,44,40-44,2013,0.3734873200511133
STAT,1830,42,35-39,1872,1.7393658381619532
STAT,1959,35,25-29,1994,1.533950133799711
STAT,1896,17,35-39,1913,0.8363897202230229
STAT,1871,51,na,1922,2483.9366949460905
STAT,1822,34,na,1856,2358.4781682058574
STAT,1826,48,na,1874,1388.9278397053283
STAT,1928,36,35-39,1964,3.530827953876247
STAT,1875,53,20-24,1928,8.659093038355848E-4
SIM,1863,29,40-44,1892,1
STAT,1839,53,35-39,1892,0.006717791079191167
SIM,1971,21,30-34,1992,2
STAT,1964,47,45-49,2011,0.32859010115435183
STAT,1875,65,na,1940,2015.441551219805
SIM,1954,24,50-100,1978,6
STAT,1945,59,na,2004,4529.975740163914
STAT,1948,32,45-49,1980,2.1183338915492356
SIM,1873,40,30-34,1913,2
STAT,1865,40,30-34,1905,1.209178188864312
STAT,1900,42,15-19,1942,0.0015337820315264527
SIM,1864,42,30-34,1906,2
SIM,1988,23,35-39,2011,40
STAT,1850,48,20-24,1898,0.012198132640119754
SIM,1904,22,30-34,1926,42
SIM,1941,37,30-34,1978,1
STAT,1893,78,na,1971,1683.013349195572
STAT,1937,31,30-34,1968,18.00876697847195
STAT,1824,34,35-39,1858,16.989967918480417
STAT,1958,19,30-34,1977,18.46263664678287
STAT,1867,30,na,1897,2591.8903962704458
STAT,1871,110,na,1981,0.016135684500603226
STAT,1929,15,45-49,1944,0.7391781191948207
STAT,1989,21,35-39,2010,15.620990585167624
SIM,1854,32,na,1886,2616
STAT,1864,27,40-44,1891,3.086753590050311
STAT,1978,32,15-19,2010,0.20630170386908692
STAT,1900,39,50-100,1939,0.42008428369385625
STAT,1857,21,40-44,1878,2.1778496262753064
SIM,1872,27,40-44,1899,8
STAT,1821,52,50-100,1873,0.02633538846107977
STAT,1974,26,20-24,2000,27.63867205954917
STAT,1885,28,15-19,1913,0.5204228358038936
STAT,1918,26,25-29,1944,81.09798062129407
SIM,1893,28,15-19,1921,1
SIM,1779,89,na,1868,153
STAT,1929,49,50-100,1978,0.33636294688644314
SIM,1902,22,20-24,1924,125
STAT,1827,37,40-44,1864,6.401986526263514
STAT,1891,30,30-34,1921,25.103287089068797
STAT,1869,26,50-100,1895,0.7173789658034374
STAT,1833,35,15-19,1868,0.05086162834966563
SIM,1900,28,30-34,1928,7
SIM,1945,31,30-34,1976,32
STAT,1835,37,15-19,1872,0.043336312414482825
SIM,1832,34,35-39,1866,21
STAT,1946,35,na,1981,4969.812452629462
STAT,1954,26,35-39,1980,21.521599869620307
STAT,1875,28,30-34,1903,29.926106240747707
SIM,1909,55,na,1964,4491
SIM,1966,19,30-34,1985,24
STAT,1974,38,15-19,2012,0.029783216893866687
SIM,1833,54,na,1887,1409
SIM,1909,31,20-24,1940,7
SIM,1937,15,45-49,1952,4
STAT,1907,47,30-34,1954,0.09228271400446189
STAT,2014,1,na,2015,7287.989935910033
STAT,1849,19,15-19,1868,5.595342614201235
STAT,1788,73,na,1861,738.3438728450508
SIM,1834,71,na,1905,984
STAT,1897,30,50-100,1927,1.4252545448380871
STAT,1861,46,30-34,1907,0.09313429625558077
STAT,1985,27,35-39,2012,24.749602876827584
SIM,1926,26,25-29,1952,110
SIM,1979,4,na,1983,6478
STAT,1854,42,20-24,1896,0.12922520444264027
STAT,1868,24,20-24,1892,75.92961521773267
STAT,1817,52,20-24,1869,0.0020272511339938072
STAT,1829,39,40-44,1868,4.817396706375658
SIM,1837,39,40-44,1876,3
SIM,1949,61,na,2010,5304
STAT,1881,77,na,1958,1083.783119421545
SIM,1857,19,15-19,1876,12
STAT,1838,16,35-39,1854,0.6316536065046083
SIM,1962,26,35-39,1988,29
STAT,1859,48,40-44,1907,0.15540741900947322
SIM,1848,63,na,1911,1214
STAT,1941,23,45-49,1964,1.3417904329147623
STAT,1873,51,45-49,1924,0.017184562755008268
SIM,1857,38,30-34,1895,5
SIM,1818,97,na,1915,19
SIM,1863,20,50-100,1883,1
STAT,1855,20,50-100,1875,0.41125133309801704
SIM,1887,34,25-29,1921,16
STAT,1908,16,15-19,1924,10.197344780606826
SIM,1862,40,30-34,1902,3
STAT,1869,40,15-19,1909,0.015589714765767987
SIM,1904,24,na,1928,3765
SIM,1908,38,na,1946,3849
SIM,1901,59,na,1960,3401
STAT,1942,16,15-19,1958,54.75795101134093
SIM,1878,27,35-39,1905,15
STAT,1874,44,15-19,1918,0.016095355263168083
STAT,1827,105,na,1932,0.023811914816747107
STAT,1933,47,50-100,1980,0.35910723515534887
SIM,1868,17,25-29,1885,11
SIM,1945,34,35-39,1979,1
STAT,1926,33,20-24,1959,3.400903829746531
SIM,1826,40,45-49,1866,7
STAT,1856,42,30-34,1898,1.0109783522393019
STAT,1893,36,25-29,1929,4.220152832028777
STAT,1987,26,30-34,2013,64.86143582788341
SIM,1967,37,35-39,2004,2
SIM,1919,95,na,2014,246
SIM,1941,47,50-100,1988,1
SIM,1848,32,45-49,1880,4
STAT,1906,22,na,1928,3980.071708876505
SIM,1967,17,na,1984,5344
STAT,1926,21,50-100,1947,0.9251241824450873
STAT,1950,29,30-34,1979,53.644309128972964
SIM,1982,26,20-24,2008,6
SIM,1931,27,20-24,1958,24
STAT,1809,47,15-19,1856,0.0010268592051778192
SIM,1861,27,40-44,1888,6
SIM,1960,23,20-24,1983,310
STAT,1863,46,40-44,1909,0.17325015625318724
STAT,1991,15,40-44,2006,2.3145373499842656
STAT,1853,27,40-44,1880,3.4550239053666707
STAT,1882,35,35-39,1917,8.04842090568122
STAT,1939,49,na,1988,4390.1955894718585
STAT,1811,50,na,1861,1494.9498884823843
SIM,1862,67,na,1929,1841
STAT,1812,72,na,1884,605.7825335775151
SIM,1882,25,35-39,1907,14
SIM,1863,21,30-34,1884,41
STAT,1896,43,na,1939,3509.620278230472
STAT,1818,40,45-49,1858,2.1160274151727156
STAT,1935,35,na,1970,6084.963349725176
STAT,1952,23,20-24,1975,154.23614859507202
SIM,1876,75,na,1951,1215
STAT,1884,51,20-24,1935,8.454169070458623E-4
STAT,1928,15,50-100,1943,0.5473194508089405
STAT,1815,64,na,1879,1147.5991437629905
STAT,1819,78,na,1897,520.1428846255479
STAT,1885,27,na,1912,2747.1490020624196
STAT,1974,22,45-49,1996,1.7011563747235545
SIM,1945,17,50-100,1962,1
SIM,1924,21,45-49,1945,3
SIM,1840,42,45-49,1882,8
SIM,1973,28,20-24,2001,48
STAT,1966,4,na,1970,5668.590686980767
SIM,1955,41,40-44,1996,1
STAT,1859,106,na,1965,0.07078001186955336
STAT,1916,26,15-19,1942,0.8453511866339385
STAT,1885,38,40-44,1923,5.013990665250469
STAT,1798,106,na,1904,0.003088357913483839
SIM,1824,39,30-34,1863,3
STAT,1855,21,30-34,1876,17.834478665433284
SIM,1843,32,na,1875,1988
SIM,1813,66,na,1879,1010
STAT,1895,30,15-19,1925,0.21564321366836756
STAT,1865,41,45-49,1906,1.5654369980130203
SIM,1873,41,45-49,1914,1
SIM,1985,19,25-29,2004,80
STAT,1773,101,na,1874,0.2483811532876315
SIM,1828,45,50-100,1873,1
STAT,1923,27,20-24,1950,24.177030725907745
SIM,1897,37,na,1934,3700
STAT,1872,16,35-39,1888,0.6417166101516923
SIM,1893,38,40-44,1931,5
SIM,1926,67,na,1993,4962
SIM,1968,19,40-44,1987,6
STAT,1962,47,35-39,2009,0.19830036163130296
STAT,1832,42,45-49,1874,1.2717848189164205
STAT,1987,7,na,1994,6475.6956785760285
SIM,1890,58,na,1948,2831
SIM,1916,16,15-19,1932,21
STAT,1889,41,30-34,1930,1.642882869915653
STAT,1990,19,na,2009,6079.149114809182
STAT,1844,30,45-49,1874,1.7808103587475126
SIM,1822,70,na,1892,840
SIM,1846,37,40-44,1883,2
SIM,1969,23,50-100,1992,1
SIM,1874,22,45-49,1896,1
SIM,1989,5,na,1994,6752
STAT,1924,31,45-49,1955,2.1193090387516356
STAT,1881,20,20-24,1901,77.1661890563455
SIM,1838,27,40-44,1865,7
STAT,1842,43,50-100,1885,0.8303946994561108
STAT,1872,25,25-29,1897,49.35154069497557
SIM,1852,30,45-49,1882,3
STAT,1963,24,35-39,1987,13.841455157309593
STAT,1970,30,45-49,2000,2.31978307395657
STAT,1838,37,40-44,1875,4.576296290344504
STAT,1880,30,30-34,1910,21.529120501673923
STAT,1916,21,45-49,1937,1.3648997622863506
SIM,1984,29,35-39,2013,53
STAT,1831,30,35-39,1861,10.529130974966153
STAT,1876,82,na,1958,674.9655830432231
SIM,1895,20,15-19,1915,9
SIM,1912,75,na,1987,1846
SIM,1864,45,35-39,1909,1
STAT,1985,24,30-34,2009,47.299282167485366
STAT,1929,24,35-39,1953,13.656077440571659
STAT,1861,49,35-39,1910,0.13151257474290884
SIM,1850,43,50-100,1893,3
STAT,1866,22,45-49,1888,0.7519886337902949
STAT,1876,41,20-24,1917,0.19031785300009132
STAT,1856,45,35-39,1901,0.12449177740544388
SIM,1908,95,na,2003,92
SIM,1863,30,20-24,1893,1
STAT,1826,53,25-29,1879,0.0024140722097099
STAT,1845,25,50-100,1870,0.5322930427926942
SIM,1850,29,30-34,1879,61
STAT,1780,77,na,1857,459.7794892311682
SIM,1932,31,45-49,1963,6
SIM,1978,17,na,1995,5279
STAT,1918,23,na,1941,4530.271558326304
SIM,1854,35,25-29,1889,1
SIM,1988,20,30-34,2008,61
STAT,1880,38,40-44,1918,5.328182436156837
STAT,1977,37,na,2014,6043.82166567112
STAT,1820,37,30-34,1857,11.695207295131203
STAT,1825,47,na,1872,1823.262734315564
STAT,1840,52,45-49,1892,0.011579904952103487
SIM,1967,32,20-24,1999,5
STAT,1821,33,na,1854,1678.0898584273814
SIM,1853,25,50-100,1878,2
STAT,1905,20,30-34,1925,29.929773016565758
STAT,1819,48,50-100,1867,0.46608476730448567
STAT,1866,16,50-100,1882,0.05410790946167539
STAT,1823,99,na,1922,1.0724738605834399
STAT,1794,69,na,1863,907.2383496666225
SIM,1884,49,30-34,1933,1
SIM,1909,22,30-34,1931,51
STAT,1892,24,15-19,1916,4.741949204021566
SIM,1969,36,30-34,2005,5
SIM,1923,38,50-100,1961,2
SIM,1988,11,na,1999,6635
STAT,1859,38,15-19,1897,0.05136710240349414
STAT,1924,39,30-34,1963,2.474247065977465
SIM,1932,39,30-34,1971,6
SIM,1958,37,25-29,1995,1
STAT,1991,18,20-24,2009,224.15415008140786
STAT,1913,30,30-34,1943,18.244962687137594
STAT,1978,21,15-19,1999,8.41433175614467
STAT,1891,31,45-49,1922,2.497409752261006
SIM,1884,41,20-24,1925,3
STAT,1816,39,30-34,1855,16.47324259740186
SIM,1865,59,na,1924,2481
SIM,1908,18,30-34,1926,1
SIM,1861,45,na,1906,1759
SIM,1861,39,35-39,1900,3
SIM,1883,29,na,1912,2499
STAT,1918,23,20-24,1941,137.94358472781332
SIM,1933,78,na,2011,3758
STAT,1862,5,na,1867,2804.8434807395015
STAT,1980,27,35-39,2007,24.15694557574027
SIM,1831,79,na,1910,423
SIM,1872,61,na,1933,2313
SIM,1813,48,45-49,1861,1
SIM,1851,19,20-24,1870,1
SIM,1960,8,na,1968,6328
STAT,1866,34,15-19,1900,0.1510238865679939
STAT,1958,47,50-100,2005,0.356593788696906
SIM,1830,31,20-24,1861,3
STAT,1833,34,na,1867,1922.47103780704
STAT,1852,43,25-29,1895,0.6010607549245455
SIM,1921,30,30-34,1951,45
STAT,1837,48,na,1885,1669.6360927428088
STAT,1878,33,50-100,1911,1.0993761445186443
STAT,1943,20,15-19,1963,6.54109425807771
SIM,1926,23,20-24,1949,159
STAT,1959,32,20-24,1991,3.7532542759751744
STAT,1829,40,20-24,1869,0.17552929897333064
SIM,1934,33,20-24,1967,5
SIM,1995,1,na,1996,6772
STAT,1843,19,20-24,1862,22.465442411941265
STAT,1846,35,25-29,1881,3.173488590236515
SIM,1937,24,35-39,1961,31
SIM,1904,25,35-39,1929,3
SIM,1948,15,20-24,1963,336
STAT,1868,27,25-29,1895,46.90244595978188
STAT,1937,34,35-39,1971,10.42600730007492
STAT,1900,81,na,1981,1621.07050154637
SIM,2001,8,na,2009,7322
STAT,1854,45,25-29,1899,0.04739438335194087
STAT,1870,20,45-49,1890,0.798093255060318
SIM,1949,20,na,1969,5244
STAT,1830,51,25-29,1881,0.0029308845306573504
STAT,1901,27,50-100,1928,1.0340517040652855
STAT,1842,29,30-34,1871,23.621040721969088
STAT,1830,69,na,1899,920.6147282756405
STAT,1867,46,25-29,1913,0.06223954225755772
SIM,1842,19,30-34,1861,7
STAT,1893,33,45-49,1926,2.5330111534362345
STAT,1964,44,40-44,2008,0.37656793060722665
STAT,1806,52,45-49,1858,0.05108356431318694
SIM,1906,41,45-49,1947,1
STAT,1867,14,na,1881,2863.4712013979884
SIM,1973,21,50-100,1994,1
STAT,1982,21,25-29,2003,150.54620105344733
STAT,1890,17,40-44,1907,0.2579152972236438
SIM,1859,32,20-24,1891,7
STAT,1868,36,15-19,1904,0.06256203223811353
SIM,1942,41,na,1983,4996
SIM,1873,46,na,1919,3194
STAT,1883,8,na,1891,2935.127602992962
SIM,1990,21,25-29,2011,148
STAT,1849,38,30-34,1887,4.183223128356798
STAT,1904,95,na,1999,194.45968178995588
SIM,1888,76,na,1964,1173
STAT,1956,20,25-29,1976,141.61885263778757
STAT,1901,38,25-29,1939,0.999579624918371
STAT,1844,23,20-24,1867,71.45053262409432
STAT,1893,38,15-19,1931,0.08150740834990321
STAT,1872,22,20-24,1894,79.85594999283204
SIM,1915,20,40-44,1935,11
SIM,1852,33,25-29,1885,7
SIM,1788,66,na,1854,640
SIM,1951,20,15-19,1971,16
SIM,1904,40,na,1944,4060
STAT,1883,20,30-34,1903,20.231709399466133
STAT,1903,73,na,1976,2565.034953079902
STAT,1907,87,na,1994,976.3378564276538
SIM,1828,36,35-39,1864,17
SIM,1908,54,na,1962,3481
STAT,1952,44,50-100,1996,0.1682838257871406
STAT,1808,52,50-100,1860,0.0719870821206578
STAT,1893,33,20-24,1926,3.926362433570734
STAT,1918,17,35-39,1935,1.0572565292318832
SIM,1960,26,25-29,1986,6
STAT,1829,34,35-39,1863,12.22741023877481
SIM,1812,49,na,1861,1511
STAT,1791,93,na,1884,7.702331922889812
STAT,1853,17,15-19,1870,7.107602830191089
STAT,1867,6,na,1873,3019.802000367907
SIM,1901,19,35-39,1920,2
SIM,1833,70,na,1903,852
SIM,1891,20,30-34,1911,37
SIM,1861,17,15-19,1878,9
SIM,1828,59,na,1887,1732
STAT,1899,29,30-34,1928,39.5297964889485
STAT,1988,8,na,1996,6486.815940445018
SIM,1865,33,35-39,1898,1
STAT,1976,38,25-29,2014,1.562406552068914
STAT,1894,17,25-29,1911,8.406813807470733
STAT,1842,38,20-24,1880,0.6886657232997893
SIM,1840,67,na,1907,1113
SIM,1900,32,15-19,1932,1
SIM,1840,48,50-100,1888,1
SIM,1852,23,20-24,1875,5
STAT,1774,100,na,1874,0.008910186087471173
STAT,1863,80,na,1943,624.2318025735826
SIM,1970,35,40-44,2005,2
STAT,1857,33,35-39,1890,9.06390329169517
STAT,1955,23,na,1978,5611.235322567214
SIM,1847,42,50-100,1889,1
SIM,1850,38,20-24,1888,2
STAT,1882,33,45-49,1915,1.9573674375215524
STAT,1956,42,45-49,1998,0.2641223017202628
SIM,1893,50,na,1943,3113
STAT,1945,1,na,1946,5204.931441362348
SIM,1897,64,na,1961,2790
SIM,1843,47,40-44,1890,1
STAT,1941,47,30-34,1988,0.11024864385600527
SIM,1902,25,25-29,1927,87
STAT,1932,49,30-34,1981,0.13877230205295757
STAT,1927,15,35-39,1942,6.04777149779227
STAT,1843,17,30-34,1860,2.043742021474225
STAT,1874,43,na,1917,2710.882528422211
STAT,1855,24,35-39,1879,5.717800138187918
STAT,1940,19,20-24,1959,158.80487228249484
STAT,1894,21,45-49,1915,1.0376271483349384
STAT,1887,42,35-39,1929,2.339083789920026
STAT,1797,107,na,1904,0.001404182669617096
STAT,1878,57,na,1935,2421.5160452381397
STAT,1913,97,na,2010,120.97566496326213
STAT,1920,49,15-19,1969,4.6697406191946304E-4
STAT,1976,30,15-19,2006,0.20218554944896863
SIM,1925,30,15-19,1955,4
STAT,1861,22,45-49,1883,0.6873055131402699
STAT,1854,52,25-29,1906,0.002870305326188524
SIM,1851,17,30-34,1868,3
STAT,1939,31,40-44,1970,4.612498942974238
SIM,1906,31,50-100,1937,1
SIM,1879,24,na,1903,2572
STAT,1847,19,40-44,1866,0.17358874828938445
STAT,1879,50,25-29,1929,0.0043295281224997205
SIM,1894,16,15-19,1910,7
STAT,1946,20,40-44,1966,4.320972437177176
STAT,1952,26,25-29,1978,91.46202152225985
SIM,1855,33,na,1888,1940
SIM,1824,66,na,1890,869
SIM,1888,18,40-44,1906,1
STAT,1951,42,20-24,1993,0.025221758637977754
SIM,1970,30,na,2000,5996
STAT,1924,9,na,1933,5469.323908483538
STAT,1876,49,30-34,1925,0.11306921148665341
STAT,1890,112,na,2002,0.0061669300120061644
STAT,1910,48,40-44,1958,0.16946303043010646
STAT,1831,38,45-49,1869,1.9509383863897807
STAT,1868,31,na,1899,2656.6771134593473
STAT,1950,33,15-19,1983,0.17862780543835588
SIM,1950,49,na,1999,4597
STAT,1853,39,35-39,1892,6.971060986975043
STAT,1887,20,15-19,1907,4.29216128221897
STAT,1842,51,40-44,1893,0.008140053561033828
STAT,1815,48,na,1863,1664.1771099560692
STAT,1854,40,30-34,1894,0.9460821884493271
SIM,1863,24,35-39,1887,8
SIM,1947,31,40-44,1978,1
STAT,1928,49,na,1977,5377.832155810147
STAT,1853,65,na,1918,1682.5587721863544
SIM,1846,49,50-100,1895,1
SIM,2009,2,na,2011,7162
SIM,1866,76,na,1942,720
STAT,1903,94,na,1997,249.93583312861787
STAT,1818,43,25-29,1861,0.8347831201052662
STAT,1924,35,na,1959,5127.1687324734785
STAT,1993,22,15-19,2015,8.867774771658912
STAT,1924,56,na,1980,4858.042200944849
STAT,1899,19,na,1918,3971.74667558056
STAT,1821,53,25-29,1874,0.0060548451229955605
STAT,1940,42,45-49,1982,0.20273019859179198
STAT,1985,26,20-24,2011,30.104843057163258
SIM,1959,15,20-24,1974,394
STAT,1855,30,20-24,1885,2.391039244220316
STAT,1949,16,25-29,1965,58.17950985097833
STAT,1920,42,na,1962,4731.637668062537
SIM,1867,33,45-49,1900,3
STAT,1875,53,45-49,1928,0.017029548995823644
STAT,1867,48,15-19,1915,4.255795413106906E-4
SIM,1830,40,50-100,1870,1
SIM,1895,42,35-39,1937,1
STAT,1816,86,na,1902,109.57351706616952
STAT,1917,30,15-19,1947,0.1565460784984985
SIM,1958,25,30-34,1983,133
STAT,1886,111,na,1997,0.013540246557825975
STAT,1836,26,na,1862,2565.785066440474
STAT,1841,45,15-19,1886,3.665202082955092E-4
STAT,1864,22,50-100,1886,0.4269614232588485
STAT,1916,21,na,1937,4429.843180491713
SIM,1885,28,40-44,1913,4
SIM,1876,27,25-29,1903,102
STAT,1857,48,30-34,1905,0.08591165440622213
SIM,1838,58,na,1896,1385
SIM,1918,38,45-49,1956,1
STAT,1920,15,25-29,1935,11.304600938134154
SIM,1948,15,45-49,1963,1
STAT,1972,40,50-100,2012,0.18090047872889273
STAT,1856,17,40-44,1873,0.19041557862884684
SIM,1958,28,35-39,1986,2
SIM,1830,34,25-29,1864,5
SIM,1938,30,25-29,1968,14
STAT,1853,81,na,1934,538.3954105288291
STAT,1845,99,na,1944,1.276191589781166
STAT,1992,10,na,2002,6508.675735883987
STAT,1861,37,40-44,1898,4.199807818691752
SIM,1956,33,na,1989,5302
STAT,1835,47,40-44,1882,0.11261412512865919
SIM,1839,43,35-39,1882,7
SIM,1874,39,20-24,1913,1
STAT,1891,33,50-100,1924,1.3013427496314736
STAT,1822,32,35-39,1854,43.78941082585846
STAT,1866,39,20-24,1905,0.8162489561368238
SIM,1921,36,na,1957,5221
STAT,1867,43,20-24,1910,0.16988307714498704
STAT,1925,27,30-34,1952,53.391139073990296
SIM,1864,40,40-44,1904,5
STAT,1960,44,20-24,2004,0.027494606595707023
STAT,1801,56,na,1857,1200.5100458838376
SIM,1954,20,40-44,1974,12
STAT,1864,52,30-34,1916,0.006101101364263302
STAT,1817,54,50-100,1871,0.039872104426984606
STAT,1877,28,40-44,1905,3.5833515241936715
SIM,1933,27,30-34,1960,135
SIM,1838,53,45-49,1891,1
SIM,1969,38,50-100,2007,3
SIM,1830,32,35-39,1862,4
STAT,1937,17,50-100,1954,0.42085277479025973
STAT,1804,85,na,1889,119.20368331104392
STAT,1846,32,20-24,1878,3.302252884520189
SIM,1890,35,35-39,1925,16
SIM,1835,49,35-39,1884,2
SIM,1958,1,na,1959,6250
STAT,1862,50,30-34,1912,0.005880691680346865
STAT,1963,45,na,2008,5629.010197211123
SIM,1934,36,25-29,1970,3
SIM,1859,35,25-29,1894,6
SIM,1890,30,40-44,1920,10
SIM,1964,37,45-49,2001,1
STAT,1883,38,30-34,1921,5.987737939102374
SIM,1871,44,na,1915,1959
STAT,1856,43,45-49,1899,1.308196880762673
STAT,1930,20,na,1950,5431.779673639826
SIM,1907,37,30-34,1944,3
STAT,1892,29,20-24,1921,16.847494980803916
STAT,1962,30,50-100,1992,1.2475957439555498
SIM,1854,26,35-39,1880,16
STAT,1931,83,na,2014,2282.293436886879
STAT,1882,30,40-44,1912,4.927705640576625
STAT,1827,49,35-39,1876,0.1726320852383736
STAT,1902,42,25-29,1944,0.07262458579746144
SIM,1989,19,45-49,2008,1
STAT,1825,63,na,1888,1287.9078753565134
SIM,1973,21,40-44,1994,7
SIM,1964,20,25-29,1984,9
STAT,1816,48,20-24,1864,0.024106861317900935
STAT,1977,6,na,1983,6129.861555511417
SIM,1876,31,45-49,1907,5
STAT,1926,36,25-29,1962,1.389666803926021
STAT,1879,34,25-29,1913,12.236859768165857
SIM,1823,71,na,1894,1175
SIM,1974,28,15-19,2002,1
SIM,1928,30,40-44,1958,13
SIM,1918,16,25-29,1934,11
STAT,1924,48,20-24,1972,0.01513689246036522
SIM,1854,32,20-24,1886,3
SIM,1919,38,na,1957,5333
STAT,1878,44,35-39,1922,2.1524979013985077
SIM,1915,24,na,1939,4510
STAT,1827,27,15-19,1854,1.7491297352461335
SIM,1891,38,30-34,1929,9
STAT,1843,47,15-19,1890,3.9948092460506674E-4
SIM,1860,42,50-100,1902,2
STAT,1846,26,35-39,1872,12.154419167688923
STAT,1945,41,30-34,1986,0.16773481000941207
STAT,1976,18,35-39,1994,6.467552711989221
STAT,1884,42,na,1926,2632.0795641882332
STAT,1935,19,na,1954,5778.94099694926
SIM,1829,29,40-44,1858,7
SIM,1909,25,35-39,1934,30
SIM,1919,17,na,1936,5225
STAT,1986,18,50-100,2004,0.6158841265856755
STAT,1800,71,na,1871,828.3053796669113
STAT,1929,21,30-34,1950,42.07319303032834
SIM,1832,38,50-100,1870,1
STAT,1892,93,na,1985,255.50342504695845
STAT,1907,23,45-49,1930,1.1803757138534383
SIM,1886,44,35-39,1930,1
STAT,1965,21,40-44,1986,4.8619626734518855
SIM,1937,21,30-34,1958,3
SIM,1852,29,40-44,1881,8
STAT,1828,53,35-39,1881,0.0068311625806463825
SIM,1975,37,20-24,2012,1
SIM,1901,16,30-34,1917,6
STAT,1883,23,35-39,1906,6.568436151506957
SIM,1822,36,40-44,1858,6
STAT,1851,45,50-100,1896,0.19670119857036422
STAT,1878,46,25-29,1924,0.06960249455795536
SIM,1826,48,30-34,1874,1
STAT,1833,30,45-49,1863,1.6291531047189824
STAT,1950,17,50-100,1967,0.5112343871242759
STAT,1878,41,30-34,1919,1.3915672792778642
SIM,1968,18,na,1986,5044
STAT,1951,17,30-34,1968,16.750316427630516
STAT,1935,49,35-39,1984,0.20893914268418193
STAT,1844,26,25-29,1870,43.62661520462367
STAT,1905,21,na,1926,3962.320063579725
STAT,1927,21,20-24,1948,158.5443445775514
SIM,1837,41,35-39,1878,9
STAT,1965,24,45-49,1989,1.6253546358633395
SIM,1864,49,50-100,1913,2
SIM,1828,33,30-34,1861,8
SIM,1847,62,na,1909,1966
STAT,1857,30,30-34,1887,16.12120926172033
SIM,1886,41,30-34,1927,1
SIM,1955,28,20-24,1983,54
STAT,1818,45,15-19,1863,5.080817009119042E-4
SIM,1935,21,20-24,1956,7
STAT,1836,47,na,1883,2142.7170631627228
STAT,1864,65,na,1929,1741.4076390056662
STAT,1939,63,na,2002,3967.483462823023
STAT,1967,37,20-24,2004,0.3915049772213631
STAT,1950,38,20-24,1988,0.37021250244986154
STAT,1829,41,35-39,1870,1.9682094923305882
SIM,1891,23,35-39,1914,19
STAT,1844,29,40-44,1873,3.0233380108881525
STAT,1832,33,na,1865,1886.8799116313064
SIM,1877,76,na,1953,981
SIM,1909,39,na,1948,4698
STAT,1821,50,20-24,1871,0.0013389188779566214
STAT,1930,32,35-39,1962,13.611924363117947
SIM,1841,30,45-49,1871,5
SIM,1918,94,na,2012,473
SIM,1875,10,na,1885,3531
STAT,1833,47,30-34,1880,0.08034034187774679
SIM,1830,37,40-44,1867,2
SIM,1916,68,na,1984,3740
STAT,1843,42,20-24,1885,0.16406881235145276
STAT,1865,46,15-19,1911,4.176846047087411E-4
STAT,1941,28,15-19,1969,0.8425902870854477
SIM,1817,42,45-49,1859,3
SIM,1852,26,25-29,1878,96
SIM,1987,17,45-49,2004,1
SIM,1900,58,na,1958,3089
STAT,1856,49,50-100,1905,0.2117234508753515
STAT,1903,29,45-49,1932,1.812046694691864
SIM,1911,29,45-49,1940,6
SIM,1905,25,na,1930,4361
SIM,1953,41,na,1994,5618
STAT,1938,48,na,1986,4340.201406972409
SIM,1832,31,30-34,1863,10
STAT,1969,28,50-100,1997,1.4404345391693252
SIM,1837,49,45-49,1886,1
STAT,1822,37,40-44,1859,10.650387187695994
STAT,1882,26,50-100,1908,0.7235453813670195
SIM,1861,66,na,1927,1286
SIM,1852,30,20-24,1882,3
STAT,1978,29,45-49,2007,2.729990483694258
STAT,1955,22,50-100,1977,1.0113887892057825
STAT,1934,34,na,1968,5954.512975326856
STAT,1861,31,50-100,1892,0.8826449670161599
STAT,1882,94,na,1976,130.4571865345643
SIM,1872,29,na,1901,2949
STAT,1870,16,25-29,1886,6.547152563288511
SIM,1982,26,45-49,2008,1
STAT,1822,34,25-29,1856,29.381838490600884
STAT,1860,50,20-24,1910,6.962082751004052E-4
SIM,1890,79,na,1969,1372
STAT,1818,51,50-100,1869,0.01829978117222413
SIM,1826,39,40-44,1865,3
STAT,1854,43,35-39,1897,1.464607542247389
SIM,1839,34,45-49,1873,5
SIM,1826,40,20-24,1866,1
STAT,1911,30,20-24,1941,2.765446293251999
STAT,1978,30,25-29,2008,14.854933434930745
STAT,1897,42,40-44,1939,0.24073200534816203
SIM,1882,28,na,1910,3302
STAT,1868,31,45-49,1899,1.941395068974759
STAT,1962,38,45-49,2000,1.0374836760090986
SIM,1936,36,35-39,1972,5
STAT,1818,39,40-44,1857,6.3857911733559884
STAT,1982,27,45-49,2009,2.817634392983274
SIM,1958,34,20-24,1992,1
SIM,1970,38,45-49,2008,1
STAT,1834,99,na,1933,1.7283441693242896
STAT,1904,42,35-39,1946,0.20813315683750536
STAT,1971,43,50-100,2014,0.17817148884765502
STAT,1860,51,na,1911,2012.2619632452274
STAT,1866,27,15-19,1893,0.4853083067509587
SIM,1943,42,na,1985,5356
SIM,1911,38,35-39,1949,2
STAT,1818,48,30-34,1866,0.11777905225606827
STAT,1910,34,50-100,1944,0.9130799005573975
STAT,1947,28,20-24,1975,23.820457104530018
STAT,1898,45,15-19,1943,3.5542398801034926E-4
STAT,1832,51,35-39,1883,0.0063412150084331915
STAT,1974,26,45-49,2000,2.615814796807212
STAT,1891,103,na,1994,6.247442136151369
SIM,1893,4,na,1897,3865
STAT,1936,28,45-49,1964,1.908268435356633
SIM,1868,24,na,1892,3008
STAT,1984,20,50-100,2004,1.0828073368573654
SIM,1864,10,na,1874,3101
SIM,1950,7,na,1957,4818
SIM,1887,75,na,1962,2046
STAT,1945,34,na,1979,4853.744876966541
SIM,1911,58,na,1969,4343
STAT,1818,40,20-24,1858,0.22453809152138293
STAT,1844,35,15-19,1879,0.05568658959945905
SIM,1815,40,45-49,1855,1
STAT,1951,45,25-29,1996,0.07618077735219268
STAT,1954,20,15-19,1974,7.624763291815518
STAT,1949,48,na,1997,5114.577010702981
STAT,1846,23,30-34,1869,22.557224048657545
STAT,1855,33,25-29,1888,8.782392313857706
SIM,1799,66,na,1865,631
SIM,1947,34,45-49,1981,1
STAT,1964,28,50-100,1992,1.45231557932391
SIM,1859,38,40-44,1897,7
STAT,1973,42,40-44,2015,0.38796934284309664
STAT,1835,32,45-49,1867,1.3864382140316238
SIM,1859,47,na,1906,2154
SIM,1961,43,50-100,2004,2
STAT,1820,41,15-19,1861,0.017603628341578657
STAT,1923,40,40-44,1963,0.3381908212542176
STAT,1984,21,35-39,2005,15.489392987222354
STAT,1913,72,na,1985,3066.1194394503964
STAT,1881,21,35-39,1902,6.515253601367256
STAT,1850,21,30-34,1871,22.167936602840864
STAT,1903,38,35-39,1941,2.4969894370877417
STAT,1780,93,na,1873,9.56733083018644
STAT,1915,38,15-19,1953,0.02228063649916662
STAT,1892,17,15-19,1909,8.583938021231718
SIM,1962,23,30-34,1985,1
SIM,1876,24,20-24,1900,140
STAT,1910,43,na,1953,4030.5247752398022
STAT,1914,57,na,1971,4022.093059245729
SIM,1844,70,na,1914,1342
STAT,1841,30,40-44,1871,4.776322897686103
STAT,1875,50,40-44,1925,0.012735650434563284
STAT,1975,30,45-49,2005,2.4447755561780466
SIM,1909,34,25-29,1943,23
STAT,1870,19,40-44,1889,0.20760812893717884
SIM,1837,63,na,1900,1609
SIM,1864,43,45-49,1907,4
STAT,1896,38,40-44,1934,6.639470761564209
SIM,1827,85,na,1912,112
STAT,1946,19,na,1965,4708.16305367269
SIM,1854,23,30-34,1877,52
STAT,1939,34,45-49,1973,1.8512499630474946
SIM,1839,40,30-34,1879,1
SIM,1929,16,na,1945,4705
STAT,1900,30,45-49,1930,2.8149258907717933
STAT,1974,34,50-100,2008,1.2683561105670083
STAT,1914,29,20-24,1943,21.09483886256932
STAT,1829,77,na,1906,633.235811743724
STAT,1842,33,15-19,1875,0.13101544740653145
STAT,1881,29,45-49,1910,1.2270774319118134
SIM,1952,28,40-44,1980,20
STAT,1948,37,15-19,1985,0.026128406913564103
SIM,1908,17,na,1925,4291
STAT,1931,42,na,1973,5727.085060509668
SIM,1890,33,45-49,1923,5
STAT,1916,17,25-29,1933,10.611614185003878
SIM,1924,17,25-29,1941,145
SIM,1899,44,45-49,1943,2
STAT,1845,19,30-34,1864,1.3415445661874619
STAT,1935,56,na,1991,5765.561908844501
SIM,1858,62,na,1920,2131
STAT,1880,42,25-29,1922,0.7845458692699387
STAT,1949,41,15-19,1990,0.002145107936598832
STAT,1860,41,45-49,1901,1.39833662181392
SIM,1957,0,na,1957,6329
STAT,1944,28,40-44,1972,5.811181617209008
STAT,1840,51,30-34,1891,0.004797991525330943
STAT,1815,40,40-44,1855,6.072891987962351
SIM,1878,48,40-44,1926,1
STAT,1895,42,na,1937,3479.627018340652
SIM,1865,32,na,1897,3055
STAT,1811,71,na,1882,768.3710905239565
STAT,1899,56,na,1955,3224.805038485778
SIM,1887,25,35-39,1912,1
STAT,1889,42,45-49,1931,2.12645308547927
SIM,1898,38,na,1936,3915
SIM,1863,39,45-49,1902,6
STAT,1896,27,na,1923,3637.7442030882944
STAT,1857,24,45-49,1881,0.6490169772193912
SIM,1885,37,30-34,1922,16
STAT,1892,13,na,1905,3729.6399596526367
SIM,1809,45,na,1854,1743
STAT,1824,31,30-34,1855,41.455784264812486
STAT,1930,49,20-24,1979,0.016698922076307146
STAT,1954,23,30-34,1977,41.12608993085879
SIM,1984,22,na,2006,5841
STAT,1962,18,45-49,1980,0.738424155858572
SIM,1911,80,na,1991,2690
STAT,1922,49,25-29,1971,0.06988394102997056
STAT,1877,37,30-34,1914,6.397864594417271
STAT,1844,77,na,1921,722.9971448304756
SIM,1922,29,20-24,1951,1
SIM,1844,33,na,1877,2393
STAT,1970,18,40-44,1988,2.019980618489825
SIM,1984,15,30-34,1999,48
SIM,1848,47,na,1895,1667
SIM,1878,23,50-100,1901,1
STAT,1976,15,30-34,1991,18.80267884594462
SIM,1970,18,45-49,1988,2
SIM,1880,22,20-24,1902,5
STAT,1840,26,40-44,1866,3.0179161032989397
SIM,1893,17,50-100,1910,4
STAT,1879,25,35-39,1904,11.70602328821593
STAT,1907,20,40-44,1927,3.559365904695417
SIM,1904,3,na,1907,4489
STAT,1816,43,15-19,1859,0.03016986205463316
STAT,1836,51,50-100,1887,0.014190218701239142
STAT,1809,52,na,1861,1362.9555608330882
STAT,1856,40,40-44,1896,2.000355972404189
STAT,1920,20,50-100,1940,0.8488670514030582
SIM,1967,36,20-24,2003,1
SIM,1887,31,20-24,1918,4
STAT,1765,106,na,1871,0.0010870652004471362
STAT,1958,46,30-34,2004,0.1408961604054515
STAT,1960,47,25-29,2007,0.08293268241044573
STAT,1879,31,20-24,1910,3.2705479506198327
STAT,1888,16,25-29,1904,7.706220104595835
SIM,1888,43,30-34,1931,4
STAT,1846,25,na,1871,2744.7034431642446
SIM,1843,32,45-49,1875,4
SIM,1896,16,25-29,1912,24
STAT,1924,43,15-19,1967,0.002104125425301905
STAT,1881,13,na,1894,2870.2103299258883
STAT,1956,59,na,2015,5487.300127843286
STAT,1878,49,40-44,1927,0.20198124736102638
SIM,1963,38,na,2001,6493
STAT,1790,92,na,1882,11.911991296339064
SIM,1882,23,45-49,1905,6
SIM,1887,32,35-39,1919,27
SIM,1875,80,na,1955,645
SIM,1969,27,50-100,1996,1
STAT,1971,30,15-19,2001,0.19167681830593558
STAT,1882,42,35-39,1924,2.038663433671684
STAT,1866,53,50-100,1919,0.01589545205260647
STAT,1858,30,35-39,1888,9.308577640387549
STAT,1913,21,40-44,1934,3.7733984262304507
SIM,1821,43,25-29,1864,1
STAT,1912,39,15-19,1951,0.021432821923030625
STAT,1918,16,20-24,1934,34.24335175505718
STAT,1927,18,50-100,1945,0.5360740733611437
SIM,1935,27,40-44,1962,16
STAT,1971,22,40-44,1993,4.930881579866383
STAT,1991,22,40-44,2013,5.579320839490397
STAT,1976,17,20-24,1993,209.03044137745286
STAT,1873,53,35-39,1926,0.00998278897393513
STAT,1784,86,na,1870,73.39701812746655
SIM,1920,42,30-34,1962,1
SIM,1926,38,40-44,1964,2
STAT,1915,40,45-49,1955,0.19394018457800455
STAT,1980,15,50-100,1995,0.6005483469497779
SIM,1841,68,na,1909,1226
SIM,1890,42,35-39,1932,11
SIM,1854,11,na,1865,3201
SIM,1917,32,30-34,1949,26
STAT,1951,60,na,2011,4890.1554319869465
SIM,1823,40,40-44,1863,4
SIM,1907,25,25-29,1932,138
STAT,1836,63,na,1899,1623.837829774192
SIM,1822,39,45-49,1861,2
SIM,1823,55,na,1878,1907
SIM,1857,23,35-39,1880,7
SIM,1867,33,20-24,1900,5
SIM,1910,35,25-29,1945,1
STAT,1894,21,20-24,1915,102.54304087385351
SIM,1936,56,na,1992,3759
SIM,1967,39,25-29,2006,3
SIM,1898,75,na,1973,2250
SIM,1833,39,20-24,1872,3
SIM,1926,16,20-24,1942,4
STAT,1878,53,25-29,1931,0.004199441314624218
SIM,1849,58,na,1907,2234
STAT,1912,42,30-34,1954,0.1424338191463688
STAT,1952,17,35-39,1969,5.803143387446606
STAT,1883,21,45-49,1904,0.7897174580172381
SIM,1960,17,35-39,1977,6
STAT,1935,0,na,1935,7111.389285124225
STAT,1902,35,25-29,1937,1.0229767610688774
SIM,1969,28,35-39,1997,33
STAT,1918,2,na,1920,5136.211798508275
STAT,1825,39,20-24,1864,1.2042112513918506
SIM,1876,31,20-24,1907,5
SIM,1965,26,25-29,1991,73
STAT,1902,48,45-49,1950,0.21434760235869257
STAT,1859,36,25-29,1895,2.659599011547708
STAT,1911,33,25-29,1944,10.351578380224284
STAT,1982,24,40-44,2006,5.4745290582934905
SIM,1933,39,25-29,1972,3
STAT,1886,19,40-44,1905,0.2214559059360429
SIM,1893,28,na,1921,3363
STAT,1961,48,50-100,2009,0.3497992260726577
SIM,1908,34,30-34,1942,4
SIM,1855,20,20-24,1875,130
STAT,1929,17,35-39,1946,6.180382393685305
STAT,1947,49,15-19,1996,4.951736974012452E-4
STAT,1956,34,na,1990,5879.491726137463
STAT,1926,48,30-34,1974,0.12656071150969042
STAT,1836,20,45-49,1856,0.8722140288023736
STAT,1907,16,45-49,1923,0.11118837147551922
STAT,1918,38,40-44,1956,1.8186960767528708
STAT,1791,106,na,1897,0.0025991222394969597
STAT,1960,36,25-29,1996,1.5260942158281263
STAT,1862,52,20-24,1914,7.148576849745212E-4
STAT,1974,18,25-29,1992,65.28209750470046
STAT,1840,68,na,1908,1225.9224006791997
SIM,1791,92,na,1883,11
SIM,1910,48,45-49,1958,1
STAT,1813,42,50-100,1855,3.9692465830801926
SIM,1866,30,35-39,1896,32
STAT,1847,51,40-44,1898,0.008139303753608561
STAT,1957,26,25-29,1983,100.62805091451119
STAT,1924,36,15-19,1960,0.026149068983334484
STAT,1843,33,na,1876,2587.2573774499047
STAT,1846,33,35-39,1879,12.244157025889887
STAT,1813,43,25-29,1856,2.317001917063562
SIM,1888,41,40-44,1929,6
SIM,1955,21,50-100,1976,6
STAT,1885,64,na,1949,2001.040467649383
SIM,1990,24,40-44,2014,6
STAT,1925,39,25-29,1964,1.3604495793517377
STAT,1898,23,30-34,1921,27.6956228365844
SIM,1973,17,45-49,1990,1
STAT,1969,30,15-19,1999,0.1890492378321187
SIM,1983,30,45-49,2013,3
SIM,1880,20,30-34,1900,50
STAT,1948,22,40-44,1970,4.4552438491167194
STAT,1879,32,35-39,1911,12.203305742436632
SIM,1973,32,40-44,2005,7
SIM,1844,20,45-49,1864,5
SIM,1889,31,30-34,1920,42
SIM,1909,37,40-44,1946,3
STAT,1939,35,50-100,1974,0.5007465851128765
STAT,1958,35,30-34,1993,2.8510260820337345
STAT,1965,17,45-49,1982,0.7197187102597039
STAT,1916,22,50-100,1938,0.7957844829543379
SIM,1937,17,35-39,1954,6
STAT,1847,20,20-24,1867,65.9471031583588
STAT,1874,22,30-34,1896,21.044272690499547
SIM,1919,35,45-49,1954,2
STAT,1870,20,20-24,1890,78.87121053658088
STAT,1896,24,35-39,1920,8.839257282141727
SIM,1939,33,20-24,1972,5
SIM,1877,97,na,1974,183
STAT,1913,48,20-24,1961,0.012419948915697965
STAT,1815,85,na,1900,152.11216163049596
STAT,1937,49,45-49,1986,0.251870959695851
SIM,1957,34,na,1991,6258
STAT,1885,20,40-44,1905,2.4130036115200673
STAT,1855,31,35-39,1886,8.8655414909426
STAT,1859,33,45-49,1892,1.5963388597658232
SIM,1855,3,na,1858,2718
STAT,1952,38,30-34,1990,2.5941780278043574
SIM,1838,64,na,1902,1152
STAT,1939,27,45-49,1966,2.005141623938867
STAT,1854,66,na,1920,1335.2966205515336
STAT,1935,25,35-39,1960,23.651445848056873
STAT,1844,42,15-19,1886,0.011830001582080306
SIM,1901,96,na,1997,54
SIM,1925,72,na,1997,3678
STAT,1906,43,na,1949,3874.7569624628777
STAT,1851,52,45-49,1903,0.0114470048624259
STAT,1835,32,20-24,1867,2.149086044353144
SIM,1929,78,na,2007,2703
SIM,1981,18,20-24,1999,392
STAT,1969,32,25-29,2001,13.581916085516875
STAT,1821,109,na,1930,4.3512287653103685E-4
SIM,1943,25,35-39,1968,1
STAT,1973,18,20-24,1991,202.2877097380598
SIM,1823,49,na,1872,2088
STAT,1834,51,45-49,1885,0.013851239648619297
STAT,1962,44,na,2006,5688.18013429938
STAT,1850,22,45-49,1872,0.8616071599462963
STAT,1904,17,45-49,1921,0.10825370904580711
STAT,1886,28,na,1914,2894.915246963528
SIM,1945,49,45-49,1994,2
STAT,1953,17,40-44,1970,1.952683723809073
SIM,1841,78,na,1919,586
STAT,1840,29,45-49,1869,1.094666145706745
SIM,1911,74,na,1985,3396
SIM,1934,24,30-34,1958,49
SIM,1893,20,40-44,1913,9
STAT,1958,32,50-100,1990,1.2774177176462518
STAT,1885,23,20-24,1908,79.08069315822272
STAT,1926,24,30-34,1950,40.03557900067073
STAT,1978,35,30-34,2013,2.9624399584368413
STAT,1848,44,50-100,1892,1.1073576318483396
STAT,1851,15,15-19,1866,5.789719366137767
STAT,1865,103,na,1968,1.121543813706558
STAT,1883,3,na,1886,3357.899060731212
STAT,1895,42,30-34,1937,0.11978032705042578
STAT,1849,23,35-39,1872,5.429053586280748
SIM,1833,33,na,1866,1856
STAT,1845,54,25-29,1899,0.002321167264709739
SIM,1886,74,na,1960,870
STAT,1899,72,na,1971,2480.551026270772
STAT,1949,18,15-19,1967,60.892652233510525
SIM,1945,25,45-49,1970,2
STAT,1856,52,35-39,1908,0.007539488573995525
STAT,1987,17,40-44,2004,2.304381069749398
SIM,1893,23,20-24,1916,1
SIM,1845,49,40-44,1894,1
SIM,1901,28,25-29,1929,141
SIM,1977,32,25-29,2009,40
STAT,1844,30,20-24,1874,2.7603932514922005
STAT,1871,41,20-24,1912,0.183162462613615
STAT,1983,16,25-29,1999,70.76655428401254
SIM,1828,43,35-39,1871,4
STAT,1833,98,na,1931,2.2859129955268247
SIM,1928,15,na,1943,5353
SIM,1931,19,na,1950,5870
STAT,1879,58,na,1937,2383.0423022125406
SIM,1931,43,45-49,1974,1
STAT,1881,26,40-44,1907,3.3458923058709296
STAT,1924,24,20-24,1948,150.43114558384255
SIM,1930,27,50-100,1957,1
STAT,1944,17,na,1961,4571.45205160439
SIM,1947,27,45-49,1974,4
SIM,1995,17,40-44,2012,5
SIM,1936,8,na,1944,4129
SIM,1878,23,na,1901,2600
STAT,1859,27,50-100,1886,0.5982229346304112
STAT,1824,38,50-100,1862,1.8397559759344102
STAT,1837,49,40-44,1886,0.12543321483161016
STAT,1890,36,50-100,1926,1.7395975439502083
SIM,1878,34,35-39,1912,27
STAT,1938,15,35-39,1953,4.801440127405661
STAT,1914,98,na,2012,87.08809041680142
SIM,1879,24,25-29,1903,144
STAT,1923,43,45-49,1966,0.2240505111408958
SIM,1932,24,20-24,1956,295
STAT,1895,45,25-29,1940,0.049294609752637684
STAT,1874,80,na,1954,730.8388782392033
STAT,1927,27,40-44,1954,6.537953725743893
STAT,1974,15,45-49,1989,0.7531712465740286
SIM,1863,31,35-39,1894,18
STAT,1948,28,25-29,1976,87.26073485251005
SIM,1956,28,25-29,1984,190
SIM,1921,21,40-44,1942,4
STAT,1967,45,50-100,2012,0.34074094458265547
SIM,1982,15,45-49,1997,2
STAT,1945,27,50-100,1972,1.2602198621607046
SIM,1846,22,20-24,1868,51
STAT,1934,46,25-29,1980,0.08554398038887616
STAT,1937,25,45-49,1962,1.9462314769282751
STAT,1838,22,20-24,1860,77.45978089882253
STAT,1909,35,35-39,1944,2.6701859004012856
SIM,1956,25,20-24,1981,2
STAT,1913,24,45-49,1937,1.3037093983073957
SIM,1856,33,45-49,1889,2
STAT,1848,31,50-100,1879,1.1471666747145264
STAT,1887,47,40-44,1934,0.2203846427470472
SIM,1900,38,35-39,1938,3
STAT,1868,25,na,1893,2664.05171429669
STAT,1920,27,30-34,1947,49.58236930711994
SIM,1811,43,50-100,1854,3
STAT,1838,25,25-29,1863,47.295771367949605
SIM,1871,50,na,1921,1876
STAT,1958,49,35-39,2007,0.20207862639409607
STAT,1824,49,30-34,1873,0.12805721249129629
STAT,1872,20,30-34,1892,20.76406843726387
SIM,1871,34,25-29,1905,2
STAT,1950,39,35-39,1989,3.3930791075140823
STAT,1904,58,na,1962,3445.1341139817796
SIM,1917,35,35-39,1952,4
SIM,1945,24,30-34,1969,66
STAT,1924,72,na,1996,3736.852747190844
STAT,1976,35,20-24,2011,0.4194521338297923
STAT,1914,17,15-19,1931,10.839228621703368
SIM,1841,84,na,1925,188
SIM,1922,17,15-19,1939,51
STAT,1869,52,30-34,1921,0.006617203478508509
STAT,1861,52,na,1913,2054.767511362324
STAT,1898,26,35-39,1924,15.100888905156024
STAT,1937,24,30-34,1961,32.295381064689884
STAT,1873,50,30-34,1923,0.0071158279480496725
SIM,1898,26,50-100,1924,1
SIM,1942,4,na,1946,5124
STAT,1912,45,35-39,1957,0.1438054774794008
STAT,1971,25,45-49,1996,2.5383119543817196
SIM,1960,38,na,1998,6202
STAT,1916,29,30-34,1945,46.424954249237
STAT,1916,35,50-100,1951,0.5009517455638908
STAT,1960,33,20-24,1993,3.734779911631395
SIM,1916,19,30-34,1935,17
SIM,1861,36,30-34,1897,1
STAT,1819,51,na,1870,1695.0483573231108
SIM,1892,20,35-39,1912,18
SIM,1893,26,25-29,1919,78
STAT,1877,36,50-100,1913,1.4809312285222047
STAT,1889,94,na,1983,189.98487247109682
STAT,1942,19,30-34,1961,14.692626493099349
STAT,1894,79,na,1973,1631.7619830397823
STAT,1973,38,20-24,2011,0.4049401597199901
SIM,1858,2,na,1860,3821
STAT,1857,31,45-49,1888,1.5935034620074024
STAT,1848,33,45-49,1881,1.945982996920342
SIM,1869,46,na,1915,1835
SIM,1980,18,15-19,1998,137
SIM,1880,0,na,1880,4249
STAT,1884,20,35-39,1904,6.693436822502648
STAT,1972,18,15-19,1990,67.03722948531195
SIM,1881,41,40-44,1922,7
SIM,1901,25,20-24,1926,32
STAT,1871,44,25-29,1915,0.7273255596851441
STAT,1946,23,45-49,1969,1.4444870925967244
STAT,1948,49,20-24,1997,0.01509192943958753
STAT,1931,28,45-49,1959,2.5733404925172536
STAT,1832,97,na,1929,3.660056753881246
STAT,1976,26,na,2002,5803.395390586394
STAT,1885,26,25-29,1911,48.86066076116435
SIM,1968,28,na,1996,4916
STAT,1858,52,45-49,1910,0.012995769742814934
SIM,1803,67,na,1870,1075
STAT,1930,82,na,2012,2450.419195181967
STAT,1845,30,na,1875,1772.8768212562775
SIM,1888,44,45-49,1932,5
STAT,1864,44,na,1908,2349.4504490329105
SIM,1900,25,15-19,1925,3
STAT,1872,95,na,1967,61.19705605061753
SIM,1787,71,na,1858,1018
STAT,1879,74,na,1953,1337.3161843287594
SIM,1911,64,na,1975,4096
STAT,1848,32,30-34,1880,21.634270624137304
STAT,1894,41,na,1935,3444.3293690987953
SIM,1845,34,na,1879,2135
SIM,1924,35,50-100,1959,2
STAT,1963,15,45-49,1978,0.7327960613058814
STAT,1853,36,30-34,1889,5.361614325854751
STAT,1857,36,15-19,1893,0.05071524573566507
STAT,1948,25,45-49,1973,2.29346386416464
STAT,1873,41,40-44,1914,2.6627427626533002
SIM,1898,81,na,1979,1592
SIM,1830,35,na,1865,2050
STAT,1903,45,50-100,1948,0.22999734919614997
SIM,1856,32,30-34,1888,34
STAT,1955,58,na,2013,5553.524898783316
SIM,1876,6,na,1882,3080
STAT,1874,23,45-49,1897,0.8213029531147767
SIM,1895,47,40-44,1942,1
STAT,1975,18,30-34,1993,18.551139852888635
SIM,1848,22,30-34,1870,46
SIM,1956,25,45-49,1981,1
STAT,1824,32,45-49,1856,4.134325144825842
STAT,1956,40,na,1996,5910.323267003027
SIM,1925,80,na,2005,2300
STAT,1847,96,na,1943,6.60704100422142
STAT,1846,30,30-34,1876,21.777661488135458
STAT,1924,49,35-39,1973,0.17605138729529674
STAT,1864,15,25-29,1879,6.71686601076466
SIM,1960,44,25-29,2004,1
SIM,1908,60,na,1968,3261
SIM,1908,37,35-39,1945,5
SIM,1888,31,25-29,1919,16
STAT,1897,34,50-100,1931,1.4017843426307224
STAT,1874,27,na,1901,2819.551287654376
STAT,1879,30,50-100,1909,1.112968048169506
STAT,1985,29,25-29,2014,108.39619716915367
SIM,1839,41,45-49,1880,3
STAT,1935,22,30-34,1957,45.19198961516164
SIM,1921,1,na,1922,5767
SIM,1957,28,30-34,1985,116
STAT,1885,23,45-49,1908,0.8002129976919738
SIM,1829,30,20-24,1859,5
STAT,1851,29,20-24,1880,10.736642476755161
SIM,1891,19,15-19,1910,13
STAT,1915,17,20-24,1932,32.75219388145697
STAT,1875,38,na,1913,2795.791327110037
SIM,1921,42,na,1963,5212
STAT,1886,16,15-19,1902,7.241937563240152
SIM,1854,30,30-34,1884,8
STAT,1883,19,15-19,1902,6.664721257519724
STAT,1904,35,35-39,1939,2.5539844701373418
STAT,1835,44,15-19,1879,0.010065185691496345
SIM,1931,82,na,2013,2771
SIM,1923,17,20-24,1940,355
STAT,1926,27,35-39,1953,20.765987017757364
STAT,1786,71,na,1857,991.9442820173101
STAT,1929,66,na,1995,4707.630137340341
SIM,1984,19,30-34,2003,45
STAT,1934,43,20-24,1977,0.02833958881544894
SIM,1791,86,na,1877,70
SIM,1972,24,50-100,1996,3
STAT,1959,26,35-39,1985,22.772319795549834
STAT,1964,24,50-100,1988,0.9589172744027832
SIM,1867,30,40-44,1897,7
STAT,1972,29,15-19,2001,1.0465924951527403
STAT,1951,50,na,2001,5204.043152327345
SIM,1838,80,na,1918,158
SIM,1902,37,30-34,1939,7
STAT,1921,84,na,2005,1747.4617977506703
STAT,1870,32,15-19,1902,0.16202065504517688
STAT,1870,23,25-29,1893,64.92846615127355
STAT,1950,26,15-19,1976,0.9679031673266327
SIM,1982,15,20-24,1997,436
SIM,1842,16,15-19,1858,13
SIM,1859,22,50-100,1881,3
SIM,1798,65,na,1863,1076
STAT,1883,108,na,1991,0.16021265592336015
STAT,1974,15,20-24,1989,204.4107174196022
SIM,1963,44,na,2007,6465
STAT,1924,19,na,1943,5029.876500394233
STAT,1859,30,40-44,1889,4.044839544802928
SIM,1828,86,na,1914,359
STAT,1855,83,na,1938,337.7944645336379
STAT,1870,50,na,1920,2484.9143393618037
STAT,1925,15,25-29,1940,60.674054910605484
STAT,1930,25,35-39,1955,22.053275273347502
SIM,1989,20,25-29,2009,180
SIM,1886,58,na,1944,1658
SIM,1905,38,50-100,1943,1
SIM,1967,26,35-39,1993,5
SIM,1924,29,30-34,1953,119
STAT,1902,23,30-34,1925,28.95545816003759
SIM,1970,16,na,1986,5642
STAT,1940,18,50-100,1958,0.43900269392203806
STAT,1944,33,na,1977,4785.0585358487
STAT,1907,60,na,1967,3523.1484588869607
STAT,1927,17,25-29,1944,62.16879591193946
SIM,1935,17,25-29,1952,162
STAT,1956,35,20-24,1991,0.4154457753476987
SIM,1894,45,na,1939,3654
STAT,1845,51,20-24,1896,4.996297547262072E-4
STAT,1978,26,40-44,2004,7.376047332984034
SIM,1805,52,na,1857,1520
STAT,1909,32,30-34,1941,17.370152239273246
STAT,1908,19,30-34,1927,2.7173862386166836
STAT,1840,84,na,1924,266.86291977093333
STAT,1859,33,20-24,1892,2.474448216199477
STAT,1945,44,35-39,1989,0.2629367052872463
SIM,1971,32,30-34,2003,60
STAT,1948,25,20-24,1973,24.232715442791612
STAT,1949,28,30-34,1977,52.791654856936646
SIM,1910,23,30-34,1933,64
SIM,1827,48,50-100,1875,1
SIM,1846,25,25-29,1871,39
SIM,1919,34,30-34,1953,4
STAT,1844,33,25-29,1877,10.13904582859953
STAT,1850,39,30-34,1889,5.4588431143271885
SIM,1821,40,30-34,1861,1
SIM,1844,23,25-29,1867,73
SIM,1981,30,35-39,2011,3
STAT,1949,62,na,2011,4668.620561847188
STAT,1905,38,45-49,1943,0.7151358413700852
SIM,1867,36,25-29,1903,11
STAT,1951,29,25-29,1980,90.75371826207048
STAT,1854,110,na,1964,0.0011828793035201432
SIM,1990,12,na,2002,6329
STAT,1959,32,na,1991,5819.624198947148
SIM,1928,33,45-49,1961,7
STAT,1822,41,25-29,1863,1.3481551653397317
SIM,1913,38,45-49,1951,2
SIM,1958,27,20-24,1985,35
STAT,1913,40,35-39,1953,0.2293095546610909
SIM,1833,27,na,1860,1993
SIM,1986,26,40-44,2012,21
STAT,1827,46,30-34,1873,0.12425429734920262
STAT,1889,109,na,1998,0.10045233743214266
SIM,1973,28,45-49,2001,8
STAT,1836,23,25-29,1859,68.28665684666345
STAT,1973,30,35-39,2003,13.918720602433174
SIM,1869,25,na,1894,1926
STAT,1861,34,15-19,1895,0.13545720556759566
STAT,1962,36,na,1998,5736.570423955402
STAT,1816,49,na,1865,1433.5890775447026
SIM,1842,69,na,1911,1234
STAT,1955,26,50-100,1981,1.5321687724793283
SIM,1959,28,40-44,1987,7
SIM,1944,43,30-34,1987,1
STAT,1853,29,30-34,1882,26.052138720371246
SIM,1925,23,na,1948,5066
SIM,1871,31,20-24,1902,3
SIM,1982,29,25-29,2011,230
STAT,1987,24,40-44,2011,5.55400514717899
SIM,1911,23,25-29,1934,3
STAT,1986,19,na,2005,6048.559323300233
STAT,1869,96,na,1965,33.91831143423057
SIM,1856,35,35-39,1891,8
STAT,1826,52,50-100,1878,0.01049937353129589
STAT,1934,40,na,1974,5985.7379210678555
SIM,1904,88,na,1992,1014
STAT,1921,18,35-39,1939,5.5033684716297095
SIM,1964,39,na,2003,5829
SIM,1960,16,20-24,1976,223
STAT,1952,16,20-24,1968,187.5493162152839
STAT,1809,45,25-29,1854,0.14771267777162606
SIM,1838,40,25-29,1878,2
STAT,1926,48,40-44,1974,0.22383464638751044
SIM,1876,81,na,1957,805
SIM,1891,30,35-39,1921,24
STAT,1937,22,40-44,1959,3.7807161263909035
STAT,1961,24,25-29,1985,138.0840016655732
SIM,1861,29,30-34,1890,3
SIM,1945,22,40-44,1967,9
STAT,1924,27,25-29,1951,88.41821019852318
STAT,1830,91,na,1921,36.35164323357604
SIM,1880,27,50-100,1907,2
SIM,1953,61,na,2014,5229
STAT,1940,29,25-29,1969,77.40628860632386
STAT,1952,38,40-44,1990,2.130754456402209
SIM,1851,46,na,1897,2594
SIM,1960,38,40-44,1998,1
STAT,1829,34,50-100,1863,1.1062740427367692
STAT,1926,49,45-49,1975,0.30760366482447177
SIM,1932,27,25-29,1959,9
SIM,1946,18,na,1964,4359
STAT,1823,50,40-44,1873,0.010425626162974079
STAT,1903,23,25-29,1926,93.8082653991497
SIM,1914,36,50-100,1950,1
STAT,1883,26,15-19,1909,0.5140300204372824
SIM,1871,53,40-44,1924,1
SIM,1939,21,na,1960,4406
STAT,1846,42,25-29,1888,0.671887074738829
STAT,1848,35,35-39,1883,7.907051607429643
STAT,1941,16,45-49,1957,0.5941128414430394
SIM,1848,57,na,1905,1420
SIM,1955,44,45-49,1999,1
STAT,1926,26,20-24,1952,25.334542562681627
STAT,1906,16,na,1922,4260.708044466821
SIM,1882,32,35-39,1914,23
STAT,1875,9,na,1884,3170.066556429617
STAT,1863,53,40-44,1916,0.010452985464894924
SIM,1908,44,na,1952,3614
STAT,1984,15,na,1999,6036.195400822311
SIM,1854,42,25-29,1896,2
SIM,1878,33,20-24,1911,6
SIM,1833,22,35-39,1855,11
STAT,1945,18,na,1963,4638.696276733716
STAT,1951,49,25-29,2000,0.07537947204622848
STAT,1974,38,50-100,2012,0.6511693416047178
SIM,1866,30,50-100,1896,2
SIM,1902,37,40-44,1939,5
STAT,1895,26,na,1921,3597.3188891279888
STAT,1875,18,50-100,1893,0.05827441002430321
STAT,1917,29,25-29,1946,79.09290379373229
STAT,1910,17,20-24,1927,31.034211452347343
STAT,1827,39,30-34,1866,7.3816392656672525
STAT,1947,21,50-100,1968,0.8584764581533469
SIM,1967,28,25-29,1995,7
SIM,1966,32,na,1998,5706
SIM,1971,17,na,1988,5802
SIM,1914,4,na,1918,4427
SIM,1960,39,45-49,1999,4
STAT,1787,72,na,1859,429.0621207003417
SIM,1903,28,35-39,1931,2
SIM,1895,35,50-100,1930,1
STAT,1874,32,35-39,1906,11.964594157291074
SIM,1924,22,50-100,1946,2
SIM,1925,29,25-29,1954,11
STAT,1953,29,35-39,1982,21.02951352683859
SIM,1862,83,na,1945,579
STAT,1874,20,40-44,1894,2.476599352590009
STAT,1928,15,40-44,1943,2.0433264465725998
STAT,1840,29,20-24,1869,11.56623116162808
STAT,1915,99,na,2014,60.7830782495776
SIM,1909,27,25-29,1936,99
STAT,1952,39,45-49,1991,0.9692451422260444
STAT,1935,34,25-29,1969,14.745871948485934
STAT,1941,10,na,1951,4698.119729408785
STAT,1835,35,25-29,1870,2.2688821120322253
STAT,1882,78,na,1960,1073.983108645182
STAT,1991,18,45-49,2009,0.8259178519245586
SIM,1943,34,25-29,1977,2
SIM,1961,29,35-39,1990,38
STAT,1894,19,50-100,1913,0.07229159741312574
STAT,1937,27,35-39,1964,16.89873121703203
STAT,1936,43,30-34,1979,0.14596271016704102
STAT,1870,34,na,1904,2691.7193658434735
STAT,1816,102,na,1918,0.14478442040399564
STAT,1855,67,na,1922,1348.8547871447156
SIM,1889,34,35-39,1923,33
STAT,1836,25,15-19,1861,0.5422298289656681
STAT,1919,17,40-44,1936,1.7833826192304763
SIM,1908,43,20-24,1951,2
SIM,1922,36,20-24,1958,2
STAT,1826,49,40-44,1875,0.12001583590876508
STAT,1948,0,na,1948,5850.5269060854025
STAT,1856,30,25-29,1886,9.320063066919609
STAT,1903,100,na,2003,33.87082259010896
SIM,1926,38,30-34,1964,4
SIM,1941,40,na,1981,3953
STAT,1917,84,na,2001,1619.7395116806522
STAT,1973,30,25-29,2003,14.077517391191593
STAT,1884,42,45-49,1926,1.7043995583050044
SIM,1919,32,40-44,1951,13
STAT,1950,17,25-29,1967,59.132789378708175
SIM,1921,26,na,1947,4980
SIM,1969,34,40-44,2003,14
STAT,1946,28,15-19,1974,0.9070796483459608
STAT,1952,51,na,2003,5217.418792899952
STAT,1836,20,20-24,1856,86.19616299530344
STAT,1831,28,40-44,1859,3.100341982828976
STAT,1845,51,30-34,1896,0.004030346538964166
SIM,1928,20,15-19,1948,7
SIM,1919,37,35-39,1956,5
STAT,1842,47,50-100,1889,0.18902697719698647
STAT,1900,35,15-19,1935,0.09077743917968002
SIM,1880,23,35-39,1903,14
SIM,1912,32,30-34,1944,40
SIM,1973,35,45-49,2008,4
STAT,1927,39,35-39,1966,3.4623352162497807
STAT,1908,106,na,2014,1.3797601527872407
SIM,1934,26,20-24,1960,3
STAT,1861,25,25-29,1886,41.47255010772202
SIM,1767,88,na,1855,106
STAT,1811,43,15-19,1854,0.05165755521912774
STAT,1864,59,na,1923,2002.6262625220766
SIM,1834,49,40-44,1883,1
SIM,1844,20,20-24,1864,113
SIM,1969,39,35-39,2008,8
STAT,1942,28,20-24,1970,22.102948395429035
SIM,1829,33,25-29,1862,14
SIM,1835,39,30-34,1874,6
STAT,1914,36,20-24,1950,0.3053510527301014
SIM,1943,31,20-24,1974,4
SIM,1978,22,15-19,2000,13
SIM,1891,26,15-19,1917,1
STAT,1922,27,50-100,1949,1.2992356153323605
SIM,1950,28,20-24,1978,56
STAT,1959,28,25-29,1987,99.74224881051697
STAT,1959,16,na,1975,5557.943512281219
STAT,1850,46,na,1896,2322.6654845584253
SIM,1887,59,na,1946,3119
STAT,1840,16,50-100,1856,0.05118604522785629
STAT,1885,106,na,1991,0.7405464525919007
STAT,1934,55,na,1989,5724.394918207348
SIM,1942,25,na,1967,4709
STAT,1905,16,35-39,1921,0.9187721219728899
SIM,1966,32,50-100,1998,2
STAT,1913,7,na,1920,4703.625056548961
STAT,1904,32,30-34,1936,16.614236131034247
STAT,1976,28,20-24,2004,28.25200450213215
STAT,1846,31,na,1877,2675.309106800122
STAT,1854,48,40-44,1902,0.13772360107343262
STAT,1874,21,50-100,1895,0.48323739650508546
SIM,1935,39,35-39,1974,7
STAT,1847,21,35-39,1868,5.544276276480783
STAT,1923,18,na,1941,4972.991686231433
STAT,1930,22,30-34,1952,42.49692357754884
STAT,1831,35,40-44,1866,4.419625055558445
SIM,1952,28,30-34,1980,176
SIM,1953,27,50-100,1980,1
STAT,1980,24,30-34,2004,46.16664722977514
SIM,1834,41,45-49,1875,1
SIM,1967,23,30-34,1990,111
SIM,1937,39,45-49,1976,2
STAT,1950,21,45-49,1971,1.5409297759285066
STAT,1862,15,15-19,1877,6.698341691273617
STAT,1890,49,50-100,1939,0.19127754202316274
SIM,1763,95,na,1858,5
SIM,1870,15,15-19,1885,8
SIM,1908,36,20-24,1944,1
STAT,1956,3,na,1959,6007.101140643188
SIM,1822,39,50-100,1861,6
SIM,1981,30,25-29,2011,3
STAT,1794,103,na,1897,0.035919705018912645
STAT,1902,26,35-39,1928,15.787807317156044
STAT,1896,23,20-24,1919,104.7177757364297
STAT,1929,39,45-49,1968,1.0079337193487792
SIM,1984,28,20-24,2012,58
SIM,1816,79,na,1895,448
SIM,1923,33,45-49,1956,5
SIM,1927,17,40-44,1944,3
STAT,1916,38,20-24,1954,0.3100225012098007
SIM,1971,35,35-39,2006,11
STAT,1944,28,30-34,1972,48.85110040149605
SIM,1910,26,35-39,1936,1
STAT,1878,31,15-19,1909,0.17229616372437737
STAT,1883,30,35-39,1913,11.526303378537623
STAT,1925,37,35-39,1962,3.3491563351911866
SIM,1855,21,35-39,1876,5
SIM,1897,80,na,1977,1487
STAT,1993,22,50-100,2015,1.0961403946285402
STAT,1909,41,20-24,1950,0.019194311028717152
STAT,1925,15,15-19,1940,63.541647164690154
STAT,1857,29,15-19,1886,0.4140228019723839
SIM,1865,29,15-19,1894,2
STAT,1962,4,na,1966,5815.093076884823
STAT,1959,23,30-34,1982,43.516117645513184
SIM,1864,30,25-29,1894,12
STAT,1894,33,15-19,1927,0.21037581878188805
STAT,1812,99,na,1911,0.8314707826733918
STAT,1915,33,45-49,1948,1.8420289375674384
SIM,1933,37,35-39,1970,2
STAT,1909,101,na,2010,23.684912460620946
STAT,1920,27,40-44,1947,5.898171191377698
STAT,1962,36,35-39,1998,3.688085761954876
STAT,1956,38,25-29,1994,1.547483369570812
STAT,1869,15,25-29,1884,6.497193214777811
STAT,1790,76,na,1866,385.2886170594555
STAT,1902,32,20-24,1934,4.407683309195067
STAT,1854,30,15-19,1884,0.12130375665386785
STAT,1917,17,30-34,1934,3.0270623498720055
STAT,1868,43,15-19,1911,0.01520128228444454
STAT,1961,21,20-24,1982,166.39406931679594
STAT,1801,66,na,1867,886.7498866247893
STAT,1831,32,na,1863,2202.23991406624
SIM,1911,20,20-24,1931,4
STAT,1906,26,45-49,1932,1.8749091127996333
SIM,1833,37,30-34,1870,11
SIM,1908,70,na,1978,2778
STAT,1957,23,20-24,1980,169.69319894056446
STAT,1894,24,25-29,1918,84.39445687803821
STAT,1837,64,na,1901,1258.7942124354342
STAT,1925,73,na,1998,3678.9464500537842
STAT,1861,44,50-100,1905,0.9998863127479802
STAT,1889,47,15-19,1936,3.194823257750798E-4
STAT,1834,23,15-19,1857,3.9975604828653815
STAT,1823,53,45-49,1876,0.013539575275799359
STAT,1936,46,35-39,1982,0.14793024967193288
STAT,1974,23,50-100,1997,0.9945000338698438
STAT,1920,28,45-49,1948,2.178456703891853
STAT,1921,15,30-34,1936,16.102436930285354
SIM,1960,19,25-29,1979,173
STAT,1872,32,25-29,1904,11.869152495776037
SIM,1918,22,na,1940,3835
SIM,1901,26,35-39,1927,33
SIM,1925,17,30-34,1942,42
SIM,1862,30,15-19,1892,1
STAT,1872,27,50-100,1899,0.7412769514286401
STAT,1903,16,25-29,1919,9.33771644661088
SIM,1965,23,20-24,1988,289
STAT,1987,27,45-49,2014,2.858539201246978
SIM,1844,16,25-29,1860,15
STAT,1940,26,20-24,1966,21.49802512439062
SIM,1921,33,35-39,1954,6
STAT,1818,50,na,1868,1195.3318276056104
STAT,1920,26,na,1946,4756.716471468726
STAT,1825,37,30-34,1862,8.85178414572015
STAT,1952,19,25-29,1971,59.89112623451117
SIM,1868,3,na,1871,3707
SIM,1903,23,na,1926,3616
SIM,1909,15,30-34,1924,4
STAT,1905,59,na,1964,3461.8320852427596
SIM,1907,22,20-24,1929,212
STAT,1800,55,na,1855,1459.80071
STAT,1949,37,20-24,1986,0.364510474934722
SIM,1952,5,na,1957,4846
STAT,1816,65,na,1881,964.844759719854
STAT,1913,33,35-39,1946,10.45383989583358
SIM,1984,27,na,2011,5988
SIM,1932,77,na,2009,3037
STAT,1871,30,50-100,1901,1.060421525587446
STAT,1928,18,45-49,1946,0.7244812529042957
STAT,1924,62,na,1986,4593.287355298223
SIM,1860,39,40-44,1899,11
SIM,1913,7,na,1920,5118
STAT,1809,79,na,1888,341.4363017655645
STAT,1868,34,25-29,1902,11.259436818562769
SIM,1843,32,20-24,1875,5
SIM,1878,36,25-29,1914,2
SIM,1962,43,na,2005,5483
STAT,1852,39,40-44,1891,4.085630336816179
SIM,1903,25,30-34,1928,93
STAT,1965,35,45-49,2000,1.0136538822964984
SIM,1856,44,50-100,1900,7
STAT,1926,29,25-29,1955,90.38852891078464
SIM,1829,31,35-39,1860,12
SIM,1832,32,na,1864,2331
SIM,1926,73,na,1999,4346
SIM,1900,20,45-49,1920,7
SIM,1855,23,25-29,1878,133
SIM,1876,34,25-29,1910,11
STAT,1865,113,na,1978,3.934335046445059E-4
STAT,1847,23,25-29,1870,53.61070369186176
STAT,1958,38,35-39,1996,3.773259785339842
STAT,1868,31,20-24,1899,3.0093119239531405
STAT,1903,20,20-24,1923,113.95266034977278
STAT,1978,28,30-34,2006,61.94833087435497
STAT,1812,52,30-34,1864,0.013186065932573598
SIM,1893,44,na,1937,3325
STAT,1935,31,20-24,1966,3.8987728296628514
SIM,1877,15,25-29,1892,21
STAT,1918,38,30-34,1956,2.214249223973321
STAT,1948,61,na,2009,4648.975140041999
SIM,1967,25,20-24,1992,31
STAT,1994,19,50-100,2013,0.6235128130903285
STAT,1964,39,50-100,2003,0.6273871685661412
SIM,1947,18,20-24,1965,355
SIM,1986,28,30-34,2014,7
STAT,1951,27,35-39,1978,20.721377181495047
STAT,1976,26,30-34,2002,60.70018341562369
SIM,1914,26,45-49,1940,3
SIM,1832,41,35-39,1873,5
STAT,1972,42,35-39,2014,0.30921457235638905
STAT,1888,9,na,1897,3519.813347588764
STAT,1893,45,15-19,1938,3.324165546250643E-4
STAT,1917,26,20-24,1943,22.168549059429534
STAT,1896,80,na,1976,1602.4339353931327
SIM,1918,37,na,1955,3839
SIM,1880,96,na,1976,69
STAT,1939,18,20-24,1957,156.62749283029794
STAT,1939,24,40-44,1963,3.895894411845465
SIM,1855,27,na,1882,1892
SIM,1939,36,25-29,1975,2
SIM,1771,88,na,1859,15
SIM,1920,41,na,1961,4131
STAT,1851,27,30-34,1878,23.38106050403607
STAT,1959,25,20-24,1984,27.698890424595728
STAT,1854,82,na,1936,380.12329845240953
STAT,1766,111,na,1877,0.0030043067059017303
STAT,1881,19,40-44,1900,0.20250288029265395
STAT,1914,39,25-29,1953,1.1236296361489764
SIM,1969,37,45-49,2006,3
SIM,1854,33,35-39,1887,28
STAT,1884,44,50-100,1928,1.188328928296764
STAT,1885,47,30-34,1932,0.11090789639104498
SIM,1792,87,na,1879,9
SIM,1934,29,25-29,1963,96
STAT,1875,81,na,1956,687.7830577116123
SIM,1984,26,30-34,2010,91
STAT,1869,52,20-24,1921,8.203145111661591E-4
SIM,1889,32,45-49,1921,3
STAT,1917,22,na,1939,4479.182170268739
STAT,1942,49,50-100,1991,0.28211515864134773
STAT,1824,41,35-39,1865,2.6206281640500713
SIM,1950,49,50-100,1999,1
SIM,1909,24,20-24,1933,12
STAT,1882,20,25-29,1902,64.91312360599325
STAT,1909,44,25-29,1953,0.0762192908553672
SIM,1922,39,25-29,1961,1
STAT,1961,43,na,2004,5745.635286099966
STAT,1874,25,35-39,1899,11.477039156058725
STAT,1896,21,30-34,1917,27.232986887683918
STAT,1830,47,40-44,1877,0.15795987011614113
SIM,1922,37,na,1959,5012
STAT,1849,20,30-34,1869,16.93384483856821
STAT,1962,33,30-34,1995,23.732253411641402
SIM,1943,36,na,1979,5338
SIM,1901,38,na,1939,4105
STAT,1861,22,20-24,1883,67.92266127564504
SIM,1923,30,40-44,1953,2
STAT,1793,68,na,1861,724.0596523657076
SIM,1802,66,na,1868,843
SIM,1914,19,20-24,1933,61
STAT,1867,101,na,1968,3.9973035408550244
STAT,1947,44,45-49,1991,0.224092101662297
STAT,1925,17,15-19,1942,63.24778871425515
STAT,1930,19,50-100,1949,0.5560619271759336
STAT,1961,41,20-24,2002,0.027404193371153525
STAT,1836,53,na,1889,1943.7599400670317
STAT,1961,15,35-39,1976,6.259771744576087
STAT,1989,26,40-44,2015,7.741435917931007
SIM,1958,35,na,1993,6167
SIM,1819,50,na,1869,1032
STAT,1906,19,20-24,1925,29.67483326024345
STAT,1938,21,na,1959,4174.367450255236
SIM,1853,31,na,1884,2347
SIM,1857,20,30-34,1877,30
STAT,1923,48,15-19,1971,4.957472612076345E-4
SIM,1835,22,45-49,1857,1
SIM,1822,39,20-24,1861,1
SIM,1880,32,25-29,1912,26
SIM,1867,40,45-49,1907,5
STAT,1858,107,na,1965,0.02938670441510903
SIM,1788,72,na,1860,355
SIM,1940,16,45-49,1956,2
STAT,1872,53,40-44,1925,0.012003587996620678
STAT,1895,42,20-24,1937,0.016546231643429207
STAT,1925,77,na,2002,3110.117907085009
SIM,1878,31,30-34,1909,27
SIM,1872,35,50-100,1907,3
STAT,1850,31,35-39,1881,11.019708812794514
SIM,1983,20,40-44,2003,16
STAT,1821,54,na,1875,1413.7386498989288
STAT,1857,40,35-39,1897,1.6440016177787957
STAT,1848,30,40-44,1878,5.486372224032549
STAT,1856,21,35-39,1877,6.010279291221013
STAT,1915,30,40-44,1945,4.637339015534988
STAT,1865,45,na,1910,2366.015684419343
SIM,1942,51,na,1993,4830
SIM,1791,76,na,1867,505
STAT,1963,17,35-39,1980,6.152226077649581
SIM,1978,21,40-44,1999,11
STAT,1871,41,30-34,1912,1.325936935249703
STAT,1932,16,45-49,1948,0.765425389071184
SIM,1823,65,na,1888,1355
STAT,1806,87,na,1893,60.4688941523944
STAT,1974,29,25-29,2003,99.51644459237957
STAT,1977,18,40-44,1995,2.180312435195636
STAT,1937,49,20-24,1986,0.012806998436665678
STAT,1969,41,15-19,2010,0.0023040648969285104
SIM,1982,1,na,1983,6833
STAT,1872,23,35-39,1895,6.741272083479389
SIM,1838,79,na,1917,298
SIM,1885,49,50-100,1934,1
SIM,1890,20,25-29,1910,100
STAT,1871,45,na,1916,2608.8539232981834
SIM,1837,47,50-100,1884,1
STAT,1904,74,na,1978,2506.781588520008
STAT,1886,44,na,1930,2775.520987032419
SIM,1856,30,40-44,1886,14
STAT,1977,27,na,2004,5866.602571596871
STAT,1811,48,50-100,1859,0.7527830585854698
STAT,1896,26,25-29,1922,64.70074441158793
SIM,1908,39,25-29,1947,1
STAT,1877,49,50-100,1926,0.288673462456159
STAT,1861,100,na,1961,2.598530238692729
SIM,1854,16,na,1870,3086
STAT,1829,47,50-100,1876,0.25058506972412364
SIM,1820,85,na,1905,476
STAT,1928,48,15-19,1976,5.409057778609443E-4
STAT,1842,21,35-39,1863,5.704866433155814
STAT,1880,20,15-19,1900,4.059580339009507
STAT,1872,38,45-49,1910,2.29859891173135
STAT,1921,17,50-100,1938,0.49266287064846914
SIM,1921,83,na,2004,2405
STAT,1893,84,na,1977,1071.2695940658664
SIM,1858,37,20-24,1895,4
SIM,1872,35,na,1907,2961
STAT,1874,25,45-49,1899,1.3206639974556074
SIM,1830,44,40-44,1874,1
STAT,1859,35,20-24,1894,0.7153751020289922
STAT,1942,44,30-34,1986,0.15972827432855957
SIM,1964,44,45-49,2008,1
STAT,1796,70,na,1866,775.8750333205542
STAT,1831,42,40-44,1873,2.1557142091728747
SIM,1912,20,25-29,1932,208
SIM,1950,44,30-34,1994,2
SIM,1924,22,na,1946,4783
STAT,1965,42,45-49,2007,0.24919327652968018
STAT,1839,37,45-49,1876,1.8892361226060561
STAT,1871,51,25-29,1922,0.004086135891049531
SIM,1985,29,40-44,2014,20
STAT,1920,25,40-44,1945,5.938186321418534
STAT,1857,48,20-24,1905,0.010650205485837774
SIM,1940,31,40-44,1971,6
STAT,1869,21,45-49,1890,0.7816852574533898
SIM,1924,36,30-34,1960,5
STAT,2011,2,na,2013,7205.082131578852
SIM,1877,21,45-49,1898,2
STAT,1822,44,40-44,1866,4.3575059734898165
STAT,1858,63,na,1921,1606.384130892683
SIM,1853,38,50-100,1891,4
SIM,1891,38,20-24,1929,2
STAT,1935,34,15-19,1969,0.2050186901803675
STAT,1935,41,na,1976,6057.535316290232
STAT,1951,42,30-34,1993,0.18258359749505834
SIM,1864,21,35-39,1885,14
SIM,1877,82,na,1959,847
STAT,1932,31,40-44,1963,6.0085425634961025
SIM,1888,46,50-100,1934,2
STAT,1956,44,45-49,2000,0.2632435047536987
SIM,1880,38,45-49,1918,7
STAT,1939,55,na,1994,4277.486437299572
STAT,1944,32,15-19,1976,0.16268501679486783
STAT,1808,48,25-29,1856,0.28303087417867656
STAT,1962,21,25-29,1983,137.08124595439583
STAT,1948,18,20-24,1966,178.99336265727175
SIM,1781,77,na,1858,558
STAT,1904,20,25-29,1924,95.4345660688672
STAT,1862,28,50-100,1890,0.6208241299587866
SIM,1795,73,na,1868,597
STAT,1892,36,20-24,1928,1.120348770687154
STAT,1853,32,na,1885,2446.640221175141
STAT,1883,38,20-24,1921,0.8660425489274679
SIM,1970,21,25-29,1991,290
STAT,1844,19,25-29,1863,5.954306704784244
SIM,1881,37,50-100,1918,1
SIM,1835,24,20-24,1859,6
STAT,1954,38,15-19,1992,0.028196917928003877
SIM,1901,65,na,1966,3175
STAT,1848,35,45-49,1883,2.2285843735933883
SIM,1907,15,20-24,1922,44
STAT,1909,37,25-29,1946,1.0767353842737826
STAT,1930,47,45-49,1977,0.3303484292245124
STAT,1946,20,30-34,1966,36.93543430882022
SIM,1910,25,20-24,1935,33
SIM,1874,40,35-39,1914,1
STAT,1912,21,15-19,1933,5.910820064077564
STAT,1909,44,15-19,1953,0.0016391246439972757
STAT,1906,41,40-44,1947,0.2640442622028244
SIM,1920,21,15-19,1941,13
STAT,1966,33,na,1999,5553.447014716829
STAT,1865,27,45-49,1892,1.1561098668937155
SIM,1953,35,na,1988,5666
STAT,1963,47,40-44,2010,0.24044029818937038
STAT,1977,29,40-44,2006,7.2921324928174265
STAT,1960,26,20-24,1986,27.568066166513155
SIM,1896,73,na,1969,2458
STAT,1937,18,45-49,1955,0.5596668540270794
STAT,1987,21,15-19,2008,8.80182221830146
SIM,1909,18,35-39,1927,5
STAT,1866,46,20-24,1912,0.012872386542117602
STAT,1866,112,na,1978,0.0013125729438948047
STAT,1954,32,na,1986,5499.99405092563
STAT,1866,40,35-39,1906,1.9565030626700044
STAT,1934,18,20-24,1952,211.1784718295414
SIM,1926,57,na,1983,5362
SIM,1868,30,na,1898,3116
SIM,1843,30,50-100,1873,2
SIM,1824,31,35-39,1855,22
SIM,1922,43,na,1965,5008
SIM,1856,35,45-49,1891,3
SIM,1851,77,na,1928,1338
STAT,1822,108,na,1930,0.0015049930032683015
STAT,1854,6,na,1860,2431.323754056072
STAT,1805,92,na,1897,17.115732426723557
STAT,1826,54,na,1880,1251.2567144859402
SIM,1924,29,40-44,1953,20
STAT,1916,36,30-34,1952,2.164519487350114
STAT,1877,25,15-19,1902,0.5483399606473291
STAT,1970,22,15-19,1992,7.715448052296332
SIM,1932,57,na,1989,5057
STAT,2002,9,na,2011,6835.931206629541
STAT,1805,52,40-44,1857,0.0376208909817762
STAT,1822,40,na,1862,2326.0080544951534
SIM,1954,20,30-34,1974,102
SIM,1917,37,25-29,1954,3
STAT,1940,38,15-19,1978,0.02316610377264142
SIM,1829,43,na,1872,1644
STAT,1902,25,20-24,1927,19.259414826439432
SIM,1838,31,35-39,1869,21
SIM,1783,72,na,1855,707
SIM,2013,0,na,2013,7575
STAT,1881,54,45-49,1935,0.015709960824729866
STAT,1903,23,15-19,1926,5.406103853724043
SIM,1931,15,40-44,1946,5
STAT,1882,47,15-19,1929,4.4878356878913896E-4
SIM,1833,35,50-100,1868,1
SIM,1861,51,na,1912,1640
SIM,1863,43,40-44,1906,4
SIM,1976,5,na,1981,6052
SIM,1898,44,na,1942,3854
SIM,1874,40,50-100,1914,1
SIM,1872,39,na,1911,2931
STAT,1971,17,50-100,1988,0.5476213222754991
SIM,1951,16,20-24,1967,357
STAT,1869,27,30-34,1896,28.143500427977212
STAT,1970,42,25-29,2012,0.10720756531997579
STAT,1858,43,50-100,1901,0.9442382443235959
STAT,1952,40,25-29,1992,0.10291653055683908
STAT,1988,27,50-100,2015,1.649967465204316
SIM,1975,37,30-34,2012,4
STAT,1923,40,na,1963,5021.561998485243
STAT,1877,43,15-19,1920,0.01645818450491582
STAT,1943,16,20-24,1959,165.97747484185294
STAT,1916,29,40-44,1945,5.522574486462811
SIM,1965,16,20-24,1981,376
SIM,1852,19,25-29,1871,13
SIM,1919,25,40-44,1944,15
STAT,1942,26,30-34,1968,47.48877275335823
STAT,1923,15,40-44,1938,1.9035404536870821
SIM,1942,18,20-24,1960,163
STAT,1918,42,15-19,1960,0.00188388811792301
STAT,1952,37,na,1989,5360.385020316222
STAT,1967,44,20-24,2011,0.02636944548569485
SIM,1840,34,na,1874,2061
STAT,1903,33,40-44,1936,4.075966431394833
STAT,1937,20,na,1957,4109.004379025451
SIM,1844,48,na,1892,2126
STAT,1910,18,35-39,1928,0.9580116844858586
STAT,1934,81,na,2015,2802.549637833566
SIM,1889,41,35-39,1930,4
STAT,1878,20,50-100,1898,0.4943011095525524
SIM,1911,33,40-44,1944,1
STAT,1934,36,20-24,1970,0.4204017758050887
SIM,1902,35,40-44,1937,1
STAT,1794,75,na,1869,544.1375296461429
SIM,1917,52,na,1969,5129
STAT,1957,16,20-24,1973,206.3449049887898
SIM,1897,28,45-49,1925,3
STAT,1917,16,na,1933,4808.388739771748
STAT,1942,19,40-44,1961,1.6860391729790334
SIM,1904,18,na,1922,4311
STAT,1950,48,25-29,1998,0.07507975254794612
SIM,1950,26,30-34,1976,103
STAT,1914,63,na,1977,3779.4605591513564
SIM,1960,17,na,1977,5913
STAT,1943,42,25-29,1985,0.09082700093255484
STAT,1828,40,15-19,1868,0.013718519825410891
STAT,1923,33,40-44,1956,5.172220690206251
SIM,1983,23,45-49,2006,2
STAT,1973,15,na,1988,5496.610922137927
STAT,1967,37,30-34,2004,2.7068291371583624
STAT,1850,83,na,1933,408.67668998016916
SIM,1897,90,na,1987,196
SIM,1823,50,na,1873,2035
SIM,1892,43,na,1935,3632
STAT,1889,20,35-39,1909,8.350905346294544
STAT,1881,36,45-49,1917,2.2296882732642107
SIM,1931,33,40-44,1964,2
STAT,1914,48,15-19,1962,4.206422951482436E-4
STAT,1870,47,25-29,1917,0.06522739482667825
STAT,1886,41,15-19,1927,0.016886924684604985
SIM,1911,16,25-29,1927,22
STAT,1871,44,35-39,1915,2.050979864942528
STAT,1969,29,45-49,1998,2.498862487506863
STAT,1908,46,20-24,1954,0.011635624862064708
SIM,1890,39,50-100,1929,3
STAT,1954,49,40-44,2003,0.23259203144337967
SIM,1883,20,35-39,1903,21
SIM,1857,41,50-100,1898,5
STAT,1889,28,45-49,1917,1.5739233206925474
STAT,1910,36,35-39,1946,2.685260571864094
SIM,1911,23,15-19,1934,1
SIM,1836,18,30-34,1854,2
SIM,1994,11,na,2005,6222
STAT,1904,89,na,1993,701.3719046999499
SIM,1916,28,20-24,1944,19
STAT,1957,35,50-100,1992,0.6593000884882951
STAT,1876,27,20-24,1903,13.99537331702974
STAT,1899,41,na,1940,3683.4445680314557
STAT,1858,59,na,1917,1749.6735616279564
STAT,1900,23,45-49,1923,1.1132093706417379
SIM,1886,43,na,1929,1957
SIM,1847,37,45-49,1884,9
STAT,1917,45,35-39,1962,0.15614869393350198
SIM,1986,16,25-29,2002,173
STAT,1886,23,15-19,1909,4.003529476669747
SIM,1894,23,15-19,1917,4
SIM,1881,12,na,1893,2161
STAT,1834,38,25-29,1872,3.234523157431299
SIM,1919,85,na,2004,1539
STAT,1908,28,20-24,1936,19.869334818033813
STAT,1810,52,20-24,1862,0.0027020354152449207
STAT,1844,83,na,1927,332.048902978887
SIM,1901,41,30-34,1942,1
STAT,1952,31,50-100,1983,1.1662025861126568
SIM,1884,27,20-24,1911,18
SIM,1947,35,na,1982,5971
STAT,1942,47,35-39,1989,0.16176298950467888
STAT,1846,48,45-49,1894,0.24090705134415527
STAT,1916,39,35-39,1955,2.8300176040957012
SIM,1850,45,20-24,1895,1
SIM,1928,52,na,1980,5525
STAT,1956,35,45-49,1991,1.0743813006044085
STAT,1955,21,35-39,1976,14.477749536917235
STAT,1839,46,50-100,1885,0.20100734812759916
STAT,1827,71,na,1898,1084.0187967452375
STAT,1892,49,50-100,1941,0.19620341926185228
STAT,1820,53,20-24,1873,7.103310446025331E-4
SIM,1823,33,40-44,1856,9
STAT,1853,28,na,1881,2486.8525849605635
STAT,1804,79,na,1883,377.4903424457792
SIM,1873,52,na,1925,2924
STAT,1842,45,20-24,1887,0.009475558330441478
SIM,1795,69,na,1864,776
SIM,1938,27,45-49,1965,3
STAT,1827,34,15-19,1861,0.2242317060824325
STAT,1881,33,40-44,1914,4.806954029012515
STAT,1955,29,45-49,1984,2.6555314535455534
STAT,1850,36,15-19,1886,0.059336460088618766
STAT,1824,46,15-19,1870,5.505934706452933E-4
STAT,1875,75,na,1950,1227.7317554936392
STAT,1984,29,30-34,2013,64.4364667505437
SIM,1802,56,na,1858,1175
STAT,1969,3,na,1972,5670.976184478087
STAT,1961,17,25-29,1978,64.61279014079008
SIM,1935,7,na,1942,6502
SIM,1835,27,25-29,1862,4
STAT,1874,22,40-44,1896,2.4619101943082953
STAT,1937,15,40-44,1952,1.5784840249754342
SIM,1895,2,na,1897,4119
SIM,1888,21,20-24,1909,74
SIM,1856,42,35-39,1898,1
STAT,1971,15,40-44,1986,2.04553742530293
STAT,1956,17,45-49,1973,0.7628366422730947
STAT,1953,26,30-34,1979,54.962207295761296
STAT,1931,29,50-100,1960,1.4818537018347155
SIM,1916,29,35-39,1945,28
SIM,1941,34,na,1975,3982
SIM,1892,20,50-100,1912,1
STAT,1922,27,15-19,1949,0.9214843087244597
SIM,1834,34,na,1868,1884
STAT,1848,42,35-39,1890,1.921671005141641
SIM,1998,2,na,2000,6866
STAT,1876,52,50-100,1928,0.01792134566287346
SIM,1849,16,15-19,1865,15
STAT,1930,44,40-44,1974,0.37858299423934116
SIM,1966,39,30-34,2005,3
STAT,1848,32,40-44,1880,5.373609218629054
STAT,1908,29,35-39,1937,16.282720043395322
SIM,1910,28,25-29,1938,3
STAT,1923,36,45-49,1959,0.9120733516893884
SIM,1856,32,40-44,1888,13
STAT,1902,28,25-29,1930,68.73507972046527
STAT,1876,29,na,1905,2826.7232041721845
SIM,1961,26,30-34,1987,133
STAT,1948,33,50-100,1981,1.1123328111103936
SIM,1968,33,20-24,2001,2
STAT,1968,35,25-29,2003,1.464686729766415
SIM,1882,25,45-49,1907,2
SIM,1924,39,35-39,1963,9
SIM,1883,82,na,1965,660
SIM,1846,20,30-34,1866,24
SIM,1964,35,45-49,1999,1
STAT,1866,23,na,1889,2532.1461194294448
STAT,1941,41,na,1982,4595.671879231096
SIM,1931,24,50-100,1955,1
SIM,1838,48,na,1886,1636
STAT,1956,42,35-39,1998,0.31956666043645726
SIM,1856,4,na,1860,2743
SIM,1789,73,na,1862,773
STAT,1885,25,20-24,1910,13.595799031382178
STAT,1867,40,na,1907,2515.4624674862735
SIM,1885,15,20-24,1900,37
STAT,1841,23,40-44,1864,2.3301428856763104
STAT,1868,89,na,1957,146.1900332450917
SIM,1887,96,na,1983,84
STAT,1864,75,na,1939,1060.8005260050786
STAT,1908,47,35-39,1955,0.1347335496024468
STAT,1838,20,30-34,1858,20.3121947727421
SIM,1828,65,na,1893,1507
SIM,1893,25,20-24,1918,19
STAT,1943,19,25-29,1962,53.00247475404408
SIM,1942,19,35-39,1961,12
STAT,1855,46,45-49,1901,0.201381488749927
STAT,1923,18,45-49,1941,0.6749187703973811
SIM,1848,32,35-39,1880,22
SIM,1947,35,50-100,1982,4
SIM,1861,17,25-29,1878,17
STAT,1952,36,40-44,1988,2.134851408965493
STAT,1882,84,na,1966,683.6104118733446
STAT,1909,19,25-29,1928,9.765630835062963
STAT,1881,51,40-44,1932,0.011774702235800896
STAT,1853,17,25-29,1870,6.786841444069953
SIM,1870,43,30-34,1913,3
STAT,1910,33,30-34,1943,17.475587176316736
SIM,1867,35,20-24,1902,1
SIM,1923,26,45-49,1949,7
STAT,1834,35,20-24,1869,0.8933813661722769
SIM,1966,19,20-24,1985,205
STAT,1986,23,20-24,2009,183.39140642157653
STAT,1927,36,30-34,1963,2.6168812249510616
SIM,1944,31,25-29,1975,23
SIM,1865,81,na,1946,569
SIM,1965,19,25-29,1984,75
STAT,1983,16,15-19,1999,74.11114075037095
SIM,1813,87,na,1900,86
STAT,1915,26,45-49,1941,2.040920567252691
SIM,1917,19,25-29,1936,2
STAT,1935,27,25-29,1962,103.59901971179067
SIM,1890,64,na,1954,2456
SIM,1894,78,na,1972,2254
STAT,1904,29,15-19,1933,0.7465106980992041
SIM,1943,27,25-29,1970,10
STAT,1900,59,na,1959,3214.502490822357
SIM,1841,47,na,1888,1797
STAT,1892,30,35-39,1922,14.765879819548967
STAT,1873,49,15-19,1922,4.615531648198663E-4
SIM,1945,18,45-49,1963,5
SIM,1957,38,35-39,1995,7
STAT,1920,36,na,1956,4756.013291610701
STAT,1829,53,40-44,1882,0.009252691982227421
STAT,1860,25,20-24,1885,11.188528355486499
STAT,1957,26,15-19,1983,1.0792829494283136
STAT,1969,30,25-29,1999,13.597276670623428
STAT,1897,35,40-44,1932,6.819226379283261
STAT,1960,27,35-39,1987,22.664083928547782
SIM,1859,57,na,1916,1812
STAT,1926,46,40-44,1972,0.22501668278393613
STAT,1949,38,35-39,1987,3.3411866718391745
STAT,1805,96,na,1901,3.5286674938915814
STAT,1795,109,na,1904,1.2466807108033008E-4
STAT,1827,27,25-29,1854,163.08190187537494
SIM,1942,37,35-39,1979,3
SIM,1981,20,30-34,2001,71
SIM,1950,29,35-39,1979,1
STAT,1938,38,50-100,1976,0.4921635523159923
STAT,1910,15,30-34,1925,2.8030692125075483
STAT,1833,23,50-100,1856,0.4078368368929676
SIM,1899,7,na,1906,4559
STAT,1942,29,35-39,1971,18.170045166048645
SIM,1842,35,20-24,1877,1
STAT,1958,19,20-24,1977,205.35899896212868
STAT,1950,45,20-24,1995,0.015759044303110765
SIM,1928,30,30-34,1958,43
SIM,1960,46,na,2006,6138
STAT,1887,48,50-100,1935,0.3136489723217616
SIM,1921,29,50-100,1950,2
SIM,1949,55,na,2004,5544
SIM,1907,22,na,1929,4188
STAT,1934,37,35-39,1971,3.8538849027102025
STAT,1943,37,25-29,1980,1.2415119568542603
STAT,1957,19,25-29,1976,65.89322212375372
SIM,1919,23,na,1942,5523
STAT,1907,95,na,2002,202.58161325672182
SIM,1911,36,45-49,1947,2
STAT,1966,29,20-24,1995,26.399240548282158
STAT,1920,37,35-39,1957,3.0548954648954125
SIM,1905,28,45-49,1933,3
STAT,1941,37,na,1978,4608.497645609874
SIM,1936,21,25-29,1957,6
STAT,1934,19,35-39,1953,6.518131587110804
SIM,1951,19,25-29,1970,1
STAT,1853,42,15-19,1895,0.013732400926901374
STAT,1961,24,15-19,1985,7.957683156868806
STAT,1958,37,20-24,1995,0.41164797166188266
SIM,1954,46,na,2000,5401
STAT,1911,23,20-24,1934,121.42929821552147
STAT,1915,80,na,1995,2173.475382183014
STAT,1903,36,45-49,1939,0.7106830248605088
STAT,1847,63,na,1910,1372.9406681536109
SIM,1913,22,na,1935,4337
SIM,1935,36,30-34,1971,1
STAT,1853,24,15-19,1877,3.8253298241807605
SIM,1861,24,15-19,1885,5
STAT,1846,46,na,1892,2332.448623053886
SIM,1919,89,na,2008,865
STAT,1936,31,25-29,1967,10.372622421619079
SIM,1919,28,45-49,1947,6
STAT,1982,21,na,2003,5951.799546771689
STAT,1845,54,35-39,1899,0.005641726047544785
STAT,1849,11,na,1860,2287.9247694229507
SIM,1894,14,na,1908,4117
SIM,1905,20,35-39,1925,20
STAT,1857,46,na,1903,2027.9222578749839
STAT,1928,21,25-29,1949,133.49303269505478
STAT,1924,17,20-24,1941,186.26717403988832
SIM,1869,29,45-49,1898,1
STAT,1885,112,na,1997,0.004648251302052088
SIM,1974,24,15-19,1998,16
SIM,1976,16,50-100,1992,1
STAT,1935,47,45-49,1982,0.35428832624407824
SIM,1881,26,45-49,1907,3
STAT,1859,112,na,1971,4.442709585339414E-4
SIM,1978,21,30-34,1999,115
STAT,1883,23,50-100,1906,0.45901026696705366
STAT,1900,28,na,1928,3808.2202180587688
SIM,1943,67,na,2010,4337
STAT,1826,85,na,1911,150.93993945842598
SIM,1906,31,40-44,1937,5
SIM,1951,32,30-34,1983,7
STAT,1835,62,na,1897,1139.1405972177772
STAT,1896,39,45-49,1935,3.0080614765107048
STAT,1931,43,40-44,1974,0.3850967849011611
STAT,1874,58,na,1932,2336.4270802852648
STAT,1908,44,30-34,1952,0.13499787012219752
SIM,1935,18,50-100,1953,1
STAT,1932,46,15-19,1978,5.782538279664808E-4
SIM,1823,86,na,1909,388
STAT,1864,31,35-39,1895,10.477995312062124
STAT,1838,23,35-39,1861,6.5121651300965055
SIM,1968,36,25-29,2004,2
SIM,1838,30,20-24,1868,6
STAT,1906,38,15-19,1944,0.020296015424463427
SIM,1834,36,20-24,1870,1
SIM,1870,28,50-100,1898,2
SIM,1929,26,40-44,1955,1
SIM,1856,77,na,1933,797
STAT,1958,43,15-19,2001,0.002415196961741078
STAT,1914,36,na,1950,4357.930760885139
STAT,1966,24,15-19,1990,7.693094003069343
SIM,1933,43,na,1976,6384
STAT,1885,28,25-29,1913,48.52215597966038
STAT,1979,22,na,2001,5821.815228927895
STAT,1889,25,40-44,1914,4.290307866665824
SIM,1948,37,30-34,1985,6
STAT,1851,27,20-24,1878,10.89249720220607
STAT,1779,108,na,1887,0.004499176482590216
STAT,1943,32,30-34,1975,19.65536143694221
STAT,1871,14,na,1885,3003.912976153477
STAT,1904,47,15-19,1951,3.7218028965742674E-4
SIM,1916,44,30-34,1960,1
STAT,1843,66,na,1909,1644.551582026166
SIM,1829,42,50-100,1871,3
SIM,1921,57,na,1978,4917
STAT,1861,46,20-24,1907,0.011545574343275463
STAT,1985,27,25-29,2012,108.50358916074416
SIM,1864,20,20-24,1884,5
STAT,1847,34,50-100,1881,0.7377889850271455
STAT,1934,44,50-100,1978,0.18818996005861416
STAT,1875,20,35-39,1895,7.000890335930867
SIM,1832,63,na,1895,1483
SIM,1892,26,20-24,1918,21
SIM,1811,48,25-29,1859,1
STAT,1961,9,na,1970,5859.095988670289
STAT,1913,17,45-49,1930,0.11793111942774684
STAT,1966,27,30-34,1993,56.722875666298314
SIM,1916,26,30-34,1942,3
STAT,1795,92,na,1887,10.154847642164636
SIM,1942,19,na,1961,4468
SIM,1921,17,45-49,1938,2
STAT,1946,47,20-24,1993,0.01471323377192961
SIM,1877,7,na,1884,3528
STAT,1830,54,40-44,1884,0.008208427690312697
SIM,1872,28,45-49,1900,4
STAT,1858,32,na,1890,2148.362427545232
STAT,1852,42,50-100,1894,0.9948107453905166
STAT,1841,26,45-49,1867,1.2349668470712936
STAT,1873,37,50-100,1910,1.4468823880571022
SIM,1822,34,40-44,1856,2
SIM,1846,23,35-39,1869,10
SIM,1932,21,40-44,1953,11
STAT,1874,45,50-100,1919,0.2930562459519499
STAT,1880,48,45-49,1928,0.2850575958201246
SIM,1893,28,25-29,1921,110
SIM,1881,43,na,1924,1844
STAT,1855,98,na,1953,2.764169215204949
STAT,1889,22,25-29,1911,81.43584790321265
STAT,1934,39,25-29,1973,1.5654736805419427
SIM,1897,22,25-29,1919,3
STAT,1845,40,50-100,1885,0.7437515521766004
STAT,1940,41,40-44,1981,0.3051192435984507
STAT,1845,20,45-49,1865,0.5918104266113468
STAT,1838,41,35-39,1879,1.8583786736683787
STAT,1949,47,50-100,1996,0.31576050466597516
STAT,1932,28,15-19,1960,1.0668394155126866
SIM,1963,37,40-44,2000,2
SIM,1908,75,na,1983,2134
STAT,1930,37,15-19,1967,0.028910566589527904
SIM,1943,47,45-49,1990,1
STAT,1990,25,na,2015,6223.469870661586
STAT,1909,89,na,1998,753.2275471634273
STAT,1861,39,30-34,1900,5.061772982862593
STAT,1825,37,20-24,1862,1.2802867764223564
STAT,1928,28,50-100,1956,1.4144563110838992
SIM,1822,64,na,1886,1103
SIM,1939,40,35-39,1979,2
SIM,1932,17,20-24,1949,399
SIM,1879,48,45-49,1927,1
STAT,1909,16,20-24,1925,30.792240433447464
SIM,1860,26,20-24,1886,17
STAT,1908,26,30-34,1934,43.31220058723314
SIM,1801,71,na,1872,779
STAT,1852,112,na,1964,1.3678823370060354E-4
SIM,1939,29,25-29,1968,98
STAT,1862,43,30-34,1905,1.1116106972073347
STAT,1884,113,na,1997,0.0015616869356274996
STAT,1885,35,15-19,1920,0.06525393034276804
SIM,1846,41,35-39,1887,7
SIM,1867,38,25-29,1905,11
SIM,1831,85,na,1916,199
STAT,1911,24,35-39,1935,10.249881655417054
STAT,1921,39,15-19,1960,0.024683367590667592
SIM,1967,34,20-24,2001,1
SIM,1936,19,na,1955,3750
STAT,1888,32,35-39,1920,13.738120501770087
STAT,1986,26,25-29,2012,108.75108665455652
STAT,1916,19,15-19,1935,11.053545423105138
STAT,1849,16,20-24,1865,17.014072067654922
SIM,1923,23,40-44,1946,9
STAT,1982,31,40-44,2013,6.481505098773732
SIM,1964,28,20-24,1992,53
STAT,1836,84,na,1920,302.74605743727835
STAT,1825,35,50-100,1860,2.1492825192323806
STAT,1911,21,30-34,1932,31.578998530366448
STAT,1860,7,na,1867,2655.101737211526
SIM,1896,32,35-39,1928,6
SIM,1857,16,20-24,1873,24
STAT,1966,49,30-34,2015,0.13287283110259468
SIM,1871,34,35-39,1905,4
STAT,1897,38,45-49,1935,3.0609587200098214
SIM,1853,25,na,1878,2545
STAT,1866,40,50-100,1906,1.141448875612198
STAT,1911,26,25-29,1937,74.39460236579545
STAT,1897,30,35-39,1927,15.753033462939385
STAT,1934,34,30-34,1968,24.805102093080322
SIM,1964,45,na,2009,5761
STAT,1886,19,30-34,1905,1.9298299605104625
SIM,1859,23,45-49,1882,1
SIM,1907,90,na,1997,614
SIM,1869,17,30-34,1886,1
SIM,1821,43,35-39,1864,2
STAT,1852,10,na,1862,2756.2666724206856
STAT,1856,20,20-24,1876,71.49003560845071
STAT,1924,21,40-44,1945,4.591284171918305
SIM,1860,29,25-29,1889,7
STAT,1934,16,30-34,1950,19.08245727116981
SIM,1987,23,30-34,2010,108
STAT,1852,29,25-29,1881,41.667032392187465
SIM,1862,77,na,1939,1131
STAT,1930,19,15-19,1949,67.35764840879301
STAT,1838,32,50-100,1870,0.9863918492815319
STAT,1935,24,20-24,1959,174.72074335715376
STAT,1902,45,40-44,1947,0.159041394321723
STAT,1971,18,45-49,1989,0.729928111269828
SIM,1943,24,20-24,1967,173
STAT,1863,105,na,1968,0.2620707740703276
STAT,1980,26,na,2006,6030.30195812942
STAT,1813,43,35-39,1856,6.533696245994397
STAT,1898,23,40-44,1921,3.240032915458588
STAT,1947,19,45-49,1966,0.6489472631100858
SIM,1924,19,15-19,1943,2
STAT,1960,29,25-29,1989,99.2622193739221
STAT,1979,23,30-34,2002,45.80511435173596
SIM,1894,19,30-34,1913,4
STAT,1840,24,40-44,1864,2.095404665114788
SIM,1910,73,na,1983,1915
STAT,1956,28,20-24,1984,27.982158079276196
SIM,1928,33,35-39,1961,25
STAT,1915,23,40-44,1938,3.999363443552793
SIM,1938,38,20-24,1976,3
STAT,1863,41,25-29,1904,0.6509392669546433
STAT,1884,29,25-29,1913,47.88823776884689
STAT,1912,30,25-29,1942,10.590187211830468
STAT,1878,50,20-24,1928,9.019376706036165E-4
STAT,1796,108,na,1904,4.66549121178053E-4
STAT,1935,41,50-100,1976,0.19161343085706953
STAT,1826,36,20-24,1862,0.632586381323292
STAT,1892,110,na,2002,0.04438816566732127
STAT,1813,50,25-29,1863,0.011706633476634452
STAT,1882,39,50-100,1921,1.3700014193968346
SIM,1900,80,na,1980,1639
SIM,1809,82,na,1891,200
SIM,1900,20,35-39,1920,20
STAT,1836,32,15-19,1868,0.16387617727787
STAT,1859,45,15-19,1904,3.713876016667645E-4
SIM,1892,29,25-29,1921,7
SIM,1939,31,na,1970,4950
SIM,1888,82,na,1970,518
STAT,1898,30,30-34,1928,27.45046902688758
SIM,1946,49,na,1995,4528
STAT,1947,37,45-49,1984,0.9130102871494482
STAT,1886,50,na,1936,2658.81384960339
STAT,1869,75,na,1944,1150.53537248222
SIM,1920,30,25-29,1950,1
SIM,1871,41,25-29,1912,1
STAT,1831,45,45-49,1876,0.2243287309313116
STAT,1907,54,na,1961,3684.6615781826636
STAT,1917,27,35-39,1944,18.17091430925379
STAT,1898,19,20-24,1917,27.502555857567344
STAT,1960,24,30-34,1984,43.31362026853502
SIM,1840,20,35-39,1860,16
STAT,1921,90,na,2011,780.354948067272
STAT,1812,46,25-29,1858,0.1357864487784039
STAT,1881,1,na,1882,3763.255237498179
SIM,1960,31,50-100,1991,1
STAT,1911,33,15-19,1944,0.14392279061062252
SIM,1868,61,na,1929,2512
STAT,1887,16,40-44,1903,0.23713371213917667
STAT,1961,37,45-49,1998,1.047186811097951
STAT,1981,27,40-44,2008,7.554104514911475
SIM,1817,86,na,1903,65
STAT,1880,50,50-100,1930,0.018739789531747146
STAT,1882,109,na,1991,0.0689777515007765
STAT,1896,36,40-44,1932,6.704682119711726
STAT,1833,67,na,1900,1115.4760967787042
STAT,1826,31,15-19,1857,0.14191252211515426
SIM,1951,35,35-39,1986,3
SIM,1855,36,45-49,1891,2
SIM,1873,21,25-29,1894,155
STAT,1944,38,35-39,1982,3.0917887686695487
SIM,1925,27,35-39,1952,56
SIM,1887,28,na,1915,3827
STAT,1839,34,40-44,1873,4.145382737747179
STAT,1924,31,35-39,1955,12.307666817241655
STAT,1985,24,20-24,2009,182.99234691432932
STAT,1867,50,45-49,1917,0.01586166785817967
SIM,1869,26,40-44,1895,1
STAT,1833,45,50-100,1878,0.20913269843967872
STAT,1861,49,25-29,1910,0.054108030205362374
SIM,1906,34,45-49,1940,1
SIM,1929,29,45-49,1958,5
SIM,1964,41,40-44,2005,3
STAT,1941,1,na,1942,4936.697002302099
STAT,1865,21,25-29,1886,60.7682342437366
SIM,1954,23,35-39,1977,1
STAT,1858,24,15-19,1882,3.0566640866013923
STAT,1893,42,50-100,1935,1.5391686491380452
SIM,1870,37,25-29,1907,6
SIM,1987,7,na,1994,6561
SIM,1942,56,na,1998,4716
STAT,1887,19,45-49,1906,0.08403003339541551
STAT,1847,36,45-49,1883,1.6080980572132126
STAT,1943,35,35-39,1978,3.055132078442007
SIM,1834,31,15-19,1865,2
STAT,1944,30,25-29,1974,11.714275985242969
SIM,1952,38,35-39,1990,7
STAT,1826,39,25-29,1865,2.2117337684156158
STAT,1879,64,na,1943,2094.754708068705
STAT,1946,23,35-39,1969,12.088075241702853
SIM,1917,34,20-24,1951,6
STAT,1921,43,35-39,1964,0.2612318972534203
STAT,1951,44,20-24,1995,0.025137839919875917
STAT,1964,6,na,1970,5714.035964977842
SIM,1910,45,40-44,1955,1
SIM,1949,27,20-24,1976,2
SIM,1834,39,25-29,1873,2
SIM,1841,74,na,1915,829
STAT,1860,66,na,1926,1524.4575177097652
SIM,1929,21,35-39,1950,34
SIM,1993,17,30-34,2010,51
STAT,1837,33,na,1870,1947.3196820692715
STAT,1852,21,15-19,1873,3.721688823007039
STAT,1921,25,35-39,1946,19.434101706566842
STAT,1784,92,na,1876,11.799805588360167
STAT,1946,2,na,1948,5167.574842623046
SIM,1952,30,25-29,1982,21
STAT,1891,17,45-49,1908,0.09317067632127814
STAT,1972,32,30-34,2004,23.729766559659605
SIM,1975,19,50-100,1994,1
STAT,1837,19,35-39,1856,0.5958656651296685
STAT,1865,24,40-44,1889,2.1647305430238197
STAT,1985,17,30-34,2002,20.006569834329216
STAT,1894,48,25-29,1942,0.04759630457885128
STAT,1908,19,40-44,1927,0.31183122014118564
STAT,1978,28,40-44,2006,7.369189202190585
SIM,1916,19,40-44,1935,3
STAT,1898,26,45-49,1924,1.7376607359650225
STAT,1967,19,50-100,1986,0.5397297774764501
SIM,1829,46,45-49,1875,1
SIM,1812,42,30-34,1854,2
STAT,1909,34,20-24,1943,2.6661687535102736
SIM,1932,31,35-39,1963,27
STAT,1918,48,35-39,1966,0.15786296446761292
SIM,1860,11,na,1871,2978
STAT,1985,0,na,1985,6501.473333747401
SIM,1915,57,na,1972,4179
STAT,1911,31,25-29,1942,10.437929540499999
SIM,1972,32,35-39,2004,2
STAT,1859,38,25-29,1897,2.633731109002273
STAT,1881,48,15-19,1929,4.3965666839253296E-4
STAT,1849,98,na,1947,2.517841034443908
SIM,1951,17,35-39,1968,9
STAT,1836,53,30-34,1889,0.005375685223865518
STAT,1860,28,25-29,1888,39.48096253093674
STAT,1951,49,50-100,2000,0.32140969557564286
STAT,1943,17,35-39,1960,5.135668340629711
SIM,1975,17,20-24,1992,371
SIM,1920,72,na,1992,2824
STAT,1874,18,20-24,1892,20.89044769586137
STAT,1847,32,na,1879,1957.9771448045399
STAT,1935,44,40-44,1979,0.4060183839480935
SIM,1813,56,na,1869,1241
STAT,1893,40,45-49,1933,2.205205815810837
STAT,1953,41,50-100,1994,0.1706889689279534
SIM,1897,27,na,1924,3681
SIM,1943,44,40-44,1987,1
STAT,1839,31,25-29,1870,10.100497874742365
SIM,1845,19,35-39,1864,1
SIM,1866,39,25-29,1905,1
STAT,1911,29,40-44,1940,5.2126923956006035
STAT,1862,22,15-19,1884,3.2891393493203998
SIM,1822,37,45-49,1859,4
SIM,1847,31,25-29,1878,27
STAT,1956,40,45-49,1996,0.2648554440491326
STAT,1973,24,40-44,1997,5.0316297842257045
STAT,1991,1,na,1992,6512.24334685526
STAT,1849,30,35-39,1879,9.279811370413857
STAT,1947,16,40-44,1963,1.818780074791609
SIM,1868,29,30-34,1897,2
SIM,1837,17,30-34,1854,7
SIM,1917,16,20-24,1933,61
STAT,1946,16,45-49,1962,0.6395844760542804
STAT,1852,26,20-24,1878,12.975867926209638
STAT,1958,1,na,1959,5968.2857079635705
STAT,1860,14,na,1874,2537.6220308289535
STAT,1956,49,25-29,2005,0.08376286747224079
STAT,1822,49,20-24,1871,0.02204274320240262
STAT,1873,26,45-49,1899,1.3129713243412682
STAT,1864,28,na,1892,2450.5164827316935
SIM,1870,46,35-39,1916,2
STAT,1828,104,na,1932,0.044268778331622884
STAT,1897,93,na,1990,286.1234419560366
STAT,1862,46,35-39,1908,0.13673766223275827
STAT,1967,17,20-24,1984,195.44117844593697
SIM,1967,37,25-29,2004,1
SIM,1965,30,35-39,1995,3
SIM,1931,2,na,1933,6506
SIM,1896,42,na,1938,3636
SIM,1812,71,na,1883,538
SIM,1857,30,35-39,1887,5
STAT,1827,29,50-100,1856,1.4122275401833235
SIM,1835,29,50-100,1864,2
STAT,1833,28,15-19,1861,0.4233867744767041
STAT,1892,46,na,1938,3264.0931323744885
SIM,1939,26,20-24,1965,4
SIM,1954,16,45-49,1970,1
SIM,1879,61,na,1940,2155
STAT,1918,40,25-29,1958,0.08784395113868931
STAT,1997,10,na,2007,6621.431411303924
SIM,1841,28,15-19,1869,4
SIM,1971,35,25-29,2006,4
STAT,1838,16,45-49,1854,0.07519684398502767
SIM,1827,48,na,1875,1386
STAT,1835,54,50-100,1889,0.009231938904879443
STAT,1940,44,45-49,1984,0.20205566757948037
STAT,1903,98,na,2001,74.12957721017588
STAT,1933,34,50-100,1967,1.2847626295575572
STAT,1986,10,na,1996,6461.162411637851
STAT,1884,26,20-24,1910,13.422351404835336
STAT,1880,45,40-44,1925,0.2115067162046669
STAT,1898,33,35-39,1931,15.728330783319482
SIM,1827,30,45-49,1857,2
STAT,1883,79,na,1962,1044.0684539246845
STAT,1908,23,15-19,1931,5.637354652179287
SIM,1932,24,45-49,1956,5
STAT,1957,30,35-39,1987,14.18936477692836
STAT,1878,24,na,1902,2831.9383579049863
STAT,1919,3,na,1922,5171.544474935545
STAT,1840,27,45-49,1867,1.1105564849789056
STAT,1961,34,40-44,1995,5.939853820244042
STAT,1930,22,40-44,1952,4.971595403700525
STAT,1946,41,na,1987,4947.410973067176
STAT,1975,31,50-100,2006,1.2838365822153655
SIM,1949,30,na,1979,5862
STAT,1938,49,15-19,1987,4.338465669257801E-4
SIM,1847,34,40-44,1881,7
STAT,1924,24,45-49,1948,1.5222041328474087
STAT,1895,45,35-39,1940,0.11981328880225631
STAT,1891,111,na,2002,0.017055420243129324
STAT,1874,47,45-49,1921,0.2775216675728012
SIM,1916,23,15-19,1939,1
SIM,1882,47,45-49,1929,1
STAT,1967,44,na,2011,5545.421879012708
SIM,1909,61,na,1970,4244
SIM,1871,31,30-34,1902,24
STAT,1870,28,na,1898,2705.6476914296095
SIM,1979,20,30-34,1999,55
SIM,1983,31,50-100,2014,1
SIM,1955,34,40-44,1989,7
SIM,1955,16,40-44,1971,1
STAT,1885,17,50-100,1902,0.056395005277205014
STAT,1925,42,na,1967,5187.4096688160935
SIM,1826,30,na,1856,2205
SIM,1942,20,na,1962,4450
STAT,1819,35,50-100,1854,5.101636667773014
STAT,1908,49,25-29,1957,0.055108314392003734
STAT,1947,34,40-44,1981,5.1787776398374605
STAT,1950,21,35-39,1971,12.89514815955812
STAT,1926,20,na,1946,5149.417113116825
STAT,1969,26,40-44,1995,6.751572247800218
SIM,1833,48,na,1881,1464
SIM,1936,64,na,2000,3621
STAT,1896,40,25-29,1936,0.06865789795368046
STAT,1962,41,15-19,2003,0.002363279968754332
STAT,1968,16,50-100,1984,0.5401851867417709
SIM,1862,36,35-39,1898,16
SIM,1844,27,na,1871,2531
STAT,1942,49,25-29,1991,0.06616381524065743
STAT,1921,40,30-34,1961,0.1665771793652109
SIM,1890,85,na,1975,645
SIM,1947,39,25-29,1986,1
SIM,1859,41,45-49,1900,1
STAT,1809,85,na,1894,127.41212792300188
STAT,1840,30,35-39,1870,10.102552679749774
SIM,1949,25,30-34,1974,124
STAT,1863,34,35-39,1897,10.131831433929031
SIM,1950,23,15-19,1973,2
SIM,1876,39,30-34,1915,6
STAT,1823,84,na,1907,188.38311936267127
SIM,1880,65,na,1945,2415
STAT,1868,39,30-34,1907,5.849789195603193
SIM,1926,36,na,1962,5863
SIM,1869,20,20-24,1889,148
STAT,1811,53,30-34,1864,0.017364551319898565
STAT,1911,46,45-49,1957,0.23824416634495596
SIM,1855,33,40-44,1888,2
SIM,1961,35,40-44,1996,5
STAT,1877,7,na,1884,3223.9512778458825
SIM,1827,39,35-39,1866,11
STAT,1910,80,na,1990,2014.159826393086
STAT,1951,47,25-29,1998,0.0758239070380154
STAT,2001,11,na,2012,6788.124311543364
STAT,1824,53,40-44,1877,0.013536960757229525
STAT,1884,11,na,1895,2949.025148338273
STAT,1960,36,50-100,1996,0.6507547120118378
STAT,1875,44,na,1919,2719.168074981406
STAT,1927,45,40-44,1972,0.22941800659854603
STAT,1820,51,30-34,1871,0.005963090608478173
STAT,1951,30,15-19,1981,0.1802119585593298
STAT,1953,35,40-44,1988,2.1568192665898027
STAT,1819,39,35-39,1858,16.79496976555877
STAT,1887,42,25-29,1929,0.8294939680949538
STAT,1854,76,na,1930,771.8468993342634
STAT,1859,10,na,1869,2579.387132592037
SIM,1870,34,20-24,1904,7
STAT,1900,16,20-24,1916,28.45940972077348
STAT,1899,15,50-100,1914,0.07781949957425446
STAT,1949,30,50-100,1979,1.1324208588949336
STAT,1864,30,20-24,1894,2.807733106944854
SIM,1959,13,na,1972,6026
STAT,1856,61,na,1917,1645.2388414257475
SIM,1852,6,na,1858,2530
SIM,1945,41,35-39,1986,1
STAT,1871,78,na,1949,897.0686783409044
SIM,1846,32,50-100,1878,2
STAT,1896,42,35-39,1938,0.19143784903638522
STAT,1879,50,35-39,1929,0.010523158737265234
STAT,1894,45,20-24,1939,0.010142191478254521
STAT,1971,43,35-39,2014,0.3053952490197593
STAT,1837,70,na,1907,1016.0054886754482
STAT,1899,116,na,2015,1.095513514712739E-4
SIM,1844,17,na,1861,2895
STAT,1831,23,35-39,1854,13.346670867032815
STAT,1942,23,15-19,1965,6.4400657096536
SIM,1957,28,na,1985,5869
STAT,1828,46,35-39,1874,0.13062120954754783
STAT,1939,46,15-19,1985,4.439005203142439E-4
STAT,1833,51,40-44,1884,0.007841064572763208
STAT,1853,30,45-49,1883,1.8254269056180872
STAT,1867,18,30-34,1885,1.7453324581870242
SIM,1899,0,na,1899,4829
SIM,1823,49,50-100,1872,3
STAT,1870,45,35-39,1915,0.16086935355336665
STAT,1860,53,25-29,1913,0.003241560796638249
STAT,1960,49,na,2009,5710.044092709468
STAT,1847,33,40-44,1880,3.877479644518508
STAT,1850,43,40-44,1893,2.298781392572488
SIM,1939,21,40-44,1960,11
STAT,1798,72,na,1870,500.62747831419637
SIM,1785,74,na,1859,552
STAT,1838,49,50-100,1887,0.21337059058596325
SIM,1940,27,20-24,1967,30
STAT,1961,36,30-34,1997,2.802199252515779
STAT,1907,35,15-19,1942,0.020775702389183436
STAT,1868,29,50-100,1897,0.704200923648272
STAT,1889,88,na,1977,611.676996742959
STAT,1925,40,15-19,1965,0.002150913606353897
SIM,1909,88,na,1997,1264
SIM,1853,29,35-39,1882,8
SIM,1864,31,na,1895,2658
STAT,1859,51,50-100,1910,0.013950458584552895
SIM,1831,28,50-100,1859,1
STAT,1985,30,15-19,2015,0.2152450760841234
STAT,1845,29,35-39,1874,7.800829061340738
STAT,1831,30,25-29,1861,10.649256397050504
STAT,1864,96,na,1960,17.618513205616217
STAT,1939,39,25-29,1978,1.169781703070307
STAT,1932,27,20-24,1959,27.598666311191362
STAT,1881,16,50-100,1897,0.05466822308781214
STAT,1912,24,30-34,1936,32.94994976912785
STAT,1990,22,35-39,2012,15.613195463379784
STAT,1935,66,na,2001,5129.964025961441
STAT,1948,44,15-19,1992,0.0021006951424303857
SIM,1882,50,na,1932,3002
SIM,1861,29,na,1890,1937
SIM,1872,31,35-39,1903,28
STAT,1918,16,50-100,1934,0.09462972974389196
STAT,1903,35,30-34,1938,1.908865018911504
STAT,1981,33,35-39,2014,15.022371152983808
SIM,1825,54,50-100,1879,1
SIM,1872,1,na,1873,4208
STAT,1897,32,25-29,1929,15.80570914118583
STAT,1850,52,na,1902,2204.7700141362366
SIM,1846,12,na,1858,2061
SIM,1822,40,35-39,1862,3
STAT,1939,34,na,1973,4449.439435366772
STAT,1967,15,30-34,1982,17.5802992491231
STAT,1982,26,50-100,2008,1.6240886771435177
STAT,1840,54,35-39,1894,0.006716284444194636
STAT,1972,30,20-24,2002,3.677922989810621
SIM,1845,41,30-34,1886,2
STAT,1881,44,na,1925,2537.981508377998
STAT,1909,17,35-39,1926,0.9507041682370488
STAT,1848,54,40-44,1902,0.01087831387587306
STAT,1890,11,na,1901,3647.082436849925
STAT,1907,33,50-100,1940,0.8895486497557137
SIM,1869,19,na,1888,2095
SIM,1806,53,na,1859,1396
SIM,1920,24,30-34,1944,43
STAT,1937,41,35-39,1978,0.2348682632381742
STAT,1835,49,30-34,1884,0.06206327120342783
SIM,1823,59,na,1882,1766
SIM,1901,44,na,1945,3994
SIM,1915,28,25-29,1943,167
STAT,1951,34,50-100,1985,1.1566734883451422
STAT,1814,40,35-39,1854,8.093498543657283
STAT,1888,31,20-24,1919,3.6818861053514076
STAT,1870,28,30-34,1898,28.549208224828813
STAT,1922,46,20-24,1968,0.014681405264885181
SIM,1920,79,na,1999,1934
SIM,1862,46,na,1908,2794
SIM,1873,83,na,1956,440
STAT,1890,45,35-39,1935,0.1993849893939058
STAT,1938,40,25-29,1978,0.08475790839395701
SIM,1851,40,50-100,1891,2
SIM,1910,48,50-100,1958,1
SIM,1911,35,30-34,1946,2
STAT,1899,20,40-44,1919,3.3143062934499112
STAT,1928,43,35-39,1971,0.29577647365302934
STAT,1886,44,30-34,1930,1.3806132805878735
STAT,1907,28,25-29,1935,71.5739117802309
STAT,1970,45,40-44,2015,0.23802448884132063
STAT,1894,29,30-34,1923,37.091328469869474
SIM,1936,43,35-39,1979,1
STAT,1857,25,na,1882,2241.4891883812384
SIM,1852,38,30-34,1890,6
STAT,1799,105,na,1904,0.013170398595205468
STAT,1838,40,20-24,1878,0.16508614209776654
SIM,1918,28,50-100,1946,2
STAT,1933,18,25-29,1951,66.80090513796105
STAT,1935,76,na,2011,3802.6748977398593
STAT,1822,67,na,1889,1303.3090047774322
SIM,1882,60,na,1942,2680
STAT,1857,46,50-100,1903,0.2213746463203427
SIM,1973,36,50-100,2009,1
STAT,1837,41,30-34,1878,0.9950285668032823
STAT,1941,66,na,2007,3891.951129393726
SIM,1842,91,na,1933,94
STAT,1875,0,na,1875,4378.392516380495
SIM,1909,24,na,1933,4928
STAT,1870,42,30-34,1912,1.306394987449769
STAT,1854,23,50-100,1877,0.38755068472535814
STAT,1880,23,30-34,1903,21.721392112961798
STAT,1772,102,na,1874,0.010685023911663032
STAT,1848,20,25-29,1868,75.1358000791544
SIM,1979,17,40-44,1996,5
STAT,1964,30,25-29,1994,13.709430181056351
SIM,1941,18,25-29,1959,121
STAT,1904,80,na,1984,1847.2905406166317
STAT,1811,49,45-49,1860,0.7112958853663516
STAT,1841,20,25-29,1861,65.41168329447662
STAT,1984,15,15-19,1999,74.42555519717878
SIM,1900,25,na,1925,3620
STAT,1938,15,na,1953,4211.709203085587
STAT,1970,28,35-39,1998,21.772337890820424
STAT,1963,31,35-39,1994,13.665160781641694
SIM,1946,40,na,1986,4642
STAT,1844,38,30-34,1882,4.661986324793068
STAT,1851,33,15-19,1884,0.11632420780161574
STAT,1962,41,50-100,2003,0.1807909043986769
STAT,1933,25,15-19,1958,1.0831803517630394
SIM,1971,32,20-24,2003,9
STAT,1912,17,40-44,1929,0.3267187280982597
STAT,1913,23,na,1936,4244.745409796637
STAT,1875,34,na,1909,2821.5381343729982
SIM,1917,17,35-39,1934,1
SIM,1867,83,na,1950,324
STAT,1854,36,35-39,1890,5.790021988716614
STAT,1890,21,35-39,1911,8.25357157422277
SIM,1882,44,40-44,1926,4
STAT,1874,44,40-44,1918,2.6215308060391105
STAT,1930,25,45-49,1955,2.537672502765048
SIM,1856,20,25-29,1876,72
STAT,1873,23,40-44,1896,2.448159309738005
STAT,1807,50,na,1857,1672.1720991996822
SIM,1920,17,40-44,1937,8
STAT,1830,32,30-34,1862,18.890868958177567
SIM,1891,23,50-100,1914,4
STAT,1817,101,na,1918,0.3945063926121253
SIM,1897,9,na,1906,4204
STAT,1863,31,30-34,1894,17.69077971690643
STAT,1993,15,15-19,2008,75.39400096339175
STAT,1875,42,50-100,1917,1.2583685125169932
SIM,1949,28,35-39,1977,1
SIM,1849,7,na,1856,3286
SIM,1927,38,45-49,1965,2
STAT,1893,48,40-44,1941,0.13909995529860442
STAT,1805,55,na,1860,1342.0862174039905
STAT,1903,57,na,1960,3423.61460166254
STAT,1864,33,25-29,1897,10.509865766770055
STAT,1850,46,45-49,1896,0.24363904352080754
STAT,1931,20,35-39,1951,14.180693101007355
STAT,1938,48,20-24,1986,0.013055750726304358
SIM,1857,26,15-19,1883,2
STAT,1900,19,25-29,1919,9.025783288408807
SIM,1848,22,40-44,1870,3
STAT,1839,49,15-19,1888,3.1502935150054767E-4
STAT,1907,23,na,1930,4003.3838705116123
STAT,1919,36,35-39,1955,3.0007939111937803
SIM,1880,40,50-100,1920,5
STAT,1923,71,na,1994,3782.1941640384657
SIM,1879,40,na,1919,2759
STAT,1931,46,45-49,1977,0.33627822321520073
STAT,1849,26,15-19,1875,0.4198631979398498
SIM,1819,44,na,1863,1161
SIM,1881,23,40-44,1904,1
SIM,1908,24,15-19,1932,12
STAT,1900,17,15-19,1917,9.503326491904629
STAT,1953,38,45-49,1991,0.979512877191359
SIM,1953,26,35-39,1979,25
SIM,1963,18,na,1981,5804
STAT,1945,26,35-39,1971,19.017336846720855
STAT,1798,68,na,1866,651.9722991532714
STAT,1825,43,15-19,1868,0.020104692169001813
STAT,1918,56,na,1974,4342.682093112906
SIM,1915,5,na,1920,5112
SIM,1971,23,na,1994,5784
STAT,1836,57,na,1893,1828.90044988019
SIM,1933,9,na,1942,6643
SIM,1799,56,na,1855,951
STAT,1878,37,35-39,1915,8.522556045963382
STAT,1860,49,40-44,1909,0.1559099042107185
SIM,1953,28,45-49,1981,4
STAT,1846,105,na,1951,0.030311184815444266
STAT,1820,34,15-19,1854,0.4847838973003683
STAT,1987,26,na,2013,6201.24250915307
SIM,1962,29,50-100,1991,2
SIM,1887,38,na,1925,3675
SIM,1836,37,50-100,1873,2
STAT,1915,35,20-24,1950,0.31029612072839036
STAT,1822,71,na,1893,1096.7078133685384
STAT,1916,93,na,2009,386.8130375514253
STAT,1868,58,na,1926,2192.696063047731
SIM,1874,8,na,1882,2966
SIM,1911,68,na,1979,3889
STAT,1941,39,50-100,1980,0.5132052108677345
SIM,1892,80,na,1972,1596
STAT,1881,21,25-29,1902,63.91413781062084
STAT,1808,66,na,1874,1087.9206247886007
STAT,1863,25,50-100,1888,0.6548905567859428
STAT,1810,50,45-49,1860,0.05534606567390846
STAT,1868,17,20-24,1885,20.01272490499638
SIM,1872,66,na,1938,2021
SIM,1886,37,35-39,1923,5
STAT,1930,25,na,1955,5502.685100985997
STAT,1956,46,20-24,2002,0.017597127256767615
SIM,1932,36,na,1968,5477
SIM,1975,25,15-19,2000,1
STAT,1924,18,15-19,1942,62.18878469679947
SIM,1932,18,15-19,1950,66
SIM,1893,38,na,1931,3391
STAT,1853,59,na,1912,1934.9498129807675
STAT,1828,37,50-100,1865,1.2635962957265712
STAT,1992,18,15-19,2010,75.15272710526091
STAT,1923,24,50-100,1947,0.8776902202096087
STAT,1954,29,50-100,1983,1.424758037934767
STAT,1845,26,30-34,1871,20.803605727434054
STAT,1834,20,50-100,1854,0.7815019325507853
STAT,1849,19,25-29,1868,5.342828525325844
STAT,1979,26,35-39,2005,23.97016941599822
STAT,1842,26,15-19,1868,0.4348807623931996
STAT,1977,32,30-34,2009,25.04165469938152
STAT,1816,71,na,1887,728.3276204762602
SIM,1886,80,na,1966,443
STAT,1876,46,15-19,1922,4.7854597416776174E-4
SIM,1957,18,na,1975,6320
STAT,1921,24,40-44,1945,4.353713495394323
STAT,1815,52,35-39,1867,0.01689185503513068
STAT,1941,25,20-24,1966,21.81641617850322
STAT,1883,45,45-49,1928,0.2691223289352648
STAT,1893,63,na,1956,2631.4320852490264
SIM,1887,65,na,1952,2918
SIM,1879,5,na,1884,3157
SIM,1901,38,40-44,1939,4
SIM,1912,6,na,1918,4265
STAT,1915,58,na,1973,4053.457764450414
SIM,1875,18,30-34,1893,7
STAT,1833,102,na,1935,0.2062995292487629
STAT,1886,47,35-39,1933,0.16962903756082262
STAT,1965,21,50-100,1986,0.9514604749859332
SIM,1873,79,na,1952,842
STAT,1877,31,45-49,1908,2.1019173017276715
STAT,1907,25,20-24,1932,20.054849188107085
STAT,1884,32,15-19,1916,0.16237621834106292
STAT,1829,41,25-29,1870,0.6979732444263035
SIM,1853,26,30-34,1879,52
STAT,1910,38,25-29,1948,1.0824660333298297
STAT,1941,15,50-100,1956,0.4456960550960535
SIM,1837,41,25-29,1878,2
STAT,1890,42,30-34,1932,1.61917447272214
SIM,1969,20,25-29,1989,147
SIM,1850,26,15-19,1876,1
SIM,1980,33,25-29,2013,31
SIM,1857,19,25-29,1876,13
SIM,1987,26,35-39,2013,68
SIM,1904,55,na,1959,3763
STAT,1965,29,25-29,1994,95.1467853126883
SIM,1871,13,na,1884,2381
SIM,1934,21,na,1955,5008
STAT,1899,21,35-39,1920,9.254160026674763
SIM,1830,25,35-39,1855,23
STAT,1901,48,40-44,1949,0.1541439768170473
STAT,1928,40,30-34,1968,0.18860488026817776
STAT,1945,28,45-49,1973,2.1862921053467663
STAT,1968,17,25-29,1985,62.463937742536956
STAT,1899,23,45-49,1922,1.099107751720359
SIM,1866,66,na,1932,1723
STAT,1810,70,na,1880,908.7696425777619
SIM,1982,24,45-49,2006,3
STAT,1981,30,30-34,2011,25.944917529971292
SIM,1885,31,45-49,1916,1
SIM,1876,17,20-24,1893,20
STAT,1902,47,30-34,1949,0.08862250988033271
SIM,1858,31,na,1889,2670
SIM,1919,54,na,1973,5085
STAT,1830,50,50-100,1880,0.014007798401461198
STAT,1969,46,30-34,2015,0.13400739014928317
STAT,1858,42,15-19,1900,0.012417489424421262
STAT,1839,51,45-49,1890,0.011564133297499623
STAT,1902,24,50-100,1926,0.660791733823313
STAT,1940,6,na,1946,4678.707280648819
STAT,1972,33,25-29,2005,13.912247847986398
STAT,1856,4,na,1860,2774.891048952581
STAT,1955,27,na,1982,5763.955170822418
STAT,1967,18,35-39,1985,6.047091109614493
STAT,2013,0,na,2013,7306.091326828846
STAT,1891,29,15-19,1920,0.642499062951657
STAT,1905,30,35-39,1935,17.051433323217328
STAT,1844,28,50-100,1872,0.6502925550836747
STAT,1837,51,25-29,1888,0.002625674979331693
SIM,1863,31,25-29,1894,19
SIM,1889,23,na,1912,3583
SIM,1829,43,40-44,1872,10
SIM,1802,87,na,1889,49
SIM,1976,17,25-29,1993,84
STAT,1898,38,15-19,1936,0.01881029264771595
STAT,1819,36,30-34,1855,17.108490591829074
STAT,1900,50,na,1950,3497.632156497417
SIM,1927,36,35-39,1963,3
SIM,1883,14,na,1897,2769
SIM,1975,18,35-39,1993,17
SIM,1941,15,20-24,1956,157
STAT,1830,35,35-39,1865,7.377182046877957
STAT,1971,36,45-49,2007,1.0275186508160379
STAT,1812,43,20-24,1855,0.4286584224891743
SIM,1836,21,20-24,1857,4
SIM,1946,38,50-100,1984,1
SIM,1959,22,20-24,1981,184
STAT,1844,52,30-34,1896,0.00495234209133395
STAT,1837,44,35-39,1881,1.372416911863877
SIM,1917,3,na,1920,5905
STAT,1919,38,45-49,1957,0.8441437913528481
SIM,1913,30,35-39,1943,26
SIM,1827,36,30-34,1863,10
SIM,1864,41,na,1905,2729
STAT,1935,46,30-34,1981,0.14567954804481043
STAT,1862,40,15-19,1902,0.013585554388190806
STAT,1860,35,na,1895,2212.125932130326
SIM,1967,41,45-49,2008,1
STAT,1859,3,na,1862,3014.962224621012
SIM,1928,21,na,1949,5450
SIM,1849,28,30-34,1877,55
STAT,1957,38,30-34,1995,2.854158199419091
STAT,1811,46,40-44,1857,0.5427329734574243
STAT,1830,38,na,1868,1668.9822659282268
STAT,1915,5,na,1920,4841.442239774388
STAT,1927,48,45-49,1975,0.3138972304722634
STAT,1925,24,50-100,1949,0.9029646208403708
SIM,1837,34,35-39,1871,6
SIM,1845,44,35-39,1889,2
STAT,1868,62,na,1930,2026.5291148699566
STAT,1933,15,20-24,1948,210.51118397962142
SIM,1912,17,35-39,1929,2
SIM,1943,46,30-34,1989,1
SIM,1903,34,40-44,1937,10
STAT,1838,43,25-29,1881,0.5845409996136653
SIM,1907,53,na,1960,4146
STAT,1875,16,15-19,1891,7.094900566407171
STAT,1904,17,35-39,1921,0.9093313244622261
SIM,1846,43,25-29,1889,2
STAT,1851,52,20-24,1903,5.820511167886254E-4
STAT,1886,105,na,1991,1.5382539301535985
STAT,1912,27,35-39,1939,17.090753929898277
SIM,1823,52,35-39,1875,1
SIM,1883,16,15-19,1899,7
SIM,1803,73,na,1876,804
STAT,1875,22,45-49,1897,0.8316225122867924
SIM,1918,35,30-34,1953,1
STAT,1865,82,na,1947,485.83178837895605
STAT,1865,39,15-19,1904,0.057882790965236706
STAT,1920,31,15-19,1951,0.16303374460872996
STAT,1949,17,na,1966,4940.2064010812555
SIM,1929,37,na,1966,5234
STAT,1956,32,40-44,1988,6.0914235734877185
STAT,1928,22,na,1950,5261.7219790102245
SIM,1942,29,na,1971,4828
STAT,1899,17,15-19,1916,9.382942768762746
STAT,1971,42,na,2013,5641.504576845373
STAT,1874,50,35-39,1924,0.010317312882385474
STAT,1928,33,40-44,1961,5.643367648445214
STAT,1941,35,15-19,1976,0.023563831779567737
SIM,1850,8,na,1858,2285
SIM,1854,45,40-44,1899,2
SIM,1877,27,30-34,1904,9
SIM,1923,38,25-29,1961,5
STAT,1917,42,30-34,1959,0.15397462651902244
SIM,1959,42,30-34,2001,1
STAT,1804,70,na,1874,885.8918281410782
STAT,1846,45,40-44,1891,0.17874794458206164
SIM,1911,27,na,1938,4696
STAT,1943,39,na,1982,4733.736845585323
SIM,1796,86,na,1882,174
SIM,1839,71,na,1910,1288
STAT,1915,38,25-29,1953,1.1423888584424997
SIM,1951,37,25-29,1988,1
SIM,1834,65,na,1899,1305
STAT,1854,45,na,1899,1851.2121019345236
SIM,1831,32,40-44,1863,9
STAT,1973,26,50-100,1999,1.4926969741368674
SIM,1916,74,na,1990,2757
SIM,1959,25,25-29,1984,220
STAT,1960,42,45-49,2002,0.2599717646802823
SIM,1833,80,na,1913,283
STAT,1845,68,na,1913,1029.783416358839
SIM,1868,24,50-100,1892,2
STAT,1871,16,30-34,1887,1.8526944804543244
STAT,1878,34,30-34,1912,20.858063017140406
SIM,1925,42,30-34,1967,1
SIM,1896,30,25-29,1926,4
STAT,1911,45,30-34,1956,0.0979369292742519
STAT,1996,18,35-39,2014,7.03541384348866
STAT,1866,22,35-39,1888,6.292957017581475
SIM,1927,35,40-44,1962,5
SIM,1874,22,35-39,1896,5
STAT,1862,18,30-34,1880,1.767402725178489
STAT,1870,44,20-24,1914,0.1782465135962169
SIM,1968,38,na,2006,5330
STAT,1853,50,na,1903,2174.5410109747368
STAT,1865,50,25-29,1915,0.0037411425809449816
SIM,1870,18,30-34,1888,5
SIM,1931,41,na,1972,6086
STAT,1891,48,20-24,1939,0.009533434963272048
SIM,1929,47,na,1976,5161
STAT,1915,45,15-19,1960,4.304670274399206E-4
STAT,1811,55,na,1866,1354.1728582535666
STAT,1841,42,35-39,1883,1.6729672812704577
SIM,1822,33,na,1855,1753
STAT,1916,4,na,1920,4926.271593908772
SIM,1912,81,na,1993,882
STAT,1822,98,na,1920,2.6690881494635668
STAT,1943,44,15-19,1987,0.0019467699828396574
STAT,1977,15,25-29,1992,67.60819931944317
SIM,1962,30,30-34,1992,46
SIM,1925,47,25-29,1972,1
SIM,1883,45,na,1928,2417
STAT,1954,23,40-44,1977,4.811225436103089
STAT,1971,38,35-39,2009,3.6386556634263485
STAT,1795,102,na,1897,0.05137263164423611
SIM,1859,26,na,1885,2297
SIM,1963,7,na,1970,6582
SIM,1944,25,30-34,1969,4
SIM,1798,71,na,1869,789
STAT,1909,18,30-34,1927,2.754333988828589
STAT,1856,30,na,1886,2171.37837063681
STAT,1869,30,20-24,1899,3.0452438293888937
STAT,1855,43,40-44,1898,1.9000732085345833
STAT,1793,90,na,1883,31.393830765809632
SIM,1855,41,25-29,1896,1
STAT,1975,35,15-19,2010,0.03017298486756109
SIM,1807,66,na,1873,869
SIM,1859,25,20-24,1884,10
STAT,1886,77,na,1963,1346.016621283128
SIM,1964,32,40-44,1996,17
STAT,1806,54,35-39,1860,0.02911150787637826
STAT,1968,29,40-44,1997,6.740851305633347
STAT,1924,66,na,1990,4322.489658678256
SIM,1848,25,45-49,1873,3
SIM,1955,2,na,1957,6590
STAT,1783,73,na,1856,356.57387909190004
STAT,1876,39,50-100,1915,1.4499298911644467
STAT,1872,41,35-39,1913,2.1078696539399293
SIM,1880,41,35-39,1921,4
SIM,1897,29,50-100,1926,2
SIM,1904,22,40-44,1926,4
SIM,1816,46,na,1862,1631
STAT,1766,94,na,1860,9.75082796492348
STAT,1890,23,25-29,1913,80.4737586680215
STAT,1855,39,50-100,1894,1.034166596829097
SIM,1911,37,na,1948,4809
STAT,1913,15,35-39,1928,0.9952241590960513
STAT,1917,47,25-29,1964,0.06394308101913414
SIM,1890,27,na,1917,3598
STAT,1954,30,30-34,1984,22.937595204865325
STAT,1811,48,30-34,1859,0.2966995124564877
STAT,1873,31,25-29,1904,12.12013420732146
STAT,1877,18,25-29,1895,6.784772597626566
STAT,1946,24,50-100,1970,0.8444336708386816
STAT,1900,17,50-100,1917,0.0784534224175906
STAT,1857,17,45-49,1874,0.06900749940412265
SIM,1974,38,na,2012,6304
STAT,1811,65,na,1876,1017.8919477576414
SIM,1921,15,35-39,1936,11
STAT,1785,105,na,1890,0.01446977341873145
STAT,1951,39,40-44,1990,2.1149294710795954
SIM,1859,16,na,1875,2484
STAT,1945,25,40-44,1970,5.906519521509775
SIM,1963,50,na,2013,6350
STAT,1985,9,na,1994,6450.06971277445
SIM,1844,28,30-34,1872,37
STAT,1862,30,na,1892,2342.787167358313
SIM,1860,43,25-29,1903,1
STAT,1945,24,na,1969,4615.743245236154
SIM,1970,18,35-39,1988,13
STAT,1941,28,25-29,1969,78.55976818110449
STAT,1971,42,20-24,2013,0.026826335424439785
STAT,1883,44,15-19,1927,0.015382101624684731
STAT,1971,16,35-39,1987,6.135077767626108
SIM,1877,45,na,1922,3067
STAT,1860,45,na,1905,2113.458659472782
STAT,1896,41,20-24,1937,0.016886351156903255
SIM,1953,25,40-44,1978,11
STAT,1802,52,25-29,1854,0.01412944761588406
SIM,1978,25,30-34,2003,75
STAT,1952,42,15-19,1994,0.00220713238123572
SIM,1827,79,na,1906,261
SIM,1973,26,20-24,1999,32
STAT,1887,32,30-34,1919,22.581054320106688
STAT,1843,40,50-100,1883,1.1197414116609796
SIM,1887,47,45-49,1934,1
STAT,1924,25,na,1949,5066.451137903836
SIM,1886,34,30-34,1920,2
STAT,1817,43,na,1860,2086.828579538022
STAT,1888,30,25-29,1918,14.00654568253405
STAT,1965,26,20-24,1991,26.42508790933123
SIM,1873,9,na,1882,3705
STAT,1842,16,na,1858,2281.7301169386255
SIM,1848,78,na,1926,248
STAT,1929,31,35-39,1960,13.404298865785492
SIM,1895,32,30-34,1927,54
STAT,1936,28,35-39,1964,16.58353040217195
SIM,1937,31,35-39,1968,3
STAT,1902,48,50-100,1950,0.22306682649506868
STAT,1879,47,45-49,1926,0.28305864077119164
STAT,1971,33,40-44,2004,5.8268923387353
SIM,1836,50,na,1886,1483
STAT,1827,49,na,1876,1999.805863632641
SIM,1847,93,na,1940,144
STAT,1857,18,50-100,1875,0.051450783924474275
SIM,1815,51,na,1866,1818
STAT,1857,108,na,1965,0.011735506416846434
SIM,1900,89,na,1989,439
STAT,1965,42,na,2007,5560.817620878768
STAT,1874,37,15-19,1911,0.06634365185412132
SIM,1922,78,na,2000,2579
SIM,1981,16,na,1997,6456
SIM,1830,68,na,1898,1059
SIM,1840,44,35-39,1884,3
STAT,1836,28,30-34,1864,29.45182674942961
STAT,1849,41,50-100,1890,0.8225272606028061
STAT,1919,35,40-44,1954,1.8658794585083325
STAT,1922,22,35-39,1944,12.455858328747071
SIM,1963,21,35-39,1984,33
STAT,1886,25,50-100,1911,0.7839876641385387
STAT,1965,36,50-100,2001,0.623774274497809
STAT,1939,5,na,1944,4636.516078007039
SIM,1915,33,50-100,1948,2
STAT,1922,15,45-49,1937,0.669991799546133
STAT,1962,18,35-39,1980,6.202764058436521
SIM,1852,53,na,1905,1722
STAT,1853,54,30-34,1907,0.005763497262368813
SIM,1831,35,45-49,1866,5
SIM,1892,12,na,1904,4115
SIM,1872,33,25-29,1905,24
STAT,1832,44,35-39,1876,1.4991269611522187
STAT,1866,15,45-49,1881,0.07257132438284884
STAT,1867,18,na,1885,2765.610678272881
SIM,1839,27,45-49,1866,1
STAT,1912,34,50-100,1946,0.9317381786388774
STAT,1900,38,30-34,1938,1.8329706913115824
SIM,1809,51,na,1860,1619
STAT,1823,35,45-49,1858,4.225664830722909
STAT,1840,90,na,1930,63.24602302678274
STAT,1842,48,25-29,1890,0.04376771236864112
STAT,1829,31,30-34,1860,23.528866441715966
STAT,1885,37,na,1922,2711.987137199049
SIM,1952,40,na,1992,4714
SIM,1845,22,25-29,1867,77
STAT,1840,32,25-29,1872,10.007801677497268
STAT,1886,81,na,1967,1054.0557037422539
STAT,1832,41,30-34,1873,0.9897485488662239
STAT,1932,34,45-49,1966,2.4115591864979162
STAT,1979,25,50-100,2004,1.5898115330616156
STAT,1966,41,35-39,2007,0.3020779832799391
SIM,1830,47,45-49,1877,1
SIM,1880,35,40-44,1915,13
SIM,1937,77,na,2014,2436
SIM,1879,42,25-29,1921,2
STAT,1928,18,na,1946,5338.182023597155
STAT,1890,20,20-24,1910,97.75470050051432
SIM,1903,37,45-49,1940,2
SIM,1865,26,na,1891,2989
STAT,1860,31,15-19,1891,0.13299590300146488
SIM,1849,64,na,1913,1995
SIM,1837,31,30-34,1868,12
STAT,1815,48,15-19,1863,8.046951253978833E-4
SIM,1938,33,50-100,1971,1
SIM,1910,42,na,1952,3527
STAT,1917,44,20-24,1961,0.02119899906815357
STAT,1931,11,na,1942,5995.388855738057
STAT,1846,35,50-100,1881,1.3532340481950953
STAT,1892,39,25-29,1931,4.122655122069807
STAT,1942,54,na,1996,4489.074097186718
STAT,1901,49,50-100,1950,0.21926985008005195
STAT,1996,15,30-34,2011,20.453583130788815
STAT,1900,30,35-39,1930,16.347389335560944
SIM,1854,35,50-100,1889,1
STAT,1852,40,20-24,1892,0.1512419001127411
STAT,1942,46,20-24,1988,0.013899871288061607
SIM,1962,26,45-49,1988,1
SIM,1879,30,na,1909,2854
STAT,1911,43,40-44,1954,0.27408558426496576
SIM,1930,22,35-39,1952,27
STAT,1854,33,30-34,1887,14.41614975229587
STAT,1971,35,30-34,2006,2.7493209559208633
SIM,1862,33,30-34,1895,41
STAT,1951,45,35-39,1996,0.18516161348838447
STAT,1872,35,40-44,1907,5.120835583898344
STAT,1936,18,40-44,1954,1.5422793845146399
STAT,1933,47,25-29,1980,0.08422058875825149
STAT,1837,22,25-29,1859,54.26541052081896
STAT,1914,41,50-100,1955,0.1345994979452574
SIM,1840,41,30-34,1881,2
SIM,1940,34,45-49,1974,5
STAT,1814,42,25-29,1856,2.1980693287735917
SIM,1886,46,50-100,1932,2
STAT,1908,102,na,2010,14.41725640194953
STAT,1843,97,na,1940,5.3904056504507505
SIM,1990,19,50-100,2009,1
STAT,1871,82,na,1953,535.6955896454542
STAT,1943,34,20-24,1977,3.0390572926236428
SIM,1917,59,na,1976,4836
SIM,1897,58,na,1955,2928
STAT,1925,49,40-44,1974,0.21911694245695804
STAT,1820,54,35-39,1874,0.008123614222144764
SIM,1922,41,50-100,1963,1
SIM,1838,27,na,1865,1857
SIM,1908,48,na,1956,3573
STAT,1878,46,50-100,1924,0.2967773052782621
SIM,1944,28,35-39,1972,24
STAT,1835,31,na,1866,1737.4740585706443
STAT,1806,51,30-34,1857,0.021377692720262735
STAT,1913,19,na,1932,4535.1944639941585
SIM,1904,25,45-49,1929,2
STAT,1844,16,20-24,1860,18.961305403665676
STAT,1906,44,45-49,1950,0.17253955947914434
SIM,1936,36,45-49,1972,1
SIM,1949,29,30-34,1978,10
STAT,1954,33,35-39,1987,13.281100937258204
STAT,1844,54,20-24,1898,6.002395312638513E-4
SIM,1962,33,35-39,1995,29
SIM,1974,28,na,2002,5947
STAT,1939,36,20-24,1975,0.3141402576022946
STAT,1857,15,na,1872,2453.753632924711
STAT,1983,2,na,1985,6424.440639865271
STAT,1955,17,na,1972,5638.969479310591
SIM,1947,25,na,1972,6047
STAT,1833,47,20-24,1880,0.009959546882366768
STAT,1828,43,30-34,1871,1.088455289897865
SIM,1958,15,15-19,1973,119
STAT,1852,45,15-19,1897,3.808848305067258E-4
STAT,1883,42,40-44,1925,2.5365132868666027
SIM,1908,16,30-34,1924,3
STAT,1911,48,35-39,1959,0.14058885715056438
SIM,1933,49,40-44,1982,1
SIM,1932,26,na,1958,5274
SIM,1859,28,25-29,1887,79
STAT,1826,50,20-24,1876,5.337412765386442E-4
STAT,1971,40,30-34,2011,0.1947383903271853
STAT,1805,65,na,1870,1008.8067749739484
STAT,1903,19,40-44,1922,0.29903954335479693
SIM,1874,49,25-29,1923,1
SIM,1818,38,30-34,1856,16
STAT,1866,49,25-29,1915,0.06032610064493367
STAT,1928,36,45-49,1964,0.9951557665896185
STAT,1901,26,30-34,1927,40.84579888422916
STAT,1972,20,na,1992,5417.489212782257
STAT,1846,51,35-39,1897,0.008942473870260781
SIM,1824,72,na,1896,486
SIM,1987,25,50-100,2012,2
SIM,1922,74,na,1996,3392
STAT,1841,31,na,1872,2362.286574785385
STAT,1822,47,45-49,1869,0.4460630562950928
SIM,1904,32,35-39,1936,3
STAT,1967,5,na,1972,5667.959121464134
STAT,1847,41,25-29,1888,0.5032729525079179
SIM,1891,42,40-44,1933,6
STAT,1879,44,40-44,1923,2.673834274588954
SIM,1909,96,na,2005,117
STAT,1837,97,na,1934,3.89019171411506
STAT,1921,27,45-49,1948,2.2212145004889106
SIM,1940,41,35-39,1981,1
SIM,1939,62,na,2001,4480
STAT,1910,35,20-24,1945,0.29401985889500953
STAT,1983,22,45-49,2005,1.8429670512706329
STAT,1858,96,na,1954,7.730447547753069
STAT,1900,20,40-44,1920,3.3568290436223163
STAT,1853,50,50-100,1903,0.015252666243385933
SIM,1898,23,35-39,1921,22
SIM,1842,41,15-19,1883,1
SIM,1966,17,30-34,1983,43
STAT,1812,45,50-100,1857,0.5886821990471204
STAT,1980,16,45-49,1996,0.8005309464840538
STAT,1887,35,35-39,1922,9.234447709216237
SIM,1978,28,35-39,2006,51
STAT,1879,95,na,1974,96.27036410089569
SIM,1895,35,35-39,1930,5
STAT,1877,15,20-24,1892,21.381005386216163
STAT,1995,16,50-100,2011,0.6260510780116626
STAT,1980,21,15-19,2001,8.559195303165037
STAT,1906,37,20-24,1943,0.279997692509998
STAT,1899,0,na,1899,4642.554823722661
STAT,1936,25,30-34,1961,43.33839524910729
STAT,1808,51,15-19,1859,1.196219608246401E-4
STAT,1958,17,30-34,1975,18.475012836181666
STAT,1932,41,35-39,1973,0.3154900576093271
STAT,1943,46,50-100,1989,0.2886522392639903
STAT,1841,38,15-19,1879,0.05821555096472668
SIM,1976,32,20-24,2008,3
SIM,1991,22,45-49,2013,1
STAT,1776,87,na,1863,79.57550540428466
SIM,1826,29,25-29,1855,94
STAT,1876,15,50-100,1891,0.058717825222166134
SIM,1939,5,na,1944,5096
SIM,1975,19,30-34,1994,45
STAT,1895,17,30-34,1912,2.394297888715018
STAT,1940,18,na,1958,4312.927407688074
STAT,1839,50,30-34,1889,0.0048381304164981775
STAT,1968,32,20-24,2000,3.5837812522904895
SIM,1861,30,45-49,1891,1
STAT,1891,33,35-39,1924,14.383462909095316
STAT,1956,29,15-19,1985,1.08163100453215
STAT,1976,16,na,1992,5676.589022161549
STAT,1890,43,45-49,1933,2.0951971819513933
STAT,1834,41,15-19,1875,0.01538896784606577
STAT,1959,49,40-44,2008,0.24610903250747374
SIM,1838,44,50-100,1882,1
STAT,1906,37,na,1943,3996.090880501134
STAT,1892,77,na,1969,1739.6093555199502
STAT,1967,19,30-34,1986,17.559212330534944
STAT,1833,54,45-49,1887,0.010185427619388615
STAT,1967,47,25-29,2014,0.07953883028630605
STAT,1823,32,40-44,1855,11.982467526659594
STAT,1905,19,50-100,1924,0.0813933791464585
STAT,1896,44,25-29,1940,0.0670545407119985
STAT,1891,40,25-29,1931,0.9251622171373771
SIM,1914,37,20-24,1951,1
SIM,1938,14,na,1952,4156
SIM,1978,3,na,1981,6043
STAT,1954,26,45-49,1980,2.4764925630186108
SIM,1945,62,na,2007,4131
STAT,1930,32,50-100,1962,1.231537856386054
STAT,1864,53,45-49,1917,0.01471408917425574
SIM,1839,24,40-44,1863,7
STAT,1848,47,15-19,1895,4.2302930316106543E-4
STAT,1841,40,45-49,1881,1.4185974530568566
STAT,1857,52,40-44,1909,0.009411990757652623
STAT,1871,19,35-39,1890,0.6266089403712127
SIM,1849,20,35-39,1869,12
SIM,1825,30,50-100,1855,1
SIM,1899,19,30-34,1918,8
SIM,1873,43,35-39,1916,2
STAT,1909,105,na,2014,2.699159398849761
STAT,1910,12,na,1922,4520.742999857026
STAT,1880,26,35-39,1906,11.843471840246249
STAT,1879,115,na,1994,1.694595895721152E-4
SIM,1885,30,na,1915,3183
SIM,1857,32,45-49,1889,3
STAT,1883,47,50-100,1930,0.27601225448240957
SIM,1855,64,na,1919,1324
STAT,1955,44,40-44,1999,0.39690352344506163
SIM,1891,47,50-100,1938,1
SIM,1970,15,30-34,1985,43
STAT,1887,22,na,1909,3058.7717902823642
STAT,1916,33,15-19,1949,0.1524786561581051
SIM,1887,44,40-44,1931,7
SIM,1894,22,20-24,1916,200
SIM,1835,40,45-49,1875,4
STAT,1865,43,35-39,1908,1.871900260837183
STAT,1888,32,50-100,1920,1.242955442756204
STAT,1870,33,50-100,1903,1.0380356528103933
SIM,1903,60,na,1963,3083
STAT,1849,32,45-49,1881,1.4242292687639382
STAT,1827,40,45-49,1867,2.071038302014256
SIM,1984,23,15-19,2007,9
STAT,1905,52,na,1957,3619.502508792911
STAT,1841,33,50-100,1874,0.9781731632066394
SIM,1953,48,35-39,2001,1
STAT,1886,22,20-24,1908,83.88794706243932
STAT,1962,15,30-34,1977,18.03287669101634
STAT,1818,38,50-100,1856,1.9032386442213467
STAT,1933,44,20-24,1977,0.027921585168397833
STAT,1845,37,30-34,1882,3.773411331963922
SIM,1825,48,35-39,1873,1
STAT,1887,78,na,1965,1380.6428544072448
SIM,1958,19,25-29,1977,160
STAT,1846,56,na,1902,2108.5371326862555
STAT,1947,54,na,2001,4837.897417939361
SIM,1864,27,35-39,1891,15
STAT,1920,46,50-100,1966,0.2891298626695596
STAT,1954,19,45-49,1973,0.7122009276490234
STAT,1850,50,40-44,1900,0.010993388630637365
STAT,1924,21,50-100,1945,0.898490118581536
STAT,1886,36,35-39,1922,8.651386293430846
SIM,1949,24,25-29,1973,264
SIM,1840,37,20-24,1877,3
SIM,1825,37,25-29,1862,5
STAT,1840,31,40-44,1871,4.281529304749961
SIM,1903,31,25-29,1934,5
STAT,1974,31,45-49,2005,2.4184878550221947
SIM,1844,42,30-34,1886,1
STAT,1895,73,na,1968,2203.8207228330243
STAT,1836,31,20-24,1867,3.143022648121234
SIM,1875,25,45-49,1900,2
SIM,1944,40,50-100,1984,2
SIM,1952,45,35-39,1997,1
STAT,1854,51,na,1905,1762.5723038989308
STAT,1947,34,50-100,1981,1.0941531417250223
STAT,1817,48,35-39,1865,0.3939975515571467
STAT,1906,104,na,2010,4.740048558663288
SIM,1919,23,30-34,1942,3
STAT,1953,21,15-19,1974,7.458477771390235
SIM,1961,32,25-29,1993,20
STAT,1856,27,35-39,1883,8.803171249149536
STAT,1836,42,30-34,1878,1.2451272296625386
SIM,1885,49,45-49,1934,1
SIM,1947,29,20-24,1976,3
SIM,1946,57,na,2003,4300
SIM,1855,32,35-39,1887,12
STAT,1986,18,40-44,2004,2.2993012983857586
STAT,1841,26,50-100,1867,0.7115164106868495
STAT,1984,19,15-19,2003,74.33628449700002
SIM,1890,25,40-44,1915,13
STAT,1825,31,45-49,1856,3.9402849918708447
STAT,1817,37,25-29,1854,12.95550311298609
SIM,1975,32,50-100,2007,5
STAT,1953,32,25-29,1985,13.15256288975458
STAT,1939,29,20-24,1968,21.165336381611272
SIM,1983,24,15-19,2007,16
STAT,1877,49,45-49,1926,0.2773898096561104
STAT,1892,43,50-100,1935,1.517049717760804
STAT,1894,44,15-19,1938,0.0014034850993375563
STAT,1847,32,35-39,1879,9.149170678324555
SIM,1988,16,45-49,2004,1
STAT,1812,68,na,1880,788.9168060318729
STAT,1944,45,35-39,1989,0.16734232473048882
STAT,1963,41,40-44,2004,0.3816608387797835
STAT,1981,18,50-100,1999,0.6043941310072068
SIM,1886,25,20-24,1911,23
STAT,1919,23,35-39,1942,11.859315978608977
SIM,1898,50,na,1948,3749
STAT,1833,50,35-39,1883,0.00654034476628242
STAT,1862,21,20-24,1883,69.20289205812519
STAT,1899,36,45-49,1935,3.1670128828227053
STAT,1819,47,30-34,1866,0.18638244155307263
STAT,1851,46,15-19,1897,3.18098247618917E-4
SIM,1851,27,25-29,1878,7
SIM,1961,21,15-19,1982,7
STAT,1927,42,25-29,1969,0.10333115742720399
STAT,1988,24,25-29,2012,152.85942025803206
SIM,1838,37,35-39,1875,3
STAT,1825,94,na,1919,14.136717625460443
STAT,1843,27,25-29,1870,52.235463341800575
STAT,1832,37,20-24,1869,0.6773392477503024
SIM,1834,24,15-19,1858,3
SIM,1865,63,na,1928,2272
SIM,1857,42,40-44,1899,8
STAT,1896,43,40-44,1939,0.23636497260080738
SIM,1910,24,na,1934,3289
STAT,1874,12,na,1886,3088.647277969577
SIM,1914,38,na,1952,3899
SIM,1851,38,35-39,1889,21
SIM,1870,21,20-24,1891,131
STAT,1873,30,na,1903,2834.8485702003477
SIM,1967,41,20-24,2008,2
SIM,1825,31,40-44,1856,9
STAT,1769,90,na,1859,41.66092880117391
STAT,1890,25,45-49,1915,1.5762828184252526
STAT,1923,22,na,1945,4901.762349281343
STAT,1841,25,na,1866,2423.561478960921
STAT,1923,37,15-19,1960,0.02566883023404147
STAT,1959,41,20-24,2000,0.027745616656362267
STAT,1927,31,15-19,1958,0.18249270166989115
SIM,1853,37,30-34,1890,11
STAT,1878,25,20-24,1903,14.231779890434607
STAT,1843,38,35-39,1881,7.461402033695243
SIM,1880,9,na,1889,3684
STAT,1849,42,40-44,1891,1.7411958814751167
SIM,1971,41,40-44,2012,2
STAT,1817,99,na,1916,1.3093441265638524
STAT,1855,40,15-19,1895,0.011869291483632702
STAT,1865,32,50-100,1897,0.9540462448391397
SIM,1903,20,15-19,1923,2
SIM,1978,31,25-29,2009,16
STAT,1851,21,45-49,1872,0.6651325531165988
SIM,1902,29,na,1931,3802
SIM,1815,44,50-100,1859,2
STAT,1948,14,na,1962,5185.873696054482
STAT,1821,37,45-49,1858,4.435701649509443
SIM,1857,68,na,1925,1594
STAT,1820,63,na,1883,1069.0500194849337
SIM,1852,37,na,1889,1949
SIM,1985,21,45-49,2006,4
STAT,1915,27,na,1942,4410.393668917539
STAT,1862,32,30-34,1894,17.004584661035206
STAT,1902,60,na,1962,3287.0171992231813
STAT,1880,51,35-39,1931,0.010581342837072861
SIM,1920,34,35-39,1954,4
STAT,1917,28,30-34,1945,47.25576212938107
STAT,1838,45,45-49,1883,0.21581142826980573
STAT,1873,22,35-39,1895,6.877054044305903
STAT,1962,21,na,1983,5419.466528103328
SIM,1925,39,40-44,1964,1
SIM,1860,32,na,1892,2470
SIM,1872,32,40-44,1904,11
SIM,1822,41,40-44,1863,4
STAT,1879,27,na,1906,2875.8055615918715
SIM,1823,40,na,1863,2282
SIM,2004,5,na,2009,7407
STAT,1888,49,20-24,1937,0.008990926133957643
STAT,1933,23,50-100,1956,1.0073641526735864
SIM,1887,40,30-34,1927,2
STAT,1899,39,25-29,1938,0.9726663157709771
STAT,1917,39,40-44,1956,1.7835417851944106
SIM,1832,27,45-49,1859,1
SIM,1877,38,30-34,1915,14
STAT,1872,54,35-39,1926,0.009701857951992736
SIM,1911,32,50-100,1943,3
STAT,1839,38,15-19,1877,0.05266818410746494
STAT,1961,42,15-19,2003,0.0023795419835384328
SIM,1927,23,35-39,1950,16
SIM,1936,29,45-49,1965,2
SIM,1890,70,na,1960,2001
STAT,1938,27,50-100,1965,1.1385618858017528
STAT,1869,38,30-34,1907,5.926836775575629
STAT,1878,16,30-34,1894,1.9252587322232353
STAT,1879,40,30-34,1919,1.3993508294674397
SIM,1822,42,25-29,1864,2
SIM,1987,23,na,2010,5622
SIM,1955,23,40-44,1978,7
STAT,1956,36,50-100,1992,0.6611442308100379
STAT,1947,23,40-44,1970,4.383919562238172
SIM,1992,19,15-19,2011,143
STAT,1828,34,20-24,1862,2.926674757208254
STAT,1840,99,na,1939,1.5192630145501973
STAT,1977,21,30-34,1998,44.97903489432716
SIM,1888,20,25-29,1908,76
STAT,1883,36,50-100,1919,1.3929069073669498
SIM,1865,101,na,1966,14
STAT,1832,64,na,1896,1184.326788382713
SIM,1868,46,35-39,1914,1
SIM,1880,43,25-29,1923,1
STAT,1972,16,50-100,1988,0.5537489519837018
STAT,1928,29,45-49,1957,2.4537955178603243
STAT,1854,24,20-24,1878,65.02194939474286
STAT,1882,28,45-49,1910,1.2471448772566478
STAT,1879,41,15-19,1920,0.0167164024628869
STAT,1875,46,30-34,1921,0.11577100133558703
SIM,1982,31,45-49,2013,5
STAT,1908,73,na,1981,2750.0837184791662
SIM,1959,31,30-34,1990,3
STAT,1943,18,30-34,1961,14.913120294296572
STAT,1965,49,50-100,2014,0.33696800404411903
SIM,1915,18,20-24,1933,36
SIM,1951,18,30-34,1969,39
SIM,1951,29,40-44,1980,3
STAT,1880,19,50-100,1899,0.05960749999158668
STAT,1868,110,na,1978,0.011696554689889971
SIM,1903,54,na,1957,3259
SIM,1898,30,35-39,1928,23
STAT,1875,35,20-24,1910,0.9280416573312777
STAT,1835,19,15-19,1854,8.30572029124926
STAT,1830,24,35-39,1854,10.046988623750618
SIM,1833,31,45-49,1864,4
STAT,1870,41,25-29,1911,0.7339033703959941
STAT,1891,18,15-19,1909,8.442380515580577
SIM,1894,36,35-39,1930,19
STAT,1844,73,na,1917,993.4631917059177
SIM,1847,9,na,1856,3159
STAT,1927,31,50-100,1958,1.1741510960893933
SIM,1864,7,na,1871,3179
STAT,1861,53,20-24,1914,6.965980487645413E-4
STAT,1872,43,25-29,1915,0.7387575369403188
SIM,1961,39,40-44,2000,4
STAT,1820,50,25-29,1870,0.0036197349386655783
STAT,1807,81,na,1888,296.39414488276014
STAT,1862,86,na,1948,216.09240660842903
STAT,1963,42,25-29,2005,0.1088053602042866
SIM,1862,24,20-24,1886,159
STAT,1782,72,na,1854,706.9999999999998
STAT,1853,45,40-44,1898,0.1721492840161882
SIM,1919,69,na,1988,4130
STAT,1803,52,20-24,1855,0.002677461472607999
STAT,1922,41,40-44,1963,0.3316515863409492
SIM,1928,46,na,1974,5658
STAT,1968,47,30-34,2015,0.1336551579993478
STAT,1940,34,na,1974,4512.873458603523
SIM,1954,52,na,2006,5284
STAT,1819,106,na,1925,0.008082873726556418
STAT,1861,40,45-49,1901,1.4503760200194311
STAT,1843,21,40-44,1864,2.643429664736098
STAT,1849,48,25-29,1897,0.0440829765576035
SIM,1851,21,40-44,1872,2
STAT,1969,27,35-39,1996,21.737517278598418
SIM,1841,53,na,1894,1736
STAT,1943,29,40-44,1972,5.723643326011397
STAT,1814,41,40-44,1855,7.818702878486961
STAT,1907,18,20-24,1925,30.023728781447883
SIM,1849,33,na,1882,2739
STAT,1964,21,45-49,1985,1.6414057386944807
STAT,1821,34,40-44,1855,12.244187273178387
STAT,1835,41,50-100,1876,0.8002062029667375
SIM,1890,28,20-24,1918,1
STAT,1880,17,25-29,1897,6.931775917115066
STAT,1934,24,15-19,1958,8.254214058095975
SIM,1826,29,na,1855,2031
SIM,1843,41,50-100,1884,1
STAT,1973,21,na,1994,5470.288229434033
SIM,1942,35,25-29,1977,2
SIM,1870,32,30-34,1902,25
STAT,1892,1,na,1893,3937.0011426032256
STAT,1919,37,50-100,1956,0.520414428571528
STAT,1891,43,na,1934,3272.749650828148
SIM,1967,43,na,2010,5619
SIM,1959,45,35-39,2004,1
STAT,1857,19,20-24,1876,18.50866547108987
SIM,1919,15,25-29,1934,22
SIM,1875,39,35-39,1914,24
STAT,1910,23,15-19,1933,5.757174392607688
STAT,1867,39,35-39,1906,7.5442891518320305
STAT,1980,32,na,2012,6176.254230767011
STAT,1819,82,na,1901,310.6097180816763
STAT,1907,91,na,1998,513.9395449219843
STAT,1995,17,25-29,2012,72.3929802600504
STAT,1915,15,45-49,1930,0.12123934684955376
SIM,1919,26,35-39,1945,1
STAT,1811,86,na,1897,114.24262188119218
SIM,1938,21,45-49,1959,3
SIM,1864,24,30-34,1888,25
SIM,1838,45,40-44,1883,2
SIM,1942,24,15-19,1966,11
STAT,1927,6,na,1933,5749.98560071036
STAT,1872,40,50-100,1912,1.2365715876917942
SIM,1902,30,50-100,1932,1
STAT,1882,47,na,1929,2524.231054490461
STAT,1919,20,30-34,1939,36.52836520312607
STAT,1873,86,na,1959,367.171574799935
SIM,1972,21,45-49,1993,1
SIM,1974,34,20-24,2008,4
STAT,1956,16,15-19,1972,69.32313345189172
STAT,1814,51,na,1865,1809.9765879777278
STAT,1911,77,na,1988,2432.6715228672906
SIM,1854,17,25-29,1871,11
STAT,1864,34,30-34,1898,17.837185099524586
SIM,1838,34,30-34,1872,6
STAT,1874,54,45-49,1928,0.016674157363899916
STAT,1916,52,na,1968,4275.86513393679
STAT,1966,34,20-24,2000,3.579188775452277
STAT,1890,38,20-24,1928,1.0815981190864392
STAT,1930,15,40-44,1945,2.0968552742287905
SIM,1864,35,40-44,1899,6
STAT,1874,34,50-100,1908,1.0732278803683584
STAT,1899,49,20-24,1948,0.010478810015542865
STAT,1890,42,na,1932,3255.113357155202
STAT,1882,28,20-24,1910,13.177319860456322
STAT,1934,35,25-29,1969,1.571531054657659
SIM,1927,37,50-100,1964,1
STAT,1898,22,na,1920,3688.7197825354037
STAT,1791,89,na,1880,41.48348925598785
STAT,1896,46,45-49,1942,0.20349465871317415
STAT,1846,17,25-29,1863,7.359035131743794
SIM,1820,91,na,1911,64
STAT,1938,31,45-49,1969,1.8279293847396096
SIM,1977,15,50-100,1992,1
STAT,1877,46,40-44,1923,0.20609966930767437
STAT,1865,28,15-19,1893,0.470757603899863
STAT,1959,44,25-29,2003,0.11165450351546441
SIM,1938,26,15-19,1964,1
SIM,1922,90,na,2012,410
STAT,1864,35,45-49,1899,2.073680301584456
STAT,1920,73,na,1993,3355.709826911023
SIM,1888,28,35-39,1916,29
SIM,1900,7,na,1907,3958
STAT,1856,24,30-34,1880,17.953503272220388
STAT,1919,57,na,1976,4395.6227295072395
STAT,1893,18,25-29,1911,8.24450449715023
STAT,1942,34,15-19,1976,0.15779736363821167
STAT,1908,34,15-19,1942,0.1389620678961358
SIM,1828,71,na,1899,1196
SIM,1990,17,15-19,2007,129
STAT,1938,20,35-39,1958,10.76720407667716
STAT,1871,17,50-100,1888,0.0566121435095679
STAT,1858,81,na,1939,486.8427125006189
SIM,1888,39,45-49,1927,4
STAT,1832,49,15-19,1881,2.9120984637724553E-4
SIM,1908,25,20-24,1933,17
STAT,1812,42,15-19,1854,0.039428334542384084
SIM,1963,32,35-39,1995,4
STAT,1930,56,na,1986,5375.972559906769
STAT,1908,45,25-29,1953,0.056248108377763735
SIM,1881,22,35-39,1903,6
STAT,1900,77,na,1977,2070.087787207447
STAT,1951,27,50-100,1978,1.3737595157181
STAT,1903,42,na,1945,3807.59028523213
SIM,1961,20,30-34,1981,98
STAT,1849,45,45-49,1894,0.18473969491164685
STAT,1901,47,35-39,1948,0.12706118357888346
STAT,1861,17,20-24,1878,19.549741792995423
STAT,1788,69,na,1857,1018.4592337464559
SIM,1944,2,na,1946,4804
STAT,1927,52,na,1979,5231.231922988165
SIM,1812,96,na,1908,6
SIM,1881,20,15-19,1901,4
STAT,1832,24,45-49,1856,0.723822654946887
STAT,1895,28,30-34,1923,37.69489297705075
STAT,1893,29,35-39,1922,13.974473634376704
STAT,1850,17,45-49,1867,0.0821735325589476
SIM,1849,35,45-49,1884,7
STAT,1810,48,25-29,1858,0.21934375504484685
STAT,1951,18,na,1969,5056.620151790976
STAT,1953,20,30-34,1973,40.284751117007204
SIM,1977,27,25-29,2004,16
STAT,1881,30,15-19,1911,0.15979231733448526
STAT,1840,34,45-49,1874,1.6688269546256507
SIM,1974,20,40-44,1994,7
STAT,1977,37,25-29,2014,1.5817319782410688
STAT,1888,45,50-100,1933,0.3364963297339125
STAT,1927,30,30-34,1957,22.386605477826834
SIM,1913,26,50-100,1939,5
SIM,1916,80,na,1996,2076
STAT,1864,48,20-24,1912,0.012209928979206997
SIM,1827,48,45-49,1875,1
STAT,1879,43,na,1922,2764.968697747789
STAT,1893,15,45-49,1908,0.09572986695712281
STAT,1905,26,50-100,1931,1.0721592607829113
SIM,1846,25,50-100,1871,4
STAT,1955,32,35-39,1987,14.270637674690805
SIM,1979,28,na,2007,5891
STAT,1814,44,45-49,1858,4.408656051666583
STAT,1932,39,na,1971,5822.592983843647
SIM,1822,44,45-49,1866,7
STAT,1828,37,25-29,1865,2.963277810295885
SIM,1965,5,na,1970,5623
SIM,1877,29,na,1906,3163
STAT,1908,41,50-100,1949,0.12631846506656522
STAT,1889,17,45-49,1906,0.0929257881215771
SIM,1818,41,20-24,1859,1
STAT,1966,20,40-44,1986,4.8659598549768095
SIM,1945,16,35-39,1961,12
STAT,1865,35,na,1900,2476.4736361754763
SIM,1828,27,25-29,1855,85
SIM,1839,29,20-24,1868,13
STAT,1854,27,25-29,1881,36.1282913949567
STAT,1890,98,na,1988,56.59424597947436
STAT,1838,44,30-34,1882,1.033194785908701
SIM,1862,27,25-29,1889,65
STAT,1963,44,45-49,2007,0.25274294291998955
STAT,1873,48,50-100,1921,0.28580031995582506
STAT,1944,42,30-34,1986,0.1650124077385815
SIM,1946,20,35-39,1966,33
SIM,1837,32,na,1869,2608
STAT,1858,54,50-100,1912,0.013222891049781164
STAT,1964,37,15-19,2001,0.028756685849492473
STAT,1911,18,40-44,1929,0.32244168959854697
STAT,1937,16,35-39,1953,4.7251285158236405
SIM,1924,16,na,1940,4918
STAT,1876,78,na,1954,932.1133949570515
SIM,1886,25,na,1911,2072
SIM,1853,38,45-49,1891,8
STAT,1877,60,na,1937,2289.46415684905
STAT,1970,33,50-100,2003,1.2167372868864719
STAT,1926,15,20-24,1941,192.67979537213202
STAT,1965,19,20-24,1984,195.20084687844073
SIM,1862,15,na,1877,3083
SIM,1866,29,na,1895,2465
STAT,1875,49,35-39,1924,0.1634772911627114
STAT,1971,36,na,2007,5670.5674936318055
STAT,1981,24,45-49,2005,1.8204691043417482
SIM,1936,41,na,1977,3936
STAT,1922,44,45-49,1966,0.2196258809886957
SIM,1836,37,25-29,1873,3
STAT,1978,26,50-100,2004,1.5751295894828792
STAT,1849,45,20-24,1894,0.009393544165554431
SIM,1903,70,na,1973,2523
STAT,1844,51,25-29,1895,0.0029767947129902632
STAT,1882,25,40-44,1907,3.399552829175839
SIM,1829,42,35-39,1871,5
SIM,1907,84,na,1991,1498
SIM,1864,38,20-24,1902,1
STAT,1972,36,40-44,2008,2.2809394250881034
STAT,1870,81,na,1951,615.2408573200343
STAT,1960,25,25-29,1985,99.44706215542374
STAT,1837,28,50-100,1865,0.5902726878988876
SIM,1927,20,30-34,1947,3
SIM,1833,58,na,1891,1355
STAT,1846,53,25-29,1899,0.0036028774836974788
SIM,1973,19,20-24,1992,195
SIM,1935,30,30-34,1965,33
STAT,1819,48,45-49,1867,0.4478664709466971
STAT,1929,42,35-39,1971,0.3009623674847349
STAT,1910,39,30-34,1949,1.9934346808226804
STAT,1875,38,25-29,1913,3.416686122330768
SIM,1882,75,na,1957,1691
STAT,1803,54,40-44,1857,0.03669295400485365
SIM,1889,107,na,1996,34
SIM,1851,37,20-24,1888,1
STAT,1903,44,40-44,1947,0.2532830519140569
STAT,1835,27,20-24,1862,9.565667449604074
STAT,1821,64,na,1885,1081.4820424294426
SIM,1883,38,25-29,1921,5
STAT,1938,77,na,2015,2635.610286968219
STAT,1979,34,30-34,2013,25.485497894518495
SIM,1843,27,20-24,1870,2
SIM,1911,44,40-44,1955,1
STAT,1921,21,25-29,1942,120.72040187307024
STAT,1828,43,na,1871,1734.6092594272181
SIM,1959,34,35-39,1993,3
STAT,1836,78,na,1914,711.0657311000482
STAT,1906,3,na,1909,4448.907757936191
SIM,1934,15,20-24,1949,203
STAT,1843,37,20-24,1880,0.9029403373630981
SIM,1865,19,20-24,1884,2
SIM,1849,17,na,1866,2992
SIM,1826,38,50-100,1864,5
SIM,1899,26,45-49,1925,1
SIM,1945,56,na,2001,4415
STAT,1825,41,40-44,1866,3.4164740359411074
STAT,1876,15,15-19,1891,7.112687334539028
SIM,1826,45,na,1871,1837
STAT,1915,28,20-24,1943,21.41494862426842
SIM,1820,41,30-34,1861,3
STAT,1891,27,na,1918,3403.94148230894
SIM,1875,36,30-34,1911,8
SIM,1934,18,25-29,1952,2
STAT,1855,42,35-39,1897,1.5389163802533792
STAT,1948,55,na,2003,4888.296858347072
STAT,1936,40,50-100,1976,0.13471305012295248
STAT,1959,41,45-49,2000,0.2614722744721655
SIM,1950,24,na,1974,4444
SIM,1954,38,na,1992,5442
SIM,1923,28,20-24,1951,49
SIM,1875,25,20-24,1900,16
SIM,1865,42,45-49,1907,4
STAT,1874,101,na,1975,8.181449058278819
STAT,1940,75,na,2015,2969.9019526488514
STAT,1874,51,40-44,1925,0.012497372856827876
STAT,1810,45,20-24,1855,0.048781718857539735
SIM,1780,74,na,1854,341
SIM,1880,42,40-44,1922,6
SIM,1893,75,na,1968,1607
STAT,1828,99,na,1927,1.2569584413911348
STAT,1820,101,na,1921,0.334898808570589
SIM,1897,89,na,1986,412
STAT,1885,41,45-49,1926,1.7305916145149869
STAT,1919,22,20-24,1941,140.48341796763614
SIM,1817,71,na,1888,292
STAT,1842,47,na,1889,1731.5985401593407
SIM,1982,30,30-34,2012,64
STAT,1975,24,25-29,1999,140.99837954480623
SIM,1834,40,na,1874,1875
SIM,1888,36,40-44,1924,2
STAT,1951,34,na,1985,5291.043580418091
SIM,1884,15,15-19,1899,9
SIM,1893,41,45-49,1934,8
SIM,1986,8,na,1994,6755
SIM,1937,42,na,1979,4342
STAT,1890,24,30-34,1914,24.960220589886152
SIM,1908,28,25-29,1936,67
STAT,1886,34,15-19,1920,0.17187025736583295
STAT,1974,30,30-34,2004,24.228015797845124
SIM,1841,37,na,1878,1921
SIM,1849,39,30-34,1888,7
STAT,1877,17,na,1894,3031.851057912891
SIM,1957,34,25-29,1991,2
SIM,1977,24,20-24,2001,158
STAT,1917,23,25-29,1940,112.9473856690759
SIM,1867,51,45-49,1918,1
SIM,1876,42,20-24,1918,2
STAT,1953,44,na,1997,5370.345402216672
STAT,1853,46,25-29,1899,0.05751047396870837
SIM,1820,49,40-44,1869,1
STAT,1970,7,na,1977,5678.299966597677
SIM,1927,22,20-24,1949,144
STAT,1810,110,na,1920,1.573433975430254E-4
SIM,1854,63,na,1917,1860
STAT,1920,57,na,1977,4478.947605981092
STAT,1920,44,35-39,1964,0.2556925833966095
SIM,1918,2,na,1920,4363
STAT,1823,31,35-39,1854,31.061468217248354
SIM,1947,41,na,1988,5952
SIM,1950,45,na,1995,4674
STAT,1812,49,40-44,1861,0.38396342768561864
STAT,1947,38,15-19,1985,0.025692626907859548
STAT,1941,18,20-24,1959,161.14552668022995
STAT,1867,29,30-34,1896,26.93927947300227
STAT,1821,46,35-39,1867,0.256896310999999
STAT,1875,35,45-49,1910,2.400001785995228
STAT,1953,23,35-39,1976,13.18422570922276
STAT,1817,46,15-19,1863,0.0011584138406055043
STAT,1808,82,na,1890,237.90531045890438
STAT,1828,26,50-100,1854,1.6277223761532729
STAT,1949,23,15-19,1972,7.165864902929593
SIM,1798,96,na,1894,1
SIM,1925,23,25-29,1948,155
STAT,1938,52,na,1990,4279.066941450438
SIM,1875,25,na,1900,3235
SIM,1901,37,35-39,1938,1
SIM,1828,55,na,1883,1765
SIM,1833,41,40-44,1874,7
SIM,1824,41,na,1865,1652
SIM,1979,28,40-44,2007,17
STAT,1821,35,25-29,1856,7.11237814252353
STAT,1945,49,na,1994,4789.117744115017
STAT,1949,34,25-29,1983,12.62859583450469
STAT,1848,101,na,1949,0.6063033766153432
SIM,1961,23,35-39,1984,32
STAT,1870,43,15-19,1913,0.015598278793581173
STAT,1859,51,45-49,1910,0.013405163808475378
STAT,1868,42,20-24,1910,0.17586995656862814
STAT,1930,18,45-49,1948,0.7434604190536424
SIM,1831,31,35-39,1862,27
STAT,1936,67,na,2003,3533.00929797905
SIM,1962,33,na,1995,5426
STAT,1867,61,na,1928,2013.433205315852
STAT,1829,44,na,1873,1861.679574888654
SIM,1903,22,35-39,1925,23
SIM,1897,68,na,1965,2465
STAT,1839,43,na,1882,1907.2337801421847
STAT,1844,43,50-100,1887,0.8934744678491094
STAT,1966,23,45-49,1989,1.6266746214654513
STAT,1951,59,na,2010,4938.104425963048
STAT,1903,32,50-100,1935,1.5061035530645317
SIM,1974,23,45-49,1997,4
SIM,1944,35,35-39,1979,1
STAT,1883,45,20-24,1928,0.013684186736366094
STAT,1846,50,20-24,1896,7.738102956219325E-4
STAT,1894,35,25-29,1929,4.311967908792117
STAT,1931,38,na,1969,5745.541496144504
STAT,1873,102,na,1975,4.7055348308244245
STAT,1936,35,35-39,1971,2.7467072574229516
SIM,1872,34,30-34,1906,32
STAT,1901,45,15-19,1946,3.683682685571843E-4
STAT,1963,22,na,1985,5371.817201006292
SIM,1853,21,15-19,1874,5
STAT,1893,26,30-34,1919,36.85936302055826
STAT,1916,44,15-19,1960,0.0018103018074602654
STAT,1831,63,na,1894,1399.9063679250035
STAT,1951,38,35-39,1989,3.4210149637524205
STAT,1877,47,25-29,1924,0.06882326653080638
STAT,1822,50,35-39,1872,0.016296293322380473
SIM,1874,24,na,1898,2723
STAT,1925,45,30-34,1970,0.12521024504851952
STAT,1955,33,40-44,1988,6.107330535608513
STAT,1941,19,na,1960,4373.433431422477
STAT,1893,15,20-24,1908,25.981091115996563
STAT,1828,35,35-39,1863,7.604991450240358
SIM,1916,64,na,1980,4073
SIM,1912,50,na,1962,3565
STAT,1822,52,25-29,1874,0.006443171738219965
SIM,1870,10,na,1880,3401
SIM,1896,36,45-49,1932,2
STAT,1888,36,45-49,1924,2.7173294345938253
STAT,1972,31,35-39,2003,13.771836579306948
STAT,1972,39,45-49,2011,1.0355706482400187
STAT,1856,35,40-44,1891,3.8907727053949017
STAT,1948,20,50-100,1968,0.8724696446818777
SIM,1935,33,35-39,1968,3
SIM,1823,96,na,1919,36
SIM,1885,24,na,1909,3333
SIM,1801,53,na,1854,1537
SIM,1828,29,45-49,1857,3
STAT,1927,33,35-39,1960,12.962072280817429
STAT,1819,45,40-44,1864,0.3393498048517031
STAT,1872,42,40-44,1914,2.6032568203019486
SIM,1851,29,15-19,1880,1
SIM,1851,15,na,1866,3027
SIM,1876,50,na,1926,2425
STAT,1922,21,na,1943,4845.3701852758195
SIM,1985,24,25-29,2009,2
SIM,1910,8,na,1918,4030
STAT,1785,77,na,1862,223.29142740777542
SIM,1831,75,na,1906,682
STAT,1863,25,na,1888,2443.22358841986
SIM,1794,66,na,1860,829
STAT,1965,43,40-44,2008,0.37391674204181696
SIM,1872,14,na,1886,3282
SIM,1920,41,50-100,1961,1
STAT,1878,26,35-39,1904,11.666429157645219
SIM,1935,31,50-100,1966,3
SIM,1838,35,45-49,1873,4
STAT,1926,18,25-29,1944,61.14252216595549
SIM,1980,31,35-39,2011,29
STAT,1842,26,na,1868,2073.5275322789716
STAT,1846,19,45-49,1865,0.08383400035110401
STAT,1885,12,na,1897,2972.750169123641
SIM,1980,20,25-29,2000,297
SIM,1886,26,35-39,1912,16
STAT,1957,44,15-19,2001,0.002420244479118818
SIM,1933,45,30-34,1978,1
STAT,1817,45,30-34,1862,0.2843851636438909
SIM,1954,49,45-49,2003,1
STAT,1843,29,15-19,1872,0.5522334905981768
STAT,1894,46,35-39,1940,0.11749018444655031
SIM,1918,45,35-39,1963,1
STAT,1841,27,15-19,1868,0.5010204650285954
STAT,1869,65,na,1934,1888.7161511241334
SIM,1853,35,40-44,1888,10
SIM,1910,24,25-29,1934,199
SIM,1954,3,na,1957,5551
STAT,1883,32,45-49,1915,1.9689361851246239
STAT,1977,24,25-29,2001,144.4089237892197
STAT,1903,109,na,2012,0.1321507250512232
STAT,1925,83,na,2008,2067.228077895686
STAT,1961,49,40-44,2010,0.243080541360964
STAT,1965,26,na,1991,5423.07170151369
STAT,1867,25,45-49,1892,1.2044551209765761
STAT,1921,37,40-44,1958,1.9282855365804745
STAT,1862,34,20-24,1896,2.6100572790126
SIM,1848,32,na,1880,1831
STAT,1977,35,35-39,2012,3.8923508384616348
STAT,1902,24,25-29,1926,92.76193390432707
STAT,1892,47,20-24,1939,0.009745267724758842
SIM,1891,32,45-49,1923,1
STAT,1867,36,30-34,1903,5.770197635418056
STAT,1865,51,na,1916,2252.7260445143247
STAT,1851,31,40-44,1882,3.6167370239770817
STAT,1966,46,15-19,2012,5.536711727135434E-4
SIM,1969,17,35-39,1986,7
STAT,1825,48,50-100,1873,0.3382399588128
SIM,1968,21,25-29,1989,120
SIM,1914,20,45-49,1934,3
SIM,1957,39,30-34,1996,2
SIM,1825,34,20-24,1859,6
SIM,1889,40,40-44,1929,6
SIM,1820,44,35-39,1864,3
STAT,1958,36,25-29,1994,1.5389465123611765
SIM,1962,16,40-44,1978,5
STAT,1850,53,45-49,1903,0.014699873499000383
STAT,1906,90,na,1996,609.1748656895863
SIM,1971,1,na,1972,5828
SIM,1825,45,30-34,1870,1
SIM,1899,29,50-100,1928,1
STAT,1897,47,50-100,1944,0.2127873177081798
STAT,1806,56,na,1862,1079.2371577060806
STAT,1921,39,na,1960,4835.813269504269
STAT,1904,24,35-39,1928,9.610129509350054
STAT,1964,41,50-100,2005,0.17771479318932054
SIM,1907,0,na,1907,5130
STAT,1939,16,45-49,1955,0.5774557118061402
SIM,1968,44,na,2012,5311
STAT,1942,25,50-100,1967,1.2068577428357117
STAT,1974,33,35-39,2007,14.028267586325502
SIM,1837,23,50-100,1860,1
STAT,1840,33,30-34,1873,16.883244497773543
STAT,1979,35,45-49,2014,1.1179361683832645
STAT,1934,49,na,1983,5875.229224145633
SIM,1905,80,na,1985,1089
STAT,1843,51,na,1894,2170.7843981625847
STAT,1906,20,45-49,1926,1.180504033964964
STAT,1836,44,20-24,1880,0.16764832437806534
STAT,1880,80,na,1960,966.0276382119866
SIM,1872,76,na,1948,1481
STAT,1929,25,50-100,1954,1.4431250966404745
SIM,1937,25,50-100,1962,1
SIM,1862,36,na,1898,2848
STAT,1949,39,30-34,1988,2.51482649218285
SIM,1958,18,40-44,1976,6
STAT,1897,39,15-19,1936,0.018515262887177423
STAT,1930,35,na,1965,5673.791473122347
STAT,1903,47,45-49,1950,0.21780545123308853
STAT,1917,53,na,1970,4334.341154846752
STAT,1937,7,na,1944,4490.217024166911
SIM,1950,25,50-100,1975,5
STAT,1864,46,50-100,1910,0.2537949819806532
STAT,1899,23,na,1922,3727.7539630385113
STAT,1849,52,50-100,1901,0.011643345928162952
STAT,1875,47,15-19,1922,4.748137910076913E-4
SIM,1958,16,20-24,1974,2
STAT,1825,44,45-49,1869,2.1315391882119474
SIM,1938,20,30-34,1958,67
STAT,1928,26,40-44,1954,6.649565785219642
STAT,1878,61,na,1939,2251.622821001485
STAT,1799,69,na,1868,944.7559407744259
STAT,1821,48,na,1869,1568.404868018686
SIM,1814,43,35-39,1857,6
STAT,1929,19,na,1948,5392.211359059378
SIM,1957,31,20-24,1988,8
SIM,1874,40,na,1914,2577
SIM,1899,23,40-44,1922,7
SIM,1833,44,45-49,1877,5
STAT,1949,31,20-24,1980,3.338970153027525
SIM,1836,35,35-39,1871,2
SIM,1841,18,20-24,1859,20
SIM,1933,48,35-39,1981,1
STAT,1962,25,35-39,1987,22.315587514301704
SIM,1887,50,na,1937,3500
STAT,1905,41,35-39,1946,0.2109877621912777
STAT,1821,43,30-34,1864,2.1694601176353365
STAT,1868,45,25-29,1913,0.0645017214532832
SIM,1886,28,25-29,1914,90
SIM,1970,25,35-39,1995,56
STAT,1845,106,na,1951,0.008181737304511365
STAT,1994,21,15-19,2015,8.897163586267178
SIM,1940,46,na,1986,4884
SIM,1840,33,35-39,1873,11
STAT,1845,21,15-19,1866,2.779748518349568
SIM,1861,14,na,1875,2183
SIM,1958,41,na,1999,6143
STAT,1897,2,na,1899,4113.470003717689
SIM,1885,23,50-100,1908,1
STAT,1961,20,50-100,1981,0.9849932563797785
SIM,1851,24,20-24,1875,178
SIM,1914,54,na,1968,3810
STAT,1888,60,na,1948,2587.231498363613
STAT,1877,23,50-100,1900,0.4880172788063762
STAT,1975,21,20-24,1996,169.90595475611656
SIM,1901,34,30-34,1935,24
SIM,1959,33,20-24,1992,7
SIM,1869,23,25-29,1892,58
SIM,1925,28,30-34,1953,60
SIM,1927,4,na,1931,5364
STAT,1920,41,30-34,1961,0.16311357841801605
STAT,1917,20,20-24,1937,137.2017169465715
STAT,1778,109,na,1887,0.004299743687209408
SIM,1896,24,na,1920,3358
STAT,1821,100,na,1921,0.6492932793438357
STAT,1843,24,20-24,1867,85.54987958915618
SIM,1905,32,40-44,1937,12
STAT,1940,37,20-24,1977,0.31832889669066267
SIM,1851,35,30-34,1886,10
STAT,1834,74,na,1908,1012.7937093888145
STAT,1875,32,40-44,1907,5.1719482250220175
SIM,1883,32,40-44,1915,11
STAT,1951,35,30-34,1986,2.5848744702340705
SIM,1774,89,na,1863,154
STAT,1984,18,30-34,2002,19.971826060506633
STAT,1814,43,30-34,1857,3.6255472521176135
STAT,1867,38,20-24,1905,0.8264610754774084
SIM,1840,52,na,1892,1707
STAT,1832,48,na,1880,1618.8205016248055
SIM,1875,38,20-24,1913,3
STAT,1940,48,30-34,1988,0.10838316630874956
SIM,1956,56,na,2012,5086
SIM,1967,27,50-100,1994,5
STAT,1958,25,15-19,1983,1.0755990068262937
SIM,1935,16,na,1951,5981
STAT,1812,44,35-39,1856,4.467659609552579
SIM,1925,20,20-24,1945,3
SIM,1926,42,na,1968,5833
STAT,1843,35,30-34,1878,6.373849411929664
STAT,1897,24,40-44,1921,3.1954657028936313
STAT,2000,2,na,2002,6753.838929268171
STAT,1972,37,na,2009,5727.196504236239
STAT,1828,33,15-19,1861,0.15900848497133074
STAT,1872,51,30-34,1923,0.006930830970665902
STAT,1898,78,na,1976,1883.7575816819622
SIM,1862,25,35-39,1887,15
SIM,1838,33,na,1871,1810
SIM,1828,26,40-44,1854,6
STAT,1877,79,na,1956,885.0935727616778
STAT,1957,49,20-24,2006,0.017387653338005907
STAT,1980,32,50-100,2012,1.350189129503111
SIM,1899,16,na,1915,4417
STAT,1880,43,na,1923,2806.780695870381
STAT,1997,18,40-44,2015,2.3563354194224684
SIM,1900,19,20-24,1919,1
SIM,1815,45,na,1860,1945
SIM,1859,32,na,1891,2278
STAT,1879,43,35-39,1922,2.166302044484505
STAT,1877,44,20-24,1921,0.18807293079873225
STAT,1959,55,na,2014,5587.504188785741
SIM,1827,70,na,1897,643
STAT,1868,53,30-34,1921,0.0064940241806109595
STAT,1931,31,35-39,1962,13.829917868154693
SIM,1983,11,na,1994,7024
STAT,1893,28,20-24,1921,17.05264813294164
SIM,1891,41,35-39,1932,1
STAT,1809,48,na,1857,1452.5522768798437
STAT,1854,25,35-39,1879,9.187326071582744
SIM,1885,44,20-24,1929,1
STAT,1908,22,45-49,1930,1.1952727745411191
STAT,1857,51,35-39,1908,0.007774937300965501
STAT,1948,19,15-19,1967,59.89629873611752
SIM,1957,23,15-19,1980,10
STAT,1843,29,na,1872,2633.069673398243
STAT,1899,36,20-24,1935,1.224632373906965
STAT,1832,33,35-39,1865,9.093702031759634
STAT,1883,41,35-39,1924,2.053827091704839
STAT,1925,48,35-39,1973,0.1797398119928743
SIM,1916,22,45-49,1938,1
STAT,1974,9,na,1983,5921.683803968043
SIM,1887,43,35-39,1930,7
STAT,1899,47,30-34,1946,0.0859291199587413
STAT,1810,45,50-100,1855,0.9983991397550789
STAT,1878,28,25-29,1906,50.791913157726206
STAT,1882,17,35-39,1899,0.61851317709165
SIM,1956,19,15-19,1975,67
STAT,1869,23,20-24,1892,76.77919281672173
SIM,1981,26,na,2007,5969
SIM,1838,32,40-44,1870,9
SIM,1860,88,na,1948,469
STAT,1852,25,na,1877,2410.0440341284934
STAT,1846,52,40-44,1898,0.010825358219543798
SIM,1888,25,30-34,1913,91
SIM,1864,62,na,1926,1919
STAT,1970,35,25-29,2005,1.4679559416460959
SIM,1886,23,30-34,1909,47
STAT,1932,37,50-100,1969,0.6511772257381766
STAT,1908,57,na,1965,3670.603694142486
SIM,1760,94,na,1854,9
STAT,1923,22,40-44,1945,4.513250431072009
SIM,1925,79,na,2004,2578
SIM,1843,63,na,1906,1453
STAT,1835,50,45-49,1885,0.009602433042280676
STAT,1875,13,na,1888,3092.0974449030746
SIM,1963,36,45-49,1999,2
STAT,1831,26,na,1857,2266.452026222961
STAT,1955,36,45-49,1991,1.0769713369027332
STAT,1881,47,45-49,1928,0.26147375429127445
SIM,1879,34,40-44,1913,1
STAT,1818,81,na,1899,239.26730183485796
STAT,1896,45,30-34,1941,0.08406076980588759
STAT,1851,34,45-49,1885,1.4097084952120855
STAT,1856,38,45-49,1894,1.7464583191336254
STAT,1847,21,50-100,1868,0.3874407355276931
STAT,1878,19,35-39,1897,0.6576244127020586
STAT,1966,37,25-29,2003,1.462165807583824
SIM,1920,80,na,2000,1934
STAT,1862,15,50-100,1877,0.055297250983694944
SIM,1806,71,na,1877,753
STAT,1894,32,20-24,1926,4.010093616133202
STAT,1970,25,30-34,1995,56.898510879559765
SIM,1879,23,30-34,1902,52
STAT,1905,105,na,2010,2.547760533916096
STAT,1880,15,35-39,1895,0.6743221612333061
STAT,1980,18,na,1998,5894.999001953057
SIM,1796,92,na,1888,21
STAT,1932,3,na,1935,6199.710464178214
STAT,1888,45,35-39,1933,0.19181386932325825
SIM,1953,16,50-100,1969,1
STAT,1872,40,20-24,1912,0.18588985005931483
STAT,1914,47,20-24,1961,0.012654459351784124
STAT,1977,33,15-19,2010,0.2041220208448554
STAT,1878,23,30-34,1901,21.39668888561594
STAT,1954,16,40-44,1970,1.9960587401944347
STAT,1871,27,30-34,1898,28.912003007503834
STAT,1857,42,45-49,1899,1.343540015643818
SIM,1832,24,40-44,1856,3
SIM,1960,23,na,1983,5548
STAT,1872,45,45-49,1917,0.27620377229000376
STAT,1898,44,50-100,1942,0.11287708263453695
STAT,1894,43,30-34,1937,0.11758325239345171
STAT,1846,16,40-44,1862,0.2389323747517826
STAT,1924,82,na,2006,2214.3416335454212
SIM,1953,4,na,1957,5701
STAT,1831,41,35-39,1872,1.7578682264566248
STAT,1939,28,15-19,1967,0.818966600365119
STAT,1986,15,25-29,2001,71.29786445618763
SIM,1836,28,35-39,1864,1
STAT,1950,33,na,1983,5257.243674701605
SIM,1908,32,20-24,1940,1
SIM,1968,23,15-19,1991,8
STAT,1850,29,15-19,1879,0.5417744732181962
SIM,1827,33,na,1860,1688
STAT,1805,71,na,1876,761.513010808538
STAT,1852,15,20-24,1867,20.456055877176475
STAT,1876,52,20-24,1928,8.756358162423337E-4
STAT,1926,7,na,1933,5654.725451241286
SIM,1887,43,50-100,1930,4
STAT,1861,15,30-34,1876,1.7784928548782182
SIM,1884,79,na,1963,832
SIM,1909,30,na,1939,4750
STAT,1897,27,45-49,1924,1.71334629805656
SIM,1808,88,na,1896,24
STAT,1966,38,30-34,2004,2.7038286265503855
SIM,1974,38,30-34,2012,3
SIM,1814,40,30-34,1854,2
STAT,1863,49,50-100,1912,0.24266279826978748
STAT,1995,15,35-39,2010,7.013526754533936
STAT,1827,98,na,1925,2.638206538623598
STAT,1966,46,50-100,2012,0.33995438562164126
STAT,1980,30,25-29,2010,15.11068022629822
STAT,1968,46,25-29,2014,0.07972806678916033
SIM,1934,31,na,1965,5754
STAT,1834,46,20-24,1880,0.012927029687301701
STAT,1942,41,15-19,1983,0.0019278393122298652
STAT,1828,28,35-39,1856,14.012548358840661
STAT,1877,23,na,1900,2830.337741429476
STAT,1971,28,40-44,1999,6.839047064575392
SIM,1838,70,na,1908,795
STAT,1874,15,40-44,1889,0.2179044918813199
STAT,1836,47,25-29,1883,0.054878424321332255
SIM,1880,55,na,1935,2866
STAT,1834,44,50-100,1878,1.132866453930582
STAT,1861,48,na,1909,2131.3916937336626
SIM,1899,37,30-34,1936,5
STAT,1837,28,45-49,1865,1.0245261941085686
SIM,1845,28,45-49,1873,5
STAT,1854,23,15-19,1877,3.1352846784843655
STAT,1896,48,35-39,1944,0.11886288135846351
STAT,1900,27,30-34,1927,40.32517776274741
STAT,1951,36,15-19,1987,0.027212937678742388
SIM,1816,83,na,1899,92
STAT,1918,45,30-34,1963,0.10997040803547267
SIM,1954,30,35-39,1984,35
SIM,1994,15,25-29,2009,154
SIM,1892,74,na,1966,2383
SIM,1973,18,15-19,1991,68
SIM,1842,38,na,1880,2318
STAT,1835,93,na,1928,18.214841177245436
STAT,1820,40,20-24,1860,0.20810883568044342
STAT,1932,38,30-34,1970,2.8238769336778007
STAT,1910,30,15-19,1940,0.14429175822077595
STAT,1823,47,15-19,1870,3.95222314889037E-4
STAT,1947,22,35-39,1969,12.280742695417148
SIM,1853,40,50-100,1893,1
SIM,1933,22,15-19,1955,1
SIM,1855,47,45-49,1902,2
SIM,1922,12,na,1934,5473
STAT,1916,46,50-100,1962,0.2684177766624695
STAT,1886,26,30-34,1912,30.75940444573361
STAT,1792,71,na,1863,900.4199175498289
STAT,1866,41,40-44,1907,2.416851018986402
STAT,1919,24,40-44,1943,4.221411307712202
SIM,1874,41,40-44,1915,1
SIM,1914,17,na,1931,4166
STAT,1959,30,45-49,1989,2.4240724504931177
STAT,1969,23,25-29,1992,133.55830384126202
STAT,1841,15,45-49,1856,0.07579508320279514
SIM,1894,26,30-34,1920,53
SIM,1955,22,35-39,1977,42
STAT,1865,52,45-49,1917,0.015030694877606937
STAT,1859,20,na,1879,2273.5945168388184
SIM,1934,22,20-24,1956,167
STAT,1871,34,30-34,1905,19.874336342935788
STAT,1852,87,na,1939,166.10560942125812
STAT,1847,22,30-34,1869,16.80189941230306
STAT,1907,103,na,2010,8.442275378318616
STAT,1943,15,15-19,1958,55.57415001826737
STAT,1944,35,30-34,1979,2.3361154336268264
STAT,1858,28,50-100,1886,0.5853195027373327
SIM,1869,28,30-34,1897,54
STAT,1845,47,35-39,1892,0.09389987071210754
STAT,1885,74,na,1959,1422.3006668771793
STAT,1925,22,15-19,1947,7.35100148854848
STAT,1930,19,na,1949,5462.961296804336
SIM,1840,30,30-34,1870,42
STAT,1885,19,35-39,1904,0.6282369051559924
STAT,1892,35,15-19,1927,0.08199527947485422
SIM,1859,39,50-100,1898,2
STAT,1826,33,na,1859,1612.999759498248
SIM,1927,24,40-44,1951,5
STAT,1860,36,20-24,1896,0.7204240512544973
SIM,1967,30,45-49,1997,4
STAT,1929,46,45-49,1975,0.3259291811422243
SIM,1940,38,30-34,1978,3
SIM,1959,36,25-29,1995,2
STAT,1784,76,na,1860,381.66001498901005
SIM,1817,49,na,1866,1417
SIM,1872,37,35-39,1909,22
STAT,1860,82,na,1942,433.97235570255424
STAT,1918,72,na,1990,3340.4327995893595
SIM,1905,74,na,1979,2570
STAT,1921,76,na,1997,3033.7371560079036
STAT,1835,25,30-34,1860,20.871884364746617
SIM,1919,27,50-100,1946,1
SIM,1936,19,40-44,1955,1
SIM,1856,25,40-44,1881,6
SIM,1884,19,25-29,1903,9
SIM,1951,15,15-19,1966,102
STAT,1925,46,15-19,1971,5.162538228717998E-4
STAT,1832,30,30-34,1862,16.21683747640833
STAT,1892,34,45-49,1926,2.5007291646256036
STAT,1901,102,na,2003,13.052088009103443
SIM,1877,36,40-44,1913,13
STAT,1896,12,na,1908,3936.4827633450527
STAT,1912,35,40-44,1947,1.703801346965007
STAT,1858,47,20-24,1905,0.010753066234904993
STAT,1926,22,20-24,1948,155.86614549797437
SIM,1920,35,40-44,1955,2
STAT,1898,16,40-44,1914,0.2859709305064204
SIM,1867,29,35-39,1896,14
STAT,1885,58,na,1943,2276.4307746772433
STAT,1920,40,25-29,1960,0.0912298212775645
STAT,1816,55,na,1871,1283.6004734285411
SIM,1822,46,35-39,1868,1
STAT,1863,18,45-49,1881,0.06804538677575768
SIM,1821,36,35-39,1857,3
STAT,1869,36,40-44,1905,4.915880590701749
SIM,1868,48,25-29,1916,1
STAT,1842,63,na,1905,1373.067145938269
SIM,1893,16,30-34,1909,3
SIM,1898,31,40-44,1929,13
STAT,1844,44,25-29,1888,0.5361787616855612
STAT,1972,20,35-39,1992,13.96863438492004
STAT,1814,46,35-39,1860,0.39566597646560575
STAT,1868,80,na,1948,685.879539986184
STAT,1897,21,15-19,1918,5.106205228514491
STAT,1848,25,40-44,1873,3.8549025071965546
STAT,1907,17,15-19,1924,10.076717001939716
SIM,1905,58,na,1963,3611
STAT,1848,28,20-24,1876,14.774000329245883
SIM,1889,70,na,1959,2477
STAT,1992,0,na,1992,6561.2681551507
STAT,1824,39,15-19,1863,0.082318629026129
STAT,1858,36,20-24,1894,0.6973246452497177
STAT,1938,36,15-19,1974,0.02255388464080523
SIM,1868,20,15-19,1888,4
SIM,1997,3,na,2000,6611
STAT,1855,36,na,1891,2014.3391558371331
SIM,1862,23,15-19,1885,6
STAT,1981,22,25-29,2003,149.55046997619553
STAT,1843,46,50-100,1889,0.24844418827063813
SIM,1879,37,45-49,1916,6
SIM,1963,34,na,1997,6509
STAT,1823,43,40-44,1866,2.3164433822483637
STAT,1901,22,na,1923,3823.060247260617
SIM,1904,96,na,2000,226
SIM,1928,3,na,1931,6122
STAT,1844,107,na,1951,0.003944530407474896
STAT,1880,37,na,1917,2881.928427121509
STAT,1888,42,30-34,1930,1.5576905847646176
STAT,1805,51,35-39,1856,0.031404762378342846
STAT,1866,45,15-19,1911,4.321300118549548E-4
SIM,1924,53,na,1977,4718
STAT,1869,48,35-39,1917,0.15449917349692965
SIM,1961,49,45-49,2010,1
STAT,1963,43,30-34,2006,0.19448891369784937
SIM,1926,45,30-34,1971,1
STAT,1870,31,20-24,1901,3.087903078722704
STAT,1858,23,45-49,1881,0.6507659470480437
STAT,1815,95,na,1910,7.377450093677879
STAT,1818,54,25-29,1872,0.004043096148635777
STAT,1923,38,20-24,1961,0.3520071022611601
STAT,1938,22,25-29,1960,105.55257664458354
SIM,1856,28,20-24,1884,21
STAT,1989,15,na,2004,6087.478805932619
STAT,1848,66,na,1914,1741.4936907055824
STAT,1841,51,45-49,1892,0.0129645796260323
STAT,1937,51,na,1988,4228.052258018708
STAT,1970,20,25-29,1990,133.97309413847725
STAT,1928,19,40-44,1947,2.0229694944202508
SIM,1977,25,35-39,2002,27
STAT,1890,27,35-39,1917,13.60614890847384
STAT,1895,26,40-44,1921,4.515354564362142
STAT,1798,90,na,1888,28.268262092410723
STAT,1917,37,na,1954,4509.75710899964
STAT,1932,26,50-100,1958,1.5055771452459616
SIM,1904,39,na,1943,4065
STAT,1838,51,30-34,1889,0.005232283267200705
SIM,1835,68,na,1903,1302
STAT,1959,46,15-19,2005,5.798489493810876E-4
SIM,1831,43,40-44,1874,10
STAT,1854,18,35-39,1872,0.5316068300555017
SIM,1873,43,50-100,1916,1
STAT,1931,60,na,1991,5280.163091350259
STAT,1955,39,50-100,1994,0.6612676160887706
STAT,1884,37,20-24,1921,0.8789380785457497
STAT,1853,7,na,1860,2964.3724212797806
STAT,1980,21,50-100,2001,1.057997069039107
STAT,1840,36,35-39,1876,6.780892051959122
STAT,1913,27,40-44,1940,5.362573431277986
SIM,1862,18,35-39,1880,2
SIM,1868,36,30-34,1904,1
SIM,1863,42,35-39,1905,1
SIM,1892,37,20-24,1929,1
SIM,1921,27,40-44,1948,18
STAT,1891,42,45-49,1933,2.1320569472099917
STAT,1867,55,na,1922,2227.937440282165
SIM,1953,15,25-29,1968,134
STAT,1984,26,15-19,2010,1.1626258455345417
STAT,1861,18,35-39,1879,0.6015128425166631
SIM,1904,92,na,1996,676
STAT,1810,104,na,1914,0.03797815634394927
SIM,1886,19,35-39,1905,1
STAT,1908,48,40-44,1956,0.16430185065878178
SIM,1872,20,na,1892,3210
SIM,1970,22,na,1992,5612
STAT,1906,25,15-19,1931,0.7687028358370446
STAT,1849,42,na,1891,1789.1630192125795
STAT,1971,30,50-100,2001,1.233241352938845
STAT,1977,29,50-100,2006,1.5572098634051885
STAT,1845,35,40-44,1880,3.4773273182706697
SIM,1882,34,50-100,1916,2
STAT,1982,15,50-100,1997,0.6087347850140038
STAT,1881,32,35-39,1913,11.272731892394226
STAT,1942,48,40-44,1990,0.19726310649528941
SIM,1825,60,na,1885,1338
SIM,1890,33,na,1923,3393
SIM,1948,19,50-100,1967,1
SIM,1908,35,25-29,1943,1
STAT,1819,54,30-34,1873,0.010593315795761518
SIM,1897,12,na,1909,4198
STAT,1856,23,50-100,1879,0.4139959621466662
STAT,1876,19,25-29,1895,6.724033173394271
STAT,1810,49,30-34,1859,0.36077577378161063
STAT,1953,49,45-49,2002,0.3137496738434988
STAT,1956,44,na,2000,5874.352391052168
SIM,1785,92,na,1877,10
SIM,1949,17,25-29,1966,123
STAT,1964,26,15-19,1990,1.0310150651694652
STAT,1929,43,40-44,1972,0.37324534001422993
STAT,1866,30,40-44,1896,4.676107772879976
SIM,1999,11,na,2010,6972
STAT,1970,39,35-39,2009,3.5922226954367598
STAT,1945,15,25-29,1960,54.659856260309496
STAT,1908,98,na,2006,79.47749136855468
SIM,1877,51,na,1928,2925
SIM,1882,38,na,1920,3263
STAT,1960,17,40-44,1977,2.1023779437306405
SIM,1856,83,na,1939,303
STAT,1895,38,35-39,1933,10.57218643621329
STAT,1904,33,25-29,1937,9.705478775705506
STAT,1845,44,30-34,1889,0.7689435433423377
STAT,1829,28,na,1857,2051.0516876091933
SIM,1959,35,40-44,1994,6
SIM,1915,42,na,1957,4536
STAT,1822,49,na,1871,2087.4191151328982
STAT,1866,44,45-49,1910,1.579289800368077
SIM,1853,44,30-34,1897,3
STAT,1923,44,15-19,1967,0.002063745683497003
SIM,1912,33,25-29,1945,20
SIM,1874,44,45-49,1918,2
STAT,1935,10,na,1945,6273.401087201828
STAT,1817,39,15-19,1856,0.18694790834432015
STAT,1914,42,na,1956,4249.008628313988
STAT,1887,18,30-34,1905,2.055987196492246
STAT,1992,20,35-39,2012,15.659671141288289
STAT,1886,29,35-39,1915,11.661799098272194
STAT,1966,30,45-49,1996,2.3146356268122474
SIM,1836,69,na,1905,830
STAT,1969,15,50-100,1984,0.540400690456681
STAT,1825,49,15-19,1874,5.432935761221841E-4
STAT,1921,30,50-100,1951,1.0699707966675431
SIM,1866,20,40-44,1886,5
SIM,1977,20,20-24,1997,5
SIM,1963,33,40-44,1996,4
STAT,1924,0,na,1924,6189.613264659499
SIM,1848,54,45-49,1902,1
SIM,1918,47,na,1965,3759
SIM,1929,68,na,1997,3954
STAT,1804,52,na,1856,1506.7632285284724
STAT,1885,16,30-34,1901,1.839223976778453
STAT,1927,15,na,1942,5304.961469794121
STAT,1911,40,15-19,1951,0.0017121454460229243
STAT,1840,29,50-100,1869,0.6306832679280073
SIM,1864,23,50-100,1887,2
SIM,1864,36,50-100,1900,4
SIM,1877,23,20-24,1900,1
STAT,1842,44,15-19,1886,0.010716651435809823
STAT,1850,35,50-100,1885,1.3108517207900567
STAT,1969,13,na,1982,5661.965712944605
STAT,1958,20,45-49,1978,1.7122818804177589
SIM,1810,76,na,1886,233
STAT,1854,22,30-34,1876,17.05063563676404
SIM,1974,7,na,1981,6402
STAT,1838,25,50-100,1863,0.7152181732333532
STAT,1864,50,na,1914,2250.5973582853844
STAT,1864,37,35-39,1901,7.288232353502721
STAT,1889,42,50-100,1931,1.5010257030957497
STAT,1969,20,20-24,1989,160.94212010272852
STAT,1862,24,na,1886,2324.223564045736
STAT,1871,37,35-39,1908,8.120607614417823
STAT,1871,25,40-44,1896,3.46261913626054
SIM,1966,20,45-49,1986,1
SIM,1894,29,35-39,1923,34
STAT,1968,43,20-24,2011,0.026412853593953952
SIM,1862,22,30-34,1884,1
SIM,1895,18,30-34,1913,4
STAT,1827,53,20-24,1880,8.842701745132765E-4
STAT,1867,19,50-100,1886,0.05333151938281852
SIM,1957,44,na,2001,6184
STAT,1816,46,50-100,1862,0.5084875731670492
STAT,1948,9,na,1957,5189.764866188304
STAT,1912,16,na,1928,4522.556617246376
STAT,1890,25,50-100,1915,0.9081629161568422
SIM,1955,39,20-24,1994,1
SIM,1901,27,30-34,1928,90
STAT,1867,22,40-44,1889,2.254529516684589
STAT,1910,49,35-39,1959,0.1381513703726283
SIM,1858,29,25-29,1887,6
STAT,1814,104,na,1918,0.04158870918813189
STAT,1898,19,45-49,1917,0.10133585235012457
SIM,1960,15,25-29,1975,171
STAT,1953,38,na,1991,5405.638015995016
SIM,1887,19,40-44,1906,1
STAT,1939,18,na,1957,4252.3038737230045
STAT,1897,77,na,1974,1948.0874527173617
SIM,1900,43,na,1943,3479
SIM,1862,52,na,1914,2685
STAT,1930,23,25-29,1953,136.15577121206448
STAT,1888,33,40-44,1921,5.858252846552638
SIM,1896,33,40-44,1929,9
SIM,1868,39,35-39,1907,13
STAT,1828,32,30-34,1860,20.131245730141426
STAT,1862,37,25-29,1899,2.8041434486855725
STAT,1926,25,25-29,1951,91.65684298517981
SIM,1908,69,na,1977,2778
STAT,1947,39,20-24,1986,0.35229463985978926
STAT,2004,7,na,2011,6931.900953615053
STAT,1946,30,35-39,1976,11.936501265182935
STAT,1991,15,50-100,2006,0.6199652108428577
STAT,1870,34,25-29,1904,11.553488137929941
SIM,1927,25,25-29,1952,8
STAT,1878,24,15-19,1902,3.9502920429501542
STAT,1945,42,50-100,1987,0.1539127359871714
STAT,1968,38,40-44,2006,2.22079902513485
STAT,1818,51,20-24,1869,8.941261513075095E-4
STAT,1823,46,45-49,1869,0.23646810756072062
STAT,1858,20,40-44,1878,2.183718491684678
SIM,1831,46,45-49,1877,1
SIM,1875,22,40-44,1897,4
SIM,1882,18,20-24,1900,22
SIM,1923,19,30-34,1942,22
SIM,1976,38,40-44,2014,1
STAT,1850,21,na,1871,2660.9660700973327
SIM,1867,26,30-34,1893,32
SIM,1926,15,25-29,1941,141
SIM,1934,25,25-29,1959,133
SIM,1985,21,20-24,2006,196
SIM,1957,40,na,1997,6226
STAT,1907,44,50-100,1951,0.12288571313691857
SIM,1979,24,30-34,2003,114
STAT,1797,65,na,1862,978.3339800578053
SIM,1826,51,na,1877,1624
SIM,1921,11,na,1932,5566
STAT,1858,39,25-29,1897,2.566012562963775
STAT,1915,19,30-34,1934,2.9287687396285373
STAT,1901,37,30-34,1938,1.8595088627950376
STAT,1838,54,35-39,1892,0.007253554059369481
STAT,1918,15,25-29,1933,10.96942095383542
STAT,1853,43,20-24,1896,0.15697506651704995
STAT,1907,69,na,1976,3040.7847099578184
STAT,1965,18,15-19,1983,65.36553439184843
STAT,1844,41,20-24,1885,0.13779919459318557
SIM,1942,10,na,1952,5067
STAT,1902,29,30-34,1931,40.76883112024713
SIM,1819,38,45-49,1857,1
SIM,1829,32,30-34,1861,40
STAT,1919,25,25-29,1944,82.6110541294444
STAT,1871,20,na,1891,2731.576130213911
SIM,1836,32,30-34,1868,40
STAT,1904,64,na,1968,3216.1963795601678
STAT,1952,15,25-29,1967,59.963049694361615
STAT,1902,16,40-44,1918,0.29897934999055836
SIM,1835,84,na,1919,196
STAT,1934,38,40-44,1972,2.3827993817554827
STAT,1867,111,na,1978,0.004009797273196743
SIM,1942,38,40-44,1980,3
SIM,1868,55,na,1923,2724
STAT,1988,22,35-39,2010,15.592723179600004
SIM,1910,29,30-34,1939,1
STAT,1942,35,20-24,1977,0.3281582681219242
STAT,1857,77,na,1934,776.9248907274487
SIM,1834,25,20-24,1859,24
STAT,1944,41,25-29,1985,0.09230200787919458
SIM,1901,28,na,1929,3873
SIM,1966,40,na,2006,5849
STAT,1829,52,35-39,1881,0.00771798915202636
SIM,1937,26,na,1963,4060
SIM,1811,52,na,1863,1492
STAT,1904,28,45-49,1932,1.8335387911453072
SIM,1971,34,40-44,2005,19
STAT,1918,19,na,1937,4597.670142559306
STAT,1985,30,50-100,2015,1.3848786263747628
SIM,1989,22,35-39,2011,21
STAT,1800,96,na,1896,4.6332468412797985
SIM,1891,49,na,1940,3182
STAT,1823,90,na,1913,44.64645412444596
SIM,1930,47,na,1977,5922
SIM,1920,38,45-49,1958,3
SIM,1929,32,35-39,1961,16
STAT,1970,39,50-100,2009,0.6235507404820373
SIM,1974,30,35-39,2004,3
STAT,1883,48,25-29,1931,0.06421853908146186
SIM,1889,54,na,1943,3293
STAT,1892,31,40-44,1923,6.298410188408235
STAT,1912,38,45-49,1950,0.7647884525436696
STAT,1974,40,35-39,2014,0.3162257813532104
SIM,1807,87,na,1894,136
STAT,1784,106,na,1890,0.014097476391957393
SIM,1934,19,30-34,1953,1
STAT,1852,31,na,1883,2353.761359154066
SIM,1951,26,15-19,1977,6
SIM,1943,3,na,1946,5571
STAT,1866,33,45-49,1899,1.8574285390767882
SIM,1887,44,na,1931,3623
STAT,1919,32,25-29,1951,11.505123864506432
STAT,1851,37,25-29,1888,2.3076387676124255
STAT,1936,8,na,1944,4409.335081076108
SIM,1870,35,35-39,1905,27
SIM,1820,54,na,1874,1708
STAT,1915,27,15-19,1942,0.8311280102192686
STAT,1856,38,20-24,1894,0.6753270278407998
STAT,1914,28,50-100,1942,1.1544612753997427
STAT,2001,1,na,2002,6803.349195864893
STAT,1851,86,na,1937,175.94666636403414
SIM,1849,32,40-44,1881,13
SIM,1923,27,15-19,1950,4
SIM,1857,12,na,1869,2913
STAT,1880,50,20-24,1930,9.156249319399567E-4
STAT,1895,35,30-34,1930,8.082083392805753
STAT,1879,43,50-100,1922,1.263848281197559
SIM,1886,16,30-34,1902,3
STAT,1954,18,50-100,1972,0.5343377139366451
STAT,1943,26,15-19,1969,0.8681419034587295
STAT,1845,38,50-100,1883,0.8602786265363791
STAT,1814,50,30-34,1864,0.01646987000557891
STAT,1954,61,na,2015,5022.093478648405
SIM,1840,21,40-44,1861,11
STAT,1934,65,na,1999,5151.645251545471
SIM,1961,46,40-44,2007,1
SIM,1779,80,na,1859,345
STAT,1905,45,45-49,1950,0.22457623864115758
STAT,1920,34,30-34,1954,19.736760502742015
SIM,1944,22,15-19,1966,10
STAT,1909,29,40-44,1938,5.109703889087485
SIM,1906,1,na,1907,4122
SIM,1932,21,50-100,1953,2
SIM,1953,22,25-29,1975,239
STAT,1901,21,15-19,1922,5.348915631667837
SIM,1939,46,na,1985,4878
STAT,1902,19,45-49,1921,0.10594547918813467
SIM,1819,37,30-34,1856,1
SIM,1955,34,50-100,1989,1
SIM,1837,94,na,1931,37
SIM,1914,60,na,1974,3717
STAT,1928,22,30-34,1950,41.41205590639416
STAT,1862,49,na,1911,2145.442414789986
SIM,1794,72,na,1866,438
STAT,1869,45,30-34,1914,0.10926303746043708
SIM,1936,22,30-34,1958,36
STAT,1836,94,na,1930,18.188685661019626
STAT,1845,38,45-49,1883,1.396834952893286
STAT,1849,67,na,1916,1228.6519630916507
SIM,1827,32,20-24,1859,4
SIM,1958,23,20-24,1981,174
STAT,1929,36,50-100,1965,0.6226542302056824
SIM,1895,85,na,1980,713
STAT,1903,88,na,1991,804.6956465432299
STAT,1855,32,30-34,1887,15.126875812036873
SIM,1981,23,35-39,2004,32
STAT,1952,45,30-34,1997,0.12883952409041943
STAT,1837,27,30-34,1864,23.40450598913639
STAT,1871,28,45-49,1899,1.2702811030370387
STAT,1903,30,15-19,1933,0.23596810839555613
STAT,1916,45,20-24,1961,0.013143923671795038
STAT,1847,48,15-19,1895,3.0391419669755876E-4
SIM,1902,44,30-34,1946,1
STAT,1923,21,35-39,1944,12.677024930798812
SIM,1931,21,35-39,1952,22
SIM,1917,29,40-44,1946,28
SIM,1845,27,30-34,1872,31
SIM,1847,23,40-44,1870,1
SIM,1944,36,40-44,1980,2
STAT,1805,50,50-100,1855,0.05623910578907059
STAT,1926,19,30-34,1945,17.150142706822667
SIM,1953,51,na,2004,5481
SIM,1922,9,na,1931,5505
SIM,1927,32,25-29,1959,5
STAT,1882,63,na,1945,2011.2945131301992
STAT,1870,59,na,1929,2211.126169593869
SIM,1959,20,45-49,1979,1
STAT,1886,35,20-24,1921,0.9472746905433271
STAT,1970,36,30-34,2006,2.715051992485462
STAT,1917,36,15-19,1953,0.023129876232682818
SIM,1863,32,30-34,1895,7
STAT,1838,47,35-39,1885,0.12478499129404864
STAT,1933,2,na,1935,6321.034516917437
STAT,1890,34,35-39,1924,14.158117435185783
STAT,1977,26,15-19,2003,1.106044772884083
STAT,1847,30,15-19,1877,0.13135622834229432
STAT,1903,21,50-100,1924,0.6723403224847688
STAT,1863,15,40-44,1878,0.2131140618313707
STAT,1871,43,50-100,1914,1.2041782553082532
STAT,1787,87,na,1874,45.7062909336839
STAT,1840,40,30-34,1880,1.0846452337707462
STAT,1910,46,30-34,1956,0.09632388139007783
STAT,1939,23,45-49,1962,1.3041706818716352
SIM,1807,72,na,1879,569
STAT,1951,28,30-34,1979,54.052963502162115
SIM,1966,4,na,1970,5946
SIM,1819,75,na,1894,174
STAT,1888,38,35-39,1926,9.547354668560091
SIM,1854,57,na,1911,2085
STAT,1839,23,40-44,1862,2.1081032896838767
SIM,1821,33,30-34,1854,12
SIM,1858,26,20-24,1884,25
STAT,1833,41,45-49,1874,1.3019168889762796
STAT,1967,16,15-19,1983,65.44143002918874
SIM,1853,22,20-24,1875,128
STAT,1988,15,35-39,2003,6.9295868332448105
STAT,1958,54,na,2012,5640.934517444469
STAT,1998,11,na,2009,6657.104881832416
STAT,1884,73,na,1957,1429.1227249256171
SIM,1983,17,15-19,2000,77
STAT,1927,87,na,2014,1373.0699731660459
STAT,1976,16,25-29,1992,66.83297558899523
STAT,1799,75,na,1874,566.6395869623663
STAT,1925,44,25-29,1969,0.09940875868144038
SIM,1843,28,35-39,1871,2
SIM,1901,39,50-100,1940,3
STAT,1815,79,na,1894,387.9206668276985
STAT,1920,11,na,1931,5135.694221407083
SIM,1952,28,na,1980,4180
SIM,1914,33,35-39,1947,4
SIM,1975,6,na,1981,6127
SIM,1792,62,na,1854,933
STAT,1861,20,50-100,1881,0.40776758505863053
STAT,1865,29,na,1894,2467.2211822678073
STAT,1879,36,35-39,1915,8.564025590446123
SIM,1896,38,35-39,1934,6
SIM,1946,27,50-100,1973,2
STAT,1991,19,15-19,2010,75.0083899028369
SIM,1941,63,na,2004,3480
STAT,1902,38,na,1940,3852.8310823961906
SIM,1867,28,20-24,1895,1
STAT,1992,20,na,2012,6073.328082466846
STAT,1886,59,na,1945,2365.8005739598652
STAT,1870,75,na,1945,1171.2439048985614
STAT,1961,31,15-19,1992,0.1954161722485198
STAT,1936,39,45-49,1975,0.771169217585574
SIM,1907,18,25-29,1925,17
STAT,1895,36,na,1931,3556.1640219187607
SIM,1975,16,15-19,1991,64
STAT,1842,43,45-49,1885,1.176392494267261
SIM,1844,64,na,1908,1552
SIM,1850,43,45-49,1893,7
SIM,1903,23,40-44,1926,6
SIM,1906,59,na,1965,3272
SIM,1905,31,35-39,1936,24
STAT,1951,34,25-29,1985,12.930320740577157
SIM,1908,29,30-34,1937,4
STAT,1832,26,35-39,1858,9.337948971553763
STAT,1936,22,15-19,1958,5.876693995070694
STAT,1837,25,40-44,1862,2.8245452840378027
STAT,1859,28,20-24,1887,10.892163072915846
SIM,1887,36,35-39,1923,17
STAT,1850,17,20-24,1867,22.301901220583233
STAT,1864,44,35-39,1908,1.840751150384012
STAT,1807,51,45-49,1858,0.05816678760917848
STAT,1945,22,25-29,1967,116.83111409976158
STAT,1825,44,20-24,1869,0.2261840928394036
STAT,1932,15,15-19,1947,69.69083669271332
SIM,1979,27,35-39,2006,31
STAT,1769,102,na,1871,0.12094784302767106
SIM,1927,58,na,1985,4692
STAT,1813,69,na,1882,797.6192612818793
STAT,1962,29,45-49,1991,2.563083908473708
SIM,1872,44,35-39,1916,7
SIM,1921,67,na,1988,4498
SIM,1841,41,45-49,1882,2
STAT,1934,1,na,1935,6521.945575739292
SIM,1845,25,40-44,1870,1
STAT,1926,14,na,1940,5586.9917057715475
SIM,1940,26,50-100,1966,7
SIM,1877,66,na,1943,1963
SIM,1934,15,na,1949,5591
STAT,1845,22,20-24,1867,57.64856656576755
SIM,1856,67,na,1923,1456
SIM,1840,26,35-39,1866,18
STAT,1847,47,45-49,1894,0.18074463941026672
STAT,1910,89,na,1999,764.7281695795854
SIM,1913,16,na,1929,5046
SIM,1882,81,na,1963,1130
SIM,1977,16,25-29,1993,83
SIM,1945,21,na,1966,4769
STAT,1826,28,25-29,1854,122.6335622622742
STAT,1896,3,na,1899,4029.6661273188993
STAT,1941,17,15-19,1958,53.96004952177179
STAT,1876,16,20-24,1892,21.201707258300047
STAT,1816,53,45-49,1869,0.02785279403070266
STAT,1931,35,45-49,1966,1.043961949773584
SIM,1881,34,40-44,1915,7
STAT,1904,25,40-44,1929,4.997985477479499
SIM,1849,49,35-39,1898,1
STAT,1935,19,40-44,1954,2.1960396175869064
SIM,1943,19,40-44,1962,12
STAT,2010,3,na,2013,7172.427661229037
STAT,1965,32,50-100,1997,1.2142298197901609
STAT,1880,53,25-29,1933,0.004263169499634409
STAT,1825,32,na,1857,2068.8246069348575
STAT,1947,13,na,1960,5105.558317651687
SIM,1834,28,25-29,1862,69
STAT,1873,34,40-44,1907,5.067019959448076
STAT,1997,15,45-49,2012,0.8422638819480343
STAT,1836,45,35-39,1881,0.13684700885104917
SIM,1866,45,na,1911,2351
SIM,1831,24,35-39,1855,10
SIM,1893,28,50-100,1921,2
STAT,1969,16,25-29,1985,62.490732555251775
STAT,1842,30,50-100,1872,0.8696205110831953
STAT,1886,33,30-34,1919,21.164217135198427
STAT,1885,28,50-100,1913,0.7337638600104098
STAT,1851,39,15-19,1890,0.04408209966506471
STAT,1886,38,25-29,1924,3.4874946223014525
SIM,1944,20,25-29,1964,9
SIM,1871,75,na,1946,407
STAT,1883,48,na,1931,2508.359183267842
STAT,1926,17,40-44,1943,1.9786603915885164
SIM,1934,17,40-44,1951,6
STAT,1852,18,25-29,1870,6.423694364385159
SIM,1888,29,na,1917,2793
STAT,1851,34,20-24,1885,2.1851567729488877
STAT,1850,22,50-100,1872,0.5038638554245589
SIM,1909,44,40-44,1953,1
STAT,1890,31,30-34,1921,24.72091431695232
STAT,1840,43,35-39,1883,1.4960228398083912
SIM,1894,38,25-29,1932,6
STAT,1935,25,na,1960,5901.457133769527
SIM,1949,21,20-24,1970,173
SIM,1816,41,50-100,1857,2
SIM,1855,82,na,1937,128
STAT,1857,93,na,1950,26.268095896644624
SIM,1825,34,45-49,1859,4
STAT,1913,41,na,1954,4205.992672209838
STAT,1814,53,35-39,1867,0.022431240547858965
STAT,1954,15,35-39,1969,5.989673292198096
STAT,1860,39,25-29,1899,2.651013668846156
STAT,1977,31,50-100,2008,1.3148907083718335
STAT,1872,85,na,1957,376.1757665057348
STAT,1909,99,na,2008,55.48058105344917
STAT,1936,20,25-29,1956,102.04447913952343
STAT,1932,23,35-39,1955,14.217092345801465
STAT,1834,49,25-29,1883,0.054336220586228515
STAT,1899,33,40-44,1932,6.827719156782413
STAT,1783,91,na,1874,13.551175219776999
STAT,1979,4,na,1983,6248.875769624315
SIM,1940,23,35-39,1963,24
STAT,1874,18,45-49,1892,0.07697289423569434
SIM,1817,65,na,1882,734
STAT,1890,22,40-44,1912,2.9384209361886433
SIM,1819,35,40-44,1854,3
SIM,1850,30,50-100,1880,1
SIM,1962,15,35-39,1977,15
STAT,1921,43,50-100,1964,0.152406025363964
STAT,1837,79,na,1916,506.24177242034966
STAT,1911,37,50-100,1948,0.4683940018414858
STAT,1875,96,na,1971,58.132048439513206
STAT,1934,20,50-100,1954,1.0243310034588748
SIM,1918,30,25-29,1948,15
STAT,1830,26,25-29,1856,55.90065379226936
STAT,1988,21,20-24,2009,184.19875339173055
STAT,1905,42,40-44,1947,0.2605736696754693
STAT,1855,35,35-39,1890,6.07547403968459
STAT,1900,29,20-24,1929,18.65195729247939
STAT,1956,25,50-100,1981,1.5278723695618448
STAT,1862,35,35-39,1897,6.953968829057234
STAT,1906,33,35-39,1939,9.744534105400868
STAT,1928,40,na,1968,5478.985183399717
STAT,1958,28,40-44,1986,7.09204267889119
STAT,1876,22,15-19,1898,3.93566590422876
STAT,1820,43,25-29,1863,0.7681412935421347
STAT,1881,81,na,1962,848.7025795839414
STAT,1796,64,na,1860,970.40254125371
STAT,1935,41,15-19,1976,0.002504750913188749
STAT,1835,28,35-39,1863,7.805872703834361
STAT,1873,38,15-19,1911,0.0658493404040078
SIM,1830,29,45-49,1859,4
SIM,1869,56,na,1925,1663
SIM,1942,20,50-100,1962,2
SIM,1888,39,20-24,1927,1
SIM,1943,11,na,1954,5483
STAT,1910,37,40-44,1947,1.653974326172908
SIM,1890,48,na,1938,3123
STAT,1774,109,na,1883,1.328118773954425E-4
STAT,1927,34,40-44,1961,5.547033076679099
SIM,1908,85,na,1993,471
SIM,1868,43,30-34,1911,4
STAT,1928,25,35-39,1953,21.490296041604505
STAT,1869,22,15-19,1891,3.687016671149102
STAT,1979,22,25-29,2001,147.25834750694784
STAT,1928,34,25-29,1962,13.319767165791918
STAT,1919,48,40-44,1967,0.19675481458495214
SIM,1880,71,na,1951,1676
SIM,1893,59,na,1952,2649
SIM,1958,26,25-29,1984,12
STAT,1925,38,30-34,1963,2.5211026573872783
SIM,1908,27,40-44,1935,10
STAT,1968,31,25-29,1999,13.587775704075066
STAT,1935,9,na,1944,6283.832248734728
STAT,1997,17,35-39,2014,7.071268654949956
SIM,1935,34,40-44,1969,9
SIM,1836,25,30-34,1861,37
SIM,1936,34,25-29,1970,21
SIM,1913,42,40-44,1955,1
STAT,1833,83,na,1916,279.3493075774722
STAT,1854,15,30-34,1869,1.5718017671949833
STAT,1981,16,40-44,1997,2.257759758021114
STAT,1906,48,30-34,1954,0.0907356410398056
SIM,1953,38,40-44,1991,1
STAT,1936,36,40-44,1972,1.698571000244876
SIM,1841,29,20-24,1870,2
STAT,1834,68,na,1902,1394.6339856665563
STAT,1957,33,15-19,1990,0.19918309104815227
STAT,1832,24,50-100,1856,0.4232881184366096
SIM,1850,40,40-44,1890,4
STAT,1859,19,30-34,1878,1.6808731909635855
STAT,1888,35,30-34,1923,7.298633738399515
SIM,1987,22,25-29,2009,172
STAT,1843,24,45-49,1867,0.8656743240888992
STAT,1882,115,na,1997,1.761635981790106E-4
STAT,1848,28,45-49,1876,1.3982599665429214
STAT,1839,26,45-49,1865,1.1172867075942787
SIM,1966,28,40-44,1994,14
STAT,1931,32,40-44,1963,5.9189548692792275
STAT,1901,44,30-34,1945,0.1273104524371805
SIM,1840,24,50-100,1864,1
STAT,1873,37,45-49,1910,2.3493038534514867
SIM,1867,19,30-34,1886,3
STAT,1851,103,na,1954,0.11380666923182317
SIM,1851,24,45-49,1875,3
SIM,1855,44,40-44,1899,8
SIM,1832,27,20-24,1859,19
SIM,1896,35,30-34,1931,4
SIM,1961,24,40-44,1985,9
SIM,1856,28,45-49,1884,2
SIM,1863,35,35-39,1898,4
STAT,1793,72,na,1865,555.9809187961865
STAT,1869,81,na,1950,604.3629050981415
STAT,1816,50,40-44,1866,0.021451211716079666
STAT,1856,36,50-100,1892,1.0861679752062894
STAT,1895,11,na,1906,3885.213450038668
SIM,1864,19,na,1883,2927
SIM,1847,26,45-49,1873,1
STAT,1949,47,15-19,1996,5.142674909027598E-4
STAT,1902,23,na,1925,3844.59787996727
SIM,1877,39,45-49,1916,6
STAT,1869,39,45-49,1908,2.205514111480709
SIM,1992,17,25-29,2009,105
STAT,1945,38,40-44,1983,1.9423083533376406
SIM,1886,22,25-29,1908,2
STAT,1838,42,40-44,1880,2.278972480733677
STAT,1909,15,15-19,1924,10.330091622566007
STAT,1841,106,na,1947,0.010795056904287281
SIM,1820,69,na,1889,1273
STAT,1984,17,25-29,2001,71.02911899764051
SIM,1898,34,45-49,1932,1
SIM,1817,38,35-39,1855,10
STAT,1878,22,25-29,1900,68.97841798556081
SIM,1846,42,40-44,1888,4
SIM,1879,92,na,1971,147
STAT,1885,18,20-24,1903,20.354009090597337
STAT,1887,84,na,1971,878.8050973557188
SIM,1901,33,25-29,1934,3
STAT,2003,8,na,2011,6883.72032186907
STAT,1911,0,na,1911,5190.095978371122
STAT,1962,26,40-44,1988,6.92508942438829
STAT,1825,47,25-29,1872,0.08043414798686879
STAT,1913,19,20-24,1932,31.834867884161476
STAT,1832,23,30-34,1855,21.162159131189185
STAT,1888,19,50-100,1907,0.06610472070038591
STAT,1873,20,15-19,1893,3.911063564722143
SIM,1858,93,na,1951,37
STAT,1955,26,40-44,1981,7.174869587484449
SIM,1815,39,20-24,1854,1
STAT,1865,16,45-49,1881,0.0705060282205652
STAT,1940,40,na,1980,4536.538572688385
STAT,1847,44,40-44,1891,1.7073536793884663
STAT,1864,32,40-44,1896,4.468732989127939
STAT,1839,53,50-100,1892,0.011784924885997018
SIM,1955,39,na,1994,6510
SIM,1844,79,na,1923,562
SIM,1893,18,20-24,1911,42
STAT,1842,40,40-44,1882,1.8372562873238143
SIM,1921,19,20-24,1940,352
STAT,1848,82,na,1930,495.7567597764457
STAT,1895,29,45-49,1924,1.6559677289333896
STAT,1901,78,na,1979,1997.1375005346376
SIM,1840,23,30-34,1863,3
STAT,1914,26,na,1940,4375.302455791399
STAT,1947,45,15-19,1992,5.004375351588005E-4
SIM,1859,78,na,1937,212
STAT,1949,8,na,1957,5274.88110030699
SIM,1862,15,30-34,1877,2
STAT,1868,104,na,1972,0.9620337666230883
SIM,1839,49,na,1888,1892
STAT,1803,51,na,1854,1208.781544107233
STAT,1922,77,na,1999,2948.217796989951
SIM,1957,20,35-39,1977,1
STAT,1834,22,45-49,1856,0.8510834556263664
STAT,1953,24,40-44,1977,4.706346357040525
SIM,1963,26,40-44,1989,13
STAT,1879,33,30-34,1912,20.950503306646315
STAT,1830,87,na,1917,110.52117838068902
SIM,1887,33,30-34,1920,75
STAT,1824,50,na,1874,1546.1317444873646
STAT,1975,37,50-100,2012,0.6585503124537943
STAT,1864,41,30-34,1905,1.190026279934219
SIM,1872,41,30-34,1913,3
SIM,1975,29,25-29,2004,105
STAT,1863,17,30-34,1880,1.8353241075492333
STAT,1852,53,50-100,1905,0.014010451472453955
SIM,1872,35,45-49,1907,4
SIM,1894,33,30-34,1927,8
STAT,1949,20,35-39,1969,12.688280859881885
SIM,1970,26,40-44,1996,21
SIM,1947,19,na,1966,5626
SIM,1939,31,45-49,1970,2
STAT,1948,29,30-34,1977,51.919542227675194
SIM,1825,69,na,1894,1003
STAT,1844,67,na,1911,1325.9120541468267
STAT,1901,38,50-100,1939,0.42623918248302584
SIM,1836,29,40-44,1865,4
STAT,1980,31,30-34,2011,25.743755445181996
SIM,1862,37,40-44,1899,6
STAT,1860,34,50-100,1894,0.8449116528838128
SIM,1940,19,25-29,1959,2
STAT,1897,17,40-44,1914,0.28224389502360714
STAT,1829,103,na,1932,0.10513613639121215
STAT,1852,62,na,1914,1723.2094687800534
STAT,1860,43,20-24,1903,0.14664632664384553
SIM,1955,14,na,1969,6578
STAT,1971,27,35-39,1998,22.03964531997791
STAT,1972,43,na,2015,5694.022319019065
STAT,1932,20,30-34,1952,43.790648825845516
STAT,1945,19,35-39,1964,5.286363806359255
STAT,1991,21,35-39,2012,15.629439060688188
SIM,1937,18,40-44,1955,1
STAT,1838,50,25-29,1888,0.003175700205051096
SIM,1891,18,na,1909,3578
STAT,1831,31,30-34,1862,17.965383933931548
SIM,1956,29,30-34,1985,5
STAT,1932,19,25-29,1951,65.88276354112747
SIM,1859,16,30-34,1875,3
SIM,1989,23,40-44,2012,12
SIM,1833,64,na,1897,1100
SIM,1968,24,50-100,1992,2
SIM,1879,18,na,1897,3035
SIM,1915,73,na,1988,3140
STAT,1913,26,35-39,1939,17.332514903297163
SIM,1830,25,50-100,1855,3
SIM,1909,47,45-49,1956,1
SIM,1921,26,35-39,1947,51
STAT,1854,37,40-44,1891,3.566338335153033
STAT,1929,36,40-44,1965,2.220066551949493
STAT,1932,37,25-29,1969,1.5270850588323674
SIM,1891,49,30-34,1940,1
STAT,1935,45,25-29,1980,0.08687734900854506
SIM,1890,20,50-100,1910,1
SIM,1846,32,25-29,1878,3
SIM,1869,35,30-34,1904,3
STAT,1839,80,na,1919,490.57765311711535
STAT,1964,48,na,2012,5538.8901179615505
STAT,1846,24,50-100,1870,0.5127121247439703
STAT,1955,4,na,1959,6024.836923953186
STAT,1838,32,25-29,1870,11.026761757416057
STAT,1906,30,30-34,1936,17.007019710282417
STAT,1963,44,50-100,2007,0.1784067827263921
STAT,1855,26,50-100,1881,0.5714569198028641
STAT,1911,9,na,1920,4586.121104513146
STAT,1883,49,30-34,1932,0.10701411348791315
SIM,1969,29,40-44,1998,1
STAT,1847,16,na,1863,2217.5001474445608
STAT,1974,19,30-34,1993,18.355339162672422
SIM,1871,24,30-34,1895,24
SIM,1935,37,45-49,1972,2
STAT,1894,20,15-19,1914,4.923433252113212
STAT,1809,70,na,1879,801.2804449646835
STAT,1863,24,30-34,1887,18.070455935963142
STAT,1898,16,na,1914,3948.8127855035464
SIM,1899,18,25-29,1917,23
SIM,1937,36,40-44,1973,1
STAT,1960,37,30-34,1997,2.8223271622583055
STAT,1906,84,na,1990,1364.1353957951449
STAT,1946,31,40-44,1977,5.1087601342031315
STAT,1772,88,na,1860,5.619364946465008
SIM,1810,46,50-100,1856,2
SIM,1859,1,na,1860,3590
STAT,1983,27,15-19,2010,1.157482674269732
STAT,1964,31,30-34,1995,23.356474532475268
STAT,1896,30,20-24,1926,4.153353906049939
SIM,1905,43,na,1948,4012
SIM,1830,26,40-44,1856,7
STAT,1885,30,45-49,1915,2.023465077406519
SIM,1946,37,20-24,1983,2
STAT,1902,36,30-34,1938,1.8848090093694632
SIM,1849,24,20-24,1873,89
SIM,1979,31,30-34,2010,61
STAT,1916,18,30-34,1934,2.9768876913567235
SIM,1940,20,30-34,1960,3
SIM,1953,19,35-39,1972,8
STAT,1885,89,na,1974,397.94521084408194
STAT,1894,39,35-39,1933,10.38734934550532
STAT,1959,19,35-39,1978,6.33015906087768
SIM,1967,19,35-39,1986,4
SIM,1954,31,40-44,1985,13
STAT,1848,24,35-39,1872,7.44154949528306
SIM,1879,27,40-44,1906,13
STAT,1900,26,25-29,1926,67.97208439747487
STAT,1945,37,35-39,1982,3.141444847035799
STAT,1899,30,45-49,1929,2.7792677178795677
SIM,1934,34,50-100,1968,2
STAT,1922,45,15-19,1967,4.904636697311805E-4
SIM,1910,36,30-34,1946,3
STAT,1844,48,35-39,1892,0.11562781203119495
SIM,1922,23,45-49,1945,2
SIM,1961,27,45-49,1988,4
STAT,1950,19,15-19,1969,61.8860534438397
STAT,1912,94,na,2006,284.66992590611164
STAT,1934,47,30-34,1981,0.14340488456848946
SIM,1936,35,na,1971,3959
SIM,1953,37,35-39,1990,1
STAT,1846,48,50-100,1894,0.25070665980064805
STAT,1890,46,40-44,1936,0.13656342990982662
SIM,1916,30,50-100,1946,1
SIM,1993,3,na,1996,6964
SIM,1975,26,20-24,2001,2
STAT,1972,21,40-44,1993,4.986305252785652
STAT,1877,54,25-29,1931,0.004135064431072772
STAT,1829,45,35-39,1874,0.1466733437416095
STAT,1866,51,45-49,1917,0.015597649381606904
STAT,1860,97,na,1957,6.748107572006354
STAT,1815,70,na,1885,917.5506926799756
STAT,1990,23,40-44,2013,5.573522279438488
STAT,1870,35,30-34,1905,6.12117619785043
SIM,1813,41,30-34,1854,1
STAT,1864,22,25-29,1886,59.93683833615383
STAT,1957,34,20-24,1991,3.778187304629278
STAT,1786,96,na,1882,2.681529963674233
SIM,1904,20,20-24,1924,221
SIM,1981,32,na,2013,6400
SIM,1856,21,30-34,1877,35
STAT,1919,47,35-39,1966,0.16134617147713157
STAT,1854,19,40-44,1873,0.17615856547486242
SIM,1889,30,25-29,1919,3
SIM,1946,63,na,2009,4092
STAT,1792,96,na,1888,2.434111504618577
STAT,1906,44,20-24,1950,0.018308696342776373
SIM,1849,79,na,1928,1028
STAT,1968,24,25-29,1992,133.49168894400665
STAT,1821,42,25-29,1863,1.2388254995940797
STAT,1887,28,35-39,1915,12.435254492269907
SIM,1886,38,40-44,1924,1
STAT,1940,31,45-49,1971,1.8811581308349148
STAT,1927,37,45-49,1964,0.9779331368097173
STAT,1948,47,30-34,1995,0.12245934403968395
SIM,1879,44,50-100,1923,3
STAT,1915,49,50-100,1964,0.2615268715754244
STAT,1957,21,45-49,1978,1.7182496034386798
STAT,1919,29,35-39,1948,18.58278140405348
SIM,1837,45,35-39,1882,1
SIM,1927,29,35-39,1956,26
SIM,1942,47,30-34,1989,1
STAT,1971,29,45-49,2000,2.533593980498957
STAT,2005,6,na,2011,6978.863028910451
STAT,1878,38,40-44,1916,5.248533856364602
SIM,1965,21,45-49,1986,2
STAT,1877,54,na,1931,2513.6800513185676
STAT,1881,25,35-39,1906,10.813370150622243
SIM,1959,37,30-34,1996,3
SIM,1927,47,35-39,1974,2
STAT,1883,54,na,1937,2364.335490369322
STAT,1927,44,50-100,1971,0.1694308011789985
SIM,1973,31,35-39,2004,30
SIM,1870,56,na,1926,2639
STAT,1983,23,50-100,2006,1.077402890258983
SIM,1856,21,na,1877,2134
STAT,1839,19,45-49,1858,0.06697120866699662
SIM,1940,34,20-24,1974,7
STAT,1854,97,na,1951,4.3767495815368385
SIM,1815,39,na,1854,2114
SIM,1949,14,na,1963,5902
STAT,1953,45,45-49,1998,0.3170849224406385
SIM,1901,30,20-24,1931,7
STAT,1871,33,25-29,1904,11.710177699140537
SIM,1913,78,na,1991,2598
STAT,1914,41,45-49,1955,0.19068262263554028
SIM,1962,24,25-29,1986,11
STAT,1988,19,45-49,2007,0.8239611628383605
STAT,1828,37,na,1865,1843.9196065935428
STAT,1828,47,40-44,1875,0.15764764337445966
STAT,1917,68,na,1985,3642.8317468937785
SIM,1870,41,50-100,1911,4
STAT,1914,23,45-49,1937,1.3231497204243856
SIM,1872,22,25-29,1894,4
STAT,1932,34,20-24,1966,3.738102528033808
STAT,1824,75,na,1899,636.9808950761142
STAT,1938,41,30-34,1979,0.15154217714953092
SIM,1894,94,na,1988,341
STAT,1900,41,45-49,1941,0.1671815663717784
STAT,1958,32,15-19,1990,0.19854293985729274
SIM,1895,48,na,1943,3409
STAT,1954,24,25-29,1978,132.12591298920128
SIM,1802,72,na,1874,458
STAT,1875,29,50-100,1904,0.7574416636553959
SIM,1827,64,na,1891,837
STAT,1903,34,25-29,1937,9.58478330474324
STAT,1953,27,45-49,1980,2.4222655902793826
SIM,1925,32,50-100,1957,4
STAT,1851,49,na,1900,1746.8612001823908
SIM,1911,34,25-29,1945,2
STAT,1872,53,50-100,1925,0.01722010052463214
SIM,1899,22,35-39,1921,15
STAT,1828,29,40-44,1857,3.945460293815889
SIM,1862,21,na,1883,3110
SIM,1967,27,na,1994,5494
STAT,1880,54,30-34,1934,0.00708117019936942
STAT,1921,16,45-49,1937,0.6584971455378603
STAT,1898,18,50-100,1916,0.07621147080731355
STAT,1848,97,na,1945,5.708156273844582
SIM,1902,29,35-39,1931,38
STAT,1971,24,30-34,1995,42.12024766817417
STAT,1945,16,30-34,1961,15.370225586218085
STAT,1948,20,na,1968,4842.10289099976
STAT,1976,34,15-19,2010,0.20169670345216428
SIM,1847,44,na,1891,2357
STAT,1930,10,na,1940,5930.385403970366
SIM,1895,46,35-39,1941,1
SIM,1905,39,30-34,1944,5
STAT,1887,46,35-39,1933,0.18157929993771124
SIM,1985,29,50-100,2014,3
SIM,1821,39,na,1860,1687
STAT,1819,53,25-29,1872,0.006430219536152067
STAT,1852,54,25-29,1906,0.0032476244538701075
STAT,1906,26,20-24,1932,19.810270273483944
STAT,1975,17,25-29,1992,65.97649689921609
STAT,1967,26,30-34,1993,56.75400817439817
STAT,1987,17,50-100,2004,0.6172447792986308
STAT,1850,104,na,1954,0.06866409307215553
SIM,1896,23,25-29,1919,103
STAT,1871,29,na,1900,2720.4467423399183
STAT,1800,65,na,1865,1097.289300242092
STAT,1766,88,na,1854,106.0
STAT,1888,23,25-29,1911,77.41797953808806
STAT,1813,75,na,1888,478.39090421121216
SIM,1857,21,45-49,1878,1
STAT,1931,39,30-34,1970,2.7802697469884903
SIM,1967,16,30-34,1983,22
STAT,1987,20,30-34,2007,47.54042692203751
STAT,1918,41,na,1959,4562.599545778651
STAT,1834,53,20-24,1887,6.769485283799593E-4
STAT,1859,29,na,1888,2199.8779063782004
SIM,1827,35,25-29,1862,3
SIM,1959,21,15-19,1980,20
STAT,1906,47,50-100,1953,0.2320560933752982
SIM,1888,32,30-34,1920,6
STAT,1849,21,45-49,1870,0.6581723062335096
SIM,1914,26,20-24,1940,49
STAT,1788,91,na,1879,28.059899448757236
STAT,1924,29,15-19,1953,0.9415488240008596
STAT,1836,32,na,1868,2492.9999532361117
SIM,1903,48,na,1951,3499
STAT,1879,89,na,1968,347.2253374791364
SIM,1913,49,30-34,1962,1
STAT,1941,42,15-19,1983,0.0018975436174683727
STAT,1870,53,30-34,1923,0.006663622039640893
SIM,1901,81,na,1982,1827
STAT,1966,17,na,1983,5305.539432528744
SIM,1910,39,35-39,1949,7
SIM,1792,77,na,1869,269
SIM,1860,26,na,1886,2523
SIM,1938,68,na,2006,3514
SIM,1905,2,na,1907,4748
STAT,1924,27,50-100,1951,1.3370817083576405
STAT,1915,34,15-19,1949,0.14977177504789402
STAT,1838,67,na,1905,1373.1315905635643
SIM,1984,16,15-19,2000,65
SIM,1885,18,na,1903,3388
STAT,1817,43,50-100,1860,3.1728693099345975
STAT,1902,39,35-39,1941,2.464307994474977
SIM,1959,41,50-100,2000,1
STAT,1881,22,30-34,1903,19.827370723299644
STAT,1832,48,45-49,1880,0.19124622884508735
STAT,1970,29,40-44,1999,6.755897028872098
STAT,1872,70,na,1942,1625.885484710318
STAT,1959,16,30-34,1975,18.405084539450304
STAT,1945,34,30-34,1979,20.21956081140488
STAT,1905,49,30-34,1954,0.08930075473007074
STAT,1861,79,na,1940,670.7266279452372
STAT,1848,21,30-34,1869,23.211051891270177
SIM,1908,91,na,1999,249
STAT,1896,33,25-29,1929,15.5467739887758
SIM,1869,31,na,1900,1982
STAT,1966,43,na,2009,5554.595664589364
SIM,1886,9,na,1895,2395
STAT,1961,33,50-100,1994,1.2557919057381017
SIM,1907,33,20-24,1940,4
SIM,1995,17,50-100,2012,3
SIM,1875,31,na,1906,3209
SIM,1899,15,20-24,1914,60
STAT,1829,50,na,1879,1732.0831304940925
STAT,1902,20,15-19,1922,5.411578044454953
SIM,1953,16,30-34,1969,40
STAT,1867,21,35-39,1888,6.359223994399925
STAT,1888,41,25-29,1929,0.8750755944222538
STAT,1964,34,35-39,1998,13.522012599235895
STAT,1859,40,45-49,1899,1.389751376651035
STAT,1908,30,50-100,1938,0.9090462617681104
STAT,1919,63,na,1982,4130.457076544452
STAT,1847,54,45-49,1901,0.01085956490016241
SIM,1898,28,na,1926,4009
STAT,1837,34,30-34,1871,15.52595103648229
STAT,1828,31,25-29,1859,12.212354446197928
STAT,1922,31,25-29,1953,12.095740358527923
SIM,1856,24,35-39,1880,7
STAT,1840,21,25-29,1861,58.822120811048585
SIM,1853,25,25-29,1878,10
SIM,1949,36,30-34,1985,2
SIM,1911,31,20-24,1942,8
STAT,1829,42,30-34,1871,1.2288027691940535
SIM,1859,34,30-34,1893,22
STAT,1920,19,35-39,1939,5.4016007738947875
STAT,1851,32,50-100,1883,0.7562374581400785
SIM,1944,30,na,1974,4549
STAT,1845,25,25-29,1870,35.199343354016804
SIM,1918,23,25-29,1941,246
STAT,1941,24,15-19,1965,6.345780401696401
STAT,1889,8,na,1897,3698.034591196637
SIM,1880,86,na,1966,544
STAT,1961,35,25-29,1996,1.515074132573471
STAT,1938,37,20-24,1975,0.3093215475800243
SIM,1854,26,na,1880,2785
SIM,1849,27,25-29,1876,11
SIM,1979,34,35-39,2013,3
STAT,1957,37,25-29,1994,1.5434604425909755
SIM,1862,21,25-29,1883,4
SIM,1922,27,na,1949,5186
SIM,1914,30,30-34,1944,38
STAT,1907,38,na,1945,4011.9571129769265
STAT,1877,51,20-24,1928,8.900699483767297E-4
STAT,1953,44,30-34,1997,0.18486513791872414
SIM,1837,42,30-34,1879,4
SIM,1950,30,na,1980,4662
STAT,1841,20,50-100,1861,0.465961605123914
STAT,1921,34,45-49,1955,2.0028619459784487
STAT,1829,59,na,1888,1449.3515943186123
SIM,1987,17,na,2004,6177
SIM,1953,34,30-34,1987,8
STAT,1949,27,25-29,1976,88.72382408864084
SIM,1837,24,30-34,1861,32
STAT,1904,18,40-44,1922,0.3023163096344654
SIM,1813,72,na,1885,640
STAT,1904,99,na,2003,51.661043138767184
STAT,1923,29,30-34,1952,51.525780801585924
SIM,1931,29,30-34,1960,76
STAT,1910,21,50-100,1931,0.7160018735231073
STAT,1912,84,na,1996,1491.702607315326
STAT,1920,33,50-100,1953,1.0402751036355418
SIM,1920,28,40-44,1948,1
STAT,1819,35,25-29,1854,11.963921376574596
SIM,1904,23,25-29,1927,205
SIM,1897,43,na,1940,3632
STAT,1892,41,45-49,1933,2.174586915203677
SIM,1845,34,30-34,1879,37
STAT,1889,100,na,1989,25.746383900709237
STAT,1912,28,40-44,1940,5.287243482089517
STAT,1854,21,25-29,1875,55.194101345671584
SIM,1957,27,25-29,1984,115
SIM,1808,57,na,1865,1480
STAT,1925,41,20-24,1966,0.024702606915251377
SIM,1897,74,na,1971,2035
STAT,1867,17,25-29,1884,6.241994467220855
STAT,1845,43,25-29,1888,0.43503803310087796
STAT,1938,44,35-39,1982,0.23755355712697931
SIM,1874,86,na,1960,308
STAT,1965,32,na,1997,5554.327092206947
SIM,1933,23,20-24,1956,168
SIM,1972,27,20-24,1999,27
STAT,1914,21,25-29,1935,104.87257320597318
STAT,1850,67,na,1917,1631.8962195998758
STAT,1837,52,30-34,1889,0.004326061772963775
STAT,1964,27,20-24,1991,26.647107017573813
STAT,1996,2,na,1998,6600.05782417314
STAT,1958,17,50-100,1975,0.567879377459701
SIM,1820,37,35-39,1857,18
SIM,1927,44,30-34,1971,1
STAT,1911,41,20-24,1952,0.019581181475479756
SIM,1848,26,na,1874,1835
STAT,1868,49,35-39,1917,0.15198643665404973
SIM,1937,57,na,1994,3980
STAT,1951,31,20-24,1982,3.418745487435517
SIM,1836,31,25-29,1867,22
SIM,1856,52,na,1908,1935
STAT,1910,99,na,2009,56.327683919678144
STAT,1925,23,20-24,1948,153.07876557807074
STAT,1890,36,na,1926,3338.200980120778
SIM,1916,84,na,2000,1309
STAT,1903,31,20-24,1934,4.461384177177101
STAT,1919,26,30-34,1945,49.014331675343755
SIM,1903,26,45-49,1929,4
SIM,1875,17,25-29,1892,13
SIM,1949,18,30-34,1967,19
SIM,1966,14,na,1980,5935
STAT,1858,29,20-24,1887,10.6572234271022
STAT,1964,36,45-49,2000,1.021792057023389
SIM,1853,43,25-29,1896,1
SIM,1858,19,20-24,1877,30
SIM,1927,26,30-34,1953,7
STAT,1919,44,30-34,1963,0.15931669919352395
STAT,1865,97,na,1962,14.685851783599253
STAT,1831,53,50-100,1884,0.012069634005149089
SIM,1922,21,25-29,1943,252
STAT,1868,5,na,1873,3119.265724930051
SIM,1916,27,na,1943,4663
STAT,1842,32,na,1874,2014.6900214308612
STAT,1947,38,na,1985,5033.541135465837
SIM,1866,29,20-24,1895,11
SIM,1921,73,na,1994,3640
SIM,1930,31,25-29,1961,16
STAT,1807,75,na,1882,588.2737111255291
STAT,1971,44,40-44,2015,0.37867839090989125
STAT,1794,91,na,1885,24.995616932115098
SIM,1936,32,35-39,1968,29
STAT,1860,46,25-29,1906,0.053726365200434924
STAT,1908,1,na,1909,4665.527396223233
SIM,1838,41,30-34,1879,4
SIM,1922,84,na,2006,1183
STAT,1905,35,40-44,1940,1.5931848941191102
STAT,1946,66,na,2012,4189.829524431861
SIM,1855,45,50-100,1900,1
STAT,1894,97,na,1991,87.92926390011654
STAT,1983,30,40-44,2013,6.5195107309538995
STAT,1870,44,na,1914,2594.0593455906783
SIM,1786,77,na,1863,103
STAT,1884,44,20-24,1928,0.17863768543684908
STAT,1909,28,35-39,1937,16.518855211878574
STAT,1851,38,30-34,1889,4.22746118800266
STAT,1910,27,25-29,1937,73.42635713726004
SIM,1906,65,na,1971,2897
SIM,1926,5,na,1931,6259
STAT,1832,45,40-44,1877,0.14418255868415786
SIM,1982,19,20-24,2001,6
STAT,1957,37,na,1994,5897.585552649139
STAT,1857,62,na,1919,1642.7842634641486
STAT,1937,28,40-44,1965,5.243787567676124
SIM,1943,18,35-39,1961,6
STAT,1853,23,30-34,1876,20.803311887481613
SIM,1843,26,na,1869,1958
SIM,1861,23,30-34,1884,42
SIM,1935,53,na,1988,5945
STAT,1966,45,45-49,2011,0.32738979830470366
STAT,1911,31,50-100,1942,0.9337182437264153
STAT,1950,36,30-34,1986,2.564536492467324
STAT,1852,51,20-24,1903,6.990490663898198E-4
SIM,1899,78,na,1977,1931
STAT,1954,40,35-39,1994,0.29938312020860236
STAT,1935,18,35-39,1953,6.6062857571486555
STAT,1987,23,35-39,2010,15.558833093754435
STAT,1853,111,na,1964,4.7349229816505E-4
STAT,1873,44,45-49,1917,1.7399676078610342
STAT,1924,46,30-34,1970,0.12274907518217913
SIM,1868,24,25-29,1892,76
STAT,1840,37,na,1877,2032.1625468003906
SIM,1878,16,35-39,1894,1
STAT,1924,10,na,1934,5460.244830795455
SIM,1962,22,35-39,1984,1
STAT,1827,33,30-34,1860,28.80740548282388
STAT,1872,47,35-39,1919,0.16147597378568365
STAT,1909,21,45-49,1930,1.2118406037365066
SIM,1948,19,30-34,1967,17
STAT,1931,25,40-44,1956,6.952175245646768
SIM,1866,51,na,1917,2200
SIM,1877,44,25-29,1921,3
SIM,1782,78,na,1860,81
SIM,1893,17,15-19,1910,17
STAT,1859,26,30-34,1885,23.71973588382348
STAT,1934,31,15-19,1965,0.20269805725561518
STAT,1948,51,na,1999,4982.390421960574
SIM,1946,9,na,1955,4694
STAT,1906,23,50-100,1929,0.6841381133577727
STAT,1940,30,30-34,1970,18.84513449900904
STAT,1836,38,35-39,1874,7.822071471102287
SIM,1903,17,na,1920,4107
STAT,1919,45,45-49,1964,0.2732636546620641
STAT,1954,22,35-39,1976,13.477761348399971
STAT,1848,29,na,1877,2704.7535541950297
SIM,1870,25,na,1895,3049
SIM,1926,83,na,2009,2722
SIM,1844,38,35-39,1882,5
STAT,1885,17,15-19,1902,6.831316354935672
SIM,1845,37,35-39,1882,11
STAT,1861,70,na,1931,1346.1195273062046
STAT,1781,96,na,1877,1.1665177096503299
STAT,1830,36,40-44,1866,4.496255326134202
STAT,1869,44,25-29,1913,0.7079927044475249
STAT,1871,15,25-29,1886,6.625963232505982
SIM,1880,47,35-39,1927,1
STAT,1844,36,na,1880,2102.0160477727077
STAT,1835,109,na,1944,4.434200867397649E-4
SIM,1928,21,20-24,1949,182
SIM,1904,61,na,1965,3548
SIM,1959,38,45-49,1997,3
SIM,1877,26,25-29,1903,4
SIM,1972,0,na,1972,5843
SIM,1927,45,45-49,1972,2
SIM,1883,51,na,1934,2320
STAT,1933,32,15-19,1965,0.19994236706228352
STAT,1811,49,na,1860,1511.518956033534
SIM,1917,21,45-49,1938,2
STAT,1888,20,20-24,1908,94.04272309835683
SIM,1896,20,20-24,1916,168
SIM,1813,44,35-39,1857,3
STAT,1924,28,30-34,1952,52.449800587087324
SIM,1932,28,30-34,1960,6
STAT,1825,48,30-34,1873,0.13331281798721042
SIM,1882,13,na,1895,3557
STAT,1926,34,50-100,1960,1.1520190802509367
STAT,1909,64,na,1973,3453.9845322266915
STAT,1967,29,35-39,1996,21.715088263892532
SIM,1884,26,50-100,1910,2
SIM,1953,35,45-49,1988,2
SIM,1915,24,15-19,1939,6
SIM,1970,19,40-44,1989,6
STAT,1953,48,na,2001,5319.914151619997
STAT,1930,76,na,2006,3545.7213412513397
SIM,1983,18,20-24,2001,427
STAT,1777,88,na,1865,33.511978780474294
STAT,1961,32,20-24,1993,3.7070686596669016
SIM,1919,38,40-44,1957,6
STAT,1961,33,na,1994,5744.4471306269925
SIM,1858,87,na,1945,180
STAT,1878,39,na,1917,2810.2760474401994
STAT,1858,113,na,1971,1.2957114225480048E-4
STAT,1942,38,25-29,1980,1.2223483608199612
SIM,1927,27,45-49,1954,3
STAT,1819,50,50-100,1869,0.02910529976642663
SIM,1913,47,na,1960,4457
STAT,1837,37,35-39,1874,6.23575628465684
SIM,1950,38,25-29,1988,3
STAT,1832,70,na,1902,955.900897458187
SIM,1923,49,50-100,1972,1
STAT,1856,31,30-34,1887,15.723023753286796
SIM,1895,79,na,1974,949
STAT,1833,52,na,1885,1561.2817783945825
STAT,1960,21,15-19,1981,8.030250351955756
SIM,1939,52,na,1991,4739
STAT,1834,37,na,1871,2431.243075117665
STAT,1962,19,40-44,1981,2.066864483341011
SIM,1889,6,na,1895,4149
SIM,1949,39,35-39,1988,7
SIM,1880,29,35-39,1909,1
SIM,1949,29,50-100,1978,1
STAT,1875,100,na,1975,13.718840373505552
SIM,1848,33,40-44,1881,3
STAT,1872,29,35-39,1901,11.101285443603972
SIM,1969,33,35-39,2002,27
SIM,1970,32,25-29,2002,4
STAT,1886,48,40-44,1934,0.2057850690257457
SIM,1949,6,na,1955,5903
STAT,1919,27,45-49,1946,2.1537154475455282
STAT,1970,19,na,1989,5313.776237777153
STAT,1820,44,30-34,1864,1.3232969243062125
STAT,1856,24,na,1880,2155.07937895481
STAT,1946,32,25-29,1978,12.05904490252805
STAT,1853,53,25-29,1906,0.0034698736294101738
STAT,1972,22,25-29,1994,136.93669601082328
STAT,1907,24,15-19,1931,5.5665919358120135
SIM,1967,3,na,1970,5784
STAT,1805,49,na,1854,1497.3881224870274
STAT,1889,40,25-29,1929,0.9227305367124654
STAT,1956,39,30-34,1995,2.8612822789646906
STAT,1907,42,15-19,1949,0.0016263239495683895
STAT,1877,24,30-34,1901,21.2488056625029
SIM,1864,31,30-34,1895,41
SIM,1954,32,25-29,1986,21
SIM,1967,45,30-34,2012,1
STAT,1916,48,25-29,1964,0.06262070959421472
STAT,1858,54,20-24,1912,6.460696208457666E-4
STAT,1888,0,na,1888,4063.0922419471444
SIM,1918,53,na,1971,3717
SIM,1927,27,na,1954,4802
STAT,1917,94,na,2011,309.10392226717096
STAT,1911,44,25-29,1955,0.07775552682971545
SIM,1945,52,na,1997,4576
SIM,1885,86,na,1971,1001
STAT,1872,79,na,1951,810.1247076975175
STAT,1890,3,na,1893,3727.852405290497
SIM,1968,15,30-34,1983,24
SIM,1978,35,35-39,2013,1
STAT,1955,33,na,1988,5902.4569733582985
SIM,1964,22,na,1986,5942
SIM,1923,8,na,1931,5711
STAT,1936,29,40-44,1965,5.145824225862306
STAT,1959,45,30-34,2004,0.14063436593894613
STAT,1905,17,40-44,1922,0.3055070611131798
STAT,1932,45,na,1977,5779.749818553925
STAT,1821,70,na,1891,858.1085186923202
STAT,1910,42,20-24,1952,0.019281535501760507
STAT,1831,34,35-39,1865,10.100762289711328
SIM,1883,29,50-100,1912,1
STAT,1975,36,20-24,2011,0.4138531021139716
STAT,1887,16,na,1903,3274.4469261643203
SIM,1900,31,45-49,1931,2
SIM,1864,87,na,1951,169
SIM,1942,35,na,1977,5006
SIM,1991,23,50-100,2014,1
SIM,1849,70,na,1919,1741
STAT,1950,18,30-34,1968,16.626839817390444
STAT,1901,22,20-24,1923,111.39585685309058
SIM,1913,35,40-44,1948,1
SIM,1849,31,35-39,1880,24
SIM,1949,45,na,1994,5764
STAT,1945,17,45-49,1962,0.6297507704510077
STAT,1866,23,40-44,1889,2.231035949647131
STAT,1945,35,45-49,1980,0.8869427795152532
SIM,1915,20,50-100,1935,2
SIM,1818,56,na,1874,1897
STAT,1865,43,50-100,1908,1.0920905204589342
STAT,1901,84,na,1985,1271.2155138365738
STAT,1910,58,na,1968,3756.3396641451764
STAT,1901,40,20-24,1941,0.018006942497001875
SIM,1889,79,na,1968,1769
STAT,1917,16,25-29,1933,10.78863126390089
STAT,1862,28,35-39,1890,9.36432527895903
STAT,1893,16,na,1909,3693.19681646887
STAT,1926,45,na,1971,5254.859484317752
SIM,1903,24,25-29,1927,13
SIM,1958,19,na,1977,5478
SIM,1874,23,40-44,1897,5
SIM,1870,28,35-39,1898,20
SIM,1944,29,40-44,1973,18
SIM,1921,23,30-34,1944,2
STAT,1917,43,15-19,1960,0.001846622912978575
STAT,1910,24,20-24,1934,119.87775919483771
STAT,1949,33,na,1982,5171.0433668558035
SIM,1929,53,na,1982,5033
SIM,1869,38,35-39,1907,4
SIM,1859,18,20-24,1877,1
SIM,1872,51,na,1923,2724
STAT,1853,26,35-39,1879,11.209365665349473
STAT,1892,31,na,1923,3465.7478396642405
SIM,1803,57,na,1860,1465
SIM,1894,32,25-29,1926,30
STAT,1866,79,na,1945,747.806229668501
STAT,1823,37,na,1860,1621.5110829510336
SIM,1870,25,30-34,1895,53
STAT,1880,27,40-44,1907,3.664297292051471
SIM,1844,17,30-34,1861,5
STAT,1826,70,na,1896,772.540448122349
STAT,1966,42,40-44,2008,0.3746814274159549
SIM,1918,39,40-44,1957,3
STAT,1830,39,45-49,1869,1.9531905895418773
SIM,1861,26,35-39,1887,12
SIM,1864,25,na,1889,2684
SIM,1823,43,45-49,1866,3
SIM,1911,43,na,1954,4678
STAT,1815,49,20-24,1864,0.023788008867688244
STAT,1864,40,25-29,1904,0.6683821519436843
STAT,1988,20,15-19,2008,8.821258979583375
STAT,1838,36,na,1874,2262.0092982115393
STAT,1939,48,50-100,1987,0.2711233874538396
STAT,1936,38,na,1974,4260.623696322132
STAT,1875,50,na,1925,2604.7591209281086
SIM,1940,16,20-24,1956,300
STAT,1890,104,na,1994,3.474363495737963
SIM,1878,79,na,1957,942
SIM,1917,25,30-34,1942,117
STAT,1866,26,45-49,1892,1.1917246110443345
SIM,1954,34,45-49,1988,5
STAT,1884,47,25-29,1931,0.06537053995518151
STAT,1946,34,45-49,1980,2.050426921846317
SIM,1922,41,45-49,1963,1
STAT,1924,42,45-49,1966,0.22839544175523832
STAT,1901,25,25-29,1926,68.84342573384254
STAT,1932,16,20-24,1948,207.73649236202016
STAT,1812,90,na,1902,34.613638167600406
STAT,1964,49,20-24,2013,0.016610039609097856
SIM,1908,100,na,2008,16
STAT,1972,43,40-44,2015,0.3834794999822327
SIM,1961,42,30-34,2003,1
STAT,1909,25,30-34,1934,43.92665552107033
STAT,1886,32,25-29,1918,12.468436432489417
STAT,1935,42,20-24,1977,0.028763155273025198
SIM,1872,40,25-29,1912,2
SIM,1953,19,na,1972,5339
STAT,1958,48,na,2006,5775.980107955529
STAT,1841,39,20-24,1880,0.7908855216588907
STAT,1921,61,na,1982,4401.2318310282335
STAT,1906,94,na,2000,260.32556364957856
SIM,1943,15,30-34,1958,42
STAT,1861,41,15-19,1902,0.01330919999461046
STAT,1928,78,na,2006,3108.3784874847306
STAT,1900,23,20-24,1923,110.01242033619678
STAT,1827,36,35-39,1863,10.628253036984564
STAT,1943,33,15-19,1976,0.16021673268435316
STAT,1868,30,15-19,1898,0.15916621704538444
STAT,1850,36,na,1886,2489.4744227819374
STAT,1905,4,na,1909,4394.096461760179
SIM,1890,21,30-34,1911,59
SIM,1909,39,50-100,1948,1
STAT,1957,43,45-49,2000,0.2627537961526596
STAT,1935,15,30-34,1950,19.329488893268152
SIM,1868,21,20-24,1889,5
SIM,1816,52,na,1868,1462
STAT,1836,35,30-34,1871,6.080573350112536
SIM,1957,49,25-29,2006,1
STAT,1933,48,30-34,1981,0.1411439057784069
STAT,1913,23,30-34,1936,33.40800500675159
SIM,1973,25,15-19,1998,3
STAT,1879,49,50-100,1928,0.28977337121140584
STAT,1959,27,50-100,1986,1.5090509225941224
STAT,1980,34,35-39,2014,14.904106567854836
SIM,1918,20,20-24,1938,113
STAT,1899,28,50-100,1927,1.0078385989677898
STAT,1859,29,35-39,1888,8.894304546728177
STAT,1863,62,na,1925,1844.3820650614557
SIM,1992,20,50-100,2012,1
STAT,1846,62,na,1908,1889.4757323225572
STAT,1919,42,40-44,1961,0.31273673376465655
STAT,1846,20,15-19,1866,4.269136001871698
STAT,1911,42,35-39,1953,0.22198870723617
SIM,1854,39,35-39,1893,19
STAT,1882,32,na,1914,2689.8856130604227
STAT,1859,27,15-19,1886,0.4242902833601929
SIM,1893,13,na,1906,3788
SIM,1928,24,25-29,1952,283
STAT,1853,50,20-24,1903,7.45244308498969E-4
SIM,1867,27,15-19,1894,1
SIM,1844,35,30-34,1879,11
SIM,1835,36,35-39,1871,16
SIM,1933,68,na,2001,5209
STAT,1895,16,25-29,1911,8.533420878620147
STAT,1901,43,25-29,1944,0.07156261884479616
STAT,1972,24,45-49,1996,1.6669223732832261
STAT,1937,45,na,1982,4302.765710340976
STAT,1965,25,15-19,1990,1.0223941395079639
STAT,1811,103,na,1914,0.0738949623160736
SIM,1776,78,na,1854,398
SIM,1839,18,na,1857,2646
STAT,1916,46,na,1962,4359.856643003284
SIM,1797,77,na,1874,251
STAT,1807,49,25-29,1856,0.23007512913464148
STAT,1882,21,30-34,1903,20.13889079974008
SIM,1976,21,20-24,1997,179
SIM,1836,44,na,1880,1574
SIM,1833,48,30-34,1881,1
STAT,1887,25,30-34,1912,32.78928470633863
STAT,1898,15,35-39,1913,0.8597870776764683
STAT,1841,39,50-100,1880,1.2596554162218987
STAT,1881,28,na,1909,2647.1575604876343
STAT,1906,47,25-29,1953,0.05442357851841318
STAT,1829,46,40-44,1875,0.17700215695242327
STAT,1940,33,35-39,1973,10.911524561409026
SIM,1887,13,na,1900,3951
STAT,1900,28,50-100,1928,1.0207692291399952
STAT,1910,45,25-29,1955,0.05744363964397678
SIM,1922,0,na,1922,5838
STAT,1937,46,40-44,1983,0.18424737518230638
SIM,1841,39,25-29,1880,5
STAT,1925,37,50-100,1962,0.581358420637854
STAT,1988,16,40-44,2004,2.309284945883676
SIM,1914,47,25-29,1961,1
STAT,1945,32,40-44,1977,5.028702707720756
STAT,1968,21,20-24,1989,160.86023779323247
STAT,1890,49,45-49,1939,0.18380089573128602
SIM,1818,48,35-39,1866,3
SIM,1867,36,na,1903,2240
SIM,1953,32,40-44,1985,1
SIM,1922,20,40-44,1942,5
STAT,1863,27,35-39,1890,9.736831738872043
STAT,1928,71,na,1999,4126.721086338994
STAT,1833,39,25-29,1872,2.499607196156553
STAT,1873,24,na,1897,2769.737515036706
SIM,1876,13,na,1889,2947
STAT,1896,89,na,1985,608.4057254184587
SIM,1931,35,na,1966,6118
STAT,1928,5,na,1933,5846.620598756761
STAT,1975,39,25-29,2014,1.5410880168841994
SIM,1975,22,na,1997,5665
STAT,1943,45,na,1988,4698.905582147156
SIM,1952,34,na,1986,4648
SIM,1973,8,na,1981,5498
SIM,1892,68,na,1960,2788
STAT,1939,35,15-19,1974,0.022903173107822836
STAT,1950,32,45-49,1982,2.1887049315329783
SIM,1823,34,na,1857,2367
SIM,1914,29,25-29,1943,9
STAT,2008,3,na,2011,7103.787903186294
STAT,1839,16,40-44,1855,0.19087231743429425
STAT,1929,82,na,2011,2411.6428798197394
SIM,1906,38,30-34,1944,1
STAT,1922,46,na,1968,4880.62748154382
SIM,1809,46,35-39,1855,1
SIM,1895,25,30-34,1920,52
STAT,1963,18,40-44,1981,2.05008590713244
STAT,1914,20,40-44,1934,3.8287053989769753
STAT,1862,25,30-34,1887,24.973208549377567
STAT,1983,14,na,1997,6410.513239932405
SIM,1834,45,50-100,1879,2
STAT,1867,50,50-100,1917,0.01650688821852122
STAT,1895,34,25-29,1929,15.254626168306148
STAT,1842,50,45-49,1892,0.011328152926911805
STAT,1826,45,50-100,1871,0.18138774803412272
SIM,1866,5,na,1871,2908
STAT,1829,81,na,1910,396.15289406346255
STAT,1869,50,na,1919,2440.9790591581786
STAT,1890,30,25-29,1920,14.559400590844993
STAT,1863,39,40-44,1902,4.372923579064069
SIM,1855,21,50-100,1876,1
STAT,1867,24,na,1891,2532.3596261461826
STAT,1963,36,40-44,1999,2.2632714088292554
STAT,1929,56,na,1985,5290.9012350609955
SIM,1781,93,na,1874,14
STAT,1941,30,45-49,1971,1.909266855680333
STAT,1900,28,15-19,1928,0.7239817138484502
STAT,1875,28,na,1903,2836.1382083212466
SIM,1863,36,40-44,1899,13
STAT,1953,47,25-29,2000,0.07702768172469592
SIM,1946,34,na,1980,4513
STAT,1960,23,50-100,1983,0.9919594789957011
STAT,1908,41,15-19,1949,0.0016512218862366186
STAT,1959,48,35-39,2007,0.20188119976770352
STAT,1855,36,40-44,1891,3.742725284358157
STAT,1864,104,na,1968,0.5586499789954023
STAT,1887,43,30-34,1930,1.4761514048601512
SIM,1973,37,na,2010,5393
SIM,1871,39,40-44,1910,14
STAT,1906,29,25-29,1935,70.67904158581045
STAT,1870,13,na,1883,2999.387174992408
STAT,1904,21,30-34,1925,29.607977521575442
SIM,1867,44,30-34,1911,1
STAT,1927,21,na,1948,5206.831012767982
STAT,1873,42,25-29,1915,0.7558438330853614
SIM,1868,35,50-100,1903,1
SIM,1843,57,na,1900,1609
STAT,1979,32,40-44,2011,6.338366765982792
SIM,1926,27,30-34,1953,77
SIM,1999,15,15-19,2014,140
STAT,1901,16,na,1917,4092.625646331045
STAT,1845,12,na,1857,2033.1952142609334
SIM,1851,52,na,1903,2532
SIM,1894,63,na,1957,2960
STAT,1849,41,35-39,1890,1.4098547371522423
STAT,1942,38,na,1980,4670.611461201247
STAT,1952,22,na,1974,5067.015593240552
STAT,1859,44,30-34,1903,1.042629320009218
SIM,1850,33,na,1883,1695
SIM,1961,49,na,2010,5472
STAT,1889,42,na,1931,3283.85071635498
STAT,1948,40,40-44,1988,0.34424581531744236
SIM,1881,42,25-29,1923,1
SIM,1985,28,35-39,2013,43
SIM,1909,19,40-44,1928,2
STAT,1918,27,30-34,1945,48.112258344618574
STAT,1860,29,na,1889,2211.408435977382
SIM,1858,25,na,1883,2663
SIM,1958,51,na,2009,5963
STAT,1871,52,30-34,1923,0.006797896635548457
STAT,1958,13,na,1971,5953.02414600063
SIM,1854,15,35-39,1869,3
STAT,1827,41,15-19,1868,0.018764371456707646
SIM,1932,42,na,1974,5458
STAT,1943,28,35-39,1971,18.44567729909055
STAT,1892,16,45-49,1908,0.09471677027784169
SIM,1919,60,na,1979,4906
STAT,1987,22,20-24,2009,183.79840564661964
SIM,1951,28,35-39,1979,46
SIM,1922,58,na,1980,4622
STAT,1944,32,50-100,1976,1.0467092055689071
SIM,1839,30,50-100,1869,1
STAT,1880,52,40-44,1932,0.012809299564861596
STAT,1846,15,35-39,1861,0.7210440321027344
SIM,1976,28,25-29,2004,96
STAT,1834,28,20-24,1862,13.937709281880466
SIM,1842,28,20-24,1870,25
STAT,1842,22,40-44,1864,2.022540764976874
SIM,1965,22,50-100,1987,2
SIM,1984,22,45-49,2006,2
STAT,1858,41,45-49,1899,1.353500881943235
STAT,1977,28,35-39,2005,23.500472535289344
SIM,1825,30,35-39,1855,15
SIM,1884,34,20-24,1918,4
SIM,1920,23,na,1943,3819
STAT,1989,24,50-100,2013,1.0905115667465077
STAT,1963,46,35-39,2009,0.19711057385013128
SIM,1970,22,30-34,1992,58
SIM,1953,10,na,1963,5699
STAT,1959,38,40-44,1997,2.3258181374328064
STAT,1911,22,15-19,1933,5.831161157884123
STAT,1979,15,35-39,1994,6.6711343222738355
SIM,1919,22,25-29,1941,7
STAT,1820,44,50-100,1864,1.2160025764237994
SIM,1965,15,15-19,1980,114
SIM,1841,34,50-100,1875,2
STAT,1902,17,25-29,1919,9.240326149400445
SIM,1905,35,45-49,1940,1
STAT,1876,34,20-24,1910,3.1970833971364527
STAT,1900,45,30-34,1945,0.08831097372566174
STAT,1881,29,50-100,1910,0.7069709863542014
STAT,1950,44,15-19,1994,0.002170480223267434
STAT,1914,43,35-39,1957,0.23001435706654458
STAT,1891,2,na,1893,3802.0792309109643
SIM,1825,38,30-34,1863,3
SIM,1955,45,40-44,2000,1
STAT,1926,40,20-24,1966,0.02518999532794674
STAT,1962,22,30-34,1984,42.63949889919341
STAT,1906,53,na,1959,3650.3574458358935
STAT,1847,47,na,1894,1723.0790656971699
STAT,1919,26,na,1945,4686.139818881467
STAT,1909,9,na,1918,4495.511928410459
SIM,1836,26,50-100,1862,1
SIM,1901,50,na,1951,3723
STAT,1869,4,na,1873,3318.8322549103714
STAT,1985,18,15-19,2003,74.4678375703465
STAT,1939,40,na,1979,4472.77190697661
SIM,1962,20,15-19,1982,7
STAT,1839,109,na,1948,5.642230104105324E-4
STAT,1884,33,50-100,1917,1.0403136795092587
STAT,1941,28,50-100,1969,1.187999947204607
SIM,1912,21,30-34,1933,42
SIM,1971,33,na,2004,5614
STAT,1882,24,35-39,1906,6.536662243110969
STAT,1957,15,15-19,1972,69.09035528030877
STAT,1841,56,na,1897,1813.418519049369
STAT,1813,54,35-39,1867,0.02626517084840031
STAT,1879,15,30-34,1894,1.9295663595914168
SIM,1887,21,25-29,1908,125
STAT,1897,45,45-49,1942,0.20747563769188743
SIM,1869,62,na,1931,1400
STAT,1910,19,40-44,1929,0.3184590692229076
STAT,1898,34,40-44,1932,6.7059816681841395
STAT,1881,50,na,1931,2431.1959762692018
STAT,1879,21,25-29,1900,69.19030563420756
STAT,1960,18,25-29,1978,65.11532752444768
STAT,1817,38,30-34,1855,18.65758312392738
SIM,1977,24,na,2001,5806
SIM,1993,18,15-19,2011,77
STAT,1876,26,50-100,1902,0.76575838623576
SIM,1879,86,na,1965,337
STAT,1869,26,25-29,1895,47.43865972732426
STAT,1976,36,na,2012,5981.457823227565
STAT,1832,79,na,1911,476.29365193519885
SIM,1916,38,25-29,1954,1
STAT,1856,55,na,1911,1820.51691774094
SIM,1826,36,25-29,1862,7
STAT,1818,44,na,1862,1280.0653178217356
SIM,1851,20,35-39,1871,15
SIM,1874,26,45-49,1900,1
STAT,1927,32,20-24,1959,3.46190884405433
STAT,1913,18,50-100,1931,0.08821660492113463
STAT,1945,40,na,1985,4879.197490984166
STAT,1835,43,30-34,1878,0.8487481288858301
STAT,1994,18,25-29,2012,72.144913989796
STAT,2006,5,na,2011,7022.702288298983
STAT,1952,30,20-24,1982,3.44236194547801
STAT,1891,24,45-49,1915,0.9883760519565271
STAT,1855,39,45-49,1894,1.6791769608197924
SIM,1935,32,20-24,1967,7
STAT,1969,43,35-39,2012,0.3012087720101086
SIM,1774,80,na,1854,360
SIM,1959,18,25-29,1977,81
STAT,1853,31,15-19,1884,0.14753193731567282
STAT,1912,47,50-100,1959,0.2510941027429348
SIM,1906,28,na,1934,3614
SIM,1843,43,30-34,1886,5
SIM,1812,49,45-49,1861,2
STAT,1810,64,na,1874,1136.6165074258015
SIM,1868,42,25-29,1910,2
STAT,1835,100,na,1935,0.6616744321546926
STAT,1886,38,50-100,1924,1.4871320099638021
SIM,2003,6,na,2009,6667
STAT,1801,87,na,1888,67.32180781995922
SIM,1986,17,30-34,2003,33
STAT,1925,26,na,1951,5122.113247364687
STAT,1830,44,25-29,1874,0.5988529125207889
SIM,1863,8,na,1871,3031
SIM,1901,6,na,1907,4524
STAT,1917,35,30-34,1952,2.205468643146689
STAT,1885,34,30-34,1919,19.925970971174564
SIM,1893,34,30-34,1927,51
STAT,1829,49,45-49,1878,0.2345006614255776
STAT,1908,38,25-29,1946,1.0599374819448528
STAT,1841,33,45-49,1874,1.8616844188854047
STAT,1922,87,na,2009,1256.365914801147
STAT,1881,50,35-39,1931,0.009720705980002022
STAT,1849,49,30-34,1898,0.07346010550374243
STAT,1843,20,35-39,1863,7.4561726635624685
STAT,1920,22,25-29,1942,118.45716134210993
SIM,1889,19,15-19,1908,17
STAT,1852,93,na,1945,27.55409373137591
STAT,1845,17,40-44,1862,0.15577739672901067
STAT,1840,18,35-39,1858,0.566550417872789
SIM,1799,72,na,1871,319
STAT,1843,28,30-34,1871,30.872336833767818
STAT,1928,30,15-19,1958,0.1856397359865082
STAT,1949,49,35-39,1998,0.17893875629629125
SIM,1895,17,na,1912,3984
STAT,1923,25,45-49,1948,2.3037175367285485
SIM,1863,20,25-29,1883,134
SIM,1961,22,20-24,1983,161
STAT,1864,13,na,1877,2783.7010064670044
SIM,1960,30,20-24,1990,10
STAT,1970,32,20-24,2002,3.591780328137947
SIM,1928,34,50-100,1962,4
STAT,1973,35,40-44,2008,2.3058898002120936
STAT,1876,37,25-29,1913,3.4348213485847867
SIM,1942,28,25-29,1970,101
STAT,1913,45,40-44,1958,0.17852151672123465
STAT,1956,18,na,1974,5618.996686155773
SIM,1955,49,na,2004,6346
STAT,1815,43,45-49,1858,3.2427381707528156
SIM,1851,28,30-34,1879,2
STAT,1916,83,na,1999,1750.5223225585053
SIM,1902,32,25-29,1934,32
STAT,1902,35,50-100,1937,0.43621615273794717
STAT,1996,9,na,2005,6590.691261257981
SIM,1912,28,na,1940,3770
SIM,1816,38,20-24,1854,2
STAT,1934,28,25-29,1962,102.18587815422757
STAT,1824,44,na,1868,1657.953794618302
STAT,1899,32,35-39,1931,16.011604651601655
SIM,1874,49,na,1923,2478
STAT,1881,44,40-44,1925,2.4699386820507017
STAT,1855,20,25-29,1875,57.73145610974765
SIM,1857,41,35-39,1898,5
SIM,1903,85,na,1988,1288
STAT,1804,54,25-29,1858,0.01566114890882169
STAT,1887,47,na,1934,2896.205349078839
SIM,1870,87,na,1957,320
STAT,1850,47,15-19,1897,4.09858338885286E-4
STAT,1844,17,50-100,1861,0.05208995815644315
SIM,1945,1,na,1946,4926
STAT,1953,22,20-24,1975,155.74687705937552
STAT,1818,36,25-29,1854,5.353926925670586
STAT,1809,53,30-34,1862,0.014093217038568553
STAT,1833,54,20-24,1887,5.179031189455158E-4
STAT,1907,20,50-100,1927,0.6965491513997635
STAT,1883,85,na,1968,633.7580653310054
STAT,1859,15,45-49,1874,0.07053542149151648
STAT,1883,114,na,1997,5.230067286600448E-4
SIM,1885,1,na,1886,3480
STAT,1821,39,35-39,1860,14.462669384432926
STAT,1891,46,50-100,1937,0.19816150927967985
SIM,1889,17,na,1906,4084
STAT,1978,17,40-44,1995,2.202933248655499
SIM,1861,25,20-24,1886,14
SIM,1868,18,30-34,1886,1
SIM,1909,43,35-39,1952,1
STAT,1884,31,45-49,1915,1.9964682858168634
STAT,1877,32,15-19,1909,0.17095256916667992
STAT,1813,48,40-44,1861,0.5588813272645137
STAT,1869,41,20-24,1910,0.1782938679003923
STAT,1998,0,na,1998,6711.7020657379635
STAT,1940,25,15-19,1965,0.8317646841360378
SIM,1873,31,40-44,1904,8
STAT,1954,5,na,1959,5609.37053036642
STAT,1926,43,25-29,1969,0.10141276763507912
SIM,1892,19,20-24,1911,25
SIM,1919,16,30-34,1935,24
STAT,1855,54,40-44,1909,0.008711592862840097
SIM,1962,27,na,1989,5335
STAT,1865,66,na,1931,1706.629264294219
SIM,1813,41,na,1854,1454
SIM,1812,65,na,1877,667
STAT,1879,18,35-39,1897,0.659472520418345
STAT,1932,39,15-19,1971,0.02972017216987951
STAT,1910,90,na,2000,646.7535548585425
SIM,1906,16,20-24,1922,49
STAT,1853,25,20-24,1878,13.727238383786105
SIM,1880,18,na,1898,3584
STAT,1895,16,50-100,1911,0.0737759581239321
STAT,1885,80,na,1965,1048.11786550026
STAT,1884,19,20-24,1903,20.106037646140344
SIM,1977,17,30-34,1994,37
STAT,1898,37,45-49,1935,3.109201996503695
STAT,1987,25,25-29,2012,109.002250597484
SIM,1972,9,na,1981,5837
STAT,1912,53,na,1965,3991.7208631715916
SIM,1878,21,15-19,1899,9
SIM,1918,42,30-34,1960,1
STAT,1893,19,30-34,1912,2.312538372057816
STAT,1890,67,na,1957,2297.0479303259176
STAT,1900,48,35-39,1948,0.12487271787830474
STAT,1888,15,40-44,1903,0.2492744521387986
STAT,1969,17,30-34,1986,17.571722650402467
STAT,1857,18,15-19,1875,6.2324062205485795
SIM,1892,31,45-49,1923,4
STAT,1835,26,15-19,1861,0.3729373911292634
STAT,1920,38,40-44,1958,1.8887961651271399
STAT,1933,21,na,1954,5609.481483060267
STAT,1964,35,50-100,1999,0.6298147525253232
STAT,1930,45,50-100,1975,0.34540438433582854
STAT,1960,43,15-19,2003,0.0023950267821482916
SIM,1864,34,35-39,1898,19
STAT,1895,31,20-24,1926,4.0771069782148315
SIM,1875,62,na,1937,2270
SIM,1938,27,20-24,1965,39
SIM,1887,37,40-44,1924,14
SIM,1880,44,30-34,1924,2
STAT,1814,110,na,1924,1.7230190807121837E-4
STAT,1828,110,na,1938,1.834054271801518E-4
SIM,1859,33,50-100,1892,3
STAT,1885,37,35-39,1922,8.141705403446261
SIM,1969,35,25-29,2004,6
SIM,1875,29,30-34,1904,3
SIM,1893,37,35-39,1930,21
SIM,1926,33,25-29,1959,16
STAT,1966,39,15-19,2005,0.028456711884490015
STAT,1929,4,na,1933,5944.790818624971
STAT,1958,48,20-24,2006,0.017374713617763535
SIM,1946,18,15-19,1964,55
STAT,1960,15,20-24,1975,203.88852875516687
STAT,1848,43,40-44,1891,2.3726536667873885
SIM,1939,15,na,1954,4699
STAT,1903,11,na,1914,4251.404219603684
SIM,1850,25,45-49,1875,1
STAT,1908,35,20-24,1943,0.28790064471611837
SIM,1856,43,40-44,1899,1
STAT,1872,44,30-34,1916,1.3142553722527477
SIM,1834,49,na,1883,1769
STAT,1888,23,na,1911,3198.451014717704
SIM,1982,27,50-100,2009,3
SIM,1976,25,20-24,2001,54
SIM,1866,41,45-49,1907,3
STAT,1954,55,na,2009,5280.622725330498
SIM,1859,30,45-49,1889,7
STAT,1854,29,na,1883,2009.0889743130638
SIM,1948,33,45-49,1981,6
STAT,1853,19,50-100,1872,0.05798668485261994
STAT,1863,45,35-39,1908,0.1426838781527789
STAT,1938,18,15-19,1956,51.67316365461055
STAT,1842,25,45-49,1867,1.07193889565776
STAT,1856,34,35-39,1890,8.840029580858488
STAT,1914,35,15-19,1949,0.0223478130753776
STAT,1948,43,45-49,1991,0.2280619284519554
STAT,1869,28,na,1897,2657.8096683749495
STAT,1843,82,na,1925,468.15992957183477
STAT,1879,37,40-44,1916,5.274973536535639
SIM,1828,40,na,1868,2327
SIM,1982,25,15-19,2007,2
SIM,1836,75,na,1911,361
SIM,1944,32,30-34,1976,6
SIM,1883,39,30-34,1922,20
STAT,1904,46,45-49,1950,0.22124144170411036
STAT,1927,35,25-29,1962,1.4148776352648782
STAT,1830,41,20-24,1871,0.1548099135211617
STAT,1870,46,50-100,1916,0.2802183996440228
STAT,1783,107,na,1890,0.006210999960339558
STAT,1964,41,25-29,2005,0.10802271810782216
STAT,1863,31,na,1894,2417.8915490380655
SIM,1916,35,20-24,1951,1
STAT,1961,30,30-34,1991,23.9719436014927
SIM,1876,44,na,1920,2517
SIM,1831,38,na,1869,1670
STAT,1901,19,30-34,1920,2.562645404492007
STAT,1968,29,50-100,1997,1.4394856581691577
STAT,1894,23,na,1917,3497.800620769069
STAT,1838,98,na,1936,2.813918968324048
SIM,1845,52,na,1897,1881
STAT,1820,47,35-39,1867,0.145264387712103
SIM,1847,22,35-39,1869,3
STAT,1939,24,50-100,1963,0.7624060069053945
SIM,1861,76,na,1937,327
STAT,1906,49,15-19,1955,3.7178335177679567E-4
SIM,1860,33,20-24,1893,2
STAT,1839,22,35-39,1861,5.946207811084792
STAT,1834,34,15-19,1868,0.16304690117587287
STAT,1990,18,50-100,2008,0.6189988793753771
STAT,1918,33,25-29,1951,11.284314670458011
SIM,1867,40,50-100,1907,1
SIM,1945,15,na,1960,4776
STAT,1875,39,30-34,1914,6.29205942729512
SIM,1830,53,na,1883,1507
STAT,1849,100,na,1949,0.8228473304179164
STAT,1935,30,50-100,1965,1.3222794676375895
STAT,1826,43,20-24,1869,0.11727734422896634
STAT,1853,47,30-34,1900,0.09592660884722287
SIM,1825,43,50-100,1868,1
SIM,1826,33,20-24,1859,2
STAT,1975,8,na,1983,5983.475107155569
STAT,1874,33,40-44,1907,5.10198012681331
STAT,1980,28,40-44,2008,7.4960592754693005
STAT,1862,31,25-29,1893,10.016370957538125
STAT,1843,36,15-19,1879,0.0664636888504583
STAT,1914,40,30-34,1954,0.14728747856285296
STAT,1795,76,na,1871,328.4545049744569
STAT,1969,40,30-34,2009,0.1920688406317727
SIM,1825,38,na,1863,1777
SIM,1968,18,35-39,1986,8
STAT,1859,97,na,1956,5.754468259572299
STAT,1936,32,30-34,1968,17.67109326862615
STAT,1862,53,35-39,1915,0.008250017354869996
SIM,1962,38,40-44,2000,5
STAT,1860,24,15-19,1884,3.1178748553309523
STAT,1877,20,45-49,1897,0.8420907343518438
STAT,1822,54,45-49,1876,0.025369136242528574
SIM,1882,44,na,1926,3159
SIM,1960,33,25-29,1993,26
STAT,1857,31,na,1888,2180.60931821
STAT,1773,92,na,1865,20.093085783020562
STAT,1804,51,20-24,1855,0.0034655744286273735
STAT,1903,26,40-44,1929,4.940937658842118
STAT,1953,25,25-29,1978,92.36619906073604
SIM,1978,32,30-34,2010,4
SIM,1857,49,30-34,1906,1
SIM,1966,29,25-29,1995,201
STAT,1861,16,15-19,1877,6.582966910882777
STAT,1852,33,20-24,1885,2.6113896091908173
STAT,1958,29,25-29,1987,100.09817528325627
STAT,1935,40,30-34,1975,0.208798200349677
SIM,1903,21,20-24,1924,3
STAT,1793,104,na,1897,0.012559396813755612
SIM,1835,35,20-24,1870,1
STAT,1836,41,25-29,1877,0.7044440461756732
SIM,1961,25,25-29,1986,186
SIM,1911,26,40-44,1937,9
STAT,1844,98,na,1942,2.7171533341258027
STAT,1846,50,50-100,1896,0.01583731675668807
STAT,1885,42,15-19,1927,0.015877051399020244
STAT,1956,17,20-24,1973,207.0339063397548
STAT,1850,98,na,1948,3.3441978600053375
STAT,1794,60,na,1854,1268.9999999999998
STAT,1875,31,50-100,1906,1.0971757533321556
STAT,1913,48,45-49,1961,0.2442589860723625
SIM,1845,28,50-100,1873,1
STAT,1891,80,na,1971,1424.1259136623264
SIM,1942,25,20-24,1967,34
STAT,1827,35,20-24,1862,1.1869223149353243
STAT,1944,23,25-29,1967,115.06266065010115
SIM,1898,59,na,1957,3399
SIM,1958,38,30-34,1996,7
STAT,1955,15,50-100,1970,0.5742817134596366
SIM,1916,58,na,1974,4172
STAT,1828,50,30-34,1878,0.005508454147649911
SIM,1805,83,na,1888,102
SIM,1900,74,na,1974,2086
STAT,1994,15,20-24,2009,225.89950676397703
STAT,1949,46,30-34,1995,0.12476224804055198
SIM,1838,44,35-39,1882,2
STAT,1859,47,35-39,1906,0.12810264146564662
STAT,1973,38,45-49,2011,1.0472128043733393
STAT,1823,51,25-29,1874,0.0034386325216160018
STAT,1899,48,15-19,1947,3.5225938394725745E-4
STAT,1891,21,40-44,1912,2.981147682710967
STAT,1876,40,15-19,1916,0.016641071720774843
STAT,1911,17,35-39,1928,0.9698660618707746
STAT,1952,33,25-29,1985,13.02120590905377
STAT,1930,41,25-29,1971,0.1086007616240351
STAT,1934,25,20-24,1959,28.377497757365525
SIM,1947,8,na,1955,6092
SIM,1952,23,25-29,1975,1
STAT,1837,17,na,1854,2184.663556451044
SIM,1960,27,30-34,1987,6
STAT,1789,76,na,1865,302.6466309541308
SIM,1972,36,45-49,2008,1
STAT,1945,40,25-29,1985,0.09381448735045798
STAT,1978,23,25-29,2001,145.9115498863522
STAT,1953,6,na,1959,5488.135735781401
SIM,1968,37,30-34,2005,5
SIM,1809,76,na,1885,567
STAT,1889,35,45-49,1924,2.862805555305001
STAT,1815,103,na,1918,0.0796338497205824
STAT,1825,29,25-29,1854,175.08541727792755
SIM,1874,18,na,1892,2805
STAT,1943,14,na,1957,4805.8868906587095
SIM,1796,61,na,1857,859
STAT,1847,29,45-49,1876,1.0121653865648557
STAT,1825,40,35-39,1865,2.8059734750014553
STAT,1936,40,15-19,1976,0.0017609550322471971
SIM,1928,19,45-49,1947,3
STAT,1797,71,na,1868,738.5101619181321
STAT,1854,20,na,1874,2076.4123602476925
SIM,1872,19,35-39,1891,1
SIM,1885,55,na,1940,2753
SIM,1862,42,20-24,1904,1
SIM,1842,40,45-49,1882,4
STAT,1821,36,30-34,1857,12.451789497750854
STAT,1965,31,45-49,1996,2.3122946731636076
STAT,1952,27,30-34,1979,54.42254597146059
STAT,1840,47,20-24,1887,0.009707474946536124
SIM,1986,23,25-29,2009,307
SIM,1886,0,na,1886,4022
STAT,1997,1,na,1998,6635.48607113237
SIM,1931,66,na,1997,4801
SIM,1871,42,30-34,1913,2
STAT,1957,22,50-100,1979,1.0044927757416198
STAT,1869,103,na,1972,1.8883082813761085
SIM,1852,48,35-39,1900,1
SIM,1879,30,30-34,1909,24
SIM,1833,40,35-39,1873,1
STAT,1833,34,50-100,1867,0.8201116594749455
STAT,1961,27,40-44,1988,6.979654769842689
SIM,1919,19,35-39,1938,14
STAT,1969,15,40-44,1984,2.017496401642943
STAT,1956,50,na,2006,5782.815467596892
SIM,1833,29,25-29,1862,11
SIM,1939,19,20-24,1958,324
STAT,1863,42,30-34,1905,1.1587135715495203
STAT,1965,47,15-19,2012,5.520431140740276E-4
SIM,1929,36,45-49,1965,1
STAT,1946,46,15-19,1992,4.916600111502948E-4
STAT,1948,44,50-100,1992,0.16070316665277687
STAT,1976,34,50-100,2010,1.2977089125698897
SIM,1846,29,35-39,1875,1
SIM,1865,6,na,1871,3542
STAT,1907,30,45-49,1937,1.713853087494713
SIM,1911,12,na,1923,5177
SIM,2002,7,na,2009,6943
STAT,1949,24,20-24,1973,149.63358284067235
STAT,1912,22,na,1934,4224.67333040348
STAT,1921,36,35-39,1957,3.1184525052811205
STAT,1823,68,na,1891,865.399682109288
SIM,1977,15,40-44,1992,2
SIM,1892,25,15-19,1917,1
STAT,1833,23,45-49,1856,0.6974009645140011
STAT,1969,37,40-44,2006,2.223375187582126
STAT,1851,19,25-29,1870,5.399329543734061
STAT,1926,37,30-34,1963,2.570021120931118
SIM,1858,56,na,1914,2300
STAT,1939,41,45-49,1980,0.2001688177754396
STAT,1891,22,50-100,1913,0.5816388736639871
STAT,1808,50,45-49,1858,0.07200926849417622
STAT,1897,23,50-100,1920,0.6273307111479249
STAT,1944,62,na,2006,4320.138332873622
STAT,1891,12,na,1903,3683.479712831015
SIM,1904,30,na,1934,4028
STAT,1916,15,na,1931,4751.46785621725
STAT,1859,66,na,1925,1506.7497494589995
SIM,1980,21,30-34,2001,90
SIM,1883,20,na,1903,2285
SIM,1948,30,40-44,1978,14
STAT,1867,92,na,1959,73.0554732546446
STAT,1868,16,50-100,1884,0.05563180049016693
STAT,1935,23,15-19,1958,8.36727437028582
STAT,1952,49,30-34,2001,0.12748432927802913
SIM,1866,82,na,1948,492
SIM,1902,26,30-34,1928,8
STAT,1835,46,35-39,1881,0.09327860584716402
SIM,1907,36,25-29,1943,1
STAT,1808,51,na,1859,1625.888861891214
SIM,1957,24,20-24,1981,331
SIM,1915,30,45-49,1945,2
STAT,1838,29,35-39,1867,10.481622456844097
STAT,1909,47,40-44,1956,0.16737981940829882
STAT,1924,41,na,1965,5104.057967898829
SIM,1929,22,na,1951,4631
STAT,2007,4,na,2011,7064.142411314755
STAT,1962,30,15-19,1992,0.19390785280072015
STAT,1912,31,30-34,1943,17.98144841407589
STAT,1873,19,45-49,1892,0.0765690709984901
STAT,1873,24,50-100,1897,0.4775683641251503
SIM,1960,49,30-34,2009,1
SIM,1841,90,na,1931,43
STAT,1839,41,40-44,1880,2.0926101931883774
STAT,1884,107,na,1991,0.35419022760465335
STAT,1819,50,20-24,1869,0.00142208310678086
SIM,1950,39,na,1989,4705
STAT,1879,80,na,1959,914.5306179066739
STAT,1884,25,15-19,1909,0.520830834009804
SIM,1847,41,40-44,1888,5
STAT,1822,53,30-34,1875,0.010614775370066167
STAT,1951,21,50-100,1972,0.9075301451393765
SIM,1897,35,45-49,1932,12
SIM,1977,37,40-44,2014,6
SIM,1926,30,20-24,1956,4
STAT,1920,16,30-34,1936,15.813705904248852
SIM,1946,21,40-44,1967,1
STAT,1976,7,na,1983,6060.240733436656
STAT,1894,36,30-34,1930,7.9446926576430545
STAT,1865,31,40-44,1896,4.534086114775008
STAT,1878,30,na,1908,2898.5116319573285
STAT,1918,30,20-24,1948,3.0146287871348876
SIM,1995,12,na,2007,6764
SIM,1814,91,na,1905,22
STAT,1868,52,25-29,1920,0.003906362348063033
STAT,1810,95,na,1905,7.570310698500423
STAT,1831,53,40-44,1884,0.008413360517876965
STAT,1922,40,50-100,1962,0.1559793405774017
SIM,1902,5,na,1907,4365
STAT,1910,27,na,1937,4179.051034098002
STAT,1931,47,15-19,1978,5.685491031930252E-4
SIM,1926,49,40-44,1975,2
STAT,1938,21,40-44,1959,3.843508589738045
STAT,1898,40,35-39,1938,0.19810350269674637
SIM,1944,39,na,1983,4596
STAT,1880,35,25-29,1915,3.555401129376356
SIM,1924,88,na,2012,132
SIM,1838,22,25-29,1860,61
SIM,1847,13,na,1860,3051
SIM,1952,20,20-24,1972,7
STAT,1893,47,na,1940,3267.1914790376177
STAT,1841,87,na,1928,156.64059995292442
STAT,1930,41,na,1971,5648.216801052266
SIM,1849,48,na,1897,2511
SIM,1887,18,35-39,1905,1
STAT,1986,27,30-34,2013,64.71003936276942
STAT,1852,36,25-29,1888,2.7577627262764555
SIM,1934,37,30-34,1971,8
STAT,1851,30,35-39,1881,8.53393115235579
SIM,1941,23,50-100,1964,2
STAT,1904,43,40-44,1947,0.2569783778957226
STAT,1847,78,na,1925,601.1998501681607
STAT,1977,25,30-34,2002,61.414713428075046
SIM,1803,88,na,1891,61
STAT,1904,27,na,1931,3954.9921218149448
STAT,1804,53,50-100,1857,0.06813345564017355
SIM,1835,90,na,1925,15
SIM,1894,38,50-100,1932,3
STAT,1981,26,35-39,2007,24.343272637922478
SIM,1829,39,45-49,1868,7
STAT,1940,49,15-19,1989,4.464800466148773E-4
STAT,1973,41,35-39,2014,0.31279104883514536
SIM,1860,36,25-29,1896,3
STAT,1862,33,15-19,1895,0.13811015435643803
STAT,1820,88,na,1908,80.57169642756483
SIM,1828,49,na,1877,2047
STAT,1889,29,15-19,1918,0.6408103294890675
STAT,1925,26,25-29,1951,89.99605736560879
STAT,1842,19,15-19,1861,5.795475464042914
SIM,1943,37,40-44,1980,3
STAT,1921,31,40-44,1952,5.0444671358141395
STAT,1944,20,20-24,1964,138.65426571827217
STAT,1897,20,30-34,1917,27.650738030694715
STAT,1898,84,na,1982,1199.0470668646105
STAT,2002,12,na,2014,6833.333878831403
STAT,1853,48,45-49,1901,0.232013724691016
STAT,1860,20,na,1880,2285.511427680524
STAT,1845,40,20-24,1885,0.11180579102060857
SIM,1850,19,15-19,1869,3
STAT,1861,36,35-39,1897,6.818472431210248
SIM,1861,48,45-49,1909,1
SIM,1790,73,na,1863,235
SIM,1985,25,30-34,2010,2
STAT,1877,85,na,1962,537.2590161131451
STAT,1930,33,40-44,1963,5.825424427858647
STAT,1951,40,na,1991,5318.789350625728
STAT,1874,36,45-49,1910,2.366535063685558
SIM,1889,48,na,1937,3561
STAT,1877,48,30-34,1925,0.11474297312172019
SIM,1834,46,25-29,1880,1
STAT,1935,37,40-44,1972,2.4170330613870417
STAT,1892,62,na,1954,2643.6930804631297
STAT,1859,40,50-100,1899,0.9810009689424873
SIM,1992,4,na,1996,7039
SIM,1952,39,40-44,1991,4
STAT,1872,48,na,1920,2574.361894896884
STAT,1826,46,25-29,1872,0.041989437970848524
STAT,1862,41,50-100,1903,1.0335683202121737
SIM,1878,18,25-29,1896,10
STAT,1822,51,40-44,1873,0.01953542076592172
STAT,1940,44,20-24,1984,0.021440740159631808
SIM,1784,73,na,1857,226
STAT,1917,32,50-100,1949,0.9991799597328457
STAT,1981,21,40-44,2002,5.445613306895672
STAT,1868,46,30-34,1914,0.10763343236066912
SIM,1824,35,45-49,1859,5
STAT,1840,107,na,1947,0.0037831452950689657
STAT,1944,39,40-44,1983,1.911396253595966
STAT,1905,77,na,1982,2229.3640591302187
SIM,1933,26,25-29,1959,146
STAT,1943,25,30-34,1968,48.204817312046764
SIM,1930,39,20-24,1969,2
STAT,1846,54,30-34,1900,0.005984418088871561
SIM,1833,26,20-24,1859,2
STAT,1847,26,40-44,1873,2.7904674236031353
STAT,1875,31,35-39,1906,12.12684879312605
STAT,1822,51,50-100,1873,0.028025112947467352
STAT,1855,17,35-39,1872,0.5553240363762715
SIM,1928,16,40-44,1944,3
STAT,1902,101,na,2003,21.435589988452225
SIM,1943,43,35-39,1986,1
STAT,1951,16,25-29,1967,59.56954619192809
STAT,1867,40,40-44,1907,2.4480233725823117
SIM,1954,37,50-100,1991,1
SIM,1880,49,na,1929,3094
STAT,1922,39,20-24,1961,0.3452733053635301
STAT,1907,2,na,1909,4526.223103788992
STAT,1979,12,na,1991,6241.755580867903
STAT,1889,32,40-44,1921,6.169279621682884
SIM,1870,31,25-29,1901,3
SIM,1847,44,45-49,1891,3
SIM,1897,32,40-44,1929,9
SIM,1961,40,na,2001,5592
STAT,1935,43,35-39,1978,0.32744431277023645
STAT,1938,62,na,2000,3961.765262063079
SIM,1883,31,35-39,1914,4
SIM,1884,70,na,1954,1401
STAT,1896,58,na,1954,3014.424353428569
STAT,1958,26,20-24,1984,27.80023594839159
STAT,1954,42,25-29,1996,0.10587439276861287
SIM,1879,55,na,1934,2406
STAT,1897,23,35-39,1920,8.977101425817045
STAT,1900,47,20-24,1947,0.010789041196515383
SIM,1820,34,30-34,1854,25
STAT,1839,44,45-49,1883,1.219304762908227
STAT,1874,74,na,1948,1311.1566442058063
STAT,1937,14,na,1951,4436.4320580105
SIM,1972,33,40-44,2005,9
SIM,2000,0,na,2000,6505
SIM,1925,6,na,1931,5649
STAT,1817,52,45-49,1869,0.03986927078882812
SIM,1864,56,na,1920,2349
SIM,1901,15,25-29,1916,22
STAT,1792,65,na,1857,1192.822315906736
STAT,1893,30,40-44,1923,6.376898434683297
STAT,1922,15,na,1937,4936.688376624067
SIM,1884,37,25-29,1921,10
STAT,1867,37,15-19,1904,0.060505890502000746
STAT,1881,59,na,1940,2163.3265024019984
STAT,1911,39,45-49,1950,0.7528772259482698
STAT,1973,16,45-49,1989,0.7457962283989851
SIM,1818,87,na,1905,178
SIM,1932,11,na,1943,5696
SIM,1889,38,20-24,1927,1
STAT,1894,42,25-29,1936,0.06607357367830102
SIM,1966,26,20-24,1992,49
SIM,1924,32,45-49,1956,1
STAT,1829,27,35-39,1856,19.887816459169358
STAT,1931,16,50-100,1947,0.5674442568145366
STAT,1921,33,30-34,1954,20.14112332377067
STAT,1826,79,na,1905,384.93123322958667
SIM,1875,40,40-44,1915,7
STAT,1802,69,na,1871,953.7142551557042
STAT,1909,33,na,1942,4152.1425125680835
STAT,1918,49,40-44,1967,0.19244734774011038
SIM,1908,23,na,1931,3940
STAT,1836,43,15-19,1879,0.014766088254162176
STAT,1873,16,40-44,1889,0.21682650628766756
SIM,1989,12,na,2001,6751
SIM,1946,0,na,1946,4814
STAT,1813,51,30-34,1864,0.019283930362338775
STAT,1912,34,35-39,1946,10.298302685618767
STAT,1858,35,15-19,1893,0.05103529424759851
STAT,1961,33,35-39,1994,13.879999179955663
SIM,1951,25,30-34,1976,90
SIM,1845,83,na,1928,536
STAT,1804,52,35-39,1856,0.03962698529644873
SIM,1837,27,35-39,1864,31
STAT,1966,17,15-19,1983,65.41665596721474
STAT,1851,16,20-24,1867,17.193997811956194
STAT,1981,23,30-34,2004,46.51808535534659
STAT,1859,46,20-24,1905,0.011062977887333646
STAT,1962,50,na,2012,5599.544234562365
SIM,1911,32,35-39,1943,25
SIM,1980,24,35-39,2004,2
SIM,1859,19,35-39,1878,1
STAT,1828,52,20-24,1880,6.563202853076293E-4
SIM,1986,20,20-24,2006,4
STAT,1846,93,na,1939,30.212688808188684
STAT,1946,37,50-100,1983,0.5536630915062583
SIM,1947,10,na,1957,6086
SIM,1974,17,15-19,1991,68
STAT,1844,45,30-34,1889,0.08224253395153894
STAT,1984,31,na,2015,6322.480219948036
STAT,1889,16,50-100,1905,0.06986551159458956
SIM,1914,23,na,1937,3905
STAT,1893,27,15-19,1920,0.6618243060195664
STAT,1903,32,35-39,1935,16.646640248232135
STAT,1926,21,15-19,1947,7.484253774370045
SIM,1943,23,15-19,1966,8
SIM,1897,16,50-100,1913,1
SIM,1948,7,na,1955,4471
STAT,1860,18,20-24,1878,18.90561928223939
SIM,1925,38,35-39,1963,2
SIM,1831,69,na,1900,931
STAT,1817,68,na,1885,1175.7328851931625
STAT,1862,47,40-44,1909,0.16595989108654052
SIM,1955,26,45-49,1981,4
STAT,1940,47,25-29,1987,0.06467225083268771
STAT,1872,50,25-29,1922,0.004163475630480466
SIM,1830,84,na,1914,207
STAT,1928,39,50-100,1967,0.6110323077884692
SIM,1852,68,na,1920,1360
STAT,1857,33,50-100,1890,0.8200559841920745
STAT,1870,8,na,1878,3099.4109046813132
SIM,1829,36,40-44,1865,14
SIM,1887,81,na,1968,1573
SIM,1935,22,na,1957,5858
SIM,1824,32,40-44,1856,2
SIM,1800,77,na,1877,594
SIM,1872,82,na,1954,744
SIM,1893,81,na,1974,953
STAT,1869,59,na,1928,2172.031684006239
SIM,1887,15,30-34,1902,2
STAT,1860,30,45-49,1890,1.6349815271074566
STAT,1917,38,35-39,1955,2.884977120543494
STAT,1953,42,40-44,1995,0.36288800679599226
SIM,1821,76,na,1897,311
SIM,1851,83,na,1934,772
SIM,1867,67,na,1934,1325
STAT,1778,100,na,1878,0.2884645344436637
SIM,1903,46,35-39,1949,1
STAT,1881,52,25-29,1933,0.003921728514582891
SIM,1934,21,15-19,1955,18
SIM,1946,24,45-49,1970,6
STAT,1885,36,20-24,1921,0.8916020667317243
SIM,1846,68,na,1914,867
SIM,1936,39,50-100,1975,1
STAT,1889,73,na,1962,1949.7717968036052
SIM,1907,34,50-100,1941,1
STAT,1916,32,45-49,1948,1.8750569555576189
SIM,1893,36,20-24,1929,4
STAT,1985,16,na,2001,6043.250070558859
STAT,1861,33,30-34,1894,16.680289859912197
STAT,1870,38,35-39,1908,8.007120543966565
STAT,1938,24,45-49,1962,1.2848853279813484
SIM,1969,32,20-24,2001,11
STAT,1915,25,50-100,1940,1.1797889886041242
SIM,1887,8,na,1895,3987
STAT,1929,18,40-44,1947,2.054730049571036
SIM,1841,20,40-44,1861,1
SIM,1846,24,40-44,1870,3
STAT,1975,20,50-100,1995,1.0057823595558255
STAT,1843,42,45-49,1885,1.546170195703476
STAT,1848,46,45-49,1894,0.2514684831928786
SIM,1879,33,35-39,1912,1
STAT,1871,30,20-24,1901,3.1283990056315205
STAT,1982,29,20-24,2011,29.741629726253333
SIM,1923,25,50-100,1948,1
STAT,1805,106,na,1911,0.004989599994959829
SIM,1815,76,na,1891,551
STAT,1779,83,na,1862,112.52878738099022
STAT,1768,103,na,1871,0.049168481422005555
STAT,1909,33,15-19,1942,0.14107927096025946
STAT,1831,27,50-100,1858,0.6668554102737498
STAT,1969,18,45-49,1987,0.7199219724502578
STAT,1947,26,45-49,1973,2.256544478520257
SIM,1870,47,40-44,1917,1
STAT,1942,22,45-49,1964,1.3616994487901963
SIM,1888,35,35-39,1923,3
STAT,1880,74,na,1954,1357.5391480946814
SIM,1855,26,40-44,1881,6
STAT,1838,24,40-44,1862,2.3087515892278505
SIM,1939,25,15-19,1964,1
STAT,1834,40,45-49,1874,1.689283856722169
STAT,1864,19,35-39,1883,0.5780370025224912
STAT,1875,59,na,1934,2317.7664382795806
STAT,1865,34,45-49,1899,1.800219586048806
STAT,1908,88,na,1996,862.7486316443453
STAT,1869,18,40-44,1887,0.20602393385894208
SIM,1969,1,na,1970,5835
STAT,1871,49,40-44,1920,0.19245522662962475
SIM,1892,37,na,1929,3750
STAT,1880,32,20-24,1912,3.3064929223229678
SIM,1917,33,15-19,1950,2
SIM,1851,42,45-49,1893,1
STAT,1933,20,45-49,1953,1.733442640190132
STAT,1864,33,20-24,1897,2.7735899629516503
SIM,1848,46,35-39,1894,1
STAT,1882,111,na,1993,0.011385767412435095
STAT,1879,23,na,1902,2841.1219445758848
SIM,1858,36,50-100,1894,3
STAT,1861,49,na,1910,2113.4453756724242
STAT,1884,37,40-44,1921,4.991320573758323
STAT,1977,17,45-49,1994,0.7789320814797097
STAT,1940,25,50-100,1965,1.1727365197363853
SIM,1834,31,35-39,1865,21
SIM,1859,44,45-49,1903,7
SIM,1965,1,na,1966,5627
STAT,1962,47,na,2009,5650.472509737077
SIM,1832,41,50-100,1873,4
STAT,1875,31,30-34,1906,20.907472376463307
STAT,1840,19,25-29,1859,5.816519806432981
SIM,1843,37,45-49,1880,5
SIM,1983,20,25-29,2003,324
SIM,1883,39,40-44,1922,22
STAT,1849,44,35-39,1893,1.3845595412241567
STAT,1883,50,20-24,1933,8.451522200421639E-4
SIM,1979,24,na,2003,5578
STAT,1880,16,15-19,1896,7.277216412512359
SIM,1823,38,30-34,1861,5
SIM,1916,17,na,1933,4791
SIM,1948,3,na,1951,4521
SIM,1878,26,na,1904,2735
SIM,1919,19,50-100,1938,1
STAT,1889,46,30-34,1935,0.13809567463688566
STAT,1824,36,30-34,1860,8.367486860094743
SIM,1808,63,na,1871,1213
STAT,1828,31,na,1859,1931.5832077838413
SIM,1886,40,50-100,1926,4
STAT,1844,35,45-49,1879,1.9768736956821682
SIM,1855,6,na,1861,2303
SIM,1894,32,45-49,1926,3
STAT,1874,52,20-24,1926,8.671717126176871E-4
STAT,1854,54,45-49,1908,0.011498089187397803
STAT,1895,61,na,1956,2834.12313765313
SIM,1981,25,20-24,2006,57
SIM,1852,35,45-49,1887,3
STAT,1863,52,45-49,1915,0.014566663622715
SIM,1827,34,na,1861,1566
SIM,1910,12,na,1922,4030
STAT,1895,30,45-49,1925,2.640612063970775
STAT,1856,111,na,1967,7.140685335467106E-4
SIM,1889,27,40-44,1916,7
STAT,1845,28,15-19,1873,0.36945569796170274
STAT,1864,45,15-19,1909,4.162855046244314E-4
SIM,1853,28,15-19,1881,3
SIM,1863,35,20-24,1898,1
SIM,1879,42,20-24,1921,2
SIM,1857,49,40-44,1906,1
STAT,1931,61,na,1992,5223.348536487329
STAT,1842,78,na,1920,601.2552337888443
STAT,1976,20,50-100,1996,1.01855372143936
STAT,1855,35,20-24,1890,0.6621411568047094
STAT,1908,15,30-34,1923,2.744731041289956
STAT,1887,25,15-19,1912,0.5907648709254358
STAT,1899,75,na,1974,2221.024139750455
SIM,1795,71,na,1866,699
SIM,1829,26,30-34,1855,3
STAT,1855,47,15-19,1902,3.3877116437719905E-4
STAT,1853,30,na,1883,2497.981971804184
STAT,1871,18,15-19,1889,6.817227662003763
STAT,1886,32,45-49,1918,2.1227741947712455
STAT,1919,37,na,1956,4663.286519814595
SIM,1938,16,20-24,1954,143
STAT,1819,70,na,1889,976.9378331196095
SIM,1825,33,35-39,1858,21
STAT,1873,43,15-19,1916,0.01615717893042978
STAT,1812,48,na,1860,1327.4009409093137
STAT,1915,23,na,1938,4343.638680834926
STAT,1793,107,na,1900,8.879984745559417E-4
STAT,1853,33,45-49,1886,1.7694392815309303
SIM,1997,4,na,2001,6611
STAT,1879,39,25-29,1918,3.434568115334353
STAT,1898,44,30-34,1942,0.12283682548949039
STAT,1966,16,30-34,1982,17.57417125912917
SIM,1983,28,35-39,2011,31
SIM,1912,9,na,1921,4220
STAT,1869,40,45-49,1909,1.6895352191213846
SIM,1901,49,25-29,1950,1
SIM,1894,64,na,1958,2877
STAT,1803,51,35-39,1854,0.03187143088937304
STAT,1890,35,15-19,1925,0.0799367084144481
SIM,1872,4,na,1876,3516
STAT,1847,49,30-34,1896,0.07292802932795567
STAT,1952,23,na,1975,5065.343478094787
SIM,1887,39,25-29,1926,1
STAT,1889,2,na,1891,3792.085911395197
STAT,1964,38,na,2002,5628.142510336278
STAT,1847,16,30-34,1863,1.5397493228242296
STAT,1959,45,40-44,2004,0.24872524177825525
SIM,1877,40,45-49,1917,5
STAT,1833,34,30-34,1867,15.627816978285916
STAT,1835,37,45-49,1872,1.5384389077561305
SIM,1890,50,na,1940,3126
SIM,1943,39,na,1982,5347
STAT,1883,16,40-44,1899,0.20702163519070874
SIM,1905,41,50-100,1946,1
STAT,1832,22,20-24,1854,105.98235939834122
STAT,1829,45,20-24,1874,0.012572001351722414
STAT,1919,16,45-49,1935,0.128099031466036
SIM,1874,33,30-34,1907,6
SIM,1892,37,40-44,1929,13
SIM,1890,16,25-29,1906,16
SIM,1967,45,40-44,2012,1
STAT,1956,37,na,1993,5918.935341807505
STAT,1950,20,50-100,1970,0.9014530813796727
SIM,1841,34,30-34,1875,44
SIM,1808,49,45-49,1857,1
STAT,1865,31,na,1896,2494.9151749521793
SIM,1898,78,na,1976,1927
STAT,1852,51,30-34,1903,0.005638995593515558
SIM,1852,33,na,1885,1969
STAT,1975,28,35-39,2003,22.94545557897428
STAT,1791,69,na,1860,745.9702291719548
SIM,1986,12,na,1998,6746
STAT,1818,45,45-49,1863,0.2997684558480516
STAT,1825,52,25-29,1877,0.004766386770193163
SIM,1857,64,na,1921,1838
SIM,1853,50,na,1903,2123
STAT,1850,26,30-34,1876,30.727290529546192
STAT,1803,87,na,1890,61.40597563746726
STAT,1951,63,na,2014,4717.926429007399
STAT,1963,3,na,1966,5767.482932293899
SIM,1856,32,25-29,1888,20
SIM,1877,29,15-19,1906,1
SIM,1896,34,20-24,1930,9
STAT,1798,91,na,1889,17.305264687731995
SIM,1953,17,na,1970,5688
STAT,1898,19,40-44,1917,0.28374045557893124
SIM,1949,17,35-39,1966,14
STAT,1837,39,20-24,1876,0.6656414502123683
STAT,1882,41,15-19,1923,0.015637082473891995
STAT,1830,53,45-49,1883,0.011541835779511284
STAT,1827,40,40-44,1867,3.112529307006294
SIM,1827,38,15-19,1865,3
STAT,1892,26,35-39,1918,14.004436597693788
STAT,1944,36,na,1980,4818.3171232762925
STAT,1940,22,na,1962,4294.506102225248
STAT,1946,5,na,1951,5080.297555445654
STAT,1997,17,50-100,2014,0.6313631557868051
SIM,1968,40,na,2008,5336
SIM,1843,37,50-100,1880,3
SIM,1816,50,na,1866,1533
STAT,1958,28,na,1986,5699.980891753606
SIM,1857,19,45-49,1876,1
STAT,1876,43,40-44,1919,2.663954675099901
STAT,1888,34,20-24,1922,3.635506287832375
STAT,1888,91,na,1979,347.6630139599026
SIM,1908,23,50-100,1931,2
SIM,1867,42,na,1909,2222
STAT,1843,23,35-39,1866,7.29671709530198
SIM,1846,43,20-24,1889,3
STAT,1881,37,15-19,1918,0.062507276910693
SIM,1949,45,50-100,1994,2
STAT,1864,14,na,1878,2771.063003897644
SIM,1906,96,na,2002,91
STAT,1897,35,25-29,1932,4.485182119879436
STAT,1969,23,45-49,1992,1.6269035099245757
STAT,1792,86,na,1878,107.80216557596759
STAT,1870,6,na,1876,3148.777639196505
STAT,1872,27,20-24,1899,13.594431644235883
SIM,1840,32,na,1872,2120
SIM,1826,42,40-44,1868,3
STAT,1853,8,na,1861,2941.0428103243084
STAT,1838,18,30-34,1856,1.8132530357962124
STAT,1777,106,na,1883,0.009827520336484572
STAT,1880,44,45-49,1924,1.8060402687134243
SIM,1930,78,na,2008,3312
STAT,1923,10,na,1933,5383.646959881346
SIM,1903,42,na,1945,3689
STAT,1831,46,15-19,1877,3.753776945363794E-4
STAT,1845,102,na,1947,0.19755740514477066
SIM,1887,36,20-24,1923,1
SIM,1844,46,na,1890,2163
SIM,1835,40,40-44,1875,7
STAT,1848,28,40-44,1876,3.7724626687419396
SIM,1842,25,35-39,1867,20
SIM,1922,77,na,1999,2760
SIM,1856,28,40-44,1884,6
SIM,1907,56,na,1963,4072
STAT,1980,21,45-49,2001,1.8091749191221296
STAT,1872,50,45-49,1922,0.017058685023243605
STAT,1886,108,na,1994,0.18494411055309584
SIM,1926,32,50-100,1958,4
STAT,1868,28,na,1896,2636.7854340827857
STAT,1865,54,20-24,1919,7.472335639058887E-4
STAT,1891,47,25-29,1938,0.04612673194071554
STAT,1854,26,15-19,1880,0.42889577935631573
STAT,1966,25,50-100,1991,1.4421779505002859
SIM,1882,27,30-34,1909,37
SIM,1884,43,40-44,1927,1
STAT,1959,48,45-49,2007,0.34031402199112837
STAT,1870,25,45-49,1895,1.2717888081152589
SIM,1916,15,30-34,1931,6
STAT,1820,43,35-39,1863,2.166075845275986
STAT,1875,21,50-100,1896,0.48779724278498815
STAT,1908,53,na,1961,3757.506392261399
STAT,1840,87,na,1927,141.33249318896247
STAT,1875,39,40-44,1914,5.168046880731541
SIM,1832,36,30-34,1868,11
STAT,1838,43,20-24,1881,0.14456390497732027
STAT,1863,29,20-24,1892,11.753715971584771
STAT,1860,17,50-100,1877,0.05255424461413615
SIM,1841,46,25-29,1887,1
STAT,1881,25,20-24,1906,13.147213806127882
STAT,1988,19,30-34,2007,20.104656460738635
STAT,1858,61,na,1919,1682.3064416049067
STAT,1974,41,15-19,2015,0.002408428775054757
SIM,1867,38,45-49,1905,8
SIM,1862,11,na,1873,3156
STAT,1974,37,30-34,2011,2.829555559365575
STAT,1988,23,15-19,2011,8.812264351644608
SIM,1866,25,na,1891,2409
SIM,1868,42,45-49,1910,8
SIM,1846,18,30-34,1864,1
SIM,1861,30,40-44,1891,2
STAT,1874,18,40-44,1892,0.2155241562700287
SIM,1895,38,na,1933,3520
STAT,1899,35,35-39,1934,11.288991300012752
STAT,1809,47,45-49,1856,0.6058474409864347
STAT,1860,36,40-44,1896,4.091149850745401
STAT,1958,22,30-34,1980,43.70811073563145
SIM,1891,24,na,1915,3281
STAT,1841,23,25-29,1864,64.01280781221112
STAT,1968,43,40-44,2011,0.37408638800573357
SIM,1965,22,15-19,1987,16
SIM,1975,31,30-34,2006,3
SIM,1883,80,na,1963,950
STAT,1985,30,35-39,2015,15.306767077083432
STAT,1819,38,15-19,1857,0.14772074515595954
STAT,1834,50,25-29,1884,0.0034482619283720713
STAT,1902,44,20-24,1946,0.01774032184998428
SIM,1831,24,20-24,1855,66
SIM,1887,94,na,1981,163
STAT,1848,32,25-29,1880,12.691572770970845
STAT,1984,26,35-39,2010,24.72565746112523
STAT,1849,53,25-29,1902,0.002701222861214497
SIM,1883,31,30-34,1914,5
STAT,1896,19,30-34,1915,2.4164840602654336
STAT,1874,27,30-34,1901,29.751085873747517
STAT,1939,17,25-29,1956,50.080266707555076
STAT,1812,91,na,1903,25.441024053186318
STAT,1890,23,20-24,1913,96.87462926747499
STAT,1948,16,50-100,1964,0.4949358080791326
SIM,1839,36,40-44,1875,11
STAT,1922,21,50-100,1943,0.8730583589533981
STAT,1966,15,na,1981,5308.352487762583
STAT,1843,52,na,1895,2148.946307117068
STAT,1967,20,30-34,1987,41.59805813283893
STAT,1893,47,35-39,1940,0.11466036702159234
STAT,1980,19,na,1999,5892.935752302371
STAT,1849,41,30-34,1890,0.895103197326092
SIM,1893,28,45-49,1921,7
SIM,1988,25,30-34,2013,8
STAT,1833,46,25-29,1879,0.048422635954648637
STAT,1942,49,20-24,1991,0.01378412881812826
SIM,1977,34,45-49,2011,9
SIM,1893,41,40-44,1934,10
SIM,1893,47,na,1940,3292
STAT,1824,40,15-19,1864,0.020325664860356522
STAT,1865,24,25-29,1889,59.46866222995069
SIM,1873,24,25-29,1897,4
STAT,1840,16,20-24,1856,18.522527290646586
STAT,1855,38,25-29,1893,2.4377445598555947
SIM,1862,51,40-44,1913,1
SIM,1800,67,na,1867,1002
STAT,1894,26,45-49,1920,1.6528308912289884
STAT,1900,57,na,1957,3268.3379611690602
STAT,1824,49,na,1873,1564.8798939289861
SIM,1975,20,30-34,1995,58
STAT,1978,37,15-19,2015,0.031159475518807444
SIM,1931,38,na,1969,6110
SIM,1946,61,na,2007,4159
SIM,1833,27,35-39,1860,3
STAT,1843,44,40-44,1887,2.2649285006259596
STAT,1859,51,40-44,1910,0.009724423906431887
STAT,1927,23,40-44,1950,4.764939801267634
STAT,1820,35,na,1855,1679.3572122923827
SIM,1858,81,na,1939,777
SIM,1883,34,35-39,1917,7
STAT,1951,47,20-24,1998,0.015796648036456265
SIM,1843,34,40-44,1877,3
STAT,1890,43,50-100,1933,1.4789627124334133
SIM,1965,18,na,1983,5612
STAT,1853,30,40-44,1883,4.539659499058015
STAT,1916,40,na,1956,4404.87548190907
STAT,1862,66,na,1928,1596.2851021076774
STAT,1854,51,40-44,1905,0.008617881226614648
STAT,1850,30,15-19,1880,0.17206323250511743
STAT,1847,19,35-39,1866,0.5207662147164087
SIM,1859,41,40-44,1900,2
STAT,1969,34,45-49,2003,2.3093641840709243
SIM,1973,31,20-24,2004,7
SIM,1908,21,30-34,1929,44
STAT,1875,34,35-39,1909,11.974089848929317
STAT,1984,6,na,1990,6443.442117991951
STAT,1861,103,na,1964,0.613005926376924
STAT,1907,36,na,1943,4051.3616350483762
STAT,1835,34,40-44,1869,3.376406624959199
STAT,1903,22,na,1925,3887.6129844879993
STAT,1869,45,na,1914,2539.5086424076667
SIM,1935,23,40-44,1958,9
STAT,1885,28,45-49,1913,1.2735813638046085
SIM,1823,33,25-29,1856,19
STAT,1953,40,na,1993,5403.230053224437
STAT,1840,44,15-19,1884,0.011263897595827467
STAT,1856,27,na,1883,2177.337400054702
STAT,1852,13,na,1865,2709.801278000114
STAT,1995,6,na,2001,6567.165475754575
SIM,1840,25,25-29,1865,11
STAT,1923,74,na,1997,3422.1946554646265
SIM,1828,51,na,1879,1952
STAT,1885,41,40-44,1926,2.6008775952614704
STAT,1976,26,50-100,2002,1.5419585383420849
STAT,1899,11,na,1910,4089.22176267217
STAT,1978,21,45-49,1999,1.778554809791595
STAT,1919,94,na,2013,320.8958241050205
SIM,1829,29,35-39,1858,28
STAT,1832,25,25-29,1857,41.859266599591365
STAT,1982,26,25-29,2008,107.39733640743772
STAT,1937,20,50-100,1957,0.7403769955463329
STAT,1966,43,30-34,2009,0.1912076443338664
SIM,1899,46,40-44,1945,1
STAT,1829,48,25-29,1877,0.05799649285319891
SIM,1847,34,25-29,1881,17
STAT,1880,41,40-44,1921,2.7638564263209955
STAT,1836,18,20-24,1854,36.239859767582715
SIM,1938,19,25-29,1957,58
STAT,1857,44,na,1901,2049.3264214399574
SIM,1844,18,20-24,1862,29
STAT,1847,54,50-100,1901,0.01130130989448984
STAT,1996,17,15-19,2013,76.11570924097055
SIM,1829,38,25-29,1867,1
SIM,1959,35,50-100,1994,2
STAT,1839,34,25-29,1873,9.790705750848623
STAT,1883,25,30-34,1908,28.625585436185936
STAT,1887,74,na,1961,1658.4923038643174
STAT,1883,60,na,1943,2153.381856513588
STAT,1910,38,20-24,1948,0.2898091676128942
STAT,1828,36,15-19,1864,0.05905270324738459
SIM,1819,47,na,1866,1116
STAT,1880,48,50-100,1928,0.2966531585527226
STAT,1854,79,na,1933,569.5589391026343
STAT,1827,43,45-49,1870,1.9595118412038115
STAT,1850,65,na,1915,1739.7252184908693
STAT,1976,32,35-39,2008,14.361819667208108
SIM,1896,37,25-29,1933,7
SIM,1938,74,na,2012,2858
STAT,1842,32,30-34,1874,16.230650125126488
SIM,1876,36,45-49,1912,6
SIM,1825,54,40-44,1879,1
SIM,1891,25,30-34,1916,68
STAT,1861,52,35-39,1913,0.008215623516235176
SIM,1812,68,na,1880,587
STAT,1991,21,20-24,2012,184.57155388373408
SIM,1979,20,15-19,1999,6
STAT,1906,15,20-24,1921,29.973448322148197
STAT,1851,42,25-29,1893,0.5086002648564375
STAT,1990,17,20-24,2007,224.06680756549565
SIM,1871,29,20-24,1900,1
STAT,1984,26,na,2010,6169.492070316175
STAT,1812,107,na,1919,0.002070460973072165
SIM,1825,33,50-100,1858,1
SIM,1811,83,na,1894,326
STAT,1832,36,na,1868,1849.4434699131957
STAT,1891,9,na,1900,3700.7723520809077
STAT,1868,36,45-49,1904,2.220951880327537
SIM,1868,31,50-100,1899,1
STAT,1888,37,25-29,1925,3.9058457535219264
SIM,1881,46,na,1927,1828
SIM,1909,33,40-44,1942,13
STAT,1876,52,30-34,1928,0.00706346198960724
STAT,1933,17,50-100,1950,0.579046424303015
STAT,1866,45,25-29,1911,0.06222677354115197
SIM,1861,42,35-39,1903,3
STAT,1872,112,na,1984,0.002578194288362856
SIM,1959,46,50-100,2005,2
STAT,1917,16,35-39,1933,1.044662837080646
STAT,1911,73,na,1984,2877.5977408482636
STAT,1817,54,40-44,1871,0.02779358421370093
STAT,1929,15,na,1944,5446.472675868398
SIM,1959,27,45-49,1986,9
STAT,1831,51,na,1882,1786.5028114798758
STAT,1852,21,35-39,1873,6.583110872060119
STAT,1831,41,45-49,1872,1.4528806023085128
STAT,1860,39,45-49,1899,1.8354979462007481
STAT,1940,47,45-49,1987,0.264976585577303
STAT,1906,100,na,2006,35.27881885390761
STAT,1878,48,20-24,1926,0.014277783555091106
SIM,1974,16,30-34,1990,25
SIM,1841,37,35-39,1878,12
SIM,1857,44,35-39,1901,2
STAT,1841,53,20-24,1894,6.455428420700593E-4
STAT,1849,16,40-44,1865,0.1755320699912645
STAT,1886,17,50-100,1903,0.05963836010747431
STAT,1852,29,45-49,1881,1.093652061997769
STAT,1858,47,40-44,1905,0.1534104056560959
STAT,1833,37,35-39,1870,6.272011395788472
STAT,1897,32,20-24,1929,4.171181364650186
STAT,1816,42,30-34,1858,2.6039884537348787
STAT,1857,26,40-44,1883,2.793316110426489
SIM,1849,13,na,1862,3165
STAT,1892,35,25-29,1927,4.2041210860585645
STAT,1811,45,35-39,1856,0.45138594569417845
SIM,1842,22,30-34,1864,50
STAT,1984,23,30-34,2007,47.24879277126835
STAT,1943,31,25-29,1974,11.537353102415286
STAT,1837,67,na,1904,1147.900811163611
SIM,1806,72,na,1878,753
SIM,1851,44,40-44,1895,1
STAT,1851,17,35-39,1868,0.5290305420709283
SIM,1958,15,35-39,1973,18
SIM,1865,26,40-44,1891,5
SIM,1817,44,40-44,1861,1
STAT,1902,47,25-29,1949,0.052734054957739876
STAT,1968,9,na,1977,5664.2377811944125
STAT,1826,39,45-49,1865,1.5313511345404127
SIM,1834,39,45-49,1873,2
STAT,1896,28,20-24,1924,17.819143196270538
STAT,1850,51,20-24,1901,7.632828176123104E-4
STAT,1826,31,35-39,1857,10.091854182481535
SIM,1888,27,25-29,1915,107
SIM,1856,37,30-34,1893,3
SIM,1892,27,50-100,1919,1
STAT,1790,95,na,1885,2.7328876529744845
STAT,1834,22,30-34,1856,21.739954810806495
STAT,1956,45,15-19,2001,5.878695843730818E-4
STAT,1976,39,na,2015,5963.292545372486
STAT,1848,83,na,1931,421.8096814881911
SIM,1893,7,na,1900,3830
SIM,1872,33,20-24,1905,7
STAT,1912,26,50-100,1938,1.1369494390532415
STAT,1980,30,35-39,2010,14.94022918516558
STAT,1848,37,30-34,1885,5.835651569054484
SIM,1908,73,na,1981,2426
STAT,1841,28,30-34,1869,27.608528700755883
SIM,1948,26,30-34,1974,3
STAT,1942,59,na,2001,4334.38733396965
SIM,1835,43,45-49,1878,7
STAT,1958,25,35-39,1983,22.87485067570117
STAT,1820,40,30-34,1860,1.5065269807089825
SIM,1857,41,30-34,1898,3
STAT,1930,35,50-100,1965,0.6331849726094829
STAT,1841,20,20-24,1861,78.74284330442227
STAT,1849,49,40-44,1898,0.1299211780881969
STAT,1945,53,na,1998,4714.887107667234
STAT,1889,49,35-39,1938,0.10999702658431613
SIM,1850,32,30-34,1882,7
STAT,1860,40,25-29,1900,0.6033025419820266
STAT,1805,51,45-49,1856,0.05293945650683267
STAT,1819,102,na,1921,0.19517023097904213
STAT,1880,95,na,1975,101.69132737739211
STAT,1876,58,na,1934,2359.2319765142597
SIM,1889,39,35-39,1928,2
STAT,1881,28,25-29,1909,46.92119657891324
SIM,1949,30,30-34,1979,7
STAT,1834,49,45-49,1883,0.22262757239364264
STAT,1990,7,na,1997,6496.177232709988
STAT,1908,37,50-100,1945,0.45422986574155105
SIM,1879,29,25-29,1908,59
STAT,1872,44,na,1916,2642.1181219221457
STAT,1839,39,30-34,1878,4.947052431056835
STAT,1820,34,45-49,1854,5.936315759042606
SIM,1886,13,na,1899,2380
STAT,1917,41,25-29,1958,0.08612786992763764
SIM,1902,37,25-29,1939,3
SIM,1873,21,20-24,1894,157
STAT,1865,45,30-34,1910,0.10179845661544804
SIM,1822,67,na,1889,965
STAT,1821,52,na,1873,1470.860149070505
STAT,1859,38,45-49,1897,1.8235319184615
SIM,1908,24,35-39,1932,21
STAT,1911,98,na,2009,83.16264994904118
STAT,1825,66,na,1891,1159.3181975539983
STAT,1938,26,20-24,1964,20.889722769506285
SIM,1763,93,na,1856,14
STAT,1894,23,40-44,1917,3.0818596406246197
STAT,1890,115,na,2005,2.5766619490803067E-4
SIM,1847,39,30-34,1886,5
SIM,1879,17,30-34,1896,4
STAT,1844,35,50-100,1879,1.2175111914508892
STAT,1818,54,35-39,1872,0.009826969904876226
STAT,1865,21,20-24,1886,73.15304095445941
STAT,1953,16,45-49,1969,0.6975821976457796
STAT,1898,34,50-100,1932,1.416815206382248
STAT,1874,31,15-19,1905,0.16893471712546726
SIM,1951,31,25-29,1982,6
SIM,1961,40,40-44,2001,1
SIM,1845,18,15-19,1863,8
STAT,1984,17,45-49,2001,0.8187793044606145
STAT,1992,17,30-34,2009,20.19057263011501
STAT,1854,21,45-49,1875,0.6723316680715743
STAT,1844,26,na,1870,2231.0401423405897
STAT,1879,52,20-24,1931,8.844730879414972E-4
STAT,1899,32,30-34,1931,27.60504296433289
STAT,1834,41,35-39,1875,2.017878267827912
SIM,1842,49,45-49,1891,1
SIM,1871,47,na,1918,1975
STAT,1890,94,na,1984,190.81358010529914
STAT,1967,43,25-29,2010,0.10681119780644016
STAT,1846,16,15-19,1862,7.752501914335069
STAT,1922,57,na,1979,4654.764983032509
STAT,1894,42,45-49,1936,0.15399405425579119
SIM,1946,26,20-24,1972,44
STAT,1842,41,20-24,1883,0.12807049881902957
STAT,1886,37,15-19,1923,0.06835757405449
SIM,1918,72,na,1990,2664
SIM,1860,84,na,1944,654
STAT,1893,44,30-34,1937,0.11488530793568075
SIM,1854,16,15-19,1870,13
STAT,1972,37,20-24,2009,0.401292626642258
STAT,1833,43,20-24,1876,0.13463490850538987
SIM,1864,98,na,1962,13
STAT,1824,41,50-100,1865,1.5289079420966631
STAT,1993,15,45-49,2008,0.8298732603959689
SIM,1815,47,35-39,1862,1
SIM,1843,29,na,1872,2063
STAT,1880,49,15-19,1929,4.7907995416164004E-4
STAT,1889,37,40-44,1926,6.2273009770313426
STAT,1837,18,15-19,1855,8.101848139253791
STAT,1856,47,30-34,1903,0.08483015532169733
SIM,1847,31,20-24,1878,7
STAT,1949,27,35-39,1976,20.237850460911957
STAT,1876,46,45-49,1922,0.2823423624017601
SIM,1954,31,50-100,1985,6
STAT,1969,31,40-44,2000,5.753917661359287
SIM,1972,16,20-24,1988,393
STAT,1971,32,35-39,2003,13.615354343554953
STAT,1847,7,na,1854,2377.0
SIM,1819,41,50-100,1860,3
SIM,1851,47,45-49,1898,1
SIM,1863,38,25-29,1901,4
STAT,1964,16,20-24,1980,197.116711402782
STAT,1921,39,35-39,1960,3.1089819785449215
STAT,1876,27,40-44,1903,3.5736443885876565
STAT,1901,30,50-100,1931,1.4930003736273514
STAT,1839,31,20-24,1870,2.665556358938113
SIM,1884,27,40-44,1911,6
STAT,1843,47,45-49,1890,0.2356939438965869
SIM,1828,26,15-19,1854,3
STAT,1843,20,30-34,1863,22.759302916996884
STAT,1924,43,50-100,1967,0.16096558327327248
STAT,1863,83,na,1946,400.60361069857635
STAT,1892,47,40-44,1939,0.13903248080343672
STAT,1836,21,50-100,1857,0.4935028032361885
SIM,1883,18,35-39,1901,1
STAT,1843,28,40-44,1871,3.6724813732789916
SIM,1825,86,na,1911,92
SIM,1851,28,40-44,1879,2
STAT,1823,48,30-34,1871,0.0943137122851782
STAT,1824,81,na,1905,334.59868635734966
STAT,1867,97,na,1964,19.232915800625133
SIM,1954,34,na,1988,5347
STAT,1807,53,20-24,1860,0.002839961317134117
STAT,1870,50,35-39,1920,0.009935489328792967
STAT,1940,44,40-44,1984,0.3036661303541286
SIM,1935,26,45-49,1961,7
SIM,1889,42,na,1931,3724
SIM,1973,34,25-29,2007,41
STAT,1807,47,35-39,1854,0.5828005827946453
STAT,1990,11,na,2001,6493.0596282136385
STAT,1897,44,15-19,1941,0.0014598638965356689
STAT,1942,0,na,1942,5394.870167050754
STAT,1920,27,25-29,1947,83.29016846054172
STAT,1967,32,na,1999,5557.440229733949
STAT,1983,30,25-29,2013,15.398001884129673
SIM,1914,15,20-24,1929,55
SIM,1957,27,35-39,1984,26
STAT,1823,40,20-24,1863,0.17304165554016931
STAT,1838,84,na,1922,288.1561947407094
STAT,1834,70,na,1904,1280.446350080725
STAT,1891,35,30-34,1926,7.673867696858793
STAT,1942,15,30-34,1957,14.710270918878491
STAT,1984,15,35-39,1999,6.881394088921567
STAT,1828,29,50-100,1857,0.8425395028484791
STAT,1878,40,50-100,1918,1.2858223783757445
SIM,1977,31,40-44,2008,19
STAT,1927,26,45-49,1953,2.431602873653582
SIM,1858,32,35-39,1890,4
STAT,1808,51,35-39,1859,0.04186772158634302
STAT,1861,81,na,1942,518.8133724726144
STAT,1912,58,na,1970,3868.9469852476013
STAT,1822,36,20-24,1858,1.9626343723610142
SIM,1851,20,30-34,1871,49
STAT,1865,95,na,1960,26.912668082620787
STAT,1890,26,25-29,1916,59.85479145372781
STAT,1853,42,35-39,1895,1.800660945729273
STAT,1945,4,na,1949,5030.5734844441995
SIM,1950,15,30-34,1965,19
STAT,1888,1,na,1889,3833.121221052936
STAT,1962,2,na,1964,5818.932953499666
STAT,1828,31,45-49,1859,2.07917576643673
STAT,1963,49,50-100,2012,0.342908927666669
STAT,1800,90,na,1890,42.54132727954397
SIM,2002,1,na,2003,6949
STAT,1887,46,20-24,1933,0.015563940563619318
SIM,1924,25,30-34,1949,51
STAT,1877,31,40-44,1908,5.227264272075313
STAT,1943,19,na,1962,4501.8684816084005
STAT,1842,35,35-39,1877,6.518787691910363
STAT,1965,20,20-24,1985,160.8451928964632
SIM,1945,17,15-19,1962,99
SIM,1909,90,na,1999,803
STAT,1991,24,25-29,2015,153.1687929656658
STAT,1833,25,40-44,1858,2.882920365015441
SIM,1974,27,30-34,2001,84
STAT,1898,23,25-29,1921,89.00896404140079
STAT,1860,54,50-100,1914,0.013660909311428117
STAT,1878,22,45-49,1900,0.840241505785605
STAT,1911,29,25-29,1940,73.61027913147876
STAT,1975,17,35-39,1992,6.388502187668307
STAT,1944,49,30-34,1993,0.11448822199346635
SIM,1813,85,na,1898,127
SIM,1836,31,45-49,1867,4
SIM,1872,36,25-29,1908,1
STAT,1842,19,35-39,1861,0.5358502263785146
STAT,1946,15,15-19,1961,58.12079160557535
STAT,1966,46,35-39,2012,0.193785073825506
SIM,1880,29,na,1909,3437
STAT,1827,27,45-49,1854,4.280479026722406
STAT,1886,57,na,1943,2446.3462188913954
STAT,1838,19,50-100,1857,0.0554069449467362
STAT,1882,43,na,1925,2586.444281920283
SIM,1979,16,30-34,1995,28
STAT,1928,41,na,1969,5471.698133105794
STAT,1867,48,45-49,1915,0.25109214071330616
STAT,1891,114,na,2005,7.604782796301118E-4
STAT,1832,46,30-34,1878,0.08048377295008513
STAT,1866,33,30-34,1899,18.59718125122219
SIM,1875,29,40-44,1904,1
STAT,1780,110,na,1890,0.0028796108228018986
STAT,1816,51,20-24,1867,0.001473891631252285
SIM,1850,35,35-39,1885,9
SIM,1925,42,na,1967,5280
SIM,1973,20,20-24,1993,159
SIM,1957,45,na,2002,6162
STAT,1918,32,50-100,1950,1.0137089304145894
SIM,1895,46,20-24,1941,1
STAT,1937,17,15-19,1954,50.97930976888892
SIM,1881,18,25-29,1899,12
STAT,1887,20,45-49,1907,0.9072430603080389
SIM,1929,56,na,1985,4965
STAT,1828,95,na,1923,8.824241049995608
SIM,1850,19,35-39,1869,1
SIM,1874,42,20-24,1916,1
STAT,1868,33,40-44,1901,4.788119360628807
SIM,1847,11,na,1858,3090
SIM,1856,47,na,1903,2006
SIM,1830,43,45-49,1873,3
SIM,1954,15,15-19,1969,63
SIM,1876,33,40-44,1909,2
STAT,1857,51,30-34,1908,0.0053758137885171
STAT,1916,25,30-34,1941,47.07638008376491
STAT,1897,19,25-29,1916,8.697625244799621
STAT,1799,65,na,1864,1096.7131821774983
STAT,1846,28,na,1874,2686.006003206201
STAT,1842,14,na,1856,2337.6289027644
STAT,1817,38,40-44,1855,15.324595290266286
STAT,1806,52,na,1858,1168.0035770263746
SIM,1864,77,na,1941,662
SIM,1950,28,50-100,1978,4
SIM,1860,63,na,1923,1816
STAT,1884,51,50-100,1935,0.01730286534580626
SIM,1860,30,25-29,1890,11
STAT,1873,18,25-29,1891,6.6606851338546225
SIM,1969,6,na,1975,5831
SIM,1825,38,40-44,1863,3
STAT,1853,38,15-19,1891,0.05563124167968429
STAT,1866,42,20-24,1908,0.16966709900935853
STAT,1862,36,15-19,1898,0.054953977285610994
STAT,1831,34,20-24,1865,2.696037904742403
SIM,1919,27,15-19,1946,4
SIM,1876,9,na,1885,3020
STAT,1893,38,45-49,1931,2.8935126523121464
STAT,1892,32,20-24,1924,3.9097969848706513
SIM,1895,20,45-49,1915,8
SIM,1929,35,na,1964,5251
STAT,1822,43,45-49,1865,2.9774252999673942
STAT,1835,50,40-44,1885,0.006965832776860778
STAT,1870,34,35-39,1904,11.423162828127117
SIM,1841,15,50-100,1856,1
STAT,1867,54,30-34,1921,0.006237427839800124
SIM,1964,36,25-29,2000,3
STAT,1847,66,na,1913,1261.1434887581236
SIM,1825,30,30-34,1855,21
SIM,1925,21,na,1946,5181
SIM,1900,77,na,1977,1884
SIM,1827,30,40-44,1857,13
STAT,1865,29,30-34,1894,26.033400982836145
SIM,1834,40,25-29,1874,1
SIM,1975,25,45-49,2000,6
STAT,1873,27,15-19,1900,0.5346838391381683
SIM,1964,40,45-49,2004,1
STAT,1977,28,45-49,2005,2.7042016306241248
STAT,1816,45,35-39,1861,0.2942576038725562
SIM,1985,28,45-49,2013,4
STAT,1913,75,na,1988,2745.3276381963474
STAT,1901,95,na,1996,186.10290485480186
STAT,1957,48,35-39,2005,0.2034847159667655
SIM,1855,28,25-29,1883,6
STAT,1827,52,35-39,1879,0.010523224433227635
STAT,1864,36,25-29,1900,2.981124064594362
STAT,1868,52,45-49,1920,0.0160052347597326
SIM,1984,16,35-39,2000,8
STAT,1883,49,40-44,1932,0.18926463011553082
STAT,1827,48,15-19,1875,4.998811655391894E-4
STAT,1813,106,na,1919,0.0055593432889173575
STAT,1877,43,35-39,1920,2.1580792924238974
STAT,1893,27,na,1920,3481.2656932851955
STAT,1987,19,15-19,2006,74.71884591816462
STAT,1905,101,na,2006,22.35639927087774
STAT,1917,35,50-100,1952,0.5080605400768065
SIM,1964,33,na,1997,5764
SIM,1885,43,35-39,1928,6
SIM,1879,43,na,1922,2668
STAT,1847,28,25-29,1875,38.84135377017347
SIM,1890,37,30-34,1927,13
STAT,1834,48,na,1882,2149.723873393742
SIM,1985,20,35-39,2005,1
SIM,1889,103,na,1992,160
STAT,1883,41,30-34,1924,1.3039550445128116
SIM,1909,36,45-49,1945,2
STAT,1830,34,na,1864,1714.7825339678336
SIM,1891,41,30-34,1932,2
STAT,1826,40,25-29,1866,0.49658998164111967
STAT,1811,74,na,1885,578.2017472031106
SIM,1995,19,15-19,2014,147
STAT,1976,21,35-39,1997,14.570254867094866
STAT,1882,37,30-34,1919,6.00758002364507
SIM,1836,59,na,1895,1195
STAT,1876,22,35-39,1898,6.961604324025901
SIM,1874,36,35-39,1910,3
SIM,1904,80,na,1984,2716
STAT,1928,30,45-49,1958,2.2732110046931213
STAT,1799,103,na,1902,0.06446476020079449
STAT,1818,51,30-34,1869,0.007212617353612842
SIM,1870,62,na,1932,2399
SIM,1981,17,25-29,1998,1
STAT,1957,22,15-19,1979,8.12634562021937
SIM,1953,34,50-100,1987,1
STAT,1844,51,45-49,1895,0.012196589555130331
STAT,1865,48,35-39,1913,0.1439441715689501
SIM,1874,76,na,1950,919
STAT,1844,32,40-44,1876,4.337678067198449
STAT,1945,34,50-100,1979,1.0610757467876748
SIM,1987,20,45-49,2007,2
SIM,1884,22,35-39,1906,1
STAT,1900,46,50-100,1946,0.22247985036003645
STAT,1936,49,na,1985,4180.101186822673
STAT,1932,35,na,1967,5845.12266573167
STAT,1993,21,30-34,2014,47.89521266489946
STAT,1788,92,na,1880,17.177709244540203
SIM,1907,21,15-19,1928,11
STAT,1978,32,45-49,2010,2.5262226377882437
STAT,1891,79,na,1970,1518.1284257870611
STAT,1998,17,25-29,2015,73.42994029005652
STAT,1852,49,50-100,1901,0.22672028730946694
STAT,1880,37,20-24,1917,0.9429341467040896
SIM,1998,5,na,2003,6868
STAT,1864,17,20-24,1881,18.898064173046702
STAT,1967,40,20-24,2007,0.026530915548999792
STAT,1925,40,50-100,1965,0.16454487886219807
SIM,1885,39,na,1924,3154
SIM,1947,30,20-24,1977,6
STAT,1908,49,20-24,1957,0.011480899367219487
STAT,1874,22,25-29,1896,67.6326696907428
STAT,1895,19,15-19,1914,8.867026118306919
STAT,1848,41,15-19,1889,0.014844228337757245
SIM,1872,17,20-24,1889,27
STAT,1983,26,40-44,2009,7.645701761520369
STAT,1866,36,35-39,1902,7.602048209271711
SIM,1852,32,40-44,1884,4
SIM,1852,41,30-34,1893,1
SIM,1923,16,25-29,1939,89
SIM,1883,43,25-29,1926,3
STAT,1923,39,45-49,1962,0.9093034473705247
STAT,1915,16,25-29,1931,10.49458727822344
STAT,1973,17,25-29,1990,64.67972047741843
STAT,1873,61,na,1934,2202.1680590725023
STAT,1822,40,40-44,1862,4.852651248707803
STAT,1968,46,45-49,2014,0.326663609824339
SIM,1849,77,na,1926,1187
STAT,1829,52,45-49,1881,0.01301032455242113
SIM,1845,63,na,1908,1687
STAT,1877,75,na,1952,1235.812524072276
STAT,1834,46,40-44,1880,0.18442561637163296
SIM,1879,26,20-24,1905,15
STAT,1980,26,15-19,2006,1.1363958058445995
SIM,1931,39,45-49,1970,1
STAT,1902,69,na,1971,2836.982817330353
SIM,1906,39,na,1945,3588
SIM,1948,63,na,2011,3933
STAT,1941,31,15-19,1972,0.15583280856800646
SIM,1902,25,na,1927,4010
STAT,1873,39,na,1912,2748.550996696991
STAT,1962,41,45-49,2003,0.2561204486320716
SIM,1910,76,na,1986,1691
STAT,1856,38,40-44,1894,3.8350525143409064
STAT,1898,47,35-39,1945,0.12259631581679321
SIM,1820,40,45-49,1860,3
SIM,1940,42,na,1982,4955
SIM,1868,19,20-24,1887,37
STAT,1818,42,40-44,1860,3.005111177830387
SIM,1950,18,35-39,1968,6
STAT,1939,30,20-24,1969,2.876534976419832
SIM,1927,0,na,1927,5506
SIM,1869,30,45-49,1899,4
STAT,1942,18,35-39,1960,5.059888186943561
STAT,1823,44,50-100,1867,1.0650895493307577
STAT,1986,21,50-100,2007,1.0859371805403757
STAT,1891,38,35-39,1929,10.038198820151132
SIM,1830,40,40-44,1870,2
SIM,1853,32,50-100,1885,4
SIM,1956,15,25-29,1971,78
STAT,1852,30,25-29,1882,10.208345657704026
SIM,1958,31,35-39,1989,34
STAT,1875,43,25-29,1918,0.7603013252634614
STAT,1843,53,30-34,1896,0.005876777157895233
STAT,1839,58,na,1897,1568.3332508078051
SIM,1957,24,30-34,1981,108
STAT,1842,44,25-29,1886,0.4983242584832584
SIM,1841,25,40-44,1866,4
SIM,1815,97,na,1912,2
STAT,1891,44,20-24,1935,0.22346034790569397
STAT,1849,28,35-39,1877,8.801500521919802
STAT,1778,105,na,1883,0.027879626359503366
STAT,1949,24,30-34,1973,38.6768144999322
SIM,1919,57,na,1976,5027
STAT,1779,88,na,1867,39.0671149930156
STAT,1982,30,45-49,2012,2.607690006761341
STAT,1849,19,45-49,1868,0.0615887890143188
STAT,1845,32,50-100,1877,0.7341109866746518
STAT,1948,15,25-29,1963,57.26190216420718
SIM,1868,80,na,1948,653
SIM,1915,43,na,1958,4536
SIM,1992,22,na,2014,6967
SIM,1873,29,30-34,1902,1
SIM,1976,27,40-44,2003,22
SIM,1857,28,35-39,1885,1
SIM,1791,89,na,1880,70
SIM,1858,37,40-44,1895,12
SIM,1927,79,na,2006,1879
STAT,1892,23,30-34,1915,25.684686278047888
STAT,1832,49,35-39,1881,0.10192353216143593
STAT,1915,41,15-19,1956,0.001787148860258727
STAT,1916,28,35-39,1944,17.85359980125689
SIM,1871,24,15-19,1895,5
SIM,1986,25,20-24,2011,61
STAT,1842,16,30-34,1858,1.584348215928014
STAT,1867,45,40-44,1912,0.1863050658035551
STAT,1881,32,45-49,1913,1.941099230725611
STAT,1848,16,25-29,1864,7.508213916863788
SIM,1856,16,25-29,1872,12
SIM,1968,25,45-49,1993,2
STAT,1892,42,35-39,1934,2.6159985386674087
STAT,1981,19,20-24,2000,218.63358496823736
STAT,1841,29,50-100,1870,0.6963001249713673
STAT,1883,28,na,1911,2685.1199702047015
STAT,1897,16,20-24,1913,27.424686869823244
STAT,1887,49,25-29,1936,0.041144233092017715
STAT,1965,43,15-19,2008,0.002295728430177232
SIM,1850,44,25-29,1894,3
STAT,1866,23,50-100,1889,0.4366019788578202
SIM,1897,37,40-44,1934,13
SIM,1885,40,30-34,1925,2
SIM,1970,41,45-49,2011,1
STAT,1841,32,15-19,1873,0.1536196780674685
STAT,1981,30,15-19,2011,0.21161598837946816
STAT,1916,20,25-29,1936,112.37875273714357
SIM,1990,23,20-24,2013,332
SIM,1815,44,30-34,1859,3
SIM,1950,20,na,1970,4434
SIM,1990,17,35-39,2007,15
STAT,1839,49,50-100,1888,0.19342818430888678
STAT,1832,41,25-29,1873,0.5528325250520542
STAT,1877,34,45-49,1911,2.0754399642694223
STAT,1838,27,20-24,1865,12.928857066278187
SIM,1885,34,45-49,1919,4
SIM,1924,68,na,1992,3868
SIM,1840,49,35-39,1889,1
SIM,1846,27,20-24,1873,11
SIM,1978,20,35-39,1998,42
SIM,1904,37,35-39,1941,3
STAT,1863,24,15-19,1887,3.3468403742399975
STAT,1976,14,na,1990,6054.1830701247545
SIM,1924,28,35-39,1952,4
STAT,1853,17,45-49,1870,0.0782344677152009
STAT,1898,20,20-24,1918,108.12275660718933
STAT,1944,31,40-44,1975,4.957094064809976
SIM,1865,51,na,1916,2693
STAT,1969,28,15-19,1997,1.021629802882006
STAT,1877,40,30-34,1917,1.3940392364022836
STAT,1854,9,na,1863,2374.370781058751
SIM,1930,27,35-39,1957,7
STAT,1789,66,na,1855,620.4296
SIM,1924,20,25-29,1944,246
STAT,1982,23,20-24,2005,181.10852199807397
SIM,1905,49,45-49,1954,1
SIM,1835,85,na,1920,158
STAT,1865,26,50-100,1891,0.6683694067503739
STAT,1898,28,30-34,1926,39.13746310245168
STAT,1948,40,15-19,1988,0.0021135584913323036
STAT,1870,22,40-44,1892,2.3707997172167916
SIM,1831,71,na,1902,828
STAT,1882,28,40-44,1910,3.364758774861936
SIM,1872,10,na,1882,3358
STAT,1870,31,30-34,1901,19.945521062067648
STAT,1967,34,35-39,2001,13.410827717522913
STAT,1848,62,na,1910,1942.0149759745284
STAT,1899,31,50-100,1930,1.454568849346242
STAT,1847,37,15-19,1884,0.04483060826898183
STAT,1893,35,40-44,1928,6.446188796487121
SIM,1939,34,na,1973,4964
SIM,1935,20,na,1955,6307
STAT,1837,34,15-19,1871,0.1266351866534556
STAT,1909,21,50-100,1930,0.7086787426380718
STAT,1978,25,20-24,2003,28.898765473600555
SIM,1974,22,na,1996,5611
STAT,1954,20,45-49,1974,1.6116620807442905
SIM,1840,41,25-29,1881,1
STAT,1831,37,25-29,1868,2.847155665272397
STAT,1891,19,30-34,1910,2.2611733741731155
STAT,1861,40,40-44,1901,2.1797461998163246
STAT,1815,42,15-19,1857,0.030861542193621017
SIM,1921,39,na,1960,5211
STAT,1911,26,20-24,1937,20.631851985864294
STAT,1869,29,15-19,1898,0.5034376639570378
STAT,1880,20,35-39,1900,7.180790425176405
STAT,1970,21,40-44,1991,4.875025472582091
SIM,1920,38,30-34,1958,2
SIM,1975,34,35-39,2009,1
STAT,1877,43,50-100,1920,1.2590510226227576
STAT,1912,38,30-34,1950,2.0446585039037024
SIM,1848,46,50-100,1894,1
STAT,1818,96,na,1914,3.799262635002308
STAT,1878,52,40-44,1930,0.012617819162172835
STAT,1821,48,20-24,1869,0.021416003860778018
STAT,1844,103,na,1947,0.12003920975353341
STAT,1816,54,25-29,1870,0.006663700929938563
STAT,1957,45,30-34,2002,0.14175140647658618
STAT,1939,18,50-100,1957,0.43283196758931625
STAT,1830,25,15-19,1855,0.6324713968730046
STAT,1838,46,25-29,1884,0.05200209687903255
STAT,1876,79,na,1955,834.017781271771
STAT,1872,65,na,1937,1958.3322910957374
SIM,1837,33,na,1870,2470
STAT,1820,38,50-100,1858,1.7663841617745557
STAT,1871,34,15-19,1905,0.16210216601143276
STAT,1855,32,na,1887,2067.4693696128484
STAT,1948,31,25-29,1979,12.449576391862893
STAT,1960,19,50-100,1979,0.5627595736798426
STAT,1912,42,15-19,1954,0.0017109168677712178
SIM,1852,35,50-100,1887,2
STAT,1950,21,na,1971,5001.156457144607
STAT,1948,29,na,1977,4963.899861427626
SIM,1831,50,na,1881,1533
STAT,1988,19,50-100,2007,0.6179708721287702
SIM,1797,73,na,1870,463
STAT,1932,34,40-44,1966,5.997313578994839
SIM,1940,34,40-44,1974,10
SIM,1848,27,30-34,1875,2
SIM,1892,62,na,1954,3025
STAT,1844,16,40-44,1860,0.19562143465757253
STAT,1951,41,25-29,1992,0.10213069965804894
SIM,1930,53,na,1983,5791
STAT,1810,48,45-49,1858,0.8987001152913549
STAT,1921,48,25-29,1969,0.06879344401616129
SIM,1968,18,20-24,1986,180
STAT,1960,45,na,2005,5770.743491426024
SIM,1931,36,40-44,1967,3
STAT,1903,44,15-19,1947,0.0015550764054745835
STAT,1875,27,25-29,1902,50.44848068820289
SIM,1806,51,na,1857,1455
SIM,1892,6,na,1898,4151
SIM,1937,19,30-34,1956,34
SIM,1867,63,na,1930,1619
STAT,1891,26,40-44,1917,4.287289780029534
STAT,1850,45,35-39,1895,0.14555928473866514
SIM,1890,28,40-44,1918,1
STAT,1925,22,na,1947,5042.915916405446
STAT,1975,32,40-44,2007,6.073051096191821
SIM,1829,46,na,1875,1651
STAT,1952,20,35-39,1972,13.07398104042965
SIM,1905,54,na,1959,3712
STAT,1924,19,50-100,1943,0.5119792486727429
SIM,1883,27,25-29,1910,5
STAT,1885,49,15-19,1934,4.508296115715772E-4
STAT,1929,19,30-34,1948,17.856263867881236
SIM,1883,21,50-100,1904,2
STAT,1809,71,na,1880,728.820654326527
STAT,1952,47,15-19,1999,5.299002678156824E-4
STAT,1906,44,40-44,1950,0.2593068582915546
STAT,1855,42,na,1897,1964.2023745882893
SIM,1877,95,na,1972,183
STAT,1930,46,25-29,1976,0.08082786564003278
STAT,1867,29,40-44,1896,3.2046165668270685
STAT,1794,106,na,1900,0.0030388869164621286
STAT,1869,0,na,1869,4189.882217411482
SIM,1839,29,30-34,1868,33
STAT,1833,53,35-39,1886,0.006163063404588852
SIM,1952,31,40-44,1983,14
STAT,1935,54,na,1989,5832.442762719069
STAT,1928,45,30-34,1973,0.13188202696887974
STAT,1856,52,50-100,1908,0.013226417058219682
SIM,1986,16,45-49,2002,2
SIM,1852,2,na,1854,2903
STAT,1974,21,25-29,1995,139.7000870154818
SIM,1855,62,na,1917,1452
STAT,1830,46,20-24,1876,0.011217157294849124
STAT,1881,49,30-34,1930,0.10550114063499905
SIM,1857,43,na,1900,2446
STAT,1868,60,na,1928,2114.619077091106
STAT,1917,25,na,1942,4564.726788910971
STAT,1918,41,40-44,1959,0.30728074011760836
STAT,1917,35,na,1952,4552.586818726641
SIM,1878,17,15-19,1895,13
SIM,1859,66,na,1925,1298
SIM,1906,18,na,1924,3905
STAT,1813,54,20-24,1867,0.0022513004407332775
STAT,1899,19,35-39,1918,0.8628953220771768
STAT,1909,5,na,1914,4540.5694299129855
SIM,1854,45,na,1899,2418
STAT,1989,16,20-24,2005,224.16746420346166
SIM,1997,16,20-24,2013,442
SIM,1856,26,na,1882,2232
STAT,1891,40,50-100,1931,1.5220410573360363
STAT,1955,48,25-29,2003,0.08429417322182478
STAT,1840,23,50-100,1863,0.4130251719209733
SIM,1870,44,50-100,1914,1
STAT,1871,48,na,1919,2550.644749574368
SIM,1888,89,na,1977,120
SIM,1904,34,30-34,1938,38
SIM,1980,18,na,1998,5175
STAT,1960,49,45-49,2009,0.3378019625495424
STAT,1928,76,na,2004,3434.9100834486244
STAT,1942,28,50-100,1970,1.2052292168533039
STAT,1907,18,40-44,1925,0.3097510837445422
STAT,1823,43,25-29,1866,0.661333031939252
SIM,1880,61,na,1941,2591
STAT,1834,104,na,1938,0.06087049690194276
SIM,1831,43,25-29,1874,1
SIM,1894,43,na,1937,3699
STAT,1943,51,na,1994,4617.31353605112
SIM,1804,70,na,1874,524
STAT,1857,19,30-34,1876,1.6640067741692033
SIM,1862,32,na,1894,2834
STAT,1910,41,50-100,1951,0.12900331401246903
STAT,1967,22,50-100,1989,0.9516795998829913
SIM,1965,36,40-44,2001,2
STAT,1802,53,50-100,1855,0.05898083655356435
SIM,1922,56,na,1978,4794
STAT,1814,45,25-29,1859,0.16541862694605994
STAT,1964,32,20-24,1996,3.6138789418163597
STAT,1828,48,30-34,1876,0.08797463101952042
SIM,1884,65,na,1949,1898
STAT,1839,18,25-29,1857,5.844175719421687
STAT,1854,47,20-24,1901,0.009730786257771467
STAT,1923,36,40-44,1959,2.0028243229961085
SIM,1912,18,15-19,1930,20
STAT,1854,38,30-34,1892,4.3204546666688985
SIM,1875,50,na,1925,2890
STAT,1894,22,50-100,1916,0.6049730585005908
STAT,1890,47,30-34,1937,0.07663819729128737
STAT,1865,36,40-44,1901,4.5800397707273595
STAT,1858,82,na,1940,420.057629199784
SIM,1839,24,na,1863,2169
SIM,1910,90,na,2000,317
SIM,1816,71,na,1887,1061
STAT,1800,68,na,1868,981.1627918549126
STAT,1875,18,35-39,1893,0.65267351319706
SIM,1958,38,50-100,1996,1
STAT,1851,54,40-44,1905,0.008118796897505946
STAT,1908,74,na,1982,2649.9806711265246
SIM,1935,25,50-100,1960,5
STAT,1792,108,na,1900,5.143636943519152E-4
SIM,1873,36,40-44,1909,1
STAT,1905,24,na,1929,3925.663330423984
STAT,1994,17,40-44,2011,2.329342133271834
SIM,1961,43,45-49,2004,1
STAT,1849,50,20-24,1899,5.801568524700412E-4
STAT,1856,28,50-100,1884,0.5794310515994294
STAT,1949,43,35-39,1992,0.28042844117516197
SIM,1847,18,25-29,1865,10
SIM,1880,34,50-100,1914,2
SIM,1956,31,25-29,1987,34
SIM,1872,64,na,1936,2174
STAT,1975,35,45-49,2010,1.0711408354135772
STAT,1885,62,na,1947,2103.918240477537
STAT,1904,18,15-19,1922,9.8090841461342
STAT,1922,24,30-34,1946,37.782383776514735
STAT,1872,46,25-29,1918,0.06693651366650065
STAT,1964,46,25-29,2010,0.08039764744483911
SIM,1973,30,50-100,2003,3
STAT,1907,35,45-49,1942,0.7375373471047842
STAT,1928,19,na,1947,5323.502023032262
STAT,1900,26,45-49,1926,1.7840917865204877
STAT,1954,38,35-39,1992,3.5515295620285845
STAT,1861,43,45-49,1904,1.4255148677496625
STAT,1990,24,30-34,2014,47.62548658891174
STAT,1943,41,na,1984,4730.633427795271
SIM,1930,24,30-34,1954,3
SIM,1956,50,na,2006,5274
SIM,1934,57,na,1991,5374
STAT,1839,49,45-49,1888,0.18586747382682528
STAT,1891,29,45-49,1920,1.5723269167717644
SIM,1802,69,na,1871,739
STAT,1840,35,25-29,1875,2.7891315402899917
STAT,1873,29,na,1902,2792.392003132949
SIM,1895,59,na,1954,2900
STAT,1973,41,20-24,2014,0.027432580504465103
SIM,1961,32,45-49,1993,6
STAT,1921,45,20-24,1966,0.014439564532687224
STAT,1953,18,na,1971,5136.898675764065
STAT,1932,37,45-49,1969,1.057316875465466
STAT,1813,86,na,1899,101.59095532731386
STAT,1821,43,15-19,1864,0.02605958283969706
STAT,1824,52,30-34,1876,0.007807386056422995
SIM,1809,48,na,1857,1712
SIM,1843,53,45-49,1896,1
STAT,1917,47,20-24,1964,0.013321475833729435
SIM,1857,37,25-29,1894,4
STAT,1942,31,30-34,1973,19.382774591135213
STAT,1906,97,na,2003,108.9767448077283
SIM,1864,42,25-29,1906,1
SIM,1898,33,50-100,1931,4
STAT,1892,113,na,2005,0.002248654846595237
STAT,1988,0,na,1988,6537.72778779616
STAT,1938,42,20-24,1980,0.02090360994739441
STAT,1965,28,50-100,1993,1.4395670391289337
STAT,1830,49,25-29,1879,0.05177834602883562
STAT,1914,20,15-19,1934,6.061492243711646
STAT,1829,29,20-24,1858,18.002252106191406
SIM,1821,72,na,1893,519
STAT,1953,32,45-49,1985,2.2392479801817866
SIM,1931,40,25-29,1971,1
STAT,1989,19,25-29,2008,71.58459527982913
SIM,1972,19,25-29,1991,139
SIM,2003,2,na,2005,6675
STAT,1899,16,30-34,1915,2.526209066658126
STAT,1844,19,45-49,1863,0.06863752741253014
STAT,1964,46,50-100,2010,0.3428066380512214
STAT,1968,17,na,1985,5305.496278526519
SIM,1944,35,na,1979,4608
STAT,1803,66,na,1869,808.8276844886676
SIM,1920,75,na,1995,2502
STAT,1880,28,30-34,1908,30.695109742466762
STAT,1947,6,na,1953,5134.158457968777
STAT,1910,45,45-49,1955,0.23535935892153328
STAT,1829,26,na,1855,2013.832681104376
STAT,1838,50,45-49,1888,0.01301154956441168
SIM,1864,13,na,1877,3047
STAT,1849,37,25-29,1886,2.283490595245414
SIM,1917,34,50-100,1951,4
SIM,1873,5,na,1878,3753
STAT,1853,46,50-100,1899,0.24521827267982746
SIM,1914,18,25-29,1932,10
STAT,1923,40,25-29,1963,0.09655179267839206
SIM,1922,20,15-19,1942,7
SIM,1849,5,na,1854,3286
STAT,1972,21,15-19,1993,7.89416982111363
SIM,1844,34,50-100,1878,4
STAT,1881,45,50-100,1926,0.2761100332011457
SIM,1905,7,na,1912,4623
STAT,1808,97,na,1905,2.739247955165168
STAT,1906,47,45-49,1953,0.22298549725778993
STAT,1943,37,20-24,1980,0.33239061154702876
STAT,1921,36,30-34,1957,2.349811921786626
SIM,1860,42,40-44,1902,6
STAT,1955,45,20-24,2000,0.0176931271776437
STAT,1949,60,na,2009,4776.045216316451
SIM,1950,41,na,1991,4710
STAT,1928,48,35-39,1976,0.1893171818603187
STAT,1836,46,15-19,1882,3.860138072128098E-4
SIM,1972,34,30-34,2006,2
STAT,1875,84,na,1959,530.4700199930174
SIM,1942,54,na,1996,4774
STAT,1769,99,na,1868,0.5030847830965917
SIM,1964,0,na,1964,5983
STAT,1981,26,30-34,2007,63.53139155256145
STAT,1892,32,na,1924,3451.6422459568084
STAT,1891,58,na,1949,2820.6832391366934
SIM,1904,37,na,1941,4100
STAT,1854,15,na,1869,2263.66110303942
SIM,1949,33,na,1982,5860
STAT,1920,24,20-24,1944,141.7065040024955
SIM,1946,29,25-29,1975,8
STAT,1877,18,45-49,1895,0.07821061934602695
STAT,1966,37,45-49,2003,1.0123683511572323
STAT,1903,9,na,1912,4264.99873331919
SIM,1814,47,40-44,1861,1
SIM,1919,36,na,1955,5355
STAT,1846,101,na,1947,0.5899004542768992
STAT,1893,19,40-44,1912,0.26537326638895303
STAT,1938,29,25-29,1967,75.21602101803919
SIM,1831,40,20-24,1871,1
SIM,1914,69,na,1983,3171
STAT,1863,48,25-29,1911,0.05739440536275896
SIM,1896,18,20-24,1914,2
SIM,1923,42,40-44,1965,2
STAT,1883,110,na,1993,0.029752413446419008
SIM,1896,49,40-44,1945,1
STAT,1886,41,35-39,1927,2.214297844557696
STAT,1960,46,40-44,2006,0.2471071893573693
STAT,1954,35,30-34,1989,2.68348960540637
SIM,1846,48,na,1894,1493
STAT,1939,46,45-49,1985,0.2619015274234802
SIM,1876,14,na,1890,2926
STAT,1880,31,na,1911,2930.963102879634
SIM,1834,90,na,1924,108
STAT,1802,54,45-49,1856,0.055484958406439674
STAT,1898,37,na,1935,3674.571240392978
STAT,1900,23,40-44,1923,3.326608004016069
STAT,1974,41,50-100,2015,0.18424478782827197
STAT,1977,37,20-24,2014,0.4234778864983238
SIM,1826,29,45-49,1855,3
STAT,1913,23,50-100,1936,0.7648353624071074
SIM,1909,58,na,1967,4415
STAT,1917,20,40-44,1937,4.1487709148149685
STAT,1804,50,na,1854,1567.6431915415253
STAT,1926,30,35-39,1956,12.763880971936171
SIM,1891,44,35-39,1935,1
SIM,1862,38,30-34,1900,13
STAT,1841,16,15-19,1857,6.845426252496208
STAT,2001,4,na,2005,6794.848382043508
STAT,1841,47,35-39,1888,0.12503690522499541
STAT,1915,42,40-44,1957,0.2906626924918466
STAT,1888,49,40-44,1937,0.1282705411929068
SIM,1941,17,50-100,1958,1
STAT,1801,85,na,1886,102.78664458079251
STAT,1883,44,35-39,1927,2.0169779346122287
STAT,1888,18,20-24,1906,23.98706416688417
STAT,1866,17,30-34,1883,1.7499427805128775
STAT,1970,35,45-49,2005,1.01637730037708
SIM,1934,30,35-39,1964,10
SIM,1901,30,na,1931,4081
STAT,1972,32,15-19,2004,0.19354842807788933
SIM,1847,46,40-44,1893,1
STAT,1857,54,35-39,1911,0.007525126781088685
SIM,1962,35,30-34,1997,2
STAT,1977,23,50-100,2000,1.02906040532042
STAT,1942,24,na,1966,4416.45170008871
STAT,1922,36,na,1958,4942.706652577026
SIM,1842,41,35-39,1883,4
SIM,1869,44,na,1913,1832
STAT,1918,52,na,1970,4434.868137340119
SIM,1874,17,30-34,1891,3
STAT,1888,59,na,1947,2636.4540963423246
STAT,1916,41,30-34,1957,0.15142878586865802
STAT,1896,47,25-29,1943,0.049294987177901324
SIM,1840,37,40-44,1877,8
STAT,1865,39,45-49,1904,2.0548388348953126
STAT,1943,43,40-44,1986,0.3176360018906474
STAT,1875,40,20-24,1915,0.19131080535363904
STAT,1964,19,25-29,1983,62.946333709926165
STAT,1850,42,30-34,1892,1.182064300993681
SIM,1847,65,na,1912,1840
SIM,1950,31,30-34,1981,42
STAT,1882,32,25-29,1914,11.545617242733465
STAT,1839,15,20-24,1854,18.610596689553216
SIM,1861,15,na,1876,2159
STAT,1851,19,50-100,1870,0.04668007308931013
SIM,1912,24,na,1936,4027
STAT,1839,46,40-44,1885,0.14011587143557325
STAT,1953,48,15-19,2001,5.334269498950339E-4
SIM,1880,43,20-24,1923,1
SIM,1839,78,na,1917,888
STAT,1789,87,na,1876,47.102844812302344
STAT,1941,32,40-44,1973,4.742797407930126
STAT,1927,42,45-49,1969,0.24082826124454473
STAT,1950,42,35-39,1992,0.2855543056711153
SIM,1976,8,na,1984,6048
STAT,1930,23,na,1953,5382.878157799642
STAT,1897,28,15-19,1925,0.6976592978061283
STAT,1949,40,30-34,1989,0.17881805107216805
STAT,1832,37,40-44,1869,3.8464795248190997
SIM,1849,39,40-44,1888,6
SIM,1834,47,na,1881,1815
STAT,1975,23,50-100,1998,1.0047568100132351
SIM,1841,18,30-34,1859,2
STAT,1776,107,na,1883,0.01183509448520177
STAT,1872,43,20-24,1915,0.18270347921207256
SIM,1870,83,na,1953,709
STAT,1810,45,40-44,1855,0.6959524953212489
STAT,1835,53,45-49,1888,0.00904852403032067
STAT,1898,90,na,1988,535.4522272233687
SIM,1885,82,na,1967,1356
STAT,1885,109,na,1994,0.07604503867152144
SIM,1858,16,35-39,1874,1
SIM,1955,29,na,1984,6533
SIM,1890,32,25-29,1922,17
SIM,1877,31,na,1908,3137
SIM,1940,67,na,2007,3886
SIM,1916,60,na,1976,4172
STAT,1839,27,15-19,1866,0.4532781646217247
SIM,1976,25,50-100,2001,5
STAT,1975,29,50-100,2004,1.5204328208400613
STAT,1849,57,na,1906,1557.6011212292176
STAT,1825,43,35-39,1868,2.6362275764693535
SIM,1859,12,na,1871,2579
SIM,1957,31,40-44,1988,18
STAT,1864,40,45-49,1904,1.5577616229924014
STAT,1974,32,25-29,2006,14.19711639387598
STAT,1890,38,40-44,1928,6.142188029066538
STAT,1920,55,na,1975,4537.610363662942
STAT,1840,32,20-24,1872,2.6410935115537355
STAT,1931,46,40-44,1977,0.2439442023810866
STAT,1931,18,na,1949,5546.557201415254
SIM,1982,32,25-29,2014,29
STAT,1787,75,na,1862,322.87064272347783
SIM,1824,69,na,1893,716
STAT,1826,48,20-24,1874,0.008522685269848436
SIM,1873,59,na,1932,2744
STAT,1895,47,50-100,1942,0.20714172479489634
STAT,1830,37,30-34,1867,5.389506498105554
STAT,1885,44,45-49,1929,1.6995418525734973
STAT,1938,40,na,1978,4408.173893569137
SIM,1893,24,50-100,1917,3
STAT,1941,41,30-34,1982,0.15819830051016553
STAT,1910,42,40-44,1952,0.273085221382857
STAT,1872,34,50-100,1906,1.0526571114433996
STAT,1859,47,50-100,1906,0.2247286332030767
STAT,1860,31,35-39,1891,9.457764825496792
STAT,1843,16,25-29,1859,7.309224285968031
STAT,1922,48,40-44,1970,0.20835441927832563
STAT,1949,31,40-44,1980,5.356956072883121
SIM,1833,43,35-39,1876,2
STAT,1838,94,na,1932,17.312141045800956
STAT,1895,35,15-19,1930,0.08515606106010616
SIM,1932,30,25-29,1962,1
STAT,1913,30,15-19,1943,0.14881241412793217
STAT,1964,37,35-39,2001,3.6220348678254144
STAT,1894,98,na,1992,62.29876276587157
STAT,1907,32,40-44,1939,4.228199377666322
STAT,1927,25,50-100,1952,1.405629567865221
STAT,1952,41,40-44,1993,0.36000506887392986
SIM,1873,49,na,1922,3081
STAT,1815,48,45-49,1863,0.4747705235910533
SIM,1915,32,40-44,1947,13
STAT,1952,38,25-29,1990,1.4014524900862857
STAT,1823,54,na,1877,1312.4071651072315
STAT,1924,30,25-29,1954,12.49707183424923
STAT,1847,17,50-100,1864,0.0470495867246873
SIM,1872,40,45-49,1912,3
STAT,1925,2,na,1927,5699.757356709033
STAT,1965,20,na,1985,5282.394278140244
SIM,1851,16,25-29,1867,16
STAT,1836,82,na,1918,424.621643019355
STAT,1992,23,na,2015,6067.13539199281
SIM,1916,70,na,1986,3433
SIM,1952,22,na,1974,4097
STAT,1865,17,15-19,1882,6.36774571839901
SIM,1823,84,na,1907,388
STAT,1920,45,na,1965,4706.680707302313
SIM,1932,19,50-100,1951,5
STAT,1852,38,20-24,1890,0.7231619225309885
SIM,1992,9,na,2001,7039
STAT,1911,29,50-100,1940,1.1131525683771903
SIM,1862,86,na,1948,92
STAT,1851,33,35-39,1884,8.27218715818474
STAT,1914,48,50-100,1962,0.25827458618219007
STAT,1945,41,15-19,1986,0.0020148326954751877
STAT,1896,44,20-24,1940,0.016583381248182663
STAT,1904,44,30-34,1948,0.13051876180387773
STAT,1861,71,na,1932,1280.6173511074846
STAT,1859,54,45-49,1913,0.012974452818740026
STAT,1888,69,na,1957,2056.9897520293
STAT,1950,20,25-29,1970,126.5459703452528
SIM,1884,11,na,1895,2998
STAT,1890,30,45-49,1920,2.478764681756675
STAT,1947,19,50-100,1966,0.4867104473325642
SIM,1849,15,30-34,1864,4
STAT,1954,46,30-34,2000,0.13261659872995302
STAT,1823,64,na,1887,1003.9365282098556
SIM,1912,44,30-34,1956,2
SIM,1841,27,na,1868,2224
SIM,1855,44,25-29,1899,2
STAT,1886,49,30-34,1935,0.11537539931700978
STAT,1952,42,45-49,1994,0.23919795502283475
STAT,1841,38,45-49,1879,2.066651813472354
STAT,1772,109,na,1881,4.055531982878773E-4
STAT,1899,28,25-29,1927,66.6461028766716
SIM,1873,17,15-19,1890,1
SIM,1879,51,50-100,1930,1
SIM,1901,31,35-39,1932,8
STAT,1864,48,40-44,1912,0.17419498000040132
STAT,1874,43,30-34,1917,1.348460501051734
STAT,1962,33,15-19,1995,0.19356871172841447
SIM,1962,46,na,2008,5425
SIM,1975,17,na,1992,5408
STAT,1902,26,na,1928,3904.8863601082553
STAT,1982,4,na,1986,6386.286945396264
STAT,1947,43,25-29,1990,0.0963188025451641
STAT,1814,46,50-100,1860,0.6941111680349026
STAT,1847,44,25-29,1891,0.48744095972104756
SIM,1841,17,na,1858,2435
STAT,1906,19,na,1925,4227.475986754853
STAT,1892,28,50-100,1920,0.922016075569146
STAT,1933,41,50-100,1974,0.186628042487772
SIM,1882,43,30-34,1925,4
STAT,1862,44,50-100,1906,1.0150243436762378
STAT,1939,43,40-44,1982,0.29992259149930717
STAT,1946,31,15-19,1977,0.16775978950051199
STAT,1915,45,45-49,1960,0.2539757599566453
STAT,1873,34,25-29,1907,11.9674598451176
STAT,1868,45,50-100,1913,0.2750281753590755
STAT,1888,39,50-100,1927,1.6487618812089049
STAT,1963,43,na,2006,5649.916772942674
STAT,1873,31,20-24,1904,3.1985453794606267
STAT,1958,42,na,2000,5850.19972144781
SIM,1992,5,na,1997,7039
STAT,1858,42,35-39,1900,1.6282431870132525
STAT,1866,59,na,1925,2078.849493799838
STAT,1920,30,40-44,1950,4.98437745827101
SIM,1944,40,45-49,1984,3
STAT,1836,50,35-39,1886,0.008250682796004803
STAT,1956,48,40-44,2004,0.24973353465829062
SIM,1857,8,na,1865,2981
STAT,1826,52,40-44,1878,0.007318781554847665
STAT,1870,63,na,1933,2030.0461001035453
STAT,1970,32,40-44,2002,5.762558082118348
STAT,1820,99,na,1919,1.1115099684233998
STAT,1846,53,20-24,1899,7.505995107836887E-4
SIM,1872,48,40-44,1920,1
STAT,1869,45,15-19,1914,4.514997743503441E-4
STAT,1852,54,35-39,1906,0.007893531738365944
STAT,1906,18,25-29,1924,9.511387662040924
SIM,1815,87,na,1902,140
SIM,1972,20,na,1992,5093
STAT,1974,12,na,1986,5919.433846575129
STAT,1807,47,na,1854,1733.949538095366
SIM,1866,42,35-39,1908,2
STAT,1962,46,15-19,2008,5.679805759678323E-4
STAT,1855,96,na,1951,7.306348617216691
STAT,1975,21,40-44,1996,5.137697246314661
SIM,1939,19,40-44,1958,5
STAT,1951,32,35-39,1983,12.800972461964818
STAT,1852,45,45-49,1897,0.22472223914386774
STAT,1877,96,na,1973,65.42507708302523
STAT,1848,53,30-34,1901,0.006223198137420534
STAT,1859,34,50-100,1893,0.8350973421747067
SIM,1880,47,50-100,1927,3
STAT,1795,72,na,1867,479.87785827089834
STAT,1886,47,na,1933,2725.9880335664625
SIM,1969,30,50-100,1999,3
SIM,1899,95,na,1994,27
SIM,1986,4,na,1990,6758
SIM,1837,29,20-24,1866,23
STAT,1927,81,na,2008,2523.1857764046435
STAT,1939,42,50-100,1981,0.14109216995651258
STAT,1920,31,45-49,1951,1.9963942547721993
STAT,1965,46,40-44,2011,0.23686206940869886
STAT,1925,40,35-39,1965,0.28203852692735953
SIM,1823,45,40-44,1868,1
STAT,1842,50,50-100,1892,0.011788959128306131
SIM,1995,19,na,2014,5913
SIM,1864,28,50-100,1892,1
STAT,1965,33,40-44,1998,5.743553896099384
SIM,1926,84,na,2010,2296
STAT,1896,111,na,2007,0.019190848167138723
STAT,1956,49,45-49,2005,0.3431950849890669
STAT,1839,79,na,1918,554.4252668472438
STAT,1791,91,na,1882,20.552466832994906
STAT,1905,88,na,1993,827.305615478044
SIM,1933,40,35-39,1973,1
SIM,1924,42,50-100,1966,2
SIM,1964,49,45-49,2013,1
STAT,1936,43,15-19,1979,0.0017533059521051154
SIM,1948,29,35-39,1977,18
STAT,1815,45,40-44,1860,0.3600748180270794
STAT,1853,33,50-100,1886,0.9297053794721228
STAT,1850,54,25-29,1904,0.0035460399890074367
SIM,1774,87,na,1861,154
SIM,1837,97,na,1934,15
STAT,1926,48,25-29,1974,0.07530885240391724
STAT,1930,34,30-34,1964,23.437575035116183
STAT,1856,42,25-29,1898,0.56469061347112
STAT,1834,27,na,1861,2588.6888127753837
STAT,1956,41,25-29,1997,0.11348925679736711
STAT,1816,84,na,1900,164.2856630803669
STAT,1845,44,15-19,1889,0.00923655973386651
STAT,1951,30,35-39,1981,12.815449832146651
STAT,1952,44,45-49,1996,0.2384020872149543
SIM,1863,19,20-24,1882,16
SIM,1898,18,30-34,1916,4
STAT,1884,41,25-29,1925,0.735513961966353
STAT,1829,50,50-100,1879,0.015480616090846328
STAT,1894,44,na,1938,3394.2139756727556
STAT,1954,48,30-34,2002,0.13191994973251175
STAT,1952,35,20-24,1987,0.37624153370923674
STAT,1962,30,45-49,1992,2.374456430572852
SIM,1951,0,na,1951,6464
SIM,1877,41,na,1918,3120
STAT,1941,44,35-39,1985,0.24798752218368125
SIM,1832,35,na,1867,2244
SIM,1833,40,30-34,1873,1
STAT,1786,90,na,1876,50.94573496714479
STAT,1947,40,20-24,1987,0.023924701422573653
STAT,1855,19,20-24,1874,17.731518143768
STAT,1815,54,30-34,1869,0.011223158252269909
STAT,1899,21,na,1920,3750.597725228022
STAT,1875,1,na,1876,4130.575499953359
STAT,1964,43,20-24,2007,0.02663467680552833
SIM,1961,14,na,1975,5663
SIM,1976,13,na,1989,6041
STAT,1825,40,30-34,1865,1.7814855409566854
STAT,1947,41,25-29,1988,0.09661034598217108
STAT,1830,33,50-100,1863,0.9719483156903911
SIM,1849,17,30-34,1866,4
STAT,1903,41,45-49,1944,0.17161037612825367
STAT,1865,39,50-100,1904,1.2655281334246522
STAT,1941,35,45-49,1976,0.8365159286924533
STAT,1978,18,50-100,1996,0.58988243959529
STAT,1931,49,45-49,1980,0.33347807698844006
SIM,1892,41,25-29,1933,4
STAT,1864,78,na,1942,805.1177048857852
STAT,1858,51,25-29,1909,0.0032040819229413606
STAT,1812,45,15-19,1857,9.587649910913742E-4
STAT,1966,19,35-39,1985,6.044378616949033
STAT,1898,16,15-19,1914,9.278734991431563
SIM,1917,55,na,1972,5013
STAT,1941,43,30-34,1984,0.15772090157539823
SIM,1916,18,35-39,1934,1
STAT,1852,42,40-44,1894,2.118036610704071
STAT,1874,46,35-39,1920,0.16587222216397668
STAT,1884,32,35-39,1916,11.547093193587905
STAT,1831,49,40-44,1880,0.15460389033617888
SIM,1844,41,45-49,1885,1
STAT,1879,77,na,1956,1088.7699753896945
STAT,1770,100,na,1870,0.09969878141130269
SIM,1888,43,25-29,1931,1
SIM,1947,21,na,1968,5333
STAT,1909,70,na,1979,3057.0328142432654
STAT,1881,26,na,1907,2665.6249074867033
STAT,1908,18,35-39,1926,0.9380733078561949
SIM,1892,32,35-39,1924,39
STAT,1958,41,35-39,1999,0.3176512635770947
SIM,1962,49,35-39,2011,1
SIM,1904,27,na,1931,3959
SIM,1881,34,25-29,1915,16
STAT,1863,45,20-24,1908,0.01223004714589354
STAT,1849,15,15-19,1864,5.729133132636943
SIM,1912,78,na,1990,1469
STAT,1851,30,30-34,1881,14.71304976867982
SIM,1923,20,30-34,1943,49
STAT,1841,44,30-34,1885,1.0352805829044205
STAT,1973,21,30-34,1994,43.05356362139562
SIM,1865,2,na,1867,3749
SIM,1810,66,na,1876,774
SIM,1849,18,35-39,1867,3
STAT,1841,35,40-44,1876,4.681760428549409
STAT,1836,41,45-49,1877,1.6418091020036856
STAT,1850,21,25-29,1871,71.24393206813525
STAT,1933,77,na,2010,3532.217033201614
STAT,1940,31,20-24,1971,2.915940029121663
SIM,1828,61,na,1889,1671
STAT,1936,40,45-49,1976,0.19084348822106928
SIM,1798,68,na,1866,1026
STAT,1915,20,30-34,1935,33.10326062502158
STAT,1954,49,35-39,2003,0.19020376446943285
STAT,1881,112,na,1993,0.004037234466114955
SIM,1896,39,50-100,1935,1
STAT,1949,13,na,1962,5271.34787035679
SIM,1800,88,na,1888,90
SIM,1830,54,na,1884,1477
STAT,1830,50,40-44,1880,0.00976439368111377
STAT,1930,37,35-39,1967,3.6414168442051777
SIM,1871,3,na,1874,2947
SIM,1884,15,25-29,1899,10
SIM,1860,20,na,1880,2552
STAT,1914,42,25-29,1956,0.08169756746873258
STAT,1876,15,25-29,1891,6.791696488120046
STAT,1862,40,35-39,1902,1.781405694686198
SIM,1870,40,35-39,1910,5
SIM,1885,92,na,1977,551
STAT,1955,48,50-100,2003,0.3594209911341874
SIM,1969,18,15-19,1987,63
SIM,1963,48,50-100,2011,1
SIM,1832,31,25-29,1863,5
STAT,1847,41,20-24,1888,0.12446535543630875
STAT,1925,42,35-39,1967,0.2812578203679574
SIM,1927,33,na,1960,5038
STAT,1903,12,na,1915,4245.069627316475
STAT,1966,7,na,1973,5665.700189801386
STAT,1996,7,na,2003,6592.339243228295
STAT,1845,64,na,1909,1171.401347550741
STAT,1966,34,40-44,2000,5.742356525490065
SIM,1969,35,na,2004,5759
SIM,1886,77,na,1963,622
STAT,1936,36,50-100,1972,0.4763922134129024
STAT,1897,47,40-44,1944,0.14832731603519966
STAT,1862,31,45-49,1893,1.7053055456507509
STAT,1983,31,na,2014,6297.344925118557
STAT,1885,50,30-34,1935,0.006950501468409223
SIM,1969,40,45-49,2009,3
SIM,1914,44,40-44,1958,1
STAT,1877,11,na,1888,3123.6531072992266
STAT,1824,31,25-29,1855,24.319706077242245
STAT,1940,32,25-29,1972,11.04285923259448
SIM,1974,34,40-44,2008,8
SIM,1944,36,50-100,1980,1
SIM,1981,20,15-19,2001,10
SIM,1989,23,na,2012,5870
STAT,1825,29,50-100,1854,2.647684321101444
SIM,1922,48,50-100,1970,2
SIM,1972,37,35-39,2009,2
SIM,1988,18,20-24,2006,241
STAT,1959,36,50-100,1995,0.65356825449503
STAT,1883,100,na,1983,18.213181100678494
STAT,1904,47,35-39,1951,0.130263211202035
STAT,1820,49,30-34,1869,0.09605176902273713
STAT,1926,45,20-24,1971,0.015807131765543197
STAT,1894,47,15-19,1941,3.331750272986286E-4
STAT,1897,41,50-100,1938,0.11371990883110382
SIM,1928,18,na,1946,5984
STAT,1928,19,15-19,1947,65.63813252359357
SIM,1936,19,15-19,1955,51
STAT,1930,43,20-24,1973,0.026777202401102537
STAT,1814,42,20-24,1856,0.5436085506207476
STAT,1898,80,na,1978,1667.5383643803807
SIM,1886,15,35-39,1901,1
STAT,1841,83,na,1924,352.9572281618404
STAT,1862,12,na,1874,2662.833040504672
STAT,1914,41,20-24,1955,0.02023391184153518
STAT,1945,43,15-19,1988,0.002008752484882201
STAT,1988,19,na,2007,6071.178032521133
SIM,1970,43,na,2013,5919
STAT,1847,45,na,1892,1748.4085953131946
STAT,1883,81,na,1964,913.1032249833712
STAT,1911,63,na,1974,3609.103770362079
STAT,1868,17,40-44,1885,0.2064687991664263
SIM,1869,19,15-19,1888,10
STAT,1875,30,na,1905,2868.7794029016864
STAT,1968,27,na,1995,5423.090658779509
STAT,1920,48,30-34,1968,0.11335809472029158
STAT,1817,79,na,1896,483.33348740952295
STAT,1965,49,45-49,2014,0.32379661679567506
STAT,1861,48,15-19,1909,3.78940576418194E-4
SIM,1867,34,50-100,1901,1
STAT,1956,46,40-44,2002,0.25105233910674535
STAT,1832,46,na,1878,1660.8362051583847
SIM,1951,36,na,1987,6253
STAT,1831,30,50-100,1861,0.9526223511535583
SIM,1965,23,40-44,1988,9
STAT,1911,30,40-44,1941,4.436809446001143
STAT,1811,51,50-100,1862,0.0458604850959127
STAT,1848,20,45-49,1868,0.91524595142397
STAT,1932,22,25-29,1954,139.90087852386065
STAT,1948,43,40-44,1991,0.342750510904939
STAT,1965,43,50-100,2008,0.1756232120751502
STAT,1925,45,40-44,1970,0.2214462181052371
STAT,1918,19,20-24,1937,169.3485622558053
SIM,1874,23,15-19,1897,7
STAT,1857,25,50-100,1882,0.6008169328284989
SIM,1848,15,15-19,1863,6
STAT,1833,105,na,1938,0.020632185058709663
SIM,1898,88,na,1986,952
SIM,1914,25,35-39,1939,3
STAT,1929,38,35-39,1967,3.580174121659524
SIM,1865,61,na,1926,2413
SIM,1945,39,25-29,1984,1
SIM,1896,22,40-44,1918,7
STAT,1921,29,20-24,1950,23.30158972346425
STAT,1888,22,40-44,1910,2.826842136833604
SIM,1795,61,na,1856,1218
STAT,1866,23,15-19,1889,3.532109602332258
STAT,1946,37,25-29,1983,1.298403262963772
STAT,1915,23,35-39,1938,11.199782454503266
STAT,1923,20,na,1943,4931.009055020003
STAT,1839,22,45-49,1861,0.7105531907493189
STAT,1946,17,na,1963,4711.319109808518
STAT,1885,24,50-100,1909,0.46647271973845617
STAT,1912,39,50-100,1951,0.46859936554486425
SIM,1842,13,na,1855,2725
STAT,1973,24,35-39,1997,14.090532098494743
SIM,1884,44,na,1928,2600
SIM,1922,23,na,1945,4911
SIM,1924,58,na,1982,4504
STAT,1847,12,na,1859,2292.5949081305944
STAT,1941,20,25-29,1961,110.26478771364839
SIM,1963,28,35-39,1991,5
STAT,1875,21,15-19,1896,3.946279239822541
STAT,1952,33,na,1985,5328.233484432943
SIM,1907,22,40-44,1929,9
SIM,1931,24,25-29,1955,147
SIM,1894,74,na,1968,2443
STAT,1902,32,40-44,1934,7.071571409264837
SIM,1919,49,25-29,1968,1
SIM,1940,48,35-39,1988,1
STAT,1960,33,40-44,1993,5.9919828604501895
SIM,1940,22,25-29,1962,225
SIM,1972,26,35-39,1998,2
STAT,1862,48,30-34,1910,0.09309206800290944
STAT,1927,17,20-24,1944,194.49695904999405
STAT,1955,28,35-39,1983,23.089286948183467
STAT,1923,42,25-29,1965,0.09628452912866628
STAT,1964,26,35-39,1990,21.926680398988708
STAT,1910,29,45-49,1939,1.913477935563467
SIM,1888,58,na,1946,2298
STAT,1932,48,35-39,1980,0.20132583957381217
SIM,1926,19,20-24,1945,369
STAT,1925,55,na,1980,4974.69280724184
STAT,1921,41,na,1962,4832.642930843815
STAT,1951,35,40-44,1986,2.1231128849522873
SIM,1867,96,na,1963,38
SIM,1905,75,na,1980,2353
SIM,1901,61,na,1962,3276
STAT,1927,40,45-49,1967,0.2414967447128338
SIM,1935,17,20-24,1952,406
STAT,2002,5,na,2007,6839.692264560133
STAT,1934,43,40-44,1977,0.40137482229355603
SIM,1922,26,25-29,1948,119
SIM,2004,3,na,2007,7412
STAT,1955,35,25-29,1990,1.5567485739897438
STAT,1859,20,20-24,1879,73.27862715127985
STAT,1904,25,50-100,1929,1.0673026429995542
STAT,1930,27,20-24,1957,26.7896991288181
SIM,1942,43,40-44,1985,2
STAT,1937,39,25-29,1976,1.1344264541655544
SIM,1956,25,40-44,1981,1
SIM,1852,43,na,1895,1903
STAT,1914,20,50-100,1934,0.7492574711408648
STAT,1907,19,45-49,1926,0.11032114040988146
STAT,1937,56,na,1993,4123.024938715645
SIM,1905,27,35-39,1932,39
SIM,1937,38,35-39,1975,4
STAT,1857,25,15-19,1882,0.4261300794742997
SIM,1833,52,na,1885,1409
SIM,1905,34,25-29,1939,1
STAT,1983,19,na,2002,6004.986834350884
SIM,1923,23,35-39,1946,18
STAT,1915,30,25-29,1945,10.952624797368504
STAT,1972,27,25-29,1999,97.67679905674169
SIM,1867,20,20-24,1887,69
STAT,1932,15,35-39,1947,6.443621554433691
SIM,1955,19,50-100,1974,1
SIM,1939,33,40-44,1972,14
STAT,1867,20,50-100,1887,0.4476040654431745
STAT,1900,37,35-39,1937,2.4446743310007535
STAT,1943,18,15-19,1961,55.52692530507331
STAT,1948,25,40-44,1973,6.187695433390036
STAT,1916,47,40-44,1963,0.18664152952828744
STAT,1852,98,na,1950,3.062768266122517
SIM,1860,100,na,1960,2
STAT,1859,16,35-39,1875,0.5890078391441543
SIM,1951,18,15-19,1969,119
STAT,1890,48,35-39,1938,0.10996029551131115
STAT,1953,30,45-49,1983,2.241780476992816
STAT,1877,42,na,1919,2771.100154604994
STAT,1974,18,45-49,1992,0.7525312314574003
STAT,1916,96,na,2012,174.31445603322942
STAT,1826,50,na,1876,1354.4124245590335
STAT,1849,47,na,1896,1735.6504916400206
STAT,1899,22,15-19,1921,5.215989352461911
STAT,1878,30,30-34,1908,21.20729145533762
STAT,1908,43,na,1951,3946.6404946143034
STAT,1948,29,50-100,1977,1.3189050994559273
STAT,1852,48,15-19,1900,3.723864661216078E-4
SIM,1910,22,na,1932,3578
STAT,1925,15,45-49,1940,0.6994125955604339
STAT,1847,41,50-100,1888,0.827965174727879
SIM,1876,45,na,1921,2539
SIM,1858,18,35-39,1876,1
STAT,1897,94,na,1991,224.5382323094193
STAT,1893,80,na,1973,1489.8357171001178
SIM,1837,30,35-39,1867,6
SIM,1849,67,na,1916,1925
SIM,1961,39,25-29,2000,4
STAT,1914,26,25-29,1940,76.8745148315259
SIM,1923,30,25-29,1953,2
STAT,1942,37,40-44,1979,1.8603252443849323
SIM,1821,51,na,1872,1363
SIM,1886,30,30-34,1916,52
STAT,1899,18,30-34,1917,2.513417402426169
STAT,1918,42,45-49,1960,0.20416636044581454
SIM,1946,36,35-39,1982,1
STAT,1897,42,na,1939,3574.4633322463346
SIM,1950,37,40-44,1987,5
STAT,1938,43,25-29,1981,0.08438974451577257
STAT,1775,108,na,1883,0.0068625281182816845
STAT,1840,97,na,1937,4.309620946630521
STAT,1822,68,na,1890,1255.6078952025782
SIM,1793,90,na,1883,22
STAT,1929,45,25-29,1974,0.0797250086696682
STAT,1883,15,15-19,1898,6.7317877220028945
STAT,1904,37,20-24,1941,0.27572972082925906
STAT,1913,35,20-24,1948,0.30323149113460895
STAT,1938,36,35-39,1974,2.840763953171273
SIM,1901,34,40-44,1935,4
SIM,1872,21,40-44,1893,6
STAT,1886,41,50-100,1927,1.2918496439722684
STAT,1927,47,15-19,1974,5.335119195265978E-4
STAT,1920,38,15-19,1958,0.024229458090183086
STAT,1795,105,na,1900,0.005137819009556268
STAT,1963,46,30-34,2009,0.13628788242889983
STAT,1784,89,na,1873,38.90514493378706
STAT,1780,75,na,1855,555.74727
STAT,1971,6,na,1977,5746.060057025825
STAT,1957,41,40-44,1998,0.39608361806557235
SIM,1858,25,25-29,1883,90
STAT,1909,17,na,1926,4375.914462679588
SIM,1964,19,40-44,1983,4
STAT,1932,82,na,2014,2524.414379018409
STAT,1913,28,30-34,1941,44.92124051511109
STAT,1935,21,na,1956,5743.887273084127
STAT,1864,21,40-44,1885,2.1975511312427956
SIM,1921,28,30-34,1949,150
STAT,1954,37,30-34,1991,2.6788491708089612
STAT,1923,24,25-29,1947,123.21014024265563
STAT,1913,32,15-19,1945,0.14762577715182998
SIM,1951,25,50-100,1976,2
STAT,1835,24,50-100,1859,0.33619472985847443
SIM,1961,30,45-49,1991,4
STAT,1871,53,20-24,1924,8.336216007919993E-4
STAT,1943,41,40-44,1984,0.3185974412904461
STAT,1939,35,na,1974,4487.048536701203
STAT,1964,33,25-29,1997,13.685452653663068
STAT,1957,23,40-44,1980,5.131263834553029
SIM,1835,31,na,1866,2543
STAT,1849,31,15-19,1880,0.12914550828067603
SIM,1906,92,na,1998,390
SIM,1883,70,na,1953,1421
STAT,1792,76,na,1868,560.5646820435986
SIM,1979,34,na,2013,6390
STAT,1893,38,50-100,1931,1.7820481118694476
SIM,1930,22,na,1952,5445
STAT,1860,50,40-44,1910,0.009932571005429838
SIM,1816,40,na,1856,1827
STAT,1963,29,25-29,1992,96.82427331656368
STAT,1923,17,35-39,1940,5.684211355479144
SIM,1903,98,na,2001,57
STAT,1968,26,20-24,1994,26.43707696733778
SIM,1898,24,na,1922,4048
STAT,1923,78,na,2001,2848.869775547925
STAT,1813,52,20-24,1865,0.002343214897205222
SIM,1936,15,na,1951,4075
STAT,1926,17,na,1943,5206.901352970713
STAT,1953,37,15-19,1990,0.027619811324350124
STAT,1867,12,na,1879,2889.649660007928
STAT,1852,16,50-100,1868,0.05619629408437185
SIM,1847,32,na,1879,2604
STAT,1932,18,40-44,1950,2.1323393862512723
STAT,1910,17,50-100,1927,0.08576143665950324
SIM,1965,42,na,2007,5504
SIM,1854,22,35-39,1876,14
SIM,1907,25,45-49,1932,2
STAT,1931,31,20-24,1962,3.6914028587722463
SIM,1913,34,30-34,1947,40
SIM,1954,34,20-24,1988,11
STAT,1880,113,na,1993,0.0014866149725182901
SIM,1972,23,30-34,1995,111
STAT,1837,46,na,1883,1712.9707358009493
STAT,1833,32,na,1865,1962.7846190213997
STAT,1868,21,25-29,1889,63.93110620293912
STAT,1985,22,na,2007,6013.82831527348
SIM,1958,27,15-19,1985,1
STAT,1957,26,45-49,1983,2.6412266259237187
SIM,1984,25,na,2009,6256
STAT,1896,4,na,1900,4009.9207632950365
SIM,1883,27,na,1910,2603
STAT,1881,47,na,1928,2492.6877705394822
STAT,1964,23,30-34,1987,41.90016706178626
SIM,1906,49,na,1955,3404
STAT,1928,47,30-34,1975,0.13126422308140917
STAT,1846,22,35-39,1868,7.443413336033724
STAT,1902,35,45-49,1937,0.7082844445574916
STAT,1961,38,na,1999,5773.273274538709
SIM,1879,10,na,1889,3078
SIM,1905,31,20-24,1936,4
STAT,1779,98,na,1877,0.504735112432898
STAT,1919,49,30-34,1968,0.1109054577155666
STAT,1854,32,35-39,1886,8.449000002163126
SIM,1980,26,30-34,2006,6
STAT,1938,33,30-34,1971,18.279870472312975
STAT,1805,68,na,1873,902.044403018614
STAT,1878,15,35-39,1893,0.6642420254443749
STAT,1883,38,na,1921,2646.9214733339086
STAT,1962,35,15-19,1997,0.029305118732600777
STAT,1971,38,30-34,2009,2.7417946698613833
STAT,1819,42,50-100,1861,2.22125896643066
SIM,1895,31,35-39,1926,28
STAT,1881,16,na,1897,2818.230347763995
STAT,1826,39,50-100,1865,0.9431240591729354
SIM,1928,37,30-34,1965,4
STAT,1937,36,20-24,1973,0.30464574510532094
STAT,1965,17,40-44,1982,2.0152128787765426
STAT,1838,63,na,1901,1545.5822409865225
STAT,1884,15,30-34,1899,1.8258071253540051
SIM,1919,39,30-34,1958,2
SIM,1946,33,30-34,1979,36
STAT,1958,37,15-19,1995,0.029987604357553654
STAT,1932,4,na,1936,6169.331882903741
STAT,1923,21,20-24,1944,149.705832756697
SIM,1912,57,na,1969,3515
STAT,1887,31,35-39,1918,13.151092476232948
STAT,1914,19,35-39,1933,0.996821562605162
STAT,1898,68,na,1966,2696.684676576225
SIM,1818,83,na,1901,421
SIM,1866,79,na,1945,565
SIM,1899,10,na,1909,4531
STAT,1905,41,20-24,1946,0.018504170094776784
STAT,1969,37,50-100,2006,0.6235821915638945
SIM,1934,2,na,1936,6095
STAT,1945,39,30-34,1984,2.362097754358725
SIM,1931,21,20-24,1952,182
SIM,1953,39,30-34,1992,3
STAT,1885,47,15-19,1932,4.582967063528662E-4
SIM,1945,36,20-24,1981,2
STAT,1781,92,na,1873,8.305672229215892
STAT,1983,16,45-49,1999,0.8157526224936406
STAT,1911,1,na,1912,4811.011368110896
STAT,1921,26,15-19,1947,0.9107684591633025
STAT,1838,31,40-44,1869,4.717459949973708
STAT,1961,24,45-49,1985,1.6820320452792987
STAT,1846,50,na,1896,2257.8934228072744
SIM,1919,67,na,1986,4460
STAT,1899,25,20-24,1924,18.674088210669645
STAT,1836,34,50-100,1870,1.0327022497953577
SIM,1977,37,50-100,2014,1
SIM,1997,16,50-100,2013,1
SIM,1896,25,45-49,1921,3
SIM,1879,30,40-44,1909,7
SIM,1896,45,na,1941,3531
STAT,1835,98,na,1933,2.024666028721652
STAT,1910,77,na,1987,2397.904128822397
STAT,1945,46,20-24,1991,0.014527100343072601
STAT,1959,28,20-24,1987,27.66151372215661
SIM,1838,21,40-44,1859,2
SIM,1817,66,na,1883,676
SIM,1967,28,20-24,1995,2
STAT,1888,25,45-49,1913,1.5164276281229425
SIM,1813,52,na,1865,1241
SIM,1846,31,40-44,1877,15
STAT,1905,34,30-34,1939,16.602230694689197
STAT,1917,56,na,1973,4263.515821160926
STAT,1904,93,na,1997,323.01157399032274
SIM,1922,19,35-39,1941,15
SIM,1905,24,30-34,1929,77
STAT,1989,16,50-100,2005,0.6194751818304222
SIM,1924,17,45-49,1941,1
SIM,1824,79,na,1903,30
STAT,1828,42,35-39,1870,1.7419703344361785
SIM,1917,18,15-19,1935,1
SIM,1940,52,na,1992,4820
STAT,1981,18,35-39,1999,6.769215521455204
STAT,1951,20,40-44,1971,4.639148797835265
STAT,1943,44,45-49,1987,0.21098118207770192
STAT,1938,40,20-24,1978,0.020961633526542418
STAT,1963,26,20-24,1989,26.89097614531923
STAT,1818,86,na,1904,98.17159840035492
SIM,1836,42,35-39,1878,3
SIM,1971,26,20-24,1997,2
SIM,1917,44,45-49,1961,1
SIM,1838,19,20-24,1857,25
SIM,1909,27,20-24,1936,29
STAT,1936,45,15-19,1981,4.235936418207697E-4
STAT,1938,18,na,1956,4190.8899701392065
STAT,1935,79,na,2014,3247.2719701890587
STAT,1916,17,45-49,1933,0.1223240581357976
SIM,1847,96,na,1943,88
STAT,1909,18,15-19,1927,10.255378796977887
STAT,1931,24,30-34,1955,42.75920330818147
SIM,1973,17,40-44,1990,6
STAT,1889,36,15-19,1925,0.08026823877200726
SIM,1939,36,45-49,1975,1
SIM,1939,37,50-100,1976,2
STAT,1937,29,30-34,1966,44.05887920454037
SIM,1902,25,45-49,1927,5
STAT,1860,53,45-49,1913,0.013281395046178097
STAT,1863,50,na,1913,2204.00720824661
SIM,1914,28,40-44,1942,5
STAT,1855,11,na,1866,2427.0351454598867
STAT,1779,104,na,1883,0.029172752699938048
STAT,1963,49,35-39,2012,0.19546925903544027
SIM,1971,38,na,2009,5711
STAT,1858,25,30-34,1883,23.545003012121576
STAT,1909,44,45-49,1953,0.1776401208214648
SIM,1878,0,na,1878,4131
STAT,1920,15,45-49,1935,0.13031237644433907
STAT,1965,45,na,2010,5531.487161343429
SIM,1900,31,40-44,1931,9
STAT,1906,28,40-44,1934,5.023402772245297
STAT,1941,46,35-39,1987,0.15984693845318435
SIM,1862,32,35-39,1894,23
STAT,1778,93,na,1871,8.952379143102865
STAT,1940,16,25-29,1956,50.80846904106703
SIM,1870,52,na,1922,2836
STAT,1881,47,30-34,1928,0.10724855694580751
SIM,1824,40,50-100,1864,1
STAT,1964,30,20-24,1994,3.6179660893661607
STAT,1917,28,15-19,1945,0.8514075395322713
STAT,1903,46,15-19,1949,3.719436092308299E-4
STAT,1925,30,40-44,1955,5.3672624723400455
STAT,1933,22,40-44,1955,5.149329724461454
STAT,1936,23,50-100,1959,0.7261749520855947
STAT,1979,32,50-100,2011,1.33914687841728
SIM,1877,62,na,1939,2258
STAT,1791,109,na,1900,1.5229930219114242E-4
SIM,1828,32,35-39,1860,24
SIM,1866,25,30-34,1891,57
SIM,1935,41,na,1976,6240
STAT,1910,26,40-44,1936,5.21751189904999
SIM,1872,29,50-100,1901,1
STAT,1850,51,50-100,1901,0.01562185438195519
STAT,1949,49,45-49,1998,0.30163961733609196
SIM,1923,40,na,1963,5365
STAT,1833,52,50-100,1885,0.011028039085919603
STAT,1897,20,40-44,1917,3.23478196842827
SIM,1876,21,25-29,1897,69
STAT,1949,16,45-49,1965,0.6706570387171197
SIM,1925,28,15-19,1953,2
STAT,1935,34,45-49,1969,2.5105117727578135
SIM,1898,2,na,1900,4316
SIM,1947,27,40-44,1974,13
STAT,1926,72,na,1998,3873.236997201985
STAT,1817,69,na,1886,1132.701061595092
SIM,1897,18,15-19,1915,19
STAT,1889,18,15-19,1907,8.42019070815101
STAT,1963,19,30-34,1982,17.85878085963003
SIM,1933,30,40-44,1963,9
SIM,1971,19,30-34,1990,43
STAT,1898,47,50-100,1945,0.21506896480841903
STAT,1947,37,40-44,1984,2.0048817420896605
SIM,1858,22,20-24,1880,92
STAT,1939,27,40-44,1966,5.409810838360839
SIM,1935,10,na,1945,6477
SIM,1883,21,15-19,1904,8
STAT,1858,32,20-24,1890,2.433525940141958
STAT,1864,29,50-100,1893,0.6544544536120924
STAT,1851,20,15-19,1871,3.1694949505126697
STAT,1838,34,45-49,1872,1.8387411977185701
STAT,1941,38,na,1979,4603.843062987812
STAT,1980,18,20-24,1998,217.1338035408614
STAT,1882,64,na,1946,1959.5036794170965
STAT,1956,35,40-44,1991,2.359236784011984
SIM,1883,79,na,1962,950
SIM,1930,36,25-29,1966,3
STAT,1901,44,40-44,1945,0.24907735696458633
STAT,1823,49,35-39,1872,0.1345059549056727
STAT,1905,18,30-34,1923,2.6553005497752196
STAT,1924,42,40-44,1966,0.34325174254789564
STAT,1953,7,na,1960,5487.367396778392
STAT,1931,15,20-24,1946,205.78782046733394
STAT,1819,48,na,1867,1772.1229057021378
STAT,1876,21,30-34,1897,21.313831746463137
SIM,1904,39,35-39,1943,4
STAT,1922,67,na,1989,4090.742953630951
SIM,1947,56,na,2003,5619
SIM,1955,37,40-44,1992,1
STAT,1872,49,30-34,1921,0.10982998679660674
SIM,1983,14,na,1997,7024
STAT,1922,36,25-29,1958,1.2935585468797606
SIM,1850,52,na,1902,1379
SIM,1930,17,20-24,1947,353
STAT,1905,37,35-39,1942,2.549960761096039
SIM,1906,40,na,1946,3576
SIM,1900,46,40-44,1946,1
STAT,1950,47,40-44,1997,0.22377580744387804
STAT,1773,108,na,1881,0.009427379100226311
STAT,1931,34,25-29,1965,13.96156078948503
STAT,1922,17,20-24,1939,180.9948823375895
STAT,1793,70,na,1863,672.0284071604613
STAT,1910,30,25-29,1940,10.378116200398997
SIM,1822,33,50-100,1855,1
SIM,1941,36,35-39,1977,3
STAT,1961,21,40-44,1982,5.031503180445286
STAT,1911,17,45-49,1928,0.11546022406877172
STAT,1933,36,35-39,1969,3.8071618070056985
SIM,1906,34,40-44,1940,1
SIM,1816,49,na,1865,1595
SIM,1948,15,50-100,1963,1
STAT,1872,21,50-100,1893,0.4739750907066254
SIM,1803,86,na,1889,106
STAT,1942,34,35-39,1976,11.221476163496307
SIM,1852,66,na,1918,1360
SIM,1932,24,40-44,1956,15
STAT,1907,46,35-39,1953,0.1344725901653407
STAT,1910,25,na,1935,4206.007747744645
SIM,1915,20,25-29,1935,253
STAT,1877,15,40-44,1892,0.2205851790807767
STAT,1905,0,na,1905,4904.6284011135285
STAT,1833,63,na,1896,1255.5679712521471
STAT,1965,21,25-29,1986,133.5660075263958
SIM,1884,46,50-100,1930,1
SIM,1899,27,35-39,1926,44
STAT,1849,34,20-24,1883,2.1622903073899353
STAT,1984,11,na,1995,6439.448172824935
STAT,1880,22,35-39,1902,7.138199859595854
STAT,1941,18,50-100,1959,0.44531732022801307
STAT,1954,28,20-24,1982,26.142265498686847
STAT,1850,32,na,1882,2569.8272864417104
STAT,1886,40,30-34,1926,1.4136254566148543
STAT,1914,39,na,1953,4293.405730280007
SIM,1845,40,35-39,1885,8
STAT,1910,46,na,1956,3969.610658068306
SIM,1846,34,45-49,1880,1
STAT,1884,76,na,1960,1266.8222533919945
STAT,1939,24,35-39,1963,10.910028681870205
STAT,1970,15,20-24,1985,195.96034676537178
STAT,1806,85,na,1891,94.08861450702328
SIM,1853,45,50-100,1898,1
STAT,1905,44,25-29,1949,0.07347878860464842
STAT,1933,43,25-29,1976,0.11309824312039458
STAT,1967,22,na,1989,5281.7087333498675
STAT,1880,62,na,1942,2235.756100168649
SIM,1867,32,na,1899,2280
STAT,1903,103,na,2006,7.990291846456891
STAT,1837,40,35-39,1877,1.587452972482089
SIM,1988,15,15-19,2003,134
STAT,1815,104,na,1919,0.03701062799613789
STAT,1870,46,15-19,1916,4.56381374998628E-4
STAT,1909,41,40-44,1950,0.27184985739802964
STAT,1802,71,na,1873,835.7204776347058
SIM,1855,41,50-100,1896,1
SIM,1964,48,na,2012,5706
SIM,1973,21,25-29,1994,152
SIM,1857,34,20-24,1891,7
STAT,1922,29,35-39,1951,19.457215547446367
SIM,1959,18,20-24,1977,197
STAT,1907,20,25-29,1927,97.78155965936564
STAT,1840,105,na,1945,0.023521086976606757
SIM,1930,29,35-39,1959,5
STAT,1910,23,35-39,1933,10.18358039555262
STAT,1986,13,na,1999,6458.319913025238
STAT,1943,28,45-49,1971,2.1225458575466427
SIM,1857,27,30-34,1884,7
STAT,1823,33,na,1856,1617.6667593539398
SIM,1948,15,40-44,1963,6
STAT,1908,37,40-44,1945,1.6195514025436126
STAT,1875,24,20-24,1899,81.67023379247821
SIM,1917,41,40-44,1958,1
STAT,2007,2,na,2009,7068.8070718611125
STAT,1848,43,15-19,1891,0.014567329743151489
STAT,1879,13,na,1892,3107.148696121994
STAT,1942,41,25-29,1983,0.08964452203154323
SIM,1820,34,na,1854,2029
SIM,1838,23,50-100,1861,1
SIM,1868,20,35-39,1888,8
STAT,1921,38,30-34,1959,2.3453024426089324
SIM,1906,61,na,1967,3143
SIM,1927,30,45-49,1957,1
SIM,1930,34,50-100,1964,3
STAT,1878,27,na,1905,2875.6544454161963
SIM,1824,48,na,1872,1463
SIM,1914,16,25-29,1930,26
STAT,1920,27,50-100,1947,1.2595342122914508
SIM,1943,8,na,1951,5502
STAT,1916,44,35-39,1960,0.23737580791797874
STAT,1858,28,35-39,1886,8.828784113328194
STAT,1920,76,na,1996,2974.613593719421
SIM,1883,58,na,1941,2078
STAT,1924,24,40-44,1948,4.548808683812447
STAT,1943,25,50-100,1968,1.2245404455301696
STAT,1990,23,50-100,2013,1.0907089403000747
STAT,1829,47,na,1876,1799.0357240636713
SIM,1895,60,na,1955,2766
STAT,1912,32,20-24,1944,2.77250131084922
SIM,1858,31,30-34,1889,4
STAT,1971,44,15-19,2015,0.0023249634214249264
STAT,1924,38,na,1962,5113.133070877586
SIM,1913,25,20-24,1938,22
SIM,1873,28,na,1901,3461
SIM,1899,74,na,1973,2399
STAT,1847,76,na,1923,728.9838650317968
SIM,1942,23,na,1965,4664
STAT,1919,30,45-49,1949,1.9745133206801755
SIM,1890,38,35-39,1928,22
SIM,1904,27,20-24,1931,32
SIM,1863,0,na,1863,3949
STAT,1900,33,50-100,1933,1.461043273527476
SIM,1834,21,20-24,1855,3
STAT,1849,27,30-34,1876,23.136390546545634
STAT,1905,25,20-24,1930,19.72824595090254
STAT,1921,87,na,2008,1232.9394859918223
STAT,1954,44,20-24,1998,0.02609686965620727
SIM,1899,3,na,1902,4594
SIM,1845,84,na,1929,404
STAT,1848,51,50-100,1899,0.016123869020832036
SIM,1950,34,35-39,1984,27
SIM,1943,31,40-44,1974,8
STAT,1846,81,na,1927,559.0326649014335
SIM,1849,21,15-19,1870,4
STAT,1945,20,45-49,1965,1.4241283574770753
SIM,1937,53,na,1990,4116
STAT,1991,20,50-100,2011,1.0925974503867957
STAT,1950,32,40-44,1982,5.443096681926303
SIM,1840,47,35-39,1887,1
SIM,1837,66,na,1903,1536
SIM,1942,27,40-44,1969,9
STAT,1917,38,45-49,1955,0.8131241894230785
STAT,1973,42,25-29,2015,0.1107633123123726
STAT,1853,29,na,1882,2468.996983400546
STAT,1934,27,40-44,1961,7.239740937934153
SIM,1832,66,na,1898,1424
STAT,1829,26,50-100,1855,1.593978406367707
STAT,1875,17,30-34,1892,1.9008413960296004
STAT,1882,97,na,1979,54.61161526360317
STAT,1949,39,15-19,1988,0.026497217105495702
SIM,1851,26,na,1877,2819
STAT,1832,47,35-39,1879,0.11491718390706807
STAT,1857,41,15-19,1898,0.012468585571759332
STAT,1931,27,35-39,1958,22.373982282853856
SIM,1953,20,45-49,1973,3
STAT,1935,31,40-44,1966,6.2550887936858866
STAT,1921,24,50-100,1945,0.8519987890691778
SIM,1938,45,40-44,1983,1
SIM,1860,40,40-44,1900,3
STAT,1876,39,20-24,1915,0.9103509924815867
STAT,1906,22,30-34,1928,29.975774694362592
SIM,1859,25,40-44,1884,4
STAT,1981,15,30-34,1996,19.679682741968485
SIM,1950,41,25-29,1991,1
STAT,1897,23,45-49,1920,1.072735475188659
STAT,1809,47,50-100,1856,0.6304920816182012
STAT,1870,32,na,1902,2714.963802103533
STAT,1943,20,na,1963,4487.305355080501
SIM,1868,58,na,1926,2561
STAT,1929,35,30-34,1964,2.70513306259251
SIM,1864,44,na,1908,2670
SIM,1894,10,na,1904,4153
STAT,1853,36,15-19,1889,0.056492111590885755
STAT,1901,47,45-49,1948,0.21418885202009036
SIM,1941,33,30-34,1974,1
SIM,1984,18,35-39,2002,17
SIM,1934,26,15-19,1960,1
STAT,1837,77,na,1914,625.9306614071816
STAT,1858,35,25-29,1893,2.616718402006688
STAT,1803,97,na,1900,1.8724390469903593
STAT,1944,43,20-24,1987,0.022758491837891054
SIM,1881,8,na,1889,2173
STAT,1867,43,na,1910,2472.344479757669
STAT,1822,37,na,1859,2361.0177224274994
STAT,1960,36,45-49,1996,1.056630839659365
SIM,1962,37,30-34,1999,3
STAT,1918,42,na,1960,4556.029402432729
STAT,1904,34,15-19,1938,0.13435143104919084
SIM,1921,61,na,1982,4743
STAT,1956,19,40-44,1975,2.1345122751093335
STAT,1970,22,45-49,1992,1.6308303072419172
SIM,1834,78,na,1912,546
SIM,1930,33,20-24,1963,8
STAT,1918,35,20-24,1953,0.32362859659510346
STAT,1932,45,30-34,1977,0.14024749123825325
STAT,1933,33,30-34,1966,24.498489084779393
STAT,1864,24,na,1888,2440.803040627243
SIM,1867,23,25-29,1890,107
STAT,1818,63,na,1881,876.8466284917879
STAT,1872,98,na,1970,23.660226636983825
STAT,1896,56,na,1952,3108.98578070467
SIM,1937,35,30-34,1972,2
STAT,1926,26,15-19,1952,0.9797889467442034
SIM,1834,37,na,1871,1939
SIM,1869,41,35-39,1910,1
STAT,1842,18,30-34,1860,1.5657395583111242
STAT,1931,18,25-29,1949,65.30205385627823
SIM,1947,21,30-34,1968,95
SIM,1958,37,45-49,1995,2
STAT,1922,33,20-24,1955,3.165700010719211
STAT,1859,23,25-29,1882,54.2093873947981
STAT,1886,43,35-39,1929,2.1884002584009314
STAT,1957,46,35-39,2003,0.20455928750549274
STAT,1823,46,30-34,1869,0.09699200353142129
STAT,1933,25,45-49,1958,2.650764368388628
STAT,1911,33,45-49,1944,1.762375224806335
STAT,1955,42,50-100,1997,0.18704209933079594
STAT,1912,21,45-49,1933,1.2493823347410529
STAT,1939,21,30-34,1960,33.33554834429058
STAT,1980,22,na,2002,5869.820378003934
STAT,1882,38,35-39,1920,7.933158569763811
STAT,1963,23,15-19,1986,7.827853126487536
STAT,1843,38,50-100,1881,1.2951765961099933
SIM,1955,41,na,1996,6486
SIM,1926,35,20-24,1961,3
STAT,1888,38,na,1926,3180.206329309387
SIM,1851,38,50-100,1889,3
SIM,1941,25,45-49,1966,4
SIM,1920,21,45-49,1941,3
STAT,1907,16,40-44,1923,0.3113275158385193
STAT,1907,43,30-34,1950,0.13457911044990875
SIM,1866,28,35-39,1894,16
STAT,1820,37,15-19,1857,0.12322537867170559
SIM,1937,15,50-100,1952,2
SIM,1926,26,45-49,1952,2
SIM,1834,24,25-29,1858,56
SIM,1942,7,na,1949,5084
STAT,1929,15,50-100,1944,0.5543835893961154
SIM,1963,32,20-24,1995,1
SIM,1904,58,na,1962,3653
STAT,1934,46,45-49,1980,0.3504927004748593
STAT,1920,7,na,1927,5173.409028166503
SIM,1963,25,30-34,1988,76
STAT,1827,46,15-19,1873,5.134470770642729E-4
STAT,1901,32,45-49,1933,2.8188584726738464
STAT,1910,20,30-34,1930,31.36686335325833
STAT,1850,55,na,1905,2128.599542265211
SIM,1831,44,50-100,1875,3
SIM,1901,27,15-19,1928,1
STAT,1773,93,na,1866,12.300585254649526
SIM,1886,5,na,1891,2414
STAT,1802,52,45-49,1854,0.05789148726300376
STAT,1955,25,30-34,1980,60.340145886510015
SIM,1883,24,20-24,1907,5
SIM,1835,21,35-39,1856,9
STAT,1900,34,30-34,1934,27.719841677434523
STAT,1830,31,35-39,1861,11.175630301832797
STAT,1863,4,na,1867,3069.194779093233
SIM,1942,46,45-49,1988,1
SIM,1826,70,na,1896,884
SIM,1860,49,50-100,1909,2
SIM,1831,39,40-44,1870,6
SIM,1796,66,na,1862,824
STAT,1867,76,na,1943,1020.8164747626568
STAT,1955,32,20-24,1987,3.8090372778103423
STAT,1854,25,na,1879,2059.7801335331665
STAT,1851,52,40-44,1903,0.008303928943474568
STAT,1901,103,na,2004,7.7555506950092665
STAT,1956,38,45-49,1994,1.0714401740008048
STAT,1912,68,na,1980,3354.873777953418
STAT,1944,32,45-49,1976,1.9921239841865332
STAT,1970,38,15-19,2008,0.02855197410383295
STAT,1922,34,50-100,1956,1.07234635181405
SIM,1952,32,45-49,1984,6
STAT,1933,40,20-24,1973,0.028092559568567193
SIM,1951,28,45-49,1979,9
STAT,1817,104,na,1921,0.04611374806832682
STAT,1958,18,na,1976,5577.275069140195
STAT,1921,72,na,1993,3538.140657080033
STAT,1820,89,na,1909,61.65587925726543
STAT,1869,24,na,1893,2626.651098471698
STAT,1964,17,25-29,1981,62.98852896962056
SIM,1817,45,na,1862,1525
STAT,1865,10,na,1875,2850.097264056695
SIM,1883,17,30-34,1900,4
STAT,1936,29,15-19,1965,0.7793769715176471
STAT,1949,59,na,2008,4822.875335827335
STAT,1876,49,15-19,1925,4.6722775294143025E-4
STAT,1823,39,40-44,1862,4.823298766026423
SIM,1803,53,na,1856,1563
SIM,1820,39,30-34,1859,8
SIM,1854,14,na,1868,3180
STAT,1856,48,35-39,1904,0.12171409658803009
STAT,1939,31,25-29,1970,10.893956670284014
STAT,1922,40,45-49,1962,0.22097073311787255
SIM,1973,15,na,1988,5486
SIM,1846,70,na,1916,867
SIM,1875,20,50-100,1895,1
STAT,1922,26,30-34,1948,51.320757403580295
STAT,1944,60,na,2004,4419.544433995007
SIM,1930,26,30-34,1956,129
STAT,1905,28,25-29,1933,70.40829487294056
SIM,1913,28,25-29,1941,91
STAT,1942,34,na,1976,4644.177259166208
SIM,1925,32,35-39,1957,23
STAT,1879,17,15-19,1896,7.151245728487482
STAT,1850,11,na,1861,3016.7610865856695
SIM,1968,19,25-29,1987,146
STAT,1890,100,na,1990,25.858688762744325
STAT,1863,30,35-39,1893,10.301469605260712
STAT,1948,40,50-100,1988,0.16168721277186593
STAT,1884,51,40-44,1935,0.01206128073845846
STAT,1944,25,20-24,1969,22.78893512875213
SIM,1878,23,35-39,1901,15
SIM,1931,31,50-100,1962,2
SIM,1962,28,20-24,1990,4
STAT,1957,33,na,1990,5862.2118933313695
STAT,1801,75,na,1876,475.5633177864765
STAT,1814,105,na,1919,0.018281980672010905
SIM,1810,52,45-49,1862,1
STAT,1880,47,15-19,1927,4.8701495961318966E-4
SIM,1947,31,25-29,1978,2
STAT,1904,102,na,2006,13.638179817370336
STAT,1821,35,50-100,1856,3.0328491792006496
SIM,1828,28,15-19,1856,1
STAT,1876,46,50-100,1922,0.2938274749660484
SIM,1943,49,na,1992,5286
SIM,1915,43,30-34,1958,2
STAT,1824,59,na,1883,1293.77564402792
SIM,1980,29,35-39,2009,1
STAT,1853,84,na,1937,331.20579150071467
STAT,1907,57,na,1964,3617.276791871397
STAT,1794,88,na,1882,62.33983414281907
STAT,1906,32,25-29,1938,9.897475515272916
STAT,1903,43,na,1946,3784.7447435207387
STAT,1962,19,15-19,1981,67.06236808811863
STAT,1906,72,na,1978,2762.0076798459495
STAT,1825,30,15-19,1855,0.3502090456049518
SIM,1970,19,15-19,1989,122
STAT,1932,40,25-29,1972,0.1120291720994879
STAT,1883,50,na,1933,2466.06131981023
SIM,1998,1,na,1999,6866
SIM,1818,52,na,1870,1935
STAT,1881,32,50-100,1913,1.0198995895091716
STAT,1938,27,25-29,1965,75.29054022173445
STAT,1972,29,35-39,2001,22.257966856597115
SIM,1839,17,15-19,1856,13
SIM,1884,21,30-34,1905,32
STAT,1937,33,15-19,1970,0.14670970751919052
SIM,1946,27,25-29,1973,156
SIM,1917,21,50-100,1938,4
SIM,1955,19,na,1974,6103
STAT,1846,18,15-19,1864,7.66144639235586
STAT,1906,25,35-39,1931,16.348065098762383
SIM,1805,49,40-44,1854,1
STAT,1836,29,na,1865,2510.913923527849
SIM,1904,36,30-34,1940,5
STAT,1929,42,20-24,1971,0.026395174687977616
STAT,1975,31,15-19,2006,0.1995405933456489
SIM,1914,32,25-29,1946,22
SIM,1854,18,15-19,1872,16
STAT,1871,17,na,1888,2918.4424127771663
STAT,1864,24,45-49,1888,0.7196573510418411
STAT,1928,38,20-24,1966,0.3840720672814834
SIM,1960,16,15-19,1976,70
STAT,1800,54,35-39,1854,0.0327106152428153
STAT,1952,16,15-19,1968,62.78133898374793
STAT,1930,24,15-19,1954,7.8216085396403745
SIM,1885,61,na,1946,2438
SIM,1820,86,na,1906,358
SIM,1835,64,na,1899,1511
STAT,1877,19,50-100,1896,0.05849665510711906
STAT,1918,38,25-29,1956,1.1962035971893072
SIM,1985,3,na,1988,6454
STAT,1869,24,45-49,1893,0.7744536286514602
STAT,1884,25,25-29,1909,48.56019611015545
STAT,1888,41,45-49,1929,2.0394906929278775
SIM,1822,33,45-49,1855,6
SIM,1976,31,25-29,2007,5
SIM,1956,39,35-39,1995,2
STAT,1837,31,50-100,1868,0.8405463471569532
STAT,1833,35,35-39,1868,6.4062525244061765
STAT,1946,49,40-44,1995,0.2086784321950853
SIM,1887,43,45-49,1930,4
STAT,1960,21,25-29,1981,139.34320845852054
SIM,1878,20,30-34,1898,34
STAT,1957,37,35-39,1994,3.7916036410547105
SIM,1924,35,na,1959,4915
STAT,1841,34,15-19,1875,0.1504622881054596
SIM,1943,18,na,1961,5066
STAT,1954,35,na,1989,5539.3303567138655
SIM,1907,36,35-39,1943,4
SIM,1846,24,15-19,1870,3
STAT,1897,73,na,1970,2304.3851174395254
STAT,1811,108,na,1919,9.431427166860169E-4
STAT,1873,37,30-34,1910,6.280853334326513
SIM,1881,37,30-34,1918,1
STAT,1925,33,25-29,1958,12.6544117126329
SIM,1841,35,35-39,1876,6
STAT,1840,66,na,1906,1314.8164359618618
STAT,1823,31,45-49,1854,5.348605168405462
SIM,1896,76,na,1972,2117
STAT,1911,19,30-34,1930,2.8021218128771337
STAT,1996,19,15-19,2015,76.06472024073851
SIM,1868,26,45-49,1894,1
SIM,1872,39,30-34,1911,4
SIM,1951,22,35-39,1973,35
STAT,1834,31,20-24,1865,3.1927390470789474
SIM,1892,25,25-29,1917,75
STAT,1900,41,40-44,1941,0.2512544188184677
SIM,1967,33,25-29,2000,12
SIM,1952,28,25-29,1980,266
STAT,1923,43,na,1966,4999.749783260284
SIM,1958,34,40-44,1992,2
STAT,1894,29,15-19,1923,0.6682748364961875
STAT,1847,22,15-19,1869,3.1118902321164907
SIM,1865,84,na,1949,241
SIM,1837,26,15-19,1863,3
SIM,1899,19,na,1918,4371
SIM,1901,2,na,1903,4614
STAT,1780,96,na,1876,2.1949680491937804
STAT,1984,25,30-34,2009,64.55645818151748
SIM,1942,24,35-39,1966,21
STAT,1893,23,25-29,1916,83.24720377772347
STAT,1838,24,15-19,1862,3.6551466860053687
STAT,1866,52,35-39,1918,0.009159759267159001
STAT,1934,24,35-39,1958,14.600470079671767
SIM,1881,13,na,1894,2155
STAT,1959,32,40-44,1991,6.021622645691856
SIM,1816,81,na,1897,282
STAT,1836,51,na,1887,2022.296739741606
STAT,1921,40,15-19,1961,0.0020009272212859618
STAT,1943,22,35-39,1965,11.562235310621597
STAT,1897,63,na,1960,2890.1763779066687
SIM,1909,68,na,1977,4009
STAT,1820,66,na,1886,955.9120840046174
SIM,1967,32,40-44,1999,9
SIM,1835,54,na,1889,1909
STAT,1864,39,30-34,1903,5.436545825473235
STAT,1872,31,40-44,1903,5.045933598338639
SIM,1823,39,35-39,1862,7
STAT,1902,28,20-24,1930,19.062296805570924
STAT,1944,28,25-29,1972,82.06175781396487
STAT,1913,16,15-19,1929,10.740358245762595
SIM,1831,31,45-49,1862,5
STAT,1766,118,na,1884,1.140293370692635E-4
STAT,1983,29,45-49,2012,2.829793805250819
SIM,1880,51,na,1931,3057
STAT,1889,47,35-39,1936,0.1118189082932434
SIM,1841,28,45-49,1869,2
SIM,1967,21,50-100,1988,1
STAT,1849,24,na,1873,1974.9300200904777
STAT,1960,29,20-24,1989,27.52838717843255
SIM,1922,38,40-44,1960,5
STAT,1828,53,50-100,1881,0.011983810890803125
STAT,1917,32,35-39,1949,11.043722258719802
STAT,1902,20,25-29,1922,93.90325512757992
STAT,1946,31,50-100,1977,1.0793600999894137
SIM,1850,31,na,1881,1758
SIM,1848,27,na,1875,2026
SIM,1985,22,35-39,2007,1
STAT,1846,44,45-49,1890,1.5263155310518495
STAT,1850,96,na,1946,8.839500590537241
STAT,1815,39,35-39,1854,21.09091903830746
STAT,1871,113,na,1984,8.174157370536534E-4
STAT,1877,37,15-19,1914,0.06741045861286908
STAT,1860,21,20-24,1881,66.55177086478386
STAT,1954,45,50-100,1999,0.33721877170797826
SIM,1880,31,40-44,1911,10
SIM,1921,16,15-19,1937,66
STAT,1879,43,45-49,1922,1.790451736827312
SIM,1933,33,25-29,1966,23
STAT,1833,28,45-49,1861,1.0361142297338837
STAT,1926,3,na,1929,5737.820984432818
STAT,1851,19,35-39,1870,0.5228169154658016
SIM,1877,42,50-100,1919,3
SIM,1948,42,30-34,1990,1
SIM,1852,12,na,1864,2454
STAT,1927,67,na,1994,4470.732810719607
STAT,1850,86,na,1936,228.40955874939016
STAT,1884,18,35-39,1902,0.6240104781936283
SIM,1825,32,30-34,1857,30
STAT,1882,53,30-34,1935,0.006602069994971823
STAT,1950,25,30-34,1975,53.74420376535804
SIM,1910,28,20-24,1938,1
SIM,1909,31,40-44,1940,16
SIM,1928,1,na,1929,6205
SIM,1926,23,40-44,1949,5
STAT,1898,27,na,1925,3722.213345922641
SIM,1865,108,na,1973,1
STAT,1918,23,40-44,1941,4.171203866398604
STAT,1852,77,na,1929,814.9605264718713
SIM,1875,26,35-39,1901,2
STAT,1855,112,na,1967,2.1543591416618458E-4
SIM,1850,21,na,1871,2052
STAT,1867,33,25-29,1900,10.989714504373387
STAT,1908,41,25-29,1949,0.07678181258192715
SIM,1833,29,35-39,1862,2
STAT,1850,27,35-39,1877,11.689215873534812
SIM,1879,74,na,1953,1140
STAT,1922,49,50-100,1971,0.2979773617715706
STAT,1851,26,25-29,1877,39.560352539142116
SIM,1894,95,na,1989,189
SIM,1987,27,15-19,2014,2
STAT,1834,24,30-34,1858,21.428889806569707
STAT,1874,33,15-19,1907,0.16753714984183768
SIM,1986,28,25-29,2014,9
STAT,1766,108,na,1874,0.012207523059735163
SIM,1852,28,20-24,1880,1
SIM,1941,37,na,1978,3968
STAT,1974,38,35-39,2012,3.751331103667358
STAT,1878,53,50-100,1931,0.017905951287286573
SIM,1875,33,25-29,1908,38
SIM,1926,16,na,1942,6103
STAT,1980,15,15-19,1995,72.7464378145178
STAT,1890,29,30-34,1919,35.25571242506707
STAT,1899,34,30-34,1933,27.368699606405425
SIM,1842,24,30-34,1866,43
STAT,1870,28,15-19,1898,0.5143713704954341
SIM,1955,15,30-34,1970,27
STAT,1969,37,15-19,2006,0.028521434404038964
SIM,1884,75,na,1959,1098
STAT,1855,42,45-49,1897,1.2719165883963004
SIM,1916,41,25-29,1957,1
STAT,1860,46,35-39,1906,0.1305849167354603
STAT,1934,39,20-24,1973,0.4191250443971338
STAT,1840,38,30-34,1878,5.004510569454565
STAT,1947,15,30-34,1962,15.853331924333924
SIM,1898,39,35-39,1937,2
SIM,1888,49,35-39,1937,1
SIM,1862,30,50-100,1892,3
SIM,1903,73,na,1976,2248
SIM,1856,39,30-34,1895,12
SIM,1961,37,na,1998,5585
STAT,1857,37,30-34,1894,4.790281417846019
STAT,1968,30,40-44,1998,5.756227275371533
STAT,1952,48,na,2000,5270.050655890872
SIM,1966,35,30-34,2001,6
STAT,1860,24,25-29,1884,54.10225919147711
STAT,1829,26,15-19,1855,1.1305309618823198
STAT,1840,23,45-49,1863,0.7062730170738405
STAT,1960,41,35-39,2001,0.3149984434817902
STAT,1848,39,30-34,1887,5.715709723597535
STAT,1957,41,20-24,1998,0.027965996492684986
SIM,1916,34,35-39,1950,16
STAT,1833,50,30-34,1883,0.004522181236351644
STAT,1927,21,40-44,1948,4.794139462175177
STAT,1825,99,na,1924,1.3395856725431738
STAT,1860,17,35-39,1877,0.5886076487333095
SIM,1946,24,20-24,1970,146
SIM,1942,39,20-24,1981,1
SIM,1826,38,20-24,1864,3
STAT,1815,44,15-19,1859,0.029028328133767656
STAT,1813,49,50-100,1862,0.789047515257582
STAT,1825,36,25-29,1861,4.9135425537118795
STAT,1938,17,30-34,1955,13.88254031467075
STAT,1978,35,15-19,2013,0.03121345149842221
STAT,1924,35,30-34,1959,2.483820807343818
SIM,1884,31,25-29,1915,12
STAT,1871,49,15-19,1920,4.49661366399173E-4
STAT,1933,43,45-49,1976,0.26359187217742974
STAT,1814,48,30-34,1862,0.26473757507990786
STAT,1909,38,na,1947,4093.815547382904
SIM,1839,48,50-100,1887,3
SIM,1978,22,45-49,2000,5
STAT,1843,22,30-34,1865,22.43365262379653
SIM,1853,83,na,1936,239
STAT,1818,38,20-24,1856,1.1949648043359795
STAT,1876,31,25-29,1907,12.269145794386334
STAT,1966,32,30-34,1998,23.148707727002787
SIM,1851,22,30-34,1873,1
STAT,1968,39,20-24,2007,0.3906298184956773
STAT,1934,31,25-29,1965,14.57896152720808
STAT,1947,57,na,2004,4749.422349934754
SIM,1946,17,30-34,1963,18
SIM,1976,24,35-39,2000,19
SIM,1848,82,na,1930,96
SIM,1932,35,30-34,1967,6
STAT,1903,19,25-29,1922,9.264885469080108
SIM,1941,43,45-49,1984,1
STAT,1859,35,40-44,1894,4.062477837596508
STAT,1825,29,35-39,1854,39.93687748644636
STAT,1866,36,50-100,1902,1.3195904574883763
STAT,1994,21,25-29,2015,154.38613566871473
STAT,1938,24,20-24,1962,126.9782203721564
STAT,1805,99,na,1904,0.7782803716307019
SIM,1901,15,35-39,1916,3
SIM,1826,30,25-29,1856,7
SIM,1833,36,25-29,1869,7
STAT,1979,27,15-19,2006,1.1265948246819748
STAT,1948,39,35-39,1987,3.283985139614243
STAT,1908,34,35-39,1942,9.882037928731494
SIM,1942,31,25-29,1973,19
STAT,1904,60,na,1964,3381.89787908207
SIM,1832,37,35-39,1869,5
STAT,1865,35,15-19,1900,0.05902658718993167
SIM,1926,38,25-29,1964,1
SIM,1953,38,na,1991,5657
STAT,1824,37,35-39,1861,10.84336853295039
STAT,1836,49,50-100,1885,0.2280758994381159
STAT,1866,81,na,1947,578.4351713586987
STAT,1904,70,na,1974,2846.5726402739224
STAT,1919,37,15-19,1956,0.02380274194520096
STAT,1899,41,20-24,1940,0.017515419539834393
STAT,1876,24,35-39,1900,6.9180234710306685
STAT,1978,28,25-29,2006,104.06293580717372
SIM,1884,24,35-39,1908,1
STAT,1822,46,15-19,1868,7.669120826133762E-4
STAT,1851,16,30-34,1867,1.54581262916201
STAT,1974,28,40-44,2002,7.050826554065303
STAT,1883,26,35-39,1909,10.931917829698584
STAT,1908,31,30-34,1939,17.254625414105323
STAT,1924,60,na,1984,4698.978597600789
SIM,1886,29,15-19,1915,1
SIM,1954,59,na,2013,5045
STAT,1932,44,50-100,1976,0.18318434928445027
SIM,1892,22,20-24,1914,106
SIM,1919,21,40-44,1940,3
STAT,1900,44,45-49,1944,0.1641820442469102
STAT,1905,22,15-19,1927,5.51043347668579
STAT,1884,22,20-24,1906,78.57547176048925
STAT,1878,29,15-19,1907,0.5427840919578372
STAT,1969,22,40-44,1991,4.863287134839226
SIM,1928,25,15-19,1953,2
STAT,1978,20,40-44,1998,5.316776474099697
SIM,1935,24,45-49,1959,2
STAT,1839,36,50-100,1875,1.1756820143998978
STAT,1816,51,na,1867,1389.3047977132287
SIM,1843,22,25-29,1865,120
SIM,1913,22,15-19,1935,9
STAT,1818,48,15-19,1866,4.8668988848188545E-4
SIM,1956,36,30-34,1992,8
STAT,1870,18,20-24,1888,20.242386161904484
STAT,1899,44,25-29,1943,0.06955252805704085
STAT,1867,35,50-100,1902,1.3354421591510275
STAT,1892,25,30-34,1917,36.671076617851405
SIM,1982,23,na,2005,6797
SIM,1982,28,40-44,2010,25
STAT,1920,42,20-24,1962,0.022499760030565807
SIM,1889,38,30-34,1927,16
SIM,1971,2,na,1973,5822
STAT,1954,25,15-19,1979,1.0123929670769052
STAT,1985,16,35-39,2001,6.889436565912588
SIM,1963,40,na,2003,6497
SIM,1822,48,30-34,1870,1
SIM,1868,27,na,1895,2966
SIM,1956,48,35-39,2004,1
SIM,1827,42,50-100,1869,5
SIM,1834,68,na,1902,1151
SIM,1828,82,na,1910,574
SIM,1916,31,30-34,1947,21
STAT,1845,20,40-44,1865,1.7685094591779724
SIM,1832,34,30-34,1866,29
SIM,1962,25,15-19,1987,1
STAT,1912,47,20-24,1959,0.012268441987837496
SIM,1891,26,35-39,1917,33
SIM,1968,20,50-100,1988,1
STAT,1986,29,15-19,2015,1.1647274900385087
STAT,1886,16,45-49,1902,0.07971311059759649
STAT,1909,37,20-24,1946,0.2882748981008008
STAT,1869,78,na,1947,873.2239245499417
STAT,1777,86,na,1863,51.16594404772417
SIM,1802,91,na,1893,23
SIM,1909,34,45-49,1943,4
STAT,1870,86,na,1956,277.6688699968271
STAT,1945,27,15-19,1972,0.8938123422878326
STAT,1822,47,na,1869,2141.5918224916804
STAT,1854,48,na,1902,1809.9075559502428
STAT,1938,21,15-19,1959,6.0849282140018595
SIM,1984,26,50-100,2010,3
SIM,1830,39,25-29,1869,2
SIM,1825,35,35-39,1860,2
SIM,1914,0,na,1914,4720
STAT,1822,39,25-29,1861,6.339476357965288
SIM,1845,30,na,1875,2190
SIM,1940,21,na,1961,4696
STAT,1855,18,50-100,1873,0.04929045317140211
STAT,1912,17,25-29,1929,10.122445889513978
STAT,1838,49,30-34,1887,0.08409720367294952
STAT,1852,67,na,1919,1494.564665198316
SIM,1846,49,30-34,1895,1
SIM,1964,39,30-34,2003,6
STAT,1893,20,20-24,1913,101.12371545074136
SIM,1938,17,na,1955,3615
STAT,1988,17,30-34,2005,20.11813335685679
SIM,1868,23,40-44,1891,1
STAT,1817,42,25-29,1859,1.9800171968474751
STAT,1896,46,na,1942,3439.777155565442
STAT,1949,34,na,1983,5167.57876780001
STAT,1921,62,na,1983,4349.033221512239
STAT,1928,35,15-19,1963,0.02805556570297437
STAT,1974,35,30-34,2009,2.8344570549988686
STAT,1844,38,15-19,1882,0.0491205513282434
SIM,1906,37,45-49,1943,1
STAT,1919,68,na,1987,3781.800913173216
STAT,1889,15,30-34,1904,2.2779243143316297
SIM,1898,57,na,1955,3466
SIM,1920,17,25-29,1937,130
SIM,1854,41,40-44,1895,7
SIM,1938,30,20-24,1968,6
SIM,1844,28,15-19,1872,1
STAT,1855,45,15-19,1900,3.4375115305675254E-4
SIM,1887,40,40-44,1927,5
STAT,1964,49,30-34,2013,0.1339876478879247
SIM,1923,73,na,1996,3707
SIM,1885,29,na,1914,3290
SIM,1923,18,na,1941,5604
STAT,1839,101,na,1940,0.4525329150462908
STAT,1883,19,45-49,1902,0.07335960273939807
STAT,1835,34,na,1869,1684.1950362415823
SIM,1839,24,25-29,1863,137
SIM,1981,27,na,2008,6138
STAT,1862,102,na,1964,1.2017870420810888
SIM,1815,64,na,1879,1290
STAT,1836,28,15-19,1864,0.5306338574925237
STAT,1896,35,45-49,1931,3.067502448570079
SIM,1915,90,na,2005,944
STAT,1879,40,40-44,1919,2.73776896867079
STAT,1844,28,20-24,1872,11.925849942862467
STAT,1842,105,na,1947,0.022562996270747874
STAT,1846,41,40-44,1887,2.383756118413242
STAT,1869,108,na,1977,0.07041205404235909
STAT,1907,67,na,1974,3178.968133003449
SIM,1955,5,na,1960,6580
STAT,1937,33,na,1970,4317.853427017312
STAT,1842,51,35-39,1893,0.006656585871336457
SIM,1900,27,35-39,1927,1
STAT,1847,25,20-24,1872,11.007269330947524
SIM,1951,25,40-44,1976,10
STAT,1855,16,15-19,1871,6.041679488194267
SIM,1875,30,20-24,1905,4
STAT,1850,24,30-34,1874,21.69385947404224
SIM,1863,16,15-19,1879,8
STAT,1874,29,30-34,1903,29.538449293604565
STAT,1899,37,35-39,1936,2.4137063327860275
STAT,1984,24,35-39,2008,15.473753964559556
STAT,1947,18,35-39,1965,5.453066593402218
STAT,1988,25,15-19,2013,1.1712600391516892
SIM,1829,28,30-34,1857,6
STAT,1877,30,50-100,1907,1.108743494010598
SIM,1866,35,25-29,1901,2
STAT,1851,23,20-24,1874,64.79091367645397
STAT,1956,16,na,1972,5622.369604153947
SIM,1936,35,50-100,1971,1
STAT,1946,41,45-49,1987,0.22170508633273156
STAT,1985,23,25-29,2008,152.0649731341832
SIM,1858,34,35-39,1892,26
SIM,1966,32,25-29,1998,33
SIM,1905,44,na,1949,3981
STAT,1983,5,na,1988,6418.852950352996
STAT,1901,22,30-34,1923,28.793248211904064
SIM,1879,23,15-19,1902,8
STAT,1895,92,na,1987,341.45709563201297
SIM,1865,36,35-39,1901,17
STAT,1943,25,40-44,1968,5.734301702978748
SIM,1949,4,na,1953,5941
STAT,1971,17,15-19,1988,66.33520959495725
SIM,1882,29,30-34,1911,67
SIM,1824,36,50-100,1860,4
SIM,1855,25,20-24,1880,2
STAT,1950,17,45-49,1967,0.6816458494990348
STAT,1841,40,50-100,1881,1.0013629051706
STAT,1925,26,35-39,1951,20.528046099740035
STAT,1841,29,35-39,1870,10.502782587468952
STAT,1914,38,40-44,1952,1.7171644000616761
STAT,1879,54,na,1933,2523.25771970835
STAT,1889,48,30-34,1937,0.0767009085682627
STAT,1882,20,45-49,1902,0.790721247555493
STAT,1941,17,na,1958,4376.36510589053
STAT,1951,16,35-39,1967,5.7681173455886
SIM,1818,62,na,1880,1722
STAT,1825,33,20-24,1858,5.272832918754467
STAT,1903,20,40-44,1923,3.4457548596788157
STAT,1970,18,25-29,1988,62.58332550309391
STAT,1928,35,50-100,1963,0.613396608977987
SIM,1897,22,20-24,1919,8
STAT,1848,52,na,1900,2275.6211945013297
SIM,1855,47,30-34,1902,1
STAT,1884,45,na,1929,2590.890763138904
SIM,1955,18,35-39,1973,13
STAT,1782,77,na,1859,440.1493375260572
STAT,1979,35,na,2014,6169.554675581636
SIM,1851,32,25-29,1883,21
STAT,1899,44,na,1943,3617.3572970642344
SIM,1980,6,na,1986,6010
STAT,1889,22,20-24,1911,98.0327960975575
SIM,1838,40,45-49,1878,2
SIM,1933,26,35-39,1959,40
STAT,1940,28,40-44,1968,5.484302794303239
SIM,1904,90,na,1994,1014
STAT,1849,39,50-100,1888,0.953709291344336
STAT,1873,15,20-24,1888,21.141204310644746
STAT,1824,34,30-34,1858,29.291804572839858
SIM,1834,39,50-100,1873,2
STAT,1881,35,15-19,1916,0.06310091609373622
STAT,1924,27,45-49,1951,2.320749819463935
STAT,1897,46,15-19,1943,3.491706547354815E-4
STAT,1948,36,30-34,1984,2.48208175064665
STAT,1843,25,35-39,1868,12.087835669131229
STAT,1835,22,25-29,1857,49.285489436609595
STAT,1911,42,na,1953,4094.273235774826
SIM,1899,34,25-29,1933,24
SIM,1853,28,na,1881,2375
STAT,1868,38,na,1906,2599.274543965984
STAT,1871,39,20-24,1910,0.8761244780624755
STAT,1884,27,50-100,1911,0.7293906862157536
SIM,1926,20,35-39,1946,19
STAT,1927,24,45-49,1951,1.5894592078191572
SIM,1841,36,30-34,1877,3
STAT,1934,21,30-34,1955,44.61167705260639
SIM,1881,15,20-24,1896,37
STAT,1958,32,25-29,1990,14.280106681180706
SIM,1865,29,na,1894,2855
SIM,1920,11,na,1931,4659
STAT,1843,32,25-29,1875,12.355208968720921
STAT,1833,84,na,1917,234.08633927069445
SIM,1866,46,na,1912,2320
SIM,1942,21,30-34,1963,94
STAT,1933,40,40-44,1973,0.39787613638409697
STAT,1847,18,30-34,1865,1.5216644929388425
STAT,1918,20,35-39,1938,11.787120591810222
SIM,1964,20,20-24,1984,9
STAT,1995,11,na,2006,6563.094841094934
SIM,1896,12,na,1908,4033
STAT,1833,36,30-34,1869,4.776412778769653
STAT,1871,27,na,1898,2740.030251480915
SIM,1833,26,30-34,1859,5
SIM,1921,86,na,2007,1788
STAT,1832,67,na,1899,1079.9935904035165
SIM,1832,27,40-44,1859,6
SIM,1866,32,20-24,1898,3
STAT,1973,15,25-29,1988,64.71401437505615
SIM,1981,15,25-29,1996,169
SIM,1888,46,30-34,1934,1
STAT,1917,35,40-44,1952,1.81148405756004
STAT,1956,20,20-24,1976,170.48133545205675
SIM,1851,25,35-39,1876,20
SIM,1916,95,na,2011,21
STAT,1951,23,25-29,1974,127.31499895529706
SIM,1966,25,35-39,1991,49
STAT,1977,25,40-44,2002,7.305711657796334
STAT,1909,22,35-39,1931,10.110666633415288
SIM,1865,30,na,1895,3078
SIM,1897,18,35-39,1915,2
SIM,1909,33,50-100,1942,3
STAT,1793,93,na,1886,7.2024744096160855
STAT,1897,38,30-34,1935,8.18345943397845
SIM,1906,22,25-29,1928,1
STAT,1901,32,25-29,1933,16.556993092006923
SIM,1845,31,50-100,1876,3
STAT,1924,69,na,1993,4055.6287760061036
STAT,1969,38,na,2007,5582.100046760867
SIM,1893,25,40-44,1918,8
SIM,1955,25,25-29,1980,100
SIM,1934,33,40-44,1967,4
SIM,1856,38,35-39,1894,11
STAT,1797,105,na,1902,0.008730276034112906
SIM,1939,22,20-24,1961,234
SIM,2009,0,na,2009,7172
SIM,1949,58,na,2007,5462
STAT,1872,37,15-19,1909,0.06507203008870406
STAT,1970,27,50-100,1997,1.4441279538737657
SIM,1917,22,35-39,1939,25
STAT,1892,28,35-39,1920,13.907414398715343
SIM,1960,19,20-24,1979,436
SIM,1882,25,30-34,1907,39
SIM,1820,55,na,1875,1673
STAT,1851,48,35-39,1899,0.10962431512880115
STAT,1841,19,40-44,1860,0.2072702355574092
STAT,1952,19,20-24,1971,187.37120054877295
STAT,1850,17,40-44,1867,0.2300859471162011
SIM,1938,26,35-39,1964,30
STAT,1845,23,45-49,1868,0.5791541387092498
STAT,1956,23,25-29,1979,141.47445047347736
STAT,1995,17,20-24,2012,226.48362913591444
SIM,1979,29,30-34,2008,5
STAT,1848,38,35-39,1886,7.664534620487007
SIM,1968,20,40-44,1988,9
STAT,1828,38,15-19,1866,0.05659916887959591
STAT,1916,7,na,1923,4878.835269759316
SIM,1937,32,na,1969,4358
SIM,1838,33,20-24,1871,5
SIM,1881,77,na,1958,706
SIM,1875,23,30-34,1898,54
SIM,1948,20,20-24,1968,3
STAT,1929,83,na,2012,2212.0553150858577
STAT,1910,19,15-19,1929,10.332859020686293
STAT,1834,80,na,1914,564.5313408801662
SIM,1888,39,40-44,1927,8
SIM,1897,62,na,1959,2843
STAT,1876,2,na,1878,3887.7273879364475
STAT,1857,36,35-39,1893,6.387814970971527
STAT,1955,21,na,1976,5614.94057187763
SIM,1864,23,20-24,1887,80
STAT,1924,38,35-39,1962,3.2872730366799456
SIM,1900,45,50-100,1945,1
SIM,1994,19,20-24,2013,211
SIM,1820,65,na,1885,1397
STAT,1845,49,20-24,1894,0.007917424273802338
SIM,1932,38,35-39,1970,10
SIM,1987,23,15-19,2010,18
SIM,1849,33,30-34,1882,40
STAT,1963,39,20-24,2002,0.3973365566774091
STAT,1950,33,50-100,1983,1.1492845008502162
STAT,1949,46,40-44,1995,0.22065389281988665
STAT,1883,37,25-29,1920,3.2508793222772914
STAT,1943,29,na,1972,4600.177842496957
SIM,1841,24,15-19,1865,3
SIM,1891,37,25-29,1928,3
STAT,1941,19,45-49,1960,0.5935486122212447
SIM,1792,73,na,1865,475
SIM,1977,27,20-24,2004,3
SIM,1956,36,na,1992,5383
STAT,1804,73,na,1877,666.6364848719652
STAT,1959,21,50-100,1980,0.9969060720854599
STAT,1841,26,30-34,1867,28.009298277471856
SIM,1803,63,na,1866,1228
SIM,1865,29,45-49,1894,3
STAT,1802,92,na,1894,19.881666370347983
SIM,1805,88,na,1893,6
STAT,1972,17,30-34,1989,18.010258615753266
STAT,1867,23,30-34,1890,19.133224039251
SIM,1867,35,40-44,1902,9
SIM,1833,25,35-39,1858,4
SIM,1946,39,40-44,1985,5
STAT,1882,74,na,1956,1290.1183781761104
STAT,1805,53,50-100,1858,0.05287031905337269
STAT,1865,85,na,1950,285.4441397980201
STAT,1861,27,50-100,1888,0.6181843457002372
STAT,1929,20,45-49,1949,1.6519364453782952
STAT,1914,16,30-34,1930,2.918291019624112
STAT,1884,7,na,1891,2970.681794704532
STAT,1857,29,45-49,1886,1.0131986694390345
STAT,1896,32,40-44,1928,6.61039668249824
STAT,1986,26,45-49,2012,2.8544353493855774
SIM,1803,76,na,1879,641
SIM,1922,16,30-34,1938,24
STAT,1856,30,45-49,1886,1.5867578488466
STAT,1889,25,25-29,1914,60.58495987443796
SIM,1865,20,na,1885,3232
STAT,1947,25,25-29,1972,86.00817537599416
STAT,1926,33,40-44,1959,5.456320838188083
STAT,1985,20,20-24,2005,183.24326130008035
STAT,1945,49,25-29,1994,0.06914944485184409
STAT,1833,24,15-19,1857,3.187197457339373
STAT,1967,23,35-39,1990,13.6140393643187
STAT,1856,19,35-39,1875,0.5645372344006487
STAT,1867,30,20-24,1897,2.9359257229870517
SIM,1929,28,35-39,1957,24
SIM,1854,78,na,1932,935
STAT,1889,18,35-39,1907,0.7785316537196495
STAT,1912,37,na,1949,4241.676985635816
STAT,1817,46,na,1863,2030.1538440128063
STAT,1869,42,50-100,1911,1.1792457748121967
SIM,1980,17,30-34,1997,21
SIM,1958,17,na,1975,5435
SIM,1954,24,na,1978,4780
STAT,1938,39,40-44,1977,1.7528381491657037
STAT,1873,22,45-49,1895,0.8217863972106279
STAT,1910,56,na,1966,3812.2118643851227
STAT,1861,24,40-44,1885,2.0244900042973697
STAT,1967,19,15-19,1986,65.3792802748612
STAT,1935,27,20-24,1962,28.73111183610597
SIM,1864,19,35-39,1883,1
SIM,1887,21,35-39,1908,18
SIM,1923,26,40-44,1949,19
STAT,1776,91,na,1867,25.821838695168424
STAT,1937,1,na,1938,4691.01741263722
SIM,1944,18,25-29,1962,1
SIM,1839,46,35-39,1885,1
SIM,1889,37,35-39,1926,16
STAT,1950,28,35-39,1978,20.565335471245863
SIM,1867,11,na,1878,2752
SIM,1938,33,25-29,1971,9
SIM,1864,30,45-49,1894,2
SIM,1918,32,45-49,1950,3
SIM,1860,26,40-44,1886,5
STAT,1946,27,30-34,1973,50.36991459368935
STAT,1833,53,na,1886,1530.6650427405255
STAT,1936,18,25-29,1954,47.783118240981906
STAT,1967,30,25-29,1997,13.596704256431844
STAT,1915,45,50-100,1960,0.26430697687673355
SIM,1864,16,30-34,1880,4
STAT,1854,30,50-100,1884,0.7804637529699014
STAT,1894,19,20-24,1913,26.159924643686658
STAT,1896,77,na,1973,1907.7348775868254
STAT,1851,15,35-39,1866,0.5353180170050702
STAT,1826,36,40-44,1862,3.5923365898567425
STAT,1964,29,40-44,1993,6.79746303370892
STAT,1939,42,15-19,1981,0.001844342225707391
STAT,1972,24,20-24,1996,164.7328612511856
STAT,1851,82,na,1933,369.99745448764037
STAT,1905,55,na,1960,3565.9102583905465
SIM,1975,19,15-19,1994,132
SIM,1854,68,na,1922,1793
SIM,1934,29,20-24,1963,29
SIM,1978,25,15-19,2003,1
SIM,1980,32,na,2012,5866
SIM,1829,42,45-49,1871,6
SIM,1943,27,20-24,1970,2
SIM,1897,25,25-29,1922,4
SIM,1880,34,45-49,1914,4
SIM,1902,22,40-44,1924,5
STAT,1925,23,30-34,1948,39.567314420625884
STAT,1898,34,15-19,1932,0.22020882630934904
STAT,1882,33,na,1915,2678.5342957733083
STAT,1976,17,15-19,1993,69.97205461936453
STAT,1862,15,45-49,1877,0.07372966797825993
STAT,1982,24,na,2006,5945.790252019257
STAT,1879,21,35-39,1900,7.05309346890794
STAT,1915,26,40-44,1941,5.506341334268659
STAT,1946,62,na,2008,4452.316256393975
STAT,1863,41,50-100,1904,1.0709000776131699
STAT,1986,19,20-24,2005,222.78997695768862
STAT,1856,23,20-24,1879,69.96117022841248
STAT,1882,16,25-29,1898,6.403309417694524
STAT,1936,61,na,1997,3873.3899256738982
STAT,1956,16,35-39,1972,6.409623676941702
STAT,1872,34,45-49,1906,2.003444192211092
SIM,1865,44,20-24,1909,1
SIM,1989,25,25-29,2014,210
STAT,1926,29,20-24,1955,25.067446970652068
STAT,1874,24,50-100,1898,0.47876680755459106
STAT,1854,19,50-100,1873,0.0471853185636174
STAT,1989,1,na,1990,6508.723161115628
STAT,1857,44,20-24,1901,0.14081608829157546
SIM,1904,31,50-100,1935,4
SIM,1895,27,15-19,1922,1
SIM,1917,22,na,1939,5031
SIM,1929,35,25-29,1964,1
SIM,1933,48,45-49,1981,1
SIM,1848,22,25-29,1870,126
SIM,1968,33,40-44,2001,1
STAT,1833,39,35-39,1872,6.14043579260381
STAT,1871,37,50-100,1908,1.4096038359667022
STAT,1852,26,40-44,1878,3.313319091326321
STAT,1867,26,35-39,1893,10.432287163895483
SIM,1844,25,45-49,1869,4
SIM,1844,49,50-100,1893,1
STAT,1889,36,50-100,1925,1.7549553622497347
SIM,1907,26,50-100,1933,3
STAT,1951,20,20-24,1971,153.41873371719032
STAT,1847,32,45-49,1879,1.575434272277469
SIM,1899,24,30-34,1923,5
STAT,1959,35,45-49,1994,1.0620700878502805
SIM,1821,49,50-100,1870,1
SIM,1954,27,30-34,1981,65
SIM,1855,32,45-49,1887,1
STAT,1961,17,20-24,1978,202.14306894281728
STAT,1836,25,45-49,1861,1.3269475464175398
STAT,1963,30,50-100,1993,1.2370347865721556
SIM,1899,31,20-24,1930,5
STAT,1887,27,15-19,1914,0.5867839360314981
STAT,1851,72,na,1923,1001.469129031812
STAT,1926,28,50-100,1954,1.371870958071383
SIM,1874,36,50-100,1910,1
SIM,1937,22,na,1959,4371
SIM,1848,48,35-39,1896,1
STAT,1842,22,15-19,1864,3.20202624176143
SIM,1964,23,25-29,1987,1
STAT,1835,65,na,1900,1053.2757619739623
STAT,1912,28,15-19,1940,0.8007960691772007
STAT,1965,32,15-19,1997,0.1887219464340398
SIM,1908,43,40-44,1951,3
SIM,1839,39,45-49,1878,3
SIM,1838,26,30-34,1864,6
SIM,1918,28,25-29,1946,15
SIM,1833,83,na,1916,149
SIM,1876,29,20-24,1905,2
SIM,1906,71,na,1977,2628
STAT,1946,34,20-24,1980,3.1783196958284234
STAT,1901,25,35-39,1926,15.703143654250788
STAT,1952,26,45-49,1978,2.400642010950097
STAT,1813,48,15-19,1861,0.0013057963957319777
SIM,1983,23,30-34,2006,54
STAT,1889,105,na,1994,1.8837132042256686
STAT,1977,23,na,2000,5711.163011788498
SIM,1841,39,35-39,1880,8
STAT,1844,20,25-29,1864,60.65102593148837
STAT,1957,34,30-34,1991,24.404235670535137
SIM,1882,28,35-39,1910,15
STAT,1888,15,15-19,1903,8.088065375855654
STAT,1936,22,45-49,1958,1.2421690365338454
SIM,1793,68,na,1861,1029
SIM,1907,33,30-34,1940,42
SIM,1877,21,40-44,1898,8
STAT,1903,28,50-100,1931,1.0478104443842147
STAT,1929,23,15-19,1952,7.744941051352741
STAT,1851,27,na,1878,2008.5679825223747
STAT,1958,39,50-100,1997,0.6542422269532603
STAT,1891,25,15-19,1916,0.6515144835381741
SIM,1911,28,50-100,1939,2
STAT,1870,96,na,1966,37.98053747746008
STAT,1938,45,50-100,1983,0.2692137327352351
STAT,1855,20,35-39,1875,5.8850058878319915
STAT,1898,58,na,1956,3109.902410685526
STAT,1834,34,25-29,1868,11.727070952515005
SIM,1923,63,na,1986,4664
SIM,1966,22,30-34,1988,59
STAT,1883,34,20-24,1917,3.0258727463741835
STAT,1939,14,na,1953,4554.264584182796
SIM,1842,34,25-29,1876,7
SIM,1880,82,na,1962,872
SIM,1779,87,na,1866,153
STAT,1847,47,30-34,1894,0.07413593691261083
SIM,1865,37,30-34,1902,13
STAT,1925,48,45-49,1973,0.30298996836559233
SIM,1836,49,na,1885,1528
STAT,1865,41,na,1906,2417.4816940177243
STAT,1926,36,45-49,1962,0.962171789034858
SIM,1946,45,50-100,1991,1
STAT,1980,28,50-100,2008,1.6007577278564686
SIM,1965,34,30-34,1999,9
STAT,1819,36,15-19,1855,0.18026189519164046
STAT,1874,28,35-39,1902,11.359572905694414
STAT,1924,15,na,1939,5080.491675528198
SIM,1833,48,40-44,1881,1
SIM,1852,20,25-29,1872,66
STAT,1908,22,na,1930,4053.9090141376196
STAT,1850,28,30-34,1878,30.287630703114207
SIM,1864,26,25-29,1890,9
SIM,1866,56,na,1922,2102
SIM,1904,24,15-19,1928,11
SIM,1909,37,na,1946,4781
SIM,1851,16,na,1867,3026
SIM,1888,25,50-100,1913,1
STAT,1944,39,15-19,1983,0.024519371796330933
STAT,1984,28,35-39,2012,24.702667940428398
STAT,1847,97,na,1944,4.133695204291131
STAT,1879,36,20-24,1915,0.9333582489733624
STAT,1933,21,15-19,1954,8.17687770637139
SIM,1888,24,20-24,1912,8
SIM,1866,15,na,1881,2672
STAT,1967,8,na,1975,5665.522247038089
SIM,1891,27,30-34,1918,76
SIM,1863,20,35-39,1883,18
SIM,1929,25,30-34,1954,126
STAT,1909,48,na,1957,3889.3731474265874
STAT,1886,26,na,1912,2915.1110241989154
SIM,1919,20,45-49,1939,1
STAT,1825,48,40-44,1873,0.23577638840000514
SIM,1847,42,na,1889,2383
SIM,1834,36,40-44,1870,2
SIM,1844,22,40-44,1866,5
STAT,1856,26,25-29,1882,38.87268173089585
SIM,1895,81,na,1976,869
SIM,1880,27,20-24,1907,1
STAT,1941,22,50-100,1963,0.7849318251870018
STAT,1940,9,na,1949,4646.963398054441
STAT,1903,23,45-49,1926,1.142699419267877
SIM,1849,36,35-39,1885,13
STAT,1879,29,30-34,1908,30.127785627200243
SIM,1948,23,25-29,1971,234
SIM,1922,5,na,1927,5560
STAT,1883,59,na,1942,2194.350378072196
STAT,1856,16,30-34,1872,1.669167084602105
SIM,1971,13,na,1984,5811
SIM,1891,34,20-24,1925,7
STAT,1914,30,45-49,1944,1.843541446662782
STAT,1848,35,30-34,1883,5.958110345389189
STAT,1810,54,50-100,1864,0.05309755640368917
STAT,1885,95,na,1980,110.33276148077591
STAT,1973,31,50-100,2004,1.2586026112180666
SIM,1859,22,35-39,1881,13
SIM,1898,36,30-34,1934,12
STAT,1952,58,na,2010,5013.247441851895
STAT,1948,28,45-49,1976,2.2903690789551354
SIM,1849,23,na,1872,2647
SIM,1933,23,30-34,1956,59
SIM,1883,48,na,1931,2399
SIM,1896,15,15-19,1911,10
SIM,1955,22,20-24,1977,320
SIM,1887,29,30-34,1916,2
STAT,1941,16,40-44,1957,1.663516360566085
SIM,1898,47,na,1945,3777
STAT,1918,49,15-19,1967,4.4964295779429E-4
SIM,1936,36,na,1972,3957
SIM,1822,36,na,1858,1791
SIM,1934,36,45-49,1970,1
STAT,1896,44,50-100,1940,0.11031553402630759
SIM,1842,27,35-39,1869,3
STAT,1851,45,30-34,1896,0.0775271826986893
SIM,1944,22,45-49,1966,2
STAT,1817,91,na,1908,40.062809315687055
SIM,1906,8,na,1914,4010
STAT,1966,20,15-19,1986,7.703642575120875
SIM,1933,30,20-24,1963,6
STAT,1834,27,35-39,1861,11.546443323231752
SIM,1956,28,45-49,1984,3
SIM,2010,4,na,2014,7249
STAT,1829,30,35-39,1859,14.208552797439877
SIM,1922,30,45-49,1952,8
SIM,1856,35,30-34,1891,6
STAT,1880,18,15-19,1898,7.2403676377530735
STAT,1947,22,20-24,1969,145.02604689381957
STAT,1951,38,45-49,1989,0.9642052270006807
SIM,1974,20,15-19,1994,9
STAT,1864,102,na,1966,1.6507271074086114
STAT,1925,30,20-24,1955,3.345394092239207
STAT,1976,37,40-44,2013,2.377869062512148
STAT,1986,23,40-44,2009,5.545476761672989
STAT,1973,35,15-19,2008,0.029579931019744935
SIM,1993,20,20-24,2013,370
STAT,1915,29,45-49,1944,2.019403664555634
STAT,1839,27,na,1866,2161.247025395494
STAT,1884,47,35-39,1931,0.15888673066106387
STAT,1961,17,na,1978,5488.01324454019
STAT,1873,44,50-100,1917,1.2282124255587765
SIM,1982,15,40-44,1997,5
STAT,1824,38,30-34,1862,7.986300442367909
SIM,1943,39,50-100,1982,3
STAT,1970,29,15-19,1999,1.0232356052474882
SIM,1900,24,30-34,1924,40
STAT,1864,45,na,1909,2341.442226020849
STAT,1857,47,25-29,1904,0.05153013320501723
SIM,1832,38,30-34,1870,3
STAT,1851,38,40-44,1889,3.4722681593398215
SIM,1966,38,35-39,2004,11
STAT,1840,20,40-44,1860,2.1566806277876025
SIM,1948,30,15-19,1978,1
SIM,1854,44,45-49,1898,4
SIM,1831,27,25-29,1858,37
STAT,1871,16,15-19,1887,6.898249729042455
SIM,1910,45,na,1955,3395
STAT,1974,15,40-44,1989,2.108880003234153
STAT,1907,26,na,1933,4066.16232914618
SIM,1923,29,45-49,1952,3
STAT,1890,8,na,1898,3665.672660780269
STAT,1903,49,20-24,1952,0.010894409670605044
SIM,1969,39,30-34,2008,5
SIM,1983,26,35-39,2009,33
STAT,1879,46,15-19,1925,4.833756541737825E-4
STAT,1906,41,na,1947,3920.6109381634806
STAT,1952,23,40-44,1975,4.663866178536946
STAT,1846,37,20-24,1883,0.8321767816277081
SIM,1886,33,35-39,1919,4
STAT,1797,86,na,1883,88.41762960027745
SIM,1882,63,na,1945,2593
STAT,1905,42,50-100,1947,0.1223876326069861
STAT,1849,78,na,1927,605.5861488260136
SIM,1922,23,20-24,1945,131
SIM,1908,46,45-49,1954,1
SIM,1939,21,25-29,1960,226
SIM,1823,36,30-34,1859,5
STAT,1918,16,15-19,1934,11.4628169158783
SIM,1935,51,na,1986,6048
STAT,1861,27,45-49,1888,1.0729719804793845
STAT,1878,33,35-39,1911,12.151169246000842
STAT,1868,29,20-24,1897,12.914486686648022
SIM,1944,15,20-24,1959,305
STAT,1883,27,30-34,1910,28.432688739833974
STAT,1918,73,na,1991,3231.1672427147923
STAT,1936,15,20-24,1951,150.580007477042
STAT,1836,22,40-44,1858,2.5036926232336105
SIM,1940,11,na,1951,5104
STAT,1914,23,20-24,1937,130.7596819160221
SIM,1838,29,35-39,1867,16
SIM,1968,36,45-49,2004,2
STAT,1867,108,na,1975,0.05476919397460883
SIM,1918,25,20-24,1943,3
STAT,1913,38,25-29,1951,1.1163796575604061
STAT,1979,15,50-100,1994,0.5956368827028089
STAT,1816,61,na,1877,1120.0331440861446
SIM,1960,23,40-44,1983,11
SIM,1854,37,20-24,1891,2
STAT,1961,16,50-100,1977,0.5587683609056434
STAT,1893,16,35-39,1909,0.8023780257776593
SIM,1881,22,45-49,1903,1
STAT,1854,0,na,1854,3279.403467985503
SIM,1853,26,15-19,1879,1
STAT,1969,21,45-49,1990,1.6279777979844638
SIM,1856,7,na,1863,2672
SIM,1929,32,20-24,1961,4
SIM,1878,42,40-44,1920,6
STAT,1975,26,35-39,2001,22.966809751212004
STAT,1965,37,30-34,2002,2.705312839903202
STAT,1897,110,na,2007,0.04970772795125757
SIM,1888,31,45-49,1919,1
SIM,1921,38,25-29,1959,3
STAT,1866,26,na,1892,2561.53335311899
STAT,1884,99,na,1983,28.38003922389297
SIM,1981,28,25-29,2009,51
STAT,1968,29,25-29,1997,95.18995339342142
SIM,1916,85,na,2001,997
STAT,1964,50,na,2014,5504.269415043563
STAT,1782,87,na,1869,75.31391407232373
STAT,1973,28,25-29,2001,98.61692043393342
SIM,1937,23,15-19,1960,6
STAT,1936,48,20-24,1984,0.012613128156714054
STAT,1823,34,15-19,1857,0.3224375533816416
SIM,1896,22,na,1918,3412
SIM,1958,47,40-44,2005,1
STAT,1885,25,40-44,1910,3.471615212846357
STAT,1854,28,15-19,1882,0.384710638074268
SIM,1989,22,20-24,2011,189
STAT,1879,44,na,1923,2747.494095578023
STAT,1940,20,45-49,1960,1.3241139015364907
SIM,1954,37,25-29,1991,3
SIM,1951,62,na,2013,5604
STAT,1894,11,na,1905,3836.970616021673
SIM,1973,37,30-34,2010,6
STAT,1903,16,20-24,1919,29.213328434243344
STAT,1907,31,15-19,1938,0.13941162955306416
SIM,1911,16,20-24,1927,51
STAT,1869,21,40-44,1890,2.3359131737875707
STAT,1839,45,15-19,1884,3.3159445353889605E-4
STAT,1845,26,15-19,1871,0.3748187727308181
SIM,1838,36,25-29,1874,3
STAT,1848,93,na,1941,31.05279053139176
SIM,1870,31,na,1901,3132
STAT,1935,39,50-100,1974,0.6764535787214647
STAT,1868,39,15-19,1907,0.06163571714354709
SIM,1821,38,20-24,1859,3
SIM,1953,24,45-49,1977,2
STAT,1810,69,na,1879,943.2942106889786
STAT,1841,35,20-24,1876,0.8244266130520811
STAT,1925,45,na,1970,5160.048744621567
SIM,1852,20,50-100,1872,1
SIM,1901,63,na,1964,3233
SIM,1975,27,45-49,2002,2
SIM,1867,86,na,1953,324
STAT,1910,48,15-19,1958,3.959413269871502E-4
SIM,1954,17,15-19,1971,2
STAT,1861,34,35-39,1895,9.632795937805568
SIM,1863,72,na,1935,1305
STAT,1847,14,na,1861,2271.825400413977
STAT,1877,41,35-39,1918,2.183618059472627
STAT,1974,20,20-24,1994,168.23208134912056
STAT,1886,47,45-49,1933,0.28594609148960876
STAT,1921,31,na,1952,4875.247876148607
STAT,1975,35,25-29,2010,1.547051034199369
STAT,1986,21,40-44,2007,5.549138588840434
STAT,1966,40,25-29,2006,0.10726660178382127
SIM,1990,16,30-34,2006,44
STAT,1872,32,45-49,1904,2.0207450042561277
STAT,1832,40,20-24,1872,0.13851073540265432
SIM,1880,32,45-49,1912,3
STAT,1946,17,15-19,1963,58.089991654479796
SIM,1885,41,35-39,1926,5
STAT,1853,20,50-100,1873,0.4866742247107251
STAT,1839,70,na,1909,1112.7076919867918
STAT,1882,34,25-29,1916,11.446768276911584
STAT,1877,52,45-49,1929,0.017328610954730168
STAT,1850,44,30-34,1894,1.1675460926837324
STAT,1945,24,45-49,1969,1.4221783032731081
SIM,1958,22,25-29,1980,5
STAT,1882,23,15-19,1905,3.707218560074185
SIM,1922,33,na,1955,4946
STAT,1946,15,na,1961,4713.81710290586
SIM,1933,29,50-100,1962,4
STAT,1892,41,30-34,1933,1.6704439268206752
STAT,1872,13,na,1885,3036.082400813923
STAT,1896,49,25-29,1945,0.04849181679417965
SIM,1909,30,35-39,1939,26
SIM,1958,23,50-100,1981,1
STAT,1861,42,40-44,1903,2.1553146721313334
SIM,1890,34,25-29,1924,30
STAT,1858,24,35-39,1882,5.406781581616203
SIM,1974,40,25-29,2014,1
SIM,1979,18,30-34,1997,45
STAT,1817,40,25-29,1857,2.0879566932772042
STAT,1826,46,35-39,1872,0.10205766276456836
STAT,1926,15,50-100,1941,0.5324606391802902
STAT,1836,53,40-44,1889,0.009507410213021537
STAT,1949,28,50-100,1977,1.3410592584619696
STAT,1823,95,na,1918,7.529101642480449
SIM,1888,56,na,1944,2344
STAT,1833,27,40-44,1860,2.822298227440714
SIM,1857,37,45-49,1894,4
SIM,1926,47,na,1973,5765
SIM,1821,41,na,1862,1642
STAT,1808,53,35-39,1861,0.04021880708679342
SIM,1891,32,20-24,1923,4
STAT,1851,23,40-44,1874,1.9591785306144194
STAT,1995,4,na,1999,6569.596005538198
SIM,1890,23,15-19,1913,5
SIM,1836,29,25-29,1865,46
STAT,1963,20,45-49,1983,1.6562784318037516
STAT,1844,57,na,1901,1680.900828086152
STAT,1832,48,30-34,1880,0.07844336851535287
STAT,1831,28,15-19,1859,0.4695720333978855
STAT,1880,39,20-24,1919,0.9334439339346216
STAT,1869,47,15-19,1916,4.449588107925738E-4
STAT,1843,30,25-29,1873,12.614478007279073
STAT,1883,32,20-24,1915,3.052002775780912
SIM,1855,23,20-24,1878,142
STAT,1871,79,na,1950,802.661170632308
SIM,1869,77,na,1946,561
STAT,1919,34,45-49,1953,1.9419982677969279
STAT,1956,41,50-100,1997,0.18670813097687947
SIM,1872,38,25-29,1910,3
STAT,1927,36,na,1963,5401.835572637083
SIM,1967,31,35-39,1998,5
STAT,1864,38,25-29,1902,2.9521289317025428
STAT,1831,31,15-19,1862,0.14653207023702372
STAT,1877,44,na,1921,2737.065280818122
SIM,1872,26,30-34,1898,63
STAT,1993,17,45-49,2010,0.8294334856590871
STAT,1971,14,na,1985,5739.512796467524
STAT,1864,26,30-34,1890,26.037524819541066
STAT,1959,31,35-39,1990,14.069805981318426
STAT,1901,113,na,2014,0.00272061907265263
STAT,1836,23,45-49,1859,0.8318150089483949
STAT,1887,43,15-19,1930,0.017731549663525248
STAT,1898,26,30-34,1924,39.41049751587857
STAT,1828,29,25-29,1857,55.71524492315472
STAT,1866,51,30-34,1917,0.006397679921865222
SIM,1889,45,40-44,1934,1
STAT,1821,40,45-49,1861,3.0199820860592794
SIM,1949,35,35-39,1984,2
STAT,1906,74,na,1980,2574.4138969637593
STAT,1847,23,20-24,1870,64.53677734057858
STAT,1815,45,20-24,1860,0.025238890094889038
STAT,1829,27,20-24,1856,24.180192806095963
SIM,1837,27,20-24,1864,21
SIM,1851,30,25-29,1881,17
SIM,1889,34,30-34,1923,58
STAT,1909,47,50-100,1956,0.2401196472935525
STAT,1897,17,25-29,1914,8.74452031462026
SIM,1944,58,na,2002,4296
STAT,1879,15,50-100,1894,0.0593104293224633
STAT,1865,39,25-29,1904,2.9678081906105294
STAT,1934,29,50-100,1963,1.5444916435529654
STAT,1884,14,na,1898,2935.0982095616073
SIM,1858,38,45-49,1896,7
STAT,1874,25,30-34,1899,29.952927009154777
SIM,1867,94,na,1961,72
SIM,1858,47,35-39,1905,2
SIM,1961,42,40-44,2003,1
STAT,1899,42,25-29,1941,0.07041740019968543
SIM,1940,42,50-100,1982,2
SIM,1873,36,20-24,1909,1
SIM,1912,47,na,1959,3624
STAT,1772,86,na,1858,8.579622060458401
STAT,1839,48,40-44,1887,0.1365712275321257
STAT,1903,49,40-44,1952,0.1554269052603841
SIM,1812,42,40-44,1854,3
SIM,1956,30,20-24,1986,8
STAT,1814,44,20-24,1858,0.46781587465142144
STAT,1839,49,25-29,1888,0.04536426440388131
SIM,1830,85,na,1915,71
STAT,1874,45,30-34,1919,0.11550425358888433
STAT,1878,50,40-44,1928,0.012867643600545299
STAT,1917,31,30-34,1948,19.117901973701006
STAT,1809,54,35-39,1863,0.019965112984385032
STAT,1958,15,40-44,1973,2.121207616286272
STAT,1843,49,45-49,1892,0.2318537482459193
STAT,1967,25,35-39,1992,21.75552537421072
SIM,1888,48,na,1936,2569
STAT,1989,17,25-29,2006,71.63258108630785
STAT,1825,33,40-44,1858,8.459594734564527
STAT,1828,33,50-100,1861,1.0230545397608337
STAT,1834,43,35-39,1877,1.9668300901541613
SIM,1951,21,30-34,1972,104
SIM,1842,25,50-100,1867,1
SIM,1933,17,na,1950,6552
STAT,1825,51,50-100,1876,0.0207312592078417
SIM,1909,35,na,1944,4836
SIM,1833,33,40-44,1866,1
STAT,1834,28,40-44,1862,3.5589201828829196
SIM,1922,25,na,1947,5202
STAT,1994,18,45-49,2012,0.831641491975963
STAT,1845,46,15-19,1891,2.70307015180041E-4
STAT,1935,31,na,1966,6045.258604230432
STAT,1865,36,20-24,1901,0.8065142874033195
STAT,1876,25,40-44,1901,3.5978891655344634
SIM,1843,44,35-39,1887,3
SIM,1981,7,na,1988,6478
STAT,1849,37,45-49,1886,1.5810338313215666
STAT,1939,45,na,1984,4436.864621829988
STAT,1890,28,25-29,1918,59.440119756960385
SIM,1997,17,25-29,2014,175
STAT,1868,31,40-44,1899,4.828061062960771
SIM,1967,33,45-49,2000,2
STAT,1860,18,40-44,1878,0.19504692785374134
STAT,1884,19,40-44,1903,0.2074314951362347
STAT,1927,20,35-39,1947,13.464918486170832
STAT,1938,0,na,1938,5131.166984462536
STAT,1881,57,na,1938,2236.978749447398
STAT,1948,30,20-24,1978,3.2872943244293804
SIM,1884,25,40-44,1909,3
STAT,1886,27,20-24,1913,14.280826440834703
STAT,1928,21,35-39,1949,13.607958924533353
STAT,1974,34,25-29,2008,14.17880801121003
SIM,1833,22,30-34,1855,44
SIM,1894,27,20-24,1921,23
STAT,1938,23,15-19,1961,6.080912824029304
STAT,1979,28,20-24,2007,29.116540439267265
STAT,1903,38,30-34,1941,1.8815279494901636
STAT,1881,22,15-19,1903,3.6722396538815643
STAT,1897,24,50-100,1921,0.6253357994864746
SIM,1911,38,30-34,1949,5
STAT,1963,19,na,1982,5392.971436956913
STAT,1881,19,15-19,1900,6.5704949727222015
SIM,1972,32,45-49,2004,1
STAT,1885,46,45-49,1931,0.2724330838021587
SIM,1842,28,40-44,1870,8
STAT,1985,23,45-49,2008,1.852337379356249
STAT,1844,17,45-49,1861,0.06945327754192422
SIM,1858,26,na,1884,2656
STAT,1835,44,35-39,1879,1.3197973815843222
STAT,1855,42,50-100,1897,0.8978234715892659
SIM,1989,20,20-24,2009,212
STAT,1830,35,45-49,1865,2.079241852345807
STAT,1966,42,50-100,2008,0.1759823735850084
STAT,1880,26,45-49,1906,1.3628294416017144
STAT,1826,52,na,1878,1301.8132125669106
STAT,1971,41,45-49,2012,0.253173618230597
SIM,1872,33,na,1905,2924
STAT,1858,24,50-100,1882,0.3778324398633034
STAT,1879,50,50-100,1929,0.01846062698589097
SIM,1829,69,na,1898,811
STAT,1782,110,na,1892,0.0010589787670583248
STAT,1978,27,20-24,2005,28.873629009505194
STAT,1943,21,30-34,1964,35.304343844125896
SIM,1879,27,25-29,1906,92
STAT,1923,33,50-100,1956,1.0927678134606977
STAT,1893,82,na,1975,1285.3009349511806
SIM,1976,25,40-44,2001,20
STAT,1891,29,25-29,1920,59.904058016918924
STAT,1964,45,20-24,2009,0.01678660907170807
SIM,1925,73,na,1998,3445
STAT,1848,50,25-29,1898,0.0038175697188926683
SIM,1880,84,na,1964,788
STAT,1893,114,na,2007,7.955670858893118E-4
SIM,1986,27,20-24,2013,4
STAT,1885,31,na,1916,2758.130340715585
STAT,1971,30,35-39,2001,13.630752745947749
SIM,1971,34,50-100,2005,1
STAT,1856,44,25-29,1900,0.5577550381812185
SIM,1842,43,35-39,1885,4
STAT,1892,44,35-39,1936,0.17942913891822038
STAT,1854,19,25-29,1873,5.457769615390459
STAT,1838,36,30-34,1874,5.629762844676086
STAT,1870,52,35-39,1922,0.009742592469152236
STAT,1840,37,25-29,1877,2.7318057078262212
SIM,1982,22,30-34,2004,4
STAT,1889,39,40-44,1928,6.164625962600998
STAT,1900,20,50-100,1920,0.6569137549597586
STAT,1830,65,na,1895,1060.1420007229715
STAT,1904,91,na,1995,493.3346060293933
STAT,1932,72,na,2004,4260.121683291971
STAT,1896,23,na,1919,3593.871234613959
SIM,1923,88,na,2011,1875
SIM,1813,54,na,1867,1241
SIM,1913,1,na,1914,5240
STAT,1895,37,15-19,1932,0.08435493204886009
SIM,1846,36,30-34,1882,10
STAT,1824,54,30-34,1878,0.007503776350401946
STAT,1917,58,na,1975,4201.029260035736
SIM,1897,39,40-44,1936,5
SIM,1990,19,35-39,2009,18
STAT,1902,42,50-100,1944,0.11947915652866117
STAT,1832,43,25-29,1875,0.5386098275241618
SIM,1981,24,50-100,2005,2
STAT,1916,22,25-29,1938,111.71221404781895
SIM,1830,38,20-24,1868,1
STAT,1940,29,45-49,1969,2.031715298298357
SIM,1847,16,25-29,1863,12
SIM,1939,25,25-29,1964,81
STAT,1882,31,20-24,1913,3.059380040185313
STAT,1981,32,15-19,2013,0.21137692981809952
STAT,1960,40,30-34,2000,0.2002558189303042
SIM,1912,55,na,1967,3515
SIM,1930,12,na,1942,6360
STAT,1857,33,30-34,1890,15.626756045764264
SIM,1847,36,50-100,1883,3
STAT,1846,42,45-49,1888,1.5659303543176617
STAT,1884,47,50-100,1931,0.278732720941915
SIM,1919,40,45-49,1959,2
SIM,1949,23,40-44,1972,9
STAT,1897,32,na,1929,3682.3972880143447
STAT,1839,16,25-29,1855,5.913633161713664
STAT,1883,18,40-44,1901,0.2059733643721681
STAT,1835,52,40-44,1887,0.006695309878093119
STAT,1794,65,na,1859,1053.1611546583636
SIM,1891,18,40-44,1909,1
SIM,1890,31,20-24,1921,9
STAT,1818,65,na,1883,813.8360439558512
STAT,1890,49,30-34,1939,0.07538952001495422
SIM,1843,84,na,1927,52
STAT,1775,106,na,1881,0.017474563156182947
STAT,1878,29,50-100,1907,0.7652918416848769
STAT,1827,50,35-39,1877,0.010949215525819933
STAT,1858,5,na,1863,2644.435859011281
STAT,1888,44,15-19,1932,0.018481189350618696
STAT,1863,52,na,1915,2161.2165559669857
STAT,1919,31,40-44,1950,4.891174081858065
SIM,1854,42,45-49,1896,5
SIM,1964,38,25-29,2002,3
STAT,1822,38,20-24,1860,1.7835757026550072
SIM,1870,26,20-24,1896,2
STAT,1988,16,25-29,2004,71.54659313299783
STAT,1862,43,40-44,1905,2.17481792840682
SIM,1946,35,na,1981,4651
STAT,1830,48,50-100,1878,0.22367258189797257
STAT,1862,26,20-24,1888,11.550694899790335
STAT,1854,16,20-24,1870,17.380098411308712
SIM,1870,43,40-44,1913,4
STAT,1882,39,30-34,1921,5.947116402878677
STAT,1951,29,20-24,1980,25.16872491828456
STAT,1888,108,na,1996,0.21295119687743996
SIM,1890,39,30-34,1929,11
STAT,1869,27,15-19,1896,0.5070617290565607
STAT,1860,87,na,1947,163.86727138907463
SIM,1886,29,50-100,1915,2
STAT,1847,35,15-19,1882,0.04577136036255645
SIM,1939,16,35-39,1955,13
SIM,1898,26,na,1924,3882
STAT,1876,33,50-100,1909,1.088448849816695
STAT,1891,28,40-44,1919,4.257587601065417
SIM,1961,31,40-44,1992,3
STAT,1964,48,25-29,2012,0.0799753101128198
SIM,1830,29,30-34,1859,60
STAT,1969,41,35-39,2010,0.3021204885008458
STAT,1826,60,na,1886,1111.100499013423
SIM,1864,46,na,1910,2639
SIM,1872,41,na,1913,2878
STAT,1836,20,40-44,1856,2.6064406624213254
STAT,1871,31,45-49,1902,2.0103101969006
SIM,1836,26,20-24,1862,24
STAT,1838,48,25-29,1886,0.05068655058309771
STAT,1849,24,50-100,1873,0.376664822669692
STAT,1982,28,25-29,2010,107.2974800824035
SIM,1832,33,na,1865,2193
STAT,1861,45,45-49,1906,0.22867741602444683
STAT,1847,26,25-29,1873,39.405180733872605
STAT,1963,27,na,1990,5516.199908156058
STAT,1808,50,30-34,1858,0.029536005071164863
STAT,1875,27,45-49,1902,1.3241424157591937
STAT,1815,48,25-29,1863,0.1158761945805566
SIM,1933,39,20-24,1972,2
SIM,1877,64,na,1941,2037
STAT,1876,28,45-49,1904,1.3199056661876662
STAT,1962,26,50-100,1988,1.4788290760271023
STAT,1836,36,20-24,1872,0.8703849687503592
SIM,1875,35,50-100,1910,5
STAT,1953,31,40-44,1984,5.572024111104464
STAT,1814,47,25-29,1861,0.16014185520465063
STAT,1893,21,25-29,1914,83.75734456085868
SIM,1924,22,25-29,1946,131
STAT,1904,38,50-100,1942,0.436980697695914
STAT,1861,31,30-34,1892,16.819434087993432
SIM,1855,26,25-29,1881,77
STAT,1832,32,15-19,1864,0.12933113056693837
STAT,1945,21,40-44,1966,4.254196390705938
STAT,1925,39,20-24,1964,0.3642338401680859
SIM,1840,43,25-29,1883,2
STAT,1828,26,20-24,1854,29.85113800687089
SIM,1824,38,na,1862,1666
STAT,1957,56,na,2013,5597.699468213971
STAT,1982,19,35-39,2001,6.809653119444726
STAT,1810,51,25-29,1861,0.013236238089863036
STAT,1824,33,25-29,1857,19.177354724323777
STAT,1914,39,45-49,1953,0.7779740684397906
STAT,1921,46,25-29,1967,0.06915673163036645
SIM,1779,77,na,1856,473
STAT,1952,38,50-100,1990,0.5976051819903406
SIM,1922,39,45-49,1961,1
STAT,1890,16,30-34,1906,2.253067515907799
STAT,1960,22,na,1982,5507.074612370757
SIM,1832,33,25-29,1865,22
SIM,1880,92,na,1972,238
SIM,1960,38,50-100,1998,1
SIM,1912,38,50-100,1950,1
SIM,1896,43,na,1939,3600
SIM,1884,28,45-49,1912,2
SIM,1951,24,35-39,1975,22
STAT,1843,51,30-34,1894,0.0060012518384429565
SIM,1990,19,na,2009,5510
SIM,1917,24,35-39,1941,1
SIM,1858,44,30-34,1902,4
SIM,1792,75,na,1867,294
SIM,1858,35,40-44,1893,9
STAT,1937,30,45-49,1967,1.7996493613862707
SIM,1930,20,na,1950,5846
SIM,1833,34,25-29,1867,4
SIM,1874,30,25-29,1904,20
STAT,1809,51,30-34,1860,0.01468900653741695
SIM,1904,68,na,1972,3230
SIM,1885,30,50-100,1915,2
STAT,1892,15,50-100,1907,0.07119277796434352
SIM,1838,39,30-34,1877,11
STAT,1819,40,35-39,1859,4.064824928515254
STAT,1847,22,na,1869,2016.844645955779
STAT,1819,51,45-49,1870,0.027416303590043427
SIM,1839,43,30-34,1882,2
SIM,1885,51,na,1936,2847
STAT,1850,23,25-29,1873,70.2245419993204
STAT,1933,49,20-24,1982,0.017443112766577323
SIM,1844,20,40-44,1864,5
STAT,1855,17,20-24,1872,17.94225545854911
SIM,1853,30,35-39,1883,29
SIM,1919,91,na,2010,865
STAT,1825,34,25-29,1859,18.685354436512583
STAT,1913,38,50-100,1951,0.4760448699803049
STAT,1853,40,35-39,1893,1.821072302973625
STAT,1912,27,na,1939,4264.447609209659
STAT,1816,82,na,1898,230.42165692335072
STAT,1974,1,na,1975,5933.600410670005
SIM,1840,18,35-39,1858,1
STAT,1849,34,40-44,1883,3.4691218138041666
SIM,1890,38,na,1928,3289
SIM,1959,34,na,1993,5952
STAT,1957,20,15-19,1977,8.131955703578502
SIM,1920,42,na,1962,4117
STAT,1861,34,50-100,1895,0.8715265045398756
SIM,1853,41,45-49,1894,1
STAT,1864,51,20-24,1915,7.640209587033825E-4
STAT,1932,23,20-24,1955,167.89283452745852
STAT,1890,41,20-24,1931,0.22495876447600477
SIM,1873,38,40-44,1911,18
STAT,1917,34,35-39,1951,10.949170317394568
STAT,1927,41,40-44,1968,0.3624587625251833
STAT,1849,88,na,1937,106.40414794426795
SIM,1827,40,35-39,1867,1
STAT,1972,23,na,1995,5411.965250732841
STAT,1831,43,50-100,1874,0.9996181423274862
SIM,1937,20,45-49,1957,2
SIM,1848,28,35-39,1876,26
STAT,1909,24,35-39,1933,10.047372103056247
SIM,1940,23,20-24,1963,262
SIM,1945,30,45-49,1975,3
STAT,1840,34,20-24,1874,2.58681034778845
SIM,1955,20,na,1975,6550
STAT,1958,18,45-49,1976,0.7569302080785516
STAT,1865,38,40-44,1903,4.5354931973796555
STAT,1947,17,30-34,1964,15.84493076814727
STAT,1810,52,50-100,1862,0.05530165597580871
STAT,1992,15,30-34,2007,20.201277893309015
SIM,1981,12,na,1993,6462
SIM,1857,34,40-44,1891,11
SIM,1875,31,25-29,1906,20
STAT,1897,47,20-24,1944,0.010396774892491202
STAT,1895,17,15-19,1912,8.914834548449171
STAT,1888,28,na,1916,3226.100815693826
SIM,1864,29,30-34,1893,59
STAT,1874,40,25-29,1914,0.7663299543120988
SIM,1927,31,40-44,1958,4
SIM,1865,38,50-100,1903,1
STAT,1866,38,35-39,1904,7.528108851733486
SIM,1889,46,25-29,1935,1
STAT,1892,42,15-19,1934,0.019950419229323415
STAT,1842,50,30-34,1892,0.004646462730325587
STAT,1845,30,35-39,1875,8.284240024128788
STAT,1835,41,30-34,1876,0.8708126345511846
SIM,1951,52,na,2003,6127
SIM,1948,19,40-44,1967,2
STAT,1985,20,40-44,2005,5.540997078875182
STAT,1881,49,na,1930,2452.0740467558194
STAT,1896,79,na,1975,1708.2060542737647
STAT,1866,18,35-39,1884,0.5988909394987278
SIM,1882,40,25-29,1922,2
SIM,1985,18,15-19,2003,73
STAT,1852,36,35-39,1888,6.774610417978661
STAT,1983,15,na,1998,6012.198243730491
STAT,1931,47,50-100,1978,0.3490894426098631
SIM,1879,24,20-24,1903,161
STAT,1880,64,na,1944,2126.4316959465045
STAT,1851,24,25-29,1875,53.435374126967695
STAT,1980,10,na,1990,6294.922962944204
SIM,1909,27,na,1936,4679
SIM,1955,17,30-34,1972,28
SIM,1905,13,na,1918,4552
STAT,1943,24,35-39,1967,11.55437432604855
STAT,1978,30,45-49,2008,2.5290796910627242
STAT,1887,29,50-100,1916,0.82141581329275
STAT,1929,32,50-100,1961,1.2120495580599369
SIM,1865,33,30-34,1898,4
STAT,1805,90,na,1895,32.39935273486645
STAT,1818,40,40-44,1858,3.180142703178513
SIM,1842,40,30-34,1882,2
SIM,1860,36,35-39,1896,8
STAT,1856,49,30-34,1905,0.08344800528370236
STAT,1879,34,20-24,1913,3.2293496590929656
STAT,1875,41,25-29,1916,0.7692987511230711
SIM,1883,41,25-29,1924,1
SIM,1843,41,30-34,1884,1
SIM,1993,20,40-44,2013,10
SIM,1844,69,na,1913,1342
SIM,1874,38,35-39,1912,6
STAT,1834,40,30-34,1874,1.297650574188916
STAT,1896,46,20-24,1942,0.010347186428941724
STAT,1856,29,30-34,1885,22.645900236576345
STAT,1874,48,35-39,1922,0.16332432384852913
STAT,1977,2,na,1979,6136.179463216002
STAT,1873,16,25-29,1889,6.717749515262534
SIM,1917,78,na,1995,2558
STAT,1903,99,na,2002,50.93739768420026
STAT,1891,41,15-19,1932,0.019786336231610458
SIM,1948,35,50-100,1983,4
STAT,1884,5,na,1889,3002.292659102212
STAT,1844,20,50-100,1864,0.43204895474437083
STAT,1964,34,20-24,1998,3.609218539186728
SIM,1934,21,25-29,1955,323
STAT,1863,42,15-19,1905,0.013918482326464015
SIM,1891,34,40-44,1925,12
SIM,1829,77,na,1906,474
STAT,1807,54,25-29,1861,0.01335788831117324
SIM,1959,22,40-44,1981,3
STAT,1883,23,30-34,1906,20.049566286689796
STAT,2002,10,na,2012,6835.179254196811
STAT,1972,23,50-100,1995,0.9751497449825218
SIM,1914,33,20-24,1947,2
SIM,1830,25,45-49,1855,1
STAT,1892,29,40-44,1921,4.301918536652973
STAT,1920,45,25-29,1965,0.06795914725729563
SIM,1908,42,na,1950,3722
SIM,1850,34,30-34,1884,2
STAT,1926,21,25-29,1947,129.86891916570488
STAT,1867,7,na,1874,2996.0361586250115
STAT,1977,33,na,2010,6007.570883606121
STAT,1863,39,15-19,1902,0.05609581941488864
SIM,1867,21,50-100,1888,1
SIM,1891,23,30-34,1914,56
STAT,1920,34,15-19,1954,0.16098004845734504
STAT,1852,44,na,1896,2149.654566692618
STAT,1861,18,na,1879,2516.3386476350893
SIM,1887,34,20-24,1921,7
STAT,1916,18,40-44,1934,0.341610076560776
STAT,1897,26,15-19,1923,0.7025263735450353
STAT,1822,54,20-24,1876,0.0012899561290827693
SIM,1826,36,35-39,1862,19
STAT,1827,45,45-49,1872,0.3070175800888155
STAT,1925,29,50-100,1954,1.3465942314977413
STAT,1832,28,30-34,1860,23.556429912870463
STAT,1883,34,40-44,1917,4.854630811767871
SIM,1980,22,20-24,2002,4
SIM,1790,71,na,1861,369
SIM,1929,12,na,1941,5474
SIM,1975,25,25-29,2000,210
SIM,1896,26,50-100,1922,3
STAT,1837,36,15-19,1873,0.050024750782079436
SIM,1840,28,30-34,1868,32
STAT,1940,26,40-44,1966,5.489406756875276
STAT,1891,42,20-24,1933,0.22623903381817145
SIM,1872,29,35-39,1901,18
STAT,1795,95,na,1890,2.329758060487996
SIM,1801,72,na,1873,779
STAT,1791,81,na,1872,225.42337903736896
STAT,1797,103,na,1900,0.04273182371494137
STAT,1863,26,15-19,1889,0.4611468778169012
SIM,1852,30,40-44,1882,5
SIM,1925,34,35-39,1959,17
STAT,1894,24,45-49,1918,1.0280277164664031
STAT,1959,19,45-49,1978,0.7535902247678458
SIM,1974,28,35-39,2002,53
STAT,1866,39,40-44,1905,4.63532108520705
SIM,1958,44,35-39,2002,1
STAT,1812,52,40-44,1864,0.023320810779686733
STAT,1946,64,na,2010,4331.595822165778
STAT,1833,44,25-29,1877,0.5374220263515757
STAT,1838,39,50-100,1877,1.257117567520607
STAT,1953,34,45-49,1987,2.2363602804709632
SIM,1861,35,45-49,1896,3
SIM,1922,36,40-44,1958,6
STAT,1811,43,35-39,1854,6.773596454842621
STAT,1870,65,na,1935,1922.7112290472385
STAT,1842,34,30-34,1876,15.897056848362505
STAT,1890,25,20-24,1915,16.6549879390289
SIM,1882,24,25-29,1906,143
STAT,1859,87,na,1946,161.96382466659566
SIM,1961,34,45-49,1995,1
STAT,1914,36,40-44,1950,1.7340299947320872
STAT,1974,19,40-44,1993,2.106350479685648
STAT,1906,33,20-24,1939,2.6009555079794557
SIM,1966,12,na,1978,5939
STAT,1844,30,40-44,1874,4.428702478432973
SIM,1898,4,na,1902,4251
STAT,1785,96,na,1881,1.0659839342518334
STAT,1811,54,45-49,1865,0.04149437681126715
SIM,1908,50,na,1958,3557
STAT,1876,34,30-34,1910,20.650743436270364
STAT,1982,25,20-24,2007,29.797013593344637
STAT,1874,79,na,1953,825.9559674508422
SIM,1884,34,30-34,1918,24
STAT,1939,23,30-34,1962,33.31355051262458
STAT,1836,39,25-29,1875,3.1512637759228386
STAT,1769,115,na,1884,2.780378282577864E-4
STAT,1843,46,40-44,1889,0.17318259390470708
SIM,1951,60,na,2011,5768
STAT,1949,45,35-39,1994,0.18084092635626345
SIM,1903,33,45-49,1936,6
SIM,1833,85,na,1918,66
STAT,1944,22,50-100,1966,0.8199220393634259
SIM,1841,44,25-29,1885,6
STAT,1875,24,40-44,1899,2.4695834578828064
STAT,1968,40,35-39,2008,0.302477821752038
SIM,1865,39,na,1904,2829
STAT,1853,112,na,1965,1.7533893293349967E-4
SIM,1900,47,45-49,1947,1
STAT,1897,7,na,1904,4020.413236318634
STAT,1875,25,25-29,1900,50.79073974607017
STAT,1927,44,45-49,1971,0.24002696902474271
STAT,1972,42,45-49,2014,0.2555662861221896
SIM,1945,42,na,1987,4685
STAT,1859,6,na,1865,2662.2093287975076
SIM,1968,14,na,1982,5395
STAT,1865,62,na,1927,1903.1361453586117
SIM,1956,34,na,1990,5339
STAT,1799,88,na,1887,64.91781203358838
STAT,1795,74,na,1869,397.0113907516641
STAT,1814,70,na,1884,1043.200122736142
STAT,1827,101,na,1928,0.4634150546449389
STAT,1843,54,35-39,1897,0.008400622251088435
SIM,1880,21,50-100,1901,1
SIM,1930,49,50-100,1979,1
STAT,1950,48,45-49,1998,0.30761843325372923
SIM,1844,77,na,1921,645
STAT,1828,46,45-49,1874,0.22019003864461556
STAT,1893,37,40-44,1930,6.385544506549961
STAT,1932,42,50-100,1974,0.1837958813738131
SIM,1941,61,na,2002,3553
STAT,1977,15,45-49,1992,0.7793450798178574
STAT,1988,17,na,2005,6075.247768098009
STAT,1884,35,40-44,1919,5.038723750062834
STAT,1946,47,40-44,1993,0.20990879365532283
STAT,1890,44,25-29,1934,0.8932958038664549
SIM,1805,67,na,1872,1027
STAT,1876,4,na,1880,3460.0912155729393
STAT,1898,49,35-39,1947,0.12059883624220513
STAT,1884,108,na,1992,0.16600187587374898
STAT,1890,33,15-19,1923,0.19996451122497017
STAT,1878,37,45-49,1915,2.4020628889359177
SIM,1872,35,20-24,1907,2
STAT,1870,20,40-44,1890,2.38494525850459
STAT,1966,45,30-34,2011,0.13428530722760257
SIM,1908,31,25-29,1939,1
STAT,1957,15,25-29,1972,65.97235352123782
SIM,1892,35,40-44,1927,21
SIM,1911,17,na,1928,5074
STAT,1918,47,50-100,1965,0.277708772928169
STAT,1827,37,na,1864,2281.9231372592176
SIM,1874,35,30-34,1909,3
STAT,1880,111,na,1991,0.011569206892537267
SIM,1870,29,25-29,1899,119
STAT,1967,47,na,2014,5508.660615952047
STAT,1961,41,30-34,2002,0.19838252692741737
SIM,1890,19,30-34,1909,2
SIM,1954,49,na,2003,5343
SIM,1967,15,35-39,1982,13
SIM,1769,86,na,1855,63
STAT,1806,53,25-29,1859,0.012220118000119254
STAT,1830,48,20-24,1878,0.010928628212724202
SIM,1960,4,na,1964,6329
STAT,1857,44,40-44,1901,1.9943843498284515
STAT,1899,28,45-49,1927,1.7492881938204392
STAT,1982,29,30-34,2011,63.84126901380596
STAT,1877,50,25-29,1927,0.004313094293993957
SIM,1886,37,45-49,1923,1
STAT,1864,43,15-19,1907,0.01412742664427169
SIM,1865,44,40-44,1909,6
STAT,1982,33,15-19,2015,0.21258220984668688
SIM,1995,10,na,2005,6763
SIM,1965,15,25-29,1980,140
STAT,1826,33,35-39,1859,9.063459742083827
SIM,1881,69,na,1950,1044
STAT,1837,44,na,1881,1751.6787009882537
SIM,1883,25,na,1908,2501
STAT,1921,23,45-49,1944,1.4615656525707272
SIM,1951,2,na,1953,6328
STAT,1866,35,30-34,1901,5.7549877593363465
STAT,1894,67,na,1961,2528.582925640735
STAT,1862,29,25-29,1891,40.90426981425511
STAT,1969,18,20-24,1987,195.38686260804843
STAT,1842,53,35-39,1895,0.006518518611008301
STAT,1882,19,30-34,1901,1.7869985694080046
STAT,1993,22,35-39,2015,15.685767211220124
STAT,1873,25,15-19,1898,0.5383113098675909
SIM,1834,33,35-39,1867,17
SIM,1816,59,na,1875,1339
STAT,1976,34,35-39,2010,14.343298885737292
SIM,1909,21,45-49,1930,4
STAT,1941,8,na,1949,4714.842628392315
SIM,1827,40,50-100,1867,1
STAT,1912,35,na,1947,4281.9607059470345
STAT,1959,15,35-39,1974,6.337760970704508
STAT,1816,44,30-34,1860,2.4254004744649875
STAT,1902,28,na,1930,3877.8334573530597
SIM,1814,53,25-29,1867,1
STAT,1992,18,35-39,2010,6.94862847443134
STAT,1873,45,15-19,1918,4.7609515545341105E-4
STAT,1893,45,35-39,1938,0.11634589220733459
STAT,1972,23,15-19,1995,7.888960528706785
STAT,1982,32,30-34,2014,26.079549243039754
SIM,1824,44,30-34,1868,1
SIM,1855,21,na,1876,1952
STAT,1968,38,50-100,2006,0.6228596643747503
SIM,1891,76,na,1967,1551
SIM,1869,38,20-24,1907,1
SIM,1875,47,40-44,1922,1
SIM,1931,33,50-100,1964,1
STAT,1841,38,25-29,1879,2.9848697012171437
SIM,1876,34,45-49,1910,2
SIM,1874,15,30-34,1889,5
STAT,1867,47,40-44,1914,0.1836060286937304
STAT,1868,34,45-49,1902,1.9169397907681534
STAT,1910,79,na,1989,2147.1088035061894
SIM,1869,21,na,1890,2008
STAT,1864,54,25-29,1918,0.003549469226199831
STAT,1866,15,30-34,1881,1.770740674951233
STAT,1859,79,na,1938,642.6907516927309
STAT,1949,42,30-34,1991,0.17832306754302962
SIM,1831,59,na,1890,1270
SIM,1816,38,40-44,1854,9
SIM,1959,25,45-49,1984,7
STAT,1916,18,50-100,1934,0.09150267682761136
STAT,1958,40,na,1998,5866.438520747225
SIM,1830,41,45-49,1871,4
SIM,1957,30,na,1987,6287
STAT,1818,43,45-49,1861,1.9455832329457643
STAT,1888,27,30-34,1915,34.16112551907846
STAT,1843,16,45-49,1859,0.08425617072922356
STAT,1901,38,20-24,1939,0.26761794840737846
STAT,1838,39,35-39,1877,7.242147212252192
STAT,1811,51,40-44,1862,0.03196789517163747
STAT,1871,24,50-100,1895,0.4652639382189972
SIM,1818,85,na,1903,235
SIM,1882,94,na,1976,322
STAT,1807,51,20-24,1858,0.002957633380506331
STAT,1858,45,40-44,1903,0.15566556242216126
STAT,1898,29,35-39,1927,14.941684101978073
STAT,1993,18,50-100,2011,0.6218760502077573
STAT,1845,95,na,1940,8.959263761928813
STAT,1835,88,na,1923,85.56253580377945
SIM,1965,38,40-44,2003,4
STAT,1991,15,15-19,2006,75.0984677367133
SIM,1896,27,30-34,1923,80
SIM,1876,31,40-44,1907,5
SIM,1846,39,35-39,1885,8
STAT,1831,107,na,1938,0.003699982059127714
SIM,1907,25,na,1932,4363
SIM,1919,30,50-100,1949,2
STAT,1979,10,na,1989,6243.441197609317
STAT,1833,43,40-44,1876,1.9068400331341913
STAT,1898,30,15-19,1928,0.22389580263241707
STAT,1816,47,35-39,1863,0.28551774477240266
STAT,1901,43,na,1944,3721.9001049530475
STAT,1974,23,25-29,1997,139.60790017139104
SIM,1995,17,15-19,2012,135
STAT,1771,93,na,1864,8.086040123936879
STAT,1801,54,30-34,1855,0.022728521884909734
STAT,1891,26,20-24,1917,16.790204750482516
STAT,1833,32,30-34,1865,15.966268851774874
SIM,1841,43,40-44,1884,5
STAT,1837,49,15-19,1886,2.930680125490591E-4
SIM,1832,89,na,1921,114
STAT,1861,40,na,1901,2239.7946913799087
SIM,1841,32,30-34,1873,25
SIM,1904,24,50-100,1928,1
SIM,1856,34,25-29,1890,14
STAT,1898,41,25-29,1939,0.06986505864392982
STAT,1987,17,15-19,2004,74.76893272897256
STAT,1854,111,na,1965,4.6633833661978126E-4
STAT,1886,24,na,1910,2860.976993160107
STAT,1880,103,na,1983,4.2378287718478775
SIM,1884,37,35-39,1921,20
STAT,1994,15,40-44,2009,2.3305771760347294
STAT,1876,40,35-39,1916,2.182060376927874
STAT,1984,29,40-44,2013,7.665170446133725
SIM,1948,24,30-34,1972,2
SIM,1836,46,45-49,1882,1
STAT,1843,23,50-100,1866,0.5099034206382935
STAT,1848,34,25-29,1882,11.311954324415801
STAT,1866,54,35-39,1920,0.008955546901512285
SIM,1895,28,20-24,1923,1
STAT,1961,15,na,1976,5490.923049391752
SIM,1836,26,na,1862,1627
SIM,1891,68,na,1959,2249
SIM,1826,33,30-34,1859,6
SIM,1869,13,na,1882,2279
SIM,1903,30,40-44,1933,3
STAT,1812,60,na,1872,1063.1096784940698
STAT,1887,28,20-24,1915,15.119148541685396
STAT,1842,17,35-39,1859,0.5422187525766816
SIM,1841,41,20-24,1882,4
SIM,1848,25,30-34,1873,37
STAT,1876,37,35-39,1913,8.437845747315869
STAT,1822,41,45-49,1863,3.1420713020208786
SIM,1783,93,na,1876,3
SIM,1884,40,35-39,1924,2
STAT,1935,23,na,1958,5740.096932993219
STAT,1991,22,50-100,2013,1.091843687946606
STAT,1864,35,20-24,1899,0.8018584465592928
STAT,1945,30,na,1975,4865.5087467373605
STAT,1891,45,25-29,1936,0.046804802057196296
STAT,1917,22,40-44,1939,4.124163804836298
STAT,1940,53,na,1993,4383.767467770448
SIM,1883,25,25-29,1908,61
STAT,1833,41,20-24,1874,0.13815035262495853
STAT,1867,52,30-34,1919,0.006379659230995363
STAT,1801,110,na,1911,1.1598584234567801E-4
STAT,1842,37,35-39,1879,6.384805150859435
STAT,1864,29,35-39,1893,9.871595010802624
STAT,1939,38,50-100,1977,0.4993757877038834
STAT,1844,33,45-49,1877,1.7261911676809107
SIM,1878,57,na,1935,2428
STAT,1837,36,na,1873,1907.9943845877401
STAT,1893,90,na,1983,478.39130418723676
STAT,1889,44,30-34,1933,1.6134067522800497
STAT,1852,23,35-39,1875,6.488916775102258
SIM,1925,31,30-34,1956,36
STAT,1881,23,20-24,1904,76.4714731725665
STAT,1948,41,na,1989,5104.670171610525
STAT,1936,16,na,1952,4079.2076633894503
SIM,1850,37,35-39,1887,20
SIM,1947,23,30-34,1970,2
STAT,1887,97,na,1984,70.20514175166734
STAT,1883,83,na,1966,775.0295798042374
STAT,1977,25,na,2002,5871.7098494126985
SIM,1852,33,45-49,1885,4
STAT,1983,28,40-44,2011,7.638592910353739
SIM,1919,83,na,2002,1910
STAT,1833,22,na,1855,2001.0896670554969
STAT,1950,45,40-44,1995,0.22482902332033938
STAT,1849,35,25-29,1884,2.3314087172848454
STAT,1953,28,50-100,1981,1.3948993459915207
SIM,1900,44,40-44,1944,1
STAT,1914,22,15-19,1936,6.2792158845609505
STAT,1855,33,20-24,1888,2.317703737895171
SIM,1986,23,35-39,2009,33
STAT,1922,45,35-39,1967,0.17166242913058302
SIM,1873,39,25-29,1912,2
SIM,1956,33,25-29,1989,24
STAT,1852,29,50-100,1881,0.6300990115955739
STAT,1975,0,na,1975,6030.436478355498
SIM,1961,28,50-100,1989,3
STAT,1853,35,45-49,1888,2.026402460392907
SIM,1863,33,20-24,1896,3
SIM,1922,22,15-19,1944,17
STAT,1898,46,30-34,1944,0.08540542807116946
STAT,1893,42,30-34,1935,1.6749776512669727
SIM,1931,83,na,2014,2771
SIM,1858,19,40-44,1877,1
STAT,1870,23,45-49,1893,0.7909081385240795
STAT,1830,108,na,1938,0.001149071122071152
STAT,1925,53,na,1978,5026.634174798556
STAT,1902,36,na,1938,3890.6727051126395
STAT,1839,46,20-24,1885,0.009821206323420494
STAT,1942,71,na,2013,3516.29441226718
STAT,1894,75,na,1969,1995.3983180382354
SIM,1857,35,25-29,1892,2
SIM,1921,2,na,1923,5721
STAT,1878,53,45-49,1931,0.017206044424836378
STAT,1923,31,50-100,1954,1.0979142608673191
SIM,1879,20,na,1899,3029
STAT,1916,9,na,1925,4858.75503127492
STAT,1898,89,na,1987,633.1243153528534
STAT,1890,19,35-39,1909,0.7695964065130914
STAT,1948,33,25-29,1981,12.434641377060332
SIM,1862,36,45-49,1898,4
STAT,1838,45,20-24,1883,0.010973462870842901
STAT,1854,49,20-24,1903,0.009572241144363433
SIM,1877,72,na,1949,1593
SIM,1966,39,40-44,2005,4
STAT,1894,21,40-44,1915,3.100745347522101
STAT,1908,100,na,2008,36.314358065456496
STAT,1854,36,45-49,1890,1.6319044275228316
STAT,1860,34,40-44,1894,3.999083317253279
STAT,1959,33,na,1992,5816.016031943798
STAT,1914,61,na,1975,3875.2790932444823
SIM,1829,32,15-19,1861,1
SIM,1928,27,15-19,1955,1
SIM,1966,37,na,2003,5823
STAT,1921,20,40-44,1941,4.40728057192144
STAT,1922,83,na,2005,1959.6165778170318
SIM,1886,34,40-44,1920,1
STAT,1966,48,35-39,2014,0.1927671003689968
SIM,1955,45,na,2000,6416
STAT,1938,44,20-24,1982,0.0208340587247511
SIM,1912,0,na,1912,4599
STAT,1829,43,20-24,1872,0.16692026696013473
SIM,1963,8,na,1971,6582
STAT,1957,48,na,2005,5798.198168995997
STAT,1923,46,35-39,1969,0.17442797628543105
SIM,1825,40,25-29,1865,2
STAT,1961,44,35-39,2005,0.3109792655080158
SIM,1779,85,na,1864,153
SIM,1824,47,35-39,1871,1
STAT,1860,95,na,1955,12.366295258000875
STAT,1934,6,na,1940,6259.547352360441
STAT,1878,34,40-44,1912,5.1808115771002985
STAT,1950,40,50-100,1990,0.16705846107234398
SIM,1822,34,na,1856,1820
SIM,1932,24,na,1956,4816
STAT,1774,107,na,1881,3.3818871113332525E-4
STAT,1960,43,35-39,2003,0.31404786486693387
STAT,1931,5,na,1936,6074.842604210211
STAT,1967,41,25-29,2008,0.10713450024476441
STAT,1881,50,45-49,1931,0.01638633291487364
STAT,1915,46,na,1961,4283.598018938424
SIM,1923,23,15-19,1946,7
SIM,1919,17,20-24,1936,189
STAT,1899,25,40-44,1924,4.7683294353318235
STAT,1915,23,15-19,1938,6.331672972111307
STAT,1935,49,30-34,1984,0.14446649287616561
STAT,1806,50,20-24,1856,0.002703852725195805
SIM,1970,39,50-100,2009,1
STAT,1962,39,50-100,2001,0.6382467749455419
SIM,1919,13,na,1932,5645
STAT,1846,26,45-49,1872,1.3986101804207325
SIM,1920,21,na,1941,3811
STAT,1981,32,50-100,2013,1.359991120537397
SIM,1994,20,35-39,2014,18
STAT,1821,83,na,1904,242.79394565110397
STAT,1834,27,50-100,1861,0.7654914173443416
SIM,1860,20,30-34,1880,54
SIM,1881,48,40-44,1929,1
STAT,1925,44,35-39,1969,0.28032200950400554
SIM,1841,46,45-49,1887,2
STAT,1946,18,20-24,1964,173.47912729832393
STAT,1849,26,na,1875,2001.9232304689037
STAT,1946,21,20-24,1967,142.84505586988715
STAT,1852,40,40-44,1892,2.142045573646393
STAT,1904,62,na,1966,3305.830925220416
STAT,1966,17,35-39,1983,6.0484303878847125
SIM,1974,17,35-39,1991,7
STAT,1888,26,50-100,1914,0.8707684731070711
SIM,1865,26,20-24,1891,14
STAT,1813,88,na,1901,62.85835122806924
SIM,1884,3,na,1887,3256
SIM,1954,18,20-24,1972,190
SIM,1965,22,35-39,1987,34
STAT,1782,85,na,1867,114.98895778976984
STAT,1859,21,50-100,1880,0.4305136062425037
STAT,1873,48,40-44,1921,0.19922237301372422
SIM,1854,26,45-49,1880,2
STAT,1822,45,30-34,1867,0.18826266132688915
STAT,2006,1,na,2007,7032.96508539991
STAT,1900,114,na,2014,9.285158093232065E-4
SIM,1812,49,30-34,1861,1
STAT,1837,31,45-49,1868,1.5997495093029568
STAT,1927,57,na,1984,5087.146949030604
SIM,1907,79,na,1986,2046
SIM,1977,0,na,1977,6255
STAT,1944,46,25-29,1990,0.06869725570611139
STAT,1917,22,50-100,1939,0.807077124243613
STAT,1940,33,20-24,1973,2.9124419496587524
SIM,1825,34,na,1859,1750
STAT,1878,80,na,1958,874.8708695947624
STAT,1885,44,50-100,1929,1.1996765983787587
STAT,1934,44,45-49,1978,0.2666024441803535
STAT,1857,21,na,1878,2234.6199412189912
SIM,1949,36,40-44,1985,1
SIM,1839,36,20-24,1875,1
SIM,1920,35,25-29,1955,1
STAT,1981,19,40-44,2000,2.255615562605016
SIM,1871,21,45-49,1892,1
STAT,1899,44,50-100,1943,0.1144251260842545
SIM,1924,37,na,1961,4909
SIM,1859,43,40-44,1902,4
STAT,1857,26,20-24,1883,10.939393377454206
STAT,1889,16,15-19,1905,8.463044017037845
SIM,1915,74,na,1989,3140
STAT,1949,36,45-49,1985,0.9435164903567432
STAT,1914,43,20-24,1957,0.02017285146396996
STAT,1956,43,25-29,1999,0.11314677745259613
STAT,1957,22,35-39,1979,14.374289938447946
SIM,1952,22,50-100,1974,2
STAT,1970,30,40-44,2000,5.769075296868791
STAT,1845,45,50-100,1890,0.16714871668073217
STAT,1870,27,50-100,1897,0.7277935030874048
STAT,1943,40,35-39,1983,0.2568333118831277
STAT,1844,46,20-24,1890,0.010065568946198318
SIM,1897,16,15-19,1913,12
STAT,1957,43,30-34,2000,0.20183855607867396
SIM,1954,21,20-24,1975,156
STAT,1960,34,45-49,1994,2.4078013610549944
SIM,1842,44,40-44,1886,1
STAT,1845,10,na,1855,2058.66975
STAT,1852,20,30-34,1872,20.23968046984051
STAT,1863,21,45-49,1884,0.7228880903879505
STAT,1912,35,25-29,1947,1.1206343523731426
SIM,1943,21,45-49,1964,3
SIM,1932,32,na,1964,5391
STAT,1827,36,50-100,1863,1.844889811442054
SIM,1876,24,30-34,1900,47
STAT,1930,39,35-39,1969,3.6336647454977538
SIM,1907,21,35-39,1928,25
STAT,1894,13,na,1907,3825.3150868326043
STAT,1841,54,25-29,1895,0.0030625687154602404
STAT,1935,18,45-49,1953,0.7864624444239495
STAT,1978,23,35-39,2001,14.873872721164377
STAT,1903,43,45-49,1946,0.1696032863810006
STAT,1860,102,na,1962,0.8672942218710412
STAT,1902,81,na,1983,1673.893100968404
STAT,1935,21,45-49,1956,1.769776051702555
STAT,1833,46,45-49,1879,0.1983983018174212
STAT,1991,22,25-29,2013,153.27300090324843
SIM,1836,71,na,1907,607
STAT,1877,3,na,1880,3680.0995088218515
STAT,1920,5,na,1925,5203.754887148059
SIM,1932,17,30-34,1949,44
STAT,1967,26,40-44,1993,6.751288022078866
STAT,1857,13,na,1870,2510.4575254936167
STAT,1899,23,20-24,1922,108.61883412581003
STAT,1858,41,30-34,1899,1.039713479549167
STAT,1907,42,35-39,1949,0.21325171298743678
SIM,1875,60,na,1935,2345
STAT,1883,16,20-24,1899,20.06631050880771
SIM,1852,23,30-34,1875,2
STAT,1854,70,na,1924,1143.0803220480766
SIM,1951,40,35-39,1991,1
STAT,1909,28,45-49,1937,1.9008262550009132
STAT,1834,44,40-44,1878,2.4119689454314805
STAT,1868,27,35-39,1895,10.698419475661389
STAT,1858,50,20-24,1908,6.738853146406213E-4
SIM,1836,28,na,1864,1808
SIM,1816,73,na,1889,904
STAT,1973,23,30-34,1996,43.02515295793857
SIM,1911,62,na,1973,4197
SIM,1973,32,25-29,2005,15
SIM,1820,39,50-100,1859,2
STAT,1909,31,45-49,1940,1.741966506850699
STAT,1964,39,35-39,2003,3.614324030802789
STAT,1993,18,na,2011,6109.543969227109
SIM,1873,15,15-19,1888,15
SIM,1946,43,50-100,1989,2
SIM,1921,49,50-100,1970,1
STAT,1865,15,15-19,1880,7.080687663416371
SIM,1828,36,45-49,1864,7
SIM,1880,39,35-39,1919,19
STAT,1973,26,na,1999,5617.99200422231
STAT,1839,25,15-19,1864,0.45985801898988093
STAT,1848,31,20-24,1879,3.384309916268857
STAT,1878,82,na,1960,754.7626451327288
STAT,1968,25,15-19,1993,1.0228579995596754
STAT,1974,19,50-100,1993,0.5642008841447922
SIM,1898,31,25-29,1929,23
STAT,1803,64,na,1867,871.4505009232316
STAT,1929,38,na,1967,5568.72109395753
SIM,1879,19,30-34,1898,5
STAT,1865,43,30-34,1908,1.188451451342661
STAT,1924,17,30-34,1941,16.746201388309874
SIM,1827,65,na,1892,803
STAT,1872,39,35-39,1911,8.113626733080883
SIM,1980,16,na,1996,6000
SIM,1915,42,35-39,1957,2
STAT,1866,109,na,1975,0.021473593786464913
SIM,1957,36,45-49,1993,1
SIM,1922,54,na,1976,4882
SIM,1882,40,na,1922,3232
SIM,1927,19,15-19,1946,125
SIM,1890,91,na,1981,211
STAT,1821,85,na,1906,167.6583383756569
SIM,1887,4,na,1891,4015
STAT,1861,50,35-39,1911,0.008378287404855184
SIM,1887,18,na,1905,3846
STAT,1859,15,30-34,1874,1.721064634303075
SIM,1876,0,na,1876,3846
STAT,1870,94,na,1964,66.14022430392578
SIM,1901,33,35-39,1934,4
SIM,1910,43,na,1953,3483
SIM,1917,31,45-49,1948,3
SIM,1892,64,na,1956,2971
STAT,1923,41,na,1964,5014.883321027253
SIM,1856,31,20-24,1887,4
STAT,1933,32,35-39,1965,14.218542403576187
SIM,1906,27,30-34,1933,5
STAT,1891,33,30-34,1924,24.798021199064937
STAT,1820,58,na,1878,1243.8853538873266
STAT,1876,44,45-49,1920,1.7613597253288618
STAT,1808,54,40-44,1862,0.04820364408876949
STAT,1904,49,35-39,1953,0.12814081378770195
STAT,1919,19,15-19,1938,57.554079523402635
STAT,1891,0,na,1891,4188.150130292116
SIM,1941,32,35-39,1973,4
STAT,1968,44,45-49,2012,0.24847683471283302
STAT,1868,30,35-39,1898,11.318819715541498
STAT,1819,40,50-100,1859,2.371470780057116
SIM,1898,55,na,1953,3642
SIM,1972,39,35-39,2011,3
SIM,1870,42,35-39,1912,4
STAT,1940,55,na,1995,4338.468989821082
STAT,1854,56,na,1910,1661.683679515833
STAT,1855,110,na,1965,0.001475679274177196
STAT,1907,101,na,2008,22.975470238183124
STAT,1908,16,35-39,1924,0.9428474925051411
SIM,1857,87,na,1944,120
STAT,1908,84,na,1992,1404.1768636815095
SIM,1884,44,45-49,1928,6
STAT,1862,42,35-39,1904,1.76143893775294
SIM,1867,15,30-34,1882,3
STAT,1923,43,30-34,1966,0.17210800498232698
SIM,1916,16,35-39,1932,4
STAT,1938,30,50-100,1968,0.9609659987082985
STAT,1884,40,20-24,1924,0.18290913407464773
STAT,1844,23,30-34,1867,18.468307339576064
SIM,1877,10,na,1887,3485
SIM,1910,42,50-100,1952,2
STAT,1967,48,15-19,2015,5.508169879691455E-4
STAT,1883,37,45-49,1920,2.2508304613848154
STAT,1810,91,na,1901,32.99475101253027
SIM,1822,38,35-39,1860,20
STAT,1905,42,25-29,1947,0.07439248303265408
SIM,1959,20,50-100,1979,2
STAT,1947,30,50-100,1977,1.0968050065005424
SIM,1854,23,40-44,1877,6
SIM,1953,40,45-49,1993,2
SIM,1961,27,na,1988,5410
STAT,1987,24,na,2011,6032.107841995
SIM,1847,63,na,1910,1921
STAT,1940,36,25-29,1976,1.190073021295634
STAT,1834,58,na,1892,1804.7566321047143
STAT,1855,1,na,1856,3212.78072486382
STAT,1896,17,45-49,1913,0.0995701863404666
STAT,1905,22,na,1927,3950.39348018835
SIM,1935,76,na,2011,4324
STAT,1950,22,25-29,1972,126.45866865937586
SIM,1866,35,50-100,1901,1
SIM,1835,42,40-44,1877,8
STAT,1981,33,20-24,2014,4.009685693604285
STAT,1925,38,15-19,1963,0.02656334529069202
STAT,1846,23,40-44,1869,2.6389061127190705
SIM,1949,39,45-49,1988,1
STAT,1868,47,20-24,1915,0.013243182426478548
STAT,1867,22,50-100,1889,0.44119954612723394
SIM,1849,44,na,1893,2572
STAT,1921,29,40-44,1950,5.949937416753573
SIM,1849,46,na,1895,2545
STAT,1946,33,15-19,1979,0.16755853807953175
STAT,1902,102,na,2004,13.255554492958968
SIM,1891,37,45-49,1928,8
STAT,1857,29,25-29,1886,38.601839877776065
SIM,1948,47,na,1995,4342
STAT,1892,45,40-44,1937,0.14107627984331145
STAT,1942,9,na,1951,4767.065586518266
SIM,1882,21,20-24,1903,6
STAT,1901,40,30-34,1941,0.13035460326857135
STAT,1870,53,40-44,1923,0.011785248874717621
SIM,1847,25,15-19,1872,1
SIM,1865,29,25-29,1894,88
STAT,1945,40,45-49,1985,0.21864828025444175
SIM,1900,21,25-29,1921,10
SIM,1975,32,35-39,2007,29
STAT,1865,101,na,1966,3.0522572834819615
STAT,1937,35,na,1972,4351.432876577275
SIM,1854,47,na,1901,2364
STAT,1865,64,na,1929,1810.0762515583606
SIM,1903,39,40-44,1942,1
STAT,1931,32,25-29,1963,13.979588651724626
STAT,1830,46,50-100,1876,0.22957781021165916
SIM,1879,76,na,1955,880
STAT,1816,53,na,1869,1335.3505562965215
STAT,1989,26,15-19,2015,1.172503493335695
SIM,1839,39,25-29,1878,3
STAT,1914,46,25-29,1960,0.060892415244953556
SIM,1962,9,na,1971,5587
SIM,1884,33,50-100,1917,7
STAT,1960,30,50-100,1990,1.268182183577436
SIM,1938,38,30-34,1976,3
STAT,1954,43,15-19,1997,0.002273271361031534
STAT,1838,29,20-24,1867,12.743865192417461
SIM,1809,46,na,1855,1744
SIM,1846,29,20-24,1875,2
STAT,1906,16,25-29,1922,9.559794455610259
STAT,1822,48,35-39,1870,0.26086256766082316
STAT,1832,77,na,1909,588.9020164307901
SIM,1935,78,na,2013,3687
STAT,1868,15,40-44,1883,0.20892266013702265
STAT,1935,15,40-44,1950,2.2181381581448254
SIM,1861,32,40-44,1893,3
STAT,1946,24,25-29,1970,118.54158632963593
STAT,1873,113,na,1986,9.808367671780335E-4
STAT,1949,26,50-100,1975,1.342307314325912
STAT,1840,42,15-19,1882,0.0115562469190604
SIM,1820,35,20-24,1855,1
STAT,1889,74,na,1963,1878.800103399954
SIM,1785,70,na,1855,674
SIM,1896,14,na,1910,4007
SIM,1811,50,na,1861,1579
STAT,1915,54,na,1969,4161.469063064544
SIM,1834,45,na,1879,1813
SIM,1980,25,25-29,2005,123
SIM,1844,39,25-29,1883,4
STAT,1924,32,25-29,1956,12.440863424337632
STAT,1975,23,40-44,1998,5.134306925627324
STAT,1938,49,na,1987,4326.79018462486
SIM,1917,19,20-24,1936,6
STAT,1951,28,15-19,1979,0.9738727847368708
STAT,1960,31,40-44,1991,5.999179718807732
SIM,1954,24,25-29,1978,279
SIM,1970,26,50-100,1996,4
STAT,1841,52,na,1893,1904.1690705717278
STAT,1839,48,na,1887,1794.7635315170141
STAT,1844,49,25-29,1893,0.04717202387530129
STAT,1853,32,40-44,1885,4.446354555878997
STAT,1889,107,na,1996,0.4832266007966156
SIM,1932,32,25-29,1964,23
STAT,1870,16,35-39,1886,0.6339605835311299
SIM,1980,8,na,1988,6008
SIM,1917,25,40-44,1942,15
SIM,1841,58,na,1899,1599
STAT,1968,41,40-44,2009,0.3752186947663537
STAT,1830,39,30-34,1869,5.221846296670451
STAT,1906,109,na,2015,0.1376441767273788
SIM,1913,97,na,2010,352
STAT,1948,18,30-34,1966,16.09225519031905
STAT,1973,26,35-39,1999,22.515394190079977
SIM,1872,19,20-24,1891,26
SIM,1852,26,35-39,1878,32
STAT,1832,106,na,1938,0.00827201597941073
STAT,1889,37,20-24,1926,1.0965859384096168
SIM,1897,37,20-24,1934,6
STAT,1985,28,15-19,2013,1.163193182753923
STAT,1980,24,15-19,2004,8.55055342485309
STAT,1831,32,20-24,1863,2.752613164395924
STAT,1844,26,35-39,1870,9.951204467301126
STAT,1917,8,na,1925,4937.034565883503
STAT,1902,46,20-24,1948,0.01106905851973535
STAT,1913,73,na,1986,2965.826672585974
SIM,1943,30,na,1973,5398
STAT,1829,71,na,1900,977.8473276648133
STAT,1806,75,na,1881,427.52295589437546
STAT,1858,53,25-29,1911,0.0031376246096101565
STAT,1839,53,30-34,1892,0.0046448726869358055
SIM,1901,30,30-34,1931,44
SIM,1967,19,45-49,1986,4
STAT,1891,36,35-39,1927,10.136791705326008
STAT,1959,22,45-49,1981,1.7041467642367873
SIM,1823,53,na,1876,1935
SIM,1828,33,40-44,1861,3
STAT,1875,40,na,1915,2784.1867564618665
STAT,1915,22,30-34,1937,34.292301563701365
STAT,1967,29,45-49,1996,2.498757291121932
SIM,1967,22,45-49,1989,4
STAT,1899,26,25-29,1925,67.1110456236884
STAT,1840,28,35-39,1868,9.581835140208721
SIM,1844,23,na,1867,2651
STAT,1967,32,45-49,1999,2.3122488055814054
STAT,1993,15,25-29,2008,71.9915198692722
STAT,1840,56,na,1896,1636.1975156460605
SIM,1923,22,30-34,1945,52
SIM,1948,27,35-39,1975,4
SIM,1899,16,25-29,1915,21
STAT,1827,45,na,1872,2104.958231674263
STAT,1949,33,40-44,1982,5.350529651957065
STAT,1918,40,45-49,1958,0.20473307896976803
STAT,1976,31,30-34,2007,24.775076393238585
STAT,1818,36,35-39,1854,13.152244310995309
STAT,1857,47,45-49,1904,0.21113040871785624
SIM,1800,98,na,1898,4
SIM,1834,30,30-34,1864,24
STAT,1827,42,40-44,1869,2.9999115952844653
STAT,1836,52,35-39,1888,0.007930263834141135
STAT,1962,25,20-24,1987,27.13194833555195
STAT,1818,45,50-100,1863,0.3119624264210497
STAT,1952,40,45-49,1992,0.23986191313869296
STAT,1948,27,na,1975,4968.817774657946
STAT,1872,36,30-34,1908,6.205651566061607
STAT,1895,94,na,1989,214.73928367565085
STAT,1833,25,20-24,1858,11.290308258008997
STAT,1865,52,20-24,1917,7.642726498996296E-4
STAT,1824,40,na,1864,1744.9334098011884
SIM,1819,41,45-49,1860,2
STAT,1956,14,na,1970,5996.357097292806
STAT,1884,43,25-29,1927,0.7269116701625
STAT,1775,97,na,1872,1.2575796148040956
STAT,1898,35,na,1933,3709.469088723461
SIM,1841,25,20-24,1866,9
STAT,1914,35,50-100,1949,0.4886043968472627
STAT,1933,48,15-19,1981,5.832387886246671E-4
SIM,1844,16,35-39,1860,1
STAT,1816,40,50-100,1856,2.5735782701205023
STAT,1887,44,20-24,1931,0.2026240811570928
SIM,1922,35,50-100,1957,3
STAT,1865,46,35-39,1911,0.14618973489728296
SIM,1889,27,20-24,1916,21
STAT,1934,41,40-44,1975,0.4025897272978479
STAT,1852,46,na,1898,2127.202527099358
STAT,1872,75,na,1947,1192.9429261452376
STAT,1933,21,35-39,1954,14.463673640728162
STAT,1986,20,35-39,2006,15.545355562710327
SIM,1865,47,45-49,1912,1
STAT,1826,30,30-34,1856,18.571254087338882
STAT,1947,41,50-100,1988,0.1589396004554619
SIM,1854,76,na,1930,1261
STAT,1909,25,40-44,1934,5.225384299873396
SIM,1873,18,na,1891,3563
STAT,1887,43,na,1930,2967.5864065874916
STAT,1835,32,na,1867,1719.529730548524
STAT,1945,22,na,1967,4618.88355257085
SIM,1988,23,45-49,2011,4
STAT,1822,99,na,1921,1.5560517002557646
STAT,1837,98,na,1935,2.3523600276082353
STAT,1848,19,30-34,1867,2.074723894082807
SIM,1852,10,na,1862,2499
STAT,1842,103,na,1945,0.11043843005136397
SIM,1880,36,30-34,1916,4
STAT,1951,34,35-39,1985,12.784464525012844
STAT,1883,31,15-19,1914,0.16144850140138026
STAT,1998,16,na,2014,6238.661900188431
STAT,1956,28,30-34,1984,60.06451219951211
SIM,1865,106,na,1971,4
SIM,1964,28,30-34,1992,119
STAT,1862,31,50-100,1893,0.8960079930312278
STAT,1869,18,50-100,1887,0.05518496886403768
SIM,1826,40,40-44,1866,11
SIM,1915,20,na,1935,4329
STAT,1883,51,25-29,1934,0.0040183943640543385
SIM,1840,40,50-100,1880,2
STAT,1864,19,20-24,1883,18.67610059062031
STAT,1826,50,40-44,1876,0.007614708582692857
SIM,1852,64,na,1916,1360
STAT,1844,49,na,1893,1842.5267994783578
STAT,1856,41,20-24,1897,0.14045950258182502
SIM,1945,50,na,1995,4576
STAT,1910,23,na,1933,4127.280418335331
STAT,1935,30,35-39,1965,14.614871972514191
SIM,1925,11,na,1936,5602
SIM,1831,81,na,1912,350
SIM,1906,29,50-100,1935,2
STAT,1936,35,20-24,1971,0.29935243060117556
STAT,1904,32,50-100,1936,0.8718766532307808
STAT,1927,45,50-100,1972,0.32911835502017206
STAT,1769,117,na,1886,1.0918970604938518E-4
SIM,1861,40,35-39,1901,1
SIM,1966,39,na,2005,5835
SIM,1900,75,na,1975,1884
SIM,1861,20,50-100,1881,1
SIM,1909,92,na,2001,478
SIM,1935,43,na,1978,6202
STAT,1951,25,45-49,1976,2.386486653819444
STAT,1863,43,20-24,1906,0.1591021628805641
SIM,1891,19,25-29,1910,19
SIM,1937,55,na,1992,4086
STAT,1863,81,na,1944,545.6909571737742
STAT,1988,9,na,1997,6486.037522532164
SIM,1955,36,35-39,1991,3
STAT,1872,48,25-29,1920,0.06590832806563368
STAT,1901,43,35-39,1944,0.2017988896152245
STAT,1901,97,na,1998,101.5536500804919
STAT,1842,54,40-44,1896,0.007878511771924546
STAT,1832,91,na,1923,39.4792875991736
STAT,1872,54,50-100,1926,0.017019830755530662
STAT,1960,44,40-44,2004,0.3894073025635152
STAT,1892,20,25-29,1912,83.29606235580461
STAT,1859,18,35-39,1877,0.5820897607178928
STAT,1907,88,na,1995,850.2145321343296
STAT,1829,57,na,1886,1507.912033534733
STAT,1904,100,na,2004,34.35201063512323
SIM,1901,24,45-49,1925,2
STAT,1911,48,30-34,1959,0.09720715261433832
SIM,1924,84,na,2008,990
STAT,1870,47,20-24,1917,0.013589041222782301
STAT,1841,37,40-44,1878,4.585534843600973
SIM,1822,35,30-34,1857,6
STAT,1868,18,45-49,1886,0.07330451715250474
SIM,1801,74,na,1875,585
STAT,1975,37,45-49,2012,1.0692885610536031
STAT,1856,0,na,1856,3503.179964597126
STAT,1845,41,45-49,1886,1.0402350957805673
SIM,1803,84,na,1887,136
STAT,1865,19,na,1884,2678.1344163890953
SIM,1970,25,20-24,1995,54
STAT,1849,51,25-29,1900,0.0027584368483547406
STAT,1917,80,na,1997,2252.6036305589078
STAT,1990,9,na,1999,6494.553289742175
SIM,2002,3,na,2005,6948
STAT,1925,35,45-49,1960,0.9455871974860545
SIM,1807,77,na,1884,297
SIM,1832,30,20-24,1862,1
STAT,1933,7,na,1940,6178.03723281653
STAT,1876,56,na,1932,2433.2402503396966
STAT,1808,87,na,1895,89.83266690054246
STAT,1860,42,25-29,1902,0.5965404690589944
STAT,1793,91,na,1884,19.21867531821334
STAT,1878,37,na,1915,2838.847787703941
STAT,1866,49,na,1915,2356.321565514113
STAT,1947,36,35-39,1983,3.242325046164632
SIM,1859,22,na,1881,2152
STAT,1909,40,35-39,1949,0.22006945169864492
STAT,1911,96,na,2007,161.01293417765842
STAT,1860,30,30-34,1890,16.36996910639177
STAT,1841,45,35-39,1886,0.1282821810552026
STAT,1879,33,15-19,1912,0.17087976707429448
STAT,1880,42,45-49,1922,1.828498027770342
SIM,1850,54,na,1904,1342
STAT,1821,45,15-19,1866,7.442756195688101E-4
STAT,1915,89,na,2004,825.2164643853465
STAT,1921,43,20-24,1964,0.022910710131975483
STAT,1824,30,20-24,1854,8.414693331686642
STAT,1954,51,na,2005,5382.268068222541
STAT,1874,44,na,1918,2693.7497508425845
STAT,1922,49,45-49,1971,0.28633003865465795
SIM,1943,30,35-39,1973,1
STAT,1902,49,25-29,1951,0.051874851343328664
STAT,1893,29,na,1922,3456.3844356823474
STAT,1910,43,45-49,1953,0.18061726590438648
STAT,1940,25,35-39,1965,17.689206503708057
STAT,1891,48,na,1939,3169.256882142215
SIM,1942,29,50-100,1971,2
SIM,1833,36,45-49,1869,5
STAT,1952,37,20-24,1989,0.3755909166073523
SIM,1960,37,20-24,1997,3
STAT,1909,19,20-24,1928,30.55207154590918
STAT,1940,38,50-100,1978,0.5064952048307438
SIM,1835,36,50-100,1871,3
STAT,1834,51,50-100,1885,0.014414679881838564
STAT,1956,17,50-100,1973,0.5721274817048211
STAT,1851,40,25-29,1891,0.5143654932994591
STAT,1825,36,45-49,1861,3.4020183946593994
SIM,1933,35,45-49,1968,1
SIM,1958,38,na,1996,6127
SIM,1888,42,20-24,1930,1
STAT,1938,43,50-100,1981,0.13883474010486066
STAT,1847,50,45-49,1897,0.011327109453043313
SIM,1933,62,na,1995,5656
STAT,1958,37,50-100,1995,0.6556379942232572
STAT,1815,52,30-34,1867,0.011679511190426057
SIM,1844,36,20-24,1880,1
STAT,1851,19,na,1870,2187.126054565525
STAT,1941,34,40-44,1975,4.736681169431937
STAT,1913,49,50-100,1962,0.2534094820321472
SIM,1971,31,45-49,2002,8
STAT,1952,45,15-19,1997,5.323942790378052E-4
SIM,1934,4,na,1938,6095
STAT,1946,46,35-39,1992,0.1720811489802861
STAT,1850,34,na,1884,2517.0088781467493
STAT,1941,42,35-39,1983,0.24881538945601786
STAT,1883,52,50-100,1935,0.016961619289697107
SIM,1928,34,25-29,1962,27
SIM,1902,56,na,1958,3508
STAT,1941,37,45-49,1978,0.8350693803440014
STAT,1892,63,na,1955,2580.878932871326
SIM,1928,19,30-34,1947,22
STAT,1854,45,50-100,1899,0.20208438599570683
SIM,1878,19,15-19,1897,7
STAT,1943,10,na,1953,4822.217667603103
STAT,1926,47,20-24,1973,0.015733082953290584
STAT,1840,25,30-34,1865,25.55327373984461
SIM,1939,11,na,1950,5033
SIM,1805,65,na,1870,1119
STAT,1956,40,20-24,1996,0.028104615048660214
SIM,1982,21,na,2003,6793
SIM,1808,47,50-100,1855,1
STAT,1965,43,na,2008,5552.031529037778
STAT,1879,18,20-24,1897,21.307243436554373
SIM,1860,61,na,1921,1911
SIM,1972,5,na,1977,5841
STAT,1890,63,na,1953,2516.0834627461245
STAT,1850,20,20-24,1870,86.38396433100161
STAT,1909,69,na,1978,3134.678808325487
SIM,1935,3,na,1938,6607
STAT,1861,26,na,1887,2322.961277801837
STAT,1905,78,na,1983,2115.3989684274816
STAT,1936,36,25-29,1972,1.1171942176298277
SIM,1869,17,15-19,1886,3
STAT,1900,31,25-29,1931,16.469081608965773
STAT,1961,20,35-39,1981,14.095251849039553
STAT,1915,44,40-44,1959,0.28969558940819345
SIM,1981,22,15-19,2003,15
SIM,1968,16,na,1984,5388
STAT,1826,53,45-49,1879,0.009890990389693863
SIM,1849,22,20-24,1871,95
SIM,1922,32,30-34,1954,77
SIM,1895,69,na,1964,2248
STAT,1912,46,15-19,1958,4.0996441829428313E-4
STAT,1939,24,15-19,1963,6.167863885800854
SIM,1847,34,na,1881,2607
STAT,1825,64,na,1889,1240.7704471184647
SIM,1897,70,na,1967,2356
STAT,1951,47,na,1998,5251.374315468609
STAT,1959,16,40-44,1975,2.112058965772972
STAT,1812,51,35-39,1863,0.019456921993815567
STAT,1883,19,25-29,1902,6.363946822066982
STAT,1851,26,45-49,1877,1.0383571529779412
SIM,1812,66,na,1878,667
STAT,1975,34,40-44,2009,6.0652193830231615
SIM,1967,16,40-44,1983,3
STAT,1896,37,30-34,1933,8.123801337298552
SIM,1922,29,30-34,1951,2
SIM,1885,2,na,1887,3480
STAT,1951,31,30-34,1982,22.08251307994413
STAT,1990,13,na,2003,6490.982014705631
SIM,1950,32,50-100,1982,7
STAT,1855,86,na,1941,188.79345576538432
SIM,1856,57,na,1913,1798
STAT,1914,32,30-34,1946,18.310953102596972
SIM,1973,17,na,1990,4794
SIM,1899,45,50-100,1944,1
STAT,1831,54,30-34,1885,0.004663800553934677
STAT,1901,19,50-100,1920,0.07876982223811294
SIM,1814,92,na,1906,12
SIM,1887,63,na,1950,3047
STAT,1855,16,50-100,1871,0.04987626526382782
STAT,1897,49,40-44,1946,0.14591059753791177
STAT,1884,34,35-39,1918,11.44823159126401
STAT,1820,106,na,1926,0.0071259540070667485
SIM,1892,34,35-39,1926,24
STAT,1833,28,25-29,1861,39.47489944239338
STAT,1854,52,45-49,1906,0.011760278869300858
SIM,1841,28,25-29,1869,52
SIM,1907,42,40-44,1949,1
STAT,1846,46,30-34,1892,0.10035422483684181
SIM,1812,43,50-100,1855,3
SIM,1866,44,35-39,1910,2
STAT,1962,39,25-29,2001,1.496761673079717
STAT,1907,59,na,1966,3557.6936643679733
STAT,1841,51,20-24,1892,6.592159382055132E-4
SIM,1839,68,na,1907,1482
SIM,1875,15,25-29,1890,10
SIM,1876,30,35-39,1906,16
SIM,1933,33,45-49,1966,6
SIM,1984,19,40-44,2003,5
SIM,1946,30,50-100,1976,2
SIM,1876,27,35-39,1903,30
STAT,1976,3,na,1979,6065.030723842029
SIM,1923,47,45-49,1970,1
STAT,1883,17,50-100,1900,0.05531635231214637
STAT,1958,24,50-100,1982,0.9999633471992004
STAT,1869,55,na,1924,2310.893865319249
SIM,1887,18,20-24,1905,33
STAT,1925,18,50-100,1943,0.5207655482344132
STAT,1917,66,na,1983,3793.504108094191
STAT,1965,48,40-44,2013,0.23561780794546042
STAT,1901,37,15-19,1938,0.01959252862980061
STAT,1858,44,35-39,1902,1.608244973930901
STAT,1827,90,na,1917,64.02803213599775
SIM,1960,28,na,1988,5822
STAT,1866,30,25-29,1896,11.044190165273985
STAT,1881,45,30-34,1926,0.10882512737343077
STAT,1925,33,45-49,1958,2.1544368276676384
STAT,1863,46,25-29,1909,0.058289771743552966
STAT,1807,50,15-19,1857,1.0060945188600008E-4
STAT,1867,15,25-29,1882,6.316179945431752
STAT,1942,32,50-100,1974,1.0165731883324631
SIM,1891,16,20-24,1907,44
SIM,1863,27,na,1890,2467
SIM,1826,80,na,1906,98
STAT,1940,22,30-34,1962,33.79964344470304
STAT,1872,45,20-24,1917,0.014044260140949916
STAT,1843,83,na,1926,398.32919447689983
SIM,1857,41,na,1898,2490
STAT,1952,8,na,1960,5435.227692191569
STAT,1975,40,50-100,2015,0.18639289901138933
STAT,1915,47,45-49,1962,0.2527860056327938
STAT,1941,36,40-44,1977,1.8354013106625682
SIM,1862,42,na,1904,2845
STAT,1894,37,20-24,1931,1.1435845443986512
STAT,1829,30,50-100,1859,1.2855177701339346
STAT,1841,42,30-34,1883,1.0621508181132715
STAT,1951,22,40-44,1973,4.635948336295636
SIM,1841,72,na,1913,897
STAT,1836,47,50-100,1883,0.23399550535420438
SIM,1844,47,50-100,1891,1
STAT,1860,33,35-39,1893,9.37952239598741
STAT,1970,33,45-49,2003,2.3157258183691614
STAT,1947,33,30-34,1980,20.86385312192543
STAT,1834,52,25-29,1886,0.003314347131907224
STAT,1930,36,30-34,1966,2.7463744716663103
SIM,1803,55,na,1858,1465
SIM,1904,82,na,1986,2112
SIM,1933,32,40-44,1965,14
STAT,1904,48,na,1952,3682.315358834543
STAT,1814,72,na,1886,863.0578061094485
STAT,1816,53,50-100,1869,0.028985788994516714
STAT,1910,40,40-44,1950,0.27618077361606275
STAT,1867,45,na,1912,2448.3454083506977
STAT,2007,0,na,2007,7115.029957184856
SIM,1908,36,50-100,1944,1
STAT,1932,58,na,1990,5457.140436058176
SIM,1866,29,40-44,1895,3
SIM,1813,62,na,1875,1157
STAT,1858,29,40-44,1887,2.7212655093555993
STAT,1894,35,50-100,1929,1.8387026211010318
STAT,1925,32,40-44,1957,5.361199177903028
STAT,1903,40,40-44,1943,0.25933936385310863
SIM,1907,23,na,1930,4150
SIM,1849,25,25-29,1874,77
STAT,1940,19,30-34,1959,14.277225100961653
STAT,1915,46,40-44,1961,0.18383287215372385
SIM,1861,46,na,1907,1730
STAT,1925,41,30-34,1966,0.17882539052219443
STAT,1951,23,45-49,1974,1.5508524195739688
STAT,1918,34,15-19,1952,0.15620701043418714
SIM,1838,38,na,1876,1732
SIM,1955,33,30-34,1988,30
STAT,1818,94,na,1912,8.843063561908647
STAT,1850,47,35-39,1897,0.14345053954972076
SIM,1970,39,25-29,2009,1
STAT,1931,48,40-44,1979,0.24266273772547112
SIM,1894,33,na,1927,3892
STAT,1830,51,45-49,1881,0.012008485334213724
STAT,1819,79,na,1898,465.403047447555
SIM,1926,34,15-19,1960,1
STAT,1852,43,45-49,1895,1.4008593353150884
STAT,1868,24,30-34,1892,19.62604642003692
SIM,1970,23,20-24,1993,182
SIM,1901,71,na,1972,2659
STAT,1873,40,45-49,1913,1.7815723915898254
SIM,1978,33,20-24,2011,6
STAT,1909,15,na,1924,4396.245599457328
SIM,1992,20,25-29,2012,345
SIM,1908,96,na,2004,92
STAT,1805,76,na,1881,474.0869126235517
SIM,1939,36,na,1975,4943
STAT,1855,32,15-19,1887,0.12338018698112216
STAT,1816,39,na,1855,1554.464943539002
SIM,1938,17,25-29,1955,100
STAT,1859,53,40-44,1912,0.009522725228914324
STAT,1884,31,30-34,1915,19.989292612090185
SIM,1914,59,na,1973,3717
STAT,1922,46,40-44,1968,0.20945470697246915
STAT,1815,47,40-44,1862,0.34952244886034717
STAT,1806,50,50-100,1856,0.0553388502513309
STAT,1868,59,na,1927,2154.8501289995274
STAT,1856,82,na,1938,410.80216428191267
SIM,1957,47,45-49,2004,1
STAT,1833,40,15-19,1873,0.012168885237097643
STAT,1825,50,25-29,1875,0.004959641884602961
SIM,1884,41,40-44,1925,7
STAT,1829,39,15-19,1868,0.06179751619363225
SIM,1842,57,na,1899,1755
STAT,1858,35,50-100,1893,1.1158169741111956
SIM,1823,47,40-44,1870,1
SIM,1892,31,30-34,1923,35
STAT,1840,36,50-100,1876,1.1770512628571272
STAT,1858,111,na,1969,0.0010083548058908856
SIM,1881,15,na,1896,2077
SIM,1877,42,45-49,1919,5
SIM,1917,40,35-39,1957,1
STAT,1829,42,15-19,1871,0.014760394670156442
STAT,1871,36,15-19,1907,0.06478284268720323
STAT,1869,42,45-49,1911,1.6705981857712595
STAT,1876,70,na,1946,1673.8378569073154
SIM,1820,38,25-29,1858,7
STAT,1984,20,25-29,2004,152.00447806984903
SIM,1929,58,na,1987,4881
SIM,1944,33,20-24,1977,5
STAT,1955,9,na,1964,6020.259424361327
SIM,1939,32,35-39,1971,26
SIM,1927,9,na,1936,5276
SIM,1814,47,na,1861,1424
SIM,1882,41,50-100,1923,3
STAT,1859,4,na,1863,2844.3153627074626
SIM,1922,35,35-39,1957,9
STAT,1953,28,na,1981,5249.915762043172
SIM,1872,19,na,1891,3170
STAT,1842,68,na,1910,1175.9865767369154
SIM,1882,96,na,1978,223
STAT,1855,29,15-19,1884,0.3966386899462775
STAT,1872,16,45-49,1888,0.07639482038772397
SIM,1845,53,na,1898,1881
SIM,1885,37,na,1922,3147
SIM,1865,82,na,1947,379
STAT,1922,32,15-19,1954,0.1674882199313665
STAT,1876,41,40-44,1917,2.6954799847187787
STAT,1895,32,45-49,1927,2.619555702960763
STAT,1937,48,50-100,1985,0.26292900826140486
STAT,1846,49,35-39,1895,0.1417076525537283
SIM,1893,88,na,1981,370
SIM,1952,24,15-19,1976,14
SIM,1935,29,na,1964,5877
STAT,1936,33,20-24,1969,2.7340871082002356
SIM,1913,74,na,1987,3100
STAT,1774,98,na,1872,0.023775436565431386
STAT,1914,35,35-39,1949,2.814808305877535
STAT,1974,31,20-24,2005,3.74884249803808
SIM,1889,44,na,1933,3647
STAT,1930,22,50-100,1952,0.9729150225837483
STAT,1939,1,na,1940,4815.611776942024
STAT,1817,102,na,1919,0.20268949439625783
SIM,1881,40,45-49,1921,3
STAT,1867,74,na,1941,1195.7843460249483
STAT,1894,20,35-39,1914,8.708817021316966
SIM,1928,28,20-24,1956,29
STAT,1977,36,50-100,2013,0.6750940153171089
SIM,1982,25,35-39,2007,41
SIM,1982,31,20-24,2013,6
STAT,1996,3,na,1999,6597.549802199955
STAT,1944,24,15-19,1968,6.628658746346287
SIM,1928,31,20-24,1959,7
SIM,1874,45,na,1919,2520
STAT,1987,1,na,1988,6487.1050804527085
SIM,1844,101,na,1945,1
SIM,1851,3,na,1854,3531
STAT,1904,46,30-34,1950,0.09074648973351146
STAT,1900,16,na,1916,4054.3267804295797
STAT,1837,53,20-24,1890,5.257720485819548E-4
STAT,1964,36,30-34,2000,2.7317564898704263
STAT,1857,67,na,1924,1424.8107134970364
STAT,1874,41,50-100,1915,1.2537897111335128
STAT,1894,17,35-39,1911,0.814031525232208
STAT,1789,97,na,1886,0.8045067974507587
STAT,1885,43,40-44,1928,2.570458719240779
STAT,1918,11,na,1929,4983.42153899089
STAT,1919,39,na,1958,4653.3589946371
SIM,1922,44,25-29,1966,1
SIM,1859,27,40-44,1886,2
SIM,1963,17,25-29,1980,166
SIM,1854,22,na,1876,2630
SIM,1942,25,40-44,1967,13
STAT,1765,109,na,1874,2.675298875517006E-4
STAT,1968,31,45-49,1999,2.31334376087374
STAT,1916,88,na,2004,977.329682114907
STAT,1912,80,na,1992,2074.5401866909524
STAT,1889,43,na,1932,3264.1476120568473
STAT,1927,34,na,1961,5360.954982540741
SIM,1912,32,50-100,1944,2
SIM,1872,6,na,1878,3477
STAT,1882,42,50-100,1924,1.189382285423358
SIM,1869,75,na,1944,642
STAT,1912,34,20-24,1946,2.7487642614082524
STAT,1937,31,15-19,1968,0.1468859178003749
SIM,1869,30,25-29,1899,14
STAT,1853,20,na,1873,2551.731615320837
STAT,1971,16,na,1987,5381.54445539618
STAT,1893,15,30-34,1908,2.3358092286477445
STAT,1812,46,na,1858,1361.8358679975279
SIM,1918,30,45-49,1948,4
SIM,1846,27,na,1873,1761
STAT,1924,83,na,2007,2031.0827199532023
STAT,1955,17,25-29,1972,66.39006418934807
STAT,1950,26,35-39,1976,20.584474586364664
STAT,1902,27,15-19,1929,0.73982007111934
SIM,1963,49,30-34,2012,1
STAT,1899,73,na,1972,2399.412202201456
SIM,1920,44,na,1964,4114
STAT,1865,50,50-100,1915,0.015951816395174175
SIM,1880,30,na,1910,3429
SIM,1882,65,na,1947,2436
STAT,1927,28,30-34,1955,54.76717392395991
SIM,1900,25,35-39,1925,19
SIM,1909,89,na,1998,1048
STAT,1908,35,40-44,1943,1.634932478460198
SIM,1907,54,na,1961,4110
SIM,1929,30,20-24,1959,3
SIM,1938,27,50-100,1965,3
SIM,1912,42,45-49,1954,1
STAT,1955,49,30-34,2004,0.14122330985296333
STAT,1914,44,25-29,1958,0.08142574046283581
SIM,1883,36,50-100,1919,1
SIM,1890,60,na,1950,2727
SIM,1935,28,30-34,1963,73
STAT,1901,34,45-49,1935,2.794724531719115
SIM,1937,27,25-29,1964,90
STAT,1960,28,15-19,1988,1.0651770070917892
SIM,1871,14,na,1885,2359
STAT,1933,27,45-49,1960,2.648458704382597
SIM,1902,20,40-44,1922,9
STAT,1868,81,na,1949,599.5821762651226
STAT,1884,12,na,1896,2944.6311008672487
SIM,1859,45,na,1904,2186
STAT,1859,31,30-34,1890,16.116394200979027
STAT,1938,2,na,1940,4658.167165702897
STAT,1904,42,45-49,1946,0.1720223516844529
STAT,1842,76,na,1918,729.0510203477111
STAT,1869,23,40-44,1892,2.321685829522305
SIM,1979,26,na,2005,6179
STAT,1902,50,na,1952,3561.567929727928
STAT,1944,45,20-24,1989,0.01434362835839029
STAT,1930,30,20-24,1960,3.6373262931868857
SIM,1808,61,na,1869,1324
STAT,1850,50,25-29,1900,0.003698710164691318
STAT,1959,47,50-100,2006,0.35514460566371514
SIM,1941,27,45-49,1968,5
STAT,1937,33,50-100,1970,0.9439246737779661
STAT,1929,69,na,1998,4416.9915394613545
SIM,1844,91,na,1935,29
STAT,1827,99,na,1926,1.5380480299521722
STAT,1904,22,20-24,1926,114.20310766487594
STAT,1962,20,50-100,1982,0.976853022507126
STAT,1929,27,25-29,1956,95.07003653943508
STAT,1934,25,40-44,1959,7.246043626386864
STAT,1962,23,20-24,1985,164.91005202875277
SIM,1965,44,35-39,2009,1
STAT,1940,34,25-29,1974,11.028618531388164
STAT,1968,47,15-19,2015,5.522935759434244E-4
SIM,1893,9,na,1902,3820
STAT,1976,39,50-100,2015,0.6654927740807695
STAT,1865,30,45-49,1895,1.8303608256227406
SIM,1863,19,na,1882,2720
SIM,1838,83,na,1921,96
SIM,1985,21,30-34,2006,67
SIM,1945,31,15-19,1976,1
SIM,1867,31,30-34,1898,47
SIM,1905,16,25-29,1921,19
STAT,1784,97,na,1881,1.0145431832689182
SIM,1962,34,25-29,1996,27
STAT,1876,17,na,1893,3012.9947064299026
STAT,1957,44,35-39,2001,0.3173545351511599
STAT,1944,27,20-24,1971,22.76911306229886
STAT,1952,21,40-44,1973,4.666945854570562
SIM,1952,27,20-24,1979,23
SIM,1877,19,na,1896,3376
STAT,1859,54,50-100,1913,0.013502227148513606
STAT,1919,47,na,1966,4597.480806302985
STAT,1945,47,50-100,1992,0.2965839517378711
SIM,1825,65,na,1890,1080
SIM,1951,28,na,1979,5903
STAT,1867,20,na,1887,2595.954558698577
SIM,1849,35,30-34,1884,12
SIM,1835,20,30-34,1855,42
STAT,1896,25,na,1921,3662.4238542240023
STAT,1950,44,35-39,1994,0.2846041993908856
SIM,1932,36,35-39,1968,12
SIM,1925,77,na,2002,2749
SIM,1921,17,20-24,1938,325
STAT,1860,20,15-19,1880,3.526429614423352
STAT,1934,38,15-19,1972,0.030566526353399473
STAT,1810,109,na,1919,4.0509615494715745E-4
SIM,1952,45,20-24,1997,1
SIM,1928,16,na,1944,5592
SIM,1914,36,na,1950,3950
STAT,1910,21,35-39,1931,10.245985610891486
SIM,1852,22,25-29,1874,132
STAT,1845,33,na,1878,1718.5009595245144
SIM,1915,34,40-44,1949,1
STAT,1933,42,40-44,1975,0.39677478149868944
STAT,1907,34,40-44,1941,4.191999222491934
SIM,1955,20,20-24,1975,5
STAT,1902,8,na,1910,4238.892916065455
SIM,1912,22,20-24,1934,237
STAT,1877,17,40-44,1894,0.21956504784707417
SIM,1891,14,na,1905,3629
STAT,1870,114,na,1984,2.573856634160635E-4
SIM,1931,46,50-100,1977,1
SIM,1867,40,na,1907,2274
SIM,1892,95,na,1987,291
SIM,1875,83,na,1958,600
STAT,1913,17,20-24,1930,32.006512248012534
SIM,1909,39,15-19,1948,1
STAT,1853,26,50-100,1879,0.7431442713995594
SIM,1840,22,na,1862,2296
SIM,1941,42,40-44,1983,1
STAT,1928,26,25-29,1954,93.9008781654286
STAT,1844,22,25-29,1866,59.78320390506143
SIM,1962,19,30-34,1981,2
SIM,1886,75,na,1961,775
STAT,1912,16,20-24,1928,31.74615632289324
STAT,1947,20,20-24,1967,145.12616670785937
STAT,1915,45,25-29,1960,0.061987303585911875
STAT,1843,104,na,1947,0.06692555155089903
SIM,1955,39,40-44,1994,2
STAT,1961,44,50-100,2005,0.18142927538708525
SIM,1903,44,na,1947,3657
SIM,1987,21,na,2008,6115
STAT,1954,19,30-34,1973,17.377706167701874
STAT,1967,6,na,1973,5667.052248004699
SIM,1936,26,25-29,1962,6
STAT,1904,40,20-24,1944,0.018460729606958267
SIM,1926,24,45-49,1950,7
SIM,1858,49,50-100,1907,1
STAT,1861,51,50-100,1912,0.014559014611712313
SIM,1808,53,na,1861,1589
STAT,1928,44,25-29,1972,0.10470571787706605
STAT,1889,31,45-49,1920,2.490845603514913
SIM,1819,45,na,1864,1135
STAT,1839,16,50-100,1855,0.05112650116578223
STAT,1918,37,20-24,1955,0.32058397176894815
STAT,1963,21,15-19,1984,7.833022068036336
STAT,1812,109,na,1921,3.123545626378584E-4
STAT,1936,39,na,1975,4255.8517977822485
SIM,1945,28,na,1973,4759
STAT,1953,18,30-34,1971,17.010798002735108
SIM,1836,21,30-34,1857,1
SIM,1916,35,40-44,1951,5
STAT,1959,34,50-100,1993,1.2705856991389002
STAT,1940,24,na,1964,4291.586334091189
STAT,1928,29,30-34,1957,55.652579447507804
SIM,1897,31,45-49,1928,4
STAT,1958,26,na,1984,5705.285574996668
SIM,1973,4,na,1977,5502
STAT,1811,84,na,1895,171.2861409427734
SIM,1831,44,30-34,1875,3
STAT,1916,42,50-100,1958,0.13895039878098567
STAT,1946,3,na,1949,5124.890674422979
SIM,1880,7,na,1887,3754
STAT,1939,48,45-49,1987,0.2605257310431233
SIM,1900,22,30-34,1922,41
SIM,1839,45,na,1884,1971
SIM,1956,6,na,1962,5523
STAT,1960,18,45-49,1978,0.7506088113237535
STAT,1839,40,45-49,1879,1.4103505673152292
STAT,1866,100,na,1966,5.503778244360733
STAT,1858,51,na,1909,1947.7415519735082
SIM,1934,36,na,1970,5817
STAT,1860,10,na,1870,2592.906837296498
STAT,1876,30,20-24,1906,3.2506124540124772
STAT,1868,100,na,1968,7.160140779994332
SIM,1863,9,na,1872,3007
STAT,1970,44,na,2014,5557.206199812332
STAT,1924,36,35-39,1960,3.2935937094601306
STAT,1938,18,35-39,1956,4.77770574887418
STAT,1868,32,50-100,1900,1.0159034059723318
SIM,1859,40,50-100,1899,1
SIM,1946,18,35-39,1964,7
STAT,1865,33,na,1898,2474.2751793179214
STAT,1834,30,15-19,1864,0.16996164529996
SIM,1847,40,45-49,1887,2
SIM,1986,10,na,1996,6750
STAT,1880,45,15-19,1925,4.9417415508399E-4
SIM,1935,29,15-19,1964,2
STAT,1823,44,30-34,1867,1.1590680415210488
STAT,1867,25,30-34,1892,27.31728614842229
SIM,1918,95,na,2013,301
STAT,1923,72,na,1995,3671.5649847403406
STAT,1906,37,30-34,1943,1.935878102501461
STAT,1915,32,50-100,1947,0.9719473246948912
SIM,1947,48,45-49,1995,1
STAT,1905,23,20-24,1928,114.75039907490212
STAT,1852,15,na,1867,2648.594793130154
STAT,1920,40,35-39,1960,0.2572582855517818
STAT,1938,75,na,2013,2885.866403284732
STAT,1840,47,40-44,1887,0.13849330385507966
SIM,1923,32,50-100,1955,2
SIM,1858,83,na,1941,435
STAT,1885,93,na,1978,183.27068429073748
STAT,1927,29,15-19,1956,0.9862374832911881
STAT,1916,42,35-39,1958,0.2381682496541166
SIM,1936,29,30-34,1965,52
SIM,1839,16,30-34,1855,4
SIM,1950,32,35-39,1982,25
STAT,1961,29,15-19,1990,1.0560792412476774
STAT,1844,71,na,1915,1116.4574284498804
STAT,1930,15,25-29,1945,64.96506697081497
SIM,1822,39,40-44,1861,11
SIM,1909,22,50-100,1931,1
STAT,1872,114,na,1986,3.104377960674831E-4
SIM,1931,36,na,1967,6108
SIM,1914,37,30-34,1951,3
SIM,1987,13,na,2000,6556
STAT,1905,47,na,1952,3741.1349160239065
STAT,1972,15,30-34,1987,18.019807852528547
SIM,1895,20,25-29,1915,175
STAT,1950,23,30-34,1973,39.335316990690124
STAT,1826,38,na,1864,1553.313593961558
STAT,1860,41,na,1901,2159.431002078324
STAT,1878,51,na,1929,2606.8849404467564
STAT,1877,98,na,1975,33.791836731211035
SIM,1851,24,30-34,1875,55
STAT,1900,55,na,1955,3311.144828921301
STAT,1977,24,35-39,2001,14.720698628135715
STAT,1801,54,na,1855,1248.7908344940408
STAT,1893,18,35-39,1911,0.7983151196515136
STAT,1922,23,25-29,1945,121.81344403525915
SIM,1930,23,25-29,1953,152
STAT,1972,21,na,1993,5415.538916665654
STAT,1998,16,50-100,2014,0.6350186594305836
STAT,1903,28,15-19,1931,0.7431607259093337
STAT,1907,34,na,1941,4051.376439975957
STAT,1843,24,30-34,1867,22.112661880752327
STAT,1919,38,20-24,1957,0.326416675072659
STAT,1873,20,na,1893,2803.8157201333283
STAT,1887,20,25-29,1907,74.47881424271738
STAT,1945,28,20-24,1973,23.100339748752507
STAT,1889,23,50-100,1912,0.5783175638523128
STAT,1908,32,35-39,1940,9.967374611176442
STAT,1885,21,30-34,1906,20.565787085349914
STAT,1953,19,15-19,1972,63.315167878056286
SIM,1961,19,15-19,1980,117
SIM,1893,49,na,1942,3170
SIM,1962,16,25-29,1978,168
STAT,1922,38,25-29,1960,1.291076103379412
STAT,1822,49,40-44,1871,0.3144764574663307
SIM,1869,7,na,1876,2436
SIM,1930,38,25-29,1968,2
STAT,1954,16,25-29,1970,61.84217448297917
SIM,1893,21,30-34,1914,2
STAT,1975,24,45-49,1999,1.7175327327289247
SIM,1830,49,40-44,1879,1
SIM,1902,70,na,1972,2823
STAT,1888,81,na,1969,1213.6770563611103
SIM,1891,22,na,1913,3348
SIM,1953,28,20-24,1981,30
STAT,1901,30,25-29,1931,16.69008055542355
STAT,1944,48,25-29,1992,0.068336381767457
SIM,1913,23,20-24,1936,230
SIM,1906,46,35-39,1952,1
STAT,1959,5,na,1964,5935.357052593074
SIM,1879,45,na,1924,2641
STAT,1937,47,30-34,1984,0.10391889479402436
SIM,1916,32,35-39,1948,3
SIM,1899,26,30-34,1925,63
SIM,1947,31,na,1978,6022
STAT,1974,29,45-49,2003,2.612049828908605
STAT,1904,25,25-29,1929,70.57832654826228
SIM,1982,29,45-49,2011,2
STAT,1960,47,45-49,2007,0.33979363227574105
STAT,1831,84,na,1915,260.9965883905846
STAT,1869,26,45-49,1895,1.2451423835724473
STAT,1913,42,na,1955,4181.892334198079
SIM,1912,25,25-29,1937,4
STAT,1954,34,25-29,1988,13.423623352497707
STAT,1883,6,na,1889,2965.0222917014253
SIM,1855,83,na,1938,16
STAT,1899,36,30-34,1935,8.466994763452284
STAT,1930,45,20-24,1975,0.016876436384916548
STAT,1798,104,na,1902,0.01696580967276179
STAT,1948,37,35-39,1985,3.2909912281609492
STAT,1995,8,na,2003,6565.392460598532
STAT,1946,43,30-34,1989,0.1697923915461795
STAT,1934,22,35-39,1956,14.61040346652741
STAT,1953,42,na,1995,5388.273454243199
SIM,1909,38,30-34,1947,3
STAT,1926,31,40-44,1957,5.462874322925989
STAT,1985,29,20-24,2014,30.06151286121775
SIM,1932,33,30-34,1965,5
SIM,1970,26,25-29,1996,197
STAT,1959,39,30-34,1998,2.8284951717559808
SIM,1835,23,35-39,1858,12
STAT,1960,30,35-39,1990,14.016946269249333
STAT,1964,34,na,1998,5596.288981641781
SIM,1900,28,40-44,1928,3
SIM,1814,61,na,1875,939
SIM,1896,17,15-19,1913,6
STAT,1855,94,na,1949,17.006064448469303
STAT,1862,3,na,1865,3151.4969229330964
STAT,1956,49,na,2005,5801.20687546727
STAT,1930,54,na,1984,5438.334154647649
STAT,1790,97,na,1887,1.0241888714489384
STAT,1962,26,25-29,1988,97.79164524841288
STAT,1863,49,30-34,1912,0.09564234093320581
SIM,1904,33,25-29,1937,2
STAT,1931,39,na,1970,5739.106489668819
SIM,1902,79,na,1981,1966
STAT,1900,19,35-39,1919,0.8739663212416602
STAT,1859,25,na,1884,2264.208982241582
SIM,1956,37,35-39,1993,9
STAT,1938,48,30-34,1986,0.10531638529449582
STAT,1924,33,30-34,1957,21.193758928877145
STAT,1955,46,25-29,2001,0.08473931780673553
STAT,1936,20,45-49,1956,1.2430265772005558
SIM,1825,34,30-34,1859,42
STAT,1941,35,25-29,1976,1.2081817720152819
SIM,1954,43,30-34,1997,1
STAT,1815,43,50-100,1858,2.288991643383764
STAT,1932,43,30-34,1975,0.19969714466192048
SIM,1862,65,na,1927,1986
STAT,1862,68,na,1930,1488.361121005221
STAT,1810,46,45-49,1856,0.9386264438423132
STAT,1844,48,50-100,1892,0.2028442182045176
STAT,1835,22,50-100,1857,0.3510862985105214
STAT,1895,63,na,1958,2764.0477913476916
STAT,1861,101,na,1962,1.6682823985431185
STAT,1888,106,na,1994,0.9198018914196153
SIM,1849,38,35-39,1887,1
SIM,1903,18,15-19,1921,19
SIM,1910,27,15-19,1937,1
SIM,1881,38,35-39,1919,3
STAT,1962,49,na,2011,5617.352774793875
STAT,1918,21,40-44,1939,4.19676509981496
SIM,1860,30,na,1890,2460
SIM,1938,72,na,2010,2981
SIM,1954,25,30-34,1979,6
STAT,1835,63,na,1898,1112.0746166278823
SIM,1927,80,na,2007,1495
STAT,1934,40,35-39,1974,0.3245426346590441
STAT,1946,25,30-34,1971,50.41376504107346
STAT,1901,16,45-49,1917,0.10585203915927408
STAT,1942,32,35-39,1974,11.235965892076855
SIM,1926,21,40-44,1947,13
STAT,1817,38,na,1855,2158.443181843403
STAT,1867,28,35-39,1895,10.360012679023837
STAT,1948,19,35-39,1967,5.538017620144315
STAT,1888,17,15-19,1905,8.050660831522617
STAT,1970,17,20-24,1987,195.85650149881047
SIM,1956,19,35-39,1975,8
SIM,1978,15,na,1993,6033
STAT,1939,45,40-44,1984,0.19041038939279092
SIM,1927,54,na,1981,4752
SIM,1863,39,30-34,1902,11
SIM,1934,31,40-44,1965,12
STAT,1938,15,30-34,1953,13.947040621604817
STAT,1914,16,na,1930,4624.251825674497
SIM,1942,22,35-39,1964,18
STAT,1985,17,50-100,2002,0.6149559149627638
SIM,1957,34,45-49,1991,3
STAT,1832,40,50-100,1872,0.9213974831577181
STAT,1840,29,40-44,1869,2.9533758158179797
STAT,1950,41,30-34,1991,0.1815571213633312
STAT,1971,18,20-24,1989,198.10252922969963
STAT,1891,25,na,1916,3427.0349390172023
STAT,1881,48,35-39,1929,0.15387996367006626
SIM,1958,35,45-49,1993,4
STAT,1902,17,45-49,1919,0.10651670644889526
STAT,1962,44,15-19,2006,0.0023520249807629577
STAT,1914,47,na,1961,4206.797711940949
STAT,1949,34,45-49,1983,2.1500416270181706
STAT,1824,71,na,1895,825.9094814091578
STAT,1873,38,35-39,1911,8.29402276100014
SIM,1836,24,35-39,1860,10
STAT,1938,45,25-29,1983,0.06313807368141618
STAT,1868,109,na,1977,0.02793607368193644
STAT,1925,0,na,1925,6278.522373247565
STAT,1766,92,na,1858,26.018557801666415
SIM,1936,43,45-49,1979,1
STAT,1866,25,50-100,1891,0.6888967636066552
STAT,1952,18,15-19,1970,62.74367580556563
STAT,1929,40,20-24,1969,0.026468441578791555
SIM,1988,20,40-44,2008,10
STAT,1953,15,50-100,1968,0.5233174776037356
SIM,1960,18,15-19,1978,134
STAT,1931,26,30-34,1957,58.418199998426196
STAT,1886,78,na,1964,1277.2082516031342
STAT,1904,17,na,1921,4185.48295781709
STAT,1905,26,25-29,1931,70.89948377398649
SIM,1846,58,na,1904,1219
STAT,1927,45,15-19,1972,5.36022929230217E-4
SIM,1928,41,50-100,1969,1
STAT,1804,71,na,1875,805.7806301222803
STAT,1970,36,15-19,2006,0.028606873007430225
STAT,1927,83,na,2010,2141.645718194164
STAT,1892,48,45-49,1940,0.19013516866512695
STAT,1922,20,20-24,1942,147.97167344607738
SIM,1927,23,na,1950,4717
STAT,1797,84,na,1881,134.9956539002132
STAT,1858,31,15-19,1889,0.12954584341776046
SIM,1868,32,30-34,1900,4
SIM,1970,33,na,2003,5981
STAT,1913,25,50-100,1938,1.1529282847585671
SIM,1893,24,35-39,1917,11
SIM,1938,27,40-44,1965,12
SIM,1952,30,45-49,1982,7
STAT,1858,20,na,1878,2240.6417911749686
SIM,1941,25,25-29,1966,91
STAT,1969,36,na,2005,5592.833146028294
STAT,1911,20,45-49,1931,1.2398987294179433
SIM,1782,74,na,1856,264
STAT,1840,30,50-100,1870,0.9140277112439327
STAT,1933,25,25-29,1958,100.99142921190843
STAT,1848,18,25-29,1866,7.420027632631158
STAT,1944,30,45-49,1974,1.9943769939834732
STAT,1863,101,na,1964,2.29965053008282
STAT,1920,26,20-24,1946,23.17812815995782
STAT,1881,29,30-34,1910,27.83036474337683
STAT,1841,104,na,1945,0.05930234965485957
STAT,1875,36,50-100,1911,1.4712476702919246
STAT,1920,44,20-24,1964,0.02242489804150051
STAT,1840,33,na,1873,2095.6957334927915
STAT,1831,53,25-29,1884,0.002830663329772593
STAT,1956,17,40-44,1973,2.1359431177726114
SIM,1959,29,30-34,1988,17
STAT,1964,35,25-29,1999,1.476987616271973
STAT,1787,77,na,1864,267.1165603730984
STAT,1966,30,30-34,1996,23.17488795760563
SIM,1962,33,45-49,1995,4
SIM,1995,16,45-49,2011,2
SIM,1949,56,na,2005,5544
STAT,1942,16,35-39,1958,5.062925488598595
STAT,1970,20,45-49,1990,1.6319561631180766
SIM,1906,16,40-44,1922,1
STAT,1921,39,50-100,1960,0.5396681050230072
STAT,1961,49,25-29,2010,0.08178410673709981
SIM,1903,27,50-100,1930,3
STAT,1859,37,40-44,1896,4.024258962595402
SIM,1867,34,35-39,1901,4
STAT,1907,35,25-29,1942,1.0652267917304838
STAT,1849,45,30-34,1894,0.07577458679776962
SIM,1857,10,na,1867,2913
STAT,1904,43,25-29,1947,0.07336604516172354
SIM,1982,26,40-44,2008,1
STAT,1954,31,20-24,1985,3.5491735032813385
STAT,1974,26,40-44,2000,7.057388400882227
STAT,1932,42,25-29,1974,0.1117190658510427
STAT,1990,21,na,2011,6057.302217779976
SIM,1970,41,na,2011,5946
STAT,1924,39,40-44,1963,2.0322479434974112
SIM,1928,35,30-34,1963,7
SIM,1930,20,20-24,1950,156
STAT,1876,25,na,1901,2866.3872286615065
STAT,1954,33,45-49,1987,2.2869287639046
SIM,1933,31,na,1964,6353
STAT,1987,16,45-49,2003,0.8232235416565047
SIM,1913,26,25-29,1939,134
SIM,1974,34,na,2008,6247
STAT,1871,25,na,1896,2758.619516402406
STAT,1922,35,20-24,1957,0.34660929050895467
SIM,1930,35,20-24,1965,1
SIM,1838,32,15-19,1870,1
STAT,1900,16,30-34,1916,2.558620481751857
STAT,1923,22,25-29,1945,123.98631613045403
STAT,1868,23,25-29,1891,63.27595213054338
SIM,1835,26,40-44,1861,9
SIM,1890,42,50-100,1932,7
STAT,1888,50,na,1938,2962.98882600469
SIM,1932,39,40-44,1971,5
SIM,1889,24,15-19,1913,6
STAT,1909,60,na,1969,3631.937103765151
STAT,1853,51,na,1904,2153.9915984210274
STAT,1859,19,40-44,1878,0.19288709517702093
STAT,1841,16,50-100,1857,0.05651148762204801
SIM,1895,83,na,1978,713
STAT,1811,53,na,1864,1408.7155021542942
SIM,1923,25,35-39,1948,3
STAT,1856,25,na,1881,2208.9439589425688
SIM,1876,23,25-29,1899,156
STAT,1810,100,na,1910,0.604487203688674
STAT,1831,35,25-29,1866,2.9069020697103447
SIM,1922,80,na,2002,2375
STAT,1930,48,25-29,1978,0.08040326832640309
SIM,1887,49,na,1936,3549
SIM,1838,38,50-100,1876,3
STAT,1897,41,45-49,1938,0.161103204639059
STAT,1921,42,15-19,1963,0.001995388485058816
STAT,1961,42,35-39,2003,0.3120174207910815
STAT,1911,35,45-49,1946,0.7677544997344566
STAT,1902,30,40-44,1932,7.128413705205816
SIM,1828,30,na,1858,2486
STAT,1873,35,30-34,1908,6.340503359515272
STAT,1930,33,25-29,1963,13.758685278350335
STAT,1906,34,25-29,1940,9.81273728098337
STAT,1923,46,50-100,1969,0.3059965060401633
STAT,1965,33,20-24,1998,3.5799350919559467
SIM,1861,26,50-100,1887,1
STAT,1825,33,na,1858,2053.2751133532174
SIM,1904,30,20-24,1934,9
SIM,1913,36,30-34,1949,3
STAT,1921,27,20-24,1948,23.46932941424634
STAT,1969,26,15-19,1995,1.02258058194581
SIM,1948,16,na,1964,3844
SIM,1925,23,45-49,1948,5
SIM,1964,23,na,1987,5948
SIM,1903,34,15-19,1937,1
STAT,1969,35,50-100,2004,0.6246623913779017
STAT,1821,46,20-24,1867,0.022019684604955646
STAT,1880,49,35-39,1929,0.16767812532216833
SIM,1818,44,50-100,1862,1
STAT,1982,26,na,2008,6112.5046546142885
SIM,1894,22,30-34,1916,56
STAT,1917,23,45-49,1940,1.3758373152164458
SIM,1839,15,15-19,1854,12
STAT,1932,27,30-34,1959,59.24133601998781
STAT,1776,93,na,1869,9.677104656372054
STAT,1920,24,na,1944,4653.851398592217
STAT,1886,22,30-34,1908,21.683090825732723
SIM,1999,6,na,2005,6974
STAT,1884,43,na,1927,2616.2870868031023
STAT,1847,99,na,1946,1.4572442252057438
SIM,1914,34,25-29,1948,12
SIM,1847,16,50-100,1863,3
SIM,1896,20,40-44,1916,5
STAT,1869,86,na,1955,247.970666916773
STAT,1921,24,15-19,1945,6.892669410063983
SIM,1924,26,35-39,1950,6
SIM,1839,35,50-100,1874,4
STAT,1955,30,20-24,1985,3.813345141362985
STAT,1926,28,15-19,1954,0.9730010065450553
STAT,1932,46,35-39,1978,0.20238901041781643
STAT,1931,16,25-29,1947,65.63439895175676
SIM,1861,19,45-49,1880,2
STAT,1829,49,30-34,1878,0.09618501714980669
STAT,1896,27,50-100,1923,0.9750742166606549
STAT,1905,36,30-34,1941,1.9306908357501789
STAT,1887,47,25-29,1934,0.07414810352457343
STAT,1768,116,na,1884,1.1302969487583247E-4
SIM,1948,49,45-49,1997,2
SIM,1859,14,na,1873,2571
SIM,1864,22,15-19,1886,7
STAT,1850,48,40-44,1898,0.17402668556929698
STAT,1840,19,50-100,1859,0.050286904603703296
STAT,1901,45,50-100,1946,0.22617830689309812
SIM,1881,35,30-34,1916,9
SIM,1905,32,25-29,1937,17
SIM,1948,40,30-34,1988,1
STAT,1822,44,15-19,1866,0.026753683970879637
SIM,1976,21,50-100,1997,1
STAT,1794,104,na,1898,0.016694042104589843
STAT,1931,16,na,1947,5574.78557975598
STAT,1917,41,45-49,1958,0.20073350261252895
STAT,1916,26,35-39,1942,17.9781517461935
STAT,1856,22,15-19,1878,3.3734483070375756
SIM,1963,30,20-24,1993,2
SIM,1842,88,na,1930,187
STAT,1857,23,15-19,1880,3.3985724098693524
SIM,1940,46,35-39,1986,1
STAT,1853,19,45-49,1872,0.07731557980349323
STAT,1888,20,40-44,1908,2.8437086869138497
STAT,1915,25,35-39,1940,17.795583832343183
STAT,1944,37,50-100,1981,0.5372262452557117
STAT,1913,91,na,2004,562.4289184045948
STAT,1952,18,50-100,1970,0.5179719023859253
SIM,1880,39,na,1919,3239
STAT,1787,85,na,1872,69.78416702461205
SIM,1866,1,na,1867,3547
STAT,1947,34,na,1981,5005.0528648331965
SIM,1884,30,20-24,1914,7
STAT,1900,32,30-34,1932,27.95921733493668
STAT,1783,92,na,1875,8.295758446043083
STAT,1939,43,20-24,1982,0.02117642275363691
STAT,1906,19,30-34,1925,2.667892163512047
SIM,1914,19,30-34,1933,5
STAT,1950,29,40-44,1979,6.38136747209523
STAT,1898,22,20-24,1920,107.48146099996995
STAT,1951,16,na,1967,5059.655491740887
SIM,1839,19,35-39,1858,1
STAT,1864,100,na,1964,4.157871204862923
SIM,1856,88,na,1944,153
STAT,1828,100,na,1928,0.7046131934906286
STAT,1922,36,50-100,1958,0.5515972152403433
SIM,1950,15,50-100,1965,1
STAT,1933,41,25-29,1974,0.113440575558584
STAT,1937,15,15-19,1952,51.21616707690664
STAT,1964,26,na,1990,5471.0974243093615
STAT,1933,22,20-24,1955,170.29064603140105
STAT,1942,15,50-100,1957,0.45215987484005216
STAT,1920,29,25-29,1949,82.6948780346347
SIM,1877,20,35-39,1897,9
SIM,1856,5,na,1861,2725
STAT,1934,28,45-49,1962,2.682115570375437
STAT,1855,39,30-34,1894,4.489272087045949
SIM,1835,29,45-49,1864,2
STAT,1826,42,25-29,1868,0.48148701470284866
STAT,1898,40,20-24,1938,0.017374187356650434
SIM,1967,44,na,2011,5623
STAT,1916,42,na,1958,4392.682413041706
SIM,1895,22,45-49,1917,1
STAT,1887,22,45-49,1909,0.901862037778531
STAT,1901,31,40-44,1932,7.0388755861170775
STAT,1860,41,50-100,1901,0.9870611419812749
SIM,1942,28,45-49,1970,8
SIM,1947,23,na,1970,6043
STAT,1893,68,na,1961,2409.3101752490675
STAT,1862,76,na,1938,922.7071255571564
SIM,1847,88,na,1935,322
SIM,1986,22,50-100,2008,5
STAT,1884,21,15-19,1905,3.772973080315194
STAT,1966,33,35-39,1999,13.418495854758334
STAT,1939,29,40-44,1968,5.404456449952557
STAT,1880,20,50-100,1900,0.5018023246429045
SIM,1840,30,na,1870,2080
SIM,1963,22,50-100,1985,3
STAT,1941,15,35-39,1956,4.991796741936899
SIM,1976,11,na,1987,6047
SIM,1903,31,45-49,1934,1
STAT,1829,28,50-100,1857,1.1220959326581201
STAT,1855,54,25-29,1909,0.0029310031833715755
STAT,1769,89,na,1858,51.477732362750416
SIM,1834,42,25-29,1876,1
SIM,1891,90,na,1981,334
STAT,1955,33,25-29,1988,14.424500698772995
STAT,1931,29,35-39,1960,22.351837517544688
STAT,1944,41,35-39,1985,0.2602817364701799
STAT,1929,24,20-24,1953,161.2676835922181
STAT,1859,34,35-39,1893,9.230152202450526
STAT,1936,47,15-19,1983,4.2160930927266226E-4
SIM,1940,27,30-34,1967,66
STAT,1880,35,50-100,1915,1.5160885966521793
STAT,1977,21,na,1998,5714.93424603454
STAT,1869,20,35-39,1889,6.588778276644303
STAT,1873,53,30-34,1926,0.006902385515992867
SIM,1963,33,25-29,1996,4
STAT,1827,29,45-49,1856,2.4511791526548996
SIM,1866,20,25-29,1886,147
STAT,1803,89,na,1892,36.615309933011154
SIM,1989,25,na,2014,6226
STAT,1929,60,na,1989,5117.664819942443
STAT,1908,38,45-49,1946,0.7338751565387995
SIM,1951,31,45-49,1982,1
SIM,1883,35,30-34,1918,3
SIM,1860,22,na,1882,2617
SIM,1941,24,40-44,1965,9
STAT,1918,24,45-49,1942,1.391404439437901
STAT,1858,20,25-29,1878,59.99029200460841
SIM,1938,64,na,2002,3673
STAT,1875,35,30-34,1910,6.416394030006637
STAT,1922,22,45-49,1944,1.488436018417268
STAT,1958,44,na,2002,5830.734732177617
SIM,1870,37,50-100,1907,1
SIM,1930,22,45-49,1952,3
SIM,1900,44,na,1944,3450
STAT,1852,32,25-29,1884,9.998530557751812
STAT,1978,22,50-100,2000,1.0397473417836431
STAT,1810,49,15-19,1859,0.0014908077263772626
STAT,1973,20,50-100,1993,0.9860135796018911
STAT,1943,46,45-49,1989,0.27736941603493764
SIM,1860,32,25-29,1892,2
STAT,1848,15,20-24,1863,23.628848331395428
STAT,1945,48,40-44,1993,0.20616456675426628
STAT,1872,26,15-19,1898,0.5275557449164191
SIM,1973,19,40-44,1992,2
STAT,1814,41,na,1855,2042.1798237770859
STAT,1923,38,40-44,1961,1.9989807410917912
SIM,1873,40,na,1913,3284
SIM,1888,23,15-19,1911,8
SIM,1831,28,30-34,1859,3
STAT,1911,32,40-44,1943,4.401430125160218
STAT,1975,16,50-100,1991,0.5705616326170382
STAT,1834,47,45-49,1881,0.22840576946695243
STAT,1881,44,25-29,1925,0.7051551744464329
SIM,1902,39,25-29,1941,2
STAT,1897,37,50-100,1934,1.894571380489268
SIM,1856,15,20-24,1871,32
SIM,1917,24,na,1941,5619
STAT,1871,37,20-24,1908,0.8850319307836094
SIM,1868,35,35-39,1903,4
STAT,1961,46,20-24,2007,0.01718142390852073
SIM,1931,38,40-44,1969,1
SIM,1918,24,15-19,1942,10
STAT,1874,21,20-24,1895,81.66227898051346
STAT,1770,97,na,1867,0.4345626923720953
SIM,1988,18,50-100,2006,1
STAT,1861,21,50-100,1882,0.4048398137979094
STAT,1943,31,45-49,1974,1.9642555483503616
STAT,1933,45,45-49,1978,0.34669456819123157
SIM,1984,2,na,1986,6316
STAT,1891,20,45-49,1911,1.0005368006297526
STAT,1866,8,na,1874,2962.755124656375
STAT,1933,24,40-44,1957,5.145828774996404
STAT,1798,69,na,1867,628.1101130042617
SIM,1962,31,20-24,1993,1
STAT,1907,37,45-49,1944,0.7305987621316478
STAT,1962,37,15-19,1999,0.029254442744672978
SIM,1905,48,40-44,1953,1
STAT,1906,31,20-24,1937,2.6226522500307548
STAT,1921,21,45-49,1942,1.4705221605706453
STAT,1842,99,na,1941,1.4573784691869924
STAT,1972,28,30-34,2000,58.118773805130026
SIM,1925,21,25-29,1946,135
SIM,1980,28,30-34,2008,127
SIM,1936,23,20-24,1959,120
SIM,1839,22,na,1861,2595
STAT,1886,25,35-39,1911,11.82543517142597
SIM,1927,31,na,1958,5000
SIM,1904,18,30-34,1922,3
STAT,1887,16,50-100,1903,0.06351794316272907
STAT,1905,20,15-19,1925,5.543311861009889
STAT,1822,47,50-100,1869,0.46420799341589786
STAT,1823,47,35-39,1870,0.13832792683227596
SIM,1913,39,35-39,1952,3
SIM,1974,26,na,2000,6352
SIM,1787,74,na,1861,736
STAT,1868,50,na,1918,2421.670033289
SIM,1919,25,15-19,1944,1
SIM,1899,29,35-39,1928,24
STAT,1870,40,na,1910,2656.0865221687677
STAT,1923,90,na,2013,809.7823633041206
STAT,1944,34,na,1978,4781.852546629676
STAT,1958,39,15-19,1997,0.029923764682250102
SIM,1991,18,35-39,2009,9
SIM,1915,37,45-49,1952,1
STAT,1917,21,25-29,1938,113.63952985126541
SIM,1869,32,45-49,1901,2
STAT,1998,16,20-24,2014,229.79213176195213
STAT,1933,42,na,1975,5891.434774432856
SIM,1916,38,45-49,1954,1
STAT,1900,35,35-39,1935,11.433829741075842
STAT,1965,19,40-44,1984,2.0138629118516045
SIM,1915,32,20-24,1947,5
STAT,1955,0,na,1955,6068.237686207987
SIM,1878,21,35-39,1899,14
STAT,1821,49,25-29,1870,0.10137922265331543
STAT,1920,47,25-29,1967,0.06764079132715319
SIM,1948,43,35-39,1991,1
STAT,1983,18,35-39,2001,6.848212518508013
STAT,1893,43,35-39,1936,0.18210388173715103
STAT,1875,94,na,1969,101.23255168039307
SIM,1845,22,na,1867,2245
SIM,1847,49,50-100,1896,1
SIM,1771,90,na,1861,2
SIM,1988,17,15-19,2005,137
STAT,1857,98,na,1955,2.9198235045594743
STAT,1907,32,20-24,1939,2.6354204385848488
STAT,1839,25,na,1864,2192.620013972124
STAT,1790,74,na,1864,465.70824081543765
SIM,1890,83,na,1973,839
STAT,1950,23,na,1973,4997.856238508835
SIM,1916,79,na,1995,2356
STAT,1888,23,45-49,1911,0.9430456888063031
STAT,1796,104,na,1900,0.016988832537146642
STAT,1874,13,na,1887,3074.624819327595
STAT,1945,44,20-24,1989,0.0230602261868842
STAT,1973,29,30-34,2002,58.6763952135754
STAT,1990,25,50-100,2015,1.6535720658887758
SIM,1981,29,30-34,2010,4
SIM,1937,24,20-24,1961,249
STAT,1917,90,na,2007,723.3186694822432
SIM,1831,47,35-39,1878,1
SIM,1942,31,na,1973,4935
STAT,1885,24,35-39,1909,6.675223838166944
STAT,1939,46,25-29,1985,0.06392172817116328
STAT,1786,92,na,1878,19.092645372504048
STAT,1828,33,na,1861,1894.325089558758
STAT,1982,31,15-19,2013,0.21283753835633565
STAT,1928,23,20-24,1951,159.72066929404872
SIM,1962,25,50-100,1987,2
SIM,1894,25,35-39,1919,1
STAT,1850,88,na,1938,141.32604838156604
SIM,1885,43,50-100,1928,2
SIM,1943,16,na,1959,5453
STAT,1953,35,15-19,1988,0.027667655723146483
SIM,1906,6,na,1912,4010
SIM,1914,31,20-24,1945,3
STAT,1929,43,25-29,1972,0.10655968294343661
STAT,1928,41,20-24,1969,0.026018876251990355
STAT,1931,43,15-19,1974,0.0023643702944132153
STAT,1954,25,50-100,1979,1.427411174650426
STAT,1905,39,35-39,1944,2.5242965402581556
STAT,1991,8,na,1999,6499.944629589788
SIM,1982,11,na,1993,6825
SIM,1901,18,na,1919,4334
STAT,1900,47,na,1947,3586.6655822904454
STAT,1960,15,40-44,1975,2.103492647589377
SIM,1830,47,50-100,1877,1
SIM,1985,18,na,2003,6021
SIM,1893,57,na,1950,2813
SIM,1889,75,na,1964,2120
SIM,1958,15,na,1973,5500
STAT,1842,26,50-100,1868,0.6131548519868325
STAT,1853,16,40-44,1869,0.220354450585589
SIM,1798,66,na,1864,1076
SIM,1885,33,40-44,1918,8
STAT,1846,36,15-19,1882,0.06125492061214476
STAT,1887,40,45-49,1927,1.9551704834527166
STAT,1910,54,na,1964,3856.4337439992687
STAT,1877,33,40-44,1910,5.184020031614588
SIM,1903,17,30-34,1920,5
SIM,1886,44,na,1930,1959
STAT,1870,41,45-49,1911,1.7104683332178254
SIM,1922,25,20-24,1947,4
STAT,1847,19,15-19,1866,5.632334692268155
SIM,1913,89,na,2002,1505
SIM,1862,30,35-39,1892,30
STAT,1949,18,45-49,1967,0.67025470458476
STAT,1858,48,45-49,1906,0.2097978341884432
STAT,1972,26,20-24,1998,27.100898031796625
SIM,1983,21,30-34,2004,125
SIM,1873,19,35-39,1892,1
SIM,1878,49,na,1927,2631
STAT,1929,46,na,1975,5509.352229266115
SIM,1874,25,50-100,1899,1
SIM,1863,42,50-100,1905,1
SIM,1975,33,na,2008,6086
SIM,1844,15,na,1859,2933
STAT,1868,42,30-34,1910,1.2731455336841024
SIM,1914,26,40-44,1940,16
STAT,1828,40,35-39,1868,1.7988407864235063
SIM,1941,6,na,1947,4064
STAT,1865,19,35-39,1884,0.5818471943350327
STAT,1976,19,15-19,1995,69.92518117963968
STAT,1856,28,25-29,1884,38.31647400127784
STAT,1930,26,15-19,1956,1.0365321599434016
SIM,1883,38,35-39,1921,17
SIM,1855,19,15-19,1874,12
STAT,1860,19,na,1879,2433.430628450512
STAT,1922,27,35-39,1949,19.597280983244616
STAT,1891,70,na,1961,2194.4993345676326
STAT,1966,49,40-44,2015,0.2349982297790689
STAT,1898,25,25-29,1923,66.42430146997904
STAT,1903,25,45-49,1928,1.8374729778058119
SIM,1830,27,30-34,1857,51
SIM,1901,40,na,1941,4047
SIM,1903,75,na,1978,2017
STAT,1865,28,35-39,1893,10.011639863292778
SIM,1880,53,na,1933,2966
STAT,1956,45,35-39,2001,0.20575452799751764
STAT,1875,47,35-39,1922,0.16618496695943866
SIM,1883,47,35-39,1930,1
STAT,1941,64,na,2005,4023.6384687850114
STAT,1829,46,25-29,1875,0.059552127109169545
STAT,1961,26,45-49,1987,2.5881675703129496
SIM,1905,26,30-34,1931,54
STAT,1894,32,30-34,1926,25.902175243962827
SIM,1911,70,na,1981,3753
SIM,1909,66,na,1975,4009
STAT,1965,30,15-19,1995,0.18893538314660832
STAT,1818,103,na,1921,0.06349982558915024
STAT,1891,15,30-34,1906,2.2839273496102983
STAT,1798,60,na,1858,878.5692686991274
STAT,1923,2,na,1925,5540.218491501306
SIM,1799,62,na,1861,796
SIM,1914,13,na,1927,4330
SIM,1857,18,40-44,1875,1
STAT,1927,11,na,1938,5692.769856903205
STAT,1981,17,30-34,1998,19.66925388769304
SIM,1818,60,na,1878,1789
SIM,1864,28,25-29,1892,89
SIM,1843,36,40-44,1879,8
STAT,1884,38,45-49,1922,2.2617412214575148
SIM,1836,40,35-39,1876,1
STAT,1946,36,20-24,1982,0.3479387734129325
SIM,1985,19,20-24,2004,216
SIM,1885,90,na,1975,719
SIM,1876,42,30-34,1918,2
STAT,1840,64,na,1904,1394.5137679784195
STAT,1929,37,30-34,1966,2.700455200964517
STAT,1931,32,50-100,1963,1.2505350714678973
STAT,1881,41,20-24,1922,0.17757929245914827
SIM,1892,38,45-49,1930,2
STAT,1939,40,15-19,1979,0.0018494616925066013
SIM,1911,25,45-49,1936,8
SIM,1919,8,na,1927,5676
STAT,1875,22,20-24,1897,82.18472445124814
SIM,1869,52,na,1921,1698
SIM,1859,76,na,1935,285
STAT,1812,69,na,1881,760.0424509311063
SIM,1940,21,20-24,1961,141
SIM,1855,52,na,1907,1682
SIM,1863,36,25-29,1899,7
STAT,1849,18,40-44,1867,0.17347039178289284
SIM,1818,44,35-39,1862,3
STAT,1914,25,20-24,1939,21.390837495901437
SIM,1910,33,45-49,1943,1
SIM,1921,25,50-100,1946,2
SIM,1981,26,25-29,2007,193
STAT,1906,26,40-44,1932,5.058447502296828
STAT,1835,36,40-44,1871,3.4137377789087724
SIM,1886,39,30-34,1925,5
SIM,1921,84,na,2005,2070
STAT,1875,32,na,1907,2845.9036251266075
STAT,1913,36,25-29,1949,1.1273444823622885
SIM,1966,20,30-34,1986,55
STAT,1913,11,na,1924,4669.335034416421
STAT,1981,15,na,1996,5942.8450211695235
STAT,1845,47,20-24,1892,0.00804856064097678
STAT,1868,47,50-100,1915,0.2710437895972614
STAT,1932,49,40-44,1981,0.24543200482897265
STAT,1889,34,15-19,1923,0.20085033053721627
SIM,1932,43,50-100,1975,1
STAT,1887,107,na,1994,0.4265635268985803
STAT,1919,16,na,1935,4952.775455361965
STAT,1964,27,40-44,1991,6.804197523589721
SIM,1873,26,na,1899,3461
STAT,1902,33,45-49,1935,2.8315256400176305
SIM,1921,36,25-29,1957,1
SIM,1889,37,50-100,1926,4
SIM,1972,27,40-44,1999,8
STAT,1932,21,20-24,1953,168.9216856864394
SIM,1838,38,25-29,1876,4
STAT,1891,48,30-34,1939,0.0769030391909284
STAT,1895,38,20-24,1933,1.1522195158935686
STAT,1935,36,45-49,1971,1.1017039052015145
STAT,1808,95,na,1903,6.779250507370184
STAT,1975,22,25-29,1997,141.09430737743043
SIM,1857,32,20-24,1889,7
SIM,1899,18,45-49,1917,1
STAT,1873,37,na,1910,2776.4951857565743
STAT,1954,30,40-44,1984,5.697334344543493
SIM,1961,35,na,1996,5584
STAT,1943,19,20-24,1962,165.81984596239957
STAT,1819,35,45-49,1854,8.28353070120826
STAT,1881,26,25-29,1907,47.24853259841137
STAT,1822,45,na,1867,2197.170383913714
STAT,1813,96,na,1909,3.931592506574251
STAT,1874,24,25-29,1898,67.20927742392077
STAT,1899,42,na,1941,3662.3384306566345
STAT,1859,21,25-29,1880,60.43549373131046
SIM,1847,38,35-39,1885,12
STAT,1862,14,na,1876,2638.7094017463874
SIM,1829,38,na,1867,1781
SIM,1874,49,50-100,1923,2
SIM,1982,18,25-29,2000,164
STAT,1990,16,15-19,2006,75.02642189203348
SIM,1808,84,na,1892,172
SIM,1921,33,20-24,1954,1
SIM,1946,37,40-44,1983,1
SIM,1930,42,30-34,1972,1
STAT,1878,39,30-34,1917,6.357270768374467
STAT,1931,30,na,1961,5726.870002437416
SIM,1943,36,45-49,1979,5
STAT,1822,32,50-100,1854,3.9618437262997843
STAT,1949,23,25-29,1972,124.34414410396658
SIM,1950,38,45-49,1988,3
STAT,1869,40,25-29,1909,0.7249216881924067
STAT,1947,34,15-19,1981,0.1700590013832399
SIM,1787,97,na,1884,13
SIM,1867,21,25-29,1888,71
STAT,1864,22,45-49,1886,0.7301040059535778
STAT,1917,28,50-100,1945,1.2004317252607595
STAT,1932,16,40-44,1948,2.143191610569913
SIM,1888,29,25-29,1917,53
STAT,1809,46,40-44,1855,0.44053987300561487
STAT,1849,32,20-24,1881,2.2076650906493605
STAT,1840,18,20-24,1858,18.30497450453179
STAT,1909,95,na,2004,208.83697814997393
STAT,1958,23,35-39,1981,14.314483892954762
STAT,1927,48,20-24,1975,0.01596087673142807
STAT,1851,46,35-39,1897,0.11133448053017639
STAT,1990,25,15-19,2015,1.172797831340087
STAT,1889,12,na,1901,3673.7981182443223
STAT,1923,16,30-34,1939,16.55183289236249
SIM,1962,30,40-44,1992,17
SIM,1951,19,20-24,1970,2
STAT,1916,73,na,1989,3115.3204395676207
STAT,1852,50,25-29,1902,0.0033874467337836494
STAT,1893,51,na,1944,3155.9799673854022
SIM,1827,35,45-49,1862,2
SIM,1977,35,50-100,2012,1
SIM,1940,16,40-44,1956,5
STAT,1938,20,45-49,1958,1.2866471295991055
SIM,1831,25,25-29,1856,6
SIM,1944,39,30-34,1983,1
SIM,1888,79,na,1967,889
STAT,1983,7,na,1990,6416.927438250197
STAT,1869,48,20-24,1917,0.013242786783842646
SIM,1841,47,30-34,1888,1
STAT,1875,38,35-39,1913,8.39329547054903
SIM,1957,23,25-29,1980,164
STAT,1832,69,na,1901,999.8231274469309
STAT,1872,35,15-19,1907,0.06569002704345882
STAT,1974,37,na,2011,5840.843569665572
STAT,1909,46,45-49,1955,0.2313075060284138
SIM,1852,48,50-100,1900,1
SIM,1931,16,30-34,1947,22
STAT,1949,32,25-29,1981,12.644902506044987
STAT,1938,37,40-44,1975,1.7565776725676086
SIM,1949,21,40-44,1970,10
STAT,1928,40,40-44,1968,0.368997236193157
STAT,1948,19,na,1967,4857.817479485009
STAT,1919,44,50-100,1963,0.14639912866738541
SIM,1866,23,30-34,1889,53
SIM,1920,67,na,1987,3280
SIM,1941,35,na,1976,3968
STAT,1973,24,15-19,1997,7.965926268044009
STAT,1844,41,30-34,1885,0.9975463266411901
STAT,1858,23,30-34,1881,16.623072846392038
STAT,1933,65,na,1998,5084.557420834003
STAT,1962,22,na,1984,5417.678104149054
SIM,1946,20,45-49,1966,3
SIM,1867,37,40-44,1904,13
STAT,1864,53,50-100,1917,0.015312628369754975
STAT,1943,49,15-19,1992,4.662026516621237E-4
SIM,1907,39,50-100,1946,1
SIM,1904,29,na,1933,4017
STAT,1852,69,na,1921,1383.6196168274862
STAT,1860,37,45-49,1897,1.8541592341625666
SIM,1823,61,na,1884,1587
STAT,1968,21,50-100,1989,0.951892152445803
STAT,1839,38,35-39,1877,6.633796406885088
STAT,1927,65,na,1992,4638.118750264218
STAT,1940,18,25-29,1958,50.77798851208122
STAT,1922,42,30-34,1964,0.16927236307199575
STAT,1969,36,45-49,2005,1.013433024983822
SIM,1978,17,50-100,1995,1
STAT,1879,15,15-19,1894,7.184471459080963
SIM,1957,32,25-29,1989,3
STAT,1824,54,50-100,1878,0.01903850688944189
SIM,1960,18,50-100,1978,5
STAT,1855,51,20-24,1906,6.308965423880376E-4
STAT,1857,110,na,1967,0.0021793511686376606
STAT,1861,29,45-49,1890,1.057619417120428
STAT,1904,36,15-19,1940,0.020182949911030666
SIM,1930,43,na,1973,5984
STAT,1903,7,na,1910,4282.62509874602
STAT,1907,15,35-39,1922,0.9360230236305969
STAT,1865,33,15-19,1898,0.14765710135969784
STAT,1839,29,35-39,1868,9.501971170772881
SIM,1847,29,35-39,1876,2
STAT,1854,30,35-39,1884,8.626298833197424
STAT,1918,18,15-19,1936,56.84503756307217
SIM,1917,46,45-49,1963,1
SIM,1961,39,na,2000,5567
SIM,1977,36,45-49,2013,5
SIM,1956,16,50-100,1972,1
SIM,1963,16,na,1979,6071
STAT,1846,39,20-24,1885,0.8150728099882527
STAT,1830,38,15-19,1868,0.055898701020914335
STAT,1839,43,15-19,1882,0.011395863796071444
STAT,1865,25,30-34,1890,26.39869654930669
SIM,1930,21,50-100,1951,1
SIM,1943,26,50-100,1969,3
SIM,1891,45,na,1936,3296
STAT,1906,29,45-49,1935,1.8551424263380225
STAT,1891,18,35-39,1909,0.7805833254777653
SIM,1890,69,na,1959,2122
STAT,1914,28,25-29,1942,76.34193114475447
STAT,1935,26,50-100,1961,1.5673549167267569
STAT,1765,100,na,1865,0.01794825228581317
STAT,1832,24,20-24,1856,71.53145155342561
STAT,1983,15,40-44,1998,2.2846790681871556
SIM,1889,21,45-49,1910,5
STAT,1877,36,45-49,1913,2.4045889773637583
SIM,1910,92,na,2002,317
STAT,1886,21,50-100,1907,0.4979065094295571
SIM,1983,24,35-39,2007,38
STAT,1846,83,na,1929,410.39804877441816
SIM,1885,36,45-49,1921,1
STAT,1840,15,15-19,1855,6.237073898538021
SIM,1873,25,30-34,1898,7
STAT,1916,23,30-34,1939,34.65245447068489
STAT,1860,52,40-44,1912,0.00973973080484168
SIM,1922,28,25-29,1950,5
SIM,1929,66,na,1995,4141
SIM,1824,60,na,1884,1003
STAT,1839,26,30-34,1865,25.340288873889136
STAT,1912,4,na,1916,4699.183062729595
STAT,1936,39,30-34,1975,2.0617174506764324
STAT,1895,30,25-29,1925,15.51003575584369
STAT,1999,16,35-39,2015,7.155996362014226
STAT,1865,16,30-34,1881,1.7203474383460517
STAT,1789,106,na,1895,0.0024611350537284936
SIM,1924,23,30-34,1947,95
STAT,1967,47,35-39,2014,0.19332354778560573
STAT,1949,15,40-44,1964,1.87830974248732
SIM,1844,17,15-19,1861,11
SIM,1840,53,na,1893,1678
STAT,1911,38,15-19,1949,0.02131716877960796
SIM,1864,15,na,1879,2989
SIM,1928,16,25-29,1944,83
STAT,1896,36,15-19,1932,0.08600759437512946
SIM,1840,24,20-24,1864,65
SIM,1959,49,na,2008,5757
STAT,2000,3,na,2003,6751.272470475049
SIM,1957,15,40-44,1972,2
SIM,1930,8,na,1938,6405
SIM,1971,37,20-24,2008,1
STAT,1917,29,20-24,1946,21.934831725839835
STAT,1957,25,40-44,1982,7.128942895447874
SIM,1955,7,na,1962,6580
STAT,1854,33,40-44,1887,3.580742635235623
SIM,1909,80,na,1989,2605
STAT,1903,47,20-24,1950,0.011074853872823743
STAT,1945,47,25-29,1992,0.0695571477996168
SIM,1886,31,35-39,1917,24
STAT,1885,27,40-44,1912,3.4482213469966565
STAT,1871,70,na,1941,1610.9064864602706
STAT,1873,51,na,1924,2549.6271826626626
SIM,1860,39,na,1899,2302
STAT,1913,33,20-24,1946,2.7902793671309327
SIM,1870,24,35-39,1894,6
SIM,1832,58,na,1890,1598
STAT,1862,24,35-39,1886,5.734749065401294
STAT,1932,24,25-29,1956,139.4197708045387
SIM,1878,40,40-44,1918,9
SIM,1893,27,40-44,1920,7
STAT,1830,29,15-19,1859,0.5214317369547099
STAT,1868,20,20-24,1888,77.51709145691902
STAT,1921,47,40-44,1968,0.20503941421131983
SIM,1981,23,20-24,2004,327
STAT,1961,23,40-44,1984,5.028182936276887
SIM,1925,29,20-24,1954,5
SIM,1928,38,35-39,1966,6
SIM,1854,39,20-24,1893,1
SIM,1887,71,na,1958,2453
STAT,1860,33,na,1893,2210.1621464658115
SIM,1862,33,40-44,1895,11
STAT,1946,39,25-29,1985,1.2956391327674301
STAT,1963,37,20-24,2000,0.39818423867978614
STAT,1858,29,na,1887,2167.993604843359
STAT,1953,38,20-24,1991,0.37876169894142103
SIM,1825,48,50-100,1873,2
STAT,1840,24,15-19,1864,3.317382196192021
SIM,1964,42,30-34,2006,1
SIM,1931,22,25-29,1953,3
STAT,1873,31,50-100,1904,1.084198775425585
STAT,1885,107,na,1992,0.36581513665134713
STAT,1809,52,35-39,1861,0.020809130592861918
STAT,1878,31,35-39,1909,12.25253229659642
STAT,1831,50,20-24,1881,6.258213618673096E-4
SIM,1990,10,na,2000,6331
STAT,1809,49,na,1858,1434.085384156446
SIM,1920,13,na,1933,4635
SIM,1853,26,na,1879,2366
SIM,1888,26,20-24,1914,31
STAT,1836,34,35-39,1870,11.41423695661827
SIM,1839,76,na,1915,1167
SIM,1842,34,na,1876,2365
STAT,1926,87,na,2013,1349.710849651703
SIM,1876,20,20-24,1896,157
STAT,1949,20,20-24,1969,149.838756549624
STAT,1960,47,50-100,2007,0.35361574555027014
SIM,1883,22,20-24,1905,75
STAT,1880,46,30-34,1926,0.11874593916105555
SIM,1912,20,35-39,1932,22
STAT,1920,47,na,1967,4684.6321711606915
STAT,1855,36,25-29,1891,2.461687527491684
SIM,1888,25,na,1913,2704
SIM,1940,24,25-29,1964,1
SIM,1827,32,40-44,1859,12
STAT,1817,48,50-100,1865,0.6911842740615218
SIM,1947,26,35-39,1973,25
STAT,1945,22,45-49,1967,1.4231458780968642
STAT,1808,64,na,1872,1172.151981959051
SIM,1849,24,40-44,1873,5
STAT,1851,43,30-34,1894,0.9050951837592297
SIM,1836,43,40-44,1879,1
STAT,1861,32,35-39,1893,9.715980282363835
SIM,1893,71,na,1964,1950
SIM,1965,25,40-44,1990,5
SIM,1874,39,40-44,1913,3
SIM,1872,72,na,1944,1805
SIM,1939,35,40-44,1974,3
SIM,1953,22,45-49,1975,2
SIM,1921,19,40-44,1940,10
STAT,1838,32,45-49,1870,1.8773264344148222
STAT,1874,49,40-44,1923,0.19804065366289006
STAT,1862,99,na,1961,4.552335652994318
STAT,1822,90,na,1912,64.7775143097113
STAT,1843,21,na,1864,2712.336320543737
STAT,1959,37,45-49,1996,1.0602334991149986
SIM,1858,21,15-19,1879,3
SIM,1887,15,15-19,1902,10
STAT,1968,20,25-29,1988,133.67472930443188
SIM,1823,43,50-100,1866,5
STAT,1828,43,40-44,1871,2.1295153822162245
STAT,1939,26,35-39,1965,17.433237771313678
STAT,1845,87,na,1932,118.7202857195589
STAT,1935,33,40-44,1968,6.247584936463392
SIM,1868,25,na,1893,3190
SIM,1943,33,40-44,1976,13
STAT,1913,19,40-44,1932,0.3284363810958927
SIM,1847,35,30-34,1882,13
STAT,1848,27,50-100,1875,0.811422467146936
STAT,1847,45,30-34,1892,0.07522574668804331
SIM,1828,84,na,1912,476
SIM,1920,3,na,1923,4743
STAT,1946,38,na,1984,4956.207554991049
STAT,1946,44,50-100,1990,0.15575239601694946
SIM,1858,43,25-29,1901,2
SIM,1985,1,na,1986,6454
STAT,1900,38,40-44,1938,1.5055290836274626
STAT,1849,48,35-39,1897,0.10714612465872343
STAT,1891,18,50-100,1909,0.0696949268619873
SIM,1954,57,na,2011,5203
STAT,1979,22,45-49,2001,1.7937867997297152
SIM,1917,47,na,1964,5262
STAT,1825,53,30-34,1878,0.007852566797956517
SIM,1949,24,45-49,1973,2
SIM,1977,33,40-44,2010,17
STAT,1839,35,30-34,1874,5.156854650433592
STAT,1858,26,35-39,1884,8.956944078329101
STAT,1880,33,na,1913,2906.7157592204385
STAT,1888,36,20-24,1924,1.0507470980692561
SIM,1973,16,35-39,1989,12
STAT,1841,46,50-100,1887,0.22217879195019072
STAT,1830,88,na,1918,86.12031261780047
STAT,1961,29,50-100,1990,1.489006106616667
STAT,1965,16,35-39,1981,6.047331539125316
SIM,1847,26,30-34,1873,36
SIM,1976,20,25-29,1996,159
SIM,1873,57,na,1930,2799
STAT,1932,19,45-49,1951,0.7594553342262266
SIM,1963,27,30-34,1990,128
SIM,1920,30,35-39,1950,3
STAT,1842,52,50-100,1894,0.011560077276690332
SIM,1980,20,35-39,2000,32
STAT,1785,73,na,1858,326.23273644253413
SIM,1857,33,na,1890,2516
STAT,1892,115,na,2007,2.707582814236859E-4
STAT,1909,43,40-44,1952,0.26867040476884807
STAT,1896,27,15-19,1923,0.6915724753009763
STAT,1891,23,15-19,1914,4.69091808118075
SIM,1901,94,na,1995,301
STAT,1896,48,na,1944,3386.940084319625
SIM,1852,44,35-39,1896,2
STAT,1835,42,35-39,1877,1.354107059211044
STAT,1969,33,40-44,2002,5.747015029274447
STAT,1977,19,30-34,1996,18.993214796617647
STAT,1940,15,20-24,1955,158.99558160078251
STAT,1891,56,na,1947,2909.16707608658
STAT,1928,43,45-49,1971,0.24445967833204063
STAT,1955,27,30-34,1982,60.28766136387631
SIM,1890,21,15-19,1911,12
STAT,1910,27,45-49,1937,1.9272523690265428
SIM,1987,22,45-49,2009,2
STAT,1912,30,35-39,1942,10.470728100194677
SIM,1815,66,na,1881,1187
SIM,1902,48,na,1950,3777
STAT,1919,32,45-49,1951,1.9587684614232643
SIM,1866,26,35-39,1892,25
SIM,1957,20,20-24,1977,6
STAT,1844,44,35-39,1888,1.5119664496638294
STAT,1849,15,35-39,1864,0.529716207949323
STAT,1904,20,35-39,1924,9.728370303882667
SIM,1927,32,45-49,1959,1
STAT,1882,21,15-19,1903,3.7299364808410993
SIM,1844,34,35-39,1878,28
SIM,1896,36,20-24,1932,1
SIM,1870,46,45-49,1916,1
STAT,1876,33,25-29,1909,12.16764530323755
STAT,1872,29,20-24,1901,13.497269696396922
STAT,1896,33,45-49,1929,2.64686681557913
STAT,1832,27,25-29,1859,40.19452514112688
STAT,1852,27,45-49,1879,1.2192611980348262
STAT,1799,96,na,1895,3.8569957071993897
STAT,1841,27,35-39,1868,10.655242567410026
STAT,1970,5,na,1975,5680.0038405177465
SIM,1839,30,45-49,1869,3
STAT,1972,18,35-39,1990,6.1982687733499215
SIM,1854,28,30-34,1882,32
STAT,1857,28,40-44,1885,2.7533480932302163
STAT,1879,48,15-19,1927,4.7595070984657496E-4
SIM,1898,34,30-34,1932,40
SIM,1980,18,35-39,1998,20
SIM,1905,43,50-100,1948,1
STAT,1954,49,15-19,2003,5.434388688942486E-4
STAT,1846,31,50-100,1877,1.131035713330836
SIM,1880,29,20-24,1909,1
STAT,1925,17,45-49,1942,0.6961780508056619
SIM,1918,27,20-24,1945,46
SIM,1959,21,35-39,1980,32
STAT,1847,68,na,1915,1175.8782526994105
SIM,1828,30,35-39,1858,3
STAT,1857,75,na,1932,925.2915066646548
STAT,1846,28,30-34,1874,31.266887365346474
STAT,1806,83,na,1889,141.08105514466465
SIM,1879,49,35-39,1928,1
STAT,1789,89,na,1878,30.85078493572838
STAT,1845,56,na,1901,1374.4173909917472
SIM,1934,15,50-100,1949,1
SIM,1927,18,30-34,1945,19
SIM,1884,33,25-29,1917,26
SIM,1931,7,na,1938,6397
STAT,1914,17,35-39,1931,1.0021961350271047
STAT,1843,27,35-39,1870,11.914877505862057
SIM,1896,39,25-29,1935,1
STAT,1920,78,na,1998,2691.838993937784
STAT,2001,2,na,2003,6799.335219839333
STAT,1863,27,20-24,1890,11.83832670870666
STAT,1976,35,40-44,2011,2.3819881245280423
STAT,1985,21,25-29,2006,152.1653857179465
STAT,1968,28,20-24,1996,26.41249619616679
SIM,1871,45,na,1916,1974
SIM,1826,58,na,1884,1392
STAT,1851,21,20-24,1872,65.73142837503126
STAT,1895,32,50-100,1927,1.3763767167881351
STAT,1928,10,na,1938,5778.9936593299635
SIM,1922,17,35-39,1939,5
STAT,1910,24,40-44,1934,3.624920822779567
SIM,1902,17,15-19,1919,9
SIM,1973,35,30-34,2008,8
SIM,1993,21,25-29,2014,336
STAT,1885,33,35-39,1918,11.608165411269175
STAT,1826,83,na,1909,218.58324383090158
SIM,1893,33,35-39,1926,3
STAT,1827,68,na,1895,1241.0803890971574
STAT,1965,35,30-34,2000,2.7099991161728414
STAT,1913,3,na,1916,4772.744279997943
STAT,1955,44,15-19,1999,0.0024368598684154164
STAT,1988,27,15-19,2015,1.1702412642857751
SIM,1918,74,na,1992,2539
STAT,1889,17,30-34,1906,2.2673896911500364
STAT,1862,21,30-34,1883,17.887344325911716
SIM,1886,17,20-24,1903,31
SIM,1971,27,25-29,1998,260
SIM,1916,62,na,1978,4126
SIM,1965,20,15-19,1985,14
SIM,1831,28,na,1859,1871
SIM,1897,17,30-34,1914,5
STAT,1880,23,40-44,1903,2.5411244885460103
STAT,1902,16,50-100,1918,0.08008373498739053
SIM,1845,37,20-24,1882,2
STAT,1908,17,50-100,1925,0.08397654838297258
STAT,1936,17,20-24,1953,149.88362629024328
STAT,1823,36,15-19,1859,0.11478376542069783
SIM,1851,27,35-39,1878,3
STAT,1929,21,15-19,1950,7.7924022285932715
STAT,1963,27,25-29,1990,96.92020058908179
STAT,1922,16,15-19,1938,60.7360733931911
STAT,1899,39,35-39,1938,2.389413452163112
STAT,1826,37,45-49,1863,1.5973641897616553
STAT,1832,38,na,1870,1811.4514577421016
STAT,1957,28,45-49,1985,2.6387708556665626
STAT,1909,21,30-34,1930,30.9550841212662
STAT,1873,46,20-24,1919,0.014182030184663293
STAT,1867,31,25-29,1898,11.081388890992958
SIM,1983,16,na,1999,7016
SIM,1943,65,na,2008,4524
STAT,1859,43,35-39,1902,1.6526642944887515
SIM,1917,21,30-34,1938,53
STAT,1872,18,30-34,1890,1.842140343213447
STAT,1967,44,30-34,2011,0.19089185214382115
SIM,1929,27,30-34,1956,4
STAT,1895,16,45-49,1911,0.09836794416524282
SIM,1956,34,30-34,1990,39
STAT,1875,18,na,1893,3004.1347889565436
STAT,1862,46,45-49,1908,0.23050063029959625
SIM,1950,35,40-44,1985,8
STAT,1855,63,na,1918,1518.2565305521025
SIM,1983,18,40-44,2001,4
STAT,1845,22,40-44,1867,1.74320483425122
STAT,1882,99,na,1981,26.58742249196969
STAT,1930,18,30-34,1948,18.140437913045755
STAT,1884,50,35-39,1934,0.00995729331008782
STAT,1857,20,45-49,1877,0.7340617551781269
STAT,1942,35,40-44,1977,1.8635477914848404
SIM,1843,20,25-29,1863,116
STAT,1973,32,na,2005,5753.965079263881
SIM,1834,37,45-49,1871,2
STAT,1859,56,na,1915,1875.0451616933167
STAT,1899,20,15-19,1919,5.247110915454412
SIM,1877,33,na,1910,3149
STAT,1825,31,20-24,1856,6.10774530094611
SIM,1901,20,25-29,1921,197
STAT,1837,37,20-24,1874,0.6796096655018004
STAT,1980,17,15-19,1997,72.70788729472677
SIM,1865,28,40-44,1893,5
SIM,1853,22,40-44,1875,3
SIM,1944,17,20-24,1961,3
SIM,1910,74,na,1984,1915
SIM,1825,37,35-39,1862,13
STAT,1941,18,40-44,1959,1.6625183998008108
SIM,1844,31,30-34,1875,7
STAT,1853,82,na,1935,464.53832811248435
STAT,1846,20,35-39,1866,7.551463049379103
STAT,1959,34,40-44,1993,6.01385725386096
STAT,1916,45,40-44,1961,0.1875199704301509
STAT,1962,21,35-39,1983,13.973732760514142
STAT,1862,45,na,1907,2213.0381023049044
SIM,1831,73,na,1904,738
SIM,1848,21,20-24,1869,117
SIM,1887,40,na,1927,3693
SIM,1968,15,15-19,1983,57
SIM,1950,43,na,1993,4688
STAT,1909,49,15-19,1958,3.887817705403251E-4
SIM,1976,38,na,2014,5950
STAT,1937,37,25-29,1974,1.1368466515323867
STAT,1817,50,50-100,1867,0.043175776885768985
STAT,1951,21,25-29,1972,127.39906846672655
STAT,1835,20,25-29,1855,74.53993610773645
STAT,1900,24,na,1924,3763.5749233699635
SIM,1837,64,na,1901,1609
STAT,1948,34,30-34,1982,21.182099482150168
SIM,1954,39,25-29,1993,2
SIM,1979,15,25-29,1994,162
SIM,1915,12,na,1927,5022
STAT,1857,38,50-100,1895,1.0980349038709452
SIM,1841,80,na,1921,415
STAT,1922,59,na,1981,4578.09253814089
SIM,1838,60,na,1898,1385
STAT,1926,34,45-49,1960,2.192552456592796
SIM,1828,39,na,1867,2270
SIM,1859,24,35-39,1883,18
SIM,1829,36,25-29,1865,9
SIM,1867,43,35-39,1910,4
STAT,1835,37,50-100,1872,0.9474892562168592
STAT,1831,53,na,1884,1717.123174621446
STAT,1932,66,na,1998,4927.764931220101
STAT,1873,82,na,1955,549.8626594516318
SIM,1839,38,40-44,1877,10
STAT,1842,45,na,1887,1776.5413902713863
STAT,1968,19,na,1987,5301.942190235485
STAT,1816,103,na,1919,0.07087486947616392
STAT,1976,22,40-44,1998,5.201218437911703
STAT,1956,22,20-24,1978,170.3637235837775
STAT,1866,49,50-100,1915,0.2572237920645378
SIM,1945,37,25-29,1982,2
SIM,1914,81,na,1995,1536
SIM,1849,27,45-49,1876,1
STAT,1877,39,15-19,1916,0.06673200233110256
SIM,1899,32,25-29,1931,27
STAT,1797,61,na,1858,1135.6920091151403
SIM,1952,1,na,1953,4998
SIM,1828,38,30-34,1866,9
STAT,1857,42,20-24,1899,0.14256710892880783
SIM,1934,34,45-49,1968,8
SIM,1964,22,20-24,1986,2
STAT,1936,31,35-39,1967,10.255617477793741
SIM,1958,32,40-44,1990,14
STAT,1882,15,20-24,1897,20.076714495608854
SIM,1870,21,30-34,1891,48
STAT,1946,28,35-39,1974,19.29093591124181
SIM,1938,32,20-24,1970,3
STAT,1919,18,30-34,1937,15.500187891067913
STAT,1888,39,25-29,1927,3.866535153332921
SIM,1907,24,40-44,1931,8
STAT,1888,36,na,1924,3211.4415860596896
STAT,1878,29,na,1907,2855.1016047722946
STAT,1897,39,35-39,1936,2.332081245916384
SIM,1977,9,na,1986,6243
STAT,1912,66,na,1978,3493.6358149551593
SIM,1875,38,na,1913,3101
STAT,1856,31,15-19,1887,0.1282425819246503
SIM,1894,8,na,1902,4167
SIM,1904,26,15-19,1930,1
SIM,1824,46,na,1870,1512
SIM,1998,7,na,2005,6866
STAT,1901,74,na,1975,2399.0542983815803
STAT,1986,27,15-19,2013,1.1658814272437066
STAT,1941,35,50-100,1976,0.5151909842467447
STAT,1914,47,30-34,1961,0.10207930165983498
STAT,1884,16,35-39,1900,0.6271862867587201
STAT,1902,59,na,1961,3319.24708845205
SIM,1834,20,15-19,1854,1
STAT,1817,37,35-39,1854,31.82597455651883
SIM,1828,53,na,1881,1855
SIM,1954,28,35-39,1982,24
STAT,1853,50,40-44,1903,0.010632151721395365
SIM,1860,27,45-49,1887,1
SIM,1872,53,50-100,1925,1
SIM,1854,20,35-39,1874,1
STAT,1836,31,30-34,1867,20.30155183905216
STAT,1879,37,25-29,1916,3.4694869583422685
SIM,1840,27,25-29,1867,82
STAT,1893,37,na,1930,3436.707573660493
STAT,1847,48,35-39,1895,0.10637005852231032
SIM,1889,29,40-44,1918,6
SIM,1970,21,35-39,1991,31
SIM,1949,35,na,1984,5860
STAT,1857,45,25-29,1902,0.05228763415846659
STAT,1903,101,na,2004,21.745406811075856
SIM,1919,59,na,1978,4979
SIM,1939,38,45-49,1977,4
STAT,1800,92,na,1892,22.473472873141077
SIM,1823,34,30-34,1857,42
SIM,1948,21,25-29,1969,1
STAT,1859,110,na,1969,0.0030431390613992566
SIM,1968,21,45-49,1989,6
STAT,1935,39,15-19,1974,0.030939668633729406
SIM,1914,67,na,1981,3171
STAT,1974,24,30-34,1998,43.424552853403725
SIM,1887,37,25-29,1924,12
SIM,1942,5,na,1947,5100
STAT,1860,64,na,1924,1616.8622014443215
STAT,1986,24,45-49,2010,1.8550776170431662
SIM,1973,38,35-39,2011,9
STAT,1979,25,15-19,2004,1.1275756023442256
STAT,1928,22,50-100,1950,0.9480783058069264
STAT,1852,24,40-44,1876,2.30050937247388
STAT,1871,15,45-49,1886,0.07637996420979218
SIM,1991,23,15-19,2014,9
STAT,1975,32,20-24,2007,3.785309431720257
SIM,1875,52,na,1927,2799
SIM,1850,38,40-44,1888,12
STAT,1896,30,40-44,1926,6.663531990447125
STAT,1976,38,45-49,2014,1.0817726257523526
STAT,1969,39,15-19,2008,0.028460716012204953
STAT,1933,11,na,1944,6132.998559261125
STAT,1842,38,40-44,1880,3.9108004045469014
STAT,1856,25,20-24,1881,10.858523408836115
STAT,1957,42,25-29,1999,0.11291706236465066
SIM,1883,44,30-34,1927,2
STAT,1820,50,45-49,1870,0.014830858558237887
STAT,1990,22,45-49,2012,1.8657279070563404
STAT,1924,1,na,1925,5737.523911808769
STAT,1841,24,30-34,1865,19.77492223773308
STAT,1965,38,35-39,2003,3.5866142185789007
SIM,1929,33,25-29,1962,2
STAT,1893,25,50-100,1918,0.9394618145843208
STAT,1860,15,35-39,1875,0.5956031916049322
STAT,1971,15,15-19,1986,66.37038125109362
STAT,1864,16,15-19,1880,6.992888054594253
SIM,1857,19,na,1876,2779
STAT,1881,18,na,1899,2803.9600101214346
STAT,1882,18,25-29,1900,6.370885741789966
STAT,1962,29,30-34,1991,58.13126228682
SIM,1931,19,35-39,1950,10
STAT,1850,29,35-39,1879,11.521961340723257
STAT,1982,15,25-29,1997,70.41033767741445
STAT,1929,15,20-24,1944,200.61298188530154
SIM,1944,31,35-39,1975,23
STAT,1801,77,na,1878,393.44189553813914
STAT,1867,17,45-49,1884,0.07195381218916522
SIM,1965,28,na,1993,5580
SIM,1970,29,30-34,1999,7
STAT,1834,25,35-39,1859,11.714053240202805
SIM,1879,46,30-34,1925,2
SIM,1933,31,25-29,1964,19
STAT,1947,39,40-44,1986,2.0006136119012363
SIM,1934,48,50-100,1982,1
STAT,1830,32,40-44,1862,4.692191816641119
SIM,1949,32,30-34,1981,2
SIM,1890,18,25-29,1908,1
STAT,1824,39,35-39,1863,10.368404278738776
STAT,1940,37,30-34,1977,2.20089649658416
SIM,1937,15,20-24,1952,283
STAT,1849,54,30-34,1903,0.004486760103797847
SIM,1870,60,na,1930,2484
SIM,1926,15,45-49,1941,1
STAT,1873,49,25-29,1922,0.0664637110974094
SIM,1901,28,20-24,1929,37
STAT,1837,75,na,1912,745.4624400291376
STAT,1923,19,35-39,1942,5.6537280952430375
STAT,1826,34,40-44,1860,3.7135982103289273
STAT,1845,25,45-49,1870,0.9238919171816485
STAT,1883,35,25-29,1918,3.2817533171212183
STAT,1835,39,45-49,1874,1.5066348308765691
STAT,1908,99,na,2007,54.61216341898866
SIM,1826,32,25-29,1858,4
STAT,1978,17,25-29,1995,68.2515897926125
STAT,1948,10,na,1958,5189.193992053023
STAT,1925,31,25-29,1956,12.669610689468257
STAT,1952,24,45-49,1976,1.560160492689254
SIM,1950,29,na,1979,4781
STAT,1926,48,50-100,1974,0.3211085812653305
SIM,1860,53,na,1913,2213
STAT,1985,20,na,2005,6017.980006541972
STAT,1875,63,na,1938,2127.953069202096
SIM,1985,21,50-100,2006,1
STAT,1814,95,na,1909,8.290014061040594
STAT,1875,44,30-34,1919,1.3525819383134239
STAT,1942,38,45-49,1980,0.8463245332127673
SIM,1878,29,30-34,1907,1
SIM,1843,39,45-49,1882,4
STAT,1897,36,30-34,1933,8.263835494541013
STAT,1781,111,na,1892,3.684162957382041E-4
STAT,1901,19,15-19,1920,9.54165306458617
STAT,1918,15,45-49,1933,0.12644863100745218
STAT,1860,15,50-100,1875,0.05317884654052142
STAT,1911,27,50-100,1938,1.1211657498737666
SIM,1834,34,40-44,1868,13
SIM,1911,22,40-44,1933,6
STAT,1878,17,20-24,1895,21.3620924780808
SIM,1891,35,25-29,1926,5
STAT,1885,70,na,1955,1615.0917108682995
STAT,1963,24,20-24,1987,163.45685065706817
STAT,1956,25,25-29,1981,101.03476809533977
STAT,1831,38,30-34,1869,5.215825041626475
SIM,1947,40,50-100,1987,1
SIM,1864,25,20-24,1889,14
STAT,1951,41,45-49,1992,0.23803042016309953
STAT,1830,57,na,1887,1269.6439867256745
SIM,1908,81,na,1989,1290
SIM,1888,70,na,1958,1431
STAT,1941,32,20-24,1973,2.9561674151290935
STAT,1915,28,40-44,1943,5.468193612948351
SIM,1923,28,40-44,1951,13
SIM,1898,37,35-39,1935,4
STAT,1816,48,40-44,1864,0.34392454143635276
STAT,1903,22,40-44,1925,3.425317464958157
SIM,1971,24,20-24,1995,3
SIM,1900,13,na,1913,3909
STAT,1951,39,na,1990,5315.199983345327
STAT,1939,40,50-100,1979,0.14148380913803363
SIM,1818,41,30-34,1859,2
STAT,1868,45,35-39,1913,0.15677501900319607
STAT,1928,37,15-19,1965,0.028007050509371346
SIM,1875,25,30-34,1900,43
SIM,1945,34,20-24,1979,1
SIM,1964,25,25-29,1989,90
STAT,1809,49,45-49,1858,0.5839371240886836
SIM,1837,24,15-19,1861,4
SIM,1844,23,45-49,1867,2
SIM,1833,31,20-24,1864,9
STAT,1969,20,40-44,1989,4.866644541415431
STAT,1947,23,25-29,1970,120.43338720848202
SIM,1975,22,30-34,1997,59
STAT,1991,20,na,2011,6063.786064609615
STAT,1950,46,50-100,1996,0.3218222914093248
STAT,1842,90,na,1932,60.66980591127424
STAT,1916,48,45-49,1964,0.256570965152123
SIM,1948,39,na,1987,4387
SIM,1842,65,na,1907,1494
SIM,1838,35,20-24,1873,1
SIM,1978,31,35-39,2009,19
SIM,1873,71,na,1944,1816
STAT,1839,56,na,1895,1617.5313109522817
STAT,1930,32,45-49,1962,2.3438946443648314
SIM,1806,49,35-39,1855,1
SIM,1893,26,na,1919,3489
STAT,1790,101,na,1891,0.1262954929391706
STAT,1958,20,30-34,1978,43.73828495614293
SIM,1862,34,na,1896,2794
STAT,1919,35,15-19,1954,0.02393548280961169
STAT,1967,22,30-34,1989,41.56936041457656
STAT,1824,57,na,1881,1346.050102660585
SIM,1955,23,25-29,1978,186
STAT,1937,34,20-24,1971,2.782850449292804
STAT,1956,45,50-100,2001,0.36095222801964044
STAT,1898,6,na,1904,4074.4422854887885
STAT,1829,49,na,1878,1753.524618794844
SIM,1964,45,50-100,2009,1
STAT,1925,88,na,2013,1154.1488698504024
SIM,1878,43,45-49,1921,1
STAT,1915,42,20-24,1957,0.020522615599405172
SIM,1958,29,15-19,1987,1
STAT,1833,22,15-19,1855,3.566196146286772
SIM,1848,24,25-29,1872,3
STAT,1850,43,15-19,1893,0.014113777759383855
SIM,1841,22,15-19,1863,5
SIM,1954,36,20-24,1990,1
STAT,1904,28,30-34,1932,41.585031230833835
SIM,1920,19,25-29,1939,117
STAT,1876,48,na,1924,2650.2877586275986
STAT,1846,45,15-19,1891,4.176350334017958E-4
STAT,1954,27,15-19,1981,1.0115123765378191
STAT,1838,26,15-19,1864,0.5036270933011385
STAT,1900,78,na,1978,1964.2648995254026
SIM,1908,21,50-100,1929,1
SIM,1821,39,25-29,1860,1
SIM,1808,47,45-49,1855,1
SIM,1832,39,35-39,1871,13
SIM,1901,49,na,1950,3787
SIM,1822,65,na,1887,1043
STAT,1912,19,25-29,1931,10.068161287309923
SIM,1962,27,15-19,1989,4
STAT,1955,31,50-100,1986,1.291884187669322
SIM,1906,21,20-24,1927,215
STAT,1840,21,45-49,1861,0.7165253829701387
SIM,1989,23,25-29,2012,311
STAT,1886,55,na,1941,2517.0507747146235
SIM,1839,90,na,1929,96
STAT,1894,35,35-39,1929,10.592609160518597
STAT,1863,2,na,1865,3448.519665576656
STAT,1921,49,30-34,1970,0.11525396701597213
SIM,1912,28,30-34,1940,56
STAT,1813,65,na,1878,925.9106192965199
SIM,1826,72,na,1898,776
SIM,1823,37,35-39,1860,2
SIM,1846,26,15-19,1872,1
STAT,1915,77,na,1992,2587.5730041561005
SIM,1958,48,45-49,2006,1
SIM,1905,29,35-39,1934,21
STAT,1861,26,40-44,1887,2.91578092791813
SIM,1932,55,na,1987,5139
SIM,1868,18,15-19,1886,9
STAT,1828,64,na,1892,1153.7474653890592
SIM,1916,48,na,1964,4312
STAT,1886,44,40-44,1930,2.7011097701401745
SIM,1829,33,20-24,1862,3
STAT,1862,49,15-19,1911,3.814386570627929E-4
SIM,1811,73,na,1884,880
SIM,1953,25,15-19,1978,2
SIM,1899,15,40-44,1914,1
STAT,1957,27,50-100,1984,1.5210371184477909
SIM,1845,44,50-100,1889,4
STAT,1945,25,15-19,1970,0.894590466916452
STAT,1983,23,15-19,2006,8.716188378760297
STAT,1923,33,15-19,1956,0.169843686422075
STAT,1837,44,50-100,1881,0.8006855551661415
SIM,1938,35,25-29,1973,1
SIM,1992,15,25-29,2007,188
STAT,1883,52,na,1935,2418.1829045122217
STAT,1819,43,40-44,1862,4.585466569793335
STAT,1908,26,40-44,1934,5.152290568375615
STAT,1938,4,na,1942,4597.0542204601115
STAT,1968,32,30-34,2000,23.14851944089212
STAT,1859,52,25-29,1911,0.003238854771697883
STAT,1845,39,25-29,1884,1.9966114785760536
SIM,1819,39,na,1858,1307
SIM,1977,15,15-19,1992,75
STAT,1886,47,50-100,1933,0.29757779641741294
STAT,1854,87,na,1941,143.53395300484243
STAT,1891,108,na,1999,0.23295731828101016
STAT,1929,18,25-29,1947,63.65993729654203
SIM,1976,22,45-49,1998,4
SIM,1843,26,35-39,1869,22
SIM,1868,39,45-49,1907,7
SIM,2004,1,na,2005,7414
SIM,1883,42,40-44,1925,1
STAT,1977,20,45-49,1997,1.7614893348831528
STAT,1835,35,50-100,1870,0.9674931666018624
STAT,1835,26,35-39,1861,7.9312895226995765
SIM,1823,49,40-44,1872,3
SIM,1818,45,40-44,1863,1
STAT,1875,42,40-44,1917,2.679173492664632
SIM,1864,37,35-39,1901,1
SIM,1814,43,30-34,1857,4
STAT,1894,40,25-29,1934,0.962277869402045
STAT,1903,45,20-24,1948,0.011237655943111408
SIM,1827,43,40-44,1870,4
SIM,1834,28,35-39,1862,16
STAT,1837,29,50-100,1866,0.5860345299997738
SIM,1889,16,30-34,1905,10
SIM,1891,16,na,1907,3532
SIM,1853,39,25-29,1892,4
SIM,1886,69,na,1955,1029
SIM,1921,6,na,1927,5593
SIM,1878,18,20-24,1896,19
SIM,1882,55,na,1937,2870
SIM,1920,46,na,1966,4101
STAT,1815,49,40-44,1864,0.3393755799901014
STAT,1895,27,45-49,1922,1.667888439841653
STAT,1927,32,na,1959,5367.877314460159
STAT,1854,37,25-29,1891,2.3456732545004932
SIM,1811,59,na,1870,1458
STAT,1831,27,na,1858,2250.1789006746803
SIM,1853,33,40-44,1886,9
STAT,1964,38,30-34,2002,2.726514028167264
SIM,1928,26,na,1954,5773
STAT,1944,28,na,1972,4670.53367786273
STAT,1932,20,15-19,1952,8.110493283837199
STAT,1940,14,na,1954,4610.275789126015
STAT,1886,21,35-39,1907,7.125041315998469
SIM,1924,12,na,1936,5343
STAT,1863,41,35-39,1904,1.835578733686144
STAT,1849,52,40-44,1901,0.008116208568229874
STAT,1917,24,40-44,1941,4.0983458226383505
STAT,1880,24,20-24,1904,83.76889291195678
SIM,1834,20,25-29,1854,59
STAT,1917,37,50-100,1954,0.5032808211342219
SIM,1972,38,30-34,2010,3
STAT,1923,22,15-19,1945,7.145243530406123
STAT,1866,44,40-44,1910,2.3734885941611745
STAT,1934,16,40-44,1950,2.1897902659542767
SIM,1787,76,na,1863,665
STAT,1841,21,na,1862,2425.5894704390334
SIM,1877,37,45-49,1914,5
STAT,1979,33,45-49,2012,2.547118720039645
SIM,1894,29,45-49,1923,4
STAT,1890,46,25-29,1936,0.04594657419141028
STAT,1968,38,15-19,2006,0.02848838741823806
STAT,1849,49,na,1898,1707.371286163278
SIM,1899,38,35-39,1937,4
SIM,1871,41,35-39,1912,2
STAT,1912,82,na,1994,1789.7331973874907
STAT,1911,100,na,2011,37.99815766601516
STAT,1950,46,45-49,1996,0.30924291896309464
STAT,1796,60,na,1856,1126.4848550612
STAT,1858,31,25-29,1889,9.317523279542595
STAT,1825,41,15-19,1866,0.020976050797947933
SIM,1825,44,45-49,1869,2
SIM,1911,85,na,1996,2359
STAT,1901,43,45-49,1944,0.16678707076943164
SIM,1952,30,35-39,1982,26
SIM,1874,44,40-44,1918,3
SIM,1869,73,na,1942,734
SIM,1844,38,na,1882,2407
STAT,1914,46,35-39,1960,0.14800239965831458
STAT,1990,20,20-24,2010,184.5070175199108
STAT,1857,36,na,1893,2127.7694509493585
STAT,1845,35,na,1880,1701.3716090185305
STAT,1858,39,35-39,1897,6.303564580115315
SIM,1938,27,30-34,1965,95
STAT,1966,27,40-44,1993,6.747584591505539
STAT,1850,15,20-24,1865,22.566957079852173
STAT,1819,110,na,1929,1.8396169609419553E-4
STAT,1869,37,45-49,1906,2.227937309514458
STAT,1817,44,45-49,1861,4.3787262727144425
STAT,1977,30,30-34,2007,25.06997577468464
STAT,1969,15,15-19,1984,65.46055021697862
SIM,1799,77,na,1876,43
SIM,1983,17,25-29,2000,101
STAT,1875,23,25-29,1898,68.05989717087698
STAT,1912,43,20-24,1955,0.019557489659175784
STAT,1859,40,30-34,1899,1.0675598803094781
STAT,1884,26,30-34,1910,28.811465771074833
STAT,1909,23,50-100,1932,0.7043623936580973
SIM,1949,20,35-39,1969,34
SIM,1948,30,na,1978,4292
SIM,1963,49,na,2012,6385
STAT,1985,10,na,1995,6449.360205106044
STAT,1862,90,na,1952,76.78538354394358
STAT,1882,27,35-39,1909,10.87641687950124
STAT,1975,39,45-49,2014,1.0670121859977797
STAT,1872,41,50-100,1913,1.2297580782436126
STAT,1944,30,35-39,1974,11.582136961195282
STAT,1828,47,25-29,1875,0.05304032819905319
STAT,1927,32,50-100,1959,1.1734700884536606
SIM,1892,26,30-34,1918,56
SIM,1957,39,na,1996,6234
STAT,1832,33,30-34,1865,15.67813100271963
SIM,1840,33,30-34,1873,24
SIM,1858,7,na,1865,3380
SIM,1866,31,25-29,1897,25
STAT,1875,51,50-100,1926,0.018097647889365773
STAT,1955,33,15-19,1988,0.20055051678865846
SIM,1890,27,35-39,1917,2
STAT,1848,17,30-34,1865,2.0993817794824783
SIM,1870,54,na,1924,2779
STAT,1892,37,45-49,1929,2.883447623708549
STAT,1881,48,25-29,1929,0.06331061298538644
STAT,1848,21,15-19,1869,4.2989333458753265
STAT,1810,65,na,1875,1095.0163432540169
STAT,1871,26,45-49,1897,1.2791429563193295
STAT,1879,79,na,1958,974.896189990911
STAT,1844,37,50-100,1881,1.0851634751823471
SIM,1847,23,15-19,1870,1
SIM,1856,21,15-19,1877,9
STAT,1937,58,na,1995,4062.597427558059
STAT,1933,44,na,1977,5871.8325864511435
STAT,1925,49,15-19,1974,5.119550425929467E-4
STAT,1899,83,na,1982,1348.24802213793
STAT,1965,18,35-39,1983,6.043703682042748
SIM,1841,89,na,1930,43
STAT,1877,45,50-100,1922,0.2977685940837985
STAT,1845,30,50-100,1875,0.7495160073579905
STAT,1882,52,25-29,1934,0.003971355346140443
SIM,1856,17,30-34,1873,3
SIM,1973,18,35-39,1991,7
STAT,1886,29,45-49,1915,1.3419243417426172
STAT,1828,44,20-24,1872,0.14798777983403452
STAT,1897,24,15-19,1921,5.058966035441584
SIM,1851,34,45-49,1885,4
STAT,1888,45,30-34,1933,0.13262558958626441
SIM,1925,24,40-44,1949,5
STAT,1956,17,30-34,1973,18.613217855721405
STAT,1843,34,45-49,1877,2.0602632247794856
STAT,1981,25,25-29,2006,106.7670577197144
STAT,1820,54,45-49,1874,0.013694092526810343
SIM,1862,37,25-29,1899,2
STAT,1819,49,25-29,1868,0.10773889332733332
STAT,1866,40,na,1906,2497.190887625062
STAT,1859,18,45-49,1877,0.06929638724649022
STAT,1838,54,30-34,1892,0.005015314518776937
STAT,1938,73,na,2011,3117.653220438481
STAT,1881,36,30-34,1917,5.961061616216956
STAT,1915,31,na,1946,4464.20851312823
STAT,1881,40,15-19,1921,0.015527233495723191
SIM,1925,75,na,2000,3039
STAT,1960,2,na,1962,5914.950523687284
STAT,1838,30,45-49,1868,1.9167213666205651
STAT,1860,25,30-34,1885,24.016499942526575
STAT,1845,36,45-49,1881,1.4261469666502293
STAT,1874,91,na,1965,183.01127951785165
SIM,1832,25,20-24,1857,2
SIM,1929,21,20-24,1950,290
STAT,1899,24,25-29,1923,89.94273979413305
SIM,1898,86,na,1984,952
STAT,1927,2,na,1929,5867.308530182913
STAT,1918,40,35-39,1958,0.24771049586163327
STAT,1885,42,25-29,1927,0.7382828407462771
STAT,1974,40,30-34,2014,0.20076870368782873
STAT,1815,96,na,1911,4.7645785939999845
STAT,1886,45,20-24,1931,0.014753367173527905
STAT,1954,17,20-24,1971,193.42094099498902
STAT,1929,43,15-19,1972,0.0022916062378560377
SIM,1962,17,20-24,1979,334
STAT,1845,19,na,1864,1932.051684794762
STAT,1807,61,na,1868,1321.718669291725
STAT,1896,31,45-49,1927,2.6689465421894414
SIM,1904,8,na,1912,4453
STAT,1835,51,25-29,1886,0.0022976854973277166
SIM,1853,36,45-49,1889,6
STAT,1968,22,45-49,1990,1.627198365939782
SIM,1882,71,na,1953,1959
STAT,1823,35,30-34,1858,11.297296006559485
STAT,1853,39,50-100,1892,1.2100614602473088
STAT,1788,107,na,1895,0.0021405174554032357
STAT,1954,40,45-49,1994,0.24744057686647591
STAT,1846,52,na,1898,2214.0565732823293
STAT,1983,25,35-39,2008,24.637707372642282
STAT,1808,46,45-49,1854,1.2004781355542378
STAT,1849,33,25-29,1882,8.279011924179352
SIM,1941,19,50-100,1960,1
SIM,1896,47,na,1943,3450
SIM,1976,32,30-34,2008,12
SIM,1892,33,na,1925,3873
STAT,1939,28,35-39,1967,17.417028625765713
SIM,1947,28,35-39,1975,48
SIM,1975,18,45-49,1993,2
STAT,1848,29,25-29,1877,52.88978906870387
STAT,1927,49,25-29,1976,0.07637547302447047
STAT,1817,106,na,1923,0.00839428011478063
SIM,1856,29,25-29,1885,65
SIM,1883,20,20-24,1903,166
STAT,1899,46,45-49,1945,0.2110754590117327
STAT,1964,31,15-19,1995,0.190503725345821
STAT,1881,43,50-100,1924,1.1674724150407667
STAT,1967,18,45-49,1985,0.7198916653848179
SIM,1831,35,30-34,1866,11
SIM,1812,76,na,1888,265
SIM,1846,30,45-49,1876,2
SIM,1878,34,na,1912,2766
STAT,1918,25,50-100,1943,1.2304809153399612
STAT,1936,34,50-100,1970,0.9261421884868546
STAT,1890,22,na,1912,3335.0028142742954
SIM,1881,38,na,1919,1908
SIM,1857,33,25-29,1890,14
STAT,1951,55,na,2006,5086.565955815441
STAT,1875,45,45-49,1920,0.28425847942560084
STAT,1943,17,45-49,1960,0.6113889748943606
STAT,1864,20,45-49,1884,0.7407023060874288
STAT,1885,17,35-39,1902,0.6316241761296193
SIM,1815,41,na,1856,2034
SIM,1869,9,na,1878,2357
SIM,1899,12,na,1911,4531
SIM,1819,55,na,1874,836
STAT,1913,21,50-100,1934,0.7384341880155584
SIM,1938,66,na,2004,3673
STAT,1942,30,25-29,1972,11.377007887164222
SIM,1893,30,30-34,1923,9
SIM,1868,31,35-39,1899,13
STAT,1909,17,45-49,1926,0.11317904667788087
STAT,1899,45,30-34,1944,0.08719229135476388
STAT,1962,37,25-29,1999,1.4999548802256377
SIM,1938,22,25-29,1960,2
STAT,1971,4,na,1975,5748.186692963149
STAT,1830,33,20-24,1863,2.8673900623118853
STAT,1890,34,30-34,1924,24.40951101383073
STAT,1885,30,30-34,1915,20.259593307827213
STAT,1813,50,35-39,1863,0.028453623320612933
STAT,1888,83,na,1971,1030.1525537013906
SIM,1893,17,35-39,1910,2
SIM,1874,20,na,1894,2591
STAT,1835,23,30-34,1858,14.910330713384113
SIM,1972,33,25-29,2005,12
STAT,1974,10,na,1984,5921.032418749606
SIM,1942,20,25-29,1962,219
SIM,1854,29,15-19,1883,1
SIM,1838,69,na,1907,902
STAT,1854,34,20-24,1888,2.2088079906338307
SIM,1877,34,40-44,1911,16
STAT,1869,34,40-44,1903,4.805254458304119
SIM,1839,25,30-34,1864,43
STAT,1928,27,20-24,1955,25.952464622517873
SIM,1883,45,45-49,1928,1
SIM,1875,35,45-49,1910,9
SIM,1951,17,45-49,1968,2
STAT,1992,22,20-24,2014,184.80099256441983
SIM,1928,17,20-24,1945,4
SIM,1899,26,40-44,1925,10
SIM,1936,27,20-24,1963,5
STAT,1903,48,25-29,1951,0.05273721129870846
STAT,1990,23,25-29,2013,153.11370504526818
STAT,1774,81,na,1855,8.093
SIM,1950,30,25-29,1980,25
STAT,1853,53,45-49,1906,0.01421684346636527
SIM,1931,49,40-44,1980,1
STAT,1885,91,na,1976,279.90876523209977
STAT,1829,43,50-100,1872,1.1103826242636157
STAT,1877,40,na,1917,2802.5119066895113
STAT,1976,28,50-100,2004,1.5405248499644708
SIM,1899,35,30-34,1934,5
STAT,1926,15,na,1941,5231.093376032017
SIM,1984,28,50-100,2012,7
SIM,1900,3,na,1903,3999
SIM,1849,47,35-39,1896,1
STAT,1875,20,20-24,1895,82.6750853216789
STAT,1825,90,na,1915,55.76616127728059
STAT,1874,75,na,1949,1216.2551262981901
STAT,1904,31,na,1935,3970.8016420949343
STAT,1862,25,40-44,1887,2.970738616983648
STAT,1895,24,40-44,1919,3.110684811244639
SIM,1932,47,na,1979,5370
STAT,1871,38,15-19,1909,0.06415274910769267
STAT,1870,61,na,1931,2125.9918877941586
STAT,1892,39,50-100,1931,1.757976158261525
SIM,1999,15,35-39,2014,15
STAT,1810,44,35-39,1854,8.0159385922806
SIM,1890,24,30-34,1914,2
STAT,2000,15,na,2015,6320.459760654938
STAT,1846,29,15-19,1875,0.5592910715789828
STAT,1953,39,25-29,1992,1.4131280971164004
STAT,1977,33,35-39,2010,14.515770977054329
SIM,1870,25,40-44,1895,6
SIM,1906,16,30-34,1922,7
SIM,1862,34,20-24,1896,6
STAT,1938,41,15-19,1979,0.0018203265812697716
STAT,1917,1,na,1918,5169.344061430445
SIM,1840,36,35-39,1876,18
STAT,1997,18,15-19,2015,76.4546657558047
STAT,1965,42,30-34,2007,0.1914218247489828
SIM,1972,12,na,1984,5833
STAT,1882,24,30-34,1906,19.952579261486477
SIM,1944,47,25-29,1991,1
STAT,1821,35,20-24,1856,1.9042005252508698
SIM,1916,30,25-29,1946,3
STAT,1916,32,na,1948,4506.659029385106
STAT,1916,40,25-29,1956,0.0846944883746748
STAT,1839,23,15-19,1862,3.3374862800298404
SIM,1930,23,50-100,1953,1
STAT,1937,72,na,2009,3171.4704055019047
SIM,1878,41,45-49,1919,11
SIM,1939,26,na,1965,4960
STAT,1824,73,na,1897,734.9233822557308
SIM,1812,43,20-24,1855,2
SIM,1774,85,na,1859,154
STAT,1890,45,50-100,1935,0.34977823747466186
STAT,1936,47,25-29,1983,0.0607117911073425
STAT,1908,30,25-29,1938,10.162124273723254
STAT,1906,26,30-34,1932,42.52331850696511
SIM,1850,43,40-44,1893,8
STAT,1873,29,35-39,1902,11.289892415257938
STAT,1872,19,15-19,1891,6.840090749330285
STAT,1891,87,na,1978,722.5083274386911
STAT,1843,87,na,1930,176.77644491535145
STAT,1900,44,50-100,1944,0.11589320737159445
STAT,1852,18,35-39,1870,0.6220061298870622
STAT,1812,49,15-19,1861,8.971100580847966E-4
STAT,1817,43,30-34,1860,3.45282837427042
SIM,1948,37,40-44,1985,5
STAT,1943,42,50-100,1985,0.14942506511106185
STAT,1851,31,15-19,1882,0.11876522402352799
STAT,1901,21,25-29,1922,92.81591895936413
STAT,1881,45,20-24,1926,0.0134907187687165
STAT,1894,52,na,1946,3177.390814110765
STAT,1836,35,40-44,1871,4.994340644461699
STAT,1933,28,na,1961,5740.157129365382
STAT,1810,81,na,1891,307.9044422745926
STAT,1859,41,50-100,1900,0.9755956536036141
STAT,1899,24,50-100,1923,0.6407091408279909
STAT,1856,36,20-24,1892,0.6819599349294438
SIM,1959,30,45-49,1989,2
SIM,1979,17,15-19,1996,132
STAT,1820,51,40-44,1871,0.010546292461568523
SIM,1866,36,30-34,1902,3
STAT,1872,42,15-19,1914,0.01598315887324349
STAT,1826,33,50-100,1859,0.8200158540735853
STAT,1840,52,20-24,1892,5.888087487236008E-4
STAT,1842,43,40-44,1885,1.767980877701739
SIM,1877,37,20-24,1914,2
SIM,1832,26,35-39,1858,15
SIM,1844,35,40-44,1879,10
SIM,1925,27,45-49,1952,8
STAT,1940,36,35-39,1976,2.923486132946061
STAT,1816,53,40-44,1869,0.020205077685200898
STAT,1863,34,50-100,1897,0.9166767043765477
STAT,1832,36,35-39,1868,6.28257047747023
STAT,1979,30,40-44,2009,6.345535196529146
STAT,1858,27,40-44,1885,2.7607678109138263
STAT,1877,47,20-24,1924,0.014338181196087627
STAT,1873,23,15-19,1896,3.8758528330000175
SIM,1879,51,na,1930,2496
SIM,1838,40,50-100,1878,5
SIM,1856,26,20-24,1882,15
STAT,1857,15,30-34,1872,1.70379492376912
STAT,1897,29,20-24,1926,17.973812291763206
STAT,1903,26,50-100,1929,1.0551202771476753
SIM,1816,43,40-44,1859,7
SIM,1825,43,30-34,1868,1
SIM,1866,27,40-44,1893,3
STAT,1867,35,45-49,1902,2.168358282920273
STAT,1954,49,50-100,2003,0.33367174579892117
SIM,1867,40,30-34,1907,4
SIM,1979,28,15-19,2007,3
STAT,1965,15,30-34,1980,17.570451209906146
SIM,1808,55,na,1863,1560
SIM,1911,26,50-100,1937,2
STAT,1923,49,40-44,1972,0.21152436997253696
STAT,1826,28,35-39,1854,27.97264117102669
SIM,1980,21,40-44,2001,16
SIM,1910,68,na,1978,2453
STAT,1939,25,30-34,1964,45.516609090039786
STAT,1860,28,35-39,1888,9.005583606898007
SIM,1864,3,na,1867,3502
SIM,1891,7,na,1898,3656
SIM,1965,40,na,2005,5537
SIM,1977,26,15-19,2003,1
SIM,1857,72,na,1929,1166
SIM,1900,85,na,1985,1018
SIM,1865,15,30-34,1880,4
STAT,1843,33,30-34,1876,20.84334008227121
SIM,1833,38,na,1871,1689
STAT,1950,43,40-44,1993,0.3541366809528062
SIM,1903,50,na,1953,3401
SIM,1969,17,30-34,1986,24
SIM,1907,64,na,1971,3731
SIM,1798,76,na,1874,616
SIM,1794,62,na,1856,892
STAT,1934,20,25-29,1954,143.79557124486055
SIM,1946,28,50-100,1974,2
STAT,1934,61,na,1995,5444.139428865921
SIM,1842,33,40-44,1875,1
SIM,1851,33,30-34,1884,38
STAT,1861,41,25-29,1902,0.6188777584160049
STAT,1917,27,45-49,1944,2.090928853929547
SIM,1883,23,25-29,1906,81
STAT,1804,96,na,1900,3.7334700327638206
STAT,1848,26,20-24,1874,14.988461951686176
SIM,1867,27,35-39,1894,15
STAT,1880,27,25-29,1907,51.74484239973121
STAT,1944,44,na,1988,4777.672671274754
STAT,1954,38,50-100,1992,0.6164870822346143
STAT,1959,7,na,1966,5933.576578429292
SIM,1888,38,35-39,1926,20
STAT,1857,40,20-24,1897,0.1441831756283951
STAT,1870,18,na,1888,2883.729814540089
STAT,1849,107,na,1956,0.004648666936471377
STAT,1888,48,35-39,1936,0.10578484277110863
SIM,1882,19,25-29,1901,6
STAT,1983,17,na,2000,6009.012199515193
SIM,1919,65,na,1984,4557
SIM,1913,90,na,2003,1505
STAT,1938,28,50-100,1966,1.1380153760965679
STAT,1977,36,15-19,2013,0.030877484852697708
STAT,1978,18,20-24,1996,213.45883506020056
STAT,1841,39,40-44,1880,4.491287011111247
SIM,1872,44,30-34,1916,5
SIM,1940,16,30-34,1956,30
STAT,1849,30,20-24,1879,2.4769143640752205
STAT,1881,39,35-39,1920,7.793835727321599
STAT,1864,44,30-34,1908,1.1686751810463218
SIM,1885,6,na,1891,3431
STAT,1932,16,30-34,1948,18.67638329043696
STAT,1940,30,na,1970,4523.811168970447
STAT,1868,50,25-29,1918,0.003983705727861175
STAT,1986,11,na,1997,6460.3870721484545
STAT,1786,82,na,1868,276.8417008744831
STAT,1865,108,na,1973,0.041820609696225
STAT,1986,23,50-100,2009,1.0852205802597779
STAT,1841,17,20-24,1858,20.329179458285772
SIM,1881,29,35-39,1910,9
STAT,1854,18,45-49,1872,0.06328651566207281
STAT,1850,16,35-39,1866,0.694347508206836
STAT,1909,106,na,2015,1.401700467416669
SIM,1952,24,na,1976,4103
STAT,1897,3,na,1900,4079.492741486981
SIM,1898,22,50-100,1920,2
STAT,1874,16,20-24,1890,20.99676652389319
STAT,1989,18,40-44,2007,2.3113204903668585
SIM,1819,71,na,1890,284
STAT,1948,5,na,1953,5221.51196075576
SIM,1854,27,25-29,1881,7
STAT,1959,37,na,1996,5851.110936980356
STAT,1894,39,45-49,1933,2.9276506065417944
SIM,1956,38,na,1994,5399
STAT,1853,31,25-29,1884,10.61116454336458
STAT,1899,48,35-39,1947,0.1232908883252696
STAT,1895,27,20-24,1922,17.622891986452068
SIM,1858,29,35-39,1887,3
STAT,1931,25,50-100,1956,1.4846131601840589
STAT,1983,27,25-29,2010,107.91908233218648
STAT,1806,60,na,1866,997.0395377484291
STAT,1839,28,20-24,1867,11.636325129464483
SIM,1921,39,30-34,1960,2
SIM,1902,26,15-19,1928,2
STAT,1942,26,40-44,1968,5.649123171843226
SIM,1993,15,na,2008,6952
STAT,1879,49,20-24,1928,0.0141583086002097
STAT,1968,33,45-49,2001,2.310568580239108
SIM,1849,36,50-100,1885,3
STAT,1884,53,na,1937,2415.7341371755824
STAT,1919,24,15-19,1943,6.683212530807734
SIM,1849,35,40-44,1884,12
STAT,1859,27,35-39,1886,9.02341561624626
STAT,1800,82,na,1882,231.17172436754916
STAT,1888,67,na,1955,2150.466243204216
STAT,1899,43,40-44,1942,0.24517029292809217
SIM,1889,34,na,1923,3710
SIM,1885,20,na,1905,3356
STAT,1842,52,30-34,1894,0.004556251967729321
STAT,1962,34,20-24,1996,3.671691434133532
STAT,1840,31,15-19,1871,0.14059545487295882
SIM,1991,22,30-34,2013,62
STAT,1846,27,25-29,1873,52.90303606037176
STAT,1873,90,na,1963,204.6598641810838
STAT,1855,49,35-39,1904,0.11663812914719024
SIM,1901,33,45-49,1934,1
STAT,1849,42,15-19,1891,0.010690382211243406
SIM,1908,65,na,1973,2994
SIM,1805,63,na,1868,1171
STAT,1814,41,15-19,1855,0.04800431878828168
STAT,1951,34,45-49,1985,2.2014108462461284
SIM,1788,77,na,1865,100
STAT,1834,38,35-39,1872,7.9458011636533525
STAT,1844,45,40-44,1889,0.14545373746295698
SIM,1809,77,na,1886,492
STAT,1943,29,15-19,1972,0.8668923783004707
SIM,1892,17,na,1909,4013
STAT,1833,54,30-34,1887,0.004177751671544551
SIM,1842,38,35-39,1880,2
SIM,1882,16,20-24,1898,22
STAT,1886,48,25-29,1934,0.06923609745097321
STAT,1899,21,20-24,1920,109.2844528443934
STAT,1983,22,30-34,2005,47.07648838378807
STAT,1865,18,20-24,1883,18.91058944749565
STAT,1965,47,na,2012,5505.574803531559
STAT,1992,20,30-34,2012,47.79975131569036
STAT,1793,95,na,1888,2.6992306577973433
STAT,1894,31,35-39,1925,15.085296600417442
STAT,1973,25,30-34,1998,58.785660432187036
SIM,1881,54,na,1935,1677
STAT,1939,16,40-44,1955,1.6168763862410915
STAT,1843,31,40-44,1874,5.285795119704761
STAT,1919,61,na,1980,4235.17422758093
SIM,1913,17,na,1930,5033
SIM,1957,38,45-49,1995,2
STAT,1924,67,na,1991,4239.930106197499
STAT,1920,53,na,1973,4584.988100713374
SIM,1845,29,25-29,1874,5
SIM,1888,36,50-100,1924,2
STAT,1917,39,15-19,1956,0.022879255969661186
STAT,1970,3,na,1973,5682.788072525345
SIM,1927,24,15-19,1951,8
STAT,1843,36,35-39,1879,8.371402731198524
STAT,1888,47,20-24,1935,0.01620300274576807
STAT,1823,37,20-24,1860,1.4447321902698271
STAT,1936,44,20-24,1980,0.02012773207980641
STAT,1818,88,na,1906,60.74265955063181
SIM,1835,30,50-100,1865,2
STAT,1940,32,50-100,1972,0.9878318385240064
STAT,1964,33,50-100,1997,1.2242233257848927
SIM,1894,30,25-29,1924,32
STAT,1841,18,35-39,1859,0.6254948352497505
STAT,1949,30,35-39,1979,12.516405402046283
SIM,1917,23,50-100,1940,2
SIM,1847,28,20-24,1875,24
SIM,1921,47,na,1968,5118
STAT,1884,17,40-44,1901,0.20854990552684444
STAT,1916,16,na,1932,4741.109656290698
SIM,1880,41,50-100,1921,2
STAT,1837,29,25-29,1866,38.75314719603738
SIM,1903,18,na,1921,4072
SIM,1918,64,na,1982,3313
SIM,1860,92,na,1952,97
SIM,1863,49,35-39,1912,1
SIM,1981,27,40-44,2008,12
STAT,1949,38,45-49,1987,0.9417058058812648
SIM,1921,68,na,1989,4344
SIM,1861,31,25-29,1892,3
SIM,1914,50,na,1964,3845
STAT,1973,27,40-44,2000,6.986884772482676
SIM,1914,26,30-34,1940,111
SIM,1851,31,40-44,1882,11
STAT,1892,36,30-34,1928,7.745987593309357
STAT,1938,37,30-34,1975,2.138620519419641
STAT,1925,44,45-49,1969,0.2316865416183467
STAT,1952,40,35-39,1992,0.29021354898237717
STAT,1940,33,30-34,1973,18.81217472440772
SIM,1858,21,25-29,1879,90
STAT,1995,16,15-19,2011,75.83566926227157
SIM,1879,35,na,1914,2792
SIM,1950,26,40-44,1976,16
STAT,1896,43,15-19,1939,0.0014512048445187047
SIM,1837,95,na,1932,37
SIM,1833,81,na,1914,283
SIM,1820,34,40-44,1854,8
SIM,1955,23,15-19,1978,10
SIM,1957,30,35-39,1987,2
STAT,1910,49,30-34,1959,0.09552180461435768
SIM,1859,42,25-29,1901,1
SIM,1908,25,50-100,1933,2
STAT,1920,16,15-19,1936,58.88013032909294
STAT,1808,48,35-39,1856,0.6879222705705736
STAT,1965,45,35-39,2010,0.19412463339359778
STAT,1845,48,15-19,1893,2.6615493486396494E-4
STAT,1890,37,35-39,1927,9.973669438958932
STAT,1828,28,45-49,1856,1.6124252848224596
STAT,1947,23,15-19,1970,6.940490754567519
SIM,1864,36,20-24,1900,2
SIM,1885,32,25-29,1917,2
STAT,1847,39,35-39,1886,5.530561633067142
STAT,1821,42,45-49,1863,2.8872626464368
STAT,1882,17,30-34,1899,1.7966335468096675
SIM,1891,30,20-24,1921,9
SIM,1990,15,15-19,2005,121
STAT,1966,35,25-29,2001,1.4646986432785687
STAT,1887,17,45-49,1904,0.08448309893597385
STAT,1893,15,40-44,1908,0.26804369266146616
STAT,1817,41,40-44,1858,7.120928953229608
STAT,1992,21,na,2013,6071.141684357156
STAT,1832,35,20-24,1867,0.6920799387445776
STAT,1882,26,20-24,1908,13.269248705952
SIM,1924,36,40-44,1960,7
STAT,1866,53,30-34,1919,0.006264982747015884
STAT,1838,19,15-19,1857,6.711629289352169
STAT,1825,74,na,1899,784.9848232887165
STAT,1975,20,35-39,1995,14.392743880669325
STAT,1911,18,15-19,1929,10.462080822956871
STAT,1817,46,35-39,1863,0.40544518603349433
STAT,1898,82,na,1980,1438.607353955011
STAT,1941,17,35-39,1958,4.9891514390894445
STAT,1806,52,20-24,1858,0.0025974694704316583
SIM,1875,69,na,1944,1859
SIM,1974,38,40-44,2012,4
STAT,1901,48,15-19,1949,3.601491757412559E-4
SIM,1969,34,50-100,2003,3
STAT,1868,36,na,1904,2624.804022036969
SIM,1852,37,50-100,1889,1
STAT,1868,41,35-39,1909,2.0168563861670097
STAT,1873,30,15-19,1903,0.16917500776322617
SIM,1892,17,40-44,1909,1
SIM,1896,21,45-49,1917,1
SIM,1867,45,50-100,1912,1
SIM,1846,19,15-19,1865,5
STAT,1940,71,na,2011,3416.8789949687243
SIM,1974,30,30-34,2004,4
STAT,1877,13,na,1890,3095.354720573336
STAT,1964,27,30-34,1991,57.19878645543585
SIM,1820,37,45-49,1857,5
SIM,1825,41,40-44,1866,3
SIM,1859,31,50-100,1890,1
SIM,1880,17,25-29,1897,27
STAT,1921,28,25-29,1949,84.3281321000506
STAT,1955,44,na,1999,5893.346374703723
SIM,1881,38,25-29,1919,1
STAT,1867,37,35-39,1904,7.620991036800616
SIM,1959,41,45-49,2000,1
STAT,1842,46,45-49,1888,0.18398037098482722
SIM,1972,27,30-34,1999,61
SIM,1875,37,35-39,1912,21
STAT,1997,6,na,2003,6624.743163523542
SIM,1939,42,na,1981,4917
STAT,1916,36,40-44,1952,1.7778500527753691
SIM,1813,46,50-100,1859,1
STAT,1872,17,25-29,1889,6.58821749188515
SIM,1851,36,35-39,1887,6
SIM,1994,18,15-19,2012,1
SIM,1902,33,na,1935,4038
STAT,1868,49,45-49,1917,0.2562057071453666
STAT,1873,38,25-29,1911,3.376274857145117
SIM,1868,72,na,1940,1744
SIM,1910,84,na,1994,350
SIM,1843,37,na,1880,1920
STAT,1977,31,45-49,2008,2.5025339442847847
STAT,1856,35,na,1891,2094.0184521940832
STAT,1852,21,na,1873,2412.0607144584637
SIM,1854,40,45-49,1894,5
SIM,1847,73,na,1920,1301
SIM,1923,24,30-34,1947,4
STAT,1966,42,25-29,2008,0.10696967873387585
STAT,1892,43,30-34,1935,1.6509070494212725
STAT,1887,2,na,1889,3624.2129582027383
STAT,1870,45,45-49,1915,0.27117976704048286
SIM,1850,77,na,1927,168
STAT,1827,41,25-29,1868,0.8725432144618087
SIM,1871,76,na,1947,407
SIM,1875,32,40-44,1907,16
SIM,1962,48,na,2010,5380
SIM,1924,90,na,2014,132
STAT,1893,27,35-39,1920,14.075070800239267
STAT,1915,24,30-34,1939,34.07762579591058
SIM,1822,38,na,1860,1688
SIM,1929,0,na,1929,5862
SIM,1890,26,20-24,1916,4
STAT,1910,15,40-44,1925,0.32166369294686076
SIM,1868,51,na,1919,2874
STAT,1864,47,35-39,1911,0.14358926498062902
STAT,1877,32,25-29,1909,12.295682369147933
SIM,1918,30,35-39,1948,21
SIM,1907,80,na,1987,1795
STAT,1883,30,20-24,1913,3.076535207818059
STAT,1986,18,15-19,2004,74.60411229699092
SIM,1855,39,35-39,1894,7
SIM,1872,47,35-39,1919,1
SIM,1853,30,50-100,1883,2
SIM,1939,18,35-39,1957,6
SIM,1822,59,na,1881,1209
SIM,1926,25,50-100,1951,1
STAT,1900,39,20-24,1939,0.263753542096778
STAT,1981,5,na,1986,6344.808795585452
STAT,1888,21,45-49,1909,0.9488246945192691
STAT,1867,28,45-49,1895,1.1921276535113692
STAT,1966,38,40-44,2004,2.22081708873551
SIM,1871,55,na,1926,1738
SIM,1835,41,25-29,1876,4
STAT,1821,60,na,1881,1255.4307001746668
STAT,1836,74,na,1910,1009.9828388560932
SIM,1965,37,25-29,2002,1
SIM,1819,39,25-29,1858,3
STAT,1831,45,30-34,1876,0.09201280158721598
SIM,1838,20,45-49,1858,1
SIM,2005,2,na,2007,6478
STAT,1846,8,na,1854,3189.0
SIM,1889,50,na,1939,3461
SIM,1840,35,20-24,1875,2
STAT,1876,19,35-39,1895,0.6510879276267539
SIM,1959,48,50-100,2007,1
STAT,1877,54,45-49,1931,0.016942278024658024
STAT,1956,21,15-19,1977,8.158456011393804
STAT,1933,19,50-100,1952,0.5759411170339949
STAT,1846,40,45-49,1886,1.6065733622480836
SIM,1927,22,50-100,1949,1
SIM,1819,36,20-24,1855,1
STAT,1912,28,50-100,1940,1.129072696998339
STAT,1912,49,40-44,1961,0.17400384437462277
STAT,1834,35,30-34,1869,6.1767559884229986
SIM,1965,33,25-29,1998,7
STAT,1968,35,35-39,2003,3.5980912657951176
STAT,1830,26,50-100,1856,0.8453433009224715
STAT,1860,16,40-44,1876,0.19736504102932684
SIM,1875,21,na,1896,3393
STAT,1951,31,40-44,1982,5.484945525479959
STAT,1983,24,20-24,2007,182.00657052506378
SIM,1864,27,30-34,1891,28
STAT,1962,27,20-24,1989,27.108348668438264
STAT,1819,46,45-49,1865,0.4610447092583482
STAT,1957,33,25-29,1990,14.326149251639919
STAT,1894,36,40-44,1930,6.525453960207353
STAT,1952,56,na,2008,5087.815023585024
SIM,1860,55,na,1915,2175
STAT,1838,22,na,1860,2402.8347875344375
STAT,1814,74,na,1888,714.0228997795617
STAT,1864,53,20-24,1917,7.481740542030294E-4
STAT,1922,41,15-19,1963,0.002036233979571706
SIM,1833,59,na,1892,1335
STAT,1862,10,na,1872,2696.1965045644483
STAT,1957,16,50-100,1973,0.5702234621420934
STAT,1844,40,35-39,1884,1.5914697670466138
STAT,1994,16,45-49,2010,0.8321407018372584
STAT,1874,19,25-29,1893,6.659037072847125
SIM,1939,67,na,2006,3845
STAT,1942,29,45-49,1971,2.090828841537494
STAT,1930,28,50-100,1958,1.4600871075619355
SIM,1969,33,na,2002,5649
STAT,1775,82,na,1857,212.0826818301108
SIM,1842,35,30-34,1877,12
STAT,1848,108,na,1956,0.0023484765246547493
SIM,1959,30,na,1989,5904
SIM,1879,37,30-34,1916,13
STAT,1875,32,15-19,1907,0.16983473929972967
STAT,1941,42,25-29,1983,0.08823577231922086
SIM,1884,19,35-39,1903,2
SIM,1923,27,35-39,1950,51
STAT,1856,27,30-34,1883,22.974631548213274
STAT,1970,16,50-100,1986,0.5413908915480168
STAT,1868,46,40-44,1914,0.19035995440085474
STAT,1975,11,na,1986,5981.38113498437
SIM,1834,26,45-49,1860,3
STAT,1866,47,45-49,1913,0.2512633119165433
STAT,1810,60,na,1870,1319.4331498488607
STAT,1880,17,na,1897,3089.425567634566
SIM,1838,37,30-34,1875,2
STAT,1896,18,25-29,1914,8.615084594000463
STAT,1905,32,na,1937,4019.8137918068155
SIM,1884,20,15-19,1904,3
STAT,1912,46,25-29,1958,0.05903492540965004
STAT,1835,29,15-19,1864,0.3642108823227377
SIM,1883,32,15-19,1915,1
STAT,1841,15,30-34,1856,1.8494004061502523
STAT,1886,19,50-100,1905,0.05931853180808174
STAT,1834,26,40-44,1860,3.610582006325937
SIM,1865,40,20-24,1905,1
SIM,1900,69,na,1969,2564
SIM,1852,40,35-39,1892,3
SIM,1878,28,25-29,1906,2
SIM,1979,26,25-29,2005,107
SIM,1858,73,na,1931,1596
STAT,1925,41,40-44,1966,0.34986409031423765
STAT,1942,21,35-39,1963,11.399035116653124
SIM,1887,86,na,1973,1232
STAT,1938,59,na,1997,4092.6649993551005
SIM,1798,92,na,1890,12
SIM,1861,77,na,1938,178
STAT,1958,21,25-29,1979,140.51671414146014
STAT,1992,23,35-39,2015,15.643703702186295
SIM,1911,69,na,1980,3889
STAT,1858,48,50-100,1906,0.21833198301719564
STAT,1895,39,15-19,1934,0.08350593717886205
SIM,1832,37,na,1869,2173
SIM,1896,90,na,1986,776
STAT,1934,45,na,1979,5937.684587963734
STAT,1930,16,20-24,1946,202.80210317707176
STAT,1805,97,na,1902,2.207710817553268
SIM,1978,32,40-44,2010,1
STAT,1945,36,50-100,1981,0.5457998025517041
SIM,1858,26,30-34,1884,49
SIM,1929,64,na,1993,4386
STAT,1860,106,na,1966,0.08300178443926852
SIM,1966,21,25-29,1987,5
SIM,1976,30,40-44,2006,1
SIM,1866,48,50-100,1914,3
STAT,1954,6,na,1960,5608.473031081561
STAT,1844,48,45-49,1892,0.19491545429514143
STAT,1945,45,na,1990,4840.027432854854
SIM,1896,20,na,1916,3516
SIM,1944,20,35-39,1964,1
SIM,1901,30,40-44,1931,17
SIM,1811,75,na,1886,732
STAT,1785,81,na,1866,135.98467686762444
STAT,1836,58,na,1894,1799.7477767090998
STAT,1949,35,40-44,1984,2.073570723652051
STAT,1832,44,na,1876,1697.6598097460828
SIM,1842,26,40-44,1868,9
STAT,1855,46,30-34,1901,0.08260054292091057
STAT,1890,43,20-24,1933,0.22232773225102392
STAT,1936,20,35-39,1956,10.402168956473758
SIM,1882,39,na,1921,3275
SIM,1797,81,na,1878,3
STAT,1981,27,15-19,2008,1.1441306272704825
STAT,1876,16,30-34,1892,1.9061225433497566
STAT,1897,27,30-34,1924,38.859041138371545
STAT,1871,51,35-39,1922,0.00993158039096528
STAT,1852,16,45-49,1868,0.07492839211249583
STAT,1965,22,na,1987,5278.750053636768
SIM,1889,13,na,1902,4117
STAT,1931,20,20-24,1951,167.4629876759012
STAT,1867,25,40-44,1892,3.2495831167170253
STAT,1940,30,15-19,1970,0.15370762919346312
SIM,1933,44,45-49,1977,1
SIM,1856,27,35-39,1883,21
SIM,1924,39,45-49,1963,4
STAT,1955,21,45-49,1976,1.7300456787179244
SIM,1826,41,na,1867,1882
SIM,1993,4,na,1997,6963
STAT,1916,31,35-39,1947,10.9336984007789
STAT,1832,38,25-29,1870,2.5024563926107337
STAT,1831,54,20-24,1885,5.781571148602042E-4
STAT,1892,39,35-39,1931,10.127550885212509
STAT,1867,34,30-34,1901,18.65157711387991
STAT,1871,23,40-44,1894,2.385083115634754
STAT,1811,82,na,1893,240.24029646904165
STAT,1899,67,na,1966,2814.4975699539973
STAT,1925,22,25-29,1947,127.55668726420664
STAT,1916,39,45-49,1955,0.7976339756725178
STAT,1970,31,35-39,2001,13.464489381361442
STAT,1981,22,20-24,2003,180.02944780405372
SIM,1897,26,30-34,1923,50
SIM,1961,12,na,1973,5666
SIM,1875,34,30-34,1909,51
SIM,1933,22,25-29,1955,2
SIM,1869,27,45-49,1896,1
SIM,1840,38,25-29,1878,5
STAT,1914,43,30-34,1957,0.14603390052583615
STAT,1895,53,na,1948,3182.625542125603
STAT,1834,106,na,1940,0.01108051336368707
STAT,1889,26,30-34,1915,35.94593180193651
STAT,1980,22,50-100,2002,1.0576479300063246
SIM,1878,50,na,1928,2579
SIM,1809,56,na,1865,1424
STAT,1944,20,30-34,1964,35.838915389201446
SIM,1839,37,50-100,1876,1
SIM,1924,31,35-39,1955,9
SIM,1952,49,na,2001,4542
SIM,1825,30,na,1855,1889
SIM,1904,26,25-29,1930,77
STAT,1837,26,20-24,1863,10.982272428830747
STAT,1944,39,50-100,1983,0.5360825610636457
SIM,1816,45,30-34,1861,1
STAT,1811,50,25-29,1861,0.010973467234665158
STAT,1913,83,na,1996,1666.5206343658617
STAT,1898,17,20-24,1915,27.65084165292947
STAT,1915,27,35-39,1942,17.675666308260887
SIM,1929,24,25-29,1953,255
STAT,1893,24,30-34,1917,25.82044885407943
SIM,1906,20,15-19,1926,10
SIM,1900,45,45-49,1945,1
SIM,1929,27,na,1956,5272
STAT,1831,48,35-39,1879,0.12805860128039667
STAT,1824,102,na,1926,0.18140237622180153
SIM,1922,43,30-34,1965,1
SIM,1845,26,20-24,1871,11
STAT,1922,16,25-29,1938,57.995094816503894
STAT,1914,40,15-19,1954,0.0017692190871166499
STAT,1829,88,na,1917,100.57111936967848
STAT,1845,33,40-44,1878,3.4387553722073165
STAT,1853,46,20-24,1899,0.011981349302377554
STAT,1905,30,20-24,1935,4.551271404179878
STAT,1846,36,na,1882,2569.9638621132003
SIM,1987,26,20-24,2013,63
STAT,1884,90,na,1974,325.8591509150503
STAT,1806,48,25-29,1854,0.20887109431524675
STAT,1877,51,40-44,1928,0.0126983307700216
STAT,1913,39,30-34,1952,2.055888921983168
STAT,1926,31,na,1957,5279.619377719137
SIM,1976,35,35-39,2011,2
SIM,1910,47,na,1957,3389
STAT,1847,48,25-29,1895,0.04376368077898698
STAT,1936,71,na,2007,3207.6329663905453
SIM,1931,46,na,1977,6049
STAT,1861,19,15-19,1880,6.467329671266374
STAT,1997,16,25-29,2013,73.04813990422988
STAT,1872,30,45-49,1902,2.0369880397719236
STAT,1888,30,35-39,1918,13.848549466711498
STAT,1847,40,15-19,1887,0.010962629240561985
SIM,1912,26,20-24,1938,19
STAT,1892,34,40-44,1926,6.219070657841602
STAT,1979,26,20-24,2005,29.14363772732793
STAT,1869,49,15-19,1918,4.377090322803111E-4
SIM,1928,42,na,1970,5671
STAT,1863,91,na,1954,58.47573074532326
STAT,1830,36,25-29,1866,2.957303786901032
STAT,1853,49,25-29,1902,0.05615027807877108
SIM,1974,33,35-39,2007,4
SIM,1907,32,25-29,1939,15
STAT,1870,42,40-44,1912,2.555904911156709
STAT,1893,18,45-49,1911,0.09503749663603896
SIM,1963,30,na,1993,6519
STAT,1856,17,50-100,1873,0.05100416044407331
STAT,1904,26,20-24,1930,19.508304668849558
SIM,1913,30,20-24,1943,5
SIM,1868,8,na,1876,3422
SIM,1896,30,35-39,1926,3
STAT,1972,31,45-49,2003,2.3714306030650927
STAT,1868,53,40-44,1921,0.011485298942774188
SIM,1941,29,na,1970,3703
STAT,1923,34,30-34,1957,20.80952418593986
STAT,1880,46,50-100,1926,0.3012810184154682
STAT,1973,16,40-44,1989,2.088229947322455
STAT,1975,4,na,1979,5987.306074863783
SIM,1893,18,na,1911,3685
STAT,1884,36,35-39,1920,8.10350930250542
STAT,1860,19,45-49,1879,0.06924930510625497
STAT,1864,32,15-19,1896,0.146742788053609
STAT,1766,116,na,1882,2.903613388433665E-4
SIM,1874,41,25-29,1915,1
STAT,1979,19,na,1998,5844.741558772208
STAT,1913,18,25-29,1931,10.203722695277314
STAT,1835,21,40-44,1856,1.9473787706184278
STAT,1885,15,45-49,1900,0.07554269959517383
STAT,1856,51,na,1907,1904.825408210776
STAT,1941,29,40-44,1970,5.560351923602417
STAT,1824,35,25-29,1859,4.633140409524579
STAT,1855,104,na,1959,0.12137362908168194
SIM,1861,72,na,1933,825
STAT,1819,53,45-49,1872,0.026346038606419642
STAT,1953,24,15-19,1977,7.450947243693447
STAT,1969,27,30-34,1996,56.73085710981321
STAT,1796,81,na,1877,243.3675078904642
STAT,1869,40,50-100,1909,1.1926130924328027
SIM,1919,26,30-34,1945,2
SIM,1809,93,na,1902,25
STAT,1968,42,35-39,2010,0.30164053749130915
SIM,1834,23,40-44,1857,1
SIM,1921,18,25-29,1939,71
STAT,1814,53,50-100,1867,0.03935080472732967
STAT,1935,37,50-100,1972,0.6778967319236794
STAT,1801,83,na,1884,156.9342037342895
STAT,1889,68,na,1957,2238.9975506977967
STAT,1966,48,na,2014,5492.804917027458
STAT,1927,59,na,1986,5003.352386785914
SIM,1832,35,25-29,1867,2
STAT,1851,20,na,1871,2054.178793118198
SIM,1888,33,na,1921,2783
STAT,1944,17,15-19,1961,56.36544783682599
STAT,1818,105,na,1923,0.012973258740592186
STAT,1875,30,25-29,1905,12.313471167294704
STAT,1971,19,25-29,1990,63.299113985928045
STAT,1920,94,na,2014,326.97883134880226
SIM,1883,30,25-29,1913,17
SIM,1892,36,35-39,1928,21
STAT,1912,24,50-100,1936,0.7543487486868442
SIM,1842,42,30-34,1884,2
SIM,1901,86,na,1987,1307
STAT,1866,41,25-29,1907,0.6899989114261791
STAT,1938,28,40-44,1966,5.329120432883058
SIM,1983,29,40-44,2012,1
SIM,1886,28,20-24,1914,23
SIM,1945,31,50-100,1976,2
SIM,1961,24,15-19,1985,15
SIM,1918,27,na,1945,3713
SIM,1851,78,na,1929,1178
SIM,1853,29,20-24,1882,12
STAT,1924,41,50-100,1965,0.16145280340212861
STAT,1845,21,25-29,1866,48.234993963832245
SIM,1928,47,na,1975,5640
STAT,1827,30,50-100,1857,1.7558434249381387
SIM,1793,61,na,1854,1415
STAT,1838,42,15-19,1880,0.013992157417296723
STAT,1834,42,30-34,1876,1.264822678608801
STAT,1867,32,40-44,1899,4.672761844596226
SIM,1930,51,na,1981,5854
STAT,1914,36,30-34,1950,2.111168885918104
STAT,1946,47,30-34,1993,0.1186867480343775
STAT,1934,29,na,1963,5812.9291171679815
STAT,1851,41,50-100,1892,0.841551553129461
SIM,1948,31,20-24,1979,7
STAT,1878,28,20-24,1906,14.08611916757673
STAT,1909,29,15-19,1938,0.773906252454941
SIM,1981,24,15-19,2005,16
STAT,1845,29,20-24,1874,9.484477651826326
STAT,1860,112,na,1972,5.209844044787964E-4
STAT,1892,31,25-29,1923,14.875799112910045
STAT,1964,18,40-44,1982,2.032408653405042
SIM,1853,21,25-29,1874,73
SIM,1922,36,30-34,1958,9
SIM,1869,24,40-44,1893,3
STAT,1882,33,20-24,1915,3.034070325728119
STAT,1896,15,20-24,1911,27.14890844999993
STAT,1950,36,40-44,1986,2.106408080464609
STAT,1870,30,35-39,1900,11.614421877946894
SIM,1903,23,15-19,1926,8
STAT,1845,43,45-49,1888,1.013919283355946
STAT,1880,29,15-19,1909,0.5510210555063971
SIM,1853,43,45-49,1896,4
SIM,1979,23,20-24,2002,346
SIM,1956,52,na,2008,5211
STAT,1864,92,na,1956,48.78636439853042
SIM,1890,33,20-24,1923,5
SIM,1953,46,na,1999,5559
STAT,1902,39,30-34,1941,1.856901875069402
STAT,1871,30,40-44,1901,5.019121251031183
SIM,1910,39,30-34,1949,3
SIM,1827,39,20-24,1866,1
STAT,1866,107,na,1973,0.10329885792185128
STAT,1937,16,30-34,1953,13.725373555392821
STAT,1901,12,na,1913,4174.581421505476
SIM,1897,29,35-39,1926,22
STAT,1855,40,na,1895,1986.4675525292075
STAT,1973,37,50-100,2010,0.6456064224642715
STAT,1867,35,na,1902,2562.646940998536
STAT,1826,59,na,1885,1133.325002308697
STAT,1945,29,25-29,1974,83.25302719305562
STAT,1912,0,na,1912,5245.161755566649
STAT,1871,33,45-49,1904,1.9936792532500514
SIM,1959,32,35-39,1991,3
SIM,1955,26,40-44,1981,12
STAT,1867,53,35-39,1920,0.009127222928774756
SIM,1955,16,15-19,1971,116
SIM,1986,17,15-19,2003,74
STAT,1893,89,na,1982,565.6548829853934
SIM,1950,21,35-39,1971,1
SIM,1842,29,45-49,1871,3
SIM,1870,35,45-49,1905,8
SIM,1953,29,25-29,1982,187
STAT,1940,29,35-39,1969,17.656327481826125
STAT,1819,39,20-24,1858,1.8304153118633908
STAT,1874,70,na,1944,1657.6581429110115
SIM,1890,40,50-100,1930,5
STAT,2006,3,na,2009,7026.144686057844
STAT,1914,84,na,1998,1538.6379157138183
SIM,1783,83,na,1866,186
STAT,1851,37,35-39,1888,5.668853773038985
SIM,1821,74,na,1895,408
SIM,1977,22,na,1999,6212
STAT,1959,44,35-39,2003,0.3148536930827865
SIM,1974,21,20-24,1995,284
STAT,1889,29,35-39,1918,13.628164869509382
STAT,1834,29,45-49,1863,1.3096394178428348
SIM,1905,44,30-34,1949,1
STAT,1924,46,40-44,1970,0.21709340529184115
STAT,1860,35,35-39,1895,6.641063081637766
SIM,1938,41,na,1979,4056
SIM,1856,24,30-34,1880,27
STAT,1954,43,na,1997,5497.720943209007
SIM,1905,20,45-49,1925,1
SIM,1977,2,na,1979,6246
STAT,1894,43,40-44,1937,0.23004651361138026
STAT,1947,26,40-44,1973,6.088088058918268
STAT,1782,79,na,1861,364.14328691739263
STAT,1866,18,na,1884,2756.5836053711355
STAT,1864,109,na,1973,0.01622239002110018
STAT,1936,37,20-24,1973,0.2988347742730193
SIM,1955,38,35-39,1993,4
SIM,1878,25,20-24,1903,32
STAT,1850,25,25-29,1875,51.990047487865425
SIM,1862,36,50-100,1898,2
STAT,1794,96,na,1890,2.1491144561817057
STAT,1966,21,20-24,1987,160.8615462029825
STAT,1902,83,na,1985,1420.7776636692745
STAT,1876,51,35-39,1927,0.01031956564644823
STAT,1944,23,35-39,1967,11.729211092618323
SIM,1901,26,45-49,1927,1
STAT,1919,39,25-29,1958,1.217833208061062
STAT,1983,31,20-24,2014,4.061351035650685
STAT,1887,31,50-100,1918,1.1898441252875736
STAT,1904,21,15-19,1925,5.483711917394815
STAT,1891,40,20-24,1931,0.22880356200035495
SIM,1946,28,40-44,1974,11
SIM,1985,5,na,1990,6449
SIM,1926,27,15-19,1953,1
SIM,1970,27,20-24,1997,32
SIM,1916,23,25-29,1939,3
STAT,1947,16,15-19,1963,59.012915375007076
STAT,1841,26,na,1867,2406.1603075419775
STAT,1908,23,25-29,1931,97.82099561340762
STAT,1838,26,50-100,1864,0.7100829067495378
STAT,1999,15,20-24,2014,231.26465465302203
STAT,1896,21,40-44,1917,3.1859104387352275
STAT,1994,20,40-44,2014,5.621864149477739
STAT,1819,89,na,1908,69.9354340544535
STAT,1828,49,15-19,1877,3.5879006567498975E-4
STAT,1808,52,30-34,1860,0.02837275882443268
STAT,1917,27,na,1944,4533.966868933331
SIM,1931,34,30-34,1965,52
SIM,1980,21,50-100,2001,3
STAT,1979,29,25-29,2008,104.9352589322383
STAT,1828,60,na,1888,1306.9845785868285
STAT,1844,52,40-44,1896,0.008758687649435687
STAT,1858,34,40-44,1892,3.87085821284246
SIM,1827,31,25-29,1858,16
STAT,1814,58,na,1872,1575.8085920282806
SIM,1945,16,30-34,1961,32
STAT,1918,27,15-19,1945,0.866839040419666
STAT,1850,94,na,1944,20.574588568184726
STAT,1859,24,30-34,1883,16.746436485524498
SIM,1912,21,15-19,1933,5
STAT,1825,47,35-39,1872,0.19549966721865486
STAT,1894,15,na,1909,3764.244052130129
STAT,1847,45,20-24,1892,0.009325506132905023
SIM,1896,68,na,1964,2740
SIM,1899,36,45-49,1935,2
STAT,1818,50,35-39,1868,0.010641125598662609
SIM,1877,44,45-49,1921,7
STAT,1947,38,35-39,1985,3.236102762096946
STAT,1777,84,na,1861,78.11994175110266
SIM,1927,21,35-39,1948,29
SIM,1922,39,35-39,1961,3
STAT,1875,86,na,1961,424.9929377745053
STAT,1981,21,na,2002,5914.385360208429
STAT,1977,22,35-39,1999,14.730713812130519
SIM,1813,77,na,1890,396
STAT,1899,46,na,1945,3567.919406830323
SIM,1864,39,25-29,1903,5
SIM,1913,33,25-29,1946,1
STAT,1824,32,20-24,1856,6.408522487076255
STAT,1899,33,15-19,1932,0.22420640202734723
STAT,1959,41,40-44,2000,0.39296236891064834
STAT,1913,15,20-24,1928,32.15521917175216
SIM,1921,37,40-44,1958,3
STAT,1818,40,na,1858,1346.6726295511232
SIM,1988,24,25-29,2012,5
SIM,1857,40,25-29,1897,1
STAT,1920,88,na,2008,1052.7439735412916
STAT,1862,110,na,1972,0.004944924451283036
SIM,1892,33,30-34,1925,4
STAT,1885,38,na,1923,2698.5356809985396
SIM,1861,56,na,1917,1487
SIM,1854,24,20-24,1878,2
STAT,1914,39,35-39,1953,2.760263951091394
SIM,1872,31,50-100,1903,1
STAT,1906,33,na,1939,4032.9224991529004
STAT,1973,19,45-49,1992,0.745087945399168
STAT,1854,39,15-19,1893,0.045288509215816834
STAT,1873,26,30-34,1899,29.778455624500538
STAT,1905,33,25-29,1938,9.78221704022029
SIM,1949,2,na,1951,5979
SIM,1868,35,na,1903,3126
SIM,1914,21,25-29,1935,5
STAT,1964,22,25-29,1986,134.7043763367409
STAT,1874,54,50-100,1928,0.017352428143424466
SIM,1945,11,na,1956,4776
STAT,1884,33,30-34,1917,19.823924700432286
SIM,1941,45,na,1986,3929
STAT,1816,107,na,1923,0.0023289729943120844
SIM,1828,34,20-24,1862,5
STAT,1983,32,50-100,2015,1.375862267526354
STAT,1849,40,25-29,1889,0.5064142065546743
SIM,1843,43,na,1886,1777
SIM,1972,22,25-29,1994,286
STAT,1988,15,45-49,2003,0.8249506606377783
SIM,1878,31,40-44,1909,8
STAT,1870,39,na,1909,2653.4746510797368
STAT,1854,15,40-44,1869,0.180370701786579
STAT,1924,16,35-39,1940,5.7792447695619344
STAT,1958,29,20-24,1987,27.760222796066305
SIM,1868,29,na,1897,3198
SIM,1848,74,na,1922,554
SIM,1963,14,na,1977,6575
SIM,1932,16,35-39,1948,22
STAT,1906,32,50-100,1938,0.885372278054594
STAT,1908,20,20-24,1928,118.82708459410756
STAT,1852,91,na,1943,54.63398003212332
STAT,1878,51,45-49,1929,0.017570481738984695
SIM,1837,43,50-100,1880,3
STAT,1790,66,na,1856,789.8467655600001
STAT,1868,31,30-34,1899,19.43788157572828
STAT,1906,21,25-29,1927,96.62782935430857
SIM,1966,29,20-24,1995,56
STAT,1832,42,20-24,1874,0.13495294721503046
SIM,1946,32,25-29,1978,23
STAT,1893,40,30-34,1933,1.693964327963329
SIM,1830,28,15-19,1858,2
SIM,1916,20,20-24,1936,131
STAT,1846,24,20-24,1870,86.64321277770412
STAT,1825,101,na,1926,0.4036181936805161
STAT,1984,22,25-29,2006,151.89961303811288
SIM,1948,34,25-29,1982,31
SIM,1829,60,na,1889,1148
SIM,1850,40,25-29,1890,1
STAT,1821,38,na,1859,1725.5943320656936
SIM,1833,75,na,1908,622
STAT,1942,45,50-100,1987,0.285114123311379
SIM,1864,8,na,1872,3142
STAT,1816,50,25-29,1866,0.007217230053897344
SIM,1898,30,45-49,1928,7
STAT,1913,37,40-44,1950,1.7057932858979532
SIM,1876,86,na,1962,445
SIM,1903,13,na,1916,4227
STAT,1895,34,45-49,1929,2.59712811275865
STAT,1836,37,na,1873,2392.460104617207
STAT,1903,38,20-24,1941,0.2721367030132602
STAT,1934,39,na,1973,5981.698465765797
SIM,1886,20,25-29,1906,78
STAT,1923,37,25-29,1960,1.3161107704314365
STAT,1862,35,45-49,1897,1.959960176854121
SIM,1937,24,na,1961,3768
SIM,1900,38,45-49,1938,3
STAT,1938,32,25-29,1970,10.730393448552668
STAT,1931,23,25-29,1954,137.85911047812408
SIM,1921,88,na,2009,1552
STAT,1865,19,50-100,1884,0.05195063272612492
STAT,1893,22,40-44,1915,3.0396905837185586
SIM,1992,22,25-29,2014,11
STAT,1901,41,50-100,1942,0.11912529378602636
SIM,1928,27,25-29,1955,125
SIM,1921,15,20-24,1936,322
STAT,1835,73,na,1908,740.2715002388701
SIM,1991,17,50-100,2008,1
SIM,1881,70,na,1951,1044
SIM,1892,38,na,1930,3759
STAT,1867,50,30-34,1917,0.006505972246256286
STAT,1845,40,40-44,1885,1.5835102546662099
STAT,1940,26,30-34,1966,46.14613314280795
STAT,1954,27,na,1981,5367.606104789051
SIM,1891,53,na,1944,2982
STAT,1980,26,50-100,2006,1.6022474719199002
STAT,1910,37,15-19,1947,0.021217165916655553
STAT,1870,88,na,1958,212.94565846175888
SIM,1925,17,40-44,1942,5
STAT,1897,31,15-19,1928,0.2206521520033109
STAT,1901,33,40-44,1934,6.980644203011907
STAT,1927,34,15-19,1961,0.18215165262230784
STAT,1769,97,na,1866,1.3424029790315557
STAT,1877,30,35-39,1907,12.254704555212962
STAT,1847,36,30-34,1883,4.299242956475303
SIM,1885,30,35-39,1915,22
STAT,1851,54,50-100,1905,0.011647059092121709
STAT,1925,37,45-49,1962,0.9439520372315704
STAT,1872,20,40-44,1892,2.4291298878717202
STAT,1876,20,15-19,1896,3.959148328382499
STAT,1851,10,na,1861,2330.4605582791096
STAT,1905,42,15-19,1947,0.0015998384516376781
SIM,1825,40,na,1865,1748
STAT,1862,37,50-100,1899,1.1957384697897162
STAT,1917,17,40-44,1934,0.3473678244887821
SIM,1853,40,40-44,1893,4
STAT,1947,29,45-49,1976,2.2532966119152604
STAT,1825,44,30-34,1869,1.6373761227177368
SIM,1897,85,na,1982,942
STAT,1851,34,30-34,1885,14.11446192695924
SIM,1836,25,40-44,1861,6
SIM,1867,41,50-100,1908,5
STAT,1842,43,na,1885,1816.6858988772287
SIM,1918,80,na,1998,2253
SIM,1855,36,30-34,1891,5
STAT,1915,39,40-44,1954,1.727966504698634
STAT,1821,44,na,1865,1636.846324422176
SIM,1863,41,na,1904,2329
SIM,1923,39,40-44,1962,5
SIM,1851,21,15-19,1872,7
STAT,1762,103,na,1865,0.06796383014217414
STAT,1842,40,25-29,1882,0.5245275063731465
SIM,1933,37,45-49,1970,1
SIM,1871,39,na,1910,2003
STAT,1919,48,15-19,1967,4.597071242037489E-4
STAT,1951,27,45-49,1978,2.3844108614766
STAT,1845,34,50-100,1879,0.7190225898658199
STAT,1892,98,na,1990,59.46981436715526
SIM,1973,38,na,2011,5381
STAT,1968,31,35-39,1999,13.43450328478281
SIM,1979,9,na,1988,6473
SIM,1849,42,40-44,1891,3
SIM,1878,71,na,1949,1286
SIM,1888,28,30-34,1916,71
SIM,1901,23,40-44,1924,3
STAT,1891,43,25-29,1934,0.9093038476959259
STAT,1825,95,na,1920,9.404310033161305
STAT,1889,38,50-100,1927,1.7378862423992782
STAT,1847,74,na,1921,853.9316477160708
SIM,1833,44,30-34,1877,3
STAT,1858,46,35-39,1904,0.12639789104618726
SIM,1913,33,na,1946,4749
SIM,1931,67,na,1998,4801
STAT,1843,21,15-19,1864,4.184999037501424
STAT,1884,47,na,1931,2553.3560332749953
SIM,1928,63,na,1991,4952
STAT,1975,29,40-44,2004,7.119912245963575
STAT,1850,22,20-24,1872,85.14794390389119
SIM,1899,23,15-19,1922,13
STAT,1819,50,40-44,1869,0.02028838486828686
STAT,1982,32,na,2014,6260.446491033634
STAT,1858,37,45-49,1895,1.7947081693725295
SIM,1888,44,20-24,1932,1
SIM,1926,31,45-49,1957,5
STAT,1906,95,na,2001,199.70615289813765
STAT,1843,52,35-39,1895,0.008592180730058553
SIM,1859,68,na,1927,1167
STAT,1882,29,25-29,1911,47.341998274287384
SIM,1980,31,45-49,2011,5
SIM,1870,4,na,1874,3545
SIM,1820,41,40-44,1861,5
STAT,1873,35,20-24,1908,0.9170651332447863
SIM,1974,24,25-29,1998,303
STAT,1903,105,na,2008,2.478131142494761
SIM,1908,49,na,1957,3556
STAT,1962,18,30-34,1980,18.0175530661023
SIM,1949,31,na,1980,5866
SIM,1849,20,20-24,1869,87
STAT,1871,19,20-24,1890,20.24543679779293
SIM,1970,18,30-34,1988,46
STAT,1836,45,45-49,1881,0.2306849574558869
STAT,1915,15,40-44,1930,0.33947025372942613
STAT,1918,31,45-49,1949,1.9372014182775168
STAT,1890,22,15-19,1912,4.652020423986264
STAT,1919,21,35-39,1940,11.93199014021721
SIM,1890,29,25-29,1919,6
STAT,1966,24,25-29,1990,133.4927747426463
STAT,1825,36,50-100,1861,2.095225141629654
STAT,1948,47,40-44,1995,0.216580988230857
SIM,1836,73,na,1909,465
STAT,1957,30,20-24,1987,3.7873443791249626
STAT,1853,86,na,1939,220.90414201064118
SIM,1918,38,30-34,1956,2
SIM,1843,27,na,1870,2130
SIM,1955,51,na,2006,6310
STAT,1907,29,40-44,1936,5.007532123946221
STAT,1846,17,20-24,1863,23.022964071777345
STAT,1899,31,25-29,1930,16.26045893747241
SIM,1899,29,45-49,1928,1
STAT,1916,26,na,1942,4485.869175024716
SIM,1858,67,na,1925,1848
SIM,1908,25,40-44,1933,8
SIM,1873,20,15-19,1893,5
STAT,1773,106,na,1879,0.02400563300357495
STAT,1834,33,40-44,1867,5.017065641395826
STAT,1947,35,30-34,1982,2.4451572125317735
STAT,1946,30,45-49,1976,2.0553964774975935
STAT,1958,26,40-44,1984,7.0986428834659545
SIM,1838,44,30-34,1882,1
SIM,1877,41,40-44,1918,2
STAT,1839,30,15-19,1869,0.14189770530083973
SIM,1943,37,50-100,1980,1
SIM,1923,11,na,1934,5668
STAT,1864,49,na,1913,2269.9245251373873
STAT,1902,48,20-24,1950,0.010899031042029389
SIM,1915,29,40-44,1944,14
SIM,1966,26,40-44,1992,17
STAT,1929,31,20-24,1960,3.577799060320832
STAT,1883,48,35-39,1931,0.15608672850918479
SIM,1920,24,50-100,1944,1
SIM,1921,27,15-19,1948,2
SIM,1883,56,na,1939,2124
SIM,1957,28,40-44,1985,19
STAT,1842,19,50-100,1861,0.047843761348055736
SIM,1854,30,40-44,1884,2
STAT,1913,27,15-19,1940,0.8122054032481187
STAT,1941,15,na,1956,4378.685502698975
STAT,1797,82,na,1879,206.11077965257917
STAT,1944,21,45-49,1965,1.4025294686133478
STAT,1862,32,40-44,1894,4.223668755975945
STAT,1876,0,na,1876,4368.215547291123
SIM,1955,35,30-34,1990,2
STAT,1919,36,30-34,1955,2.2611539843580863
STAT,1865,53,25-29,1918,0.003628925341155333
STAT,1878,20,25-29,1898,69.389982510601
SIM,1808,92,na,1900,17
SIM,1849,15,na,1864,3063
SIM,1918,20,30-34,1938,37
STAT,1990,19,40-44,2009,2.310120886229315
SIM,1945,19,25-29,1964,57
STAT,1968,21,30-34,1989,41.57864470951328
STAT,1892,46,35-39,1938,0.11455163217460423
SIM,1918,89,na,2007,999
SIM,1944,28,30-34,1972,64
STAT,1826,75,na,1901,566.8275357737311
STAT,1815,69,na,1884,952.408856840331
STAT,1817,49,15-19,1866,0.0011097116299827966
STAT,1867,46,50-100,1913,0.2653824945536996
STAT,1869,37,20-24,1906,0.8615071227101564
STAT,1857,18,35-39,1875,0.5762488867193122
STAT,1924,49,45-49,1973,0.2967723381697723
STAT,1867,19,na,1886,2749.321231377856
SIM,1929,39,45-49,1968,1
STAT,1916,11,na,1927,4843.267942991181
SIM,1831,47,25-29,1878,1
STAT,1945,38,15-19,1983,0.02491591189896294
STAT,1856,46,25-29,1902,0.05085786413194155
STAT,1972,20,45-49,1992,1.669208014242751
STAT,1823,47,25-29,1870,0.05691206075097783
SIM,1858,57,na,1915,2300
STAT,1981,34,15-19,2015,0.21110434138461087
SIM,1927,36,30-34,1963,2
SIM,1858,52,na,1910,2405
SIM,1811,81,na,1892,477
SIM,1906,63,na,1969,2963
SIM,1911,48,na,1959,4598
STAT,1837,19,20-24,1856,19.252136198712567
STAT,1863,16,45-49,1879,0.07566384588872054
STAT,1930,52,na,1982,5490.093196312046
SIM,1983,12,na,1995,7024
STAT,1937,31,50-100,1968,0.9450584040197879
STAT,1808,62,na,1870,1262.9048824931565
STAT,1937,19,25-29,1956,48.53411649754912
STAT,1936,28,30-34,1964,43.27991470065991
STAT,1979,33,20-24,2012,3.9482302486672403
STAT,1929,36,15-19,1965,0.028478991259629494
STAT,1821,38,25-29,1859,6.131968974055481
SIM,1988,17,25-29,2005,170
STAT,1864,31,50-100,1895,0.947995855810376
STAT,1930,29,40-44,1959,6.833837136325099
SIM,1845,19,20-24,1864,12
SIM,1934,15,40-44,1949,3
SIM,1829,46,30-34,1875,1
STAT,1914,27,40-44,1941,5.42523041957654
SIM,1976,21,30-34,1997,59
STAT,1891,23,na,1914,3362.888288625054
SIM,1929,21,45-49,1950,6
STAT,1865,20,15-19,1885,3.527356694531827
SIM,1935,32,50-100,1967,4
STAT,1894,21,30-34,1915,26.505000380562823
STAT,1860,23,40-44,1883,1.9836295038156126
STAT,1935,49,20-24,1984,0.017909070027617227
STAT,1925,34,40-44,1959,5.354285458005672
STAT,1975,18,40-44,1993,2.1288194122455217
STAT,1901,36,45-49,1937,0.6988823300025502
STAT,1971,16,30-34,1987,17.820940503535855
STAT,1860,56,na,1916,1897.0812464478727
STAT,1913,18,35-39,1931,0.9880261581744335
SIM,1974,22,35-39,1996,27
SIM,1866,39,35-39,1905,4
STAT,1946,38,40-44,1984,1.9720856140281342
STAT,1969,27,20-24,1996,26.4291135229184
SIM,1994,15,35-39,2009,17
SIM,1881,28,20-24,1909,24
SIM,1919,29,25-29,1948,171
STAT,1878,35,20-24,1913,0.937659945548573
STAT,1986,27,50-100,2013,1.6438203658902304
SIM,1844,42,40-44,1886,4
SIM,1920,39,25-29,1959,1
STAT,1986,15,35-39,2001,6.903770046327587
SIM,1951,54,na,2005,6061
STAT,1922,23,50-100,1945,0.8677408231922732
SIM,1887,32,45-49,1919,5
SIM,1954,38,40-44,1992,1
STAT,1903,78,na,1981,2057.5858651848002
SIM,1868,19,na,1887,3232
SIM,1845,26,45-49,1871,2
SIM,1881,26,30-34,1907,56
SIM,1934,16,45-49,1950,1
STAT,1949,38,na,1987,5196.992119951986
SIM,1890,36,25-29,1926,7
STAT,1955,26,15-19,1981,1.0866924101338957
STAT,1867,99,na,1966,9.363459690314274
SIM,1954,17,25-29,1971,1
STAT,1882,40,50-100,1922,1.2028645052634996
SIM,1933,34,40-44,1967,10
SIM,1991,6,na,1997,6714
STAT,1893,25,45-49,1918,1.6306077803336858
SIM,1931,62,na,1993,5379
STAT,1856,34,30-34,1890,15.240783275345338
SIM,1926,1,na,1927,6324
STAT,1896,54,na,1950,3191.877024252361
STAT,1879,32,45-49,1911,2.101338665291551
STAT,1954,1,na,1955,5617.567920666303
STAT,1832,45,25-29,1877,0.04851001936655616
STAT,1955,21,20-24,1976,170.9709938016589
STAT,1882,36,25-29,1918,3.2610948923661875
STAT,1957,29,50-100,1986,1.5195316640504137
SIM,1905,23,25-29,1928,113
STAT,1931,32,15-19,1963,0.1943646984491272
SIM,1828,27,20-24,1855,24
SIM,1784,84,na,1868,7
SIM,1859,40,35-39,1899,2
STAT,1812,44,45-49,1856,3.692527054499514
SIM,1962,13,na,1975,5584
STAT,1944,47,20-24,1991,0.014276435355947746
STAT,1950,1,na,1951,5572.358636480796
STAT,1969,34,na,2003,5550.507104029132
SIM,1866,37,45-49,1903,1
STAT,1950,39,45-49,1989,0.9563315699453485
SIM,1864,34,30-34,1898,25
SIM,1798,82,na,1880,171
SIM,1979,23,45-49,2002,1
STAT,1926,18,45-49,1944,0.704812793379455
STAT,1846,30,40-44,1876,5.409225231853367
SIM,1820,44,45-49,1864,4
STAT,1902,17,20-24,1919,28.90863994268505
STAT,1981,16,15-19,1997,73.25623772982144
STAT,1866,31,20-24,1897,2.9031747895619726
STAT,1940,17,40-44,1957,1.6394684190865223
STAT,1892,31,15-19,1923,0.20682512774893838
STAT,1951,24,40-44,1975,4.632796426878986
STAT,1874,51,25-29,1925,0.004204723545264741
SIM,1889,19,35-39,1908,2
STAT,1945,26,30-34,1971,49.63169461503793
SIM,1963,21,20-24,1984,313
STAT,1884,27,45-49,1911,1.2659909209535885
STAT,1949,28,40-44,1977,6.279938255746592
SIM,1892,27,45-49,1919,3
STAT,1944,50,na,1994,4703.224727315688
SIM,1918,17,15-19,1935,95
STAT,1972,36,15-19,2008,0.02925986786017135
SIM,1815,62,na,1877,1354
STAT,1856,39,25-29,1895,2.509473560683132
SIM,1931,52,na,1983,5947
STAT,1880,60,na,1940,2332.9408230302306
STAT,1912,39,25-29,1951,1.0989190982388746
STAT,1852,15,30-34,1867,1.8390853519705992
STAT,1971,28,15-19,1999,1.0358293550849416
STAT,1835,57,na,1892,1252.5103981189432
SIM,1848,6,na,1854,2420
SIM,1854,17,20-24,1871,28
SIM,1922,89,na,2011,410
STAT,1842,40,15-19,1882,0.011280162180754791
SIM,1876,31,30-34,1907,29
SIM,1953,26,30-34,1979,69
STAT,1951,28,50-100,1979,1.373100111150555
STAT,1950,54,na,2004,5078.261009819015
STAT,1946,17,25-29,1963,55.46842898588097
STAT,1865,93,na,1958,44.70388513252968
SIM,1839,28,35-39,1867,3
SIM,1949,22,25-29,1971,164
SIM,1809,72,na,1881,812
STAT,1869,44,45-49,1913,1.6500797652057613
SIM,1908,26,45-49,1934,6
SIM,1849,23,25-29,1872,129
STAT,1836,42,40-44,1878,2.436037210707528
STAT,1967,15,50-100,1982,0.540377940825865
STAT,1837,26,45-49,1863,1.039398371238967
SIM,1954,30,45-49,1984,7
SIM,1948,32,35-39,1980,20
SIM,1942,9,na,1951,5074
STAT,1839,23,na,1862,2163.055516984277
SIM,1923,17,30-34,1940,46
SIM,1853,36,20-24,1889,2
SIM,1842,42,na,1884,2179
SIM,1953,29,35-39,1982,39
SIM,1940,44,na,1984,4930
STAT,1871,29,25-29,1900,48.2202564309325
STAT,1865,50,20-24,1915,7.794047407206023E-4
SIM,1868,36,40-44,1904,2
STAT,1973,18,30-34,1991,18.18651484414581
STAT,1776,83,na,1859,185.498859608352
SIM,1858,43,50-100,1901,3
SIM,1941,32,25-29,1973,3
STAT,1874,85,na,1959,443.4310817692429
SIM,1908,28,45-49,1936,4
STAT,1884,37,na,1921,2686.3346110589705
STAT,1835,24,45-49,1859,0.5748929661529235
SIM,1818,48,45-49,1866,3
STAT,1961,13,na,1974,5855.87414379389
STAT,1883,45,30-34,1928,0.11038576892137915
SIM,1818,54,na,1872,1937
SIM,1937,34,25-29,1971,1
SIM,1981,18,30-34,1999,48
STAT,1850,18,25-29,1868,7.086568196995818
SIM,1837,68,na,1905,1468
STAT,1937,38,40-44,1975,1.7267046308290357
SIM,1867,24,30-34,1891,47
STAT,1969,44,50-100,2013,0.17542151886149177
SIM,1945,38,40-44,1983,4
STAT,1855,31,45-49,1886,1.5265949667130476
STAT,1966,31,25-29,1997,13.587886224726132
STAT,1951,15,50-100,1966,0.5151391666571801
STAT,1934,40,50-100,1974,0.1893423181838732
SIM,1939,1,na,1940,5152
STAT,1861,49,50-100,1910,0.23071063041988152
STAT,1834,36,45-49,1870,2.2865009671849506
STAT,1945,29,35-39,1974,18.98996500723425
STAT,1933,32,25-29,1965,14.380759818452562
SIM,1863,31,45-49,1894,5
STAT,1823,44,20-24,1867,0.16011150393193818
STAT,1860,26,45-49,1886,1.0513160710739424
STAT,1957,44,25-29,2001,0.11254136076265381
STAT,1854,32,50-100,1886,0.7644226542621128
STAT,1937,16,20-24,1953,152.66665469516738
STAT,1884,29,35-39,1913,10.923277989396302
STAT,1845,36,20-24,1881,0.5514678373371366
STAT,1879,47,30-34,1926,0.11610201886623955
STAT,1979,36,25-29,2015,1.6133136323464836
STAT,1768,114,na,1882,2.878158759554025E-4
STAT,1923,37,35-39,1960,3.2331054632163156
SIM,1945,16,20-24,1961,299
STAT,1858,43,30-34,1901,1.0275533857834827
SIM,1867,34,na,1901,2349
SIM,1955,43,na,1998,6446
STAT,1940,48,40-44,1988,0.19168593014128385
SIM,1849,75,na,1924,1500
SIM,1888,35,30-34,1923,2
SIM,1880,20,40-44,1900,7
SIM,1842,36,45-49,1878,5
STAT,1885,48,na,1933,2557.2714661167925
STAT,1832,44,50-100,1876,0.8746098162871877
SIM,1840,44,50-100,1884,2
STAT,1908,21,35-39,1929,10.03274361879438
SIM,1849,20,30-34,1869,23
SIM,1864,42,na,1906,2701
STAT,1901,40,40-44,1941,0.25503310552072717
STAT,1902,67,na,1969,2965.9048010329693
SIM,1834,25,30-34,1859,54
SIM,1927,62,na,1989,4391
STAT,1976,12,na,1988,6056.423740990514
SIM,1963,24,25-29,1987,181
STAT,1854,50,45-49,1904,0.011993124579471963
STAT,1881,52,20-24,1933,8.170268119834656E-4
STAT,1908,48,15-19,1956,3.8388250588445325E-4
STAT,1937,10,na,1947,4464.313172761827
SIM,1843,53,na,1896,1642
STAT,1926,16,45-49,1942,0.7083998333158364
STAT,1962,38,20-24,2000,0.4011780640148011
STAT,1960,18,20-24,1978,203.71527235284933
SIM,1844,38,45-49,1882,1
STAT,1969,29,20-24,1998,26.402955170377698
SIM,1907,48,na,1955,4265
STAT,1841,42,na,1883,2135.2988041747285
STAT,1844,30,30-34,1874,17.83005500289257
STAT,1968,24,35-39,1992,13.607821945780993
SIM,1881,60,na,1941,1511
STAT,1867,22,15-19,1889,3.5693039172598886
STAT,1955,24,25-29,1979,141.8822142508293
SIM,1914,34,na,1948,3982
STAT,1981,31,na,2012,6224.7024162674315
STAT,1915,17,30-34,1932,2.9445598102561803
STAT,1873,28,20-24,1901,13.776730906168915
SIM,1889,18,na,1907,4023
STAT,1908,38,20-24,1946,0.2837775873846256
SIM,1875,22,15-19,1897,5
SIM,1880,5,na,1885,3817
STAT,1871,26,20-24,1897,13.515411232532225
SIM,1837,41,45-49,1878,4
STAT,1834,45,35-39,1879,0.15275997532449975
SIM,1897,69,na,1966,2355
STAT,1966,22,35-39,1988,13.617190746406807
STAT,1856,43,20-24,1899,0.13881674161423901
STAT,1969,8,na,1977,5665.760762583898
STAT,1971,19,35-39,1990,6.129251281623767
SIM,1918,23,35-39,1941,22
STAT,1836,38,45-49,1874,2.2046329169332304
STAT,1948,17,35-39,1965,5.541729958542783
STAT,1889,84,na,1973,995.5422186363114
SIM,1852,30,30-34,1882,19
SIM,1823,39,na,1862,2329
SIM,1966,29,45-49,1995,5
STAT,1991,6,na,1997,6501.6999702508165
STAT,1905,103,na,2008,8.214799399349168
STAT,1888,33,15-19,1921,0.19237138533843906
STAT,1856,37,35-39,1893,6.227348605753693
STAT,1931,19,30-34,1950,18.31686857215353
STAT,1829,41,45-49,1870,1.6267279592684294
STAT,1858,36,30-34,1894,4.821237985828493
STAT,1955,28,na,1983,5761.188472340422
SIM,1832,23,30-34,1855,1
SIM,1956,17,35-39,1973,7
STAT,1811,76,na,1887,478.3564730810378
SIM,1812,92,na,1904,13
STAT,1958,29,45-49,1987,2.6273187581574278
SIM,1921,15,30-34,1936,31
SIM,2007,0,na,2007,6977
SIM,1948,65,na,2013,3933
STAT,1892,8,na,1900,3760.0729407777885
SIM,1845,23,40-44,1868,1
STAT,1878,38,25-29,1916,3.452096894695351
STAT,1866,41,15-19,1907,0.01483868725827041
STAT,1889,0,na,1889,4104.349811302352
SIM,1831,38,35-39,1869,17
SIM,1886,48,na,1934,1892
STAT,1975,36,40-44,2011,2.350192298543874
STAT,1975,9,na,1984,5982.75709014271
STAT,1819,44,50-100,1863,2.090768675766425
STAT,1905,29,30-34,1934,41.761265060187625
SIM,1919,26,20-24,1945,2
STAT,1843,39,15-19,1882,0.05862691651842598
STAT,1854,7,na,1861,2412.1892361116506
SIM,1905,47,35-39,1952,2
STAT,1950,31,50-100,1981,1.1506648849330434
STAT,1871,89,na,1960,201.6727417702252
STAT,1893,23,50-100,1916,0.5930133386067596
SIM,1855,38,20-24,1893,1
STAT,1880,105,na,1985,1.3143318989948247
STAT,1909,27,50-100,1936,1.0990145893275174
STAT,1823,38,35-39,1861,8.075837839142636
SIM,1875,85,na,1960,453
SIM,1903,71,na,1974,2523
SIM,1866,34,40-44,1900,3
SIM,1862,1,na,1863,3943
STAT,1926,15,40-44,1941,1.9878535363360144
STAT,1860,32,30-34,1892,16.239434226266813
STAT,1856,56,na,1912,1795.7942979980178
STAT,1944,69,na,2013,3814.45269669869
SIM,1913,29,30-34,1942,55
STAT,1892,88,na,1980,645.5601464757137
STAT,1906,30,15-19,1936,0.13871531028082984
SIM,1886,38,25-29,1924,1
STAT,1847,38,20-24,1885,0.6090448070925605
SIM,1936,22,15-19,1958,5
STAT,1810,51,35-39,1861,0.032171412348615425
STAT,1935,19,15-19,1954,71.25363968354866
SIM,1908,59,na,1967,3322
STAT,1838,41,50-100,1879,1.0842018538042237
STAT,1913,15,30-34,1928,2.890889276175367
STAT,1959,41,30-34,2000,0.2008541345808237
SIM,1832,28,25-29,1860,75
STAT,1861,16,35-39,1877,0.6086617623220927
STAT,1820,43,na,1863,1583.9211211961551
STAT,1821,47,15-19,1868,7.238538824449921E-4
SIM,1846,41,50-100,1887,4
SIM,1870,28,45-49,1898,1
SIM,1918,70,na,1988,2852
STAT,1848,6,na,1854,3286.0
STAT,1911,25,15-19,1936,0.8005828750015769
SIM,1916,21,35-39,1937,29
STAT,1862,28,45-49,1890,1.0775538088023358
STAT,1886,26,40-44,1912,3.6590472722671783
STAT,1837,23,40-44,1860,1.961143107500932
STAT,1856,41,na,1897,2044.136953919837
STAT,1866,34,na,1900,2530.692060038673
STAT,1851,26,50-100,1877,0.5982412857883221
STAT,1895,31,40-44,1926,6.5412034207428995
STAT,1841,52,25-29,1893,0.0031324041380444427
STAT,1919,17,15-19,1936,57.86439440841411
SIM,1927,17,15-19,1944,114
STAT,1951,43,50-100,1994,0.16751443001009686
SIM,1896,84,na,1980,1298
SIM,1969,8,na,1977,5831
STAT,1870,52,45-49,1922,0.01642322728224685
STAT,1849,71,na,1920,1034.561535874913
SIM,1943,19,15-19,1962,102
SIM,1956,28,na,1984,5018
SIM,1871,49,na,1920,1921
STAT,1892,21,20-24,1913,99.9783322800969
SIM,1891,37,50-100,1928,4
SIM,1942,28,20-24,1970,26
STAT,1825,49,50-100,1874,0.3335825359619336
STAT,1947,38,25-29,1985,1.3173308906483236
STAT,1970,20,35-39,1990,13.656895234327642
SIM,1849,32,15-19,1881,3
SIM,1927,39,35-39,1966,1
STAT,1923,66,na,1989,4246.970044413899
STAT,1906,48,na,1954,3739.3132683228305
STAT,1923,15,15-19,1938,61.76308684226664
SIM,1840,21,15-19,1861,6
SIM,1972,29,40-44,2001,1
STAT,1859,15,40-44,1874,0.19749922820311894
STAT,1762,113,na,1875,6.34843813759568E-4
STAT,1894,46,45-49,1940,0.19805488207664956
SIM,1901,27,50-100,1928,2
SIM,1931,15,15-19,1946,134
STAT,1819,46,20-24,1865,0.023442952207887734
STAT,1904,39,40-44,1943,1.5500568958142573
STAT,1928,22,15-19,1950,7.669952610989094
SIM,1834,76,na,1910,669
SIM,1912,39,40-44,1951,2
SIM,1998,3,na,2001,6866
SIM,1894,26,40-44,1920,7
STAT,1883,37,50-100,1920,1.3862348832806615
SIM,1899,33,40-44,1932,8
STAT,1919,39,35-39,1958,2.991680705551669
SIM,1938,24,15-19,1962,11
SIM,1798,97,na,1895,1
SIM,1888,20,35-39,1908,11
STAT,1884,24,40-44,1908,2.3611283794003746
SIM,1832,80,na,1912,500
SIM,1938,25,na,1963,4084
STAT,1869,41,40-44,1910,2.525183763623954
SIM,1830,26,25-29,1856,87
STAT,1934,28,20-24,1962,28.33920534660881
STAT,1848,49,50-100,1897,0.25550822537200846
STAT,1968,18,15-19,1986,65.39519072397273
SIM,1905,20,20-24,1925,210
SIM,1917,26,na,1943,5192
STAT,1834,72,na,1906,1152.5186380067532
STAT,1870,20,30-34,1890,20.386380659992295
SIM,1954,26,15-19,1980,2
STAT,1929,34,25-29,1963,13.531890444990747
SIM,1820,35,50-100,1855,4
SIM,1988,21,20-24,2009,158
STAT,1880,40,45-49,1920,1.8492249317185463
SIM,1870,32,40-44,1902,8
STAT,1912,36,20-24,1948,0.29863586071163783
SIM,1892,24,40-44,1916,5
STAT,1840,103,na,1943,0.11512796827280304
STAT,1907,42,25-29,1949,0.0756240586041781
SIM,1940,33,35-39,1973,31
STAT,1870,23,35-39,1893,6.618651794643177
STAT,1982,25,30-34,2007,63.96015208748233
SIM,1973,33,na,2006,5295
SIM,1970,3,na,1973,6055
SIM,1870,37,20-24,1907,1
STAT,1914,33,15-19,1947,0.1487203956946991
STAT,1929,49,45-49,1978,0.32321521007968973
STAT,1828,32,40-44,1860,5.000281706621596
STAT,1926,49,20-24,1975,0.01564086490668395
SIM,1932,53,na,1985,5265
SIM,1954,50,na,2004,5348
STAT,1881,21,45-49,1902,0.7785523786037886
SIM,1968,26,15-19,1994,1
STAT,1863,38,na,1901,2365.648396504433
STAT,1946,26,15-19,1972,0.9079238213883067
STAT,1889,26,20-24,1915,16.746073665721685
STAT,1978,32,na,2010,6071.721729348617
SIM,1897,26,20-24,1923,21
STAT,1929,9,na,1938,5863.315034352919
STAT,1793,109,na,1902,1.33965517220758E-4
STAT,1945,33,45-49,1978,2.0208207062255
SIM,1876,49,na,1925,2473
STAT,1941,39,45-49,1980,0.8332916271943517
STAT,1889,4,na,1893,3742.3355416864138
SIM,1848,26,25-29,1874,88
STAT,1963,36,15-19,1999,0.029033222726416744
STAT,1860,93,na,1953,27.18279154503688
STAT,1782,112,na,1894,1.597600022068865E-4
STAT,1932,33,35-39,1965,14.014268713933644
STAT,1813,44,15-19,1857,0.04782272315019349
STAT,1898,24,20-24,1922,106.80860837383219
SIM,1913,70,na,1983,3413
SIM,1875,91,na,1966,231
STAT,1936,35,45-49,1971,0.7741531453995646
STAT,1933,50,na,1983,5780.334927776991
STAT,1948,32,30-34,1980,21.209450863358008
SIM,1866,15,35-39,1881,2
SIM,1922,33,15-19,1955,1
STAT,1973,27,30-34,2000,58.73452801810087
SIM,1839,53,na,1892,1804
STAT,1863,20,40-44,1883,2.175831837436859
SIM,1859,30,40-44,1889,10
SIM,1981,27,30-34,2008,79
SIM,1886,79,na,1965,481
STAT,1859,21,na,1880,2257.2701082079166
SIM,1826,74,na,1900,776
STAT,1883,52,30-34,1935,0.006685198499528007
STAT,1854,40,40-44,1894,1.850968608304231
SIM,1956,32,30-34,1988,7
SIM,1914,28,na,1942,3991
SIM,1861,39,20-24,1900,1
STAT,1905,35,15-19,1940,0.02043735969750518
SIM,1911,89,na,2000,1228
SIM,1966,37,50-100,2003,2
SIM,1903,40,na,1943,3745
STAT,1850,16,50-100,1866,0.06199530174649756
SIM,1871,20,40-44,1891,1
STAT,1839,17,na,1856,2381.347650429196
STAT,1972,16,15-19,1988,67.07746995714491
STAT,1854,22,40-44,1876,1.994705842817571
STAT,1950,15,25-29,1965,59.164142232601485
SIM,1822,40,50-100,1862,2
SIM,1912,19,20-24,1931,53
STAT,1991,14,na,2005,6494.291707309835
STAT,1851,41,na,1892,1841.0941697362414
STAT,1916,21,30-34,1937,34.864805510227725
STAT,1940,23,15-19,1963,6.257987150554254
STAT,1906,64,na,1970,3302.968512622832
SIM,1845,30,40-44,1875,11
SIM,1953,15,na,1968,5025
STAT,1839,72,na,1911,1001.5385288008401
SIM,1902,38,20-24,1940,1
STAT,1974,22,30-34,1996,43.45409662015728
SIM,1793,82,na,1875,339
SIM,1906,32,20-24,1938,5
SIM,1905,38,45-49,1943,1
SIM,1953,33,45-49,1986,2
STAT,1904,19,20-24,1923,29.222503289771126
STAT,1914,15,15-19,1929,10.889589258674802
SIM,1967,15,45-49,1982,2
STAT,1937,28,15-19,1965,0.7942143171616888
STAT,1971,39,15-19,2010,0.02885628926350221
STAT,1970,29,50-100,1999,1.4426986207219537
STAT,1850,46,40-44,1896,0.17674154327424088
STAT,1900,48,45-49,1948,0.21049972412997206
STAT,1945,23,50-100,1968,0.8319744410322402
SIM,1930,19,40-44,1949,6
STAT,1833,54,40-44,1887,0.0073887508764788
STAT,1874,17,50-100,1891,0.05788131973447507
SIM,1880,54,50-100,1934,1
STAT,1887,24,45-49,1911,0.896216224678415
SIM,1980,33,20-24,2013,6
SIM,1843,58,na,1901,1561
SIM,1895,24,45-49,1919,2
STAT,1922,37,40-44,1959,1.9649238666526208
STAT,1901,17,na,1918,4082.5987134975344
SIM,1874,31,20-24,1905,5
STAT,1956,33,20-24,1989,3.7944069345062252
SIM,1963,39,na,2002,6493
SIM,1964,33,20-24,1997,7
SIM,1948,22,50-100,1970,2
SIM,1924,21,30-34,1945,49
STAT,1922,19,40-44,1941,1.857287782286434
STAT,1913,46,na,1959,4150.64176263837
SIM,1970,25,45-49,1995,9
STAT,1865,18,30-34,1883,1.7001414279877016
STAT,1915,49,45-49,1964,0.2513043232620749
STAT,1837,30,40-44,1867,4.019947784136526
STAT,1945,51,na,1996,4755.984939447878
STAT,1937,46,15-19,1983,4.3048415951507364E-4
SIM,1899,21,25-29,1920,4
SIM,1959,28,15-19,1987,2
STAT,1962,25,45-49,1987,2.567856797512987
SIM,1856,0,na,1856,3647
STAT,1872,29,30-34,1901,28.972280052257815
STAT,1894,48,20-24,1942,0.009915897249809725
SIM,1923,49,45-49,1972,2
STAT,1961,40,35-39,2001,0.3128835088761724
STAT,1868,85,na,1953,303.95138118754903
SIM,1887,92,na,1979,216
SIM,1905,30,50-100,1935,1
SIM,1898,23,30-34,1921,71
SIM,1984,17,na,2001,5876
SIM,1951,44,na,1995,6267
SIM,1880,29,30-34,1909,2
SIM,1886,41,40-44,1927,3
STAT,1924,25,25-29,1949,89.01806836883944
STAT,1972,33,20-24,2005,3.671490373861311
STAT,1880,15,45-49,1895,0.08027643289255514
STAT,1839,28,30-34,1867,24.97770867836825
STAT,1889,19,30-34,1908,2.2552301450512857
STAT,1891,7,na,1898,3716.0668855422387
STAT,1866,50,na,1916,2336.258775077984
STAT,1904,24,45-49,1928,1.148380346487943
SIM,1944,47,50-100,1991,1
STAT,1977,18,15-19,1995,70.7433488042901
STAT,1865,25,20-24,1890,12.298318472576268
SIM,1832,74,na,1906,851
SIM,1847,28,30-34,1875,56
STAT,1854,105,na,1959,0.05297885647968937
STAT,1922,41,25-29,1963,0.09468487372630559
STAT,1936,21,50-100,1957,0.7266544648997574
SIM,1852,33,35-39,1885,10
STAT,1878,41,40-44,1919,2.7225407916287105
SIM,1965,30,30-34,1995,6
STAT,1869,18,15-19,1887,6.684740581093534
SIM,1929,38,30-34,1967,3
STAT,1887,42,45-49,1929,1.9332560964477623
SIM,1874,29,50-100,1903,1
SIM,1975,39,50-100,2014,3
SIM,1955,28,30-34,1983,129
SIM,1846,23,na,1869,1592
STAT,1952,39,20-24,1991,0.3747913328234235
SIM,1990,17,na,2007,5539
SIM,1869,67,na,1936,1165
STAT,1877,20,40-44,1897,2.516423101422268
STAT,1963,28,40-44,1991,6.860083880355797
STAT,1919,43,45-49,1962,0.20776235031951626
STAT,1928,15,15-19,1943,66.2986428905753
STAT,1844,33,35-39,1877,10.024675668441642
STAT,1881,55,na,1936,2301.6321446390875
SIM,1971,28,40-44,1999,17
STAT,1947,28,30-34,1975,51.13130060588977
STAT,1830,36,15-19,1866,0.05767791781809234
STAT,1964,20,50-100,1984,0.9602321170339092
STAT,1874,23,20-24,1897,81.16489861142286
SIM,1960,39,20-24,1999,1
STAT,1905,9,na,1914,4333.8735764961075
SIM,1869,34,45-49,1903,3
SIM,1911,30,35-39,1941,25
STAT,1858,15,35-39,1873,0.5839101856609693
STAT,1881,30,50-100,1911,1.02809768734935
STAT,1765,98,na,1863,0.04789210118537725
STAT,1874,47,40-44,1921,0.20132080273360933
STAT,1910,95,na,2005,212.02559657116544
STAT,1957,30,30-34,1987,24.463383453857453
SIM,1914,40,30-34,1954,1
SIM,1941,14,na,1955,4025
SIM,1907,7,na,1914,4859
STAT,1988,22,45-49,2010,1.8632815333297894
STAT,1923,35,35-39,1958,3.238706007887537
SIM,1931,35,35-39,1966,2
STAT,1944,38,na,1982,4809.070382914871
STAT,1913,43,25-29,1956,0.08028004960166578
STAT,1828,50,40-44,1878,0.009742224672833226
STAT,1913,22,45-49,1935,1.2589216189289516
STAT,1973,33,50-100,2006,1.2570927406781038
STAT,1954,12,na,1966,5604.155889100726
STAT,1850,44,50-100,1894,1.072880190922615
SIM,1921,43,25-29,1964,1
STAT,1890,32,na,1922,3364.985417857565
SIM,1907,70,na,1977,3128
STAT,1958,24,40-44,1982,5.109812332429681
STAT,1839,35,20-24,1874,0.7458669018803926
STAT,1786,76,na,1862,617.5440149825737
STAT,1870,24,na,1894,2673.928297174217
STAT,1895,46,15-19,1941,3.399065905274603E-4
SIM,1932,25,25-29,1957,19
STAT,1963,18,15-19,1981,66.51796323585909
STAT,1941,48,50-100,1989,0.27894413858692385
SIM,1939,39,50-100,1978,1
SIM,1837,58,na,1895,1800
STAT,1920,49,25-29,1969,0.06724432092998847
SIM,1838,75,na,1913,338
STAT,1875,55,na,1930,2465.9457239518524
SIM,1931,28,45-49,1959,6
SIM,1882,47,40-44,1929,1
STAT,1831,30,45-49,1861,1.8130554537100008
STAT,1923,28,45-49,1951,2.280139237721424
STAT,1947,35,20-24,1982,0.3536577930441044
SIM,1836,32,40-44,1868,13
STAT,1834,52,35-39,1886,0.008055704915787098
SIM,1971,18,15-19,1989,70
SIM,1852,35,na,1887,1903
STAT,1992,19,50-100,2011,0.6201959970982545
STAT,1850,63,na,1913,1836.8449415044258
SIM,1917,32,na,1949,5387
SIM,1857,66,na,1923,1750
SIM,1889,71,na,1960,2477
SIM,1884,48,50-100,1932,1
STAT,1807,71,na,1878,859.4783274290783
STAT,1870,23,50-100,1893,0.46251939687716015
SIM,1853,52,na,1905,2089
SIM,1955,35,20-24,1990,1
STAT,1882,48,30-34,1930,0.10774338578237357
STAT,1856,29,na,1885,2146.1830819584993
STAT,1914,29,30-34,1943,45.28068216246428
SIM,1847,35,20-24,1882,2
STAT,1910,27,20-24,1937,20.36332857682801
STAT,1889,29,25-29,1918,59.74660722336706
SIM,1955,30,50-100,1985,1
STAT,1917,46,15-19,1963,4.4515278275843135E-4
SIM,1914,32,50-100,1946,2
STAT,1949,23,35-39,1972,12.675343209396694
SIM,1902,32,35-39,1934,39
SIM,1902,1,na,1903,4385
STAT,1921,44,15-19,1965,0.0019887493586527305
STAT,1816,40,20-24,1856,0.3868777865433609
STAT,1912,90,na,2002,666.1418934375207
STAT,1828,35,45-49,1863,2.143449410573205
STAT,1906,40,30-34,1946,0.13570821149439602
STAT,1892,67,na,1959,2413.7615343171915
STAT,1840,49,50-100,1889,0.19365345886417099
STAT,1824,52,50-100,1876,0.019808822422563224
STAT,1904,69,na,1973,2918.8731276457074
STAT,1975,20,25-29,1995,141.19171288574614
SIM,1924,24,35-39,1948,30
STAT,1845,72,na,1917,851.007929436472
STAT,1855,36,15-19,1891,0.04801164206849198
STAT,1854,43,45-49,1897,1.2105002275484738
STAT,1836,47,20-24,1883,0.011433005600262156
SIM,1948,24,na,1972,4431
STAT,1873,84,na,1957,458.2982334834303
STAT,1870,4,na,1874,3364.166940607086
STAT,1956,36,25-29,1992,1.5504588254890441
STAT,1878,23,40-44,1901,2.5031383724523706
STAT,1965,30,50-100,1995,1.2156030634745092
SIM,1890,48,30-34,1938,1
SIM,1886,23,40-44,1909,5
STAT,1913,25,25-29,1938,76.24055791685328
SIM,1919,28,20-24,1947,30
SIM,1893,5,na,1898,3852
STAT,1860,28,50-100,1888,0.5970407307492702
SIM,1950,8,na,1958,4818
STAT,1931,42,30-34,1973,0.1971453026366568
SIM,1841,95,na,1936,1
SIM,1921,25,25-29,1946,174
SIM,1892,91,na,1983,591
STAT,1868,69,na,1937,1627.1645950223149
STAT,1864,55,na,1919,2130.6580279959626
STAT,1825,47,45-49,1872,0.3295565814234431
SIM,1945,44,na,1989,4666
STAT,1961,31,35-39,1992,13.896670186937385
SIM,1931,32,30-34,1963,1
STAT,1902,42,35-39,1944,0.2047935222225175
SIM,1941,30,na,1971,3928
STAT,1916,24,35-39,1940,11.31638579593738
STAT,1852,51,50-100,1903,0.014307203658985345
STAT,1943,36,15-19,1979,0.024235943364336515
SIM,1968,37,50-100,2005,2
STAT,1773,97,na,1870,1.7275965319386322
SIM,1849,30,25-29,1879,32
STAT,1830,29,25-29,1859,48.61622191151429
SIM,1900,48,na,1948,3317
SIM,1930,14,na,1944,6346
STAT,1955,35,50-100,1990,0.6638262955421809
SIM,1984,30,25-29,2014,4
STAT,1963,38,50-100,2001,0.6335535655956298
SIM,1882,49,na,1931,2996
SIM,1888,23,50-100,1911,3
STAT,1894,24,35-39,1918,8.602968106043999
STAT,1976,37,na,2013,5976.014696608431
SIM,1805,57,na,1862,1349
STAT,1905,45,40-44,1950,0.16291293228941195
SIM,1910,42,35-39,1952,1
SIM,1987,11,na,1998,6558
SIM,1885,20,40-44,1905,1
SIM,1975,22,40-44,1997,7
STAT,1880,38,na,1918,2867.634062122988
STAT,1822,38,30-34,1860,12.331477148870423
STAT,1829,46,15-19,1875,4.135560937713502E-4
SIM,1829,38,50-100,1867,3
SIM,1905,47,50-100,1952,2
SIM,1835,23,na,1858,2575
STAT,1982,28,35-39,2010,24.474490127600024
SIM,1953,30,40-44,1983,1
STAT,1835,105,na,1940,0.018274223152154833
SIM,1982,18,35-39,2000,17
SIM,1862,25,45-49,1887,1
STAT,1953,40,40-44,1993,0.3638952998442826
SIM,1921,18,35-39,1939,5
SIM,1787,82,na,1869,341
SIM,1840,20,50-100,1860,1
STAT,1885,85,na,1970,678.2109107731576
STAT,1845,41,na,1886,1606.4199994737696
SIM,1889,105,na,1994,79
STAT,1976,30,25-29,2006,14.542099646553396
STAT,1883,45,40-44,1928,0.1952277231851569
STAT,1967,22,40-44,1989,4.863082401594389
STAT,1854,25,45-49,1879,1.057186493018051
STAT,1819,104,na,1923,0.04440304559746767
STAT,1911,48,20-24,1959,0.012050473910567783
SIM,1918,58,na,1976,3550
STAT,1832,23,15-19,1855,3.919456644444682
STAT,1886,48,15-19,1934,4.8080583179350886E-4
SIM,1913,45,40-44,1958,1
STAT,1945,30,40-44,1975,5.03438996240788
SIM,1864,52,na,1916,2478
STAT,1900,22,35-39,1922,9.344679056154785
STAT,1962,15,15-19,1977,67.14290351701965
STAT,1835,48,50-100,1883,0.15949701780607933
STAT,1825,54,35-39,1879,0.011133553466434642
STAT,1960,17,50-100,1977,0.5631368122727424
STAT,1844,21,40-44,1865,2.191918209533589
STAT,1935,41,35-39,1976,0.32843544054436585
STAT,1987,20,50-100,2007,1.0883798552639363
SIM,1965,33,35-39,1998,5
SIM,1830,38,30-34,1868,5
SIM,1928,32,na,1960,5592
SIM,1898,35,50-100,1933,5
STAT,1937,18,20-24,1955,151.89361472311933
SIM,1945,18,20-24,1963,160
STAT,1931,35,40-44,1966,2.292438849809784
SIM,1852,21,40-44,1873,5
STAT,1905,27,40-44,1932,5.003557251006723
STAT,1804,59,na,1863,1311.9443181592542
SIM,1827,31,35-39,1858,19
STAT,1874,38,na,1912,2769.6567417451797
SIM,1908,23,40-44,1931,4
STAT,1857,42,na,1899,2074.8093964316827
SIM,1833,60,na,1893,1276
SIM,1849,23,35-39,1872,14
STAT,1797,76,na,1873,459.7662779696282
STAT,1949,30,25-29,1979,12.659203367564464
STAT,1906,102,na,2008,14.00613432455352
STAT,1924,22,20-24,1946,151.37880320152001
SIM,1863,35,na,1898,2470
STAT,1927,26,na,1953,5272.683882490389
STAT,1879,85,na,1964,591.7699370617872
SIM,1898,26,35-39,1924,18
STAT,1924,87,na,2011,1302.1848908491245
STAT,1898,42,20-24,1940,0.01717945003381717
SIM,1925,67,na,1992,4228
STAT,1904,21,40-44,1925,3.463753904221394
SIM,1912,21,40-44,1933,6
STAT,1888,35,15-19,1923,0.0769013223540538
SIM,1957,30,25-29,1987,3
SIM,1971,38,25-29,2009,3
STAT,1899,77,na,1976,2028.4217119920097
STAT,1912,31,40-44,1943,4.466306197278332
STAT,1868,34,35-39,1902,11.132428457618758
STAT,1923,32,30-34,1955,20.83639447938
SIM,1932,22,20-24,1954,149
SIM,1918,45,45-49,1963,1
STAT,1957,40,25-29,1997,0.11323049397391637
SIM,1888,25,15-19,1913,3
STAT,1963,38,25-29,2001,1.485755560468671
SIM,1934,32,na,1966,5775
SIM,1952,49,30-34,2001,1
SIM,1853,21,35-39,1874,10
SIM,1889,19,25-29,1908,28
STAT,1919,40,40-44,1959,0.3136048184959421
SIM,1949,32,40-44,1981,1
STAT,1851,44,35-39,1895,1.4165831190366605
STAT,1931,17,40-44,1948,2.1132688491994047
SIM,1836,35,45-49,1871,1
STAT,1955,39,45-49,1994,1.073700648693442
SIM,1904,66,na,1970,3419
STAT,1810,59,na,1869,1345.8247736603398
SIM,1830,79,na,1909,513
STAT,1923,25,40-44,1948,6.215359528687338
SIM,1876,34,35-39,1910,10
STAT,1851,37,45-49,1888,1.5977534436362932
STAT,1860,42,35-39,1902,1.6821799734262242
STAT,1958,27,45-49,1985,2.6299217368720895
STAT,1867,20,25-29,1887,62.83465214328772
SIM,1850,30,20-24,1880,2
SIM,1979,30,45-49,2009,5
SIM,1957,23,35-39,1980,22
SIM,1931,25,40-44,1956,2
SIM,1966,27,45-49,1993,5
STAT,1905,35,50-100,1940,0.44683494418307174
STAT,1957,33,35-39,1990,14.164547853238691
SIM,1874,16,25-29,1890,18
STAT,1999,15,30-34,2014,20.791663913836445
SIM,1986,21,45-49,2007,4
SIM,1819,40,40-44,1859,3
SIM,1871,61,na,1932,1570
STAT,1852,50,35-39,1902,0.008233377561029645
STAT,1920,22,35-39,1942,12.075238335041336
SIM,1875,20,25-29,1895,86
SIM,1970,27,na,1997,5758
STAT,1842,30,20-24,1872,2.5655080328950746
STAT,1828,53,45-49,1881,0.011515388334178965
STAT,1908,6,na,1914,4477.818669482506
SIM,1865,37,na,1902,2870
STAT,1840,18,30-34,1858,1.6456941006423547
STAT,1911,11,na,1922,4571.50302602013
SIM,1897,29,25-29,1926,83
STAT,1866,16,25-29,1882,6.258482790872365
STAT,1915,25,na,1940,4440.315227730715
SIM,1843,48,50-100,1891,1
STAT,1959,38,15-19,1997,0.029835571527922156
STAT,1811,45,na,1856,1590.9490959854018
SIM,1875,36,na,1911,3174
STAT,1924,31,30-34,1955,21.219214355674477
SIM,1941,47,45-49,1988,1
SIM,1915,39,45-49,1954,3
STAT,1828,47,15-19,1875,3.6833530567497336E-4
STAT,1858,50,30-34,1908,0.005436008003584466
SIM,1995,17,na,2012,5954
STAT,1828,46,50-100,1874,0.22914692119619628
STAT,1859,22,40-44,1881,1.9875573003249267
STAT,1814,89,na,1903,65.50281382055284
STAT,1822,45,50-100,1867,0.4776581560169571
STAT,1959,44,45-49,2003,0.2602270274645446
SIM,1884,13,na,1897,2988
SIM,1853,21,na,1874,2452
STAT,1910,41,35-39,1951,0.22111842619723768
STAT,1825,44,40-44,1869,3.2034550910475748
SIM,1913,48,45-49,1961,1
SIM,1989,23,15-19,2012,17
STAT,1821,37,50-100,1858,2.7318469622063213
SIM,1836,40,na,1876,1678
STAT,1931,45,35-39,1976,0.1999289247701849
STAT,1848,36,25-29,1884,3.185499569634353
SIM,1857,35,na,1892,2551
STAT,1967,25,45-49,1992,2.5034103932881107
STAT,1948,27,50-100,1975,1.3202117859361595
SIM,1784,78,na,1862,99
STAT,1841,17,30-34,1858,1.8276786289496323
STAT,1842,37,na,1879,1933.4317885697624
STAT,1829,55,na,1884,1568.8385825717069
STAT,1905,48,45-49,1953,0.21956545702070637
SIM,1788,67,na,1855,580
STAT,1933,47,45-49,1980,0.3450704708300042
STAT,1851,41,30-34,1892,0.9158061039446466
SIM,1972,24,15-19,1996,8
STAT,1904,110,na,2014,0.056116238974524585
SIM,1914,83,na,1997,916
SIM,1844,23,35-39,1867,9
SIM,1892,40,30-34,1932,2
STAT,1892,94,na,1986,200.50886783985112
STAT,1836,23,35-39,1859,6.96097768327593
STAT,1948,66,na,2014,4323.0081175651785
STAT,1861,49,20-24,1910,0.01127250681861494
SIM,1948,22,30-34,1970,81
STAT,1845,21,35-39,1866,4.916959359851736
STAT,1893,36,50-100,1929,1.7995509794672617
SIM,1900,20,30-34,1920,65
SIM,1840,78,na,1918,287
STAT,1853,76,na,1929,943.2530698205378
STAT,1915,19,50-100,1934,0.09002361098913463
STAT,1831,23,50-100,1854,0.9326815114725014
STAT,1857,15,20-24,1872,18.95122710130092
STAT,1909,24,45-49,1933,1.200629465583692
SIM,1886,1,na,1887,3605
STAT,1768,108,na,1876,0.0047520534659605115
STAT,1951,49,na,2000,5220.593858592453
SIM,1856,36,25-29,1892,5
SIM,1866,87,na,1953,87
STAT,1900,27,40-44,1927,4.796963216787368
STAT,1859,40,40-44,1899,2.088634423164287
SIM,1868,43,40-44,1911,11
STAT,1967,39,50-100,2006,0.6222284713963716
STAT,1961,48,na,2009,5681.719364764863
STAT,1891,17,na,1908,3602.3179376328835
STAT,1916,48,20-24,1964,0.013045981774020188
STAT,1924,46,na,1970,5058.621289750048
SIM,1801,82,na,1883,216
STAT,1814,40,50-100,1854,4.72185042216045
STAT,1885,20,15-19,1905,3.820195379666776
SIM,1885,53,na,1938,2806
STAT,1912,34,45-49,1946,1.7733081573883143
SIM,1879,39,30-34,1918,2
STAT,1964,24,15-19,1988,7.7576398568347456
SIM,1928,24,20-24,1952,318
STAT,1943,12,na,1955,4807.665563456559
STAT,1878,68,na,1946,1841.4101297349637
STAT,1887,12,na,1899,3340.018483226205
SIM,1814,43,50-100,1857,4
STAT,1861,53,40-44,1914,0.009938131776155415
SIM,1833,44,40-44,1877,8
SIM,1897,79,na,1976,1731
SIM,1932,31,30-34,1963,39
STAT,1907,39,45-49,1946,0.7232456105611222
SIM,1874,14,na,1888,2868
SIM,1882,23,20-24,1905,133
STAT,1888,41,50-100,1929,1.4396404850000852
STAT,1903,84,na,1987,1309.6920328087356
STAT,1874,41,20-24,1915,0.18847819546263941
SIM,1953,47,25-29,2000,1
SIM,1858,88,na,1946,180
SIM,1893,20,15-19,1913,10
STAT,1880,33,45-49,1913,2.1241134698953834
STAT,1965,45,50-100,2010,0.340550070119285
STAT,1857,27,50-100,1884,0.5922201752279297
STAT,1825,51,30-34,1876,0.008170952347325355
STAT,1874,69,na,1943,1733.8250786145486
STAT,1970,39,30-34,2009,2.7068065654855458
STAT,1895,16,na,1911,3803.263255625823
STAT,1837,51,45-49,1888,0.010757973967212136
STAT,1997,2,na,1999,6631.571134350402
STAT,1870,55,na,1925,2352.4877368900493
SIM,1909,19,15-19,1928,11
SIM,1903,28,na,1931,4015
STAT,1846,15,45-49,1861,0.08583855934648107
STAT,1902,29,15-19,1931,0.7345324385767328
SIM,1894,33,40-44,1927,3
STAT,1841,24,20-24,1865,76.50558876385419
SIM,1862,43,45-49,1905,8
STAT,1808,89,na,1897,53.565649051675706
STAT,1888,34,na,1922,3209.4932645048775
STAT,1885,17,na,1902,2907.2486054510737
STAT,1936,47,50-100,1983,0.2588683333533549
STAT,1894,105,na,1999,2.0826303070808123
STAT,1966,15,35-39,1981,6.051637332056087
SIM,1983,21,20-24,2004,404
SIM,1962,23,na,1985,5566
STAT,1830,39,50-100,1869,1.202925309289017
STAT,1911,40,35-39,1951,0.22450505592377598
SIM,1999,15,25-29,2014,176
STAT,1962,22,40-44,1984,4.988274889039641
STAT,1916,16,50-100,1932,0.09196836609879024
SIM,1882,41,20-24,1923,2
STAT,1811,47,20-24,1858,0.037405674860823364
STAT,1886,33,40-44,1919,5.256855397559968
SIM,1970,22,40-44,1992,9
STAT,1902,106,na,2008,1.2685829663133081
STAT,1956,42,30-34,1998,0.20288979564893
SIM,1865,15,20-24,1880,24
SIM,1959,40,na,1999,5931
STAT,1955,36,40-44,1991,2.364924251676858
STAT,1955,38,30-34,1993,2.873752480082296
STAT,1801,53,35-39,1854,0.03356648849324281
STAT,1955,18,40-44,1973,2.1421637108500327
STAT,1970,11,na,1981,5675.574872611886
STAT,1934,16,50-100,1950,0.5865508214603706
STAT,1850,37,30-34,1887,5.573394718389447
SIM,1950,45,50-100,1995,3
STAT,1826,81,na,1907,297.7479392665321
SIM,1935,68,na,2003,4885
SIM,1924,80,na,2004,1986
STAT,1932,38,40-44,1970,2.319419984394053
STAT,1886,34,50-100,1920,1.1058066937728577
STAT,1831,24,15-19,1855,4.264600222266958
STAT,1906,23,15-19,1929,5.534676699895082
SIM,1923,32,na,1955,5318
STAT,1877,22,30-34,1899,21.3826648608389
SIM,1830,26,15-19,1856,3
STAT,1940,61,na,2001,4126.065798373264
SIM,1963,18,40-44,1981,9
STAT,1900,48,50-100,1948,0.21906242441277343
STAT,1907,42,50-100,1949,0.12441377305062823
STAT,1950,21,30-34,1971,39.361291156408754
STAT,1851,34,40-44,1885,3.5058081709524433
STAT,1904,17,30-34,1921,2.6413910377395537
SIM,1952,30,na,1982,4671
STAT,1946,33,50-100,1979,1.0780652560073185
STAT,1897,36,20-24,1933,1.1952482270261926
STAT,1853,22,45-49,1875,0.8203052179806122
SIM,1914,23,15-19,1937,7
SIM,1970,24,50-100,1994,1
STAT,1884,43,35-39,1927,2.0498127409965186
STAT,1870,47,50-100,1917,0.2781223660146855
STAT,1876,48,50-100,1924,0.28931410606840313
STAT,1936,30,na,1966,4246.777793618699
SIM,1912,17,30-34,1929,14
STAT,1932,35,25-29,1967,1.5297303508545588
STAT,1973,31,15-19,2004,0.1956185976531914
STAT,1922,43,15-19,1965,0.0020300891857929493
SIM,1819,43,45-49,1862,4
STAT,1852,9,na,1861,2778.1305599273137
STAT,1847,38,30-34,1885,4.210879364481241
STAT,1880,27,15-19,1907,0.5549876561787964
STAT,1971,20,40-44,1991,4.934285650772281
STAT,1929,48,30-34,1977,0.13298393886751006
STAT,1857,73,na,1930,1067.564771419451
STAT,1823,42,50-100,1865,1.110012164467863
SIM,1931,31,na,1962,6059
SIM,1869,36,na,1905,1979
SIM,1889,16,20-24,1905,54
STAT,1868,1,na,1869,3937.9381024542045
STAT,1942,48,15-19,1990,4.6089472112659984E-4
SIM,1996,5,na,2001,6947
SIM,1964,2,na,1966,5979
STAT,1897,29,30-34,1926,38.581308296943114
STAT,1931,38,45-49,1969,1.0411040963635314
STAT,1906,48,40-44,1954,0.16047460451685197
STAT,1874,39,50-100,1913,1.4359145247076999
SIM,1967,41,40-44,2008,1
SIM,1903,16,15-19,1919,15
STAT,1796,59,na,1855,1149.0170799999999
SIM,1947,4,na,1951,6147
SIM,1895,31,50-100,1926,3
STAT,1996,14,na,2010,6585.749707708199
STAT,1936,32,40-44,1968,4.389218908337008
STAT,1977,25,50-100,2002,1.5601096474755949
SIM,1886,16,15-19,1902,10
STAT,1971,37,25-29,2008,1.482696935124038
SIM,1944,32,40-44,1976,2
SIM,1848,58,na,1906,1398
STAT,1812,49,25-29,1861,0.12918395597265261
SIM,1839,25,20-24,1864,19
STAT,1887,36,15-19,1923,0.07297553988694402
STAT,1900,21,20-24,1921,110.68657898319178
SIM,1913,43,na,1956,4514
STAT,1827,32,45-49,1859,3.0196021554330135
SIM,1844,20,30-34,1864,37
STAT,1856,24,15-19,1880,3.3251794987050203
STAT,1877,50,na,1927,2621.9033021103
STAT,1945,19,30-34,1964,15.355628476348752
STAT,1907,108,na,2015,0.31479920733358746
STAT,1963,34,25-29,1997,13.795235428714346
SIM,1948,25,35-39,1973,24
SIM,1965,16,50-100,1981,1
STAT,1863,23,45-49,1886,0.7125446840259704
STAT,1919,22,50-100,1941,0.8313121063767475
STAT,1830,42,45-49,1872,1.4375883519309665
STAT,1858,53,35-39,1911,0.007626171003091732
STAT,1893,106,na,1999,1.0526416842600117
STAT,1972,43,15-19,2015,0.0023544406856243548
SIM,1903,20,35-39,1923,12
SIM,1869,52,45-49,1921,1
SIM,1889,33,50-100,1922,4
STAT,1850,49,45-49,1899,0.23787667011721553
STAT,1937,26,25-29,1963,74.1182990996218
SIM,1919,29,35-39,1948,46
STAT,1862,51,35-39,1913,0.008424759096333006
SIM,1940,30,30-34,1970,44
STAT,1859,25,45-49,1884,1.053397788242499
SIM,1855,38,30-34,1893,6
SIM,1871,23,45-49,1894,1
STAT,1960,12,na,1972,5904.312030588295
STAT,1815,52,20-24,1867,0.0014478733416542185
SIM,1915,36,40-44,1951,2
STAT,1901,21,35-39,1922,9.461431711024664
STAT,1882,49,45-49,1931,0.26046838826612245
STAT,1874,26,25-29,1900,50.14840434987609
STAT,1836,20,30-34,1856,22.27971116834813
SIM,1972,22,na,1994,5066
STAT,1861,105,na,1966,0.19011934806387826
STAT,1971,16,20-24,1987,198.22144433565953
SIM,1835,32,45-49,1867,1
STAT,1976,16,35-39,1992,6.4714349931445305
STAT,1929,46,40-44,1975,0.23643676169770653
SIM,1859,32,30-34,1891,46
SIM,1823,34,20-24,1857,9
STAT,1933,44,40-44,1977,0.3954546185585696
STAT,1939,47,40-44,1986,0.1895184082678009
STAT,1878,16,15-19,1894,7.168432608834007
STAT,1880,30,40-44,1910,5.3474915982467515
STAT,1932,30,30-34,1962,24.203838550057768
STAT,1825,37,na,1862,2019.573513954218
SIM,1845,88,na,1933,165
SIM,1864,24,15-19,1888,4
STAT,2005,2,na,2007,6986.055982960117
STAT,1808,56,na,1864,1472.86135457446
STAT,1903,47,na,1950,3681.680002054512
SIM,1866,17,25-29,1883,13
SIM,1844,44,na,1888,2233
STAT,1887,21,40-44,1908,2.7031744811291145
SIM,1940,38,40-44,1978,3
SIM,1963,36,40-44,1999,7
STAT,1864,76,na,1940,976.2441160772139
STAT,1860,62,na,1922,1699.9885474347234
SIM,1971,16,25-29,1987,74
SIM,1918,42,40-44,1960,1
STAT,1859,30,15-19,1889,0.13282311417530054
STAT,1837,33,45-49,1870,1.5668693919511703
STAT,1830,24,45-49,1854,1.200583641008963
SIM,1931,27,30-34,1958,71
STAT,1869,9,na,1878,3033.5803478339967
SIM,1953,56,na,2009,5351
SIM,1958,26,35-39,1984,4
STAT,1858,17,25-29,1875,5.959435733114668
STAT,1923,27,30-34,1950,51.89669620442044
SIM,1882,26,25-29,1908,79
STAT,1907,36,40-44,1943,1.6120454821668246
SIM,1944,31,na,1975,4511
STAT,1902,15,45-49,1917,0.10701159860147194
STAT,1918,15,35-39,1933,1.0621686972571711
SIM,1937,28,40-44,1965,1
SIM,1893,24,na,1917,3436
STAT,1793,105,na,1898,0.0055209852453588296
SIM,1917,21,40-44,1938,5
SIM,1897,38,na,1935,3747
STAT,1848,51,20-24,1899,7.878112211344397E-4
SIM,1870,21,na,1891,2951
STAT,1909,21,40-44,1930,3.621348111413733
SIM,1926,33,35-39,1959,21
STAT,1818,55,na,1873,1082.7030159942592
SIM,1874,10,na,1884,2924
SIM,1881,91,na,1972,76
SIM,1856,33,20-24,1889,2
SIM,1868,46,45-49,1914,1
STAT,1963,16,25-29,1979,63.55417863073378
STAT,1955,48,na,2003,5838.003783936093
SIM,1953,19,30-34,1972,20
STAT,1857,69,na,1926,1319.0436649316073
STAT,1929,28,40-44,1957,6.729127892895481
STAT,1841,42,50-100,1883,0.9760304793676913
SIM,1926,15,35-39,1941,19
SIM,1822,60,na,1882,1163
STAT,1847,43,na,1890,1765.5467746666336
SIM,1845,33,45-49,1878,4
SIM,1891,48,45-49,1939,2
STAT,1857,18,25-29,1875,5.9511418750393625
STAT,1848,33,20-24,1881,3.0164235657274094
STAT,1815,108,na,1923,0.0010163897918288682
SIM,1958,19,45-49,1977,4
STAT,1918,33,35-39,1951,11.157025683116437
STAT,1841,42,20-24,1883,0.14672353891103823
STAT,1964,11,na,1975,5710.4941396756885
STAT,1930,46,na,1976,5597.935983217116
SIM,1876,76,na,1952,1215
STAT,1955,43,30-34,1998,0.20322421203750146
SIM,1872,87,na,1959,532
SIM,1778,78,na,1856,189
STAT,1883,48,45-49,1931,0.26311762769152996
SIM,1841,42,25-29,1883,1
STAT,1871,45,15-19,1916,4.6382868638926737E-4
STAT,1905,17,15-19,1922,9.91261263185154
STAT,1931,25,15-19,1956,1.052963539092545
SIM,1950,38,20-24,1988,1
STAT,1938,67,na,2005,3656.9904099148353
STAT,1879,37,15-19,1916,0.06766730713989559
SIM,1854,39,30-34,1893,14
SIM,1843,22,na,1865,1880
STAT,1925,4,na,1929,5624.979241873997
STAT,1886,36,45-49,1922,2.4383733989220167
STAT,1942,38,20-24,1980,0.32725993248259133
STAT,1900,45,40-44,1945,0.15618634993614677
SIM,1864,21,na,1885,2573
STAT,1900,24,25-29,1924,91.09671058483704
STAT,1846,39,30-34,1885,5.63533788673723
SIM,1894,36,45-49,1930,8
SIM,1930,37,40-44,1967,8
SIM,1904,29,40-44,1933,11
SIM,1969,19,20-24,1988,1
SIM,1862,40,40-44,1902,4
STAT,1824,47,30-34,1871,0.13149190585086898
STAT,1848,21,na,1869,2786.1781924269512
STAT,1996,5,na,2001,6594.317390732805
STAT,1833,42,25-29,1875,0.5514549716449801
STAT,1884,68,na,1952,1742.4829136973428
STAT,1888,28,50-100,1916,0.8647358225628947
STAT,1927,27,15-19,1954,0.9902263176972224
SIM,1987,3,na,1990,6565
STAT,1945,26,20-24,1971,23.121838063834858
STAT,1863,69,na,1932,1480.9129431899269
STAT,1860,25,na,1885,2276.076699360232
SIM,1919,36,25-29,1955,2
SIM,1945,19,35-39,1964,8
SIM,1867,65,na,1932,1462
STAT,1817,70,na,1887,1091.2442027407121
SIM,1931,34,20-24,1965,8
STAT,1884,40,30-34,1924,1.3241030569442007
STAT,1960,16,45-49,1976,0.751059379656627
SIM,1812,97,na,1909,2
STAT,1923,34,20-24,1957,3.221665335317993
STAT,1800,97,na,1897,2.8987908862467076
SIM,1816,39,45-49,1855,3
SIM,1953,26,20-24,1979,28
STAT,1937,19,35-39,1956,4.6995570239926625
STAT,1968,33,na,2001,5553.4018442929955
STAT,1972,36,25-29,2008,1.500233040658861
STAT,1938,16,15-19,1954,51.81665516516037
STAT,1947,30,na,1977,5017.183455045588
STAT,1854,37,15-19,1891,0.04574895206926005
SIM,1884,32,40-44,1916,12
STAT,1920,28,20-24,1948,23.017550978105746
STAT,1783,96,na,1879,1.165125335460552
STAT,1848,54,25-29,1902,0.0036599934250720234
STAT,1842,92,na,1934,32.050274980991894
SIM,1908,28,na,1936,3931
STAT,1843,77,na,1920,867.3146266281549
SIM,1905,19,30-34,1924,3
SIM,1983,17,35-39,2000,10
STAT,1937,44,25-29,1981,0.08289313131157876
SIM,1993,8,na,2001,6960
SIM,1869,31,40-44,1900,13
STAT,1950,60,na,2010,4855.6609802396
STAT,1812,46,20-24,1858,0.028288844815096827
SIM,1839,28,25-29,1867,7
STAT,1917,64,na,1981,3921.860412260491
SIM,1948,5,na,1953,4502
STAT,1919,29,30-34,1948,48.497586132993085
SIM,1896,53,na,1949,3311
SIM,1927,36,20-24,1963,1
SIM,1983,24,25-29,2007,324
STAT,1958,47,35-39,2005,0.2032700756073076
STAT,1876,32,40-44,1908,5.173611078697513
STAT,1831,37,na,1868,2113.4659369170604
STAT,1807,52,25-29,1859,0.01391135898667279
STAT,1953,17,15-19,1970,63.35761038095916
STAT,1920,46,20-24,1966,0.014126866813532613
SIM,1905,37,30-34,1942,1
STAT,1964,45,30-34,2009,0.13541197483360037
SIM,1949,41,na,1990,5821
STAT,1919,36,20-24,1955,0.32704429954136244
SIM,1927,29,30-34,1956,59
STAT,1900,31,50-100,1931,1.4732310556461088
SIM,1945,26,25-29,1971,90
STAT,1845,17,15-19,1862,5.054419969693862
STAT,1938,34,15-19,1972,0.14899723937711634
STAT,1878,35,na,1913,2865.808669136746
STAT,1906,17,na,1923,4250.269309757876
STAT,1906,43,35-39,1949,0.21008668435600913
STAT,1971,23,45-49,1994,1.64951571373181
STAT,1935,52,na,1987,5887.952711055512
SIM,1918,17,na,1935,3674
SIM,1851,88,na,1939,578
SIM,1936,34,20-24,1970,5
SIM,1877,93,na,1970,261
SIM,1916,36,45-49,1952,3
STAT,1855,48,20-24,1903,0.01008244850881876
STAT,1882,46,40-44,1928,0.1935271117324128
STAT,1950,18,40-44,1968,1.907998087893562
STAT,1881,88,na,1969,402.18638000630983
SIM,1823,37,25-29,1860,3
SIM,1885,22,30-34,1907,2
STAT,1880,17,20-24,1897,21.686270691241443
STAT,1930,48,35-39,1978,0.19542461248759901
SIM,1969,23,na,1992,5417
STAT,1824,42,na,1866,1700.8890464820897
STAT,1826,41,40-44,1867,1.7126203099578876
STAT,1963,23,50-100,1986,0.9675962951365238
SIM,1912,26,na,1938,3852
SIM,1938,31,na,1969,3965
SIM,1879,19,na,1898,2951
STAT,1918,30,30-34,1948,19.472224495137382
SIM,1860,31,40-44,1891,1
SIM,1909,22,40-44,1931,6
STAT,1893,25,35-39,1918,14.170560702131043
STAT,1871,20,50-100,1891,0.47098843731850104
STAT,1952,31,45-49,1983,2.2195468711414166
SIM,1956,27,50-100,1983,3
STAT,1846,67,na,1913,1638.7698166945527
STAT,1787,108,na,1895,5.625683153127736E-4
SIM,1832,39,50-100,1871,1
STAT,1920,44,45-49,1964,0.21133028572904355
STAT,1971,34,20-24,2005,3.629446263938308
STAT,1993,16,40-44,2009,2.323064782737691
STAT,1885,54,na,1939,2410.43935261767
STAT,1944,35,15-19,1979,0.024614245961191557
SIM,1823,45,na,1868,2200
SIM,1949,19,na,1968,5236
STAT,1963,31,20-24,1994,3.647426836213392
SIM,1951,24,45-49,1975,2
SIM,1928,11,na,1939,6061
STAT,1935,37,15-19,1972,0.031005675649242
STAT,1899,98,na,1997,69.34307537936708
SIM,1851,31,30-34,1882,38
SIM,1926,30,30-34,1956,36
SIM,1865,43,25-29,1908,2
STAT,1940,42,20-24,1982,0.021512316692662722
SIM,1804,62,na,1866,921
SIM,1827,69,na,1896,643
STAT,1931,44,20-24,1975,0.027142673967577514
STAT,1920,20,45-49,1940,1.4515626025905384
STAT,1808,93,na,1901,14.901710619775365
STAT,1857,43,25-29,1900,0.573008196313455
STAT,1867,35,35-39,1902,7.693368512138883
STAT,1984,18,40-44,2002,2.291848983553278
SIM,1890,75,na,1965,1738
STAT,1855,34,na,1889,2024.9760698188616
SIM,1842,36,na,1878,2294
STAT,1902,29,50-100,1931,1.0356450953970424
STAT,1852,31,40-44,1883,4.277562942090395
STAT,1899,39,45-49,1938,0.6734507052592205
SIM,1797,75,na,1872,384
STAT,1853,50,30-34,1903,0.006011637199404802
STAT,1912,24,15-19,1936,6.1026806743168756
SIM,1825,41,30-34,1866,2
SIM,1942,26,45-49,1968,3
SIM,1952,20,30-34,1972,2
STAT,1837,19,30-34,1856,1.7308479156384815
SIM,1845,19,30-34,1864,1
SIM,1968,29,30-34,1997,63
SIM,1879,49,25-29,1928,1
STAT,1909,47,15-19,1956,3.9107401560793486E-4
STAT,1977,31,35-39,2008,14.533205597630753
STAT,1993,16,na,2009,6113.211348292348
SIM,1804,72,na,1876,475
SIM,1920,24,15-19,1944,7
STAT,1803,52,40-44,1855,0.038198448858061
STAT,1863,16,20-24,1879,20.535171903059894
SIM,1825,34,40-44,1859,10
SIM,1875,35,35-39,1910,29
STAT,1870,38,45-49,1908,2.2567885740109923
STAT,1849,45,40-44,1894,0.13401455822046185
STAT,1841,43,15-19,1884,0.012596152702998742
STAT,1930,15,na,1945,5517.934563596502
STAT,1979,19,40-44,1998,2.2210443097439927
SIM,1821,50,45-49,1871,1
SIM,1856,22,na,1878,2414
STAT,1928,34,20-24,1962,3.515132670552377
STAT,1796,91,na,1887,22.188482204049603
SIM,1848,26,50-100,1874,1
SIM,1872,56,na,1928,2584
STAT,1830,48,30-34,1878,0.0881575976533184
STAT,1896,33,20-24,1929,4.102847481447744
STAT,1847,15,50-100,1862,0.04760876634413836
STAT,1881,38,20-24,1919,0.8537983801604785
SIM,1907,29,45-49,1936,4
SIM,1936,46,na,1982,3885
STAT,1999,4,na,2003,6704.723985746502
STAT,1889,78,na,1967,1564.042191558431
STAT,1895,17,50-100,1912,0.07359520702652847
SIM,1871,16,20-24,1887,24
STAT,1885,33,45-49,1918,1.9988589425384204
SIM,1979,17,25-29,1996,178
STAT,1895,5,na,1900,3936.702149045164
STAT,1988,27,25-29,2015,109.1086425364052
STAT,1970,25,15-19,1995,1.0251410403324426
SIM,1925,34,45-49,1959,5
STAT,1963,42,45-49,2005,0.2535866854152371
STAT,1864,46,20-24,1910,0.012400406776664203
SIM,1951,13,na,1964,6323
STAT,1917,34,45-49,1951,1.8853837989811593
SIM,1858,42,40-44,1900,2
SIM,1893,33,45-49,1926,1
STAT,1820,44,40-44,1864,2.588972814688531
STAT,1817,41,30-34,1858,3.6397073497836057
SIM,1868,24,35-39,1892,9
STAT,1933,26,40-44,1959,7.1486775710593555
STAT,1839,16,15-19,1855,6.1931247610968505
STAT,1980,34,45-49,2014,2.566400946077233
STAT,1903,26,15-19,1929,0.7483452329467315
STAT,1813,50,45-49,1863,0.04796467924502318
STAT,1790,72,na,1862,562.9135042158316
SIM,1986,20,30-34,2006,1
SIM,1884,33,35-39,1917,21
STAT,1910,22,40-44,1932,3.6477564118981123
STAT,1987,16,na,2003,6065.743031798311
SIM,1811,44,na,1855,1737
STAT,1905,15,25-29,1920,9.509240012322618
SIM,1904,23,20-24,1927,215
SIM,1982,21,25-29,2003,4
SIM,1893,30,40-44,1923,3
STAT,1804,50,35-39,1854,0.04125275924157328
STAT,1840,21,20-24,1861,70.81030189983365
STAT,1770,102,na,1872,0.03915323574491769
STAT,1938,15,20-24,1953,155.13224656544332
STAT,1993,16,50-100,2009,0.6222493440606526
STAT,1838,17,25-29,1855,6.484905133127673
SIM,1837,19,25-29,1856,13
STAT,1871,44,50-100,1915,1.1965678487347051
STAT,1934,26,45-49,1960,2.6846116793611206
SIM,1949,18,40-44,1967,3
STAT,1958,49,na,2007,5758.132329421952
STAT,1926,35,50-100,1961,0.5930658621120649
SIM,1941,26,40-44,1967,1
STAT,1918,45,15-19,1963,4.544227907924442E-4
STAT,1924,28,40-44,1952,6.239272288503575
SIM,1822,81,na,1903,250
SIM,1913,15,25-29,1928,19
SIM,1847,16,15-19,1863,11
STAT,1828,37,20-24,1865,0.7933598368586744
STAT,1958,44,30-34,2002,0.2007132688311992
STAT,1962,24,50-100,1986,0.9755154209256413
STAT,1804,52,45-49,1856,0.0667997751208886
STAT,1838,32,na,1870,2332.723558904083
STAT,1974,30,50-100,2004,1.271430185633982
STAT,1980,17,25-29,1997,69.42662872305598
STAT,1925,24,na,1949,5011.346386309962
STAT,1824,53,25-29,1877,0.004554491434265744
STAT,1949,45,45-49,1994,0.3048461325755748
SIM,1932,28,40-44,1960,2
SIM,1833,69,na,1902,852
STAT,1961,45,15-19,2006,5.739821270062885E-4
SIM,1861,19,na,1880,2041
STAT,1874,17,na,1891,2983.870384488421
SIM,1954,33,50-100,1987,2
STAT,1869,22,35-39,1891,6.521781021363657
SIM,1917,63,na,1980,4517
SIM,1906,38,40-44,1944,2
STAT,1807,51,50-100,1858,0.06053289412437388
STAT,1937,41,20-24,1978,0.02059855153534422
SIM,1968,7,na,1975,5398
SIM,1888,27,na,1915,2700
STAT,1843,31,30-34,1874,21.280729102331673
STAT,1786,97,na,1883,1.6415790131620922
STAT,1954,27,25-29,1981,94.30939215784079
STAT,1906,99,na,2005,53.054844505462995
STAT,1943,24,45-49,1967,1.380711506446328
SIM,1962,27,25-29,1989,99
SIM,1862,49,30-34,1911,1
SIM,1911,26,15-19,1937,1
SIM,1902,30,45-49,1932,9
STAT,1908,36,45-49,1944,0.7410831099114776
STAT,1846,57,na,1903,2077.520551464441
SIM,1859,74,na,1933,482
STAT,1890,36,20-24,1926,1.0922213275993429
SIM,1826,32,35-39,1858,2
SIM,1862,27,20-24,1889,15
STAT,1965,47,25-29,2012,0.07949427464428714
SIM,1930,39,30-34,1969,7
STAT,1899,43,30-34,1942,0.12531344196521763
STAT,1866,71,na,1937,1427.7853198008715
STAT,1922,39,30-34,1961,2.387187641582765
STAT,1850,43,25-29,1893,0.6562906219792511
STAT,1909,7,na,1916,4514.090957616681
STAT,1964,48,35-39,2012,0.19438443626353208
SIM,1877,22,35-39,1899,2
SIM,1870,53,45-49,1923,2
STAT,1866,37,40-44,1903,4.6824478399634835
STAT,1854,27,20-24,1881,10.019457552818807
SIM,1851,24,40-44,1875,6
SIM,1853,73,na,1926,911
STAT,1862,53,45-49,1915,0.013907172093107257
STAT,1865,44,15-19,1909,0.014185471734224686
SIM,1874,41,na,1915,2553
STAT,1840,45,20-24,1885,0.009959428029984943
STAT,1843,24,40-44,1867,2.586898036732499
STAT,2003,4,na,2007,6888.127678763381
SIM,1976,26,45-49,2002,3
STAT,1940,21,25-29,1961,108.6620939699145
STAT,1876,33,35-39,1909,12.030392196229169
SIM,1867,40,40-44,1907,3
STAT,1853,39,na,1892,2322.0476291495443
SIM,1858,27,45-49,1885,2
STAT,1815,75,na,1890,571.2296032951433
SIM,1950,33,40-44,1983,7
STAT,1944,26,50-100,1970,1.242112783914399
STAT,1993,19,45-49,2012,0.8288778581202463
STAT,1850,40,20-24,1890,0.16513911427601866
STAT,1914,31,25-29,1945,10.78587348751683
SIM,1835,31,30-34,1866,7
SIM,1958,43,40-44,2001,1
SIM,1851,34,35-39,1885,29
STAT,1975,21,na,1996,5579.96311275151
STAT,1851,49,15-19,1900,3.1057481929101056E-4
SIM,1940,35,25-29,1975,3
SIM,1868,21,30-34,1889,2
STAT,1924,34,35-39,1958,12.284665798529211
STAT,1932,10,na,1942,6074.67793911423
STAT,1846,42,20-24,1888,0.16616562275739308
STAT,1898,40,45-49,1938,0.16373282819818744
STAT,1931,47,25-29,1978,0.08187113905731784
SIM,1916,33,40-44,1949,13
STAT,1936,19,20-24,1955,149.079831128592
STAT,1840,46,35-39,1886,0.11471418177005757
STAT,1951,46,15-19,1997,5.278635730344137E-4
SIM,1969,27,25-29,1996,12
STAT,1912,51,na,1963,4026.515136884558
STAT,1916,43,40-44,1959,0.29536978349046783
STAT,1881,24,na,1905,2616.123869522168
SIM,1885,21,50-100,1906,1
STAT,1908,12,na,1920,4426.656176035625
STAT,1942,33,40-44,1975,4.808597846432502
STAT,1893,22,30-34,1915,25.983107623667696
STAT,1877,54,35-39,1931,0.010050503926944052
SIM,2003,4,na,2007,6669
SIM,1944,19,20-24,1963,187
STAT,1921,18,30-34,1939,15.985975372549698
SIM,1893,40,35-39,1933,8
STAT,1800,76,na,1876,515.6691147519946
STAT,1899,36,40-44,1935,6.954452096654912
STAT,1920,41,40-44,1961,0.31912461404096
STAT,1953,21,35-39,1974,13.192931607373374
SIM,1857,22,50-100,1879,4
STAT,1855,53,50-100,1908,0.012644527853982578
STAT,1971,26,50-100,1997,1.4618141968829488
STAT,1945,49,50-100,1994,0.2948455516566319
SIM,1825,37,45-49,1862,4
SIM,1942,46,na,1988,4927
SIM,1961,21,35-39,1982,19
SIM,1866,24,50-100,1890,1
STAT,1857,21,15-19,1878,3.4479066007965433
SIM,1967,28,na,1995,5736
SIM,1971,38,50-100,2009,1
SIM,1825,44,35-39,1869,7
STAT,1913,67,na,1980,3478.898688286795
STAT,1988,24,20-24,2012,184.01277525294043
STAT,1864,49,25-29,1913,0.058114179899704875
SIM,1802,67,na,1869,802
SIM,1915,78,na,1993,2460
STAT,1824,50,20-24,1874,0.00100701823744377
SIM,1875,32,30-34,1907,60
STAT,1885,30,40-44,1915,5.032161206449595
SIM,1837,89,na,1926,161
STAT,1817,44,35-39,1861,5.297905261399512
SIM,1836,37,20-24,1873,1
SIM,1966,44,30-34,2010,2
STAT,1928,18,30-34,1946,17.677346164850395
STAT,1830,42,na,1872,1607.6155921480104
SIM,1861,21,30-34,1882,26
STAT,1870,35,40-44,1905,5.027690205607032
SIM,1922,31,25-29,1953,45
STAT,1885,40,35-39,1925,2.1054773094342285
SIM,1901,92,na,1993,437
STAT,1875,35,40-44,1910,5.270170368777881
STAT,1906,45,25-29,1951,0.055223613566911946
SIM,1975,29,45-49,2004,5
STAT,1966,42,15-19,2008,0.0023004233522177986
STAT,1876,17,45-49,1893,0.077928367071056
STAT,1892,27,40-44,1919,4.332886487495453
STAT,1891,54,na,1945,2986.730787738603
STAT,1853,21,30-34,1874,21.105295908064644
STAT,1928,37,25-29,1965,1.4359976861944184
SIM,1772,83,na,1855,155
SIM,1870,85,na,1955,425
STAT,1946,42,25-29,1988,0.094989076605314
SIM,1861,43,40-44,1904,2
STAT,1831,47,20-24,1878,0.011117983874296767
STAT,1857,112,na,1969,3.181656878432376E-4
STAT,1863,41,45-49,1904,1.5171084476327932
SIM,1918,29,20-24,1947,16
STAT,1840,53,25-29,1893,0.0027957862807437266
SIM,1871,41,45-49,1912,2
SIM,1885,84,na,1969,1356
STAT,1921,25,20-24,1946,23.628553051202672
SIM,1882,18,na,1900,3458
SIM,1883,35,40-44,1918,5
SIM,1875,25,40-44,1900,6
STAT,1990,21,50-100,2011,1.0914291646921352
SIM,1974,35,25-29,2009,1
STAT,1978,29,20-24,2007,28.845051185050163
SIM,1969,31,35-39,2000,50
SIM,1930,45,na,1975,5965
SIM,1936,37,25-29,1973,2
STAT,1862,20,na,1882,2392.1908825903565
SIM,1897,48,na,1945,3506
STAT,1934,35,na,1969,6004.843783317232
STAT,1960,41,50-100,2001,0.18377411515073455
STAT,1871,51,45-49,1922,0.016741806921430426
STAT,1875,42,30-34,1917,1.3694010313323302
STAT,1853,22,50-100,1875,0.47971067206818097
STAT,1872,54,30-34,1926,0.006708141780909296
STAT,1868,105,na,1973,0.5238658672769364
STAT,1928,66,na,1994,4633.834244146606
SIM,1905,9,na,1914,4586
STAT,1948,25,na,1973,4973.143469552344
SIM,1956,29,40-44,1985,1
STAT,1873,53,20-24,1926,8.556676576172458E-4
STAT,1883,33,25-29,1916,11.516041884797588
STAT,1873,53,na,1926,2496.7442113057964
STAT,1886,30,25-29,1916,12.568659496444946
SIM,1891,33,25-29,1924,2
STAT,1949,42,40-44,1991,0.34888131727716365
SIM,1829,54,na,1883,1476
SIM,1936,18,30-34,1954,18
STAT,1877,47,45-49,1924,0.28198421948834257
STAT,1906,27,na,1933,4016.210746788293
STAT,1843,27,45-49,1870,1.3710460983988957
STAT,1864,86,na,1950,228.6304447395058
STAT,1976,33,40-44,2009,6.146353218399078
STAT,1948,29,40-44,1977,6.176194331092959
SIM,1939,15,30-34,1954,21
STAT,1960,53,na,2013,5621.539230270541
SIM,1944,7,na,1951,4682
STAT,1802,61,na,1863,1285.183491366553
STAT,1863,19,25-29,1882,5.868170186445977
STAT,1939,25,50-100,1964,1.1562522561455861
STAT,1950,40,25-29,1990,0.10154533972149282
SIM,1842,30,25-29,1872,13
SIM,1883,42,30-34,1925,2
STAT,1959,40,45-49,1999,0.26182049573148836
STAT,1817,60,na,1877,1584.3660573788181
SIM,1942,23,40-44,1965,7
STAT,1927,15,45-49,1942,0.7199726639624032
SIM,1815,39,40-44,1854,3
STAT,1871,5,na,1876,3193.040401605643
SIM,1921,38,50-100,1959,1
SIM,1962,24,20-24,1986,11
STAT,1980,31,40-44,2011,6.394339979644135
STAT,1825,58,na,1883,1498.5358160172495
STAT,1928,74,na,2002,3733.9285699661536
STAT,1954,24,20-24,1978,159.05369712203873
STAT,1934,23,40-44,1957,5.215550488897062
SIM,1968,21,35-39,1989,16
SIM,1848,37,na,1885,1797
STAT,1899,46,35-39,1945,0.12521425552050328
SIM,1932,78,na,2010,2682
STAT,1921,26,50-100,1947,1.2841269333216268
STAT,1841,27,25-29,1868,46.713156073497565
SIM,1960,31,45-49,1991,7
STAT,1834,30,25-29,1864,12.224410640524086
STAT,1925,19,45-49,1944,0.692444590635692
STAT,1831,58,na,1889,1555.2769678805391
STAT,1941,48,na,1989,4530.834249381041
STAT,1833,29,40-44,1862,2.7700879919787753
STAT,1888,52,na,1940,2905.4625964680604
STAT,1956,39,40-44,1995,2.3501432444436965
STAT,1817,37,45-49,1854,8.970077987652717
STAT,1821,75,na,1896,629.6104472704352
STAT,1858,86,na,1944,199.75202164789596
STAT,1849,52,30-34,1901,0.004589071208296796
STAT,1821,35,45-49,1856,4.924439140627696
STAT,2009,0,na,2009,7188.81483573392
STAT,1890,46,15-19,1936,3.190731661010546E-4
STAT,1926,10,na,1936,5622.103605340044
STAT,1894,21,na,1915,3519.2352235780054
STAT,1859,43,45-49,1902,1.3659294021319175
SIM,1910,94,na,2004,223
SIM,1892,60,na,1952,3154
STAT,1944,45,45-49,1989,0.2820913470095628
SIM,1935,31,35-39,1966,23
SIM,1952,45,45-49,1997,1
STAT,1887,17,20-24,1904,22.928717661337682
SIM,1941,29,45-49,1970,4
STAT,1827,31,30-34,1858,31.777336815410834
SIM,1867,43,45-49,1910,2
STAT,1908,33,40-44,1941,4.250319443701012
STAT,1968,43,na,2011,5554.550484822682
STAT,1989,11,na,2000,6494.157606069727
SIM,1839,24,50-100,1863,1
SIM,1933,19,45-49,1952,2
STAT,1954,53,na,2007,5335.758344057642
SIM,1895,29,50-100,1924,5
STAT,1987,21,35-39,2008,15.569107008904563
STAT,1890,39,25-29,1929,4.019151864556907
STAT,1926,41,45-49,1967,0.23707259522335838
STAT,1901,15,40-44,1916,0.2970333143448486
SIM,1904,35,na,1939,4174
STAT,1933,29,45-49,1962,2.6458373786079483
SIM,1923,4,na,1927,5771
SIM,1919,34,na,1953,5358
STAT,1927,31,35-39,1958,12.9776407829974
STAT,1950,24,35-39,1974,12.882128442486325
STAT,1859,50,35-39,1909,0.008028081196984713
SIM,1854,37,na,1891,2541
STAT,1821,42,35-39,1863,3.4933546910474718
STAT,1926,41,na,1967,5290.341229525482
SIM,1850,62,na,1912,1064
STAT,1843,34,35-39,1877,11.964764393841376
STAT,1897,39,25-29,1936,0.949327907855619
STAT,1927,46,20-24,1973,0.01604516367055879
SIM,1840,19,30-34,1859,2
STAT,1921,32,45-49,1953,2.020157730015878
STAT,1952,30,30-34,1982,22.23505755730928
STAT,1840,35,na,1875,2074.8066518929622
STAT,1906,42,20-24,1948,0.018536361416604013
STAT,1783,86,na,1869,51.601183467457886
SIM,1837,20,40-44,1857,7
SIM,1950,36,45-49,1986,2
SIM,1939,57,na,1996,4532
STAT,1949,20,30-34,1969,38.72984715029543
STAT,1990,16,25-29,2006,71.64052939680656
STAT,1839,38,25-29,1877,2.700441108180047
STAT,1958,50,na,2008,5739.877479609598
STAT,1942,36,45-49,1978,0.8479518213572544
SIM,1847,38,25-29,1885,5
STAT,1860,20,25-29,1880,61.191618609651165
STAT,1879,26,50-100,1905,0.7734867303595976
STAT,1897,17,15-19,1914,9.157806005791501
STAT,1816,46,40-44,1862,0.35445062129387067
STAT,1814,53,30-34,1867,0.015509600600348209
SIM,1940,32,20-24,1972,4
STAT,1913,45,15-19,1958,4.171059967885879E-4
STAT,1840,48,25-29,1888,0.04600271204834152
STAT,1945,14,na,1959,4950.221702338772
STAT,1872,32,20-24,1904,3.132310436838638
STAT,1824,39,50-100,1863,1.7997843435034069
STAT,1891,42,50-100,1933,1.5049813701884538
SIM,1953,47,50-100,2000,1
SIM,1887,55,na,1942,3372
STAT,1903,74,na,1977,2471.6676807877934
SIM,1957,20,30-34,1977,2
SIM,1972,1,na,1973,5842
STAT,1841,102,na,1943,0.2606589958865103
STAT,1936,25,15-19,1961,0.7808283012195447
STAT,1933,3,na,1936,6268.8227718077
STAT,1825,32,25-29,1857,21.452547754161788
STAT,1830,26,20-24,1856,15.502925995682393
STAT,1846,26,na,1872,2724.9964724423253
SIM,1941,43,50-100,1984,1
STAT,1896,87,na,1983,812.9701534006429
SIM,1902,64,na,1966,3150
SIM,1928,73,na,2001,3856
STAT,1856,20,na,1876,2218.100410538963
SIM,1782,76,na,1858,140
STAT,1853,43,40-44,1896,2.2232446574331823
SIM,1833,32,25-29,1865,5
SIM,1906,30,na,1936,3761
STAT,1932,32,20-24,1964,3.742929352085146
SIM,1798,61,na,1859,1136
SIM,1927,25,na,1952,5097
STAT,1827,53,na,1880,1861.4903609225078
STAT,1798,102,na,1900,0.07457193415508025
STAT,1858,52,40-44,1910,0.009427439737037198
STAT,1885,102,na,1987,7.738046401038467
STAT,1814,80,na,1894,385.7062281136406
STAT,1926,40,30-34,1966,0.18235365875458212
SIM,1930,38,35-39,1968,8
STAT,1840,50,20-24,1890,6.004667708483477E-4
STAT,1940,43,35-39,1983,0.24489961858011958
STAT,1968,47,50-100,2015,0.33910854049424394
SIM,1883,38,45-49,1921,8
STAT,1922,38,35-39,1960,3.1716062941234515
SIM,1813,83,na,1896,227
SIM,1941,51,na,1992,3846
STAT,1959,27,na,1986,5679.54257561236
STAT,1957,49,40-44,2006,0.24806384464855136
STAT,1851,22,25-29,1873,54.211050096616084
SIM,1946,29,na,1975,4643
SIM,1880,32,20-24,1912,9
STAT,1827,53,40-44,1880,0.012615587332785266
STAT,1904,33,20-24,1937,2.5613094510730323
STAT,1875,38,45-49,1913,2.3656310920042474
SIM,1903,42,45-49,1945,2
SIM,1912,33,20-24,1945,6
SIM,1837,80,na,1917,777
STAT,1840,43,30-34,1883,0.9498104960020073
STAT,1953,43,45-49,1996,0.24107965919806662
STAT,1882,27,50-100,1909,0.7210708561627446
SIM,1970,15,15-19,1985,118
STAT,1834,25,50-100,1859,0.7766034064921153
SIM,1960,30,30-34,1990,55
STAT,1846,51,50-100,1897,0.01568765411333737
SIM,1883,51,50-100,1934,1
STAT,1916,47,na,1963,4349.044198528638
STAT,1891,15,20-24,1906,25.40401152832776
STAT,1955,47,30-34,2002,0.142055958037553
STAT,1842,36,40-44,1878,3.992866961530815
STAT,1853,39,20-24,1892,0.7597475284926848
STAT,1895,37,na,1932,3539.129996253772
SIM,1921,37,na,1958,5216
STAT,1874,48,na,1922,2624.6694481290374
SIM,1850,36,40-44,1886,6
STAT,1886,38,20-24,1924,0.9337086637578249
STAT,1865,28,25-29,1893,43.89156722870581
STAT,1863,35,15-19,1898,0.05720430408534026
SIM,1889,44,25-29,1933,1
STAT,1918,39,20-24,1957,0.319901490553669
SIM,1868,82,na,1950,535
STAT,1930,23,20-24,1953,163.90485640429418
SIM,1985,21,40-44,2006,12
STAT,1873,16,15-19,1889,7.0352454614825515
SIM,1952,29,20-24,1981,19
SIM,1834,42,35-39,1876,4
STAT,1937,18,50-100,1955,0.41975014052030923
SIM,1900,79,na,1979,1767
STAT,1966,18,50-100,1984,0.5398655151686634
SIM,1964,38,35-39,2002,5
STAT,1884,45,45-49,1929,0.2717748860499672
STAT,1927,88,na,2015,1195.6967940324562
SIM,1889,40,na,1929,3747
SIM,1982,30,50-100,2012,4
STAT,1929,18,15-19,1947,66.66864906561766
SIM,1965,49,40-44,2014,1
SIM,1952,29,na,1981,4607
STAT,1910,25,45-49,1935,1.9567978457618806
SIM,1843,42,45-49,1885,1
SIM,1974,32,20-24,2006,6
SIM,1848,68,na,1916,903
SIM,1837,90,na,1927,125
STAT,1981,22,45-49,2003,1.8217076551400098
SIM,1843,80,na,1923,199
STAT,1833,54,50-100,1887,0.010599750081413043
STAT,1944,29,20-24,1973,22.746577214246056
SIM,1947,35,25-29,1982,2
SIM,1879,29,na,1908,2808
SIM,1899,43,na,1942,3938
STAT,1915,62,na,1977,3889.55715175559
STAT,1973,33,25-29,2006,14.052896086409493
SIM,1944,21,50-100,1965,3
STAT,1880,31,35-39,1911,12.438469326439328
SIM,1857,48,45-49,1905,1
STAT,1862,47,15-19,1909,3.8775642886044955E-4
STAT,1920,22,na,1942,4683.168849524987
STAT,1820,80,na,1900,363.0539703912401
SIM,1914,29,35-39,1943,2
SIM,1907,32,35-39,1939,20
STAT,1906,29,35-39,1935,16.121846516727643
SIM,1885,44,40-44,1929,10
SIM,1946,39,na,1985,4611
SIM,1868,41,na,1909,3032
STAT,1842,15,25-29,1857,5.666251579510916
STAT,1877,44,40-44,1921,2.6636850544711606
SIM,1903,28,30-34,1931,7
SIM,1921,78,na,1999,2889
STAT,1877,51,30-34,1928,0.007179897317848836
SIM,1862,41,35-39,1903,5
STAT,1852,33,30-34,1885,16.867604041809816
STAT,1878,53,20-24,1931,8.748836480242689E-4
SIM,1897,32,15-19,1929,2
SIM,1883,89,na,1972,233
STAT,1925,16,40-44,1941,1.954086528270886
SIM,1952,42,40-44,1994,1
STAT,1971,32,na,2003,5634.919871195121
STAT,1827,49,20-24,1876,0.014797036418498132
STAT,1889,32,15-19,1921,0.2025847805564965
STAT,1921,47,30-34,1968,0.11593350077355456
STAT,1847,26,15-19,1873,0.4226390086929208
SIM,1900,23,35-39,1923,23
STAT,1853,51,45-49,1904,0.01451796719478424
SIM,1860,33,30-34,1893,20
SIM,1934,35,50-100,1969,2
STAT,1932,19,35-39,1951,6.379425989456067
STAT,1902,40,45-49,1942,0.17118080659499346
STAT,1939,35,25-29,1974,1.1743080042769578
STAT,1826,42,35-39,1868,1.3577416044808366
SIM,1844,75,na,1919,881
STAT,1940,45,25-29,1985,0.06497663512749385
STAT,1837,45,15-19,1882,3.08478327521068E-4
SIM,1934,73,na,2007,3653
STAT,1862,37,20-24,1899,0.7507547153519732
SIM,1924,46,45-49,1970,1
SIM,1899,33,na,1932,4127
STAT,1994,7,na,2001,6545.840436015158
STAT,1930,49,30-34,1979,0.13470463309687794
STAT,1876,33,na,1909,2834.8050483485513
STAT,1909,62,na,1971,3550.2461710467687
SIM,1874,37,40-44,1911,5
STAT,1861,32,45-49,1893,1.6730356076832074
SIM,1921,21,50-100,1942,5
SIM,1869,27,20-24,1896,13
STAT,1949,35,50-100,1984,0.5815670622931761
SIM,1952,39,na,1991,4700
STAT,1916,46,45-49,1962,0.2579258770210875
STAT,1936,65,na,2001,3665.2865119839016
STAT,1976,36,45-49,2012,1.0838526266265254
STAT,1944,42,40-44,1986,0.3228395909296541
STAT,1820,40,50-100,1860,1.384376141397406
STAT,1913,77,na,1990,2507.2587407694223
STAT,1826,43,30-34,1869,0.8489859775974709
STAT,1854,49,30-34,1903,0.07721607570681363
STAT,1826,46,50-100,1872,0.17903829927763482
STAT,1912,18,20-24,1930,31.585407088913612
SIM,1834,46,50-100,1880,1
STAT,1965,27,na,1992,5420.631319248018
SIM,1939,37,40-44,1976,6
SIM,1873,28,25-29,1901,1
SIM,1927,2,na,1929,5416
SIM,1973,25,25-29,1998,170
SIM,1966,0,na,1966,5958
STAT,1925,22,35-39,1947,13.002822138336006
SIM,1825,61,na,1886,1264
STAT,1853,46,45-49,1899,0.23563319400441227
STAT,1975,40,15-19,2015,0.0024365086618532857
STAT,1868,43,50-100,1911,1.1628980097829453
STAT,1878,99,na,1977,24.466504180711578
STAT,1917,31,40-44,1948,4.748583211865173
STAT,1923,29,na,1952,4926.253298986279
STAT,1800,66,na,1866,1057.1285118532307
STAT,1867,40,15-19,1907,0.015030075474788579
STAT,1943,18,50-100,1961,0.45839499781679577
STAT,1903,30,35-39,1933,16.780448308230408
STAT,1940,40,30-34,1980,0.15616273556026553
SIM,1951,21,40-44,1972,10
SIM,1951,18,50-100,1969,1
SIM,1876,43,50-100,1919,1
SIM,1925,31,40-44,1956,12
STAT,1974,25,35-39,1999,22.741911162571967
STAT,1904,1,na,1905,4510.729379403737
STAT,1952,33,35-39,1985,12.874324493342385
SIM,1912,36,25-29,1948,2
STAT,1860,89,na,1949,97.71118962772164
STAT,1970,19,20-24,1989,195.72529957873442
STAT,1965,25,25-29,1990,95.32396447067072
STAT,1821,105,na,1926,0.017932278627247413
STAT,1816,49,45-49,1865,0.4670113372379472
STAT,1901,18,45-49,1919,0.10531604878497594
STAT,1836,32,50-100,1868,1.0543730867758676
STAT,1904,36,25-29,1940,1.0348347593089138
SIM,1960,33,35-39,1993,27
STAT,1852,23,50-100,1875,0.4534533567146488
STAT,1815,65,na,1880,1105.597015101265
STAT,1853,53,35-39,1906,0.008433720712143558
STAT,1943,21,40-44,1964,4.130155757412194
STAT,1898,113,na,2011,0.002566166227215688
STAT,1806,54,na,1860,1122.6437407904582
STAT,1895,47,na,1942,3364.5619009274074
STAT,1772,84,na,1856,13.0993298
STAT,1830,40,35-39,1870,1.791267067594209
STAT,1835,42,45-49,1877,1.119171420341555
SIM,1839,16,na,1855,2607
STAT,1930,47,40-44,1977,0.23964258911718841
STAT,1884,21,25-29,1905,65.46971157763517
STAT,1953,29,30-34,1982,54.88309965161246
SIM,1860,32,35-39,1892,2
SIM,1817,76,na,1893,221
SIM,1873,25,20-24,1898,2
STAT,1882,51,20-24,1933,8.357736183070731E-4
STAT,1820,47,45-49,1867,0.24487425323045373
SIM,1918,48,na,1966,3739
STAT,1842,39,45-49,1881,1.6039261259111994
STAT,1966,13,na,1979,5661.169133061564
STAT,1828,38,na,1866,1825.1244860782544
SIM,1956,35,35-39,1991,5
SIM,1903,49,na,1952,3457
SIM,1867,42,30-34,1909,3
SIM,1893,55,na,1948,2813
SIM,1848,23,20-24,1871,62
STAT,1873,52,25-29,1925,0.004152004695639036
STAT,1893,30,15-19,1923,0.2094024990342361
SIM,1858,43,35-39,1901,5
STAT,1957,27,40-44,1984,7.122742062499042
SIM,1948,44,40-44,1992,1
SIM,1907,26,40-44,1933,10
STAT,1852,32,35-39,1884,9.885745433730776
STAT,1926,43,35-39,1969,0.2859730992510189
STAT,1952,40,50-100,1992,0.1693142911421208
STAT,1849,48,45-49,1897,0.18061775274433609
SIM,1837,23,45-49,1860,1
SIM,1834,43,30-34,1877,1
STAT,1948,35,35-39,1983,3.2966920454079
STAT,1875,45,35-39,1920,0.16862791175874434
SIM,1900,38,na,1938,3530
STAT,1787,83,na,1870,106.54616394895571
SIM,1965,27,40-44,1992,1
STAT,2008,1,na,2009,7110.683672132985
STAT,1880,39,30-34,1919,6.453744869887919
STAT,1943,43,na,1986,4716.357677980505
SIM,1832,43,na,1875,2048
STAT,1977,24,45-49,2001,1.7590773334194516
STAT,1951,14,na,1965,5396.2124964786035
STAT,1938,28,na,1966,4283.093886010882
STAT,1898,27,25-29,1925,65.97669391485643
SIM,1823,76,na,1899,1111
SIM,1791,87,na,1878,70
SIM,1853,42,na,1895,2234
STAT,1938,18,25-29,1956,49.341188163702085
SIM,1884,30,30-34,1914,39
SIM,1905,85,na,1990,884
STAT,1973,30,20-24,2003,3.715105578506918
SIM,1802,77,na,1879,281
STAT,1931,37,30-34,1968,2.786201203801786
STAT,1859,42,30-34,1901,1.0555942125756088
STAT,1849,46,50-100,1895,0.1908972126638734
SIM,1961,29,30-34,1990,69
STAT,1774,105,na,1879,8.611549402127827E-4
STAT,1965,44,20-24,2009,0.02635467398894201
SIM,1892,21,25-29,1913,3
STAT,1889,47,na,1936,3186.2254923898454
SIM,1934,43,35-39,1977,1
STAT,1884,42,40-44,1926,2.561513985962193
SIM,1892,34,50-100,1926,2
STAT,1831,47,50-100,1878,0.22754806095138402
SIM,1770,88,na,1858,57
STAT,1891,18,25-29,1909,8.061381500717655
STAT,1930,26,25-29,1956,96.64213728250029
SIM,1955,10,na,1965,6579
SIM,1946,18,25-29,1964,69
STAT,1930,77,na,2007,3381.518985937991
STAT,1809,52,45-49,1861,0.0350782486647792
STAT,1876,30,30-34,1906,20.99650070394827
SIM,1920,52,na,1972,4026
STAT,1922,35,30-34,1957,2.3964245190909685
SIM,1851,57,na,1908,2415
STAT,1834,79,na,1913,638.0038661002737
SIM,1871,71,na,1942,869
STAT,1898,48,40-44,1946,0.14872743296450588
SIM,1833,28,na,1861,1860
STAT,1953,36,20-24,1989,0.37948997089630976
STAT,1907,17,35-39,1924,0.9316942363301568
STAT,1884,34,50-100,1918,1.0357779118665975
SIM,1892,70,na,1962,2697
SIM,1930,35,30-34,1965,7
STAT,1875,92,na,1967,160.9699561651474
STAT,1885,32,30-34,1917,20.098042386953143
STAT,1856,19,na,1875,2361.6567436995797
SIM,1819,61,na,1880,649
SIM,1959,41,35-39,2000,2
STAT,1845,54,20-24,1899,4.835765360386968E-4
SIM,1844,32,50-100,1876,2
STAT,1950,48,20-24,1998,0.01564161584379334
SIM,1886,26,45-49,1912,1
STAT,1905,47,30-34,1952,0.09077984390809875
SIM,1776,80,na,1856,356
SIM,1886,70,na,1956,1006
SIM,1937,16,25-29,1953,109
STAT,1910,2,na,1912,4666.300457192464
STAT,1933,43,50-100,1976,0.18606485041558113
SIM,1945,6,na,1951,4821
STAT,1825,68,na,1893,1080.937314916335
STAT,1902,34,na,1936,3890.686922833207
STAT,1907,24,25-29,1931,96.59310065301516
STAT,1854,93,na,1947,23.80984006807527
SIM,1881,23,na,1904,1750
SIM,1970,17,na,1987,5658
STAT,1862,50,40-44,1912,0.01040056212613525
STAT,1923,92,na,2015,550.2598138194543
STAT,1894,20,50-100,1914,0.6085826723008962
STAT,1913,40,20-24,1953,0.020111038477954698
STAT,1929,16,25-29,1945,63.9839250839023
STAT,1917,33,na,1950,4551.323144161974
SIM,1893,32,30-34,1925,54
STAT,1961,27,15-19,1988,1.0571255367447234
SIM,1997,12,na,2009,6607
SIM,1934,11,na,1945,5985
SIM,1949,10,na,1959,5902
SIM,1915,24,25-29,1939,133
STAT,1927,39,30-34,1966,2.608933935850333
STAT,1990,23,15-19,2013,8.82383431120019
STAT,1833,94,na,1927,14.063677256690799
SIM,1913,12,na,1925,5086
STAT,1863,60,na,1923,1924.5543878968253
STAT,1946,44,15-19,1990,0.0020359791816774754
STAT,1793,79,na,1872,286.36028180169063
STAT,1866,29,50-100,1895,0.6793640606176503
STAT,1890,109,na,1999,0.1008905071549249
STAT,1928,42,50-100,1970,0.17283284834615872
SIM,1968,43,35-39,2011,1
STAT,1878,26,45-49,1904,1.3424571231191464
SIM,1935,39,30-34,1974,6
STAT,1910,43,50-100,1953,0.12749454027303847
STAT,1877,18,na,1895,3023.907608141159
STAT,1946,20,15-19,1966,6.8408347427931115
STAT,1935,38,20-24,1973,0.42519343263507503
STAT,1903,2,na,1905,4381.751040346064
SIM,1973,22,20-24,1995,8
SIM,1860,44,40-44,1904,6
STAT,1777,102,na,1879,0.06372184366167004
STAT,2003,11,na,2014,6881.311300601302
STAT,1882,45,35-39,1927,0.1593833992815163
STAT,1845,51,40-44,1896,0.007128050890414733
SIM,1859,43,na,1902,2218
STAT,1970,40,45-49,2010,0.2505563537464697
STAT,1784,87,na,1871,59.40020677055867
STAT,1771,101,na,1872,0.16327840748506964
SIM,1958,33,35-39,1991,36
STAT,1841,46,30-34,1887,0.08756884005022877
STAT,1851,39,50-100,1890,0.9637948754073306
STAT,1955,15,15-19,1970,69.56467230056315
STAT,1958,24,na,1982,5549.67779553239
STAT,1878,45,15-19,1923,4.867869700365393E-4
SIM,1938,56,na,1994,3940
SIM,1954,28,25-29,1982,94
STAT,1798,95,na,1893,3.3818505909356285
SIM,1892,85,na,1977,1025
SIM,1954,39,35-39,1993,5
STAT,1987,25,20-24,2012,30.229589633338335
STAT,1950,44,na,1994,5249.128979860851
STAT,1911,21,40-44,1932,3.6943381009814487
STAT,1857,34,15-19,1891,0.12690167400105956
STAT,1939,32,20-24,1971,2.8732854095111358
SIM,1880,21,35-39,1901,16
STAT,1792,82,na,1874,251.29816865198327
STAT,1946,28,25-29,1974,84.57249981167885
STAT,1954,22,45-49,1976,1.6105502253740316
STAT,1929,11,na,1940,5844.625951040857
SIM,1806,76,na,1882,608
SIM,1857,26,35-39,1883,2
SIM,1961,39,50-100,2000,4
STAT,1849,15,25-29,1864,5.470581166692647
STAT,1842,25,40-44,1867,2.8920583895707415
SIM,1850,25,40-44,1875,2
STAT,1945,55,na,2000,4666.167094288186
STAT,1992,9,na,2001,6509.391768978576
STAT,1942,49,na,1991,4582.3404984129875
STAT,1976,25,45-49,2001,2.6774755638442325
SIM,1825,55,na,1880,1552
STAT,1892,19,45-49,1911,0.09397801203782288
STAT,1817,51,35-39,1868,0.024126653024905454
STAT,1939,43,30-34,1982,0.15329888386979051
SIM,1951,38,na,1989,6247
STAT,1909,48,20-24,1957,0.011699615186707441
STAT,1965,35,40-44,2000,2.2258852830229907
SIM,1867,45,35-39,1912,1
SIM,1814,71,na,1885,677
STAT,1931,65,na,1996,4942.716665647075
STAT,1829,38,30-34,1867,5.990385065976548
STAT,1916,98,na,2014,90.0328421575989
STAT,1850,33,20-24,1883,2.8808641110104016
SIM,1948,28,50-100,1976,2
STAT,1831,39,25-29,1870,2.788637246077038
SIM,1867,34,25-29,1901,4
SIM,1897,17,na,1914,4080
STAT,1843,41,35-39,1884,1.8948627047018562
STAT,1895,45,45-49,1940,0.2019709722708088
SIM,1893,37,50-100,1930,7
STAT,1877,21,50-100,1898,0.4910078599369875
SIM,1967,20,25-29,1987,281
STAT,1932,35,50-100,1967,0.6523052270307794
STAT,1895,30,50-100,1925,1.387440228436966
STAT,1949,17,40-44,1966,1.8773143698054837
STAT,1864,15,20-24,1879,21.01391854670128
STAT,1961,28,20-24,1989,27.32112536439058
STAT,1829,49,40-44,1878,0.1701123440654422
SIM,1868,20,na,1888,3080
STAT,1884,44,30-34,1928,1.293181483631295
STAT,1832,51,30-34,1883,0.004384497232415427
STAT,1853,15,45-49,1868,0.07916427651758058
STAT,1900,46,35-39,1946,0.12682076199096584
SIM,1980,18,25-29,1998,174
SIM,1930,47,50-100,1977,1
STAT,1950,28,45-49,1978,2.366455126898599
STAT,1805,82,na,1887,212.53064408168575
STAT,1959,20,25-29,1979,139.99605836182752
SIM,1956,8,na,1964,5520
STAT,1901,27,na,1928,3857.773621621851
SIM,1843,68,na,1911,1177
SIM,1957,17,40-44,1974,3
SIM,1851,63,na,1914,2172
SIM,1836,18,15-19,1854,14
STAT,1972,18,25-29,1990,64.01188392715963
STAT,1889,53,na,1942,3013.9325515920823
STAT,1898,37,40-44,1935,6.827505016094764
STAT,1971,33,15-19,2004,0.19134157926967427
SIM,1837,38,30-34,1875,14
SIM,1851,41,35-39,1892,2
STAT,1861,23,25-29,1884,56.01823791354252
STAT,1933,25,35-39,1958,23.03608374885241
SIM,1970,40,40-44,2010,1
SIM,1973,35,40-44,2008,5
STAT,1856,66,na,1922,1443.065299901815
SIM,1949,46,45-49,1995,1
STAT,1917,42,40-44,1959,0.30124465256999583
STAT,1978,24,40-44,2002,5.3094962298292705
SIM,1937,25,15-19,1962,1
SIM,1922,28,35-39,1950,2
SIM,1905,69,na,1974,3124
STAT,1824,43,20-24,1867,0.22223938924955927
SIM,1898,29,30-34,1927,5
STAT,1851,35,na,1886,1927.909683503167
SIM,1922,17,25-29,1939,56
STAT,1868,91,na,1959,102.82790338920796
STAT,1918,22,35-39,1940,11.717209049647506
SIM,1866,31,50-100,1897,3
STAT,1805,49,25-29,1854,0.21045912516499649
STAT,1846,88,na,1934,141.92131804632203
STAT,1842,74,na,1916,854.0103134483624
STAT,1885,23,40-44,1908,2.391279693868583
STAT,1914,17,25-29,1931,10.350061446743481
STAT,1962,40,40-44,2002,0.3854318224456826
STAT,1864,61,na,1925,1925.5197857784317
SIM,1771,89,na,1860,10
STAT,1839,52,25-29,1891,0.0027940388380391515
STAT,1834,54,45-49,1888,0.013052246336852659
STAT,1941,42,50-100,1983,0.14516207612882523
STAT,1854,44,15-19,1898,0.011098961481521862
STAT,1859,36,45-49,1895,1.841442230487666
STAT,1874,34,20-24,1908,3.1661796302186875
SIM,1874,29,45-49,1903,2
SIM,1800,63,na,1863,1145
STAT,1843,56,na,1899,2046.529948414079
STAT,1933,22,30-34,1955,44.016186758310205
STAT,1824,30,45-49,1854,5.428564586821348
SIM,1843,33,25-29,1876,23
STAT,1840,26,15-19,1866,0.4570879629082775
STAT,1902,52,na,1954,3492.420326997312
STAT,1808,48,50-100,1856,1.2068122081365529
STAT,1929,25,15-19,1954,1.0235380837681882
STAT,1968,29,15-19,1997,1.020956807974706
SIM,1913,80,na,1993,2345
STAT,1928,32,45-49,1960,2.2706430014121293
STAT,1973,30,45-49,2003,2.3967231822746258
SIM,1880,20,na,1900,3144
STAT,1903,27,20-24,1930,19.283892202132833
STAT,1859,45,35-39,1904,0.12998577017139898
STAT,1977,38,50-100,2015,0.6737984552866094
SIM,1884,34,na,1918,2706
STAT,1954,49,25-29,2003,0.07825526230631888
STAT,1869,52,40-44,1921,0.011703153237825689
SIM,1916,13,na,1929,4829
STAT,1868,28,40-44,1896,3.3096929996982825
SIM,1882,34,20-24,1916,4
SIM,1863,29,na,1892,2552
STAT,1839,41,15-19,1880,0.01284795296286563
SIM,1888,42,45-49,1930,4
STAT,1979,18,35-39,1997,6.665465456354252
SIM,1911,27,20-24,1938,43
STAT,1819,74,na,1893,738.8000352825219
STAT,1891,21,15-19,1912,4.719664135281812
STAT,1864,16,50-100,1880,0.05772883852126336
SIM,1793,92,na,1885,13
STAT,1810,50,40-44,1860,0.04014934929970966
SIM,1936,32,45-49,1968,5
STAT,1972,34,50-100,2006,1.2436773209082808
STAT,1937,62,na,1999,3898.3272547320544
STAT,1849,26,35-39,1875,8.929264434182853
STAT,1890,17,15-19,1907,8.36842992725363
STAT,1820,49,20-24,1869,0.011907244534407307
STAT,1891,32,25-29,1923,14.609212757406693
STAT,1946,46,50-100,1992,0.30187950043735284
STAT,1913,49,25-29,1962,0.05943153934071636
SIM,1821,40,40-44,1861,3
STAT,1867,10,na,1877,2925.8549800976725
STAT,1907,21,20-24,1928,117.364938821852
STAT,1868,20,30-34,1888,20.036372249710045
SIM,1854,12,na,1866,3179
STAT,1943,32,40-44,1975,4.882079606381478
STAT,1791,107,na,1898,0.0010095250690430142
STAT,1871,44,20-24,1915,0.17987621598380935
SIM,1835,22,40-44,1857,4
SIM,1842,17,30-34,1859,5
SIM,1965,44,na,2009,5491
STAT,1924,38,45-49,1962,0.9265103713748588
STAT,1818,92,na,1910,18.428248848075288
STAT,1838,53,na,1891,1835.1493398954203
STAT,1986,21,na,2007,6026.822358107317
STAT,1835,33,25-29,1868,8.05853570607012
STAT,1953,50,na,2003,5286.662152849492
STAT,1998,15,25-29,2013,73.46887365027
STAT,1790,99,na,1889,0.38382947914384824
SIM,1884,35,50-100,1919,5
STAT,1862,1,na,1863,3540.9936146020545
STAT,1935,77,na,2012,3626.5730232255264
SIM,1944,66,na,2010,3896
STAT,1896,38,15-19,1934,0.08517106373280212
STAT,1913,48,40-44,1961,0.17719126431122997
STAT,1848,47,25-29,1895,0.06091627039760097
STAT,1885,24,25-29,1909,65.48343355657111
STAT,1860,41,40-44,1901,2.101537046525391
STAT,1882,31,45-49,1913,1.9736954739916994
STAT,1881,29,40-44,1910,3.3106174204415715
SIM,1959,18,na,1977,5641
SIM,1876,20,30-34,1896,46
SIM,1934,22,50-100,1956,1
STAT,1879,111,na,1990,0.01095247538435384
SIM,1998,15,na,2013,6853
STAT,1813,61,na,1874,1074.836725417406
SIM,1893,35,35-39,1928,4
SIM,1951,32,40-44,1983,1
SIM,1915,21,20-24,1936,239
STAT,1968,17,20-24,1985,195.42031919711633
SIM,1846,25,20-24,1871,10
STAT,1885,35,35-39,1920,8.219028166221317
STAT,1980,28,15-19,2008,1.1353392032066583
SIM,1832,30,45-49,1862,1
SIM,1909,35,50-100,1944,1
STAT,1887,70,na,1957,1883.2988234416946
STAT,1918,9,na,1927,4999.356789783927
SIM,1932,38,45-49,1970,2
STAT,1812,46,50-100,1858,0.5789783342923805
STAT,1907,32,30-34,1939,17.02282504505966
SIM,1915,32,30-34,1947,38
STAT,1883,4,na,1887,3167.8419738938255
SIM,1946,51,na,1997,4457
STAT,1880,91,na,1971,257.9858738148107
STAT,1838,25,20-24,1863,13.116534310148554
SIM,1893,24,25-29,1917,92
SIM,1976,17,20-24,1993,190
STAT,1995,20,25-29,2015,154.92318271208424
STAT,1935,25,45-49,1960,2.7215741442173553
STAT,1969,30,35-39,1999,13.44389707881374
SIM,1890,31,45-49,1921,6
STAT,1846,31,35-39,1877,12.501095684563674
STAT,1918,67,na,1985,3790.1417457125176
STAT,1936,18,15-19,1954,50.04145584419193
STAT,1807,49,35-39,1856,0.5592103889563744
SIM,1860,24,na,1884,2739
SIM,1990,20,15-19,2010,10
STAT,1795,107,na,1902,8.263697945698749E-4
SIM,1964,30,25-29,1994,27
SIM,1916,69,na,1985,3640
SIM,1841,31,25-29,1872,12
SIM,1899,5,na,1904,4594
SIM,1964,49,35-39,2013,1
STAT,1970,18,15-19,1988,65.54115417816672
SIM,1841,20,15-19,1861,5
SIM,1978,13,na,1991,6034
STAT,1940,18,35-39,1958,4.916831082898574
SIM,1939,36,35-39,1975,5
SIM,1934,26,na,1960,5846
STAT,1862,35,na,1897,2316.354262695819
STAT,1950,44,50-100,1994,0.1660417249467038
SIM,1867,33,40-44,1900,12
STAT,1798,79,na,1877,257.85026234016567
STAT,1861,20,20-24,1881,68.90863689585683
STAT,1867,42,35-39,1909,1.9487287321650282
STAT,1900,49,15-19,1949,3.537748148653449E-4
SIM,1873,50,na,1923,3032
SIM,1847,98,na,1945,47
STAT,1793,64,na,1857,840.5194729777598
STAT,1956,49,35-39,2005,0.2035903049383548
SIM,1854,31,35-39,1885,14
SIM,1957,49,na,2006,6110
STAT,1867,66,na,1933,1766.0144649536126
STAT,1822,49,30-34,1871,0.1778114552520251
STAT,1821,53,20-24,1874,0.0012614261261327656
STAT,1873,18,50-100,1891,0.05758516244559294
SIM,1878,2,na,1880,3698
SIM,1845,42,50-100,1887,4
STAT,1984,30,20-24,2014,4.079805451798366
STAT,1872,35,25-29,1907,3.3681064276615604
STAT,1881,18,30-34,1899,1.7695341052774465
STAT,1950,25,40-44,1975,6.393250640946039
SIM,1876,23,35-39,1899,15
SIM,1871,31,40-44,1902,7
STAT,1889,37,na,1926,3351.540719710672
STAT,1882,42,30-34,1924,1.29432778403628
SIM,1827,81,na,1908,189
STAT,1996,15,15-19,2011,76.15606662535731
SIM,1890,42,30-34,1932,8
SIM,1942,21,na,1963,4464
STAT,1805,66,na,1871,971.8844470099018
STAT,1861,22,40-44,1883,2.0538778072796324
STAT,1956,30,25-29,1986,14.403202119118088
SIM,1865,55,na,1920,2584
STAT,1846,47,15-19,1893,4.1158467482108567E-4
STAT,1868,23,35-39,1891,6.450198486913772
STAT,1923,14,na,1937,5350.024301062314
STAT,1871,41,40-44,1912,2.594137881150665
STAT,1885,23,na,1908,2714.017045873895
STAT,1863,47,20-24,1910,0.012052868114505963
SIM,1817,43,25-29,1860,2
SIM,1864,41,45-49,1905,1
STAT,1893,32,35-39,1925,14.772538934203492
STAT,1937,44,50-100,1981,0.1363725700102124
STAT,1849,22,50-100,1871,0.382132546183006
SIM,1815,41,25-29,1856,2
STAT,1838,37,15-19,1875,0.05870468249690604
SIM,1814,55,na,1869,1202
SIM,1875,33,50-100,1908,4
SIM,1935,5,na,1940,6540
SIM,1878,23,45-49,1901,5
STAT,1847,15,15-19,1862,5.767009730141515
STAT,1965,38,45-49,2003,1.0108789974410097
STAT,1867,33,50-100,1900,0.9830778111946035
STAT,1982,20,15-19,2002,8.67899531403584
STAT,1926,19,na,1945,5178.977808429506
SIM,1970,32,35-39,2002,4
SIM,1984,23,na,2007,5819
STAT,1872,21,35-39,1893,6.7825827541558
STAT,1914,28,35-39,1942,17.41354819040743
SIM,1915,47,na,1962,4502
STAT,1823,79,na,1902,395.8948000566524
SIM,1977,30,25-29,2007,30
STAT,1873,3,na,1876,3658.9208256532793
STAT,1824,44,35-39,1868,2.4919244404182748
STAT,1913,93,na,2006,368.25117875618645
STAT,1895,42,40-44,1937,0.2343449945148473
SIM,1921,16,na,1937,5162
STAT,1893,48,15-19,1941,3.2499962230699085E-4
STAT,1944,28,15-19,1972,0.8801507651576297
STAT,1961,15,45-49,1976,0.7452107839035006
SIM,1952,28,15-19,1980,3
SIM,1825,71,na,1896,950
SIM,1876,55,na,1931,2396
STAT,1832,54,35-39,1886,0.005975399922663449
SIM,1832,44,35-39,1876,2
STAT,1850,20,45-49,1870,0.8741143797452883
STAT,1848,31,na,1879,2713.464672873395
STAT,1885,38,15-19,1923,0.06431942150839652
SIM,1918,37,50-100,1955,1
STAT,1821,48,50-100,1869,0.4383141949965841
SIM,1894,12,na,1906,4141
SIM,1871,24,na,1895,2056
SIM,1861,22,50-100,1883,1
SIM,1839,32,20-24,1871,5
STAT,1948,20,25-29,1968,122.47727592662679
SIM,1905,0,na,1905,4996
SIM,1945,26,na,1971,4558
SIM,1901,39,na,1940,4051
SIM,1866,77,na,1943,645
STAT,1806,54,50-100,1860,0.051069902233776415
STAT,1958,43,25-29,2001,0.11230665122026455
SIM,1824,35,40-44,1859,9
STAT,1855,28,30-34,1883,22.173887396908817
SIM,1888,80,na,1968,701
SIM,1863,28,30-34,1891,29
SIM,1827,38,na,1865,1547
SIM,1844,93,na,1937,29
STAT,1937,49,40-44,1986,0.18271317059577533
STAT,1932,45,40-44,1977,0.2480410171022646
STAT,1978,27,45-49,2005,2.732695182961611
STAT,1844,27,40-44,1871,3.0672252425485547
STAT,1852,107,na,1959,0.010765168049625807
SIM,1889,65,na,1954,2736
SIM,1945,49,40-44,1994,1
STAT,1864,27,15-19,1891,0.46751396068751166
SIM,1828,41,35-39,1869,7
STAT,1924,5,na,1929,5524.141707690542
SIM,1917,35,45-49,1952,1
SIM,1956,20,25-29,1976,135
STAT,1976,23,35-39,1999,14.560640085583335
STAT,1962,43,45-49,2005,0.2553475476024475
STAT,1918,38,15-19,1956,0.02333021486598469
SIM,1956,39,45-49,1995,1
SIM,1918,28,15-19,1946,1
STAT,1964,40,15-19,2004,0.0023261631587732966
STAT,1860,44,45-49,1904,1.3732480804982048
STAT,1848,44,20-24,1892,0.16646552952956206
SIM,1832,68,na,1900,1264
SIM,1900,54,na,1954,3203
STAT,1967,37,40-44,2004,2.22328158858128
SIM,1862,63,na,1925,2212
STAT,1865,31,15-19,1896,0.14888883255633514
SIM,1989,19,40-44,2008,3
STAT,1889,45,15-19,1934,5.747001860996516E-4
STAT,1917,45,45-49,1962,0.2632220836923761
SIM,1848,39,45-49,1887,1
STAT,1880,34,15-19,1914,0.17270751740170526
STAT,1854,41,35-39,1895,1.4819397463839923
STAT,1943,72,na,2015,3463.456064133795
STAT,1938,44,na,1982,4381.3452635379135
SIM,1880,35,25-29,1915,7
STAT,1968,0,na,1968,5709.3787401252175
SIM,1932,35,40-44,1967,6
STAT,1909,35,45-49,1944,0.7525857763002649
SIM,1993,17,40-44,2010,5
STAT,1835,30,20-24,1865,2.1946214718469252
STAT,1979,15,30-34,1994,19.37805719035562
STAT,1834,23,na,1857,2590.854960124776
STAT,1951,30,50-100,1981,1.1594768817309027
SIM,1843,12,na,1855,2359
STAT,1897,88,na,1985,722.9253035074848
STAT,1873,51,50-100,1924,0.017883595786858105
SIM,1882,37,25-29,1919,7
STAT,1866,29,45-49,1895,1.1791605637663714
STAT,1818,37,40-44,1855,7.217559388733267
STAT,1813,43,45-49,1856,5.400109288234775
STAT,1877,29,20-24,1906,13.98230759076379
STAT,1856,52,30-34,1908,0.0052130178116573484
SIM,1967,23,50-100,1990,3
STAT,1957,17,45-49,1974,0.7600850660969248
STAT,1849,23,30-34,1872,16.571702493774563
STAT,1852,47,45-49,1899,0.2214666450984984
STAT,1901,70,na,1971,2724.243053155827
STAT,1943,35,45-49,1978,0.8610819743331654
STAT,1802,53,40-44,1855,0.041113677627624426
STAT,1965,33,30-34,1998,23.123676150800115
STAT,1948,39,45-49,1987,0.925583685122334
SIM,1979,0,na,1979,6482
STAT,1874,37,25-29,1911,3.401619550203206
STAT,1828,51,35-39,1879,0.007810386193806455
STAT,1876,27,na,1903,2847.071759005632
SIM,1913,64,na,1977,3881
SIM,1846,17,na,1863,1998
STAT,1884,78,na,1962,1146.3947946949227
STAT,1855,39,40-44,1894,3.68730919888764
STAT,1875,52,35-39,1927,0.010212467364982634
STAT,1985,17,40-44,2002,2.2958359741508745
STAT,1806,101,na,1907,0.19584983591034102
STAT,1834,51,40-44,1885,0.010048017905427604
STAT,1924,35,40-44,1959,2.040111433150842
STAT,1965,22,20-24,1987,160.73422882177354
SIM,1843,30,20-24,1873,5
STAT,1974,17,50-100,1991,0.5645790889014983
SIM,1875,42,35-39,1917,9
STAT,1822,34,50-100,1856,2.628333380336545
STAT,1840,43,50-100,1883,0.8727988322487367
SIM,1951,35,45-49,1986,1
STAT,1939,29,na,1968,4343.64257095254
SIM,1982,17,50-100,1999,3
SIM,1895,34,na,1929,3546
SIM,1874,27,25-29,1901,100
STAT,1978,26,na,2004,5928.239684712725
STAT,1850,34,35-39,1884,10.681723592645826
STAT,1859,34,25-29,1893,9.335457752534227
SIM,1857,23,30-34,1880,19
SIM,1821,43,45-49,1864,2
STAT,1858,54,30-34,1912,0.005211628081943465
SIM,1908,18,na,1926,4268
STAT,1857,22,20-24,1879,71.50534369439421
STAT,1881,73,na,1954,1322.1220497194147
STAT,1959,23,50-100,1982,0.9962482226409546
STAT,1969,44,15-19,2013,0.00229309191738773
SIM,1896,19,25-29,1915,1
STAT,1888,19,25-29,1907,7.646114237546433
STAT,1843,40,20-24,1883,0.16832714352381223
SIM,1865,22,20-24,1887,1
SIM,1826,37,40-44,1863,10
SIM,1850,23,20-24,1873,69
STAT,1980,23,45-49,2003,1.8079810606946574
STAT,1877,16,45-49,1893,0.07860866066661386
STAT,1851,108,na,1959,0.0034628901556216455
STAT,1917,82,na,1999,1943.3508803690634
STAT,1940,15,30-34,1955,14.294370669777706
SIM,1835,34,35-39,1869,3
STAT,1871,31,50-100,1902,1.056264673207143
SIM,1984,23,25-29,2007,176
SIM,1934,32,35-39,1966,21
SIM,1899,64,na,1963,3118
STAT,1871,44,45-49,1915,1.6951377905651341
STAT,1907,23,40-44,1930,3.5273214554306276
SIM,1969,24,20-24,1993,159
SIM,1895,35,45-49,1930,1
STAT,1892,18,30-34,1910,2.2993872749323385
STAT,1930,21,45-49,1951,1.6687074346052237
STAT,1867,44,25-29,1911,0.6825771954989179
SIM,1886,40,45-49,1926,1
STAT,1894,83,na,1977,1211.2843744123697
STAT,1842,23,20-24,1865,66.40608735826112
SIM,1840,33,50-100,1873,1
SIM,1835,23,25-29,1858,84
STAT,1874,112,na,1986,0.003039141763223058
STAT,1957,23,na,1980,5572.975896767768
STAT,1887,35,45-49,1922,2.602707922658223
SIM,1826,56,na,1882,1433
SIM,1895,50,na,1945,3289
STAT,1882,44,20-24,1926,0.17660004605923593
STAT,1926,32,35-39,1958,12.749461858115914
STAT,1956,46,30-34,2002,0.14195015461777347
STAT,1845,66,na,1911,1104.455029583775
SIM,1925,46,na,1971,5264
STAT,1846,45,25-29,1891,0.06013949490522294
STAT,1827,34,35-39,1861,15.945835132411615
STAT,1941,21,20-24,1962,132.6894025829137
STAT,1924,47,35-39,1971,0.17708938072696565
STAT,1943,29,50-100,1972,1.2222643857139497
STAT,1922,32,na,1954,4929.391494568166
SIM,1826,47,45-49,1873,1
SIM,1864,73,na,1937,1241
SIM,1958,21,50-100,1979,2
STAT,1943,47,15-19,1990,4.689513678050996E-4
SIM,1882,35,35-39,1917,15
STAT,1846,34,15-19,1880,0.17039978717869564
STAT,1941,32,30-34,1973,19.0946081979506
STAT,1860,54,40-44,1914,0.009522588256614445
SIM,1828,32,45-49,1860,5
SIM,1940,35,50-100,1975,1
STAT,1983,16,35-39,1999,6.852323298518958
SIM,1861,24,35-39,1885,13
SIM,1854,45,25-29,1899,1
STAT,1860,43,30-34,1903,1.0615918684493268
SIM,1894,19,15-19,1913,14
STAT,1856,54,20-24,1910,6.318342533757559E-4
STAT,1979,16,15-19,1995,72.13345778443038
STAT,1839,54,na,1893,1660.6121420932868
STAT,1914,25,30-34,1939,45.916051795944526
SIM,1973,33,20-24,2006,5
SIM,1975,36,35-39,2011,9
STAT,1950,37,35-39,1987,3.4003179382829716
STAT,1939,34,40-44,1973,4.6038789359433485
STAT,1853,24,35-39,1877,6.766436301472739
STAT,1928,45,na,1973,5435.000046802978
SIM,1915,27,50-100,1942,3
STAT,1898,35,20-24,1933,1.2136960227684297
SIM,1852,27,40-44,1879,4
STAT,1972,26,30-34,1998,58.17286200145318
STAT,1963,25,15-19,1988,1.040419487380946
STAT,1885,37,50-100,1922,1.4132660649225879
SIM,1945,67,na,2012,3647
STAT,1925,15,35-39,1940,5.875066891217675
SIM,1900,36,35-39,1936,2
STAT,1874,35,35-39,1909,8.435644164892071
STAT,1967,36,35-39,2003,3.5955245778338796
STAT,1781,82,na,1863,120.43152648472004
STAT,1831,23,45-49,1854,1.5948853238482805
STAT,1899,15,na,1914,4011.7139896003973
SIM,1837,99,na,1936,2
SIM,1947,52,na,1999,5780
STAT,1819,58,na,1877,1475.7159223386616
STAT,1815,44,na,1859,1735.6858340639046
STAT,1952,22,35-39,1974,13.064961546700701
STAT,1833,33,15-19,1866,0.128839165042407
STAT,1967,47,45-49,2014,0.3258882658128458
SIM,1817,42,40-44,1859,2
STAT,1880,33,50-100,1913,1.1160596128861366
STAT,1938,19,30-34,1957,13.87324056750443
SIM,1992,21,30-34,2013,5
STAT,1917,15,50-100,1932,0.09347723067801125
STAT,1766,90,na,1856,69.42644794
SIM,1960,22,35-39,1982,17
STAT,1876,45,40-44,1921,0.20627414460965968
SIM,1952,20,na,1972,4806
STAT,1988,4,na,1992,6490.9691761403155
SIM,1973,27,35-39,2000,53
STAT,1869,76,na,1945,1058.8261979416623
STAT,1951,41,35-39,1992,0.28799759035256367
SIM,1904,84,na,1988,1497
SIM,1856,38,50-100,1894,4
SIM,1848,38,30-34,1886,11
STAT,1972,15,20-24,1987,200.43343607317263
STAT,1957,26,35-39,1983,22.953197379616125
SIM,1947,34,40-44,1981,2
SIM,1874,72,na,1946,1111
STAT,1815,40,15-19,1855,0.037285601907072446
STAT,1835,32,40-44,1867,3.4479372407708446
STAT,1820,90,na,1910,46.271504264992544
SIM,1885,35,na,1920,3174
SIM,1927,56,na,1983,4752
SIM,1923,42,na,1965,5333
STAT,1807,49,na,1856,1690.1448110884426
STAT,1815,51,25-29,1866,0.007089681283917526
SIM,1848,36,40-44,1884,2
SIM,1973,38,45-49,2011,3
STAT,1858,31,50-100,1889,0.8334930254796256
SIM,1843,32,40-44,1875,13
SIM,1859,26,45-49,1885,2
SIM,1932,30,50-100,1962,1
SIM,1840,63,na,1903,1466
STAT,1831,27,30-34,1858,26.25118945081354
SIM,1956,36,40-44,1992,7
STAT,1809,96,na,1905,3.9909044142872516
STAT,1976,20,30-34,1996,44.49042172736155
STAT,1898,38,25-29,1936,0.9644548864480296
SIM,1813,48,40-44,1861,1
STAT,1937,35,15-19,1972,0.022210952171377713
SIM,1897,60,na,1957,2872
STAT,1844,22,na,1866,2232.9070355204303
SIM,1965,26,35-39,1991,20
SIM,1958,24,45-49,1982,2
STAT,1933,13,na,1946,6114.368407801143
STAT,1862,18,15-19,1880,6.580677763492688
STAT,1878,40,45-49,1918,1.8215817079189478
SIM,1955,47,50-100,2002,1
STAT,1831,38,40-44,1869,4.284070843305282
STAT,1911,47,25-29,1958,0.05800352186332405
STAT,1841,30,15-19,1871,0.15684332457454087
STAT,1946,25,20-24,1971,23.486179960390388
STAT,1870,17,40-44,1887,0.2100755307278331
STAT,1851,51,na,1902,1715.6203485766266
SIM,1842,67,na,1909,1354
STAT,1832,53,20-24,1885,5.224226975787575E-4
STAT,1850,31,50-100,1881,0.9970073449775506
STAT,1855,65,na,1920,1437.9815708214373
STAT,1980,27,30-34,2007,63.04511274689687
STAT,1833,78,na,1911,549.8032753359133
SIM,1923,31,20-24,1954,1
STAT,1796,69,na,1865,805.350875358682
SIM,1851,47,na,1898,2590
SIM,1870,18,15-19,1888,3
STAT,1890,53,na,1943,2987.5572776164295
STAT,1946,36,30-34,1982,2.405616440704283
SIM,1848,43,na,1891,1708
SIM,1857,17,na,1874,2821
STAT,1846,22,45-49,1868,0.8894645569105847
STAT,1859,48,15-19,1907,3.631011409986401E-4
STAT,1843,43,25-29,1886,0.6549634752156136
STAT,1899,48,50-100,1947,0.21628744343387507
SIM,1899,44,40-44,1943,1
STAT,1899,17,35-39,1916,0.8675478030978911
SIM,1967,26,45-49,1993,1
STAT,1902,46,45-49,1948,0.21769147596000885
SIM,1812,45,na,1857,1615
SIM,1885,25,35-39,1910,1
SIM,1918,19,25-29,1937,61
SIM,1854,22,45-49,1876,1
SIM,1954,25,20-24,1979,5
STAT,1866,26,40-44,1892,3.215236589874688
SIM,1896,16,na,1912,3879
STAT,1911,36,15-19,1947,0.02152654111934706
SIM,1973,24,40-44,1997,1
SIM,1922,79,na,2001,2375
SIM,1887,39,na,1926,3700
STAT,1969,11,na,1980,5663.777977471058
STAT,1915,31,20-24,1946,2.879105096472479
STAT,1893,34,25-29,1927,14.813157284832908
STAT,1872,24,15-19,1896,3.7989842030651655
STAT,1841,41,25-29,1882,0.6009231845032443
SIM,1907,22,30-34,1929,73
STAT,1991,17,35-39,2008,6.939932019805358
SIM,1794,77,na,1871,202
SIM,1954,36,30-34,1990,5
SIM,1872,25,na,1897,2958
STAT,1816,38,45-49,1854,7.273675389447856
SIM,1824,38,45-49,1862,2
STAT,1875,111,na,1986,0.008835161317041658
STAT,1926,22,50-100,1948,0.9223395586559271
STAT,1991,23,20-24,2014,184.44975675801297
SIM,1931,21,na,1952,5778
STAT,1841,49,35-39,1890,0.12187372821106578
STAT,1915,42,30-34,1957,0.14856588868095033
STAT,1897,17,50-100,1914,0.07560102492561181
SIM,1969,20,35-39,1989,18
STAT,1965,24,40-44,1989,4.857053743547499
SIM,1861,28,20-24,1889,17
STAT,1833,21,20-24,1854,96.5691923570386
STAT,1930,34,20-24,1964,3.628531933736661
SIM,1920,17,15-19,1937,107
STAT,1908,19,15-19,1927,10.117808997652148
STAT,1891,37,30-34,1928,7.601673680791296
STAT,1831,74,na,1905,870.7035774663713
SIM,1915,68,na,1983,3480
STAT,1822,110,na,1932,2.2704674824726705E-4
STAT,1857,91,na,1948,52.084116454354536
STAT,1897,42,15-19,1939,0.0014780170198143909
STAT,1959,26,45-49,1985,2.620413024961401
STAT,1876,48,45-49,1924,0.2780054118252388
SIM,1878,65,na,1943,2046
STAT,1915,45,35-39,1960,0.15066358662499793
STAT,1879,75,na,1954,1240.5212389070434
STAT,1875,61,na,1936,2228.5262204141986
SIM,1874,51,na,1925,2424
STAT,1910,87,na,1997,1021.852936879095
STAT,1838,28,25-29,1866,46.28431757790399
SIM,1876,28,40-44,1904,9
STAT,1962,26,na,1988,5565.798061281498
STAT,1888,16,20-24,1904,24.10914276411081
STAT,1892,16,40-44,1908,0.26520702126967155
STAT,1904,36,50-100,1940,0.44127262182727134
STAT,1912,17,15-19,1929,10.600855441470388
SIM,1924,64,na,1988,4389
STAT,1965,36,25-29,2001,1.4628220045468932
SIM,1900,24,40-44,1924,4
STAT,1905,57,na,1962,3519.8097533585737
STAT,1887,27,na,1914,3086.545427989941
SIM,1835,49,50-100,1884,1
STAT,1831,36,20-24,1867,0.7702268406814199
STAT,1891,48,40-44,1939,0.13601033352367273
STAT,1845,54,45-49,1899,0.009510338181174348
STAT,1968,36,50-100,2004,0.6240572807828065
SIM,1841,21,20-24,1862,125
SIM,1896,16,20-24,1912,54
STAT,1987,28,25-29,2015,108.8551636700539
STAT,1853,28,20-24,1881,12.224641054744366
SIM,1958,30,30-34,1988,4
SIM,1973,36,25-29,2009,3
STAT,1948,36,40-44,1984,2.038683041279618
SIM,1861,25,na,1886,1847
SIM,1863,39,40-44,1902,11
STAT,1931,49,na,1980,5636.955182806807
STAT,1804,53,15-19,1857,1.1096644691416398E-4
STAT,1889,33,20-24,1922,3.8290611855690604
SIM,1826,44,40-44,1870,5
STAT,1896,36,25-29,1932,4.409843388417777
STAT,1911,49,15-19,1960,4.0044091263133336E-4
STAT,1878,53,na,1931,2552.814360020826
STAT,1765,110,na,1875,1.6765295463202424E-4
STAT,1954,46,20-24,2000,0.01644007483115818
SIM,1815,93,na,1908,38
STAT,1834,53,30-34,1887,0.005460717926833962
STAT,1820,36,45-49,1856,5.052025933196129
SIM,1969,38,25-29,2007,5
STAT,1803,56,na,1859,1095.0165038233274
STAT,1865,47,30-34,1912,0.10032368291059515
SIM,1958,21,40-44,1979,9
SIM,1884,48,45-49,1932,1
STAT,1839,29,50-100,1868,0.6299496022680136
STAT,1848,45,35-39,1893,0.1502368915052253
SIM,1850,28,45-49,1878,1
SIM,1895,39,30-34,1934,15
STAT,1842,28,45-49,1870,1.0490147181393223
STAT,1870,34,50-100,1904,1.0335098173641404
STAT,1877,28,na,1905,2854.805296156943
SIM,1886,17,na,1903,2294
STAT,1891,34,15-19,1925,0.20137963329427508
SIM,1911,95,na,2006,187
SIM,1852,22,35-39,1874,18
STAT,1810,53,45-49,1863,0.05207026702562242
STAT,1890,21,50-100,1911,0.5767695695491402
STAT,1916,57,na,1973,4158.094038038328
SIM,1838,19,30-34,1857,3
SIM,1884,50,na,1934,2476
SIM,1839,47,na,1886,1891
SIM,1916,19,15-19,1935,53
SIM,1835,33,na,1868,2489
STAT,1983,17,30-34,2000,19.898794812556808
STAT,1887,39,30-34,1926,6.823491972722194
STAT,1887,48,20-24,1935,0.015324868961235109
STAT,1941,24,25-29,1965,110.11380250806512
STAT,1976,38,20-24,2014,0.41830388057086937
SIM,1906,14,na,1920,3984
SIM,1830,30,35-39,1860,6
STAT,1950,34,30-34,1984,21.885768708018933
SIM,1991,17,30-34,2008,26
STAT,1866,28,30-34,1894,26.841302808818288
SIM,1897,33,20-24,1930,4
SIM,1872,18,25-29,1890,12
STAT,1965,15,50-100,1980,0.5400752347639362
SIM,1918,79,na,1997,2253
STAT,1842,26,25-29,1868,40.546553174979984
SIM,1850,26,25-29,1876,75
STAT,1831,36,50-100,1867,1.2267520203793647
SIM,1914,65,na,1979,3378
STAT,1896,25,15-19,1921,0.6962643300528841
STAT,1984,21,30-34,2005,47.27999241747273
SIM,1902,80,na,1982,1720
SIM,1911,54,na,1965,4453
STAT,1892,57,na,1949,2906.799284304794
STAT,1949,44,na,1993,5163.06172447307
STAT,1867,41,20-24,1908,0.17189347794349255
STAT,1865,42,25-29,1907,0.6678266924494958
STAT,1941,35,35-39,1976,2.967971370966355
STAT,1864,18,25-29,1882,6.004977747363394
STAT,1844,22,35-39,1866,6.094156127050179
STAT,1907,83,na,1990,1522.842848939274
SIM,1915,1,na,1916,5214
STAT,1948,22,15-19,1970,7.053409239185867
STAT,1840,24,25-29,1864,57.56416782049494
STAT,1969,32,45-49,2001,2.3123461500559057
STAT,1830,43,15-19,1873,0.013070522045926531
STAT,1875,16,35-39,1891,0.6559951980178348
STAT,1906,79,na,1985,2022.3541210884996
STAT,1932,31,na,1963,5806.982894875211
SIM,1874,26,40-44,1900,10
SIM,1913,23,30-34,1936,76
STAT,1967,44,40-44,2011,0.3734715970907327
SIM,1804,93,na,1897,39
SIM,1902,21,35-39,1923,19
SIM,1977,32,45-49,2009,9
STAT,1961,40,50-100,2001,0.18254023528944704
STAT,1890,90,na,1980,446.51334046034214
SIM,1918,16,20-24,1934,33
STAT,1849,24,15-19,1873,3.0472180645925304
STAT,1835,47,15-19,1882,2.631168935653401E-4
SIM,1907,25,35-39,1932,41
STAT,1886,19,15-19,1905,7.185452940370819
STAT,1929,67,na,1996,4617.714401717141
STAT,1964,18,50-100,1982,0.5443950426359164
STAT,1989,22,15-19,2011,8.828239742699006
SIM,1854,44,50-100,1898,4
STAT,1984,2,na,1986,6450.083225989684
SIM,1960,34,na,1994,6042
STAT,1989,25,30-34,2014,65.10492866293339
STAT,1894,18,40-44,1912,0.27063293654802406
SIM,1900,33,30-34,1933,4
STAT,1958,42,40-44,2000,0.3939976941227532
SIM,1859,23,40-44,1882,5
SIM,1922,25,30-34,1947,4
STAT,1879,52,50-100,1931,0.01810221514982191
SIM,1876,39,na,1915,2599
STAT,1846,44,50-100,1890,1.077399195302115
SIM,1857,24,15-19,1881,8
STAT,1878,42,35-39,1920,2.179263793653261
SIM,1930,4,na,1934,6439
STAT,1967,33,30-34,2000,23.136636709800722
STAT,1993,20,15-19,2013,8.87389670616724
SIM,1975,33,30-34,2008,2
STAT,1905,23,30-34,1928,29.66031965924984
STAT,1946,39,35-39,1985,3.1828156509455834
SIM,1875,54,na,1929,2696
SIM,1923,34,25-29,1957,21
SIM,1871,40,na,1911,2057
SIM,1966,42,40-44,2008,1
SIM,1928,38,25-29,1966,2
SIM,1987,19,30-34,2006,22
STAT,1866,65,na,1931,1807.6884621931254
STAT,1911,44,20-24,1955,0.019229861719711066
STAT,1827,38,20-24,1865,1.0968866140130467
STAT,1974,33,na,2007,5805.810248195755
SIM,1835,38,20-24,1873,2
SIM,1815,56,na,1871,1592
SIM,1848,22,15-19,1870,7
STAT,1845,47,50-100,1892,0.16472720126334378
STAT,1822,78,na,1900,641.9638059746626
STAT,1856,10,na,1866,2516.4292117031528
SIM,1929,17,35-39,1946,16
STAT,1904,44,20-24,1948,0.018029619051811094
STAT,1893,31,20-24,1924,3.9591155016873336
STAT,1913,45,50-100,1958,0.2561032971653902
STAT,1856,41,45-49,1897,1.3236781170216736
SIM,1822,34,25-29,1856,5
SIM,1954,20,15-19,1974,10
STAT,1893,36,45-49,1929,2.9219320695594697
STAT,1915,34,25-29,1949,10.772263808781139
SIM,1846,28,25-29,1874,74
SIM,1824,36,25-29,1860,7
SIM,1943,38,20-24,1981,1
SIM,1977,33,50-100,2010,3
SIM,1899,27,na,1926,4001
SIM,1966,9,na,1975,5942
STAT,1911,32,na,1943,4253.781874671817
STAT,1982,24,25-29,2006,150.39420055529905
SIM,1930,34,25-29,1964,18
SIM,1838,81,na,1919,137
STAT,1883,109,na,1992,0.07106072140824717
STAT,1817,48,na,1865,1978.8032808848182
STAT,1922,34,25-29,1956,11.987637318273192
STAT,1861,37,15-19,1898,0.053875092192897024
STAT,1913,46,20-24,1959,0.012485536758764437
STAT,1940,7,na,1947,4666.16834513668
SIM,1836,55,na,1891,1256
STAT,1852,36,na,1888,2256.6103049265207
STAT,1914,94,na,2008,293.6268525070684
STAT,1969,33,50-100,2002,1.2142082528221692
STAT,1842,24,35-39,1866,5.582863797219752
STAT,1864,42,50-100,1906,1.0872716894494057
SIM,1915,84,na,1999,1754
STAT,1966,41,30-34,2007,0.19178640291825552
STAT,1948,48,35-39,1996,0.17661825409714155
SIM,1945,23,20-24,1968,238
SIM,2000,12,na,2012,6484
STAT,1959,23,40-44,1982,5.090828047318222
SIM,1957,14,na,1971,6325
STAT,1817,52,40-44,1869,0.028922115054331576
STAT,1854,62,na,1916,1489.0470452572297
SIM,1846,35,25-29,1881,1
SIM,1860,37,40-44,1897,6
SIM,1948,29,45-49,1977,2
SIM,1969,24,45-49,1993,2
SIM,1874,24,20-24,1898,8
SIM,1914,15,30-34,1929,4
STAT,1930,37,25-29,1967,1.4823234140717658
SIM,1919,6,na,1925,5712
STAT,1833,24,25-29,1857,55.30516487426122
SIM,1897,36,25-29,1933,3
STAT,1878,90,na,1968,280.9240049067336
SIM,1781,88,na,1869,56
SIM,1874,35,na,1909,2649
SIM,1879,1,na,1880,3821
STAT,1897,30,45-49,1927,2.7125812472429796
STAT,1955,60,na,2015,5451.588662514431
STAT,1866,24,20-24,1890,73.2516104185334
STAT,1906,15,30-34,1921,2.6947389119529106
STAT,1960,47,na,2007,5743.710332742163
STAT,1845,50,35-39,1895,0.0058846232820680975
SIM,1851,42,40-44,1893,2
SIM,1967,23,40-44,1990,12
SIM,1835,43,50-100,1878,5
STAT,1954,42,20-24,1996,0.02618398994398857
STAT,1967,28,50-100,1995,1.4403739001757803
SIM,1939,29,35-39,1968,27
STAT,1882,35,30-34,1917,6.06463473908882
SIM,1981,20,50-100,2001,2
STAT,1829,73,na,1902,870.123035942161
STAT,1934,42,35-39,1976,0.3236442731250925
STAT,1926,48,15-19,1974,5.229777060603383E-4
SIM,1907,89,na,1996,754
STAT,1829,35,15-19,1864,0.06704229028082832
STAT,1891,72,na,1963,2073.3670366095166
STAT,1919,33,50-100,1952,1.0248402684872122
SIM,1955,47,35-39,2002,1
STAT,1809,45,50-100,1854,0.6298304499416663
STAT,1849,16,na,1865,2202.9360380566222
STAT,1944,15,50-100,1959,0.4655640231475244
STAT,1900,30,30-34,1930,28.183957497207885
STAT,1941,62,na,2003,4135.776212718408
SIM,1959,29,20-24,1988,7
STAT,1855,24,45-49,1879,0.6832591899466639
STAT,1943,42,45-49,1985,0.2116855095139497
STAT,1813,47,30-34,1860,0.32109488863544483
STAT,1947,65,na,2012,4330.204154679276
SIM,1905,15,20-24,1920,35
STAT,1935,48,25-29,1983,0.08622998276936004
STAT,1838,35,25-29,1873,3.0731113581143457
STAT,1895,84,na,1979,1125.258133019792
SIM,1882,30,na,1912,3301
STAT,1952,37,45-49,1989,0.97131294003913
STAT,1931,16,35-39,1947,6.355376853822842
STAT,1871,58,na,1929,2270.5318070971016
STAT,1881,102,na,1983,6.7208732059898395
STAT,1902,31,35-39,1933,16.580962043482742
SIM,1907,18,35-39,1925,3
STAT,1840,29,30-34,1869,24.827249947690852
SIM,1831,40,na,1871,1688
STAT,1957,19,35-39,1976,6.3804386936936
STAT,1909,91,na,2000,529.8090966294478
STAT,1953,22,50-100,1975,0.9216337864135498
SIM,1894,89,na,1983,799
STAT,1856,17,15-19,1873,6.178305218675022
STAT,1873,35,na,1908,2802.8638969732024
STAT,1831,29,20-24,1860,12.054612992182214
SIM,1864,17,15-19,1881,8
STAT,1913,47,35-39,1960,0.14530334201029485
STAT,1889,36,25-29,1925,4.115571009983184
STAT,1987,24,15-19,2011,8.792935369264866
SIM,1808,86,na,1894,63
SIM,1841,24,25-29,1865,72
SIM,1844,13,na,1857,3030
STAT,1933,67,na,2000,4901.059872176729
STAT,1973,37,35-39,2010,3.719283600406047
STAT,1852,37,40-44,1889,4.149562678465185
SIM,1827,59,na,1886,1093
SIM,1848,80,na,1928,96
STAT,1792,106,na,1898,0.003409490631822718
SIM,1965,19,35-39,1984,7
SIM,1890,35,30-34,1925,13
STAT,1811,49,50-100,1860,0.7402299540638538
STAT,1844,78,na,1922,653.5243491837153
STAT,1857,11,na,1868,2533.408658506954
SIM,1877,101,na,1978,73
STAT,1894,113,na,2007,0.002355622197935325
STAT,1898,21,50-100,1919,0.6379428863010727
STAT,1820,74,na,1894,651.3345686133179
STAT,1869,30,na,1899,2688.398474762683
STAT,1855,25,15-19,1880,0.44861275494807784
STAT,1907,27,50-100,1934,1.0861814841705981
STAT,1863,0,na,1863,3874.725698374348
STAT,1973,16,na,1989,5495.236769407391
STAT,1964,16,30-34,1980,17.721620372280185
STAT,1978,35,50-100,2013,0.6824394669611396
STAT,1913,15,na,1928,4580.83170022524
SIM,1855,56,na,1911,1555
STAT,1929,26,20-24,1955,26.37763922461973
STAT,1940,29,na,1969,4405.56828716475
SIM,1824,34,35-39,1858,5
STAT,1875,38,50-100,1913,1.4569379599972279
SIM,1921,47,35-39,1968,1
SIM,1944,41,na,1985,4564
SIM,1972,16,30-34,1988,49
STAT,1885,22,35-39,1907,6.717275148056198
STAT,1981,11,na,1992,6339.861447781915
SIM,1875,46,45-49,1921,1
STAT,1991,19,25-29,2010,71.62331117928339
STAT,1877,28,15-19,1905,0.5427277606516399
SIM,1885,28,15-19,1913,1
STAT,1867,46,45-49,1913,0.2550092378564046
STAT,1920,26,45-49,1946,2.1936542563434775
STAT,1967,1,na,1968,5676.24213162916
SIM,1900,17,na,1917,3846
STAT,1932,41,30-34,1973,0.20030159976701714
SIM,1919,33,20-24,1952,8
SIM,1858,48,40-44,1906,1
STAT,1919,12,na,1931,5051.955929411181
STAT,1952,38,15-19,1990,0.02733329660185592
STAT,1920,15,20-24,1935,35.36678607794208
SIM,1863,25,15-19,1888,1
STAT,1960,32,35-39,1992,14.00111159137094
SIM,1934,44,40-44,1978,1
STAT,1922,31,20-24,1953,3.192107758307991
STAT,1958,34,45-49,1992,2.428079124225838
SIM,1946,26,30-34,1972,104
STAT,1924,20,30-34,1944,39.36137294603096
STAT,1825,89,na,1914,74.30732501503115
SIM,1821,43,50-100,1864,3
STAT,1859,32,35-39,1891,9.309859503019469
STAT,1794,86,na,1880,95.18018874953292
STAT,1862,97,na,1959,9.350677122131648
STAT,1807,92,na,1899,20.366730400722375
SIM,1890,81,na,1971,1150
STAT,1794,108,na,1902,4.5845355505010706E-4
SIM,1882,44,25-29,1926,1
SIM,1928,57,na,1985,5297
STAT,1977,19,20-24,1996,211.26059361547067
SIM,1942,62,na,2004,4401
STAT,1947,45,25-29,1992,0.07206306509040004
STAT,1875,49,50-100,1924,0.2867858756260665
SIM,1913,26,35-39,1939,42
STAT,1944,19,25-29,1963,53.78565816369047
SIM,1973,29,25-29,2002,13
SIM,1867,32,35-39,1899,26
STAT,1908,18,45-49,1926,0.11167537310161228
STAT,1866,28,na,1894,2543.78714841146
SIM,1950,27,35-39,1977,46
STAT,1829,34,45-49,1863,2.1054893201412987
STAT,1874,44,25-29,1918,0.7484339697511816
STAT,1905,26,35-39,1931,16.17212924614568
SIM,1884,22,25-29,1906,6
STAT,1864,25,25-29,1889,44.05504450621039
STAT,1895,49,30-34,1944,0.08031197052048217
SIM,1918,90,na,2008,822
STAT,1903,37,na,1940,3903.260024080212
STAT,1850,38,45-49,1888,2.0631497242219137
SIM,1932,20,30-34,1952,1
STAT,1938,26,30-34,1964,44.840394532067926
SIM,1856,32,na,1888,2077
SIM,1861,62,na,1923,1429
SIM,1930,31,20-24,1961,5
STAT,1918,26,45-49,1944,2.1286126858164054
SIM,1888,18,15-19,1906,12
STAT,1807,100,na,1907,0.5191486818369105
STAT,1948,24,35-39,1972,12.46794343168773
SIM,1822,39,30-34,1861,10
STAT,1921,10,na,1931,5226.058790423163
STAT,1848,48,30-34,1896,0.1015603345967117
SIM,1982,29,35-39,2011,53
STAT,1824,42,15-19,1866,0.019652288707732293
STAT,1940,45,na,1985,4500.119370570328
SIM,1837,34,45-49,1871,2
SIM,1941,15,30-34,1956,17
SIM,1836,18,na,1854,1908
SIM,1903,34,50-100,1937,3
STAT,1926,44,40-44,1970,0.3545956704155667
SIM,1838,27,15-19,1865,1
SIM,1878,30,45-49,1908,1
STAT,1856,45,30-34,1901,0.08607717176704169
STAT,1933,15,30-34,1948,18.92583972235156
STAT,1879,25,45-49,1904,1.347013223524858
SIM,1889,33,25-29,1922,27
SIM,1899,32,50-100,1931,4
SIM,1851,8,na,1859,3244
STAT,1820,68,na,1888,887.2198210467285
SIM,1898,28,25-29,1926,5
SIM,1874,29,na,1903,2456
STAT,1974,29,35-39,2003,22.699640651761054
SIM,1949,25,50-100,1974,4
STAT,1874,2,na,1876,3874.765224759516
STAT,1899,52,na,1951,3386.279689326393
STAT,1843,42,40-44,1885,2.3237136865436883
STAT,1940,45,50-100,1985,0.27705315451200924
SIM,1920,15,na,1935,4271
STAT,1937,47,20-24,1984,0.012882508095867376
SIM,1960,34,40-44,1994,21
SIM,1802,83,na,1885,86
SIM,1863,24,45-49,1887,1
STAT,1833,28,50-100,1861,0.5969490432476887
SIM,1902,36,45-49,1938,2
SIM,1902,25,20-24,1927,21
SIM,1804,56,na,1860,1071
STAT,1869,51,35-39,1920,0.009667591585096249
STAT,1887,89,na,1976,464.0292203431591
STAT,1782,83,na,1865,175.5646426884677
SIM,1956,24,35-39,1980,15
STAT,1998,16,30-34,2014,20.659277920384522
STAT,1944,16,45-49,1960,0.6205968428556502
SIM,1915,26,45-49,1941,2
STAT,1923,41,20-24,1964,0.023846642372048376
STAT,1923,51,na,1974,4894.754369223608
STAT,1952,34,40-44,1986,5.5094819915605715
STAT,1854,45,20-24,1899,0.00987383032557442
SIM,1872,25,25-29,1897,82
STAT,1937,23,20-24,1960,124.98871994384065
STAT,1879,38,na,1917,2824.915544713284
SIM,1832,48,45-49,1880,1
STAT,1966,38,na,2004,5581.314703149162
STAT,1918,29,25-29,1947,80.24298538730267
STAT,1980,20,40-44,2000,5.408311621640088
SIM,1912,47,25-29,1959,1
SIM,1911,37,25-29,1948,1
STAT,1850,32,15-19,1882,0.15335935601780712
STAT,1903,37,25-29,1940,1.0215243832466907
SIM,1833,21,25-29,1854,115
STAT,1994,15,50-100,2009,0.6242615917758879
SIM,1824,70,na,1894,618
STAT,1824,48,45-49,1872,0.31636474741842624
SIM,1926,29,25-29,1955,9
STAT,1904,47,25-29,1951,0.05359400635373271
STAT,1876,9,na,1885,3162.698174258458
SIM,1837,37,na,1874,2399
STAT,1911,88,na,1999,902.7519768425942
STAT,1821,53,45-49,1874,0.024808046205805352
SIM,1990,21,20-24,2011,157
STAT,1985,27,45-49,2012,2.8479391789384123
STAT,1877,25,35-39,1902,11.661590090472439
SIM,1964,31,30-34,1995,55
STAT,1924,45,45-49,1969,0.2999271128422851
STAT,1871,40,35-39,1911,2.1000213375122017
STAT,1945,45,15-19,1990,4.853087845656037E-4
STAT,1858,92,na,1950,37.49638411530882
SIM,1856,48,30-34,1904,1
STAT,1851,27,40-44,1878,2.781341420668282
STAT,1854,46,na,1900,1838.1425444948654
SIM,1919,30,40-44,1949,10
STAT,1910,16,35-39,1926,0.9628873425386776
STAT,1905,39,25-29,1944,1.0275736137266525
SIM,1913,39,25-29,1952,2
STAT,1970,42,50-100,2012,0.17637373538548692
STAT,1936,24,na,1960,4028.7741601654384
STAT,1869,14,na,1883,2945.5344561376237
STAT,1948,45,30-34,1993,0.12303570717221779
SIM,1906,30,30-34,1936,1
STAT,1982,21,20-24,2003,181.2281128167916
STAT,1996,18,30-34,2014,20.436202485348
STAT,1900,33,35-39,1933,16.148598621936337
STAT,1970,42,35-39,2012,0.30231380557554793
STAT,1874,60,na,1934,2253.232155365961
SIM,1932,45,45-49,1977,1
STAT,1837,42,50-100,1879,0.9027108901009238
STAT,1835,40,25-29,1875,0.49268172408702193
SIM,1977,12,na,1989,6241
STAT,1970,21,na,1991,5294.679893846356
SIM,1908,6,na,1914,4396
STAT,1954,45,25-29,1999,0.07908713808368198
STAT,1893,33,40-44,1926,6.299352830029177
SIM,1969,17,na,1986,5451
STAT,1857,32,25-29,1889,9.262998909318874
STAT,1862,41,na,1903,2261.176515319173
STAT,1832,44,30-34,1876,0.951781272754058
STAT,1960,20,40-44,1980,5.074086379020008
STAT,1801,79,na,1880,325.5013988150913
STAT,1895,41,35-39,1936,0.1897502768986393
STAT,1966,44,35-39,2010,0.3006393538669093
STAT,1893,49,20-24,1942,0.009667902268823737
STAT,1987,22,na,2009,6036.211768815333
SIM,1840,44,30-34,1884,2
STAT,1876,110,na,1986,0.023766680965013408
SIM,1865,32,25-29,1897,2
SIM,1969,21,40-44,1990,11
SIM,1843,40,25-29,1883,1
STAT,1925,25,50-100,1950,1.3654893771195227
STAT,1920,23,40-44,1943,4.298658547218145
SIM,1929,80,na,2009,2175
STAT,1913,44,30-34,1957,0.1434756624153858
SIM,1831,24,na,1855,1769
STAT,1838,21,35-39,1859,6.606696703690348
STAT,1899,112,na,2011,0.007556137294185691
SIM,1891,47,na,1938,3273
SIM,1871,30,35-39,1901,28
SIM,1929,19,25-29,1948,140
STAT,1935,45,20-24,1980,0.018099448554402528
STAT,1828,91,na,1919,38.45993221610141
STAT,1877,65,na,1942,2028.7069218403012
SIM,1982,26,30-34,2008,11
STAT,1838,32,20-24,1870,2.9100006044727476
STAT,1958,45,45-49,2003,0.34426799988718554
STAT,1974,26,30-34,2000,59.32720951671671
STAT,1896,20,45-49,1916,1.0692595526050381
STAT,1836,43,na,1879,2247.1777147934818
SIM,1875,43,40-44,1918,9
SIM,1958,37,20-24,1995,1
STAT,1873,19,40-44,1892,0.21439345093089757
STAT,1880,69,na,1949,1795.1595872004239
STAT,1867,43,40-44,1910,2.406061370325195
STAT,1882,95,na,1977,100.07892607812566
STAT,1973,34,30-34,2007,23.93875576209151
STAT,1930,21,na,1951,5415.864559196062
STAT,1924,30,50-100,1954,1.11791748732566
STAT,1806,54,30-34,1860,0.020128528293974057
STAT,1893,47,50-100,1940,0.2011470432499681
SIM,1960,18,na,1978,5549
STAT,1880,22,50-100,1902,0.49882604437976735
STAT,1927,63,na,1990,4780.265142864183
STAT,1809,50,25-29,1859,0.008923407818470992
STAT,1937,20,40-44,1957,3.783326171990428
STAT,1859,49,20-24,1908,0.010801324382947543
STAT,1895,68,na,1963,2530.731652129448
STAT,1913,34,15-19,1947,0.14636186418006625
STAT,1945,20,na,1965,4622.072233309657
STAT,1866,19,40-44,1885,0.19845450211197238
SIM,1943,45,20-24,1988,1
STAT,1835,67,na,1902,987.9932278342777
SIM,1893,22,35-39,1915,24
STAT,1888,15,50-100,1903,0.0667699263003981
STAT,1906,18,35-39,1924,0.9209873779678014
SIM,1914,18,35-39,1932,1
STAT,1931,29,25-29,1960,97.99165695955796
SIM,1850,25,na,1875,1875
SIM,1937,26,20-24,1963,37
STAT,1945,8,na,1953,4971.022654651658
STAT,1863,46,15-19,1909,4.04789744367933E-4
STAT,1964,41,20-24,2005,0.026715296217463103
SIM,1924,27,na,1951,4749
STAT,1903,53,na,1956,3504.6697552544592
STAT,1908,15,40-44,1923,0.3149691484418998
STAT,1864,22,20-24,1886,72.15220326954609
STAT,1957,23,30-34,1980,43.86176052679763
STAT,1879,22,40-44,1901,2.5110289924257563
STAT,1870,92,na,1962,105.16962014914816
STAT,1924,52,na,1976,4961.168260737298
STAT,1930,15,50-100,1945,0.5616575261587581
SIM,1887,22,40-44,1909,3
SIM,1829,39,40-44,1868,12
STAT,1772,100,na,1872,0.027208067049265892
SIM,1934,63,na,1997,5238
STAT,1889,40,20-24,1929,0.2282021786617792
SIM,1943,63,na,2006,4675
STAT,1942,15,40-44,1957,1.6880639432311277
SIM,1845,78,na,1923,873
STAT,1926,47,45-49,1973,0.30941728633890797
STAT,1932,44,35-39,1976,0.3139875539463088
SIM,1965,23,30-34,1988,92
STAT,1875,53,40-44,1928,0.012353638921296787
STAT,1850,35,40-44,1885,4.673826850787023
STAT,1939,37,45-49,1976,0.8116565571328251
STAT,2001,6,na,2007,6792.3345164490565
SIM,1848,34,20-24,1882,1
SIM,1934,47,45-49,1981,1
SIM,1934,67,na,2001,4566
SIM,1950,15,40-44,1965,3
STAT,1877,71,na,1948,1602.3546212536155
SIM,1927,46,50-100,1973,1
SIM,1864,11,na,1875,3072
SIM,1882,86,na,1968,752
STAT,1947,42,20-24,1989,0.023858475820221298
STAT,1966,19,45-49,1985,0.7195687496511395
STAT,1885,39,20-24,1924,0.8784006980546835
STAT,1890,15,25-29,1905,8.027894527912594
SIM,1893,39,20-24,1932,2
SIM,1874,28,30-34,1902,68
STAT,1989,3,na,1992,6502.411158905078
SIM,1858,32,25-29,1890,5
STAT,1841,73,na,1914,1056.0191925935424
STAT,1843,50,25-29,1893,0.0036050606179092465
STAT,1898,22,45-49,1920,1.0875987383041283
STAT,1969,45,20-24,2014,0.016649281909981196
SIM,1907,33,na,1940,4482
STAT,1874,38,30-34,1912,6.265383736507325
SIM,1941,39,na,1980,3941
STAT,1810,52,30-34,1862,0.02179641820963739
STAT,1804,81,na,1885,277.8763038069652
STAT,1898,36,35-39,1934,11.084591661313967
SIM,1961,35,50-100,1996,2
SIM,1969,34,15-19,2003,3
STAT,1876,22,25-29,1898,68.29280414432857
STAT,1900,26,na,1926,3834.7874784536566
STAT,1904,31,45-49,1935,2.901705551188331
STAT,1950,35,45-49,1985,0.9600319567163506
SIM,1882,38,30-34,1920,10
STAT,1769,107,na,1876,0.011689411591281326
SIM,1958,23,30-34,1981,62
STAT,1915,56,na,1971,4113.749331275767
STAT,1810,50,na,1860,1608.1919893151978
STAT,1881,15,15-19,1896,6.636613246945258
STAT,1955,16,20-24,1971,207.76149779804467
SIM,1819,40,na,1859,1279
STAT,1953,35,50-100,1988,0.6049154873091438
STAT,1933,18,35-39,1951,6.46832961234651
STAT,1983,3,na,1986,6421.999352422122
SIM,1963,16,20-24,1979,259
SIM,1889,30,20-24,1919,1
STAT,1807,86,na,1893,108.4983437173873
SIM,1941,18,35-39,1959,7
SIM,1837,43,na,1880,2361
STAT,1824,45,40-44,1869,0.23879385566579642
STAT,1855,40,50-100,1895,0.9080007321470834
STAT,1861,30,25-29,1891,9.905818023505837
SIM,1850,24,35-39,1874,12
STAT,1826,47,40-44,1873,0.12318558108011023
STAT,1965,27,45-49,1992,2.4998317719503667
SIM,1916,15,40-44,1931,1
STAT,1774,88,na,1862,1.8402478675076117
STAT,1956,31,30-34,1987,24.538439529465116
STAT,1918,37,45-49,1955,0.8290598797250651
SIM,1859,35,35-39,1894,14
SIM,1855,29,40-44,1884,1
SIM,1924,25,40-44,1949,8
SIM,1865,92,na,1957,70
SIM,1872,22,20-24,1894,3
STAT,1898,23,15-19,1921,5.129523517706611
STAT,1926,23,45-49,1949,1.572327035397492
SIM,1902,33,40-44,1935,10
SIM,1841,47,40-44,1888,1
SIM,1833,37,40-44,1870,12
STAT,1948,21,30-34,1969,38.09575053744587
SIM,1956,21,30-34,1977,50
STAT,1843,45,45-49,1888,0.24181127268105604
SIM,1835,20,20-24,1855,130
STAT,1833,47,40-44,1880,0.1420895299998392
STAT,1848,39,40-44,1887,4.694656201126132
STAT,1890,47,na,1937,3158.342462868962
STAT,1916,25,40-44,1941,5.600066166352744
STAT,1911,31,45-49,1942,1.7770766683846335
STAT,1880,35,20-24,1915,0.9518893065539212
STAT,1847,29,40-44,1876,2.7307912882961465
STAT,1882,12,na,1894,2911.043024146491
STAT,1912,41,45-49,1953,0.18648918555997301
STAT,1825,37,40-44,1862,7.270502761742624
SIM,1934,23,45-49,1957,3
SIM,1791,66,na,1857,819
STAT,1854,49,50-100,1903,0.19591186099797492
STAT,1877,32,50-100,1909,1.0999023228306546
STAT,1892,17,25-29,1909,8.196550610335242
SIM,1878,81,na,1959,821
SIM,1869,0,na,1869,3732
STAT,1837,48,30-34,1885,0.0718370038569857
STAT,1859,52,na,1911,1968.8797513181107
STAT,1936,40,na,1976,4258.725784695448
STAT,1876,44,35-39,1920,2.13110305939545
SIM,1891,22,25-29,1913,83
STAT,1926,22,30-34,1948,40.287787552768556
SIM,1884,44,35-39,1928,6
SIM,1924,28,45-49,1952,1
STAT,1785,75,na,1860,269.8980796289556
SIM,1956,13,na,1969,5513
SIM,1964,34,35-39,1998,5
SIM,1934,22,30-34,1956,59
SIM,1984,24,30-34,2008,61
SIM,2001,13,na,2014,7313
STAT,1879,91,na,1970,244.23315778805684
STAT,1896,22,35-39,1918,8.894941159742485
SIM,1976,34,na,2010,5978
SIM,1894,4,na,1898,4199
STAT,1821,50,40-44,1871,0.019101908583170256
SIM,1921,22,20-24,1943,8
STAT,1853,61,na,1914,1860.4490608699748
STAT,1859,21,35-39,1880,6.160648984267412
STAT,1881,26,15-19,1907,0.5067626288647464
STAT,1956,34,35-39,1990,14.206300185486562
STAT,1916,28,45-49,1944,2.0544154430329207
STAT,1976,24,30-34,2000,44.42950114146759
SIM,1909,38,20-24,1947,4
SIM,1867,21,35-39,1888,5
STAT,1883,22,25-29,1905,64.63557848346429
SIM,1909,5,na,1914,5152
STAT,1922,47,50-100,1969,0.299734226906556
STAT,1977,21,50-100,1998,1.029739921529952
SIM,1822,69,na,1891,888
SIM,1910,22,45-49,1932,2
SIM,1939,33,30-34,1972,37
STAT,1960,23,45-49,1983,1.6962506444506433
SIM,1893,73,na,1966,1865
SIM,1824,43,25-29,1867,2
STAT,1848,15,na,1863,3059.399379526642
STAT,1857,25,25-29,1882,39.730674292833044
SIM,1809,87,na,1896,133
STAT,1888,28,15-19,1916,0.61331484626813
SIM,1822,44,na,1866,1615
STAT,1822,94,na,1916,16.421094931070485
SIM,1948,18,na,1966,4457
SIM,1902,28,25-29,1930,7
SIM,1882,36,40-44,1918,10
STAT,1960,45,45-49,2005,0.34139289384168603
STAT,1861,2,na,1863,3302.4857127491327
STAT,1842,12,na,1854,2359.0
STAT,1959,39,20-24,1998,0.40910226751570367
STAT,1848,49,45-49,1897,0.2455209335782844
SIM,1874,25,35-39,1899,28
SIM,1889,59,na,1948,3122
SIM,1820,39,20-24,1859,1
STAT,1951,32,na,1983,5297.875639255184
SIM,1911,38,na,1949,4782
STAT,1892,73,na,1965,2057.777182141906
STAT,1949,28,na,1977,5047.280407052558
STAT,1863,103,na,1966,0.8450004656092213
SIM,1817,41,35-39,1858,3
STAT,1866,25,35-39,1891,10.391112501479476
STAT,1816,43,25-29,1859,1.4028984918441703
STAT,1971,23,20-24,1994,163.0126558722859
STAT,1902,22,45-49,1924,1.1370720906942646
STAT,1985,24,40-44,2009,5.53340981007943
SIM,1919,33,45-49,1952,3
STAT,1874,36,40-44,1910,5.196680703359406
STAT,1884,3,na,1887,3373.349044920912
STAT,1991,22,15-19,2013,8.83301441860379
STAT,1937,23,45-49,1960,1.2647536872727019
SIM,1929,16,20-24,1945,375
STAT,1889,20,45-49,1909,0.9979070069487883
STAT,1979,17,20-24,1996,215.4269548889944
SIM,1796,87,na,1883,174
STAT,1886,88,na,1974,499.4998931438639
STAT,1922,27,25-29,1949,85.91553307162393
SIM,1817,45,50-100,1862,1
SIM,1932,23,35-39,1955,13
STAT,1955,13,na,1968,6016.948957692326
SIM,1942,15,na,1957,5043
SIM,1961,22,50-100,1983,1
SIM,1905,16,35-39,1921,3
STAT,1909,32,40-44,1941,4.3144699363152625
SIM,1945,23,45-49,1968,2
SIM,1917,32,40-44,1949,10
SIM,1897,54,na,1951,3106
SIM,1963,3,na,1966,6584
STAT,1919,46,50-100,1965,0.2837509852610202
SIM,1930,27,25-29,1957,17
STAT,1836,27,na,1863,2547.3627296634327
STAT,1937,48,35-39,1985,0.14987809962690438
SIM,1956,23,20-24,1979,166
STAT,1912,33,na,1945,4280.77214984773
STAT,1885,31,50-100,1916,1.0590089074186275
STAT,1942,18,45-49,1960,0.6023675296984211
STAT,1888,23,20-24,1911,93.19607025351375
STAT,1883,15,25-29,1898,6.427986621636001
SIM,1885,23,45-49,1908,4
SIM,1963,17,35-39,1980,15
SIM,1950,24,30-34,1974,45
SIM,1950,10,na,1960,4818
STAT,1877,23,45-49,1900,0.8345095149617017
STAT,1830,36,na,1866,1703.7492516227007
STAT,1882,43,15-19,1925,0.01545419709936869
SIM,1950,18,45-49,1968,2
SIM,1896,23,20-24,1919,110
STAT,1859,77,na,1936,794.6397733320267
SIM,1971,29,15-19,2000,6
STAT,1903,39,15-19,1942,0.019722830686706643
STAT,1955,17,35-39,1972,6.428547895790582
SIM,1858,42,na,1900,2527
STAT,1942,24,30-34,1966,34.75940869577593
SIM,1883,38,50-100,1921,6
SIM,1843,31,35-39,1874,11
STAT,1961,35,20-24,1996,0.40563154843968746
SIM,1869,41,50-100,1910,1
STAT,1929,24,30-34,1953,41.683960008973315
STAT,1898,45,25-29,1943,0.05118109690663348
STAT,1919,43,20-24,1962,0.02204629358591437
STAT,1904,38,na,1942,3915.6604527240797
STAT,1929,29,25-29,1958,94.97594047640598
SIM,1929,33,na,1962,5265
STAT,1773,87,na,1860,101.14856903637013
SIM,1845,94,na,1939,10
STAT,1948,23,20-24,1971,147.28829330816384
SIM,1848,32,30-34,1880,33
SIM,1924,29,15-19,1953,2
SIM,1777,83,na,1860,195
SIM,1855,31,na,1886,1965
SIM,1846,54,na,1900,1394
SIM,1889,26,25-29,1915,7
SIM,1937,29,25-29,1966,3
STAT,1920,18,25-29,1938,55.93821997295898
STAT,1916,34,30-34,1950,18.612949938291884
STAT,1962,32,45-49,1994,2.3717740522579063
SIM,1848,37,25-29,1885,3
STAT,1928,45,20-24,1973,0.016349012212778933
STAT,1889,43,25-29,1932,0.906913849135911
STAT,1835,31,35-39,1866,8.136448023108711
STAT,1859,31,20-24,1890,2.495089655278873
SIM,1839,42,25-29,1881,1
STAT,1938,50,na,1988,4313.073079759749
SIM,1903,17,20-24,1920,52
SIM,1978,28,30-34,2006,132
STAT,1936,42,45-49,1978,0.19031521726214554
STAT,1861,96,na,1957,11.010980636450538
STAT,1836,104,na,1940,0.060701559156311334
SIM,1867,31,20-24,1898,5
STAT,1838,102,na,1940,0.2539511169696238
STAT,1891,16,50-100,1907,0.07004962883159604
STAT,1924,36,na,1960,5122.964454112851
SIM,1908,34,na,1942,3933
SIM,1980,34,50-100,2014,3
SIM,1907,21,25-29,1928,219
SIM,1878,20,40-44,1898,3
SIM,1849,16,35-39,1865,2
SIM,1839,35,25-29,1874,6
SIM,1972,20,50-100,1992,2
STAT,1842,33,25-29,1875,9.423223848667957
STAT,1893,58,na,1951,2884.7581085237653
STAT,1972,29,25-29,2001,97.58012293695597
STAT,1884,22,na,1906,2696.6780541348394
SIM,1865,25,25-29,1890,99
STAT,1869,114,na,1983,2.2985686012561146E-4
SIM,1900,34,45-49,1934,7
STAT,1872,59,na,1931,2252.090543907734
STAT,1983,18,45-49,2001,0.8152632440115791
STAT,1955,19,25-29,1974,66.3455902820284
STAT,1898,39,30-34,1937,1.7761091429541302
STAT,1952,15,35-39,1967,5.806220277758398
SIM,1991,18,45-49,2009,5
STAT,1948,43,na,1991,5089.265681837836
SIM,1974,16,40-44,1990,5
SIM,1892,23,na,1915,3983
STAT,1945,33,20-24,1978,3.1324277807233214
SIM,1900,60,na,1960,3044
STAT,1817,54,na,1871,1784.1212775695126
STAT,1930,41,20-24,1971,0.026858253217922946
SIM,1850,9,na,1859,2285
STAT,1827,43,50-100,1870,1.3831848251213497
SIM,1809,62,na,1871,1131
SIM,1869,30,35-39,1899,15
SIM,1924,34,30-34,1958,41
SIM,1980,29,25-29,2009,5
SIM,1949,51,na,2000,5653
SIM,1960,15,35-39,1975,13
SIM,1953,33,20-24,1986,3
STAT,1874,39,45-49,1913,2.3314953267574277
STAT,1891,29,50-100,1920,0.905883754613198
STAT,1897,11,na,1908,3991.1039148489353
SIM,1978,21,15-19,1999,14
STAT,1966,16,40-44,1982,2.016708257672694
SIM,1925,52,na,1977,5210
SIM,1937,24,30-34,1961,84
STAT,1861,21,35-39,1882,5.7932570573860405
STAT,1939,46,35-39,1985,0.15536531309492926
SIM,1984,18,45-49,2002,1
STAT,1860,31,na,1891,2228.598954721967
SIM,1813,104,na,1917,3
SIM,1850,33,25-29,1883,8
STAT,1981,19,30-34,2000,19.656077690544716
STAT,1826,31,25-29,1857,10.206990773161875
STAT,1954,35,20-24,1989,0.38812924037802715
STAT,1935,22,40-44,1957,5.286883589228003
SIM,1910,53,na,1963,3270
SIM,1935,14,na,1949,6431
SIM,1834,31,25-29,1865,20
SIM,1968,39,na,2007,5336
STAT,1852,44,40-44,1896,2.0920227156084756
SIM,1963,19,25-29,1982,89
SIM,1908,32,30-34,1940,3
STAT,1833,31,25-29,1864,9.467284918617743
STAT,1907,26,45-49,1933,1.8917363360678296
STAT,1937,25,na,1962,4220.205302100303
SIM,1910,78,na,1988,1592
SIM,1948,26,40-44,1974,1
SIM,1879,66,na,1945,1853
STAT,1926,20,40-44,1946,4.74127616753012
SIM,1929,22,15-19,1951,11
SIM,1896,26,25-29,1922,136
STAT,1863,23,na,1886,2416.6795890232615
STAT,1879,26,15-19,1905,0.5485963258870673
STAT,1971,26,25-29,1997,96.66648950716936
STAT,1862,24,50-100,1886,0.40075120451539953
SIM,1930,74,na,2004,4180
STAT,1848,32,15-19,1880,0.17645681685852613
STAT,1926,25,35-39,1951,20.90687029224703
SIM,1955,9,na,1964,6580
STAT,1842,27,30-34,1869,23.96392732032214
SIM,1879,41,na,1920,2713
STAT,1892,15,35-39,1907,0.7973592609323364
SIM,1919,19,30-34,1938,39
SIM,1939,26,30-34,1965,9
STAT,1808,108,na,1916,9.339759570649531E-4
STAT,1873,41,15-19,1914,0.01634838341041227
STAT,1991,16,20-24,2007,224.28870320706417
SIM,1926,26,20-24,1952,29
SIM,1891,24,15-19,1915,4
STAT,1853,106,na,1959,0.027934510495985512
STAT,1863,38,30-34,1901,5.351455567166876
STAT,1963,35,30-34,1998,2.7577778297988775
STAT,1826,54,40-44,1880,0.007034355147826448
SIM,1899,80,na,1979,1571
STAT,1866,22,30-34,1888,19.208690767945246
STAT,1888,26,25-29,1914,57.581963322195456
STAT,1911,24,45-49,1935,1.2248287221786167
SIM,1904,34,20-24,1938,5
SIM,1905,23,na,1928,4076
STAT,1928,29,na,1957,5320.806377609384
SIM,1934,20,40-44,1954,11
STAT,1827,37,15-19,1864,0.08212461836588762
SIM,1984,27,35-39,2011,34
STAT,1958,40,30-34,1998,0.20194231190083445
STAT,1902,112,na,2014,0.007962623282156852
STAT,1802,55,na,1857,1472.8690366628775
STAT,1864,19,30-34,1883,1.6790598947503526
SIM,1872,19,30-34,1891,4
STAT,1804,54,20-24,1858,0.003262739508202249
SIM,1930,24,20-24,1954,10
STAT,1942,19,15-19,1961,54.70594736164505
SIM,1918,7,na,1925,4328
STAT,1861,38,20-24,1899,0.7358897830569713
STAT,1866,27,25-29,1893,45.24821690812265
STAT,1976,27,35-39,2003,23.247974575453068
SIM,1961,51,na,2012,5450
STAT,1867,51,25-29,1918,0.0038347382953892763
STAT,1887,47,15-19,1934,5.14916956668282E-4
SIM,1850,27,30-34,1877,26
STAT,1918,34,40-44,1952,4.7569453321637125
STAT,1871,74,na,1945,1274.1775208291556
STAT,1962,48,15-19,2010,5.649969140235245E-4
STAT,1979,27,na,2006,5978.292899672324
STAT,1811,51,na,1862,1465.6339665521646
STAT,1848,46,40-44,1894,0.18242120459049557
SIM,1926,34,40-44,1960,9
SIM,1949,43,40-44,1992,1
SIM,1972,19,35-39,1991,15
STAT,1948,38,50-100,1986,0.5706849407823211
STAT,1874,22,15-19,1896,3.897622823501053
SIM,1859,33,45-49,1892,3
STAT,1776,98,na,1874,0.832034094916522
STAT,1916,29,15-19,1945,0.836438865635513
STAT,1933,16,45-49,1949,0.7739580964068832
STAT,1865,89,na,1954,109.38761738549118
SIM,1874,34,25-29,1908,7
STAT,1942,27,35-39,1969,18.188046880025993
SIM,1864,67,na,1931,1491
STAT,1852,21,25-29,1873,64.57981242835268
STAT,1964,19,35-39,1983,6.095091578230498
SIM,1860,21,25-29,1881,1
SIM,1846,29,30-34,1875,2
STAT,1922,26,na,1948,4906.651515663793
SIM,1956,38,50-100,1994,2
STAT,1842,18,40-44,1860,0.17967503844430532
SIM,1907,15,30-34,1922,5
SIM,1874,22,30-34,1896,25
SIM,1984,22,40-44,2006,8
SIM,1934,25,35-39,1959,34
STAT,1866,34,25-29,1900,10.86232133536261
STAT,1883,24,15-19,1907,3.7015840436954806
SIM,1932,22,na,1954,5151
SIM,1871,38,30-34,1909,10
SIM,1856,16,na,1872,2460
STAT,1902,18,50-100,1920,0.07967822450849939
STAT,1935,24,50-100,1959,1.0339118401960294
SIM,1976,28,20-24,2004,29
SIM,1940,46,50-100,1986,1
STAT,1838,29,30-34,1867,27.355075478820833
STAT,1882,53,50-100,1935,0.016750706472896913
SIM,1941,25,35-39,1966,25
STAT,1934,14,na,1948,6167.994251068704
SIM,1790,65,na,1855,644
SIM,1889,23,20-24,1912,175
STAT,1957,16,30-34,1973,18.55127374002013
SIM,1793,76,na,1869,593
STAT,1932,46,50-100,1978,0.35504814862632045
STAT,1919,84,na,2003,1681.5304109501724
STAT,1948,46,45-49,1994,0.29930016902841106
SIM,1827,44,50-100,1871,2
SIM,1965,16,30-34,1981,38
STAT,1857,48,40-44,1905,0.15194292569309983
SIM,1943,24,50-100,1967,2
SIM,1842,16,25-29,1858,14
SIM,1852,26,50-100,1878,1
SIM,1908,30,40-44,1938,8
STAT,1994,18,20-24,2012,225.70754630368938
STAT,1836,19,50-100,1855,0.06482350477482171
SIM,1902,27,na,1929,4171
SIM,1848,35,35-39,1883,9
STAT,1835,48,20-24,1883,0.007793014207865647
SIM,1878,32,35-39,1910,4
SIM,1849,49,50-100,1898,2
STAT,1848,31,45-49,1879,2.183317233095524
STAT,1959,15,45-49,1974,0.7544952138652715
STAT,1796,106,na,1902,0.003092548862621277
SIM,1846,79,na,1925,15
STAT,1919,46,25-29,1965,0.06654746187188064
STAT,1931,26,20-24,1957,27.215193251432275
SIM,1908,35,35-39,1943,3
STAT,1924,23,35-39,1947,12.77908158558664
STAT,1929,27,35-39,1956,21.685417671766608
STAT,1964,44,25-29,2008,0.10750826598569801
SIM,1898,25,20-24,1923,18
SIM,1893,21,20-24,1914,7
STAT,1835,42,na,1877,1570.0114493282633
SIM,1923,26,na,1949,5080
STAT,1830,44,20-24,1874,0.14810341036516564
SIM,1966,31,40-44,1997,15
SIM,1824,37,30-34,1861,4
STAT,1893,41,25-29,1934,0.9409648348410119
STAT,1818,43,35-39,1861,2.353998629817124
STAT,1903,34,20-24,1937,2.5294574984160247
STAT,1890,45,30-34,1935,0.1378604783184541
STAT,1953,18,20-24,1971,189.2102691625779
STAT,1961,38,25-29,1999,1.5109266061457156
STAT,1916,37,35-39,1953,2.858790054403455
STAT,1883,38,40-44,1921,4.918089337264694
SIM,1881,85,na,1966,316
STAT,1994,19,na,2013,6125.624142751927
STAT,1911,40,50-100,1951,0.13097911704964732
STAT,1958,31,40-44,1989,6.049702966914883
STAT,1779,94,na,1873,3.59374261681866
STAT,1887,33,na,1920,3073.246936451986
STAT,1928,48,25-29,1976,0.0778904968936785
SIM,1944,25,na,1969,4620
STAT,1909,44,na,1953,3964.0889505354685
STAT,1968,17,45-49,1985,0.7200452465193107
SIM,1967,34,40-44,2001,3
SIM,1976,17,45-49,1993,1
SIM,1946,29,35-39,1975,1
STAT,1937,45,30-34,1982,0.10440799605618312
SIM,1965,24,na,1989,5175
STAT,1922,24,20-24,1946,146.1731925402259
STAT,1938,29,35-39,1967,17.156728773402524
STAT,1920,16,50-100,1936,0.48607692692091453
STAT,2000,7,na,2007,6745.940505670565
STAT,1874,21,45-49,1895,0.8263359165379319
SIM,1840,57,na,1897,1584
SIM,1860,86,na,1946,654
STAT,1938,15,50-100,1953,0.4286999319475992
STAT,1944,16,20-24,1960,168.4300170160505
STAT,1907,35,35-39,1942,2.616793842344467
STAT,1989,18,50-100,2007,0.6191035522263002
SIM,1924,37,35-39,1961,8
STAT,1790,108,na,1898,4.054133729606685E-4
STAT,1799,101,na,1900,0.25631542157207066
STAT,1872,34,na,1906,2741.5874381256403
STAT,1945,36,25-29,1981,1.2799629511697452
SIM,1980,26,20-24,2006,3
STAT,1918,26,20-24,1944,22.49089959919352
STAT,1920,27,15-19,1947,0.8933260443536158
STAT,1981,25,50-100,2006,1.6145574493270949
SIM,1781,73,na,1854,703
SIM,1892,48,na,1940,3488
SIM,1891,38,40-44,1929,2
STAT,1876,38,40-44,1914,5.196365836813144
STAT,1946,7,na,1953,5050.671641745788
STAT,1913,22,20-24,1935,124.41236838681753
STAT,1885,21,20-24,1906,79.56530146826667
SIM,1856,31,45-49,1887,4
STAT,1822,33,15-19,1855,0.48042038963723765
STAT,1954,38,25-29,1992,1.445732705372849
SIM,1905,18,25-29,1923,17
SIM,1937,27,35-39,1964,29
STAT,1880,85,na,1965,625.0923735863284
STAT,1905,63,na,1968,3307.477460760128
STAT,1926,62,na,1988,4760.92897604684
STAT,1930,44,25-29,1974,0.10808355660216168
STAT,1853,27,15-19,1880,0.5232914980562734
STAT,1905,36,20-24,1941,0.2792474269230706
SIM,1915,35,35-39,1950,4
SIM,1833,50,na,1883,1466
SIM,1943,40,na,1983,5365
SIM,1959,24,na,1983,5995
SIM,1986,27,na,2013,6679
SIM,1812,51,na,1863,1463
STAT,1814,43,na,1857,1992.529179709278
STAT,1923,44,25-29,1967,0.09596416787339089
STAT,1987,18,20-24,2005,223.28888039785014
SIM,1906,33,35-39,1939,23
SIM,1895,20,35-39,1915,20
SIM,1995,18,20-24,2013,237
STAT,1887,20,35-39,1907,7.592191326404658
STAT,1927,28,20-24,1955,25.51429558280683
SIM,1935,28,20-24,1963,24
STAT,1887,109,na,1996,0.08867331241620907
STAT,1831,35,15-19,1866,0.05669490548270369
SIM,1953,36,25-29,1989,3
STAT,1899,37,50-100,1936,0.41897969550351505
STAT,1997,15,na,2012,6206.037624460243
SIM,1885,21,25-29,1906,131
STAT,1887,18,50-100,1905,0.06319631491257124
STAT,1964,15,25-29,1979,63.021926178960555
SIM,1910,21,30-34,1931,35
STAT,1819,80,na,1899,411.8072325034947
STAT,1873,45,25-29,1918,0.06855775949295306
STAT,1879,18,30-34,1897,1.9156106890947548
STAT,1837,93,na,1930,21.162929434657578
SIM,1858,36,na,1894,2581
STAT,1808,51,25-29,1859,0.01722557670741443
STAT,1940,41,15-19,1981,0.0018733339360471806
SIM,1832,38,40-44,1870,3
SIM,1966,38,45-49,2004,3
STAT,1854,43,50-100,1897,0.8544707464091508
STAT,1944,38,30-34,1982,2.3297203006818807
STAT,1844,15,35-39,1859,0.5903413807264533
SIM,1920,17,50-100,1937,1
SIM,1888,31,20-24,1919,5
STAT,1941,28,35-39,1969,17.91943547321302
SIM,1840,26,na,1866,2132
SIM,1856,25,50-100,1881,1
SIM,1897,37,30-34,1934,14
SIM,1911,39,50-100,1950,1
STAT,1869,39,na,1908,2606.559089258665
STAT,1902,21,30-34,1923,29.132897874904657
STAT,1977,32,40-44,2009,6.219949305440842
SIM,1909,32,45-49,1941,5
SIM,1972,15,25-29,1987,101
STAT,1824,38,40-44,1862,6.559628936547947
SIM,1997,15,15-19,2012,135
STAT,1902,38,25-29,1940,1.008326596464936
STAT,1957,38,40-44,1995,2.344291809393035
SIM,1946,55,na,2001,4366
SIM,1921,40,45-49,1961,1
SIM,1907,37,40-44,1944,1
STAT,1930,38,30-34,1968,2.7411039568734887
STAT,1823,51,20-24,1874,7.163818087538871E-4
STAT,1833,25,30-34,1858,24.23497344908772
SIM,1827,44,na,1871,1404
SIM,1910,38,25-29,1948,1
STAT,1918,48,30-34,1966,0.10915096395385637
STAT,1794,71,na,1865,794.9945833494205
SIM,1950,40,40-44,1990,1
STAT,1836,39,15-19,1875,0.06146082586979469
STAT,1867,39,50-100,1906,1.3095644356936225
STAT,1913,40,45-49,1953,0.1895246747605534
STAT,1832,62,na,1894,1245.215563127315
STAT,1960,22,30-34,1982,43.34308856263088
SIM,1804,87,na,1891,83
STAT,1883,19,35-39,1902,0.6162207771819839
STAT,1927,38,50-100,1965,0.6016782914206952
STAT,1947,17,50-100,1964,0.48703670737839655
SIM,1870,36,na,1906,3023
SIM,1887,19,15-19,1906,10
STAT,1895,99,na,1994,43.764274030199
STAT,1989,15,15-19,2004,75.05787334533164
STAT,1924,40,20-24,1964,0.02430300632544889
SIM,1863,82,na,1945,218
STAT,1951,61,na,2012,4837.537359538768
STAT,1899,40,15-19,1939,0.0015315187103424573
STAT,1831,80,na,1911,485.33028349166483
SIM,1924,32,40-44,1956,2
SIM,1871,18,na,1889,2184
STAT,1809,50,na,1859,1418.0249379989907
SIM,1957,29,na,1986,6033
STAT,1811,54,35-39,1865,0.02461530831218636
STAT,1872,47,50-100,1919,0.28327499315245575
STAT,1954,41,15-19,1995,0.002280152232972751
SIM,1841,25,30-34,1866,31
STAT,1969,38,20-24,2007,0.39112602270371505
STAT,1934,32,30-34,1966,24.83713167559734
STAT,1823,85,na,1908,155.23899334200297
STAT,1876,80,na,1956,782.3754002554231
STAT,1960,39,25-29,1999,1.5214595721872561
STAT,1943,66,na,2009,4006.2464414095475
STAT,1959,33,45-49,1992,2.419832794809592
SIM,1923,38,35-39,1961,8
SIM,1939,73,na,2012,3505
STAT,1909,40,25-29,1949,0.07804178864076997
STAT,1872,48,15-19,1920,4.5769634142299594E-4
SIM,1948,40,na,1988,4401
STAT,1856,72,na,1928,1111.9149082727902
STAT,1916,32,40-44,1948,4.663084615097066
STAT,1833,109,na,1942,5.006355242676966E-4
STAT,1786,109,na,1895,6.195538552504469E-4
SIM,1902,37,50-100,1939,1
SIM,1992,12,na,2004,7032
SIM,1877,31,45-49,1908,4
STAT,1993,15,35-39,2008,6.970936678874749
SIM,1952,38,30-34,1990,8
SIM,1877,15,na,1892,3358
STAT,1833,43,30-34,1876,0.9746396473050649
STAT,1904,49,50-100,1953,0.22479559836213608
STAT,1900,40,35-39,1940,0.2033969144419447
STAT,1849,35,50-100,1884,0.994155663957681
STAT,1822,104,na,1926,0.05480253405588304
STAT,1869,31,45-49,1900,1.9568746541758093
SIM,1913,3,na,1916,5155
SIM,1959,39,25-29,1998,5
STAT,1877,34,na,1911,2840.1091264465053
STAT,1915,38,35-39,1953,2.8063471117534693
STAT,1945,61,na,2006,4437.7204268161
STAT,1954,23,15-19,1977,7.616988674939424
SIM,1903,96,na,1999,142
STAT,1934,49,25-29,1983,0.08483166648517532
STAT,1912,27,30-34,1939,44.60367330222331
STAT,1825,80,na,1905,437.55063914169045
STAT,1892,11,na,1903,3741.003971878474
STAT,1927,22,45-49,1949,1.599472181664643
SIM,1864,36,na,1900,2694
SIM,1872,31,na,1903,2928
STAT,1820,53,50-100,1873,0.014538108137263427
SIM,1872,2,na,1874,3960
STAT,1871,20,45-49,1891,0.8053901971269645
SIM,1795,65,na,1860,990
STAT,1950,33,25-29,1983,12.847720093791173
SIM,1842,23,25-29,1865,4
STAT,1922,30,15-19,1952,0.168834514045217
STAT,1807,109,na,1916,3.4790667788284544E-4
STAT,1839,17,20-24,1856,18.3920095012317
STAT,1860,47,40-44,1907,0.15849224131147993
STAT,1834,23,25-29,1857,69.36681663402817
STAT,1814,49,35-39,1863,0.37666194799443387
STAT,1952,25,50-100,1977,1.3836921151859265
STAT,1947,46,30-34,1993,0.12083834132715834
STAT,1927,35,20-24,1962,0.378805890554233
STAT,1860,31,25-29,1891,9.565667177014548
STAT,1953,43,20-24,1996,0.025581694354626767
SIM,1895,28,na,1923,3808
STAT,1818,39,na,1857,1338.3992350676776
SIM,1856,49,50-100,1905,1
STAT,1899,29,40-44,1928,4.7023470259751985
SIM,1920,27,30-34,1947,2
SIM,1882,61,na,1943,2680
SIM,1942,32,30-34,1974,40
STAT,1869,30,30-34,1899,19.669974539269578
STAT,1910,32,45-49,1942,1.7528040493718289
SIM,1826,40,30-34,1866,5
SIM,1916,0,na,1916,5187
STAT,1904,48,30-34,1952,0.08935256840474178
SIM,1884,23,30-34,1907,46
STAT,1830,47,25-29,1877,0.05314537644777307
STAT,1942,40,40-44,1982,0.31441497804716095
SIM,1917,86,na,2003,1155
STAT,1958,36,35-39,1994,3.7805148992752042
STAT,1988,17,20-24,2005,223.7730074090273
SIM,1907,58,na,1965,3978
SIM,1802,52,na,1854,1274
SIM,1935,22,45-49,1957,2
STAT,1885,69,na,1954,1689.3027820853067
SIM,1886,23,na,1909,1967
SIM,1946,25,25-29,1971,10
STAT,1848,77,na,1925,918.4406051093189
STAT,1963,17,na,1980,5396.586545524721
STAT,1818,40,30-34,1858,1.6254605046817578
STAT,1892,26,50-100,1918,0.9284483299465999
SIM,1858,36,35-39,1894,2
STAT,1834,41,25-29,1875,0.7155869570496982
STAT,1882,101,na,1983,11.350291621300485
STAT,1848,23,25-29,1871,73.52896742667615
STAT,1908,24,30-34,1932,30.340742985616153
SIM,1859,42,50-100,1901,2
STAT,1960,42,40-44,2002,0.39070727749194134
STAT,1854,77,na,1931,704.2176740145953
STAT,1932,25,na,1957,5668.8494031764485
STAT,1810,75,na,1885,565.7628799779261
STAT,1956,19,50-100,1975,0.571744220370357
STAT,1959,49,15-19,2008,5.750206205283402E-4
STAT,1928,33,15-19,1961,0.18531505569009077
STAT,1855,18,15-19,1873,5.970718102372313
STAT,1878,16,50-100,1894,0.05917802277044292
SIM,1969,28,30-34,1997,71
STAT,1938,25,25-29,1963,75.35608577405766
SIM,1847,17,20-24,1864,32
SIM,1938,10,na,1948,4188
STAT,1999,10,na,2009,6698.892968026748
STAT,1895,21,45-49,1916,1.0506733973939297
SIM,1926,37,na,1963,5846
STAT,1894,46,na,1940,3347.8257523982957
STAT,1978,30,35-39,2008,14.687367261070928
SIM,1952,55,na,2007,4371
STAT,1973,38,40-44,2011,2.2995774101578683
SIM,1842,41,25-29,1883,1
SIM,1833,44,na,1877,1593
STAT,1923,46,45-49,1969,0.29403573104267094
STAT,1961,27,50-100,1988,1.49048131825191
STAT,1876,41,30-34,1917,1.3777357386954387
STAT,1984,28,45-49,2012,2.8425383713013184
STAT,1967,40,30-34,2007,0.19206075497368094
SIM,1916,24,30-34,1940,51
STAT,1840,39,35-39,1879,6.572915477267338
STAT,1942,22,40-44,1964,4.069171896027423
SIM,1853,30,45-49,1883,5
STAT,1889,37,30-34,1926,7.581693572715397
SIM,1925,30,35-39,1955,27
STAT,1892,24,25-29,1916,82.28366333245962
STAT,1879,69,na,1948,1768.4174874702212
STAT,1953,25,20-24,1978,25.61591415124176
SIM,1961,25,20-24,1986,49
SIM,1841,79,na,1920,501
SIM,1856,23,25-29,1879,5
STAT,1845,30,45-49,1875,1.4264982163580364
STAT,1908,42,30-34,1950,0.13667654234945686
STAT,1858,37,50-100,1895,1.1053196197470667
SIM,1861,33,50-100,1894,2
SIM,1818,42,50-100,1860,3
STAT,1902,35,20-24,1937,0.2738820752654244
STAT,1919,43,na,1962,4636.2749216243365
STAT,1978,28,15-19,2006,1.1161236977505582
SIM,1884,41,30-34,1925,2
STAT,1882,80,na,1962,950.7104596565363
STAT,1957,58,na,2015,5515.658963463186
SIM,1882,29,40-44,1911,9
STAT,1920,71,na,1991,3573.7181884505503
SIM,1902,43,45-49,1945,1
SIM,1863,18,15-19,1881,11
STAT,1942,55,na,1997,4464.698424838993
STAT,1874,29,40-44,1903,3.5138060785750165
STAT,1775,104,na,1879,0.04449677323520913
STAT,1970,43,40-44,2013,0.3749213567665213
SIM,1944,10,na,1954,4671
SIM,1967,30,40-44,1997,9
STAT,1974,36,35-39,2010,3.75854405377276
STAT,1840,36,30-34,1876,5.109528189721565
STAT,1820,37,na,1857,1657.0421641267894
STAT,1807,55,na,1862,1514.739736587397
STAT,1879,19,15-19,1898,7.1128950636509805
STAT,1901,33,na,1934,3841.1522657858886
STAT,1924,43,25-29,1967,0.09784182574191454
SIM,1910,24,35-39,1934,25
SIM,1950,19,na,1969,4804
STAT,1833,28,35-39,1861,9.004200620078722
STAT,1843,35,40-44,1878,5.235225914853815
SIM,1932,43,25-29,1975,1
STAT,1883,24,50-100,1907,0.45755061431809846
SIM,1851,35,40-44,1886,12
STAT,1902,24,35-39,1926,9.455928604258327
SIM,1835,30,25-29,1865,18
STAT,1825,36,35-39,1861,12.070413548051203
STAT,1854,48,25-29,1902,0.04633691214995859
STAT,1921,35,25-29,1956,1.2704804113823895
STAT,1903,68,na,1971,2945.527772437373
STAT,1962,9,na,1971,5810.674934697399
STAT,1813,49,20-24,1862,0.038552811718145175
SIM,1954,40,na,1994,5444
STAT,1977,35,45-49,2012,1.0970501630453542
SIM,1978,20,45-49,1998,3
SIM,1831,49,na,1880,1532
SIM,1924,35,45-49,1959,1
STAT,1935,44,15-19,1979,0.0024928221777777756
SIM,1930,49,35-39,1979,1
STAT,1909,34,50-100,1943,0.9037410931219156
STAT,1959,30,40-44,1989,6.028432851744248
STAT,1922,49,35-39,1971,0.16985680282854218
STAT,1938,22,20-24,1960,127.06460963074291
SIM,1833,36,35-39,1869,12
STAT,1883,34,na,1917,2671.297318681627
STAT,1895,112,na,2007,0.006940188075320848
STAT,1965,48,30-34,2013,0.1332231533375119
SIM,1908,71,na,1979,2697
STAT,1843,93,na,1936,29.32420373802035
SIM,1956,26,25-29,1982,193
STAT,1905,43,20-24,1948,0.018287752352932913
STAT,1843,17,40-44,1860,0.23452778230545065
SIM,1916,43,45-49,1959,1
SIM,1959,36,20-24,1995,1
SIM,1889,28,na,1917,3752
STAT,1908,43,45-49,1951,0.17685821459870815
STAT,1905,16,30-34,1921,2.6688143071936534
STAT,1937,66,na,2003,3668.5009975015732
SIM,1966,26,50-100,1992,5
STAT,1830,67,na,1897,994.4338938304276
STAT,1921,17,25-29,1938,56.98468353945812
STAT,1869,15,35-39,1884,0.6291230213346611
STAT,1948,44,25-29,1992,0.09768231759904207
SIM,1915,53,na,1968,4334
STAT,1966,45,40-44,2011,0.23749632804511517
SIM,1838,22,20-24,1860,71
STAT,1829,28,15-19,1857,0.795847791290333
SIM,1822,46,30-34,1868,1
SIM,1897,23,na,1920,4078
SIM,1891,78,na,1969,1551
SIM,1966,35,40-44,2001,8
STAT,1899,47,40-44,1946,0.15197381518262199
STAT,1951,17,40-44,1968,1.922167535535153
STAT,1983,17,50-100,2000,0.6116431588195068
SIM,1891,16,30-34,1907,7
SIM,1868,44,50-100,1912,7
STAT,1814,46,30-34,1860,0.27357476074652715
SIM,1937,3,na,1940,4575
STAT,1876,23,30-34,1899,21.184015610627398
SIM,1868,66,na,1934,2202
SIM,1916,25,45-49,1941,2
STAT,1971,12,na,1983,5741.637006944436
STAT,1856,30,20-24,1886,2.4595969111438967
STAT,1950,30,20-24,1980,3.396498223430198
SIM,1842,20,20-24,1862,1
SIM,1904,22,15-19,1926,6
SIM,1943,26,15-19,1969,2
STAT,1947,19,40-44,1966,1.817052778570031
SIM,1825,49,na,1874,1621
STAT,1889,99,na,1988,38.71927799189299
STAT,1904,13,na,1917,4273.150027454487
SIM,1942,33,45-49,1975,4
SIM,1965,22,25-29,1987,303
STAT,1984,25,40-44,2009,7.679444269899549
STAT,1986,15,na,2001,6055.823059031952
STAT,1952,48,20-24,2000,0.015852828296810294
STAT,1833,46,35-39,1879,0.1176939080218684
STAT,1853,20,25-29,1873,68.3193205283452
STAT,1788,71,na,1859,892.4551905110252
STAT,1883,34,30-34,1917,19.544851977318967
SIM,1950,25,45-49,1975,6
STAT,1923,76,na,1999,3148.140278882193
STAT,1946,32,20-24,1978,3.182423700423164
SIM,1966,33,30-34,1999,84
SIM,1962,32,50-100,1994,2
SIM,1912,49,50-100,1961,1
STAT,1957,22,25-29,1979,141.01068112881822
SIM,1832,90,na,1922,77
SIM,1877,15,35-39,1892,3
STAT,1942,25,45-49,1967,2.0947223130027854
SIM,1891,34,30-34,1925,43
STAT,1853,24,na,1877,2479.231399388615
STAT,1935,30,25-29,1965,14.781611057494809
STAT,1958,33,30-34,1991,24.327020413030954
STAT,1966,25,30-34,1991,56.77225679975754
STAT,1840,54,30-34,1894,0.004643830956452961
SIM,1933,19,na,1952,5846
SIM,1864,30,20-24,1894,2
SIM,1887,18,30-34,1905,4
STAT,1908,25,45-49,1933,1.9160724839852625
STAT,1949,41,35-39,1990,0.2812772585339158
STAT,1876,26,35-39,1902,11.550470202049706
SIM,1838,28,na,1866,2011
STAT,1862,72,na,1934,1229.9742797557703
STAT,1923,43,40-44,1966,0.33672181798740014
STAT,1884,16,na,1900,2886.821826090357
SIM,1921,53,na,1974,4999
STAT,1916,35,45-49,1951,0.8133956677894477
STAT,1948,26,25-29,1974,87.34194399456509
STAT,1961,20,25-29,1981,138.27333888674218
SIM,1869,23,35-39,1892,5
STAT,1808,49,40-44,1857,0.826813626329831
SIM,1974,25,30-34,1999,3
STAT,1812,70,na,1882,732.2248972270277
SIM,1931,43,40-44,1974,2
SIM,1874,66,na,1940,1582
SIM,1898,32,20-24,1930,4
STAT,1817,45,40-44,1862,0.502962189314262
SIM,1819,49,na,1868,1094
SIM,1842,39,40-44,1881,5
STAT,1861,59,na,1920,1864.5735428015007
STAT,1965,12,na,1977,5659.517918668413
SIM,1841,28,35-39,1869,13
SIM,1948,35,30-34,1983,4
STAT,1942,43,45-49,1985,0.20829907884716548
STAT,1925,27,40-44,1952,6.351251115299752
SIM,1830,64,na,1894,1170
SIM,1897,21,15-19,1918,4
STAT,1851,53,25-29,1904,0.0027636996402257722
SIM,1858,33,30-34,1891,2
STAT,1933,19,40-44,1952,2.150180693130417
STAT,1936,55,na,1991,4072.785772017242
STAT,1889,21,15-19,1910,4.707259051419404
STAT,1863,45,50-100,1908,0.250308288342261
STAT,1827,30,25-29,1857,19.62837298809865
STAT,1909,36,15-19,1945,0.021101235700952153
SIM,1861,20,25-29,1881,126
SIM,1868,97,na,1965,4
SIM,1763,91,na,1854,43
STAT,1846,18,50-100,1864,0.06324803116690103
STAT,1896,48,30-34,1944,0.08218519221632185
SIM,1856,20,20-24,1876,82
STAT,1890,16,na,1906,3570.1551023333227
SIM,1941,19,40-44,1960,1
STAT,1834,39,40-44,1873,4.866936683429088
STAT,1855,6,na,1861,2524.8358915028366
SIM,1865,44,30-34,1909,1
STAT,1834,20,20-24,1854,132.0659975848971
STAT,1918,21,na,1939,4558.0331668333065
STAT,1970,28,30-34,1998,56.82173239934723
SIM,1979,30,na,2009,6328
SIM,1955,19,40-44,1974,9
STAT,1813,55,na,1868,1231.8036630334334
STAT,1812,51,45-49,1863,0.03279881131527881
STAT,1851,26,35-39,1877,9.023692419617184
STAT,1874,15,15-19,1889,7.070222242620303
STAT,1920,33,45-49,1953,1.9798784352700212
SIM,1950,43,45-49,1993,1
SIM,1982,16,25-29,1998,156
SIM,1866,31,na,1897,2421
STAT,1848,20,20-24,1868,90.44877358606111
STAT,1913,32,50-100,1945,0.9498186309248307
STAT,1974,16,25-29,1990,65.32128442256689
STAT,1857,44,30-34,1901,1.019386013263311
SIM,1856,39,40-44,1895,10
STAT,1923,44,50-100,1967,0.1578765332509252
SIM,1816,44,na,1860,1714
SIM,1933,27,40-44,1960,18
STAT,1972,22,20-24,1994,164.84493676859802
STAT,1934,33,45-49,1967,2.4791173456873588
STAT,1897,26,na,1923,3695.3628638384994
STAT,1903,21,45-49,1924,1.1497019076420205
SIM,1833,36,50-100,1869,4
STAT,1962,0,na,1962,5856.982919764391
SIM,1980,4,na,1984,6010
STAT,1974,33,30-34,2007,24.18564146829198
SIM,1817,82,na,1899,79
SIM,1814,49,na,1863,1410
SIM,1835,70,na,1905,1203
STAT,1979,33,na,2012,6121.945013221629
STAT,1903,15,15-19,1918,9.800402798818363
STAT,1815,59,na,1874,1358.8288994724535
STAT,1821,39,30-34,1860,10.897890182020044
SIM,1875,39,50-100,1914,2
STAT,1933,37,40-44,1970,2.3541468197569606
STAT,1965,29,35-39,1994,21.702924020395177
STAT,1868,16,35-39,1884,0.6230762809310714
SIM,1960,29,25-29,1989,7
STAT,1909,42,45-49,1951,0.1798490411325784
STAT,1847,52,20-24,1899,5.64772617124575E-4
STAT,1956,24,30-34,1980,44.00513684719616
STAT,1952,29,25-29,1981,91.33037933742577
STAT,1906,41,15-19,1947,0.001621146772551852
SIM,1899,89,na,1988,453
STAT,1961,16,15-19,1977,67.68548781425879
STAT,1924,21,na,1945,4986.513430280655
SIM,1827,75,na,1902,395
STAT,1917,89,na,2006,855.2595621324102
STAT,1883,16,30-34,1899,1.8040456061726278
SIM,1904,20,50-100,1924,6
STAT,1920,37,30-34,1957,2.3019205105950515
SIM,1930,28,30-34,1958,73
SIM,1929,29,40-44,1958,18
SIM,1908,40,na,1948,3788
STAT,1922,28,30-34,1950,50.96520916700538
SIM,1866,62,na,1928,1889
SIM,1948,33,40-44,1981,15
SIM,1881,79,na,1960,606
STAT,1826,50,30-34,1876,0.004305512804734096
STAT,1836,52,45-49,1888,0.013368159016058612
SIM,1904,38,30-34,1942,5
STAT,1868,54,50-100,1922,0.016284951152748996
STAT,1935,32,45-49,1967,2.5137534705215936
SIM,1906,23,30-34,1929,1
SIM,1890,28,na,1918,3564
SIM,1923,57,na,1980,5010
SIM,1999,2,na,2001,6976
STAT,1828,85,na,1913,181.94286153337106
SIM,1853,36,na,1889,2272
SIM,1841,48,na,1889,1800
STAT,1962,37,50-100,1999,0.6396084173494547
SIM,1877,3,na,1880,3645
STAT,1844,47,na,1891,1873.0445868987729
SIM,1930,46,30-34,1976,1
SIM,1935,38,50-100,1973,1
SIM,1833,33,30-34,1866,4
STAT,1898,64,na,1962,2903.241657106975
STAT,1904,32,15-19,1936,0.13551162750766982
STAT,1930,40,15-19,1970,0.0023386107582702843
SIM,1913,19,35-39,1932,1
STAT,1954,39,30-34,1993,2.6731462523893206
STAT,1981,29,35-39,2010,24.308235126803314
SIM,1917,8,na,1925,5825
SIM,1879,28,20-24,1907,23
SIM,1964,24,30-34,1988,2
SIM,1893,31,25-29,1924,5
STAT,1848,25,15-19,1873,0.5838563677427538
SIM,1865,26,30-34,1891,37
STAT,1861,42,30-34,1903,1.1016420336134634
STAT,1885,31,25-29,1916,11.83853955159128
SIM,1857,35,50-100,1892,1
SIM,1985,29,15-19,2014,2
STAT,1832,93,na,1925,19.910978301708376
STAT,1841,67,na,1908,1409.4015647080532
STAT,1867,72,na,1939,1360.7546463357708
STAT,1831,42,15-19,1873,0.013235391307463122
SIM,1954,32,20-24,1986,5
STAT,1874,54,na,1928,2473.8997127293246
STAT,1908,40,40-44,1948,0.27043283090158116
STAT,1847,109,na,1956,6.251375603520835E-4
STAT,1922,46,30-34,1968,0.1184299980870546
SIM,1957,55,na,2012,5913
STAT,1825,33,30-34,1858,34.05851717382387
STAT,1985,23,35-39,2008,15.501137898314365
STAT,1903,33,15-19,1936,0.1338452486668974
STAT,1977,29,15-19,2006,1.1044528317919948
SIM,1939,32,25-29,1971,23
STAT,1928,20,na,1948,5293.116408897526
STAT,1935,26,15-19,1961,1.1116482221712887
SIM,1854,74,na,1928,1389
STAT,1857,26,30-34,1883,23.48172450151337
STAT,1907,28,35-39,1935,16.32596586530886
STAT,1842,101,na,1943,0.43910925392729727
SIM,1915,28,35-39,1943,46
SIM,1911,33,15-19,1944,1
SIM,1959,23,45-49,1982,3
STAT,1932,31,15-19,1963,0.19730654976507336
SIM,1837,74,na,1911,1235
SIM,1902,29,30-34,1931,109
STAT,1860,29,40-44,1889,2.7757598041245397
SIM,1938,34,30-34,1972,2
STAT,1916,33,25-29,1949,10.966954947407727
SIM,1831,29,50-100,1860,1
SIM,1863,40,50-100,1903,2
STAT,1859,41,25-29,1900,0.5930091265062606
STAT,1826,32,30-34,1858,16.429787874600205
STAT,1827,47,na,1874,2051.7085147059197
STAT,1912,29,20-24,1941,20.630927268703275
STAT,1804,75,na,1879,551.5200866704994
STAT,1813,43,50-100,1856,3.8118418395953446
STAT,1897,104,na,2001,4.088427235120629
SIM,1942,30,40-44,1972,7
STAT,1852,11,na,1863,2734.5748537087347
STAT,1843,62,na,1905,1833.9106355093613
STAT,1920,19,30-34,1939,15.690364435702904
STAT,1961,34,15-19,1995,0.1950509713455911
STAT,1930,22,15-19,1952,7.870881626582006
SIM,1920,29,20-24,1949,2
SIM,1933,10,na,1943,6642
STAT,1889,90,na,1979,444.57412306392587
STAT,1901,99,na,2000,49.440943785656245
STAT,1966,28,35-39,1994,21.724026494914707
SIM,1869,20,30-34,1889,52
STAT,1994,10,na,2004,6543.484215572683
SIM,1916,22,40-44,1938,9
SIM,1850,56,na,1906,1266
SIM,1876,61,na,1937,2396
SIM,1908,49,25-29,1957,1
STAT,1966,26,45-49,1992,2.5021122381489365
STAT,1961,22,45-49,1983,1.6831764108317888
STAT,1848,46,na,1894,2397.3052837751648
SIM,1830,37,25-29,1867,2
SIM,1960,44,35-39,2004,1
SIM,1959,45,45-49,2004,1
STAT,1898,15,30-34,1913,2.4974767944808054
SIM,1918,31,50-100,1949,3
SIM,1970,37,na,2007,5977
STAT,1901,26,40-44,1927,4.858894757035595
SIM,1860,25,35-39,1885,3
STAT,1852,43,35-39,1895,1.6949266934755556
SIM,1810,56,na,1866,1220
SIM,1834,32,30-34,1866,34
STAT,1880,38,25-29,1918,3.504483832170137
SIM,1934,6,na,1940,6052
STAT,1849,38,40-44,1887,3.435932779993175
STAT,1972,25,na,1997,5564.101322587868
SIM,1856,9,na,1865,2633
STAT,1786,100,na,1886,0.37661637797128744
STAT,1879,60,na,1939,2298.1875138542873
STAT,1905,19,35-39,1924,0.9116060153392278
SIM,1838,25,25-29,1863,42
SIM,1968,32,35-39,2000,4
STAT,1861,28,na,1889,2289.723308081582
SIM,1857,38,40-44,1895,3
SIM,1841,70,na,1911,1061
SIM,1867,41,25-29,1908,1
STAT,1856,15,25-29,1871,5.9695971722065115
STAT,1906,17,50-100,1923,0.08244701182551549
SIM,1955,17,50-100,1972,1
STAT,1939,36,30-34,1975,2.1719366340304225
STAT,1846,11,na,1857,3114.298705865287
STAT,1852,25,35-39,1877,10.749623237908862
SIM,1903,27,25-29,1930,132
STAT,1986,22,35-39,2008,15.534631114160296
SIM,1934,39,25-29,1973,1
STAT,1942,23,25-29,1965,111.74986822774166
STAT,1898,33,30-34,1931,27.11666047708356
SIM,1868,28,45-49,1896,1
STAT,1884,32,25-29,1916,11.678832408061062
SIM,1913,58,na,1971,4121
STAT,1962,49,20-24,2011,0.01689754707042081
SIM,1950,23,25-29,1973,8
STAT,1934,30,40-44,1964,6.176126086945877
STAT,1926,56,na,1982,5035.34660305071
STAT,1973,39,25-29,2012,1.5107977362822582
SIM,1935,45,na,1980,6205
SIM,1938,16,30-34,1954,17
SIM,1864,15,25-29,1879,9
SIM,1977,19,25-29,1996,159
STAT,1847,27,20-24,1874,10.849772394506571
STAT,1856,50,50-100,1906,0.013488291330689498
SIM,1828,29,na,1857,2335
SIM,1938,19,na,1957,3858
STAT,1864,39,na,1903,2403.263140865874
STAT,1932,56,na,1988,5538.310529937406
SIM,1944,19,na,1963,4299
STAT,1837,20,45-49,1857,0.6930662201829507
SIM,1840,29,35-39,1869,21
SIM,1947,36,30-34,1983,4
STAT,1886,15,40-44,1901,0.2236843959322734
STAT,1933,32,50-100,1965,1.2864215790149622
SIM,1839,36,30-34,1875,14
STAT,1982,17,35-39,1999,6.814217882233421
SIM,1889,27,30-34,1916,53
STAT,1851,23,30-34,1874,16.74695012959479
STAT,1910,45,20-24,1955,0.011967425484075629
SIM,1948,38,35-39,1986,8
STAT,1832,29,35-39,1861,8.902990600729508
STAT,1783,71,na,1854,431.00000000000006
STAT,1897,18,20-24,1915,27.28581974645827
STAT,1916,15,25-29,1931,10.660917292107078
STAT,1856,33,25-29,1889,9.034207639976282
STAT,1848,25,50-100,1873,0.8232011983578971
STAT,1915,36,45-49,1951,0.798731153831239
STAT,1868,30,50-100,1898,1.0240693819213362
STAT,1926,39,25-29,1965,1.3854464809938292
STAT,1886,101,na,1987,13.498057837347472
SIM,1864,33,25-29,1897,23
STAT,1931,33,20-24,1964,3.686974502770189
STAT,1867,106,na,1973,0.2365650390702731
STAT,1915,18,45-49,1933,0.12036247813371384
SIM,1917,57,na,1974,4952
STAT,1941,26,45-49,1967,2.063910150760592
STAT,1971,27,30-34,1998,57.51935482667267
STAT,1823,54,25-29,1877,0.003239517802422505
STAT,1838,47,na,1885,2004.9521899188621
SIM,1855,27,20-24,1882,11
SIM,1900,91,na,1991,375
SIM,1835,48,na,1883,1948
STAT,1842,21,30-34,1863,17.413596641573132
STAT,1853,40,45-49,1893,1.50511886190973
STAT,1873,42,20-24,1915,0.18692912239870763
STAT,1960,37,na,1997,5825.922520802182
SIM,1892,32,25-29,1924,34
STAT,1960,25,35-39,1985,22.68381455997401
STAT,1799,55,na,1854,1459.0342598400002
STAT,1917,30,35-39,1947,11.132493267677964
STAT,1934,17,35-39,1951,6.553275459981212
STAT,1860,3,na,1863,3030.764970341861
SIM,1865,47,35-39,1912,1
STAT,1949,24,50-100,1973,0.8854583034464301
STAT,1926,36,20-24,1962,0.3720561821844769
STAT,1892,42,na,1934,3338.94070366838
SIM,1843,74,na,1917,713
SIM,1942,17,35-39,1959,6
SIM,1960,26,20-24,1986,1
STAT,1863,54,na,1917,2113.033286877015
SIM,1880,47,30-34,1927,1
STAT,1857,47,35-39,1904,0.12524685280384237
STAT,1846,73,na,1919,1227.8774353645083
STAT,1887,44,50-100,1931,1.347890601133237
STAT,1939,18,30-34,1957,14.081469541812783
SIM,1947,18,30-34,1965,34
STAT,1963,34,50-100,1997,1.2340438730030516
STAT,1843,100,na,1943,1.0652344243869698
STAT,1982,22,na,2004,5949.835452921253
SIM,1984,21,35-39,2005,15
STAT,1862,42,45-49,1904,1.4558318002997965
STAT,1929,45,50-100,1974,0.33993858103130103
SIM,1993,20,30-34,2013,112
STAT,1827,49,50-100,1876,0.30284600004146284
SIM,1938,19,35-39,1957,8
STAT,1952,26,20-24,1978,25.36515863203005
STAT,1821,59,na,1880,1280.5421313708493
STAT,1841,53,30-34,1894,0.005207378733310022
STAT,1857,29,35-39,1886,8.805056262926774
STAT,1851,29,na,1880,1979.8284927934162
SIM,1954,49,40-44,2003,1
STAT,1978,31,40-44,2009,6.286116398162961
STAT,1852,22,30-34,1874,19.95008206239705
STAT,1985,20,30-34,2005,47.36413772309544
STAT,1932,22,50-100,1954,0.9965870717888764
STAT,1861,45,35-39,1906,0.13565609444090754
STAT,1901,29,45-49,1930,1.7819581610356274
STAT,1848,24,30-34,1872,22.714666998343375
STAT,1827,50,45-49,1877,0.018457249003508213
STAT,1851,50,20-24,1901,5.935753422896307E-4
STAT,1945,37,30-34,1982,2.3671370786307477
STAT,1961,1,na,1962,5870.886645658632
STAT,1871,48,30-34,1919,0.10974217144494088
STAT,1835,52,30-34,1887,0.0037856658726653906
SIM,1860,22,30-34,1882,23
SIM,1898,35,25-29,1933,5
STAT,1929,17,30-34,1946,17.95253965779536
SIM,1810,49,45-49,1859,1
SIM,1908,28,20-24,1936,17
SIM,1937,17,30-34,1954,17
STAT,1868,54,na,1922,2321.711730808307
STAT,1847,28,50-100,1875,0.5873684112960524
SIM,1888,16,25-29,1904,23
STAT,1908,22,40-44,1930,3.571838401323191
STAT,1826,53,35-39,1879,0.005867536680032173
SIM,1940,22,50-100,1962,1
SIM,1951,20,35-39,1971,33
STAT,1872,47,30-34,1919,0.11164910182407603
STAT,1858,42,25-29,1900,0.5774132196715257
STAT,1939,3,na,1942,4677.213834555811
SIM,1865,29,35-39,1894,28
STAT,1907,25,30-34,1932,43.04831422600528
SIM,1948,36,45-49,1984,3
SIM,1872,62,na,1934,2236
SIM,1887,61,na,1948,3047
STAT,1817,85,na,1902,189.52561140787117
STAT,1858,39,na,1897,2099.7058002786634
STAT,1873,17,20-24,1890,20.892894356639424
STAT,1989,21,45-49,2010,1.866659399670558
SIM,1824,31,30-34,1855,33
SIM,1834,35,35-39,1869,11
SIM,1829,31,45-49,1860,6
SIM,1984,6,na,1990,6306
SIM,1881,17,20-24,1898,33
STAT,1934,35,35-39,1969,3.8605607921301237
STAT,1943,20,35-39,1963,11.57021738607616
STAT,1837,22,35-39,1859,5.531685530563273
SIM,1845,22,35-39,1867,11
SIM,1915,94,na,2009,179
SIM,1973,26,30-34,1999,67
STAT,1883,37,35-39,1920,7.985981068801843
STAT,1826,35,35-39,1861,5.957762697519352
SIM,1888,34,25-29,1922,2
STAT,1956,27,35-39,1983,23.02592368425491
SIM,1820,49,na,1869,1799
STAT,1853,55,na,1908,2058.654892303606
STAT,1918,44,45-49,1962,0.20348705098551667
SIM,1891,37,35-39,1928,13
SIM,1964,27,35-39,1991,60
SIM,1864,100,na,1964,3
SIM,1866,42,25-29,1908,1
STAT,1881,33,15-19,1914,0.15784917961734818
SIM,1942,35,35-39,1977,5
STAT,1965,26,30-34,1991,56.72221601373577
SIM,1829,70,na,1899,811
STAT,1871,80,na,1951,710.2267102222913
SIM,1806,82,na,1888,168
SIM,1807,67,na,1874,869
STAT,1884,48,40-44,1932,0.19275306460804706
SIM,1823,82,na,1905,469
STAT,1908,107,na,2015,0.6815739202738412
STAT,1928,49,30-34,1977,0.1304948296778504
STAT,1905,94,na,1999,256.958415451525
STAT,1923,45,30-34,1968,0.12087161266955708
SIM,1974,23,40-44,1997,15
STAT,1822,52,20-24,1874,0.0013423275080783402
SIM,1847,36,na,1883,2565
STAT,1852,40,30-34,1892,1.094859823652116
STAT,1914,42,50-100,1956,0.13440567466821624
STAT,1931,36,25-29,1967,1.5065601175212435
STAT,1908,24,50-100,1932,0.6946141546738538
STAT,1934,20,na,1954,5684.915393242598
STAT,1946,48,na,1994,4877.610863351444
SIM,1978,1,na,1979,6045
STAT,1985,24,50-100,2009,1.0828591414199584
STAT,1964,48,50-100,2012,0.3410058385811573
STAT,1972,39,40-44,2011,2.274012368231422
STAT,1850,28,40-44,1878,3.6029264709329296
SIM,1938,37,35-39,1975,3
SIM,1892,48,40-44,1940,1
STAT,1875,46,40-44,1921,0.20475201851164526
STAT,1908,45,35-39,1953,0.13671415368665146
STAT,1880,54,na,1934,2561.414552053391
STAT,1844,49,15-19,1893,3.275832262615299E-4
STAT,1875,39,na,1914,2781.4489176019642
SIM,1952,39,50-100,1991,1
SIM,1883,28,40-44,1911,4
SIM,1839,39,35-39,1878,12
SIM,1863,51,na,1914,2178
STAT,1939,39,35-39,1978,2.8736392862489106
SIM,1870,42,45-49,1912,3
STAT,1939,20,15-19,1959,6.176321101659318
SIM,1881,17,na,1898,2075
STAT,1908,27,35-39,1935,16.539143376933975
SIM,1947,39,35-39,1986,1
STAT,1908,68,na,1976,3158.026349536413
STAT,1861,38,50-100,1899,1.1720628657175922
SIM,1916,24,50-100,1940,1
STAT,1829,31,40-44,1860,5.844196728963608
STAT,1927,38,25-29,1965,1.4110043974752957
SIM,1832,22,25-29,1854,4
SIM,1935,38,25-29,1973,3
STAT,1966,23,40-44,1989,4.860998261789059
SIM,1862,43,50-100,1905,6
STAT,1887,100,na,1987,22.72736704367348
SIM,1916,27,35-39,1943,1
STAT,1990,24,20-24,2014,184.2543726769883
STAT,1905,46,25-29,1951,0.05442485575900003
SIM,1916,45,35-39,1961,1
STAT,1887,64,na,1951,2248.258941182005
STAT,1900,42,25-29,1942,0.07132085970262855
STAT,1954,37,na,1991,5529.75144864506
SIM,1855,21,45-49,1876,1
STAT,1909,13,na,1922,4467.570217055683
SIM,1927,47,30-34,1974,1
SIM,1863,21,40-44,1884,8
STAT,1809,59,na,1868,1186.6407315545596
SIM,1934,36,20-24,1970,1
STAT,1822,34,20-24,1856,7.753968903034051
STAT,1822,63,na,1885,1512.9369441364795
STAT,1921,19,15-19,1940,59.35786742179242
SIM,1903,24,20-24,1927,12
SIM,1947,20,15-19,1967,10
SIM,1902,58,na,1960,3481
STAT,1881,17,50-100,1898,0.05453428594124699
SIM,1961,28,25-29,1989,190
SIM,1878,28,na,1906,2947
STAT,1847,21,45-49,1868,0.6625236325083081
SIM,1946,45,na,1991,4590
STAT,1940,20,na,1960,4297.470846569847
STAT,1955,40,15-19,1995,0.002451781680761898
STAT,1953,28,25-29,1981,92.24156071296093
STAT,1803,93,na,1896,10.186206319440641
SIM,1812,82,na,1894,59
STAT,1875,28,40-44,1903,3.55992059608858
STAT,1921,32,20-24,1953,3.1314001165220495
SIM,1821,56,na,1877,1204
STAT,1815,50,50-100,1865,0.03083810060993772
STAT,1855,21,40-44,1876,2.086405431175856
STAT,1928,48,50-100,1976,0.33211642659794066
SIM,1934,18,20-24,1952,3
STAT,1903,39,50-100,1942,0.4312127436942128
STAT,1886,18,45-49,1904,0.0793094768053236
SIM,1957,24,50-100,1981,3
SIM,1884,28,na,1912,2750
SIM,1952,45,na,1997,4642
SIM,1990,24,25-29,2014,160
SIM,1957,7,na,1964,6328
STAT,1973,36,20-24,2009,0.40571876685623537
STAT,1916,2,na,1918,4991.76113389064
STAT,1889,25,50-100,1914,0.9161805183322477
STAT,1953,46,25-29,1999,0.0772191853042505
STAT,1919,47,30-34,1966,0.11155935279934638
STAT,1926,18,20-24,1944,191.28623058374765
STAT,1984,27,50-100,2011,1.6384925443892997
STAT,1951,49,45-49,2000,0.3088464506532051
SIM,1800,57,na,1857,1407
STAT,1914,68,na,1982,3460.432375648469
SIM,1967,33,35-39,2000,14
SIM,1954,29,30-34,1983,3
SIM,1834,94,na,1928,21
STAT,1948,42,35-39,1990,0.27637318985582016
STAT,1883,50,50-100,1933,0.017297448085345057
STAT,1884,21,50-100,1905,0.4663749709112063
STAT,1913,29,35-39,1942,17.14978263891925
STAT,1939,42,25-29,1981,0.08576190776755874
STAT,1941,23,40-44,1964,4.009677704449499
SIM,1836,42,45-49,1878,6
SIM,1876,24,na,1900,2454
STAT,1969,16,20-24,1985,195.50414757942457
SIM,1857,16,30-34,1873,3
STAT,1878,46,20-24,1924,0.014500520375983006
STAT,1850,53,40-44,1903,0.010663637037007002
SIM,1994,16,na,2010,5765
SIM,1834,29,40-44,1863,8
STAT,1870,24,40-44,1894,2.3559580989420237
STAT,1855,43,15-19,1898,0.011665837855859056
SIM,1919,15,20-24,1934,49
SIM,1827,42,35-39,1869,7
STAT,1798,70,na,1868,605.1212828683058
STAT,1904,29,25-29,1933,69.60168932191914
STAT,1819,42,35-39,1861,3.8073540249219966
SIM,1860,43,35-39,1903,2
STAT,1932,23,30-34,1955,43.3964080362934
STAT,1938,41,50-100,1979,0.13925497329128508
SIM,1814,42,25-29,1856,3
SIM,1899,22,30-34,1921,46
SIM,1865,86,na,1951,194
STAT,1900,104,na,2004,4.344467840241993
SIM,1921,29,35-39,1950,33
STAT,1923,45,na,1968,4981.249042155009
STAT,1929,39,40-44,1968,2.2133243618405296
STAT,1832,33,50-100,1865,0.8227520230094385
STAT,1828,42,45-49,1870,1.43974097182514
STAT,1874,17,35-39,1891,0.6482709011352858
STAT,1949,54,na,2003,4994.995388239746
STAT,1961,41,40-44,2002,0.3881267761531121
SIM,1882,17,35-39,1899,2
SIM,1903,65,na,1968,2922
STAT,1953,47,20-24,2000,0.016047434441213197
SIM,1929,74,na,2003,3349
STAT,1921,37,15-19,1958,0.024736027347523677
SIM,1783,77,na,1860,587
SIM,1977,16,20-24,1993,214
SIM,1829,48,na,1877,1606
STAT,1929,36,na,1965,5579.428468564468
SIM,1873,81,na,1954,702
STAT,1918,0,na,1918,5657.753246761333
SIM,1832,24,15-19,1856,4
STAT,1841,36,na,1877,2267.00877495679
STAT,1821,81,na,1902,330.72707549317937
STAT,1956,32,15-19,1988,0.20002816918437158
STAT,1931,40,na,1971,5742.982122028329
SIM,1950,51,na,2001,4598
STAT,1920,3,na,1923,5249.431672469952
SIM,1853,32,35-39,1885,15
STAT,1930,19,25-29,1949,64.31784255784005
SIM,1937,39,40-44,1976,2
SIM,1879,72,na,1951,1491
STAT,1949,16,35-39,1965,5.633520168980979
SIM,1935,16,15-19,1951,73
SIM,1950,45,35-39,1995,1
STAT,1892,20,15-19,1912,4.800293042257182
SIM,1924,33,na,1957,4942
STAT,1886,40,40-44,1926,2.765696655152679
STAT,1866,49,35-39,1915,0.14662594054715414
SIM,1915,31,25-29,1946,14
STAT,1929,31,45-49,1960,2.308142734623859
STAT,1950,18,50-100,1968,0.5110707921203962
STAT,1839,42,20-24,1881,0.13274223523105752
STAT,1851,48,45-49,1899,0.18479527381664315
STAT,1838,53,25-29,1891,0.0030194353878723957
STAT,1937,31,na,1968,4323.039519876158
STAT,1973,42,15-19,2015,0.0023820068754837028
STAT,1980,29,20-24,2009,29.341655853103443
SIM,1844,45,50-100,1889,1
SIM,1911,60,na,1971,4272
STAT,1949,50,na,1999,5082.608466921166
STAT,1875,54,25-29,1929,0.004108025945805489
SIM,1894,40,40-44,1934,2
STAT,1849,16,30-34,1865,1.5296365489452919
STAT,1848,27,35-39,1875,12.239253525026125
STAT,1946,29,30-34,1975,50.32006070879667
STAT,1978,34,45-49,2012,2.522964859978382
STAT,1927,16,15-19,1943,65.26693698211582
STAT,1864,40,20-24,1904,0.16529881388300277
SIM,1937,31,45-49,1968,1
SIM,1929,37,25-29,1966,1
STAT,1962,47,30-34,2009,0.1371105356943657
STAT,1913,21,na,1934,4282.672443512995
SIM,1940,23,30-34,1963,98
STAT,1868,35,40-44,1903,4.899728942248425
STAT,1852,73,na,1925,1119.8291605050783
SIM,1876,35,40-44,1911,13
STAT,1963,39,30-34,2002,2.7471481371856714
STAT,1852,19,40-44,1871,0.20611418319444114
STAT,1942,45,35-39,1987,0.16252433788597298
SIM,1979,29,20-24,2008,3
STAT,1845,32,35-39,1877,8.113971627370603
STAT,1812,79,na,1891,306.93051957495294
STAT,1898,27,50-100,1925,0.997715633616601
STAT,1809,81,na,1890,251.33638361559474
SIM,1926,68,na,1994,4853
SIM,1932,21,15-19,1953,11
STAT,1959,27,15-19,1986,1.0702960493281495
STAT,1879,38,20-24,1917,0.9242801811444947
STAT,1889,18,25-29,1907,8.040193104531642
STAT,1890,49,40-44,1939,0.13333353101905848
STAT,1892,107,na,1999,0.5099943873192825
STAT,1923,18,40-44,1941,1.8897730166582012
STAT,1864,51,45-49,1915,0.015025744950935258
STAT,1905,26,na,1931,3999.9428444099913
SIM,1880,28,25-29,1908,73
STAT,1827,78,na,1905,634.5362219761954
STAT,1882,5,na,1887,3000.5340533960775
SIM,1905,33,20-24,1938,1
STAT,1942,18,na,1960,4438.41370048469
STAT,1776,103,na,1879,0.07673899566580708
STAT,1823,32,15-19,1855,0.39347633812576416
STAT,1947,59,na,2006,4671.1907260569005
SIM,1905,60,na,1965,3509
STAT,1889,22,na,1911,3364.4454675064503
STAT,1947,43,50-100,1990,0.15845996448146532
STAT,1909,20,35-39,1929,10.170992628593849
STAT,1964,34,30-34,1998,23.31282509706598
STAT,1818,44,40-44,1862,2.846386293718091
STAT,1878,84,na,1962,629.0777906406248
STAT,1972,19,30-34,1991,17.99819375962968
SIM,1908,38,50-100,1946,1
STAT,1949,48,50-100,1997,0.31488269046300366
SIM,1823,51,na,1874,1966
STAT,1848,42,30-34,1890,1.2200504176661038
SIM,1967,27,15-19,1994,1
SIM,1979,16,50-100,1995,1
STAT,1872,28,25-29,1900,48.8464330312032
STAT,1858,21,20-24,1879,71.69803617101432
SIM,1920,77,na,1997,2083
STAT,1818,47,50-100,1865,0.30313078606590094
STAT,1851,51,35-39,1902,0.006859603727797277
SIM,1873,1,na,1874,4057
SIM,1897,18,25-29,1915,22
STAT,1907,31,25-29,1938,10.027115263055654
STAT,1970,24,45-49,1994,1.6297215309938928
SIM,1913,46,50-100,1959,3
SIM,1866,21,20-24,1887,148
STAT,1815,81,na,1896,300.0602943486178
STAT,1910,72,na,1982,2932.3900017851665
SIM,1886,54,na,1940,1776
STAT,1820,48,15-19,1868,4.028437080896438E-4
SIM,1800,94,na,1894,11
STAT,1839,45,25-29,1884,0.047749641084389144
STAT,1811,52,45-49,1863,0.04319278667363317
STAT,1921,37,50-100,1958,0.5408194386523874
STAT,1910,101,na,2011,24.046544528108598
SIM,1856,42,30-34,1898,2
STAT,1823,103,na,1926,0.08127081052599486
SIM,1862,32,45-49,1894,4
SIM,1952,34,45-49,1986,6
SIM,1877,19,20-24,1896,19
STAT,1947,27,25-29,1974,85.93336451896224
SIM,1917,20,35-39,1937,2
STAT,1835,36,na,1871,1667.4438839956485
SIM,1980,19,30-34,1999,2
STAT,1890,41,45-49,1931,2.1199918004526013
STAT,1870,39,15-19,1909,0.06324539480667161
STAT,1890,30,20-24,1920,3.8422762232643004
STAT,1911,26,na,1937,4234.158578327754
SIM,1955,27,25-29,1982,14
STAT,1958,16,45-49,1974,0.7573845709594696
STAT,1879,44,15-19,1923,0.016416481723275405
STAT,1869,19,20-24,1888,19.85198377611348
SIM,1896,78,na,1974,1975
SIM,1791,72,na,1863,555
SIM,1905,28,40-44,1933,6
STAT,1944,34,45-49,1978,1.989554971775236
STAT,1963,45,25-29,2008,0.08127654215243071
STAT,1895,90,na,1985,502.50068590067326
STAT,1863,28,15-19,1891,0.45622426106599157
STAT,1863,19,50-100,1882,0.05073344958573637
STAT,1894,25,40-44,1919,4.474186285980154
SIM,1916,9,na,1925,4870
SIM,1877,33,35-39,1910,20
STAT,1962,32,na,1994,5700.507878754374
STAT,1891,22,20-24,1913,98.29114284320555
STAT,1889,49,50-100,1938,0.19296621176484408
STAT,1971,37,50-100,2008,0.6322493113532279
STAT,1840,50,45-49,1890,0.011809179378522482
STAT,1854,32,45-49,1886,1.4548689316087557
SIM,1920,20,40-44,1940,7
SIM,1785,72,na,1857,609
SIM,1912,29,25-29,1941,138
STAT,1933,21,25-29,1954,141.88752838835728
STAT,1916,29,50-100,1945,1.1793268252024132
SIM,1854,43,na,1897,2470
STAT,1858,16,40-44,1874,0.19349032942533473
SIM,1946,44,30-34,1990,1
SIM,1956,42,35-39,1998,3
SIM,1852,34,40-44,1886,3
STAT,1923,23,20-24,1946,148.79401957586097
STAT,1968,23,na,1991,5279.4022438044085
SIM,1866,16,40-44,1882,1
STAT,1900,15,35-39,1915,0.8827609623043913
SIM,1931,23,20-24,1954,322
STAT,1884,51,30-34,1935,0.006819696131110656
STAT,1844,34,40-44,1878,4.248524507185234
SIM,1983,26,45-49,2009,4
STAT,1810,44,na,1854,1698.9621808978914
STAT,1936,18,na,1954,4058.552264970058
SIM,1899,25,35-39,1924,24
SIM,1941,21,25-29,1962,3
SIM,1892,54,na,1946,3433
STAT,1975,26,45-49,2001,2.64279300283001
STAT,1912,20,40-44,1932,3.7445056174259244
STAT,1938,44,30-34,1982,0.15082046605031507
SIM,1955,25,na,1980,6311
STAT,1869,33,35-39,1902,11.270330781964871
STAT,1969,19,25-29,1988,62.431385079588075
SIM,1866,19,45-49,1885,1
STAT,1878,49,25-29,1927,0.06795630699430176
STAT,1938,13,na,1951,4505.868474535716
STAT,1836,110,na,1946,2.5148639305484983E-4
STAT,1878,33,45-49,1911,2.0923610621612463
SIM,1921,26,30-34,1947,124
SIM,1886,33,45-49,1919,1
STAT,1843,16,50-100,1859,0.06319212804691765
STAT,1898,33,na,1931,3706.1760563903613
STAT,1897,57,na,1954,3101.129560534403
SIM,1984,20,20-24,2004,2
STAT,1920,42,50-100,1962,0.14967231387191582
STAT,1939,19,45-49,1958,0.5769073018675469
SIM,1928,45,25-29,1973,1
STAT,1836,89,na,1925,95.60582681339378
STAT,1913,26,30-34,1939,45.23462425493974
SIM,1845,32,na,1877,2256
SIM,1900,23,na,1923,3266
STAT,1858,19,45-49,1877,0.0678897883211941
STAT,1864,43,25-29,1907,0.6569252950841473
SIM,1974,26,35-39,2000,5
SIM,1975,21,35-39,1996,16
STAT,1836,27,45-49,1863,1.3079609869816757
SIM,1949,25,na,1974,5458
SIM,1867,16,na,1883,2663
SIM,1860,36,50-100,1896,2
STAT,1852,36,50-100,1888,1.1759608745788812
STAT,1932,26,35-39,1958,22.70967483429755
SIM,1860,40,30-34,1900,3
SIM,1871,45,50-100,1916,1
SIM,1948,49,na,1997,4307
STAT,1766,99,na,1865,0.838372799362014
SIM,1940,26,35-39,1966,49
SIM,1949,31,35-39,1980,3
STAT,1817,53,25-29,1870,0.009539069665438897
STAT,1860,50,30-34,1910,0.005616079877962376
SIM,1958,19,20-24,1977,391
STAT,1886,43,45-49,1929,1.808715942222022
STAT,1929,44,20-24,1973,0.02630735173892466
SIM,1882,24,na,1906,3086
STAT,1853,92,na,1945,41.46694733380178
SIM,1829,37,20-24,1866,2
SIM,1957,20,na,1977,6303
SIM,1872,43,25-29,1915,2
STAT,1887,32,40-44,1919,5.608775251498794
STAT,1822,37,25-29,1859,7.005035986071477
STAT,1862,17,45-49,1879,0.0728636903264905
STAT,1920,39,20-24,1959,0.33223182053321737
STAT,1982,18,30-34,2000,19.787346894140267
STAT,1859,46,na,1905,2074.161482745007
SIM,1990,18,30-34,2008,22
STAT,1809,45,45-49,1854,0.605211671133346
STAT,1802,52,35-39,1854,0.034342407746268525
SIM,1878,39,25-29,1917,9
SIM,1838,59,na,1897,1385
STAT,1895,23,35-39,1918,8.738924354282526
SIM,1968,19,15-19,1987,107
STAT,1916,63,na,1979,3907.2572878150654
SIM,1935,74,na,2009,4324
SIM,1907,27,na,1934,4629
STAT,1861,50,na,1911,2095.4505432646192
STAT,1912,35,50-100,1947,0.47785915029723675
STAT,1857,21,50-100,1878,0.42619369564033843
STAT,1906,36,35-39,1942,2.581483225404165
SIM,1894,43,45-49,1937,1
STAT,1992,21,15-19,2013,8.849834559746029
STAT,1955,46,50-100,2001,0.36131903819712724
SIM,1895,32,40-44,1927,14
STAT,1925,78,na,2003,2951.1286796748223
SIM,1817,51,na,1868,1416
SIM,1963,46,50-100,2009,1
STAT,1870,27,45-49,1897,1.2632187175545009
STAT,1903,90,na,1993,584.8623755678831
SIM,1915,22,na,1937,4893
SIM,1971,39,30-34,2010,4
STAT,1923,48,35-39,1971,0.17351168770640946
STAT,1903,49,30-34,1952,0.08788156809043954
STAT,1837,38,15-19,1875,0.0489965775170504
STAT,1885,60,na,1945,2195.3721835569318
STAT,1838,50,20-24,1888,6.616042402476438E-4
SIM,1996,11,na,2007,6941
SIM,1810,52,35-39,1862,1
STAT,1924,21,15-19,1945,7.268784222519443
SIM,1834,33,50-100,1867,1
STAT,1847,92,na,1939,32.047322723493565
STAT,1914,18,30-34,1932,2.9035140166646727
SIM,1875,21,30-34,1896,2
SIM,1971,25,15-19,1996,1
STAT,1856,35,15-19,1891,0.04991079288719774
SIM,1885,41,45-49,1926,3
STAT,1835,35,45-49,1870,1.5709192697672354
STAT,1858,24,25-29,1882,53.04011236751017
STAT,1830,31,45-49,1861,1.9243788984636334
SIM,1847,67,na,1914,1761
SIM,1818,37,45-49,1855,1
STAT,1888,38,30-34,1926,7.194109188360172
STAT,1950,13,na,1963,5359.2202351680235
SIM,1924,30,20-24,1954,6
SIM,1910,43,40-44,1953,1
STAT,1898,18,35-39,1916,0.853568631187859
SIM,1959,20,40-44,1979,5
SIM,1896,38,30-34,1934,7
STAT,1958,26,50-100,1984,1.5158908214863394
SIM,1876,30,50-100,1906,1
STAT,1849,22,na,1871,2003.598402849087
STAT,1882,23,25-29,1905,64.32872027357185
SIM,1942,52,na,1994,4800
STAT,1867,21,30-34,1888,19.41096481213082
SIM,1914,2,na,1916,4489
SIM,1948,16,25-29,1964,118
SIM,1936,52,na,1988,3833
STAT,1842,48,35-39,1890,0.10637985752504078
STAT,1899,15,15-19,1914,9.426537289276427
STAT,1910,48,25-29,1958,0.057015598579351706
STAT,1844,37,45-49,1881,1.7619806246270255
SIM,1923,33,40-44,1956,13
STAT,1849,22,25-29,1871,53.643761229613645
STAT,1878,42,50-100,1920,1.271410331212678
STAT,1874,32,30-34,1906,20.627734880388005
STAT,1818,47,45-49,1865,0.29128202617688637
STAT,1907,47,40-44,1954,0.163210750085637
SIM,1822,75,na,1897,535
STAT,1891,25,25-29,1916,60.7446199865825
STAT,1874,23,na,1897,2785.5461246058026
SIM,1849,30,50-100,1879,4
STAT,1916,30,20-24,1946,2.9298454586896767
STAT,1954,32,50-100,1986,1.202352089539771
STAT,1955,34,20-24,1989,3.804125201996054
SIM,1801,76,na,1877,419
STAT,1947,47,45-49,1994,0.2938752506408167
STAT,1992,16,35-39,2008,6.9527995311792115
STAT,1900,88,na,1988,768.1990044988004
STAT,1840,17,25-29,1857,5.885648560972797
STAT,1882,58,na,1940,2229.177545898566
SIM,1869,42,na,1911,1888
STAT,1851,45,40-44,1896,0.13711419063452673
STAT,1823,31,50-100,1854,2.8102840541872687
SIM,1882,32,30-34,1914,44
STAT,1910,34,35-39,1944,10.092076731074084
SIM,1983,23,40-44,2006,7
SIM,1955,24,20-24,1979,326
STAT,1915,33,40-44,1948,4.580947140765595
STAT,1967,21,35-39,1988,13.623029079963615
STAT,1992,15,na,2007,6100.355647171626
STAT,1865,35,25-29,1900,3.0264537352954397
STAT,1965,32,25-29,1997,13.573736392214343
SIM,1857,22,25-29,1879,127
SIM,1913,99,na,2012,352
STAT,1832,26,30-34,1858,24.370301447695997
STAT,1957,41,30-34,1998,0.20244949293424894
STAT,1944,13,na,1957,4877.875959066963
STAT,1910,30,50-100,1940,0.9283676800294846
SIM,1895,65,na,1960,2526
STAT,1839,19,40-44,1858,0.18751942986762588
SIM,1815,40,50-100,1855,1
SIM,1873,35,25-29,1908,9
STAT,1876,89,na,1965,297.04917153116685
STAT,1771,83,na,1854,155.0
SIM,1916,38,na,1954,4405
SIM,1844,27,45-49,1871,2
SIM,1970,33,40-44,2003,2
STAT,1866,46,30-34,1912,0.10383724759679792
STAT,1826,29,40-44,1855,5.186803963923433
SIM,1947,19,45-49,1966,1
SIM,1853,67,na,1920,1310
STAT,1912,23,45-49,1935,1.2417727228792903
SIM,1866,24,25-29,1890,5
SIM,1840,26,30-34,1866,25
SIM,1816,75,na,1891,726
STAT,1828,54,na,1882,1471.8504401852235
STAT,1847,47,40-44,1894,0.13111645016447668
STAT,1890,33,25-29,1923,14.382352526839762
STAT,1834,54,na,1888,1936.5260562866843
SIM,1830,33,na,1863,2106
STAT,1898,41,15-19,1939,0.00150247447978606
STAT,1951,45,45-49,1996,0.3121295765881395
STAT,1882,47,25-29,1929,0.06462488773727032
SIM,1920,23,45-49,1943,5
SIM,1851,32,na,1883,2814
STAT,1942,20,20-24,1962,134.6622426049173
SIM,1890,23,25-29,1913,95
STAT,1902,43,40-44,1945,0.2528549892960195
STAT,1894,33,50-100,1927,1.353550010236991
STAT,1955,29,40-44,1984,7.1645427273005655
SIM,1849,31,30-34,1880,31
SIM,1889,96,na,1985,308
SIM,1777,77,na,1854,423
STAT,1865,54,30-34,1919,0.00602768385909341
STAT,1896,29,25-29,1925,64.01862103830776
STAT,1941,47,40-44,1988,0.19498520447494508
STAT,1862,104,na,1966,0.4067167145934303
STAT,1986,19,45-49,2005,0.8208914228551607
SIM,1880,25,20-24,1905,18
SIM,1950,20,20-24,1970,153
SIM,1847,19,40-44,1866,1
STAT,1865,32,20-24,1897,2.8145763280576936
STAT,1967,15,40-44,1982,2.0174114696672434
STAT,1874,28,50-100,1902,0.7531025200210789
SIM,1856,78,na,1934,660
SIM,1886,30,40-44,1916,14
STAT,1872,25,20-24,1897,13.686660732274314
STAT,1836,80,na,1916,562.9645612920152
STAT,1914,37,na,1951,4337.056272540495
SIM,1831,29,25-29,1860,10
SIM,1978,23,na,2001,5588
STAT,1836,24,40-44,1860,2.4678686685275664
SIM,1913,27,na,1940,4857
STAT,1958,15,30-34,1973,18.484808490745166
STAT,1937,41,45-49,1978,0.1941189553465388
STAT,1919,8,na,1927,5085.284269537279
STAT,1943,40,25-29,1983,0.09107911564817796
STAT,1882,89,na,1971,360.961955494499
STAT,1905,38,40-44,1943,1.5703687150702632
SIM,1877,30,30-34,1907,6
STAT,1934,15,45-49,1949,0.7837763944871431
STAT,1973,42,na,2015,5760.68889561529
SIM,1989,24,20-24,2013,3
STAT,1874,54,40-44,1928,0.012095829398712668
SIM,1939,32,na,1971,4860
STAT,1896,72,na,1968,2332.9634466411126
STAT,1880,53,20-24,1933,8.881603538540468E-4
STAT,1852,42,na,1894,2176.385102633976
STAT,1929,19,50-100,1948,0.5488604581204871
STAT,1825,43,na,1868,1908.0578048340224
STAT,1911,37,20-24,1948,0.29408521546264027
STAT,1924,41,35-39,1965,0.27673854789466906
STAT,1947,24,20-24,1971,144.92744593244015
SIM,1933,41,na,1974,6401
STAT,1919,25,20-24,1944,22.91052021239869
STAT,1945,29,na,1974,4738.3346109973
SIM,1921,22,na,1943,5488
STAT,1900,37,45-49,1937,0.6890258573086754
STAT,1890,84,na,1974,999.8847403646148
STAT,1881,27,20-24,1908,13.058619841295672
STAT,1832,48,40-44,1880,0.13873455232380547
SIM,1876,92,na,1968,46
STAT,1915,41,25-29,1956,0.08310241645181701
STAT,1966,48,45-49,2014,0.324950254454727
SIM,1889,44,50-100,1933,3
STAT,1806,50,45-49,1856,0.053175768244148706
SIM,1829,25,50-100,1854,1
SIM,1913,30,45-49,1943,3
STAT,1890,27,30-34,1917,35.50950550831443
STAT,1927,73,na,2000,3811.3839476501553
STAT,1959,12,na,1971,5929.8393643523805
SIM,1902,89,na,1991,248
STAT,1963,42,20-24,2005,0.026908852867448846
SIM,1966,15,30-34,1981,18
STAT,1934,51,na,1985,5834.582317416831
SIM,1884,26,35-39,1910,27
STAT,1883,40,25-29,1923,0.7323706151577359
STAT,1861,25,45-49,1886,1.0885474039691942
SIM,1829,79,na,1908,213
STAT,1931,28,40-44,1959,6.9427940256239475
STAT,1929,47,25-29,1976,0.079351535335835
SIM,1887,30,na,1917,3727
STAT,1907,52,na,1959,3719.7301390178554
STAT,1860,53,35-39,1913,0.007878793682445344
STAT,1891,44,30-34,1935,1.6176585782041344
SIM,1975,37,40-44,2012,3
SIM,1845,41,40-44,1886,6
SIM,1927,25,20-24,1952,3
STAT,1910,31,30-34,1941,17.62136564349786
STAT,1865,52,50-100,1917,0.015642112948633574
SIM,1918,31,40-44,1949,3
STAT,1817,50,20-24,1867,0.0021095657294077025
STAT,1836,45,50-100,1881,0.24006875194117525
STAT,1888,41,20-24,1929,0.21641654762221985
SIM,1832,41,30-34,1873,3
SIM,1958,6,na,1964,6233
STAT,1878,30,40-44,1908,5.267554374558431
STAT,1897,46,25-29,1943,0.05028061616496456
SIM,1900,30,35-39,1930,34
STAT,1971,41,35-39,2012,0.30631963738622664
STAT,1847,33,15-19,1880,0.12732740466751408
STAT,1941,6,na,1947,4738.078276076843
STAT,1963,47,15-19,2010,5.61775925313397E-4
SIM,1949,25,40-44,1974,23
STAT,1877,41,45-49,1918,1.8047634479708918
SIM,1913,24,15-19,1937,7
STAT,1948,41,20-24,1989,0.02427359446215864
STAT,1841,53,50-100,1894,0.01321210964459855
STAT,1870,30,na,1900,2736.7870669730687
SIM,1867,36,45-49,1903,7
STAT,1905,24,15-19,1929,5.475937205408398
SIM,1898,27,40-44,1925,3
SIM,1945,41,45-49,1986,1
SIM,1966,35,na,2001,5837
STAT,1882,20,20-24,1902,78.14267517770683
SIM,1872,37,30-34,1909,14
SIM,1914,36,35-39,1950,5
STAT,1926,25,na,1951,5216.636632855664
STAT,1863,34,45-49,1897,1.744642770712091
STAT,1882,25,15-19,1907,0.5148899519733053
STAT,1801,54,40-44,1855,0.04019755102775344
STAT,1856,49,40-44,1905,0.1475857280795269
STAT,1932,48,45-49,1980,0.3393778433798737
STAT,1955,37,25-29,1992,1.5540565606025283
STAT,1839,23,50-100,1862,0.4125447050990978
SIM,1881,37,40-44,1918,1
STAT,1951,42,40-44,1993,0.35721685862042774
SIM,1960,44,na,2004,6156
SIM,1973,28,40-44,2001,15
STAT,1931,49,50-100,1980,0.34704328632987325
STAT,1922,63,na,1985,4373.966590616221
STAT,1863,85,na,1948,276.6318391378983
STAT,1903,15,50-100,1918,0.08090589556122244
SIM,1929,34,20-24,1963,4
STAT,1921,19,na,1940,4814.148653440281
SIM,1983,31,25-29,2014,7
STAT,1815,41,20-24,1856,0.36661655866884213
SIM,1869,11,na,1880,2333
STAT,1942,42,30-34,1984,0.16026150200719053
STAT,1947,24,na,1971,4759.631900418679
STAT,1864,37,30-34,1901,5.491818536280011
STAT,1950,31,35-39,1981,12.718052717410375
STAT,1896,26,20-24,1922,17.94345476183184
SIM,1838,50,na,1888,1531
STAT,1978,16,na,1994,5798.705421582931
STAT,1931,20,45-49,1951,1.694548365964256
SIM,1864,49,40-44,1913,1
STAT,1811,46,15-19,1857,0.001268066628839403
STAT,1904,104,na,2008,4.6155229621630625
STAT,1819,43,na,1862,1873.8123125387795
STAT,1828,40,50-100,1868,1.0494666899556973
STAT,1972,25,25-29,1997,97.76183337479124
STAT,1946,35,25-29,1981,1.3006524211054475
SIM,1960,25,50-100,1985,3
STAT,1905,30,45-49,1935,2.9361581932768193
SIM,1976,28,na,2004,5767
STAT,1841,31,20-24,1872,2.946310655907327
STAT,1894,77,na,1971,1822.3616753827152
STAT,1900,20,15-19,1920,5.314431665810445
STAT,1975,31,25-29,2006,14.351862434645504
STAT,1832,34,15-19,1866,0.1264334526220441
STAT,1901,64,na,1965,3077.982455335685
STAT,1829,47,20-24,1876,0.012243570666715426
SIM,1959,17,15-19,1976,66
STAT,1849,53,na,1902,1642.0566435137753
SIM,1889,20,50-100,1909,1
STAT,1879,50,45-49,1929,0.017739038989517262
STAT,1882,39,40-44,1921,4.884724426141841
STAT,1953,24,na,1977,5111.480456921839
STAT,1923,20,50-100,1943,0.8884891161964029
STAT,1859,8,na,1867,2620.4710429552115
STAT,1850,31,30-34,1881,18.998691377331806
SIM,1940,26,na,1966,4679
STAT,1837,44,45-49,1881,1.1343045397358626
STAT,1799,86,na,1885,99.1162342268661
STAT,1961,44,45-49,2005,0.2570248075349085
SIM,1882,92,na,1974,442
STAT,1867,18,40-44,1885,0.2002840605631134
SIM,1869,42,40-44,1911,1
STAT,1855,37,20-24,1892,0.6559118821805358
SIM,1818,36,na,1854,2259
STAT,1832,40,45-49,1872,1.3053131048806437
STAT,1914,21,20-24,1935,126.24601879931747
STAT,1826,28,na,1854,1460.1542017440888
STAT,1874,40,15-19,1914,0.016480215171902443
STAT,1939,61,na,2000,4068.068835655114
SIM,1913,38,40-44,1951,2
SIM,1839,17,25-29,1856,16
STAT,1821,50,na,1871,1530.2896177214539
SIM,1922,21,20-24,1943,279
STAT,1845,23,50-100,1868,0.33868664372905294
STAT,1876,35,50-100,1911,1.4785813142891933
SIM,1881,48,na,1929,1791
STAT,1936,24,45-49,1960,1.2413245050595265
STAT,1768,94,na,1862,3.7957295349728843
SIM,1897,49,50-100,1946,1
STAT,1873,37,40-44,1910,5.158842642519742
SIM,1844,24,40-44,1868,4
STAT,1945,15,20-24,1960,171.005014152096
SIM,1928,23,15-19,1951,1
SIM,1898,6,na,1904,4220
SIM,1849,34,35-39,1883,24
SIM,1890,20,20-24,1910,106
STAT,1877,21,25-29,1898,68.92767617785985
STAT,1903,111,na,2014,0.021813372951145688
STAT,1957,17,na,1974,5600.520952029733
STAT,1941,31,25-29,1972,11.208200766940562
SIM,1863,20,na,1883,2338
SIM,1890,39,40-44,1929,15
STAT,1831,43,na,1874,1985.1494369963773
STAT,1846,42,na,1888,2418.243577016923
STAT,1941,33,na,1974,4580.855922700179
STAT,1769,113,na,1882,7.079882961434312E-4
STAT,1846,35,20-24,1881,0.8496396731602798
SIM,1840,40,45-49,1880,2
STAT,1884,84,na,1968,729.7018095186502
STAT,1842,51,25-29,1893,0.0027387095879991665
STAT,1888,46,15-19,1934,5.441700080961361E-4
SIM,1953,15,20-24,1968,360
STAT,1789,93,na,1882,5.7281340099029805
SIM,1818,40,35-39,1858,5
SIM,1944,34,50-100,1978,3
STAT,1937,27,30-34,1964,44.102529912854784
SIM,1918,33,na,1951,3937
SIM,1827,28,20-24,1855,2
STAT,1974,27,na,2001,5669.57627170327
SIM,1835,79,na,1914,780
STAT,1830,98,na,1928,2.0378646998029626
STAT,1880,23,na,1903,2884.0855359935426
STAT,1933,73,na,2006,4178.2458747025885
SIM,1953,18,25-29,1971,140
STAT,1980,35,15-19,2015,0.031750831225042506
SIM,1814,40,na,1854,1524
STAT,1900,34,40-44,1934,6.8851684147193115
SIM,1836,24,na,1860,1561
STAT,1945,18,25-29,1963,54.6134084777654
STAT,1849,19,35-39,1868,0.5173459235721614
STAT,1913,52,na,1965,4070.6807240574594
STAT,1872,96,na,1968,45.809056306689754
STAT,1815,50,na,1865,1623.8379843015691
STAT,1819,40,45-49,1859,3.359583614708234
STAT,1960,36,20-24,1996,0.40858196079141024
SIM,1831,26,20-24,1857,8
STAT,1892,42,25-29,1934,0.9276944322050221
STAT,1947,30,15-19,1977,0.17047116807026985
SIM,1844,30,35-39,1874,9
SIM,1849,28,40-44,1877,8
STAT,1845,97,na,1942,3.620111826959042
STAT,1923,26,25-29,1949,87.47702577062722
SIM,1845,44,45-49,1889,1
SIM,1897,91,na,1988,142
SIM,1945,27,30-34,1972,8
STAT,1991,18,40-44,2009,2.312570547748084
STAT,1867,41,na,1908,2501.602269290425
STAT,1883,42,15-19,1925,0.015573375063079478
STAT,1989,26,na,2015,6221.90796147897
SIM,1947,62,na,2009,5275
STAT,1941,25,30-34,1966,46.82956875559313
STAT,1888,44,25-29,1932,0.8593752474081298
SIM,1855,47,40-44,1902,1
STAT,1858,18,30-34,1876,1.666325830967226
SIM,1890,59,na,1949,2727
STAT,1836,30,35-39,1866,11.898309498675232
STAT,1963,17,30-34,1980,17.870752262121393
STAT,1875,51,20-24,1926,8.842499318843165E-4
STAT,1850,36,25-29,1886,3.042341761968585
STAT,1984,31,35-39,2015,15.276669498842807
SIM,1873,32,20-24,1905,1
SIM,1955,44,40-44,1999,2
STAT,1908,37,na,1945,4070.225369469426
STAT,1895,22,na,1917,3552.757036423545
STAT,1868,38,45-49,1906,2.1993503657574975
SIM,1988,16,na,2004,6172
STAT,1842,45,30-34,1887,0.07643616770337383
SIM,1903,34,na,1937,3776
STAT,1915,35,30-34,1950,2.145358627867233
STAT,1818,61,na,1879,944.7357555708409
SIM,1983,25,30-34,2008,152
SIM,1966,18,35-39,1984,8
STAT,1933,43,35-39,1976,0.3189248835153264
SIM,1876,38,45-49,1914,1
SIM,1866,18,30-34,1884,3
STAT,1891,47,35-39,1938,0.11211358570946979
SIM,1887,38,20-24,1925,1
STAT,1811,51,30-34,1862,0.018075305247362214
STAT,1947,44,40-44,1991,0.3367843236960725
STAT,1958,18,35-39,1976,6.358214925885692
STAT,1834,38,50-100,1872,1.3792603130126029
STAT,1897,43,20-24,1940,0.016895211640973237
SIM,1881,39,30-34,1920,2
STAT,1928,51,na,1979,5340.626417327301
STAT,1911,43,15-19,1954,0.001682797257653816
STAT,1866,52,25-29,1918,0.0037685866318879187
STAT,1968,46,20-24,2014,0.016610014689219417
SIM,1859,31,25-29,1890,23
SIM,1881,23,15-19,1904,6
STAT,1873,39,30-34,1912,6.21763933924008
SIM,1841,43,30-34,1884,2
STAT,1867,24,35-39,1891,6.248300388979292
STAT,1955,54,na,2009,5701.508045780491
STAT,1973,20,15-19,1993,7.976848940659492
SIM,1906,45,na,1951,3464
STAT,1890,19,50-100,1909,0.06871395213617847
STAT,1832,32,25-29,1864,9.302080159692736
STAT,1906,70,na,1976,2923.3724219925266
STAT,1859,33,40-44,1892,3.9699397692385774
STAT,1894,28,45-49,1922,1.6413801422832606
SIM,1925,15,na,1940,5602
SIM,1866,37,50-100,1903,2
SIM,1854,38,25-29,1892,6
STAT,1824,41,30-34,1865,1.6638115876974375
STAT,1824,46,25-29,1870,0.07928552581666447
STAT,1934,46,20-24,1980,0.01782166341234693
STAT,1920,45,15-19,1965,4.7193812950187107E-4
SIM,1884,59,na,1943,2216
STAT,1861,111,na,1972,0.0016734966820081516
STAT,1887,29,15-19,1916,0.5825900813947282
STAT,1857,50,25-29,1907,0.0032293486592331944
STAT,1975,25,30-34,2000,59.96426568628486
SIM,1967,13,na,1980,5779
STAT,1997,17,30-34,2014,20.540352177661436
STAT,1871,22,35-39,1893,6.699868518007941
STAT,1841,34,25-29,1875,10.821928632591407
STAT,1781,76,na,1857,268.643662284005
SIM,1914,33,30-34,1947,4
STAT,1847,100,na,1947,0.8168873953235838
STAT,1838,47,30-34,1885,0.0862799082270708
STAT,1845,18,20-24,1863,15.01034513139061
STAT,1880,22,45-49,1902,0.8529925033879459
STAT,1858,30,na,1888,2193.4449399069626
SIM,1840,32,25-29,1872,8
STAT,1844,16,na,1860,2455.058544258899
STAT,1796,75,na,1871,483.0281215262371
SIM,1820,40,na,1860,1960
SIM,1946,14,na,1960,4687
SIM,1910,16,na,1926,3908
STAT,1803,62,na,1865,938.9218372754535
STAT,1837,41,40-44,1878,1.9467300663778133
STAT,1881,6,na,1887,2957.4386508821503
STAT,1878,27,15-19,1905,0.5466913977179573
STAT,1936,21,40-44,1957,3.7132040454880775
STAT,1961,54,na,2015,5548.877642253389
SIM,1853,18,20-24,1871,19
STAT,1906,33,30-34,1939,16.800207630663046
SIM,1944,21,40-44,1965,9
STAT,1895,20,30-34,1915,26.917119070906743
STAT,1865,15,na,1880,2738.7599498365607
SIM,1927,28,25-29,1955,168
STAT,1982,22,50-100,2004,1.0720653691962414
STAT,1947,49,35-39,1996,0.1733109402049276
STAT,1905,22,50-100,1927,0.6811414228756654
STAT,1951,39,15-19,1990,0.027130293850298425
SIM,1905,36,25-29,1941,3
STAT,1862,20,35-39,1882,5.9024504528801796
STAT,1938,47,35-39,1985,0.1527417081875131
STAT,1807,53,30-34,1860,0.02290902044370022
SIM,1952,14,na,1966,4837
STAT,1963,31,45-49,1994,2.3530616477167654
SIM,1942,27,50-100,1969,2
STAT,1919,28,25-29,1947,81.76553895473081
STAT,1914,24,25-29,1938,108.27665515645371
SIM,1928,39,30-34,1967,5
STAT,1934,27,50-100,1961,1.5460218266952517
SIM,1973,13,na,1986,5489
SIM,1936,4,na,1940,4196
SIM,1893,26,45-49,1919,5
STAT,1900,37,50-100,1937,0.42435523033396116
SIM,1931,26,25-29,1957,194
SIM,1931,15,na,1946,5559
STAT,1918,36,50-100,1954,0.5130565153180693
SIM,1959,50,na,2009,5759
SIM,1871,34,45-49,1905,1
STAT,1866,96,na,1962,23.321643432735836
STAT,1846,38,25-29,1884,3.0761545991091723
SIM,1919,37,30-34,1956,2
STAT,1864,30,na,1894,2478.7195460029893
SIM,1883,74,na,1957,1121
STAT,1850,29,50-100,1879,0.7638683419985234
STAT,1885,26,45-49,1911,1.2824662406732896
STAT,1843,31,na,1874,2641.549921950943
STAT,1859,15,na,1874,2478.624944824448
STAT,1863,31,40-44,1894,4.394108709421539
STAT,1943,48,20-24,1991,0.014029442830843118
SIM,1878,59,na,1937,2333
STAT,1837,103,na,1940,0.1039232623435078
STAT,1940,51,na,1991,4421.97905881001
STAT,1838,16,na,1854,2641.921955294654
SIM,1899,58,na,1957,3308
SIM,1922,24,25-29,1946,242
SIM,1904,16,20-24,1920,25
SIM,1979,27,30-34,2006,86
STAT,1863,21,50-100,1884,0.42274158943395107
STAT,1887,95,na,1982,128.65496026359216
STAT,1896,40,35-39,1936,0.1936078890630986
STAT,1967,43,35-39,2010,0.30119609181098467
SIM,1808,49,50-100,1857,1
STAT,1851,97,na,1948,4.260160349790345
SIM,1919,81,na,2000,2239
STAT,1815,44,25-29,1859,1.3498171680691007
SIM,1882,28,50-100,1910,1
SIM,1900,32,25-29,1932,20
STAT,1891,95,na,1986,149.9141937397483
SIM,1870,46,na,1916,2947
STAT,1953,16,20-24,1969,189.32384650706547
STAT,1928,42,15-19,1970,0.002259253084649215
SIM,1952,18,20-24,1970,366
SIM,1956,34,40-44,1990,13
SIM,1940,39,35-39,1979,7
STAT,1973,15,35-39,1988,6.266256043260107
SIM,1838,33,45-49,1871,3
SIM,1823,68,na,1891,1175
SIM,1903,15,20-24,1918,59
STAT,1932,39,35-39,1971,3.743390335050657
STAT,1991,12,na,2003,6496.695263669753
SIM,1937,29,35-39,1966,1
STAT,1966,31,na,1997,5560.117155885766
STAT,1839,31,45-49,1870,1.7196283077624044
STAT,1937,48,25-29,1985,0.06166413179567166
STAT,1824,65,na,1889,1052.6671097467204
STAT,1910,97,na,2007,115.69928615082605
STAT,1957,32,40-44,1989,6.0694516137588
STAT,1932,19,na,1951,5595.880910153743
STAT,1894,28,na,1922,3528.038223462809
STAT,1890,14,na,1904,3629.858882876477
STAT,1902,41,40-44,1943,0.2558472818829554
SIM,1834,35,50-100,1869,1
SIM,1885,12,na,1897,3408
STAT,1918,28,20-24,1946,22.335083510420862
STAT,1902,96,na,1998,141.47896453253873
STAT,1932,31,25-29,1963,14.191179910835015
SIM,1917,25,50-100,1942,4
STAT,1972,41,na,2013,5711.257321878477
STAT,1942,19,50-100,1961,0.45161752579726994
STAT,1888,31,40-44,1919,5.90712142600084
SIM,1922,35,25-29,1957,4
SIM,1965,32,40-44,1997,2
SIM,1941,18,45-49,1959,1
SIM,1919,73,na,1992,3814
STAT,1941,37,35-39,1978,2.962838995194821
STAT,1933,18,45-49,1951,0.7700390968951215
STAT,1964,17,35-39,1981,6.099177343943078
STAT,1923,33,25-29,1956,12.215926504239004
STAT,1923,58,na,1981,4703.209727652428
SIM,1907,31,40-44,1938,8
STAT,1854,20,30-34,1874,17.298145241529653
STAT,1951,44,40-44,1995,0.35602831418583575
STAT,1988,20,35-39,2008,15.603487732441046
SIM,1931,33,25-29,1964,3
SIM,1950,46,40-44,1996,1
SIM,1981,15,35-39,1996,16
STAT,1845,27,na,1872,1774.3180126982056
SIM,1849,33,20-24,1882,6
SIM,1787,68,na,1855,1175
SIM,1896,31,40-44,1927,2
SIM,2007,2,na,2009,6960
STAT,1914,35,25-29,1949,1.1458331842908485
STAT,1964,49,40-44,2013,0.2369698892139332
STAT,1865,21,45-49,1886,0.7402314250752743
STAT,1922,17,30-34,1939,16.272200217251655
STAT,1919,44,15-19,1963,0.0019137142400691037
STAT,1947,25,35-39,1972,19.618412636681082
SIM,1925,83,na,2008,1971
STAT,1824,110,na,1934,1.70984522782388E-4
STAT,1896,19,na,1915,3829.1009197688118
SIM,1936,21,na,1957,4017
SIM,1928,34,na,1962,5586
STAT,1926,80,na,2006,2660.3959067908363
STAT,1954,32,15-19,1986,0.18687584750323008
SIM,1924,20,na,1944,4528
SIM,1965,34,na,1999,5556
STAT,1877,103,na,1980,3.642360413639776
STAT,1904,87,na,1991,937.1943772597509
STAT,1786,74,na,1860,746.441301688538
STAT,1948,34,40-44,1982,5.261297088527973
SIM,1961,20,na,1981,4920
STAT,1858,20,15-19,1878,3.4571980135460847
SIM,1930,17,30-34,1947,39
STAT,1944,18,20-24,1962,168.32897409717046
SIM,1832,72,na,1904,1023
STAT,1870,26,na,1896,2724.523082725041
STAT,1937,40,15-19,1977,0.001793563931149287
STAT,1873,66,na,1939,1931.5568235951368
SIM,1938,38,40-44,1976,1
SIM,1873,21,45-49,1894,1
STAT,1915,47,35-39,1962,0.1499578001607123
SIM,1870,48,50-100,1918,1
STAT,1980,18,30-34,1998,19.52124104017547
STAT,1857,16,15-19,1873,6.306477743409419
STAT,1875,57,na,1932,2396.6767211777747
STAT,1930,36,20-24,1966,0.39722465678044994
STAT,1955,44,25-29,1999,0.11331397631334444
STAT,1850,52,35-39,1902,0.008815381923193073
STAT,1860,39,20-24,1899,0.7097572034988835
SIM,1899,27,25-29,1926,157
STAT,1929,29,35-39,1958,21.6639544168618
STAT,1900,20,25-29,1920,92.21754328832759
STAT,1887,58,na,1945,2557.672333914416
STAT,1883,44,na,1927,2574.3782439986935
STAT,1872,49,40-44,1921,0.1942447696770502
SIM,1849,34,50-100,1883,2
STAT,1931,23,50-100,1954,0.9820424909439056
STAT,1916,23,40-44,1939,4.053893055553163
SIM,1927,60,na,1987,4502
STAT,1965,29,45-49,1994,2.497357550454954
SIM,1875,23,20-24,1898,161
STAT,1920,29,15-19,1949,0.8869412758839849
SIM,1935,26,20-24,1961,49
STAT,1910,30,35-39,1940,10.261049285815306
SIM,1811,67,na,1878,1268
STAT,1832,52,na,1884,1517.2763753388938
SIM,1930,21,15-19,1951,10
SIM,1862,59,na,1921,2404
STAT,1887,22,35-39,1909,7.547160667738781
SIM,1915,25,40-44,1940,2
SIM,1924,23,40-44,1947,10
SIM,1905,18,35-39,1923,3
STAT,1910,38,45-49,1948,0.7494733823359534
SIM,1929,32,30-34,1961,28
SIM,1959,5,na,1964,6033
STAT,1983,25,na,2008,6147.546956244593
STAT,1904,46,20-24,1950,0.011249565259336557
STAT,1960,28,50-100,1988,1.5018333911322175
SIM,1836,30,30-34,1866,43
SIM,1886,21,30-34,1907,43
SIM,1976,3,na,1979,6056
SIM,1895,22,35-39,1917,11
SIM,1848,12,na,1860,2302
STAT,1927,26,20-24,1953,25.692290786793766
STAT,1925,24,45-49,1949,1.5440694428035675
STAT,1954,36,50-100,1990,0.6176724456274741
STAT,1950,35,35-39,1985,3.40620813664686
SIM,1855,26,50-100,1881,1
STAT,1933,40,30-34,1973,0.20336569953333275
SIM,1964,28,40-44,1992,18
SIM,1955,22,30-34,1977,92
SIM,1926,28,20-24,1954,40
STAT,1896,20,35-39,1916,8.948013444387177
SIM,1912,46,20-24,1958,1
STAT,1837,83,na,1920,287.46944707483874
SIM,1900,31,30-34,1931,26
STAT,1939,39,45-49,1978,0.8099286468120301
SIM,1921,19,30-34,1940,42
STAT,1956,28,40-44,1984,7.145095735238372
STAT,1779,110,na,1889,0.001766895392172503
STAT,1825,82,na,1907,330.0269396533836
STAT,1942,46,40-44,1988,0.19830482266976307
STAT,1907,25,40-44,1932,5.120899431660249
STAT,1954,28,30-34,1982,56.1151295236117
STAT,1829,96,na,1925,6.290407743228329
STAT,1985,28,50-100,2013,1.6400301082040398
STAT,1778,87,na,1865,73.61603704617391
STAT,1864,30,40-44,1894,4.504653299953962
STAT,1828,107,na,1935,0.0031299757633170356
SIM,1946,27,35-39,1973,40
SIM,1844,30,50-100,1874,1
SIM,1939,18,na,1957,4692
SIM,1921,23,15-19,1944,1
SIM,1951,42,na,1993,6267
STAT,1834,49,20-24,1883,0.011320046483512978
STAT,1867,23,20-24,1890,74.0229747796687
SIM,1932,45,35-39,1977,1
SIM,1962,28,30-34,1990,10
STAT,1828,30,30-34,1858,21.55878680085561
STAT,1963,30,15-19,1993,0.19226641359282323
STAT,1927,38,15-19,1965,0.02751959269082373
SIM,1847,31,45-49,1878,5
STAT,1913,19,30-34,1932,2.8620883497391874
STAT,1878,0,na,1878,4386.298962217865
STAT,1889,22,45-49,1911,0.991988240168779
SIM,1799,69,na,1868,476
STAT,1898,10,na,1908,4040.080507838754
SIM,1947,39,45-49,1986,1
STAT,1820,51,na,1871,1428.7961689876925
SIM,1882,47,na,1929,3075
SIM,1884,21,20-24,1905,83
SIM,1914,43,50-100,1957,2
STAT,1937,64,na,2001,3792.6277195117013
STAT,1911,57,na,1968,3840.799764326784
STAT,1938,27,35-39,1965,17.17372655856725
STAT,1924,45,35-39,1969,0.177922863798549
STAT,1946,43,20-24,1989,0.02345480523385271
STAT,1914,23,30-34,1937,33.79834837558583
SIM,1897,22,45-49,1919,1
SIM,1925,47,45-49,1972,1
SIM,1982,28,na,2010,6051
SIM,1869,81,na,1950,218
STAT,1849,22,15-19,1871,3.0914519427228995
SIM,1857,22,15-19,1879,2
SIM,1939,75,na,2014,3352
STAT,1980,24,50-100,2004,1.0569288515722561
SIM,1868,20,25-29,1888,83
STAT,1969,28,na,1997,5421.294384507089
STAT,1965,14,na,1979,5657.424089462114
STAT,1962,26,15-19,1988,1.048861170955405
STAT,1938,24,30-34,1962,32.82092817422336
STAT,1928,38,30-34,1966,2.655438686538971
STAT,1787,91,na,1878,14.831454300514906
STAT,1891,31,50-100,1922,1.312198336308163
STAT,1891,31,na,1922,3417.54825578382
STAT,1895,45,na,1940,3414.021482911249
STAT,1972,24,30-34,1996,42.57962815365644
SIM,1938,16,50-100,1954,1
STAT,1942,41,35-39,1983,0.25278791215406166
SIM,1878,42,na,1920,2770
STAT,1814,48,40-44,1862,0.4682135616704477
STAT,1961,33,45-49,1994,2.39005557728755
STAT,1899,34,20-24,1933,4.237136323100662
STAT,1854,23,35-39,1877,5.545849649315215
SIM,1970,26,15-19,1996,2
SIM,1907,34,45-49,1941,4
STAT,1803,102,na,1905,0.1021830863512018
STAT,1947,28,50-100,1975,1.2988815042936797
STAT,1923,30,20-24,1953,3.251754952229109
STAT,1914,0,na,1914,5363.105622966221
SIM,1932,39,na,1971,5448
STAT,1961,38,15-19,1999,0.02946843033321357
STAT,1953,28,15-19,1981,0.9893339163523333
SIM,1948,22,na,1970,3822
STAT,1922,29,25-29,1951,85.30147867337324
STAT,1913,23,15-19,1936,6.18751736954714
SIM,1971,37,30-34,2008,4
STAT,1906,46,30-34,1952,0.09215113863078765
SIM,1903,27,15-19,1930,2
SIM,1862,23,35-39,1885,12
STAT,1903,37,15-19,1940,0.01992335034603323
SIM,1898,94,na,1992,167
SIM,1930,29,25-29,1959,13
STAT,1861,65,na,1926,1621.3622440131137
SIM,1899,15,30-34,1914,8
STAT,1963,37,30-34,2000,2.753008932007142
SIM,1936,38,30-34,1974,4
STAT,1865,79,na,1944,727.947587264497
SIM,1852,17,na,1869,2337
STAT,1902,44,45-49,1946,0.16718324776969695
SIM,1935,34,50-100,1969,3
SIM,1946,24,30-34,1970,42
SIM,1902,34,45-49,1936,1
STAT,1928,17,25-29,1945,63.01385768122747
STAT,1962,17,25-29,1979,64.07881366988128
SIM,1865,24,na,1889,3152
STAT,1908,49,45-49,1957,0.22579101231981719
STAT,1888,34,45-49,1922,2.345371353579365
STAT,1972,35,30-34,2007,2.779306164114019
SIM,1906,27,40-44,1933,3
STAT,1905,25,30-34,1930,42.34725092452957
SIM,1822,48,40-44,1870,1
SIM,1973,21,na,1994,5087
SIM,1866,8,na,1874,2811
STAT,1970,18,50-100,1988,0.5410661055217119
STAT,1816,78,na,1894,385.86102860050994
STAT,1913,44,20-24,1957,0.01981946120851725
SIM,1846,40,40-44,1886,2
SIM,1873,11,na,1884,3705
SIM,1899,24,20-24,1923,15
STAT,1931,40,20-24,1971,0.027308878800598655
STAT,1922,21,15-19,1943,7.0630413108135786
STAT,1847,61,na,1908,1437.8297728156954
STAT,1871,49,25-29,1920,0.06475129069840713
SIM,1849,36,25-29,1885,5
SIM,1838,30,40-44,1868,13
SIM,1985,22,25-29,2007,7
SIM,1878,30,35-39,1908,8
SIM,1938,42,25-29,1980,2
STAT,1958,28,15-19,1986,1.0741476005278574
STAT,1959,43,na,2002,5817.218990404741
SIM,1913,25,30-34,1938,57
SIM,1896,34,45-49,1930,8
STAT,1974,38,45-49,2012,1.057304073992956
SIM,1958,18,15-19,1976,124
SIM,1920,38,na,1958,4145
STAT,1908,41,35-39,1949,0.2165164547049536
SIM,1916,49,45-49,1965,1
SIM,1871,63,na,1934,1456
STAT,1937,45,20-24,1982,0.01294314048598226
SIM,1839,39,50-100,1878,1
STAT,1846,44,na,1890,2357.0669789306335
STAT,1904,16,25-29,1920,9.414075640414051
STAT,1842,30,na,1872,2056.967472680086
SIM,1875,77,na,1952,912
STAT,1936,36,15-19,1972,0.021789251600298164
STAT,1869,17,45-49,1886,0.07401591220829042
STAT,1959,37,20-24,1996,0.409975050609725
STAT,1838,40,40-44,1878,2.3381221717478917
SIM,1905,15,30-34,1920,3
SIM,1834,20,na,1854,2057
STAT,1919,49,20-24,1968,0.013748610969434794
STAT,1974,32,50-100,2006,1.2699938751104447
SIM,1841,43,50-100,1884,2
SIM,1900,22,40-44,1922,4
SIM,1973,26,40-44,1999,10
SIM,1801,89,na,1890,13
STAT,1975,15,45-49,1990,0.7609390782589488
STAT,1924,42,30-34,1966,0.1754456333412771
STAT,1934,39,45-49,1973,1.0838962315561012
STAT,1931,15,30-34,1946,18.501189501427394
STAT,1940,25,25-29,1965,77.55043200531249
STAT,1916,26,45-49,1942,2.068747647293459
STAT,1977,15,na,1992,5742.434160421478
SIM,1863,33,na,1896,2450
SIM,1904,39,25-29,1943,5
STAT,1852,52,45-49,1904,0.013609659928221017
STAT,1920,24,45-49,1944,1.4339199851651263
SIM,1896,39,na,1935,3690
SIM,1892,25,na,1917,3793
SIM,1953,33,na,1986,5602
STAT,1920,18,na,1938,4751.221722799412
STAT,1882,27,na,1909,2690.1247948132536
STAT,1899,3,na,1902,4179.783552386692
STAT,1900,28,35-39,1928,15.396977396889747
SIM,1983,15,45-49,1998,5
SIM,1914,37,40-44,1951,4
STAT,1876,21,20-24,1897,82.45935063478751
STAT,1901,32,35-39,1933,16.37022739593675
SIM,1841,15,15-19,1856,6
STAT,1956,6,na,1962,6003.197349019531
STAT,1853,37,50-100,1890,1.2223640103035012
SIM,1970,17,25-29,1987,79
STAT,1961,49,15-19,2010,5.679447125838494E-4
STAT,1960,21,35-39,1981,14.204311781932272
STAT,1807,53,na,1860,1575.7150538523958
STAT,1775,90,na,1865,39.02847029731567
STAT,1955,19,35-39,1974,6.424241488697766
SIM,1825,32,20-24,1857,6
STAT,1965,26,40-44,1991,6.747506121198554
SIM,1925,19,15-19,1944,59
STAT,1963,35,20-24,1998,0.39887399304798565
SIM,1883,64,na,1947,1715
STAT,1906,37,40-44,1943,1.5900531304120364
STAT,1948,46,35-39,1994,0.17755094797624077
STAT,1880,7,na,1887,3244.5972271516243
SIM,1954,34,30-34,1988,43
SIM,1887,78,na,1965,1722
STAT,1858,16,30-34,1874,1.6861299463464758
STAT,1917,19,15-19,1936,55.87622342310118
SIM,1866,16,30-34,1882,2
STAT,1866,51,50-100,1917,0.016232130007759447
SIM,1924,26,45-49,1950,1
SIM,1857,48,na,1905,2358
STAT,1946,34,30-34,1980,20.52954410128461
STAT,1936,32,50-100,1968,0.9273380693801208
SIM,1906,55,na,1961,3317
SIM,1902,41,na,1943,3918
SIM,1870,39,30-34,1909,5
SIM,1984,19,na,2003,5542
STAT,1935,3,na,1938,6402.523846718252
SIM,1835,21,25-29,1856,78
SIM,1942,31,35-39,1973,18
SIM,1963,19,35-39,1982,12
SIM,1937,1,na,1938,4600
SIM,1865,99,na,1964,23
STAT,1908,16,45-49,1924,0.11224372831166032
STAT,1811,48,15-19,1859,0.0012260300101254885
STAT,1889,27,15-19,1916,0.6454232905700114
SIM,1832,29,na,1861,2154
STAT,1949,25,45-49,1974,2.3307987497129967
STAT,1942,16,45-49,1958,0.6027291131617899
SIM,1862,34,50-100,1896,2
SIM,1882,5,na,1887,3608
STAT,1890,20,40-44,1910,2.955953228930175
SIM,1894,80,na,1974,2099
STAT,1942,49,45-49,1991,0.27108785646866174
SIM,1898,30,na,1928,3895
STAT,1862,39,30-34,1901,5.13840697113652
SIM,1897,27,15-19,1924,1
STAT,1868,30,25-29,1898,11.44795458897586
STAT,1925,21,40-44,1946,4.657234493133118
SIM,1947,36,40-44,1983,5
STAT,1843,22,20-24,1865,86.79173457544199
STAT,1950,32,30-34,1982,21.914028701956926
SIM,1851,22,20-24,1873,6
STAT,1957,35,45-49,1992,1.070505972877548
SIM,1879,19,20-24,1898,46
STAT,1934,31,35-39,1965,14.414508363370993
STAT,1959,48,20-24,2007,0.01730410346980381
SIM,1932,17,40-44,1949,6
STAT,1867,26,25-29,1893,45.735707601919856
SIM,1840,16,na,1856,2426
STAT,1924,17,40-44,1941,1.921695317889369
STAT,1890,78,na,1968,1570.8644910789158
STAT,1939,36,40-44,1975,1.7839422014920212
STAT,1932,27,40-44,1959,7.0471731451050825
SIM,1861,2,na,1863,2940
SIM,1911,77,na,1988,3152
STAT,1910,35,40-44,1945,1.6696823207663465
SIM,1903,26,na,1929,3727
STAT,1935,43,45-49,1978,0.270633192636443
SIM,1836,33,35-39,1869,18
SIM,1918,56,na,1974,3666
STAT,1828,33,35-39,1861,11.307602882329569
SIM,1940,27,40-44,1967,10
SIM,1914,42,na,1956,3921
SIM,1957,25,45-49,1982,4
STAT,1840,38,40-44,1878,4.110505556552906
STAT,1896,40,50-100,1936,0.11295331527830034
STAT,1919,16,20-24,1935,34.766084130051745
SIM,1849,24,30-34,1873,29
STAT,1860,48,na,1908,2066.3028255762533
SIM,1938,2,na,1940,4270
STAT,1914,26,35-39,1940,17.53503020633173
STAT,1947,34,25-29,1981,12.231412930589391
STAT,1851,52,50-100,1903,0.01191264571862105
STAT,1896,105,na,2001,2.1801964602350585
STAT,1926,42,40-44,1968,0.3557794321946449
STAT,1894,60,na,1954,2829.3758132945027
SIM,1906,39,35-39,1945,4
SIM,1976,19,20-24,1995,207
STAT,1871,46,50-100,1917,0.28278042784717566
STAT,1874,53,35-39,1927,0.010007840482267799
SIM,1826,33,na,1859,2114
SIM,1955,0,na,1955,6593
STAT,1898,74,na,1972,2262.857075305629
STAT,1870,49,30-34,1919,0.10783223555068376
SIM,1809,64,na,1873,1131
SIM,1805,50,na,1855,1569
SIM,1888,21,40-44,1909,4
SIM,1844,15,40-44,1859,1
STAT,1829,32,na,1861,2077.608972311968
SIM,1921,28,20-24,1949,66
SIM,1925,44,40-44,1969,1
STAT,1827,30,na,1857,2399.8940686249443
STAT,1830,28,30-34,1858,30.216801794081515
SIM,1877,25,na,1902,3327
STAT,1906,43,50-100,1949,0.1225672549226713
SIM,1942,17,na,1959,4710
STAT,1909,75,na,1984,2586.1037872493225
STAT,1905,61,na,1966,3391.330073289373
SIM,1922,26,35-39,1948,30
STAT,1854,54,20-24,1908,5.846486249366201E-4
STAT,1968,19,20-24,1987,195.28940947032999
STAT,1826,35,50-100,1861,1.0341695536787339
STAT,1876,24,25-29,1900,67.86527932109574
SIM,1960,32,40-44,1992,7
SIM,1872,80,na,1952,875
STAT,1901,41,25-29,1942,0.07240949275646859
STAT,1913,47,25-29,1960,0.059781945823831235
SIM,1823,39,45-49,1862,2
STAT,1902,28,45-49,1930,1.8041184445370426
SIM,1953,38,50-100,1991,1
STAT,1842,41,50-100,1883,0.8519472150340338
STAT,1972,27,35-39,1999,22.280018620883226
SIM,1834,63,na,1897,1305
SIM,1879,27,na,1906,2712
SIM,1972,28,35-39,2000,3
STAT,1856,43,na,1899,2020.2295048788335
STAT,1963,29,35-39,1992,22.085558016631502
STAT,1924,21,25-29,1945,126.13002967109898
SIM,1875,26,25-29,1901,5
SIM,1884,24,25-29,1908,7
SIM,1918,18,20-24,1936,302
STAT,1951,23,35-39,1974,12.978185012983598
SIM,1798,84,na,1882,117
STAT,1815,39,45-49,1854,5.944427193232217
SIM,1794,70,na,1864,681
STAT,1934,53,na,1987,5784.164015919991
STAT,1952,32,40-44,1984,5.516596108947087
SIM,1876,94,na,1970,30
SIM,1932,21,25-29,1953,277
STAT,1907,41,40-44,1948,0.2664140473419763
SIM,1932,29,35-39,1961,2
SIM,1937,38,25-29,1975,2
SIM,1933,56,na,1989,6108
SIM,1960,28,20-24,1988,50
SIM,1917,39,na,1956,5306
STAT,1940,16,35-39,1956,4.9197825115930165
STAT,1937,39,35-39,1976,2.786786985549436
SIM,1966,15,50-100,1981,1
SIM,1913,25,na,1938,4685
STAT,1859,62,na,1921,1680.2418487716118
SIM,1872,39,40-44,1911,3
STAT,1834,49,50-100,1883,0.23168360885627193
STAT,1938,48,40-44,1986,0.18626203645670344
STAT,1940,49,35-39,1989,0.15626814806131042
STAT,1929,30,15-19,1959,0.1885961322250397
STAT,1909,54,na,1963,3798.4374648939115
SIM,1847,81,na,1928,686
STAT,1905,40,na,1945,3912.9363704232883
STAT,1960,29,45-49,1989,2.6053770730530683
SIM,1902,31,40-44,1933,14
SIM,1945,39,35-39,1984,1
STAT,1841,29,45-49,1870,1.2085562005817139
STAT,1929,38,25-29,1967,1.457393139550905
SIM,1860,29,20-24,1889,2
STAT,1948,43,30-34,1991,0.17518943973131473
STAT,1957,19,45-49,1976,0.7595758942321675
STAT,1865,26,15-19,1891,0.4740417469193169
STAT,1944,46,15-19,1990,4.7706387834896616E-4
SIM,1931,54,na,1985,5862
SIM,1955,34,25-29,1989,16
STAT,1810,52,40-44,1862,0.03854903709272307
STAT,1926,37,50-100,1963,0.5920403007163577
STAT,1899,37,25-29,1936,0.9825552978027656
STAT,1876,31,na,1907,2858.452524712929
SIM,1929,19,35-39,1948,14
STAT,1963,41,15-19,2004,0.002343274691278865
STAT,1952,28,20-24,1980,25.341574513376518
STAT,1852,29,20-24,1881,11.555516363658612
STAT,1940,22,20-24,1962,130.7646923036287
STAT,1884,61,na,1945,2130.657494672738
STAT,1864,39,40-44,1903,4.465362099634411
STAT,1963,49,25-29,2012,0.08042163719161527
STAT,1888,75,na,1963,1697.0124575211858
STAT,1903,24,50-100,1927,0.6661202798340744
SIM,1954,18,30-34,1972,21
STAT,1986,16,40-44,2002,2.300681501145383
SIM,1963,28,25-29,1991,16
SIM,1952,16,na,1968,4836
STAT,1895,106,na,2001,1.1056914365259232
SIM,1933,30,30-34,1963,38
STAT,1838,52,50-100,1890,0.01301496860311946
SIM,1964,39,40-44,2003,5
STAT,1856,19,50-100,1875,0.050405100875476685
SIM,1829,49,50-100,1878,1
SIM,1939,29,45-49,1968,5
STAT,1955,20,15-19,1975,8.18778296025583
STAT,1926,38,20-24,1964,0.3713421762715197
STAT,1866,32,na,1898,2552.545939395437
STAT,1884,23,50-100,1907,0.4635344212956148
STAT,1836,40,30-34,1876,1.2774439388508017
STAT,1830,101,na,1931,0.3579618075356908
SIM,1929,44,25-29,1973,1
SIM,1954,37,35-39,1991,7
STAT,1901,16,35-39,1917,0.8891572936775807
STAT,1965,37,40-44,2002,2.2220361624389584
SIM,1897,56,na,1953,3031
SIM,2006,1,na,2007,7594
SIM,1893,42,na,1935,3352
STAT,1856,20,40-44,1876,2.161749772759226
SIM,1885,76,na,1961,1797
SIM,1881,62,na,1943,1427
STAT,1898,25,15-19,1923,0.7124317260714846
STAT,1921,17,15-19,1938,59.677907807392344
SIM,1927,17,na,1944,4537
STAT,1889,27,50-100,1916,0.910006733846956
STAT,1946,18,30-34,1964,15.59650226820888
SIM,1953,39,20-24,1992,1
STAT,1915,35,40-44,1950,1.7621120863389643
SIM,1969,41,na,2010,5725
STAT,1893,16,25-29,1909,8.286463677183209
STAT,1953,59,na,2012,5016.5014031219725
STAT,1935,36,20-24,1971,0.42601098217415556
SIM,1876,30,25-29,1906,12
STAT,1925,30,30-34,1955,21.608718481952657
STAT,1841,51,30-34,1892,0.0053176750380540235
SIM,1908,57,na,1965,3393
STAT,1945,37,na,1982,4886.307087512124
SIM,1994,16,40-44,2010,1
STAT,1920,40,45-49,1960,0.2126243407987048
STAT,1941,28,45-49,1969,2.0619911601249763
SIM,1904,43,na,1947,4028
STAT,1936,27,25-29,1963,72.73800279379141
STAT,1941,23,na,1964,4354.840819182058
SIM,1944,27,25-29,1971,164
STAT,1843,25,25-29,1868,52.9937212250786
STAT,1881,8,na,1889,2911.0717410992406
SIM,1844,40,30-34,1884,1
SIM,1851,25,25-29,1876,80
STAT,1802,86,na,1888,100.05606889545238
STAT,1880,79,na,1959,1029.7923825387884
SIM,1845,47,na,1892,1993
STAT,1926,23,na,1949,5103.057666001026
SIM,1841,33,na,1874,2056
STAT,1836,49,30-34,1885,0.08989310717688101
STAT,1930,60,na,1990,5199.950711703961
SIM,1921,76,na,1997,3292
STAT,1950,19,35-39,1969,5.721990534391952
STAT,1945,39,20-24,1984,0.3416444040814765
SIM,1910,16,15-19,1926,12
STAT,1905,46,50-100,1951,0.23206153938728327
STAT,1902,20,35-39,1922,9.572272146780138
SIM,1825,35,25-29,1860,1
STAT,1949,22,40-44,1971,4.527769962039533
STAT,1863,52,20-24,1915,7.406778394334237E-4
SIM,1875,17,35-39,1892,1
STAT,1808,70,na,1878,937.1816533830154
SIM,1973,37,40-44,2010,6
SIM,1928,28,30-34,1956,74
STAT,1862,30,30-34,1892,17.14126992909169
SIM,1881,49,35-39,1930,1
STAT,1894,20,25-29,1914,85.43282661339913
STAT,1826,39,20-24,1865,0.5921485780335345
STAT,1919,6,na,1925,5110.345524594043
STAT,1940,46,30-34,1986,0.1089555211671436
STAT,1952,35,45-49,1987,0.9729954961983138
STAT,1847,41,45-49,1888,1.1729506675590695
STAT,1910,32,50-100,1942,0.9209648338153635
SIM,1862,3,na,1865,3716
SIM,1907,40,30-34,1947,1
SIM,1963,20,15-19,1983,7
STAT,1867,17,35-39,1884,0.6044121343721675
STAT,1813,49,na,1862,1374.479163739465
STAT,1907,98,na,2005,78.32283432352263
SIM,1920,19,15-19,1939,108
SIM,1923,35,40-44,1958,1
STAT,1912,19,15-19,1931,10.544005226913152
STAT,1955,28,25-29,1983,101.2246748971416
STAT,1902,16,15-19,1918,9.700811727822018
STAT,1863,32,50-100,1895,0.9245926979590687
STAT,1954,47,50-100,2001,0.3356390638973117
STAT,1946,37,35-39,1983,3.1896059034377084
SIM,1839,21,45-49,1860,1
SIM,1919,49,35-39,1968,1
STAT,1961,26,20-24,1987,27.346551750663508
SIM,1938,17,35-39,1955,10
SIM,1900,25,45-49,1925,2
STAT,1956,32,25-29,1988,14.386931095344957
STAT,1935,48,15-19,1983,5.988188259790385E-4
SIM,1858,65,na,1923,2037
SIM,1922,23,30-34,1945,42
STAT,1986,29,25-29,2015,108.59456014866902
SIM,1854,51,na,1905,2285
STAT,1862,48,20-24,1910,0.011540339435725775
STAT,1846,29,50-100,1875,0.7885656572260706
STAT,1899,59,na,1958,3149.8019967706055
STAT,1920,21,40-44,1941,4.325000825855685
SIM,1964,32,25-29,1996,31
STAT,1879,37,50-100,1916,1.4794532100232594
STAT,1859,43,50-100,1902,0.9641854575654148
SIM,1970,21,45-49,1991,4
STAT,1923,17,25-29,1940,58.7030170535382
SIM,1864,16,20-24,1880,35
SIM,1858,34,25-29,1892,23
SIM,1911,32,45-49,1943,5
STAT,1954,19,na,1973,5247.697126632847
SIM,1962,39,30-34,2001,2
STAT,1768,101,na,1869,0.12520134258008397
SIM,1867,43,50-100,1910,3
SIM,1960,35,45-49,1995,2
STAT,1872,28,na,1900,2755.7738064913856
SIM,1823,36,40-44,1859,2
STAT,1941,34,30-34,1975,19.069984085275493
STAT,1981,18,25-29,1999,69.90826859596322
SIM,1945,60,na,2005,4194
SIM,1955,31,20-24,1986,1
STAT,1934,27,15-19,1961,1.0965177042816527
STAT,1919,19,25-29,1938,54.95670221266783
SIM,1801,68,na,1869,982
STAT,1943,40,50-100,1983,0.14983983447931853
STAT,1951,47,45-49,1998,0.3106673995937244
SIM,1892,46,na,1938,3530
SIM,1971,26,30-34,1997,4
SIM,1820,71,na,1891,1224
STAT,1856,16,20-24,1872,18.566063350120288
STAT,1948,18,40-44,1966,1.8466523085709823
STAT,1962,21,45-49,1983,1.669817254141712
STAT,1951,20,30-34,1971,39.655188308312006
STAT,1849,84,na,1933,257.8366682248458
STAT,1845,16,45-49,1861,0.05596440134098545
SIM,1912,20,45-49,1932,3
STAT,1845,70,na,1915,945.4684386026399
SIM,1947,48,na,1995,5847
STAT,1825,38,50-100,1863,1.9798871357969188
STAT,1937,36,30-34,1973,2.106292454351473
STAT,1904,21,50-100,1925,0.6778383867363272
STAT,1963,26,30-34,1989,57.72225859639973
SIM,1931,17,25-29,1948,2
STAT,1947,22,30-34,1969,37.4858732036328
SIM,1898,27,30-34,1925,39
STAT,1924,15,50-100,1939,0.5171312477992612
STAT,1957,7,na,1964,5980.70620799775
STAT,1902,21,na,1923,3868.1576643723206
STAT,1872,43,50-100,1915,1.2153752950685448
STAT,1903,32,45-49,1935,2.8664551670754275
STAT,1906,35,na,1941,4034.042239813368
SIM,1923,38,45-49,1961,2
STAT,1873,49,35-39,1922,0.1615437438807908
STAT,1919,53,na,1972,4499.690481554834
SIM,1923,19,40-44,1942,2
STAT,1865,52,30-34,1917,0.0061651324810227
STAT,1885,20,50-100,1905,0.47221209140415576
SIM,1893,20,50-100,1913,1
STAT,1958,32,35-39,1990,14.119024650799556
STAT,1935,48,50-100,1983,0.3676750680131571
STAT,1912,35,15-19,1947,0.021856346435088873
SIM,1857,80,na,1937,458
STAT,1820,41,45-49,1861,1.9077930875764373
STAT,1827,108,na,1935,0.0014875800870807457
STAT,1971,24,15-19,1995,7.80111724731199
SIM,1880,43,50-100,1923,1
STAT,1902,49,15-19,1951,3.60241723140956E-4
STAT,1908,37,15-19,1945,0.02077558900072538
STAT,1836,66,na,1902,1491.6103465512
SIM,1966,32,35-39,1998,42
STAT,1901,58,na,1959,3297.081741185383
STAT,1838,49,40-44,1887,0.14873389712945642
STAT,1851,15,50-100,1866,0.04779624266280228
STAT,1847,26,50-100,1873,0.5958947399578552
SIM,1854,29,na,1883,2735
SIM,1850,15,na,1865,2200
STAT,1979,17,30-34,1996,19.36778817650874
SIM,1907,72,na,1979,2876
STAT,1915,19,40-44,1934,0.3360882294210211
STAT,1944,52,na,1996,4666.142464247289
STAT,1926,45,45-49,1971,0.3108735795912762
SIM,1859,22,25-29,1881,114
STAT,1936,31,45-49,1967,1.7659580114908113
STAT,1970,42,45-49,2012,0.2498627925121204
STAT,1817,52,na,1869,1856.207913421092
STAT,1842,51,na,1893,1664.8445924994683
STAT,1930,27,30-34,1957,57.50486454923839
STAT,1948,37,45-49,1985,0.9275583351221554
SIM,1838,77,na,1915,338
SIM,1867,47,na,1914,2178
STAT,1947,31,20-24,1978,3.2339559551827812
STAT,1941,25,40-44,1966,5.5707062247873935
STAT,1811,90,na,1901,40.59450156482678
SIM,1784,71,na,1855,431
STAT,1866,30,15-19,1896,0.1535524931789373
STAT,1931,39,40-44,1970,2.2836027789542044
SIM,1837,21,35-39,1858,12
SIM,1944,31,45-49,1975,6
STAT,1891,16,15-19,1907,8.485346756193653
SIM,1849,27,35-39,1876,2
STAT,1841,26,40-44,1867,3.3319028214968056
SIM,1956,37,45-49,1993,3
STAT,1955,15,na,1970,5641.9593228145295
STAT,1986,26,20-24,2012,30.159934347472483
SIM,1961,45,na,2006,5547
STAT,1936,24,20-24,1960,122.67334144475079
STAT,1830,24,50-100,1854,0.7020957232483253
STAT,1973,4,na,1977,5869.624813916724
STAT,1925,49,na,1974,5105.772920958288
SIM,1819,63,na,1882,537
SIM,1931,79,na,2010,2980
STAT,1850,81,na,1931,556.6878784267556
STAT,1959,29,na,1988,5673.921218814523
STAT,1841,54,35-39,1895,0.00744374348074758
STAT,1945,34,15-19,1979,0.16491793973757676
STAT,1957,18,50-100,1975,0.5698813791568299
STAT,1896,41,40-44,1937,0.23916212189690728
STAT,1925,33,35-39,1958,12.511667797796726
SIM,1933,33,35-39,1966,28
STAT,1905,49,40-44,1954,0.15793687170929593
SIM,1939,30,25-29,1969,3
STAT,1854,95,na,1949,10.831834980589331
STAT,1961,29,25-29,1990,98.46462942300772
SIM,1944,24,20-24,1968,5
SIM,1848,15,25-29,1863,6
SIM,1955,25,35-39,1980,25
STAT,1980,29,30-34,2009,62.98271351872104
SIM,1774,93,na,1867,24
STAT,1878,24,35-39,1902,6.987475775781312
STAT,1889,15,20-24,1904,25.337240062304435
SIM,1905,27,25-29,1932,142
SIM,1929,16,30-34,1945,44
STAT,1924,29,35-39,1953,20.023994645041526
SIM,1868,43,na,1911,3032
SIM,1942,38,na,1980,5003
SIM,1805,71,na,1876,812
SIM,1839,51,na,1890,1850
STAT,1915,44,30-34,1959,0.14807157505632493
SIM,1809,85,na,1894,162
STAT,1974,24,40-44,1998,5.080116140166603
STAT,1795,99,na,1894,0.3318595949428288
STAT,1915,38,45-49,1953,0.7909625016556298
STAT,1940,41,25-29,1981,0.0871100222083216
SIM,1945,36,30-34,1981,5
SIM,1838,26,20-24,1864,2
STAT,1990,18,35-39,2008,6.932788733484931
STAT,1897,38,40-44,1935,6.721567475650253
STAT,1954,41,na,1995,5514.361769476928
SIM,1914,21,na,1935,4238
STAT,1854,107,na,1961,0.013590600030483766
STAT,1868,26,40-44,1894,3.3327823881042256
STAT,1997,17,na,2014,6202.748858941914
SIM,1918,35,na,1953,3884
STAT,1813,48,25-29,1861,0.18803483761581402
SIM,1960,0,na,1960,6344
SIM,1939,38,35-39,1977,11
STAT,1878,97,na,1975,50.25516533488432
STAT,1920,61,na,1981,4315.45758925105
STAT,1874,83,na,1957,542.2766569388878
STAT,1823,48,na,1871,1456.6003404782796
STAT,1935,39,25-29,1974,1.5863609970207717
STAT,1960,17,15-19,1977,68.21465299693972
STAT,1903,25,20-24,1928,19.414720458743943
SIM,1906,31,25-29,1937,11
STAT,1829,41,50-100,1870,1.1482785561930564
SIM,1814,86,na,1900,85
SIM,1900,34,35-39,1934,35
SIM,1870,30,30-34,1900,40
STAT,1914,32,20-24,1946,2.834844388567444
STAT,1830,53,20-24,1883,5.868730280098584E-4
STAT,1924,75,na,1999,3345.8856803608037
SIM,1899,39,40-44,1938,2
STAT,1873,31,45-49,1904,2.063475101450983
SIM,1927,19,25-29,1946,179
SIM,1911,25,20-24,1936,41
STAT,1839,95,na,1934,10.544023782719297
STAT,1835,81,na,1916,337.0335976621855
STAT,1890,29,40-44,1919,4.193914697157627
SIM,1913,49,40-44,1962,1
SIM,1922,32,20-24,1954,11
STAT,1892,37,50-100,1929,1.7758492914825312
STAT,1913,28,20-24,1941,20.92738635811705
STAT,1804,101,na,1905,0.24810656221066973
STAT,1851,66,na,1917,1299.7265692512408
SIM,1976,18,na,1994,6036
STAT,1904,37,30-34,1941,1.9063697417547252
STAT,1946,46,25-29,1992,0.07079910058031032
SIM,1864,23,45-49,1887,1
STAT,1868,48,15-19,1916,4.379340000454089E-4
STAT,1839,36,15-19,1875,0.05377340454450624
SIM,1813,44,50-100,1857,1
STAT,1964,31,50-100,1995,1.2256937174864162
STAT,1923,42,15-19,1965,0.002070635173317896
STAT,1861,17,40-44,1878,0.20169225985841302
STAT,1861,39,15-19,1900,0.05333286335361653
STAT,1869,30,40-44,1899,4.885709268908282
STAT,1916,24,na,1940,4388.861236382346
SIM,1859,39,na,1898,2330
SIM,1888,40,45-49,1928,1
STAT,1878,21,30-34,1899,21.527808288181753
STAT,1869,61,na,1930,2088.402644647508
STAT,1857,28,na,1885,2193.5533440264344
STAT,1856,23,45-49,1879,0.7079330682965227
STAT,1912,10,na,1922,4627.085108215455
SIM,1922,72,na,1994,3543
SIM,1929,35,35-39,1964,2
STAT,1878,15,45-49,1893,0.07907641694954055
STAT,1853,14,na,1867,2833.20848252002
STAT,1835,27,40-44,1862,2.4425424767181694
SIM,1894,22,40-44,1916,10
STAT,1864,94,na,1958,30.681303970821624
STAT,1981,15,20-24,1996,218.8961427937297
STAT,1984,16,30-34,2000,19.983814558692057
STAT,1850,23,15-19,1873,4.046990587803501
STAT,1875,36,25-29,1911,3.450244029339076
SIM,1802,85,na,1887,86
SIM,1833,42,20-24,1875,3
SIM,1956,22,25-29,1978,6
SIM,1847,59,na,1906,2100
STAT,1822,53,na,1875,1943.5032859350715
STAT,1957,20,25-29,1977,141.10802890512898
STAT,1905,18,na,1923,4207.523626822557
SIM,1949,45,40-44,1994,1
STAT,1854,29,30-34,1883,21.199323049914405
SIM,1934,37,50-100,1971,2
STAT,1814,42,45-49,1856,5.122919627765088
SIM,1858,11,na,1869,3261
STAT,1951,32,25-29,1983,12.94701701433478
STAT,1966,26,35-39,1992,21.744243945026888
STAT,1961,17,45-49,1978,0.7448158743527866
SIM,1935,30,40-44,1965,11
STAT,1864,48,30-34,1912,0.09849342345375725
SIM,1848,36,30-34,1884,2
SIM,1787,89,na,1876,226
SIM,1846,15,15-19,1861,11
STAT,1883,65,na,1948,1908.123638715023
SIM,1845,22,45-49,1867,1
STAT,1959,42,25-29,2001,0.112027244484266
STAT,1889,115,na,2004,2.565471448766949E-4
SIM,1839,30,20-24,1869,7
SIM,1872,48,na,1920,2738
SIM,1929,76,na,2005,3065
SIM,1822,42,45-49,1864,4
SIM,1917,71,na,1988,3991
STAT,1956,41,15-19,1997,0.002440629341441852
SIM,1901,31,25-29,1932,7
SIM,1992,16,30-34,2008,29
STAT,1894,38,15-19,1932,0.08289428867869776
STAT,1845,48,na,1893,1497.0168219442276
STAT,1884,34,25-29,1918,11.57884290717314
SIM,1926,22,na,1948,6013
STAT,1893,97,na,1990,85.58056152831193
STAT,1921,56,na,1977,4599.709377870143
STAT,1825,42,20-24,1867,0.23623614006773763
SIM,1910,39,na,1949,3581
STAT,1865,17,25-29,1882,6.080373591410639
STAT,1875,24,30-34,1899,21.109863324740143
SIM,1879,80,na,1959,569
SIM,1889,24,25-29,1913,93
STAT,1880,19,30-34,1899,1.9392310606584964
SIM,1925,23,35-39,1948,19
STAT,1918,32,40-44,1950,4.798024099129237
STAT,1930,39,50-100,1969,0.630744398335002
STAT,1790,90,na,1880,31.78528379248022
STAT,1995,17,45-49,2012,0.8345010449464259
STAT,1837,22,45-49,1859,0.6610190778459363
STAT,1975,24,35-39,1999,14.37303594453859
STAT,1855,106,na,1961,0.03432264988044603
STAT,1950,16,30-34,1966,16.63682041898272
SIM,1905,24,20-24,1929,220
STAT,1815,48,35-39,1863,0.2816435313364821
STAT,1778,111,na,1889,0.0016885750843183944
STAT,1947,43,15-19,1990,0.0020713722360875073
STAT,1906,89,na,1995,720.2947343591763
STAT,1830,37,20-24,1867,0.7795167377983483
STAT,1987,18,na,2005,6062.104129469807
STAT,1889,43,15-19,1932,0.01950352493992562
STAT,1788,86,na,1874,106.84859401866474
STAT,1858,46,50-100,1904,0.22173801390487743
STAT,1970,15,45-49,1985,0.7220350308217277
STAT,1835,28,na,1863,1744.2610095284454
SIM,1825,37,50-100,1862,4
STAT,1899,28,35-39,1927,15.201935643273478
STAT,1977,28,20-24,2005,28.572566430522695
STAT,1856,97,na,1953,4.729986843572524
STAT,1925,42,25-29,1967,0.09974061916043266
SIM,1994,18,na,2012,6208
STAT,1939,24,25-29,1963,107.02654406952722
STAT,1863,39,25-29,1902,2.8761852969132278
STAT,1849,34,30-34,1883,13.966761834438921
STAT,1978,25,45-49,2003,2.7350741805696854
STAT,1928,82,na,2010,2373.8384357176037
SIM,1926,32,40-44,1958,8
STAT,1934,15,35-39,1949,6.583722933499123
SIM,1932,30,15-19,1962,2
STAT,1891,17,40-44,1908,0.2608779571385734
STAT,1841,25,15-19,1866,0.5082933538475511
STAT,1886,22,40-44,1908,2.536643728822395
STAT,1870,15,40-44,1885,0.2125722573413048
SIM,1849,50,na,1899,2445
STAT,1935,27,45-49,1962,2.7192068890894
STAT,1853,23,40-44,1876,2.433720868589932
SIM,1876,26,40-44,1902,10
STAT,1917,23,35-39,1940,11.513585044765774
SIM,1920,59,na,1979,3745
STAT,1765,91,na,1856,1.4863118219999998
STAT,1873,45,na,1918,2677.8479870162478
SIM,1860,47,na,1907,2300
SIM,1947,24,25-29,1971,3
SIM,1986,25,45-49,2011,5
SIM,1861,23,40-44,1884,5
SIM,1830,70,na,1900,924
SIM,1965,20,25-29,1985,290
STAT,1948,25,50-100,1973,1.321361120373633
STAT,1988,16,15-19,2004,74.92804598919174
STAT,1989,25,20-24,2014,30.330328822698725
STAT,1805,51,na,1856,1452.514809979769
SIM,1866,41,20-24,1907,1
STAT,1944,25,45-49,1969,2.1568197482437887
STAT,1871,64,na,1935,1995.8551253246687
SIM,1838,21,15-19,1859,3
SIM,1933,7,na,1940,6662
STAT,1868,21,35-39,1889,6.516983318499461
SIM,1881,4,na,1885,2285
SIM,1866,32,30-34,1898,16
STAT,1881,96,na,1977,71.73311251845412
SIM,1890,77,na,1967,1466
STAT,1964,23,20-24,1987,162.10414947923886
STAT,1949,34,35-39,1983,12.486143127161412
SIM,1974,16,na,1990,5985
SIM,1982,4,na,1986,6833
STAT,1924,30,15-19,1954,0.17375258021352974
SIM,1867,23,35-39,1890,15
SIM,1882,24,15-19,1906,8
STAT,1896,44,45-49,1940,0.15628034031844376
STAT,1839,27,25-29,1866,42.26185380965356
SIM,1847,27,25-29,1874,5
STAT,1965,49,35-39,2014,0.19208273904487635
SIM,1909,74,na,1983,3417
STAT,1820,72,na,1892,741.192626836065
STAT,1909,37,45-49,1946,0.745505619100183
STAT,1808,48,na,1856,1697.0386649416635
STAT,1796,73,na,1869,583.8484885881182
STAT,1876,104,na,1980,1.9547935452021723
STAT,1851,35,25-29,1886,2.3560636292341988
STAT,1847,29,na,1876,1972.062799577036
SIM,1826,29,20-24,1855,25
STAT,1953,20,40-44,1973,4.7127995777638
SIM,1817,37,40-44,1854,5
SIM,1897,27,50-100,1924,1
STAT,1860,27,na,1887,2243.5095751738554
SIM,1932,26,30-34,1958,70
SIM,1857,43,20-24,1900,1
SIM,1870,67,na,1937,2192
SIM,1855,46,na,1901,1789
SIM,1772,91,na,1863,26
SIM,1826,35,40-44,1861,9
STAT,1828,39,30-34,1867,5.263884218244266
STAT,1858,32,30-34,1890,15.718739110900756
STAT,1975,13,na,1988,5979.467245546394
SIM,1898,22,25-29,1920,201
SIM,1903,22,45-49,1925,4
SIM,1857,34,30-34,1891,43
STAT,1924,26,30-34,1950,52.81570576852859
SIM,1836,24,45-49,1860,2
STAT,1973,21,20-24,1994,166.56643164704136
STAT,1848,22,20-24,1870,89.15459204872069
SIM,1919,52,na,1971,5159
STAT,1857,20,20-24,1877,72.54332607425742
SIM,1972,23,20-24,1995,325
STAT,1771,116,na,1887,1.4740503733851325E-4
STAT,1865,58,na,1923,2059.1853838919287
STAT,1874,15,25-29,1889,6.751147817542106
STAT,1876,95,na,1971,82.35871295219971
SIM,1836,39,30-34,1875,3
STAT,1824,33,15-19,1857,0.26663164853461546
STAT,1923,37,na,1960,5028.879037776096
SIM,1883,10,na,1893,2785
STAT,1964,37,25-29,2001,1.4744335298239817
SIM,1877,42,35-39,1919,5
SIM,1946,20,na,1966,4126
STAT,1894,16,40-44,1910,0.27201028264704025
SIM,1869,60,na,1929,1477
STAT,1899,25,30-34,1924,40.08447082483018
SIM,1961,20,40-44,1981,12
STAT,1860,70,na,1930,1305.0114584821852
STAT,1814,42,50-100,1856,3.61617855041273
STAT,1904,20,45-49,1924,1.1625097507235735
STAT,1954,16,15-19,1970,64.76497469444395
STAT,1868,98,na,1966,15.670661891197115
STAT,1877,27,45-49,1904,1.3328577465951255
SIM,1886,44,50-100,1930,2
STAT,1880,25,na,1905,2939.0990870544565
STAT,1938,33,20-24,1971,2.8300322731331025
STAT,1892,105,na,1997,1.9880593491554337
STAT,1915,1,na,1916,5028.453665421911
SIM,1917,37,45-49,1954,2
STAT,1987,20,40-44,2007,5.561620655769711
SIM,1852,25,40-44,1877,2
SIM,1939,35,30-34,1974,3
STAT,1835,49,15-19,1884,2.564595822621E-4
STAT,1855,26,na,1881,2131.9547392473296
STAT,1875,49,45-49,1924,0.275576004718678
SIM,1862,29,30-34,1891,38
SIM,1962,16,15-19,1978,118
STAT,1840,32,45-49,1872,1.7038466099905345
STAT,1844,25,40-44,1869,3.1117495478989916
STAT,1932,20,50-100,1952,1.0025332778173743
SIM,1957,34,35-39,1991,3
SIM,1951,21,na,1972,5540
STAT,1955,33,50-100,1988,1.2903343912056728
SIM,1868,32,40-44,1900,2
SIM,1842,28,na,1870,2276
SIM,1901,39,20-24,1940,1
SIM,1911,28,25-29,1939,154
STAT,1890,38,30-34,1928,7.478069178628821
STAT,1954,48,20-24,2002,0.016353713381998203
SIM,1974,23,30-34,1997,85
STAT,1949,21,15-19,1970,7.170596715884092
STAT,1930,17,na,1947,5492.415997855554
SIM,1876,21,35-39,1897,8
SIM,1916,25,35-39,1941,28
STAT,1927,30,40-44,1957,5.560477247393171
SIM,1946,33,20-24,1979,6
STAT,1884,31,20-24,1915,3.094679652954804
STAT,1948,22,25-29,1970,122.39278115653781
STAT,1869,42,35-39,1911,2.0212889244148537
STAT,1903,28,25-29,1931,69.28935123461493
SIM,1842,18,na,1860,2582
SIM,1957,21,15-19,1978,14
STAT,1855,16,na,1871,2336.878930207164
SIM,1862,38,20-24,1900,2
SIM,1854,29,50-100,1883,1
STAT,1908,25,35-39,1933,16.65135035627013
SIM,1892,31,20-24,1923,5
SIM,1918,22,50-100,1940,1
SIM,1986,19,25-29,2005,179
SIM,1870,33,35-39,1903,29
SIM,1972,37,25-29,2009,1
SIM,1974,1,na,1975,6415
STAT,1972,3,na,1975,5812.506247581177
STAT,1849,46,25-29,1895,0.04477068148155102
STAT,1927,33,45-49,1960,2.231993874517722
STAT,1902,25,40-44,1927,4.917789483917411
SIM,1882,26,na,1908,3289
SIM,1972,29,na,2001,5788
STAT,1988,26,30-34,2014,64.98126542567226
STAT,1894,107,na,2001,0.534254557301552
SIM,1933,29,15-19,1962,4
SIM,1906,36,30-34,1942,5
STAT,1886,25,45-49,1911,1.3607539603890881
STAT,1839,37,40-44,1876,4.148578676517306
SIM,1916,22,30-34,1938,72
SIM,1992,20,15-19,2012,19
STAT,1870,18,45-49,1888,0.07458504823843662
STAT,1874,50,30-34,1924,0.007133684904016571
STAT,1942,22,30-34,1964,34.783057157199735
SIM,1977,24,40-44,2001,6
SIM,1884,15,35-39,1899,1
STAT,1825,45,25-29,1870,0.08269561128075437
STAT,1835,31,25-29,1866,8.229275651083618
STAT,1917,41,na,1958,4479.424220322074
SIM,1950,22,30-34,1972,1
STAT,1893,43,na,1936,3358.6530522649923
STAT,1929,2,na,1931,6023.820488138436
STAT,1878,76,na,1954,1141.5793007492953
SIM,1969,32,50-100,2001,4
STAT,1895,32,35-39,1927,15.21279728993061
STAT,1768,88,na,1856,41.26288887
STAT,1960,51,na,2011,5670.539994945956
STAT,1844,39,50-100,1883,1.0628597943858369
STAT,1932,15,25-29,1947,66.54573560707829
SIM,1885,27,45-49,1912,3
STAT,1925,29,15-19,1954,0.9550734600410509
STAT,1832,31,na,1863,1926.3962004093667
STAT,1863,77,na,1940,872.2668984762953
SIM,1843,31,25-29,1874,12
STAT,1908,22,30-34,1930,30.53187784738112
STAT,1957,16,40-44,1973,2.128834776343191
STAT,1960,26,40-44,1986,7.039359560369461
SIM,1961,1,na,1962,5676
STAT,1885,2,na,1887,3592.8248995766253
STAT,1981,21,50-100,2002,1.0656778283923094
SIM,1822,73,na,1895,662
SIM,1842,71,na,1913,1234
SIM,1941,43,na,1984,3933
STAT,1889,39,30-34,1928,7.5053871992433185
SIM,1965,16,40-44,1981,3
STAT,1900,30,na,1930,3852.0491318888867
STAT,1940,21,50-100,1961,0.7740568836060263
STAT,1868,44,na,1912,2528.0371569684016
SIM,1822,36,25-29,1858,4
STAT,1865,27,40-44,1892,3.119149098292429
STAT,1982,29,40-44,2011,7.594367493530662
SIM,1848,76,na,1924,284
SIM,1872,33,45-49,1905,3
STAT,1894,103,na,1997,6.71506994787182
STAT,1935,24,40-44,1959,5.283289119022382
SIM,1929,19,na,1948,4677
STAT,1844,19,20-24,1863,18.62822868520629
SIM,1883,24,30-34,1907,3
STAT,1863,13,na,1876,2736.399120640746
SIM,1939,50,na,1989,4781
SIM,1966,19,na,1985,5547
STAT,1793,87,na,1880,59.22644857718188
SIM,1961,23,45-49,1984,7
SIM,1916,28,50-100,1944,4
STAT,1975,21,30-34,1996,43.916752976057175
STAT,1892,16,30-34,1908,2.311089664647544
STAT,1857,16,50-100,1873,0.052062271331232944
SIM,1839,33,25-29,1872,23
STAT,1953,23,45-49,1976,1.5754736367914408
STAT,1840,26,25-29,1866,42.61706425391781
STAT,1898,38,50-100,1936,0.4112613463634161
STAT,1876,15,35-39,1891,0.6576397643332528
SIM,1874,27,50-100,1901,1
SIM,1969,33,45-49,2002,6
SIM,1923,20,20-24,1943,148
STAT,1910,62,na,1972,3604.452952053892
STAT,1893,28,40-44,1921,4.354303306557319
STAT,1868,41,50-100,1909,1.1766597753851349
SIM,1876,41,50-100,1917,2
STAT,1933,57,na,1990,5576.80649489475
STAT,1956,48,30-34,2004,0.14120447546562995
STAT,1946,22,15-19,1968,6.836115379511751
STAT,2003,2,na,2005,6892.676111616309
SIM,1982,32,50-100,2014,4
STAT,1838,78,na,1916,676.7982282535924
SIM,1954,18,na,1972,5184
SIM,1974,28,45-49,2002,9
STAT,1966,29,50-100,1995,1.4394973667000912
STAT,1837,49,25-29,1886,0.042201828960602136
STAT,1836,37,15-19,1873,0.06275055632053768
STAT,1951,19,15-19,1970,62.32568987913454
STAT,1908,28,50-100,1936,1.0834347714030461
STAT,1884,82,na,1966,875.4905611110099
STAT,1984,20,15-19,2004,8.759910346707798
STAT,1930,26,50-100,1956,1.4614459366106614
SIM,1908,31,35-39,1939,4
SIM,1852,19,20-24,1871,25
STAT,1929,35,20-24,1964,0.39125966375655885
SIM,1903,39,30-34,1942,2
STAT,1928,26,15-19,1954,1.0071308727463175
STAT,1833,47,na,1880,1687.2629109693148
STAT,1913,69,na,1982,3327.6778804448986
STAT,1949,31,30-34,1980,21.567224687755893
STAT,1833,27,30-34,1860,23.725359686467318
STAT,1883,22,15-19,1905,3.724902581242126
STAT,1833,43,50-100,1876,0.8956148090717498
SIM,1948,36,35-39,1984,8
STAT,1858,44,25-29,1902,0.5703213843144628
STAT,1886,49,20-24,1935,0.014302735981857056
SIM,1939,26,40-44,1965,1
STAT,1841,38,35-39,1879,7.332512395465382
SIM,1847,24,20-24,1871,132
STAT,1915,20,20-24,1935,128.07051343484392
SIM,1990,16,20-24,2006,416
SIM,1934,21,35-39,1955,36
STAT,1843,16,35-39,1859,0.7077519652550679
SIM,1985,28,20-24,2013,39
STAT,1810,52,na,1862,1545.737363439948
STAT,1830,40,na,1870,1649.3085152569518
STAT,1982,30,na,2012,6267.526796973162
STAT,1958,41,25-29,1999,0.11264658762136492
SIM,1871,39,25-29,1910,9
SIM,1867,9,na,1876,2796
STAT,1896,38,25-29,1934,4.366952186203862
STAT,1943,35,na,1978,4752.053356041846
SIM,1804,54,na,1858,1159
STAT,1831,49,30-34,1880,0.08741621852962947
STAT,1897,37,15-19,1934,0.08665400340711542
STAT,1818,38,45-49,1856,3.0902897967478262
STAT,1888,27,20-24,1915,15.914588821860333
SIM,1943,24,40-44,1967,8
SIM,1826,38,45-49,1864,5
STAT,1876,10,na,1886,3137.8077396270437
STAT,1846,65,na,1911,1747.0529946470556
SIM,1868,35,45-49,1903,1
STAT,1879,24,15-19,1903,3.950499631531347
SIM,1867,20,30-34,1887,22
STAT,1827,33,40-44,1860,7.155301990841222
SIM,1822,83,na,1905,191
STAT,1862,33,35-39,1895,9.82145562710955
STAT,1939,20,na,1959,4237.064573705965
STAT,1915,60,na,1975,3979.0556079977623
STAT,1962,42,na,2004,5707.169227504056
STAT,1943,34,40-44,1977,4.875783751705119
SIM,1963,25,20-24,1988,32
SIM,1897,39,30-34,1936,3
STAT,1866,48,40-44,1914,0.18082512587258903
STAT,1847,34,20-24,1881,2.176585698641099
STAT,1959,20,35-39,1979,14.270861732058735
SIM,1924,32,30-34,1956,6
SIM,1850,69,na,1919,768
SIM,1949,64,na,2013,4919
SIM,1909,20,na,1929,4704
SIM,1930,27,na,1957,6072
SIM,1874,48,40-44,1922,1
SIM,1984,22,30-34,2006,58
STAT,1839,24,20-24,1863,69.21536200363595
STAT,1866,26,30-34,1892,27.028555604147275
SIM,1979,7,na,1986,6475
STAT,1898,16,25-29,1914,8.85999185560805
SIM,1951,34,40-44,1985,1
STAT,1800,74,na,1874,623.3024949110991
STAT,1844,28,45-49,1872,1.1287016495520783
SIM,1858,25,35-39,1883,23
STAT,1992,18,45-49,2010,0.8272175222637984
SIM,1937,63,na,2000,3631
STAT,1993,17,35-39,2010,6.967242570400515
STAT,1950,20,15-19,1970,7.292754588796828
STAT,1973,24,25-29,1997,138.22703849611898
STAT,1977,34,40-44,2011,6.211928154603767
SIM,1892,34,25-29,1926,19
SIM,1891,51,na,1942,3121
SIM,1835,33,40-44,1868,1
SIM,1797,67,na,1864,689
STAT,1865,54,50-100,1919,0.015293379669102273
STAT,1861,21,25-29,1882,56.83140712441647
STAT,1916,32,30-34,1948,18.773682715245677
STAT,1941,41,40-44,1982,0.3095080868305338
SIM,1967,20,35-39,1987,28
STAT,1857,23,25-29,1880,58.97300370647412
STAT,1919,23,45-49,1942,1.4171510778678407
STAT,1955,25,20-24,1980,28.110567103492176
STAT,1879,1,na,1880,4125.611392805445
SIM,1889,21,20-24,1910,155
SIM,1846,10,na,1856,2074
SIM,1879,23,50-100,1902,1
SIM,1917,34,40-44,1951,10
STAT,1928,68,na,1996,4449.78521531145
SIM,1907,97,na,2004,127
STAT,1881,42,na,1923,2569.540814221531
SIM,1847,37,40-44,1884,10
SIM,1837,82,na,1919,571
SIM,1975,37,50-100,2012,3
STAT,1873,24,20-24,1897,80.70426930016177
STAT,1917,44,40-44,1961,0.3002423408184021
STAT,1836,43,35-39,1879,1.936203187046123
SIM,1859,37,45-49,1896,2
SIM,1891,22,15-19,1913,4
SIM,1910,25,40-44,1935,12
STAT,1887,42,50-100,1929,1.3646513582878363
SIM,1949,15,45-49,1964,1
STAT,1987,23,45-49,2010,1.859231774324152
STAT,1851,32,20-24,1883,2.2310113996942214
SIM,1808,90,na,1898,17
SIM,1896,27,20-24,1923,32
STAT,1926,21,35-39,1947,13.238525501308212
SIM,1841,27,30-34,1868,4
STAT,1909,34,40-44,1943,4.277531167056928
STAT,1835,71,na,1906,831.9197152057919
STAT,1919,20,50-100,1939,0.8362721878371941
SIM,1905,32,50-100,1937,3
SIM,1957,31,30-34,1988,54
STAT,1858,35,35-39,1893,6.428126531061788
STAT,1956,37,30-34,1993,2.8673865687684814
STAT,1920,40,na,1960,4744.771598202991
SIM,1840,28,40-44,1868,2
STAT,1832,28,40-44,1860,2.802202843982467
STAT,1858,41,20-24,1899,0.14362408668473545
SIM,1889,33,15-19,1922,4
SIM,1910,82,na,1992,715
SIM,1892,36,50-100,1928,3
SIM,1853,34,na,1887,2382
STAT,1843,79,na,1922,701.4689020717353
STAT,1866,17,40-44,1883,0.20081311396585919
SIM,1824,35,30-34,1859,7
SIM,1868,41,30-34,1909,4
STAT,1888,49,30-34,1937,0.07252680146308739
STAT,1942,25,35-39,1967,18.203880815802265
SIM,1925,32,25-29,1957,23
STAT,1878,22,na,1900,2849.7784663961215
STAT,1900,42,50-100,1942,0.11733431683774095
STAT,1926,30,25-29,1956,12.909502352545237
STAT,1874,24,15-19,1898,3.873223027219088
SIM,1947,15,35-39,1962,14
STAT,1961,46,na,2007,5711.723652268247
SIM,1832,51,na,1883,1871
STAT,1843,38,45-49,1881,2.102979062608717
STAT,1922,26,20-24,1948,23.908719039373675
STAT,1899,49,40-44,1948,0.14949768374525355
SIM,1851,38,45-49,1889,8
SIM,1913,28,35-39,1941,22
SIM,1958,4,na,1962,6238
SIM,1960,20,25-29,1980,3
STAT,1951,22,na,1973,5035.0223979638195
SIM,1896,49,30-34,1945,1
SIM,1980,28,20-24,2008,52
STAT,1977,17,20-24,1994,211.40220941873372
STAT,1849,48,50-100,1897,0.18796491525913323
SIM,1834,30,20-24,1864,1
SIM,1941,27,35-39,1968,43
STAT,1839,49,35-39,1888,0.11026036598318571
SIM,1911,3,na,1914,5225
SIM,1893,22,25-29,1915,167
STAT,1854,31,na,1885,2011.6773046500637
STAT,1889,28,40-44,1917,4.246397031200935
STAT,1905,28,35-39,1933,16.06008935573816
SIM,1904,53,na,1957,3815
STAT,1933,27,35-39,1960,23.016046709810745
STAT,1823,39,30-34,1862,5.8723311091832855
SIM,1796,72,na,1868,648
STAT,1854,38,20-24,1892,0.6248933420436943
SIM,1858,22,30-34,1880,22
STAT,1972,28,20-24,2000,27.07570005042103
SIM,1835,36,45-49,1871,3
STAT,1863,48,15-19,1911,3.985719274584451E-4
STAT,1981,26,20-24,2007,29.59726760978517
STAT,1943,25,na,1968,4608.744139655855
STAT,1890,16,20-24,1906,25.06075911652302
SIM,1897,28,40-44,1925,10
STAT,1846,25,15-19,1871,0.5756464321429217
STAT,1885,22,25-29,1907,65.89595367932043
SIM,1950,25,35-39,1975,51
STAT,1837,27,15-19,1864,0.4216792187928659
SIM,1894,28,15-19,1922,1
STAT,1897,28,25-29,1925,65.04697899452938
STAT,1940,63,na,2003,4024.0464168373373
SIM,1885,66,na,1951,2179
SIM,1846,43,45-49,1889,4
SIM,1868,64,na,1932,2283
STAT,1911,26,45-49,1937,1.952666307334898
SIM,1850,25,30-34,1875,30
STAT,1907,73,na,1980,2710.130223655773
STAT,1875,27,35-39,1902,11.507267846435937
STAT,1989,16,30-34,2005,20.15359667964909
STAT,1966,37,35-39,2003,3.591898468453139
SIM,1894,31,30-34,1925,5
STAT,1900,19,45-49,1919,0.10404359039482224
STAT,1853,29,15-19,1882,0.4693816442264879
SIM,1915,37,35-39,1952,4
STAT,1886,63,na,1949,2172.0534516906796
STAT,1904,49,25-29,1953,0.0527207914263616
STAT,1952,20,25-29,1972,128.25475063259358
SIM,1909,39,25-29,1948,3
STAT,1886,28,15-19,1914,0.5503530735969427
SIM,1968,20,na,1988,4999
SIM,1916,46,40-44,1962,1
STAT,1800,84,na,1884,151.40973289626118
STAT,1843,37,40-44,1880,5.1276247926515595
SIM,1861,31,na,1892,1924
SIM,1871,17,15-19,1888,5
SIM,1884,37,45-49,1921,7
STAT,1838,43,45-49,1881,1.3623576476657715
STAT,1949,43,25-29,1992,0.09944650184806789
STAT,1827,36,45-49,1863,2.9955487598644712
SIM,1864,38,30-34,1902,2
STAT,1859,20,30-34,1879,18.94082742212719
SIM,1948,24,40-44,1972,1
STAT,1892,38,40-44,1930,6.300364801353094
STAT,1968,39,45-49,2007,1.01020493492563
SIM,1831,39,30-34,1870,6
SIM,1959,31,40-44,1990,1
STAT,1863,17,15-19,1880,6.833573566053875
SIM,1883,27,35-39,1910,3
SIM,1911,23,na,1934,5055
STAT,1917,32,25-29,1949,11.169718582715124
STAT,1839,48,30-34,1887,0.07722018019629555
STAT,1890,17,25-29,1907,7.990768253233031
STAT,1842,25,30-34,1867,24.311791312377427
SIM,1935,58,na,1993,5751
SIM,1974,37,35-39,2011,1
STAT,1862,48,50-100,1910,0.2361922710997174
SIM,1902,27,20-24,1929,2
SIM,1930,26,20-24,1956,49
SIM,1972,26,25-29,1998,8
SIM,1975,27,35-39,2002,30
SIM,1878,21,45-49,1899,2
SIM,1966,7,na,1973,5943
SIM,1845,31,35-39,1876,13
SIM,1851,37,40-44,1888,12
STAT,1875,15,40-44,1890,0.21914280999217506
STAT,1876,36,40-44,1912,5.247403349563648
SIM,1879,42,45-49,1921,4
STAT,1908,46,40-44,1954,0.16600157491425263
STAT,1964,26,25-29,1990,96.12774530206
STAT,1983,29,35-39,2012,24.591913135367946
STAT,1939,15,35-39,1954,4.861226351323515
SIM,1959,42,na,2001,5913
STAT,1785,101,na,1886,0.09382230797174013
SIM,1860,20,20-24,1880,122
STAT,1907,37,35-39,1944,2.5921756362243817
SIM,1884,36,40-44,1920,3
SIM,1836,32,na,1868,1678
STAT,1848,34,15-19,1882,0.15727534235166046
STAT,1849,43,20-24,1892,0.12220175245650057
SIM,1947,27,50-100,1974,2
STAT,1841,16,25-29,1857,6.5364967208665306
SIM,1959,27,20-24,1986,63
SIM,1942,36,40-44,1978,2
STAT,1841,98,na,1939,2.888245980335992
SIM,1870,27,15-19,1897,1
STAT,1852,23,25-29,1875,63.65577556620379
STAT,1827,39,15-19,1866,0.07777590176691039
STAT,1891,26,30-34,1917,36.04066045265333
STAT,1832,22,45-49,1854,1.0724294151915448
STAT,1905,34,20-24,1939,2.570305339041409
SIM,1914,25,25-29,1939,12
SIM,1943,59,na,2002,5027
STAT,1931,18,35-39,1949,6.323195888337986
SIM,1939,40,na,1979,4927
SIM,1901,18,15-19,1919,17
SIM,1787,90,na,1877,226
STAT,1921,29,30-34,1950,50.01753675495098
STAT,1939,45,30-34,1984,0.10766194934214383
STAT,1966,36,30-34,2002,2.7090274694245338
SIM,1904,36,20-24,1940,1
STAT,1906,25,25-29,1931,71.67079600739775
SIM,1854,61,na,1915,1973
STAT,1838,39,25-29,1877,2.948084451786841
STAT,1986,20,25-29,2006,152.4987450283845
STAT,2000,13,na,2013,6740.5455433233365
STAT,1839,15,30-34,1854,1.6731708188858387
SIM,1974,17,45-49,1991,1
SIM,1875,39,45-49,1914,10
STAT,1873,36,15-19,1909,0.06649609751388502
SIM,1932,18,na,1950,5226
SIM,1848,27,40-44,1875,1
STAT,1898,95,na,1993,175.53761716427698
STAT,1886,31,30-34,1917,21.340765545385132
STAT,1862,27,15-19,1889,0.4435045691519872
SIM,1913,34,20-24,1947,5
STAT,1915,23,25-29,1938,109.86900634165282
STAT,1930,39,25-29,1969,1.479167742004039
SIM,1840,22,45-49,1862,1
STAT,1842,26,35-39,1868,9.248644186491019
STAT,1911,19,20-24,1930,31.16786304531778
STAT,1887,37,20-24,1924,0.9969566059020157
SIM,1963,16,30-34,1979,29
STAT,1929,77,na,2006,3328.0086123415426
STAT,1841,20,45-49,1861,0.7967943144017482
STAT,1856,29,40-44,1885,2.6938889416687832
STAT,1934,36,40-44,1970,2.3873809589548354
STAT,1955,16,30-34,1971,18.6786313841745
SIM,1974,36,30-34,2010,3
STAT,1899,19,45-49,1918,0.10272561454800191
SIM,1921,55,na,1976,4967
SIM,1805,49,30-34,1854,1
STAT,1817,37,50-100,1854,5.524465403130283
STAT,1817,47,40-44,1864,0.4887498712463786
STAT,1826,30,20-24,1856,2.8751433714657995
SIM,1895,37,20-24,1932,2
SIM,1850,26,35-39,1876,23
SIM,1864,29,40-44,1893,8
STAT,1917,51,na,1968,4372.121915996292
STAT,1814,87,na,1901,109.85197713768578
STAT,1878,31,50-100,1909,1.1085469590719106
STAT,1920,17,20-24,1937,175.46412972641775
SIM,1822,42,50-100,1864,1
STAT,1840,17,na,1857,2384.121067523734
SIM,1923,23,25-29,1946,144
STAT,1931,24,20-24,1955,165.42760496542792
SIM,1943,55,na,1998,5154
SIM,1825,47,40-44,1872,1
SIM,1875,38,40-44,1913,17
STAT,1817,48,45-49,1865,0.6641673002704228
SIM,1984,25,35-39,2009,4
STAT,1916,35,35-39,1951,2.8859403299595785
STAT,1832,37,30-34,1869,4.683060799287839
STAT,1841,47,25-29,1888,0.05144375477344897
STAT,1977,37,45-49,2014,1.0951530848821172
STAT,1860,5,na,1865,2697.391613127551
SIM,1968,25,20-24,1993,50
STAT,1991,15,25-29,2006,71.70932386045732
SIM,1840,37,30-34,1877,10
STAT,1872,15,15-19,1887,6.981592415999917
STAT,1933,45,50-100,1978,0.3607973974912063
STAT,1971,20,50-100,1991,0.9656137005401728
STAT,1965,39,na,2004,5572.490046622413
SIM,1828,43,50-100,1871,4
STAT,1867,38,40-44,1905,4.693313750003947
SIM,1824,36,35-39,1860,20
SIM,1869,47,20-24,1916,1
SIM,1958,21,30-34,1979,99
STAT,1847,37,25-29,1884,2.298587269066601
SIM,1965,39,35-39,2004,5
STAT,1951,0,na,1951,6032.27874913283
SIM,1874,26,30-34,1900,73
STAT,1930,85,na,2015,1837.9284171255117
SIM,1924,35,35-39,1959,6
SIM,1893,63,na,1956,2394
STAT,1879,101,na,1980,10.918349645168455
SIM,1903,18,25-29,1921,25
STAT,1873,5,na,1878,3256.4525605895583
STAT,1945,47,na,1992,4817.354231417116
STAT,1897,32,45-49,1929,2.6909510006837594
SIM,1920,60,na,1980,3745
STAT,1903,92,na,1995,397.42315524982916
SIM,1819,41,35-39,1860,2
STAT,1836,30,50-100,1866,1.0764986774625196
STAT,1831,25,20-24,1856,12.407126293331956
STAT,1890,23,45-49,1913,0.980268816452127
STAT,1966,17,45-49,1983,0.7200511032445897
STAT,1867,39,45-49,1906,2.126340606888796
SIM,1896,18,30-34,1914,1
SIM,1905,38,na,1943,4171
SIM,1880,15,15-19,1895,13
SIM,1859,34,40-44,1893,6
STAT,1834,97,na,1931,4.902711488248754
SIM,1809,46,45-49,1855,1
STAT,1783,103,na,1886,0.040272251280527034
SIM,1934,30,25-29,1964,5
STAT,1976,25,35-39,2001,23.268213523526157
STAT,1888,18,30-34,1906,2.1565378297248072
SIM,1994,20,25-29,2014,151
STAT,1882,28,30-34,1910,28.2854984691633
STAT,1919,20,40-44,1939,4.273350568945594
SIM,1890,28,30-34,1918,8
STAT,1987,28,15-19,2015,1.1675225847922635
SIM,1825,48,45-49,1873,2
STAT,1857,32,15-19,1889,0.12878776583474405
STAT,1878,44,50-100,1922,1.255794767811898
STAT,1918,36,na,1954,4597.354339988216
SIM,1857,27,na,1884,2715
STAT,1816,38,35-39,1854,25.807112066984534
STAT,1849,30,na,1879,1985.935032823646
SIM,1884,39,45-49,1923,2
SIM,1940,36,30-34,1976,1
SIM,1872,27,25-29,1899,96
STAT,1966,23,30-34,1989,41.551545302356004
SIM,1883,33,20-24,1916,1
SIM,1869,32,35-39,1901,12
SIM,1966,43,na,2009,5830
STAT,1933,15,40-44,1948,2.1718177596357138
STAT,1907,34,30-34,1941,16.877082412535618
SIM,1797,57,na,1854,1172
STAT,1808,47,40-44,1855,0.8559096205445665
STAT,1905,96,na,2001,147.55648065780946
STAT,1923,29,40-44,1952,6.129353642919107
SIM,1979,24,15-19,2003,21
STAT,1917,47,45-49,1964,0.26198901478745523
STAT,1917,20,30-34,1937,35.46346518391574
STAT,1819,64,na,1883,1221.8758372064851
STAT,1859,32,25-29,1891,9.416074422845721
STAT,1864,27,25-29,1891,43.589142832495455
STAT,1927,18,na,1945,5266.593111068374
SIM,1869,59,na,1928,1568
SIM,1969,38,15-19,2007,2
STAT,1967,16,na,1983,5307.548703115317
SIM,1838,39,40-44,1877,9
SIM,1930,37,na,1967,6048
STAT,1875,33,20-24,1908,3.21005164567374
STAT,1966,16,50-100,1982,0.5401895805159864
SIM,1808,47,na,1855,1736
STAT,1831,27,20-24,1858,12.229599576897233
STAT,1928,20,40-44,1948,4.873585908887142
SIM,1915,34,30-34,1949,4
STAT,1932,36,30-34,1968,2.8293066019378244
SIM,1834,33,25-29,1867,20
SIM,1842,37,40-44,1879,6
SIM,1859,82,na,1941,53
SIM,1933,20,15-19,1953,7
SIM,1941,24,30-34,1965,68
STAT,1876,39,45-49,1915,2.3542520861845584
SIM,1934,17,15-19,1951,128
SIM,1973,27,25-29,2000,182
STAT,1865,39,35-39,1904,7.290599765926693
STAT,1953,19,25-29,1972,60.45779648347149
STAT,1941,22,15-19,1963,6.350097734719726
SIM,1863,12,na,1875,2953
SIM,1834,24,35-39,1858,7
STAT,1987,26,15-19,2013,1.16860913887184
SIM,1879,35,20-24,1914,2
STAT,1937,5,na,1942,4516.555458238157
SIM,1824,38,35-39,1862,7
SIM,1908,27,15-19,1935,5
STAT,1863,67,na,1930,1599.6594224368164
SIM,1925,20,30-34,1945,1
STAT,1880,15,na,1895,3103.7794893841624
SIM,1969,20,45-49,1989,1
STAT,1949,40,20-24,1989,0.024701593057272667
SIM,1846,64,na,1910,1020
STAT,1833,49,40-44,1882,0.12602850621699166
SIM,1937,26,30-34,1963,100
SIM,1883,6,na,1889,2828
STAT,1910,19,na,1929,4397.423339428353
SIM,1873,39,35-39,1912,1
SIM,1991,17,40-44,2008,2
SIM,1874,27,35-39,1901,29
STAT,1904,25,15-19,1929,0.7569855895095985
STAT,1983,17,40-44,2000,2.283468348208551
STAT,1895,19,50-100,1914,0.07320053101826261
STAT,1849,37,35-39,1886,5.609532331591564
SIM,1876,30,na,1906,2675
STAT,1897,25,20-24,1922,18.226017293602325
SIM,1936,20,40-44,1956,10
STAT,1925,20,15-19,1945,7.394861749838285
STAT,1933,24,30-34,1957,43.98626083518413
STAT,1875,18,45-49,1893,0.07769921336573761
STAT,1842,28,35-39,1870,9.116310445777573
STAT,1926,17,15-19,1943,64.2004604421842
SIM,1873,38,30-34,1911,15
STAT,1898,20,45-49,1918,1.0940879717663714
STAT,1983,26,30-34,2009,64.27280525631066
STAT,1912,74,na,1986,2815.1603823542673
SIM,1986,22,40-44,2008,9
STAT,1968,37,45-49,2005,1.0123601167926344
STAT,1880,28,20-24,1908,14.299881604322959
STAT,1904,23,na,1927,3907.2929887837345
SIM,1924,41,na,1965,4923
SIM,1947,21,20-24,1968,302
STAT,1900,16,40-44,1916,0.2936121981353186
SIM,1856,25,25-29,1881,59
SIM,1858,49,45-49,1907,2
SIM,1850,28,35-39,1878,9
STAT,1918,35,45-49,1953,0.8369335618628597
STAT,1943,16,50-100,1959,0.4586701588152389
SIM,1872,26,20-24,1898,19
SIM,1976,36,40-44,2012,1
SIM,1936,30,35-39,1966,1
STAT,1929,26,30-34,1955,56.62036603870416
SIM,1841,87,na,1928,149
STAT,1864,26,20-24,1890,12.13005997740198
SIM,1883,25,50-100,1908,1
STAT,1896,16,15-19,1912,9.068170276710998
STAT,1801,69,na,1870,792.904837626549
STAT,1826,33,25-29,1859,9.16686352057712
STAT,1875,25,50-100,1900,0.768069936226306
STAT,1887,39,20-24,1926,0.9869226811099104
STAT,1953,39,50-100,1992,0.6025838761047946
SIM,1857,37,35-39,1894,11
STAT,1865,38,30-34,1903,5.521929926062519
SIM,1833,46,na,1879,1530
SIM,1867,32,25-29,1899,24
STAT,1865,48,25-29,1913,0.059222744276463735
STAT,1939,21,20-24,1960,128.9691925048115
STAT,1974,21,15-19,1995,8.050817010276218
SIM,1868,44,35-39,1912,9
STAT,1943,37,45-49,1980,0.8595929450569385
STAT,1898,38,35-39,1936,2.3692415809184655
STAT,1928,21,45-49,1949,1.626108427523802
STAT,1952,17,na,1969,5090.37950348041
SIM,1899,25,na,1924,4186
STAT,1831,35,na,1866,2157.816160606288
STAT,1978,22,40-44,2000,5.313108529965613
STAT,1921,28,50-100,1949,1.2752305512380486
SIM,1973,34,50-100,2007,4
STAT,1844,26,50-100,1870,0.6597323001301142
SIM,1926,35,45-49,1961,2
STAT,1911,23,40-44,1934,3.6718369992347046
SIM,1951,16,50-100,1967,5
SIM,1948,33,30-34,1981,45
STAT,1859,23,35-39,1882,5.525974667739012
STAT,1968,36,40-44,2004,2.225069112770348
STAT,1956,57,na,2013,5579.199693688823
STAT,1899,91,na,1990,455.0160743258443
SIM,1941,15,40-44,1956,1
STAT,1942,40,na,1982,4668.530918907976
SIM,1848,37,50-100,1885,1
SIM,1931,29,40-44,1960,8
STAT,1837,31,35-39,1868,9.290378888368451
SIM,1884,81,na,1965,699
SIM,1866,20,15-19,1886,7
STAT,1985,27,na,2012,6175.466878166206
SIM,1935,29,25-29,1964,170
STAT,1830,49,15-19,1879,3.5957154790411253E-4
STAT,1899,16,40-44,1915,0.28989285527137376
SIM,1902,31,na,1933,4004
SIM,1929,29,na,1958,4914
STAT,1917,39,50-100,1956,0.5002236695673432
SIM,1914,22,20-24,1936,1
SIM,1861,26,45-49,1887,1
STAT,1900,25,30-34,1925,40.59875700955787
SIM,1962,37,20-24,1999,1
STAT,1944,22,40-44,1966,4.189801316323164
STAT,1837,25,15-19,1862,0.42780037808596916
SIM,1850,79,na,1929,27
STAT,1954,37,20-24,1991,0.3874580664142123
SIM,1880,45,na,1925,3201
STAT,1905,37,25-29,1942,1.0380208316859043
STAT,1852,20,20-24,1872,78.30365409896737
SIM,1847,49,na,1896,2278
SIM,1860,90,na,1950,201
SIM,1887,88,na,1975,759
STAT,1931,81,na,2012,2688.8902719121706
SIM,1905,45,50-100,1950,1
STAT,1877,26,na,1903,2874.72125461965
STAT,1882,19,40-44,1901,0.20506541777907933
STAT,1981,28,20-24,2009,29.569748543917875
STAT,1848,25,25-29,1873,54.43644628232105
STAT,1891,29,35-39,1920,13.66407930001985
STAT,1881,41,50-100,1922,1.1812883142749677
STAT,1927,29,25-29,1956,91.95286160593315
STAT,1831,28,25-29,1859,43.78102934899695
SIM,1865,78,na,1943,1019
STAT,1898,37,30-34,1935,8.312437617698798
STAT,1906,22,20-24,1928,115.97083741087562
SIM,1905,39,40-44,1944,3
STAT,1907,28,45-49,1935,1.8786304593742267
SIM,1868,28,20-24,1896,14
SIM,1997,16,30-34,2013,47
SIM,1949,17,na,1966,5271
STAT,1958,48,40-44,2006,0.2478792379802679
SIM,1846,36,20-24,1882,2
SIM,1952,22,40-44,1974,12
STAT,1863,9,na,1872,2805.399083293946
STAT,1867,36,40-44,1903,4.739410400601754
SIM,1913,37,25-29,1950,1
STAT,1830,50,na,1880,1458.3895796676397
SIM,1871,21,35-39,1892,13
SIM,1875,36,40-44,1911,8
STAT,2005,4,na,2009,6981.44592932772
SIM,1915,28,45-49,1943,5
STAT,1815,83,na,1898,220.28079403385595
STAT,1939,48,35-39,1987,0.15454916269866453
STAT,1853,26,45-49,1879,1.2898627831836875
STAT,1991,17,25-29,2008,71.67132293846396
SIM,1844,83,na,1927,277
STAT,1948,31,15-19,1979,0.17309222907108113
STAT,1838,36,20-24,1874,0.8142664581261444
SIM,1833,21,15-19,1854,8
SIM,1968,28,25-29,1996,183
STAT,1841,13,na,1854,2725.0
STAT,1862,29,15-19,1891,0.4387174407943786
SIM,1974,39,35-39,2013,1
SIM,1975,25,35-39,2000,55
SIM,1972,39,na,2011,5717
STAT,1811,47,na,1858,1550.7258010988796
STAT,1913,59,na,1972,3893.3563673702142
STAT,1906,49,35-39,1955,0.1301242828266867
STAT,1931,27,25-29,1958,98.08874080082705
STAT,1877,24,40-44,1901,2.485837930669294
STAT,1898,25,50-100,1923,1.0044844640773554
STAT,1863,21,35-39,1884,6.049431436754297
STAT,1886,34,35-39,1920,12.222244730694841
SIM,1945,24,15-19,1969,12
STAT,1906,16,35-39,1922,0.925674606316528
SIM,1894,34,35-39,1928,27
STAT,1977,21,40-44,1998,5.261970616189729
STAT,1850,49,na,1899,2267.7314903174033
SIM,1945,36,na,1981,4710
STAT,1857,8,na,1865,2594.176402142507
STAT,1809,98,na,1907,1.5098561129157777
STAT,1841,110,na,1951,2.4568947192895165E-4
STAT,1838,37,25-29,1875,3.0099488057883055
SIM,1914,16,35-39,1930,2
STAT,1891,28,30-34,1919,35.79097214099871
STAT,1981,29,25-29,2010,106.56860922366114
STAT,1846,53,50-100,1899,0.015362269379140385
SIM,1870,29,15-19,1899,3
STAT,1938,36,25-29,1974,1.1563990341665977
STAT,1921,38,20-24,1959,0.33921519713458687
SIM,1961,19,25-29,1980,151
SIM,1986,16,20-24,2002,424
STAT,1930,15,15-19,1945,68.03546210273876
STAT,1966,39,35-39,2005,3.584251787870881
STAT,1823,53,50-100,1876,0.014090337636758625
STAT,1864,33,45-49,1897,1.7893239429825436
STAT,1946,22,50-100,1968,0.8450081788018222
SIM,1827,50,na,1877,1349
STAT,1915,32,15-19,1947,0.15106513442362746
SIM,1954,22,50-100,1976,1
SIM,1948,32,na,1980,4310
SIM,1895,44,na,1939,3475
SIM,1869,20,40-44,1889,6
SIM,1879,37,na,1916,2753
SIM,1983,22,15-19,2005,21
STAT,1862,82,na,1944,454.41975134557316
STAT,1979,28,30-34,2007,62.49949676744855
STAT,1870,108,na,1978,0.07884495260344407
STAT,1937,24,15-19,1961,5.981447597769703
STAT,1821,39,20-24,1860,1.576227397918341
SIM,1846,37,25-29,1883,1
STAT,1828,48,20-24,1876,0.010905946397777576
STAT,1829,42,na,1871,1909.9265107253832
SIM,1904,27,30-34,1931,90
SIM,1933,70,na,2003,4970
STAT,1928,47,20-24,1975,0.016272424951167135
SIM,1907,19,na,1926,4641
STAT,1847,46,15-19,1893,3.0865533048314515E-4
STAT,1893,26,40-44,1919,4.384680202629416
STAT,1939,23,20-24,1962,128.88408688250342
STAT,1884,20,30-34,1904,20.431119700805553
STAT,1936,45,50-100,1981,0.26008671456138255
STAT,1919,25,45-49,1944,2.1683269603192636
STAT,1835,46,45-49,1881,0.15724107820886796
STAT,1829,86,na,1915,162.54190406668724
STAT,1855,44,20-24,1899,0.13330925504686658
SIM,1902,19,na,1921,4251
STAT,1875,48,40-44,1923,0.20160690285427746
STAT,1964,36,20-24,2000,0.39511037015945255
SIM,1883,22,30-34,1905,26
STAT,1881,54,50-100,1935,0.01634901005176664
STAT,1885,77,na,1962,1247.8087012967237
STAT,1898,35,30-34,1933,8.391381845000819
STAT,1891,23,25-29,1914,81.39815664509358
SIM,1837,36,20-24,1873,2
SIM,1974,31,25-29,2005,20
SIM,1813,48,na,1861,1352
SIM,1857,35,35-39,1892,2
STAT,1868,52,35-39,1920,0.009494630802908275
SIM,1852,26,45-49,1878,1
SIM,1892,28,40-44,1920,4
STAT,1858,33,35-39,1891,9.078780915218474
SIM,1890,25,25-29,1915,130
STAT,1806,49,30-34,1855,0.34511605174253474
SIM,1984,17,50-100,2001,1
SIM,1909,41,na,1950,4682
STAT,1870,31,40-44,1901,4.95415064882783
STAT,1842,16,40-44,1858,0.18181045825596162
SIM,1947,23,20-24,1970,4
STAT,1849,35,35-39,1884,5.727246087631996
STAT,1884,28,40-44,1912,3.4035818959698907
STAT,1873,34,15-19,1907,0.16638913933360713
STAT,1855,31,50-100,1886,0.8021092148469843
STAT,1912,45,30-34,1957,0.0994312158121259
STAT,1919,48,50-100,1967,0.28226041137134006
STAT,1846,46,20-24,1892,0.012440606845151412
STAT,1844,44,45-49,1888,1.2496424322349802
SIM,1928,24,na,1952,5065
STAT,1867,44,50-100,1911,1.122949572633025
STAT,1943,6,na,1949,4863.231694663393
STAT,1960,4,na,1964,5911.047285692385
STAT,1886,41,45-49,1927,1.8301203342051584
SIM,1880,78,na,1958,1109
SIM,1885,43,45-49,1928,5
STAT,1824,55,na,1879,1400.4366887227254
SIM,1800,73,na,1873,691
SIM,1953,15,45-49,1968,1
SIM,1938,25,20-24,1963,4
SIM,1866,38,40-44,1904,5
STAT,1798,85,na,1883,81.42380759868466
STAT,1877,43,45-49,1920,1.7836556204935348
STAT,1891,85,na,1976,921.5163339474072
SIM,1892,46,40-44,1938,1
STAT,1910,45,50-100,1955,0.24493329854319768
STAT,1832,31,20-24,1863,2.4826599362897506
STAT,1829,54,20-24,1883,6.358194753752009E-4
STAT,1987,16,20-24,2003,223.42291412763362
STAT,1835,28,45-49,1863,0.8982225213750723
SIM,1860,42,30-34,1902,3
STAT,1861,36,45-49,1897,1.921770827661527
STAT,1973,34,20-24,2007,3.7061231636176806
STAT,1989,26,25-29,2015,109.31956377826879
SIM,1953,25,50-100,1978,4
STAT,1851,29,40-44,1880,2.7415447426929407
SIM,1837,29,30-34,1866,57
SIM,1995,16,20-24,2011,422
STAT,1886,18,20-24,1904,21.524596332762513
SIM,1920,22,50-100,1942,2
STAT,1880,53,45-49,1933,0.017467152962912867
STAT,1959,53,na,2012,5645.84399388324
SIM,1889,36,40-44,1925,13
STAT,1859,54,35-39,1913,0.007696709309982479
STAT,1983,30,15-19,2013,0.21408555483917902
SIM,1866,33,35-39,1899,6
SIM,1868,10,na,1878,3406
STAT,1877,50,35-39,1927,0.010483215403688443
SIM,1892,20,30-34,1912,59
SIM,1959,16,na,1975,6010
STAT,1786,84,na,1870,181.32203710739012
STAT,1832,39,30-34,1871,4.581588116430592
STAT,1898,28,40-44,1926,4.655676213144176
STAT,1807,63,na,1870,1226.7393841602072
STAT,1865,29,40-44,1894,3.0968559557822224
STAT,1875,47,na,1922,2670.6408160078863
STAT,1882,25,25-29,1907,48.00629189035604
STAT,1818,36,45-49,1854,3.7069299157761266
SIM,1840,39,30-34,1879,12
STAT,1816,68,na,1884,862.734903133069
STAT,1858,99,na,1957,2.3546550948115033
STAT,1884,46,40-44,1930,0.19576005828198179
SIM,1946,53,na,1999,4422
STAT,1829,36,20-24,1865,0.9026628820362766
STAT,1884,36,50-100,1920,1.4066358504162757
SIM,1862,49,na,1911,2721
SIM,1967,22,35-39,1989,29
STAT,1894,42,35-39,1936,0.18632037251331596
STAT,1894,38,na,1932,3477.8483777447723
STAT,1959,22,35-39,1981,14.261016532841987
SIM,1826,36,45-49,1862,5
SIM,1873,33,25-29,1906,2
STAT,1812,54,na,1866,1197.1243918717025
STAT,1890,24,na,1914,3314.125117033448
STAT,1849,28,45-49,1877,1.0127895099800195
STAT,1985,21,35-39,2006,15.511373715778182
SIM,1910,2,na,1912,4165
SIM,1970,31,40-44,2001,3
STAT,1891,30,15-19,1921,0.2047513507333438
STAT,1838,52,20-24,1890,6.359105432450873E-4
STAT,1866,27,50-100,1893,0.6842545560219924
STAT,1956,15,20-24,1971,207.14367798903146
STAT,1929,43,50-100,1972,0.17530786438562249
SIM,1959,33,40-44,1992,17
STAT,1840,32,50-100,1872,0.8952414336212694
STAT,1860,27,40-44,1887,2.8160531531045523
SIM,1822,35,20-24,1857,3
SIM,1932,61,na,1993,4908
SIM,1847,39,40-44,1886,5
STAT,1848,41,25-29,1889,0.6902565716051084
SIM,1873,96,na,1969,13
SIM,1958,56,na,2014,5819
SIM,1849,46,40-44,1895,1
SIM,1873,30,20-24,1903,1
STAT,1888,43,20-24,1931,0.21388542191951845
STAT,1974,32,15-19,2006,0.1973890874394536
SIM,1833,24,40-44,1857,3
STAT,1844,51,35-39,1895,0.007235265000418175
SIM,1906,17,25-29,1923,13
STAT,1930,38,na,1968,5658.259427808912
SIM,1847,43,25-29,1890,4
STAT,1874,52,50-100,1926,0.0177481136822144
SIM,1968,0,na,1968,5404
STAT,1915,17,na,1932,4665.876702090781
SIM,1829,31,na,1860,1890
SIM,1847,7,na,1854,3189
STAT,1971,32,45-49,2003,2.3444852671571796
STAT,1904,77,na,1981,2199.2423622169345
STAT,1859,47,45-49,1906,0.21594445245532926
STAT,1903,37,50-100,1940,0.4355968320553792
STAT,1813,71,na,1884,698.937597299839
STAT,1835,53,35-39,1888,0.005367768500046275
STAT,1818,51,40-44,1869,0.012756199262918497
SIM,1894,18,20-24,1912,56
STAT,1870,16,45-49,1886,0.07547148405634836
STAT,1879,45,20-24,1924,0.014604389369976363
STAT,1825,39,40-44,1864,6.838484463169772
STAT,1840,35,15-19,1875,0.054397962251038455
STAT,1985,29,45-49,2014,2.8451204163267745
STAT,1983,23,25-29,2006,151.24580193561846
STAT,1900,63,na,1963,3071.175687946942
SIM,1806,66,na,1872,909
STAT,1903,47,30-34,1950,0.0893371512678002
STAT,1848,37,40-44,1885,4.793171653410955
SIM,1811,57,na,1868,1458
STAT,1820,34,35-39,1854,34.47453634571113
STAT,1928,30,35-39,1958,13.201436477395626
SIM,1967,39,45-49,2006,1
SIM,1833,39,40-44,1872,10
STAT,1882,32,15-19,1914,0.16052406617243986
SIM,1896,25,20-24,1921,34
SIM,1947,15,na,1962,5479
STAT,1837,48,20-24,1885,0.008905414030862941
STAT,1839,39,40-44,1878,4.063311731327594
STAT,1844,63,na,1907,1492.4324355236872
SIM,1991,23,25-29,2014,165
STAT,1848,19,40-44,1867,0.23808307930390424
STAT,1843,46,na,1889,2275.895219295545
STAT,1855,29,25-29,1884,36.98101439267672
SIM,1863,66,na,1929,1835
STAT,1880,20,45-49,1900,0.8580819424439879
STAT,1834,37,40-44,1871,4.9690673716133675
STAT,1891,38,25-29,1929,4.086282285945066
SIM,1830,48,na,1878,1670
STAT,1888,25,20-24,1913,16.022558618020895
SIM,1927,70,na,1997,3770
SIM,1961,40,30-34,2001,1
SIM,1976,20,35-39,1996,18
STAT,1839,46,30-34,1885,0.07922439474354732
STAT,1991,22,na,2013,6059.602772602821
STAT,1954,20,35-39,1974,13.487065821553426
SIM,1831,33,20-24,1864,6
SIM,1936,23,45-49,1959,1
SIM,1888,62,na,1950,1982
STAT,1928,23,45-49,1951,1.6162042903877798
SIM,1842,49,na,1891,1973
SIM,1963,20,50-100,1983,1
STAT,1876,52,40-44,1928,0.01249240382624035
SIM,1856,41,25-29,1897,1
SIM,1893,37,45-49,1930,4
STAT,1864,63,na,1927,1838.6212827215568
SIM,1879,8,na,1887,3110
SIM,1939,65,na,2004,4143
SIM,1843,66,na,1909,1272
STAT,1972,31,na,2003,5699.682406012687
SIM,1850,48,na,1898,1464
SIM,1898,49,40-44,1947,1
STAT,1797,68,na,1865,874.7965545898096
STAT,1844,26,45-49,1870,1.1450860533438396
STAT,1949,4,na,1953,5313.328501481396
SIM,1863,29,25-29,1892,5
STAT,1957,31,15-19,1988,0.19942232612723648
SIM,1932,49,na,1981,5311
SIM,1875,3,na,1878,3910
SIM,1817,38,45-49,1855,4
STAT,1852,50,na,1902,2059.2078845569886
STAT,1823,33,20-24,1856,6.743461713096415
STAT,1861,40,30-34,1901,1.1141296755300667
STAT,1896,47,15-19,1943,3.423260146934817E-4
STAT,1929,21,na,1950,5345.724563764943
SIM,1916,23,na,1939,4689
SIM,1993,21,35-39,2014,39
SIM,1850,53,25-29,1903,1
SIM,1792,69,na,1861,709
SIM,1962,20,35-39,1982,16
STAT,1845,36,50-100,1881,0.8783312238626467
SIM,1893,44,35-39,1937,1
STAT,1892,59,na,1951,2811.0932794748896
STAT,1948,12,na,1960,5187.79300308066
STAT,1885,44,35-39,1929,2.0563084243985124
SIM,1946,17,50-100,1963,1
STAT,1856,64,na,1920,1530.5364108358017
STAT,1857,49,50-100,1906,0.21613885424140616
STAT,1840,28,25-29,1868,42.00728022317478
STAT,1968,20,35-39,1988,13.626480640215533
STAT,1950,38,na,1988,5283.62498856868
SIM,1847,46,30-34,1893,1
SIM,1858,5,na,1863,3380
STAT,1829,39,25-29,1868,3.1685268049530837
SIM,1908,30,30-34,1938,26
STAT,1936,49,35-39,1985,0.14669845319554445
SIM,1883,25,35-39,1908,12
STAT,1885,50,40-44,1935,0.012292622408954538
STAT,1969,43,45-49,2012,0.2489494806904699
SIM,1938,28,25-29,1966,140
SIM,1870,17,20-24,1887,27
SIM,1857,70,na,1927,1381
STAT,1996,17,25-29,2013,72.6806579325295
SIM,1807,49,40-44,1856,1
SIM,1929,41,na,1970,5225
STAT,1912,64,na,1976,3611.845830954311
SIM,1841,37,25-29,1878,3
STAT,1939,26,25-29,1965,76.42825132564917
STAT,1898,103,na,2001,7.3152586729414
STAT,1835,43,40-44,1878,1.6605387587938614
STAT,1886,94,na,1980,155.14303137696965
SIM,1974,27,40-44,2001,10
SIM,1843,43,40-44,1886,7
STAT,1839,25,25-29,1864,42.875333269066516
SIM,1832,31,15-19,1863,1
STAT,1917,26,50-100,1943,1.2088062888114837
STAT,1862,17,20-24,1879,19.775209530670423
STAT,1960,15,50-100,1975,0.5634353935908679
STAT,1875,105,na,1980,1.003727780099043
SIM,1860,78,na,1938,1332
SIM,2001,6,na,2007,7322
STAT,1830,39,20-24,1869,0.7552670345412418
STAT,1840,25,20-24,1865,11.90446270263986
STAT,1891,19,40-44,1910,0.2594789221344205
STAT,1965,40,20-24,2005,0.02651605360079937
STAT,1846,49,25-29,1895,0.058302576462343644
STAT,1914,44,50-100,1958,0.1339584754032616
SIM,1938,20,15-19,1958,11
STAT,1878,39,20-24,1917,0.9194903044287982
STAT,1964,39,25-29,2003,1.4712946542846659
STAT,1885,37,45-49,1922,2.294721008203896
STAT,1882,22,20-24,1904,77.67919685084647
SIM,1925,26,50-100,1951,1
STAT,1964,30,45-49,1994,2.3340556589383086
STAT,1865,33,25-29,1898,10.620166907803275
STAT,1847,44,15-19,1891,0.010482601984431744
SIM,1855,37,25-29,1892,1
STAT,1975,28,na,2003,5725.29998309827
SIM,1904,22,na,1926,4017
STAT,1866,54,25-29,1920,0.003684567830869678
STAT,1894,17,45-49,1911,0.09690849695375542
STAT,1919,22,40-44,1941,4.248004554526732
STAT,1893,29,45-49,1922,1.6080440226233106
SIM,1839,45,40-44,1884,1
SIM,1890,22,20-24,1912,105
SIM,1927,22,40-44,1949,4
STAT,1890,32,20-24,1922,3.811637737452194
STAT,1875,25,35-39,1900,11.585336929944903
SIM,1982,25,25-29,2007,147
STAT,1894,35,45-49,1929,2.985502614973792
STAT,1859,30,50-100,1889,0.8545788607866613
SIM,1990,17,25-29,2007,162
SIM,1901,57,na,1958,3501
STAT,1856,105,na,1961,0.08112250566754868
STAT,1880,50,40-44,1930,0.013062915188021718
STAT,1836,27,20-24,1863,13.81990224613563
SIM,1972,39,25-29,2011,2
SIM,1859,61,na,1920,1571
SIM,1847,18,35-39,1865,1
SIM,1885,40,40-44,1925,5
SIM,1959,47,45-49,2006,1
STAT,1846,98,na,1944,3.35828372430141
STAT,1842,84,na,1926,255.992721321976
STAT,1810,83,na,1893,226.03935378400143
STAT,1815,42,25-29,1857,1.4350616161590073
STAT,1885,19,45-49,1904,0.07479009389983932
STAT,1857,81,na,1938,486.0449112694527
SIM,1867,30,50-100,1897,2
STAT,1910,47,20-24,1957,0.011911363849620913
SIM,1829,29,25-29,1858,78
STAT,1981,7,na,1988,6342.905495070493
STAT,1807,47,25-29,1854,0.239780808787304
STAT,1962,41,35-39,2003,0.30988506425150225
STAT,1791,75,na,1866,447.4131829197388
STAT,1831,49,50-100,1880,0.22179156214272835
STAT,1877,40,40-44,1917,2.727377068111068
STAT,1852,109,na,1961,0.002237845126183099
SIM,1844,52,na,1896,2076
SIM,1876,27,45-49,1903,3
STAT,1832,41,15-19,1873,0.011888872300525398
SIM,1832,24,25-29,1856,78
STAT,1944,42,na,1986,4793.6221787647155
SIM,1837,39,25-29,1876,6
STAT,1872,106,na,1978,0.4107507340442018
STAT,1831,45,na,1876,1941.927946076023
STAT,1861,11,na,1872,2644.478589990086
SIM,1894,58,na,1952,3177
STAT,1933,26,na,1959,5745.499202595968
STAT,1899,81,na,1980,1588.4421048839872
SIM,1924,20,15-19,1944,9
SIM,1844,27,20-24,1871,25
SIM,1822,38,25-29,1860,7
STAT,1824,31,15-19,1855,0.3381281420960446
STAT,1814,45,15-19,1859,0.0011487395080183337
STAT,1849,105,na,1954,0.022725520294392183
SIM,1944,49,35-39,1993,1
STAT,1839,43,25-29,1882,0.5299076311260451
STAT,1832,34,25-29,1866,9.093666049321765
SIM,1847,25,25-29,1872,72
SIM,1974,34,30-34,2008,37
STAT,1861,33,40-44,1894,4.1431190779607405
SIM,1967,8,na,1975,5779
SIM,1813,91,na,1904,24
STAT,1989,19,35-39,2008,6.931534183258103
STAT,1916,20,15-19,1936,6.476307878244596
SIM,1812,74,na,1886,318
SIM,1840,34,25-29,1874,16
SIM,1890,44,na,1934,3228
STAT,1966,34,30-34,2000,23.118855510008153
STAT,1845,17,na,1862,1955.0139252961526
STAT,1992,17,40-44,2009,2.3169510499188624
SIM,1873,29,40-44,1902,1
STAT,1964,46,15-19,2010,5.583165310744094E-4
SIM,1830,27,20-24,1857,23
STAT,1859,104,na,1963,0.2502961437119836
SIM,1850,49,40-44,1899,1
STAT,1874,93,na,1967,119.82691003744841
STAT,1916,34,na,1950,4468.074813833792
STAT,1866,36,25-29,1902,3.0945905227626995
STAT,1893,76,na,1969,1859.8119717423597
SIM,1900,83,na,1983,1136
STAT,1842,49,40-44,1891,0.12899203268928106
STAT,1892,44,25-29,1936,0.06362978063228086
STAT,1857,17,40-44,1874,0.1932210453180692
STAT,1864,42,20-24,1906,0.16344607407869935
STAT,1967,26,50-100,1993,1.4417143831417956
STAT,1875,22,30-34,1897,21.242847240472347
SIM,1984,23,35-39,2007,19
STAT,1829,29,30-34,1858,38.642355181741436
STAT,1857,38,na,1895,2107.074251200326
SIM,1827,42,45-49,1869,6
SIM,1857,25,40-44,1882,4
SIM,1850,23,30-34,1873,23
SIM,1872,79,na,1951,1027
SIM,1917,40,na,1957,5331
STAT,1912,20,na,1932,4249.880137452052
SIM,1959,36,45-49,1995,1
STAT,1926,20,30-34,1946,40.5281674372789
SIM,1874,36,25-29,1910,1
STAT,1863,38,20-24,1901,0.7740132028149619
STAT,1881,16,20-24,1897,19.782611638925484
STAT,1853,42,45-49,1895,1.488248845966109
STAT,1995,15,45-49,2010,0.8349435065588569
STAT,1939,51,na,1990,4359.822668886381
STAT,1835,25,40-44,1860,2.482857289601877
SIM,1860,38,45-49,1898,2
STAT,1863,46,na,1909,2276.7830962030525
SIM,1820,40,35-39,1860,4
STAT,1938,40,45-49,1978,0.19754060840382287
STAT,1855,26,20-24,1881,10.480066888513639
STAT,1888,46,25-29,1934,0.07836054643909093
STAT,1852,38,45-49,1890,1.8701637926782972
STAT,1956,18,25-29,1974,66.15491572393185
STAT,1868,45,45-49,1913,0.2642778888083886
STAT,1896,19,20-24,1915,26.8784332984488
STAT,1849,25,40-44,1874,2.7921880871245714
SIM,1962,2,na,1964,5600
STAT,1777,112,na,1889,5.952198127348139E-4
STAT,1965,1,na,1966,5673.06244427998
SIM,1960,50,na,2010,6032
SIM,1816,39,50-100,1855,4
STAT,1831,50,45-49,1881,0.012307819649638526
STAT,1861,43,35-39,1904,1.7247578970887374
STAT,1839,18,35-39,1857,0.5658913571248894
STAT,1850,21,15-19,1871,4.105737315035046
SIM,1964,18,25-29,1982,75
SIM,1824,33,30-34,1857,9
STAT,1997,4,na,2001,6627.195003000899
STAT,1809,53,40-44,1862,0.02492519372450663
STAT,1921,25,na,1946,4849.154630605553
SIM,1863,26,20-24,1889,17
STAT,1888,28,25-29,1916,57.1830376914467
STAT,1862,29,na,1891,2307.700037293878
STAT,1980,21,35-39,2001,15.139936285921209
STAT,1843,53,40-44,1896,0.010393638921150968
STAT,1860,22,35-39,1882,5.595111637843604
STAT,1881,19,25-29,1900,6.273972906801464
SIM,1886,39,20-24,1925,2
STAT,1985,26,40-44,2011,7.687112092225082
STAT,1857,35,40-44,1892,3.9719131309307976
SIM,1931,69,na,2000,4801
STAT,1891,106,na,1997,1.0062144994575266
STAT,1932,41,na,1973,5818.77571658952
STAT,1865,15,25-29,1880,6.76114094086164
SIM,1871,38,20-24,1909,1
SIM,1934,20,30-34,1954,105
STAT,1873,27,25-29,1900,49.85179522799049
STAT,1897,41,20-24,1938,0.01709515001944365
SIM,1930,84,na,2014,1680
SIM,1881,27,25-29,1908,3
STAT,1842,23,30-34,1865,17.164435106499646
STAT,1826,48,45-49,1874,0.16761280394606584
SIM,1839,27,40-44,1866,4
STAT,1971,2,na,1973,5751.98238932918
STAT,1811,68,na,1879,910.1680888059135
SIM,1834,22,35-39,1856,12
SIM,1930,58,na,1988,5624
STAT,1865,36,30-34,1901,5.576165054584889
SIM,1810,44,40-44,1854,5
STAT,1958,16,35-39,1974,6.362031574792539
SIM,1873,15,25-29,1888,18
SIM,1896,28,25-29,1924,5
STAT,1896,37,20-24,1933,1.1749942446861859
STAT,1819,42,45-49,1861,3.146783544794281
STAT,1993,21,40-44,2014,5.6031260406310945
STAT,1893,12,na,1905,3767.153936939148
STAT,1857,42,30-34,1899,1.032061879836412
STAT,1849,32,30-34,1881,14.25984865488471
STAT,1827,52,45-49,1879,0.017739149734139432
STAT,1927,50,na,1977,5272.80500392738
SIM,1874,29,35-39,1903,25
SIM,1863,19,30-34,1882,2
SIM,1857,32,30-34,1889,31
STAT,1852,45,35-39,1897,0.13330980306780155
STAT,1874,31,25-29,1905,12.15054931915851
SIM,1882,31,25-29,1913,3
STAT,1850,28,na,1878,2601.8822065934737
SIM,1949,21,30-34,1970,64
STAT,1992,5,na,1997,6512.973168322137
STAT,1855,19,30-34,1874,1.5941379649235548
STAT,1876,22,50-100,1898,0.48648533464955895
STAT,1835,50,30-34,1885,0.0039386250820651085
SIM,1874,2,na,1876,3800
STAT,1885,34,40-44,1919,4.9492947167525925
STAT,1862,31,35-39,1893,9.90338459077538
STAT,1883,28,25-29,1911,47.594085006686235
SIM,1872,42,50-100,1914,2
SIM,1839,84,na,1923,574
STAT,1841,28,40-44,1869,3.2842284645671262
SIM,1844,34,45-49,1878,4
STAT,1888,42,na,1930,3131.5089968394814
STAT,1997,17,20-24,2014,228.4693265774231
SIM,1898,37,50-100,1935,1
SIM,1891,61,na,1952,2607
STAT,1858,105,na,1963,0.11455520669632252
SIM,1943,21,35-39,1964,14
STAT,1848,47,35-39,1895,0.14806038093269544
STAT,1868,27,45-49,1895,1.231068156086684
SIM,1847,28,na,1875,2649
SIM,1843,14,na,1857,2345
SIM,1888,18,25-29,1906,14
SIM,1949,17,45-49,1966,1
STAT,1874,34,30-34,1908,20.45112844893388
SIM,1880,39,25-29,1919,8
SIM,1833,34,35-39,1867,3
SIM,1882,34,30-34,1916,37
SIM,1877,40,35-39,1917,3
SIM,1864,32,20-24,1896,5
SIM,1838,24,20-24,1862,6
SIM,1870,40,45-49,1910,1
SIM,1798,74,na,1872,616
STAT,1840,41,20-24,1881,0.13461042307709256
SIM,1891,0,na,1891,3797
STAT,1974,41,25-29,2015,0.1119919305603701
STAT,1829,54,50-100,1883,0.013013104747456242
SIM,1931,5,na,1936,6417
SIM,1828,45,na,1873,2205
SIM,1824,31,na,1855,1686
STAT,1873,105,na,1978,0.8671680795904191
STAT,1935,21,35-39,1956,14.810230000384568
STAT,1852,17,40-44,1869,0.20856382958977618
STAT,1986,28,20-24,2014,30.13189212307515
SIM,1988,18,30-34,2006,25
STAT,1836,34,45-49,1870,1.9654655843239264
STAT,1892,26,25-29,1918,61.396202702167635
STAT,1856,32,20-24,1888,2.409044099840496
SIM,1891,28,25-29,1919,119
STAT,1857,38,45-49,1895,1.7828799715726695
SIM,1829,44,20-24,1873,2
STAT,1928,35,na,1963,5496.473542823531
STAT,1963,48,20-24,2011,0.016806440430735405
STAT,1975,28,45-49,2003,2.6403357761806667
STAT,1895,26,15-19,1921,0.6838872085863426
SIM,1983,28,45-49,2011,5
STAT,1845,32,45-49,1877,1.3971789832635992
STAT,1947,18,na,1965,4783.300457165172
STAT,1952,47,25-29,1999,0.07630570212704878
SIM,1807,52,na,1859,1155
STAT,1928,1,na,1929,6072.459264022883
SIM,1863,31,50-100,1894,1
STAT,1883,20,15-19,1903,3.747127471380819
SIM,1853,32,45-49,1885,1
STAT,1979,32,15-19,2011,0.20813720873668942
STAT,1923,82,na,2005,2175.654154981044
SIM,1975,31,40-44,2006,1
SIM,1897,16,25-29,1913,12
SIM,1829,26,20-24,1855,1
SIM,1917,31,35-39,1948,26
STAT,1967,32,35-39,1999,13.428144445806797
STAT,1872,46,15-19,1918,4.6483651325912535E-4
STAT,1836,41,35-39,1877,1.9864564574224488
SIM,1941,68,na,2009,3355
SIM,1891,20,15-19,1911,2
STAT,1850,26,40-44,1876,3.655227096306531
STAT,1869,36,15-19,1905,0.06306086646503484
STAT,1843,69,na,1912,1472.5050997982798
SIM,1855,34,20-24,1889,3
STAT,1986,17,45-49,2003,0.8214416967905401
STAT,1859,44,40-44,1903,2.039858867439207
SIM,1911,37,50-100,1948,1
STAT,1969,36,20-24,2005,0.3918780684199485
STAT,1825,34,35-39,1859,18.47458046274447
STAT,1902,47,15-19,1949,3.6620840993752915E-4
STAT,1869,40,35-39,1909,2.0442012058347045
SIM,1818,44,45-49,1862,2
SIM,1946,5,na,1951,4720
STAT,1970,41,40-44,2011,0.37605619085987263
SIM,1983,5,na,1988,7028
STAT,1909,31,35-39,1940,10.116289309907126
STAT,1871,22,45-49,1893,0.8006132823337959
SIM,1927,38,na,1965,5000
STAT,1860,58,na,1918,1839.3805289225008
SIM,1812,47,50-100,1859,1
SIM,1877,58,na,1935,2504
STAT,1889,16,25-29,1905,8.081112472104254
SIM,1841,19,50-100,1860,1
SIM,1844,41,35-39,1885,1
SIM,1865,38,25-29,1903,1
STAT,1857,50,na,1907,1963.1010444402887
SIM,1870,6,na,1876,3501
STAT,1862,35,50-100,1897,1.2070945429290638
SIM,1838,44,na,1882,1647
STAT,1862,40,45-49,1902,1.4723343534506745
STAT,1872,39,25-29,1911,3.3028404585494715
SIM,1950,35,na,1985,4731
SIM,1907,17,40-44,1924,2
STAT,1963,33,na,1996,5648.7484113601295
STAT,1892,19,35-39,1911,0.7894154473776015
SIM,1853,8,na,1861,2855
STAT,1895,24,na,1919,3530.5161599063586
SIM,1912,34,50-100,1946,2
STAT,1860,40,15-19,1900,0.012974249081186582
SIM,1899,37,40-44,1936,2
SIM,1917,49,na,1966,5217
STAT,1852,2,na,1854,3415.0
SIM,1913,35,na,1948,4750
STAT,1964,18,na,1982,5348.341439587909
STAT,1850,18,50-100,1868,0.06126714783913156
STAT,1951,22,30-34,1973,39.62783093941564
STAT,1852,35,40-44,1887,4.236639564724749
STAT,1857,53,20-24,1910,6.526006359254111E-4
STAT,1932,17,25-29,1949,66.23798427199141
STAT,1826,77,na,1903,475.9391155331539
STAT,1814,97,na,1911,3.349692424008832
SIM,1903,37,30-34,1940,3
STAT,1889,34,25-29,1923,14.446064660286645
SIM,1988,25,20-24,2013,1
SIM,1902,95,na,1997,38
STAT,1872,43,45-49,1915,1.721781672947759
STAT,1841,35,30-34,1876,5.700009214433011
SIM,1880,43,45-49,1923,2
SIM,1890,13,na,1903,3751
STAT,1803,51,45-49,1854,0.05372612628147247
STAT,1891,10,na,1901,3694.6290699764536
STAT,1844,32,na,1876,2167.733122523368
SIM,1894,27,na,1921,3753
SIM,1924,76,na,2000,2773
SIM,1856,44,30-34,1900,4
SIM,1880,14,na,1894,3619
SIM,1928,20,35-39,1948,15
STAT,1873,40,20-24,1913,0.18904805384202164
STAT,1952,48,45-49,2000,0.31177227800542295
STAT,1861,15,40-44,1876,0.20408935213838994
STAT,1862,24,45-49,1886,0.6852845336100303
STAT,1902,11,na,1913,4217.395642353724
STAT,1941,44,45-49,1985,0.2049620416209922
SIM,1949,24,35-39,1973,29
SIM,1912,35,30-34,1947,1
STAT,1893,7,na,1900,3800.481362510457
STAT,1894,28,20-24,1922,17.34280558891062
STAT,1861,98,na,1959,5.687135216444406
SIM,1826,66,na,1892,1175
SIM,1979,27,20-24,2006,33
SIM,1988,22,na,2010,6585
STAT,1883,46,25-29,1929,0.06522036357208648
STAT,1889,49,25-29,1938,0.04525591905229687
STAT,1851,24,35-39,1875,5.447073615429112
SIM,1838,42,20-24,1880,3
STAT,1939,33,15-19,1972,0.1512820252812087
SIM,1897,34,25-29,1931,16
STAT,1904,35,30-34,1939,1.9244747661935666
STAT,1874,15,50-100,1889,0.05836726041760643
STAT,1895,102,na,1997,11.553484067235743
SIM,1989,17,na,2006,6739
STAT,1876,64,na,1940,2073.824827046108
STAT,1872,50,na,1922,2530.9510434338317
STAT,1930,25,30-34,1955,57.55492645737519
STAT,1909,21,na,1930,4110.100766807344
SIM,1839,48,45-49,1887,1
STAT,1847,49,40-44,1896,0.12898015080383832
SIM,1968,38,20-24,2006,1
STAT,1833,22,25-29,1855,61.88165888190338
STAT,1955,20,50-100,1975,1.0120870090060596
SIM,1912,61,na,1973,3322
SIM,1861,42,45-49,1903,1
SIM,1917,38,50-100,1955,1
SIM,1916,54,na,1970,4314
STAT,1897,47,30-34,1944,0.0838673143622195
SIM,1912,40,na,1952,3700
STAT,1998,5,na,2003,6662.299792397313
STAT,1802,54,35-39,1856,0.03291480588021487
SIM,1947,26,25-29,1973,112
STAT,1982,33,50-100,2015,1.3677458463632024
STAT,1889,41,15-19,1930,0.019734330166507632
STAT,1965,23,15-19,1988,7.692234967259532
SIM,1873,32,na,1905,3396
STAT,1851,17,45-49,1868,0.06297981476835277
STAT,1852,42,30-34,1894,1.0825881664770762
STAT,1883,26,50-100,1909,0.724750387585641
SIM,1968,42,40-44,2010,1
STAT,1868,38,20-24,1906,0.8504530164936294
SIM,1848,31,25-29,1879,1
STAT,1937,74,na,2011,2956.0661779871566
SIM,1767,90,na,1857,63
SIM,1978,27,25-29,2005,116
STAT,1833,37,25-29,1870,2.5531681054580035
SIM,1841,22,25-29,1863,121
SIM,1862,81,na,1943,853
SIM,1848,39,35-39,1887,2
SIM,1858,44,na,1902,2476
SIM,1860,35,40-44,1895,15
STAT,1867,80,na,1947,666.5303447356026
SIM,1893,32,na,1925,3385
STAT,1790,89,na,1879,39.275032487928115
SIM,1940,17,25-29,1957,67
STAT,1975,32,30-34,2007,24.450239230970276
SIM,1888,15,20-24,1903,51
SIM,1963,22,15-19,1985,16
STAT,1895,49,20-24,1944,0.009956029771831899
STAT,1848,44,30-34,1892,1.2050656608322952
STAT,1926,79,na,2005,2836.0010945663867
STAT,1975,25,40-44,2000,7.133170708164924
STAT,1858,30,30-34,1888,16.048590462419543
STAT,1879,27,20-24,1906,14.136620299210726
STAT,1850,19,30-34,1869,1.981484853330787
STAT,1866,21,25-29,1887,62.179876900169795
SIM,1939,20,30-34,1959,46
STAT,1855,47,na,1902,1905.45455082961
SIM,1831,34,na,1865,1745
SIM,1864,35,25-29,1899,4
STAT,1965,39,40-44,2004,2.217305738980271
SIM,1838,27,25-29,1865,85
STAT,1920,39,na,1959,4741.5696048912
SIM,1978,31,45-49,2009,2
SIM,1844,31,40-44,1875,1
STAT,1856,35,25-29,1891,2.559062157515048
SIM,1790,78,na,1868,125
STAT,1967,40,na,2007,5579.3785893402965
SIM,1965,25,30-34,1990,16
STAT,1820,40,40-44,1860,2.947454442014407
SIM,1895,18,15-19,1913,9
STAT,1823,43,15-19,1866,0.014222216690497216
SIM,1903,36,na,1939,3843
STAT,1993,8,na,2001,6525.5237081982705
STAT,1812,85,na,1897,120.35415690717637
SIM,1869,91,na,1960,11
SIM,1983,25,40-44,2008,21
SIM,1891,25,20-24,1916,28
SIM,1968,45,45-49,2013,2
STAT,1887,18,15-19,1905,7.6551818288137055
SIM,1853,35,15-19,1888,5
STAT,1984,19,35-39,2003,6.873140111280465
STAT,1847,53,25-29,1900,0.00268165773371996
STAT,1958,31,30-34,1989,24.35623914149717
SIM,1973,39,40-44,2012,6
SIM,1833,31,30-34,1864,34
SIM,1882,37,35-39,1919,17
SIM,1885,97,na,1982,111
SIM,1887,27,20-24,1914,1
STAT,1834,43,25-29,1877,0.6974840760648048
STAT,1883,25,20-24,1908,13.335755630987832
SIM,1907,24,30-34,1931,75
SIM,1966,31,30-34,1997,46
SIM,1977,14,na,1991,6240
STAT,1860,33,25-29,1893,9.48653209027713
STAT,1943,56,na,1999,4502.616736324136
STAT,1895,23,45-49,1918,1.0442740618780286
STAT,1861,29,20-24,1890,11.174795810957944
SIM,1992,19,35-39,2011,19
STAT,1884,23,35-39,1907,6.633176792371209
STAT,1836,31,40-44,1867,5.042583039203176
SIM,1903,9,na,1912,4251
SIM,1966,29,na,1995,5412
STAT,1980,30,45-49,2010,2.572621051846005
SIM,1818,41,40-44,1859,6
SIM,1874,21,25-29,1895,147
SIM,1962,15,na,1977,4870
STAT,1965,16,25-29,1981,62.453097583622274
STAT,1933,30,15-19,1963,0.20016849360630917
SIM,1833,38,50-100,1871,4
SIM,1880,36,20-24,1916,1
STAT,1884,50,25-29,1934,0.004096714920524622
SIM,1973,16,25-29,1989,146
SIM,1870,35,50-100,1905,6
STAT,1874,37,35-39,1911,8.356283527670096
STAT,1955,22,15-19,1977,8.182134362721875
SIM,1939,28,40-44,1967,14
STAT,1825,31,30-34,1856,39.45142040926899
STAT,1925,32,30-34,1957,21.584307523249244
SIM,1875,42,25-29,1917,5
SIM,1864,17,25-29,1881,9
SIM,1877,79,na,1956,917
STAT,1872,18,20-24,1890,20.490036394448826
STAT,1872,36,20-24,1908,0.8975607073467546
STAT,1850,59,na,1909,2000.6914717056882
STAT,1884,49,45-49,1933,0.263473713895406
SIM,1860,14,na,1874,2920
SIM,1978,30,50-100,2008,3
STAT,1883,43,20-24,1926,0.17801924073108769
STAT,1895,43,50-100,1938,0.10940799794900131
STAT,1850,29,45-49,1879,1.3258331975573756
STAT,1826,45,40-44,1871,0.1264396681030968
SIM,1926,53,na,1979,5610
SIM,1888,33,20-24,1921,2
SIM,1856,37,40-44,1893,5
SIM,1986,24,50-100,2010,1
STAT,1917,20,na,1937,4505.907521999208
SIM,1967,15,na,1982,5076
STAT,1866,29,35-39,1895,10.247324064031545
STAT,1836,50,45-49,1886,0.013908293836732942
SIM,1984,20,30-34,2004,1
SIM,1803,90,na,1893,26
SIM,1889,31,50-100,1920,2
SIM,1889,43,30-34,1932,1
STAT,1969,39,25-29,2008,1.4592583509387218
SIM,1886,83,na,1969,114
STAT,1856,17,25-29,1873,5.899482415379979
SIM,1866,30,30-34,1896,43
SIM,1832,29,30-34,1861,64
SIM,1920,28,na,1948,4358
STAT,1858,38,40-44,1896,3.9214571078189446
STAT,1826,52,30-34,1878,0.004138189578399433
STAT,1873,76,na,1949,1116.5055930150234
STAT,1819,45,15-19,1864,7.928727091967735E-4
STAT,1976,28,40-44,2004,7.2139995888887976
SIM,1842,25,25-29,1867,84
SIM,1933,32,30-34,1965,41
STAT,1851,47,40-44,1898,0.13512779113857118
STAT,1907,40,50-100,1947,0.12582406296327234
STAT,1964,9,na,1973,5711.807780069242
STAT,1853,24,50-100,1877,0.47284675705373264
STAT,1873,43,25-29,1916,0.7513087700868496
STAT,1935,38,na,1973,6068.305718417034
STAT,1957,25,30-34,1982,59.928725013643046
SIM,1873,65,na,1938,2353
SIM,1937,49,na,1986,4227
STAT,1823,70,na,1893,794.543855740221
STAT,1859,51,30-34,1910,0.005498389228310882
STAT,1834,25,25-29,1859,51.35503896800181
STAT,1850,30,25-29,1880,12.37556630242284
STAT,1931,24,na,1955,5432.887475091191
STAT,1851,51,25-29,1902,0.0028222369338144543
SIM,1984,28,40-44,2012,18
STAT,1824,40,25-29,1864,0.94514335288269
STAT,1828,44,50-100,1872,0.9844404296951331
STAT,1851,21,30-34,1872,16.99005138962454
STAT,1846,28,20-24,1874,14.566254729546522
STAT,1977,27,50-100,2004,1.5587526469430137
SIM,1836,44,50-100,1880,2
STAT,1850,109,na,1959,0.001609617767516761
SIM,1991,11,na,2002,6710
STAT,1953,38,30-34,1991,2.6187232918741494
STAT,1860,26,50-100,1886,0.6057074642626007
SIM,1908,27,50-100,1935,3
SIM,1887,24,na,1911,3810
STAT,1848,23,50-100,1871,0.5237852621984282
SIM,1843,39,20-24,1882,2
SIM,1893,41,30-34,1934,6
STAT,1808,50,50-100,1858,0.07493845895391614
STAT,1863,54,20-24,1917,7.241647882318377E-4
SIM,1961,38,30-34,1999,3
SIM,1823,38,40-44,1861,4
STAT,1961,25,50-100,1986,1.491778883934724
STAT,1846,53,45-49,1899,0.014761789818531788
STAT,1883,18,30-34,1901,1.7949106751180777
SIM,1909,10,na,1919,5106
STAT,1854,19,15-19,1873,5.715716078614838
STAT,1900,40,na,1940,3751.3734523120334
SIM,1856,47,35-39,1903,1
STAT,1957,18,40-44,1975,2.127557666220979
SIM,1961,19,na,1980,4955
STAT,1885,41,30-34,1926,1.329381792956564
STAT,1975,35,35-39,2010,3.8004241458375034
SIM,1857,58,na,1915,2068
STAT,1983,15,30-34,1998,19.909345371949772
SIM,1867,44,40-44,1911,1
SIM,1891,18,30-34,1909,2
STAT,1875,24,na,1899,2802.889021341923
STAT,1978,21,35-39,1999,14.88369433859354
STAT,1904,38,35-39,1942,2.5174085729054982
STAT,1879,48,25-29,1927,0.0685369593082424
STAT,1894,46,50-100,1940,0.2061113515175349
SIM,1854,28,20-24,1882,13
STAT,1847,50,20-24,1897,5.759547398089992E-4
SIM,1839,29,na,1868,2298
STAT,1907,15,25-29,1922,9.666666505235817
STAT,1861,18,45-49,1879,0.07160865846079206
STAT,1969,30,45-49,1999,2.314961317872442
SIM,1870,31,35-39,1901,4
STAT,1893,32,25-29,1925,14.941076820088645
STAT,1902,27,50-100,1929,1.043100328714748
STAT,1941,31,50-100,1972,1.0026223586617058
STAT,1869,33,45-49,1902,1.9406857733976277
SIM,1978,24,20-24,2002,4
SIM,1808,78,na,1886,482
STAT,1871,10,na,1881,3069.356428927152
STAT,1871,25,15-19,1896,0.5244418576084495
STAT,1874,27,40-44,1901,3.5391006937529186
STAT,1941,46,50-100,1987,0.280417199749263
SIM,1882,27,40-44,1909,6
SIM,1877,33,45-49,1910,4
STAT,1815,45,30-34,1860,0.20359370589723091
STAT,1927,75,na,2002,3528.020631812074
SIM,1824,52,na,1876,1328
STAT,1930,28,35-39,1958,22.023516727244587
SIM,1815,53,50-100,1868,1
STAT,1927,48,30-34,1975,0.12875106753519094
STAT,1945,15,45-49,1960,0.6300846712208275
STAT,1962,22,50-100,1984,0.9761791099717348
STAT,1854,21,50-100,1875,0.39317642905809086
SIM,1831,36,25-29,1867,5
SIM,1854,49,25-29,1903,1
SIM,1852,70,na,1922,1199
SIM,1859,6,na,1865,2705
STAT,1885,16,40-44,1901,0.21105849755230574
STAT,1773,89,na,1862,66.24892323027403
STAT,1807,53,50-100,1860,0.05812453932270901
STAT,1973,37,25-29,2010,1.514020888113511
SIM,1912,38,35-39,1950,9
STAT,1856,42,15-19,1898,0.01214388497173054
STAT,1828,29,15-19,1857,0.5975720817634538
STAT,1920,39,30-34,1959,2.297020023839965
SIM,1942,64,na,2006,4325
SIM,1982,22,20-24,2004,8
STAT,1929,32,15-19,1961,0.18838307875779162
SIM,1909,7,na,1916,5138
STAT,1944,67,na,2011,3987.7941795565057
STAT,1907,40,15-19,1947,0.0016447591131722968
SIM,1970,22,50-100,1992,1
STAT,1845,35,15-19,1880,0.04460711964555294
SIM,1828,38,20-24,1866,1
STAT,1814,51,20-24,1865,0.0020012409762360647
STAT,1908,90,na,1998,627.0559762427453
STAT,1952,44,20-24,1996,0.02529756906461956
SIM,1893,34,40-44,1927,15
SIM,1935,48,30-34,1983,1
STAT,1842,29,na,1871,2029.1836676875457
SIM,1857,20,50-100,1877,1
STAT,1787,70,na,1857,518.6183982203202
STAT,1823,36,25-29,1859,5.885275977263373
SIM,1915,22,15-19,1937,1
STAT,1835,39,20-24,1874,0.5825911853894349
STAT,1808,53,25-29,1861,0.016547166177302747
STAT,1889,82,na,1971,1194.443818329777
STAT,1919,18,20-24,1937,172.40782722056522
STAT,1901,25,na,1926,3883.946024580073
STAT,1969,6,na,1975,5667.290827962755
STAT,1813,47,20-24,1860,0.03980515295689623
STAT,1862,21,40-44,1883,2.092590035907739
STAT,1901,80,na,1981,1767.904444536171
SIM,1892,79,na,1971,1785
STAT,1907,22,15-19,1929,5.601659296576969
STAT,1832,85,na,1917,186.76513824133553
SIM,1915,8,na,1923,5059
SIM,1927,18,20-24,1945,196
SIM,1870,21,40-44,1891,3
SIM,1869,28,15-19,1897,1
STAT,1895,30,35-39,1925,15.335079916464135
STAT,1965,46,30-34,2011,0.1339266843530765
SIM,1963,32,na,1995,6507
STAT,1860,80,na,1940,575.3617623061547
SIM,1890,37,40-44,1927,11
STAT,1934,33,35-39,1967,14.397216136792158
STAT,1879,52,45-49,1931,0.017394636736051402
STAT,1909,49,25-29,1958,0.05598462159221937
STAT,1807,47,45-49,1854,0.9824352667699395
STAT,1834,40,20-24,1874,0.1792550372960632
STAT,1858,76,na,1934,852.934245176626
STAT,1826,67,na,1893,872.8297405287175
STAT,1980,6,na,1986,6298.071409828251
SIM,1965,28,35-39,1993,1
STAT,1915,38,na,1953,4365.08500065476
STAT,1921,31,15-19,1952,0.1656485571089415
SIM,1857,79,na,1936,625
STAT,1912,99,na,2011,58.016271789045554
STAT,1857,35,20-24,1892,0.6994272645610248
SIM,1917,49,25-29,1966,1
SIM,1850,41,50-100,1891,5
STAT,1923,45,40-44,1968,0.2137729344079018
STAT,1858,33,50-100,1891,0.8214020360869598
STAT,1807,84,na,1891,162.67363518110403
STAT,1913,47,50-100,1960,0.2549035763526356
STAT,1922,25,50-100,1947,1.308050056353877
STAT,1873,46,30-34,1919,0.11440170592234924
STAT,1824,46,35-39,1870,0.19270787719345872
STAT,1935,46,15-19,1981,6.019810962468266E-4
STAT,1957,28,35-39,1985,22.93185586394372
SIM,1839,38,30-34,1877,11
STAT,1912,33,15-19,1945,0.14544977977501375
STAT,1884,16,25-29,1900,6.477191818677358
SIM,1809,95,na,1904,8
SIM,1839,30,na,1869,2319
STAT,1944,37,25-29,1981,1.259856978893286
SIM,1783,75,na,1858,707
STAT,1847,39,na,1886,1842.2199363803882
STAT,1882,37,40-44,1919,4.934386834819032
SIM,1932,40,na,1972,5469
STAT,1940,44,30-34,1984,0.15521231201569477
SIM,1942,33,35-39,1975,20
STAT,1846,20,45-49,1866,0.9023761588956323
STAT,1943,31,35-39,1974,11.407209798555344
STAT,1891,35,40-44,1926,6.3030091295476645
SIM,1891,29,na,1920,3200
STAT,1968,40,25-29,2008,0.10726572930266627
STAT,1869,15,45-49,1884,0.07489558390156456
STAT,1827,84,na,1911,270.16256177505136
STAT,1841,34,na,1875,2289.832940882998
SIM,1888,31,na,1919,2822
SIM,1901,88,na,1989,1136
STAT,1923,4,na,1927,5467.533450956374
STAT,1966,43,40-44,2009,0.3740894307606377
SIM,1943,39,25-29,1982,3
SIM,1841,44,35-39,1885,7
SIM,1926,23,50-100,1949,1
STAT,1914,47,40-44,1961,0.18053694640270485
STAT,1833,37,45-49,1870,1.7677520372473703
STAT,1969,46,15-19,2015,5.5374907946878E-4
STAT,1823,40,45-49,1863,1.6307294882970973
STAT,1847,39,50-100,1886,0.960014479603767
STAT,1900,94,na,1994,238.60009560480188
STAT,1902,75,na,1977,2340.505186296418
STAT,1882,44,30-34,1926,1.2784307466465235
STAT,1860,30,20-24,1890,2.5343473276492365
STAT,1960,23,35-39,1983,14.19493848300575
STAT,1784,72,na,1856,557.6120522225999
SIM,1900,15,30-34,1915,2
STAT,1958,8,na,1966,5957.014283575346
STAT,1769,95,na,1864,3.5819921783776243
STAT,1856,47,40-44,1903,0.15003019177855884
SIM,1864,47,40-44,1911,1
STAT,1979,17,na,1996,5848.65950559109
SIM,1828,30,45-49,1858,1
STAT,1866,43,35-39,1909,1.9229662971099546
SIM,1951,31,35-39,1982,6
SIM,1963,22,na,1985,5757
SIM,1922,47,40-44,1969,1
STAT,1980,23,20-24,2003,178.67292322051006
SIM,1901,78,na,1979,2077
STAT,1833,44,35-39,1877,1.5154723223268145
STAT,1851,17,25-29,1868,5.46350003384321
STAT,1809,49,20-24,1858,0.029691719300809945
STAT,1892,26,na,1918,3463.7953423658964
STAT,1960,30,25-29,1990,14.176863701270126
SIM,1890,44,30-34,1934,4
SIM,1907,27,35-39,1934,6
STAT,1917,29,na,1946,4501.561758962466
STAT,1932,43,40-44,1975,0.3906987685108519
STAT,1880,49,25-29,1929,0.06898757086496494
STAT,1902,37,20-24,1939,0.2713054544891237
SIM,1829,40,50-100,1869,3
STAT,1886,32,50-100,1918,1.1153559259608488
STAT,1877,59,na,1936,2333.021671455117
SIM,2000,5,na,2005,6491
SIM,1841,37,45-49,1878,5
STAT,1816,47,na,1863,1470.7884088950889
STAT,1872,40,40-44,1912,2.632765987524132
STAT,1822,43,50-100,1865,2.101711970424848
STAT,1888,11,na,1899,3508.594082631896
SIM,1920,26,25-29,1946,5
STAT,1809,65,na,1874,965.4979014014549
STAT,1860,15,25-29,1875,6.151021157970099
STAT,1875,78,na,1953,931.813803789255
STAT,1848,38,50-100,1886,1.330437070097571
STAT,1976,24,na,2000,5645.111732702555
STAT,1912,26,25-29,1938,75.18391273991894
STAT,1891,42,30-34,1933,1.6377738476225423
SIM,1842,18,35-39,1860,2
SIM,1880,40,40-44,1920,4
SIM,1875,13,na,1888,3511
STAT,1844,37,20-24,1881,0.6813292509223642
STAT,1889,49,45-49,1938,0.18542355884077827
STAT,1934,42,50-100,1976,0.1888182025909117
STAT,1978,37,25-29,2015,1.5976310941085055
SIM,1842,81,na,1923,627
STAT,1854,47,50-100,1901,0.19915675085725243
STAT,1814,54,25-29,1868,0.009045895183180856
STAT,1840,47,30-34,1887,0.0783069616706337
STAT,1953,42,15-19,1995,0.00222801554598146
SIM,1799,70,na,1869,476
SIM,1879,17,20-24,1896,19
SIM,1888,41,na,1929,2697
STAT,1877,46,15-19,1923,4.81540878563186E-4
STAT,1945,18,15-19,1963,57.19456095473012
SIM,1858,45,50-100,1903,1
SIM,1791,74,na,1865,505
SIM,1877,30,40-44,1907,5
SIM,1923,81,na,2004,2694
STAT,1867,42,25-29,1909,0.6910649100088395
STAT,1865,45,40-44,1910,0.18004024525074258
STAT,1956,20,na,1976,5598.859466700631
STAT,1906,8,na,1914,4374.700971383844
SIM,1947,38,na,1985,5965
STAT,1895,78,na,1973,1767.831804107711
SIM,1878,36,45-49,1914,4
STAT,1846,16,50-100,1862,0.0639997276739477
SIM,1953,18,15-19,1971,107
STAT,1856,54,30-34,1910,0.005096796121935236
STAT,1843,15,na,1858,2978.3163469924543
SIM,1975,27,na,2002,5867
STAT,1828,48,na,1876,1633.7217153242532
STAT,1824,32,na,1856,1796.7718721813208
STAT,1857,28,30-34,1885,23.14573747692584
SIM,1865,28,30-34,1893,29
SIM,1956,47,40-44,2003,1
SIM,1874,27,na,1901,2482
STAT,1958,15,50-100,1973,0.5681804733379365
STAT,1915,17,50-100,1932,0.0905089921597439
STAT,1872,81,na,1953,626.6391018521729
STAT,1957,45,40-44,2002,0.2507008341304208
STAT,1850,36,35-39,1886,7.473695978012062
SIM,1837,17,15-19,1854,5
STAT,1853,108,na,1961,0.006467357264426108
STAT,1934,48,20-24,1982,0.017728044332474217
STAT,1765,102,na,1867,0.0070485530816732055
SIM,1833,27,25-29,1860,5
SIM,1883,18,25-29,1901,9
SIM,1906,21,30-34,1927,80
STAT,1818,47,20-24,1865,0.014810951045650257
SIM,1841,41,30-34,1882,3
STAT,1908,43,35-39,1951,0.2139841605269772
STAT,1859,26,40-44,1885,2.8216292366037785
STAT,1808,50,20-24,1858,0.0036614883674719466
STAT,1941,70,na,2011,3561.21885230261
STAT,1821,34,15-19,1855,0.40207060531207606
STAT,1990,15,30-34,2005,20.15522808509235
SIM,1828,78,na,1906,775
STAT,1907,44,45-49,1951,0.17408809410950643
STAT,1807,51,30-34,1858,0.02385824171977265
STAT,1944,44,15-19,1988,0.0019755361481938742
STAT,1860,48,45-49,1908,0.2167475460390932
STAT,1924,44,30-34,1968,0.17486188448942677
STAT,1934,40,25-29,1974,0.11509042942344774
SIM,1860,1,na,1861,3516
SIM,1943,15,50-100,1958,1
STAT,1800,105,na,1905,0.01582104630703369
STAT,1918,47,25-29,1965,0.06513039579730003
STAT,1909,38,50-100,1947,0.4568624873715068
STAT,1824,39,45-49,1863,2.9223109828933373
STAT,1933,41,35-39,1974,0.31989022417810625
SIM,1815,44,40-44,1859,4
SIM,1987,18,15-19,2005,1
STAT,1947,49,45-49,1996,0.29215272736673303
STAT,1919,28,15-19,1947,0.8769736792341228
STAT,1929,52,na,1981,5403.215985438569
SIM,1927,28,15-19,1955,2
STAT,1895,20,40-44,1915,3.148957952440528
SIM,1867,26,40-44,1893,3
STAT,1940,47,35-39,1987,0.15718950013787578
STAT,1900,35,45-49,1935,3.222598707632843
STAT,1904,34,50-100,1938,0.8644119933789786
SIM,1832,39,45-49,1871,6
SIM,1876,38,20-24,1914,1
STAT,1857,38,25-29,1895,2.5750174138491033
STAT,1844,47,15-19,1891,3.330089900899711E-4
STAT,1831,99,na,1930,1.4858657171478122
SIM,1966,43,35-39,2009,1
SIM,1823,90,na,1913,288
SIM,1900,32,35-39,1932,22
SIM,1877,89,na,1966,536
SIM,1928,65,na,1993,4952
STAT,1869,51,50-100,1920,0.0169597177577862
STAT,1950,33,35-39,1983,12.702795627561239
SIM,1886,60,na,1946,1598
STAT,1934,30,30-34,1964,24.86522144382322
SIM,1860,37,na,1897,2381
STAT,1873,97,na,1970,36.612091285150285
STAT,1935,48,na,1983,5972.073115558228
STAT,1943,46,20-24,1989,0.014103530164128068
SIM,1891,28,45-49,1919,3
STAT,1905,31,15-19,1936,0.1371412415242679
STAT,1857,59,na,1916,1746.8063281544687
STAT,1911,42,50-100,1953,0.12951104708598649
STAT,1810,54,40-44,1864,0.037012628920807575
STAT,1844,96,na,1940,7.182074598165951
SIM,1811,88,na,1899,86
SIM,1831,88,na,1919,59
STAT,1874,62,na,1936,2159.367904545568
SIM,1861,54,na,1915,1521
STAT,1974,37,40-44,2011,2.3240841812459196
STAT,1927,34,50-100,1961,1.171956799499031
SIM,1902,10,na,1912,4334
STAT,1871,48,20-24,1919,0.013604401922284601
STAT,1887,25,na,1912,3107.4855656479504
STAT,1900,42,35-39,1942,0.2011171548320192
STAT,1909,46,20-24,1955,0.011761399057962658
STAT,1958,43,35-39,2001,0.31669267948124685
SIM,1954,46,50-100,2000,1
SIM,1932,36,45-49,1968,4
STAT,1908,40,30-34,1948,0.1382258366457731
STAT,1964,20,15-19,1984,7.768276932495983
SIM,1857,28,25-29,1885,3
STAT,1832,53,30-34,1885,0.004214209604503418
STAT,1967,41,35-39,2008,0.30210776992054655
SIM,1958,31,na,1989,6046
SIM,1844,62,na,1906,1615
STAT,1824,43,30-34,1867,1.608819899385993
STAT,1954,34,15-19,1988,0.18663485528817791
STAT,1932,46,45-49,1978,0.34117004565726816
SIM,1889,29,30-34,1918,44
STAT,1883,35,35-39,1918,8.061824898701124
STAT,1924,36,45-49,1960,0.9282918385117725
STAT,1970,44,45-49,2014,0.24903144028367646
STAT,1920,33,20-24,1953,3.06896410650831
STAT,1924,43,35-39,1967,0.2759034271155713
STAT,1950,15,na,1965,5025.22171642604
SIM,1842,40,na,1882,2268
SIM,1906,46,45-49,1952,1
SIM,1940,46,45-49,1986,1
STAT,1920,49,na,1969,4657.173622243248
STAT,1822,48,25-29,1870,0.1073263124688483
STAT,1896,26,45-49,1922,1.698227554880803
SIM,1875,23,na,1898,2984
STAT,1928,44,15-19,1972,0.0022517360187121124
STAT,1883,28,45-49,1911,1.249221896019143
SIM,1972,20,15-19,1992,18
STAT,1978,17,15-19,1995,71.47731338248337
SIM,1938,32,30-34,1970,38
SIM,1966,36,45-49,2002,1
SIM,1943,36,20-24,1979,1
STAT,1938,30,15-19,1968,0.14935835932978678
STAT,1914,76,na,1990,2671.201751335553
STAT,1966,46,45-49,2012,0.32666626685045014
SIM,1903,59,na,1962,3150
STAT,1961,42,50-100,2003,0.1820349484387539
STAT,1891,38,45-49,1929,2.829243331179492
STAT,1944,7,na,1951,4915.27019655988
STAT,1846,50,40-44,1896,0.011039693121844977
STAT,1960,20,30-34,1980,43.373010787360506
SIM,1810,72,na,1882,407
SIM,1932,43,35-39,1975,2
STAT,1814,66,na,1880,1210.9914072793094
STAT,1931,21,15-19,1952,7.99340828174239
SIM,1839,15,25-29,1854,14
STAT,1980,26,25-29,2006,105.9530265628113
STAT,1890,45,na,1935,3204.1748451569033
STAT,1888,96,na,1984,102.58108663661358
STAT,1840,44,25-29,1884,0.5237712032245379
SIM,1892,56,na,1948,3368
STAT,1947,32,50-100,1979,1.0955659667239932
SIM,1928,16,15-19,1944,72
STAT,1816,52,35-39,1868,0.016855768518876695
SIM,1935,37,na,1972,6247
STAT,1950,8,na,1958,5362.812363388416
STAT,1925,17,35-39,1942,5.847896710243602
SIM,1988,2,na,1990,6642
STAT,1857,45,35-39,1902,0.12708800097316644
STAT,1891,45,35-39,1936,0.1137616728147692
SIM,1871,30,na,1901,2058
SIM,1897,31,20-24,1928,8
SIM,1914,11,na,1925,4353
STAT,1824,36,40-44,1860,6.872720270136526
STAT,1960,38,20-24,1998,0.4077978589543711
STAT,1947,49,na,1996,4938.41108109226
SIM,1899,25,25-29,1924,92
STAT,1969,46,50-100,2015,0.3400022204095398
STAT,1820,50,35-39,1870,0.008797966953592737
STAT,1888,21,na,1909,3218.051196242415
STAT,1950,26,45-49,1976,2.3686574667126292
SIM,1859,29,na,1888,2283
SIM,1956,44,na,2000,5372
SIM,1982,17,30-34,1999,27
STAT,1970,27,25-29,1997,95.49693798145972
STAT,1875,18,25-29,1893,6.740408119882459
SIM,1832,36,40-44,1868,9
SIM,1808,68,na,1876,988
SIM,1786,73,na,1859,227
SIM,1841,64,na,1905,1314
SIM,1865,45,35-39,1910,1
SIM,1831,40,45-49,1871,3
STAT,1974,17,30-34,1991,18.367643426592174
STAT,1962,16,na,1978,5444.183283718351
STAT,1917,19,na,1936,4531.774092222399
STAT,1847,16,20-24,1863,17.126555953908007
STAT,1866,40,30-34,1906,1.242164955597905
STAT,1962,36,30-34,1998,2.7790411678025015
STAT,1878,102,na,1980,6.458998178234435
SIM,1872,70,na,1942,1805
STAT,1889,31,20-24,1920,3.8610025827160177
STAT,1980,33,15-19,2013,0.20972334398702322
SIM,1945,13,na,1958,4776
STAT,1789,108,na,1897,3.712925639739993E-4
STAT,1889,92,na,1981,302.0950878553892
SIM,1833,24,20-24,1857,107
SIM,1915,41,40-44,1956,2
SIM,1898,61,na,1959,3318
STAT,1901,31,30-34,1932,28.33867017939588
STAT,1919,42,15-19,1961,0.0019201028735535914
SIM,1891,35,35-39,1926,13
STAT,1787,69,na,1856,538.3209448000002
SIM,1977,36,20-24,2013,1
STAT,1849,28,25-29,1877,38.586251318100885
SIM,1843,45,na,1888,1745
STAT,1992,17,50-100,2009,0.6206117374538341
SIM,1850,42,35-39,1892,5
STAT,1873,39,40-44,1912,5.10692118597599
STAT,1859,95,na,1954,12.222651051451773
SIM,1851,41,25-29,1892,1
STAT,1881,44,15-19,1925,0.01516462842025976
SIM,1813,79,na,1892,310
SIM,1949,49,50-100,1998,2
STAT,1984,26,45-49,2010,2.8451837776548414
SIM,1956,27,30-34,1983,70
SIM,1874,40,30-34,1914,4
STAT,1942,40,30-34,1982,0.16070635081414264
STAT,1956,22,30-34,1978,44.03507561256148
STAT,1900,32,40-44,1932,6.9446255261799505
STAT,1911,20,35-39,1931,10.37599381130659
STAT,1843,41,25-29,1884,0.6719627534044088
STAT,1870,27,20-24,1897,13.347155890618776
STAT,1824,86,na,1910,137.28615490064652
STAT,1842,42,35-39,1884,1.4416926866605586
STAT,1885,33,50-100,1918,1.0502479124777153
SIM,1903,23,50-100,1926,5
STAT,1832,46,40-44,1878,0.14234320148267834
STAT,1851,54,30-34,1905,0.004590534702890185
SIM,1950,40,30-34,1990,1
SIM,1955,28,50-100,1983,3
STAT,1850,33,30-34,1883,18.608205742934455
SIM,1941,31,40-44,1972,6
SIM,1889,36,20-24,1925,1
STAT,1940,37,40-44,1977,1.8077286785694635
SIM,1942,30,30-34,1972,24
SIM,1926,78,na,2004,3978
STAT,1832,46,50-100,1878,0.2042026300152715
STAT,1839,85,na,1924,217.40225003314293
STAT,1865,48,45-49,1913,0.24264874602081263
STAT,1948,27,30-34,1975,51.97098077614749
SIM,1856,63,na,1919,1513
STAT,1820,43,45-49,1863,1.790264782858084
STAT,1947,46,40-44,1993,0.21371409087682638
STAT,1837,50,na,1887,1628.0472298797624
STAT,1846,13,na,1859,3086.085064295236
STAT,1911,45,15-19,1956,4.046977138440012E-4
STAT,1843,19,40-44,1862,0.23177318129116897
SIM,1854,0,na,1854,3802
STAT,1877,47,50-100,1924,0.29345476352795147
SIM,1915,22,35-39,1937,2
SIM,1846,25,45-49,1871,1
STAT,1865,30,20-24,1895,2.8372002925669544
STAT,1965,23,35-39,1988,13.606413123623865
SIM,1966,40,30-34,2006,3
STAT,1881,37,25-29,1918,3.2049181681603542
SIM,1845,16,na,1861,2532
STAT,1830,28,na,1858,1753.0170383120083
STAT,1856,33,na,1889,2104.780077606264
STAT,2004,3,na,2007,6937.379900825124
STAT,1799,71,na,1870,827.8704882557576
STAT,1910,32,35-39,1942,10.179227210906369
STAT,1965,43,25-29,2008,0.10675136487357013
STAT,1961,39,20-24,2000,0.40406806546889007
STAT,1970,37,20-24,2007,0.39233694642891526
STAT,1831,43,20-24,1874,0.15026939680918913
STAT,1933,31,40-44,1964,6.092344215805922
SIM,1973,23,35-39,1996,2
SIM,1899,18,35-39,1917,2
SIM,1866,33,50-100,1899,2
STAT,1834,32,35-39,1866,11.838099504243365
STAT,1942,65,na,2007,4017.986663838908
SIM,1842,32,35-39,1874,26
SIM,1985,19,45-49,2004,1
STAT,1886,30,na,1916,2928.232908138421
SIM,1891,25,40-44,1916,10
STAT,1933,45,35-39,1978,0.20566626955270248
SIM,1875,44,50-100,1919,2
SIM,1930,25,50-100,1955,2
STAT,1826,98,na,1924,1.7886648154260931
STAT,1950,30,30-34,1980,21.938812561670407
SIM,1917,18,na,1935,5715
SIM,1867,29,45-49,1896,1
STAT,1833,52,20-24,1885,5.388292926326641E-4
SIM,1895,5,na,1900,4064
STAT,1922,45,25-29,1967,0.07062682727245659
STAT,1860,45,40-44,1905,0.16082210185016915
STAT,1855,51,45-49,1906,0.012407631529424956
SIM,1813,70,na,1883,787
STAT,1893,21,50-100,1914,0.5966473380114029
SIM,1779,91,na,1870,95
STAT,1838,25,45-49,1863,1.2413919329189262
STAT,1961,30,40-44,1991,5.954250058317999
STAT,1943,49,25-29,1992,0.06713323776040087
STAT,1881,49,40-44,1930,0.18658879383516974
STAT,1859,29,45-49,1888,1.0234684780236813
STAT,1913,81,na,1994,1963.4158558505148
SIM,1857,25,20-24,1882,13
STAT,1839,41,na,1880,1956.0169468478648
STAT,1883,25,40-44,1908,3.405214509016776
STAT,1945,25,50-100,1970,1.2613169695352935
STAT,1983,20,20-24,2003,182.2561332396582
SIM,1855,39,50-100,1894,1
SIM,1826,43,na,1869,1910
STAT,1939,33,35-39,1972,10.75814957562093
STAT,1822,45,20-24,1867,0.023338347309219538
STAT,1912,22,50-100,1934,0.7284337668861025
STAT,1866,51,20-24,1917,7.931008461123102E-4
STAT,1918,23,50-100,1941,0.8162826164128204
STAT,1920,43,15-19,1963,0.001953409706350351
SIM,1892,15,na,1907,4097
STAT,1961,31,na,1992,5751.346678456879
SIM,1855,13,na,1868,2189
SIM,1891,84,na,1975,839
STAT,1890,34,50-100,1924,1.2809546344405893
STAT,1839,40,20-24,1879,0.14965657934786888
STAT,1890,35,25-29,1925,4.098572546464193
STAT,1892,81,na,1973,1362.2752754131793
STAT,1811,52,35-39,1863,0.025622839587875857
STAT,1924,33,40-44,1957,5.264193109914814
STAT,1873,12,na,1885,3091.5769570456364
STAT,1888,65,na,1953,2292.5602191375892
SIM,1890,8,na,1898,3792
SIM,1931,44,na,1975,6070
STAT,1965,30,25-29,1995,13.589087726426223
SIM,1816,42,35-39,1858,3
SIM,1932,33,40-44,1965,3
SIM,1991,20,20-24,2011,202
STAT,1907,22,35-39,1929,9.908497451185953
STAT,1969,40,40-44,2009,0.37577432382011405
STAT,1855,47,25-29,1902,0.048783088305951954
SIM,1839,61,na,1900,1529
STAT,1892,30,30-34,1922,25.457332709251677
STAT,1805,53,20-24,1858,0.0025832404469045772
STAT,1817,51,25-29,1868,0.009926394287222116
STAT,1969,16,45-49,1985,0.7203541203787559
STAT,1811,45,45-49,1856,0.7609077359665537
STAT,1924,40,30-34,1964,0.17593262977959404
STAT,1984,30,30-34,2014,26.35246103697097
STAT,1894,32,40-44,1926,6.4336889415727265
STAT,1936,46,30-34,1982,0.10228320115538418
STAT,1870,37,15-19,1907,0.06388840316698557
SIM,1888,10,na,1898,3112
SIM,1938,70,na,2008,3193
STAT,1899,22,50-100,1921,0.6447453588310164
STAT,1920,36,25-29,1956,1.2446989220428746
STAT,1935,17,na,1952,5810.099368793729
SIM,1839,16,20-24,1855,38
STAT,1839,31,na,1870,2137.184002789482
STAT,1790,68,na,1858,733.0880294542818
STAT,1868,42,40-44,1910,2.4908538025797844
STAT,1950,23,40-44,1973,4.601727953251949
SIM,1842,50,na,1892,1974
SIM,1879,24,45-49,1903,3
SIM,1807,83,na,1890,162
SIM,1995,6,na,2001,6767
SIM,1865,42,30-34,1907,4
STAT,1869,16,40-44,1885,0.20847250764997613
SIM,1855,19,25-29,1874,15
STAT,1946,58,na,2004,4639.930767214243
STAT,1828,40,45-49,1868,1.4867444816976958
SIM,1830,43,50-100,1873,3
SIM,1916,77,na,1993,2515
STAT,1808,80,na,1888,363.23279754190827
STAT,1864,45,25-29,1909,0.059945162599406354
SIM,1858,75,na,1933,1596
STAT,1961,21,na,1982,5464.627595313363
STAT,1858,19,35-39,1877,0.5702743275562866
STAT,1797,90,na,1887,37.92949227259902
STAT,1949,18,35-39,1967,5.630140561642995
STAT,1820,36,20-24,1856,1.9535362628822874
STAT,1912,23,20-24,1935,122.7176363711954
SIM,1877,16,40-44,1893,3
STAT,1901,20,40-44,1921,3.388539054274741
SIM,1920,23,20-24,1943,262
STAT,1835,33,50-100,1868,0.7208711054508582
STAT,1901,49,20-24,1950,0.01071351101440647
STAT,1893,47,45-49,1940,0.19328461842408484
SIM,1823,42,25-29,1865,2
STAT,1926,54,na,1980,5093.756916857214
SIM,1876,42,40-44,1918,4
STAT,1971,35,15-19,2006,0.028967944503595328
SIM,1950,43,35-39,1993,1
STAT,1961,43,40-44,2004,0.38695551635517084
SIM,1924,16,30-34,1940,22
SIM,1889,26,na,1915,3948
STAT,1849,25,20-24,1874,10.934975728269226
STAT,1890,42,15-19,1932,0.019449544594448254
STAT,1842,50,20-24,1892,5.760077978043259E-4
SIM,1827,83,na,1910,112
STAT,1822,52,45-49,1874,0.02639910665702046
SIM,1822,50,na,1872,1499
STAT,1878,31,45-49,1909,2.1098151931929467
SIM,1980,20,45-49,2000,1
SIM,1825,29,40-44,1854,1
STAT,1762,105,na,1867,0.026690435189034446
STAT,1932,21,30-34,1953,43.66234222478578
STAT,1964,37,50-100,2001,0.6287256429712225
SIM,1962,36,na,1998,5519
SIM,1962,36,50-100,1998,1
STAT,1898,32,25-29,1930,15.975188463626793
SIM,1857,18,30-34,1875,5
SIM,1886,31,45-49,1917,6
STAT,1882,47,35-39,1929,0.15707438150201905
SIM,1889,36,na,1925,3782
STAT,1916,16,30-34,1932,2.992038118725981
STAT,1873,22,na,1895,2787.1857824477174
STAT,1931,43,25-29,1974,0.10994321134736756
STAT,1956,45,25-29,2001,0.08465329066473966
SIM,1891,32,30-34,1923,39
SIM,1814,44,25-29,1858,1
STAT,1964,28,na,1992,5466.0104854618
STAT,1849,18,30-34,1867,1.5116704967028363
STAT,1810,102,na,1912,0.1669301158528971
STAT,1965,19,50-100,1984,0.539427434499244
SIM,1923,17,50-100,1940,1
STAT,1938,17,50-100,1955,0.42671734094901836
SIM,1874,82,na,1956,408
SIM,1947,30,30-34,1977,39
SIM,1929,9,na,1938,5494
STAT,1942,43,35-39,1985,0.2520250678024143
STAT,1934,22,na,1956,5666.38806580532
STAT,1876,48,20-24,1924,0.014135868934353694
SIM,1865,35,40-44,1900,1
SIM,1958,21,na,1979,5437
STAT,1880,24,50-100,1904,0.4957033066459834
STAT,1935,40,40-44,1975,0.40850458769457093
STAT,1887,80,na,1967,1222.171552018955
STAT,1967,34,45-49,2001,2.3092669651303597
SIM,1873,42,na,1915,3256
STAT,1886,40,na,1926,2841.887136539165
STAT,1883,32,30-34,1915,19.71363222676253
STAT,1830,73,na,1903,745.0972838021431
SIM,1826,34,50-100,1860,6
SIM,1909,99,na,2008,34
SIM,1939,16,25-29,1955,60
STAT,1951,41,50-100,1992,0.16802147257481842
STAT,1911,38,25-29,1949,1.0929892468858913
SIM,1901,24,na,1925,4017
SIM,1854,82,na,1936,632
STAT,1906,31,30-34,1937,16.94035219301811
STAT,1914,22,na,1936,4307.652198972815
SIM,1968,35,50-100,2003,1
SIM,1883,15,20-24,1898,29
SIM,1912,30,na,1942,3946
STAT,1892,41,20-24,1933,0.23075201780755314
SIM,1853,36,50-100,1889,3
STAT,1847,19,25-29,1866,5.378151175525206
STAT,1856,7,na,1863,2576.7896769207596
STAT,1841,32,25-29,1873,11.049022406482251
STAT,1875,15,20-24,1890,21.24119861687283
STAT,1832,49,45-49,1881,0.17181395397546756
STAT,1931,36,50-100,1967,0.6424250123207813
SIM,1840,49,45-49,1889,2
STAT,1922,42,20-24,1964,0.023382969467438404
STAT,1897,102,na,1999,12.080690803600312
SIM,1963,34,30-34,1997,5
STAT,1881,34,20-24,1915,2.9830927506107856
STAT,1930,33,15-19,1963,0.1912933764938141
STAT,1901,30,35-39,1931,16.50181361014676
STAT,1810,73,na,1883,683.8521147188133
STAT,1831,46,25-29,1877,0.054054433039830915
SIM,1866,26,25-29,1892,99
STAT,1912,48,35-39,1960,0.14273391150515718
STAT,1933,42,30-34,1975,0.20280276603161315
STAT,1922,5,na,1927,5367.780896195419
SIM,1952,34,20-24,1986,7
SIM,1967,36,50-100,2003,1
STAT,1969,42,na,2011,5564.168635023719
SIM,1782,80,na,1862,61
SIM,1844,31,na,1875,2576
STAT,1820,46,15-19,1866,4.3404221293639236E-4
STAT,1861,34,na,1895,2269.8427539845147
SIM,1943,22,na,1965,5436
STAT,1880,48,na,1928,2717.51780566346
SIM,1969,31,na,2000,5563
STAT,1870,21,50-100,1891,0.46535372639972455
SIM,1846,28,50-100,1874,1
STAT,1918,44,20-24,1962,0.021592628597334546
SIM,1968,18,50-100,1986,1
STAT,1844,41,40-44,1885,1.9516559538748128
STAT,1847,50,50-100,1897,0.011787873208044771
STAT,1880,46,20-24,1926,0.014720571515177791
STAT,1834,108,na,1942,0.0016716320425889943
STAT,1929,44,30-34,1973,0.19044234741934973
SIM,1884,40,25-29,1924,1
STAT,1900,43,30-34,1943,0.12692122100376402
SIM,1931,48,45-49,1979,1
STAT,1875,52,25-29,1927,0.004201700816336216
STAT,1891,41,na,1932,3311.4794561855006
STAT,1876,40,25-29,1916,0.7738097833351059
STAT,1939,30,30-34,1969,18.580242804022376
STAT,1951,49,20-24,2000,0.01570405740884823
STAT,1833,41,30-34,1874,1.0000884053935357
STAT,1897,44,25-29,1941,0.06788366665511912
SIM,1940,9,na,1949,5119
SIM,1964,17,na,1981,5967
STAT,1911,42,45-49,1953,0.18347398389758252
SIM,1940,21,30-34,1961,49
STAT,1912,30,45-49,1942,1.802998816474836
STAT,1858,26,25-29,1884,39.26772422359591
STAT,1923,48,45-49,1971,0.2924911302973307
STAT,1891,20,20-24,1911,98.87760377839828
STAT,1933,34,45-49,1967,2.445193406832685
SIM,1979,16,na,1995,6008
STAT,1918,69,na,1987,3625.391821102269
STAT,1955,41,20-24,1996,0.02815798780711718
SIM,1852,41,40-44,1893,2
STAT,1875,88,na,1963,325.92922993860805
STAT,1904,43,15-19,1947,0.0015777645174552286
STAT,1904,56,na,1960,3496.3774093917177
SIM,1846,18,20-24,1864,8
STAT,1962,49,30-34,2011,0.1363068746567635
SIM,1900,93,na,1993,229
SIM,1954,48,35-39,2002,1
STAT,1871,47,25-29,1918,0.06582376688995614
SIM,1928,55,na,1983,5427
STAT,1976,20,na,1996,5652.852164293229
STAT,1838,45,na,1883,2056.989809299766
STAT,1948,35,na,1983,5127.783708194414
STAT,1825,72,na,1897,893.2812585680887
STAT,1868,11,na,1879,2974.841731754689
STAT,1824,50,50-100,1874,0.0206103057769999
STAT,1975,38,na,2013,5895.123016138997
SIM,1841,34,40-44,1875,15
STAT,1984,23,40-44,2007,5.5275031978111295
STAT,1916,19,35-39,1935,1.0220118873774293
STAT,1833,34,40-44,1867,3.881701529973053
STAT,1838,18,20-24,1856,20.168724295456283
STAT,1865,40,15-19,1905,0.01452466395879651
STAT,1867,54,40-44,1921,0.011031483927635588
SIM,1904,1,na,1905,4489
STAT,1838,28,50-100,1866,0.6999227226866563
SIM,1913,56,na,1969,4216
SIM,1957,15,30-34,1972,25
STAT,1955,34,30-34,1989,24.571774892151108
STAT,1823,48,40-44,1871,0.16680276356719012
STAT,1842,20,25-29,1862,56.36903153072371
SIM,1922,19,na,1941,4656
SIM,1989,1,na,1990,6754
SIM,1875,67,na,1942,2129
STAT,1965,20,30-34,1985,41.57475595225391
SIM,1858,28,40-44,1886,4
STAT,1892,41,50-100,1933,1.535002523980319
SIM,1827,28,na,1855,1730
SIM,1958,40,35-39,1998,3
STAT,1933,36,na,1969,5921.785237907581
STAT,1970,24,20-24,1994,161.05650457765577
STAT,1782,91,na,1873,24.438974415519155
SIM,1860,68,na,1928,1636
SIM,1928,30,50-100,1958,2
STAT,1901,23,45-49,1924,1.1237252117950116
STAT,1944,41,45-49,1985,0.2151232273052474
SIM,1973,20,30-34,1993,57
STAT,1820,39,25-29,1859,3.909363397220475
STAT,1818,54,45-49,1872,0.01656546353084043
STAT,1901,89,na,1990,671.2309083648204
STAT,1843,29,50-100,1872,0.7786149065930531
STAT,1949,15,30-34,1964,16.368127103449567
STAT,1869,92,na,1961,93.9211545322526
STAT,1982,16,na,1998,5978.944132701744
SIM,1813,69,na,1882,907
SIM,1851,29,50-100,1880,4
SIM,1914,41,25-29,1955,1
STAT,1978,34,20-24,2012,3.91078990473444
STAT,1981,21,15-19,2002,8.621332639178997
STAT,1860,52,30-34,1912,0.005507044063409091
SIM,1869,28,50-100,1897,4
SIM,1843,35,na,1878,2028
STAT,1842,20,na,1862,2105.387447790661
STAT,1911,35,20-24,1946,0.29687817838920894
STAT,1931,55,na,1986,5492.238067922241
STAT,1917,41,35-39,1958,0.24287133138624117
STAT,1889,46,40-44,1935,0.24423532493830252
STAT,1787,79,na,1866,220.99022761466682
SIM,1914,52,na,1966,3829
STAT,1864,15,45-49,1879,0.07742783464105363
STAT,1982,32,20-24,2014,4.0375541029327495
STAT,1937,42,15-19,1979,0.0017885991940936453
SIM,1812,84,na,1896,59
STAT,1869,19,45-49,1888,0.07314657252990468
STAT,1872,4,na,1876,3405.3249700259344
SIM,1961,10,na,1971,5670
SIM,1915,37,na,1952,4653
SIM,1862,30,45-49,1892,4
STAT,1842,61,na,1903,1437.9622283023741
STAT,1857,60,na,1917,1714.1934540078248
STAT,1892,33,35-39,1925,14.58632088653707
STAT,1870,41,35-39,1911,2.069528583798493
STAT,1939,40,25-29,1979,0.08599996295782289
SIM,1986,20,na,2006,6723
STAT,1972,38,35-39,2010,3.678340316240736
STAT,1842,53,25-29,1895,0.0026819047728945155
STAT,1969,19,15-19,1988,65.38203270862451
STAT,1941,40,15-19,1981,0.0019028107590076586
STAT,1784,102,na,1886,0.09140832640532928
STAT,1775,112,na,1887,0.0010583754450073754
SIM,1809,54,na,1863,1454
STAT,1961,46,45-49,2007,0.3379013240441236
SIM,1839,19,25-29,1858,13
SIM,1947,33,35-39,1980,1
SIM,1828,68,na,1896,1434
STAT,1844,86,na,1930,185.58225920912417
STAT,1992,21,25-29,2013,153.5648688190369
SIM,1861,64,na,1925,1341
STAT,1876,18,40-44,1894,0.2176277982197612
SIM,1940,31,25-29,1971,13
STAT,1854,30,45-49,1884,1.4853987648217164
SIM,1929,51,na,1980,5064
SIM,1785,87,na,1872,64
STAT,1963,32,15-19,1995,0.19204921387844925
STAT,1870,34,45-49,1904,1.9670025677707748
STAT,1843,49,20-24,1892,0.011789174087025484
SIM,1889,4,na,1893,4172
STAT,1944,34,20-24,1978,3.0839634835815666
STAT,1988,19,20-24,2007,223.62310455664016
SIM,1815,47,45-49,1862,1
STAT,1924,77,na,2001,3055.7376835397904
STAT,1853,45,15-19,1898,4.022176151356492E-4
STAT,1881,41,45-49,1922,1.6734917833518097
SIM,1824,30,25-29,1854,20
SIM,1876,63,na,1939,2285
SIM,1977,19,15-19,1996,126
SIM,1891,30,na,1921,3370
STAT,1874,52,na,1926,2530.3117798275234
STAT,1828,79,na,1907,463.9957477036793
STAT,1912,41,na,1953,4161.558303687677
STAT,1858,45,na,1903,2045.6935153684599
STAT,1964,47,40-44,2011,0.23836705621321833
SIM,1839,20,na,1859,2591
STAT,1906,41,25-29,1947,0.07538331988898755
STAT,1957,48,45-49,2005,0.3430170921514932
STAT,1927,40,na,1967,5389.0673620323005
STAT,1896,16,50-100,1912,0.07486104932619912
STAT,1939,76,na,2015,2804.0903214683567
STAT,1807,54,35-39,1861,0.03246708997283921
SIM,1878,39,50-100,1917,5
STAT,1893,44,40-44,1937,0.22476810275104306
SIM,1839,26,15-19,1865,1
STAT,1812,48,30-34,1860,0.2207366595906859
SIM,1956,54,na,2010,5175
STAT,1831,68,na,1899,1198.9734822788835
STAT,1867,19,35-39,1886,0.5973131277554703
SIM,1896,51,na,1947,3378
STAT,1839,19,na,1858,2353.377989057964
STAT,1955,26,25-29,1981,101.31887957026395
STAT,1954,10,na,1964,5605.669318914785
STAT,1831,90,na,1921,61.85571323821134
STAT,1898,15,20-24,1913,27.779311495852575
STAT,1950,17,35-39,1967,5.725826196651172
SIM,1935,19,30-34,1954,38
SIM,1781,75,na,1856,611
STAT,1901,25,45-49,1926,1.8069622477583513
STAT,1905,44,15-19,1949,0.0015801891077875884
SIM,1924,30,30-34,1954,54
SIM,1855,77,na,1932,396
STAT,1913,36,na,1949,4307.600213503151
SIM,1963,26,25-29,1989,109
STAT,1927,19,30-34,1946,17.39231929562254
STAT,1960,19,15-19,1979,68.1689568194729
SIM,1876,32,25-29,1908,2
SIM,1945,22,15-19,1967,16
SIM,1934,42,na,1976,5774
STAT,1868,32,25-29,1900,11.356668077056632
STAT,1970,26,20-24,1996,26.49608508445197
SIM,1875,19,35-39,1894,2
SIM,1909,43,na,1952,4646
STAT,1853,48,20-24,1901,0.011797308482847577
SIM,1920,25,20-24,1945,6
STAT,1939,53,na,1992,4322.148189063462
STAT,1964,35,35-39,1999,3.6283091351850074
STAT,1900,61,na,1961,3149.0374747696633
STAT,1801,102,na,1903,0.12305270130426346
STAT,1948,49,40-44,1997,0.21531151830394682
SIM,1804,85,na,1889,121
STAT,1955,37,35-39,1992,3.817633643849083
STAT,1866,32,15-19,1898,0.15232805859633475
STAT,1844,65,na,1909,1413.522876268351
SIM,1910,18,15-19,1928,8
SIM,1880,76,na,1956,1255
STAT,1848,79,na,1927,742.8186993557385
STAT,1902,18,15-19,1920,9.651690881872446
STAT,1935,22,50-100,1957,1.0346152590741375
SIM,1947,17,na,1964,6064
STAT,1948,41,30-34,1989,0.17571971346849746
SIM,1817,43,50-100,1860,3
STAT,1982,27,40-44,2009,7.601891505177745
STAT,1912,25,20-24,1937,20.920416385718834
STAT,1841,31,50-100,1872,0.9986997294678837
STAT,1900,1,na,1901,4358.676305049944
SIM,1910,23,40-44,1933,8
STAT,1766,101,na,1867,0.321629015246622
SIM,1952,36,20-24,1988,1
STAT,1929,36,25-29,1965,1.4601953726007315
SIM,1867,22,30-34,1889,21
STAT,1930,41,45-49,1971,0.253109838725798
SIM,1840,31,50-100,1871,1
STAT,1937,22,15-19,1959,5.9855170580419506
STAT,1826,44,na,1870,1456.4395138979005
SIM,1813,46,na,1859,1354
STAT,1885,79,na,1964,1117.3011528870245
STAT,1922,45,50-100,1967,0.3011449461889612
STAT,1929,47,35-39,1976,0.1928683169986169
STAT,1930,21,20-24,1951,164.90926914143554
SIM,1880,68,na,1948,2095
STAT,1923,40,15-19,1963,0.002076382776921675
SIM,1961,48,25-29,2009,1
SIM,1955,12,na,1967,6578
SIM,1964,35,30-34,1999,1
STAT,1951,9,na,1960,5400.261492295454
STAT,1961,42,45-49,2003,0.2578828443605644
STAT,1959,19,20-24,1978,204.52442812426727
SIM,1906,34,30-34,1940,3
STAT,1973,22,25-29,1995,138.32108085501554
SIM,1850,46,na,1896,1510
STAT,1818,49,na,1867,1209.6674778201052
STAT,1813,46,25-29,1859,0.19414392721377954
SIM,1923,21,25-29,1944,6
STAT,1933,36,45-49,1969,1.0730398297719679
STAT,1972,42,20-24,2014,0.02711891430688309
SIM,1845,21,40-44,1866,2
STAT,1987,3,na,1990,6480.814042933628
SIM,1909,18,20-24,1927,41
STAT,1968,10,na,1978,5663.61471503848
STAT,1952,30,40-44,1982,5.522835150883172
SIM,1888,19,20-24,1907,41
STAT,1917,10,na,1927,4919.5235826268645
STAT,1916,38,40-44,1954,1.7605582536335036
STAT,1944,36,20-24,1980,0.3376093579056909
SIM,1909,29,30-34,1938,103
STAT,1887,15,45-49,1902,0.08487561973466036
STAT,1894,22,25-29,1916,84.92610908104326
STAT,1845,19,50-100,1864,0.04123599262615902
SIM,1905,36,35-39,1941,2
STAT,1948,16,40-44,1964,1.847760799491309
STAT,1940,43,25-29,1983,0.08684714813397497
STAT,1852,52,na,1904,2019.2285014452425
SIM,1905,25,25-29,1930,13
STAT,1837,21,40-44,1858,1.9896113573519676
SIM,1956,16,40-44,1972,3
STAT,1934,34,40-44,1968,6.161193395061659
STAT,1915,21,25-29,1936,110.54228614438436
STAT,1916,30,30-34,1946,18.924588244871504
SIM,1924,38,40-44,1962,1
SIM,1950,28,40-44,1978,21
STAT,1844,31,25-29,1875,10.35180958439946
STAT,1963,19,40-44,1982,2.049368377064944
SIM,1941,36,45-49,1977,2
SIM,1901,55,na,1956,3549
SIM,1916,44,40-44,1960,2
STAT,1974,15,50-100,1989,0.5648784349305213
SIM,1942,29,15-19,1971,1
STAT,1913,26,20-24,1939,21.073381938972375
STAT,1963,44,20-24,2007,0.026819320790378416
SIM,1977,31,50-100,2008,3
SIM,1921,37,30-34,1958,2
SIM,1966,30,35-39,1996,32
STAT,1845,18,45-49,1863,0.05530708221579641
STAT,1921,23,na,1944,4743.576647735566
STAT,1906,66,na,1972,3194.8675639678113
STAT,1913,37,30-34,1950,2.0767908986211987
STAT,1918,46,20-24,1964,0.013602567458015068
STAT,1867,31,50-100,1898,0.991278484224345
STAT,1942,28,40-44,1970,5.6438707075040195
STAT,1942,20,30-34,1962,34.80706990035106
SIM,1867,0,na,1867,3961
SIM,1889,81,na,1970,1589
STAT,1922,47,25-29,1969,0.07029597454406367
STAT,1946,23,na,1969,4688.147418041275
STAT,1889,40,45-49,1929,2.15055745320825
SIM,1941,33,40-44,1974,3
SIM,1952,53,na,2005,4400
STAT,1868,75,na,1943,1141.4342221928243
STAT,1953,48,25-29,2001,0.0768135447695013
SIM,1850,38,na,1888,1617
STAT,1956,35,30-34,1991,2.8723535971412817
SIM,1971,19,40-44,1990,5
SIM,1843,76,na,1919,656
STAT,1809,88,na,1897,63.8066307663979
STAT,1948,19,45-49,1967,0.6592876897716059
SIM,1849,26,30-34,1875,62
STAT,1859,25,35-39,1884,9.15440088156959
SIM,1967,25,50-100,1992,2
STAT,1904,31,20-24,1935,4.497867154676284
SIM,1956,41,30-34,1997,1
STAT,1859,31,na,1890,2202.712032091681
STAT,1863,44,na,1907,2300.8139177021767
STAT,1938,45,35-39,1983,0.15346059730201783
SIM,1855,69,na,1924,853
SIM,1950,20,30-34,1970,50
STAT,1928,35,25-29,1963,1.4384851921792383
STAT,1947,48,40-44,1995,0.21259142818924237
STAT,1902,23,40-44,1925,3.387417501829174
SIM,1921,26,20-24,1947,50
SIM,1926,33,45-49,1959,3
SIM,1858,16,25-29,1874,10
SIM,1934,50,na,1984,5656
STAT,1794,73,na,1867,657.7129987052244
STAT,1918,33,45-49,1951,1.9211752907292352
SIM,1937,36,25-29,1973,1
STAT,1870,21,25-29,1891,65.32634928808879
STAT,1888,17,50-100,1905,0.06646113815980363
SIM,1977,37,na,2014,6129
SIM,1818,77,na,1895,775
STAT,1920,18,50-100,1938,0.4836156370292193
STAT,1945,63,na,2008,4327.995202959608
STAT,1801,60,na,1861,1109.0759548665808
STAT,1892,49,na,1941,3186.893176320502
STAT,1885,35,50-100,1920,1.4266880239914816
SIM,1896,4,na,1900,4089
STAT,1852,60,na,1912,1798.1146136852635
SIM,1936,35,25-29,1971,2
SIM,1931,15,25-29,1946,165
STAT,1908,44,40-44,1952,0.264117454947206
SIM,2001,4,na,2005,7324
SIM,1889,46,50-100,1935,3
STAT,1907,43,40-44,1950,0.2632981698816025
STAT,1817,83,na,1900,274.4609748699272
STAT,1895,48,25-29,1943,0.04819474038965263
SIM,1932,27,35-39,1959,2
STAT,1920,47,15-19,1967,4.6972732627300755E-4
SIM,1985,24,na,2009,6427
SIM,1931,26,35-39,1957,53
STAT,1823,53,30-34,1876,0.0055535207115702135
STAT,1913,41,15-19,1954,0.0017391502379278945
STAT,1923,15,25-29,1938,58.97575983202724
SIM,1875,16,30-34,1891,5
STAT,1960,27,45-49,1987,2.607958313355094
STAT,1970,29,25-29,1999,95.40241939050851
SIM,1831,67,na,1898,1056
SIM,1897,25,na,1922,4021
STAT,1871,31,na,1902,2750.983133937907
SIM,1893,11,na,1904,3809
SIM,1915,43,40-44,1958,2
SIM,1898,21,20-24,1919,205
STAT,1834,21,15-19,1855,4.055589675220372
STAT,1978,31,50-100,2009,1.3281076123814914
STAT,1924,27,35-39,1951,20.168140117940276
STAT,1923,26,35-39,1949,19.953456520794294
STAT,1812,52,na,1864,1245.4936342480541
STAT,1934,29,15-19,1963,1.0954324201819474
STAT,1930,48,na,1978,5568.5294343552405
STAT,1852,39,15-19,1891,0.05241042461096099
SIM,1852,80,na,1932,27
STAT,1980,15,25-29,1995,69.46343948354146
STAT,1961,38,50-100,1999,0.6442869635803103
SIM,1924,33,35-39,1957,2
SIM,1985,15,35-39,2000,6
SIM,1944,29,25-29,1973,178
STAT,1909,23,na,1932,4085.0673797660443
STAT,1772,94,na,1866,0.516919442123601
STAT,1867,16,30-34,1883,1.7660755594069233
STAT,1842,82,na,1924,359.0469545627472
STAT,1910,17,40-44,1927,0.32017610805430063
STAT,1964,29,30-34,1993,57.14217365910785
SIM,1905,22,20-24,1927,5
STAT,1877,26,40-44,1903,3.608350034673246
STAT,1970,38,na,2008,5593.726817651105
SIM,1914,31,30-34,1945,23
SIM,1937,39,na,1976,4344
STAT,1848,36,50-100,1884,1.358355751270799
STAT,1916,33,35-39,1949,10.843245831679956
STAT,1876,62,na,1938,2180.444599555185
STAT,1946,16,30-34,1962,15.60586438855656
SIM,1914,28,30-34,1942,45
STAT,1936,29,25-29,1965,72.66600997728864
STAT,1914,53,na,1967,4117.317378747066
STAT,1931,22,20-24,1953,166.46973443543354
STAT,1887,40,35-39,1927,2.3655984288773313
STAT,1978,20,50-100,1998,1.0404651391223794
SIM,1820,48,50-100,1868,1
SIM,1954,16,30-34,1970,39
STAT,1797,78,na,1875,380.3727267082949
STAT,1863,36,na,1899,2388.8832521692257
STAT,1927,49,50-100,1976,0.32565653311005105
STAT,1906,19,40-44,1925,0.3061515719519407
SIM,1928,8,na,1936,6072
STAT,1921,15,15-19,1936,59.95518007050201
STAT,1813,43,20-24,1856,0.5730219868102048
SIM,1969,32,40-44,2001,28
SIM,1888,3,na,1891,3171
SIM,1987,15,na,2002,6552
STAT,1843,15,30-34,1858,2.0680316904252276
STAT,1919,47,20-24,1966,0.013829672346457109
STAT,1971,29,30-34,2000,57.462424746132335
SIM,1869,69,na,1938,1040
STAT,1906,58,na,1964,3538.0829269513492
SIM,1856,36,50-100,1892,3
STAT,1927,28,na,1955,5236.154931023553
SIM,1851,15,30-34,1866,7
SIM,1914,19,40-44,1933,1
STAT,1902,44,na,1946,3730.7409054543396
STAT,1868,67,na,1935,1757.6382111134062
SIM,1966,45,na,2011,5788
STAT,1903,19,15-19,1922,9.702764787435532
STAT,1944,39,25-29,1983,1.2571749086784576
SIM,1913,32,20-24,1945,3
STAT,1846,40,50-100,1886,1.1340517818665228
STAT,1954,25,25-29,1979,94.39149491842728
STAT,1938,39,30-34,1977,2.1340676769208096
SIM,1818,69,na,1887,1405
STAT,1838,22,40-44,1860,2.3422657763540866
SIM,1904,24,25-29,1928,218
SIM,1902,41,35-39,1943,3
STAT,1855,57,na,1912,1709.9860594739348
STAT,1837,40,50-100,1877,0.9261403394146107
STAT,1945,48,30-34,1993,0.11656968515649288
STAT,1979,19,50-100,1998,0.5949224382968477
STAT,1871,95,na,1966,55.91501017869147
STAT,1905,32,20-24,1937,2.592501300247609
STAT,1860,79,na,1939,650.2438433006585
SIM,1869,25,45-49,1894,3
SIM,1845,40,50-100,1885,5
SIM,1906,37,35-39,1943,3
SIM,1945,38,30-34,1983,9
STAT,1817,110,na,1927,1.9104913173779303E-4
SIM,1962,25,25-29,1987,110
STAT,1931,71,na,2002,4325.561144652789
SIM,1952,39,25-29,1991,4
STAT,1897,24,na,1921,3626.739443903516
SIM,1875,1,na,1876,4165
SIM,1941,30,50-100,1971,3
SIM,1974,40,na,2014,6299
STAT,1945,37,20-24,1982,0.3423732718578888
STAT,1830,49,35-39,1879,0.12585014786782212
SIM,1933,25,na,1958,6204
STAT,1937,27,20-24,1964,20.54597496136051
SIM,1905,33,30-34,1938,2
STAT,1899,27,30-34,1926,39.81435715276698
SIM,1846,22,40-44,1868,6
SIM,1838,28,20-24,1866,1
STAT,1908,8,na,1916,4455.859341050843
SIM,1945,27,20-24,1972,2
STAT,1850,26,na,1876,2639.6515220794045
STAT,1919,35,50-100,1954,0.5233166261947864
STAT,1925,61,na,1986,4731.141307574616
STAT,1971,38,20-24,2009,0.396562252502063
SIM,1967,19,20-24,1986,186
SIM,1926,30,40-44,1956,8
STAT,1947,40,na,1987,5031.298924718001
STAT,1963,21,50-100,1984,0.9682352249441711
STAT,1930,6,na,1936,5980.824642553572
SIM,1907,5,na,1912,4880
SIM,1941,12,na,1953,4025
STAT,1904,34,25-29,1938,9.663162888243434
STAT,1923,23,30-34,1946,38.459806846719495
STAT,1963,47,25-29,2010,0.080895800630208
SIM,1852,9,na,1861,2530
STAT,1843,110,na,1953,2.7727237647061413E-4
STAT,1946,49,30-34,1995,0.1179910763663187
SIM,1906,86,na,1992,1150
SIM,1801,80,na,1881,276
SIM,1912,34,25-29,1946,15
STAT,1791,73,na,1864,540.7997981498469
STAT,1862,22,50-100,1884,0.40656856958917326
SIM,1868,95,na,1963,21
STAT,1809,107,na,1916,0.0021918797417534303
STAT,1872,108,na,1980,0.0950964128786466
STAT,1941,44,25-29,1985,0.0879421911693083
SIM,1960,30,40-44,1990,13
STAT,1891,27,50-100,1918,0.9124048831150153
STAT,1937,38,30-34,1975,2.102250308732512
STAT,1932,34,30-34,1966,24.145318296682866
SIM,1926,49,25-29,1975,1
STAT,1905,18,40-44,1923,0.3047066326130633
STAT,1908,23,35-39,1931,9.971637196264856
STAT,1918,30,40-44,1948,4.836591298693586
STAT,1938,42,30-34,1980,0.1513239564144356
STAT,1842,39,na,1881,1895.5799014074173
STAT,1886,30,50-100,1916,1.1243213153988911
STAT,1855,48,30-34,1903,0.08133174829443487
SIM,1946,39,30-34,1985,7
STAT,1948,28,35-39,1976,19.90412069355881
SIM,1963,37,25-29,2000,1
STAT,1901,35,na,1936,3874.90167285305
SIM,1849,29,35-39,1878,26
SIM,1940,34,30-34,1974,46
STAT,1830,49,na,1879,1476.387086264967
SIM,1802,54,na,1856,1222
SIM,1883,33,na,1916,2518
SIM,1918,39,25-29,1957,4
STAT,1893,74,na,1967,2021.7137821208266
SIM,1940,60,na,2000,4441
STAT,1956,38,35-39,1994,3.8014862037453607
SIM,1931,23,30-34,1954,108
SIM,1956,28,35-39,1984,49
STAT,1987,22,40-44,2009,5.557783798237763
STAT,1958,32,na,1990,5843.3714289885465
SIM,1928,32,50-100,1960,3
STAT,1918,49,25-29,1967,0.06474863985709585
SIM,1994,7,na,2001,6228
STAT,1829,30,45-49,1859,2.4466306098740174
STAT,1827,45,50-100,1872,0.3195064302795565
STAT,1963,28,30-34,1991,57.66858936391292
SIM,1874,49,45-49,1923,3
SIM,1882,17,25-29,1899,8
STAT,1856,18,20-24,1874,18.34799921958222
STAT,1981,16,25-29,1997,69.95023246790312
STAT,1882,82,na,1964,820.190460356843
SIM,1847,26,na,1873,2740
SIM,1932,24,30-34,1956,91
STAT,1963,17,20-24,1980,198.77549807540277
STAT,1924,24,30-34,1948,38.88296599135574
STAT,1895,45,20-24,1940,0.010269710844186318
STAT,1902,26,45-49,1928,1.8167045035763663
STAT,1940,47,50-100,1987,0.275755293690277
STAT,1873,47,35-39,1920,0.16421939431705465
SIM,1898,24,25-29,1922,3
STAT,1926,40,40-44,1966,0.35676699348645646
STAT,1804,57,na,1861,1364.9528743989295
STAT,1826,49,15-19,1875,2.804105958012325E-4
STAT,1949,43,45-49,1992,0.231774507546718
SIM,1909,51,na,1960,4490
SIM,1891,20,na,1911,3342
STAT,1870,36,50-100,1906,1.4035556698073468
SIM,1971,17,20-24,1988,4
SIM,1805,59,na,1864,1318
SIM,1839,39,na,1878,2135
SIM,1894,30,50-100,1924,3
STAT,1866,49,45-49,1915,0.24716944229205434
STAT,1971,27,20-24,1998,26.796449691154013
STAT,1918,49,50-100,1967,0.27608100800498175
SIM,1846,41,na,1887,1540
STAT,1966,44,50-100,2010,0.17539683887223326
SIM,1971,28,30-34,1999,132
SIM,1950,37,na,1987,4721
STAT,1874,17,25-29,1891,6.69494066718239
STAT,1964,32,30-34,1996,23.342927777246427
STAT,1885,87,na,1972,531.7464408844123
STAT,1780,81,na,1861,280.00611577121686
STAT,1920,31,35-39,1951,11.593851993414342
STAT,1935,15,na,1950,5837.093937807051
STAT,1877,36,na,1913,2841.8332135135456
STAT,1942,23,35-39,1965,11.391512994831055
SIM,1952,61,na,2013,4096
SIM,1926,49,50-100,1975,4
STAT,1903,61,na,1964,3298.6462256637715
SIM,2002,5,na,2007,6946
SIM,1896,29,20-24,1925,2
SIM,1871,34,20-24,1905,1
SIM,1929,37,35-39,1966,5
SIM,1968,22,na,1990,5379
STAT,1910,33,40-44,1943,4.340658300115721
SIM,1851,18,35-39,1869,1
STAT,1867,21,20-24,1888,75.09750347300303
STAT,1961,19,30-34,1980,18.161336812112747
STAT,1821,77,na,1898,528.6550502443167
STAT,1949,40,40-44,1989,0.34984973099982836
STAT,1965,44,30-34,2009,0.1907849193539141
SIM,1893,86,na,1979,652
STAT,1894,44,50-100,1938,0.10736660225366645
STAT,1929,45,15-19,1974,5.536454323600195E-4
SIM,1944,26,20-24,1970,36
STAT,1825,108,na,1933,0.0012956298715039876
STAT,1843,18,35-39,1861,0.699439200506317
STAT,1925,26,45-49,1951,2.362164235339736
STAT,1860,39,50-100,1899,1.130441108233463
STAT,1940,34,35-39,1974,10.904213839952885
STAT,1951,45,na,1996,5276.090261600008
STAT,1936,53,na,1989,4115.310219447677
SIM,1853,49,50-100,1902,2
STAT,1867,32,30-34,1899,18.81264345715279
SIM,1847,18,15-19,1865,9
SIM,1841,39,50-100,1880,2
STAT,1873,14,na,1887,3063.5691606232695
SIM,1828,47,na,1875,2127
STAT,1942,63,na,2005,4141.127605356833
STAT,1785,88,na,1873,30.92122965764951
STAT,1958,35,40-44,1993,2.3417192129847337
STAT,1897,48,35-39,1945,0.12033261476595421
STAT,1898,97,na,1995,95.78832615951164
SIM,1822,42,na,1864,1673
SIM,1926,3,na,1929,6324
SIM,1929,26,25-29,1955,15
STAT,1921,80,na,2001,2430.22952856894
STAT,1781,74,na,1855,324.71649
STAT,1936,45,25-29,1981,0.060997535232290845
SIM,2005,9,na,2014,6472
STAT,1871,21,40-44,1892,2.3996989599302725
SIM,1837,30,45-49,1867,1
STAT,1836,106,na,1942,0.011049760913101433
SIM,1921,21,15-19,1942,6
SIM,1934,43,45-49,1977,1
STAT,1839,18,15-19,1857,6.120384603914653
STAT,1890,47,40-44,1937,0.13554193545410115
STAT,1824,96,na,1920,5.313004648147599
STAT,1840,45,50-100,1885,0.20383628560994654
STAT,1837,47,25-29,1884,0.04329715817776354
STAT,1926,24,40-44,1950,4.683649633626123
STAT,1937,19,na,1956,4122.3397653966285
SIM,1842,59,na,1901,1718
STAT,1902,39,20-24,1941,0.26857488576635646
STAT,1982,14,na,1996,6376.650168632637
STAT,1816,41,15-19,1857,0.03247360464194446
STAT,1946,56,na,2002,4708.945596570541
STAT,1900,18,na,1918,4033.7973683764067
SIM,1875,46,na,1921,3022
STAT,1842,45,40-44,1887,0.13518462692737887
STAT,1864,1,na,1865,3718.604404095206
STAT,1947,16,25-29,1963,56.34970177304112
STAT,1859,102,na,1961,0.7395876574598658
SIM,1847,18,na,1865,2954
SIM,1955,27,35-39,1982,4
STAT,1856,21,45-49,1877,0.7182095317473501
STAT,1963,36,25-29,1999,1.4886123279547532
STAT,1946,48,50-100,1994,0.30029369554308016
SIM,1955,16,25-29,1971,157
STAT,1866,23,25-29,1889,61.290179389769264
STAT,1941,43,40-44,1984,0.3085740766011048
STAT,1985,22,30-34,2007,47.33146209492604
STAT,1945,32,15-19,1977,0.16513088999029246
STAT,1896,23,40-44,1919,3.1665060168933428
STAT,1877,29,45-49,1906,1.3233315627692392
STAT,1942,44,40-44,1986,0.31250141398957937
STAT,1841,36,35-39,1877,7.486382187858285
STAT,1947,41,15-19,1988,0.0020776419878397318
SIM,1933,26,45-49,1959,3
SIM,1960,33,45-49,1993,5
STAT,1957,15,na,1972,5603.490409702548
SIM,1875,21,20-24,1896,4
SIM,1885,21,35-39,1906,19
SIM,1863,20,45-49,1883,2
STAT,1851,99,na,1950,1.5018267582326645
STAT,1888,29,20-24,1917,15.800844276339475
STAT,1994,9,na,2003,6544.2040780212665
STAT,1883,13,na,1896,2911.3714992288365
STAT,1962,35,25-29,1997,1.5025531760149637
STAT,1864,44,50-100,1908,1.0739177315778523
SIM,1997,14,na,2011,6599
STAT,1832,31,50-100,1863,0.8415378065317342
SIM,1899,56,na,1955,3372
STAT,1834,95,na,1929,12.133516165095003
SIM,1857,25,na,1882,2629
SIM,1853,11,na,1864,2829
STAT,1845,31,40-44,1876,3.510916256045543
SIM,1934,24,40-44,1958,7
STAT,1906,44,30-34,1950,0.13253903868048253
STAT,1936,26,20-24,1962,20.181508974367038
STAT,1980,29,na,2009,6021.622485362854
STAT,1946,48,25-29,1994,0.0704271854285769
STAT,1983,15,50-100,1998,0.6119674587349141
STAT,1992,17,na,2009,6097.122885703518
STAT,1895,25,45-49,1920,1.6792039426726724
STAT,1952,46,20-24,1998,0.015936544648749284
SIM,1823,43,30-34,1866,3
SIM,1968,30,na,1998,5346
STAT,1969,31,50-100,2000,1.2156666156071825
SIM,1950,44,40-44,1994,2
STAT,1909,31,na,1940,4186.77900088134
STAT,1886,61,na,1947,2274.7109131729326
SIM,1859,20,25-29,1879,4
STAT,1952,17,45-49,1969,0.6908502752693201
SIM,1859,31,35-39,1890,30
SIM,1881,21,na,1902,1763
STAT,1892,6,na,1898,3778.603300538668
SIM,1874,23,25-29,1897,124
STAT,1858,14,na,1872,2487.8029064383372
STAT,1957,37,45-49,1994,1.068654796356027
STAT,1951,30,25-29,1981,12.961659554862383
SIM,1928,29,35-39,1957,49
STAT,1855,20,45-49,1875,0.7032397528021613
SIM,1849,31,20-24,1880,6
STAT,1835,21,30-34,1856,16.646086431311975
SIM,1956,25,30-34,1981,8
STAT,1867,90,na,1957,107.51109257609306
STAT,1937,46,25-29,1983,0.061989770606788897
SIM,1928,25,25-29,1953,184
SIM,1843,21,30-34,1864,1
SIM,1943,29,30-34,1972,107
SIM,1922,41,30-34,1963,1
SIM,1932,16,na,1948,4913
STAT,1835,40,na,1875,1610.760109310379
STAT,1950,42,50-100,1992,0.16659602908553822
SIM,1921,24,na,1945,5063
SIM,1943,18,20-24,1961,197
STAT,1935,18,20-24,1953,213.44595033272094
STAT,1879,30,35-39,1909,12.301397648227328
SIM,1887,30,35-39,1917,21
SIM,1859,15,35-39,1874,4
STAT,1857,83,na,1940,356.8161499773697
STAT,1959,25,50-100,1984,1.5103646543845173
SIM,1978,21,na,1999,5232
SIM,1862,28,na,1890,2778
STAT,1783,78,na,1861,221.9883403980144
STAT,1937,27,na,1964,4216.534521106277
SIM,1893,35,50-100,1928,1
STAT,1898,43,15-19,1941,0.0014849021092107847
STAT,1926,43,45-49,1969,0.2363571753733525
SIM,1807,85,na,1892,136
SIM,1918,23,45-49,1941,2
STAT,1845,49,50-100,1894,0.16204327705477048
STAT,1836,22,30-34,1858,21.401426590754955
STAT,1901,34,35-39,1935,16.230072043967507
STAT,1914,41,30-34,1955,0.14647592455597164
SIM,1840,17,20-24,1857,32
STAT,1935,29,30-34,1964,61.61112277123646
STAT,1951,16,45-49,1967,0.6866805091540208
STAT,1934,68,na,2002,4861.346985313373
SIM,1943,57,na,2000,5094
SIM,1834,44,45-49,1878,1
STAT,1955,35,15-19,1990,0.03036212130513116
STAT,1985,3,na,1988,6456.781917223127
STAT,1961,23,na,1984,5461.021536198402
STAT,1911,18,50-100,1929,0.08636828871128369
STAT,1901,23,25-29,1924,92.25060512529267
STAT,1972,15,na,1987,5441.598159021902
STAT,1872,22,40-44,1894,2.4147222795629815
STAT,1914,38,30-34,1952,2.090635147275262
STAT,1894,6,na,1900,3875.534466885178
STAT,1941,27,40-44,1968,5.565860763235304
SIM,1922,38,30-34,1960,5
SIM,1908,34,40-44,1942,1
STAT,1869,35,45-49,1904,2.249096300109764
SIM,1899,33,30-34,1932,37
SIM,1890,46,na,1936,3182
SIM,1942,38,50-100,1980,1
STAT,1971,22,15-19,1993,7.806424714475779
SIM,1848,30,20-24,1878,1
STAT,1828,70,na,1898,931.2195319938335
STAT,1861,36,50-100,1897,1.1835745982114199
STAT,1815,43,30-34,1858,2.4909614997367333
STAT,1866,46,40-44,1912,0.18364604086396927
STAT,1958,28,50-100,1986,1.5144813704547735
SIM,1844,22,30-34,1866,38
STAT,1952,49,15-19,2001,5.267943051928849E-4
SIM,1877,35,45-49,1912,2
STAT,1946,19,35-39,1965,5.36740831862542
SIM,1939,47,45-49,1986,1
STAT,1912,37,15-19,1949,0.02165072685861932
SIM,1907,33,40-44,1940,8
SIM,1899,22,20-24,1921,128
SIM,1982,15,30-34,1997,50
SIM,1960,17,45-49,1977,1
SIM,1954,19,35-39,1973,1
SIM,1935,35,na,1970,6267
STAT,1842,31,15-19,1873,0.13376475332044627
STAT,1956,55,na,2011,5652.272939567483
SIM,1945,34,na,1979,4737
STAT,1831,47,30-34,1878,0.08968506660013977
STAT,1925,42,45-49,1967,0.23245999063528816
SIM,1854,9,na,1863,3264
STAT,1925,23,40-44,1948,4.628868679197303
STAT,1948,33,na,1981,5088.213258811976
SIM,1941,20,na,1961,4002
SIM,1792,67,na,1859,789
STAT,1863,37,25-29,1900,2.9054271286288906
STAT,1898,18,25-29,1916,8.81512856918784
SIM,1929,34,30-34,1963,34
STAT,1965,47,35-39,2012,0.19321525282127247
SIM,1920,28,25-29,1948,15
STAT,1837,44,20-24,1881,0.12036449751552138
SIM,1929,23,20-24,1952,6
SIM,1931,13,na,1944,6359
SIM,1979,14,na,1993,6468
SIM,1935,27,na,1962,5823
STAT,1795,66,na,1861,673.3360833955089
STAT,1892,22,15-19,1914,4.771821636810602
STAT,1988,25,na,2013,6215.309552577697
SIM,1958,41,40-44,1999,2
SIM,1983,18,50-100,2001,1
STAT,1802,53,na,1855,1532.1492402807448
STAT,1857,29,50-100,1886,0.5837464238830178
STAT,1774,96,na,1870,0.06344103011178336
STAT,1840,70,na,1910,1125.5482653978493
STAT,1912,28,25-29,1940,74.66304147951904
SIM,1920,50,na,1970,4052
STAT,1920,22,45-49,1942,1.4429531224972116
SIM,1962,52,na,2014,5324
SIM,1875,24,25-29,1899,8
STAT,1841,33,30-34,1874,18.639792510023895
STAT,1940,28,30-34,1968,46.10322720654988
SIM,1929,42,25-29,1971,1
SIM,1846,33,na,1879,1724
STAT,1826,44,45-49,1870,1.0886451097279504
STAT,1867,24,25-29,1891,61.29534728465087
SIM,1871,37,25-29,1908,5
STAT,1881,54,30-34,1935,0.006443746649426798
SIM,1844,85,na,1929,200
SIM,1908,37,45-49,1945,3
STAT,1930,45,30-34,1975,0.13613658179999819
STAT,1952,42,35-39,1994,0.289410213268685
SIM,1826,41,25-29,1867,2
STAT,1944,48,15-19,1992,4.7455781141805364E-4
STAT,1937,42,50-100,1979,0.13682782834967153
STAT,1865,41,50-100,1906,1.1050143483720418
STAT,1877,21,35-39,1898,7.026321653314271
STAT,1925,40,25-29,1965,0.10001747601552562
STAT,1940,31,30-34,1971,18.834769675034575
STAT,1971,22,na,1993,5355.34423495595
STAT,1827,29,na,1856,2301.6062847215458
STAT,1866,20,20-24,1886,75.39370880194214
SIM,1925,4,na,1929,5683
SIM,1873,41,50-100,1914,1
STAT,1940,40,20-24,1980,0.021572029900736096
STAT,1937,29,40-44,1966,5.2411132360166075
SIM,1901,31,45-49,1932,2
STAT,1978,1,na,1979,6201.517473325447
STAT,1818,41,25-29,1859,0.8823078438571921
SIM,1896,24,15-19,1920,10
STAT,1827,47,50-100,1874,0.3110639716339615
STAT,1948,25,30-34,1973,52.01622506088393
STAT,1842,48,45-49,1890,0.17932604529221463
STAT,1958,38,45-49,1996,1.0634846226645842
STAT,1926,27,45-49,1953,2.3895441196177405
STAT,1896,31,na,1927,3652.2855697916357
STAT,1908,39,15-19,1947,0.02056649193841507
SIM,1835,47,50-100,1882,2
SIM,1978,17,30-34,1995,44
STAT,1948,44,35-39,1992,0.2754536313054702
STAT,1918,25,15-19,1943,0.8727199610985318
STAT,1958,30,35-39,1988,14.134992683469212
STAT,1872,2,na,1874,3826.1925267197066
SIM,1945,29,40-44,1974,1
STAT,1863,34,20-24,1897,2.704330703649686
STAT,1912,43,na,1955,4112.886299159899
SIM,1874,20,20-24,1894,84
SIM,1933,23,40-44,1956,1
STAT,1940,49,50-100,1989,0.27413897890943895
STAT,1852,34,45-49,1886,1.6672809712989065
SIM,1955,24,30-34,1979,111
SIM,1850,48,45-49,1898,1
STAT,1800,103,na,1903,0.07743880710488704
SIM,1854,84,na,1938,510
SIM,1926,25,15-19,1951,2
STAT,1897,45,30-34,1942,0.08510017689606661
STAT,1941,46,45-49,1987,0.26945626730257827
SIM,1864,34,20-24,1898,5
STAT,1839,62,na,1901,1449.4817809646784
SIM,1904,22,50-100,1926,1
STAT,1915,37,40-44,1952,1.7455345333631742
SIM,1910,51,na,1961,3328
STAT,1888,24,15-19,1912,4.447355587547493
STAT,1941,41,20-24,1982,0.02185321905771771
SIM,1860,34,45-49,1894,4
STAT,1963,33,20-24,1996,3.643051235624627
STAT,1856,34,20-24,1890,2.3595303151837372
SIM,1907,17,na,1924,4700
STAT,1951,32,45-49,1983,2.2042534175078448
STAT,1946,18,50-100,1964,0.4794005870065627
SIM,1860,99,na,1959,3
SIM,1954,18,50-100,1972,1
SIM,1853,15,40-44,1868,1
STAT,1952,33,45-49,1985,2.2168842130451027
SIM,1907,36,45-49,1943,1
SIM,1853,34,45-49,1887,1
SIM,1823,46,35-39,1869,1
SIM,1849,34,25-29,1883,20
SIM,1902,32,45-49,1934,10
SIM,1859,51,na,1910,2056
STAT,1815,46,35-39,1861,0.29007352354433813
SIM,1879,90,na,1969,192
STAT,1937,43,20-24,1980,0.020536390775531932
STAT,1893,49,50-100,1942,0.19786972526774563
SIM,1875,37,50-100,1912,4
STAT,1779,81,na,1860,171.8084651643632
STAT,1850,18,na,1868,2870.581951992887
STAT,1962,32,20-24,1994,3.6764325048747573
SIM,1929,20,na,1949,5348
STAT,1907,7,na,1914,4423.828850230597
SIM,1978,22,35-39,2000,38
STAT,1845,34,45-49,1879,1.3684623569017806
SIM,1888,64,na,1952,1886
SIM,1924,3,na,1927,5428
STAT,1895,22,40-44,1917,3.1302809138079004
STAT,1961,35,45-49,1996,1.0490007997170636
STAT,1923,35,na,1958,5037.590309962439
STAT,1904,19,30-34,1923,2.627225799089319
STAT,1960,43,50-100,2003,0.18321953544584613
STAT,1913,28,na,1941,4294.809430142804
STAT,1775,114,na,1889,4.156402186507376E-4
STAT,1919,26,15-19,1945,0.8830917046532388
STAT,1946,45,20-24,1991,0.014782482595471767
STAT,1902,65,na,1967,3076.949406635527
STAT,1964,46,35-39,2010,0.19541095062254873
STAT,1830,46,30-34,1876,0.09048506549632129
STAT,1947,32,25-29,1979,12.247206739794047
SIM,1930,23,15-19,1953,7
STAT,1913,21,15-19,1934,5.973931893308137
SIM,1879,68,na,1947,1740
SIM,1977,29,na,2006,6186
SIM,1953,16,15-19,1969,109
SIM,1955,32,25-29,1987,5
STAT,1988,18,15-19,2006,74.88309587515111
SIM,1848,33,25-29,1881,2
STAT,1869,32,40-44,1901,4.846750400409666
SIM,1983,22,na,2005,6127
STAT,1943,8,na,1951,4839.382291660496
SIM,1806,89,na,1895,16
SIM,1854,46,50-100,1900,1
STAT,1936,42,20-24,1978,0.020194925342227464
STAT,1858,26,50-100,1884,0.5938160891327253
SIM,1928,19,20-24,1947,228
STAT,1815,52,na,1867,1560.7755375790216
SIM,1891,39,na,1930,3306
SIM,1933,27,50-100,1960,1
STAT,1862,51,na,1913,2107.07333995899
SIM,1912,19,30-34,1931,8
SIM,1921,29,25-29,1950,128
SIM,1911,25,na,1936,4712
STAT,1971,28,50-100,1999,1.460455025431714
SIM,1930,68,na,1998,5027
STAT,1871,24,45-49,1895,0.7956013040397979
STAT,1922,23,15-19,1945,7.020022451458542
STAT,1838,17,15-19,1855,6.791396330322742
SIM,1922,17,na,1939,5082
STAT,1903,18,30-34,1921,2.613101947133649
STAT,1845,15,40-44,1860,0.15762879546566091
STAT,1879,21,45-49,1900,0.8428225565280789
STAT,1923,24,15-19,1947,7.100513064062455
SIM,1919,39,40-44,1958,1
STAT,1913,29,25-29,1942,75.18556879114976
SIM,1887,21,45-49,1908,1
STAT,1872,25,45-49,1897,1.295350572025542
SIM,1899,24,40-44,1923,2
SIM,1878,33,40-44,1911,7
STAT,1914,44,35-39,1958,0.22961183194167822
STAT,1945,16,15-19,1961,57.228893162919036
SIM,1964,37,40-44,2001,4
STAT,1849,32,na,1881,1948.9682255360103
SIM,1895,13,na,1908,4007
SIM,1877,32,40-44,1909,9
SIM,1928,22,20-24,1950,1
STAT,1927,71,na,1998,4058.9958129436855
SIM,1899,34,50-100,1933,3
SIM,1981,22,50-100,2003,1
SIM,1972,30,na,2002,5771
SIM,1832,41,na,1873,2123
STAT,1925,27,50-100,1952,1.3562878748362868
SIM,1931,24,15-19,1955,9
STAT,1871,87,na,1958,269.48122439331325
STAT,1944,15,15-19,1959,56.39533341586306
STAT,1811,78,na,1889,395.75272203068585
STAT,1961,36,15-19,1997,0.029525091372136582
STAT,1892,109,na,2001,0.10601678011732132
SIM,1879,82,na,1961,481
STAT,1790,80,na,1870,263.7124839319369
SIM,1876,33,30-34,1909,3
STAT,1887,35,20-24,1922,1.0064248235929387
SIM,1963,18,30-34,1981,49
STAT,1930,17,15-19,1947,67.72082129060618
STAT,1823,101,na,1924,0.32313719924793144
STAT,1881,50,20-24,1931,8.332034001732002E-4
STAT,1784,74,na,1858,461.3222563559341
SIM,1836,31,35-39,1867,29
STAT,1911,24,na,1935,4154.151506982006
STAT,1828,56,na,1884,1414.7345901097397
STAT,1868,33,30-34,1901,19.277075390856712
SIM,1872,28,20-24,1900,22
STAT,1906,35,40-44,1941,1.6051540576637813
SIM,1853,65,na,1918,1518
STAT,1871,28,20-24,1899,13.421776982505031
SIM,1832,26,25-29,1858,57
STAT,1980,19,35-39,1999,6.71807497264979
STAT,1921,39,25-29,1960,1.2655834192831101
STAT,1836,43,50-100,1879,1.1296056688991332
STAT,1888,32,45-49,1920,2.3656248895260314
SIM,1828,76,na,1904,911
STAT,1964,44,15-19,2008,0.0023120058745359304
STAT,1975,17,45-49,1992,0.7605358338132071
SIM,1881,28,30-34,1909,62
SIM,1968,33,50-100,2001,1
SIM,1878,19,25-29,1897,11
SIM,1914,35,40-44,1949,5
SIM,1933,35,35-39,1968,1
STAT,1843,20,20-24,1863,88.0516165164631
SIM,1870,69,na,1939,2081
SIM,1936,54,na,1990,3812
SIM,1940,25,40-44,1965,17
STAT,1891,24,30-34,1915,25.24693737561188
STAT,1846,35,45-49,1881,2.1972469844736433
STAT,1843,13,na,1856,3047.1423806700004
STAT,1940,39,na,1979,4533.477104740397
SIM,1919,50,na,1969,5213
STAT,1899,50,na,1949,3453.3257779321184
SIM,1915,29,50-100,1944,2
STAT,1828,31,35-39,1859,12.074597012458279
SIM,1867,30,25-29,1897,12
STAT,1965,21,15-19,1986,7.697314356497289
STAT,1925,35,35-39,1960,3.3549579089039967
STAT,1871,3,na,1874,3587.6714938147475
STAT,1968,21,40-44,1989,4.864168545111336
SIM,1851,20,20-24,1871,144
SIM,1837,37,25-29,1874,10
SIM,1910,37,na,1947,3617
SIM,1968,27,20-24,1995,50
STAT,1873,28,30-34,1901,29.572151627426702
SIM,1930,18,35-39,1948,7
STAT,1839,25,50-100,1864,0.6483712317303182
STAT,1932,25,40-44,1957,7.053308190155268
STAT,1937,41,na,1978,4331.818749166949
SIM,1973,21,15-19,1994,5
STAT,1965,17,50-100,1982,0.5397890326947777
SIM,1985,20,25-29,2005,6
SIM,1940,33,50-100,1973,4
STAT,1922,18,35-39,1940,5.58722790098276
STAT,1900,47,40-44,1947,0.15392364842179168
STAT,1958,11,na,1969,5954.92957161284
STAT,1959,21,30-34,1980,43.544852506132784
STAT,1903,34,45-49,1937,1.631826955364354
SIM,1936,36,30-34,1972,2
SIM,1957,27,45-49,1984,4
STAT,1943,20,25-29,1963,113.50294459103259
SIM,1839,23,30-34,1862,42
STAT,1856,37,25-29,1893,2.5349870780615693
STAT,1831,23,20-24,1854,157.61383191922076
STAT,1896,39,20-24,1935,1.1631684502508595
STAT,1850,51,30-34,1901,0.006157147834200499
SIM,1909,20,30-34,1929,42
STAT,1851,28,35-39,1879,8.894577389472571
STAT,1883,67,na,1950,1789.85722541249
STAT,1859,30,25-29,1889,9.553239422732698
SIM,1915,20,15-19,1935,15
STAT,1929,28,30-34,1957,56.567721328287256
SIM,1825,30,20-24,1855,4
SIM,1937,28,30-34,1965,2
STAT,1870,50,45-49,1920,0.016748396273759344
STAT,1912,44,25-29,1956,0.078941892767957
SIM,1967,21,30-34,1988,42
STAT,1881,86,na,1967,524.4278679883078
STAT,1880,38,15-19,1918,0.06834987036572132
STAT,1949,27,45-49,1976,2.3287713953217106
SIM,1990,7,na,1997,6333
STAT,1881,47,20-24,1928,0.013295276146488677
STAT,1917,16,45-49,1933,0.12436460042017759
STAT,1905,33,50-100,1938,0.8750619056303356
SIM,1951,20,25-29,1971,292
STAT,1928,36,30-34,1964,2.6605444866468955
STAT,1841,45,25-29,1886,0.052778953958689236
STAT,1939,31,15-19,1970,0.1514637272875974
SIM,1853,38,20-24,1891,2
SIM,1892,29,45-49,1921,3
SIM,1933,5,na,1938,6681
STAT,1885,39,45-49,1924,2.2716256619482293
SIM,1967,38,na,2005,5682
SIM,1969,15,50-100,1984,1
STAT,1814,56,na,1870,1639.4784728435693
STAT,1803,80,na,1883,270.0497957957649
STAT,1833,26,35-39,1859,9.184068012291547
STAT,1884,29,45-49,1913,1.2569426468480325
STAT,1849,27,40-44,1876,2.752236210190606
SIM,1982,24,20-24,2006,343
STAT,1870,47,45-49,1917,0.2672511339057959
STAT,1928,16,20-24,1944,197.62494147082506
STAT,1852,54,45-49,1906,0.013306239197552475
STAT,1914,34,20-24,1948,2.810573582582409
STAT,1845,38,20-24,1883,0.5401333583440592
STAT,1781,105,na,1886,0.015834429023946425
SIM,1831,33,50-100,1864,2
SIM,1925,2,na,1927,5754
STAT,1839,47,35-39,1886,0.11312212347879183
STAT,1907,16,50-100,1923,0.0833912786066394
STAT,1865,24,15-19,1889,3.4271368593077516
STAT,1834,38,45-49,1872,2.2395058472059657
STAT,1864,31,45-49,1895,1.8042501883250741
STAT,1923,42,50-100,1965,0.15840357918371048
SIM,1873,34,30-34,1907,4
SIM,1893,36,40-44,1929,16
SIM,1952,28,50-100,1980,4
STAT,1840,27,20-24,1867,11.734128321852985
SIM,1901,24,35-39,1925,15
STAT,1819,48,20-24,1867,0.022772872268306252
STAT,1890,18,20-24,1908,24.93386193281501
SIM,1962,29,35-39,1991,50
SIM,1842,35,40-44,1877,12
SIM,1886,52,na,1938,1823
STAT,1858,68,na,1926,1375.8148540668105
STAT,1835,26,na,1861,1769.4629542248742
STAT,1954,21,50-100,1975,0.9421531834982774
STAT,1879,24,50-100,1903,0.48831892290793877
STAT,1900,17,45-49,1917,0.10460456322345413
STAT,1844,32,30-34,1876,17.4635886920891
SIM,1930,48,30-34,1978,1
SIM,1815,58,na,1873,1520
STAT,1879,49,30-34,1928,0.11421035181483882
SIM,1919,42,na,1961,5342
SIM,1941,17,40-44,1958,9
STAT,1947,24,30-34,1971,37.460387139472694
SIM,1982,27,25-29,2009,270
STAT,1823,49,25-29,1872,0.05533959231704314
SIM,1868,22,25-29,1890,78
SIM,1992,16,50-100,2008,1
STAT,1974,27,25-29,2001,99.61503909532239
SIM,1968,9,na,1977,5398
STAT,1886,18,na,1904,3066.3934426635624
STAT,1922,48,30-34,1970,0.11780787280089547
STAT,1814,43,15-19,1857,0.04355012022934829
STAT,1942,47,45-49,1989,0.27268618192773764
STAT,1823,52,25-29,1875,0.003370937105705348
SIM,1943,24,na,1967,5005
STAT,1933,17,40-44,1950,2.1617738430872557
SIM,1967,35,35-39,2002,2
SIM,1976,16,15-19,1992,59
STAT,1849,41,20-24,1890,0.12364789120584549
STAT,1885,36,40-44,1921,5.063236930918627
SIM,1858,45,45-49,1903,1
STAT,1829,37,25-29,1866,3.3041933733591646
STAT,1891,62,na,1953,2606.926150991942
STAT,1883,21,na,1904,2678.420181457744
STAT,1891,64,na,1955,2479.452206814031
SIM,1921,92,na,2013,602
STAT,1894,23,30-34,1917,26.34356639859944
STAT,1928,19,25-29,1947,62.675927280323855
STAT,1964,0,na,1964,5757.327846560234
SIM,1818,40,50-100,1858,3
STAT,1860,40,35-39,1900,1.701248291905799
SIM,1982,6,na,1988,6829
STAT,1907,20,15-19,1927,5.635081986095818
SIM,1969,15,na,1984,5181
STAT,1824,34,na,1858,1790.563484289075
STAT,1889,38,35-39,1927,10.01181459139625
SIM,1897,38,35-39,1935,4
SIM,1904,25,30-34,1929,10
SIM,1965,32,20-24,1997,1
SIM,1828,45,45-49,1873,1
STAT,1870,22,30-34,1892,20.265465352478905
STAT,1850,16,25-29,1866,7.170791349279762
SIM,1906,33,25-29,1939,17
SIM,1951,28,20-24,1979,46
SIM,1976,21,40-44,1997,6
STAT,1968,16,15-19,1984,65.43444552836345
STAT,1943,28,20-24,1971,22.42679755450968
SIM,1912,18,na,1930,4007
STAT,1865,46,25-29,1911,0.06014663317936913
SIM,1986,26,15-19,2012,1
SIM,1988,15,25-29,2003,156
SIM,1867,46,40-44,1913,1
SIM,1884,35,45-49,1919,2
STAT,1876,35,45-49,1911,2.4007734201294846
SIM,1965,11,na,1976,5616
SIM,1899,27,45-49,1926,4
STAT,1958,46,40-44,2004,0.24918825017270432
SIM,1873,46,25-29,1919,1
STAT,1903,35,15-19,1938,0.02011256481845059
STAT,1873,99,na,1972,17.82443413574703
SIM,1883,29,35-39,1912,12
SIM,1966,28,50-100,1994,4
STAT,1923,27,na,1950,4961.715609278958
STAT,1871,43,15-19,1914,0.015740893376494227
STAT,1865,48,na,1913,2313.224757040194
STAT,1970,22,35-39,1992,13.647473599055113
SIM,1852,32,30-34,1884,13
SIM,1888,38,25-29,1926,6
STAT,1983,24,30-34,2007,47.0444818090215
STAT,1978,26,15-19,2004,1.1171624174917438
STAT,1870,19,15-19,1889,6.736142051444588
STAT,1875,29,35-39,1904,11.425023248976922
STAT,1869,39,20-24,1908,0.8528364367184467
STAT,1934,38,50-100,1972,0.6682953326235639
SIM,1870,77,na,1947,1392
SIM,1816,45,40-44,1861,1
STAT,1934,25,50-100,1959,1.5473677441801843
STAT,1982,20,50-100,2002,1.0728054775264442
STAT,1940,27,25-29,1967,77.48297778649955
STAT,1854,21,35-39,1875,5.626354041294121
STAT,1776,113,na,1889,7.168118184429546E-4
SIM,1951,11,na,1962,6323
STAT,1899,32,20-24,1931,4.273726261278202
STAT,1968,35,45-49,2003,1.014113776894961
STAT,1825,38,35-39,1863,11.405961122129167
SIM,1877,39,20-24,1916,4
SIM,1833,38,35-39,1871,17
STAT,1859,46,40-44,1905,0.15783181172558525
STAT,1904,27,15-19,1931,0.7518845577864935
STAT,1954,29,35-39,1983,21.49062361979762
SIM,1873,63,na,1936,2483
STAT,1949,41,25-29,1990,0.09974751238994531
STAT,1781,103,na,1884,0.04032037832878583
STAT,1860,28,45-49,1888,1.0362733701599431
STAT,1782,93,na,1875,9.158856420152205
STAT,1941,44,50-100,1985,0.14467908778845678
SIM,1891,17,35-39,1908,2
STAT,1896,45,15-19,1941,3.473582602242498E-4
STAT,1843,23,25-29,1866,71.58023471202647
SIM,1857,20,15-19,1877,1
SIM,1956,42,na,1998,5380
STAT,1942,7,na,1949,4786.766891324104
STAT,1839,17,30-34,1856,1.65351891244873
STAT,1986,4,na,1990,6466.786497989474
STAT,1818,39,15-19,1857,0.08191686454269935
SIM,1924,51,na,1975,4773
STAT,1870,44,40-44,1914,2.5245130825654893
SIM,1916,56,na,1972,4270
SIM,1954,15,25-29,1969,75
STAT,1917,38,20-24,1955,0.314421899505139
SIM,1925,38,20-24,1963,1
STAT,1883,17,35-39,1900,0.6195432606826565
STAT,1910,36,45-49,1946,0.7568345379028203
STAT,1946,15,25-29,1961,55.49783895567877
SIM,1829,36,50-100,1865,7
SIM,1914,27,25-29,1941,70
SIM,1851,23,25-29,1874,4
SIM,1847,17,30-34,1864,1
SIM,1833,77,na,1910,622
STAT,1914,37,25-29,1951,1.135053444193007
STAT,1832,75,na,1907,701.362564856036
SIM,1862,26,na,1888,2991
SIM,1935,49,50-100,1984,1
STAT,1916,65,na,1981,3791.0707350143443
STAT,1906,47,35-39,1953,0.13227953245598012
STAT,1932,28,45-49,1960,2.6107747475576732
STAT,1940,19,40-44,1959,1.6383701588661976
SIM,1947,46,na,1993,5869
STAT,1844,94,na,1938,16.71680751754937
SIM,1928,34,15-19,1962,1
STAT,1929,0,na,1929,6635.491537668093
SIM,1906,24,na,1930,3889
SIM,1961,29,na,1990,5380
SIM,1868,33,na,1901,3062
STAT,1857,30,15-19,1887,0.13149032475629374
STAT,1911,29,15-19,1940,0.789504700202905
STAT,1921,36,20-24,1957,0.33986743022847044
SIM,1954,24,15-19,1978,10
SIM,1842,73,na,1915,1234
STAT,1851,25,30-34,1876,23.7204635132633
STAT,1859,93,na,1952,26.867042127623442
SIM,1832,23,20-24,1855,2
SIM,1949,20,25-29,1969,247
STAT,1900,32,na,1932,3821.332716457763
STAT,1839,34,15-19,1873,0.13612471856481015
STAT,1964,28,25-29,1992,96.03836726252207
STAT,1849,20,15-19,1869,3.1363279265158694
SIM,1846,41,45-49,1887,5
SIM,1881,17,30-34,1898,5
STAT,1812,48,50-100,1860,0.5600508621428398
STAT,1949,24,40-44,1973,4.524691601422776
STAT,1972,22,45-49,1994,1.668056459014835
STAT,1808,58,na,1866,1415.6621241749613
STAT,1985,25,35-39,2010,24.77114909479286
STAT,1965,47,50-100,2012,0.3389547567772496
STAT,1980,16,30-34,1996,19.532959065461615
STAT,1873,17,30-34,1890,1.878358966277342
SIM,1958,32,50-100,1990,2
SIM,1886,38,na,1924,2049
STAT,1968,24,45-49,1992,1.626092058992354
SIM,1914,38,45-49,1952,1
SIM,1880,25,45-49,1905,1
STAT,1912,41,20-24,1953,0.019788933505663284
STAT,1964,43,30-34,2007,0.19281189623109748
STAT,1840,33,15-19,1873,0.13770575556161793
STAT,1852,51,40-44,1903,0.009973099626250452
SIM,1828,90,na,1918,116
SIM,1854,40,50-100,1894,5
STAT,1892,36,40-44,1928,6.362245538579845
STAT,1934,76,na,2010,3752.6057935420404
STAT,1838,41,45-49,1879,1.5359526306241202
STAT,1849,40,na,1889,1822.6766793913898
SIM,1932,23,25-29,1955,144
STAT,1967,29,20-24,1996,26.401843666463698
STAT,1891,27,35-39,1918,13.762442049678052
STAT,1885,20,25-29,1905,66.2891264668404
SIM,1922,37,25-29,1959,4
STAT,1893,45,na,1938,3315.2197007118352
STAT,1938,38,25-29,1976,1.1541798108673502
STAT,1928,39,35-39,1967,3.5201050711382624
STAT,1906,27,25-29,1933,71.18783436437526
SIM,1893,20,25-29,1913,179
SIM,1909,23,35-39,1932,14
SIM,1839,26,35-39,1865,18
SIM,1917,28,20-24,1945,1
SIM,1956,46,na,2002,5355
SIM,1946,38,25-29,1984,3
SIM,1936,19,25-29,1955,54
STAT,1924,23,25-29,1947,125.36180961289827
STAT,1855,51,50-100,1906,0.012912348722974828
STAT,1981,24,20-24,2005,179.9070485729481
STAT,1899,18,40-44,1917,0.288424959317386
STAT,1854,42,40-44,1896,1.830222160483083
STAT,1846,48,20-24,1894,0.012249511550168436
STAT,1868,24,40-44,1892,2.295995897129282
STAT,1822,37,15-19,1859,0.13662305905366592
STAT,1986,2,na,1988,6471.056706895592
SIM,1805,81,na,1886,177
STAT,1870,25,35-39,1895,11.052296403246755
STAT,1878,38,15-19,1916,0.06732813919025137
SIM,1825,33,25-29,1858,16
STAT,1909,28,20-24,1937,20.084110529642825
STAT,1838,38,20-24,1876,0.7975306025793117
SIM,1901,26,na,1927,3956
SIM,1836,42,50-100,1878,2
STAT,1846,32,40-44,1878,5.2980478510376185
STAT,1828,42,50-100,1870,1.0162877419054428
SIM,1893,39,45-49,1932,10
SIM,1854,32,40-44,1886,8
SIM,1906,28,45-49,1934,3
SIM,1888,19,na,1907,2977
STAT,1886,32,35-39,1918,12.327790350421242
SIM,1852,29,15-19,1881,1
STAT,1878,22,35-39,1900,7.031494151241768
STAT,1894,59,na,1953,2883.2052554130637
SIM,1894,32,35-39,1926,32
SIM,1801,58,na,1859,1430
STAT,1844,29,15-19,1873,0.45790915495278844
SIM,1947,6,na,1953,6105
STAT,1830,47,15-19,1877,3.690648067945299E-4
STAT,1906,38,45-49,1944,0.7205084618823749
STAT,1996,16,20-24,2012,227.44732268887338
STAT,1849,5,na,1854,2399.0
STAT,1865,37,35-39,1902,7.3647224212682225
STAT,1896,18,15-19,1914,9.022252861993076
SIM,1863,27,25-29,1890,48
STAT,1931,38,50-100,1969,0.6411921467499538
STAT,1890,21,45-49,1911,0.9862759263490932
SIM,1855,15,na,1870,2152
STAT,1944,11,na,1955,4879.437254562773
SIM,1875,44,na,1919,3062
SIM,1901,21,30-34,1922,1
STAT,1949,37,50-100,1986,0.5805613852407505
SIM,1833,35,30-34,1868,6
SIM,1914,75,na,1989,2556
STAT,1864,28,20-24,1892,12.046023387672843
STAT,1829,108,na,1937,0.0013418828319276448
SIM,1891,82,na,1973,1101
SIM,1847,44,30-34,1891,5
STAT,1840,19,35-39,1859,0.5632134359115184
STAT,1946,32,45-49,1978,2.053074535149497
SIM,1962,26,30-34,1988,71
STAT,1818,36,50-100,1854,2.2830131577142248
STAT,1869,53,50-100,1922,0.0166079485758037
SIM,1954,32,45-49,1986,4
STAT,1924,18,45-49,1942,0.6845214321687882
STAT,1951,25,35-39,1976,20.73941655414743
STAT,1825,35,30-34,1860,9.329941665443533
STAT,1855,27,25-29,1882,37.51783638870995
SIM,1909,31,50-100,1940,1
SIM,1828,42,40-44,1870,5
STAT,1962,16,20-24,1978,200.52865542058586
SIM,1975,25,na,2000,5644
STAT,1924,23,na,1947,4956.142077418708
STAT,1947,27,35-39,1974,19.60134832556717
SIM,1993,19,15-19,2012,144
STAT,1846,15,20-24,1861,23.296589690714747
STAT,1886,32,na,1918,2904.8830454015047
STAT,1806,77,na,1883,353.69725935984405
SIM,1855,27,30-34,1882,26
STAT,1849,39,35-39,1888,5.494237980645498
SIM,1932,18,45-49,1950,1
SIM,1949,27,na,1976,5848
SIM,2003,10,na,2013,6665
SIM,1970,16,20-24,1986,212
STAT,1989,18,30-34,2007,20.14150632740356
STAT,1968,32,40-44,2000,5.749724574786863
SIM,1883,31,20-24,1914,2
SIM,1899,36,35-39,1935,5
STAT,1839,44,30-34,1883,0.9366285715707077
SIM,1838,31,45-49,1869,4
STAT,1939,17,35-39,1956,4.849270701791826
STAT,1914,29,40-44,1943,5.3864552821646985
STAT,1875,31,20-24,1906,3.236829367289455
SIM,1826,36,50-100,1862,5
SIM,1857,39,35-39,1896,3
STAT,1834,50,35-39,1884,0.008381192271590326
SIM,1957,37,50-100,1994,1
SIM,1854,15,20-24,1869,37
STAT,1972,38,15-19,2010,0.029203715806624366
STAT,1985,19,15-19,2004,74.44177382719687
STAT,1901,20,20-24,1921,112.06050797522545
STAT,1940,24,20-24,1964,130.67578741618416
STAT,1850,54,35-39,1904,0.008618847282477245
STAT,1861,25,50-100,1886,0.6271580031248701
SIM,1852,35,35-39,1887,16
SIM,1868,42,35-39,1910,7
STAT,1899,35,25-29,1934,4.595446454280885
SIM,1957,24,40-44,1981,10
STAT,1858,22,15-19,1880,3.4077308769264363
STAT,1892,24,50-100,1916,0.5861495364560684
STAT,1957,21,20-24,1978,169.80525191503645
SIM,1840,47,na,1887,1845
STAT,1852,25,50-100,1877,0.7126648525393157
SIM,1867,49,45-49,1916,1
SIM,1914,73,na,1987,2682
STAT,1859,49,45-49,1908,0.2124260381363402
STAT,1847,27,30-34,1874,23.289350467733005
STAT,1848,44,na,1892,2422.608183928186
STAT,1954,26,30-34,1980,56.16735302978113
STAT,1828,52,40-44,1880,0.009363502373168223
STAT,1865,34,30-34,1899,18.024386526541782
SIM,1918,20,40-44,1938,4
SIM,1865,68,na,1933,1969
STAT,1873,115,na,1988,1.1810157429913978E-4
STAT,1844,35,35-39,1879,7.013978253793963
SIM,1920,21,35-39,1941,35
SIM,1873,37,35-39,1910,15
STAT,1933,59,na,1992,5484.946349385862
STAT,1973,17,35-39,1990,6.262935366195105
STAT,1889,46,20-24,1935,0.01711929914227922
SIM,1903,81,na,1984,1288
STAT,1835,24,35-39,1859,4.810946021185672
SIM,1965,21,20-24,1986,296
SIM,1843,24,35-39,1867,7
SIM,1860,45,na,1905,2326
SIM,1946,68,na,2014,3709
SIM,1888,35,20-24,1923,2
STAT,1959,19,na,1978,5552.6651309301305
STAT,1881,17,25-29,1898,6.307800346963158
STAT,1865,43,20-24,1908,0.1641704735253134
STAT,1857,16,35-39,1873,0.5830975469439028
STAT,1955,18,30-34,1973,18.667425878949373
STAT,1912,21,35-39,1933,10.455356607482415
STAT,1876,24,50-100,1900,0.48343985190350164
STAT,1819,95,na,1914,8.851004985292455
STAT,1827,35,40-44,1862,6.7403039128667945
STAT,1924,48,40-44,1972,0.2159529907087794
SIM,1876,25,45-49,1901,2
STAT,1844,54,40-44,1898,0.008563416979903486
STAT,1971,39,50-100,2010,0.6309033355204668
STAT,1915,30,15-19,1945,0.15227941744225343
STAT,1928,58,na,1986,5131.633627146743
SIM,1957,36,35-39,1993,4
SIM,1975,34,25-29,2009,2
SIM,1960,2,na,1962,6340
STAT,1839,22,20-24,1861,70.22010266305696
STAT,1848,27,25-29,1875,53.65754524316025
SIM,1964,26,40-44,1990,11
SIM,1886,46,45-49,1932,2
STAT,1843,27,50-100,1870,0.7899173982948838
STAT,1920,30,na,1950,4817.17393792414
SIM,1972,25,20-24,1997,58
SIM,1856,27,25-29,1883,72
SIM,1902,39,50-100,1941,1
STAT,1822,34,45-49,1856,5.002311948293842
STAT,1931,25,25-29,1956,98.17413374227155
SIM,1862,71,na,1933,1513
SIM,1827,31,50-100,1858,2
SIM,1903,24,45-49,1927,1
STAT,1845,79,na,1924,471.09550436552377
SIM,1946,7,na,1953,4700
SIM,1826,45,35-39,1871,1
STAT,1981,27,25-29,2008,106.67419055847213
SIM,1838,23,15-19,1861,4
SIM,1969,23,15-19,1992,12
STAT,1938,35,20-24,1973,0.30985736961388693
STAT,1905,27,30-34,1932,42.06188925669086
STAT,1894,48,45-49,1942,0.19501263851213996
STAT,1891,33,20-24,1924,3.839151946371135
SIM,1953,23,50-100,1976,1
SIM,1866,22,15-19,1888,8
STAT,1822,84,na,1906,273.3249582645311
SIM,1961,25,45-49,1986,4
STAT,1932,33,50-100,1965,1.2679399319570277
STAT,1967,34,25-29,2001,13.56383002549098
STAT,1833,34,20-24,1867,2.4194496604422846
SIM,1847,25,50-100,1872,1
STAT,1818,45,35-39,1863,0.17782874524251654
SIM,1925,36,na,1961,5330
STAT,1952,27,50-100,1979,1.3824885645635252
STAT,1900,26,35-39,1926,15.504391223920438
STAT,1931,17,30-34,1948,18.41562780888891
STAT,1881,38,30-34,1919,5.903082890745144
SIM,1927,48,na,1975,4901
SIM,1948,31,30-34,1979,46
SIM,1906,78,na,1984,1990
SIM,1841,34,20-24,1875,5
STAT,1930,62,na,1992,5082.991411035362
STAT,1821,37,20-24,1858,1.7152136861976541
STAT,1867,46,35-39,1913,0.1512766667358794
STAT,1953,25,45-49,1978,2.4243743377464724
STAT,1906,24,20-24,1930,115.24483981295198
STAT,1896,107,na,2003,0.5592830809832707
SIM,1974,21,30-34,1995,93
SIM,1826,35,na,1861,2066
SIM,1839,82,na,1921,574
SIM,1938,4,na,1942,4244
STAT,1888,44,na,1932,3093.04755281958
STAT,1898,51,na,1949,3374.413730249022
STAT,1927,36,15-19,1963,0.027572506561531082
STAT,1876,43,30-34,1919,1.361622265035238
SIM,1820,43,40-44,1863,6
SIM,1815,44,20-24,1859,1
STAT,1897,35,15-19,1932,0.08747696697763725
STAT,1837,52,na,1889,1564.8212865050277
SIM,1941,34,25-29,1975,1
STAT,1836,21,25-29,1857,69.27791628161611
SIM,1883,41,na,1924,2464
STAT,1933,34,25-29,1967,14.36221461205439
SIM,1841,35,25-29,1876,3
STAT,1890,24,15-19,1914,4.622897967610961
STAT,1996,19,25-29,2015,72.63197003194841
STAT,1964,25,20-24,1989,26.670305142359993
STAT,1927,35,45-49,1962,0.9796271608001142
STAT,1955,38,na,1993,5932.076024639937
STAT,1938,69,na,2007,3498.028309086966
SIM,1877,27,na,1904,3310
STAT,1884,51,na,1935,2466.8336474054204
SIM,1884,43,30-34,1927,2
STAT,1966,21,30-34,1987,41.57898290312085
SIM,1857,36,30-34,1893,12
STAT,1954,42,45-49,1996,0.2467556403667487
SIM,1836,42,na,1878,1632
SIM,1844,21,25-29,1865,77
STAT,1987,25,45-49,2012,2.8610277546592857
SIM,1873,34,na,1907,3368
STAT,1892,39,45-49,1931,2.854427005933427
SIM,1835,35,40-44,1870,9
STAT,1851,64,na,1915,1378.5092320528204
STAT,1949,36,35-39,1985,3.347611008185614
STAT,1812,43,40-44,1855,6.071107780414806
SIM,1847,22,20-24,1869,6
STAT,1823,33,50-100,1856,2.285805597262265
STAT,1921,4,na,1925,5307.489786427787
STAT,1977,31,na,2008,6014.786464446247
SIM,1952,47,na,1999,4602
SIM,1851,34,na,1885,2759
STAT,1905,20,50-100,1925,0.6852055005158584
SIM,1913,35,25-29,1948,1
STAT,1823,46,20-24,1869,0.012023802535665354
STAT,1855,24,20-24,1879,67.52278518788407
SIM,1859,37,na,1896,2333
SIM,1863,24,20-24,1887,71
SIM,1879,49,50-100,1928,1
STAT,1929,19,40-44,1948,2.049079541934715
SIM,1903,0,na,1903,4648
SIM,1916,20,30-34,1936,42
STAT,1944,20,40-44,1964,4.1926937769372286
STAT,1909,85,na,1994,1283.7122469637995
STAT,1905,35,25-29,1940,1.0478790413049905
STAT,1894,15,45-49,1909,0.09735874796375474
SIM,1828,28,25-29,1856,75
SIM,1914,24,20-24,1938,280
STAT,1956,26,40-44,1982,7.151745313603035
SIM,1922,70,na,1992,3676
STAT,1907,44,25-29,1951,0.07469523786647692
STAT,1884,26,40-44,1910,3.4273262808341802
SIM,1989,19,na,2008,6305
STAT,1891,19,na,1910,3582.999445008538
STAT,1821,69,na,1890,897.5373337645995
STAT,1789,72,na,1861,442.1720965174938
STAT,1922,11,na,1933,5297.574910465952
STAT,1840,27,na,1867,2163.764104094466
STAT,1867,29,na,1896,2553.0725315007476
STAT,1908,20,30-34,1928,30.714048418580266
SIM,1935,35,45-49,1970,2
SIM,1912,63,na,1975,3218
STAT,1849,36,30-34,1885,4.271006365476386
STAT,1998,3,na,2001,6665.5655275705685
SIM,1874,24,30-34,1898,3
STAT,1944,28,50-100,1972,1.24095788732172
STAT,1984,16,50-100,2000,0.6142564701571047
SIM,1982,15,50-100,1997,1
SIM,1938,22,15-19,1960,1
SIM,1983,20,15-19,2003,14
STAT,1893,36,35-39,1929,10.367059888406896
SIM,1809,45,40-44,1854,1
SIM,1816,57,na,1873,1431
STAT,1874,106,na,1980,0.48418760205265454
STAT,1921,15,50-100,1936,0.49495185419554133
SIM,1870,19,20-24,1889,1
STAT,1880,56,na,1936,2494.9644370614437
SIM,1849,60,na,1909,2123
STAT,1805,102,na,1907,0.12047959877312328
SIM,1885,22,na,1907,3342
SIM,1866,64,na,1930,1723
STAT,1972,33,45-49,2005,2.36858573910786
SIM,1990,24,15-19,2014,9
STAT,1872,19,50-100,1891,0.05646744109959686
STAT,1919,76,na,1995,2919.2748552347093
STAT,1881,21,50-100,1902,0.45529380600518315
SIM,1826,64,na,1890,1206
SIM,1892,26,40-44,1918,7
SIM,1940,59,na,1999,4550
SIM,1844,29,20-24,1873,2
STAT,1904,15,20-24,1919,29.516566597637375
SIM,1923,55,na,1978,5046
STAT,1836,29,20-24,1865,13.622160899009671
SIM,1876,24,40-44,1900,3
SIM,1869,48,25-29,1917,1
SIM,1912,15,20-24,1927,28
SIM,1980,33,45-49,2013,5
STAT,1924,15,40-44,1939,1.9306237945966636
STAT,1982,24,15-19,2006,8.667111194736135
SIM,1962,21,50-100,1983,1
STAT,1966,24,35-39,1990,13.607932629484779
SIM,1967,24,35-39,1991,31
STAT,1923,84,na,2007,1813.3590975118886
STAT,1946,24,15-19,1970,6.83146761062501
STAT,1843,45,35-39,1888,0.1434473653497578
SIM,1904,41,45-49,1945,3
STAT,1915,16,35-39,1931,1.0161905668926627
SIM,1938,36,40-44,1974,2
STAT,1957,24,25-29,1981,140.91481015238423
STAT,1821,46,50-100,1867,0.45066952707157343
STAT,1918,38,50-100,1956,0.51008326964534
STAT,1959,24,35-39,1983,14.251320688747061
SIM,1913,27,30-34,1940,1
SIM,1830,34,45-49,1864,4
STAT,1846,18,25-29,1864,7.315690414817822
SIM,1854,18,25-29,1872,15
STAT,1878,46,45-49,1924,0.28517688990512235
STAT,1858,12,na,1870,2510.5469261386534
STAT,1862,19,20-24,1881,17.78407858179878
STAT,1989,21,20-24,2010,184.4717839400576
STAT,1950,38,40-44,1988,2.1023657129497826
SIM,1815,72,na,1887,710
SIM,1990,20,50-100,2010,1
SIM,1927,47,20-24,1974,1
STAT,1900,23,30-34,1923,28.43566192331464
STAT,1839,53,20-24,1892,5.758106849801158E-4
STAT,1831,26,25-29,1857,44.41656139022111
SIM,1942,25,50-100,1967,2
SIM,1993,13,na,2006,6952
SIM,1837,27,na,1864,2497
SIM,1877,56,na,1933,2652
STAT,1866,24,30-34,1890,18.933844222627503
SIM,1966,10,na,1976,5942
STAT,1880,70,na,1950,1716.298226534709
SIM,1969,35,45-49,2004,2
STAT,1883,47,30-34,1930,0.10878658918125611
STAT,1835,107,na,1942,0.002939236669116237
STAT,1834,87,na,1921,160.78268752664175
SIM,1867,49,na,1916,2154
SIM,1895,38,25-29,1933,9
SIM,1787,80,na,1867,424
STAT,1926,19,15-19,1945,63.85616653392712
SIM,1934,19,15-19,1953,2
STAT,1932,37,35-39,1969,3.751376523488563
SIM,1923,16,35-39,1939,10
STAT,1888,98,na,1986,52.982793232872346
SIM,1970,19,25-29,1989,140
STAT,1853,28,45-49,1881,1.156980222774814
SIM,1861,28,45-49,1889,3
STAT,1957,46,25-29,2003,0.08416153458155456
STAT,1962,19,25-29,1981,64.03588804154961
STAT,1941,20,15-19,1961,6.35448157209206
STAT,1877,49,20-24,1926,0.014104567127955867
SIM,1936,77,na,2013,1706
STAT,1853,90,na,1943,78.49516573467243
SIM,1952,32,35-39,1984,28
STAT,1881,53,25-29,1934,0.003879413063910541
STAT,1941,54,na,1995,4424.900853614553
SIM,1957,33,30-34,1990,2
SIM,1912,2,na,1914,4357
STAT,1850,39,40-44,1889,4.483676204172354
STAT,1808,46,50-100,1854,1.2493111424063523
SIM,1826,34,45-49,1860,2
STAT,1922,15,30-34,1937,16.34780323260153
STAT,1827,38,45-49,1865,2.836650501482664
STAT,1956,29,45-49,1985,2.646972798104678
SIM,1964,29,45-49,1993,5
SIM,1904,12,na,1916,4443
STAT,1859,16,45-49,1875,0.0701199678589314
STAT,1912,29,30-34,1941,44.28488249932469
STAT,1901,41,45-49,1942,0.16876083334714317
SIM,1848,45,na,1893,1687
SIM,1975,31,20-24,2006,1
STAT,1894,45,40-44,1939,0.1446952594665732
SIM,1920,29,30-34,1949,3
STAT,1887,38,25-29,1925,3.705262259269157
STAT,1934,37,45-49,1971,1.086208627212865
SIM,1948,34,35-39,1982,30
STAT,1837,24,45-49,1861,0.6515609210079774
STAT,1988,23,na,2011,6045.367862829244
SIM,1965,24,25-29,1989,156
SIM,1947,38,40-44,1985,1
SIM,1830,31,40-44,1861,9
STAT,1920,19,20-24,1939,174.5231515688415
STAT,1860,25,40-44,1885,2.856931406430254
STAT,1901,29,20-24,1930,18.8281514795372
STAT,1879,62,na,1941,2202.4505305527687
SIM,1948,39,50-100,1987,2
SIM,1965,37,35-39,2002,8
STAT,1850,42,50-100,1892,1.086221247178157
SIM,1974,24,35-39,1998,38
SIM,1986,23,45-49,2009,6
STAT,1844,23,40-44,1867,2.1605552626889915
STAT,1944,32,35-39,1976,11.569052841130825
STAT,1939,38,40-44,1977,1.780518672086434
STAT,1978,23,45-49,2001,1.7773811573017508
STAT,1965,28,40-44,1993,6.74123239796716
STAT,1899,36,na,1935,3742.8943086556205
STAT,1905,92,na,1997,408.5897686554996
SIM,1880,17,15-19,1897,20
STAT,1808,48,45-49,1856,1.1596403973451779
STAT,1948,24,25-29,1972,122.3095682017176
SIM,1915,27,40-44,1942,11
STAT,1833,23,30-34,1856,17.814311103473347
STAT,1891,35,20-24,1926,1.1099176363279577
STAT,1804,65,na,1869,1067.4498626715
STAT,1914,55,na,1969,4074.7721908777435
SIM,1941,31,20-24,1972,6
SIM,1917,30,na,1947,5429
STAT,1822,32,45-49,1854,7.540283267568118
STAT,1867,43,30-34,1910,1.2298057333701153
SIM,1875,43,30-34,1918,4
SIM,1826,33,40-44,1859,2
STAT,1889,29,na,1918,3370.7299590884463
STAT,1870,49,na,1919,2506.253720159073
SIM,1831,37,30-34,1868,6
STAT,1812,46,45-49,1858,0.5563472602500348
STAT,1973,2,na,1975,5873.500699437878
STAT,1944,23,45-49,1967,1.4016039518995216
STAT,1823,37,30-34,1860,9.988744500180003
STAT,1918,42,35-39,1960,0.24702481220323821
SIM,1835,38,45-49,1873,3
STAT,1922,31,45-49,1953,2.059322003906599
SIM,1879,28,30-34,1907,58
STAT,1949,33,30-34,1982,21.54135177370459
SIM,1883,34,25-29,1917,2
STAT,1982,21,45-49,2003,1.8338368776438183
SIM,1897,35,30-34,1932,20
STAT,1872,17,15-19,1889,6.899591463441693
SIM,1841,32,20-24,1873,2
SIM,1990,21,45-49,2011,2
STAT,1824,49,40-44,1873,0.2264813505980083
STAT,1818,42,30-34,1860,1.5359969622931646
STAT,1933,31,20-24,1964,3.797334759102792
STAT,1978,32,35-39,2010,14.670775221336068
STAT,1818,49,50-100,1867,0.2945885504277629
SIM,1830,32,45-49,1862,1
STAT,1848,24,20-24,1872,87.8789282400922
SIM,1884,26,na,1910,2659
SIM,1842,38,45-49,1880,1
SIM,1871,53,na,1924,1793
SIM,1852,24,45-49,1876,1
STAT,1875,34,25-29,1909,12.110700610121146
SIM,1817,84,na,1901,79
STAT,1891,36,25-29,1927,4.126416812808746
SIM,1878,16,20-24,1894,23
STAT,1955,23,20-24,1978,170.85817156449102
SIM,1858,20,30-34,1878,2
SIM,1963,23,20-24,1986,312
STAT,1929,54,na,1983,5352.275997479909
STAT,1914,31,50-100,1945,0.9648433447211309
SIM,1826,42,30-34,1868,2
STAT,1876,46,35-39,1922,0.16749123216674563
SIM,1937,19,40-44,1956,8
STAT,1875,26,na,1901,2855.9239397080664
STAT,1993,21,20-24,2014,185.29789396118477
SIM,1848,34,30-34,1882,10
STAT,1890,1,na,1891,3838.158908405657
SIM,1856,24,20-24,1880,66
STAT,1806,91,na,1897,19.88889097241826
SIM,1922,31,50-100,1953,5
STAT,1907,27,40-44,1934,5.086391680371811
STAT,1834,35,40-44,1869,5.073341230779206
STAT,1893,5,na,1898,3822.7739882937403
STAT,1968,30,50-100,1998,1.2161545823830164
STAT,1833,32,20-24,1865,2.4718477190787964
STAT,1889,35,30-34,1924,7.653697835275435
STAT,1896,103,na,1999,7.029654605911233
STAT,1878,44,45-49,1922,1.7790425928315972
SIM,1902,29,20-24,1931,43
STAT,1953,26,15-19,1979,0.9902546392718538
STAT,1983,27,35-39,2010,24.616277223754786
STAT,1917,30,25-29,1947,11.25950236803111
SIM,1860,16,na,1876,2821
STAT,1899,102,na,2001,12.578868308865564
STAT,1841,23,15-19,1864,3.6890127488108075
STAT,1854,45,45-49,1899,0.1941853223669091
SIM,1930,31,45-49,1961,5
SIM,1832,49,40-44,1881,1
STAT,1855,71,na,1926,1135.7758927509815
STAT,1836,68,na,1904,1390.763369629053
STAT,1957,43,20-24,2000,0.027881602811512307
STAT,1982,16,40-44,1998,2.272042264090122
SIM,1970,28,15-19,1998,2
STAT,1904,18,25-29,1922,9.36640670586869
SIM,1918,15,15-19,1933,11
STAT,1838,44,15-19,1882,0.012410749058746522
STAT,1875,17,40-44,1892,0.21812934922365945
STAT,1919,22,na,1941,4613.683442336458
SIM,1918,66,na,1984,3152
STAT,1962,28,15-19,1990,1.0478859566204302
STAT,1844,24,45-49,1868,0.7178126733648391
SIM,1870,23,na,1893,3270
STAT,1829,34,20-24,1863,3.2636706552485735
SIM,1884,37,50-100,1921,1
STAT,1891,44,50-100,1935,1.4864970686012897
STAT,1850,100,na,1950,1.0929062811554573
SIM,1883,26,30-34,1909,45
SIM,1903,67,na,1970,2733
SIM,1956,24,25-29,1980,133
STAT,1846,75,na,1921,1064.2394659176719
STAT,1859,22,30-34,1881,16.989530289419267
STAT,1939,22,25-29,1961,107.09935926385066
STAT,1989,23,20-24,2012,184.35005265163437
STAT,1908,47,45-49,1955,0.22712226901320953
SIM,1886,44,45-49,1930,1
STAT,1849,44,25-29,1893,0.49099728400623976
STAT,1866,63,na,1929,1908.6022162026752
SIM,1912,18,25-29,1930,27
STAT,1826,46,na,1872,1424.9765152676991
STAT,1907,41,20-24,1948,0.018810508624303342
STAT,1876,37,50-100,1913,1.464671154852305
STAT,1877,81,na,1958,774.0697390700416
SIM,1924,27,50-100,1951,1
SIM,1834,61,na,1895,1375
SIM,1947,22,25-29,1969,268
SIM,1938,39,45-49,1977,1
STAT,1923,22,50-100,1945,0.8832193266982588
SIM,1896,29,na,1925,3856
STAT,1864,34,15-19,1898,0.14548643488201496
STAT,1936,38,15-19,1974,0.021747436263726737
STAT,1866,34,50-100,1900,0.9716819375618153
STAT,1840,72,na,1912,1013.0962173974805
STAT,1916,27,50-100,1943,1.187816371166364
STAT,1897,18,30-34,1915,2.4531098132270026
STAT,1975,23,30-34,1998,43.887772701627355
SIM,1925,30,25-29,1955,28
SIM,1824,54,na,1878,1217
STAT,1875,26,30-34,1901,30.134879528944857
SIM,1840,20,45-49,1860,1
SIM,1893,15,35-39,1908,1
STAT,1929,33,20-24,1962,3.5735069880249903
STAT,1911,17,20-24,1928,31.335911112753696
STAT,1857,104,na,1961,0.17925016974196192
STAT,1868,19,15-19,1887,6.620490999392545
SIM,1837,34,20-24,1871,2
SIM,1864,38,na,1902,2746
STAT,1811,101,na,1912,0.29381042230051213
SIM,1835,46,na,1881,2014
SIM,1861,25,40-44,1886,5
SIM,1949,21,50-100,1970,1
STAT,1831,76,na,1907,743.3017161222406
STAT,1853,25,40-44,1878,3.5051775547373247
STAT,1853,45,na,1898,2262.3158809665174
STAT,1907,9,na,1916,4405.621320479102
STAT,1960,24,40-44,1984,5.067138449486301
STAT,1979,35,20-24,2014,0.43228773434714673
STAT,1885,15,35-39,1900,0.6345587941680977
STAT,1946,21,na,1967,4691.2431276291345
STAT,1921,48,50-100,1969,0.2933276036382204
SIM,1837,72,na,1909,1323
SIM,1979,18,50-100,1997,2
SIM,1975,32,25-29,2007,27
SIM,1945,69,na,2014,3293
STAT,1973,38,30-34,2011,2.7997187441013702
SIM,1937,33,20-24,1970,3
STAT,1842,53,na,1895,1630.3132972977746
STAT,1847,107,na,1954,0.003628711145835228
STAT,1878,66,na,1944,1974.9343862065164
SIM,1872,89,na,1961,285
STAT,1846,27,15-19,1873,0.5674098253324776
STAT,1839,64,na,1903,1378.604759932347
STAT,1991,24,15-19,2015,8.8270089890123
STAT,1931,34,15-19,1965,0.19411404872722368
STAT,1963,35,na,1998,5692.67807816385
STAT,1852,38,50-100,1890,1.1517910084014507
STAT,1989,24,25-29,2013,153.08599774871277
STAT,1893,33,30-34,1926,25.36133506123198
SIM,1907,23,25-29,1930,210
SIM,1876,19,15-19,1895,15
STAT,1878,43,40-44,1921,2.690698989095322
SIM,1860,38,50-100,1898,4
STAT,1888,73,na,1961,1833.3129861081588
SIM,1897,5,na,1902,4243
SIM,1961,26,15-19,1987,2
STAT,1854,48,15-19,1902,3.2178384411079224E-4
STAT,1931,22,na,1953,5467.112549837334
STAT,1958,49,45-49,2007,0.3406468268751547
SIM,1886,43,40-44,1929,2
STAT,1845,25,na,1870,1800.074281227254
SIM,1868,33,45-49,1901,4
SIM,1866,39,50-100,1905,1
SIM,1825,31,25-29,1856,21
STAT,1826,40,35-39,1866,1.4003303471405826
STAT,1896,17,na,1913,3849.7463200854345
STAT,1966,18,40-44,1984,2.0154984134151497
SIM,1909,21,35-39,1930,30
SIM,1832,27,30-34,1859,45
SIM,1984,15,na,1999,5476
SIM,1898,40,na,1938,3849
STAT,1828,109,na,1937,4.721954305505826E-4
STAT,1876,19,45-49,1895,0.07751045321376916
STAT,1850,35,30-34,1885,5.690350141304603
SIM,1933,80,na,2013,3089
STAT,1887,34,15-19,1921,0.1826022537887807
STAT,1813,45,50-100,1858,0.8411511421218577
STAT,1830,37,50-100,1867,1.2415481810107267
SIM,1983,26,25-29,2009,133
STAT,1850,9,na,1859,3064.8113929946385
SIM,1918,48,50-100,1966,1
STAT,1871,27,15-19,1898,0.5209078477281323
STAT,1845,19,15-19,1864,4.995054250893901
STAT,1877,101,na,1978,9.912605255123049
STAT,1904,85,na,1989,1195.3356022762434
STAT,1859,19,50-100,1878,0.05166617364420628
STAT,1881,63,na,1944,1986.160984317988
STAT,1854,28,25-29,1882,35.86889026274092
SIM,1834,40,35-39,1874,6
SIM,1869,29,20-24,1898,14
STAT,1820,41,na,1861,1624.6237920936057
STAT,1864,47,25-29,1911,0.059076725567313665
STAT,1820,52,35-39,1872,0.008454069906778692
STAT,1872,41,45-49,1913,1.7421572825041602
STAT,1822,76,na,1898,778.4121309395432
STAT,1976,21,25-29,1997,142.933082039346
STAT,1908,17,40-44,1925,0.3135125235348357
STAT,1801,104,na,1905,0.027995635807243124
SIM,1841,36,40-44,1877,3
STAT,1792,92,na,1884,17.331011916471947
SIM,1928,18,15-19,1946,1
SIM,1862,28,25-29,1890,87
SIM,1885,32,35-39,1917,4
SIM,1894,38,45-49,1932,5
STAT,1942,41,50-100,1983,0.14747969660872276
STAT,1967,36,45-49,2003,1.01339036177561
STAT,1886,38,45-49,1924,2.4146571901330884
STAT,1849,46,45-49,1895,0.1834354326655706
STAT,1841,44,20-24,1885,0.14301173458534205
STAT,1886,3,na,1889,3394.4938706172115
SIM,1996,18,na,2014,6922
SIM,1844,44,40-44,1888,1
STAT,1845,37,15-19,1882,0.03975817003764729
STAT,1873,22,20-24,1895,81.2126747589154
SIM,1816,44,35-39,1860,3
STAT,1930,49,40-44,1979,0.23823794569683954
STAT,1948,21,20-24,1969,147.38555172201384
STAT,1833,36,40-44,1869,3.9231551207739366
STAT,1883,41,20-24,1924,0.18012592510324363
SIM,1857,43,40-44,1900,5
SIM,1940,48,50-100,1988,1
STAT,1877,32,35-39,1909,12.15698498227517
SIM,1821,43,na,1864,1560
STAT,1891,93,na,1984,249.01830157097103
SIM,1837,18,20-24,1855,31
STAT,1863,15,15-19,1878,6.914789902522814
STAT,1959,40,35-39,1999,0.31678166103271743
STAT,1993,22,25-29,2015,153.87617252425176
SIM,1880,41,45-49,1921,5
SIM,1859,42,35-39,1901,2
STAT,1882,43,25-29,1925,0.7186201171257066
STAT,1958,45,35-39,2003,0.204226779878804
SIM,1888,39,30-34,1927,8
STAT,1906,19,50-100,1925,0.08200486540273269
SIM,1851,21,25-29,1872,129
STAT,1890,32,50-100,1922,1.2920163627656573
SIM,1891,23,20-24,1914,184
STAT,1847,32,20-24,1879,2.4420444950819378
SIM,1968,20,30-34,1988,52
SIM,1894,23,45-49,1917,2
STAT,1850,71,na,1921,1374.1052063999139
SIM,1848,37,35-39,1885,10
STAT,1814,53,20-24,1867,0.001922677831530829
SIM,1862,45,45-49,1907,1
SIM,1943,35,50-100,1978,4
SIM,1885,14,na,1899,3398
SIM,1938,54,na,1992,3990
SIM,1939,22,30-34,1961,86
STAT,1843,21,25-29,1864,72.61930422122431
STAT,1850,17,30-34,1867,2.005034602082398
SIM,1917,33,35-39,1950,17
STAT,1975,26,25-29,2001,100.68772828317414
STAT,1887,49,15-19,1936,2.857236029127969E-4
SIM,1836,38,25-29,1874,1
STAT,1858,43,na,1901,2065.7457288284795
STAT,1883,98,na,1981,39.861311636403315
STAT,1857,36,25-29,1893,2.6003086439547776
SIM,1880,23,45-49,1903,1
STAT,1927,42,na,1969,5374.1499665812835
STAT,1871,33,na,1904,2728.224732993281
STAT,1983,19,40-44,2002,2.2819386801637074
SIM,1872,29,25-29,1901,61
STAT,1803,53,45-49,1856,0.05160864234606444
SIM,1949,26,35-39,1975,10
STAT,1825,43,25-29,1868,0.9348681234209544
SIM,1874,42,30-34,1916,1
STAT,1978,24,na,2002,5766.5509837101135
STAT,1866,42,30-34,1908,1.2282422395016124
SIM,1831,65,na,1896,1093
SIM,1869,83,na,1952,160
STAT,1935,5,na,1940,6346.813681216231
STAT,1828,38,25-29,1866,2.901993393571781
STAT,1877,34,50-100,1911,1.0904853982235858
SIM,1991,19,40-44,2010,4
STAT,1910,39,15-19,1949,0.021003624579099833
SIM,1974,27,50-100,2001,3
STAT,1840,46,25-29,1886,0.04719669145198895
STAT,1856,53,25-29,1909,0.0030684908230032594
SIM,1936,69,na,2005,2957
STAT,1876,34,40-44,1910,5.129316685947247
STAT,1998,17,35-39,2015,7.110218884460854
STAT,1864,17,30-34,1881,1.6990153532005203
STAT,1829,94,na,1923,14.641387250043751
STAT,1906,30,50-100,1936,0.89248902624739
SIM,1972,41,45-49,2013,2
STAT,1949,22,50-100,1971,0.8860607223976473
SIM,1872,17,30-34,1889,1
STAT,1824,100,na,1924,0.6568941415066686
STAT,1834,41,na,1875,2342.869269199624
STAT,1815,54,20-24,1869,0.0013913006612766802
STAT,1974,28,30-34,2002,59.27204802654341
STAT,1880,48,20-24,1928,0.014494454574820716
STAT,1886,23,45-49,1909,0.846234355054229
STAT,1897,26,25-29,1923,65.50076578465604
STAT,2000,15,30-34,2015,20.930150867132824
STAT,1917,22,30-34,1939,35.253124963661776
SIM,1882,36,30-34,1918,13
SIM,1925,22,30-34,1947,2
SIM,1842,34,35-39,1876,7
SIM,1975,16,35-39,1991,10
STAT,1870,29,20-24,1899,13.251761268880939
STAT,1943,30,30-34,1973,19.67759083743704
STAT,1804,51,40-44,1855,0.04944219326031288
STAT,1830,44,45-49,1874,1.3957136381174815
STAT,1819,47,15-19,1866,7.70174729350251E-4
STAT,1862,34,40-44,1896,4.187507390175846
STAT,1899,33,25-29,1932,16.125939012767194
STAT,1979,0,na,1979,6293.890427292311
STAT,1886,36,20-24,1922,0.9428793359792058
STAT,1831,37,15-19,1868,0.05552963858643071
SIM,1987,19,20-24,2006,198
SIM,1951,30,30-34,1981,9
STAT,1892,17,35-39,1909,0.7936717462500321
SIM,1880,22,na,1902,3518
SIM,1882,57,na,1939,2800
STAT,1834,34,35-39,1868,11.594787599061886
SIM,1986,18,20-24,2004,245
STAT,1899,35,50-100,1934,1.9595830997227086
STAT,1825,42,40-44,1867,3.3458226707691083
STAT,1868,22,40-44,1890,2.3104597768905255
STAT,1902,42,na,1944,3777.1319421382373
STAT,1890,37,25-29,1927,4.060014100585022
STAT,1964,44,na,2008,5591.397197513069
STAT,1865,45,20-24,1910,0.012619643849125345
STAT,1881,28,15-19,1909,0.5032517968316563
SIM,1884,34,40-44,1918,7
STAT,1878,12,na,1890,3111.808726987253
SIM,1892,38,50-100,1930,1
SIM,1890,43,25-29,1933,4
STAT,1964,41,45-49,2005,0.25176262440632896
SIM,1991,19,50-100,2010,4
STAT,1874,20,15-19,1894,3.9208782609695643
STAT,1871,40,45-49,1911,1.7356706377562723
STAT,1880,35,45-49,1915,2.4616740183503123
STAT,1894,31,50-100,1925,1.3648411012747077
STAT,1880,18,25-29,1898,6.913614664212222
STAT,1889,44,20-24,1933,0.22287300857894599
SIM,1816,88,na,1904,49
STAT,1869,38,15-19,1907,0.062447521242290555
STAT,1925,47,na,1972,5135.876397204454
SIM,1851,25,45-49,1876,4
STAT,1838,27,30-34,1865,27.75216589024795
STAT,1968,34,40-44,2002,5.742309818520977
SIM,1894,36,20-24,1930,4
STAT,1892,35,35-39,1927,10.327676937787777
STAT,1824,45,30-34,1869,0.13501895602383315
SIM,1992,17,35-39,2009,10
STAT,1959,42,45-49,2001,0.26109575439692545
SIM,1956,21,20-24,1977,154
SIM,1785,79,na,1864,453
STAT,1881,46,15-19,1927,4.465154170368042E-4
STAT,1895,55,na,1950,3106.1027252858744
STAT,1839,51,50-100,1890,0.012034538700006056
STAT,1875,33,40-44,1908,5.150122603512425
SIM,1969,17,20-24,1986,192
STAT,1851,33,na,1884,1949.2330369957847
SIM,1982,28,30-34,2010,207
STAT,1981,23,15-19,2004,8.61564349850026
SIM,1862,57,na,1919,2535
STAT,1865,15,50-100,1880,0.05845365627901255
STAT,1928,31,50-100,1959,1.193742075645586
STAT,1967,16,35-39,1983,6.050721000069934
SIM,1926,38,50-100,1964,1
STAT,1895,28,15-19,1923,0.6791492642665248
STAT,1978,36,20-24,2014,0.4281241576531564
SIM,1868,48,45-49,1916,1
SIM,1883,33,40-44,1916,3
STAT,1890,19,25-29,1909,7.947915401198434
STAT,1918,20,25-29,1938,115.63074839285893
STAT,1861,51,40-44,1912,0.010148629085282785
STAT,1798,77,na,1875,311.67023044884604
STAT,1978,19,15-19,1997,71.42943158797621
SIM,1882,18,30-34,1900,2
STAT,1848,30,15-19,1878,0.18015969144120325
STAT,1830,24,20-24,1854,118.647143697056
STAT,1933,34,na,1967,5876.969717017652
SIM,1959,15,40-44,1974,3
SIM,1975,33,40-44,2008,3
STAT,1847,20,na,1867,2046.1214677604655
SIM,1920,36,na,1956,4163
STAT,1805,84,na,1889,139.20044997162103
SIM,1989,3,na,1992,6752
STAT,1874,36,30-34,1910,6.326920897742861
SIM,1926,20,25-29,1946,179
SIM,1846,27,30-34,1873,25
SIM,1851,65,na,1916,2015
STAT,1873,40,50-100,1913,1.2575805081067062
STAT,1830,26,45-49,1856,1.4672478882465767
STAT,1841,29,25-29,1870,46.04476332758929
STAT,1984,17,35-39,2001,6.877747431752026
STAT,1964,22,15-19,1986,7.762917744283858
SIM,1779,79,na,1858,428
STAT,1918,83,na,2001,1815.617525071384
SIM,1879,36,25-29,1915,1
SIM,1972,22,15-19,1994,17
STAT,1889,48,40-44,1937,0.13565284630738916
SIM,1857,44,25-29,1901,1
STAT,1938,26,na,1964,4287.079944349862
STAT,1848,49,35-39,1897,0.14564801164779168
STAT,1873,68,na,1941,1800.965300907393
STAT,1893,30,25-29,1923,15.061175318870916
SIM,1911,79,na,1990,2690
STAT,1953,22,40-44,1975,4.709548305935733
STAT,1862,52,40-44,1914,0.010198635909293997
STAT,1885,25,na,1910,2765.7865629253147
STAT,1957,15,35-39,1972,6.388100984504716
STAT,1851,15,25-29,1866,5.5284331837914165
SIM,1862,25,20-24,1887,13
SIM,1973,23,na,1996,5450
SIM,1814,53,na,1867,1264
STAT,1847,17,25-29,1864,5.442069962852247
SIM,1985,26,na,2011,6426
SIM,1823,52,50-100,1875,1
STAT,1876,16,40-44,1892,0.21873538254685304
SIM,1889,37,25-29,1926,7
SIM,1818,39,20-24,1857,1
STAT,1789,80,na,1869,207.1478140508624
STAT,1914,2,na,1916,4868.7253006471
STAT,1833,39,45-49,1872,1.7306677550443867
STAT,1816,51,30-34,1867,0.01188939205208291
SIM,1854,33,45-49,1887,5
STAT,1940,38,45-49,1978,0.8223965861257038
STAT,1978,37,50-100,2015,0.6812593559196267
SIM,1840,61,na,1901,1533
STAT,1875,36,45-49,1911,2.38886577770821
SIM,1976,1,na,1977,6064
STAT,1849,86,na,1935,171.96917878463185
STAT,1909,15,35-39,1924,0.95512127845354
SIM,1835,41,35-39,1876,7
STAT,1861,63,na,1924,1711.8743837289408
STAT,1822,47,20-24,1869,0.022681173214744665
STAT,1988,25,25-29,2013,109.2036290541964
STAT,1844,39,20-24,1883,0.6673256924932119
STAT,1846,51,45-49,1897,0.015074455931710145
STAT,1956,47,25-29,2003,0.08425673069927751
STAT,1854,25,20-24,1879,11.170221539374632
SIM,1845,45,na,1890,2037
STAT,1951,38,20-24,1989,0.37284247957429295
STAT,1873,29,50-100,1902,0.7484829314696724
STAT,1839,33,na,1872,2093.2578378458857
STAT,1885,48,50-100,1933,0.2791601424356026
STAT,1938,32,15-19,1970,0.14918963202906077
SIM,1819,53,na,1872,902
STAT,1893,49,45-49,1942,0.1901354040711746
STAT,1958,42,30-34,2000,0.20138331845678484
STAT,1862,35,20-24,1897,0.7578847238552096
STAT,1872,30,50-100,1902,1.0702818447987683
SIM,1838,48,30-34,1886,1
STAT,1906,80,na,1986,1897.1299539107
SIM,1870,34,40-44,1904,9
STAT,1815,39,25-29,1854,8.585549101451235
SIM,1908,36,na,1944,3881
SIM,1891,27,40-44,1918,13
STAT,1826,109,na,1935,3.917336964977753E-4
STAT,1882,25,na,1907,2708.3754847301398
SIM,1816,41,30-34,1857,2
SIM,1953,31,na,1984,5678
STAT,1795,89,na,1884,33.481553262933474
STAT,1818,49,20-24,1867,0.014393577952343367
STAT,1846,33,45-49,1879,2.1083730200195974
STAT,1990,0,na,1990,6546.311421136221
SIM,1833,25,25-29,1858,7
STAT,1865,25,na,1890,2501.840745035608
STAT,1925,48,20-24,1973,0.015406270162583755
SIM,1823,39,25-29,1862,3
STAT,1981,23,50-100,2004,1.0649745970778852
STAT,1828,35,20-24,1863,0.8288370262896386
STAT,1883,27,40-44,1910,3.3822680917068686
STAT,1847,35,25-29,1882,2.3468221886702807
SIM,1998,13,na,2011,6856
STAT,1851,28,50-100,1879,0.5896813816984632
SIM,1909,29,na,1938,4520
STAT,1891,37,40-44,1928,6.243711841615741
SIM,1961,22,40-44,1983,4
STAT,1832,52,25-29,1884,0.0025577911972498374
STAT,1849,94,na,1943,15.490573683846966
SIM,1916,31,na,1947,4547
SIM,1988,16,30-34,2004,31
STAT,1836,76,na,1912,862.2015537827976
STAT,1950,52,na,2002,5126.593075432396
STAT,1914,48,45-49,1962,0.24817916302565848
STAT,1824,42,25-29,1866,0.9138313638769169
SIM,1914,44,na,1958,3895
SIM,1880,30,50-100,1910,1
SIM,1993,21,na,2014,6047
STAT,1807,49,45-49,1856,0.942668940069436
SIM,1882,39,35-39,1921,3
SIM,1865,22,na,1887,3182
SIM,1898,32,na,1930,3979
STAT,1858,36,40-44,1894,3.9599727596083123
SIM,1865,37,40-44,1902,13
STAT,1909,33,35-39,1942,10.032599022843407
STAT,1917,25,35-39,1942,18.294191758390678
SIM,1854,30,na,1884,2780
SIM,1958,17,45-49,1975,2
STAT,1902,45,15-19,1947,3.7159173038394023E-4
SIM,1851,42,30-34,1893,2
STAT,1840,43,20-24,1883,0.13120505571497965
STAT,1866,27,35-39,1893,10.321090832318315
STAT,1883,23,20-24,1906,77.56813679379432
STAT,1876,37,45-49,1913,2.3781874854073894
SIM,1861,31,35-39,1892,4
STAT,1912,29,na,1941,4233.968803842045
STAT,1833,35,25-29,1868,2.607814078878517
SIM,1849,83,na,1932,612
SIM,1896,6,na,1902,4074
STAT,1880,32,40-44,1912,5.304850456396714
SIM,1939,25,35-39,1964,22
SIM,1821,35,na,1856,1759
STAT,1868,25,45-49,1893,1.239420126681731
STAT,1941,49,15-19,1990,4.5290222735882543E-4
SIM,1953,9,na,1962,5699
SIM,1907,62,na,1969,3911
SIM,1925,25,35-39,1950,49
SIM,1935,32,40-44,1967,13
STAT,1937,21,45-49,1958,1.2655888380832123
STAT,1946,35,50-100,1981,0.5546221740082261
STAT,1816,99,na,1915,0.9352859211504518
STAT,1845,50,45-49,1895,0.009919793518799975
SIM,1922,31,na,1953,4882
STAT,1897,38,20-24,1935,1.1836229539981644
STAT,1973,16,30-34,1989,18.197431672659533
STAT,1850,32,25-29,1882,11.03029886666109
STAT,1887,16,15-19,1903,7.694141738733261
STAT,1856,50,20-24,1906,6.590370617944421E-4
STAT,1861,54,45-49,1915,0.013540432884132475
STAT,1853,31,35-39,1884,10.491468803863823
SIM,1832,27,na,1859,2199
STAT,1958,34,na,1992,5835.835907181649
STAT,1897,23,20-24,1920,106.01260564126608
STAT,1818,71,na,1889,614.3364135845876
STAT,1889,47,50-100,1936,0.19616231281022892
STAT,1836,44,40-44,1880,2.3744104702174176
STAT,1851,19,45-49,1870,0.062240097452413504
SIM,1895,16,15-19,1911,12
SIM,1858,26,40-44,1884,7
STAT,1834,36,50-100,1870,1.4082035300946865
SIM,1978,29,25-29,2007,3
STAT,1782,104,na,1886,0.04551461028957003
STAT,1864,29,25-29,1893,43.27760306878405
STAT,1817,52,30-34,1869,0.016353158542330003
STAT,1927,32,40-44,1959,5.554195681895857
STAT,1817,39,50-100,1856,4.087360570376098
STAT,1837,18,50-100,1855,0.06688370803354979
STAT,1925,39,na,1964,5198.298293167623
SIM,1842,36,50-100,1878,4
SIM,1871,22,na,1893,1894
SIM,1958,31,25-29,1989,31
STAT,1951,57,na,2008,5020.80623601044
SIM,1850,41,30-34,1891,2
SIM,1871,18,20-24,1889,32
SIM,1867,88,na,1955,236
SIM,1841,39,45-49,1880,4
STAT,1895,108,na,2003,0.25598807415140956
STAT,1969,26,na,1995,5426.33970834647
STAT,1849,43,40-44,1892,1.7307487061862665
STAT,1865,47,40-44,1912,0.17743196779410023
SIM,1932,6,na,1938,5776
SIM,1828,43,45-49,1871,2
SIM,1887,25,20-24,1912,2
STAT,1834,31,30-34,1865,20.622682216936752
STAT,1935,23,35-39,1958,14.800456861418363
STAT,1772,92,na,1864,1.3793186006439417
STAT,1977,13,na,1990,6124.101798544758
SIM,1964,47,25-29,2011,1
SIM,1951,15,35-39,1966,16
STAT,1852,100,na,1952,1.0009332030861249
STAT,1889,47,25-29,1936,0.04600549323354867
SIM,1919,31,45-49,1950,4
STAT,1848,46,30-34,1894,0.10314469998294307
STAT,1899,5,na,1904,4143.414076998412
STAT,1882,40,20-24,1922,0.1808227722120642
STAT,1851,33,25-29,1884,8.366563415475133
STAT,1920,16,na,1936,4775.402359454097
STAT,1943,15,35-39,1958,5.1383913283463425
STAT,1795,80,na,1875,224.8121266247594
STAT,1863,18,20-24,1881,18.46752168407403
SIM,1857,46,45-49,1903,1
SIM,1864,83,na,1947,442
STAT,1843,42,30-34,1885,1.1877155128573451
STAT,1811,47,45-49,1858,0.7356449110115935
SIM,1879,33,20-24,1912,1
STAT,1880,15,20-24,1895,21.78702826760247
STAT,1825,29,45-49,1854,4.5955403262087815
STAT,1857,51,20-24,1908,6.664232215875076E-4
STAT,1827,41,35-39,1868,2.4604780353492544
SIM,1873,47,40-44,1920,1
STAT,1852,30,35-39,1882,10.093193783695785
SIM,1856,28,30-34,1884,44
STAT,1842,41,30-34,1883,0.9271190301597425
STAT,1874,39,35-39,1913,8.272181250839006
SIM,1951,33,35-39,1984,3
SIM,1948,28,40-44,1976,16
STAT,1875,50,25-29,1925,0.0042848917016357286
STAT,1841,26,20-24,1867,13.048646919606252
STAT,1920,29,50-100,1949,1.2505320854913982
STAT,1947,26,30-34,1973,51.17888591515153
SIM,1875,40,25-29,1915,5
SIM,1878,40,na,1918,2779
STAT,1873,25,25-29,1898,50.19000617577263
SIM,1875,75,na,1950,1292
SIM,1860,30,35-39,1890,11
SIM,1933,23,na,1956,6048
STAT,1856,38,30-34,1894,4.6691484972781225
SIM,1909,24,40-44,1933,1
STAT,1967,37,50-100,2004,0.6235559401824805
SIM,1858,47,45-49,1905,1
STAT,1819,56,na,1875,1535.3416010967583
SIM,1880,90,na,1970,321
STAT,1867,40,25-29,1907,0.698898462899894
SIM,1965,15,35-39,1980,15
SIM,1873,88,na,1961,194
STAT,1943,33,35-39,1976,11.393525248829715
STAT,1879,25,20-24,1904,14.232527773113445
SIM,1842,31,30-34,1873,8
STAT,1966,21,na,1987,5282.931344938642
SIM,1943,23,35-39,1966,14
STAT,1848,28,30-34,1876,31.71281930784302
SIM,1803,61,na,1864,1340
SIM,1933,54,na,1987,6176
STAT,1953,34,na,1987,5375.04379324064
SIM,1895,75,na,1970,1572
STAT,1979,19,30-34,1998,19.35481392762275
STAT,1863,36,20-24,1899,0.7816153828670027
SIM,1889,2,na,1891,4214
SIM,1948,30,25-29,1978,30
STAT,1945,16,na,1961,4641.480749306624
STAT,1837,28,20-24,1865,10.825133159253898
STAT,1990,17,30-34,2007,20.144547225073218
STAT,1922,25,15-19,1947,0.9277359608464093
STAT,1846,37,30-34,1883,5.75359316186399
STAT,1888,48,25-29,1936,0.04352290630092223
STAT,1954,18,15-19,1972,64.72612151256904
STAT,1856,40,15-19,1896,0.012281541744417375
SIM,1929,7,na,1936,5520
SIM,1939,21,15-19,1960,12
STAT,1820,51,50-100,1871,0.015129494314658876
STAT,1860,21,30-34,1881,17.20209091778553
STAT,1982,18,na,2000,5975.357301935515
STAT,1965,37,na,2002,5584.378455684111
SIM,1955,26,30-34,1981,78
SIM,1959,30,35-39,1989,15
STAT,1849,33,50-100,1882,0.7405936631053841
SIM,1828,29,30-34,1857,64
STAT,1877,48,15-19,1925,4.7414411750636864E-4
STAT,1848,13,na,1861,3130.0991643030297
STAT,1896,24,45-49,1920,1.0562635321913056
STAT,1885,42,35-39,1927,2.0818782192374443
SIM,1854,19,30-34,1873,5
SIM,1796,74,na,1870,437
SIM,1988,19,35-39,2007,17
SIM,1872,31,45-49,1903,9
STAT,1854,33,na,1887,1970.3307154083275
SIM,1870,91,na,1961,320
SIM,1984,26,40-44,2010,13
SIM,1917,16,na,1933,5630
STAT,1953,11,na,1964,5484.733933949948
SIM,1833,26,40-44,1859,1
STAT,1784,104,na,1888,0.0358974473121344
SIM,1887,57,na,1944,3265
STAT,1893,16,45-49,1909,0.0955211758471563
SIM,1839,29,40-44,1868,3
SIM,1889,34,20-24,1923,8
SIM,1930,39,40-44,1969,6
SIM,1930,25,15-19,1955,1
SIM,1898,43,30-34,1941,1
STAT,1896,85,na,1981,1036.8950044163923
SIM,1902,62,na,1964,3339
SIM,1837,19,na,1856,2761
STAT,1851,30,20-24,1881,2.2778282671446544
STAT,1869,94,na,1963,59.06616586460283
STAT,1917,72,na,1989,3279.5373424088775
STAT,1985,30,25-29,2015,15.481399899132391
STAT,1922,39,40-44,1961,1.9607408015385293
STAT,1872,27,30-34,1899,29.180840985434138
SIM,1804,53,50-100,1857,1
STAT,1869,51,45-49,1920,0.01629679722072873
SIM,1880,38,20-24,1918,4
STAT,1837,53,50-100,1890,0.01076080083492908
STAT,1894,50,na,1944,3240.301041735898
SIM,1932,20,20-24,1952,3
SIM,1974,20,25-29,1994,158
STAT,1837,46,20-24,1883,0.009136549989165351
STAT,1825,45,45-49,1870,0.33882229916647444
STAT,1895,44,15-19,1939,0.0014211313378596714
STAT,1879,39,15-19,1918,0.06698626579195076
STAT,1913,20,45-49,1933,1.266433062265704
STAT,1997,18,25-29,2015,73.0043175654007
SIM,1956,11,na,1967,5513
STAT,1867,22,25-29,1889,61.93558581563125
STAT,1826,28,45-49,1854,3.2188145048557644
SIM,1834,30,na,1864,2023
SIM,1834,28,45-49,1862,2
STAT,1935,35,50-100,1970,0.6790710180621331
STAT,1956,8,na,1964,6001.576594993487
SIM,1898,25,30-34,1923,47
SIM,1923,24,na,1947,5527
STAT,1857,19,40-44,1876,0.1909516046480486
STAT,1872,38,20-24,1910,0.8888308150564329
SIM,1875,22,25-29,1897,96
STAT,1821,36,15-19,1857,0.1311970311667318
STAT,1975,27,40-44,2002,7.126966197818089
SIM,1833,45,45-49,1878,2
SIM,1856,65,na,1921,1513
STAT,1840,49,30-34,1889,0.0763259562967283
SIM,1870,37,45-49,1907,6
STAT,1968,30,30-34,1998,23.174699458551164
STAT,1909,30,30-34,1939,17.509775991475056
SIM,1823,78,na,1901,925
SIM,1929,36,30-34,1965,2
STAT,1775,89,na,1864,48.22497256556985
STAT,1924,20,20-24,1944,152.28201535193253
STAT,1846,46,50-100,1892,0.2546177433497829
SIM,1833,22,20-24,1855,129
SIM,1850,60,na,1910,1215
STAT,1914,24,na,1938,4280.685547537298
STAT,1857,37,40-44,1894,3.934546268258603
STAT,1874,52,30-34,1926,0.006995184889561982
SIM,1845,28,20-24,1873,20
STAT,1826,46,45-49,1872,0.1720400598490041
STAT,1884,20,na,1904,2712.767971169016
STAT,1982,19,25-29,2001,70.32588308211264
SIM,1878,38,30-34,1916,2
STAT,1793,85,na,1878,90.42668515328451
SIM,1855,35,25-29,1890,5
SIM,1839,47,40-44,1886,1
STAT,1955,40,50-100,1995,0.18756128487252013
STAT,1985,16,45-49,2001,0.8201708677933339
SIM,1881,25,25-29,1906,99
SIM,1967,25,40-44,1992,9
SIM,1883,87,na,1970,394
SIM,1780,79,na,1859,176
STAT,1907,42,na,1949,3933.131517535754
STAT,1812,42,35-39,1854,5.170040005643753
STAT,1851,35,45-49,1886,1.6312816502601795
STAT,1983,30,50-100,2013,1.3774183108211406
STAT,1926,46,15-19,1972,5.25739471019693E-4
SIM,1803,78,na,1881,519
STAT,1975,36,na,2011,5906.4579868482115
STAT,1836,45,20-24,1881,0.011729744044598958
STAT,1971,21,45-49,1992,1.6506049332368695
STAT,1858,39,45-49,1897,1.7766452299339888
STAT,1941,33,35-39,1974,11.068476217942603
STAT,1878,43,na,1921,2764.823405763854
SIM,1958,23,na,1981,5799
STAT,1966,20,25-29,1986,133.67581659189054
STAT,1826,43,40-44,1869,1.6610040994420072
SIM,1914,30,50-100,1944,2
STAT,1827,51,na,1878,1936.7030875818798
STAT,1873,37,20-24,1910,0.9084375913611135
STAT,1851,16,40-44,1867,0.17738834156554353
STAT,1835,48,45-49,1883,0.1532626069383319
SIM,1849,36,45-49,1885,3
STAT,1963,40,45-49,2003,0.25429058331369087
STAT,1840,16,30-34,1856,1.665253009975923
SIM,1949,23,30-34,1972,90
SIM,1863,10,na,1873,2970
SIM,1890,27,25-29,1917,7
STAT,1884,38,50-100,1922,1.3929545702919057
SIM,1886,26,20-24,1912,14
SIM,1964,31,20-24,1995,9
STAT,1841,46,40-44,1887,0.1548738160002097
STAT,1936,22,35-39,1958,10.394992695671466
STAT,1929,75,na,2004,3644.009242066865
SIM,1968,43,45-49,2011,2
STAT,1859,52,35-39,1911,0.007872216538426699
STAT,1911,39,30-34,1950,2.0128138929276793
STAT,1880,51,45-49,1931,0.017837120757627663
SIM,1944,22,35-39,1966,15
SIM,1829,27,25-29,1856,2
SIM,1990,19,25-29,2009,165
STAT,1860,51,25-29,1911,0.003310219558710843
STAT,1994,5,na,1999,6547.804630733556
STAT,1857,33,20-24,1890,2.419285410193333
STAT,1956,31,20-24,1987,3.7989643255893606
STAT,1858,51,35-39,1909,0.007787699196846171
STAT,1976,26,40-44,2002,7.220713292576821
STAT,1823,45,15-19,1868,4.0643903176264604E-4
STAT,1872,23,45-49,1895,0.8055608785983083
STAT,1878,26,20-24,1904,14.184388063399458
SIM,1947,15,15-19,1962,97
STAT,1907,65,na,1972,3297.9899109207727
SIM,1943,20,30-34,1963,56
STAT,1846,19,30-34,1865,2.045550024448215
STAT,1882,27,25-29,1909,47.68279614455195
SIM,1792,81,na,1873,117
STAT,1840,41,na,1881,1959.014058407135
STAT,1910,17,na,1927,4421.132969209967
STAT,1952,36,15-19,1988,0.027385852267873424
STAT,1813,42,15-19,1855,0.0518855800408765
STAT,1879,28,25-29,1907,50.79458228220454
SIM,1862,42,40-44,1904,10
STAT,1951,40,30-34,1991,0.18309040726844397
SIM,1868,42,50-100,1910,6
SIM,1939,59,na,1998,4532
STAT,1915,43,35-39,1958,0.23363270466704164
STAT,1852,36,45-49,1888,1.909408419758382
STAT,1832,36,25-29,1868,2.557466425226821
STAT,1879,93,na,1972,159.91202675339332
SIM,1840,36,25-29,1876,7
SIM,1899,23,25-29,1922,187
STAT,1949,49,20-24,1998,0.01533760824322376
SIM,1819,38,20-24,1857,1
SIM,1919,28,na,1947,5173
STAT,1865,0,na,1865,3967.687064735242
SIM,1860,36,45-49,1896,2
STAT,1842,29,40-44,1871,2.809888753675822
SIM,1887,28,25-29,1915,5
SIM,1830,29,20-24,1859,25
SIM,1868,30,40-44,1898,7
STAT,1959,25,40-44,1984,7.072764841186017
SIM,1820,42,35-39,1862,2
STAT,1922,42,na,1964,4917.374184123927
SIM,1845,14,na,1859,2555
SIM,1850,29,40-44,1879,8
STAT,1762,93,na,1855,8.570519999999998
STAT,1797,92,na,1889,14.214621608401377
STAT,1967,14,na,1981,5660.595011690258
STAT,1939,15,15-19,1954,52.57647875724389
STAT,1896,28,30-34,1924,38.249306606909514
SIM,1849,32,25-29,1881,25
STAT,1962,30,35-39,1992,13.78940875784768
STAT,1935,20,30-34,1955,45.22318824253422
SIM,1978,26,20-24,2004,56
SIM,1844,43,50-100,1887,1
STAT,1884,25,35-39,1909,11.07655127948554
STAT,1863,47,50-100,1910,0.2466820243101018
SIM,1954,16,na,1970,4845
STAT,1930,43,30-34,1973,0.1938436575903502
STAT,1979,9,na,1988,6244.128051695004
SIM,1925,28,na,1953,5217
STAT,1847,51,na,1898,1664.6912381231125
SIM,1854,37,30-34,1891,10
STAT,1785,103,na,1888,0.0368454547803867
STAT,1931,44,30-34,1975,0.19648935388563854
STAT,1861,38,45-49,1899,1.9030792202918583
SIM,1962,38,na,2000,5499
SIM,1834,22,na,1856,1897
SIM,1889,38,40-44,1927,8
STAT,1853,99,na,1952,1.885569976015331
STAT,1942,42,na,1984,4655.608029433011
SIM,1840,18,25-29,1858,9
SIM,1892,25,35-39,1917,19
SIM,1979,28,25-29,2007,236
STAT,1852,18,45-49,1870,0.07404833507668264
SIM,1881,40,50-100,1921,2
STAT,1857,54,25-29,1911,0.003096052130119841
SIM,1865,14,na,1879,3370
STAT,1875,53,30-34,1928,0.006985001459096572
STAT,1894,44,35-39,1938,0.18403197079247757
STAT,1947,45,50-100,1992,0.30726890470589435
STAT,1868,13,na,1881,2947.8914850781953
STAT,1850,38,35-39,1888,7.320086928983084
STAT,1834,33,na,1867,2507.2530410451877
SIM,1818,42,45-49,1860,2
STAT,1868,36,35-39,1904,7.879971404022701
STAT,1793,77,na,1870,346.13102275144286
STAT,1878,20,na,1898,2866.7818676808242
STAT,1894,46,20-24,1940,0.010070587606418047
STAT,1883,44,25-29,1927,0.7152676777768039
SIM,1865,36,25-29,1901,7
SIM,1994,15,45-49,2009,1
SIM,1979,25,20-24,2004,1
SIM,1969,39,20-24,2008,1
SIM,1944,40,35-39,1984,2
SIM,1918,32,35-39,1950,13
SIM,1844,47,45-49,1891,1
STAT,1898,20,na,1918,3710.728785490843
SIM,1881,83,na,1964,369
SIM,1858,44,40-44,1902,6
STAT,1893,20,na,1913,3470.524555548564
SIM,1842,16,35-39,1858,1
STAT,1867,68,na,1935,1646.6151725022437
SIM,1984,29,45-49,2013,7
STAT,1936,40,35-39,1976,0.23090521247026022
STAT,1925,16,na,1941,5142.234529548042
SIM,1964,15,na,1979,5967
STAT,1776,85,na,1861,121.49553697668512
STAT,1872,54,20-24,1926,8.315878548562034E-4
STAT,1888,13,na,1901,3497.936059718729
SIM,1850,47,40-44,1897,1
SIM,1983,23,20-24,2006,180
SIM,1883,4,na,1887,2907
SIM,1918,9,na,1927,4319
STAT,1842,47,40-44,1889,0.13176473338663675
SIM,1940,7,na,1947,5139
SIM,1843,46,50-100,1889,1
SIM,1833,42,40-44,1875,10
STAT,1911,22,35-39,1933,10.314451917069649
SIM,1964,41,na,2005,5825
STAT,1852,33,40-44,1885,4.189644945743035
STAT,1992,15,40-44,2007,2.318179522793376
STAT,1835,46,50-100,1881,0.16363732518929508
STAT,1872,83,na,1955,460.0294058509606
SIM,1860,33,40-44,1893,5
STAT,1895,41,50-100,1936,0.11070273507135654
STAT,1901,28,15-19,1929,0.7308207478176993
STAT,1836,47,45-49,1883,0.22484910160540209
STAT,1956,16,25-29,1972,66.19462656883455
SIM,1891,26,25-29,1917,114
STAT,1969,18,na,1987,5304.587960448231
STAT,1833,50,50-100,1883,0.011473633355153754
SIM,1911,31,40-44,1942,10
STAT,1868,54,35-39,1922,0.009282952639688868
STAT,1979,34,15-19,2013,0.20786879819761567
STAT,1969,44,na,2013,5545.655338395365
SIM,1898,46,35-39,1944,1
STAT,1878,29,25-29,1907,50.607030593832086
SIM,1866,35,35-39,1901,4
STAT,1986,15,45-49,2001,0.8218772341932561
STAT,1976,29,45-49,2005,2.6724989258229876
STAT,1895,29,20-24,1924,17.496937878419523
STAT,1927,21,50-100,1948,0.9381878299348357
STAT,1867,26,45-49,1893,1.2004442854237245
STAT,1861,32,na,1893,2289.444060080859
STAT,1898,12,na,1910,4027.8886748766145
SIM,1870,35,20-24,1905,1
SIM,1834,46,45-49,1880,1
SIM,1898,28,35-39,1926,3
SIM,1844,32,45-49,1876,6
STAT,1920,40,50-100,1960,0.15008776954546046
STAT,1830,71,na,1901,837.342947744539
STAT,1883,26,25-29,1909,47.92611529307381
SIM,1822,40,45-49,1862,2
SIM,1860,3,na,1863,3516
SIM,1881,22,20-24,1903,71
STAT,1860,24,35-39,1884,5.515054276157371
SIM,1905,36,na,1941,4170
STAT,1903,31,40-44,1934,7.157727672325353
SIM,1834,25,40-44,1859,10
SIM,1933,72,na,2005,4537
SIM,1912,32,na,1944,3795
STAT,1816,39,40-44,1855,13.530465025762611
SIM,1824,39,40-44,1863,3
STAT,1804,54,45-49,1858,0.06416720789281387
SIM,1864,91,na,1955,128
SIM,1812,54,45-49,1866,1
SIM,1876,36,35-39,1912,21
STAT,1836,32,45-49,1868,2.00671008076724
STAT,1922,50,na,1972,4824.643034799055
SIM,1878,32,na,1910,2908
STAT,1814,40,45-49,1854,6.689288117229651
SIM,1917,30,30-34,1947,26
STAT,1906,45,50-100,1951,0.23546735395337884
STAT,1926,24,50-100,1950,0.9165655527161258
STAT,1935,60,na,1995,5576.783999021962
STAT,1855,38,15-19,1893,0.047544669238121125
STAT,1896,93,na,1989,280.19669689537034
STAT,1825,40,20-24,1865,0.24609109989889894
STAT,1863,98,na,1961,7.83945423542813
STAT,1946,52,na,1998,4808.906647764556
SIM,1847,40,na,1887,2467
STAT,1824,109,na,1933,4.402165824319354E-4
SIM,1776,82,na,1858,251
STAT,1967,31,30-34,1998,23.164425690702085
SIM,1983,27,40-44,2010,9
STAT,1847,47,20-24,1894,0.009190405742520854
SIM,1892,41,35-39,1933,6
STAT,1876,50,40-44,1926,0.012739745124265033
SIM,1911,87,na,1998,1768
STAT,1886,86,na,1972,651.3190825052664
SIM,1832,48,35-39,1880,1
SIM,1841,31,15-19,1872,2
STAT,1829,33,15-19,1862,0.1780932850066309
SIM,1979,29,40-44,2008,1
SIM,1886,29,25-29,1915,112
STAT,1956,34,25-29,1990,14.368377930563147
STAT,1840,30,45-49,1870,1.7396011385898627
STAT,1851,32,40-44,1883,3.5793761305194
SIM,1944,64,na,2008,3968
STAT,1884,41,35-39,1925,2.074070278831021
SIM,1855,32,20-24,1887,3
STAT,1938,34,na,1972,4385.178401207347
SIM,1892,22,30-34,1914,31
STAT,1997,15,20-24,2012,228.5904635217572
STAT,1881,32,na,1913,2656.272277412137
STAT,1947,63,na,2010,4462.913758066206
STAT,1977,20,35-39,1997,14.740883270370142
SIM,1864,37,25-29,1901,1
STAT,1928,28,15-19,1956,1.0032047156486472
SIM,1964,34,25-29,1998,3
SIM,1939,3,na,1942,5152
STAT,1931,47,35-39,1978,0.19899235388346356
STAT,1863,50,35-39,1913,0.008812331979114003
STAT,1928,27,na,1955,5326.077890897501
STAT,1928,46,15-19,1974,5.437622182145152E-4
SIM,1894,20,40-44,1914,9
SIM,1901,19,20-24,1920,53
SIM,1982,30,15-19,2012,1
STAT,1824,48,35-39,1872,0.18767400296748094
STAT,1833,31,15-19,1864,0.13162804887768284
STAT,1904,54,na,1958,3536.9355909367187
STAT,1862,37,45-49,1899,1.9415213136772935
STAT,1940,16,na,1956,4315.516330816302
STAT,1850,40,na,1890,2403.304581208739
STAT,1854,41,50-100,1895,0.8645825756728415
STAT,1886,20,40-44,1906,2.551778789931909
STAT,1830,41,40-44,1871,2.1925795018932663
SIM,1940,13,na,1953,5093
STAT,1938,49,45-49,1987,0.2559696899315595
SIM,1906,32,na,1938,3627
SIM,1835,32,50-100,1867,1
STAT,1829,48,15-19,1877,4.0275308710364954E-4
STAT,1862,22,45-49,1884,0.695232227507148
STAT,1855,23,15-19,1878,3.2558721450033996
STAT,1809,63,na,1872,1040.2507801751876
SIM,1829,42,20-24,1871,1
STAT,1894,26,35-39,1920,14.363687428085722
SIM,1878,34,45-49,1912,5
SIM,1962,18,15-19,1980,1
STAT,1906,21,15-19,1927,5.568593326255576
STAT,1852,15,40-44,1867,0.21104258978683588
STAT,1974,30,15-19,2004,0.19761232632987427
STAT,1922,3,na,1925,5414.897445873041
SIM,1894,35,40-44,1929,1
STAT,1886,35,40-44,1921,5.3793910712486595
STAT,1896,42,45-49,1938,0.15822365591832518
STAT,1930,46,35-39,1976,0.19645661985752966
SIM,1938,26,25-29,1964,95
STAT,1940,34,50-100,1974,0.9865579457976563
STAT,1905,39,na,1944,3926.374224677004
STAT,1954,36,15-19,1990,0.02825113413993516
STAT,1974,40,20-24,2014,0.027733815391665407
SIM,1872,58,na,1930,2440
SIM,1898,49,na,1947,3744
STAT,1884,22,30-34,1906,20.30993903795674
STAT,1983,32,15-19,2015,0.21384370645550282
SIM,1937,16,na,1953,3918
SIM,1953,23,na,1976,5283
STAT,1895,41,45-49,1936,0.15682887513383503
STAT,1947,15,50-100,1962,0.48729493958573106
SIM,1793,74,na,1867,750
STAT,1881,94,na,1975,124.9177728146933
SIM,1980,26,na,2006,5958
STAT,1836,99,na,1935,1.7235473862766473
STAT,1844,40,na,1884,2031.279110177346
SIM,1884,83,na,1967,561
STAT,1827,32,50-100,1859,1.5865706142472207
STAT,1881,104,na,1985,2.274522335342974
STAT,1898,34,25-29,1932,15.83841527729645
STAT,1871,56,na,1927,2341.757587936713
SIM,1948,57,na,2005,4089
STAT,1877,42,40-44,1919,2.696807459432506
STAT,1910,49,20-24,1959,0.011841546464821379
STAT,1981,20,45-49,2001,1.8229652846181204
STAT,1822,36,30-34,1858,13.569472200327919
STAT,1975,30,30-34,2005,24.477891439849937
STAT,1958,6,na,1964,5958.6230033393085
SIM,1907,30,35-39,1937,2
STAT,1894,49,25-29,1943,0.04719554369429735
SIM,1931,25,30-34,1956,14
STAT,1894,41,30-34,1935,1.7132952306662232
STAT,1853,35,50-100,1888,1.248014822242159
STAT,1933,69,na,2002,4688.020545780869
STAT,1856,99,na,1955,1.6674538572509994
STAT,1861,41,35-39,1902,1.7451687273598213
STAT,1819,46,50-100,1865,0.4797990695249349
STAT,1902,73,na,1975,2528.4897191375812
STAT,1957,31,35-39,1988,14.181560626301051
STAT,1861,35,40-44,1896,4.2396939024510685
SIM,1917,61,na,1978,4640
STAT,1946,27,20-24,1973,23.465751422712863
STAT,1847,37,na,1884,1880.8781729935615
STAT,1895,86,na,1981,901.5151501173079
SIM,1964,36,35-39,2000,11
SIM,1821,66,na,1887,809
STAT,1884,47,45-49,1931,0.2678376313124032
SIM,1842,53,40-44,1895,1
SIM,1898,63,na,1961,3244
STAT,1846,17,45-49,1863,0.0848303590372642
SIM,1827,44,45-49,1871,4
STAT,1956,22,na,1978,5594.996918813114
STAT,1837,40,45-49,1877,1.3120321512638289
STAT,1972,17,20-24,1989,200.32722038239453
SIM,1814,41,50-100,1855,3
SIM,1980,17,20-24,1997,211
STAT,1856,19,25-29,1875,5.830191177960706
SIM,1864,19,25-29,1883,6
SIM,1926,24,na,1950,5335
SIM,1949,30,40-44,1979,1
SIM,1960,43,40-44,2003,1
SIM,1789,78,na,1867,554
SIM,1860,41,25-29,1901,1
STAT,1903,16,45-49,1919,0.10763936094519869
STAT,1771,114,na,1885,3.753483541509077E-4
SIM,1830,36,30-34,1866,4
STAT,1906,17,40-44,1923,0.30780225233173414
SIM,1834,84,na,1918,389
SIM,1905,35,30-34,1940,2
SIM,1947,35,35-39,1982,6
STAT,1826,69,na,1895,808.0375371283999
STAT,1914,16,20-24,1930,32.460007415820854
SIM,2000,10,na,2010,6484
STAT,1878,48,30-34,1926,0.11517411641521384
SIM,1847,57,na,1904,2174
STAT,1849,23,20-24,1872,64.11291234746174
STAT,1868,51,30-34,1919,0.006631572629979131
SIM,1828,27,45-49,1855,4
SIM,1875,23,40-44,1898,6
STAT,1905,16,na,1921,4228.93719284243
STAT,1842,17,50-100,1859,0.048412379653254914
STAT,1863,30,45-49,1893,1.7738534826332881
SIM,1890,24,20-24,1914,8
SIM,1954,27,20-24,1981,28
STAT,1812,100,na,1912,0.46609757664322327
STAT,1867,37,na,1904,2538.538136710773
STAT,1854,64,na,1918,1416.2353548097735
STAT,1882,24,20-24,1906,77.19291157791578
STAT,1928,46,50-100,1974,0.3338702824483435
STAT,1925,30,na,1955,5187.214876122848
SIM,1922,16,20-24,1938,189
STAT,1813,45,20-24,1858,0.041098591633154685
SIM,1983,30,30-34,2013,13
SIM,1841,66,na,1907,1314
SIM,1867,71,na,1938,1101
SIM,1838,29,25-29,1867,39
STAT,1834,53,40-44,1887,0.009657798629563102
STAT,1852,83,na,1935,374.2846714139258
STAT,1881,32,20-24,1913,3.0088533518752834
SIM,1914,17,40-44,1931,1
STAT,1995,13,na,2008,6560.994818104702
SIM,1870,104,na,1974,2
SIM,1938,23,na,1961,4118
STAT,1889,25,15-19,1914,0.6498020540995096
SIM,1965,31,35-39,1996,3
STAT,1870,32,45-49,1902,1.9839886868997265
STAT,1893,34,50-100,1927,1.3251014150239981
SIM,1843,45,40-44,1888,2
STAT,1862,38,25-29,1900,2.7902348971800928
STAT,1932,30,20-24,1962,3.7471624503091716
STAT,1902,42,45-49,1944,0.1692621389006458
STAT,1992,20,20-24,2012,184.92857130910886
STAT,1867,23,40-44,1890,2.2383419947547933
SIM,1870,38,25-29,1908,7
SIM,1840,39,na,1879,1982
STAT,1835,45,40-44,1880,0.12696415153300117
SIM,1881,18,15-19,1899,7
STAT,1973,35,25-29,2008,1.5166435497351363
STAT,1873,18,15-19,1891,6.975484089106248
SIM,1886,48,30-34,1934,1
STAT,1876,53,45-49,1929,0.01703502423395591
SIM,1854,39,na,1893,2491
STAT,1884,29,na,1913,2701.715214253571
SIM,1927,35,50-100,1962,1
SIM,1917,22,45-49,1939,5
SIM,1941,28,50-100,1969,2
STAT,1788,84,na,1872,163.13597054204212
SIM,1924,43,na,1967,4906
STAT,1852,49,20-24,1901,0.011077538906478
SIM,1872,44,50-100,1916,7
SIM,1975,20,40-44,1995,6
STAT,1859,45,50-100,1904,0.22803217897970848
STAT,1904,45,15-19,1949,3.7765139766230793E-4
STAT,1947,25,15-19,1972,0.922477940804122
STAT,1965,41,25-29,2006,0.10707448620604137
STAT,1913,42,20-24,1955,0.019885625357202633
SIM,1910,29,na,1939,3786
STAT,1938,46,40-44,1984,0.1872456576695832
STAT,1819,87,na,1906,117.28573560077197
SIM,1865,76,na,1941,1352
SIM,1882,88,na,1970,652
SIM,1834,39,na,1873,1904
STAT,1838,20,40-44,1858,2.376266460487611
STAT,1909,22,45-49,1931,1.20819296351926
SIM,1823,47,na,1870,2166
STAT,1935,45,45-49,1980,0.35595580806129296
STAT,1879,41,50-100,1920,1.2788046949640748
STAT,1967,20,40-44,1987,4.8664396668314716
STAT,1930,35,15-19,1965,0.028960646898227128
STAT,1823,34,25-29,1857,23.191167933839857
SIM,1955,25,15-19,1980,3
STAT,1946,20,50-100,1966,0.8455915365057365
SIM,1831,34,25-29,1865,6
SIM,1908,4,na,1912,4462
STAT,1963,43,15-19,2006,0.002336203333129781
SIM,1846,20,40-44,1866,2
SIM,1896,82,na,1978,1494
SIM,1944,48,30-34,1992,1
STAT,1819,44,45-49,1863,2.9619222991568734
SIM,1857,23,20-24,1880,72
STAT,1777,92,na,1869,8.225786386301781
STAT,1895,47,20-24,1942,0.010120931579617878
SIM,1981,15,15-19,1996,123
STAT,1907,24,35-39,1931,9.846468535044668
SIM,1832,28,50-100,1860,5
STAT,1805,53,na,1858,1396.1060712364374
STAT,1869,31,25-29,1900,11.49400030019213
STAT,1985,29,na,2014,6169.354677711112
SIM,1924,29,na,1953,4586
SIM,1877,87,na,1964,536
SIM,1909,12,na,1921,5073
STAT,1936,48,30-34,1984,0.10174589669860887
SIM,1901,29,50-100,1930,3
STAT,1953,49,30-34,2002,0.12869054430774246
STAT,1923,25,30-34,1948,52.24878043187476
SIM,1829,52,na,1881,1509
STAT,1848,40,20-24,1888,0.17290975788192453
STAT,1883,75,na,1958,1276.7379425013264
SIM,1915,24,35-39,1939,12
SIM,1877,31,25-29,1908,26
SIM,1955,35,na,1990,6523
SIM,1930,33,30-34,1963,52
STAT,1872,44,15-19,1916,0.0157868524373096
STAT,1865,9,na,1874,2872.705455995379
SIM,1814,84,na,1898,85
STAT,1818,52,45-49,1870,0.017238026649273094
STAT,1801,91,na,1892,24.322113599509414
SIM,1962,47,50-100,2009,1
STAT,1778,113,na,1891,4.110074405915625E-4
SIM,1906,18,30-34,1924,2
STAT,1948,40,25-29,1988,0.09828046328303251
STAT,1879,46,25-29,1925,0.06960615218198309
STAT,1898,29,na,1927,3695.6099903409963
STAT,1909,32,50-100,1941,0.9115453807832659
STAT,1988,21,40-44,2009,5.569889704181889
STAT,1816,45,na,1861,1508.952939113242
STAT,1969,45,45-49,2014,0.32743586513668005
STAT,1922,33,30-34,1955,20.448030469306698
STAT,1979,29,na,2008,5972.375853187751
SIM,1961,53,na,2014,5390
STAT,1862,15,35-39,1877,0.6193293257643635
STAT,1946,42,15-19,1988,0.0020427759774066614
STAT,1840,19,na,1859,2356.1188315147906
STAT,1953,41,45-49,1994,0.24180937334086988
SIM,1937,65,na,2002,3438
SIM,1961,29,20-24,1990,31
STAT,1882,30,15-19,1912,0.161814381428688
STAT,1919,30,na,1949,4745.700262015878
STAT,1974,15,30-34,1989,18.377382152716372
SIM,1981,32,20-24,2013,2
STAT,1921,38,40-44,1959,1.9263379681885282
STAT,1919,41,45-49,1960,0.20839121766516655
SIM,1917,1,na,1918,5949
STAT,1822,39,35-39,1861,15.57330591569383
STAT,1835,51,35-39,1886,0.005584652306804212
STAT,1854,24,40-44,1878,1.9661646987882018
STAT,1914,78,na,1992,2417.2702801136247
SIM,1949,33,45-49,1982,1
STAT,1827,51,40-44,1878,0.013126279307471858
STAT,1815,52,50-100,1867,0.02963313988593613
STAT,1953,29,20-24,1982,25.56830171584348
SIM,1882,30,20-24,1912,5
SIM,1922,62,na,1984,4349
STAT,1832,33,20-24,1865,2.4272391200642374
STAT,1871,107,na,1978,0.18538969581526737
STAT,1836,45,na,1881,2198.3303069769536
STAT,1908,26,50-100,1934,1.1002539655041497
STAT,1988,24,45-49,2012,1.8620147170961425
STAT,1973,32,20-24,2005,3.7109086943218847
SIM,1844,60,na,1904,1736
STAT,1907,11,na,1918,4391.578577863804
STAT,1831,34,50-100,1865,0.9138657258367833
STAT,1874,30,20-24,1904,3.2191912625262766
STAT,1967,39,15-19,2006,0.02845951788127457
STAT,1900,22,25-29,1922,91.67058437537445
STAT,1975,33,35-39,2008,14.172948124698776
SIM,1922,19,25-29,1941,147
STAT,1885,4,na,1889,3197.6269510798393
SIM,1867,57,na,1924,1927
STAT,1878,74,na,1952,1337.2459118075071
SIM,1871,30,45-49,1901,5
STAT,1927,39,20-24,1966,0.3773458055056279
STAT,1895,21,25-29,1916,86.25352148485753
STAT,1914,19,25-29,1933,10.294556188967192
STAT,1805,51,20-24,1856,0.0026918368736898275
STAT,1884,44,40-44,1928,2.530053266265487
SIM,1963,38,40-44,2001,3
SIM,1849,52,na,1901,2391
SIM,1937,61,na,1998,3798
STAT,1875,27,50-100,1902,0.7628942113980541
STAT,1849,63,na,1912,1382.957516641429
SIM,1823,92,na,1915,131
SIM,1867,36,50-100,1903,6
SIM,1921,28,40-44,1949,20
SIM,1989,25,15-19,2014,4
SIM,1840,33,20-24,1873,6
STAT,1860,43,40-44,1903,2.0769582678133087
STAT,1913,28,40-44,1941,5.3436971727998905
STAT,1936,22,na,1958,4031.515124810312
SIM,1862,24,40-44,1886,8
SIM,1895,21,na,1916,3940
STAT,1945,31,45-49,1976,2.023247876116904
STAT,1962,40,na,2002,5723.011007283553
SIM,1931,31,25-29,1962,19
SIM,1954,20,50-100,1974,6
STAT,1963,46,20-24,2009,0.016895192661920827
STAT,1989,20,15-19,2009,8.834334383904974
SIM,1968,24,15-19,1992,10
STAT,1968,34,50-100,2002,1.2132141531549452
STAT,1985,26,50-100,2011,1.6415564010808628
STAT,1933,30,50-100,1963,1.2878764685918775
SIM,1881,29,50-100,1910,1
SIM,1974,3,na,1977,6405
SIM,1870,15,35-39,1885,3
SIM,1824,32,25-29,1856,3
STAT,1837,21,na,1858,2041.4606604481178
SIM,1830,39,35-39,1869,5
STAT,1864,18,50-100,1882,0.05191622364889877
STAT,1992,23,25-29,2015,153.46353272883047
STAT,1931,41,25-29,1972,0.11027599394915252
STAT,1802,103,na,1905,0.06850799320905794
SIM,1893,18,40-44,1911,1
STAT,1878,40,35-39,1918,2.203966796141007
STAT,1853,41,40-44,1894,2.24955459312361
STAT,1855,18,na,1873,2309.431567646859
STAT,1918,34,na,1952,4597.371140141895
STAT,1885,18,40-44,1903,0.2099897857542114
STAT,1961,32,40-44,1993,5.947523655157867
SIM,2005,0,na,2005,6492
SIM,1865,90,na,1955,83
STAT,1923,31,25-29,1954,12.273458051657226
SIM,1903,28,20-24,1931,2
SIM,1795,78,na,1873,478
STAT,1839,87,na,1926,139.72013207575944
STAT,1836,48,25-29,1884,0.05417982197972169
SIM,1928,47,35-39,1975,1
STAT,1853,37,na,1890,2345.655609511662
STAT,1915,95,na,2010,228.79634897958636
STAT,1913,45,25-29,1958,0.060063313569463005
SIM,1953,0,na,1953,5701
SIM,1836,34,40-44,1870,3
STAT,1769,100,na,1869,0.3079784425160714
STAT,1838,23,45-49,1861,0.7781833159699739
SIM,1965,34,40-44,1999,1
STAT,1900,92,na,1992,379.39819053226296
STAT,1929,46,30-34,1975,0.13368620662819136
STAT,1941,46,na,1987,4554.760889315364
SIM,1853,31,40-44,1884,6
STAT,1932,33,25-29,1965,14.174155598090309
STAT,1967,23,45-49,1990,1.6268350210146285
SIM,1967,28,45-49,1995,1
STAT,1907,49,15-19,1956,3.7713645820091805E-4
SIM,1831,42,na,1873,1666
STAT,1951,17,50-100,1968,0.5148661789585931
STAT,1783,111,na,1894,1.413588936062505E-4
STAT,1824,88,na,1912,84.94438619749637
STAT,1886,45,50-100,1931,0.30195223619645867
STAT,1831,41,20-24,1872,0.15416957044678156
STAT,1867,51,na,1918,2331.1136539283975
SIM,1852,20,35-39,1872,8
STAT,1925,20,35-39,1945,13.0804043803449
STAT,1816,90,na,1906,38.93540113804481
STAT,1900,29,40-44,1929,4.762678422685476
SIM,1886,40,35-39,1926,1
SIM,1846,23,45-49,1869,1
STAT,1878,100,na,1978,16.269001954964164
STAT,1939,35,35-39,1974,2.8847584180789663
STAT,1981,28,40-44,2009,7.5504785447443155
STAT,1876,93,na,1969,136.8037695918994
SIM,1897,28,20-24,1925,35
STAT,1899,17,25-29,1916,8.959496805291158
STAT,1915,40,30-34,1955,0.14897827317445494
SIM,1777,81,na,1858,269
STAT,1828,34,40-44,1862,4.695480161679435
SIM,1923,31,30-34,1954,5
STAT,1844,20,35-39,1864,6.182619818757592
SIM,1850,22,25-29,1872,1
STAT,1957,34,40-44,1991,6.061624542427251
STAT,1911,47,15-19,1958,4.0280189963330285E-4
STAT,1849,18,na,1867,2177.0618760056404
STAT,1773,114,na,1887,5.709846055250249E-4
STAT,1841,49,45-49,1890,0.20544428441224555
STAT,1804,88,na,1892,59.6907665854275
STAT,1935,42,40-44,1977,0.40737381235464326
SIM,1942,48,na,1990,4905
STAT,1882,16,50-100,1898,0.05536001261088624
STAT,1959,28,45-49,1987,2.6179766068574004
STAT,1915,31,30-34,1946,18.59684383790693
STAT,1871,33,50-100,1904,1.0475263808345245
STAT,1954,44,30-34,1998,0.1889186401940762
STAT,1827,82,na,1909,378.9211058083124
STAT,1854,47,30-34,1901,0.07849500624097269
STAT,1980,4,na,1984,6300.402347003123
STAT,1882,51,50-100,1933,0.01710549937743328
STAT,1842,22,25-29,1864,55.562478196803625
STAT,1971,37,15-19,2008,0.028917851575484276
SIM,1827,41,40-44,1868,11
SIM,1866,17,35-39,1883,1
SIM,1964,19,30-34,1983,29
STAT,1889,28,20-24,1917,16.6300575104148
SIM,1907,31,na,1938,4547
STAT,1969,42,40-44,2011,0.37473414862611737
STAT,1814,64,na,1878,1304.7514182881189
STAT,1924,54,na,1978,4914.395773362387
SIM,1933,20,35-39,1953,18
STAT,1941,21,30-34,1962,34.29713646080816
SIM,1852,58,na,1910,1528
SIM,1957,16,na,1973,6322
STAT,1962,35,50-100,1997,0.6407163785818395
STAT,1933,39,15-19,1972,0.030134681929683736
STAT,1803,72,na,1875,576.4409579616189
SIM,1963,36,30-34,1999,7
STAT,1935,46,na,1981,6003.610716633997
STAT,1836,25,35-39,1861,11.531645428065879
STAT,1945,38,50-100,1983,0.5447523685754037
SIM,1845,40,45-49,1885,7
STAT,1819,41,40-44,1860,4.8825059717828845
STAT,1890,40,15-19,1930,0.019670014530167586
SIM,1894,25,na,1919,3964
STAT,1880,37,30-34,1917,6.519359321649292
STAT,1885,56,na,1941,2347.8416040463353
STAT,1904,23,50-100,1927,0.6737098770842869
STAT,1876,42,25-29,1918,0.7651365923250418
STAT,1955,36,30-34,1991,2.8792780475892132
SIM,1880,27,30-34,1907,2
STAT,1941,30,30-34,1971,19.116203409734705
STAT,1858,17,35-39,1875,0.5770519807444353
STAT,1956,19,30-34,1975,18.600749084438476
STAT,1888,45,20-24,1933,0.01644118940016365
SIM,1841,16,20-24,1857,23
STAT,1951,43,35-39,1994,0.28712849288181647
SIM,1844,25,35-39,1869,19
STAT,1829,63,na,1892,1307.1443940530332
STAT,1891,32,15-19,1923,0.20311865412593458
STAT,1979,31,45-49,2010,2.5501780166155696
SIM,1927,41,45-49,1968,1
SIM,1810,74,na,1884,233
STAT,1833,39,50-100,1872,1.0658785966205186
SIM,1849,33,40-44,1882,11
SIM,1836,34,na,1870,1732
STAT,1844,53,35-39,1897,0.0070851950943635654
STAT,1915,41,50-100,1956,0.13671687781940778
SIM,1973,25,35-39,1998,48
STAT,1970,45,15-19,2015,5.561315156944547E-4
STAT,1870,57,na,1927,2286.4057959982288
STAT,1882,49,35-39,1931,0.15451514579700637
STAT,1897,19,15-19,1916,9.108694569532672
STAT,1965,25,35-39,1990,21.74333847886641
STAT,1910,18,45-49,1928,0.11404898892727387
STAT,1967,20,50-100,1987,0.9523365989987127
SIM,1864,60,na,1924,2078
STAT,1895,104,na,1999,3.910006446563604
STAT,1879,43,20-24,1922,0.1899902681154705
SIM,1882,33,25-29,1915,1
STAT,1816,54,35-39,1870,0.01619649547926225
STAT,1983,21,25-29,2004,151.34567359864977
SIM,1975,2,na,1977,6133
STAT,1904,47,50-100,1951,0.228518889814832
STAT,1865,70,na,1935,1460.959534399435
STAT,1971,34,45-49,2005,2.341461855061726
STAT,1916,17,35-39,1933,1.0275222787161162
STAT,1827,54,45-49,1881,0.015514599327597649
STAT,1865,27,20-24,1892,12.215444883516136
SIM,1925,37,50-100,1962,1
STAT,1859,28,40-44,1887,2.781256102525207
SIM,1841,41,50-100,1882,1
SIM,1870,46,50-100,1916,2
SIM,1946,17,20-24,1963,157
STAT,1956,44,20-24,2000,0.027933567277516145
SIM,1925,59,na,1984,4955
STAT,1994,21,35-39,2015,15.737751628554692
STAT,1873,107,na,1980,0.22245354679246948
STAT,1905,17,25-29,1922,9.465263019916465
STAT,1894,33,45-49,1927,2.576111325708146
STAT,1830,27,25-29,1857,53.17591608073945
STAT,1870,40,30-34,1910,1.32120360250543
STAT,1805,54,25-29,1859,0.012146879216250787
STAT,1820,49,50-100,1869,0.24370159515541898
SIM,1897,87,na,1984,494
SIM,1908,67,na,1975,2910
STAT,1874,114,na,1988,3.659400205679251E-4
STAT,1945,39,na,1984,4875.904780806302
STAT,1874,33,25-29,1907,12.050029955847462
STAT,1940,35,40-44,1975,1.8108601153051236
SIM,1805,73,na,1878,638
STAT,1952,27,15-19,1979,0.9805315557874397
SIM,1895,52,na,1947,3217
STAT,1843,22,40-44,1865,2.6244498397432934
STAT,1880,17,45-49,1897,0.0799051817646907
STAT,1911,81,na,1992,1905.0071547892585
SIM,1914,43,25-29,1957,1
STAT,1865,42,15-19,1907,0.014361865312947537
STAT,1974,18,35-39,1992,6.321263515421803
STAT,1920,35,20-24,1955,0.33351734353825346
SIM,1887,43,20-24,1930,1
SIM,1861,35,50-100,1896,1
STAT,1932,48,50-100,1980,0.35318304320850197
STAT,1858,40,15-19,1898,0.012558247635077726
SIM,1826,30,35-39,1856,7
SIM,1827,46,50-100,1873,1
SIM,1885,45,na,1930,3047
STAT,1854,27,45-49,1881,0.9482744057375937
STAT,1907,21,30-34,1928,30.33611761099142
SIM,1881,52,na,1933,1699
SIM,1815,80,na,1895,382
STAT,1896,62,na,1958,2867.6461784278877
SIM,1988,20,na,2008,6131
STAT,1974,35,40-44,2009,2.328110074438961
SIM,1920,85,na,2005,854
STAT,1874,18,30-34,1892,1.8781390011958434
STAT,1811,44,40-44,1855,7.4214889814961476
STAT,1853,44,45-49,1897,1.4699700545800454
SIM,1915,21,30-34,1936,75
SIM,1957,21,35-39,1978,28
SIM,1894,39,25-29,1933,1
SIM,1904,21,20-24,1925,2
STAT,1860,46,45-49,1906,0.22012885933289608
STAT,1954,22,20-24,1976,159.16190883684726
STAT,1826,100,na,1926,0.5845476534267694
SIM,1845,20,25-29,1865,5
STAT,1949,21,35-39,1970,12.68371307877233
SIM,1867,28,40-44,1895,1
SIM,1962,22,20-24,1984,8
STAT,1938,17,20-24,1955,154.41481282517432
STAT,1893,46,40-44,1939,0.1412699477004271
STAT,1839,37,20-24,1876,0.7305368823241897
SIM,1893,40,na,1933,3359
STAT,1886,39,25-29,1925,3.4696037748890465
STAT,1823,31,20-24,1854,8.290750072987445
STAT,1917,43,35-39,1960,0.2421384125463079
SIM,1878,18,na,1896,3000
STAT,1804,103,na,1907,0.062400186219997315
STAT,1805,110,na,1915,1.1356051188683536E-4
STAT,1833,53,25-29,1886,0.00253566034658627
STAT,1922,44,20-24,1966,0.023305168833022416
SIM,1899,17,30-34,1916,5
SIM,1991,21,25-29,2012,4
SIM,1831,31,20-24,1862,6
SIM,1935,17,45-49,1952,2
STAT,1828,37,45-49,1865,2.051702108796628
SIM,1855,38,na,1893,1837
STAT,1837,20,25-29,1857,56.896274580906685
SIM,1858,41,35-39,1899,2
SIM,1872,27,na,1899,2916
STAT,1871,46,20-24,1917,0.01381663382947196
STAT,1943,22,45-49,1965,1.381650869456883
SIM,1854,53,na,1907,2258
SIM,1940,33,25-29,1973,26
STAT,1974,19,na,1993,5542.921468044695
STAT,1869,63,na,1932,1994.1532555006077
STAT,1912,12,na,1924,4613.121859554565
STAT,1996,12,na,2008,6588.187112941626
SIM,1971,28,na,1999,5316
SIM,1976,31,35-39,2007,8
STAT,1927,17,45-49,1944,0.7166430359022554
SIM,1959,38,30-34,1997,8
SIM,1870,15,na,1885,3298
STAT,1867,82,na,1949,502.7371695552995
SIM,1815,49,45-49,1864,1
STAT,1933,28,50-100,1961,1.525156171748587
SIM,1940,36,na,1976,4998
STAT,1910,31,na,1941,4230.043076357965
STAT,1921,18,20-24,1939,177.8112174737561
SIM,1987,17,50-100,2004,4
STAT,1911,41,40-44,1952,0.27732912027058465
SIM,1825,32,40-44,1857,9
STAT,1769,109,na,1878,0.004590610650141055
STAT,1980,25,20-24,2005,29.39629490223977
STAT,1878,28,45-49,1906,1.3331566317205301
STAT,1880,44,50-100,1924,1.2748519507326943
STAT,1938,57,na,1995,4161.207657461863
STAT,1936,4,na,1940,4462.157122163716
STAT,1921,33,15-19,1954,0.1642781756507362
SIM,1909,27,45-49,1936,3
SIM,1869,38,na,1907,1962
SIM,1828,26,50-100,1854,1
STAT,1915,34,35-39,1949,10.650750842186385
STAT,1939,29,50-100,1968,1.154103123948905
STAT,1993,6,na,1999,6527.285956609951
SIM,1836,37,45-49,1873,3
SIM,1960,36,na,1996,6230
STAT,1894,81,na,1975,1427.078007690066
SIM,1973,22,30-34,1995,1
STAT,1831,44,25-29,1875,0.5998761430775306
SIM,1839,24,15-19,1863,7
SIM,1887,41,50-100,1928,4
SIM,1977,17,15-19,1994,125
SIM,1849,38,na,1887,2683
STAT,1848,106,na,1954,0.01290088189483524
STAT,1821,33,45-49,1854,7.046855157405963
SIM,1807,54,na,1861,1087
SIM,1923,34,35-39,1957,20
STAT,1932,18,30-34,1950,18.581813910858795
STAT,1983,19,50-100,2002,0.6112334264071316
SIM,1966,27,na,1993,5466
STAT,1821,46,na,1867,1609.1082753672795
STAT,1863,75,na,1938,1038.8406425608705
STAT,1905,45,30-34,1950,0.09211432169880766
SIM,1847,71,na,1918,1409
STAT,1860,49,15-19,1909,3.6427517085557985E-4
STAT,1898,43,na,1941,3591.1143580848184
SIM,1904,20,na,1924,3831
SIM,1930,29,na,1959,6065
STAT,1913,34,50-100,1947,0.9416866629744496
SIM,1886,28,45-49,1914,5
SIM,1931,77,na,2008,3404
STAT,1859,70,na,1929,1289.8527281122413
SIM,1974,33,25-29,2007,4
STAT,1899,28,na,1927,3759.979454281512
STAT,1969,17,15-19,1986,65.42586070760217
STAT,1941,24,35-39,1965,11.224736387380288
STAT,1906,43,25-29,1949,0.07450166522522746
SIM,1904,74,na,1978,2716
STAT,1858,103,na,1961,0.36936283086024974
STAT,1868,43,45-49,1911,1.6474388519134535
SIM,1990,23,30-34,2013,107
STAT,1930,24,25-29,1954,135.72279585961013
STAT,1873,44,30-34,1917,1.3365841130999043
SIM,1876,43,45-49,1919,3
STAT,1917,32,45-49,1949,1.9016650963917592
SIM,1896,37,na,1933,3678
SIM,1925,32,45-49,1957,5
STAT,1812,83,na,1895,174.29052986038778
STAT,1842,44,35-39,1886,1.4052208213389628
SIM,1850,44,35-39,1894,3
SIM,1890,15,na,1905,3735
SIM,1890,46,30-34,1936,1
STAT,1931,35,30-34,1966,2.7910275988830597
STAT,1965,22,30-34,1987,41.54607430972786
SIM,1803,92,na,1895,11
STAT,1853,68,na,1921,1521.5024979264113
STAT,1882,46,30-34,1928,0.10942420823837294
STAT,1899,37,45-49,1936,0.6802975979865838
STAT,1926,37,15-19,1963,0.027078769775449745
SIM,1924,74,na,1998,3062
STAT,1906,28,30-34,1934,42.22871858924428
STAT,1877,45,45-49,1922,0.2861294312670556
SIM,1838,46,na,1884,1634
SIM,1834,53,na,1887,1584
STAT,1870,43,35-39,1913,2.045324163903248
SIM,1818,46,na,1864,2138
STAT,1922,73,na,1995,3487.435435651188
SIM,1939,28,na,1967,4681
SIM,1849,47,50-100,1896,1
STAT,1953,24,50-100,1977,0.9210071818874908
STAT,1898,31,20-24,1929,4.2331364097990285
STAT,1900,41,30-34,1941,0.12842321006789836
STAT,1982,23,30-34,2005,46.812357070504035
SIM,1924,17,35-39,1941,12
SIM,1859,8,na,1867,2657
STAT,1811,50,35-39,1861,0.02667162202006644
STAT,1855,45,25-29,1900,0.04950020727315781
STAT,1850,57,na,1907,2068.8066740905692
STAT,1967,33,40-44,2000,5.746773093110194
STAT,1887,19,20-24,1906,22.80575564890706
STAT,1898,19,30-34,1917,2.472595300046997
SIM,1806,58,na,1864,1279
STAT,1816,76,na,1892,467.87513988179876
STAT,1901,22,40-44,1923,3.368441016834829
STAT,1908,29,45-49,1937,1.8736541584951418
STAT,1957,47,40-44,2004,0.24952642125948063
STAT,1847,54,30-34,1901,0.0044542622174780395
STAT,1866,45,35-39,1911,0.15124563166096883
SIM,1962,38,25-29,2000,3
STAT,1876,31,35-39,1907,12.130747744586982
SIM,1865,45,na,1910,2831
SIM,1953,58,na,2011,5287
STAT,1824,30,50-100,1854,2.8522966297057653
STAT,1868,40,40-44,1908,2.519088827573521
SIM,1874,45,35-39,1919,1
STAT,1806,69,na,1875,712.8073323713613
STAT,1837,43,15-19,1880,0.011649927393391955
STAT,1973,15,15-19,1988,67.77254419684
SIM,1883,16,25-29,1899,8
STAT,1843,25,45-49,1868,1.3909484108498442
STAT,1844,50,30-34,1894,0.005050395175285642
STAT,1920,38,25-29,1958,1.2423102441153309
STAT,1858,54,40-44,1912,0.009217259565862314
STAT,1891,17,20-24,1908,25.286526637777175
SIM,1948,15,30-34,1963,44
STAT,1894,30,40-44,1924,6.4854038475878095
SIM,1872,44,20-24,1916,1
SIM,1867,26,na,1893,2364
SIM,1832,30,50-100,1862,1
STAT,1851,52,30-34,1903,0.004695212168328084
STAT,1848,43,25-29,1891,0.6773807878158838
STAT,1875,16,25-29,1891,6.774712424998146
STAT,1931,38,35-39,1969,3.6938533340693764
STAT,1934,19,45-49,1953,0.7759679023162137
STAT,1884,30,15-19,1914,0.16368142145965503
STAT,1870,71,na,1941,1518.634944275399
STAT,1955,42,25-29,1997,0.1136922571706316
STAT,1864,44,20-24,1908,0.16143861632117887
SIM,1881,44,30-34,1925,1
STAT,1826,51,25-29,1877,0.0025116825872002766
STAT,1865,56,na,1921,2123.781302082889
SIM,1943,47,na,1990,5283
STAT,1844,24,50-100,1868,0.4197735091903842
SIM,1846,72,na,1918,669
SIM,1919,16,15-19,1935,58
STAT,1917,40,30-34,1957,0.15440202441589726
SIM,1904,46,35-39,1950,1
SIM,1836,65,na,1901,998
SIM,1887,26,na,1913,3827
SIM,1881,6,na,1887,2237
STAT,1923,47,40-44,1970,0.2127715109922276
STAT,1893,104,na,1997,3.7224090152223215
SIM,1910,20,na,1930,3898
SIM,1884,31,35-39,1915,14
STAT,1933,33,40-44,1966,6.085035593553934
STAT,1881,35,25-29,1916,3.235355664354362
SIM,1981,18,50-100,1999,1
SIM,1852,27,na,1879,2021
SIM,1878,63,na,1941,2106
SIM,1970,32,45-49,2002,1
STAT,1852,41,25-29,1893,0.6081737236908181
STAT,1833,50,20-24,1883,5.606010004605012E-4
SIM,1953,39,40-44,1992,7
STAT,1847,82,na,1929,359.01388155278113
SIM,1895,19,20-24,1914,58
STAT,1855,42,20-24,1897,0.13496692967448295
SIM,1925,40,30-34,1965,1
STAT,1835,49,na,1884,1440.5875339567663
STAT,1901,47,20-24,1948,0.010890958990607684
STAT,1921,30,45-49,1951,2.0363960449378737
SIM,1931,47,40-44,1978,2
STAT,1971,31,40-44,2002,5.83389090996008
STAT,1972,36,50-100,2008,0.6397270300869503
STAT,1945,39,40-44,1984,1.940132967981902
SIM,1917,96,na,2013,176
SIM,1880,49,40-44,1929,1
STAT,1911,44,45-49,1955,0.1812205417494337
STAT,1852,38,na,1890,2210.229536430106
STAT,1822,50,45-49,1872,0.027470894419430153
SIM,1794,79,na,1873,106
STAT,1849,26,25-29,1875,39.14637517603716
SIM,1968,23,35-39,1991,17
STAT,1844,42,45-49,1886,1.2820763314460655
SIM,1947,32,30-34,1979,2
SIM,1951,22,45-49,1973,5
STAT,1939,32,30-34,1971,18.559253056751285
STAT,1832,83,na,1915,270.463403508666
STAT,1893,108,na,2001,0.2437060726199257
STAT,1905,48,35-39,1953,0.13025069502437336
SIM,1852,72,na,1924,902
STAT,1890,34,20-24,1924,3.7790040167499126
STAT,1821,91,na,1912,35.440402965242335
SIM,1894,16,35-39,1910,1
STAT,1970,40,50-100,2010,0.17686330802009517
SIM,1863,64,na,1927,1835
SIM,1868,23,30-34,1891,27
STAT,1928,32,20-24,1960,3.519671584825226
SIM,1886,25,40-44,1911,10
SIM,1857,26,25-29,1883,10
SIM,1930,36,35-39,1966,7
STAT,1878,25,40-44,1903,3.634009553941662
STAT,1936,23,15-19,1959,5.874754686052322
SIM,1969,29,25-29,1998,6
STAT,1980,28,25-29,2008,105.85451313396155
SIM,1926,55,na,1981,5530
STAT,1894,115,na,2009,2.836381132311945E-4
STAT,1900,44,35-39,1944,0.198647017847
SIM,1940,30,20-24,1970,7
STAT,1897,28,50-100,1925,0.9836562581648091
STAT,1921,16,30-34,1937,16.067333617777333
STAT,1973,18,50-100,1991,0.5590116131139657
SIM,1938,18,50-100,1956,1
STAT,1940,21,15-19,1961,6.262119467457967
STAT,1834,64,na,1898,1586.4269167649838
SIM,1885,99,na,1984,64
SIM,1954,8,na,1962,5543
STAT,1775,80,na,1855,323.80692
STAT,1914,45,40-44,1959,0.18138665567383275
STAT,1803,58,na,1861,1052.4910474394565
STAT,1907,46,45-49,1953,0.2266823659627012
STAT,1840,21,50-100,1861,0.41902070776129063
SIM,1866,20,50-100,1886,1
STAT,1863,33,15-19,1896,0.14309859554239696
STAT,1940,47,na,1987,4479.038474976592
STAT,1905,30,na,1935,4017.9479170584436
SIM,1847,37,20-24,1884,4
STAT,1970,39,20-24,2009,0.39150171254457566
STAT,1780,104,na,1884,0.04754450930022197
STAT,1858,20,50-100,1878,0.42734220167485004
SIM,1841,35,na,1876,1989
STAT,1890,47,50-100,1937,0.1944456736169149
SIM,1862,27,45-49,1889,2
SIM,1898,18,na,1916,3995
STAT,1836,90,na,1926,71.75026090691573
SIM,1895,31,45-49,1926,6
STAT,1841,41,15-19,1882,0.012923080099730795
STAT,1855,49,na,1904,1874.408703160943
SIM,1956,45,40-44,2001,1
SIM,1975,36,45-49,2011,5
STAT,1906,40,20-24,1946,0.018746479982113026
STAT,1922,36,35-39,1958,3.1777045662624097
STAT,1892,32,30-34,1924,25.254334777373735
STAT,1838,54,20-24,1892,6.217332278170103E-4
STAT,1953,44,15-19,1997,0.0022206024146763253
STAT,1982,26,35-39,2008,24.497267294774428
STAT,1910,85,na,1995,1303.3125522087767
SIM,1922,48,na,1970,4964
STAT,1971,22,50-100,1993,0.9649475418017077
SIM,1801,66,na,1867,1117
SIM,1902,93,na,1995,103
STAT,1853,47,15-19,1900,3.963906116411711E-4
STAT,1847,28,15-19,1875,0.41659170058332223
STAT,1909,77,na,1986,2361.8424390968917
SIM,1800,81,na,1881,280
SIM,1885,42,40-44,1927,4
STAT,1887,31,45-49,1918,2.2645420588811076
STAT,1818,57,na,1875,1040.6557594254414
STAT,1914,31,15-19,1945,0.14996099671738322
STAT,1886,16,35-39,1902,0.6695902530789438
SIM,1903,36,50-100,1939,1
STAT,1919,49,40-44,1968,0.1961468422078846
STAT,1899,34,40-44,1933,6.797950301258844
STAT,1988,22,20-24,2010,184.1379678031113
STAT,1972,37,30-34,2009,2.774500038368361
SIM,1936,32,20-24,1968,6
SIM,1903,26,30-34,1929,87
STAT,1829,52,20-24,1881,6.61541951499998E-4
STAT,1901,0,na,1901,4746.537265697518
SIM,1974,30,20-24,2004,1
STAT,1860,50,50-100,1910,0.014249062132897297
SIM,1937,47,na,1984,4274
SIM,1911,56,na,1967,4407
SIM,1818,91,na,1909,59
STAT,1912,47,30-34,1959,0.09896542837257466
SIM,1918,0,na,1918,4678
SIM,1875,31,50-100,1906,2
STAT,1823,72,na,1895,715.1620233027509
SIM,1883,19,na,1902,2733
SIM,1816,65,na,1881,1163
STAT,1820,38,20-24,1858,1.1090395367211887
STAT,1838,17,50-100,1855,0.0560654509304669
STAT,1887,66,na,1953,2119.769539779875
STAT,1860,52,50-100,1912,0.013972417546274266
SIM,1859,21,40-44,1880,1
SIM,1862,31,40-44,1893,11
SIM,1956,23,30-34,1979,46
STAT,1824,47,40-44,1871,0.23255593223095572
STAT,1850,73,na,1923,1222.7272704747468
STAT,1973,36,30-34,2009,2.805101961698619
STAT,1937,37,15-19,1974,0.02217254379793373
STAT,1958,47,45-49,2005,0.34265526983176836
STAT,1932,42,35-39,1974,0.3150357519263696
STAT,1957,29,40-44,1986,7.115692291504425
STAT,1902,30,30-34,1932,28.69915264485439
SIM,1965,29,40-44,1994,1
STAT,1972,25,15-19,1997,1.048541424656059
STAT,1936,44,45-49,1980,0.18968199381023834
STAT,1948,23,30-34,1971,38.07061149071838
STAT,1887,40,50-100,1927,1.3801203373058288
STAT,1941,48,45-49,1989,0.26804078507585594
STAT,1803,95,na,1898,4.634021296025301
STAT,1911,49,na,1960,3993.6326396974396
STAT,1915,43,50-100,1958,0.1363043039066336
STAT,1959,51,na,2010,5695.056613702503
STAT,1836,23,50-100,1859,0.48644154423563063
STAT,1854,31,40-44,1885,3.655883064079202
SIM,1832,47,40-44,1879,1
STAT,1957,21,30-34,1978,43.89072362469014
STAT,1923,44,35-39,1967,0.27060863384134626
STAT,1889,35,20-24,1924,1.1070003479437933
SIM,1840,24,na,1864,2102
STAT,1844,24,35-39,1868,6.00695821344006
STAT,1960,31,30-34,1991,24.15283141721174
STAT,1830,45,15-19,1875,3.7880842536923263E-4
SIM,1921,31,45-49,1952,2
STAT,1873,54,25-29,1927,0.004059437775882457
STAT,1914,24,15-19,1938,6.239906901795877
STAT,1941,26,25-29,1967,78.63287977459287
SIM,1922,24,15-19,1946,15
STAT,1862,46,50-100,1908,0.23987692673138447
STAT,1989,24,15-19,2013,8.822237559335658
SIM,1962,0,na,1962,5606
STAT,1918,39,30-34,1957,2.2117692648424696
SIM,1886,21,na,1907,1978
SIM,1926,39,30-34,1965,7
SIM,1852,24,35-39,1876,7
STAT,1832,60,na,1892,1299.3430815074842
SIM,1897,35,20-24,1932,5
STAT,1832,53,50-100,1885,0.010692250787111049
SIM,1940,42,35-39,1982,1
SIM,1824,77,na,1901,65
STAT,1922,28,40-44,1950,6.062669708448237
STAT,1879,16,20-24,1895,21.415683484548744
STAT,1962,34,45-49,1996,2.3687154489654345
SIM,1932,31,20-24,1963,6
SIM,1909,23,45-49,1932,2
STAT,1850,37,40-44,1887,4.577764326971801
SIM,1912,33,45-49,1945,1
SIM,1958,54,na,2012,5888
SIM,1932,63,na,1995,4909
STAT,1837,91,na,1928,41.96164371894156
STAT,1833,45,40-44,1878,0.14577979641295075
STAT,1807,107,na,1914,0.002306120303620354
STAT,1843,49,50-100,1892,0.24128508676134688
STAT,1909,42,35-39,1951,0.21760281916030216
STAT,1945,42,45-49,1987,0.2180430432733232
SIM,1849,69,na,1918,1834
STAT,1883,39,45-49,1922,2.2281768539603677
STAT,1907,28,na,1935,4037.9921126704885
STAT,1944,29,30-34,1973,48.82618634029127
STAT,1903,14,na,1917,4231.326721683858
STAT,1959,24,45-49,1983,1.7029881412660577
SIM,1795,63,na,1858,1117
STAT,1930,47,30-34,1977,0.13549884736873374
STAT,1879,28,15-19,1907,0.5447956716074208
STAT,1853,22,na,1875,2515.2202972137557
SIM,1959,19,15-19,1978,4
STAT,1882,19,na,1901,2831.633768357708
STAT,1972,33,na,2005,5692.844836731264
STAT,1858,53,na,1911,1907.3425628962011
STAT,1851,50,30-34,1901,0.004788174250595725
STAT,1833,23,20-24,1856,68.92033976210115
STAT,1954,43,25-29,1997,0.10570711122803847
SIM,1952,29,30-34,1981,52
STAT,1889,34,50-100,1923,1.2922633814516964
STAT,1900,31,35-39,1931,16.283307569365547
SIM,1967,24,45-49,1991,7
SIM,1866,33,na,1899,2494
STAT,1894,39,20-24,1933,1.1320748746256841
SIM,1930,28,40-44,1958,12
STAT,1778,79,na,1857,355.93403994491405
SIM,1979,32,na,2011,6384
SIM,1953,25,na,1978,5247
STAT,1847,52,50-100,1899,0.011559012439498084
STAT,1992,7,na,1999,6511.0194222622395
STAT,1918,85,na,2003,1484.6688178804106
SIM,1848,35,25-29,1883,1
STAT,1908,61,na,1969,3536.619751449487
SIM,1841,23,20-24,1864,4
STAT,1956,42,20-24,1998,0.028026819090934168
SIM,1899,30,25-29,1929,2
SIM,1939,39,40-44,1978,5
STAT,1915,36,25-29,1951,1.1536091396466712
STAT,1879,31,na,1910,2887.301186601215
STAT,1910,41,45-49,1951,0.18275469537470485
SIM,1929,29,30-34,1958,107
SIM,1874,68,na,1942,1422
SIM,1971,36,na,2007,5710
STAT,1847,19,50-100,1866,0.04649697484203811
SIM,1980,24,20-24,2004,4
STAT,1856,103,na,1959,0.26156504976045164
SIM,1856,39,na,1895,2072
STAT,1861,57,na,1918,1928.0544972742766
STAT,1934,41,30-34,1975,0.20577494860818435
STAT,1872,38,30-34,1910,6.145293899644672
STAT,1960,45,35-39,2005,0.20252120849350277
SIM,1990,0,na,1990,6354
SIM,1852,25,na,1877,2216
SIM,1973,2,na,1975,5504
SIM,1837,20,na,1857,2469
SIM,1856,48,40-44,1904,1
SIM,1895,33,45-49,1928,5
STAT,1887,33,45-49,1920,2.2458078996286623
STAT,1912,18,30-34,1930,2.839660776350363
STAT,1904,79,na,1983,1969.22494948899
STAT,1900,65,na,1965,2979.850932512811
STAT,1904,33,45-49,1937,1.6523755808934417
SIM,1804,89,na,1893,83
STAT,1866,88,na,1954,146.84702178905923
STAT,1954,39,40-44,1993,2.19561580926433
STAT,1950,24,25-29,1974,126.37269137066369
SIM,1845,55,na,1900,1827
SIM,1827,42,na,1869,1416
SIM,1917,88,na,2005,988
STAT,1857,49,45-49,1906,0.20769043031248094
STAT,1862,74,na,1936,1080.8590613346616
STAT,1820,36,50-100,1856,3.1114269599524893
SIM,1826,31,30-34,1857,8
SIM,1894,72,na,1966,2443
STAT,1839,19,30-34,1858,1.6340978237035462
SIM,1905,29,45-49,1934,3
SIM,1847,19,30-34,1866,3
STAT,1878,14,na,1892,3101.7346180947748
SIM,1886,32,40-44,1918,3
STAT,1851,3,na,1854,2724.0
STAT,1881,17,15-19,1898,6.605921173763254
STAT,1844,61,na,1905,1562.969063038716
STAT,1878,32,40-44,1910,5.225550655775223
STAT,1960,37,15-19,1997,0.02973716707437107
SIM,1865,49,45-49,1914,1
STAT,1848,75,na,1923,1093.8319796755286
STAT,1919,45,na,1964,4619.119158688953
STAT,1974,16,35-39,1990,6.325057983486699
SIM,1940,50,na,1990,4862
SIM,1813,93,na,1906,17
SIM,1931,19,45-49,1950,1
STAT,1958,33,40-44,1991,6.042445498827771
SIM,1965,21,30-34,1986,95
SIM,1936,13,na,1949,4106
SIM,1982,16,35-39,1998,13
STAT,1913,31,45-49,1944,1.815106825764538
STAT,1876,32,30-34,1908,20.829073649894553
SIM,1884,32,30-34,1916,30
SIM,1992,14,na,2006,7025
STAT,1938,16,25-29,1954,49.47820399786421
STAT,1923,19,45-49,1942,0.6730627437787877
SIM,1836,41,40-44,1877,6
STAT,1924,34,25-29,1958,12.424819878454903
STAT,1934,47,15-19,1981,5.925816683144509E-4
STAT,1963,27,15-19,1990,1.0395145190662076
SIM,1857,56,na,1913,2167
SIM,1971,27,15-19,1998,1
SIM,1986,21,35-39,2007,40
SIM,1819,43,50-100,1862,2
STAT,1901,32,50-100,1933,1.4810951205672302
STAT,1924,45,50-100,1969,0.312127537258845
STAT,1967,42,40-44,2009,0.37471837317711065
SIM,1869,43,45-49,1912,3
STAT,1874,38,40-44,1912,5.146136531320474
SIM,1900,20,20-24,1920,204
STAT,1833,107,na,1940,0.003318492632142382
STAT,1898,36,50-100,1934,1.9241026863767332
STAT,1828,41,40-44,1869,2.1987191695159938
SIM,1966,33,40-44,1999,24
STAT,1892,15,25-29,1907,8.234632979857233
STAT,1833,41,50-100,1874,0.9190001542909195
STAT,1952,15,na,1967,5093.078478558551
STAT,1770,99,na,1869,0.1628586059840287
STAT,1877,111,na,1988,0.00994358749992904
SIM,1882,38,40-44,1920,8
STAT,1947,44,20-24,1991,0.02377909306442559
STAT,1894,36,na,1930,3512.007006389813
SIM,1877,17,na,1894,3340
SIM,1969,26,20-24,1995,2
STAT,1803,79,na,1882,296.8983099659893
STAT,1824,51,25-29,1875,0.00473877037141875
STAT,1883,36,na,1919,2672.9189286107908
STAT,1921,27,na,1948,4816.478061931389
STAT,1958,44,40-44,2002,0.3926867712049485
SIM,1982,27,35-39,2009,75
STAT,1855,27,15-19,1882,0.40239635713680033
STAT,1839,44,20-24,1883,0.1293841291862465
SIM,1903,29,35-39,1932,50
SIM,1863,68,na,1931,1695
SIM,1967,6,na,1973,5784
STAT,1825,38,45-49,1863,3.214744001254068
STAT,1844,48,20-24,1892,0.009910955679266338
STAT,1939,16,50-100,1955,0.43309178385460506
STAT,1998,7,na,2005,6660.301251695108
STAT,1865,23,na,1888,2474.659909216337
SIM,1862,34,45-49,1896,3
STAT,1784,110,na,1894,3.2085069684952727E-4
STAT,1974,27,35-39,2001,22.722129998081744
STAT,1854,34,45-49,1888,1.424966586945055
STAT,1791,77,na,1868,370.15279394558024
STAT,1921,89,na,2010,922.6998546430563
SIM,1890,31,50-100,1921,3
SIM,1824,31,20-24,1855,5
STAT,1928,49,40-44,1977,0.23079250825880165
STAT,1895,114,na,2009,8.356611059613078E-4
SIM,1844,54,na,1898,1998
STAT,1943,45,15-19,1988,4.7115851893328627E-4
STAT,1902,33,35-39,1935,16.44379065279776
STAT,1875,19,40-44,1894,0.2169595662402895
STAT,1961,22,35-39,1983,14.085527799779632
SIM,1902,23,35-39,1925,1
STAT,1912,40,40-44,1952,0.28182437355922324
STAT,1894,15,35-39,1909,0.8178136344169368
STAT,1919,29,20-24,1948,22.593492762066386
SIM,1921,34,25-29,1955,4
STAT,1779,102,na,1881,0.07428473890499976
STAT,1840,95,na,1935,10.665701122064545
SIM,1874,21,50-100,1895,1
SIM,1960,52,na,2012,5972
STAT,1778,95,na,1873,3.3550325720042116
SIM,1833,38,45-49,1871,1
STAT,1882,31,50-100,1913,1.0370264290856297
SIM,1865,16,na,1881,3319
SIM,1908,32,40-44,1940,1
SIM,1968,32,na,2000,5335
SIM,1927,29,20-24,1956,22
STAT,1910,18,20-24,1928,30.952901818342216
STAT,1913,34,25-29,1947,10.527007588636023
SIM,1954,42,na,1996,5447
STAT,1948,35,25-29,1983,1.3419951675318071
STAT,1976,16,45-49,1992,0.7704087850168675
STAT,1883,36,40-44,1919,4.966393682097485
SIM,1944,48,na,1992,4503
STAT,1836,38,20-24,1874,0.8524956931185685
SIM,1929,43,na,1972,5227
STAT,1812,50,50-100,1862,0.034824164489813444
SIM,1940,34,na,1974,4890
STAT,1856,54,50-100,1910,0.012931540540430272
SIM,1913,36,40-44,1949,3
SIM,1835,77,na,1912,886
SIM,1910,33,35-39,1943,1
STAT,1922,32,25-29,1954,12.046510695268713
SIM,1822,37,30-34,1859,9
STAT,1908,45,na,1953,3895.603420707277
STAT,1964,44,50-100,2008,0.17686843647759773
SIM,1967,21,40-44,1988,8
STAT,1923,41,30-34,1964,0.17262895165092196
STAT,1799,57,na,1856,1402.3720108576686
STAT,1962,31,40-44,1993,5.901794853556202
SIM,1885,20,30-34,1905,1
STAT,1854,46,15-19,1900,3.268037486481498E-4
SIM,1930,32,25-29,1962,30
STAT,1905,36,40-44,1941,1.585792516210397
STAT,1869,53,na,1922,2367.7608039122442
SIM,1953,19,20-24,1972,188
SIM,1956,35,25-29,1991,2
SIM,1932,17,50-100,1949,2
SIM,1891,36,40-44,1927,4
STAT,1957,19,na,1976,5596.76923025022
SIM,1966,44,40-44,2010,1
STAT,1792,78,na,1870,463.76501892854657
STAT,1864,22,na,1886,2476.2341065866694
STAT,1846,24,45-49,1870,0.8767376999059726
STAT,1959,21,40-44,1980,5.094189657735074
STAT,1966,23,na,1989,5279.445185562202
STAT,1967,31,40-44,1998,5.753675434610041
STAT,1924,17,50-100,1941,0.5147396921199453
SIM,1994,5,na,1999,6233
SIM,1935,12,na,1947,6460
STAT,1856,9,na,1865,2536.390605770567
STAT,1911,39,20-24,1950,0.29112537857811266
SIM,1984,21,25-29,2005,171
STAT,1921,19,35-39,1940,5.488234208332729
STAT,1829,37,15-19,1866,0.0644434956894988
SIM,1816,42,na,1858,1757
STAT,1888,26,15-19,1914,0.6175935103925386
SIM,1905,26,40-44,1931,9
SIM,1841,26,25-29,1867,9
STAT,1882,103,na,1985,4.170634441770569
STAT,1965,8,na,1973,5662.348564697262
STAT,1850,49,35-39,1899,0.14111327907981883
SIM,1934,22,40-44,1956,6
SIM,1954,23,20-24,1977,10
STAT,1868,16,45-49,1884,0.07417573398688926
STAT,1936,57,na,1993,4020.132321040668
STAT,1898,66,na,1964,2808.223137823901
STAT,1896,42,50-100,1938,0.1116872862105282
STAT,1822,47,30-34,1869,0.18296145716098583
STAT,1990,20,45-49,2010,1.867015926243957
STAT,1900,39,45-49,1939,0.6820911185335649
SIM,1915,51,na,1966,4391
STAT,1857,46,40-44,1903,0.15431327148909205
SIM,1852,41,na,1893,1918
STAT,1925,18,40-44,1943,1.9441918528539777
SIM,1860,49,45-49,1909,2
STAT,1935,35,15-19,1970,0.031059385209140568
SIM,1955,46,30-34,2001,1
STAT,1772,107,na,1879,0.0010326901186450785
SIM,1960,11,na,1971,6321
STAT,1896,39,30-34,1935,8.04203889030548
STAT,1926,22,40-44,1948,4.7131548018318945
STAT,1833,26,25-29,1859,40.26344775669174
STAT,1851,28,45-49,1879,1.0234998740644707
SIM,1896,26,15-19,1922,1
STAT,1943,68,na,2011,3847.1242700139874
SIM,1936,20,50-100,1956,2
STAT,1893,19,na,1912,3664.39115119783
STAT,1906,41,50-100,1947,0.12401771903780423
SIM,1988,9,na,1997,6634
STAT,1852,49,45-49,1901,0.21785825689295163
STAT,1945,19,20-24,1964,170.79989996373698
STAT,1960,48,15-19,2008,5.743198657195761E-4
SIM,1964,25,na,1989,5726
SIM,1796,80,na,1876,227
STAT,1871,48,50-100,1919,0.2784367483187187
STAT,1853,22,35-39,1875,6.864658913833194
STAT,1904,30,40-44,1934,7.244659067371091
STAT,1952,31,na,1983,5334.633125849895
STAT,1960,32,45-49,1992,2.410910434022689
STAT,1898,33,20-24,1931,4.198116414772888
STAT,1823,46,50-100,1869,0.24608714882005017
SIM,1876,25,35-39,1901,32
SIM,1861,22,35-39,1883,14
SIM,1971,29,25-29,2000,218
STAT,1924,31,20-24,1955,3.285092283779713
STAT,1928,20,50-100,1948,0.953735080911743
SIM,1947,13,na,1960,6076
STAT,1850,41,25-29,1891,0.6640571824433795
STAT,1916,15,35-39,1931,1.0322962970770604
STAT,1946,23,20-24,1969,142.7507936888395
STAT,1828,44,45-49,1872,1.3946239460645797
SIM,1902,17,na,1919,4217
SIM,1897,38,25-29,1935,4
STAT,1833,48,45-49,1881,0.17597231039381994
STAT,1879,15,na,1894,3057.5431651946737
SIM,1965,24,35-39,1989,23
SIM,1874,25,25-29,1899,114
SIM,1888,16,15-19,1904,18
STAT,1889,30,15-19,1919,0.2042131858122849
SIM,1807,81,na,1888,210
SIM,1835,32,35-39,1867,2
STAT,1921,35,50-100,1956,0.5417562727457065
STAT,1902,36,15-19,1938,0.0198591010866549
SIM,1849,85,na,1934,301
SIM,1845,71,na,1916,1143
SIM,1846,56,na,1902,1325
SIM,1912,30,40-44,1942,2
STAT,1958,36,45-49,1994,1.0655294598994642
SIM,1860,76,na,1936,1332
STAT,1841,69,na,1910,1304.7783734795162
SIM,1985,28,na,2013,6060
STAT,1893,27,50-100,1920,0.9331311464906978
SIM,1944,44,45-49,1988,2
STAT,1933,28,40-44,1961,7.142030845032627
SIM,1949,41,40-44,1990,1
SIM,1957,53,na,2010,6042
SIM,1836,44,45-49,1880,7
STAT,1849,92,na,1941,32.28113703434296
STAT,1909,45,15-19,1954,3.9483381715727737E-4
STAT,1840,27,30-34,1867,25.1876460615296
STAT,1935,32,35-39,1967,14.598361829329404
SIM,1889,20,15-19,1909,6
STAT,1931,26,40-44,1957,6.949255332043599
STAT,1889,38,25-29,1927,4.075541972018131
STAT,1871,35,na,1906,2730.6488305323674
STAT,1860,51,35-39,1911,0.008045672619722439
SIM,1840,40,na,1880,2033
STAT,1950,21,20-24,1971,152.2816989227135
SIM,1860,41,35-39,1901,2
SIM,1975,20,50-100,1995,1
STAT,1827,32,35-39,1859,17.536025454591396
STAT,1875,49,na,1924,2627.127677415626
SIM,1889,28,25-29,1917,79
STAT,1934,42,45-49,1976,0.26749245443699227
STAT,1943,42,35-39,1985,0.2561223754963704
SIM,1931,16,40-44,1947,2
STAT,1866,25,25-29,1891,45.555195668986904
STAT,1923,16,40-44,1939,1.8993907354980435
SIM,1828,34,45-49,1862,6
STAT,1848,48,40-44,1896,0.1796191038299562
STAT,1957,24,35-39,1981,14.364517081520288
STAT,1842,21,20-24,1863,67.37004816219944
STAT,1974,25,25-29,1999,99.70176078357127
STAT,1970,19,30-34,1989,17.59652660447231
SIM,1894,56,na,1950,3274
SIM,1897,21,na,1918,3847
SIM,1890,42,na,1932,3222
STAT,1943,27,na,1970,4604.735403307
STAT,1814,49,25-29,1863,0.15496948561105076
SIM,1824,34,25-29,1858,6
SIM,1960,21,30-34,1981,1
STAT,1963,38,15-19,2001,0.028977505623217027
STAT,1870,38,20-24,1908,0.8726634374577991
STAT,1875,29,45-49,1904,1.3146785220343027
STAT,1890,18,30-34,1908,2.2416589260425304
SIM,1818,38,na,1856,2195
STAT,1914,15,25-29,1929,10.398149341679826
SIM,1966,17,40-44,1983,4
SIM,1828,31,40-44,1859,2
STAT,1947,45,35-39,1992,0.1751532849733108
STAT,1913,31,20-24,1944,2.813555417603143
STAT,1839,47,25-29,1886,0.04654167319019229
STAT,1880,87,na,1967,490.0992296033631
SIM,1918,26,15-19,1944,1
SIM,1940,41,20-24,1981,1
STAT,1872,57,na,1929,2328.764836449488
STAT,1869,50,40-44,1919,0.011934867898437706
STAT,1972,19,40-44,1991,2.0653665793420113
STAT,1926,31,30-34,1957,21.993653925951804
STAT,1937,32,45-49,1969,1.7976163316960505
SIM,1884,35,35-39,1919,15
SIM,1883,29,45-49,1912,3
SIM,1937,30,na,1967,4368
STAT,1921,41,45-49,1962,0.21656206125398134
STAT,1952,21,30-34,1973,39.89279601767656
STAT,1838,92,na,1930,36.07714012813673
SIM,1932,32,35-39,1964,32
STAT,1929,85,na,2014,1808.8443762986246
STAT,1902,31,45-49,1933,2.855145760098357
SIM,1904,51,na,1955,3859
STAT,1865,44,25-29,1909,0.6596243915866955
STAT,1932,41,20-24,1973,0.02766929052463904
STAT,1866,16,35-39,1882,0.6060086982497491
STAT,1874,42,25-29,1916,0.7577406004248471
STAT,1781,99,na,1880,0.26762627392610855
SIM,1907,37,50-100,1944,1
STAT,1876,35,35-39,1911,8.517980990820998
STAT,1919,27,30-34,1946,48.8467026610141
SIM,1882,42,25-29,1924,2
STAT,1913,36,15-19,1949,0.02198721778073046
SIM,1873,28,50-100,1901,1
SIM,1918,29,30-34,1947,40
SIM,1927,27,30-34,1954,79
SIM,1971,18,25-29,1989,90
STAT,1907,38,40-44,1945,1.5963663383370814
SIM,1873,44,25-29,1917,1
SIM,1885,68,na,1953,2093
STAT,1966,27,50-100,1993,1.4409235282549835
SIM,1874,16,35-39,1890,2
STAT,1963,18,25-29,1981,63.51605181800974
STAT,1972,16,25-29,1988,64.05030837327595
SIM,1863,15,20-24,1878,41
SIM,1915,38,40-44,1953,5
STAT,1891,24,20-24,1915,97.67582320600646
STAT,1851,17,50-100,1868,0.04723486107626459
STAT,1924,32,35-39,1956,12.300528370487658
STAT,1929,27,15-19,1956,1.0196706435833627
SIM,1876,16,na,1892,2916
SIM,1934,31,30-34,1965,36
STAT,1918,48,20-24,1966,0.013531111734726988
STAT,1930,20,40-44,1950,5.001258773211904
SIM,1857,6,na,1863,3046
STAT,1879,23,45-49,1902,0.8376891779415737
SIM,1960,39,30-34,1999,6
STAT,1958,17,40-44,1975,2.1200835247341736
SIM,1887,23,45-49,1910,1
STAT,1914,14,na,1928,4701.583288387674
STAT,1922,65,na,1987,4243.90192817025
SIM,1848,26,35-39,1874,25
STAT,1886,29,20-24,1915,14.178758700891345
STAT,1937,28,25-29,1965,74.04938509101174
STAT,1830,26,na,1856,1768.669865267529
SIM,1978,8,na,1986,6040
SIM,1848,48,50-100,1896,2
STAT,1872,6,na,1878,3187.3005439736608
STAT,1918,28,na,1946,4583.703174494911
STAT,1980,34,20-24,2014,3.9781191845477246
STAT,1932,68,na,2000,4732.041411099664
SIM,1872,28,30-34,1900,58
STAT,1768,96,na,1864,1.422504121059666
SIM,1830,41,na,1871,1914
STAT,1890,15,15-19,1905,8.40731087314893
STAT,1851,74,na,1925,880.0566000257351
SIM,1804,101,na,1905,1
STAT,1952,39,30-34,1991,2.5912725484132166
STAT,1910,40,30-34,1950,0.14116377205861627
STAT,1855,88,na,1943,116.81399504342328
STAT,1829,40,na,1869,1959.4232940754732
SIM,1856,55,na,1911,1885
STAT,1848,91,na,1939,61.57116087261889
STAT,1951,19,50-100,1970,0.514521276283703
SIM,1894,29,20-24,1923,37
STAT,1855,15,20-24,1870,18.1554973651808
SIM,1834,55,na,1889,1487
SIM,1902,20,30-34,1922,67
SIM,1969,37,20-24,2006,3
STAT,1984,18,na,2002,6031.06608086882
SIM,1937,27,15-19,1964,1
SIM,1859,30,30-34,1889,37
SIM,1830,47,30-34,1877,1
SIM,1956,32,20-24,1988,1
STAT,1899,40,25-29,1939,0.0712156152746018
STAT,1851,95,na,1946,10.543293153997489
STAT,1914,18,40-44,1932,0.3331901463424232
SIM,1835,93,na,1928,1
STAT,1948,32,20-24,1980,3.283580730489666
STAT,1891,46,40-44,1937,0.1381321270906237
STAT,1945,47,15-19,1992,4.830353462463774E-4
STAT,1971,43,45-49,2014,0.2524096099241568
SIM,1979,18,na,1997,5693
STAT,1905,21,45-49,1926,1.1682682762485173
STAT,1963,36,50-100,1999,0.6347717439252563
STAT,1975,40,25-29,2015,0.11329764520929611
STAT,1826,51,35-39,1877,0.006104784127715355
STAT,1872,36,na,1908,2743.251717642655
STAT,1956,47,35-39,2003,0.2047906669606264
STAT,1862,28,20-24,1890,11.385422387073104
SIM,1934,25,45-49,1959,3
STAT,1950,22,35-39,1972,12.890892760665464
SIM,1870,28,20-24,1898,19
STAT,1955,17,15-19,1972,69.52780789377093
STAT,1976,27,45-49,2003,2.67514666614657
STAT,1988,17,50-100,2005,0.6183851209006401
STAT,1929,49,35-39,1978,0.19173783675525172
STAT,1971,36,20-24,2007,0.3973247508425022
STAT,1926,25,45-49,1951,2.4057555715377195
SIM,1945,28,25-29,1973,2
SIM,1916,87,na,2003,371
STAT,1946,26,25-29,1972,84.6512071496673
STAT,1836,51,40-44,1887,0.009891553108413415
STAT,1841,40,20-24,1881,0.15053168142459172
STAT,1974,22,20-24,1996,168.1160211989609
SIM,1963,17,15-19,1980,141
SIM,1909,20,40-44,1929,6
STAT,1926,49,30-34,1975,0.12616963891112545
STAT,1994,17,na,2011,6129.730375573758
STAT,1930,31,na,1961,5636.7696484237995
STAT,1991,16,30-34,2007,20.164496575354868
STAT,1922,49,na,1971,4839.98711388634
STAT,1892,40,15-19,1932,0.020176566819756877
STAT,1811,53,40-44,1864,0.030710859302254093
SIM,1815,89,na,1904,64
STAT,1942,67,na,2009,3872.9807877461335
STAT,1866,22,20-24,1888,74.3149418701799
SIM,1851,40,na,1891,2648
STAT,1937,3,na,1940,4556.200241386934
SIM,1954,26,25-29,1980,186
STAT,1842,24,25-29,1866,54.767465388998524
STAT,1900,40,25-29,1940,0.0721293159252269
STAT,1965,31,30-34,1996,23.15144956501687
STAT,1890,86,na,1976,801.0706302479632
SIM,1919,19,20-24,1938,351
STAT,1846,21,40-44,1867,2.6772128728239166
SIM,1895,7,na,1902,4047
SIM,1988,21,45-49,2009,1
STAT,1946,29,40-44,1975,5.985924766575886
SIM,1874,22,20-24,1896,72
STAT,1944,38,20-24,1982,0.33696145823527285
SIM,1820,63,na,1883,1469
STAT,1823,56,na,1879,1261.4911185617962
STAT,1841,48,30-34,1889,0.08535352816702974
STAT,1936,16,15-19,1952,50.29613439468631
STAT,1959,33,35-39,1992,14.052927273643075
SIM,1848,23,30-34,1871,29
STAT,1861,4,na,1865,2939.2240411958655
STAT,1951,30,na,1981,5303.867317390163
SIM,1906,47,na,1953,3464
STAT,1841,96,na,1937,7.634312656595045
STAT,1865,28,50-100,1893,0.663738969165793
STAT,1985,15,40-44,2000,2.2970532515804845
SIM,1944,16,15-19,1960,62
STAT,1777,78,na,1855,220.11594
STAT,1815,50,20-24,1865,0.0015067476464608546
STAT,1970,28,20-24,1998,26.47144944847781
SIM,1862,41,50-100,1903,2
SIM,1907,23,35-39,1930,25
STAT,1949,11,na,1960,5273.035107128676
SIM,1919,42,45-49,1961,1
SIM,1928,39,40-44,1967,4
SIM,1824,37,40-44,1861,3
STAT,1901,27,45-49,1928,1.794785831356238
STAT,1866,21,50-100,1887,0.4429397591921781
STAT,1945,42,20-24,1987,0.023137209118866815
STAT,1847,17,15-19,1864,5.699274425198707
STAT,1945,17,30-34,1962,15.365921923053946
SIM,1834,37,50-100,1871,5
SIM,1850,24,25-29,1874,126
STAT,1819,53,50-100,1872,0.027417741826736435
STAT,1950,22,50-100,1972,0.900831185846147
STAT,1848,52,25-29,1900,0.003743451858577539
SIM,1911,21,na,1932,5117
STAT,1863,49,20-24,1912,0.011856488984239867
STAT,1949,19,40-44,1968,1.8760567794369236
SIM,1964,47,35-39,2011,1
STAT,1956,43,35-39,1999,0.3190617451129676
SIM,1981,19,na,2000,6452
SIM,1950,12,na,1962,4816
SIM,1954,26,na,1980,5076
SIM,1958,23,40-44,1981,10
SIM,1908,35,45-49,1943,2
SIM,1984,27,45-49,2011,4
SIM,1888,17,na,1905,3065
STAT,1955,39,35-39,1994,3.8095064026948617
SIM,1858,34,50-100,1892,2
STAT,1909,83,na,1992,1569.8655650784865
SIM,1919,38,25-29,1957,2
STAT,1882,48,40-44,1930,0.1905544174768973
STAT,1948,26,35-39,1974,19.922644449605738
STAT,1954,47,25-29,2001,0.07871665286685586
STAT,1883,102,na,1985,7.230861725555392
STAT,1903,21,35-39,1924,9.621188888661141
STAT,1941,45,40-44,1986,0.195902915443677
STAT,1864,28,30-34,1892,25.857137847432227
STAT,1922,28,na,1950,4872.6584223786995
STAT,1820,47,20-24,1867,0.012451233687635628
STAT,1838,50,50-100,1888,0.013540832914284769
STAT,1869,32,na,1901,2666.9610627339553
STAT,1857,102,na,1959,0.5296574336810036
STAT,1963,15,20-24,1978,198.88089102598417
STAT,1844,21,30-34,1865,18.736396081115544
SIM,1864,69,na,1933,1339
STAT,1971,40,40-44,2011,0.3809971815642341
SIM,1900,34,50-100,1934,4
STAT,1937,47,40-44,1984,0.18379044169185432
SIM,1841,41,na,1882,1853
SIM,1848,32,20-24,1880,5
SIM,1849,21,na,1870,2807
STAT,1849,39,45-49,1888,1.5485383827474652
STAT,1952,24,35-39,1976,13.056078881852002
SIM,1853,1,na,1854,3642
SIM,1896,17,25-29,1913,11
STAT,1884,25,50-100,1909,0.7343391121282068
STAT,1947,47,25-29,1994,0.0717254842783732
STAT,1943,30,40-44,1973,4.88760103640789
STAT,1898,39,40-44,1937,1.4588252736876655
STAT,1864,25,15-19,1889,0.4725109742238054
STAT,1947,19,30-34,1966,15.834316439164853
STAT,1917,40,40-44,1957,0.3020808379458851
SIM,1862,41,45-49,1903,3
STAT,1865,37,25-29,1902,2.9979815413217428
STAT,1779,96,na,1875,1.3468066244843255
STAT,1802,78,na,1880,430.44130363518383
STAT,1859,91,na,1950,53.27170101956021
STAT,1937,22,50-100,1959,0.7398662233761928
STAT,1909,46,na,1955,3909.9123297816714
SIM,1945,47,40-44,1992,1
STAT,1886,49,na,1935,2681.5731147221036
STAT,1882,35,na,1917,2680.9142420864628
STAT,1923,28,35-39,1951,19.815219740230965
SIM,1955,19,30-34,1974,24
STAT,1952,15,45-49,1967,0.6912165716671435
SIM,1931,28,35-39,1959,53
SIM,1945,22,50-100,1967,2
STAT,1937,25,20-24,1962,20.56386163441261
STAT,1888,17,25-29,1905,7.687339865339575
SIM,1872,25,15-19,1897,1
STAT,1838,38,30-34,1876,5.514052690105493
STAT,1852,41,35-39,1893,1.714984500499284
SIM,1946,12,na,1958,4694
STAT,1939,41,30-34,1980,0.15376289798034565
SIM,1877,31,50-100,1908,2
STAT,1964,42,15-19,2006,0.0023197241418911755
STAT,1974,29,na,2003,5663.964779106554
STAT,1831,29,30-34,1860,25.875575682118903
STAT,1792,99,na,1891,0.5318141010675833
STAT,1865,34,20-24,1899,2.790479049115733
SIM,1958,20,25-29,1978,3
SIM,1960,15,45-49,1975,1
SIM,1797,59,na,1856,1126
STAT,1830,96,na,1926,5.386555153562154
STAT,1891,27,25-29,1918,60.33528559785225
STAT,1908,29,20-24,1937,19.797010439296177
STAT,1865,41,20-24,1906,0.16611327122248856
STAT,1875,54,35-39,1929,0.009984785385700683
STAT,1869,31,50-100,1900,1.0281883712708209
SIM,1859,33,35-39,1892,17
STAT,1891,49,45-49,1940,0.18591220728191138
SIM,1916,29,20-24,1945,23
SIM,1852,21,30-34,1873,47
STAT,1827,92,na,1919,33.82433824580885
STAT,1941,23,20-24,1964,132.60184202708493
SIM,1925,50,na,1975,5210
SIM,1849,16,25-29,1865,20
STAT,1829,32,45-49,1861,2.2619756976386833
SIM,1956,26,35-39,1982,55
SIM,1879,25,50-100,1904,1
STAT,1880,48,30-34,1928,0.11692192924301396
SIM,1947,49,40-44,1996,1
STAT,1842,27,40-44,1869,2.850677523647429
STAT,1898,36,25-29,1934,4.512240827670686
STAT,1962,48,25-29,2010,0.08135962339082428
STAT,1911,65,na,1976,3501.783137270894
SIM,1883,72,na,1955,1170
STAT,1915,79,na,1994,2316.940327246092
STAT,1867,31,15-19,1898,0.15406968429858928
SIM,1857,39,45-49,1896,2
STAT,1941,31,na,1972,4586.357902929398
STAT,1931,28,30-34,1959,58.363883690758854
SIM,1949,47,50-100,1996,2
STAT,1897,49,na,1946,3399.948764510774
SIM,1837,32,45-49,1869,1
STAT,1849,17,25-29,1866,5.4063275064979015
SIM,1934,34,35-39,1968,37
STAT,1813,78,na,1891,357.7505912804973
SIM,1857,17,25-29,1874,10
STAT,1939,49,40-44,1988,0.1884075632122996
STAT,1926,34,35-39,1960,12.733020348445402
STAT,1789,95,na,1884,2.146700432681705
STAT,1893,35,na,1928,3469.346401925256
STAT,1947,42,30-34,1989,0.1727146155242939
SIM,1859,24,45-49,1883,1
STAT,1911,34,15-19,1945,0.14329528724356017
SIM,1967,30,30-34,1997,33
STAT,1862,41,40-44,1903,2.200554780913569
SIM,1850,27,40-44,1877,5
SIM,1923,33,20-24,1956,6
STAT,1926,39,50-100,1965,0.5907799245918198
SIM,1934,39,50-100,1973,1
STAT,1930,38,40-44,1968,2.251433559674876
SIM,1959,33,50-100,1992,4
STAT,1899,15,35-39,1914,0.8715785567144075
STAT,1879,39,50-100,1918,1.4645631715251626
STAT,1932,27,na,1959,5663.918575608223
STAT,1991,19,35-39,2010,6.935283042624477
SIM,1837,25,20-24,1862,3
SIM,1886,35,45-49,1921,2
STAT,1861,73,na,1934,1139.5384799863264
STAT,1863,30,50-100,1893,0.9320247054607392
STAT,1865,87,na,1952,183.4493106982603
STAT,1956,44,30-34,2000,0.2022147336197041
SIM,1826,34,35-39,1860,18
STAT,1961,18,15-19,1979,67.64488258618994
STAT,1890,41,50-100,1931,1.4964647960311717
STAT,1862,58,na,1920,1926.0462829013616
SIM,1963,1,na,1964,6588
STAT,1888,42,15-19,1930,0.018710999341409847
SIM,1929,27,40-44,1956,1
STAT,1901,9,na,1910,4194.179610220873
STAT,1959,30,30-34,1989,24.270605183186092
STAT,1887,38,15-19,1925,0.07226576215511318
STAT,1930,23,45-49,1953,1.6585438397351104
STAT,1781,78,na,1859,222.2536258794942
STAT,1949,52,na,2001,5042.534977948928
SIM,1919,17,50-100,1936,1
STAT,1801,106,na,1907,0.005096163699579936
SIM,1954,30,20-24,1984,10
STAT,1844,18,na,1862,2426.2231257440512
STAT,1863,44,15-19,1907,0.013747534413051793
SIM,1945,25,20-24,1970,29
SIM,1965,26,na,1991,5434
SIM,1846,38,30-34,1884,3
STAT,1844,15,45-49,1859,0.07027872277979157
STAT,1829,25,20-24,1854,42.6661660365827
SIM,1895,16,50-100,1911,1
SIM,1905,16,15-19,1921,18
STAT,1877,23,35-39,1900,6.98352644234412
SIM,1970,30,35-39,2000,6
STAT,1841,43,25-29,1884,0.5857210615705175
STAT,1851,50,50-100,1901,0.012148508191203208
STAT,1915,33,20-24,1948,2.8552867650043963
STAT,1840,74,na,1914,890.2740850771031
SIM,1866,17,na,1883,2645
STAT,1844,88,na,1932,114.82710043902242
STAT,1901,87,na,1988,896.9190652590872
SIM,1972,37,na,2009,5739
STAT,1840,39,25-29,1879,2.6756581098846275
STAT,1871,20,25-29,1891,66.11734992423975
STAT,1960,42,30-34,2002,0.19970149384181168
STAT,1897,71,na,1968,2454.092705318631
SIM,1913,38,30-34,1951,3
SIM,1885,23,35-39,1908,18
SIM,1933,64,na,1997,5494
SIM,1910,4,na,1914,4093
STAT,1880,31,45-49,1911,2.1418324742776664
STAT,1895,40,40-44,1935,3.4129378732368836
STAT,1987,27,20-24,2014,30.203295603749773
SIM,1925,13,na,1938,5602
STAT,1859,54,na,1913,1924.9845374851277
STAT,1952,16,50-100,1968,0.5182828256431703
STAT,1815,53,25-29,1868,0.006812663812480288
STAT,1863,21,na,1884,2451.7604753120136
STAT,1877,20,30-34,1897,21.5102460168664
STAT,1855,22,45-49,1877,0.6931774836489546
STAT,1878,35,45-49,1913,2.4248755712583874
STAT,1842,22,na,1864,2075.26262181625
STAT,1905,48,50-100,1953,0.2284969328632295
STAT,1868,15,30-34,1883,1.8206116800443892
STAT,1904,48,40-44,1952,0.158028509117222
STAT,1845,110,na,1955,1.8621177596650365E-4
SIM,1849,41,15-19,1890,1
SIM,1905,38,35-39,1943,4
STAT,1967,45,45-49,2012,0.327422080837031
STAT,1832,30,15-19,1862,0.13227030253594116
STAT,1905,38,30-34,1943,1.9119124702267671
STAT,1831,26,15-19,1857,0.4763884120286447
STAT,1963,22,45-49,1985,1.6551357964516844
SIM,1870,41,40-44,1911,11
SIM,1973,29,35-39,2002,4
STAT,1879,16,45-49,1895,0.0789081767820538
SIM,1868,27,15-19,1895,3
SIM,1900,23,25-29,1923,201
STAT,1912,27,20-24,1939,20.779441829369283
STAT,1989,15,25-29,2004,71.67056146694603
SIM,1831,63,na,1894,1165
STAT,1838,35,15-19,1873,0.059936576399175684
STAT,1934,19,20-24,1953,210.5977310320101
STAT,1812,56,na,1868,1150.7542322130666
STAT,1982,6,na,1988,6383.924233805707
STAT,1945,45,25-29,1990,0.06988452319028453
SIM,1942,19,20-24,1961,296
STAT,1861,20,40-44,1881,2.083692208053089
SIM,1921,31,20-24,1952,1
SIM,1912,48,40-44,1960,1
STAT,1919,86,na,2005,1347.1799015452214
STAT,1968,27,15-19,1995,1.0219683064202207
SIM,1825,78,na,1903,733
STAT,1946,35,15-19,1981,0.025367337568331243
STAT,1950,39,20-24,1989,0.3697978644471179
SIM,1997,15,25-29,2012,181
STAT,1809,73,na,1882,602.9661435626599
STAT,1843,40,30-34,1883,1.2185421271285641
STAT,1889,30,na,1919,3421.9797916383095
SIM,1868,15,35-39,1883,3
SIM,1842,26,na,1868,2316
STAT,1852,46,40-44,1898,0.16186793147610012
SIM,1947,22,15-19,1969,16
SIM,1853,30,25-29,1883,22
STAT,1938,19,40-44,1957,1.592011276129578
STAT,1828,51,45-49,1879,0.01316607956549044
STAT,1928,43,20-24,1971,0.0259403584438566
STAT,1889,45,25-29,1934,0.0827568957336951
SIM,1932,49,20-24,1981,1
SIM,1837,41,na,1878,2382
STAT,1829,44,15-19,1873,0.014273831017379971
SIM,1857,36,40-44,1893,7
STAT,1909,38,15-19,1947,0.02089599998446616
STAT,1946,38,30-34,1984,2.4009998681402025
STAT,1835,30,40-44,1865,3.5209930854368934
SIM,1791,70,na,1861,688
STAT,1839,93,na,1932,23.17719208152759
STAT,1937,49,30-34,1986,0.10330978356567351
SIM,1945,49,30-34,1994,1
STAT,1834,62,na,1896,1667.9885196360833
SIM,1942,35,45-49,1977,1
SIM,1851,40,30-34,1891,3
STAT,1921,54,na,1975,4653.066274497148
STAT,1780,98,na,1878,0.8225957794947982
STAT,1961,20,45-49,1981,1.6843384042313065
SIM,1810,80,na,1890,145
SIM,1898,65,na,1963,3095
STAT,1893,34,35-39,1927,14.646062353046384
STAT,1843,23,na,1866,2673.52699842766
STAT,1913,49,45-49,1962,0.24350422580539888
STAT,1963,47,50-100,2010,0.34493070789826485
STAT,1962,45,20-24,2007,0.017077172819417896
STAT,1903,17,50-100,1920,0.0805317333831622
STAT,1827,86,na,1913,180.19017313042895
STAT,1943,33,45-49,1976,1.9618991480386356
STAT,1900,21,30-34,1921,28.60991631486467
SIM,1884,67,na,1951,1781
STAT,1947,17,40-44,1964,1.818270816370668
STAT,1956,24,na,1980,5591.192967130461
STAT,1944,26,15-19,1970,0.8809698768536101
STAT,1834,51,30-34,1885,0.005681355929016646
STAT,1942,26,na,1968,4540.284878785192
SIM,1905,52,na,1957,3736
STAT,1935,28,15-19,1963,1.110614629440685
SIM,1808,76,na,1884,531
SIM,1899,20,20-24,1919,10
STAT,1878,110,na,1988,0.026576470625807418
SIM,1874,32,25-29,1906,21
STAT,1855,29,50-100,1884,0.5592359061548223
STAT,1917,43,45-49,1960,0.20012774414350426
SIM,1922,27,30-34,1949,3
STAT,1854,60,na,1914,1553.7735261154337
STAT,1855,34,15-19,1889,0.12084431808212674
STAT,1913,27,25-29,1940,75.72680242413244
STAT,1934,35,45-49,1969,1.0880902113455768
STAT,1923,48,50-100,1971,0.30438907408070337
STAT,1954,33,20-24,1987,3.544915771360192
STAT,1939,44,35-39,1983,0.24103470107428754
STAT,1833,33,25-29,1866,9.26669577292571
SIM,1843,30,40-44,1873,10
STAT,1817,50,30-34,1867,0.017017162920761053
STAT,1845,21,50-100,1866,0.34360307025499565
STAT,1822,55,na,1877,1868.1276054436544
SIM,1811,43,40-44,1854,9
SIM,1921,27,25-29,1948,151
STAT,1957,39,45-49,1996,1.066379770502094
STAT,1879,20,40-44,1899,2.526011221430287
SIM,1884,57,na,1941,2271
STAT,1929,44,na,1973,5532.36373480273
SIM,1962,33,20-24,1995,8
STAT,1806,108,na,1914,6.286854797617151E-4
STAT,1914,27,30-34,1941,45.6066413658694
SIM,2000,14,na,2014,6485
STAT,1938,19,50-100,1957,0.42643148812292464
STAT,1881,34,50-100,1915,1.0111676163677104
STAT,1970,16,15-19,1986,65.5804966001143
STAT,1876,106,na,1982,0.5527864244330812
STAT,1991,20,15-19,2011,8.839112356042909
SIM,1866,38,na,1904,2477
STAT,1878,20,35-39,1898,7.073448049797177
STAT,1881,40,na,1921,2598.66779431038
STAT,1924,49,20-24,1973,0.01509011946266269
STAT,1845,30,25-29,1875,8.378753790926124
SIM,1821,58,na,1879,1163
SIM,1885,19,15-19,1904,1
STAT,1800,107,na,1907,0.002544666280051203
SIM,1920,15,15-19,1935,56
STAT,1839,51,20-24,1890,5.880068001539871E-4
SIM,1839,49,40-44,1888,1
STAT,1820,35,40-44,1855,12.10775754279168
STAT,1974,33,20-24,2007,3.7443452351241966
SIM,1910,48,30-34,1958,1
STAT,1879,36,na,1915,2852.6612169119167
SIM,1818,46,50-100,1864,2
STAT,1900,35,50-100,1935,1.9847246693948457
STAT,1902,48,30-34,1950,0.08791884715188288
SIM,1907,38,45-49,1945,2
STAT,1890,49,na,1939,3106.8831305301105
STAT,1935,30,45-49,1965,2.5165964216838383
SIM,1900,26,40-44,1926,1
STAT,1939,22,15-19,1961,6.172060173846118
STAT,1932,32,30-34,1964,24.17649593352071
STAT,1973,42,50-100,2015,0.18222351265878803
STAT,1995,20,45-49,2015,1.8871538681903242
STAT,1849,36,40-44,1885,3.508034432881002
STAT,1815,41,50-100,1856,2.438797061176687
STAT,1816,43,na,1859,1531.4471440352092
SIM,1971,33,45-49,2004,6
STAT,1912,15,15-19,1927,10.650108561882075
STAT,1972,5,na,1977,5809.65846129523
SIM,1940,32,30-34,1972,24
STAT,1845,52,45-49,1897,0.009727201392258638
STAT,1838,54,50-100,1892,0.0127248062255131
SIM,1955,27,na,1982,6511
SIM,1963,24,na,1987,6078
STAT,1829,28,25-29,1857,74.20168372398079
SIM,1831,23,15-19,1854,1
STAT,1960,43,45-49,2003,0.25956100929208753
STAT,1841,51,50-100,1892,0.01349195233442447
STAT,1882,42,20-24,1924,0.17879603324321175
SIM,1910,24,45-49,1934,4
STAT,1918,50,na,1968,4470.112442074187
SIM,1817,40,40-44,1857,6
STAT,1857,39,40-44,1896,3.8949468101547597
STAT,1930,44,15-19,1974,0.0023243777165764886
STAT,1784,70,na,1854,674.0
SIM,1915,33,35-39,1948,19
SIM,1929,17,15-19,1946,112
STAT,1835,54,40-44,1889,0.006435292922107589
STAT,1974,35,na,2009,5850.96136684284
STAT,1807,88,na,1895,67.13222624079077
STAT,1908,39,50-100,1947,0.4496582441843066
STAT,1939,68,na,2007,3632.584071120843
SIM,1814,88,na,1902,46
STAT,1844,33,50-100,1877,0.9069817943691638
SIM,1930,22,20-24,1952,298
STAT,1867,44,35-39,1911,1.9247942899782784
STAT,1985,22,40-44,2007,5.537174449161209
STAT,1876,42,35-39,1918,2.157602910956044
STAT,1872,48,35-39,1920,0.16019385455382532
SIM,1977,30,na,2007,6045
SIM,1880,48,35-39,1928,1
STAT,1887,87,na,1974,620.0498954629226
SIM,1830,25,na,1855,2078
STAT,1945,38,25-29,1983,1.2775065987174474
SIM,1837,28,25-29,1865,10
STAT,1807,102,na,1909,0.14336374546076772
SIM,1929,39,35-39,1968,2
STAT,1896,48,20-24,1944,0.010188247346026082
STAT,1891,43,15-19,1934,0.0195549227618533
STAT,1907,33,35-39,1940,9.83199085192619
STAT,1850,47,45-49,1897,0.24181662347527183
STAT,1892,18,na,1910,3643.55224771522
SIM,1906,35,35-39,1941,4
STAT,1898,4,na,1902,4103.031919769873
STAT,1897,65,na,1962,2804.233834173433
SIM,1955,17,40-44,1972,4
STAT,1885,45,40-44,1930,0.19903460765373165
STAT,1893,99,na,1992,41.66451652217828
SIM,1919,17,30-34,1936,18
STAT,1897,39,50-100,1936,0.40481092377782785
SIM,1944,28,20-24,1972,28
STAT,1899,20,50-100,1919,0.6485922768254931
STAT,1874,26,50-100,1900,0.7583563839280476
SIM,1834,92,na,1926,38
SIM,1887,35,15-19,1922,2
SIM,1957,12,na,1969,6325
STAT,1854,41,45-49,1895,1.2248253190464198
STAT,1900,86,na,1986,1001.6872428989908
SIM,1977,30,45-49,2007,6
STAT,1936,28,20-24,1964,20.162744530226824
STAT,1784,80,na,1864,261.2288713287385
STAT,1954,36,25-29,1990,1.4485125180797065
SIM,1884,42,35-39,1926,3
STAT,1818,41,35-39,1859,2.488013240199236
SIM,1888,20,45-49,1908,1
SIM,1916,45,45-49,1961,1
STAT,1909,40,45-49,1949,0.1818877164519481
STAT,1929,17,50-100,1946,0.5518197543399624
STAT,1929,28,na,1957,5408.300844245226
SIM,1867,7,na,1874,2822
STAT,1827,76,na,1903,769.4058264809902
SIM,1905,62,na,1967,3509
STAT,1856,52,20-24,1908,6.462419013951861E-4
SIM,1873,73,na,1946,1425
SIM,1841,30,20-24,1871,6
SIM,1941,23,35-39,1964,29
SIM,1920,37,50-100,1957,1
SIM,1884,5,na,1889,3056
STAT,1946,46,na,1992,4903.368777334525
STAT,1882,7,na,1889,2953.4914911732344
STAT,1918,36,15-19,1954,0.02346620532974243
STAT,1879,35,15-19,1914,0.0683099517552842
STAT,1854,17,na,1871,2237.073706402968
STAT,1919,48,25-29,1967,0.06619788102725571
SIM,1855,60,na,1915,1452
STAT,1868,18,35-39,1886,0.6157580581663491
STAT,1840,36,20-24,1876,0.7390217912420162
STAT,1819,40,25-29,1859,1.4414822479192515
STAT,1900,24,35-39,1924,9.286179741158039
STAT,1826,37,50-100,1863,0.9837799866048568
STAT,1922,22,20-24,1944,147.09402671238726
STAT,1861,47,20-24,1908,0.011459213447187762
SIM,1826,41,35-39,1867,8
SIM,1880,26,15-19,1906,2
STAT,1908,45,45-49,1953,0.230461001607643
SIM,1900,15,na,1915,3842
STAT,1959,17,45-49,1976,0.7540953842165877
STAT,1891,31,20-24,1922,3.871177518981128
SIM,1827,40,25-29,1867,1
STAT,1847,90,na,1937,60.6642174135303
SIM,1786,81,na,1867,43
SIM,1970,42,40-44,2012,2
STAT,1908,42,40-44,1950,0.26740170406871416
SIM,1978,28,20-24,2006,50
STAT,1811,61,na,1872,1181.612593219645
STAT,1913,46,40-44,1959,0.17812698416928066
STAT,1932,44,25-29,1976,0.11134735026497576
STAT,1860,41,30-34,1901,1.0741547745132187
STAT,1875,26,40-44,1901,3.584755645546305
STAT,1903,29,20-24,1932,19.146066614619574
SIM,1829,39,30-34,1868,13
SIM,1889,98,na,1987,308
SIM,1932,25,35-39,1957,7
STAT,1976,22,na,1998,5648.9523678586975
SIM,1993,18,45-49,2011,1
SIM,1971,11,na,1982,5818
STAT,1893,31,30-34,1924,25.572895137216364
STAT,1843,43,35-39,1886,1.846926568236546
STAT,1872,73,na,1945,1376.3704012126534
STAT,1910,64,na,1974,3506.721546540602
SIM,1929,16,50-100,1945,1
STAT,1951,18,45-49,1969,0.686268562375102
STAT,1852,59,na,1911,1832.3241047203933
STAT,1882,45,15-19,1927,4.553807568829022E-4
STAT,1839,54,25-29,1893,0.00273174710479781
STAT,1874,47,30-34,1921,0.11383092138272888
SIM,1962,36,25-29,1998,3
STAT,1879,52,na,1931,2580.7952920916678
STAT,1814,46,20-24,1860,0.033914227793969715
STAT,1824,54,40-44,1878,0.013271141619921918
SIM,1908,8,na,1916,4383
STAT,1924,25,35-39,1949,20.30496740275712
STAT,1911,49,25-29,1960,0.05766353945183982
SIM,1878,22,40-44,1900,7
SIM,1920,5,na,1925,4726
STAT,1858,39,50-100,1897,1.094195069420479
SIM,1900,29,45-49,1929,1
SIM,1855,17,na,1872,2139
SIM,1903,19,20-24,1922,44
STAT,1848,70,na,1918,1490.8052174910779
STAT,1878,47,15-19,1925,4.797347941279514E-4
STAT,1961,18,50-100,1979,0.5584331499547455
SIM,1876,22,30-34,1898,1
STAT,1932,35,35-39,1967,3.757874842840469
STAT,1855,18,25-29,1873,5.701263567501515
STAT,1851,18,40-44,1869,0.1753048608759859
STAT,1871,42,45-49,1913,1.716216498901968
SIM,1839,44,25-29,1883,1
SIM,1921,24,20-24,1945,164
STAT,1834,56,na,1890,1861.37121021603
STAT,1811,49,20-24,1860,0.036167588764079564
STAT,1947,47,na,1994,4967.527797204574
SIM,1980,34,na,2014,5778
SIM,1940,35,35-39,1975,6
SIM,1863,18,25-29,1881,13
STAT,1809,100,na,1909,0.49343110022921405
STAT,1923,46,25-29,1969,0.07176465237611225
STAT,1848,16,50-100,1864,0.0649124991483646
SIM,1841,62,na,1903,1411
STAT,1897,55,na,1952,3190.758733394176
SIM,1975,30,25-29,2005,18
SIM,1928,36,25-29,1964,3
STAT,1864,41,15-19,1905,0.014294610982369308
STAT,1878,42,45-49,1920,1.8011646410460962
STAT,1899,33,50-100,1932,1.442535456386976
STAT,1817,53,35-39,1870,0.023185239004126963
SIM,1916,93,na,2009,100
STAT,1868,22,30-34,1890,19.749682867280992
STAT,1885,48,45-49,1933,0.2682483457776961
STAT,1918,34,50-100,1952,1.0050299592249847
STAT,1974,36,25-29,2010,1.53000276872824
STAT,1816,41,25-29,1857,1.5100225149995852
STAT,1914,20,na,1934,4345.443882242904
SIM,1818,44,na,1862,2128
STAT,1922,71,na,1993,3714.001534782905
STAT,1928,46,25-29,1974,0.07830182464722305
STAT,1835,39,50-100,1874,0.9279018543412586
STAT,1861,44,40-44,1905,2.128842924903043
STAT,1932,48,na,1980,5736.682034532341
STAT,1968,15,45-49,1983,0.7204270224112974
SIM,1883,26,40-44,1909,6
SIM,1817,43,35-39,1860,5
SIM,1904,46,50-100,1950,1
SIM,1934,59,na,1993,5238
STAT,1905,44,50-100,1949,0.12088445791229648
SIM,1893,34,na,1927,3327
SIM,1926,34,50-100,1960,2
STAT,1913,24,20-24,1937,128.8385007396792
SIM,1856,61,na,1917,1641
SIM,1886,42,45-49,1928,1
SIM,1911,29,20-24,1940,39
STAT,1931,21,50-100,1952,0.9880604699590309
STAT,1979,18,15-19,1997,72.09018417291755
STAT,1860,72,na,1932,1174.6294787112888
STAT,1859,38,na,1897,2155.11824289712
STAT,1965,34,35-39,1999,13.40331531085551
STAT,1936,19,30-34,1955,13.402903049788089
SIM,1835,56,na,1891,1851
SIM,1866,15,25-29,1881,14
STAT,1897,81,na,1978,1525.5329380464857
STAT,1861,23,35-39,1884,5.710364542347105
SIM,1915,30,30-34,1945,22
STAT,1910,43,35-39,1953,0.21853230910943666
STAT,1812,50,40-44,1862,0.024274824776099775
STAT,1925,28,45-49,1953,2.3457992522244084
STAT,1832,51,20-24,1883,5.43532734878045E-4
SIM,1933,28,45-49,1961,5
STAT,1877,67,na,1944,1902.9666991314377
STAT,1941,72,na,2013,3364.646168813429
STAT,1850,44,40-44,1894,2.2842530941714285
STAT,1902,13,na,1915,4204.584499676204
SIM,1984,24,40-44,2008,5
STAT,1965,41,50-100,2006,0.17615479878006782
SIM,1944,19,30-34,1963,28
SIM,1803,94,na,1897,11
STAT,1843,30,15-19,1873,0.17538493263716107
SIM,1943,26,na,1969,5182
STAT,1900,112,na,2012,0.0077113488968698915
SIM,1891,24,25-29,1915,90
STAT,1891,34,25-29,1925,14.484134509775506
STAT,1842,31,25-29,1873,9.620966371157667
SIM,1923,48,40-44,1971,1
STAT,1867,41,30-34,1908,1.2443592867311941
SIM,1831,46,50-100,1877,1
SIM,1901,32,na,1933,3986
SIM,1867,18,na,1885,2602
STAT,1947,4,na,1951,5170.183931486278
STAT,1960,29,na,1989,5649.49558570639
STAT,1960,40,40-44,2000,0.3917917903916892
STAT,1939,22,na,1961,4234.141502513377
STAT,1901,66,na,1967,2977.2449453976687
STAT,1907,30,30-34,1937,17.15965693191511
STAT,1971,39,25-29,2010,1.4795404678789974
STAT,1980,22,40-44,2002,5.404580529128579
STAT,1915,48,40-44,1963,0.1828671786635491
SIM,1850,31,25-29,1881,11
SIM,1875,41,30-34,1916,5
STAT,1971,28,25-29,1999,96.57661055188943
SIM,1948,55,na,2003,4204
STAT,1959,10,na,1969,5931.440746588026
SIM,1888,87,na,1975,143
SIM,1811,46,45-49,1857,1
STAT,1821,51,35-39,1872,0.015313350314008689
STAT,1835,33,35-39,1868,7.967634053693571
STAT,1915,93,na,2008,380.0472577496144
SIM,1939,24,30-34,1963,1
STAT,1883,24,25-29,1907,64.23094852849427
STAT,1969,18,30-34,1987,17.56609969915433
SIM,1874,90,na,1964,107
STAT,1934,32,40-44,1966,6.16914903465185
SIM,1942,32,40-44,1974,7
STAT,1985,18,45-49,2003,0.8196788387599678
SIM,1978,17,20-24,1995,404
SIM,1820,57,na,1877,1635
STAT,1941,38,40-44,1979,1.8318790270634406
STAT,1931,32,na,1963,5720.40046620619
SIM,1851,43,35-39,1894,6
SIM,1900,21,na,1921,3790
STAT,1897,40,15-19,1937,0.0014947710530910144
SIM,1817,53,na,1870,1324
SIM,2006,3,na,2009,7592
STAT,1944,5,na,1949,4944.101880934529
STAT,1938,11,na,1949,4519.597613269368
STAT,1899,42,15-19,1941,0.0015143527936063866
STAT,1910,46,15-19,1956,3.9803223233581415E-4
STAT,1892,34,na,1926,3422.0906629425103
STAT,1888,3,na,1891,3586.2970241562243
STAT,1962,42,40-44,2004,0.38436491447653426
STAT,1890,31,15-19,1921,0.20163258221124894
STAT,1976,24,40-44,2000,5.197682210114653
SIM,1796,58,na,1854,859
STAT,1950,15,35-39,1965,5.72886209253987
SIM,1843,33,35-39,1876,25
STAT,1872,45,30-34,1917,0.1132903609441915
STAT,1926,1,na,1927,5907.60210757904
STAT,1940,17,30-34,1957,14.286795653928674
SIM,1858,47,50-100,1905,2
STAT,1876,51,25-29,1927,0.004245764108837417
STAT,1972,40,45-49,2012,0.25627567893365566
STAT,1857,51,50-100,1908,0.01363946139513569
STAT,1948,38,40-44,1986,2.0347706435939443
STAT,1911,22,45-49,1933,1.2325446660040646
STAT,1956,40,30-34,1996,0.20345297072470794
STAT,1942,17,50-100,1959,0.45192026175757827
STAT,1882,51,na,1933,2438.6955903897265
STAT,1812,77,na,1889,377.1354750198017
STAT,1973,34,na,2007,5746.544854508726
STAT,1833,45,na,1878,1731.055036614487
STAT,1898,43,25-29,1941,0.06904794346675269
SIM,1850,23,na,1873,1870
STAT,1858,15,25-29,1873,6.0302630291095465
SIM,1833,28,40-44,1861,4
SIM,1956,38,40-44,1994,5
SIM,1879,29,50-100,1908,1
SIM,1833,35,40-44,1868,3
SIM,1823,41,50-100,1864,2
SIM,1921,48,30-34,1969,1
SIM,1932,22,30-34,1954,51
STAT,1933,20,30-34,1953,44.278812395811165
STAT,1894,22,35-39,1916,8.657163453880294
STAT,1912,43,45-49,1955,0.18430807891155415
STAT,1946,54,na,2000,4763.569639695356
SIM,1817,40,30-34,1857,3
STAT,1890,17,50-100,1907,0.06908443781386446
SIM,1882,7,na,1889,3608
STAT,1926,58,na,1984,4961.548004312928
STAT,1840,40,15-19,1880,0.013028772500293762
SIM,1927,15,15-19,1942,125
SIM,1929,17,25-29,1946,136
STAT,1913,48,30-34,1961,0.1001875842120846
SIM,1917,33,45-49,1950,1
STAT,1985,5,na,1990,6453.618473742463
STAT,1802,94,na,1896,9.540507124637166
SIM,1845,39,na,1884,2088
SIM,1967,35,45-49,2002,1
STAT,1896,18,50-100,1914,0.07448198433919097
STAT,2000,15,20-24,2015,232.8050382202421
STAT,1910,48,na,1958,3948.7578740905888
SIM,1915,29,na,1944,4437
STAT,1828,87,na,1915,116.931083463068
SIM,1960,32,na,1992,6168
STAT,1943,38,15-19,1981,0.02418943262833254
SIM,1900,30,50-100,1930,3
STAT,1976,37,50-100,2013,0.666912543386714
SIM,1883,66,na,1949,1599
SIM,1921,20,na,1941,5507
STAT,1825,35,40-44,1860,7.663242294300896
STAT,1834,21,25-29,1855,70.37375583176208
SIM,1923,43,50-100,1966,1
SIM,1889,25,20-24,1914,4
SIM,1928,33,20-24,1961,5
STAT,1941,25,na,1966,4477.26000428207
STAT,1942,17,40-44,1959,1.6871693875056912
STAT,1983,31,30-34,2014,26.233259450464576
SIM,1977,30,35-39,2007,36
STAT,1916,27,40-44,1943,5.562329496643402
SIM,1842,21,25-29,1863,3
SIM,1906,53,na,1959,3353
STAT,1833,61,na,1894,1314.909706395378
SIM,1898,23,20-24,1921,189
STAT,1844,24,na,1868,2200.957602207015
SIM,1982,24,30-34,2006,114
SIM,1843,30,30-34,1873,38
SIM,1894,19,na,1913,3947
STAT,1922,34,15-19,1956,0.1666696760920952
STAT,1953,32,na,1985,5381.984317333714
SIM,1874,4,na,1878,3161
SIM,1991,13,na,2004,6708
SIM,1895,73,na,1968,1886
STAT,1956,33,30-34,1989,24.509002226052615
SIM,1858,30,25-29,1888,26
STAT,1824,94,na,1918,12.36640956996035
SIM,1835,72,na,1907,1130
STAT,1872,47,20-24,1919,0.013840798259025436
STAT,1938,28,30-34,1966,44.79870265067833
STAT,1896,15,45-49,1911,0.10003280394753782
STAT,1968,42,45-49,2010,0.24930633547795714
STAT,1831,33,15-19,1864,0.14352035394195656
SIM,1887,22,na,1909,3601
STAT,1902,21,40-44,1923,3.4081756743415266
STAT,1901,39,15-19,1940,0.0193953385438984
SIM,1914,9,na,1923,4366
STAT,1870,30,25-29,1900,11.746929236215234
STAT,1880,43,15-19,1923,0.016770723572857932
SIM,1828,41,45-49,1869,3
STAT,1868,25,35-39,1893,10.771001066235737
SIM,1947,54,na,2001,5681
SIM,1899,66,na,1965,3118
STAT,1820,110,na,1930,1.621827372017745E-4
STAT,1941,20,50-100,1961,0.78547370873175
STAT,1851,106,na,1957,0.014957290504229106
SIM,1946,28,30-34,1974,97
STAT,1853,40,25-29,1893,0.6457949464191938
STAT,1896,70,na,1966,2469.262142604777
STAT,1917,48,15-19,1965,4.4281434818246743E-4
STAT,1920,25,15-19,1945,0.8993866615642406
STAT,1817,40,15-19,1857,0.044902297477997684
STAT,1985,25,45-49,2010,2.8504185043080623
STAT,1924,22,30-34,1946,39.12791353048795
STAT,1873,19,30-34,1892,1.8682857122047853
SIM,1851,24,na,1875,2578
STAT,1867,53,25-29,1920,0.0037552002528020547
SIM,1901,16,na,1917,4353
STAT,1843,40,40-44,1883,2.384024615142664
STAT,1810,50,30-34,1860,0.022701267636759725
STAT,1919,15,15-19,1934,11.66322519459049
STAT,1909,33,45-49,1942,1.7275555234804492
STAT,1960,22,40-44,1982,5.070585862219944
STAT,1979,18,25-29,1997,68.83680213209644
STAT,1833,42,15-19,1875,0.011859247494093617
SIM,1979,18,40-44,1997,3
STAT,1813,57,na,1870,1183.966016054669
SIM,1897,34,50-100,1931,3
STAT,1808,72,na,1880,775.3468620894255
STAT,1888,30,45-49,1918,2.3846401185711064
STAT,1822,35,15-19,1857,0.1482281960275522
SIM,1965,17,35-39,1982,7
STAT,1921,37,25-29,1958,1.2682834283031812
STAT,1949,29,45-49,1978,2.3264664817235796
STAT,1832,29,50-100,1861,0.5902391500803965
STAT,1882,56,na,1938,2299.1060581706515
STAT,1915,15,30-34,1930,2.9582406645697477
STAT,1850,46,30-34,1896,0.09993330269069904
STAT,1876,20,50-100,1896,0.4893879832103883
STAT,1930,42,25-29,1972,0.10844437652729647
STAT,1866,32,25-29,1898,10.956123289281015
SIM,1933,58,na,1991,6109
STAT,1964,18,30-34,1982,17.710988987914
STAT,1887,45,15-19,1932,5.224863158250227E-4
STAT,1900,30,20-24,1930,4.363351995437724
STAT,1893,31,40-44,1924,6.351900992819337
STAT,1857,24,20-24,1881,64.13881376333295
STAT,1846,31,45-49,1877,2.1526163709176944
SIM,1983,3,na,1986,7032
STAT,1877,41,25-29,1918,0.7743621740962433
STAT,1876,66,na,1942,1955.304444113731
SIM,1910,21,40-44,1931,4
STAT,1957,17,35-39,1974,6.3847157381499935
STAT,1847,29,30-34,1876,22.95611601692741
SIM,1896,30,45-49,1926,1
STAT,1935,23,45-49,1958,1.768608192237044
STAT,1845,89,na,1934,70.79083121521076
STAT,1861,20,30-34,1881,17.811286183677566
SIM,1964,33,30-34,1997,53
STAT,1921,44,25-29,1965,0.09247683900104266
STAT,1995,20,35-39,2015,15.792496913452144
STAT,1996,18,20-24,2014,227.31087467454017
SIM,1885,41,25-29,1926,2
SIM,1887,19,25-29,1906,13
STAT,1821,51,45-49,1872,0.025813933350484822
STAT,1835,30,30-34,1865,14.175596731518924
STAT,1898,21,15-19,1919,5.160957356030121
STAT,1817,50,40-44,1867,0.030096469903265022
STAT,1845,52,35-39,1897,0.005770373715316506
STAT,1957,25,50-100,1982,1.5223612850394923
SIM,1882,26,50-100,1908,1
SIM,1924,27,40-44,1951,10
STAT,1867,89,na,1956,127.12224063955763
SIM,1984,17,40-44,2001,4
SIM,1855,29,30-34,1884,4
SIM,1939,27,35-39,1966,5
SIM,1943,23,45-49,1966,1
SIM,1854,7,na,1861,3339
STAT,1867,41,40-44,1908,2.4345347637993826
STAT,1900,48,20-24,1948,0.010703376209415054
STAT,1883,21,20-24,1904,78.04347612358107
SIM,1886,20,35-39,1906,10
SIM,1933,48,na,1981,6334
STAT,1912,37,50-100,1949,0.4733635592162646
STAT,1960,34,35-39,1994,13.983055973479827
STAT,1908,29,na,1937,4062.8287578943928
SIM,1954,16,20-24,1970,377
STAT,1975,19,45-49,1994,0.7600263599845655
SIM,1857,29,40-44,1886,8
STAT,1911,31,35-39,1942,10.320187921274217
STAT,1843,52,25-29,1895,0.003535068607551601
SIM,1902,97,na,1999,38
STAT,1868,32,35-39,1900,11.228562930991588
STAT,1826,91,na,1917,31.906389683822614
SIM,1938,43,30-34,1981,1
STAT,1907,44,na,1951,3884.8244815868566
SIM,1968,31,50-100,1999,2
SIM,1889,0,na,1889,4652
STAT,1877,19,15-19,1896,7.085896255848327
STAT,1849,29,40-44,1878,2.712855982594271
STAT,1870,51,50-100,1921,0.017264976399423097
STAT,1841,50,25-29,1891,0.0031944236593646202
SIM,1894,29,na,1923,3631
STAT,1842,15,50-100,1857,0.048987755929982606
SIM,1915,45,na,1960,4532
STAT,1876,20,25-29,1896,68.70027790673363
SIM,1876,32,35-39,1908,1
STAT,1946,16,20-24,1962,173.58326170228503
STAT,1857,52,na,1909,1924.9875691902512
STAT,1993,20,25-29,2013,153.98240208858363
SIM,1875,41,40-44,1916,11
STAT,1851,25,40-44,1876,2.82171579323792
STAT,1870,54,45-49,1924,0.0160570794395971
STAT,1893,43,25-29,1936,0.06457830716393796
SIM,1839,34,20-24,1873,4
STAT,1880,36,15-19,1916,0.06902118710704329
STAT,1928,43,na,1971,5455.186053951403
STAT,1962,45,45-49,2007,0.33585105270290966
SIM,1854,31,45-49,1885,2
SIM,1915,92,na,2007,589
STAT,1931,47,na,1978,5670.190492929931
STAT,1936,41,40-44,1977,0.2864340662597847
SIM,1888,27,50-100,1915,1
STAT,1844,46,50-100,1890,0.20600863627577118
SIM,1891,21,20-24,1912,1
STAT,1963,10,na,1973,5760.85353106703
STAT,1827,50,25-29,1877,0.004504820056593344
STAT,1911,27,15-19,1938,0.7951880581134462
STAT,1809,57,na,1866,1234.586449283765
SIM,1908,19,20-24,1927,56
SIM,1970,18,20-24,1988,377
STAT,1947,29,35-39,1976,19.581947789134922
SIM,1962,34,50-100,1996,3
SIM,1970,10,na,1980,6043
STAT,1879,30,45-49,1909,2.118229524108054
STAT,1912,37,25-29,1949,1.1100916772011256
STAT,1816,38,50-100,1854,4.479689931115076
STAT,1962,18,20-24,1980,200.408356194701
STAT,1973,39,35-39,2012,3.7113657335907924
SIM,1926,51,na,1977,5662
SIM,1864,15,15-19,1879,7
SIM,1944,41,40-44,1985,1
STAT,1859,48,na,1907,2042.3010996205344
SIM,1848,20,na,1868,1999
STAT,1791,100,na,1891,0.2272620418163907
STAT,1812,62,na,1874,986.7141492292272
SIM,1971,30,40-44,2001,14
STAT,1851,90,na,1941,62.52016196257057
SIM,1950,58,na,2008,4313
STAT,1878,51,35-39,1929,0.010423167147826857
STAT,1833,30,20-24,1863,2.5253128239195366
STAT,1933,23,35-39,1956,14.415379337535155
STAT,1893,40,20-24,1933,0.2340010822844676
STAT,1980,20,na,2000,5873.872652317963
SIM,1917,30,40-44,1947,6
SIM,1894,43,50-100,1937,1
STAT,1818,50,25-29,1868,0.0043780630592705864
SIM,1890,1,na,1891,3884
SIM,1920,37,25-29,1957,2
STAT,1889,14,na,1903,3661.904635855381
SIM,1930,6,na,1936,6419
STAT,1875,41,15-19,1916,0.016544060268875584
STAT,1948,16,30-34,1964,16.101914896525397
SIM,1871,43,50-100,1914,3
SIM,1956,16,30-34,1972,25
STAT,1838,49,na,1887,1954.2310154802637
STAT,1863,43,50-100,1906,1.0583752372474358
SIM,1806,80,na,1886,284
STAT,1777,94,na,1871,3.082731508043123
STAT,1943,40,45-49,1983,0.2122730994539971
STAT,1868,15,na,1883,2884.8962727418375
STAT,1971,25,20-24,1996,26.819777828927165
STAT,1799,78,na,1877,426.3981339962634
STAT,1932,33,na,1965,5800.016603592411
SIM,1884,20,25-29,1904,69
STAT,1881,24,15-19,1905,3.6492507954130136
SIM,1874,74,na,1948,1111
SIM,1889,88,na,1977,892
STAT,1865,51,25-29,1916,0.003705788783555051
SIM,1943,20,40-44,1963,4
STAT,1891,33,na,1924,3389.2754785016855
STAT,1973,19,35-39,1992,6.258739900948515
SIM,1926,21,50-100,1947,2
STAT,1914,30,na,1944,4430.9121821730205
STAT,1918,21,50-100,1939,0.8212848150969754
STAT,1886,43,50-100,1929,1.2767406614392336
STAT,1909,30,40-44,1939,4.349150258800185
SIM,1820,73,na,1893,1118
STAT,1856,15,15-19,1871,6.251733756554578
SIM,1880,38,30-34,1918,20
STAT,1934,4,na,1938,6303.469478882268
STAT,1979,15,20-24,1994,215.5411766247231
SIM,1856,71,na,1927,1294
STAT,1976,22,50-100,1998,1.0178510403757495
SIM,1898,26,25-29,1924,67
STAT,1902,24,45-49,1926,1.1299538217833893
STAT,1831,109,na,1940,5.581879073682391E-4
STAT,1875,113,na,1988,0.0011352967597978525
SIM,1922,15,na,1937,5424
STAT,1871,19,na,1890,2884.164408050678
SIM,1785,80,na,1865,346
SIM,1874,89,na,1963,164
STAT,1889,42,20-24,1931,0.22564439104126613
STAT,1867,50,20-24,1917,8.065255149220904E-4
SIM,1937,14,na,1951,4466
STAT,1844,31,35-39,1875,10.235039412915263
STAT,1844,40,25-29,1884,0.5643725025411692
SIM,1891,17,25-29,1908,18
STAT,1914,92,na,2006,466.8962778513801
SIM,1872,23,na,1895,2967
STAT,1956,36,35-39,1992,3.808795590615315
STAT,1916,0,na,1916,5498.634766293954
SIM,1957,5,na,1962,6328
SIM,1851,40,40-44,1891,5
STAT,1879,19,25-29,1898,6.791894842555404
SIM,1836,57,na,1893,1234
SIM,1852,40,25-29,1892,2
STAT,1918,7,na,1925,5020.018106512444
SIM,1919,11,na,1930,5656
STAT,1853,16,na,1869,2765.459100239166
STAT,1954,34,50-100,1988,1.2008015548013224
SIM,1800,59,na,1859,1322
SIM,1892,8,na,1900,4138
STAT,1878,2,na,1880,3903.8216915982057
SIM,1849,32,50-100,1881,3
SIM,1957,26,40-44,1983,1
STAT,1861,47,45-49,1908,0.22536452257537867
STAT,1934,44,35-39,1978,0.322567432572001
SIM,1930,25,25-29,1955,168
SIM,1980,27,25-29,2007,3
STAT,1857,27,25-29,1884,39.16219002160139
SIM,1870,38,na,1908,2988
STAT,1919,51,na,1970,4538.912528287445
STAT,1970,25,50-100,1995,1.4453851657902064
SIM,1891,37,na,1928,3361
STAT,1892,22,25-29,1914,82.80201835837383
SIM,1978,31,na,2009,5902
STAT,1883,17,25-29,1900,6.398259375454372
STAT,1954,40,20-24,1994,0.02625667063487155
STAT,2002,3,na,2005,6843.044954216655
STAT,1960,25,45-49,1985,2.6102287190074027
SIM,1880,21,45-49,1901,1
STAT,1846,48,30-34,1894,0.09881272284769581
SIM,1891,39,45-49,1930,8
SIM,1939,31,30-34,1970,8
STAT,1857,23,50-100,1880,0.42009552547881845
SIM,1890,52,na,1942,3052
STAT,1942,73,na,2015,3301.7890866971934
SIM,1821,47,50-100,1868,1
SIM,1907,16,35-39,1923,1
SIM,1839,46,50-100,1885,1
STAT,1868,49,20-24,1917,0.013027409332293842
SIM,1924,66,na,1990,4236
STAT,1904,52,na,1956,3570.5981779366625
STAT,1970,40,35-39,2010,0.30315295867252445
STAT,1890,92,na,1982,303.4128164845402
STAT,1887,29,na,1916,3064.4853100147925
STAT,1931,34,50-100,1965,1.248922400697973
STAT,1915,18,35-39,1933,1.0110450036457654
STAT,1945,35,20-24,1980,0.34296634771795226
STAT,1935,20,40-44,1955,5.290533428778487
SIM,1841,33,25-29,1874,2
STAT,1957,5,na,1962,5982.500824237006
SIM,1826,32,50-100,1858,1
STAT,1948,18,50-100,1966,0.49463889094053354
STAT,1795,97,na,1892,0.9413702880994348
STAT,1871,42,35-39,1913,2.0764834001822394
STAT,1899,30,20-24,1929,4.308079080313024
STAT,1870,21,35-39,1891,6.659211045363882
STAT,1946,19,25-29,1965,55.431271350924504
SIM,1845,49,na,1894,1949
SIM,1900,31,na,1931,3642
STAT,1971,43,20-24,2014,0.02678394981446917
STAT,1921,46,15-19,1967,4.8025468072061903E-4
SIM,1820,37,20-24,1857,2
STAT,1923,43,20-24,1966,0.023774679767965518
STAT,1802,84,na,1886,152.76517260517002
SIM,1954,19,25-29,1973,5
STAT,1921,41,20-24,1962,0.02298005762176613
STAT,1843,38,na,1881,2485.3793324783073
STAT,1944,48,50-100,1992,0.2913787409806913
STAT,1960,39,na,1999,5813.519896116428
SIM,1906,32,30-34,1938,28
STAT,1882,41,na,1923,2617.0523315097316
STAT,1982,22,15-19,2004,8.673007838333795
STAT,1870,51,40-44,1921,0.012034869551058076
SIM,1804,95,na,1899,24
SIM,1915,30,na,1945,4694
STAT,1813,47,50-100,1860,0.814678764929213
STAT,1822,54,30-34,1876,0.01040564572282798
STAT,1913,49,35-39,1962,0.14445165957746295
STAT,1975,16,40-44,1991,2.1300972797566606
STAT,1915,15,na,1930,4687.555045720967
STAT,1822,39,na,1861,2316.785775212477
STAT,1976,24,50-100,2000,1.0171590192300892
STAT,1919,45,20-24,1964,0.01389476262877103
SIM,1990,22,15-19,2012,8
STAT,1932,18,50-100,1950,0.571162196710624
SIM,1839,37,25-29,1876,2
SIM,1884,52,na,1936,2476
SIM,1878,25,45-49,1903,3
SIM,1984,24,50-100,2008,2
STAT,1922,25,25-29,1947,86.49841225855133
SIM,1875,15,na,1890,3400
STAT,1921,70,na,1991,3744.849407013662
STAT,1873,74,na,1947,1307.8745723486502
SIM,1838,42,na,1880,1623
STAT,1900,33,25-29,1933,16.332835785491707
STAT,1819,35,na,1854,1971.631573393505
STAT,1935,47,20-24,1982,0.01801466134014002
SIM,1958,47,50-100,2005,1
SIM,1912,17,20-24,1929,74
SIM,1815,43,25-29,1858,1
STAT,1858,37,na,1895,2121.0532578746834
STAT,1892,43,40-44,1935,3.229927759992501
STAT,1904,17,20-24,1921,29.38006254227252
STAT,1900,71,na,1971,2607.7819714246893
STAT,1981,31,20-24,2012,4.01450165197186
STAT,1813,49,30-34,1862,0.310992669683396
STAT,1837,38,na,1875,1868.7788205841432
SIM,1807,91,na,1898,21
STAT,1966,42,35-39,2008,0.30164299098401604
SIM,1820,47,na,1867,1896
STAT,1852,75,na,1927,970.5906740937636
SIM,1817,43,na,1860,1504
SIM,1887,30,45-49,1917,3
STAT,1954,45,15-19,1999,5.492157792027356E-4
STAT,1868,41,25-29,1909,0.7152245738475754
SIM,1825,57,na,1882,1473
STAT,1965,31,20-24,1996,3.5842348849269943
STAT,1962,15,50-100,1977,0.5542891298590498
SIM,1830,35,25-29,1865,2
SIM,1930,20,45-49,1950,1
STAT,1984,29,50-100,2013,1.6368708378733288
SIM,1881,42,50-100,1923,1
SIM,1925,85,na,2010,1756
SIM,1997,6,na,2003,6607
SIM,1853,42,40-44,1895,5
SIM,1827,34,40-44,1861,8
STAT,1896,29,15-19,1925,0.6866296773576328
STAT,1985,22,50-100,2007,1.0835958614504224
SIM,1806,74,na,1880,669
SIM,1802,60,na,1862,1082
STAT,1840,89,na,1929,84.27409528139687
STAT,1964,36,na,2000,5638.964138710663
STAT,1871,100,na,1971,9.877590082638125
STAT,1848,69,na,1917,1559.3055084785406
SIM,1915,30,20-24,1945,4
STAT,1849,24,25-29,1873,52.87620228299279
STAT,1950,46,na,1996,5227.295570784251
SIM,1810,51,50-100,1861,2
STAT,1845,48,25-29,1893,0.03832634254572221
STAT,1897,50,na,1947,3370.465783334569
SIM,1938,36,30-34,1974,1
STAT,1882,17,20-24,1899,19.983866537226305
STAT,1961,37,20-24,1998,0.4049301085431484
STAT,1826,37,35-39,1863,5.667472694309536
SIM,1915,61,na,1976,3959
STAT,1777,104,na,1881,0.02502454224283339
STAT,1923,31,15-19,1954,0.17064357418299805
SIM,1812,45,50-100,1857,1
STAT,1939,34,30-34,1973,18.5353193298218
SIM,1855,8,na,1863,2260
SIM,1919,75,na,1994,3315
STAT,1873,19,20-24,1892,20.780850047248112
SIM,1910,14,na,1924,4001
SIM,1919,23,15-19,1942,2
STAT,1871,35,20-24,1906,0.8934371862726331
STAT,1991,23,30-34,2014,47.67598884725891
SIM,1877,70,na,1947,1803
STAT,1897,86,na,1983,942.6529452023776
SIM,1853,43,50-100,1896,2
SIM,1947,34,30-34,1981,6
SIM,1834,37,35-39,1871,11
STAT,1835,35,35-39,1870,5.573645711751515
STAT,1845,42,40-44,1887,1.5434506960113568
SIM,1874,58,na,1932,2132
STAT,1880,33,20-24,1913,3.2925395221907636
SIM,1870,44,na,1914,2996
SIM,1866,22,25-29,1888,132
STAT,1864,35,30-34,1899,5.543975002381652
STAT,1887,56,na,1943,2637.9056116626066
STAT,1944,35,50-100,1979,0.5381568550422895
STAT,1879,21,na,1900,2858.532405324315
SIM,1905,67,na,1972,3124
STAT,1898,17,30-34,1915,2.485926815945919
STAT,1817,53,45-49,1870,0.03908368855247062
STAT,1861,32,25-29,1893,9.8268285788811
STAT,1932,17,na,1949,5626.052275164736
SIM,1972,29,30-34,2001,2
STAT,1894,31,25-29,1925,15.25740269594434
STAT,1847,29,20-24,1876,10.694528994727847
STAT,1883,42,na,1925,2606.39013616225
STAT,1871,17,45-49,1888,0.0754828580127572
SIM,1976,29,15-19,2005,2
STAT,1861,25,35-39,1886,9.459863525204083
STAT,1819,52,40-44,1871,0.019496374547725338
SIM,1839,33,50-100,1872,2
STAT,1858,22,25-29,1880,59.131924054951796
SIM,1889,25,30-34,1914,8
SIM,1936,33,50-100,1969,1
SIM,1967,11,na,1978,5779
STAT,1933,16,35-39,1949,6.5012492143445275
STAT,1922,20,45-49,1942,1.4973168753702486
SIM,1938,58,na,1996,3900
STAT,1824,63,na,1887,1134.1689925884857
SIM,1855,29,20-24,1884,1
STAT,1939,41,20-24,1980,0.021240520800020042
SIM,1888,28,20-24,1916,33
STAT,1798,93,na,1891,7.433765548367152
STAT,1829,47,30-34,1876,0.09876479972294844
SIM,1846,19,na,1865,1953
SIM,1892,87,na,1979,867
STAT,1843,50,35-39,1893,0.008762300201394515
STAT,1982,18,40-44,2000,2.2706792423066555
SIM,1907,24,50-100,1931,2
STAT,1866,98,na,1964,12.045551985860785
STAT,1859,43,25-29,1902,0.5860735171061114
SIM,1941,16,35-39,1957,6
STAT,1949,26,40-44,1975,6.285782675906129
STAT,1866,94,na,1960,40.612872545385564
STAT,1969,24,15-19,1993,7.694176493943072
STAT,1780,83,na,1863,183.39462282520756
SIM,1892,35,30-34,1927,19
SIM,1877,28,45-49,1905,4
SIM,1990,18,40-44,2008,2
STAT,1836,29,45-49,1865,1.2892460957366036
STAT,1859,49,50-100,1908,0.22106709695170149
STAT,1858,40,25-29,1898,0.5839584760299092
STAT,1911,59,na,1970,3777.53480694579
STAT,1884,35,30-34,1919,6.134609457844345
SIM,1930,66,na,1996,5353
SIM,1821,37,25-29,1858,4
STAT,1896,22,45-49,1918,1.0629175809833367
SIM,1840,24,30-34,1864,19
STAT,1928,41,45-49,1969,0.2451996233162728
STAT,1833,71,na,1904,939.2640866427731
SIM,1911,29,30-34,1940,99
STAT,1831,40,15-19,1871,0.013578909850537692
STAT,1912,15,50-100,1927,0.08792052619788265
STAT,1843,43,45-49,1886,1.5264874491121698
STAT,1869,49,25-29,1918,0.06303015315160734
STAT,1838,55,na,1893,1791.0742362404367
SIM,1906,28,35-39,1934,25
SIM,1936,23,na,1959,3725
STAT,1955,42,15-19,1997,0.0024449949411584617
STAT,1907,23,30-34,1930,30.151349446760655
STAT,1778,89,na,1867,48.2160373918425
SIM,1973,33,30-34,2006,45
STAT,1979,24,45-49,2003,1.7925672318882737
STAT,1881,31,15-19,1912,0.15916593145053406
SIM,1964,26,30-34,1990,80
SIM,1851,43,45-49,1894,3
SIM,1817,58,na,1875,1144
STAT,1954,47,15-19,2001,5.466429673401171E-4
STAT,1770,109,na,1879,0.0014860724796636625
STAT,1835,42,25-29,1877,0.4801981197128305
STAT,1839,32,15-19,1871,0.13898124045736965
SIM,1847,32,15-19,1879,1
SIM,1905,31,na,1936,4236
SIM,1936,41,45-49,1977,2
STAT,1874,54,30-34,1928,0.006839230654000867
STAT,1933,20,20-24,1953,171.30669700646652
STAT,1984,4,na,1988,6445.826857349387
STAT,1903,29,30-34,1932,41.097586129290995
SIM,1959,7,na,1966,6032
STAT,1862,33,50-100,1895,0.8885954760646821
STAT,1848,26,30-34,1874,32.17316738753357
STAT,1978,33,40-44,2011,6.2785753189726226
STAT,1849,17,35-39,1866,0.5234945279873378
STAT,1979,16,25-29,1995,68.8781228343172
SIM,1894,82,na,1976,1720
SIM,1867,36,35-39,1903,26
STAT,1885,21,na,1906,2730.648604874014
STAT,1828,53,20-24,1881,5.855282426029426E-4
STAT,1913,46,30-34,1959,0.10071665945990668
STAT,1819,72,na,1891,840.7248213824237
SIM,1865,53,na,1918,2620
STAT,1956,26,30-34,1982,60.120411195915516
SIM,1872,40,50-100,1912,1
SIM,1884,88,na,1972,285
SIM,1857,17,35-39,1874,3
STAT,1834,45,45-49,1879,0.25750967233087874
SIM,1941,20,20-24,1961,3
SIM,1893,26,35-39,1919,24
STAT,1840,17,15-19,1857,6.16381754520464
SIM,1793,78,na,1871,537
SIM,1896,36,30-34,1932,4
STAT,1891,49,35-39,1940,0.11028690277861276
SIM,1932,18,35-39,1950,9
STAT,1869,44,50-100,1913,1.1647621838662907
STAT,1963,1,na,1964,5773.081527050259
STAT,1981,34,25-29,2015,15.183579521888015
SIM,1912,49,na,1961,3579
SIM,1859,53,na,1912,1949
SIM,1848,35,50-100,1883,3
STAT,1913,39,40-44,1952,1.6886252352122437
SIM,1947,19,35-39,1966,9
STAT,1862,37,na,1899,2294.562524361898
STAT,1903,36,20-24,1939,0.2748095672584069
SIM,1853,27,45-49,1880,2
STAT,1895,18,45-49,1913,0.09786985011215862
SIM,1831,26,30-34,1857,25
STAT,1895,39,25-29,1934,4.281576617009999
SIM,1831,57,na,1888,1348
STAT,1953,37,50-100,1990,0.6038694349040357
SIM,1903,25,50-100,1928,4
SIM,1982,31,30-34,2013,55
SIM,1927,31,50-100,1958,1
STAT,1939,19,35-39,1958,4.846022233539946
STAT,1885,26,35-39,1911,11.145087084139693
STAT,1954,31,45-49,1985,2.289675551198711
SIM,1921,39,40-44,1960,2
SIM,1818,39,45-49,1857,3
STAT,1991,19,45-49,2010,0.8256287806763851
STAT,1845,27,45-49,1872,0.9106724580965913
STAT,1924,18,35-39,1942,5.749981095552428
SIM,1915,23,30-34,1938,4
STAT,1838,21,45-49,1859,0.789479542637068
STAT,1860,34,30-34,1894,16.10039867320366
SIM,1857,42,25-29,1899,3
STAT,1809,45,35-39,1854,0.3590238732067347
SIM,1898,30,20-24,1928,4
STAT,1982,16,30-34,1998,19.799224654922696
SIM,1893,33,25-29,1926,3
STAT,1974,31,30-34,2005,24.21469038915631
STAT,1892,46,45-49,1938,0.19310132253941759
STAT,1907,30,20-24,1937,2.6566043225943736
STAT,1871,41,na,1912,2665.6021950621553
SIM,1857,24,25-29,1881,82
STAT,1956,39,na,1995,5906.334705029114
STAT,1849,42,25-29,1891,0.49710273962250234
STAT,1881,27,30-34,1908,28.0307054425226
STAT,1934,12,na,1946,6188.027249820742
STAT,1811,92,na,1903,21.445015660207147
STAT,1838,45,30-34,1883,0.08851926388209087
STAT,1939,37,35-39,1976,2.8797699386224203
SIM,1882,16,30-34,1898,3
STAT,1994,19,15-19,2013,75.52820070924923
STAT,1931,73,na,2004,4061.6879324525694
STAT,1791,67,na,1858,803.7263589669151
STAT,1885,33,25-29,1918,11.740601390360807
STAT,1899,15,25-29,1914,9.001123934103118
STAT,1874,16,30-34,1890,1.8876975104434721
SIM,1950,21,25-29,1971,7
STAT,1821,44,20-24,1865,0.2931292352920532
SIM,1857,21,20-24,1878,145
SIM,1830,32,20-24,1862,1
SIM,1877,25,40-44,1902,2
STAT,1846,38,15-19,1884,0.05999593039749597
STAT,1963,25,na,1988,5521.002136545451
STAT,1969,32,35-39,2001,13.428709763717846
STAT,1893,41,35-39,1934,2.653419647060571
STAT,1926,26,50-100,1952,1.3814415319574291
STAT,1835,32,30-34,1867,13.88147227068151
STAT,1942,21,25-29,1963,111.82365966552436
STAT,1996,16,45-49,2012,0.8380518679353567
STAT,1822,32,20-24,1854,11.688019975789942
STAT,1924,3,na,1927,5572.630739234491
SIM,1880,26,25-29,1906,11
STAT,1929,79,na,2008,2979.934228318011
STAT,1890,43,30-34,1933,1.6094594258858068
STAT,1867,44,45-49,1911,1.5908452324555575
STAT,1871,32,40-44,1903,4.979098549303533
STAT,1896,40,45-49,1936,0.16001719710280868
STAT,1903,39,25-29,1942,1.0112431947033582
SIM,1852,19,na,1871,2288
STAT,1880,5,na,1885,3296.2764574465155
SIM,1870,16,40-44,1886,1
STAT,1924,32,50-100,1956,1.1128894003298944
STAT,1862,16,40-44,1878,0.20522717056094547
SIM,1939,34,25-29,1973,1
STAT,1865,22,15-19,1887,3.4768856961016086
STAT,1809,52,25-29,1861,0.008561470786097694
SIM,1841,31,na,1872,2043
STAT,1853,49,15-19,1902,3.899321618497846E-4
SIM,1850,28,50-100,1878,1
SIM,1975,10,na,1985,6127
SIM,1911,39,25-29,1950,2
STAT,1853,31,50-100,1884,0.9492148689909417
STAT,1903,20,na,1923,3910.808697556336
STAT,1861,22,30-34,1883,17.556434328629813
STAT,1854,43,20-24,1897,0.12844985321598443
SIM,1848,10,na,1858,2320
SIM,1846,28,15-19,1874,2
SIM,1924,31,25-29,1955,7
SIM,1877,44,50-100,1921,2
SIM,1839,34,30-34,1873,30
SIM,1990,22,25-29,2012,155
SIM,1858,30,50-100,1888,1
STAT,1877,35,40-44,1912,5.304857935446677
SIM,1833,40,50-100,1873,3
SIM,1973,29,45-49,2002,1
STAT,1890,25,30-34,1915,35.75041365331337
SIM,1781,81,na,1862,296
SIM,1934,28,na,1962,5859
STAT,1787,93,na,1880,5.558300366082664
STAT,1970,36,na,2006,5604.482272534716
STAT,1858,18,40-44,1876,0.19121772593056183
STAT,1872,21,45-49,1893,0.8104973742260592
SIM,1811,65,na,1876,1401
SIM,1866,18,40-44,1884,1
SIM,1906,84,na,1990,1384
SIM,1800,65,na,1865,1039
STAT,1780,112,na,1892,4.3442479274985105E-4
STAT,1944,19,15-19,1963,56.32768929970552
STAT,1825,40,50-100,1865,1.6370407637732798
STAT,1832,54,na,1886,1458.3522678478207
SIM,1804,79,na,1883,283
SIM,1895,36,na,1931,3585
STAT,1836,26,40-44,1862,3.5543590789744925
STAT,1918,91,na,2009,612.7471690447397
STAT,1916,31,25-29,1947,11.058439477555252
SIM,1977,32,35-39,2009,46
STAT,1939,27,na,1966,4347.945973088725
SIM,1862,45,50-100,1907,1
STAT,1911,55,na,1966,3891.104417495381
SIM,1839,37,na,1876,2180
SIM,1938,39,35-39,1977,5
STAT,1890,76,na,1966,1735.8820046733015
STAT,1936,38,25-29,1974,1.115050231545184
STAT,1908,21,25-29,1929,98.42044492875685
STAT,1963,32,50-100,1995,1.235637331877426
STAT,1834,89,na,1923,95.87190618722812
STAT,1978,28,na,2006,5922.727702305717
SIM,1944,38,25-29,1982,1
SIM,1916,21,25-29,1937,236
STAT,1971,29,20-24,2000,26.76992776573066
STAT,1843,36,50-100,1879,1.4531377407484247
SIM,1913,66,na,1979,3710
STAT,1881,71,na,1952,1485.805408846563
STAT,1880,93,na,1973,168.9166382202382
SIM,1878,32,45-49,1910,1
SIM,1932,71,na,2003,3847
SIM,1844,26,40-44,1870,7
SIM,1874,47,35-39,1921,1
STAT,1956,29,35-39,1985,23.003133656553626
SIM,1978,26,45-49,2004,10
SIM,1981,10,na,1991,6471
SIM,1864,27,20-24,1891,15
STAT,1900,3,na,1903,4233.410428129626
STAT,1808,52,40-44,1860,0.05017992047254522
STAT,1979,21,40-44,2000,5.362149760297944
SIM,1818,75,na,1893,882
SIM,1906,25,30-34,1931,6
SIM,1840,27,35-39,1867,24
STAT,1874,19,35-39,1893,0.6447943571880318
STAT,1858,101,na,1959,1.0052129724783845
STAT,1869,46,20-24,1915,0.013449377408823139
SIM,1872,18,15-19,1890,11
STAT,1856,27,20-24,1883,10.703154795627416
STAT,1855,37,30-34,1892,4.534913979116016
SIM,1940,25,30-34,1965,109
SIM,1914,17,30-34,1931,7
STAT,1858,45,30-34,1903,0.08801650975692804
STAT,1871,29,15-19,1900,0.5171848218264701
SIM,1964,29,35-39,1993,32
STAT,1882,29,na,1911,2670.8979693133615
SIM,1903,29,25-29,1932,143
STAT,1924,91,na,2015,685.4638543423862
STAT,1872,33,15-19,1905,0.16432593248643337
STAT,1965,24,30-34,1989,41.51782777776882
STAT,1895,15,40-44,1910,0.27603206053240353
STAT,1906,17,30-34,1923,2.682276663391098
STAT,1880,9,na,1889,3193.728227090256
STAT,1864,18,15-19,1882,6.288786497242745
SIM,1959,21,45-49,1980,1
SIM,1987,21,40-44,2008,5
STAT,1793,62,na,1855,905.5959999999999
STAT,1852,27,35-39,1879,10.595812817089502
STAT,1792,84,na,1876,164.59187946541752
STAT,1858,7,na,1865,2602.9762267497995
STAT,1948,48,45-49,1996,0.29772791363440715
STAT,1803,104,na,1907,0.023247604000784385
STAT,1875,71,na,1946,1591.8770960440534
STAT,1918,29,15-19,1947,0.8606435795255186
SIM,1775,81,na,1856,10
SIM,1817,42,30-34,1859,1
SIM,1873,22,15-19,1895,1
STAT,1869,47,na,1916,2502.7182951510554
STAT,1990,19,30-34,2009,20.131052634621707
STAT,1832,27,35-39,1859,9.168346805484877
STAT,1923,12,na,1935,5367.4006191624785
STAT,1963,45,15-19,2008,5.644199614597185E-4
SIM,1904,30,45-49,1934,7
SIM,1818,36,40-44,1854,8
SIM,1973,24,30-34,1997,4
STAT,1910,33,na,1943,4195.048671936806
SIM,1971,42,na,2013,5703
STAT,1799,94,na,1893,8.97744153892964
STAT,1851,37,na,1888,1888.284794563618
SIM,1896,39,35-39,1935,4
STAT,1867,51,35-39,1918,0.009320544562013955
STAT,1972,30,40-44,2002,5.900763107450284
STAT,1848,29,35-39,1877,12.064128807300175
STAT,1880,36,25-29,1916,3.5389040681360515
SIM,1947,16,30-34,1963,1
STAT,1978,36,45-49,2014,1.1071687729514252
STAT,1834,42,40-44,1876,2.474570499010674
STAT,1875,32,25-29,1907,12.215282986712408
STAT,1953,49,20-24,2002,0.015953373851714622
SIM,1856,17,20-24,1873,29
STAT,1857,24,30-34,1881,16.578397409701303
SIM,1860,27,35-39,1887,13
STAT,1977,27,15-19,2004,1.1055470527362852
STAT,1823,77,na,1900,489.49475832935747
STAT,1881,54,20-24,1935,7.988115976742702E-4
SIM,1843,32,30-34,1875,37
STAT,1866,47,35-39,1913,0.14905450727693156
STAT,1967,30,na,1997,5563.725464680611
SIM,1861,40,25-29,1901,1
SIM,1872,35,30-34,1907,9
STAT,1921,6,na,1927,5270.5075754892305
STAT,1939,16,30-34,1955,14.089922232695368
STAT,1899,13,na,1912,4076.799972571307
SIM,1842,42,40-44,1884,3
SIM,1865,31,20-24,1896,1
SIM,1883,32,25-29,1915,19
STAT,1848,17,20-24,1865,23.35132023242078
STAT,1859,36,35-39,1895,6.5334653339101765
STAT,1864,53,30-34,1917,0.0060352704805429
STAT,1932,25,30-34,1957,59.29290964501906
SIM,1866,70,na,1936,1352
STAT,1841,48,40-44,1889,0.15095582639586136
STAT,1834,93,na,1927,26.67111157731097
STAT,1849,21,20-24,1870,65.04358507624126
STAT,1850,53,30-34,1903,0.006029439644246235
STAT,1861,50,25-29,1911,0.0034470667832131006
SIM,1898,33,25-29,1931,19
STAT,1917,12,na,1929,4904.677836445243
STAT,1815,42,na,1857,1780.0640791307446
STAT,1818,46,40-44,1864,0.21435021528030973
STAT,1857,31,20-24,1888,2.47005313123201
STAT,1924,15,30-34,1939,16.8240066822289
SIM,1876,53,na,1929,2394
STAT,1895,36,20-24,1931,1.1635363515592156
STAT,1959,45,na,2004,5795.693340690328
STAT,1991,16,40-44,2007,2.3139587156467702
STAT,1918,22,45-49,1940,1.400169745393566
STAT,1888,39,35-39,1927,9.498376739110377
SIM,1940,28,na,1968,5020
STAT,1908,22,50-100,1930,0.698989953265751
STAT,1900,17,35-39,1917,0.8786784938752215
SIM,1861,34,40-44,1895,4
STAT,1814,44,30-34,1858,3.3865800789378375
STAT,1840,52,30-34,1892,0.004749723730586115
STAT,1916,37,45-49,1953,0.8057434248489466
SIM,1880,23,20-24,1903,91
SIM,1887,32,na,1919,3683
STAT,1860,32,40-44,1892,4.033617540414182
STAT,1907,50,na,1957,3749.291176344813
SIM,1891,39,35-39,1930,24
SIM,1833,23,25-29,1856,2
STAT,1874,50,50-100,1924,0.018099514544426966
STAT,1951,15,40-44,1966,1.9231866898577095
SIM,1930,47,35-39,1977,1
STAT,1907,29,50-100,1936,1.0693412965834082
STAT,1851,31,25-29,1882,8.542132348243303
STAT,1860,37,35-39,1897,6.5785854583895444
STAT,1872,28,15-19,1900,0.5239008589737791
STAT,1879,42,15-19,1921,0.016620617476774555
STAT,1901,72,na,1973,2573.8698832818814
SIM,1822,44,30-34,1866,3
STAT,1946,21,45-49,1967,1.4454409261994992
SIM,1954,21,45-49,1975,2
STAT,1883,39,35-39,1922,7.905605721508731
STAT,1892,37,35-39,1929,10.230516483080988
STAT,1905,86,na,1991,1078.7588582514866
STAT,1915,87,na,2002,1102.6792280409027
STAT,1961,48,20-24,2009,0.017091168074370906
STAT,1932,64,na,1996,5094.499875047399
SIM,1866,40,25-29,1906,1
STAT,1898,99,na,1997,46.63412142469375
STAT,1894,85,na,1979,990.4928298183949
STAT,1853,34,40-44,1887,4.354967336358203
STAT,1825,41,na,1866,1957.3634601065726
STAT,1922,32,50-100,1954,1.077612831718634
STAT,1915,21,15-19,1936,6.370473609994273
STAT,1957,25,na,1982,5729.638148315337
SIM,1838,52,na,1890,1490
SIM,1835,19,na,1854,2862
STAT,1953,45,20-24,1998,0.016122962769869534
SIM,1946,19,50-100,1965,2
SIM,1820,42,na,1862,1932
SIM,1902,87,na,1989,463
SIM,1950,45,45-49,1995,1
SIM,1856,40,45-49,1896,3
STAT,1942,45,45-49,1987,0.2739695977687014
SIM,1900,52,na,1952,3243
STAT,1809,50,35-39,1859,0.021688838666535308
STAT,1857,27,35-39,1884,8.932871790863866
STAT,1825,41,25-29,1866,0.9753862969608359
SIM,1891,28,50-100,1919,2
STAT,1898,49,50-100,1947,0.21156481493678178
STAT,1913,1,na,1914,4913.968951619144
STAT,1892,71,na,1963,2191.4635421169382
SIM,1856,29,35-39,1885,16
STAT,1938,42,na,1980,4395.971694418593
STAT,1840,58,na,1898,1586.431713130864
SIM,1980,25,50-100,2005,3
SIM,1975,0,na,1975,6133
STAT,1849,55,na,1904,1602.6190727259527
STAT,1840,25,na,1865,2195.1736309660437
STAT,1881,47,50-100,1928,0.27210997435792234
STAT,1840,34,30-34,1874,16.708840582111534
SIM,1835,44,40-44,1879,6
SIM,1889,35,25-29,1924,9
STAT,1942,27,45-49,1969,2.0929003004929885
SIM,1862,73,na,1935,1513
STAT,1947,26,na,1973,4893.08753124606
STAT,1984,28,na,2012,6163.75577530107
STAT,1909,20,25-29,1929,99.77665710484943
STAT,1920,32,na,1952,4778.761573280001
SIM,1889,67,na,1956,2578
SIM,1951,27,50-100,1978,1
STAT,1922,47,35-39,1969,0.1708582731854022
SIM,1912,24,20-24,1936,6
STAT,1852,105,na,1957,0.04196476180607325
STAT,1836,30,25-29,1866,12.034055692166111
SIM,1950,27,45-49,1977,7
STAT,1978,18,na,1996,5795.22671789399
SIM,1923,49,na,1972,5213
SIM,1956,44,35-39,2000,1
SIM,1939,31,20-24,1970,1
SIM,1851,30,na,1881,2834
STAT,1928,33,50-100,1961,1.192310014424462
SIM,1893,65,na,1958,2303
STAT,1858,43,40-44,1901,2.010363458548321
STAT,1827,44,40-44,1871,2.891313988520245
STAT,1837,105,na,1942,0.021231922435061445
SIM,1866,43,40-44,1909,1
STAT,1904,42,20-24,1946,0.018253813853869427
STAT,1967,21,25-29,1988,133.64086976325348
STAT,1910,34,45-49,1944,1.737797240820483
SIM,1929,30,45-49,1959,5
STAT,1857,49,35-39,1906,0.12320618764526639
SIM,1937,45,na,1982,4318
SIM,1892,30,25-29,1922,2
STAT,1981,25,15-19,2006,1.1451266710453512
SIM,1843,40,35-39,1883,3
STAT,1918,38,na,1956,4570.711926356846
SIM,1829,37,30-34,1866,3
STAT,1821,47,25-29,1868,0.10423504589842496
STAT,1931,41,15-19,1972,0.0023715269099833392
STAT,1966,31,35-39,1997,13.43461255874215
STAT,1893,34,45-49,1927,2.521967224807252
STAT,1953,26,na,1979,5254.80159248704
STAT,1837,69,na,1906,1062.689435580499
SIM,1999,14,na,2013,6971
SIM,1844,30,25-29,1874,7
STAT,1921,34,20-24,1955,3.1045903187793145
SIM,1940,28,35-39,1968,2
SIM,1981,24,25-29,2005,295
STAT,1908,39,na,1947,4029.260361561962
STAT,1981,31,45-49,2012,2.5898723390864253
STAT,1834,25,na,1859,2626.2666109619668
STAT,1835,40,35-39,1875,1.3893094811147366
STAT,1896,46,30-34,1942,0.08346730077105802
SIM,1892,36,45-49,1928,3
STAT,1855,55,na,1910,1759.4082564897794
SIM,1831,26,na,1857,1839
SIM,1903,26,20-24,1929,40
STAT,1932,28,35-39,1960,22.688559741991423
STAT,1877,53,40-44,1930,0.012434948944256077
STAT,1977,30,40-44,2007,6.226983810739143
STAT,1882,45,25-29,1927,0.0655748836141056
SIM,1975,21,25-29,1996,139
SIM,1864,25,30-34,1889,35
STAT,1921,49,40-44,1970,0.20383759417947522
STAT,1966,41,20-24,2007,0.02649301706622969
STAT,1856,25,30-34,1881,23.308134773270336
SIM,1848,20,15-19,1868,5
STAT,1797,99,na,1896,0.5639018935916189
SIM,1862,18,na,1880,3076
STAT,1986,21,30-34,2007,47.43373090168386
SIM,1868,27,40-44,1895,11
SIM,1907,95,na,2002,195
STAT,1974,25,na,1999,5674.51202468197
STAT,1939,44,25-29,1983,0.08547655774636777
STAT,1896,64,na,1960,2789.892606593118
STAT,1892,50,na,1942,3159.2577270723273
STAT,1925,25,40-44,1950,6.394340088314342
STAT,1869,25,40-44,1894,3.370580139950121
STAT,1848,17,na,1865,3023.465791825033
STAT,1982,22,25-29,2004,150.49652080709973
STAT,1904,24,20-24,1928,113.48817636239369
STAT,1878,49,15-19,1927,4.7191840546973265E-4
SIM,1867,24,na,1891,2125
STAT,1910,16,45-49,1926,0.11462942430221144
SIM,1883,35,na,1918,2524
STAT,1833,40,na,1873,1838.885544580228
STAT,1888,19,15-19,1907,8.007486787868633
SIM,1810,79,na,1889,145
STAT,1858,48,35-39,1906,0.12445634248868175
SIM,1947,64,na,2011,5100
SIM,1885,35,40-44,1920,13
SIM,1927,46,na,1973,4922
STAT,1812,53,45-49,1865,0.031509803747177406
STAT,2000,5,na,2005,6747.964743939337
STAT,1889,23,15-19,1912,4.6785885529514575
SIM,1928,31,45-49,1959,5
SIM,1862,40,na,1902,2859
STAT,1858,46,45-49,1904,0.21307073032367552
STAT,1859,40,20-24,1899,0.1474707367044995
SIM,1933,25,40-44,1958,5
STAT,1880,40,35-39,1920,2.2374128650863376
SIM,1889,28,35-39,1917,22
STAT,1832,54,25-29,1886,0.0024584502290875194
STAT,1865,72,na,1937,1314.9969873106074
SIM,1949,31,25-29,1980,1
SIM,1852,74,na,1926,587
STAT,1849,37,50-100,1886,0.9737224931976455
STAT,1929,22,20-24,1951,162.28360717804358
SIM,1978,25,na,2003,5744
STAT,1905,40,15-19,1945,0.0016179733893932164
STAT,1903,51,na,1954,3556.359768736318
STAT,1861,30,35-39,1891,9.794078712628323
STAT,1886,71,na,1957,1695.6372091616806
SIM,1896,19,15-19,1915,1
STAT,1874,30,45-49,1904,2.07679436399045
STAT,1924,50,na,1974,5000.595120928745
SIM,1871,5,na,1876,2508
SIM,1869,21,35-39,1890,8
STAT,1821,41,40-44,1862,4.435734732487898
SIM,1937,22,20-24,1959,8
STAT,1857,34,25-29,1891,9.127342649696256
STAT,1962,28,25-29,1990,97.70072014132724
SIM,1915,14,na,1929,5022
STAT,1844,55,na,1899,1729.4824006840754
STAT,1929,15,30-34,1944,18.035949775247012
STAT,1973,40,na,2013,5776.679233596281
SIM,1870,20,25-29,1890,2
STAT,1928,12,na,1940,5761.5542728506325
SIM,1960,42,na,2002,6171
STAT,1930,32,20-24,1962,3.633217274782673
STAT,1854,50,35-39,1904,0.007114565438418675
STAT,1820,97,na,1917,3.1529673245710685
STAT,1869,16,na,1885,2878.6803685828822
SIM,1839,37,35-39,1876,6
SIM,1882,30,45-49,1912,6
STAT,1884,36,45-49,1920,2.2839555246943455
STAT,1878,44,20-24,1922,0.18877960921742337
SIM,1859,45,40-44,1904,1
SIM,1838,35,30-34,1873,10
SIM,1989,19,30-34,2008,24
SIM,1841,19,na,1860,2406
SIM,1970,28,25-29,1998,45
STAT,1859,33,30-34,1892,15.983066098569878
SIM,1947,37,35-39,1984,1
STAT,1875,16,na,1891,3019.4238863785554
SIM,1921,14,na,1935,5566
SIM,1865,34,25-29,1899,11
SIM,1969,29,35-39,1998,2
SIM,1926,61,na,1987,5244
STAT,1853,37,45-49,1890,1.984753220738695
SIM,1860,24,30-34,1884,3
STAT,1837,17,45-49,1854,0.12608593623767983
STAT,1862,20,25-29,1882,57.90258595407208
SIM,1937,15,30-34,1952,28
STAT,1852,24,30-34,1876,19.664627358591545
STAT,1833,48,35-39,1881,0.10439035376898226
SIM,1924,37,45-49,1961,3
SIM,1904,20,15-19,1924,8
STAT,1808,46,35-39,1854,0.7121480475080254
STAT,1860,35,45-49,1895,1.8717684090842786
SIM,1895,29,25-29,1924,74
STAT,1950,49,15-19,1999,5.19775651148828E-4
STAT,1904,45,25-29,1949,0.05438184656269555
STAT,1907,33,25-29,1940,9.944162697240413
SIM,1968,34,35-39,2002,2
SIM,1894,6,na,1900,4179
STAT,1843,70,na,1913,1407.8179507641416
STAT,1895,20,na,1915,3573.9548082046394
SIM,1891,36,30-34,1927,6
SIM,1861,37,45-49,1898,1
STAT,1908,35,na,1943,4108.880793006523
STAT,1967,24,50-100,1991,0.9510325676740647
STAT,1966,22,25-29,1988,133.5835961591292
STAT,1879,38,30-34,1917,6.390387532175181
STAT,1779,112,na,1891,4.300709868776634E-4
STAT,1958,20,20-24,1978,169.2154943449496
SIM,1887,38,30-34,1925,13
STAT,1920,18,15-19,1938,58.58198601988101
STAT,1965,34,25-29,1999,13.556231910798486
SIM,1888,26,30-34,1914,69
STAT,1871,109,na,1980,0.03853849984619462
SIM,1988,14,na,2002,6629
STAT,1847,84,na,1931,255.96914098041924
STAT,1845,45,20-24,1890,0.008166875731201334
STAT,1871,38,25-29,1909,3.289286004994802
SIM,1838,38,35-39,1876,14
STAT,1771,108,na,1879,0.006197279567586389
SIM,1828,92,na,1920,116
SIM,1974,22,25-29,1996,281
STAT,1930,42,15-19,1972,0.0023321372853772004
SIM,1834,34,30-34,1868,50
STAT,1778,85,na,1863,112.39664650045519
SIM,1856,40,na,1896,2092
SIM,1930,44,30-34,1974,1
STAT,1934,20,35-39,1954,14.658174943855027
STAT,1826,34,30-34,1860,14.951029262240446
SIM,1986,2,na,1988,6758
STAT,1919,78,na,1997,2641.7609016292586
STAT,1819,41,na,1860,1921.7673538917281
STAT,1809,49,50-100,1858,0.6076904976298534
STAT,1901,46,15-19,1947,3.657675885811706E-4
STAT,1887,29,25-29,1916,54.31838277805743
SIM,1966,20,20-24,1986,158
SIM,1958,48,na,2006,6073
SIM,1930,76,na,2006,3666
STAT,1838,104,na,1942,0.05777624471603421
STAT,1876,97,na,1973,44.94195253294326
STAT,1995,18,15-19,2013,75.79017465559018
SIM,1943,71,na,2014,3812
SIM,1959,3,na,1962,6033
STAT,1883,36,30-34,1919,6.046548127031915
STAT,1835,33,45-49,1868,1.3719804994885711
STAT,1922,44,30-34,1966,0.16870915414104987
SIM,1947,60,na,2007,5402
STAT,1882,15,30-34,1897,1.8049809682894964
SIM,1942,20,35-39,1962,26
STAT,1978,18,30-34,1996,19.190845936529037
STAT,1921,17,na,1938,4840.105145111963
SIM,1843,33,45-49,1876,4
STAT,1881,110,na,1991,0.027653992834472382
STAT,1957,36,40-44,1993,2.348799345354637
STAT,1869,16,50-100,1885,0.055840836684288256
SIM,1917,36,50-100,1953,2
STAT,1835,26,50-100,1861,0.5258185475941269
SIM,1857,37,50-100,1894,1
SIM,1907,35,40-44,1942,2
SIM,1863,58,na,1921,1993
STAT,1850,53,50-100,1903,0.015297834429767765
STAT,1965,27,35-39,1992,21.724425883880766
SIM,1866,46,45-49,1912,1
STAT,1933,23,25-29,1956,141.41376498042217
SIM,1941,23,25-29,1964,201
SIM,1930,35,na,1965,6046
SIM,1889,32,20-24,1921,1
STAT,1827,47,45-49,1874,0.29890511981343837
SIM,1856,26,30-34,1882,33
STAT,1850,18,35-39,1868,0.6861921829333489
SIM,1827,52,na,1879,1321
STAT,1909,36,50-100,1945,0.46134968587844455
SIM,1923,28,na,1951,5073
STAT,1857,46,30-34,1903,0.08725189665784129
SIM,1976,15,35-39,1991,6
STAT,1884,38,35-39,1922,8.024692613221408
SIM,1890,42,20-24,1932,3
STAT,1910,31,40-44,1941,4.376867356049785
STAT,1859,17,na,1876,2449.512731678864
STAT,1813,63,na,1876,997.5984854007521
STAT,1980,25,45-49,2005,2.7821620015213377
SIM,1835,47,45-49,1882,1
SIM,1864,28,35-39,1892,26
STAT,1968,25,na,1993,5427.81182921449
SIM,1892,38,35-39,1930,6
STAT,1817,77,na,1894,597.6062544346477
STAT,1936,2,na,1938,4521.476753996164
SIM,1842,36,35-39,1878,21
SIM,1916,46,na,1962,4330
STAT,1863,47,30-34,1910,0.09722646585872488
STAT,1991,18,30-34,2009,20.152399684148556
STAT,1856,28,35-39,1884,8.739964479580639
STAT,1864,32,na,1896,2458.954123313546
STAT,1926,64,na,1990,4631.84079357719
STAT,1834,36,35-39,1870,8.112540571581626
SIM,1865,39,40-44,1904,8
STAT,1986,24,35-39,2010,15.524069359252563
SIM,1898,16,na,1914,4125
SIM,1867,33,30-34,1900,41
SIM,1950,53,na,2003,4543
SIM,1954,48,50-100,2002,1
SIM,1839,92,na,1931,51
STAT,1885,30,20-24,1915,3.1365267597789335
STAT,1955,15,25-29,1970,66.42526492999241
SIM,1876,32,na,1908,2696
STAT,1884,30,25-29,1914,11.772708522656234
STAT,1821,38,15-19,1859,0.11959515424666102
STAT,1882,18,35-39,1900,0.6168926725676699
SIM,1981,21,20-24,2002,328
STAT,1912,72,na,1984,3020.2970102169256
SIM,1938,18,30-34,1956,14
SIM,1950,27,na,1977,4360
STAT,1893,21,15-19,1914,4.826876408827135
STAT,1911,28,na,1939,4204.824490288789
STAT,1855,41,15-19,1896,0.011803891687557888
STAT,1881,19,50-100,1900,0.05424182974527271
STAT,1958,40,40-44,1998,0.39509134045688354
SIM,1891,29,40-44,1920,14
SIM,1813,60,na,1873,1157
SIM,1897,31,na,1928,3738
STAT,1883,29,40-44,1912,3.3580943884948544
STAT,1962,47,20-24,2009,0.016997174475463603
SIM,1876,34,50-100,1910,2
SIM,1936,2,na,1938,4196
SIM,1948,32,25-29,1980,24
STAT,1930,17,25-29,1947,64.66462568916279
STAT,1929,18,35-39,1947,6.164189791813851
SIM,1828,37,na,1865,2358
SIM,1898,71,na,1969,2724
STAT,1868,34,50-100,1902,1.0072056465590362
SIM,1849,36,na,1885,2719
SIM,1944,27,na,1971,4245
SIM,1961,27,20-24,1988,26
SIM,1881,87,na,1968,217
STAT,1798,62,na,1860,815.4348944799301
SIM,1981,5,na,1986,6481
STAT,1902,110,na,2012,0.05454187242195675
STAT,1908,30,35-39,1938,10.047493784782013
SIM,1833,41,25-29,1874,2
STAT,1952,41,na,1993,5345.466699584009
STAT,1968,15,35-39,1983,6.051588109470108
SIM,1831,29,35-39,1860,3
STAT,1964,2,na,1966,5719.925290784061
STAT,1876,47,40-44,1923,0.2032858116370831
SIM,1817,43,45-49,1860,3
STAT,1928,31,15-19,1959,0.1855376341317156
SIM,1796,70,na,1866,780
SIM,1908,32,na,1940,3976
STAT,1886,17,40-44,1903,0.22264993187746576
STAT,1940,0,na,1940,5258.950972783022
SIM,1843,26,50-100,1869,2
STAT,1953,27,20-24,1980,25.593633147337957
STAT,1869,28,45-49,1897,1.2365160849525254
SIM,1848,14,na,1862,2285
SIM,1917,20,25-29,1937,6
STAT,1907,26,35-39,1933,16.439860588173087
SIM,1884,47,40-44,1931,1
SIM,1916,30,35-39,1946,3
SIM,1954,6,na,1960,5546
SIM,1981,26,15-19,2007,2
STAT,1865,17,na,1882,2709.963775328172
STAT,1878,47,25-29,1925,0.06908186789866191
SIM,1866,91,na,1957,6
STAT,1933,75,na,2008,3867.6076336582937
STAT,1823,53,20-24,1876,6.884530062523761E-4
STAT,1889,20,na,1909,3384.519665223593
SIM,1818,40,25-29,1858,4
STAT,1964,38,40-44,2002,2.2394499736309794
STAT,1947,20,45-49,1967,1.4685233559155526
SIM,1912,27,25-29,1939,14
STAT,1929,25,25-29,1954,95.43062128510677
SIM,1845,92,na,1937,32
STAT,1930,35,25-29,1965,1.484891167766212
STAT,1904,27,25-29,1931,70.10272663239125
STAT,1974,34,35-39,2008,14.018868647042664
STAT,1822,42,15-19,1864,0.028219319316751826
STAT,1848,40,45-49,1888,1.629486496255293
SIM,1904,14,na,1918,4417
STAT,1913,50,na,1963,4103.0307979425925
STAT,1927,36,50-100,1963,0.6028351809022127
SIM,1915,26,35-39,1941,29
STAT,1954,21,15-19,1975,7.622018377030463
STAT,1862,19,45-49,1881,0.06552717393544742
SIM,1962,21,15-19,1983,10
SIM,1807,60,na,1867,993
STAT,1967,18,na,1985,5304.3646494498125
SIM,1958,36,50-100,1994,1
SIM,1820,78,na,1898,1003
STAT,1914,22,50-100,1936,0.7761701616123521
SIM,1972,38,40-44,2010,2
STAT,1830,59,na,1889,1220.3367938276408
SIM,1922,22,50-100,1944,2
SIM,1892,33,40-44,1925,1
SIM,1973,28,30-34,2001,118
SIM,1814,78,na,1892,371
SIM,1917,94,na,2011,243
STAT,1873,43,na,1916,2704.0966792302715
SIM,1915,33,25-29,1948,18
STAT,1965,35,20-24,2000,0.3919634703507663
STAT,1867,37,50-100,1904,1.3228786205934857
STAT,1885,23,30-34,1908,20.440527064458383
STAT,1927,37,20-24,1964,0.3781508390285297
SIM,1890,21,na,1911,3216
SIM,1893,23,30-34,1916,1
SIM,1960,42,35-39,2002,2
SIM,1937,25,25-29,1962,138
STAT,1884,33,40-44,1917,4.923948043841158
STAT,1822,35,25-29,1857,7.600062936049441
STAT,1955,52,na,2007,5755.771830259282
STAT,1864,37,20-24,1901,0.794314743193329
SIM,1959,38,20-24,1997,1
STAT,1788,88,na,1876,69.98224858583984
STAT,1872,26,na,1898,2774.9988922569864
SIM,1800,96,na,1896,7
SIM,1834,32,40-44,1866,7
STAT,1873,21,15-19,1894,3.8996041484775064
STAT,1928,84,na,2012,1978.5412647394837
STAT,1952,22,45-49,1974,1.5612219432895562
SIM,1859,26,35-39,1885,12
STAT,1815,46,25-29,1861,0.11934453419678961
SIM,1902,21,45-49,1923,4
STAT,1914,45,30-34,1959,0.10255974475327882
STAT,1866,50,25-29,1916,0.003843202144019514
STAT,1908,76,na,1984,2437.766325101115
STAT,1857,6,na,1863,2635.4958727350363
STAT,1838,33,15-19,1871,0.1517264838108447
SIM,1926,21,30-34,1947,107
STAT,1826,32,40-44,1858,4.080898363385063
STAT,1850,34,25-29,1884,10.803589923134608
STAT,1937,32,20-24,1969,2.786443804311611
STAT,1876,26,45-49,1902,1.3291137149669914
SIM,1919,35,30-34,1954,9
STAT,1820,76,na,1896,556.0309101161552
SIM,1927,87,na,2014,203
SIM,1941,8,na,1949,4053
SIM,1979,15,15-19,1994,128
STAT,1811,99,na,1910,0.9751399672264696
SIM,1945,32,20-24,1977,4
STAT,1857,52,25-29,1909,0.003166651071380543
SIM,1845,20,35-39,1865,1
STAT,1966,28,45-49,1994,2.4997858142237015
STAT,1889,113,na,2002,0.0021306309734047697
SIM,1971,22,20-24,1993,4
SIM,1846,26,25-29,1872,35
SIM,1958,25,40-44,1983,12
STAT,1824,44,25-29,1868,0.8836948471803251
STAT,1972,20,20-24,1992,164.95873870120377
STAT,1952,10,na,1962,5433.97766156737
SIM,1912,16,na,1928,4154
SIM,1960,22,45-49,1982,2
STAT,1883,28,50-100,1911,0.7197293447308626
SIM,1799,60,na,1859,857
SIM,1894,51,na,1945,3543
STAT,1947,67,na,2014,4173.930602862675
STAT,1981,27,50-100,2008,1.613153089497538
STAT,1837,20,35-39,1857,5.799869490002462
STAT,1984,27,40-44,2011,7.672764604799704
SIM,1888,49,50-100,1937,1
SIM,1842,33,30-34,1875,7
SIM,1894,20,30-34,1914,62
STAT,1841,36,25-29,1877,3.0475059787269094
STAT,1959,38,50-100,1997,0.6523140041409825
STAT,1931,35,20-24,1966,0.403683107117736
STAT,1943,27,50-100,1970,1.2234753267807028
SIM,1817,90,na,1907,24
SIM,1937,71,na,2008,3171
SIM,1860,22,40-44,1882,3
STAT,1935,62,na,1997,5451.348818446622
SIM,1893,24,45-49,1917,2
STAT,1950,27,40-44,1977,6.387689721212785
STAT,1918,21,30-34,1939,35.87371683283175
SIM,1934,65,na,1999,4893
SIM,1936,25,20-24,1961,2
STAT,1946,30,20-24,1976,3.1860228899475023
STAT,1942,16,na,1958,4441.077949333705
STAT,1967,35,40-44,2002,2.2271328665538737
STAT,1834,33,30-34,1867,20.19881822606926
STAT,1885,24,45-49,1909,0.7976683203593133
STAT,1929,17,20-24,1946,199.68521525310885
SIM,1874,37,na,1911,2613
STAT,1988,18,25-29,2006,71.50367158769278
STAT,1852,22,40-44,1874,2.333903914335586
STAT,1962,30,na,1992,5706.9549172922925
SIM,1838,25,50-100,1863,1
SIM,1940,69,na,2009,3713
STAT,1886,20,30-34,1906,21.81246449415992
SIM,1836,20,25-29,1856,2
SIM,1986,19,na,2005,5853
STAT,1883,73,na,1956,1379.2828918083962
SIM,1916,7,na,1923,4870
SIM,1979,32,20-24,2011,1
SIM,1872,37,20-24,1909,1
STAT,1801,93,na,1894,12.26661131903645
STAT,1877,16,35-39,1893,0.6603128719398119
STAT,1917,25,45-49,1942,2.1051144018360644
STAT,1776,105,na,1881,0.03013657685279328
STAT,1905,17,35-39,1922,0.9165211302740559
STAT,1820,53,40-44,1873,0.010134055842496702
SIM,1937,17,20-24,1954,146
SIM,1968,32,45-49,2000,1
STAT,1963,18,35-39,1981,6.150257365304733
SIM,1878,9,na,1887,3142
SIM,1857,89,na,1946,14
SIM,1936,27,30-34,1963,9
SIM,1980,28,na,2008,5526
STAT,1892,40,25-29,1932,0.9382102944578489
STAT,1928,25,20-24,1953,26.128534664070468
STAT,1915,48,na,1963,4261.09582619699
STAT,1881,29,20-24,1910,12.965287440716292
STAT,1976,22,30-34,1998,44.45972862183178
STAT,1874,42,15-19,1916,0.016295497871667727
SIM,1897,3,na,1900,4281
SIM,1925,25,45-49,1950,6
STAT,1896,24,20-24,1920,104.38477320958788
STAT,1903,29,na,1932,3894.874707500316
STAT,1924,37,40-44,1961,2.036583562702641
STAT,1892,18,40-44,1910,0.2638641240357039
SIM,1971,18,35-39,1989,9
STAT,1954,18,25-29,1972,61.80507471934821
STAT,1965,38,25-29,2003,1.4600147307778673
STAT,1918,17,45-49,1935,0.1258638492080259
SIM,1957,22,na,1979,6297
SIM,1942,17,45-49,1959,3
SIM,1821,41,45-49,1862,4
SIM,1836,28,20-24,1864,1
STAT,1976,15,40-44,1991,2.15768454374691
STAT,1952,29,15-19,1981,0.9795610695813346
STAT,1863,25,20-24,1888,12.010173649030714
SIM,1802,81,na,1883,152
STAT,1934,17,45-49,1951,0.7801516959303906
SIM,1876,2,na,1878,3414
SIM,1797,65,na,1862,781
SIM,1960,29,15-19,1989,2
SIM,1899,29,na,1928,4123
STAT,1852,81,na,1933,509.84003924271843
SIM,1900,38,20-24,1938,1
STAT,1864,16,25-29,1880,6.677303669961256
SIM,1886,19,20-24,1905,30
SIM,1878,34,20-24,1912,4
SIM,1975,17,40-44,1992,5
SIM,1868,31,25-29,1899,15
STAT,1862,44,45-49,1906,1.4379511576619706
SIM,1853,69,na,1922,1118
SIM,1821,64,na,1885,893
SIM,1984,15,40-44,1999,5
STAT,1900,106,na,2006,1.2285506310199645
STAT,1967,17,40-44,1984,2.0163423828071227
STAT,1887,35,na,1922,3075.977595054103
STAT,1802,57,na,1859,1415.6695079260326
SIM,1934,69,na,2003,4255
STAT,1956,30,na,1986,5893.741666490349
STAT,1885,6,na,1891,3007.10867924927
STAT,1874,21,na,1895,2802.6160154487443
STAT,1905,24,25-29,1929,95.02003375687474
STAT,1907,13,na,1920,4378.238321337823
SIM,1929,72,na,2001,3639
STAT,1853,48,50-100,1901,0.2414515707225809
STAT,1828,28,20-24,1856,17.036868864771403
STAT,1909,19,45-49,1928,0.11257209065225196
STAT,1933,35,40-44,1968,2.358224788934479
SIM,1859,30,20-24,1889,4
STAT,1820,38,45-49,1858,2.8680790865835495
SIM,1926,20,na,1946,5612
STAT,1813,41,45-49,1854,5.84845786178937
SIM,1932,37,40-44,1969,4
STAT,1910,70,na,1980,3103.7089883195026
SIM,1925,40,40-44,1965,1
STAT,1963,22,20-24,1985,163.56805804442772
SIM,1976,33,35-39,2009,4
STAT,1790,82,na,1872,172.72283997008216
STAT,1843,15,40-44,1858,0.23731512147651826
SIM,1812,43,45-49,1855,3
STAT,1908,27,45-49,1935,1.9031608161014528
SIM,1956,20,15-19,1976,8
STAT,1918,60,na,1978,4200.492578626206
SIM,1949,27,40-44,1976,1
STAT,1947,47,35-39,1994,0.17433277604691022
STAT,1940,38,35-39,1978,2.9178757265469106
SIM,1862,18,20-24,1880,24
STAT,1838,26,25-29,1864,46.95618772952773
STAT,1968,33,35-39,2001,13.418386711888449
STAT,1960,35,na,1995,5836.014471003024
SIM,1856,18,na,1874,2486
STAT,1925,14,na,1939,5504.08624052094
SIM,1926,30,na,1956,5785
SIM,1894,41,na,1935,3780
SIM,1951,15,45-49,1966,3
STAT,1926,89,na,2015,1010.0885071273016
SIM,1966,37,40-44,2003,6
SIM,1873,37,25-29,1910,5
STAT,1966,9,na,1975,5664.283853138859
STAT,1854,18,20-24,1872,17.175963804135595
STAT,1833,39,na,1872,1845.1349253219655
STAT,1886,16,na,1902,3081.9993962484164
STAT,1861,23,45-49,1884,0.6823706595559226
SIM,1851,15,40-44,1866,1
SIM,1826,49,45-49,1875,1
SIM,1874,28,40-44,1902,12
SIM,1932,30,na,1962,5508
SIM,1962,18,25-29,1980,2
SIM,1870,44,45-49,1914,3
SIM,1906,16,na,1922,3877
SIM,1872,23,15-19,1895,1
STAT,1937,25,30-34,1962,44.14092417425172
SIM,1884,26,45-49,1910,3
SIM,1973,38,25-29,2011,2
STAT,1802,105,na,1907,0.013996446658771597
STAT,1913,13,na,1926,4655.151039741057
STAT,1943,15,45-49,1958,0.6117131400386616
SIM,1878,41,50-100,1919,5
STAT,1890,27,20-24,1917,16.542756447436098
SIM,1966,22,50-100,1988,2
STAT,1850,41,15-19,1891,0.014280800576219088
STAT,1877,54,50-100,1931,0.017631455406873806
STAT,1829,52,50-100,1881,0.01353955807130008
SIM,1911,17,15-19,1928,13
SIM,1816,43,30-34,1859,3
STAT,1919,14,na,1933,5035.600825798446
SIM,1945,25,30-34,1970,76
STAT,1869,53,45-49,1922,0.01595877797364317
STAT,1948,20,15-19,1968,7.0582786129052755
STAT,1864,23,15-19,1887,3.4293169527466887
STAT,1903,17,15-19,1920,9.755079277811182
STAT,1833,49,na,1882,1644.6484993057206
STAT,1914,46,50-100,1960,0.259638494612213
SIM,1922,22,25-29,1944,274
STAT,1838,47,20-24,1885,0.010695856787632503
SIM,1867,41,35-39,1908,5
STAT,1972,23,25-29,1995,136.89150690113965
STAT,1871,72,na,1943,1449.9629364513291
SIM,1807,59,na,1866,993
STAT,1942,42,40-44,1984,0.3135446507255362
STAT,1827,39,na,1866,2236.1454418400294
STAT,1892,34,30-34,1926,25.038117244540295
STAT,1899,27,40-44,1926,4.736197516239937
STAT,1963,51,na,2014,5531.2677651795175
STAT,1904,46,na,1950,3739.7603546480414
STAT,1914,48,35-39,1962,0.14722492742385604
STAT,1840,54,20-24,1894,5.75681544832835E-4
STAT,1835,20,15-19,1855,4.295683691983399
STAT,1806,52,50-100,1858,0.053161539723363495
SIM,1932,32,50-100,1964,3
STAT,1814,47,35-39,1861,0.38923367977240647
STAT,1990,22,20-24,2012,184.37972959725573
STAT,1846,33,20-24,1879,3.268140612223096
STAT,1905,48,25-29,1953,0.053588856840689605
STAT,1899,110,na,2009,0.051757550457747145
STAT,1906,36,25-29,1942,1.0508527838936106
SIM,1854,33,20-24,1887,7
SIM,1850,17,na,1867,2160
STAT,1876,87,na,1963,396.92609792771003
STAT,1840,34,50-100,1874,0.87684127583127
SIM,1943,32,na,1975,5376
STAT,1824,41,20-24,1865,0.22983583881411407
STAT,1851,58,na,1909,1568.2245760416984
STAT,1917,43,na,1960,4465.906550762691
STAT,1953,57,na,2010,5100.51618093068
STAT,1877,20,20-24,1897,83.21924183527734
STAT,1785,108,na,1893,9.039569882526429E-4
SIM,2008,1,na,2009,7735
STAT,1861,88,na,1949,131.71086819113353
SIM,1903,19,30-34,1922,5
STAT,1897,15,50-100,1912,0.07595227831308293
SIM,1913,24,25-29,1937,123
SIM,1904,16,30-34,1920,2
STAT,1877,73,na,1950,1425.8316490271852
STAT,1786,102,na,1888,0.14790300967946574
SIM,1969,19,na,1988,5813
STAT,1876,112,na,1988,0.00346972186300348
STAT,1858,90,na,1948,70.9790586196078
SIM,1873,3,na,1876,3807
STAT,1959,47,15-19,2006,5.784109239866224E-4
SIM,1843,20,15-19,1863,8
STAT,1914,22,25-29,1936,108.95875590545361
STAT,1928,28,25-29,1956,93.53481888826504
STAT,1840,37,35-39,1877,6.710845437062389
STAT,1911,86,na,1997,1177.1365667091065
SIM,1908,11,na,1919,4365
STAT,1875,44,40-44,1919,2.646267669493846
STAT,1943,16,40-44,1959,1.7123690093155417
STAT,1898,31,45-49,1929,2.730920010939125
SIM,1997,17,15-19,2014,142
SIM,1851,36,50-100,1887,2
SIM,1976,30,30-34,2006,6
STAT,1906,38,35-39,1944,2.556375095867536
SIM,1900,30,25-29,1930,27
SIM,1894,23,35-39,1917,9
STAT,1813,108,na,1921,8.386954712731833E-4
SIM,1868,30,30-34,1898,28
STAT,1897,59,na,1956,3025.056235681371
STAT,1943,33,na,1976,4715.382369610146
SIM,1914,38,35-39,1952,7
STAT,1816,92,na,1908,20.56855620725938
SIM,1846,23,20-24,1869,130
STAT,1938,47,25-29,1985,0.06284230216300454
STAT,1886,23,35-39,1909,7.081644833267654
STAT,1977,34,50-100,2011,1.3124333924372071
SIM,1893,31,35-39,1924,9
SIM,1824,62,na,1886,1003
SIM,1922,64,na,1986,4217
STAT,1895,43,45-49,1938,0.15499466420524236
STAT,1847,54,20-24,1901,5.521812870653881E-4
STAT,1951,37,15-19,1988,0.027188173905454728
SIM,1936,28,25-29,1964,1
SIM,1954,33,25-29,1987,25
SIM,1883,44,40-44,1927,8
SIM,1951,16,40-44,1967,5
STAT,1989,17,15-19,2006,75.01809792650975
SIM,1812,43,na,1855,1618
STAT,1921,16,20-24,1937,178.71616123216418
STAT,1832,23,na,1855,1908.049412193842
STAT,1938,49,35-39,1987,0.15184642644227397
STAT,1885,31,35-39,1916,11.70499881339561
STAT,1853,1,na,1854,3802.0
SIM,1880,37,na,1917,3259
SIM,1914,36,25-29,1950,4
SIM,1908,42,45-49,1950,1
SIM,1931,28,25-29,1959,224
STAT,1967,38,45-49,2005,1.0114455836880822
STAT,1886,21,25-29,1907,69.89610849246564
STAT,1988,15,20-24,2003,223.8916543133976
STAT,1931,38,25-29,1969,1.5036689067750064
STAT,1885,21,40-44,1906,2.405933510938314
STAT,1924,41,25-29,1965,0.09813797915543376
STAT,1946,33,25-29,1979,12.051568294688488
SIM,1830,31,na,1861,2078
STAT,1938,23,25-29,1961,105.51774429429084
STAT,1984,31,25-29,2015,15.450958941718454
STAT,1868,21,na,1889,2641.253526982268
STAT,1879,54,50-100,1933,0.017698635091506962
SIM,1852,56,na,1908,1631
SIM,1962,15,20-24,1977,369
STAT,1866,28,40-44,1894,3.1929615542451213
STAT,1896,49,35-39,1945,0.11786205589742525
STAT,1855,24,na,1879,2095.0096929071283
SIM,1859,20,na,1879,2477
SIM,1895,67,na,1962,2470
STAT,1959,31,45-49,1990,2.4227392106453456
SIM,1909,32,35-39,1941,27
STAT,1897,48,25-29,1945,0.04950827528983157
SIM,1838,21,na,1859,1990
SIM,1894,21,25-29,1915,3
STAT,1928,27,30-34,1955,55.707716449543895
STAT,1962,27,30-34,1989,58.18885500864686
STAT,1853,52,40-44,1905,0.010425729208078646
STAT,1879,8,na,1887,3191.3728892694653
STAT,1883,69,na,1952,1656.9919161527407
STAT,1824,43,50-100,1867,1.4783750394348736
STAT,1917,26,40-44,1943,5.660621489314729
SIM,1912,40,45-49,1952,1
STAT,1896,113,na,2009,0.00246597735571628
STAT,1771,85,na,1856,101.51980594999999
STAT,1831,38,20-24,1869,0.7543961442118617
STAT,1863,28,25-29,1891,42.53653612827055
SIM,1968,30,35-39,1998,3
SIM,1970,27,30-34,1997,73
SIM,1915,86,na,2001,1754
STAT,1828,93,na,1921,19.396876752558214
STAT,1882,20,na,1902,2681.824652423792
SIM,1882,22,na,1904,3505
SIM,1871,28,25-29,1899,4
SIM,1859,33,25-29,1892,14
STAT,1832,108,na,1940,0.0012479355887343043
STAT,1954,15,20-24,1969,193.52349490064168
STAT,1838,23,20-24,1861,76.90361967196901
STAT,1843,18,45-49,1861,0.08326655606153388
SIM,1868,33,35-39,1901,20
SIM,1911,1,na,1912,5254
STAT,1822,92,na,1914,34.22027011669699
SIM,1936,50,na,1986,3868
STAT,1895,45,50-100,1940,0.2101867402891702
STAT,1807,48,40-44,1855,0.6980933417850185
STAT,1844,17,35-39,1861,0.5834076394437101
SIM,1867,34,45-49,1901,2
SIM,1867,55,na,1922,2011
SIM,1851,18,45-49,1869,3
SIM,1898,21,45-49,1919,5
SIM,1955,44,30-34,1999,2
STAT,1807,94,na,1901,9.773272163114726
SIM,1844,21,na,1865,2633
STAT,1875,51,30-34,1926,0.007132949186547559
SIM,1859,44,50-100,1903,3
STAT,1978,19,25-29,1997,68.20586887162952
STAT,1921,58,na,1979,4532.295526660337
STAT,1910,28,15-19,1938,0.7847599379036154
STAT,1922,34,na,1956,4905.3007075212345
SIM,1849,54,na,1903,2353
STAT,1878,18,50-100,1896,0.05887837005872496
STAT,1933,38,45-49,1971,1.0709805795297138
STAT,1926,39,15-19,1965,0.027021122627332403
SIM,1966,23,25-29,1989,2
STAT,1952,29,50-100,1981,1.3811202393178075
STAT,1926,32,45-49,1958,2.1953835894608575
SIM,1962,17,30-34,1979,32
STAT,1909,16,40-44,1925,0.3176797230821142
SIM,1929,10,na,1939,5474
STAT,1947,44,30-34,1991,0.17213995341050994
STAT,1813,94,na,1907,9.151071082807297
STAT,1843,60,na,1903,1913.6277821388342
SIM,1948,38,45-49,1986,2
STAT,1872,45,50-100,1917,0.2874391795043057
STAT,1788,78,na,1866,459.66275318129067
SIM,1915,82,na,1997,2186
STAT,1820,52,45-49,1872,0.014251146394416684
STAT,1860,19,50-100,1879,0.05193697882969123
SIM,1835,22,30-34,1857,50
STAT,1918,46,45-49,1964,0.26751714985527836
STAT,1954,17,30-34,1971,17.38935508800307
STAT,1925,47,15-19,1972,5.149735133910776E-4
STAT,1878,19,20-24,1897,21.24753195534981
STAT,1950,31,25-29,1981,12.863151249701623
STAT,1994,20,30-34,2014,48.055384986856915
SIM,1954,11,na,1965,5542
STAT,1940,35,30-34,1975,2.204708997996841
SIM,1916,24,40-44,1940,2
STAT,1833,45,30-34,1878,0.08242689438622286
SIM,1930,32,50-100,1962,4
SIM,1855,54,na,1909,1582
SIM,1848,38,40-44,1886,11
STAT,1955,44,50-100,1999,0.18641976631142904
SIM,1870,33,50-100,1903,4
STAT,1838,76,na,1914,820.6505509623378
STAT,1883,40,15-19,1923,0.015749906754215847
SIM,1826,46,40-44,1872,1
SIM,1958,32,30-34,1990,48
STAT,1908,24,40-44,1932,3.5494780721453956
SIM,1934,32,45-49,1966,4
STAT,1859,41,35-39,1900,1.6722219671724532
STAT,1883,42,25-29,1925,0.7241618920681361
STAT,1958,23,25-29,1981,140.42398841239694
STAT,1897,22,15-19,1919,5.090835550776661
STAT,1849,54,40-44,1903,0.007935261656476105
SIM,1895,26,20-24,1921,4
STAT,1873,44,20-24,1917,0.18463324396307687
STAT,1887,26,20-24,1913,15.224624153193151
SIM,1830,72,na,1902,836
STAT,1904,40,45-49,1944,0.17397230771730446
STAT,1927,22,35-39,1949,13.385055621518578
SIM,1935,22,35-39,1957,16
SIM,1996,13,na,2009,6933
STAT,1833,38,40-44,1871,3.84088170835966
SIM,1909,82,na,1991,2605
STAT,1872,23,20-24,1895,79.60919510735418
STAT,1945,32,50-100,1977,1.0624458606078484
STAT,1850,31,20-24,1881,2.9413178734817045
SIM,1841,38,40-44,1879,10
STAT,1836,54,45-49,1890,0.012849000573071557
SIM,1975,19,na,1994,5338
STAT,1901,24,40-44,1925,3.347353990634394
STAT,1986,22,45-49,2008,1.8563397136412056
SIM,1873,34,20-24,1907,1
SIM,1861,22,25-29,1883,111
SIM,1923,59,na,1982,4943
STAT,1970,28,na,1998,5432.586218621347
STAT,1907,48,45-49,1955,0.2232003868172896
SIM,1830,62,na,1892,1278
STAT,1846,36,25-29,1882,3.1407064530993725
SIM,1946,20,20-24,1966,227
STAT,1972,39,30-34,2011,2.76859349180108
STAT,1871,20,35-39,1891,6.739843749174056
STAT,1842,43,30-34,1885,0.9036648219793579
STAT,1945,23,15-19,1968,6.730672453094754
SIM,1792,83,na,1875,58
STAT,1973,22,15-19,1995,7.971345862540091
SIM,1912,71,na,1983,2353
STAT,1938,46,30-34,1984,0.10587254495327612
STAT,1944,36,45-49,1980,0.8730891070907231
STAT,1968,7,na,1975,5665.654106336792
STAT,1845,43,50-100,1888,0.7157077273767741
STAT,1909,52,na,1961,3834.588881378137
STAT,1888,38,20-24,1926,1.0405272779329355
STAT,1851,43,40-44,1894,1.7707793182446263
SIM,1897,52,na,1949,3233
STAT,1976,23,45-49,1999,1.7399508394033387
SIM,1928,19,50-100,1947,3
SIM,1944,17,na,1961,4647
SIM,1953,23,15-19,1976,4
STAT,1841,65,na,1906,1502.529030739644
STAT,1929,41,50-100,1970,0.17583849657753928
STAT,1897,18,na,1915,3887.137182725566
SIM,1877,48,na,1925,3006
SIM,1904,18,20-24,1922,33
SIM,1952,36,45-49,1988,2
SIM,1913,39,45-49,1952,2
STAT,1864,38,35-39,1902,7.252082721029345
STAT,1836,32,35-39,1868,11.653760079951066
SIM,1854,36,25-29,1890,1
SIM,1858,33,40-44,1891,1
SIM,1866,60,na,1926,1889
SIM,1810,48,na,1858,1465
SIM,1949,26,45-49,1975,2
STAT,1930,19,35-39,1949,6.227894738251083
SIM,1810,58,na,1868,1158
STAT,1837,38,25-29,1875,2.5121878479273376
STAT,1934,49,15-19,1983,5.891083043164921E-4
STAT,1930,30,45-49,1960,2.3465454922230315
SIM,1845,38,25-29,1883,5
STAT,1870,38,50-100,1908,1.3899043482637505
STAT,1978,33,50-100,2011,1.326514360834131
STAT,1850,42,na,1892,2376.3673155691827
SIM,1850,43,30-34,1893,2
SIM,1969,26,30-34,1995,6
STAT,1941,30,20-24,1971,2.9595107181566913
STAT,1929,46,20-24,1975,0.016572670856508244
SIM,1835,25,35-39,1860,4
STAT,1848,38,na,1886,2553.04242457349
SIM,1999,4,na,2003,6976
STAT,1905,39,45-49,1944,0.7114671945038564
SIM,1877,31,35-39,1908,30
SIM,1914,35,30-34,1949,5
STAT,1960,39,15-19,1999,0.02967386054718606
SIM,1849,26,40-44,1875,9
SIM,1867,31,40-44,1898,15
SIM,1968,24,na,1992,4687
STAT,1947,32,15-19,1979,0.17027859003065307
SIM,1962,19,20-24,1981,6
STAT,1904,27,50-100,1931,1.0601105052421875
STAT,1898,72,na,1970,2427.748167363113
SIM,1852,36,40-44,1888,5
STAT,1848,45,25-29,1893,0.0618117490241198
STAT,1921,19,25-29,1940,56.67908636349614
SIM,1844,32,35-39,1876,18
STAT,1967,16,45-49,1983,0.7203237951208783
STAT,1970,26,45-49,1996,2.5076766087763644
STAT,1837,60,na,1897,1381.0424344138876
STAT,1919,33,15-19,1952,0.15928603226555185
STAT,1859,31,40-44,1890,4.003056352305113
SIM,1957,28,50-100,1985,3
STAT,1825,53,40-44,1878,0.013888010674784502
STAT,1890,28,35-39,1918,13.55825526431602
STAT,1902,38,15-19,1940,0.019665946671527264
STAT,1829,34,na,1863,2037.9142613577933
SIM,1975,16,45-49,1991,5
STAT,1844,36,40-44,1880,4.296179498716314
STAT,1967,45,35-39,2012,0.19423343805545867
SIM,1972,15,15-19,1987,72
STAT,1951,24,na,1975,5031.599164278294
SIM,1909,28,15-19,1937,1
SIM,1899,87,na,1986,649
SIM,1815,48,40-44,1863,1
STAT,1930,37,50-100,1967,0.6320900350894948
SIM,1831,28,20-24,1859,1
SIM,1959,20,30-34,1979,57
STAT,1936,38,50-100,1974,0.47547797821523285
STAT,1875,23,50-100,1898,0.484826216557375
STAT,1900,49,na,1949,3528.227519174345
STAT,1912,25,45-49,1937,1.9799769909069942
STAT,1855,8,na,1863,2485.2513550787103
SIM,1973,36,35-39,2009,4
STAT,1938,20,20-24,1958,127.15232963249257
SIM,1915,48,45-49,1963,1
SIM,1835,20,40-44,1855,5
STAT,1954,19,20-24,1973,193.29137062766773
STAT,1905,46,35-39,1951,0.13228263686021557
SIM,1858,38,35-39,1896,18
SIM,1924,39,20-24,1963,1
STAT,1836,19,15-19,1855,7.852288800680062
SIM,1885,38,45-49,1923,10
SIM,1964,31,na,1995,5772
SIM,1938,0,na,1938,4341
STAT,1906,35,30-34,1941,1.9542633714179445
STAT,1943,19,45-49,1962,0.6109794127567467
STAT,1964,15,15-19,1979,66.00048410812073
STAT,1959,29,15-19,1988,1.0692367182477878
STAT,1874,32,20-24,1906,3.1935212846037686
SIM,1882,32,20-24,1914,6
SIM,1855,23,na,1878,1704
STAT,1876,25,30-34,1901,30.245285113527956
STAT,1830,30,40-44,1860,4.88086676408087
SIM,1975,38,45-49,2013,2
SIM,1867,49,50-100,1916,1
SIM,1991,18,25-29,2009,97
STAT,1877,38,45-49,1915,2.3812013640212215
STAT,1897,28,na,1925,3669.7615318197563
STAT,1900,36,40-44,1936,1.5203160447874213
SIM,1845,42,45-49,1887,5
SIM,1844,19,15-19,1863,14
STAT,1927,20,45-49,1947,1.6090155436028597
STAT,1983,18,25-29,2001,70.72410069212543
STAT,1853,22,25-29,1875,67.34177711049776
STAT,1872,67,na,1939,1836.9539215691204
STAT,1880,24,45-49,1904,0.84765262206664
SIM,1884,25,30-34,1909,33
SIM,1909,30,45-49,1939,3
SIM,1928,15,20-24,1943,352
STAT,1923,28,25-29,1951,86.87098829520615
STAT,1955,27,40-44,1982,7.17164089617008
STAT,1978,16,20-24,1994,213.58696810367027
STAT,1931,29,45-49,1960,2.57202808886607
STAT,1910,15,na,1925,4441.674197763724
SIM,1899,20,30-34,1919,3
STAT,1940,23,50-100,1963,0.7735460903576405
STAT,1958,22,50-100,1980,1.0006436693199938
STAT,1831,36,30-34,1867,5.3252770102053635
STAT,1863,15,na,1878,2674.591868302568
SIM,1871,32,45-49,1903,1
SIM,1974,26,25-29,2000,11
SIM,1978,23,40-44,2001,6
SIM,1917,6,na,1923,5837
STAT,1920,63,na,1983,4208.7553853081345
STAT,1965,36,35-39,2001,3.5935104558586892
SIM,1958,33,45-49,1991,6
SIM,1840,26,20-24,1866,14
STAT,1864,40,50-100,1904,1.0995964366083073
STAT,1941,23,30-34,1964,34.274504085702155
STAT,1909,15,45-49,1924,0.11370489303479824
STAT,1823,46,na,1869,1494.4034535551089
SIM,1848,41,na,1889,1756
STAT,1976,39,15-19,2015,0.030438342786384312
STAT,1935,70,na,2005,4694.027235571673
STAT,1966,47,40-44,2013,0.23638377193645832
STAT,1846,43,15-19,1889,0.014265247238277613
STAT,1873,47,25-29,1920,0.06756455012293502
SIM,1881,21,15-19,1902,7
SIM,1927,15,na,1942,4494
STAT,1838,28,15-19,1866,0.49642097142669883
STAT,1892,40,na,1932,3376.789201289171
SIM,1970,35,na,2005,5985
STAT,1846,108,na,1954,0.0018936030678039719
STAT,1870,26,40-44,1896,3.4198212937065047
STAT,1917,29,45-49,1946,2.075984593988632
SIM,1958,35,35-39,1993,5
STAT,1904,26,30-34,1930,41.87514059688363
STAT,1866,44,30-34,1910,1.2131568700566746
SIM,1963,27,40-44,1990,17
SIM,1827,73,na,1900,526
SIM,1889,24,50-100,1913,1
STAT,1912,49,30-34,1961,0.09838535144085042
SIM,1874,44,30-34,1918,7
STAT,1802,88,na,1890,65.53337224765264
STAT,1876,23,40-44,1899,2.478258324970967
STAT,1955,29,30-34,1984,60.22799133754558
STAT,1897,45,20-24,1942,0.010549609096558294
STAT,1878,9,na,1887,3175.791022528878
SIM,1963,29,30-34,1992,8
SIM,1864,75,na,1939,888
STAT,1841,75,na,1916,915.2845953154389
SIM,1912,26,30-34,1938,42
STAT,1822,36,50-100,1858,3.125917657491393
STAT,1886,42,40-44,1928,2.734697544153268
STAT,1951,43,45-49,1994,0.23731210986101894
STAT,1988,2,na,1990,6495.255353578508
SIM,1872,38,35-39,1910,6
SIM,1983,30,20-24,2013,2
STAT,1877,23,25-29,1900,68.5078584425983
SIM,1925,29,45-49,1954,1
STAT,1854,38,na,1892,1909.8872308840498
STAT,1942,39,15-19,1981,0.02381342958511343
STAT,1937,46,50-100,1983,0.2643174959797139
SIM,1817,80,na,1897,94
SIM,1940,26,25-29,1966,152
STAT,1904,15,na,1919,4204.929322050677
STAT,1905,16,20-24,1921,29.685090219039587
STAT,1929,39,30-34,1968,2.6947062861413857
STAT,1832,26,20-24,1858,11.353353295934733
STAT,1791,98,na,1889,0.6622438216567602
STAT,1872,26,25-29,1898,49.18720006446128
STAT,1955,36,20-24,1991,0.41644730026025134
STAT,1840,80,na,1920,496.2388868931008
STAT,1827,32,25-29,1859,17.736091582026123
STAT,1903,30,na,1933,3954.0938318398044
SIM,1961,37,50-100,1998,1
STAT,1898,23,50-100,1921,0.6340573681376271
STAT,1848,48,na,1896,2360.4812151369206
STAT,1949,48,15-19,1997,5.128378272780502E-4
STAT,1915,40,20-24,1955,0.02057958162649585
STAT,1981,17,40-44,1998,2.2571275852888695
STAT,1919,31,50-100,1950,1.0333893170506874
SIM,1911,31,na,1942,4802
STAT,1975,30,20-24,2005,3.7895904600607717
STAT,1785,98,na,1883,0.3994927787886925
SIM,1974,32,na,2006,6246
SIM,1963,36,20-24,1999,1
STAT,1862,22,35-39,1884,5.817995549863551
SIM,1883,23,50-100,1906,1
SIM,1954,49,30-34,2003,1
SIM,1835,21,50-100,1856,1
STAT,1915,33,30-34,1948,18.442995410722336
STAT,1931,36,35-39,1967,3.7009557675947122
STAT,1956,30,15-19,1986,0.2002543927670471
SIM,1923,33,30-34,1956,42
STAT,1811,53,50-100,1864,0.04405716728460964
STAT,1930,69,na,1999,4488.011448055475
STAT,1853,20,35-39,1873,6.964307340484819
SIM,1885,23,25-29,1908,145
STAT,1867,19,45-49,1886,0.07110869251042473
STAT,1932,26,25-29,1958,99.56043498789914
STAT,1945,6,na,1951,4995.520806581424
STAT,1816,53,30-34,1869,0.011424366375885038
STAT,1992,16,25-29,2008,71.80421063253038
STAT,1973,40,15-19,2013,0.002388618774807242
STAT,1949,21,na,1970,4919.155079071651
STAT,1916,49,15-19,1965,4.3352194167061114E-4
SIM,1958,28,45-49,1986,1
SIM,1863,37,30-34,1900,2
SIM,1923,36,35-39,1959,1
SIM,1926,24,35-39,1950,26
STAT,1933,15,50-100,1948,0.5817367584385584
SIM,1866,21,30-34,1887,45
STAT,1876,28,35-39,1904,11.47044898802796
SIM,1987,17,20-24,2004,199
STAT,1866,67,na,1933,1695.6470690389988
SIM,1813,49,35-39,1862,1
STAT,1961,3,na,1964,5865.193201865129
STAT,1815,43,20-24,1858,0.34409678955173045
SIM,1896,37,50-100,1933,6
SIM,1898,29,40-44,1927,1
STAT,1896,33,na,1929,3622.0708518836423
SIM,1984,29,20-24,2013,52
SIM,1971,25,25-29,1996,106
STAT,1896,27,25-29,1923,64.47946786570027
SIM,1861,20,35-39,1881,15
STAT,1890,55,na,1945,2915.7246679275913
STAT,1976,29,20-24,2005,28.237595979836065
SIM,1884,28,35-39,1912,8
SIM,1886,15,na,1901,2306
SIM,1974,24,na,1998,5556
STAT,1868,37,40-44,1905,4.853633397738602
STAT,1907,45,40-44,1952,0.1656099734354229
SIM,1804,58,na,1862,1050
SIM,1859,23,30-34,1882,44
SIM,1876,22,na,1898,2837
STAT,1818,49,45-49,1867,0.2830736889866934
SIM,1979,35,25-29,2014,3
SIM,1858,35,30-34,1893,8
STAT,1838,48,35-39,1886,0.12319647835487538
STAT,1830,33,45-49,1863,1.849837128378122
STAT,1941,33,25-29,1974,11.194754956489227
STAT,1955,39,25-29,1994,1.5507481780772259
STAT,1805,49,35-39,1854,0.5115326010490361
SIM,1937,37,40-44,1974,2
STAT,1819,37,45-49,1856,5.892470003678974
STAT,1880,21,40-44,1901,2.5566965579706165
SIM,1856,49,na,1905,1966
STAT,1888,36,30-34,1924,7.264768077853338
SIM,1919,38,35-39,1957,10
STAT,1891,46,30-34,1937,0.0781027449015676
STAT,1930,16,30-34,1946,18.23276097509679
STAT,1915,36,35-39,1951,2.833910409064789
SIM,1876,37,40-44,1913,2
SIM,1834,35,45-49,1869,3
SIM,1835,23,45-49,1858,1
STAT,1843,102,na,1945,0.2941662036654007
SIM,1861,23,na,1884,1690
SIM,1845,61,na,1906,1736
STAT,1888,37,50-100,1925,1.6655246459449788
SIM,1955,58,na,2013,6002
STAT,1881,34,na,1915,2633.530334556827
STAT,1826,35,45-49,1861,1.679181761858427
STAT,1866,20,45-49,1886,0.7629046144905309
STAT,1831,29,40-44,1860,3.0780815273922646
STAT,1856,33,15-19,1889,0.12560677480693735
STAT,1932,47,40-44,1979,0.24687906419526148
STAT,1844,39,45-49,1883,1.7257661239365067
STAT,1856,26,50-100,1882,0.5878421603478371
STAT,1929,37,40-44,1966,2.2180462913872194
SIM,1807,69,na,1876,712
SIM,1959,23,35-39,1982,13
STAT,1859,34,45-49,1893,1.589378822337244
STAT,1874,35,25-29,1909,3.43392514325746
STAT,1945,17,20-24,1962,170.91439346494644
STAT,1808,79,na,1887,399.3456221532245
STAT,1848,42,20-24,1890,0.16853549597395379
STAT,1887,48,30-34,1935,0.12362060504550962
SIM,1941,35,40-44,1976,2
STAT,1897,106,na,2003,1.1561461712435825
SIM,1867,21,15-19,1888,4
SIM,1878,88,na,1966,217
SIM,1969,28,20-24,1997,32
STAT,1936,47,na,1983,4204.746931694632
STAT,1958,21,35-39,1979,14.323936130924524
SIM,1961,3,na,1964,5671
STAT,1966,0,na,1966,5709.425179238528
SIM,1885,74,na,1959,1797
SIM,1849,29,45-49,1878,6
STAT,1852,25,45-49,1877,1.2369601779239376
STAT,1963,25,25-29,1988,97.00457623654266
STAT,1893,66,na,1959,2508.9624452937924
STAT,1805,58,na,1863,1264.6694706923083
STAT,1840,15,25-29,1855,5.955598903827148
STAT,1795,64,na,1859,725.4685743548188
SIM,1774,95,na,1869,6
STAT,1951,40,40-44,1991,0.35820840987503516
STAT,1851,53,35-39,1904,0.006717325582222388
STAT,1827,30,35-39,1857,19.406961604795175
SIM,1882,35,25-29,1917,8
STAT,1877,1,na,1878,4134.926728632245
STAT,1832,24,30-34,1856,18.489223008103558
SIM,1958,30,40-44,1988,1
STAT,1851,68,na,1919,1211.8527517777698
STAT,1918,24,35-39,1942,11.643857284545781
STAT,1858,21,30-34,1879,18.532281272369563
STAT,1837,42,45-49,1879,1.2788404313076567
STAT,1963,15,30-34,1978,17.880227531096956
SIM,1835,30,35-39,1865,21
SIM,1870,75,na,1945,1594
STAT,1941,26,35-39,1967,17.936112183343305
STAT,1859,21,15-19,1880,3.482854673544729
STAT,1865,49,40-44,1914,0.17454104297970924
SIM,1873,49,40-44,1922,1
SIM,1834,24,na,1858,1989
STAT,1841,33,20-24,1874,2.8857542753254313
SIM,1926,29,na,1955,5874
STAT,1923,18,30-34,1941,16.46802134581356
SIM,1948,16,35-39,1964,11
STAT,1842,46,35-39,1888,0.10914089819399907
SIM,1871,25,20-24,1896,24
SIM,1837,35,na,1872,2500
SIM,1848,30,45-49,1878,2
SIM,1925,24,50-100,1949,1
STAT,1896,34,15-19,1930,0.2152115708932178
SIM,1895,30,40-44,1925,13
STAT,1904,29,35-39,1933,15.876103118781046
STAT,1927,18,15-19,1945,64.93645256008497
SIM,1975,35,40-44,2010,4
STAT,1822,61,na,1883,1630.0748393231727
STAT,1917,24,50-100,1941,0.8020246811758436
SIM,1936,29,20-24,1965,21
STAT,1833,51,25-29,1884,0.0026381151628220773
STAT,1853,15,35-39,1868,0.6649800459526484
SIM,1931,25,20-24,1956,4
SIM,1905,28,30-34,1933,53
STAT,1859,85,na,1944,252.01307344455535
SIM,1877,1,na,1878,4055
STAT,1801,62,na,1863,1029.377268756449
STAT,1868,52,na,1920,2374.653471844585
SIM,1861,15,35-39,1876,1
STAT,1855,39,20-24,1894,0.6493104208359937
STAT,1916,39,20-24,1955,0.30843208577859427
STAT,1845,24,40-44,1869,1.71826227922427
STAT,1921,48,na,1969,4764.462015891297
STAT,1923,25,20-24,1948,24.341055640937814
STAT,1876,102,na,1978,5.776122466262839
SIM,1899,23,35-39,1922,22
SIM,1946,43,na,1989,4615
STAT,1928,29,20-24,1957,25.926778035704917
SIM,1912,29,35-39,1941,37
STAT,1870,29,45-49,1899,1.254190256905595
SIM,1841,26,50-100,1867,1
STAT,1956,43,50-100,1999,0.18614469721966884
SIM,1925,44,na,1969,5275
STAT,1823,87,na,1910,99.76903481792834
STAT,1867,16,40-44,1883,0.20266441653569897
SIM,1953,17,20-24,1970,4
STAT,1833,26,50-100,1859,0.6088736629028164
STAT,1831,39,35-39,1870,6.850455537465615
STAT,1905,26,15-19,1931,0.7604301510872082
STAT,1956,15,50-100,1971,0.5724308299745493
STAT,1976,18,45-49,1994,0.7699466087744848
STAT,1931,16,15-19,1947,68.73642821802
STAT,1869,31,35-39,1900,11.364346023309418
SIM,1904,45,na,1949,3988
SIM,1829,41,15-19,1870,2
STAT,1847,53,na,1900,1630.1631237139477
STAT,1942,47,na,1989,4609.357833590497
STAT,1975,27,50-100,2002,1.5219391680457184
SIM,1983,27,50-100,2010,3
STAT,1908,66,na,1974,3288.6465153520617
SIM,1818,42,35-39,1860,5
STAT,1887,30,40-44,1917,5.65385938404314
STAT,1967,42,30-34,2009,0.19152911451716162
SIM,1840,29,25-29,1869,77
SIM,1878,37,25-29,1915,4
STAT,1948,42,25-29,1990,0.09800841462648176
SIM,1935,18,15-19,1953,132
STAT,1832,29,25-29,1861,39.03118927811034
STAT,1905,19,25-29,1924,9.414502754719576
STAT,1847,31,15-19,1878,0.12999931850351845
SIM,1913,21,20-24,1934,2
STAT,1837,35,20-24,1872,0.6938709981118403
STAT,1900,15,25-29,1915,9.11660889850643
STAT,1894,27,40-44,1921,4.444036483267727
STAT,1840,22,15-19,1862,3.3655378177024344
SIM,1885,20,20-24,1905,1
SIM,1928,21,15-19,1949,9
SIM,1796,79,na,1875,313
STAT,1937,28,35-39,1965,16.890619826047857
SIM,1945,35,25-29,1980,3
SIM,1874,20,45-49,1894,1
STAT,1998,15,15-19,2013,76.94117780574872
SIM,1967,46,na,2013,5623
STAT,1994,12,na,2006,6541.717592617194
SIM,1869,40,40-44,1909,2
STAT,1836,20,na,1856,2600.1984892709447
SIM,1919,44,na,1963,5327
STAT,1869,37,na,1906,2633.059663587737
STAT,1891,39,40-44,1930,6.180871659132907
STAT,1929,49,25-29,1978,0.07888642346897241
STAT,1863,32,45-49,1895,1.7597086940750521
STAT,1886,45,45-49,1931,0.2901495434014583
STAT,1905,21,20-24,1926,115.45359216479198
SIM,1904,38,40-44,1942,3
SIM,1927,27,20-24,1954,37
SIM,1911,93,na,2004,394
SIM,1913,19,25-29,1932,10
STAT,1877,105,na,1982,1.1296517006739002
SIM,1815,95,na,1910,17
SIM,1914,34,35-39,1948,11
SIM,1845,35,20-24,1880,3
STAT,1817,87,na,1904,121.80436703672508
STAT,1808,101,na,1909,0.29095476804189097
SIM,1992,20,na,2012,6060
STAT,1838,86,na,1924,192.1913764726855
STAT,1938,25,15-19,1963,0.808229293645889
STAT,1895,21,35-39,1916,8.792476684109202
SIM,1933,3,na,1936,6746
SIM,1851,61,na,1912,2246
STAT,1889,51,na,1940,3077.7699715711283
STAT,1920,37,20-24,1957,0.33294060740457415
STAT,1829,49,20-24,1878,0.011923762897878503
STAT,1975,33,25-29,2008,14.334645360653663
SIM,1884,23,40-44,1907,6
STAT,1907,81,na,1988,1794.1414789104454
STAT,1980,27,20-24,2007,29.370725681574548
SIM,1950,29,20-24,1979,1
STAT,1859,32,50-100,1891,0.8423088543358357
STAT,1915,43,25-29,1958,0.08285163622875041
STAT,1853,53,na,1906,2109.3146837815793
STAT,1976,20,40-44,1996,5.204809137885518
SIM,1984,4,na,1988,6307
STAT,1937,35,25-29,1972,1.1388159533472129
SIM,1867,32,50-100,1899,2
STAT,1942,29,20-24,1971,22.091675891747364
SIM,1968,17,15-19,1985,122
STAT,1919,27,20-24,1946,22.756135119715488
SIM,1871,16,na,1887,2262
STAT,1880,31,50-100,1911,1.1253695981820695
SIM,1910,29,25-29,1939,1
SIM,1905,77,na,1982,1856
STAT,1955,47,20-24,2002,0.017610243383671988
STAT,1906,34,35-39,1940,9.702047936701323
STAT,1851,43,na,1894,1819.5614319427907
STAT,1862,46,20-24,1908,0.011720371476974252
STAT,1930,18,20-24,1948,201.77519830066436
SIM,1816,42,25-29,1858,3
STAT,1921,23,20-24,1944,144.4385747731057
STAT,1970,37,45-49,2007,1.014619726068169
SIM,1793,84,na,1877,254
STAT,1877,30,25-29,1907,12.394516811391934
STAT,1960,45,50-100,2005,0.355280061821249
SIM,1850,39,50-100,1889,2
STAT,1893,17,40-44,1910,0.26680408198580596
SIM,1876,21,50-100,1897,4
SIM,1913,72,na,1985,3413
STAT,1852,27,50-100,1879,0.7024677248403954
STAT,1914,42,15-19,1956,0.0017569370521531146
SIM,1884,42,na,1926,2617
SIM,1919,29,15-19,1948,2
SIM,1985,23,40-44,2008,5
SIM,1839,55,na,1894,1733
SIM,1876,43,35-39,1919,3
STAT,1859,23,na,1882,2239.609857485559
STAT,1836,48,15-19,1884,3.762484503380705E-4
STAT,1843,48,na,1891,2229.0825039530696
STAT,1838,61,na,1899,1618.6308803964896
STAT,1902,29,25-29,1931,68.48488403028273
SIM,1841,16,30-34,1857,3
SIM,1785,89,na,1874,30
STAT,1892,30,20-24,1922,3.9412244886630887
SIM,1920,36,30-34,1956,2
STAT,1958,35,50-100,1993,0.6567737226789393
STAT,1810,47,40-44,1857,0.666220331908338
STAT,1910,23,45-49,1933,1.2169059294939157
SIM,1800,71,na,1871,894
STAT,1929,59,na,1988,5167.844590920279
STAT,1911,16,15-19,1927,10.515326028041269
SIM,1832,29,40-44,1861,6
STAT,1930,29,30-34,1959,57.44794881052547
STAT,1904,39,30-34,1943,1.8871829782572251
SIM,1872,49,35-39,1921,1
SIM,1931,35,50-100,1966,1
SIM,1858,34,na,1892,2522
SIM,1854,20,na,1874,3010
SIM,1942,23,30-34,1965,48
SIM,1970,5,na,1975,6049
STAT,1911,16,50-100,1927,0.08680784727740846
STAT,1932,24,35-39,1956,14.212116363480437
STAT,1916,41,40-44,1957,0.29626382618609254
SIM,1964,24,20-24,1988,5
SIM,1997,2,na,1999,6617
STAT,1977,23,40-44,2000,5.258498288611645
SIM,1891,43,30-34,1934,5
SIM,1935,31,45-49,1966,5
STAT,1876,17,35-39,1893,0.6545984046783713
STAT,1937,19,15-19,1956,50.827947966902386
STAT,1896,15,na,1911,3867.632802936228
STAT,1894,37,50-100,1931,1.8214045216530248
SIM,1991,21,15-19,2012,1
STAT,1904,83,na,1987,1461.788812223387
STAT,1866,40,20-24,1906,0.17159035712116832
STAT,1881,65,na,1946,1881.1464562548251
STAT,1956,24,20-24,1980,170.24789592875058
STAT,1870,40,40-44,1910,2.584877321730697
STAT,1818,43,50-100,1861,1.373352866379138
STAT,1843,25,50-100,1868,0.8013839586750664
STAT,1883,43,30-34,1926,1.288704481815107
SIM,1825,47,na,1872,1618
SIM,1821,33,na,1854,1752
SIM,1953,7,na,1960,5700
SIM,1945,19,15-19,1964,50
SIM,1965,36,na,2001,5574
SIM,1905,47,45-49,1952,1
STAT,1940,32,15-19,1972,0.15353398860520828
STAT,1870,22,na,1892,2690.7730038345703
STAT,1864,49,35-39,1913,0.14124974423713826
STAT,1950,36,na,1986,5293.784188693929
SIM,1959,26,na,1985,5966
STAT,1865,27,30-34,1892,26.220805991794386
STAT,1934,23,30-34,1957,44.5822382039633
STAT,1915,29,35-39,1944,17.54933501227103
SIM,1885,30,25-29,1915,17
SIM,1838,73,na,1911,595
STAT,1978,34,na,2012,6063.89173051096
SIM,1967,21,na,1988,5400
SIM,1906,23,20-24,1929,2
STAT,1835,19,45-49,1854,0.0914223292299183
SIM,1923,29,35-39,1952,32
SIM,1973,31,na,2004,5296
STAT,1944,47,30-34,1991,0.11516324094252657
SIM,1938,48,na,1986,4036
SIM,1934,34,na,1968,5679
SIM,1892,77,na,1969,1998
SIM,1916,33,30-34,1949,41
STAT,1830,27,15-19,1857,0.570336591284376
STAT,1942,31,40-44,1973,4.814373363219703
SIM,1896,24,50-100,1920,2
STAT,1938,34,25-29,1972,10.716555698409474
STAT,1983,32,25-29,2015,15.38060705396321
STAT,1849,40,15-19,1889,0.010890628825309275
STAT,1910,93,na,2003,352.1898269311412
STAT,1831,82,na,1913,366.06521360832744
STAT,1869,7,na,1876,3081.8985477331557
STAT,1777,110,na,1887,0.0015156522538300743
STAT,1869,21,30-34,1890,19.96725710148308
SIM,1863,80,na,1943,267
STAT,1894,33,35-39,1927,14.960498587603212
STAT,1999,16,25-29,2015,73.90270174761443
STAT,1984,19,45-49,2003,0.8182308140299083
STAT,1865,16,20-24,1881,19.135339906468268
STAT,1908,33,30-34,1941,17.111880924515734
STAT,1861,29,50-100,1890,0.6093390873826449
STAT,1899,38,40-44,1937,1.486457740920269
STAT,1894,44,45-49,1938,0.15210268696189724
SIM,1926,39,na,1965,5820
SIM,1955,37,30-34,1992,1
STAT,1830,38,25-29,1868,2.8660785004992757
STAT,1879,54,20-24,1933,8.647541918033666E-4
SIM,1950,31,40-44,1981,16
STAT,1839,37,30-34,1876,5.0508643156428406
STAT,1924,85,na,2009,1660.859260945772
SIM,1912,39,30-34,1951,3
SIM,1905,21,na,1926,4418
SIM,1966,27,35-39,1993,53
SIM,1846,25,na,1871,1788
SIM,1946,34,25-29,1980,26
STAT,1867,58,na,1925,2130.838401788516
STAT,1944,24,50-100,1968,0.8193645870776538
STAT,1805,74,na,1879,573.0410198894251
STAT,1928,24,15-19,1952,7.621937374606537
STAT,1792,90,na,1882,46.24509189703806
STAT,1904,28,20-24,1932,19.373151883222675
STAT,1947,37,30-34,1984,2.4409289151304043
SIM,1877,21,30-34,1898,54
STAT,1886,5,na,1891,3190.1324812632733
SIM,1851,55,na,1906,2415
STAT,1844,42,35-39,1886,1.551208849068619
STAT,1983,21,15-19,2004,8.721943911922478
STAT,1912,36,30-34,1948,2.064740670506394
STAT,1784,79,na,1863,287.20040384878405
STAT,1862,27,na,1889,2332.880837649983
SIM,1858,27,35-39,1885,23
SIM,1964,9,na,1973,5976
STAT,1988,26,20-24,2014,30.272718028455653
STAT,1780,106,na,1886,0.018671455705445407
STAT,1844,53,45-49,1897,0.01194361457099094
STAT,1964,42,na,2006,5610.063196131452
SIM,1901,25,40-44,1926,10
SIM,1912,28,20-24,1940,23
STAT,1798,87,na,1885,53.32986546534584
STAT,1899,31,15-19,1930,0.22607669487015578
STAT,1927,31,45-49,1958,2.2346746805453614
STAT,1823,42,20-24,1865,0.16686457692441758
SIM,1847,37,30-34,1884,14
SIM,1898,34,na,1932,3859
STAT,1889,17,20-24,1906,25.220063967015133
STAT,1840,48,35-39,1888,0.11181214846801889
SIM,1814,63,na,1877,875
STAT,1834,20,30-34,1854,34.13600071167429
STAT,1931,57,na,1988,5421.233771588288
SIM,1922,33,50-100,1955,1
STAT,1897,96,na,1993,128.93942887406186
SIM,1830,36,50-100,1866,3
SIM,1854,42,50-100,1896,4
STAT,1829,39,50-100,1868,1.351118251464006
STAT,1889,45,na,1934,3232.462500105007
SIM,1972,24,25-29,1996,157
STAT,1839,26,20-24,1865,11.805239784323916
STAT,1976,1,na,1977,6070.918153350929
SIM,1876,47,na,1923,2500
STAT,1950,42,25-29,1992,0.10126425361009894
STAT,1964,24,25-29,1988,134.6127929191874
STAT,1890,39,35-39,1929,9.873288892343979
STAT,1856,74,na,1930,977.1125492789852
STAT,1881,30,45-49,1911,1.95670206219517
SIM,1894,20,na,1914,3563
STAT,1924,16,25-29,1940,59.68446334022147
SIM,1881,93,na,1974,15
SIM,1897,17,20-24,1914,47
STAT,1953,21,45-49,1974,1.5765139643255253
STAT,1960,16,35-39,1976,6.308899958004638
STAT,1834,32,25-29,1866,11.973158770103462
STAT,1953,34,20-24,1987,3.4665307261908778
STAT,1973,29,40-44,2002,6.979969466947311
SIM,1868,12,na,1880,3383
STAT,1888,114,na,2002,6.951692311772715E-4
STAT,1889,28,30-34,1917,35.696899766736514
STAT,1957,40,15-19,1997,0.0024350645491680264
SIM,1933,74,na,2007,4243
STAT,1901,19,na,1920,4060.7045735297834
SIM,1897,28,30-34,1925,83
STAT,1845,21,45-49,1866,0.5875612277482775
STAT,1913,44,na,1957,4167.978195657495
SIM,1817,68,na,1885,564
SIM,1847,26,20-24,1873,17
STAT,1911,3,na,1914,4672.745638856856
SIM,1842,32,25-29,1874,19
SIM,1932,16,25-29,1948,152
STAT,1835,96,na,1931,5.351667965153585
SIM,1898,32,30-34,1930,8
STAT,1923,37,45-49,1960,0.9112433649393511
SIM,1836,23,40-44,1859,4
SIM,1853,21,45-49,1874,1
STAT,1997,13,na,2010,6618.518404572156
STAT,1906,20,20-24,1926,116.66278547247819
STAT,1921,26,25-29,1947,84.91642986536692
SIM,1932,4,na,1936,5810
STAT,1913,100,na,2013,39.1632047507009
STAT,1851,46,45-49,1897,0.1876781240606568
STAT,1905,7,na,1912,4351.784587530231
SIM,1883,47,50-100,1930,1
SIM,1837,19,15-19,1856,11
STAT,1944,33,40-44,1977,4.951147334503227
STAT,1846,96,na,1942,8.876732839039176
STAT,1920,14,na,1934,5111.440613723367
STAT,1865,2,na,1867,3531.2556125803158
STAT,1932,6,na,1938,6126.344417600096
STAT,1875,103,na,1978,3.236341192707726
STAT,1875,47,50-100,1922,0.2915359125807593
STAT,1966,36,40-44,2002,2.225087211103172
SIM,1836,26,45-49,1862,6
SIM,1910,26,20-24,1936,1
STAT,1910,20,40-44,1930,3.669521004055612
SIM,1938,37,25-29,1975,1
SIM,1914,20,20-24,1934,229
STAT,1916,44,45-49,1960,0.19619144460931676
SIM,1862,39,25-29,1901,9
STAT,1902,26,20-24,1928,19.19528097506739
STAT,1847,46,25-29,1893,0.0444464046128109
SIM,1879,12,na,1891,3073
SIM,1851,26,40-44,1877,6
STAT,1828,26,45-49,1854,2.8252098484206534
SIM,1964,27,25-29,1991,193
STAT,1953,26,50-100,1979,1.3961975080953877
STAT,1862,49,25-29,1911,0.05492721237064752
STAT,1864,53,na,1917,2183.089687043177
SIM,1951,38,50-100,1989,4
SIM,1986,19,15-19,2005,149
SIM,1985,26,45-49,2011,1
STAT,1862,38,15-19,1900,0.05441948162565027
SIM,1917,49,50-100,1966,1
STAT,1931,33,30-34,1964,23.815069879307263
SIM,1936,44,50-100,1980,1
SIM,1961,26,50-100,1987,3
STAT,1953,46,15-19,1999,5.362438957065359E-4
STAT,1975,22,35-39,1997,14.382814597249633
STAT,1886,39,15-19,1925,0.06766958547708053
STAT,1956,27,25-29,1983,100.946886942668
STAT,1921,35,15-19,1956,0.02477887631354861
SIM,1906,26,25-29,1932,4
SIM,1838,31,20-24,1869,6
STAT,1878,17,45-49,1895,0.07871071548620713
STAT,1928,44,50-100,1972,0.17225779284399173
STAT,1913,16,25-29,1929,10.255653025077695
STAT,1970,23,40-44,1993,4.871808486660461
SIM,1921,16,25-29,1937,83
STAT,1891,17,30-34,1908,2.2733649644375755
STAT,1896,6,na,1902,3981.9799209227544
SIM,1916,34,45-49,1950,1
STAT,1843,26,40-44,1869,3.725791668130959
STAT,1825,45,35-39,1870,0.20099627944676018
STAT,1956,47,na,2003,5835.410608394342
STAT,1926,70,na,1996,4099.523076667533
STAT,1872,88,na,1960,256.8378518742381
STAT,1949,2,na,1951,5383.963551275407
STAT,1879,103,na,1982,4.011918512470394
STAT,1893,10,na,1903,3778.5565637863842
STAT,1943,27,15-19,1970,0.8677512396021737
STAT,1927,44,20-24,1971,0.025469990205244476
STAT,1905,43,30-34,1948,0.13238742240873846
SIM,1970,25,na,1995,5549
STAT,1875,53,na,1928,2526.628209704292
SIM,1905,44,40-44,1949,1
STAT,1854,16,45-49,1870,0.06403866955348483
STAT,1956,47,50-100,2003,0.3592613403771997
STAT,1873,16,50-100,1889,0.05807851434666537
SIM,1946,31,20-24,1977,2
STAT,1869,112,na,1981,0.001908967437032211
SIM,1882,16,na,1898,3477
STAT,1918,59,na,1977,4241.679284478491
STAT,1840,43,na,1883,1909.4550243893957
SIM,1863,40,45-49,1903,1
STAT,1822,102,na,1924,0.24088039651346574
SIM,1930,82,na,2012,2461
SIM,1931,34,40-44,1965,16
STAT,1908,34,45-49,1942,1.7016297739152506
SIM,1796,89,na,1885,141
STAT,1957,31,25-29,1988,14.343356121114393
STAT,1982,17,25-29,1999,70.37302512716906
SIM,1833,45,35-39,1878,2
STAT,1843,91,na,1934,58.14373635728062
STAT,1932,80,na,2012,2926.1339538087173
STAT,1869,24,35-39,1893,6.4809535386843775
SIM,1864,21,20-24,1885,154
STAT,1951,26,40-44,1977,6.435963837163798
STAT,1909,27,15-19,1936,0.7794773227991413
STAT,1904,23,15-19,1927,5.45031227815488
SIM,1902,72,na,1974,2661
STAT,1973,18,40-44,1991,2.0869771964594643
SIM,1884,17,35-39,1901,1
STAT,1957,42,35-39,1999,0.31841397326750454
SIM,1981,18,40-44,1999,6
SIM,1864,81,na,1945,536
SIM,1858,24,30-34,1882,2
STAT,1923,34,40-44,1957,5.168755302343814
SIM,1849,21,25-29,1870,94
STAT,1938,31,20-24,1969,2.8334313718774338
STAT,1905,49,na,1954,3680.1800616243395
STAT,1845,74,na,1919,747.8364766958401
STAT,1967,34,na,2001,5550.273440398262
SIM,1966,24,30-34,1990,1
SIM,1957,21,25-29,1978,281
STAT,1979,23,15-19,2002,8.483593695827732
STAT,1912,22,40-44,1934,3.722296277976806
SIM,1887,47,na,1934,3608
SIM,1806,68,na,1874,837
SIM,1920,22,40-44,1942,8
STAT,1782,102,na,1884,0.11589722013893823
SIM,1950,30,50-100,1980,2
SIM,1965,31,25-29,1996,2
STAT,1948,17,25-29,1965,57.23155736439332
STAT,1913,60,na,1973,3855.5518770430494
STAT,1826,36,na,1862,1585.4286086796608
SIM,1956,17,25-29,1973,83
STAT,1864,51,50-100,1915,0.015636961669020993
STAT,1972,21,50-100,1993,0.975793662535866
STAT,1917,74,na,1991,3056.7932781345144
STAT,1938,32,50-100,1970,0.9598804136779115
SIM,1892,93,na,1985,291
SIM,1847,50,na,1897,2253
SIM,1951,46,na,1997,6232
SIM,1972,21,20-24,1993,284
STAT,1858,34,30-34,1892,15.584161541553872
STAT,1920,42,45-49,1962,0.2120357785928298
STAT,1934,24,45-49,1958,1.7447103988210741
STAT,1868,54,45-49,1922,0.015648405856517358
STAT,1898,105,na,2003,2.268774492994207
STAT,1878,45,na,1923,2737.9852386371217
STAT,1931,44,40-44,1975,0.3844228655275841
STAT,1949,21,25-29,1970,124.42625188018867
STAT,1834,48,40-44,1882,0.1635817188359981
STAT,1886,96,na,1982,89.0897450015151
STAT,1968,23,50-100,1991,0.9512640072862442
STAT,1840,45,30-34,1885,0.08033938313523556
STAT,1942,30,50-100,1972,1.0177228905451772
STAT,1942,57,na,1999,4406.978281232959
STAT,1941,19,35-39,1960,4.985809266410216
STAT,1977,26,45-49,2003,2.70671829398638
STAT,1889,61,na,1950,2658.2635401244293
SIM,1911,30,45-49,1941,5
STAT,1868,43,35-39,1911,1.9932680002798275
SIM,1825,36,40-44,1861,11
STAT,1858,23,20-24,1881,64.3116549278249
STAT,1989,18,na,2007,6082.305907371139
SIM,1917,27,15-19,1944,1
STAT,1902,15,35-39,1917,0.898897594796689
SIM,1957,32,35-39,1989,3
STAT,1874,31,na,1905,2830.82204417922
STAT,1892,65,na,1957,2504.133685676712
SIM,1898,35,35-39,1933,17
STAT,1863,111,na,1974,0.0023068381799344487
STAT,1917,37,15-19,1954,0.023019084125528267
STAT,1949,32,35-39,1981,12.502265856675292
STAT,1925,36,40-44,1961,2.0747148046833206
STAT,1970,34,40-44,2004,5.755126775959043
STAT,1873,36,25-29,1909,3.409435853980633
STAT,1784,95,na,1879,2.7071496442277905
STAT,1839,27,50-100,1866,0.6390940459357574
SIM,1835,25,na,1860,2732
SIM,1942,24,45-49,1966,4
STAT,1834,23,35-39,1857,7.07108657601469
SIM,1820,42,45-49,1862,3
STAT,1781,90,na,1871,22.16238597941925
SIM,1866,23,20-24,1889,158
STAT,1939,18,40-44,1957,1.6159064052814713
STAT,1856,21,20-24,1877,70.97673715278205
STAT,1857,36,50-100,1893,1.1088195507119722
SIM,1903,20,45-49,1923,4
SIM,1851,71,na,1922,1616
STAT,1903,30,45-49,1933,2.889496141065306
STAT,1942,34,45-49,1976,1.9322732906709954
SIM,1855,85,na,1940,16
SIM,1950,34,45-49,1984,7
STAT,1947,28,40-44,1975,6.082427452050496
STAT,1851,35,35-39,1886,5.7878123654175955
SIM,1955,28,40-44,1983,15
STAT,1857,53,30-34,1910,0.005264311601636147
STAT,1876,19,na,1895,2996.8366334832335
SIM,1947,18,40-44,1965,6
STAT,1812,42,45-49,1854,4.273045456029318
SIM,1992,16,40-44,2008,5
SIM,1842,48,40-44,1890,1
STAT,1875,30,15-19,1905,0.17119989506973096
STAT,1946,31,na,1977,4937.384132646699
STAT,1984,16,40-44,2000,2.293224712908088
SIM,1933,36,40-44,1969,6
STAT,1964,21,20-24,1985,162.21119120063264
SIM,1920,83,na,2003,1140
STAT,1907,75,na,1982,2508.641342693894
STAT,1897,37,25-29,1934,4.442986538352699
STAT,1826,102,na,1928,0.16142377690152923
SIM,1874,80,na,1954,633
SIM,1904,76,na,1980,2716
STAT,1847,23,45-49,1870,0.6530439478288016
STAT,1949,37,40-44,1986,2.0699849935986063
STAT,1889,19,40-44,1908,0.258796912208006
STAT,1910,22,30-34,1932,31.18082081871794
STAT,1955,11,na,1966,6018.874844161149
SIM,1900,62,na,1962,2972
SIM,1894,32,50-100,1926,5
STAT,1831,52,20-24,1883,6.015173089738046E-4
STAT,1981,28,30-34,2009,63.47232108119814
SIM,1872,17,na,1889,3211
STAT,1842,39,50-100,1881,0.987821332653978
STAT,1862,20,50-100,1882,0.4124703804138771
SIM,1921,47,50-100,1968,3
STAT,1999,15,50-100,2014,0.6390879002052708
STAT,1839,21,15-19,1860,3.3859337354607515
STAT,1888,32,20-24,1920,3.666900828902627
STAT,1945,29,15-19,1974,0.8929276868742292
SIM,1847,21,15-19,1868,5
SIM,1896,32,20-24,1928,2
STAT,1828,31,50-100,1859,1.092448277316325
STAT,1862,23,40-44,1885,2.0626483210306708
STAT,1936,34,15-19,1970,0.1439458606906278
SIM,1847,29,25-29,1876,9
STAT,1940,23,25-29,1963,108.5903888211964
SIM,1915,39,na,1954,4566
SIM,1855,23,45-49,1878,2
SIM,1837,18,30-34,1855,4
STAT,1876,53,35-39,1929,0.01010552286473984
STAT,1965,41,15-19,2006,0.0023026772765009245
SIM,1964,25,35-39,1989,23
SIM,1808,94,na,1902,17
SIM,1957,37,40-44,1994,3
STAT,1816,52,25-29,1868,0.006934944692071382
STAT,1820,82,na,1902,273.8370832054276
STAT,1956,25,35-39,1981,23.045969321876743
STAT,1966,39,45-49,2005,1.0102131517603459
SIM,1889,57,na,1946,3199
SIM,1885,43,na,1928,3093
STAT,1832,39,40-44,1871,3.7631339067143306
STAT,1958,24,30-34,1982,43.67839426861801
STAT,1947,16,na,1963,4786.171731363003
SIM,1840,39,40-44,1879,14
SIM,1902,19,25-29,1921,1
SIM,1871,32,na,1903,2139
SIM,1970,24,15-19,1994,7
STAT,1936,37,30-34,1973,2.0661159404392158
STAT,1910,39,25-29,1949,1.0769129825788482
STAT,1931,45,50-100,1976,0.3507324555318654
STAT,1950,40,35-39,1990,0.2863469382784905
STAT,1841,25,25-29,1866,47.39125130955882
STAT,1890,36,30-34,1926,7.551517057981265
SIM,1862,29,20-24,1891,15
STAT,1955,49,40-44,2004,0.24976684506227298
SIM,1976,36,na,2012,5962
STAT,1855,73,na,1928,1010.6534425066812
STAT,1866,38,50-100,1904,1.3067558018857897
SIM,1826,43,50-100,1869,3
STAT,1959,40,25-29,1999,0.1123382061652112
SIM,1836,63,na,1899,1094
STAT,1919,34,20-24,1953,3.010246928598551
STAT,1892,21,30-34,1913,25.842082627449024
STAT,1854,29,20-24,1883,9.876094669443875
SIM,1863,37,na,1900,2422
STAT,1886,47,20-24,1933,0.0145396323224412
STAT,1876,35,na,1911,2837.323845227117
STAT,1899,22,25-29,1921,90.50934401821105
STAT,1894,41,40-44,1935,3.351987520152316
SIM,1963,38,30-34,2001,5
STAT,1825,51,na,1876,1721.2921228155944
SIM,1922,87,na,2009,727
STAT,1830,81,na,1911,339.2306985844065
SIM,1873,19,25-29,1892,18
STAT,1843,29,45-49,1872,1.3514285571427709
STAT,1905,65,na,1970,3209.126014636984
SIM,1953,29,15-19,1982,2
STAT,1875,47,45-49,1922,0.28014037248394086
STAT,1829,65,na,1894,1238.0315916489394
SIM,1895,42,na,1937,3516
SIM,1978,33,45-49,2011,4
STAT,1845,20,30-34,1865,15.117121412759614
SIM,1940,0,na,1940,5319
SIM,1963,49,40-44,2012,1
SIM,1923,2,na,1925,5856
SIM,1927,34,20-24,1961,1
STAT,1901,2,na,1903,4308.993277515275
SIM,1848,51,na,1899,1650
STAT,1877,32,45-49,1909,2.0933624983096415
SIM,1944,37,30-34,1981,2
STAT,1962,24,15-19,1986,7.89191884674605
STAT,1969,25,45-49,1994,2.503515785566228
STAT,1875,36,35-39,1911,8.475732492508133
SIM,1883,47,45-49,1930,2
STAT,1981,34,50-100,2015,1.3582372969322156
SIM,1883,36,35-39,1919,3
SIM,1907,41,35-39,1948,1
STAT,1865,19,25-29,1884,6.008957731432491
STAT,1879,41,45-49,1920,1.8116399897239266
STAT,1912,48,25-29,1960,0.05872480871238505
SIM,1922,30,20-24,1952,9
STAT,1957,47,30-34,2004,0.14108736929131954
STAT,1898,41,na,1939,3633.611699752682
STAT,1894,30,30-34,1924,26.11038060957695
STAT,1942,33,30-34,1975,19.359522231671594
SIM,1848,41,30-34,1889,3
STAT,1837,33,50-100,1870,0.8232703534007946
SIM,1928,18,25-29,1946,1
SIM,1942,13,na,1955,5043
SIM,1869,29,30-34,1898,34
SIM,1907,30,25-29,1937,2
STAT,1817,56,na,1873,1714.9838655274516
SIM,1823,32,20-24,1855,1
SIM,1861,33,na,1894,1895
SIM,1950,33,30-34,1983,37
STAT,1871,22,50-100,1893,0.46819491978915445
SIM,1952,24,50-100,1976,1
STAT,1770,90,na,1860,13.48647587151602
STAT,1844,92,na,1936,34.83651188551274
STAT,1909,79,na,1988,2114.81878383932
SIM,1991,8,na,1999,6712
STAT,1822,86,na,1908,182.29939495303267
SIM,1948,26,na,1974,4431
STAT,1864,46,30-34,1910,0.10002994429637972
STAT,1946,40,15-19,1986,0.0020484462503358326
STAT,1962,18,na,1980,5440.9172615469415
STAT,1810,50,50-100,1860,0.05759743096265966
STAT,1866,36,na,1902,2532.2283156039052
SIM,1841,93,na,1934,13
STAT,1879,83,na,1962,723.681844462578
STAT,1862,43,na,1905,2234.7306540430764
STAT,1915,17,40-44,1932,0.337900319565284
SIM,1923,17,40-44,1940,2
SIM,1983,22,25-29,2005,329
SIM,1887,41,45-49,1928,6
STAT,1967,28,15-19,1995,1.021586794608226
STAT,1880,19,20-24,1899,21.56997166720981
STAT,1884,24,30-34,1908,20.18279528971172
SIM,1938,24,25-29,1962,210
SIM,1829,29,50-100,1858,3
SIM,1844,33,40-44,1877,8
SIM,1995,8,na,2003,6764
SIM,1933,31,35-39,1964,19
SIM,1908,23,30-34,1931,34
STAT,1969,29,30-34,1998,56.674707448988315
STAT,1866,57,na,1923,2149.625650943729
STAT,1966,25,40-44,1991,6.753458824278943
SIM,1938,35,35-39,1973,3
STAT,1916,43,30-34,1959,0.1509718154661083
STAT,1941,16,30-34,1957,14.496356278467918
STAT,1868,40,30-34,1908,1.287577250201147
STAT,1845,58,na,1903,1332.613767774205
SIM,1925,38,na,1963,5329
STAT,1806,49,40-44,1855,0.6103705366616027
SIM,1922,49,40-44,1971,1
STAT,1914,30,20-24,1944,2.8576312706274125
SIM,1860,27,50-100,1887,1
SIM,1786,71,na,1857,341
STAT,1817,39,45-49,1856,6.636649956963379
STAT,1833,30,na,1863,2003.9447376300127
STAT,1919,46,15-19,1965,4.6213476693589446E-4
STAT,1867,27,40-44,1894,3.227685438881469
STAT,1916,49,na,1965,4323.55266824275
SIM,1834,22,25-29,1856,105
SIM,1869,18,20-24,1887,10
STAT,1868,51,40-44,1919,0.011728566447817546
SIM,1840,20,20-24,1860,127
STAT,1874,104,na,1978,1.7122106428900303
SIM,1974,25,40-44,1999,1
STAT,1914,49,40-44,1963,0.17947874537579808
STAT,1842,42,25-29,1884,0.5112580372644234
SIM,1953,24,20-24,1977,157
STAT,1935,15,50-100,1950,0.5941440050220805
STAT,1925,20,25-29,1945,128.3177631041974
SIM,1939,49,na,1988,4808
SIM,1952,33,40-44,1985,15
SIM,1859,35,na,1894,2308
STAT,1846,42,50-100,1888,1.1053625998802024
SIM,1877,24,35-39,1901,5
STAT,1836,33,40-44,1869,4.938941362102511
STAT,1901,45,45-49,1946,0.21733746137799595
SIM,1888,72,na,1960,1329
SIM,1933,20,25-29,1953,170
STAT,1971,19,15-19,1990,66.29077243407208
STAT,1945,24,20-24,1969,140.54613751814404
SIM,1934,16,35-39,1950,16
STAT,1892,17,50-100,1909,0.07086353564299573
STAT,1869,68,na,1937,1707.9262783047952
SIM,1949,48,na,1997,5717
SIM,1901,47,na,1948,3866
STAT,1865,54,na,1919,2180.3454396893453
STAT,1915,26,30-34,1941,46.288491925409254
STAT,1892,33,25-29,1925,14.752734236064105
SIM,1922,3,na,1925,5559
STAT,1915,8,na,1923,4802.475761743337
SIM,1827,31,45-49,1858,3
STAT,1925,39,45-49,1964,0.9419424871908116
STAT,1847,20,40-44,1867,1.994139939270914
SIM,1861,24,50-100,1885,1
SIM,1933,39,45-49,1972,1
SIM,1853,81,na,1934,487
SIM,1862,55,na,1917,2592
STAT,1920,25,50-100,1945,1.2680793059586868
STAT,1925,31,35-39,1956,12.526695327590197
STAT,1841,81,na,1922,480.78839664268025
SIM,1903,11,na,1914,4237
SIM,1945,18,30-34,1963,20
SIM,1889,48,50-100,1937,1
STAT,1926,16,35-39,1942,5.950559702350076
SIM,1929,45,40-44,1974,1
SIM,1936,60,na,1996,3666
STAT,1855,40,45-49,1895,1.2863343742278581
STAT,1881,43,20-24,1924,0.17550239253467717
STAT,1887,115,na,2002,2.2646446771340596E-4
SIM,1840,71,na,1911,908
STAT,1875,3,na,1878,3676.2268998072695
SIM,1955,21,15-19,1976,14
SIM,1901,20,35-39,1921,12
STAT,1854,91,na,1945,47.20991151184264
SIM,1866,34,30-34,1900,6
SIM,1840,55,na,1895,1648
STAT,1940,20,20-24,1960,130.85496668507136
SIM,1971,36,50-100,2007,1
STAT,1929,30,50-100,1959,1.213420335958482
STAT,1821,103,na,1924,0.08777259345667529
STAT,1960,27,20-24,1987,27.555660536738223
SIM,1853,59,na,1912,1920
STAT,1841,22,20-24,1863,77.61615545712591
STAT,1906,10,na,1916,4359.184508122259
STAT,1873,53,50-100,1926,0.017512664032527426
STAT,1848,23,15-19,1871,4.237422283359974
STAT,1968,45,40-44,2013,0.23749439630618457
STAT,1866,43,25-29,1909,0.6819289463577247
STAT,1818,52,35-39,1870,0.010225948026536558
SIM,1849,37,40-44,1886,3
STAT,1831,66,na,1897,1285.9133986860109
STAT,1941,56,na,1997,4374.16033897261
STAT,1905,31,50-100,1936,0.8823615277834764
STAT,1965,29,na,1994,5415.266221212509
SIM,1978,30,40-44,2008,11
STAT,1918,43,40-44,1961,0.3063534514075931
STAT,1987,14,na,2001,6469.222737012055
SIM,1948,35,40-44,1983,4
STAT,1844,50,40-44,1894,0.008932103847177682
STAT,1899,46,50-100,1945,0.2196615790175539
STAT,1940,39,40-44,1979,1.8038802613867913
SIM,1850,70,na,1920,726
STAT,1816,74,na,1890,548.0689056227939
STAT,1958,27,35-39,1985,22.85495387896008
SIM,1901,28,45-49,1929,3
SIM,1812,53,na,1865,1401
SIM,1955,35,40-44,1990,2
SIM,1934,75,na,2009,3181
STAT,1902,98,na,2000,73.0734189937202
SIM,1924,72,na,1996,3333
SIM,1923,26,30-34,1949,118
SIM,1916,21,na,1937,4100
STAT,1939,37,na,1976,4479.289290968331
SIM,1818,43,40-44,1861,9
STAT,1951,21,35-39,1972,12.986754856931565
STAT,1866,31,30-34,1897,18.752315871268994
STAT,1888,35,25-29,1923,3.9429400439279267
STAT,1849,46,35-39,1895,0.10881762969907419
STAT,1825,53,50-100,1878,0.019923454551612464
STAT,1937,18,30-34,1955,13.655874014639828
STAT,1829,50,45-49,1879,0.014875510600325246
STAT,1783,101,na,1884,0.10254821347376128
SIM,1861,44,35-39,1905,1
SIM,1989,20,45-49,2009,1
SIM,1874,43,na,1917,2557
STAT,1966,40,50-100,2006,0.1764708598899125
SIM,1883,17,na,1900,2698
STAT,1833,52,30-34,1885,0.0043465561330402
SIM,1845,40,na,1885,2086
STAT,1951,29,45-49,1980,2.382050878427516
STAT,1897,34,20-24,1931,4.135469374941651
STAT,1789,70,na,1859,534.4647624901389
STAT,1971,17,25-29,1988,63.34154572731221
SIM,1859,40,25-29,1899,1
SIM,1896,35,25-29,1931,2
SIM,1816,67,na,1883,1163
STAT,1828,62,na,1890,1213.064091696365
SIM,1837,29,na,1866,2456
SIM,1927,37,25-29,1964,1
SIM,1922,33,25-29,1955,26
SIM,1967,43,40-44,2010,1
STAT,1845,23,35-39,1868,4.846605304499968
STAT,1982,15,35-39,1997,6.817830855338592
SIM,1970,29,20-24,1999,3
STAT,1918,75,na,1993,2990.9410475849245
STAT,1908,47,20-24,1955,0.011548590388096466
SIM,1818,93,na,1911,39
STAT,1879,17,50-100,1896,0.05903613881170332
STAT,1978,15,15-19,1993,71.51521143848096
STAT,1912,45,20-24,1957,0.012326184234546967
STAT,1902,40,50-100,1942,0.12083351019137849
STAT,1962,29,20-24,1991,27.081518039380263
STAT,1855,53,20-24,1908,6.178108316585925E-4
STAT,1841,44,na,1885,2081.280127984025
STAT,1919,37,25-29,1956,1.2204313462766931
STAT,1860,23,30-34,1883,16.955955701277958
STAT,1830,35,20-24,1865,0.8040090077863781
STAT,1959,43,40-44,2002,0.3917765166245199
STAT,1925,86,na,2011,1504.9436312270582
SIM,1829,30,40-44,1859,8
STAT,1927,49,na,1976,5289.574397312246
STAT,1832,23,25-29,1855,68.01153641716473
STAT,1870,43,45-49,1913,1.690463345570476
SIM,1908,47,50-100,1955,2
STAT,1876,31,50-100,1907,1.097528510679042
STAT,1883,41,50-100,1924,1.19822895719319
STAT,1870,32,35-39,1902,11.521807948274512
STAT,1903,43,20-24,1946,0.017997119492251978
STAT,1843,51,50-100,1894,0.01522631660861693
STAT,1890,61,na,1951,2635.000766996599
SIM,1849,23,15-19,1872,8
SIM,1848,44,35-39,1892,4
SIM,1840,23,25-29,1863,8
SIM,1886,46,na,1932,1941
SIM,1882,32,na,1914,3282
STAT,1982,31,50-100,2013,1.3693886202753847
STAT,1963,41,na,2004,5667.018274531782
STAT,1919,42,50-100,1961,0.14688785909323543
STAT,1839,29,25-29,1868,41.65715228893927
STAT,1934,37,20-24,1971,0.42001921018910593
STAT,1892,24,35-39,1916,8.387798884950506
SIM,1908,26,35-39,1934,36
SIM,1919,28,30-34,1947,66
STAT,1947,21,15-19,1968,6.945073746921959
SIM,1900,41,25-29,1941,1
SIM,1802,75,na,1877,372
STAT,1936,39,20-24,1975,0.2981985942457145
SIM,1953,27,25-29,1980,12
STAT,1919,20,na,1939,4641.211305254805
STAT,1916,46,35-39,1962,0.15300687641225583
STAT,1831,44,15-19,1875,0.012900563078319122
SIM,1955,45,50-100,2000,1
STAT,1819,66,na,1885,1134.0713019194588
SIM,1825,63,na,1888,1205
SIM,1891,41,50-100,1932,2
SIM,1828,74,na,1902,1104
STAT,1913,18,15-19,1931,10.685973571816156
STAT,1912,39,35-39,1951,2.699561024779216
STAT,1856,58,na,1914,1741.1742759423084
SIM,1865,47,na,1912,2799
SIM,1921,18,15-19,1939,61
SIM,1920,39,35-39,1959,1
STAT,1923,35,25-29,1958,1.318390602390504
STAT,1892,49,40-44,1941,0.1367672044061901
STAT,1952,19,na,1971,5086.969519335581
STAT,1945,27,25-29,1972,83.3355089463799
STAT,1973,18,na,1991,5491.940119718963
SIM,1865,0,na,1865,4164
SIM,1936,38,na,1974,3941
SIM,1931,35,25-29,1966,1
STAT,1990,25,25-29,2015,109.34700668349366
STAT,1840,46,15-19,1886,3.2775452873472357E-4
SIM,1855,20,40-44,1875,3
STAT,1828,39,20-24,1867,0.7613472319583082
SIM,1927,64,na,1991,4202
SIM,1823,35,25-29,1858,4
SIM,1971,26,na,1997,5763
STAT,1849,20,50-100,1869,0.38767963999749716
STAT,1914,33,25-29,1947,10.69664384799681
SIM,1886,17,45-49,1903,1
STAT,1895,7,na,1902,3913.7451476378997
STAT,1868,83,na,1951,440.16632778070505
STAT,1955,38,40-44,1993,2.360385770715518
STAT,1831,45,50-100,1876,0.23345396706036223
SIM,1905,37,40-44,1942,1
STAT,1890,45,20-24,1935,0.017090142572799553
STAT,1825,51,20-24,1876,0.0010129280144289827
STAT,1867,37,45-49,1904,2.1479588573761883
SIM,1869,50,na,1919,1766
STAT,1906,87,na,1993,962.479635251455
STAT,1968,31,na,1999,5560.071931208582
STAT,1861,52,45-49,1913,0.013849193908060817
SIM,1928,49,na,1977,5615
SIM,1950,1,na,1951,5001
STAT,1838,44,25-29,1882,0.5770997926885834
STAT,1874,4,na,1878,3448.5548442001696
SIM,1836,31,50-100,1867,2
STAT,1905,45,20-24,1950,0.011419131211723183
STAT,1914,9,na,1923,4738.99750326732
SIM,1890,26,30-34,1916,5
STAT,1934,22,25-29,1956,143.32693671854014
STAT,1874,15,na,1889,3008.921368461583
STAT,1920,35,45-49,1955,0.8625067784715432
SIM,1920,69,na,1989,3206
SIM,1872,31,20-24,1903,5
STAT,1803,70,na,1873,696.7589816567179
STAT,1898,45,35-39,1943,0.12439850068115442
SIM,1974,32,30-34,2006,40
STAT,1925,32,na,1957,5181.354978034371
STAT,1955,46,15-19,2001,5.884669945837515E-4
STAT,1900,96,na,1996,137.0143504745545
STAT,1921,22,15-19,1943,6.936090542351642
STAT,1885,52,na,1937,2465.404340000279
STAT,1840,41,45-49,1881,1.268556901277484
SIM,1827,33,35-39,1860,3
SIM,1848,29,na,1877,1994
STAT,1852,52,35-39,1904,0.00807352708731855
SIM,1922,46,na,1968,4981
SIM,1892,27,35-39,1919,12
STAT,1912,97,na,2009,119.16771228685084
STAT,1975,38,40-44,2013,2.3456820893924117
STAT,1796,83,na,1879,159.3975624230646
STAT,2009,2,na,2011,7142.1126059801
STAT,1860,17,na,1877,2462.3517074121573
SIM,1823,43,na,1866,2221
SIM,1830,25,20-24,1855,25
STAT,1847,39,25-29,1886,2.2513437358067216
STAT,1920,92,na,2012,519.9292843602404
SIM,1815,48,na,1863,1884
STAT,1882,26,30-34,1908,28.482826396699092
STAT,1916,71,na,1987,3317.711569829894
SIM,1842,22,20-24,1864,144
STAT,1856,39,35-39,1895,6.164673111961442
SIM,1865,36,50-100,1901,2
STAT,1984,15,45-49,1999,0.8192134302336983
STAT,1814,51,45-49,1865,0.03935773770567202
STAT,1866,1,na,1867,3830.0683500426203
STAT,1969,25,20-24,1994,26.452121869493826
STAT,1908,15,50-100,1923,0.08436671567391439
STAT,1929,48,40-44,1977,0.23519473442078653
SIM,1969,15,45-49,1984,1
SIM,1910,22,35-39,1932,9
STAT,1834,22,20-24,1856,84.10794351073015
STAT,1858,78,na,1936,703.4228945260866
STAT,1907,40,25-29,1947,0.07648129365450713
STAT,1962,38,30-34,2000,2.773707962977057
SIM,1974,18,na,1992,6383
STAT,1848,18,35-39,1866,0.71848104994169
STAT,1964,25,30-34,1989,57.248581901708334
SIM,1970,38,30-34,2008,2
SIM,1887,34,45-49,1921,5
STAT,1896,42,20-24,1938,0.016789592364774206
STAT,1958,4,na,1962,5960.828309530005
STAT,1884,15,40-44,1899,0.20951885880287704
STAT,1879,34,45-49,1913,2.0833478424937195
STAT,1866,73,na,1939,1270.4937284081184
STAT,1924,19,40-44,1943,1.9113896598470685
SIM,1982,13,na,1995,6822
SIM,1932,19,40-44,1951,4
STAT,1979,17,50-100,1996,0.5953212368495585
SIM,1897,21,50-100,1918,1
STAT,1953,33,15-19,1986,0.18275279904997863
SIM,1837,40,40-44,1877,7
STAT,1963,40,35-39,2003,0.3076710749555028
SIM,1972,25,30-34,1997,130
SIM,1947,15,25-29,1962,116
STAT,1899,60,na,1959,3119.217419381963
STAT,1903,39,na,1942,3863.975448107906
SIM,1846,44,25-29,1890,1
STAT,1884,27,35-39,1911,11.001910704760911
STAT,1931,46,30-34,1977,0.13793106795703336
STAT,1892,48,35-39,1940,0.11279204936536864
SIM,1861,70,na,1931,966
SIM,1919,24,20-24,1943,11
SIM,1875,37,45-49,1912,7
STAT,1833,92,na,1925,29.307597122979026
SIM,1858,13,na,1871,3225
STAT,1846,59,na,1905,2009.1184457510303
SIM,1910,19,20-24,1929,37
STAT,1902,22,35-39,1924,9.515497270968007
STAT,1929,40,45-49,1969,0.2494362877947887
STAT,1941,33,50-100,1974,1.0014195723743116
SIM,1894,31,40-44,1925,1
STAT,1817,43,40-44,1860,6.755308374541913
STAT,1979,20,45-49,1999,1.7950251538368744
STAT,1879,46,na,1925,2718.797928681279
STAT,1977,33,45-49,2010,2.49953180346285
SIM,1884,44,50-100,1928,5
STAT,1992,22,30-34,2014,47.76677516589298
STAT,1902,19,20-24,1921,28.753608832943623
STAT,1918,45,50-100,1963,0.2790158279312168
STAT,1816,43,35-39,1859,3.9560228855097725
STAT,1913,25,15-19,1938,0.8177156713933287
STAT,1911,34,na,1945,4217.362692370602
STAT,1844,101,na,1945,0.4772824804950711
SIM,1931,70,na,2001,4539
SIM,1950,30,35-39,1980,26
SIM,1853,75,na,1928,842
STAT,1874,53,25-29,1927,0.0041175114711545285
SIM,1898,34,20-24,1932,5
SIM,1939,35,50-100,1974,1
STAT,1878,37,20-24,1915,0.9288386523169357
STAT,1882,10,na,1892,2919.85432782461
SIM,1820,88,na,1908,126
STAT,1886,31,40-44,1917,5.300707218635696
SIM,1990,9,na,1999,6331
STAT,1935,44,na,1979,6028.686644891341
SIM,1955,36,25-29,1991,2
STAT,1933,30,25-29,1963,14.397023862766876
SIM,1917,65,na,1982,4282
SIM,1859,4,na,1863,2771
SIM,1845,33,50-100,1878,1
STAT,1979,36,15-19,2015,0.0314653406638344
STAT,1842,54,30-34,1896,0.0044546725521928815
STAT,1938,35,30-34,1973,2.142325143314552
SIM,1863,33,45-49,1896,1
STAT,1856,95,na,1951,11.70604714650955
SIM,1977,28,15-19,2005,5
SIM,1877,20,25-29,1897,86
SIM,1944,5,na,1949,4682
STAT,1859,17,40-44,1876,0.19517953895786092
SIM,1868,41,40-44,1909,9
STAT,1942,30,35-39,1972,11.248673304584251
SIM,1961,33,15-19,1994,1
SIM,1778,82,na,1860,30
STAT,1841,28,na,1869,2371.7318888643163
STAT,1840,30,20-24,1870,2.6965157854477884
STAT,1866,34,35-39,1900,10.739792504562027
SIM,1923,30,50-100,1953,1
STAT,1821,39,50-100,1860,2.510481383981558
SIM,1847,38,50-100,1885,4
STAT,1860,26,35-39,1886,9.13631002007764
STAT,1974,30,25-29,2004,14.213172745075815
SIM,1874,34,35-39,1908,9
SIM,1864,36,30-34,1900,16
STAT,1908,32,25-29,1940,10.081091031371724
SIM,1856,30,na,1886,2145
STAT,1829,43,45-49,1872,1.5730420555478761
STAT,1923,27,40-44,1950,6.173476636112225
SIM,1896,30,na,1926,3859
STAT,1849,52,20-24,1901,5.688931460498446E-4
SIM,1783,85,na,1868,141
STAT,1849,43,30-34,1892,0.8846344104693808
STAT,1966,30,20-24,1996,3.587863543431824
STAT,1899,45,40-44,1944,0.15420785384582814
STAT,1959,18,15-19,1977,68.48765645394572
SIM,1929,82,na,2011,1796
STAT,1855,33,45-49,1888,1.4952184159703998
SIM,1907,87,na,1994,1040
SIM,1956,15,35-39,1971,10
STAT,1887,27,50-100,1914,0.8273288877293192
STAT,1908,20,na,1928,4078.09694402475
STAT,1840,49,40-44,1889,0.13498970758044962
STAT,1771,91,na,1862,21.57633209283029
SIM,1966,25,45-49,1991,6
SIM,1916,32,25-29,1948,2
SIM,1789,76,na,1865,693
SIM,1931,27,40-44,1958,9
STAT,1870,48,15-19,1918,4.4937107923366797E-4
STAT,1948,15,35-39,1963,5.544668244585636
STAT,1968,35,na,2003,5596.590011809241
STAT,1828,46,na,1874,1676.1236494322604
SIM,1835,62,na,1897,1637
STAT,1848,51,30-34,1899,0.0063550102819562426
SIM,1890,67,na,1957,2226
STAT,1957,38,50-100,1995,0.6574952497137186
SIM,1965,8,na,1973,5618
SIM,1983,30,na,2013,6940
SIM,1832,28,35-39,1860,23
STAT,1980,8,na,1988,6296.371045172496
STAT,1809,67,na,1876,896.1167973876701
STAT,1864,34,25-29,1898,10.464042752026932
STAT,1869,29,50-100,1898,0.7098158231452758
STAT,1851,44,25-29,1895,0.5023535957154492
SIM,1851,33,40-44,1884,10
STAT,1958,25,45-49,1983,2.6322112631831307
STAT,1860,110,na,1970,0.0035686059626337963
STAT,1940,49,45-49,1989,0.26342344922182964
STAT,1881,20,40-44,1901,2.33338800627946
SIM,1942,22,25-29,1964,123
STAT,1933,49,45-49,1982,0.34304787139059045
SIM,1941,30,25-29,1971,17
STAT,1947,36,25-29,1983,1.3198638160883804
STAT,1853,47,na,1900,2229.541278244158
STAT,1949,42,na,1991,5180.29779259903
SIM,1872,54,na,1926,2674
STAT,1843,33,40-44,1876,5.177154633914512
SIM,1810,70,na,1880,498
SIM,1936,44,na,1980,3912
SIM,1866,25,40-44,1891,5
STAT,1892,28,na,1920,3439.798301243725
SIM,1867,73,na,1940,960
STAT,1869,28,20-24,1897,13.065016151018913
STAT,1950,35,50-100,1985,0.5912616744335366
SIM,1906,29,40-44,1935,10
STAT,1869,20,25-29,1889,64.63540923237368
STAT,1981,13,na,1994,6337.832853785089
STAT,1940,30,25-29,1970,11.055348249460279
SIM,1952,8,na,1960,4844
STAT,1890,21,20-24,1911,97.4682792280478
STAT,1895,34,50-100,1929,1.3645927287885808
STAT,1854,36,20-24,1890,0.631030901044317
STAT,1952,43,40-44,1995,0.35891867264946337
STAT,1890,32,45-49,1922,2.458998899152676
SIM,1911,52,na,1963,4520
STAT,1810,46,35-39,1856,0.5568122979708402
STAT,1858,25,40-44,1883,2.800843533853771
STAT,1839,89,na,1928,83.31267253269876
SIM,1840,35,30-34,1875,7
STAT,1964,31,25-29,1995,13.701889994456774
STAT,1916,34,40-44,1950,4.623161146125982
SIM,1949,22,35-39,1971,22
STAT,1790,64,na,1854,851.0
SIM,1914,30,25-29,1944,22
STAT,1863,19,15-19,1882,6.145513103399461
STAT,1895,21,50-100,1916,0.6144289107763709
STAT,1867,34,40-44,1901,4.63275552304932
STAT,1827,40,30-34,1867,1.5909013935590084
SIM,1875,34,40-44,1909,12
STAT,1919,30,35-39,1949,11.466780744469318
SIM,1974,35,35-39,2009,4
SIM,1909,14,na,1923,5065
STAT,1796,67,na,1863,867.7045027136674
STAT,1921,27,30-34,1948,50.37759485607307
STAT,1966,35,35-39,2001,3.5981205320560554
STAT,1856,48,25-29,1904,0.050076656376607236
STAT,1806,54,20-24,1860,0.0024952721949072065
SIM,1825,46,45-49,1871,1
STAT,1858,28,45-49,1886,1.015929035462542
STAT,1837,23,na,1860,2012.2505275606356
SIM,1969,18,25-29,1987,79
STAT,1849,61,na,1910,1448.3200462263726
SIM,1924,34,40-44,1958,9
SIM,1946,22,na,1968,4672
STAT,1931,30,15-19,1961,0.19458451688074163
STAT,1878,104,na,1982,2.185896857456055
SIM,1861,30,30-34,1891,10
STAT,1814,40,20-24,1854,0.7098206652283917
STAT,1832,35,30-34,1867,4.784976571006344
SIM,1953,20,35-39,1973,30
STAT,1906,30,25-29,1936,9.977032830012122
STAT,1892,23,20-24,1915,99.36939434165899
STAT,1970,33,35-39,2003,13.448336835934189
SIM,1863,43,na,1906,2298
SIM,1882,41,30-34,1923,3
STAT,1825,54,25-29,1879,0.004580661951395217
STAT,1920,48,20-24,1968,0.014052656890363991
STAT,1842,28,50-100,1870,0.6043815579164934
SIM,1950,24,40-44,1974,6
SIM,1892,24,30-34,1916,35
STAT,1911,18,na,1929,4452.417118800552
STAT,1817,46,45-49,1863,0.6834647412179347
STAT,1816,105,na,1921,0.014480008588827987
SIM,1872,34,25-29,1906,20
STAT,1920,32,40-44,1952,4.9446318051311415
STAT,1953,30,35-39,1983,13.0189069568056
STAT,1874,41,30-34,1915,1.3644182180511375
STAT,1945,36,15-19,1981,0.024963819488133667
STAT,1846,51,20-24,1897,7.664977883283052E-4
SIM,1914,49,45-49,1963,1
STAT,1931,49,35-39,1980,0.19782597815028596
STAT,1853,30,30-34,1883,18.27677044389044
STAT,1863,50,45-49,1913,0.014855073886939983
STAT,1971,24,50-100,1995,0.9642914889247234
STAT,1954,29,na,1983,5362.293488735283
STAT,1945,20,35-39,1965,11.917704787571752
STAT,1837,29,15-19,1866,0.41564564378675933
STAT,1938,41,25-29,1979,0.08464518037579302
SIM,1814,45,30-34,1859,1
SIM,1886,62,na,1948,1437
SIM,1982,30,25-29,2012,39
STAT,1912,2,na,1914,4761.653702279649
SIM,1878,67,na,1945,1783
SIM,1938,21,20-24,1959,212
SIM,1988,0,na,1988,6645
STAT,1838,24,na,1862,2368.453951885546
STAT,1875,33,30-34,1908,20.734508524663482
STAT,1936,26,na,1962,4141.737222909567
SIM,1894,34,45-49,1928,6
STAT,1882,29,50-100,1911,0.715917227769285
SIM,1830,28,25-29,1858,52
STAT,1913,17,30-34,1930,2.8775198990662996
STAT,1914,40,25-29,1954,0.08226868205639361
STAT,1828,46,20-24,1874,0.011196104084791
STAT,1864,42,45-49,1906,1.5403015644672564
SIM,1921,17,30-34,1938,38
STAT,1959,32,50-100,1991,1.2722263426380809
STAT,1886,34,45-49,1920,2.1045998495270717
STAT,1879,31,40-44,1910,5.24718128727278
SIM,1866,48,na,1914,2283
STAT,1845,109,na,1954,4.7942065334698804E-4
SIM,1872,42,45-49,1914,2
STAT,1923,20,15-19,1943,7.187876122538113
STAT,1833,86,na,1919,156.12843513001508
STAT,1928,17,15-19,1945,65.99203427504362
SIM,1899,35,na,1934,4190
STAT,1838,41,20-24,1879,0.16298459550886196
STAT,1862,26,45-49,1888,1.093195742804801
STAT,1979,7,na,1986,6245.689376606401
SIM,1967,32,50-100,1999,1
STAT,1887,41,40-44,1928,2.9222029254288593
SIM,1964,47,50-100,2011,2
STAT,1966,44,25-29,2010,0.10661376547485373
STAT,1776,111,na,1887,0.0018252709754457298
SIM,1931,39,35-39,1970,2
SIM,1866,22,50-100,1888,1
STAT,1892,45,30-34,1937,0.07976742940500367
STAT,1963,48,30-34,2011,0.13557194779050039
SIM,1887,31,40-44,1918,11
STAT,1885,42,45-49,1927,1.7206753245638164
STAT,1936,49,50-100,1985,0.2573509999673278
SIM,1791,64,na,1855,851
STAT,1858,22,50-100,1880,0.4212275981749167
SIM,1931,23,na,1954,5401
SIM,1824,43,35-39,1867,3
SIM,1819,78,na,1897,84
SIM,1918,25,na,1943,4073
STAT,1850,52,25-29,1902,0.0036268999546574163
SIM,1868,44,45-49,1912,7
SIM,1935,40,35-39,1975,1
SIM,1858,23,25-29,1881,1
STAT,1968,22,35-39,1990,13.617079987399688
STAT,1803,53,35-39,1856,0.030615296349667896
STAT,1939,15,25-29,1954,50.2037372568457
STAT,1826,48,50-100,1874,0.17443095161672006
STAT,1909,93,na,2002,346.89330147350853
STAT,1844,22,50-100,1866,0.42586700491477625
STAT,1966,33,25-29,1999,13.571585647460347
SIM,1843,26,45-49,1869,3
STAT,1775,99,na,1874,0.4712960099334983
SIM,1987,20,35-39,2007,19
SIM,1888,37,30-34,1925,2
SIM,1883,33,30-34,1916,8
SIM,1955,33,na,1988,6437
STAT,1880,26,20-24,1906,14.399641769556203
STAT,1899,48,45-49,1947,0.20783321145857309
STAT,1901,42,40-44,1943,0.25217458539639154
SIM,1876,84,na,1960,521
SIM,1853,20,30-34,1873,1
STAT,1836,41,na,1877,2305.502187163276
STAT,1971,26,15-19,1997,1.0367933489521033
SIM,1861,17,na,1878,2058
STAT,1886,34,na,1920,2880.012596396088
STAT,1768,86,na,1854,63.0
STAT,1908,14,na,1922,4412.325405651122
SIM,1818,46,45-49,1864,2
SIM,1955,33,20-24,1988,2
SIM,1908,24,45-49,1932,3
SIM,1992,15,35-39,2007,16
STAT,1847,35,na,1882,1920.3476369898106
SIM,1939,22,50-100,1961,1
STAT,1952,46,45-49,1998,0.3134186995310745
STAT,1841,18,25-29,1859,6.459723554292613
SIM,1874,31,30-34,1905,39
SIM,1988,24,na,2012,6592
STAT,1942,24,40-44,1966,4.066405329127475
SIM,1976,22,35-39,1998,40
STAT,1947,33,20-24,1980,3.230076370967124
SIM,1874,38,50-100,1912,1
STAT,1882,18,50-100,1900,0.055079692702869984
STAT,1922,19,30-34,1941,16.184935743287575
SIM,1848,35,na,1883,1841
STAT,1927,43,15-19,1970,0.0022186645395442703
STAT,1972,41,15-19,2013,0.0023615672456684766
SIM,1930,19,30-34,1949,51
STAT,1926,48,na,1974,5215.7029186463715
STAT,1850,15,30-34,1865,2.028864237236034
SIM,1841,56,na,1897,1684
STAT,1836,36,45-49,1872,2.2508962426441927
STAT,1851,41,20-24,1892,0.12650775222842123
STAT,1872,52,20-24,1924,8.505504626065556E-4
SIM,1857,43,30-34,1900,2
STAT,1972,38,50-100,2010,0.6384993421622966
SIM,1961,30,35-39,1991,16
SIM,1976,23,50-100,1999,3
SIM,1912,22,45-49,1934,2
STAT,1895,30,na,1925,3613.5116174888253
STAT,1881,46,25-29,1927,0.06429827361286909
SIM,1829,56,na,1885,1372
STAT,1842,33,35-39,1875,9.316928282103326
SIM,1832,25,30-34,1857,2
SIM,1866,28,45-49,1894,1
SIM,1890,11,na,1901,3751
SIM,1850,33,35-39,1883,9
SIM,1902,42,40-44,1944,2
STAT,1883,91,na,1974,261.56234691131294
SIM,1958,25,na,1983,5723
STAT,1859,52,45-49,1911,0.013270307860562118
STAT,1983,24,40-44,2007,5.503601433746289
STAT,1890,24,25-29,1914,80.21785211545723
SIM,1909,17,15-19,1926,17
STAT,1843,36,45-49,1879,2.3594606735936927
STAT,1835,26,45-49,1861,0.9126542467616031
SIM,1906,22,na,1928,3911
STAT,1895,18,20-24,1913,26.56188266104891
SIM,1927,30,35-39,1957,2
STAT,1815,73,na,1888,690.4598835091712
STAT,1976,30,na,2006,5950.578065649909
SIM,1903,57,na,1960,3235
STAT,1820,41,35-39,1861,2.30827560501222
SIM,1844,36,45-49,1880,1
STAT,1904,22,45-49,1926,1.1556146953265207
STAT,1927,40,35-39,1967,0.29219156319443557
SIM,1881,26,20-24,1907,24
STAT,1888,47,30-34,1935,0.13070421731191545
SIM,1859,42,45-49,1901,3
STAT,1821,44,45-49,1865,2.762424379150515
STAT,1866,33,20-24,1899,2.8791573337447853
SIM,1890,38,25-29,1928,9
SIM,1945,59,na,2004,4272
STAT,1937,35,50-100,1972,0.485612120188008
STAT,1864,31,20-24,1895,2.7967267931656297
STAT,1887,19,na,1906,3248.9073660514446
SIM,1918,46,50-100,1964,1
STAT,1940,46,40-44,1986,0.19269819410384056
SIM,1923,71,na,1994,3986
STAT,1890,48,25-29,1938,0.04524080683955588
SIM,1834,86,na,1920,245
SIM,1866,37,35-39,1903,2
SIM,1827,30,30-34,1857,34
STAT,1818,78,na,1896,345.7093917615304
SIM,1849,22,30-34,1871,37
STAT,1933,46,40-44,1979,0.25094465015704204
SIM,1888,29,35-39,1917,15
STAT,1958,34,35-39,1992,14.100816974042868
STAT,1882,38,25-29,1920,3.229376695562509
SIM,1835,40,30-34,1875,2
STAT,1950,44,45-49,1994,0.2352257776819001
SIM,1870,13,na,1883,3361
SIM,1868,74,na,1942,1398
SIM,1845,46,50-100,1891,1
STAT,1851,32,30-34,1883,14.41064817381535
STAT,1869,84,na,1953,371.78714829699123
STAT,1920,46,30-34,1966,0.11395672141169703
STAT,1856,45,20-24,1901,0.010670724167690491
SIM,1923,22,20-24,1945,151
STAT,1832,38,35-39,1870,6.147435015487431
SIM,1823,99,na,1922,10
STAT,1795,82,na,1877,147.2444094848542
STAT,1897,26,50-100,1923,0.9905185325222109
STAT,1864,3,na,1867,3309.571157876412
SIM,1882,44,35-39,1926,4
SIM,1929,38,40-44,1967,3
STAT,1972,17,na,1989,5438.714492909489
SIM,1921,45,na,1966,5171
SIM,1904,29,30-34,1933,53
STAT,1814,43,25-29,1857,2.025080455414364
STAT,1899,23,30-34,1922,28.075452174102246
STAT,1873,42,50-100,1915,1.2434850079046624
STAT,1926,33,na,1959,5273.285733017002
SIM,1822,43,25-29,1865,2
SIM,1870,30,40-44,1900,12
STAT,1992,19,40-44,2011,2.3153989522139344
STAT,1887,44,45-49,1931,1.9095116904107041
STAT,1900,18,40-44,1918,0.29212546898747244
STAT,1973,23,20-24,1996,166.4565159412388
STAT,1813,47,na,1860,1410.1330141067015
STAT,1910,21,25-29,1931,100.51233250578775
STAT,1861,51,30-34,1912,0.005738243558853256
SIM,1844,43,45-49,1887,1
STAT,1827,43,35-39,1870,2.3708511212446224
SIM,1908,33,35-39,1941,1
STAT,1819,49,15-19,1868,7.48186135988409E-4
STAT,1867,20,15-19,1887,3.621116472561025
STAT,1915,70,na,1985,3349.205455881265
SIM,1849,44,40-44,1893,1
STAT,1906,32,15-19,1938,0.13760918807123243
STAT,1814,107,na,1921,0.0029404843931170044
STAT,1964,33,15-19,1997,0.19027518938054563
STAT,1997,16,15-19,2013,76.5005592368967
STAT,1976,32,25-29,2008,14.52567171288258
STAT,1959,35,na,1994,5861.246519797456
SIM,1881,31,na,1912,1994
STAT,1842,32,20-24,1874,2.512778399475594
STAT,1858,22,na,1880,2208.5816855155713
STAT,1828,49,25-29,1877,0.051665812494103056
STAT,1885,100,na,1985,19.49068393459592
STAT,1901,35,40-44,1936,1.541831684815477
SIM,1807,50,na,1857,1175
STAT,1836,43,45-49,1879,1.600274702192898
SIM,1850,32,20-24,1882,2
SIM,1969,15,20-24,1984,339
SIM,1875,20,15-19,1895,4
STAT,1834,47,35-39,1881,0.13549494817776253
SIM,1949,15,35-39,1964,9
STAT,1950,48,50-100,1998,0.3201317249281177
STAT,1868,107,na,1975,0.13438665809090866
STAT,1923,35,50-100,1958,0.5621860615677549
STAT,1825,42,30-34,1867,1.7101442025127702
SIM,1964,10,na,1974,5975
STAT,1963,16,15-19,1979,66.55789200747645
STAT,1874,44,35-39,1918,2.110503311423818
STAT,1940,24,30-34,1964,33.77666359101947
SIM,1912,23,15-19,1935,1
SIM,1899,28,40-44,1927,10
STAT,1896,95,na,1991,168.68423581163324
SIM,1971,16,15-19,1987,54
STAT,1889,21,50-100,1910,0.581861507210605
STAT,1847,43,20-24,1890,0.12131663745869835
STAT,1977,38,15-19,2015,0.030818228461276853
STAT,1831,32,45-49,1863,1.775791197189456
STAT,1806,48,35-39,1854,0.5076728038058336
STAT,1900,22,50-100,1922,0.6530174807747767
SIM,1900,45,35-39,1945,1
STAT,1784,109,na,1893,8.260618852489051E-4
STAT,1980,12,na,1992,6293.223447052823
STAT,1868,21,50-100,1889,0.4554146807315745
SIM,1833,42,30-34,1875,2
STAT,1872,52,45-49,1924,0.016727491796449227
STAT,1910,29,20-24,1939,20.217788055474315
SIM,1767,92,na,1859,21
SIM,1865,17,30-34,1882,3
STAT,1851,89,na,1940,83.30689953439207
SIM,1868,34,40-44,1902,1
STAT,1890,46,35-39,1936,0.11167570228660081
SIM,1943,17,15-19,1960,57
STAT,1845,39,15-19,1884,0.03894100879526021
STAT,1950,46,35-39,1996,0.18344918947114014
STAT,1853,33,35-39,1886,10.275834591471442
STAT,1898,44,20-24,1942,0.016968450654145817
STAT,1932,22,15-19,1954,8.062388482604623
STAT,1894,49,15-19,1943,3.2774655820183807E-4
STAT,1923,39,35-39,1962,3.2262226058685637
SIM,2005,4,na,2009,6474
STAT,1857,17,30-34,1874,1.6837833277909944
SIM,1940,22,15-19,1962,16
STAT,1855,44,50-100,1899,0.8867963318853289
STAT,1914,45,na,1959,4226.59728808766
SIM,1861,33,35-39,1894,6
STAT,1935,17,15-19,1952,71.6378186190498
STAT,1927,9,na,1936,5710.973357182485
STAT,1932,29,40-44,1961,7.040198168839412
SIM,1823,31,15-19,1854,1
SIM,1950,32,25-29,1982,22
STAT,1914,29,na,1943,4329.174762865959
SIM,1835,87,na,1922,65
STAT,1883,50,30-34,1933,0.0068175609893598435
STAT,1937,26,15-19,1963,0.7949534521622539
SIM,1953,54,na,2007,5439
STAT,1815,54,50-100,1869,0.02847528574005164
STAT,1839,38,50-100,1877,1.1515178797169026
STAT,1933,81,na,2014,2766.0531466190246
SIM,1859,44,35-39,1903,4
STAT,1831,32,50-100,1863,0.9330428266619325
STAT,1915,30,50-100,1945,0.9797599754159123
SIM,1918,41,na,1959,3811
SIM,1919,26,na,1945,5461
SIM,1940,29,40-44,1969,18
STAT,1922,40,na,1962,4931.0236758093715
STAT,1874,50,20-24,1924,8.843411365326111E-4
SIM,1839,27,30-34,1866,51
STAT,1934,43,na,1977,5959.737604064121
STAT,1942,32,25-29,1974,11.364155497517242
SIM,1988,16,20-24,2004,238
STAT,1948,45,40-44,1993,0.21760034120716848
SIM,1863,44,50-100,1907,4
STAT,1916,42,25-29,1958,0.08446004684876102
STAT,1893,24,40-44,1917,3.0206615923662565
STAT,1800,99,na,1899,1.0219056002670264
STAT,1841,15,20-24,1856,20.57078971726116
SIM,1788,75,na,1863,233
SIM,1929,24,15-19,1953,13
SIM,1928,81,na,2009,3087
STAT,1901,41,na,1942,3765.9451685856616
SIM,1848,29,30-34,1877,1
SIM,1903,38,50-100,1941,2
STAT,1961,40,25-29,2001,0.11095582999104217
SIM,1868,89,na,1957,84
STAT,1912,38,20-24,1950,0.2957312561799325
SIM,1945,26,15-19,1971,1
SIM,1845,24,na,1869,2387
SIM,1927,21,45-49,1948,1
STAT,1926,23,35-39,1949,13.157893625952065
SIM,1859,35,45-49,1894,4
STAT,1880,29,25-29,1909,51.375012324465835
STAT,1773,116,na,1889,2.2423438431621272E-4
STAT,1919,21,45-49,1940,1.4258354123304702
STAT,1985,15,50-100,2000,0.6152819713378346
SIM,1908,88,na,1996,405
STAT,1886,24,40-44,1910,2.520763898211287
STAT,1897,5,na,1902,4043.995924726349
SIM,1885,34,35-39,1919,16
SIM,1966,39,50-100,2005,1
SIM,1974,29,40-44,2003,10
SIM,1934,23,35-39,1957,32
SIM,1987,1,na,1988,6565
STAT,1882,66,na,1948,1847.5168214081136
STAT,1895,14,na,1909,3866.8653088288675
SIM,1890,35,20-24,1925,2
STAT,1806,62,na,1868,925.3918378684303
SIM,1835,43,35-39,1878,7
STAT,1969,28,25-29,1997,95.25270076271218
SIM,1894,24,40-44,1918,5
STAT,1950,41,40-44,1991,0.35520860276253585
STAT,1960,14,na,1974,5902.127635883588
SIM,1860,16,35-39,1876,1
STAT,1917,21,35-39,1938,11.58414055924424
STAT,1989,18,20-24,2007,224.03298381034438
STAT,1864,110,na,1974,0.006792152477934433
STAT,1902,1,na,1903,4438.351733269919
STAT,1910,36,20-24,1946,0.29265560674973656
SIM,1905,49,35-39,1954,1
STAT,1862,33,45-49,1895,1.6911978519821744
STAT,1882,35,20-24,1917,0.8771645955737866
STAT,1938,36,na,1974,4418.618092699425
STAT,1853,31,45-49,1884,1.8065702456830526
SIM,1966,20,na,1986,5529
STAT,1946,45,30-34,1991,0.11924535519027721
STAT,1781,84,na,1865,78.87861418703912
SIM,1958,25,50-100,1983,3
STAT,1841,21,15-19,1862,3.742563015609352
SIM,1925,21,35-39,1946,19
STAT,1955,46,na,2001,5868.833385458713
STAT,1812,47,15-19,1859,9.274172653665224E-4
STAT,1897,27,20-24,1924,18.10319924569107
STAT,1852,16,35-39,1868,0.6293986103575436
SIM,1943,6,na,1949,5542
SIM,1843,23,40-44,1866,1
SIM,1914,39,40-44,1953,4
STAT,1903,82,na,1985,1571.3583243581538
STAT,1816,42,20-24,1858,0.3597101227998293
SIM,1840,38,35-39,1878,7
SIM,1837,39,50-100,1876,2
STAT,1877,34,35-39,1911,12.052901729925331
STAT,1876,50,30-34,1926,0.007203313845291547
STAT,1850,24,na,1874,2604.0594135625684
STAT,1915,22,20-24,1937,132.6706972426186
STAT,1931,47,45-49,1978,0.3354442532216269
STAT,1906,39,40-44,1945,1.5740499529100715
SIM,1889,18,30-34,1907,3
STAT,1821,49,15-19,1870,7.040217930960447E-4
STAT,1827,61,na,1888,1561.262902188205
STAT,1832,44,20-24,1876,0.13147729515078616
STAT,1898,42,30-34,1940,0.12436427749482407
SIM,1954,45,30-34,1999,1
STAT,1835,23,40-44,1858,1.7443175976502254
STAT,1848,54,35-39,1902,0.008895817442373588
STAT,1971,20,na,1991,5359.041336824249
STAT,1848,60,na,1908,2026.4312444659288
STAT,1801,53,25-29,1854,0.0138102122692892
STAT,1947,32,na,1979,5011.515638222907
SIM,1900,33,40-44,1933,2
STAT,1913,36,50-100,1949,0.480720473447118
STAT,1847,36,20-24,1883,0.6218253648292598
STAT,1842,19,45-49,1861,0.06379168179740766
STAT,1955,31,15-19,1986,0.20079139425718168
STAT,1986,23,na,2009,6022.8453116719165
SIM,1958,17,35-39,1975,15
STAT,1920,49,35-39,1969,0.16344105946523307
STAT,1894,69,na,1963,2418.670454203138
SIM,1900,46,na,1946,3401
SIM,1923,25,25-29,1948,10
STAT,1884,92,na,1976,221.4264027463645
STAT,1845,45,45-49,1890,0.16061521661823333
STAT,1901,56,na,1957,3346.1228896761163
STAT,1882,29,35-39,1911,10.798681091998208
STAT,1866,19,30-34,1885,1.7293891637483716
STAT,1987,22,50-100,2009,1.0876290024633306
SIM,1869,34,na,1903,1959
STAT,1856,36,30-34,1892,4.715007802309266
STAT,1836,40,40-44,1876,2.499263445131426
STAT,1915,25,25-29,1940,78.01679593121813
STAT,1976,30,35-39,2006,14.378062290995057
SIM,1861,19,20-24,1880,13
SIM,1996,3,na,1999,6952
STAT,1897,33,15-19,1930,0.21882673545217504
STAT,1827,41,45-49,1868,2.033588613846705
STAT,1971,18,30-34,1989,17.810249535990007
SIM,1870,33,45-49,1903,3
SIM,1995,19,25-29,2014,171
STAT,1971,39,na,2010,5653.346368420845
STAT,1898,47,25-29,1945,0.05043962656992133
STAT,1973,26,25-29,1999,98.70869820218265
STAT,1873,33,20-24,1906,3.172084374561208
SIM,1881,33,20-24,1914,1
SIM,1878,11,na,1889,3117
SIM,1881,29,25-29,1910,43
STAT,1861,42,na,1903,2214.690114518732
STAT,1912,19,na,1931,4487.282230702774
STAT,1873,29,25-29,1902,49.49549511523999
SIM,1919,27,25-29,1946,163
STAT,1852,21,50-100,1873,0.4600357541977132
STAT,1842,30,30-34,1872,16.571243721217716
SIM,1977,24,50-100,2001,1
STAT,1853,19,20-24,1872,20.98345257766182
SIM,1835,41,45-49,1876,10
SIM,1856,15,30-34,1871,3
STAT,1873,26,20-24,1899,13.872841418801254
SIM,1953,28,30-34,1981,67
STAT,1858,37,35-39,1895,6.367652166842904
STAT,1810,44,45-49,1854,6.625184706532982
STAT,1834,31,na,1865,2559.866727063733
STAT,1944,21,na,1965,4551.972074174961
SIM,1850,30,30-34,1880,16
SIM,1868,37,45-49,1905,2
STAT,1846,19,20-24,1865,22.75255226998368
STAT,1979,30,50-100,2009,1.3406613981261768
STAT,1923,36,30-34,1959,2.438424022372612
STAT,1901,38,45-49,1939,0.6920848316109746
STAT,1945,28,30-34,1973,49.58554785949199
SIM,1832,76,na,1908,620
STAT,1972,34,15-19,2006,0.1932988310056859
SIM,1850,35,25-29,1885,3
STAT,1834,44,30-34,1878,1.2328252613944748
STAT,1980,35,na,2015,6220.427192191662
SIM,1975,9,na,1984,6127
STAT,1950,43,30-34,1993,0.18100923193557647
STAT,1871,35,50-100,1906,1.4229910144034366
STAT,1962,24,na,1986,5413.994708780056
STAT,1936,73,na,2009,3011.956986767159
STAT,1848,15,30-34,1863,2.1243327213770966
SIM,1849,47,45-49,1896,1
STAT,1816,40,30-34,1856,2.800658711865136
STAT,1842,35,25-29,1877,2.6536241360169623
STAT,1848,29,50-100,1877,0.7998122712943015
SIM,1864,39,35-39,1903,10
SIM,1996,7,na,2003,6943
STAT,1941,15,25-29,1956,51.5521874441309
SIM,1868,6,na,1874,3471
STAT,1787,101,na,1888,0.11223669660147498
STAT,1861,54,35-39,1915,0.008032460196700302
SIM,1889,73,na,1962,2376
SIM,1834,26,35-39,1860,18
STAT,1896,45,25-29,1941,0.050019631137950285
SIM,1856,29,50-100,1885,2
STAT,1836,97,na,1933,4.889104682514275
STAT,1946,42,50-100,1988,0.1562723508522373
SIM,1833,21,na,1854,1813
STAT,1883,46,35-39,1929,0.15852171861513564
STAT,1883,52,20-24,1935,8.287436463152439E-4
SIM,1824,40,30-34,1864,1
STAT,1903,42,15-19,1945,0.0015744134777615285
SIM,1856,86,na,1942,303
SIM,1859,32,40-44,1891,15
STAT,1959,20,na,1979,5534.702774810855
STAT,1887,4,na,1891,3402.3290004950977
STAT,1884,49,50-100,1933,0.2741912882476173
SIM,1877,85,na,1962,630
STAT,1783,94,na,1877,3.108954541698166
SIM,1913,19,na,1932,4913
STAT,1829,40,40-44,1869,2.4860290543215826
STAT,1762,95,na,1857,3.211925377531247
STAT,1815,98,na,1913,1.8025558542231612
SIM,1931,36,30-34,1967,3
STAT,1876,41,na,1917,2769.736110104307
SIM,1854,19,20-24,1873,44
STAT,1877,25,45-49,1902,1.341900291195035
STAT,1942,47,20-24,1989,0.013865399607267213
STAT,1955,18,50-100,1973,0.5737937115882302
SIM,1963,18,50-100,1981,1
SIM,1871,78,na,1949,242
STAT,1846,34,na,1880,2593.2547664551403
STAT,1977,22,45-49,1999,1.7602741165070162
STAT,1856,12,na,1868,2485.290236698365
SIM,1892,49,50-100,1941,2
SIM,1954,32,na,1986,5381
STAT,1854,39,25-29,1893,2.3220650965494096
SIM,1988,19,25-29,2007,178
STAT,1912,44,15-19,1956,0.0016976752266731022
STAT,1955,30,45-49,1985,2.460100395314232
STAT,1908,92,na,2000,426.09436853359205
STAT,1929,41,15-19,1970,0.0022985426068846907
SIM,1904,100,na,2004,110
STAT,1963,25,50-100,1988,1.4669268267435687
SIM,1908,63,na,1971,3104
STAT,1983,27,na,2010,6142.199752279039
SIM,1870,93,na,1963,257
SIM,1921,30,na,1951,5222
STAT,1837,17,20-24,1854,34.21972997522433
SIM,1891,92,na,1983,225
SIM,1922,34,30-34,1956,3
SIM,1845,17,20-24,1862,17
STAT,1881,23,45-49,1904,0.7738104503321238
SIM,1934,18,na,1952,5922
STAT,1914,34,30-34,1948,18.15418203186502
STAT,1897,40,na,1937,3614.9815920577453
SIM,1791,80,na,1871,275
STAT,1840,33,25-29,1873,9.904421086168718
STAT,1825,35,na,1860,2060.652738860026
STAT,1916,40,35-39,1956,0.23882934954639004
STAT,1808,54,30-34,1862,0.027255331521255286
SIM,1881,56,na,1937,1577
STAT,1893,27,45-49,1920,1.6196197481561998
SIM,1984,30,35-39,2014,5
SIM,1792,65,na,1857,836
STAT,1938,43,15-19,1981,0.0018148333366013749
STAT,1855,30,40-44,1885,3.8361206038975624
STAT,1930,70,na,2000,4376.843404487141
STAT,1948,3,na,1951,5267.3446116125815
STAT,1870,78,na,1948,888.9411170681116
STAT,1832,47,25-29,1879,0.04728021233037328
STAT,1968,44,35-39,2012,0.3006369085375492
STAT,1834,23,50-100,1857,0.4941360869069284
STAT,1937,17,25-29,1954,48.678647442132544
STAT,1987,19,25-29,2006,71.3468341219684
SIM,1885,31,30-34,1916,2
SIM,1855,39,25-29,1894,3
STAT,1958,57,na,2015,5537.773573355454
STAT,1901,105,na,2006,2.40532787460344
SIM,1863,30,40-44,1893,3
SIM,1971,25,50-100,1996,1
STAT,1812,87,na,1899,77.34923946911213
STAT,1816,45,25-29,1861,0.12106598437159959
STAT,1943,58,na,2001,4436.625885646111
SIM,1945,17,25-29,1962,104
SIM,1835,29,20-24,1864,19
SIM,1933,33,na,1966,6303
STAT,1877,31,30-34,1908,21.04508260368309
SIM,1860,5,na,1865,3098
STAT,1904,8,na,1912,4308.017922355144
SIM,1990,15,25-29,2005,169
SIM,1975,35,na,2010,6075
STAT,1805,80,na,1885,324.49086682539394
STAT,1916,55,na,1971,4212.5544346382
STAT,1959,42,35-39,2001,0.31590478253189397
STAT,1877,22,40-44,1899,2.501497741290077
STAT,1883,11,na,1894,2920.242291495411
SIM,1914,23,25-29,1937,123
STAT,1886,27,45-49,1913,1.3515843682390154
SIM,1912,34,na,1946,3789
STAT,1957,40,50-100,1997,0.18628242439903972
SIM,1894,27,45-49,1921,1
STAT,1919,38,30-34,1957,2.256814646934746
STAT,1906,23,25-29,1929,96.03929832102531
SIM,1831,45,25-29,1876,1
STAT,1871,35,45-49,1906,2.310511414859311
STAT,1944,49,20-24,1993,0.014192755317843335
STAT,1823,45,25-29,1868,0.058527269326223826
STAT,1862,30,40-44,1892,4.25761920566939
STAT,1827,29,20-24,1856,25.89913354803361
SIM,1828,29,20-24,1857,22
SIM,1927,38,30-34,1965,3
SIM,1892,17,30-34,1909,3
SIM,1791,95,na,1886,3
STAT,1848,53,20-24,1901,7.714708720335313E-4
STAT,1837,46,50-100,1883,0.18699471570797407
SIM,1864,1,na,1865,3899
STAT,1886,30,35-39,1916,12.426882881181642
STAT,1895,36,45-49,1931,3.009012903410727
STAT,1898,46,40-44,1944,0.1510476163087979
STAT,1890,44,15-19,1934,0.019210663731775664
SIM,1903,88,na,1991,786
SIM,1939,15,40-44,1954,3
STAT,1826,42,na,1868,1494.2105047486443
STAT,1849,39,na,1888,1830.120594379893
STAT,1917,15,40-44,1932,0.34898174606154136
SIM,1871,43,45-49,1914,3
STAT,1950,37,45-49,1987,0.9583718178070766
SIM,1890,36,35-39,1926,18
SIM,1928,29,25-29,1957,176
SIM,1911,83,na,1994,2690
SIM,1970,19,na,1989,5349
STAT,1978,8,na,1986,6189.80557836714
STAT,1984,24,25-29,2008,151.79633884565223
STAT,1815,47,30-34,1862,0.1976271793947051
STAT,1852,53,40-44,1905,0.009766243053077503
STAT,1924,29,45-49,1953,2.3041629860598603
SIM,1965,32,na,1997,5559
SIM,1886,31,na,1917,2073
STAT,1853,24,45-49,1877,0.8085679237531301
STAT,1923,68,na,1991,4078.2866882593858
STAT,1908,51,na,1959,3790.2591097915247
STAT,1857,34,na,1891,2126.4785730137455
STAT,1850,24,20-24,1874,83.92960901029461
STAT,1806,52,30-34,1858,0.020952919619361108
STAT,1884,17,30-34,1901,1.8173633899994714
SIM,1904,6,na,1910,4461
STAT,1863,43,45-49,1906,1.4993649237304905
SIM,1944,68,na,2012,3895
SIM,1889,111,na,2000,8
SIM,1894,30,35-39,1924,33
SIM,1921,4,na,1925,5647
SIM,1901,29,15-19,1930,1
STAT,1970,31,45-49,2001,2.318507193265893
STAT,1909,39,20-24,1948,0.285373539476091
STAT,1939,43,na,1982,4453.343477432864
STAT,1831,29,na,1860,2217.982333783752
STAT,1854,17,15-19,1871,5.783646790959502
STAT,1946,48,35-39,1994,0.17117718853292332
SIM,1862,17,15-19,1879,9
STAT,1864,24,20-24,1888,71.11981724983924
STAT,1918,81,na,1999,2139.074766536986
STAT,1872,30,35-39,1902,11.82959617771775
SIM,1825,42,35-39,1867,1
STAT,1931,63,na,1994,5094.198199755153
SIM,1924,10,na,1934,5361
STAT,1864,36,15-19,1900,0.05814249775921487
STAT,1893,72,na,1965,2169.0331143930784
STAT,1845,100,na,1945,0.7153947194836281
SIM,1830,30,50-100,1860,1
STAT,1964,47,30-34,2011,0.13477763483758243
SIM,1872,24,20-24,1896,1
STAT,1835,24,25-29,1859,47.19501124760382
SIM,1934,40,na,1974,5793
STAT,1921,22,50-100,1943,0.8573660495495777
SIM,1848,48,45-49,1896,1
STAT,1950,19,45-49,1969,0.6811892231242054
SIM,1905,23,15-19,1928,6
STAT,1976,34,45-49,2010,2.4698331069114823
STAT,1903,0,na,1903,4826.683000537064
SIM,1901,53,na,1954,3652
STAT,1955,24,15-19,1979,8.176571456391741
STAT,1929,16,15-19,1945,67.00794924425986
STAT,1901,23,35-39,1924,9.403804977417611
SIM,1955,16,35-39,1971,13
STAT,1810,67,na,1877,1016.3279870205927
STAT,1817,42,35-39,1859,5.583435572829446
SIM,1860,53,40-44,1913,1
STAT,1831,48,25-29,1879,0.05268696685226878
SIM,1861,24,45-49,1885,4
SIM,1840,42,30-34,1882,3
STAT,1869,46,45-49,1915,0.2645044123355044
SIM,1851,32,35-39,1883,26
SIM,1916,15,na,1931,4693
STAT,1842,54,50-100,1896,0.011302350991656211
SIM,1979,16,20-24,1995,238
SIM,1968,31,40-44,1999,2
SIM,1972,33,50-100,2005,6
STAT,1866,53,40-44,1919,0.01108021739981118
STAT,1947,16,35-39,1963,5.456339908459237
SIM,1922,37,35-39,1959,11
STAT,1870,16,na,1886,2918.0026541662887
STAT,1828,27,15-19,1855,0.7361876031123599
SIM,1983,19,35-39,2002,1
STAT,1849,109,na,1958,9.663571064636188E-4
STAT,1879,28,50-100,1907,0.7681280439935567
STAT,1862,80,na,1942,602.4709766078184
STAT,1939,27,50-100,1966,1.1552465352144157
STAT,1821,98,na,1919,1.9867807814242444
STAT,1882,36,35-39,1918,8.01107623267886
STAT,1975,37,35-39,2012,3.7938522479417016
STAT,1832,42,30-34,1874,0.9769419709686269
STAT,1854,85,na,1939,223.33649328705397
SIM,1963,24,15-19,1987,8
STAT,1971,42,15-19,2013,0.0023327249455089975
SIM,1878,36,na,1914,2840
SIM,1832,82,na,1914,388
STAT,1825,32,15-19,1857,0.29826471143618094
SIM,1838,42,45-49,1880,4
STAT,1867,114,na,1981,1.7879147441204738E-4
STAT,1915,33,na,1948,4427.276899121287
SIM,1882,25,20-24,1907,18
STAT,1881,38,40-44,1919,4.84855705397079
STAT,1974,39,40-44,2013,2.3191365109438915
STAT,1867,32,20-24,1899,2.9125145173937397
STAT,1837,85,na,1922,198.5084500401633
STAT,1914,37,35-39,1951,2.7883272243565935
STAT,1848,38,25-29,1886,3.120027069680734
STAT,1820,45,45-49,1865,0.2611067214704589
SIM,1929,23,30-34,1952,4
STAT,1870,49,20-24,1919,0.013367633001010721
STAT,1933,31,30-34,1964,24.527913761054872
STAT,1929,34,15-19,1963,0.18814014284052497
STAT,1878,21,40-44,1899,2.5184776620821854
STAT,1809,48,15-19,1857,0.001012659168122786
SIM,1925,33,40-44,1958,3
SIM,1856,38,25-29,1894,5
STAT,1859,27,45-49,1886,1.0383253011874762
STAT,1925,16,50-100,1941,0.5234159070765841
STAT,1843,32,35-39,1875,12.215840111687951
SIM,1897,15,na,1912,4177
SIM,1813,44,na,1857,1370
STAT,1897,15,15-19,1912,9.200354508070433
STAT,1861,46,15-19,1907,3.8485213958012733E-4
SIM,1867,27,45-49,1894,2
STAT,1935,28,50-100,1963,1.5658976152028625
STAT,1860,16,30-34,1876,1.7198952889780743
STAT,1910,47,45-49,1957,0.23425681348576566
STAT,1917,33,40-44,1950,4.709299015854906
STAT,1956,37,40-44,1993,2.35515706483813
SIM,1868,40,35-39,1908,2
STAT,1854,35,15-19,1889,0.046448962048273514
SIM,1844,36,50-100,1880,1
SIM,1835,31,40-44,1866,2
STAT,1866,38,45-49,1904,2.12178022638922
SIM,1909,45,na,1954,4600
SIM,1906,94,na,2000,127
SIM,1959,22,50-100,1981,2
STAT,1872,11,na,1883,3063.838907471741
STAT,1918,31,35-39,1949,11.250095752005985
SIM,1877,43,40-44,1920,3
SIM,1844,36,na,1880,2433
SIM,1866,23,na,1889,2263
STAT,1890,26,15-19,1916,0.6419706560000578
STAT,1905,37,50-100,1942,0.4426312218341606
SIM,1884,36,na,1920,2718
STAT,1892,28,45-49,1920,1.6003275099382335
STAT,1906,56,na,1962,3590.708753004049
SIM,1880,30,35-39,1910,3
SIM,1906,39,45-49,1945,1
SIM,1981,20,na,2001,5964
SIM,1898,96,na,1994,81
STAT,1903,18,20-24,1921,29.065404379436956
STAT,1978,29,30-34,2007,61.91673722560906
SIM,1880,74,na,1954,1435
SIM,1937,16,15-19,1953,90
STAT,1861,67,na,1928,1520.869438739391
SIM,1986,15,40-44,2001,7
SIM,1888,1,na,1889,3184
STAT,1874,43,20-24,1917,0.18627382611022267
SIM,1981,21,45-49,2002,4
STAT,1885,32,40-44,1917,4.992034523522815
SIM,1964,19,na,1983,5555
STAT,1881,39,25-29,1920,3.172662092345421
SIM,1994,9,na,2003,6225
STAT,1891,41,25-29,1932,0.9200645733209498
STAT,1823,93,na,1916,16.549984954995033
SIM,1941,31,30-34,1972,21
SIM,1896,61,na,1957,3078
STAT,1850,42,20-24,1892,0.16328816445321392
SIM,1885,41,50-100,1926,3
STAT,1885,15,25-29,1900,6.553330512528505
STAT,1921,33,na,1954,4834.915805587707
STAT,1869,43,40-44,1912,2.4956501738944388
STAT,1827,31,40-44,1858,7.892985764181794
SIM,1874,38,45-49,1912,2
STAT,1967,27,45-49,1994,2.5012328993905144
STAT,1977,17,na,1994,5739.391072286845
SIM,1843,24,25-29,1867,57
SIM,1883,40,30-34,1923,1
STAT,1930,24,50-100,1954,0.9668244054497431
STAT,1805,109,na,1914,2.9237278104795293E-4
SIM,1905,83,na,1988,1005
SIM,1855,79,na,1934,396
STAT,1899,44,35-39,1943,0.19613064975001562
SIM,1932,29,45-49,1961,1
SIM,1831,37,40-44,1868,4
SIM,1926,31,35-39,1957,26
STAT,1794,63,na,1857,1134.7012885199756
STAT,1825,29,na,1854,1840.865320965823
STAT,1899,69,na,1968,2692.1569574979644
SIM,1846,34,20-24,1880,3
STAT,1868,77,na,1945,958.4100275018825
SIM,1841,40,25-29,1881,1
STAT,1855,49,25-29,1904,0.04798825836487867
STAT,1946,25,na,1971,4819.9362044458985
STAT,1856,46,35-39,1902,0.1236128654569615
STAT,1924,47,45-49,1971,0.298522098523575
STAT,1969,21,35-39,1990,13.623602602416604
SIM,1933,27,na,1960,5983
STAT,1824,52,20-24,1876,9.678578114094304E-4
STAT,1880,37,50-100,1917,1.501825577164463
STAT,1901,111,na,2012,0.02117253324442345
STAT,1954,8,na,1962,5606.958845437379
STAT,1838,34,20-24,1872,2.8501905149478435
STAT,1952,25,na,1977,5207.735645015932
SIM,1893,15,25-29,1908,19
STAT,1838,16,20-24,1854,20.408427560914067
SIM,1963,47,na,2010,6441
SIM,1846,16,20-24,1862,17
STAT,1824,34,20-24,1858,4.534865408647262
SIM,1832,34,20-24,1866,3
STAT,1943,23,40-44,1966,4.127430304386263
STAT,1882,22,45-49,1904,0.7860313369529119
STAT,1907,41,30-34,1948,0.1361717231789551
SIM,1890,22,45-49,1912,2
STAT,1937,48,na,1985,4270.703667843296
SIM,1918,10,na,1928,4313
STAT,1968,41,30-34,2009,0.1917848429730392
STAT,1875,40,30-34,1915,1.3849238501770447
SIM,1936,18,20-24,1954,132
STAT,1984,21,20-24,2005,182.91771836893813
SIM,1875,33,35-39,1908,46
SIM,1902,35,na,1937,4029
SIM,1899,33,20-24,1932,4
STAT,1833,40,25-29,1873,0.5658531257330487
STAT,1899,26,35-39,1925,15.307988801866038
STAT,1866,42,na,1908,2469.2013041080168
SIM,1846,62,na,1908,1099
STAT,1878,51,50-100,1929,0.01828521316952313
SIM,1938,31,25-29,1969,27
SIM,1964,30,50-100,1994,6
SIM,1867,42,40-44,1909,5
STAT,1894,8,na,1902,3856.52875439696
STAT,1810,53,35-39,1863,0.03088914149894001
STAT,1867,33,35-39,1900,10.865748656974882
STAT,1867,49,15-19,1916,4.219961615728547E-4
STAT,1871,97,na,1968,30.512008301881494
STAT,1859,42,40-44,1901,2.0652241152405186
STAT,1882,40,45-49,1922,1.7040580540064882
STAT,1848,85,na,1933,291.27542747997524
SIM,1970,17,15-19,1987,69
STAT,1909,26,45-49,1935,1.9303345988155878
STAT,1895,33,40-44,1928,6.487089192170175
STAT,1804,98,na,1902,1.4124624311161451
STAT,1990,21,15-19,2011,8.829660925861184
SIM,1861,21,40-44,1882,2
SIM,1959,32,na,1991,5969
STAT,1943,26,45-49,1969,2.1245212033691963
STAT,1928,18,20-24,1946,196.62425157206732
SIM,1833,36,na,1869,1756
SIM,1851,49,na,1900,2562
STAT,1880,46,na,1926,2759.9117300716234
SIM,1890,33,30-34,1923,35
SIM,1957,47,na,2004,6141
STAT,1863,40,40-44,1903,2.292669875691097
SIM,1838,67,na,1905,992
STAT,1882,51,30-34,1933,0.006741906938163352
SIM,1890,40,45-49,1930,3
STAT,1935,16,45-49,1951,0.79046502812151
SIM,1899,35,40-44,1934,7
SIM,1982,20,20-24,2002,5
SIM,1992,21,20-24,2013,14
SIM,1871,30,50-100,1901,1
STAT,1846,40,35-39,1886,1.9438240571731444
STAT,1899,43,20-24,1942,0.01731056584875591
STAT,1889,39,na,1928,3317.8089531320957
STAT,1838,46,15-19,1884,3.6112537195838744E-4
STAT,1940,36,50-100,1976,0.5074690790476847
STAT,1928,36,20-24,1964,0.3848105498578342
SIM,1918,19,15-19,1937,51
STAT,1827,34,50-100,1861,1.4426982617142152
SIM,1964,21,25-29,1985,5
STAT,1950,34,40-44,1984,5.436077348268979
SIM,1835,34,50-100,1869,2
STAT,1853,21,40-44,1874,2.469049128669322
STAT,1824,53,35-39,1877,0.011069944569991953
STAT,1832,45,35-39,1877,0.1179062982612869
STAT,1843,54,na,1897,2101.0365972410063
STAT,1882,33,30-34,1915,19.597802146897976
SIM,1944,27,15-19,1971,1
SIM,1965,37,45-49,2002,3
SIM,1988,23,20-24,2011,330
SIM,1893,32,40-44,1925,17
SIM,1992,7,na,1999,7039
STAT,1894,54,na,1948,3106.552435523665
SIM,1892,31,na,1923,3801
SIM,1888,33,45-49,1921,3
STAT,1871,50,40-44,1921,0.012260768252934517
STAT,1828,45,15-19,1873,3.78135583638034E-4
STAT,1891,89,na,1980,540.7064468941013
STAT,1950,16,40-44,1966,1.9091434028760388
SIM,1906,20,25-29,1926,189
SIM,1839,23,20-24,1862,122
STAT,1807,50,25-29,1857,0.014487773139697912
SIM,1856,92,na,1948,107
SIM,1905,15,na,1920,4478
SIM,1815,79,na,1894,436
STAT,1914,51,na,1965,4153.206428294847
STAT,1844,18,40-44,1862,0.1933238006756796
STAT,1830,75,na,1905,645.798931173372
SIM,1885,4,na,1889,3480
STAT,1845,80,na,1925,416.84414608279
STAT,1871,47,15-19,1918,4.5710911152550127E-4
SIM,1904,99,na,2003,110
SIM,1906,36,40-44,1942,4
STAT,1835,59,na,1894,1211.271649073171
STAT,1893,23,35-39,1916,8.48601988223078
SIM,1809,70,na,1879,950
SIM,1968,29,20-24,1997,24
STAT,1977,31,25-29,2008,14.699012962056628
STAT,1893,39,15-19,1932,0.08108927534506825
STAT,1956,30,50-100,1986,1.2884291405223751
SIM,1861,4,na,1865,2363
SIM,1910,30,na,1940,3789
STAT,1958,19,15-19,1977,68.74305482620512
STAT,1894,48,50-100,1942,0.20294535567763466
SIM,1966,19,15-19,1985,60
SIM,1840,18,na,1858,2350
STAT,1856,50,45-49,1906,0.012961061723414739
STAT,1932,74,na,2006,3970.7769620811446
STAT,1847,24,15-19,1871,3.0673639137932995
STAT,1935,13,na,1948,6244.775289328982
STAT,1936,27,15-19,1963,0.7801491281740326
STAT,1944,37,15-19,1981,0.02457168168282904
STAT,1887,72,na,1959,1779.344217198783
SIM,1925,9,na,1934,5602
SIM,1986,18,45-49,2004,2
SIM,1852,18,40-44,1870,1
STAT,1849,53,35-39,1902,0.006565472298370957
STAT,1850,43,35-39,1893,1.8506689793945186
SIM,1814,57,na,1871,1166
STAT,1910,44,40-44,1954,0.26973116684701515
STAT,1898,101,na,1999,19.908318598137186
STAT,1897,49,30-34,1946,0.08250085203178181
STAT,1841,19,30-34,1860,1.8062119807103696
SIM,1836,27,15-19,1863,1
STAT,1842,52,40-44,1894,0.008058164622209827
SIM,1932,45,na,1977,5411
STAT,1816,44,40-44,1860,4.74519042384586
SIM,1885,38,20-24,1923,3
SIM,1889,35,50-100,1924,2
STAT,1901,41,35-39,1942,0.20418698297707072
SIM,1832,35,35-39,1867,5
STAT,1824,35,35-39,1859,11.381588773847485
STAT,1940,45,35-39,1985,0.15792932308410626
STAT,1853,51,35-39,1904,0.008612353432641133
SIM,1945,35,50-100,1980,1
SIM,1857,74,na,1931,992
STAT,1906,46,40-44,1952,0.16297804653262787
STAT,1880,25,15-19,1905,0.5587528746698294
STAT,1855,46,20-24,1901,0.010239737104698884
STAT,1974,3,na,1977,5927.846148584866
SIM,1843,82,na,1925,156
STAT,1851,80,na,1931,490.54365944154773
STAT,1926,74,na,2000,3610.169234716652
STAT,1851,22,15-19,1873,3.1241443980947956
SIM,1932,44,40-44,1976,1
STAT,1860,19,35-39,1879,0.5816942706666423
STAT,1848,35,20-24,1883,0.8617573318657137
STAT,1796,98,na,1894,0.8274196144265963
SIM,1824,44,40-44,1868,3
STAT,1820,42,40-44,1862,2.781756978136502
STAT,1929,13,na,1942,5826.871786313327
STAT,1917,36,45-49,1953,0.8211105086101197
STAT,1864,16,na,1880,2704.7996816135023
STAT,1799,63,na,1862,1181.6252958525956
STAT,1817,41,20-24,1858,0.5027824051478685
STAT,1956,21,25-29,1977,141.56786985083792
SIM,1831,40,50-100,1871,2
STAT,1960,38,45-49,1998,1.0546030795966237
STAT,1851,40,15-19,1891,0.011061624250595987
SIM,1856,35,20-24,1891,2
STAT,1954,20,na,1974,5230.721313690407
SIM,1926,45,na,1971,5787
SIM,1925,36,45-49,1961,1
STAT,1877,38,20-24,1915,0.9207718399215173
STAT,1859,25,25-29,1884,40.133385461169105
STAT,1918,47,15-19,1965,4.5229403850405927E-4
STAT,1930,8,na,1938,5951.494537359028
SIM,1942,48,45-49,1990,1
SIM,1951,26,45-49,1977,4
STAT,1841,37,30-34,1878,5.582855265776085
SIM,1863,74,na,1937,1131
STAT,1969,35,15-19,2004,0.028570840638782773
SIM,1843,21,20-24,1864,6
STAT,1842,34,40-44,1876,3.948576437521443
SIM,1917,26,45-49,1943,9
STAT,1940,27,35-39,1967,17.673820237309865
SIM,1826,28,40-44,1854,8
STAT,1895,39,na,1934,3503.5102270465004
STAT,1858,16,na,1874,2428.3130696728495
STAT,1881,36,20-24,1917,0.8621841919147416
SIM,1827,36,na,1863,1558
STAT,1823,40,50-100,1863,1.151103164911081
SIM,1868,22,35-39,1890,12
SIM,1854,40,35-39,1894,6
STAT,1875,43,35-39,1918,2.1439679778055925
SIM,1883,43,35-39,1926,6
STAT,1867,0,na,1867,4073.1511532000113
STAT,1924,44,40-44,1968,0.34210966333627935
STAT,1874,46,25-29,1920,0.0682445707159494
STAT,1993,18,40-44,2011,2.3216711520146527
STAT,1818,47,na,1865,1241.0603432393166
STAT,1934,48,45-49,1982,0.3486515253072357
STAT,1827,34,45-49,1861,2.745780579566998
SIM,1972,14,na,1986,5831
SIM,1958,24,35-39,1982,23
STAT,1835,21,20-24,1856,64.40069031530706
STAT,1913,38,na,1951,4265.703453110414
SIM,1864,43,30-34,1907,2
SIM,1919,20,35-39,1939,32
STAT,1863,29,30-34,1892,25.22969151860054
STAT,1917,18,45-49,1935,0.12373487019241744
STAT,1849,50,30-34,1899,0.004679931770057024
STAT,1843,31,20-24,1874,3.294615804122877
SIM,1940,36,40-44,1976,1
SIM,1932,26,40-44,1958,9
SIM,1882,28,25-29,1910,65
STAT,1874,28,25-29,1902,49.80097813023889
STAT,1980,32,45-49,2012,2.569714810723534
STAT,1932,36,40-44,1968,2.323879697535491
SIM,1813,42,45-49,1855,1
SIM,1948,20,30-34,1968,1
STAT,1960,20,na,1980,5510.87646243771
STAT,1813,52,45-49,1865,0.046083224562831336
SIM,1851,31,20-24,1882,3
SIM,1879,89,na,1968,241
STAT,1924,26,40-44,1950,6.282799280660498
STAT,1850,25,35-39,1875,11.858898298431654
STAT,1925,63,na,1988,4614.161081435679
SIM,1913,29,40-44,1942,6
SIM,1904,28,25-29,1932,2
SIM,1845,39,30-34,1884,8
SIM,1807,75,na,1882,323
STAT,1923,15,35-39,1938,5.710621030423079
STAT,1857,16,25-29,1873,6.021870599362834
STAT,1827,55,na,1882,1789.2665149925817
STAT,1888,37,15-19,1925,0.07617785206228517
STAT,1860,44,35-39,1904,1.6615193044182044
STAT,1954,29,25-29,1983,94.21604894654368
SIM,1819,42,40-44,1861,2
STAT,1856,44,15-19,1900,0.011994732804996949
SIM,1842,24,40-44,1866,4
STAT,1971,30,na,2001,5641.29273241036
STAT,1897,112,na,2009,0.007256881627123327
STAT,1900,28,45-49,1928,1.7717316671325982
SIM,1926,86,na,2012,2023
SIM,1794,60,na,1854,940
SIM,1891,86,na,1977,582
STAT,1831,100,na,1931,0.8329317450615488
STAT,1911,46,20-24,1957,0.012114110612867254
STAT,1868,19,50-100,1887,0.054654565159857366
SIM,1849,21,50-100,1870,1
STAT,1823,38,25-29,1861,3.287457610423841
SIM,1995,4,na,1999,6768
STAT,1947,15,20-24,1962,176.33583092601611
SIM,1873,36,na,1909,3334
SIM,1831,38,25-29,1869,7
STAT,1954,23,50-100,1977,0.9415314649976502
SIM,1815,70,na,1885,884
SIM,1931,15,35-39,1946,16
STAT,1967,46,40-44,2013,0.23699482792017237
STAT,1837,50,40-44,1887,0.007960188886725403
STAT,1981,16,35-39,1997,6.773278881898552
SIM,1962,29,25-29,1991,192
STAT,1805,100,na,1905,0.4362806279250224
SIM,1923,32,25-29,1955,16
STAT,1825,52,35-39,1877,0.011584967961123757
STAT,1930,79,na,2009,3027.847984688356
STAT,1883,31,25-29,1914,11.612106807653769
STAT,1973,35,50-100,2008,0.64672477373681
SIM,1858,39,40-44,1897,12
SIM,1899,41,na,1940,4031
SIM,1909,29,20-24,1938,44
STAT,1812,48,20-24,1860,0.027364049722315237
STAT,1874,45,40-44,1919,0.20428024977041712
STAT,1967,24,40-44,1991,4.8597760672473225
SIM,1955,15,20-24,1970,242
SIM,1971,33,20-24,2004,8
STAT,1933,5,na,1938,6214.275977062179
STAT,1936,63,na,1999,3777.618102349962
STAT,1950,3,na,1953,5412.212219940402
STAT,1909,23,40-44,1932,3.599291569730758
STAT,1893,0,na,1893,4283.288488562381
STAT,1884,18,45-49,1902,0.07428694792611215
STAT,1931,23,15-19,1954,7.944722837114848
SIM,1824,56,na,1880,1137
SIM,1814,41,45-49,1855,4
SIM,1877,28,20-24,1905,24
SIM,1888,19,30-34,1907,3
STAT,1931,37,40-44,1968,2.288474641217483
STAT,1915,32,25-29,1947,10.865288067794596
STAT,1834,24,40-44,1858,2.5069054675061215
STAT,1856,43,30-34,1899,1.0049124821258661
SIM,1891,31,25-29,1922,14
STAT,1847,42,15-19,1889,0.010685297225957334
STAT,1844,39,na,1883,2039.5749693305631
STAT,1869,106,na,1975,0.30413137581084565
SIM,1988,26,25-29,2014,1
STAT,1970,30,30-34,2000,23.226425879797574
SIM,1949,16,40-44,1965,2
STAT,1911,28,20-24,1939,20.488915307569346
SIM,1898,36,40-44,1934,7
STAT,1979,29,15-19,2008,1.1254797715959528
STAT,1870,25,50-100,1895,0.7327310931850761
STAT,1980,19,25-29,1999,69.38012065759395
STAT,1867,9,na,1876,2949.064114680206
SIM,1917,23,40-44,1940,4
STAT,1872,16,20-24,1888,20.733558421977595
SIM,1916,83,na,1999,1451
STAT,1979,24,20-24,2003,177.14965845257112
STAT,1824,50,30-34,1874,0.008123280148075633
STAT,1783,88,na,1871,33.797046015526924
STAT,1851,42,35-39,1893,1.4341980542751116
STAT,1878,18,15-19,1896,7.132134669676137
SIM,1976,23,40-44,1999,14
STAT,1837,39,30-34,1876,4.602183310983635
STAT,1882,34,15-19,1916,0.15914972319907864
STAT,1917,97,na,2014,129.3962021391052
STAT,1988,20,45-49,2008,1.8645678636450425
STAT,1922,18,25-29,1940,57.70143195629787
STAT,1905,15,15-19,1920,9.958668075796284
SIM,1929,25,20-24,1954,50
SIM,1829,48,40-44,1877,1
SIM,1951,9,na,1960,6323
SIM,1987,24,20-24,2011,6
STAT,1876,44,50-100,1920,1.2433127437280886
SIM,1952,37,na,1989,4735
STAT,1955,26,35-39,1981,23.11077497698467
SIM,1930,18,25-29,1948,92
STAT,1977,16,15-19,1993,70.78581395025132
SIM,1855,24,15-19,1879,8
STAT,1820,104,na,1924,0.03914623330829215
STAT,1918,13,na,1931,4968.283446724403
SIM,1878,27,20-24,1905,16
STAT,1840,23,20-24,1863,69.79711640555968
SIM,1913,15,15-19,1928,14
SIM,1928,71,na,1999,4025
STAT,1838,52,45-49,1890,0.012506240209204707
STAT,1894,24,50-100,1918,0.6011858220100597
SIM,1886,21,40-44,1907,7
STAT,1977,0,na,1977,6176.303902427704
STAT,1859,45,45-49,1904,0.21911886941202932
STAT,1861,16,45-49,1877,0.0724597201847093
STAT,1936,33,45-49,1969,1.763839496915524
STAT,1941,22,25-29,1963,110.1887181095827
STAT,1899,38,na,1937,3735.7369443387984
SIM,1900,1,na,1901,4036
STAT,1884,101,na,1985,12.11556785966836
STAT,1815,67,na,1882,1026.1483271334012
STAT,1873,48,30-34,1921,0.1126444260716234
STAT,1934,78,na,2012,3395.8732069474004
STAT,1838,39,na,1877,2192.631266212478
STAT,1910,4,na,1914,4605.080807020515
STAT,1968,23,40-44,1991,4.860958723579518
STAT,1906,45,35-39,1951,0.13422406210737028
SIM,1898,18,40-44,1916,1
SIM,1890,16,15-19,1906,17
STAT,1859,69,na,1928,1349.1195499411565
STAT,1871,17,20-24,1888,20.486051783647213
STAT,1898,111,na,2009,0.019970542845407023
SIM,1940,39,45-49,1979,2
SIM,1881,48,30-34,1929,1
SIM,1949,34,40-44,1983,2
SIM,1918,22,40-44,1940,6
STAT,1945,21,50-100,1966,0.8325238160890149
STAT,1846,44,20-24,1890,0.161961973623038
STAT,1888,43,45-49,1931,2.015637584789857
SIM,1890,36,na,1926,3362
STAT,1828,77,na,1905,573.6965637223841
SIM,1839,26,25-29,1865,59
STAT,1836,36,50-100,1872,1.3862753964503471
SIM,1914,45,35-39,1959,1
SIM,1858,20,20-24,1878,5
SIM,1866,54,na,1920,2102
STAT,1931,19,40-44,1950,2.1019358215812622
STAT,1832,31,45-49,1863,1.601636480382737
SIM,1970,23,45-49,1993,6
SIM,1822,52,na,1874,1499
STAT,1962,39,15-19,2001,0.029192163874252462
STAT,1832,43,15-19,1875,0.011583007817132
STAT,1925,42,50-100,1967,0.16408940468410174
STAT,1955,23,30-34,1978,44.16287896035866
SIM,1887,53,na,1940,3425
SIM,1944,33,45-49,1977,9
STAT,1856,15,50-100,1871,0.05161033977556089
STAT,1877,41,50-100,1918,1.2739506655052544
STAT,1850,40,30-34,1890,1.1954635679631804
SIM,1871,25,45-49,1896,6
STAT,1837,54,na,1891,1516.293149385943
STAT,1843,85,na,1928,275.0612693138515
STAT,1784,100,na,1884,0.2327597854959124
STAT,1829,38,20-24,1867,0.8664254188073404
SIM,1979,17,35-39,1996,13
STAT,1868,46,na,1914,2501.6331052565884
STAT,1934,45,40-44,1979,0.25481887117381363
SIM,1905,25,35-39,1930,4
STAT,1861,23,50-100,1884,0.3990471845357885
STAT,1863,25,45-49,1888,1.1366823223514548
STAT,1896,35,20-24,1931,1.1861533074060757
SIM,1963,23,30-34,1986,105
SIM,1837,38,20-24,1875,2
SIM,1946,37,na,1983,4645
SIM,1902,66,na,1968,3103
STAT,1906,49,45-49,1955,0.21935236217347454
SIM,1853,44,na,1897,2215
SIM,1845,35,45-49,1880,5
STAT,1976,18,20-24,1994,208.96355163621203
SIM,1854,26,20-24,1880,12
STAT,1962,23,45-49,1985,1.668715356597077
SIM,1840,31,45-49,1871,2
SIM,1867,22,20-24,1889,69
STAT,1832,25,15-19,1857,0.4489602283452167
STAT,1900,43,40-44,1943,0.2483158426126461
STAT,1916,19,45-49,1935,0.12166805928844725
STAT,1821,67,na,1888,967.028421635858
SIM,1796,95,na,1891,3
SIM,1940,20,25-29,1960,7
SIM,1979,32,45-49,2011,2
SIM,1848,28,25-29,1876,84
SIM,1923,65,na,1988,4436
STAT,1859,22,20-24,1881,65.72941233281723
STAT,2004,1,na,2005,6944.114134665362
STAT,1809,109,na,1918,3.3067208075614933E-4
SIM,1849,25,35-39,1874,23
STAT,1896,17,20-24,1913,27.02335400619646
STAT,1905,47,40-44,1952,0.16055278149038263
SIM,1891,9,na,1900,3656
STAT,1801,54,50-100,1855,0.05766658017059712
SIM,1937,33,30-34,1970,5
STAT,1841,44,50-100,1885,0.95133891193266
STAT,1960,35,40-44,1995,2.3221626725327584
STAT,1837,35,45-49,1872,1.7944147458935231
STAT,1932,39,45-49,1971,1.0550659865575744
STAT,1905,29,40-44,1934,4.96779589066786
STAT,1846,26,20-24,1872,14.777700685452801
SIM,1981,29,na,2010,6396
SIM,1948,23,35-39,1971,27
STAT,1976,33,30-34,2009,24.745355210684178
STAT,1817,93,na,1910,20.205271561354692
STAT,1929,33,30-34,1962,23.082155455663173
STAT,1962,17,15-19,1979,67.10732247815886
STAT,1907,17,45-49,1924,0.1109159599654042
SIM,1838,36,na,1874,1820
SIM,1863,28,20-24,1891,11
STAT,1857,43,15-19,1900,0.012322757732974551
SIM,1813,75,na,1888,511
STAT,1885,22,50-100,1907,0.4694113161613129
STAT,1873,28,40-44,1901,3.517815207973424
STAT,1941,40,25-29,1981,0.08848069438443988
STAT,1972,38,25-29,2010,1.4973539720849838
STAT,1936,15,45-49,1951,0.5548267398710005
SIM,1829,62,na,1891,1126
SIM,1949,20,15-19,1969,11
SIM,1849,43,35-39,1892,2
SIM,1881,28,40-44,1909,8
STAT,1821,33,50-100,1854,3.7025848903573526
STAT,1806,93,na,1899,10.030760448806907
STAT,1874,46,na,1920,2665.6149160661744
STAT,1898,48,30-34,1946,0.08409354870117168
STAT,1951,33,40-44,1984,5.478365563235794
SIM,1897,46,na,1943,3528
STAT,1928,8,na,1936,5799.563915678794
STAT,1932,20,25-29,1952,140.7356068389466
STAT,1983,27,45-49,2010,2.832597383240386
SIM,1861,48,na,1909,1678
SIM,1869,28,na,1897,1906
STAT,1904,21,na,1925,3931.236970260385
STAT,1834,27,45-49,1861,1.328650341634839
STAT,1827,28,15-19,1855,1.2425726051037738
STAT,1868,113,na,1981,5.925343838042537E-4
STAT,1883,33,15-19,1916,0.1601128662673538
STAT,1819,37,20-24,1856,2.2785223160662857
STAT,1876,29,40-44,1905,3.548102883156191
STAT,1874,48,45-49,1922,0.27531814553227324
STAT,1817,46,50-100,1863,0.7112666956247641
SIM,1864,39,50-100,1903,1
SIM,1962,26,20-24,1988,27
SIM,1901,22,na,1923,4359
STAT,1954,26,20-24,1980,26.166594779847635
STAT,1934,18,50-100,1952,0.5835807738652901
STAT,1924,79,na,2003,2736.139949329826
STAT,1949,39,50-100,1988,0.579325446221227
STAT,1762,111,na,1873,0.0016165497797087877
SIM,1899,34,35-39,1933,29
STAT,1868,47,45-49,1915,0.26044924450328905
STAT,1855,28,20-24,1883,10.330113400594843
STAT,1834,54,35-39,1888,0.007742858007232274
STAT,1897,34,na,1931,3650.870072447364
SIM,1871,29,30-34,1900,3
SIM,1887,49,40-44,1936,1
SIM,1855,70,na,1925,853
SIM,1891,47,40-44,1938,1
SIM,1853,27,20-24,1880,18
STAT,1984,22,35-39,2006,15.484281487536563
STAT,1856,80,na,1936,544.6426577512816
STAT,1823,37,40-44,1860,8.204356690059331
SIM,1987,27,25-29,2014,214
STAT,1850,22,30-34,1872,22.008770818032463
SIM,1842,54,35-39,1896,1
STAT,1866,18,25-29,1884,6.18497498350672
STAT,1915,64,na,1979,3784.0954097598365
SIM,1975,29,na,2004,5854
SIM,1851,18,na,1869,3030
SIM,1965,35,25-29,2000,1
STAT,1976,36,35-39,2012,3.845525776421758
STAT,1823,35,20-24,1858,1.633995864384072
STAT,1804,67,na,1871,990.7424458619861
STAT,1876,72,na,1948,1506.6069163814177
STAT,1904,16,15-19,1920,9.859006021704586
STAT,1979,27,25-29,2006,105.03922204846477
STAT,1842,36,30-34,1878,4.861286437029954
STAT,1900,25,40-44,1925,4.829507390344329
SIM,1833,67,na,1900,946
STAT,1837,53,45-49,1890,0.01034018322969891
SIM,1825,46,50-100,1871,2
STAT,1845,27,20-24,1872,9.62215576336548
STAT,1883,47,40-44,1930,0.1923994218318329
STAT,1987,21,45-49,2008,1.8604594749735979
STAT,1930,48,50-100,1978,0.34283060486583666
SIM,1888,44,30-34,1932,3
SIM,1908,21,40-44,1929,4
SIM,1823,74,na,1897,1111
STAT,1873,32,15-19,1905,0.1678259985369418
SIM,1941,34,35-39,1975,1
STAT,1958,22,40-44,1980,5.113288778214011
STAT,1835,22,35-39,1857,5.024044343654731
STAT,1890,107,na,1997,0.48533441900298724
SIM,1844,21,35-39,1865,10
SIM,1949,19,45-49,1968,2
SIM,1842,44,na,1886,2116
SIM,1830,56,na,1886,1443
SIM,1864,28,na,1892,2589
STAT,1975,34,30-34,2009,24.4187085789917
SIM,1820,35,45-49,1855,8
SIM,1992,22,35-39,2014,1
SIM,1908,98,na,2006,30
STAT,1911,15,45-49,1926,0.11599666910853455
SIM,1850,36,30-34,1886,11
SIM,1898,39,45-49,1937,4
STAT,1867,15,35-39,1882,0.6115955119705191
STAT,1939,12,na,1951,4569.056358140039
SIM,1889,9,na,1898,4142
SIM,1843,22,35-39,1865,12
STAT,1925,43,40-44,1968,0.34880829677226693
SIM,1933,43,40-44,1976,1
STAT,1861,36,na,1897,2271.2206610867147
SIM,1836,30,40-44,1866,15
SIM,1934,49,na,1983,5656
SIM,1848,66,na,1914,1007
STAT,1858,47,na,1905,2016.0571622747161
SIM,1901,9,na,1910,4489
STAT,1980,16,20-24,1996,217.26414255952994
STAT,1788,109,na,1897,3.229234466608201E-4
STAT,1933,34,35-39,1967,14.20020639025809
STAT,1836,21,35-39,1857,7.062024287747084
STAT,1850,27,25-29,1877,51.246150617663766
STAT,1901,20,30-34,1921,28.965045128545125
STAT,1976,31,40-44,2007,6.1537354881015185
STAT,1879,49,40-44,1928,0.2019918615131223
STAT,1964,28,35-39,1992,21.906293322380616
STAT,1968,37,20-24,2005,0.3914631922720536
SIM,1875,15,35-39,1890,1
STAT,1879,47,20-24,1926,0.014392812788814262
STAT,1903,48,15-19,1951,3.6623032895377497E-4
SIM,1957,39,50-100,1996,1
SIM,1913,10,na,1923,5094
STAT,1869,90,na,1959,138.21778834522277
STAT,1872,19,25-29,1891,6.531402005408088
STAT,1858,27,30-34,1885,23.20811057028079
STAT,1875,42,20-24,1917,0.18916651202360396
STAT,1881,18,20-24,1899,19.68244078250023
SIM,1866,27,30-34,1893,38
STAT,1944,21,35-39,1965,11.73695620555946
STAT,1812,93,na,1905,12.830922458358572
STAT,1969,18,50-100,1987,0.5399414793376933
SIM,1877,54,na,1931,2788
STAT,1824,32,30-34,1856,41.394213802716315
STAT,1927,19,20-24,1946,193.45391173048552
SIM,1832,32,30-34,1864,3
SIM,1867,24,40-44,1891,7
STAT,1882,44,50-100,1926,1.1747741970432053
STAT,1922,15,20-24,1937,181.8358109572553
SIM,1865,41,25-29,1906,1
SIM,1890,44,50-100,1934,5
STAT,1846,47,25-29,1893,0.05926824254385956
STAT,1882,72,na,1954,1423.5540811273133
SIM,1842,29,50-100,1871,4
SIM,1858,28,na,1886,2673
SIM,1886,18,15-19,1904,10
SIM,1963,26,35-39,1989,29
SIM,1969,31,45-49,2000,11
SIM,1941,53,na,1994,3807
STAT,1816,46,30-34,1862,0.20041366942069241
STAT,1927,0,na,1927,6463.087035475053
STAT,1917,49,20-24,1966,0.013243393204727153
STAT,1850,45,25-29,1895,0.059887247973869503
SIM,1944,30,40-44,1974,14
STAT,1870,47,na,1917,2547.7648223449924
SIM,1817,74,na,1891,238
SIM,1832,37,25-29,1869,3
STAT,1839,20,45-49,1859,0.7208676882938037
SIM,1901,84,na,1985,1827
STAT,1843,48,15-19,1891,3.9630904606370273E-4
STAT,1859,24,40-44,1883,1.9591184408412308
STAT,1924,13,na,1937,5435.3294997509465
STAT,1864,47,na,1911,2307.521304808732
STAT,1956,23,15-19,1979,8.153072318882144
STAT,1824,37,25-29,1861,4.414045343196563
STAT,1951,48,15-19,1999,5.250906499428705E-4
STAT,1920,36,15-19,1956,0.024276045785978473
STAT,1938,38,35-39,1976,2.835312297327332
STAT,1828,30,40-44,1858,5.3548602357910875
STAT,1903,76,na,1979,2273.732901041818
SIM,1905,22,30-34,1927,1
STAT,1945,12,na,1957,4952.053793872676
SIM,1847,20,45-49,1867,1
SIM,1966,22,40-44,1988,5
SIM,1878,41,35-39,1919,6
SIM,1936,39,25-29,1975,1
SIM,1907,10,na,1917,4830
SIM,1972,3,na,1975,5842
STAT,1906,42,30-34,1948,0.13418713581756467
SIM,1888,35,na,1923,2805
SIM,1896,40,40-44,1936,1
SIM,1989,21,15-19,2010,16
STAT,1936,30,40-44,1966,4.394182933307288
STAT,1888,40,40-44,1928,3.082099292719696
STAT,1837,32,40-44,1869,3.9373246271223685
SIM,1945,4,na,1949,4846
STAT,1968,26,45-49,1994,2.5020918865600996
SIM,1845,32,40-44,1877,2
SIM,1804,64,na,1868,818
SIM,1828,39,25-29,1867,7
STAT,1860,17,45-49,1877,0.07007232615218152
STAT,1885,46,na,1931,2597.1655094970306
STAT,1900,46,45-49,1946,0.21378356991530853
STAT,1885,35,45-49,1920,2.3165142516780683
STAT,1942,43,50-100,1985,0.14703464347077017
STAT,1896,31,35-39,1927,15.499629451703761
STAT,1878,36,15-19,1914,0.06798942072244187
STAT,1901,43,50-100,1944,0.11773204961751661
SIM,1950,43,50-100,1993,1
SIM,1926,17,20-24,1943,226
STAT,1875,15,30-34,1890,1.909672982374596
STAT,1833,55,na,1888,1471.2615830768884
SIM,1912,65,na,1977,2999
SIM,1861,18,15-19,1879,10
SIM,1894,97,na,1991,189
STAT,1853,18,15-19,1871,7.065739049521269
SIM,1854,29,25-29,1883,52
SIM,1845,18,na,1863,2492
STAT,1894,19,45-49,1913,0.09638879655083435
STAT,1846,29,25-29,1875,52.14607574102104
STAT,1870,49,50-100,1919,0.27359087792184067
SIM,1893,35,45-49,1928,2
SIM,1946,38,35-39,1984,7
STAT,1929,36,35-39,1965,3.5870579761086674
SIM,1822,33,20-24,1855,6
STAT,1863,22,40-44,1885,2.144699061604482
STAT,1983,25,25-29,2008,108.01303325665644
STAT,1928,39,25-29,1967,1.4329406355234067
SIM,1935,19,20-24,1954,336
SIM,1871,22,40-44,1893,5
STAT,1918,17,20-24,1935,34.1594555432573
SIM,1805,49,na,1854,1566
STAT,1841,59,na,1900,1727.914837263019
STAT,1854,20,40-44,1874,2.0236612944087664
STAT,1930,13,na,1943,5903.324801352677
SIM,1830,24,15-19,1854,4
STAT,1894,37,45-49,1931,2.9574156799015086
SIM,1884,29,40-44,1913,8
SIM,1904,25,20-24,1929,3
SIM,1982,23,25-29,2005,1
STAT,1848,22,45-49,1870,0.902150202686908
STAT,1907,44,35-39,1951,0.21063253838838802
SIM,1810,64,na,1874,852
SIM,1837,41,50-100,1878,4
STAT,1972,35,20-24,2007,0.4019877655133256
STAT,1999,6,na,2005,6702.243463150501
STAT,1962,20,40-44,1982,4.991718581844948
SIM,1957,37,na,1994,6228
STAT,1816,49,50-100,1865,0.48600840778503135
STAT,1877,57,na,1934,2412.451331433624
SIM,1937,36,35-39,1973,2
SIM,1801,90,na,1891,6
SIM,1894,35,na,1929,3872
STAT,1921,47,20-24,1968,0.014371922115394212
STAT,1834,29,50-100,1863,0.7545384235110201
STAT,1943,39,20-24,1982,0.3316829955446933
SIM,1812,90,na,1902,19
SIM,1970,20,40-44,1990,1
STAT,1875,34,50-100,1909,1.083354899082511
STAT,1885,17,45-49,1902,0.0751933403696067
SIM,1841,15,25-29,1856,12
STAT,1825,97,na,1922,3.799938798554519
STAT,1922,81,na,2003,2308.727645450089
SIM,1890,73,na,1963,1738
SIM,1947,33,25-29,1980,2
SIM,1876,44,40-44,1920,6
STAT,1855,15,45-49,1870,0.06689570270738363
STAT,1862,45,15-19,1907,3.9345650852838464E-4
STAT,1826,38,40-44,1864,3.43157771266066
STAT,1835,20,50-100,1855,0.5309869204593257
SIM,1907,41,na,1948,4426
STAT,1953,15,15-19,1968,63.391203281314034
STAT,1849,25,30-34,1874,23.472241889678628
SIM,1896,21,35-39,1917,14
STAT,1921,28,15-19,1949,0.9044586902517281
SIM,1968,5,na,1973,5402
STAT,1902,40,35-39,1942,0.2071149552237315
STAT,1915,24,40-44,1939,3.986645467802295
SIM,1853,41,35-39,1894,4
STAT,1887,41,na,1928,3002.704902094525
STAT,1890,39,na,1929,3288.77442145636
STAT,1893,45,45-49,1938,0.19612593230466074
STAT,1899,100,na,1999,31.68380412271776
STAT,1786,99,na,1885,0.6152052957811224
SIM,1953,45,50-100,1998,1
SIM,1840,49,na,1889,1789
SIM,1952,40,40-44,1992,1
STAT,1888,21,35-39,1909,7.940163922071627
STAT,1975,15,35-39,1990,6.391889441640114
SIM,1924,46,35-39,1970,1
STAT,1897,21,45-49,1918,1.079309222901205
STAT,1906,6,na,1912,4396.2603358224615
STAT,1914,82,na,1996,1846.0458157059513
SIM,1960,28,45-49,1988,5
SIM,1863,15,45-49,1878,1
SIM,1821,38,30-34,1859,6
SIM,1883,21,25-29,1904,143
SIM,1938,33,na,1971,4048
SIM,1882,78,na,1960,1377
STAT,1906,24,30-34,1930,29.78812113498623
STAT,1788,100,na,1888,0.3388428639039954
STAT,1937,38,20-24,1975,0.304061105274623
SIM,1971,28,20-24,1999,53
SIM,1874,15,20-24,1889,40
STAT,1843,51,40-44,1894,0.010613784223529944
STAT,1940,37,na,1977,4543.148872629088
STAT,1963,28,20-24,1991,26.86597334595492
STAT,1794,94,na,1888,5.734575453665014
STAT,1866,15,20-24,1881,19.695861397612116
SIM,1836,33,45-49,1869,3
SIM,1837,51,na,1888,2036
STAT,1884,45,35-39,1929,0.16122239025440036
SIM,1848,25,20-24,1873,12
STAT,1952,28,45-49,1980,2.398409932418587
SIM,1945,38,20-24,1983,1
SIM,1883,15,30-34,1898,3
SIM,1893,16,na,1909,3714
SIM,1825,32,na,1857,1822
SIM,1933,46,45-49,1979,1
STAT,1986,25,50-100,2011,1.6452514236763103
SIM,1899,31,30-34,1930,47
SIM,1957,15,50-100,1972,3
SIM,1914,24,30-34,1938,92
SIM,1897,27,25-29,1924,132
STAT,1927,25,15-19,1952,0.9969443381796453
STAT,1944,40,40-44,1984,0.32373571885222574
STAT,1975,2,na,1977,5991.259668775145
SIM,1880,43,na,1923,3241
STAT,1852,28,40-44,1880,3.2659106387259995
STAT,1845,49,30-34,1894,0.06386722011165351
STAT,1936,25,50-100,1961,1.1009193849520498
STAT,1974,41,na,2015,5824.58809969677
SIM,1983,15,35-39,1998,10
STAT,1851,39,45-49,1890,1.5649143520032096
SIM,1926,14,na,1940,6149
STAT,1823,41,15-19,1864,0.014783300709391642
STAT,1875,45,25-29,1920,0.06937834013778432
STAT,1883,15,50-100,1898,0.05557336015233511
SIM,1857,25,30-34,1882,33
STAT,1973,33,15-19,2006,0.19538392568045534
STAT,1913,38,35-39,1951,2.742453941546966
STAT,1856,26,15-19,1882,0.4169277076264951
SIM,1921,38,35-39,1959,5
SIM,1908,45,40-44,1953,1
SIM,1911,24,50-100,1935,1
STAT,1914,86,na,2000,1232.699725385168
STAT,1953,39,15-19,1992,0.027561012369759837
STAT,1930,28,25-29,1958,96.55228096952919
SIM,1950,36,35-39,1986,8
STAT,1863,54,50-100,1917,0.01482123874566665
STAT,1939,33,25-29,1972,10.88088783974649
STAT,1868,44,40-44,1912,2.4602609369081967
SIM,1968,38,45-49,2006,1
STAT,1987,15,15-19,2002,74.8085760376722
STAT,1931,7,na,1938,6039.416970028669
STAT,1920,17,45-49,1937,0.6465147179332777
STAT,1845,41,35-39,1886,1.2586004796348897
STAT,1837,47,15-19,1884,3.006744591099436E-4
STAT,1974,23,35-39,1997,14.23129381899958
STAT,1955,7,na,1962,6021.7647716147
SIM,1957,25,35-39,1982,30
STAT,1947,35,40-44,1982,2.0083546970813364
STAT,1942,36,35-39,1978,3.008546093893182
STAT,1872,37,25-29,1909,3.336420042234931
STAT,1844,43,40-44,1887,1.9022830647962878
STAT,1936,46,20-24,1982,0.01267973614968851
SIM,1915,76,na,1991,2740
STAT,1912,101,na,2013,24.767410371772048
STAT,1825,49,45-49,1874,0.32054347970810226
STAT,1858,84,na,1942,299.49201419035563
STAT,1854,54,na,1908,1705.9404512532774
STAT,1840,47,50-100,1887,0.1986796460395256
STAT,1841,18,50-100,1859,0.055847742800040026
STAT,1907,22,25-29,1929,97.20159955989816
STAT,1975,18,50-100,1993,0.5702193467597904
STAT,1851,20,25-29,1871,54.997985895913274
SIM,1929,28,25-29,1957,106
STAT,1854,23,45-49,1877,0.6627116456291513
SIM,1843,51,na,1894,1667
SIM,1889,42,25-29,1931,3
STAT,1973,28,35-39,2001,22.49445973680834
STAT,1839,36,25-29,1875,2.757108767268069
STAT,1945,49,35-39,1994,0.16807156904424764
STAT,1864,20,35-39,1884,6.198508282681738
STAT,1921,64,na,1985,4231.1132111760835
STAT,1894,34,40-44,1928,6.378606265183608
SIM,1978,34,50-100,2012,4
SIM,1981,28,35-39,2009,16
SIM,1873,26,25-29,1899,2
STAT,1949,25,35-39,1974,20.255468890563126
STAT,1973,24,na,1997,5464.765097464777
STAT,1879,29,20-24,1908,14.03558322755695
STAT,1889,27,25-29,1916,60.176701373159524
STAT,1959,36,15-19,1995,0.029892938495233237
STAT,1811,43,45-49,1854,5.5983871538219585
STAT,1895,76,na,1971,1953.5405080880064
SIM,1901,0,na,1901,4853
STAT,1922,40,20-24,1962,0.02344787517430069
SIM,1915,22,25-29,1937,9
STAT,1848,54,na,1902,2224.887329790379
STAT,1910,19,50-100,1929,0.08530151565579283
SIM,1879,31,45-49,1910,8
STAT,1868,8,na,1876,3046.197933646787
SIM,1847,36,25-29,1883,10
STAT,1858,52,30-34,1910,0.0053304682724074105
SIM,1934,35,40-44,1969,4
STAT,1848,33,30-34,1881,19.48381740893884
STAT,1858,30,20-24,1888,2.484592492913687
SIM,1856,33,30-34,1889,24
STAT,1807,78,na,1885,442.67788286320734
STAT,1800,54,25-29,1854,0.01345808156409522
SIM,1918,19,na,1937,3906
SIM,1899,16,35-39,1915,2
STAT,1901,10,na,1911,4187.217272067906
STAT,1828,33,45-49,1861,1.9471038134997125
STAT,1926,35,40-44,1961,2.114569563179802
SIM,1851,86,na,1937,772
STAT,1923,32,20-24,1955,3.225825309960008
STAT,1922,18,na,1940,4900.9835686570295
STAT,1884,39,na,1923,2659.297848080296
SIM,1991,22,20-24,2013,196
STAT,1788,94,na,1882,6.437593080745602
STAT,1904,38,25-29,1942,1.0247697064237973
STAT,1865,26,25-29,1891,44.19776766590088
STAT,1899,104,na,2003,4.257023759405807
STAT,1829,25,45-49,1854,4.0380662356376185
STAT,1962,36,20-24,1998,0.40194943750307904
SIM,1893,22,50-100,1915,1
STAT,1867,48,50-100,1915,0.2613060578724921
STAT,1826,73,na,1899,653.9832088633277
STAT,1851,12,na,1863,2301.6228096405207
STAT,1948,33,35-39,1981,12.29437650896113
SIM,1888,27,15-19,1915,5
SIM,1969,25,na,1994,5804
SIM,1833,30,25-29,1863,23
STAT,1898,19,na,1917,3918.01340356701
STAT,1864,84,na,1948,342.78998447870094
STAT,1974,17,40-44,1991,2.107762444454038
STAT,1942,32,na,1974,4650.174052010999
SIM,1982,17,40-44,1999,3
SIM,1817,37,na,1854,1642
STAT,1973,28,na,2001,5612.768485144655
SIM,1909,76,na,1985,3237
SIM,1823,37,na,1860,2405
STAT,1983,22,20-24,2005,182.13039815975142
SIM,1956,33,35-39,1989,29
SIM,1880,37,25-29,1917,9
SIM,1971,36,25-29,2007,5
STAT,1889,76,na,1965,1728.343030410814
STAT,1903,46,25-29,1949,0.05355992434391291
SIM,1852,43,40-44,1895,2
STAT,1819,51,35-39,1870,0.016263908932021173
STAT,1973,25,40-44,1998,6.992967332391028
STAT,1778,103,na,1881,0.07099195561648367
SIM,1912,38,25-29,1950,2
SIM,1833,49,45-49,1882,1
STAT,1927,47,50-100,1974,0.3275765937670077
STAT,1947,18,25-29,1965,56.31589700091058
SIM,1955,18,25-29,1973,164
STAT,1820,39,15-19,1859,0.076246458596743
STAT,1868,29,45-49,1897,1.2222694815191735
SIM,1905,19,40-44,1924,1
STAT,1825,30,25-29,1855,25.18861932611549
SIM,1972,28,25-29,2000,9
STAT,1910,17,15-19,1927,10.388570796209354
SIM,1876,78,na,1954,938
SIM,1901,35,45-49,1936,3
STAT,1949,30,15-19,1979,0.17600677004464627
SIM,1924,19,na,1943,5186
SIM,1847,28,40-44,1875,9
STAT,1929,50,na,1979,5446.155839530601
SIM,1940,17,35-39,1957,5
SIM,1869,33,40-44,1902,12
STAT,1968,41,na,2009,5571.363326101676
SIM,1887,16,na,1903,3918
SIM,1969,30,40-44,1999,17
STAT,1843,54,45-49,1897,0.014161048917807277
SIM,1846,30,35-39,1876,17
STAT,1893,42,40-44,1935,3.277020844444717
STAT,1965,18,45-49,1983,0.719488400272421
STAT,1901,17,50-100,1918,0.07919452624750041
SIM,1906,17,35-39,1923,1
SIM,1849,40,30-34,1889,1
STAT,1830,44,na,1874,1566.9777781386572
STAT,1911,40,na,1951,4140.6837906711235
SIM,1944,33,na,1977,4521
STAT,1982,30,20-24,2012,4.042120409559142
STAT,1852,28,na,1880,2358.5035242268436
SIM,1960,25,40-44,1985,16
SIM,1896,92,na,1988,532
STAT,1952,25,40-44,1977,6.479580222500249
SIM,1794,69,na,1863,754
SIM,1964,28,50-100,1992,1
STAT,1884,42,30-34,1926,1.309261943563093
STAT,1955,45,30-34,2000,0.1427245539508472
STAT,1956,28,50-100,1984,1.525810668531707
STAT,1951,2,na,1953,5476.212894389202
SIM,1989,15,na,2004,6747
SIM,1973,18,45-49,1991,1
STAT,1809,54,45-49,1863,0.0336554761267588
SIM,1958,28,20-24,1986,3
STAT,1937,44,15-19,1981,0.0017826481042540843
STAT,1798,56,na,1854,951.0
SIM,1857,31,25-29,1888,4
SIM,1862,24,na,1886,2662
SIM,1932,14,na,1946,5675
STAT,1859,109,na,1968,0.007268239177910284
STAT,1932,17,35-39,1949,6.413822002019384
SIM,1960,26,na,1986,6279
STAT,1967,30,35-39,1997,13.443331121551525
STAT,1883,39,50-100,1922,1.372283045777718
SIM,1854,47,25-29,1901,1
SIM,1825,44,25-29,1869,1
SIM,1855,48,na,1903,1776
STAT,1943,38,50-100,1981,0.5288688919841528
STAT,1910,25,35-39,1935,17.00526821323861
STAT,1817,62,na,1879,1470.5128153745109
STAT,1851,36,40-44,1887,3.545132295395088
STAT,1946,44,25-29,1990,0.09467302562501517
STAT,1849,31,25-29,1880,9.288729364886652
STAT,1836,18,45-49,1854,0.13352930169893715
SIM,1829,28,20-24,1857,1
STAT,1857,41,25-29,1898,0.5797891903640605
SIM,1953,48,na,2001,5527
STAT,1896,29,50-100,1925,0.9681051787002881
STAT,1977,9,na,1986,6127.471219662373
STAT,1838,30,35-39,1868,11.13115998209952
STAT,1981,23,na,2004,5910.482509947261
STAT,1867,52,40-44,1919,0.011283033660357752
STAT,1953,0,na,1953,6051.64312797208
STAT,1885,48,20-24,1933,0.013639746913108299
STAT,1860,54,na,1914,1947.6075245394368
STAT,1867,27,na,1894,2571.451174419988
STAT,1906,27,35-39,1933,16.237901840919925
STAT,1891,16,25-29,1907,8.10240870348285
SIM,1842,75,na,1917,997
STAT,1951,45,50-100,1996,0.3248263723904547
STAT,1822,49,50-100,1871,0.4511414596806358
SIM,1914,27,35-39,1941,19
STAT,1878,24,45-49,1902,0.8349814479254134
STAT,1920,86,na,2006,1372.7174887750737
SIM,1846,43,50-100,1889,3
STAT,1906,25,na,1931,4043.458039226848
STAT,1838,43,50-100,1881,0.9616642191259485
STAT,1887,23,40-44,1910,2.686710258749758
STAT,1913,43,15-19,1956,0.0017264527949114059
STAT,1893,41,na,1934,3386.7032922721073
SIM,1824,49,35-39,1873,1
SIM,1925,60,na,1985,4852
STAT,1859,39,15-19,1898,0.0511035891681642
STAT,1959,46,45-49,2005,0.34211116808401293
STAT,1913,35,30-34,1948,2.0965144334373207
STAT,1871,31,35-39,1902,11.67466737995432
SIM,1921,35,30-34,1956,1
STAT,1969,20,50-100,1989,0.9523766918752028
STAT,1908,82,na,1990,1684.7204902706253
STAT,1863,37,15-19,1900,0.05666613889779638
STAT,1963,34,15-19,1997,0.1918015501697895
STAT,1990,18,25-29,2008,71.59755149815992
SIM,1919,32,50-100,1951,7
SIM,1981,25,30-34,2006,141
STAT,1921,45,30-34,1966,0.11647914958619075
STAT,1816,49,35-39,1865,0.2770406241714431
STAT,1966,29,15-19,1995,1.0209651122633254
STAT,1819,97,na,1916,3.576368402489418
SIM,1858,50,na,1908,2455
STAT,1875,21,25-29,1896,68.4769697891424
SIM,1833,46,40-44,1879,1
STAT,1866,37,30-34,1903,5.700846132821749
SIM,1879,58,na,1937,2299
SIM,1909,20,50-100,1929,1
STAT,1838,30,na,1868,2381.6748146756486
SIM,1858,59,na,1917,2232
STAT,1839,33,20-24,1872,2.610770403149402
SIM,1880,34,20-24,1914,5
STAT,1867,30,30-34,1897,18.963862158758843
STAT,1912,32,45-49,1944,1.7886216216955197
SIM,1887,2,na,1889,4287
STAT,1905,33,15-19,1938,0.13600669608771138
SIM,1882,23,30-34,1905,45
STAT,1965,23,25-29,1988,133.47786850676658
STAT,1844,46,45-49,1890,0.1979561817627405
STAT,1974,20,30-34,1994,43.484095480128005
STAT,1951,36,45-49,1987,0.9660591727072931
SIM,1957,22,30-34,1979,1
STAT,1823,62,na,1885,1081.6654859640455
SIM,1911,46,na,1957,4618
SIM,1910,61,na,1971,3085
SIM,1948,25,25-29,1973,82
STAT,1830,28,20-24,1858,14.077053046624313
STAT,1928,37,na,1965,5486.9687450630045
SIM,1874,37,30-34,1911,6
SIM,1931,60,na,1991,5521
SIM,1947,44,na,1991,5913
STAT,1861,34,45-49,1895,1.6587117446860389
STAT,1959,49,50-100,2008,0.3530629575916608
SIM,1935,25,15-19,1960,2
STAT,1865,18,40-44,1883,0.1950982044318681
STAT,1955,43,20-24,1998,0.028073014748993548
SIM,1901,32,40-44,1933,20
SIM,1924,21,20-24,1945,164
STAT,1843,17,na,1860,2943.335104473424
STAT,1957,44,50-100,2001,0.18514868912312138
STAT,1898,27,35-39,1925,15.049243865100399
STAT,1982,27,30-34,2009,63.90451884363495
SIM,1971,4,na,1975,5820
SIM,1788,69,na,1857,524
SIM,1905,46,na,1951,3898
SIM,1896,29,30-34,1925,8
STAT,1802,63,na,1865,1192.829640196217
STAT,1856,39,50-100,1895,1.0700857963723462
STAT,1871,7,na,1878,3142.9797127084207
SIM,1946,32,50-100,1978,2
STAT,1888,29,30-34,1917,33.91696956003091
STAT,1919,39,15-19,1958,0.02375206903051937
SIM,1878,73,na,1951,1286
SIM,1899,72,na,1971,2506
STAT,1830,40,45-49,1870,1.48048479225749
STAT,1947,38,45-49,1985,0.9120881467594274
SIM,1924,82,na,2006,1788
SIM,1838,20,35-39,1858,8
SIM,1949,40,35-39,1989,3
SIM,1827,67,na,1894,679
SIM,1947,28,45-49,1975,5
STAT,1916,21,20-24,1937,134.88561121153683
SIM,1955,38,45-49,1993,2
STAT,1842,20,15-19,1862,3.24850733879682
SIM,1925,0,na,1925,5842
STAT,1960,55,na,2015,5563.450571887979
STAT,1927,49,15-19,1976,5.303847875330678E-4
STAT,1871,66,na,1937,1881.7907594987653
STAT,1925,46,45-49,1971,0.304590011862612
STAT,1823,31,na,1854,1626.8202534352938
STAT,1880,44,20-24,1924,0.19164441454770956
STAT,1898,32,15-19,1930,0.2221104472925775
SIM,1843,44,45-49,1887,1
SIM,1866,33,25-29,1899,7
STAT,1842,39,35-39,1881,5.690754544615001
STAT,1927,23,50-100,1950,0.9324736101634212
STAT,1939,28,45-49,1967,2.004179155959376
SIM,1910,34,40-44,1944,4
SIM,1902,8,na,1910,4352
STAT,1865,23,20-24,1888,72.10633450118189
STAT,1971,30,45-49,2001,2.3471367829853182
STAT,1909,49,50-100,1958,0.23871220763973358
STAT,1986,28,45-49,2014,2.851781341068682
SIM,1965,32,30-34,1997,8
STAT,1847,38,40-44,1885,3.4586485102699225
SIM,1850,39,35-39,1889,2
STAT,1829,106,na,1935,0.008894750921768682
STAT,1831,97,na,1928,4.214884425654405
STAT,1858,33,25-29,1891,9.182359490890567
SIM,1858,45,35-39,1903,1
STAT,1926,38,45-49,1964,0.9603253035320025
SIM,1855,38,40-44,1893,3
SIM,1973,23,25-29,1996,6
STAT,1899,24,15-19,1923,5.183336352576549
STAT,1949,36,na,1985,5206.984744922554
SIM,1870,39,50-100,1909,1
STAT,1844,30,na,1874,2213.2221210461876
STAT,1960,49,20-24,2009,0.0171763716289435
STAT,1949,22,30-34,1971,38.703128156867564
STAT,1862,39,50-100,1901,1.183703893955754
SIM,1888,38,50-100,1926,3
SIM,1946,3,na,1949,4770
SIM,1884,73,na,1957,1281
STAT,1839,28,40-44,1867,2.971273938944684
STAT,1934,37,na,1971,5994.459884386522
STAT,1957,32,30-34,1989,24.435747634373914
SIM,1993,17,na,2010,6123
SIM,1920,26,50-100,1946,1
STAT,1911,40,45-49,1951,0.18555374968539515
STAT,1825,46,40-44,1871,0.2424057529199149
STAT,1966,15,25-29,1981,62.497565148256434
SIM,1852,46,45-49,1898,1
SIM,1856,24,na,1880,2210
STAT,1842,15,35-39,1857,0.5486629680699916
SIM,1918,82,na,2000,1720
SIM,1840,17,30-34,1857,3
SIM,1772,85,na,1857,130
SIM,1956,30,30-34,1986,55
STAT,1839,103,na,1942,0.11381455580199241
SIM,1920,32,45-49,1952,1
SIM,1948,37,50-100,1985,1
STAT,1854,34,50-100,1888,0.7487112529256291
SIM,2000,3,na,2003,6494
STAT,1916,16,40-44,1932,0.34334865026262157
STAT,1886,65,na,1951,2057.210208893024
SIM,1864,59,na,1923,2126
STAT,1922,38,50-100,1960,0.5505386555600824
SIM,1834,38,40-44,1872,7
SIM,1898,22,15-19,1920,10
SIM,1951,15,na,1966,5666
SIM,1930,38,50-100,1968,2
SIM,1924,16,40-44,1940,3
STAT,1835,44,45-49,1879,1.090814422732126
SIM,1873,23,20-24,1896,161
STAT,1902,34,40-44,1936,4.025732191791371
SIM,1902,24,40-44,1926,1
STAT,1882,16,15-19,1898,6.705944217919137
STAT,1948,30,30-34,1978,21.233437874689734
STAT,1872,34,20-24,1906,3.1054928452967516
STAT,1961,47,15-19,2008,5.712932967118706E-4
SIM,1820,37,50-100,1857,5
STAT,1913,37,20-24,1950,0.300378757675039
SIM,1842,29,35-39,1871,21
STAT,1924,44,na,1968,5079.750178768679
SIM,1929,25,na,1954,4842
SIM,1866,85,na,1951,225
STAT,1860,38,40-44,1898,4.051358338875247
SIM,1948,47,35-39,1995,2
SIM,1930,37,30-34,1967,4
STAT,1891,15,na,1906,3619.054832133806
SIM,1833,24,30-34,1857,39
STAT,1886,46,15-19,1932,4.883065171783763E-4
SIM,1941,28,40-44,1969,2
STAT,1859,100,na,1959,1.8628822478428013
STAT,1922,37,30-34,1959,2.3922804928849155
SIM,1841,25,na,1866,2153
STAT,1848,16,15-19,1864,7.863068987976662
SIM,1875,35,25-29,1910,11
STAT,1955,36,na,1991,5943.482047516815
SIM,1843,20,50-100,1863,1
STAT,1834,29,35-39,1863,11.381231643974926
SIM,1860,94,na,1954,29
STAT,1945,45,50-100,1990,0.2979798440384824
STAT,1804,50,45-49,1854,0.06954036548170632
STAT,1926,41,35-39,1967,0.28683869950812435
SIM,1911,15,na,1926,5151
SIM,1865,9,na,1874,3471
STAT,1904,41,15-19,1945,0.0015964358242095706
STAT,1955,48,35-39,2003,0.20488167309273603
STAT,1865,17,50-100,1882,0.052568060785759575
STAT,1821,48,30-34,1869,0.17275575808336155
STAT,1867,35,25-29,1902,3.1317645758611645
STAT,1893,9,na,1902,3784.8393971857126
STAT,1810,98,na,1908,1.8496780994240887
STAT,1939,25,40-44,1964,5.4145204478060664
SIM,1880,12,na,1892,3619
STAT,1874,25,20-24,1899,13.95412212327928
STAT,1892,96,na,1988,115.14074301532929
STAT,1935,41,45-49,1976,0.27145236115873006
STAT,1835,50,na,1885,1422.8172251399444
SIM,1923,34,na,1957,5304
STAT,1997,8,na,2005,6622.954603439715
SIM,1968,41,35-39,2009,1
STAT,1882,53,20-24,1935,8.184384594186261E-4
SIM,1777,91,na,1868,18
SIM,1888,30,40-44,1918,10
STAT,1909,25,50-100,1934,1.1158628809693514
STAT,1880,77,na,1957,1150.078376040945
STAT,1821,40,35-39,1861,3.6539344975193755
STAT,1849,33,15-19,1882,0.11510693885126097
STAT,1884,30,na,1914,2742.79309768193
STAT,1872,42,na,1914,2674.972346276907
SIM,1864,50,na,1914,2558
STAT,1949,15,50-100,1964,0.5031185586775092
SIM,1889,11,na,1900,4135
STAT,1899,46,25-29,1945,0.05151672175143591
STAT,1953,9,na,1962,5485.995640532128
STAT,1990,15,20-24,2005,224.18561024593322
SIM,1902,30,35-39,1932,37
SIM,1838,34,25-29,1872,4
STAT,1949,47,45-49,1996,0.3034180750144789
STAT,1876,54,40-44,1930,0.012213891775479666
STAT,1903,24,15-19,1927,5.388912443469202
SIM,1877,23,na,1900,3366
SIM,1911,24,15-19,1935,6
STAT,1965,42,20-24,2007,0.02644265491587101
STAT,1946,41,20-24,1987,0.023525799622814317
STAT,1857,35,30-34,1892,4.835775300926225
STAT,1892,27,30-34,1919,36.423964482904076
STAT,1907,19,35-39,1926,0.9266977511380365
STAT,1932,40,15-19,1972,0.0024092296684226073
STAT,1858,49,40-44,1907,0.1509108676415502
STAT,1885,29,15-19,1914,0.5185284966815675
SIM,1882,26,35-39,1908,24
STAT,1830,35,50-100,1865,1.2805573924592795
STAT,1885,40,25-29,1925,0.7466516315758821
SIM,1856,16,15-19,1872,9
SIM,1960,31,35-39,1991,34
SIM,1902,38,30-34,1940,1
SIM,1915,19,35-39,1934,2
STAT,1950,62,na,2012,4746.445577244647
STAT,1850,40,50-100,1890,1.0985340870690559
STAT,1956,15,30-34,1971,18.62308678810302
SIM,1816,39,35-39,1855,8
SIM,1916,31,40-44,1947,10
STAT,1809,51,40-44,1860,0.025978904075889334
STAT,1874,26,35-39,1900,11.438820615669055
STAT,1925,24,35-39,1949,12.921422211859541
STAT,1952,31,35-39,1983,12.889787603298718
SIM,1839,86,na,1925,344
SIM,1939,23,25-29,1962,5
STAT,1905,71,na,1976,2808.429399501282
SIM,1864,24,25-29,1888,76
STAT,1940,42,30-34,1982,0.15573046386563472
STAT,1937,17,na,1954,4134.615782828955
STAT,1888,24,50-100,1912,0.5497349937627914
STAT,1956,53,na,2009,5711.289003003114
STAT,1870,36,45-49,1906,2.278954233481173
STAT,1893,25,25-29,1918,62.12449970423519
STAT,1856,41,50-100,1897,0.9343610211024732
STAT,1916,18,na,1934,4717.102663516189
STAT,1936,32,na,1968,4241.980289434025
STAT,1825,103,na,1928,0.10151223016043245
STAT,1843,34,25-29,1877,12.101268762185468
STAT,1898,29,25-29,1927,65.50514613260985
STAT,1931,42,20-24,1973,0.027233285508285673
STAT,1877,52,35-39,1929,0.010279684479001261
STAT,1966,40,15-19,2006,0.002306808794578578
STAT,1921,48,35-39,1969,0.16720628922656486
SIM,1935,47,50-100,1982,2
STAT,1874,77,na,1951,1021.2337131485054
STAT,1893,20,30-34,1913,26.138137641178997
STAT,1901,17,40-44,1918,0.29565963655436406
STAT,1908,31,40-44,1939,4.2857749077882215
STAT,1948,58,na,2006,4787.416350627656
STAT,1875,23,15-19,1898,3.922243640408206
SIM,1851,34,25-29,1885,23
STAT,1898,24,30-34,1922,27.60755075596407
STAT,1835,41,40-44,1876,1.7037070034167319
STAT,1859,60,na,1919,1753.2792603215485
STAT,1930,31,15-19,1961,0.19152313538455604
SIM,1924,24,25-29,1948,233
STAT,1859,50,25-29,1909,0.0033029819448575004
SIM,1850,37,45-49,1887,7
STAT,1911,20,25-29,1931,101.78770297426773
SIM,1828,43,na,1871,2262
STAT,1826,41,30-34,1867,0.8753684765686788
SIM,1809,79,na,1888,414
STAT,1911,71,na,1982,3064.544884972956
STAT,1986,25,40-44,2011,7.70441521556328
STAT,1873,92,na,1965,139.06958692097874
STAT,1902,104,na,2006,4.486032370722375
STAT,1945,48,20-24,1993,0.014450787950908643
STAT,1868,50,35-39,1918,0.009682618186259071
STAT,1896,31,50-100,1927,1.4023278355447026
STAT,1958,38,20-24,1996,0.4112322072105042
SIM,1900,15,40-44,1915,1
STAT,1999,15,40-44,2014,2.385928740964543
STAT,1887,26,45-49,1913,1.4409084868457578
STAT,1957,31,na,1988,5869.252886211489
STAT,1957,35,35-39,1992,3.7981716438028092
STAT,1822,46,25-29,1868,0.11043543188750775
STAT,1861,31,40-44,1892,4.1776802942701154
SIM,1860,34,35-39,1894,20
STAT,1920,20,35-39,1940,12.147286083819065
STAT,1852,34,35-39,1886,9.68256083009081
STAT,1849,47,40-44,1896,0.1320730636919385
STAT,1856,18,30-34,1874,1.649562203256908
SIM,1925,69,na,1994,4003
STAT,1789,79,na,1868,227.74257511886105
STAT,1988,27,na,2015,6209.903407960463
STAT,1961,25,15-19,1986,1.0580458366519472
SIM,1839,45,30-34,1884,1
STAT,1811,43,na,1854,1603.3298869195028
SIM,1834,41,30-34,1875,1
STAT,1914,33,50-100,1947,0.9568613649637758
SIM,1892,23,25-29,1915,1
SIM,1964,37,30-34,2001,5
STAT,1817,44,25-29,1861,1.8787614521580114
STAT,1867,24,50-100,1891,0.4366387924738727
SIM,1947,27,30-34,1974,81
SIM,1843,41,40-44,1884,4
STAT,1902,37,45-49,1939,0.7016210642920657
SIM,1843,20,na,1863,1940
STAT,1847,18,20-24,1865,16.925399280962782
SIM,1891,55,na,1946,2862
STAT,1862,39,20-24,1901,0.743198703077653
SIM,1889,36,30-34,1925,17
STAT,1894,40,35-39,1934,2.7135201126133364
STAT,1934,21,40-44,1955,5.2189944568901145
STAT,1880,47,25-29,1927,0.0701302126017928
SIM,1936,70,na,2006,2876
SIM,1891,39,50-100,1930,2
STAT,1970,27,15-19,1997,1.0242493613790098
STAT,1907,5,na,1912,4449.77786870502
STAT,1920,28,30-34,1948,49.40783936715888
SIM,1942,21,40-44,1963,8
STAT,1836,35,na,1871,2442.664907521245
SIM,1874,12,na,1886,2899
SIM,1907,31,30-34,1938,25
STAT,1916,24,25-29,1940,111.01287617229681
STAT,1887,10,na,1897,3350.1282332031456
STAT,1894,91,na,1985,408.79263450606254
SIM,1780,80,na,1860,86
SIM,1796,64,na,1860,824
SIM,1897,77,na,1974,1925
STAT,1884,23,25-29,1907,65.07095526425199
STAT,1965,15,40-44,1980,2.0162813667612305
STAT,1866,11,na,1877,2893.353543591438
SIM,1938,25,30-34,1963,7
STAT,1856,24,25-29,1880,57.69946885120543
STAT,1961,31,45-49,1992,2.3929262282651957
SIM,1934,41,35-39,1975,1
STAT,1815,106,na,1921,0.0067372007619764945
SIM,1870,39,20-24,1909,1
STAT,1931,26,na,1957,5585.220563105559
SIM,1875,30,30-34,1905,34
STAT,1963,31,na,1994,5655.53301725116
STAT,1816,47,45-49,1863,0.48130134051678625
SIM,1950,33,na,1983,4663
STAT,1816,51,50-100,1867,0.0301656475252932
STAT,1915,27,45-49,1942,2.0339406189126863
SIM,1853,13,na,1866,2799
SIM,1923,27,45-49,1950,6
STAT,1841,50,na,1891,1941.870353377233
STAT,1967,24,na,1991,5278.11778144855
SIM,1868,19,45-49,1887,1
STAT,1890,30,50-100,1920,1.3024017739002594
STAT,1853,78,na,1931,777.9096787307216
STAT,1956,18,35-39,1974,6.40577847703782
STAT,1903,45,na,1948,3735.8012693284777
SIM,1928,40,na,1968,5692
SIM,1846,19,25-29,1865,2
STAT,1898,49,45-49,1947,0.20329518081059078
SIM,1851,49,50-100,1900,1
SIM,1983,24,na,2007,6145
SIM,1969,19,30-34,1988,1
SIM,1942,18,15-19,1960,49
STAT,1861,28,15-19,1889,0.4352998802334654
SIM,1942,70,na,2012,3721
STAT,1907,18,50-100,1925,0.08296902011272109
STAT,1926,27,20-24,1953,25.247898427117256
SIM,1976,26,35-39,2002,34
SIM,1846,31,na,1877,1682
SIM,1934,27,20-24,1961,1
SIM,1924,40,50-100,1964,2
SIM,1908,26,na,1934,3806
STAT,1821,36,na,1857,1757.9666577469868
STAT,1916,40,50-100,1956,0.13933609290183874
STAT,1945,43,na,1988,4858.003666068631
STAT,1958,30,25-29,1988,14.296256890961548
SIM,1798,90,na,1888,29
SIM,1887,84,na,1971,1232
SIM,1838,28,30-34,1866,3
STAT,1919,92,na,2011,510.2566899908396
STAT,1773,95,na,1868,4.609820867099718
SIM,1861,79,na,1940,18
STAT,1890,30,na,1920,3392.0336488502344
SIM,1968,35,40-44,2003,2
SIM,1858,42,30-34,1900,1
STAT,1838,19,25-29,1857,6.408737925636797
STAT,1939,27,30-34,1966,45.47701824277057
STAT,1930,25,20-24,1955,26.813021389766142
SIM,1861,37,20-24,1898,2
STAT,1860,23,na,1883,2251.348639750468
STAT,1944,43,45-49,1987,0.21447404460715233
SIM,1840,42,50-100,1882,4
SIM,1842,26,30-34,1868,62
SIM,1855,30,45-49,1885,3
STAT,1912,26,15-19,1938,0.8063826572616152
SIM,1865,38,35-39,1903,4
SIM,1952,43,45-49,1995,1
STAT,1948,27,40-44,1975,6.182313307837423
STAT,1862,89,na,1951,102.3150297728701
STAT,1814,44,50-100,1858,3.1119924981409492
STAT,1895,48,15-19,1943,3.3468541836182623E-4
STAT,1853,37,20-24,1890,0.7674717906945728
SIM,1903,7,na,1910,4275
SIM,1845,86,na,1931,218
STAT,1834,26,30-34,1860,30.351986173781917
SIM,1956,27,40-44,1983,8
STAT,2005,0,na,2005,7031.737759430018
STAT,1934,18,15-19,1952,70.69109871230694
SIM,1863,2,na,1865,3321
SIM,1960,17,20-24,1977,210
STAT,1949,44,40-44,1993,0.34772050714747266
SIM,1947,2,na,1949,6199
STAT,1826,44,35-39,1870,1.31717268799476
STAT,1842,17,25-29,1859,5.599699710070699
STAT,1842,37,45-49,1879,1.799542698605122
STAT,1885,15,na,1900,2920.7561064656434
STAT,1938,65,na,2003,3793.909523980768
STAT,1925,21,30-34,1946,39.809783835202154
SIM,1942,26,35-39,1968,35
STAT,1900,34,na,1934,3788.6159912154726
SIM,1866,30,20-24,1896,7
STAT,1907,16,30-34,1923,2.7129968155827173
SIM,1864,18,30-34,1882,1
SIM,1913,41,na,1954,4584
SIM,1829,40,45-49,1869,1
STAT,1832,42,50-100,1874,0.8977304578390288
STAT,1871,39,30-34,1910,6.057443462988917
STAT,1835,38,15-19,1873,0.042885997127348495
SIM,1883,23,15-19,1906,5
STAT,1934,26,35-39,1960,23.330228901674786
STAT,1874,23,30-34,1897,20.979245887885895
STAT,1818,53,40-44,1871,0.012258499765939469
STAT,1908,28,15-19,1936,0.7684273195658851
STAT,1975,20,15-19,1995,8.136778352075247
SIM,1961,43,na,2004,5563
SIM,1856,36,35-39,1892,12
STAT,1873,51,20-24,1924,8.73791359686472E-4
STAT,1918,44,na,1962,4540.870421943924
SIM,1888,25,25-29,1913,114
SIM,1875,32,20-24,1907,9
SIM,1964,18,35-39,1982,3
STAT,1792,68,na,1860,1066.5855152362142
STAT,1994,16,35-39,2010,6.989983190510449
SIM,1879,39,40-44,1918,2
STAT,1941,17,45-49,1958,0.5939464898474355
STAT,1881,42,15-19,1923,0.015353197621705358
STAT,1965,17,30-34,1982,17.56114010069648
STAT,1984,18,50-100,2002,0.6138879713123904
STAT,1860,22,25-29,1882,54.88761576554737
STAT,1889,24,20-24,1913,97.41909375588685
SIM,1966,30,25-29,1996,29
SIM,1864,41,50-100,1905,2
SIM,1895,11,na,1906,4017
STAT,1866,21,15-19,1887,3.583382239334547
STAT,1857,38,35-39,1895,6.325685539267762
SIM,1874,21,15-19,1895,8
SIM,1897,24,20-24,1921,5
SIM,1973,17,30-34,1990,39
SIM,1928,20,45-49,1948,5
SIM,1916,52,na,1968,4314
SIM,1948,22,20-24,1970,262
SIM,1860,31,30-34,1891,3
SIM,1961,37,25-29,1998,2
STAT,1841,17,40-44,1858,0.20973362151913347
SIM,1929,26,35-39,1955,5
SIM,1924,22,35-39,1946,14
SIM,1891,28,35-39,1919,25
STAT,1870,101,na,1971,5.754461319376106
SIM,1981,27,20-24,2008,34
STAT,1813,46,15-19,1859,0.0013482205937123853
STAT,1875,37,40-44,1912,5.220589794898857
STAT,1898,26,20-24,1924,18.360105344886055
STAT,1848,36,35-39,1884,7.825371764324896
SIM,1886,3,na,1889,2811
STAT,1962,28,50-100,1990,1.4774540844134778
STAT,1873,20,45-49,1893,0.8266896428652805
STAT,1870,33,40-44,1903,4.913165829468101
STAT,1893,22,20-24,1915,100.52393242134767
STAT,1991,16,na,2007,6089.248472572227
SIM,1939,20,20-24,1959,148
STAT,1961,19,20-24,1980,202.00765572664926
SIM,1892,39,40-44,1931,17
STAT,1929,22,45-49,1951,1.6421385118158411
SIM,2001,2,na,2003,7328
STAT,1883,28,35-39,1911,10.856181922760081
STAT,1916,22,35-39,1938,11.387674618225322
SIM,1994,17,20-24,2011,1
STAT,1852,31,30-34,1883,17.221563856959136
STAT,1770,84,na,1854,48.0
STAT,1786,68,na,1854,1175.0
STAT,1952,17,20-24,1969,187.49680240674357
STAT,1875,22,na,1897,2820.5461303286975
STAT,1822,48,15-19,1870,7.453209935244445E-4
STAT,1862,51,45-49,1913,0.014201736742591398
SIM,1903,33,20-24,1936,4
SIM,1916,36,35-39,1952,7
SIM,1977,20,na,1997,6211
SIM,1874,35,40-44,1909,3
STAT,1936,49,25-29,1985,0.06035593441997037
STAT,1969,41,45-49,2010,0.24970301567350278
STAT,1970,13,na,1983,5673.75883337981
SIM,1880,32,50-100,1912,4
STAT,1850,19,40-44,1869,0.2273835168238583
SIM,1938,28,35-39,1966,34
STAT,1869,22,45-49,1891,0.7793323848284551
STAT,1966,46,na,2012,5521.811576341282
STAT,1866,35,40-44,1901,4.726917614487974
STAT,1884,20,20-24,1904,79.04429777389079
STAT,1966,32,40-44,1998,5.749771342066313
SIM,1956,21,na,1977,5115
STAT,1965,45,25-29,2010,0.07986841979026833
SIM,1837,22,40-44,1859,3
STAT,1927,47,25-29,1974,0.07682578040663861
SIM,1892,20,20-24,1912,182
STAT,1791,83,na,1874,147.64475933204517
STAT,1908,36,35-39,1944,2.629374263275546
STAT,1945,46,30-34,1991,0.11718527176383303
SIM,1883,37,40-44,1920,10
STAT,1808,54,na,1862,1532.1015075448831
STAT,1899,41,30-34,1940,0.12679640452996643
STAT,1919,29,na,1948,4636.735047267352
STAT,1836,49,20-24,1885,0.01114377402939272
STAT,1871,53,45-49,1924,0.016394557526731225
STAT,1831,45,20-24,1876,0.011406546073456793
STAT,1850,107,na,1957,0.0077430763908742884
SIM,1831,32,na,1863,1708
SIM,1941,22,na,1963,4005
STAT,1995,19,20-24,2014,226.33191047055982
STAT,1922,43,25-29,1965,0.09439914083467688
STAT,1892,25,40-44,1917,4.362282212140199
STAT,1838,110,na,1948,2.3936682335414205E-4
STAT,1856,32,45-49,1888,1.5541447528740466
STAT,1897,29,40-44,1926,4.589517691523752
SIM,1907,34,35-39,1941,25
SIM,1962,21,na,1983,5181
SIM,1993,6,na,1999,6962
SIM,1864,32,45-49,1896,5
STAT,1830,34,15-19,1864,0.14811070609981145
STAT,1847,30,45-49,1877,1.6084941201617926
SIM,1822,44,50-100,1866,5
SIM,1898,31,50-100,1929,2
SIM,1924,1,na,1925,5460
STAT,1849,26,50-100,1875,0.5919810192816947
STAT,1872,32,50-100,1904,1.061747368563491
SIM,1888,66,na,1954,1590
STAT,1827,47,20-24,1874,0.015198565991032477
STAT,1822,43,20-24,1865,0.31594363556371585
STAT,1985,12,na,1997,6447.618993939148
SIM,1783,91,na,1874,25
STAT,1904,35,20-24,1939,0.27834835939909575
STAT,1982,33,25-29,2015,15.289874509331874
SIM,1799,75,na,1874,178
SIM,1894,66,na,1960,2816
SIM,1893,46,50-100,1939,1
STAT,1860,104,na,1964,0.29351544338040436
STAT,1952,1,na,1953,5601.206389310951
STAT,1848,23,na,1871,2746.3123077563487
SIM,1940,31,50-100,1971,2
STAT,1986,17,20-24,2003,222.93932133377828
STAT,1854,23,na,1877,2032.0068015534273
STAT,1884,39,40-44,1923,4.941085152322835
STAT,1964,13,na,1977,5708.666927168593
STAT,1877,88,na,1965,366.81908800327574
STAT,1931,45,25-29,1976,0.08225647107539481
STAT,1935,29,20-24,1964,28.70267506876439
STAT,1953,37,25-29,1990,1.4161428795089295
STAT,1833,24,na,1857,1987.995105464335
STAT,1856,89,na,1945,92.49429749654485
STAT,1885,46,50-100,1931,0.28351510708441646
STAT,1973,27,20-24,2000,27.362560479222946
SIM,1976,27,50-100,2003,4
STAT,1960,41,25-29,2001,0.11170583540163725
STAT,1869,22,na,1891,2643.197977196758
STAT,1785,83,na,1868,89.06540650177217
SIM,1778,76,na,1854,295
SIM,1873,67,na,1940,2353
SIM,1943,29,20-24,1972,39
STAT,1932,31,50-100,1963,1.2694628308552203
