Source,YOB,Age,NPA,Date,freq
SIM,1930,26,45-49,1956,3
SIM,1896,0,na,1896,3453
STAT,1868,71,na,1939,1203.112008102661
SIM,1875,18,na,1893,2450
SIM,1921,20,35-39,1941,11
STAT,1839,17,35-39,1856,0.4779041610604874
STAT,1876,90,na,1966,205.5319246893468
STAT,1906,62,na,1968,2775.746233774849
STAT,1890,48,20-24,1938,0.00771973018226787
SIM,1867,4,na,1871,2712
STAT,1810,57,na,1867,1040.3114203396956
SIM,1905,65,na,1970,2535
SIM,1859,55,na,1914,1659
SIM,1907,17,30-34,1924,2
SIM,1931,19,15-19,1950,47
STAT,1838,30,15-19,1868,0.12129553434219704
SIM,1863,60,na,1923,1581
STAT,1871,18,50-100,1889,0.04598229712750292
SIM,1867,74,na,1941,992
SIM,1901,51,na,1952,2890
SIM,1910,27,30-34,1937,35
STAT,1784,99,na,1883,0.33057235425657516
SIM,1941,16,na,1957,3507
STAT,1917,14,na,1931,4001.8764454475913
STAT,1898,31,25-29,1929,13.14785798217115
STAT,1927,35,35-39,1962,2.8457812793391732
SIM,1902,49,50-100,1951,3
STAT,1934,25,25-29,1959,83.7199538539313
STAT,1925,27,25-29,1952,73.43979624579465
SIM,1907,9,na,1916,3603
STAT,1925,33,na,1958,4240.038628429513
SIM,1884,2,na,1886,2851
SIM,1909,25,40-44,1934,6
SIM,1933,27,25-29,1960,91
STAT,1907,36,20-24,1943,0.2320027561332087
SIM,1886,35,50-100,1921,1
SIM,1888,68,na,1956,1737
STAT,1902,27,30-34,1929,33.57330036412312
STAT,1855,21,na,1876,1787.8856716805622
STAT,1859,35,na,1894,1788.2604530635563
STAT,1829,32,15-19,1861,0.14208988608250606
SIM,1872,47,50-100,1919,1
STAT,1942,24,20-24,1966,110.06494714261784
SIM,1797,62,na,1859,864
STAT,1913,20,35-39,1933,8.671220958612414
STAT,1922,26,45-49,1948,1.8531179196104963
SIM,1833,62,na,1895,1093
SIM,1878,16,25-29,1894,7
SIM,1858,41,50-100,1899,3
SIM,1924,7,na,1931,4520
STAT,1931,24,45-49,1955,1.3699611744658204
STAT,1916,34,20-24,1950,2.3586156558907594
SIM,1876,35,na,1911,2306
SIM,1869,23,20-24,1892,56
SIM,1914,26,na,1940,3577
SIM,1940,17,15-19,1957,37
STAT,1932,17,15-19,1949,56.770187382458836
SIM,1912,22,35-39,1934,10
STAT,1893,70,na,1963,1885.475039921941
STAT,1815,88,na,1903,61.27780412616724
STAT,1918,42,30-34,1960,0.1284116400830428
STAT,1900,19,20-24,1919,23.108724108587957
STAT,1844,69,na,1913,1019.2436420837574
STAT,1923,19,15-19,1942,50.07299694005894
STAT,1909,44,30-34,1953,0.11158236901454231
SIM,1875,93,na,1968,118
STAT,1896,23,15-19,1919,4.103425362339302
STAT,1909,31,25-29,1940,8.366568725633806
STAT,1852,88,na,1940,99.52871650591777
SIM,1924,34,20-24,1958,4
SIM,1970,1,na,1971,4528
SIM,1875,20,40-44,1895,3
STAT,1907,23,15-19,1930,4.564000469557781
STAT,1940,30,50-100,1970,0.8092846718933305
STAT,1941,15,15-19,1956,44.183640361969864
SIM,1832,36,50-100,1868,1
SIM,1858,38,na,1896,1912
STAT,1787,105,na,1892,0.010806137231199615
STAT,1912,41,25-29,1953,0.06544026472263442
SIM,1854,24,na,1878,1952
STAT,1849,24,40-44,1873,1.8621764226511426
STAT,1826,40,na,1866,1518.2191747682946
STAT,1904,22,35-39,1926,7.907404611237687
SIM,1860,6,na,1866,2400
STAT,1924,48,15-19,1972,4.131349454025218E-4
STAT,1801,96,na,1897,3.0354208847315776
STAT,1958,3,na,1961,4879.85247450077
STAT,1855,101,na,1956,0.48435371491236734
SIM,1850,10,na,1860,2245
SIM,1825,43,na,1868,1481
SIM,1829,57,na,1886,1157
SIM,1865,30,25-29,1895,8
SIM,1858,23,45-49,1881,1
SIM,1917,39,35-39,1956,5
STAT,1867,15,45-49,1882,0.059942402302729896
STAT,1829,101,na,1930,0.3447910639087903
STAT,1901,18,25-29,1919,7.473719535066693
STAT,1929,7,na,1936,4819.10455821862
SIM,1941,5,na,1946,3809
STAT,1943,23,25-29,1966,92.80867241095295
SIM,1915,23,15-19,1938,4
STAT,1867,20,40-44,1887,1.883059798963652
STAT,1920,18,35-39,1938,4.435764922792889
SIM,1836,34,50-100,1870,4
SIM,1884,54,na,1938,2062
SIM,1953,3,na,1956,4447
STAT,1841,48,25-29,1889,0.039382346610261174
STAT,1942,13,na,1955,3877.4091598070595
SIM,1934,36,30-34,1970,1
SIM,1880,40,na,1920,2355
SIM,1939,28,30-34,1967,45
STAT,1838,41,na,1879,1671.9805159206333
STAT,1903,26,35-39,1929,13.014137235437202
STAT,1905,34,45-49,1939,1.3555672600150375
SIM,1884,22,na,1906,2333
STAT,1899,18,45-49,1917,0.08433209535933378
STAT,1855,22,15-19,1877,2.73881112980259
STAT,1848,15,35-39,1863,0.5114397225159686
SIM,1926,17,40-44,1943,3
STAT,1809,60,na,1869,1004.4575256702285
SIM,1863,22,15-19,1885,6
STAT,1929,43,45-49,1972,0.2032829919718227
SIM,1935,35,35-39,1970,7
STAT,1827,89,na,1916,60.68224683339311
STAT,1920,23,30-34,1943,30.09156311749505
STAT,1922,31,40-44,1953,4.194111963546742
SIM,1940,20,45-49,1960,5
STAT,1857,30,25-29,1887,7.839609039568752
SIM,1917,31,25-29,1948,10
SIM,1888,36,na,1924,2677
SIM,1912,35,40-44,1947,3
STAT,1904,35,40-44,1939,1.292478318372091
SIM,1892,73,na,1965,1908
SIM,1850,42,na,1892,1745
SIM,1857,24,40-44,1881,1
SIM,1839,20,30-34,1859,20
STAT,1910,33,15-19,1943,0.116562733893871
SIM,1911,26,35-39,1937,19
SIM,1847,22,30-34,1869,23
STAT,1878,15,20-24,1893,17.535198689624853
STAT,1765,96,na,1861,1.0223405909057268
STAT,1912,21,30-34,1933,26.1005345006913
STAT,1926,36,30-34,1962,2.1060911155896958
SIM,1822,78,na,1900,386
SIM,1863,92,na,1955,25
STAT,1934,30,20-24,1964,3.1496498414140524
STAT,1917,46,na,1963,3634.127922065656
STAT,1938,18,20-24,1956,126.3024520007274
SIM,1902,20,25-29,1922,81
SIM,1950,19,25-29,1969,59
STAT,1944,27,35-39,1971,15.329235723638039
STAT,1913,32,na,1945,3554.8867140635903
SIM,1884,30,35-39,1914,10
STAT,1942,19,25-29,1961,42.75406045176184
SIM,1830,97,na,1927,4
SIM,1856,90,na,1946,52
SIM,1909,29,50-100,1938,1
SIM,1929,18,20-24,1947,135
SIM,1930,32,na,1962,4612
SIM,1925,38,30-34,1963,1
STAT,1932,20,45-49,1952,1.4029838209729202
SIM,1797,94,na,1891,3
STAT,1831,94,na,1925,11.669583056243491
SIM,1863,17,na,1880,2178
STAT,1914,32,45-49,1946,1.4963976178002
STAT,1950,15,50-100,1965,0.41872781336781567
STAT,1915,25,15-19,1940,0.6848620203223921
STAT,1822,58,na,1880,1088.704290023163
STAT,1910,16,25-29,1926,8.132001458277518
SIM,1913,34,45-49,1947,2
STAT,1919,41,35-39,1960,0.20644592398582737
STAT,1839,90,na,1929,52.49191084047439
SIM,1896,30,50-100,1926,4
STAT,1954,14,na,1968,4585.480629649415
STAT,1858,17,45-49,1875,0.056517970141117986
STAT,1894,2,na,1896,3236.2430212919003
STAT,1944,18,50-100,1962,0.38076520458416463
STAT,1917,30,20-24,1947,2.432348119822428
SIM,1937,33,50-100,1970,5
STAT,1944,15,40-44,1959,1.422732758116077
STAT,1877,4,na,1881,2834.068278999218
SIM,1905,32,45-49,1937,2
SIM,1936,31,35-39,1967,9
STAT,1897,52,na,1949,2705.8668636598145
STAT,1903,39,40-44,1942,1.2572340895649647
STAT,1922,9,na,1931,4352.317223046966
STAT,1908,35,25-29,1943,0.879165383837381
STAT,1934,38,30-34,1972,2.37358899014299
SIM,1887,19,na,1906,2611
SIM,1911,23,30-34,1934,30
SIM,1920,21,30-34,1941,41
STAT,1899,23,40-44,1922,2.688953138215903
SIM,1793,80,na,1873,217
STAT,1917,38,30-34,1955,1.7794991684120216
SIM,1880,72,na,1952,1259
SIM,1884,86,na,1970,478
STAT,1905,13,na,1918,3520.935810265803
STAT,1772,98,na,1870,0.49005315315188636
STAT,1848,20,30-34,1868,16.34958639248271
STAT,1927,40,30-34,1967,0.15188735540504505
STAT,1839,22,30-34,1861,15.237905508177864
STAT,1871,46,45-49,1917,0.22201361605064565
STAT,1909,27,na,1936,3382.301423719551
STAT,1813,97,na,1910,2.2109283746908046
STAT,1940,22,45-49,1962,1.0828119342399571
SIM,1894,32,na,1926,2998
SIM,1804,81,na,1885,188
STAT,1882,49,25-29,1931,0.0518131169196239
STAT,1889,33,na,1922,2771.302411650534
STAT,1933,26,20-24,1959,22.907277510579085
STAT,1927,24,na,1951,4223.6914902521785
STAT,1919,49,45-49,1968,0.22139105676818255
SIM,1898,25,40-44,1923,4
SIM,1935,15,40-44,1950,1
STAT,1885,83,na,1968,678.4682806738513
STAT,1923,22,45-49,1945,1.2367663823807553
STAT,1864,20,15-19,1884,2.863322314999892
STAT,1865,49,25-29,1914,0.04829114810666846
STAT,1924,23,15-19,1947,5.915417127698701
SIM,1868,48,na,1916,2000
SIM,1952,15,40-44,1967,1
STAT,1913,28,45-49,1941,1.6205384334570483
SIM,1833,47,50-100,1880,2
STAT,1845,43,na,1888,1644.2585631697834
SIM,1904,33,40-44,1937,6
SIM,1941,26,20-24,1967,16
SIM,1872,53,na,1925,1975
SIM,1925,25,25-29,1950,76
STAT,1908,40,20-24,1948,0.015610924281137471
SIM,1843,40,na,1883,1735
SIM,1921,33,40-44,1954,10
STAT,1869,25,20-24,1894,10.8093403972833
STAT,1912,29,40-44,1941,4.308371514126226
SIM,1921,28,45-49,1949,1
SIM,1942,25,25-29,1967,53
SIM,1902,33,30-34,1935,11
STAT,1889,65,na,1954,1970.92700193288
SIM,1899,24,45-49,1923,5
STAT,1826,72,na,1898,689.6453043111917
STAT,1837,24,na,1861,1790.4820081119651
SIM,1876,67,na,1943,1527
STAT,1806,105,na,1911,0.01016792367283911
SIM,1922,32,45-49,1954,1
STAT,1885,51,na,1936,2037.2732404475737
STAT,1918,37,35-39,1955,2.4084435183765582
SIM,1893,20,35-39,1913,10
STAT,1913,33,40-44,1946,3.662754072294707
SIM,1922,45,na,1967,3992
SIM,1901,16,25-29,1917,11
STAT,1859,21,45-49,1880,0.6021131322965783
STAT,1927,15,40-44,1942,1.6505525366473102
STAT,1920,43,25-29,1963,0.07438688105270964
STAT,1930,40,50-100,1970,0.14642720510815346
SIM,1920,29,40-44,1949,6
SIM,1842,31,50-100,1873,3
SIM,1872,20,15-19,1892,3
STAT,1810,54,30-34,1864,0.018241110502056578
SIM,1922,13,na,1935,4290
STAT,1903,43,25-29,1946,0.059506391825332364
STAT,1940,19,15-19,1959,43.50170864042041
SIM,1839,35,na,1874,1770
SIM,1901,29,30-34,1930,42
SIM,1925,30,20-24,1955,2
SIM,1926,37,35-39,1963,7
STAT,1930,20,35-39,1950,11.46305739596608
SIM,1931,22,45-49,1953,1
STAT,1818,53,na,1871,1250.1556715997945
STAT,1846,60,na,1906,1414.5624244578057
SIM,1835,21,na,1856,1807
STAT,1861,33,50-100,1894,0.7166619716914813
SIM,1887,23,15-19,1910,3
SIM,1901,21,20-24,1922,92
SIM,1902,28,35-39,1930,13
STAT,1800,79,na,1879,285.88504259350685
STAT,1875,17,45-49,1892,0.06342911074164745
STAT,1780,85,na,1865,69.0035739300192
STAT,1876,15,na,1891,2476.4564699720418
STAT,1822,106,na,1928,0.006169648945152834
SIM,1789,75,na,1864,333
SIM,1900,17,20-24,1917,16
STAT,1939,25,na,1964,3560.851009565237
SIM,1926,27,na,1953,4156
STAT,1930,28,45-49,1958,2.0742044911784885
STAT,1810,49,35-39,1859,0.4520563145341152
STAT,1858,22,40-44,1880,1.7708781211987719
STAT,1860,45,30-34,1905,0.07493786023843302
STAT,1917,25,25-29,1942,65.65239046758626
SIM,1848,71,na,1919,965
SIM,1946,18,20-24,1964,140
STAT,1877,32,na,1909,2338.4288862670496
SIM,1866,22,40-44,1888,4
STAT,1876,30,35-39,1906,9.963514544106784
STAT,1935,11,na,1946,5124.701224381392
STAT,1808,54,50-100,1862,0.05240912679913907
STAT,1908,48,30-34,1956,0.0759521089717483
STAT,1924,36,20-24,1960,0.2939119750846901
SIM,1938,28,na,1966,3340
STAT,1926,44,30-34,1970,0.1483912582060664
STAT,1907,3,na,1910,3668.654593072242
SIM,1916,27,25-29,1943,68
SIM,1934,14,na,1948,4939
STAT,1910,21,20-24,1931,98.94796894350911
SIM,1904,48,na,1952,3070
STAT,1835,103,na,1938,0.09134386354892451
STAT,1851,39,na,1890,1677.6986282142352
STAT,1835,76,na,1911,602.9996704215463
STAT,1875,22,40-44,1897,2.0234089564706585
SIM,1904,20,35-39,1924,12
STAT,1891,39,25-29,1930,3.3312828834684973
STAT,1855,30,15-19,1885,0.10520342330255923
STAT,1902,31,15-19,1933,0.19063828540746527
SIM,1868,16,na,1884,2335
SIM,1889,31,25-29,1920,15
SIM,1857,27,45-49,1884,4
STAT,1858,18,na,1876,1974.3518380931573
SIM,1885,71,na,1956,1249
STAT,1914,24,45-49,1938,1.0791872353754581
SIM,1881,9,na,1890,2010
STAT,1916,46,15-19,1962,3.578213355544589E-4
STAT,1931,21,40-44,1952,4.132087754026653
SIM,1834,36,na,1870,1645
SIM,1918,35,35-39,1953,5
STAT,1904,38,45-49,1942,0.5801571261900978
STAT,1864,20,50-100,1884,0.3539335778287411
STAT,1942,27,25-29,1969,65.26197410513932
SIM,1848,21,35-39,1869,5
SIM,1930,23,40-44,1953,7
STAT,1809,103,na,1912,0.0575914475906174
STAT,1848,40,25-29,1888,0.4889416963115567
STAT,1922,43,35-39,1965,0.21800051350064234
SIM,1802,58,na,1860,983
SIM,1872,16,30-34,1888,1
STAT,1846,32,15-19,1878,0.1248215978230995
SIM,1920,37,40-44,1957,2
SIM,1829,31,50-100,1860,3
SIM,1892,32,50-100,1924,1
STAT,1920,35,25-29,1955,1.0201655774432725
SIM,1948,18,30-34,1966,11
SIM,1932,23,15-19,1955,4
STAT,1930,42,30-34,1972,0.15890616625850737
STAT,1885,20,35-39,1905,5.527728242416918
SIM,1826,60,na,1886,1047
SIM,1888,23,30-34,1911,24
SIM,1851,91,na,1942,42
STAT,1861,49,40-44,1910,0.13166765506071348
STAT,1886,9,na,1895,2589.211324182492
SIM,1931,30,45-49,1961,6
STAT,1849,27,45-49,1876,0.9869464055224659
SIM,1891,56,na,1947,2374
STAT,1901,43,15-19,1944,0.0012589427158284589
STAT,1922,23,40-44,1945,3.631347629692055
SIM,1855,20,15-19,1875,1
SIM,1928,42,40-44,1970,4
STAT,1879,87,na,1966,380.74961368515403
STAT,1875,73,na,1948,1153.3252584801696
STAT,1864,16,30-34,1880,1.534601556574502
STAT,1913,45,35-39,1958,0.11944538324616122
STAT,1928,31,35-39,1959,10.800590354360372
SIM,1821,61,na,1882,998
STAT,1935,37,35-39,1972,3.195107454497419
STAT,1921,22,35-39,1943,10.04691833126538
SIM,1898,46,na,1944,2832
STAT,1860,0,na,1860,2974.7371686705114
STAT,1896,35,na,1931,2967.435374248369
STAT,1812,49,45-49,1861,0.7643663091921788
SIM,1858,20,40-44,1878,2
STAT,1907,19,30-34,1926,2.1999950037243043
STAT,1905,31,40-44,1936,3.414171659340647
STAT,1829,45,50-100,1874,0.2060735807650866
STAT,1933,22,50-100,1955,0.8245261754205873
SIM,1898,28,45-49,1926,2
STAT,1910,29,30-34,1939,35.489685733968244
STAT,1892,21,na,1913,2806.8932523623093
STAT,1902,22,25-29,1924,76.32164901780835
SIM,1846,26,30-34,1872,30
STAT,1802,108,na,1910,6.421925196605505E-4
STAT,1904,30,35-39,1934,13.833050984086286
STAT,1948,24,15-19,1972,5.770278477023249
SIM,1875,23,45-49,1898,3
STAT,1900,5,na,1905,3434.358488395104
SIM,1902,3,na,1905,3529
SIM,1922,24,45-49,1946,1
STAT,1829,37,na,1866,1653.8369009112753
STAT,1884,34,na,1918,2208.125197440932
SIM,1846,22,15-19,1868,2
STAT,1867,23,45-49,1890,0.6166672563423687
SIM,1915,19,30-34,1934,2
STAT,1903,23,30-34,1926,23.86843838664038
STAT,1850,27,50-100,1877,0.5306593333429084
STAT,1888,48,na,1936,2480.73062704576
STAT,1881,69,na,1950,1339.289633656604
SIM,1837,45,50-100,1882,2
SIM,1904,28,45-49,1932,1
SIM,1910,22,25-29,1932,85
STAT,1918,45,35-39,1963,0.13022476714596135
STAT,1923,30,45-49,1953,1.7178591037030075
SIM,1879,25,30-34,1904,33
SIM,1901,37,30-34,1938,5
STAT,1922,34,45-49,1956,1.671407424915759
SIM,1869,26,25-29,1895,46
STAT,1773,83,na,1856,105.44960489
STAT,1777,97,na,1874,0.8153835578574045
STAT,1854,25,50-100,1879,0.5349160972482526
SIM,1826,92,na,1918,23
STAT,1841,45,20-24,1886,0.008526141813218552
STAT,1824,48,25-29,1872,0.06922807890834097
STAT,1888,21,15-19,1909,3.6943093618365976
SIM,1924,37,25-29,1961,1
SIM,1951,20,20-24,1971,120
SIM,1917,34,na,1951,3677
STAT,1925,24,20-24,1949,124.94748147348709
SIM,1913,20,na,1933,3416
STAT,1928,39,45-49,1967,0.8121483500207719
STAT,1830,45,45-49,1875,0.18147197493376063
SIM,1912,30,35-39,1942,10
STAT,1838,26,30-34,1864,21.661124630785867
STAT,1918,17,40-44,1935,0.28855208769567275
SIM,1869,37,50-100,1906,1
STAT,1880,20,na,1900,2369.4882191814777
STAT,1937,15,50-100,1952,0.34592161064880267
STAT,1852,56,na,1908,1478.7066341424086
STAT,1829,40,15-19,1869,0.012154932447928998
STAT,1943,28,30-34,1971,39.40292835626371
STAT,1933,34,20-24,1967,3.101280968405797
SIM,1900,34,na,1934,3143
STAT,1916,37,25-29,1953,0.9525297043767607
SIM,1896,21,15-19,1917,7
STAT,1814,51,50-100,1865,0.04501741645731622
STAT,1943,20,20-24,1963,111.8374827482927
STAT,1908,27,25-29,1935,59.28088329439842
STAT,1911,42,20-24,1953,0.015924165162988318
STAT,1896,31,15-19,1927,0.17840609409455657
SIM,1903,4,na,1907,3519
SIM,1933,24,20-24,1957,134
STAT,1933,38,15-19,1971,0.024684703124506793
SIM,1930,34,45-49,1964,2
STAT,1921,51,na,1972,3862.61821715765
STAT,1934,7,na,1941,5107.744048194862
STAT,1904,27,40-44,1931,4.059158033402847
STAT,1903,40,20-24,1943,0.014973294620851351
SIM,1870,94,na,1964,41
STAT,1865,6,na,1871,2419.004060842246
STAT,1840,49,20-24,1889,0.007740500803954741
SIM,1871,36,50-100,1907,1
SIM,1887,27,30-34,1914,24
STAT,1839,15,na,1854,2023.0010613961322
STAT,1935,21,25-29,1956,118.86606560105257
SIM,1943,21,25-29,1964,77
SIM,1897,72,na,1969,2014
STAT,1820,48,40-44,1868,0.2829508475257085
STAT,1872,39,15-19,1911,0.05267524272080386
STAT,1900,42,45-49,1942,0.13603273566840451
STAT,1952,17,40-44,1969,1.5834539600781283
STAT,1909,39,35-39,1948,2.1411282150141786
SIM,1923,20,45-49,1943,1
SIM,1919,25,na,1944,3904
STAT,1798,59,na,1857,1000.7397143777848
STAT,1879,27,30-34,1906,24.90170565629301
STAT,1851,104,na,1955,0.0479802048973135
STAT,1856,70,na,1926,1034.1748465174162
SIM,1915,11,na,1926,3751
STAT,1907,44,20-24,1951,0.015097701859804415
STAT,1944,24,30-34,1968,29.295898181182928
SIM,1842,23,na,1865,1824
SIM,1854,56,na,1910,1655
SIM,1903,24,35-39,1927,10
STAT,1934,17,25-29,1951,55.37328605912082
SIM,1917,23,25-29,1940,90
STAT,1864,57,na,1921,1692.0525948732025
STAT,1913,41,40-44,1954,0.23176402413650019
STAT,1860,43,na,1903,1758.7900854351208
SIM,1840,75,na,1915,645
SIM,1877,84,na,1961,506
SIM,1909,47,na,1956,3241
STAT,1860,22,50-100,1882,0.32222047238147145
SIM,1905,33,na,1938,3236
SIM,1846,37,na,1883,1733
SIM,1897,16,35-39,1913,2
STAT,1764,109,na,1873,0.001983416934771044
SIM,1888,7,na,1895,2928
STAT,1797,74,na,1871,458.0007766159539
STAT,1872,22,15-19,1894,3.1260801395925855
SIM,1869,18,25-29,1887,6
SIM,1781,79,na,1860,230
STAT,1850,38,25-29,1888,2.040455560258463
STAT,1858,30,40-44,1888,3.2795307172359256
STAT,1848,23,35-39,1871,5.241738157193381
STAT,1925,32,20-24,1957,2.736227518123655
SIM,1847,54,na,1901,1570
SIM,1838,24,30-34,1862,15
SIM,1932,28,20-24,1960,24
SIM,1934,19,40-44,1953,7
SIM,1838,93,na,1931,14
SIM,1916,49,na,1965,3453
STAT,1821,52,40-44,1873,0.015966075494221774
STAT,1871,16,na,1887,2398.6302568985943
SIM,1912,27,40-44,1939,5
SIM,1853,39,na,1892,1758
SIM,1877,17,20-24,1894,16
SIM,1900,25,20-24,1925,16
SIM,1779,97,na,1876,1
SIM,1912,35,na,1947,3446
SIM,1933,32,20-24,1965,2
STAT,1869,17,20-24,1886,16.449640420932464
STAT,1897,15,30-34,1912,2.0230223623672425
STAT,1929,35,45-49,1964,0.8282112771600858
SIM,1775,83,na,1858,96
SIM,1898,20,35-39,1918,11
SIM,1925,33,25-29,1958,13
STAT,1889,16,35-39,1905,0.6415063975083499
STAT,1808,75,na,1883,442.43812445106255
STAT,1785,84,na,1869,107.96077103731108
SIM,1829,25,na,1854,1707
STAT,1789,98,na,1887,0.5368588289237741
SIM,1844,89,na,1933,38
SIM,1848,30,25-29,1878,15
STAT,1917,33,25-29,1950,9.104730137689444
STAT,1804,61,na,1865,954.6271545795084
SIM,1866,30,40-44,1896,8
SIM,1913,31,40-44,1944,7
STAT,1924,28,20-24,1952,20.00709045441178
STAT,1926,19,40-44,1945,1.6113171748201291
SIM,1856,23,35-39,1879,6
SIM,1787,84,na,1871,75
SIM,1907,34,20-24,1941,1
SIM,1921,41,40-44,1962,4
STAT,1912,37,40-44,1949,1.3803252222169382
STAT,1934,26,na,1960,4762.908415721426
STAT,1889,41,25-29,1930,0.752307443609087
SIM,1867,30,35-39,1897,7
STAT,1916,29,25-29,1945,63.83246895701431
STAT,1898,7,na,1905,3330.7384258374086
STAT,1868,16,15-19,1884,5.47817622871706
STAT,1893,30,50-100,1923,1.1065108806186645
STAT,1914,41,35-39,1955,0.18877243370806734
STAT,1930,12,na,1942,4839.191222931475
SIM,1878,21,20-24,1899,59
SIM,1818,73,na,1891,524
SIM,1942,17,25-29,1959,51
STAT,1919,46,40-44,1965,0.16195087019016333
SIM,1876,50,50-100,1926,1
SIM,1908,29,40-44,1937,5
SIM,1926,34,30-34,1960,31
STAT,1868,50,50-100,1918,0.013808365028905397
SIM,1843,42,50-100,1885,1
SIM,1924,29,25-29,1953,93
STAT,1934,33,50-100,1967,1.0657575855248798
SIM,1873,70,na,1943,1299
STAT,1950,18,20-24,1968,151.39490971324767
STAT,1882,46,20-24,1928,0.011055885625144334
STAT,1930,25,40-44,1955,5.603701943023676
STAT,1862,53,40-44,1915,0.008366846774729412
STAT,1860,48,35-39,1908,0.10596298381928594
STAT,1849,68,na,1917,1145.9464418273549
STAT,1911,25,30-34,1936,36.3443596418836
STAT,1830,77,na,1907,521.7002622223176
SIM,1869,33,na,1902,2175
STAT,1908,44,15-19,1952,0.0013257709227141384
STAT,1816,62,na,1878,1018.192964382767
SIM,1847,40,50-100,1887,1
SIM,1839,67,na,1906,1055
STAT,1839,40,50-100,1879,0.8357985134788957
STAT,1936,33,35-39,1969,8.379882322158252
SIM,1849,25,45-49,1874,1
SIM,1886,15,20-24,1901,17
STAT,1915,17,15-19,1932,8.973341625250782
SIM,1836,19,25-29,1855,9
SIM,1899,21,40-44,1920,3
STAT,1875,16,50-100,1891,0.047688670298466844
STAT,1918,34,30-34,1952,15.680843218163764
STAT,1899,31,40-44,1930,5.636397624096903
STAT,1901,35,15-19,1936,0.016179617221995398
SIM,1876,16,15-19,1892,5
SIM,1832,88,na,1920,87
STAT,1923,27,15-19,1950,0.7656767243066598
SIM,1862,43,na,1905,1958
SIM,1923,17,15-19,1940,48
SIM,1931,27,15-19,1958,3
STAT,1831,38,15-19,1869,0.04253476330292344
SIM,1819,90,na,1909,33
STAT,1935,29,35-39,1964,19.31435428908164
STAT,1914,21,40-44,1935,3.1235514761653804
STAT,1917,22,20-24,1939,111.64452878401256
SIM,1882,30,25-29,1912,3
STAT,1919,30,30-34,1949,16.18697094409944
STAT,1830,42,40-44,1872,1.7497615069325785
STAT,1918,28,45-49,1946,1.7307824162197287
STAT,1856,48,20-24,1904,0.00873379701937585
STAT,1921,38,45-49,1959,0.7183670463044329
STAT,1887,16,25-29,1903,6.002649468120341
STAT,1940,31,35-39,1971,8.939930614388944
STAT,1836,18,na,1854,1964.4002037049459
SIM,1889,21,na,1910,2869
STAT,1840,23,na,1863,1771.5934679998795
STAT,1874,39,25-29,1913,2.7510984058871646
STAT,1844,37,na,1881,1729.1001717593335
SIM,1918,32,30-34,1950,17
STAT,1914,40,45-49,1954,0.1568851233686117
STAT,1957,11,na,1968,4892.537799227818
STAT,1944,19,35-39,1963,4.26307848158763
SIM,1943,25,40-44,1968,5
STAT,1937,21,35-39,1958,8.665038605145043
SIM,1829,89,na,1918,53
SIM,1899,52,na,1951,2810
SIM,1927,12,na,1939,4640
STAT,1881,20,15-19,1901,3.028674388504147
SIM,1786,78,na,1864,276
STAT,1861,92,na,1953,32.71507908525985
STAT,1873,17,35-39,1890,0.525726170445496
STAT,1855,26,30-34,1881,18.787373194076356
SIM,1952,19,35-39,1971,5
STAT,1859,30,35-39,1889,7.725365407047705
STAT,1828,74,na,1902,625.0109948792672
STAT,1906,48,20-24,1954,0.009196467977559207
STAT,1926,28,30-34,1954,44.21561248198163
STAT,1905,18,50-100,1923,0.06672286262577867
STAT,1921,19,40-44,1940,1.4980917552042996
SIM,1860,95,na,1955,10
STAT,1910,24,25-29,1934,81.43565889025336
SIM,1927,30,30-34,1957,22
STAT,1874,30,25-29,1904,9.965869692401409
STAT,1913,42,30-34,1955,0.11778233817684995
SIM,1827,77,na,1904,456
STAT,1807,48,25-29,1855,0.21814859313549365
STAT,1906,35,15-19,1941,0.01683497888035611
STAT,1857,87,na,1944,131.26542951271728
STAT,1876,47,na,1923,2185.61820202154
STAT,1853,73,na,1926,898.8866135995884
STAT,1866,27,45-49,1893,0.9674307809242009
STAT,1881,29,15-19,1910,0.41109258075329325
SIM,1831,82,na,1913,233
STAT,1809,92,na,1901,16.713581775602886
STAT,1919,38,40-44,1957,1.5177492610000638
SIM,1934,28,30-34,1962,60
STAT,1932,38,20-24,1970,0.3342565932171139
SIM,1890,38,20-24,1928,4
STAT,1898,29,50-100,1927,0.8119503560528014
SIM,1925,22,20-24,1947,133
STAT,1920,32,20-24,1952,2.5239369065878288
STAT,1824,36,50-100,1860,2.021838763484347
SIM,1875,40,35-39,1915,2
SIM,1877,25,20-24,1902,11
SIM,1927,38,40-44,1965,1
SIM,1833,23,40-44,1856,3
STAT,1901,27,15-19,1928,0.5999498510056133
STAT,1842,49,30-34,1891,0.06863719357798269
STAT,1867,49,35-39,1916,0.12159791604439651
STAT,1886,22,50-100,1908,0.40693828611985405
SIM,1882,39,25-29,1921,5
STAT,1921,30,35-39,1951,9.68435480743676
STAT,1937,34,40-44,1971,3.6528327942002736
SIM,1825,75,na,1900,537
STAT,1910,37,30-34,1947,1.6467470744991517
STAT,1804,93,na,1897,9.789528251064981
STAT,1831,62,na,1893,1067.185899457363
STAT,1832,23,50-100,1855,0.3850800711469799
SIM,1902,36,35-39,1938,5
STAT,1952,18,30-34,1970,13.79425409916189
SIM,1929,33,45-49,1962,2
STAT,1940,30,45-49,1970,1.5402514818210407
SIM,1896,25,30-34,1921,37
SIM,1810,45,na,1855,1305
STAT,1907,27,30-34,1934,34.94561917095273
STAT,1864,5,na,1869,2406.7868519228887
STAT,1866,20,25-29,1886,51.01655943688958
STAT,1869,24,50-100,1893,0.37086914877609056
SIM,1814,59,na,1873,1008
SIM,1871,36,na,1907,2254
SIM,1879,21,15-19,1900,3
STAT,1917,42,15-19,1959,0.0015140018128626325
STAT,1930,36,45-49,1966,0.8407806704429511
SIM,1883,69,na,1952,1346
SIM,1848,37,45-49,1885,1
SIM,1841,38,25-29,1879,3
STAT,1926,20,20-24,1946,128.3749891021301
SIM,1922,16,45-49,1938,1
STAT,1836,53,50-100,1889,0.00970161807843938
SIM,1838,20,15-19,1858,2
SIM,1850,74,na,1924,812
SIM,1925,17,25-29,1942,60
SIM,1902,17,30-34,1919,2
SIM,1944,22,30-34,1966,39
STAT,1937,29,45-49,1966,1.5893549272609366
STAT,1846,40,15-19,1886,0.010635869078204928
STAT,1924,43,45-49,1967,0.18671428554565994
STAT,1930,17,40-44,1947,1.7082749015814414
STAT,1909,35,40-44,1944,1.3513519802962395
STAT,1933,37,25-29,1970,1.2669314965485174
STAT,1829,69,na,1898,886.7418951688342
STAT,1888,25,30-34,1913,28.305023592675848
SIM,1934,27,40-44,1961,6
STAT,1917,49,35-39,1966,0.1264758173505898
SIM,1895,16,25-29,1911,7
STAT,1833,38,25-29,1871,2.1858009716470455
SIM,1767,96,na,1863,1
STAT,1828,34,50-100,1862,0.885138665805272
STAT,1905,43,35-39,1948,0.17046594189801678
SIM,1899,31,na,1930,3172
STAT,1863,72,na,1935,1046.9617146957428
STAT,1878,35,50-100,1913,1.2202175738167338
STAT,1915,20,45-49,1935,1.0606766336622768
STAT,1937,0,na,1937,4140.382154271485
STAT,1924,38,50-100,1962,0.46721972278808377
SIM,1854,88,na,1942,97
SIM,1863,26,30-34,1889,28
STAT,1912,47,na,1959,3335.5311351720297
SIM,1917,35,40-44,1952,1
SIM,1922,21,40-44,1943,2
STAT,1932,25,15-19,1957,0.8742653259778159
STAT,1757,108,na,1865,0.005456933332487837
STAT,1928,30,na,1958,4472.447161195927
STAT,1900,14,na,1914,3373.4331920635777
STAT,1950,4,na,1954,4408.827310191263
SIM,1846,69,na,1915,1031
SIM,1909,21,25-29,1930,84
STAT,1900,47,15-19,1947,2.943146775299823E-4
SIM,1940,4,na,1944,3757
SIM,1945,21,35-39,1966,11
STAT,1921,8,na,1929,4294.814583127801
STAT,1904,28,na,1932,3222.490353272517
STAT,1867,86,na,1953,196.8214935522538
STAT,1910,35,na,1945,3431.5421245969965
STAT,1913,4,na,1917,3885.8802773558355
STAT,1914,49,na,1963,3421.9182420291945
STAT,1825,55,na,1880,1194.9261367634083
STAT,1856,1,na,1857,2766.733371549928
SIM,1857,21,na,1878,1982
STAT,1926,27,40-44,1953,5.278337508595667
STAT,1850,22,na,1872,1809.04006149938
SIM,1829,34,30-34,1863,21
SIM,1881,57,na,1938,1556
STAT,1821,41,na,1862,1480.8779965562233
STAT,1901,6,na,1907,3454.4293556871958
SIM,1812,57,na,1869,1090
STAT,1874,42,50-100,1916,1.0184566520993916
STAT,1823,49,20-24,1872,0.014363087088896486
STAT,1893,39,35-39,1932,8.388272962922631
SIM,1932,0,na,1932,5201
STAT,1824,92,na,1916,22.964939661724717
STAT,1856,25,35-39,1881,7.476650915459992
STAT,1947,12,na,1959,4180.321250511326
STAT,1907,47,25-29,1954,0.04487872578316292
STAT,1854,36,na,1890,1693.779583797969
SIM,1856,58,na,1914,1539
STAT,1916,38,15-19,1954,0.018485563842860854
STAT,1779,77,na,1856,266.39626233779995
STAT,1806,49,20-24,1855,0.04285761785529306
STAT,1902,19,30-34,1921,2.113600926579104
SIM,1892,20,40-44,1912,4
STAT,1836,102,na,1938,0.18985032191246032
SIM,1937,32,40-44,1969,4
STAT,1838,73,na,1911,797.3979299360566
STAT,1836,26,20-24,1862,9.901290282415387
SIM,1910,19,30-34,1929,1
STAT,1846,49,15-19,1895,2.9048679451190826E-4
STAT,1938,30,40-44,1968,3.7215083099352815
STAT,1806,63,na,1869,900.7767956924449
STAT,1783,82,na,1865,136.47499580552028
STAT,1909,16,50-100,1925,0.06958121506307574
SIM,1821,93,na,1914,18
STAT,1795,62,na,1857,929.0474568361965
STAT,1901,30,45-49,1931,2.3244644305126965
SIM,1903,21,30-34,1924,31
STAT,1846,17,na,1863,2138.731944834177
STAT,1787,96,na,1883,1.5302439430081825
SIM,1944,13,na,1957,3897
STAT,1799,76,na,1875,366.3125018351261
SIM,1918,27,35-39,1945,20
STAT,1901,25,50-100,1926,0.8516308188727403
STAT,1905,18,45-49,1923,0.0889638168343716
SIM,1874,20,25-29,1894,60
STAT,1921,31,25-29,1952,9.756446511425988
STAT,1893,30,35-39,1923,12.230027957197326
STAT,1884,20,40-44,1904,1.9564661110839965
STAT,1938,26,50-100,1964,0.9319957607492807
SIM,1919,31,35-39,1950,15
STAT,1838,22,15-19,1860,2.873547705216033
SIM,1841,81,na,1922,318
STAT,1903,47,50-100,1950,0.1853491566410049
STAT,1911,17,30-34,1928,2.3042826820590965
STAT,1903,17,45-49,1920,0.08780339205725819
STAT,1904,44,50-100,1948,0.09806805315348784
STAT,1920,26,35-39,1946,15.611900982775978
STAT,1865,31,50-100,1896,0.7877562473815329
STAT,1815,56,na,1871,1159.984987562008
SIM,1878,90,na,1968,195
SIM,1919,44,40-44,1963,2
SIM,1903,29,40-44,1932,4
STAT,1815,47,20-24,1862,0.027016132796680442
STAT,1929,33,50-100,1962,0.9914778123898244
STAT,1841,37,20-24,1878,0.6261318620853935
SIM,1900,66,na,1966,2411
SIM,1934,20,20-24,1954,125
STAT,1867,40,35-39,1907,1.6225416475923111
SIM,1868,5,na,1873,2520
SIM,1813,74,na,1887,445
SIM,1879,32,na,1911,2412
SIM,1824,37,na,1861,1558
STAT,1851,43,50-100,1894,0.7544615093213893
STAT,1882,54,na,1936,1923.8031885732244
STAT,1814,82,na,1896,214.45342800674038
STAT,1821,39,45-49,1860,3.760811970425552
STAT,1846,92,na,1938,30.891528803491138
STAT,1909,40,15-19,1949,0.0013723777773025246
STAT,1888,28,35-39,1916,10.734609642661257
SIM,1933,16,20-24,1949,165
SIM,1844,26,20-24,1870,16
STAT,1925,16,20-24,1941,155.09271424393413
STAT,1882,38,20-24,1920,0.7046780898283146
SIM,1877,20,na,1897,2316
STAT,1882,86,na,1968,446.37900232037254
STAT,1880,53,50-100,1933,0.01479984965259546
STAT,1830,52,50-100,1882,0.009953094277576603
STAT,1811,63,na,1874,923.7469620051517
STAT,1815,77,na,1892,385.8294536334391
STAT,1874,35,na,1909,2295.641171912258
STAT,1893,38,na,1931,2808.526077810624
SIM,1854,15,25-29,1869,7
SIM,1907,26,20-24,1933,18
STAT,1906,22,45-49,1928,0.9594474068310405
STAT,1884,40,35-39,1924,1.7071234306895375
STAT,1886,68,na,1954,1525.0042100754565
SIM,1847,22,na,1869,1966
STAT,1862,55,na,1917,1670.1305711255588
STAT,1878,49,na,1927,2168.766774295987
STAT,1915,46,20-24,1961,0.01054628229936731
STAT,1866,69,na,1935,1278.701838782521
SIM,1871,15,25-29,1886,3
SIM,1947,18,15-19,1965,41
STAT,1862,16,20-24,1878,16.49749028071467
STAT,1853,51,50-100,1904,0.011484389137807829
STAT,1858,18,50-100,1876,0.0421388094727401
SIM,1911,29,na,1940,3393
STAT,1830,45,na,1875,1495.268415497372
STAT,1925,40,20-24,1965,0.020254270041108878
STAT,1834,59,na,1893,1204.8893075151723
STAT,1920,13,na,1933,4193.0301227364835
STAT,1935,30,15-19,1965,0.16814162572783722
STAT,1877,38,50-100,1915,1.197140261910639
STAT,1844,40,50-100,1884,0.7709666945583988
STAT,1882,15,35-39,1897,0.5064496769985309
SIM,1914,22,45-49,1936,1
STAT,1924,27,na,1951,4120.4462649796615
STAT,1901,26,25-29,1927,56.128899509470756
SIM,1908,37,40-44,1945,3
SIM,1958,9,na,1967,4785
STAT,1912,33,25-29,1945,8.555740879174708
SIM,1917,20,20-24,1937,106
SIM,1782,85,na,1867,65
SIM,1892,40,35-39,1932,3
STAT,1863,15,25-29,1878,5.424360575057541
SIM,1832,56,na,1888,1175
STAT,1939,18,15-19,1957,42.90173245447037
SIM,1859,24,15-19,1883,5
SIM,1861,58,na,1919,1715
STAT,1847,20,15-19,1867,3.0255739541239297
STAT,1945,20,30-34,1965,29.778379289611262
SIM,1870,16,20-24,1886,17
STAT,1861,17,na,1878,2072.3864416811257
STAT,1922,42,45-49,1964,0.18046286740393278
STAT,1911,16,40-44,1927,0.2650753266393044
STAT,1784,107,na,1891,0.004760685566712905
SIM,1920,33,25-29,1953,16
SIM,1938,31,45-49,1969,1
SIM,1929,24,na,1953,4311
STAT,1820,43,50-100,1863,1.8822350484141968
STAT,1846,15,25-29,1861,5.34261023894405
STAT,1867,31,45-49,1898,1.5532280366802582
SIM,1908,30,20-24,1938,2
STAT,1931,33,35-39,1964,11.30481433544821
STAT,1826,48,35-39,1874,0.1275193794318524
SIM,1925,10,na,1935,4514
STAT,1925,35,25-29,1960,1.1182926225912855
STAT,1929,32,40-44,1961,4.6957124948872355
SIM,1861,69,na,1930,1245
SIM,1906,50,na,1956,3006
STAT,1847,27,35-39,1874,8.55209486179345
STAT,1879,23,15-19,1902,3.252235874034232
SIM,1889,35,40-44,1924,6
STAT,1922,18,45-49,1940,0.5447207860832366
STAT,1935,25,40-44,1960,6.0074155276409185
STAT,1881,16,30-34,1897,1.4581480787188263
SIM,1908,38,30-34,1946,3
SIM,1910,38,35-39,1948,7
SIM,1841,92,na,1933,32
SIM,1832,45,na,1877,1455
STAT,1894,41,50-100,1935,1.2883882408409821
STAT,1908,42,50-100,1950,0.10268262438369744
STAT,1911,21,15-19,1932,4.783851472240778
STAT,1912,31,50-100,1943,0.7717326821137604
SIM,1855,27,35-39,1882,10
STAT,1845,53,40-44,1898,0.007330055987303241
STAT,1902,38,35-39,1940,2.0252530612768793
SIM,1782,96,na,1878,3
SIM,1841,60,na,1901,1256
SIM,1952,16,30-34,1968,13
STAT,1845,27,50-100,1872,0.5509738075331025
SIM,1811,94,na,1905,8
SIM,1914,19,15-19,1933,7
STAT,1853,51,25-29,1904,0.0026934072055012363
STAT,1858,25,45-49,1883,0.8540883675962923
SIM,1853,18,na,1871,2072
STAT,1909,47,35-39,1956,0.11192491099931007
STAT,1848,49,25-29,1897,0.04190650755937735
SIM,1849,88,na,1937,58
SIM,1885,27,20-24,1912,11
STAT,1905,40,30-34,1945,0.1101146803596825
STAT,1908,10,na,1918,3630.062782385543
STAT,1921,35,40-44,1956,1.581794300035444
SIM,1919,46,na,1965,3845
STAT,1917,37,40-44,1954,1.468895426826403
SIM,1915,32,na,1947,3479
STAT,1911,49,40-44,1960,0.1401832169117738
STAT,1918,25,40-44,1943,4.717885120684928
STAT,1869,16,30-34,1885,1.4876540553142221
SIM,1845,74,na,1919,751
SIM,1881,25,na,1906,1864
SIM,1935,32,30-34,1967,19
STAT,1870,44,50-100,1914,0.965862984933433
STAT,1899,26,50-100,1925,0.8308610910478487
STAT,1919,33,35-39,1952,9.274669701978642
SIM,1864,30,30-34,1894,26
STAT,1852,54,50-100,1906,0.010648187717342252
SIM,1896,20,25-29,1916,89
STAT,1841,40,na,1881,1698.7120460934918
STAT,1911,41,30-34,1952,0.115941451251038
STAT,1843,95,na,1938,8.980427485249965
STAT,1935,28,45-49,1963,2.223638657891327
STAT,1837,88,na,1925,89.09484346011583
SIM,1851,59,na,1910,1460
SIM,1818,41,na,1859,1423
SIM,1874,24,40-44,1898,1
STAT,1863,40,na,1903,1935.391442758569
STAT,1812,54,40-44,1866,0.032355475713354155
STAT,1918,31,na,1949,3812.2387336868646
SIM,1901,24,25-29,1925,74
STAT,1895,3,na,1898,3255.9055402078648
STAT,1891,68,na,1959,1887.2069852102916
STAT,1794,77,na,1871,338.7838394568052
STAT,1833,74,na,1907,680.8842668837331
STAT,1856,30,30-34,1886,13.300092243889814
SIM,1842,55,na,1897,1375
STAT,1888,20,25-29,1908,64.29309492948796
STAT,1845,54,na,1899,1481.7443636423943
STAT,1844,15,15-19,1859,5.301639233260199
SIM,1815,43,50-100,1858,2
SIM,1931,31,35-39,1962,17
STAT,1867,54,na,1921,1857.5033031712094
SIM,1849,22,40-44,1871,3
SIM,1848,34,40-44,1882,3
SIM,1925,37,40-44,1962,2
STAT,1916,41,45-49,1957,0.161352984362489
STAT,1930,21,25-29,1951,112.12222979213452
STAT,1950,17,30-34,1967,13.61539526585513
SIM,1862,38,45-49,1900,2
SIM,1898,41,40-44,1939,1
SIM,1926,25,40-44,1951,6
STAT,1881,50,50-100,1931,0.013980932968704023
SIM,1925,8,na,1933,4525
STAT,1906,15,50-100,1921,0.06772130035946385
SIM,1870,37,40-44,1907,2
STAT,1865,15,35-39,1880,0.5383702200357529
STAT,1890,38,50-100,1928,1.4109676391565338
STAT,1827,37,50-100,1864,1.2743649352183104
STAT,1945,23,35-39,1968,9.745744057565533
SIM,1852,15,15-19,1867,7
SIM,1890,3,na,1893,3283
STAT,1855,39,15-19,1894,0.03950330433336894
STAT,1849,9,na,1858,2248.7929367486195
STAT,1903,18,35-39,1921,0.7356162525207517
SIM,1840,96,na,1936,4
STAT,1901,23,20-24,1924,90.8442949863906
SIM,1876,20,35-39,1896,5
STAT,1923,31,35-39,1954,9.937181024244033
STAT,1888,16,na,1904,2826.6337106197666
STAT,1849,20,25-29,1869,52.65299487912524
STAT,1926,23,25-29,1949,105.6810346624749
SIM,1874,27,45-49,1901,4
STAT,1896,67,na,1963,2166.7024023183435
STAT,1952,6,na,1958,4450.39314780454
STAT,1862,87,na,1949,142.30448442636018
STAT,1897,31,30-34,1928,22.14844350238808
STAT,1892,53,na,1945,2506.8984071524224
SIM,1921,17,40-44,1938,1
STAT,1922,16,50-100,1938,0.4106197961604894
SIM,1896,28,35-39,1924,12
STAT,1884,15,45-49,1899,0.06125010795348622
STAT,1831,30,na,1861,1671.1878889743418
STAT,1865,38,20-24,1903,0.6567779748941305
STAT,1868,20,35-39,1888,5.336115473350296
SIM,1944,17,35-39,1961,4
STAT,1866,24,40-44,1890,1.8043006739930147
STAT,1942,28,15-19,1970,0.6996292376992232
STAT,1882,24,50-100,1906,0.37229798154461463
STAT,1887,41,15-19,1928,0.014658658308074847
STAT,1852,20,45-49,1872,0.6092859687410165
SIM,1966,2,na,1968,4462
SIM,1777,85,na,1862,69
STAT,1913,17,40-44,1930,0.2701724629179163
SIM,1829,37,35-39,1866,17
STAT,1835,44,na,1879,1562.766580040913
STAT,1788,81,na,1869,182.93047179243658
STAT,1943,27,40-44,1970,4.689506133169541
SIM,1868,91,na,1959,60
STAT,1852,38,35-39,1890,5.102337130174583
SIM,1817,56,na,1873,1195
SIM,1882,37,50-100,1919,1
SIM,1839,23,35-39,1862,6
SIM,1813,42,na,1855,1408
SIM,1860,38,35-39,1898,9
STAT,1908,32,20-24,1940,2.1750958945534578
STAT,1874,37,50-100,1911,1.1850460468399855
STAT,1923,48,20-24,1971,0.012178813347372945
SIM,1902,36,na,1938,3169
SIM,1791,78,na,1869,290
SIM,1857,20,25-29,1877,56
SIM,1934,23,25-29,1957,122
SIM,1940,31,na,1971,3599
STAT,1906,19,15-19,1925,8.121581794863488
SIM,1915,28,20-24,1943,18
STAT,1930,41,40-44,1971,0.3113413268566314
STAT,1931,17,20-24,1948,167.6376978656482
SIM,1823,63,na,1886,915
STAT,1927,32,30-34,1959,18.30849147589709
STAT,1762,100,na,1862,0.0986286527150568
STAT,1867,28,15-19,1895,0.4010528736958069
STAT,1823,39,50-100,1862,1.7813760736998105
STAT,1897,49,20-24,1946,0.008373279053415785
SIM,1922,29,50-100,1951,1
STAT,1760,97,na,1857,0.6882697237566959
STAT,1917,46,30-34,1963,0.08818328472842346
SIM,1949,12,na,1961,4243
STAT,1904,31,25-29,1935,13.936026167941266
STAT,1877,27,20-24,1904,11.49605562326466
SIM,1849,41,45-49,1890,1
STAT,1914,29,50-100,1943,0.9411670651444031
STAT,1936,17,35-39,1953,3.7950809490987187
STAT,1841,18,na,1859,2028.9946514795736
STAT,1891,30,25-29,1921,12.067591277044246
STAT,1897,20,na,1917,3005.7886144597423
STAT,1870,21,na,1891,2198.4528295977016
SIM,1792,63,na,1855,807
SIM,1796,77,na,1873,325
STAT,1859,26,15-19,1885,0.34953260418232696
STAT,1781,109,na,1890,0.0031466442213812203
STAT,1914,17,na,1931,3774.3938607824907
STAT,1840,55,na,1895,1356.9528599886594
SIM,1859,87,na,1946,115
STAT,1870,39,40-44,1909,4.016069238399433
SIM,1855,73,na,1928,884
STAT,1907,28,20-24,1935,16.222753812883436
SIM,1910,35,30-34,1945,2
SIM,1899,20,na,1919,3122
STAT,1871,17,25-29,1888,5.350132387625363
STAT,1903,65,na,1968,2552.454218077801
STAT,1928,44,40-44,1972,0.3002182610912925
SIM,1837,36,30-34,1873,3
STAT,1921,42,50-100,1963,0.12500168639004142
STAT,1829,49,15-19,1878,3.1848672204014126E-4
SIM,1912,31,25-29,1943,10
STAT,1925,19,25-29,1944,49.18700851884069
SIM,1933,19,25-29,1952,59
SIM,1894,49,50-100,1943,3
SIM,1865,40,na,1905,2073
STAT,1820,52,25-29,1872,0.005709439446249327
STAT,1858,48,30-34,1906,0.07079707928379139
SIM,1869,54,na,1923,1904
STAT,1848,33,50-100,1881,0.7150413973965829
STAT,1820,56,na,1876,1161.6380511622287
STAT,1911,45,25-29,1956,0.047665817973712686
SIM,1916,32,20-24,1948,2
STAT,1839,25,35-39,1864,8.21057991819042
STAT,1902,35,30-34,1937,1.5482383167882943
STAT,1951,5,na,1956,4423.093947799179
STAT,1770,86,na,1856,48.46752025999999
SIM,1939,16,15-19,1955,44
STAT,1872,76,na,1948,897.7381563165435
SIM,1889,38,45-49,1927,3
STAT,1899,26,45-49,1925,1.4421113646206176
STAT,1871,91,na,1962,115.90096197846432
STAT,1880,53,35-39,1933,0.008436396407389152
SIM,1929,30,40-44,1959,7
STAT,1848,8,na,1856,2261.9718109961996
STAT,1872,30,15-19,1902,0.13602695814005855
SIM,1828,47,50-100,1875,3
SIM,1926,29,35-39,1955,33
STAT,1812,50,25-29,1862,0.011794762606845378
STAT,1840,44,na,1884,1542.18428997848
SIM,1838,18,na,1856,1968
SIM,1917,38,45-49,1955,2
STAT,1940,27,15-19,1967,0.680064275978854
STAT,1783,108,na,1891,0.002737054960225507
STAT,1880,28,45-49,1908,1.1018972070382718
STAT,1840,37,50-100,1877,0.9529644158961115
SIM,1847,25,35-39,1872,11
STAT,1917,17,25-29,1934,8.80972739863173
STAT,1918,27,50-100,1945,1.0006991019682119
SIM,1865,44,50-100,1909,3
STAT,1938,33,45-49,1971,1.493825688368116
STAT,1906,2,na,1908,3667.6916588745203
STAT,1952,12,na,1964,4446.9674419157645
STAT,1821,107,na,1928,0.002512500319864171
STAT,1886,49,50-100,1935,0.23996956621880408
STAT,1896,27,30-34,1923,31.41908967039004
STAT,1918,21,25-29,1939,94.39827546375501
STAT,1851,16,45-49,1867,0.0574688595314655
STAT,1857,44,50-100,1901,0.7764964344167247
SIM,1926,21,25-29,1947,117
STAT,1909,38,45-49,1947,0.6065838553852317
SIM,1926,27,50-100,1953,2
STAT,1883,17,na,1900,2339.250159244472
SIM,1869,65,na,1934,1513
STAT,1905,15,40-44,1920,0.2509134901655291
SIM,1838,40,30-34,1878,5
STAT,1829,36,30-34,1865,4.927234971448772
SIM,1889,53,na,1942,2537
STAT,1883,21,50-100,1904,0.3788412400899957
STAT,1849,30,50-100,1879,0.8122921943743011
STAT,1924,27,30-34,1951,43.097501928645094
STAT,1920,45,50-100,1965,0.23730335990043214
SIM,1890,39,na,1929,2915
STAT,1840,28,15-19,1868,0.3685799613033176
SIM,1803,75,na,1878,383
STAT,1847,24,30-34,1871,15.871718526515858
STAT,1918,29,35-39,1947,14.986364209351388
STAT,1909,19,40-44,1928,0.25774381658431444
SIM,1927,33,35-39,1960,14
STAT,1804,52,40-44,1856,0.03720187979358772
STAT,1931,30,30-34,1961,19.52437951625126
SIM,1941,18,20-24,1959,119
STAT,1805,78,na,1883,333.16872837121014
STAT,1905,27,20-24,1932,16.019230978467245
SIM,1772,86,na,1858,51
STAT,1933,18,20-24,1951,171.0004765963579
SIM,1889,30,35-39,1919,11
STAT,1937,23,na,1960,3358.365232705324
STAT,1895,15,20-24,1910,21.935882189764236
STAT,1913,36,45-49,1949,0.6386355695593304
SIM,1921,28,na,1949,3960
SIM,1906,17,15-19,1923,5
STAT,1935,34,30-34,1969,20.56495422357718
SIM,1921,36,45-49,1957,1
SIM,1932,27,30-34,1959,60
STAT,1914,37,15-19,1951,0.01811344316869492
SIM,1834,30,45-49,1864,2
STAT,1860,41,15-19,1901,0.01063326428968872
STAT,1801,64,na,1865,804.6710918683882
SIM,1879,41,30-34,1920,2
STAT,1849,40,40-44,1889,1.716138157090304
SIM,1833,26,45-49,1859,1
SIM,1855,24,30-34,1879,25
SIM,1877,16,30-34,1893,1
SIM,1898,21,25-29,1919,78
SIM,1807,89,na,1896,28
SIM,1878,37,30-34,1915,7
STAT,1925,44,15-19,1969,0.0017505218624698
SIM,1858,16,20-24,1874,17
SIM,1866,36,na,1902,2107
STAT,1871,43,40-44,1914,2.094741311161691
SIM,1807,78,na,1885,289
SIM,1866,25,45-49,1891,1
SIM,1870,73,na,1943,1004
SIM,1874,87,na,1961,253
SIM,1816,93,na,1909,13
SIM,1942,22,20-24,1964,101
SIM,1917,19,40-44,1936,1
SIM,1803,64,na,1867,823
STAT,1915,49,25-29,1964,0.05020062841376589
SIM,1872,21,na,1893,2242
SIM,1821,37,45-49,1858,1
SIM,1836,24,20-24,1860,49
SIM,1920,24,35-39,1944,10
STAT,1839,50,25-29,1889,0.0024169456601566656
SIM,1943,28,45-49,1971,1
STAT,1887,53,na,1940,2238.748772550363
SIM,1857,40,40-44,1897,3
SIM,1920,30,20-24,1950,3
STAT,1892,17,45-49,1909,0.07729287442159531
STAT,1852,17,15-19,1869,5.2036716982029265
SIM,1913,27,20-24,1940,20
STAT,1840,15,30-34,1855,1.370366349967202
SIM,1811,45,50-100,1856,1
STAT,1861,53,25-29,1914,0.0027375342893755307
SIM,1908,33,25-29,1941,8
STAT,1826,30,45-49,1856,2.7582289449122595
STAT,1912,24,35-39,1936,8.82834524470249
SIM,1935,31,na,1966,4869
STAT,1903,47,40-44,1950,0.12920104087994352
STAT,1934,22,20-24,1956,141.16767272983554
STAT,1912,30,20-24,1942,2.2856844658143465
SIM,1888,26,35-39,1914,11
STAT,1870,10,na,1880,2485.1191325559203
STAT,1925,39,40-44,1964,1.6936875251923993
SIM,1907,29,25-29,1936,62
STAT,1816,41,na,1857,1476.4891865943348
STAT,1860,49,25-29,1909,0.04322911862479065
STAT,1893,21,45-49,1914,0.8379327068400478
STAT,1833,33,40-44,1866,3.390427853380971
SIM,1887,6,na,1893,2712
STAT,1821,95,na,1916,7.083412185012131
STAT,1859,34,15-19,1893,0.1061582469312517
SIM,1838,42,50-100,1880,1
SIM,1882,42,na,1924,2175
STAT,1831,25,30-34,1856,23.258882013654258
SIM,1914,15,na,1929,3813
STAT,1909,32,15-19,1941,0.11585084180497325
SIM,1799,74,na,1873,443
SIM,1924,47,na,1971,4136
SIM,1851,37,30-34,1888,8
SIM,1922,34,na,1956,3990
STAT,1808,49,30-34,1857,0.3544787847674938
STAT,1895,39,45-49,1934,2.430465382791742
SIM,1827,36,50-100,1863,1
STAT,1879,38,35-39,1917,6.959531108538599
STAT,1901,22,45-49,1923,0.9220974910325489
STAT,1920,31,50-100,1951,0.859025538275809
SIM,1837,44,30-34,1881,8
STAT,1817,52,50-100,1869,0.03262433183433565
STAT,1856,33,35-39,1889,7.4777734047215025
STAT,1898,43,40-44,1941,0.19823943501602823
SIM,1916,3,na,1919,3955
STAT,1904,23,25-29,1927,77.33133788557173
STAT,1836,34,20-24,1870,2.16708560223518
SIM,1823,31,na,1854,1550
STAT,1819,37,25-29,1856,7.989771081935061
STAT,1894,27,20-24,1921,14.242562160165276
SIM,1862,25,25-29,1887,35
SIM,1881,19,15-19,1900,4
STAT,1854,25,25-29,1879,35.37280005360669
STAT,1871,22,20-24,1893,64.64490163479108
SIM,1856,36,na,1892,1844
STAT,1946,26,50-100,1972,1.0479192865904878
SIM,1820,98,na,1918,1
STAT,1906,31,35-39,1937,8.033524311274673
STAT,1895,72,na,1967,1867.9418333943001
SIM,1829,25,40-44,1854,1
SIM,1853,27,25-29,1880,5
STAT,1915,12,na,1927,3904.8847173934832
STAT,1813,41,15-19,1854,0.04888509119322613
STAT,1850,27,20-24,1877,9.731871494996048
STAT,1841,29,20-24,1870,9.901705884274321
STAT,1857,33,na,1890,1770.4443418707401
SIM,1857,53,na,1910,1657
STAT,1835,38,35-39,1873,5.5078915107700395
SIM,1903,25,25-29,1928,52
STAT,1944,20,15-19,1964,5.433351378709148
SIM,1844,21,15-19,1865,2
SIM,1838,23,40-44,1861,1
STAT,1910,20,45-49,1930,1.004191101626857
STAT,1843,37,30-34,1880,4.202501095006546
STAT,1908,64,na,1972,2779.6784049102575
STAT,1929,24,40-44,1953,3.99152841161404
SIM,1920,22,20-24,1942,105
SIM,1841,33,40-44,1874,2
STAT,1858,50,na,1908,1617.7295297815513
SIM,1865,72,na,1937,1061
STAT,1840,23,30-34,1863,14.75876454268048
STAT,1921,20,20-24,1941,119.35422507354033
STAT,1828,48,45-49,1876,0.18858553708372888
SIM,1943,22,15-19,1965,5
STAT,1849,43,45-49,1892,1.114175462137815
STAT,1842,31,40-44,1873,3.8334902786274285
SIM,1864,33,35-39,1897,7
STAT,1868,37,20-24,1905,0.6947985661125828
SIM,1881,22,30-34,1903,17
SIM,1916,28,na,1944,3558
STAT,1883,27,45-49,1910,1.0283775938911757
STAT,1938,22,40-44,1960,3.1437379244170547
SIM,1937,24,40-44,1961,3
SIM,1844,25,na,1869,1816
SIM,1842,39,30-34,1881,5
SIM,1855,35,35-39,1890,6
STAT,1923,31,na,1954,4112.652333847045
SIM,1899,17,20-24,1916,21
SIM,1804,60,na,1864,969
SIM,1908,0,na,1908,3783
SIM,1919,20,30-34,1939,35
SIM,1946,22,40-44,1968,6
STAT,1857,23,na,1880,1825.8635041922782
STAT,1885,40,na,1925,2198.3243598131694
STAT,1849,14,na,1863,2183.5245223161783
STAT,1914,30,30-34,1944,15.102852573912214
SIM,1833,41,na,1874,1563
SIM,1847,21,40-44,1868,3
SIM,1890,71,na,1961,1881
STAT,1912,22,20-24,1934,100.67429122847602
STAT,1895,50,na,1945,2690.0202825315187
SIM,1885,22,15-19,1907,6
STAT,1864,32,30-34,1896,14.700589381104006
SIM,1882,52,na,1934,2019
STAT,1884,38,30-34,1922,4.949533294755193
SIM,1891,27,45-49,1918,1
SIM,1874,29,25-29,1903,44
SIM,1921,21,25-29,1942,98
STAT,1828,35,25-29,1863,2.7506049084452355
STAT,1874,48,15-19,1922,3.812378136551554E-4
STAT,1878,31,20-24,1909,2.6720924324274007
STAT,1834,39,30-34,1873,4.029563053303802
STAT,1862,24,20-24,1886,56.165163327725914
STAT,1890,17,35-39,1907,0.6337403037101061
STAT,1932,21,35-39,1953,11.706357994948338
SIM,1871,23,25-29,1894,69
STAT,1847,35,35-39,1882,5.524998341244047
STAT,1845,32,20-24,1877,2.274282749285005
STAT,1950,11,na,1961,4388.560950769829
SIM,1891,26,20-24,1917,17
STAT,1841,49,15-19,1890,2.700067843789689E-4
STAT,1880,50,30-34,1930,0.0060135444606980925
STAT,1861,28,35-39,1889,7.579359727605863
STAT,1880,32,15-19,1912,0.1418287669728672
SIM,1824,36,45-49,1860,1
SIM,1827,55,na,1882,1192
SIM,1935,36,25-29,1971,1
STAT,1820,78,na,1898,411.6120720226821
SIM,1940,21,35-39,1961,8
STAT,1833,104,na,1937,0.04092221670979657
SIM,1961,7,na,1968,4756
STAT,1839,21,40-44,1860,1.7955315669832363
STAT,1845,27,25-29,1872,36.43466036804986
STAT,1857,39,25-29,1896,2.123587247992563
STAT,1889,15,45-49,1904,0.07653664496369782
STAT,1913,21,25-29,1934,84.81477456808773
STAT,1827,36,20-24,1863,0.819535111219089
STAT,1839,48,20-24,1887,0.008036721317650364
STAT,1893,18,15-19,1911,7.091128394712692
SIM,1870,24,20-24,1894,67
SIM,1874,33,na,1907,2211
STAT,1947,15,45-49,1962,0.5318917060200236
SIM,1829,36,na,1865,1560
SIM,1882,20,na,1902,2244
STAT,1869,49,45-49,1918,0.2114751141593624
STAT,1890,24,50-100,1914,0.46803554115202506
STAT,1896,22,25-29,1918,71.42451615644691
STAT,1863,23,25-29,1886,48.0558444612056
SIM,1835,23,15-19,1858,1
STAT,1863,36,30-34,1899,4.439577720185075
STAT,1878,92,na,1970,155.97037349759364
STAT,1931,27,50-100,1958,1.2139492484714796
STAT,1838,39,15-19,1877,0.044556204684749114
STAT,1945,15,50-100,1960,0.38683486691289765
SIM,1870,100,na,1970,9
SIM,1922,30,30-34,1952,22
STAT,1857,2,na,1859,2622.5860455580114
STAT,1844,58,na,1902,1373.488292530625
SIM,1905,33,35-39,1938,9
STAT,1897,34,35-39,1931,12.684816592659391
SIM,1878,48,50-100,1926,3
SIM,1892,38,30-34,1930,9
SIM,1904,5,na,1909,3609
SIM,1836,35,25-29,1871,1
STAT,1861,15,15-19,1876,5.421548242312475
SIM,1841,20,35-39,1861,8
STAT,1933,33,45-49,1966,2.0020683731470754
SIM,1865,94,na,1959,31
STAT,1895,26,25-29,1921,52.27716280440894
SIM,1867,85,na,1952,222
SIM,1869,34,25-29,1903,15
SIM,1890,15,35-39,1905,1
STAT,1810,46,na,1856,1254.590579869347
SIM,1854,35,na,1889,1907
SIM,1819,36,na,1855,1550
SIM,1933,1,na,1934,5234
SIM,1940,29,30-34,1969,40
STAT,1855,17,40-44,1872,0.15459324067557942
STAT,1874,34,40-44,1908,4.150062245395353
SIM,1904,29,20-24,1933,16
STAT,1888,16,40-44,1904,0.2047033162458911
SIM,1869,22,30-34,1891,20
STAT,1817,47,30-34,1864,0.21822251898843836
STAT,1932,29,30-34,1961,48.43424761800052
SIM,1829,68,na,1897,899
SIM,1853,32,20-24,1885,1
STAT,1846,39,35-39,1885,5.365713659329223
STAT,1927,36,25-29,1963,1.1574915314782572
STAT,1896,35,30-34,1931,6.712789008372648
SIM,1892,52,na,1944,2838
STAT,1848,47,45-49,1895,0.1745441486795171
STAT,1831,50,35-39,1881,0.005613111042916718
STAT,1851,24,45-49,1875,0.5904530872989951
STAT,1925,44,na,1969,4233.494016516564
STAT,1878,17,35-39,1895,0.5402154548158454
STAT,1932,38,50-100,1970,0.5323755670361303
STAT,1815,39,20-24,1854,2.3633160374968107
STAT,1940,11,na,1951,3790.619112932148
STAT,1922,39,15-19,1961,0.0205985060257422
STAT,1863,36,50-100,1899,1.0227188045675442
STAT,1829,44,30-34,1873,0.9505848949399236
SIM,1887,38,35-39,1925,13
SIM,1890,61,na,1951,2359
SIM,1813,48,50-100,1861,3
SIM,1863,36,50-100,1899,2
SIM,1886,31,20-24,1917,2
SIM,1879,24,40-44,1903,2
SIM,1888,43,50-100,1931,2
STAT,1819,42,20-24,1861,0.3345196050499785
STAT,1873,25,35-39,1898,9.307497580102845
STAT,1885,16,15-19,1901,5.601956373575166
STAT,1847,15,40-44,1862,0.1703367432864246
STAT,1858,72,na,1930,935.4028594377344
STAT,1864,15,40-44,1879,0.1771452102763492
STAT,1923,23,35-39,1946,10.317800191150937
STAT,1912,40,35-39,1952,0.1855569280350497
SIM,1875,72,na,1947,1167
STAT,1856,47,50-100,1903,0.18018235313654885
SIM,1887,43,30-34,1930,4
STAT,1935,32,na,1967,4943.031694508788
SIM,1880,26,30-34,1906,29
STAT,1872,22,na,1894,2241.066270782787
STAT,1884,23,45-49,1907,0.6488136213965477
SIM,1865,37,45-49,1902,1
SIM,1840,21,30-34,1861,17
STAT,1876,39,35-39,1915,6.833727605408524
STAT,1857,42,40-44,1899,1.673784445910161
SIM,1845,30,20-24,1875,2
STAT,1939,21,45-49,1960,1.0678564119949996
SIM,1810,98,na,1908,1
SIM,1868,38,25-29,1906,2
SIM,1882,28,20-24,1910,10
STAT,1869,24,30-34,1893,16.199562661652113
STAT,1870,26,20-24,1896,10.909565595850037
STAT,1907,40,40-44,1947,0.21894233082204906
STAT,1918,43,20-24,1961,0.017710518274177245
STAT,1835,25,15-19,1860,0.3818097396424617
SIM,1822,33,30-34,1855,18
STAT,1844,49,40-44,1893,0.11641986242424524
STAT,1834,32,45-49,1866,1.3862336405916793
STAT,1932,14,na,1946,4940.378368882981
STAT,1879,43,30-34,1922,1.128663559670537
STAT,1940,23,35-39,1963,9.058435200815826
SIM,1842,32,45-49,1874,1
STAT,1872,51,35-39,1923,0.008196780418256921
STAT,1862,37,40-44,1899,3.5357901559138
STAT,1927,41,20-24,1968,0.020953531525306636
SIM,1907,45,na,1952,3171
SIM,1857,75,na,1932,720
STAT,1838,37,35-39,1875,5.72982255742256
SIM,1844,35,na,1879,1702
STAT,1807,80,na,1887,278.5672893031733
STAT,1874,28,20-24,1902,11.283612706528718
STAT,1927,13,na,1940,4646.838456273206
SIM,1884,39,35-39,1923,11
SIM,1838,43,35-39,1881,1
SIM,1931,17,na,1948,4539
SIM,1941,30,40-44,1971,4
SIM,1834,44,50-100,1878,1
STAT,1839,54,50-100,1893,0.009778867620071208
SIM,1936,32,25-29,1968,8
STAT,1829,31,25-29,1860,10.507514587639013
SIM,1902,14,na,1916,3448
STAT,1905,35,35-39,1940,2.1043996400767817
STAT,1841,22,35-39,1863,5.096402740483444
STAT,1866,35,45-49,1901,1.7534636564856374
STAT,1908,36,15-19,1944,0.0170672833381586
STAT,1761,101,na,1862,0.16154103119198832
SIM,1921,29,20-24,1950,20
SIM,1947,21,45-49,1968,1
STAT,1864,27,35-39,1891,8.124125480675811
SIM,1872,42,na,1914,2181
SIM,1894,33,20-24,1927,2
SIM,1898,67,na,1965,2216
STAT,1848,44,40-44,1892,1.6487824780643179
SIM,1872,27,35-39,1899,10
STAT,1880,15,25-29,1895,5.669913830226002
SIM,1867,53,na,1920,2061
STAT,1885,8,na,1893,2447.8460003456694
STAT,1892,25,45-49,1917,1.322679540351674
STAT,1816,41,50-100,1857,2.986459593016052
SIM,1849,56,na,1905,1547
STAT,1955,17,45-49,1972,0.6264002745010457
STAT,1771,110,na,1881,0.001397452985705221
SIM,1914,47,na,1961,3448
STAT,1930,21,50-100,1951,0.7987052393807894
STAT,1937,30,25-29,1967,8.6482944867234
SIM,1837,31,25-29,1868,13
SIM,1867,39,35-39,1906,17
STAT,1928,32,25-29,1960,10.917477008118254
SIM,1809,91,na,1900,23
SIM,1907,35,na,1942,3344
SIM,1913,35,35-39,1948,6
STAT,1889,32,35-39,1921,11.810739986988041
STAT,1920,42,35-39,1962,0.2100949553623629
STAT,1827,49,40-44,1876,0.15249591115560543
STAT,1913,29,20-24,1942,17.06026607323724
SIM,1901,28,40-44,1929,4
SIM,1959,11,na,1970,4878
STAT,1833,47,15-19,1880,2.874819308081189E-4
SIM,1897,32,35-39,1929,16
SIM,1936,15,35-39,1951,3
SIM,1888,34,35-39,1922,16
STAT,1886,33,20-24,1919,2.6860273340542085
STAT,1947,20,40-44,1967,3.5925118806828973
STAT,1853,39,40-44,1892,3.2795345463445695
SIM,1856,31,35-39,1887,12
STAT,1889,45,40-44,1934,0.2016533852128281
SIM,1901,20,45-49,1921,3
STAT,1909,15,25-29,1924,8.065812304145343
SIM,1894,28,25-29,1922,55
SIM,1839,56,na,1895,1398
STAT,1839,16,45-49,1855,0.05723042919417077
STAT,1922,19,20-24,1941,147.43069862714043
SIM,1826,38,35-39,1864,13
STAT,1825,34,45-49,1859,2.5288254087294697
SIM,1831,23,30-34,1854,23
SIM,1846,37,35-39,1883,18
STAT,1902,22,50-100,1924,0.5436789926646775
SIM,1871,20,20-24,1891,59
SIM,1802,79,na,1881,268
SIM,1837,27,40-44,1864,2
STAT,1936,31,20-24,1967,2.2393969023293736
SIM,1831,60,na,1891,1137
SIM,1895,49,na,1944,2793
SIM,1902,21,15-19,1923,3
STAT,1870,48,30-34,1918,0.08858327707615665
SIM,1879,44,35-39,1923,4
SIM,1893,29,35-39,1922,17
SIM,1843,38,35-39,1881,17
STAT,1871,38,na,1909,2199.1149394148233
STAT,1928,15,35-39,1943,5.017925595701818
SIM,1896,33,30-34,1929,34
STAT,1885,29,35-39,1914,9.020913148647736
SIM,1834,101,na,1935,1
SIM,1874,35,45-49,1909,1
SIM,1887,83,na,1970,711
STAT,1801,109,na,1910,2.5150412932255646E-4
STAT,1839,54,40-44,1893,0.006816539648936628
STAT,1866,18,50-100,1884,0.043557351574173515
SIM,1936,20,30-34,1956,28
SIM,1833,34,45-49,1867,1
STAT,1896,18,40-44,1914,0.22760758450025015
STAT,1861,50,20-24,1911,5.879556624731249E-4
SIM,1894,21,na,1915,3002
STAT,1803,76,na,1879,380.5143594267193
STAT,1837,30,20-24,1867,2.2456852511278997
STAT,1852,40,50-100,1892,0.7736414410228742
STAT,1934,26,15-19,1960,0.8975585608861832
STAT,1899,49,30-34,1948,0.0692028929099984
SIM,1931,23,35-39,1954,14
STAT,1855,37,35-39,1892,5.026206689184562
SIM,1906,33,50-100,1939,1
STAT,1829,27,40-44,1856,4.304951203482687
SIM,1917,15,25-29,1932,11
SIM,1888,22,40-44,1910,2
STAT,1809,48,35-39,1857,0.3882425760479035
STAT,1864,29,15-19,1893,0.37927447685478144
STAT,1885,72,na,1957,1248.2682431448914
STAT,1886,28,25-29,1914,42.06443754844993
STAT,1818,38,35-39,1856,20.34084241317225
STAT,1884,32,50-100,1916,0.8551509556975899
STAT,1918,30,15-19,1948,0.13003995933645018
SIM,1878,32,25-29,1910,13
SIM,1893,16,15-19,1909,7
SIM,1920,31,50-100,1951,4
SIM,1861,26,20-24,1887,11
STAT,1891,28,20-24,1919,13.663235670708492
SIM,1827,37,25-29,1864,2
SIM,1830,76,na,1906,542
STAT,1869,33,20-24,1902,2.4633713625368214
SIM,1832,22,35-39,1854,5
SIM,1930,19,20-24,1949,144
SIM,1929,22,40-44,1951,4
STAT,1939,23,50-100,1962,0.6240653705930894
SIM,1836,38,na,1874,1614
STAT,1838,42,30-34,1880,0.9026586108837785
STAT,1944,16,30-34,1960,12.394999730236302
STAT,1854,38,45-49,1892,1.4192353851422803
STAT,1881,24,30-34,1905,16.153842457258158
STAT,1875,25,45-49,1900,1.0854349468628042
STAT,1928,20,30-34,1948,34.1016640625649
STAT,1849,36,na,1885,1826.6417669174216
STAT,1798,80,na,1878,261.9073613354183
STAT,1853,26,20-24,1879,10.359514988750822
STAT,1919,42,25-29,1961,0.07310514299950524
SIM,1883,25,45-49,1908,1
STAT,1800,58,na,1858,1013.4495139463121
STAT,1830,29,45-49,1859,1.0006831742257358
SIM,1816,61,na,1877,1012
STAT,1895,43,15-19,1938,0.0011725502173026599
STAT,1860,22,45-49,1882,0.5509969867777532
STAT,1824,37,20-24,1861,1.2091863421609803
SIM,1877,33,20-24,1910,2
SIM,1834,37,30-34,1871,5
SIM,1907,13,na,1920,3577
STAT,1878,39,45-49,1917,1.9428757424397156
STAT,1898,46,45-49,1944,0.17067108433282868
STAT,1847,23,40-44,1870,1.870215799759194
STAT,1926,32,15-19,1958,0.1467866914076954
SIM,1832,29,20-24,1861,13
STAT,1888,70,na,1958,1650.9506212644385
STAT,1850,50,45-49,1900,0.010377151433775666
STAT,1907,47,na,1954,3108.1883945983086
STAT,1893,28,30-34,1921,30.062418811260322
SIM,1887,35,30-34,1922,8
STAT,1937,13,na,1950,3635.8234838105323
SIM,1820,43,50-100,1863,1
SIM,1917,45,na,1962,3608
STAT,1830,56,na,1886,1245.9664859315287
STAT,1929,27,45-49,1956,2.042500799031888
SIM,1879,54,na,1933,2128
STAT,1826,31,50-100,1857,1.345915518505131
STAT,1899,39,15-19,1938,0.01553086693320704
STAT,1931,40,45-49,1971,0.2106203238531511
SIM,1853,15,30-34,1868,2
SIM,1886,34,25-29,1920,12
SIM,1937,27,45-49,1964,2
STAT,1881,49,45-49,1930,0.2108782656119331
STAT,1944,3,na,1947,4082.534956967893
SIM,1865,39,25-29,1904,1
STAT,1834,24,45-49,1858,0.5704913596127894
STAT,1945,24,25-29,1969,95.57153950869156
SIM,1845,25,25-29,1870,38
SIM,1854,44,30-34,1898,1
SIM,1900,16,30-34,1916,3
STAT,1915,29,30-34,1944,37.48597287214877
STAT,1865,42,na,1907,1976.599922870586
SIM,1861,37,na,1898,2029
STAT,1851,21,40-44,1872,1.8030120140664938
STAT,1879,35,30-34,1914,5.320329066593853
SIM,1838,35,35-39,1873,9
STAT,1830,26,40-44,1856,3.2600989086014627
SIM,1928,21,35-39,1949,14
STAT,1816,94,na,1910,9.31354594974337
STAT,1825,49,30-34,1874,0.09604791965832105
STAT,1845,15,30-34,1860,1.4424689176770669
SIM,1849,26,20-24,1875,16
SIM,1874,42,50-100,1916,3
STAT,1838,45,35-39,1883,0.09920763755730162
SIM,1867,17,25-29,1884,8
STAT,1848,31,35-39,1879,8.867082485120498
SIM,1787,95,na,1882,2
STAT,1826,37,30-34,1863,5.8156835160042775
STAT,1846,44,30-34,1890,0.8412032766831143
SIM,1827,34,20-24,1861,2
STAT,1843,22,45-49,1865,0.5912058561811423
STAT,1866,7,na,1873,2432.5344622424404
STAT,1908,39,40-44,1947,1.31077272389552
SIM,1872,74,na,1946,988
SIM,1932,12,na,1944,4923
STAT,1927,33,20-24,1960,2.8327059199963025
STAT,1888,33,30-34,1921,19.41061042583231
STAT,1857,37,45-49,1894,1.485269182760968
STAT,1877,22,15-19,1899,3.2328279585472592
SIM,1905,21,40-44,1926,2
SIM,1813,96,na,1909,4
SIM,1892,20,na,1912,3109
STAT,1892,49,20-24,1941,0.007842190306779885
STAT,1909,20,20-24,1929,98.21642067463848
SIM,1861,34,20-24,1895,1
SIM,1920,25,25-29,1945,64
STAT,1929,41,30-34,1970,0.1566277604717909
STAT,1897,26,35-39,1923,12.232120039819986
STAT,1789,104,na,1893,0.014737833847027102
SIM,1869,31,20-24,1900,1
STAT,1866,42,50-100,1908,0.9193757546515537
SIM,1781,90,na,1871,16
STAT,1918,26,30-34,1944,39.528346698649884
SIM,1893,24,15-19,1917,8
STAT,1872,26,30-34,1898,23.943682877666927
SIM,1834,25,na,1859,1763
STAT,1929,28,50-100,1957,1.1762058794007502
STAT,1914,33,35-39,1947,8.653500995612418
SIM,1861,7,na,1868,2434
STAT,1837,25,25-29,1862,35.748591215579125
SIM,1935,33,20-24,1968,3
STAT,1836,37,25-29,1873,2.2885546374110257
SIM,1918,27,50-100,1945,5
STAT,1863,20,20-24,1883,59.11401107996003
STAT,1853,34,20-24,1887,2.063312855164749
STAT,1878,5,na,1883,2678.1282245631232
STAT,1941,19,30-34,1960,11.85236882545513
SIM,1878,28,40-44,1906,8
SIM,1889,43,40-44,1932,9
SIM,1922,33,35-39,1955,17
STAT,1885,24,15-19,1909,3.087057505460371
STAT,1878,49,50-100,1927,0.23674969577688912
STAT,1837,35,na,1872,1727.846039654858
SIM,1853,24,20-24,1877,50
STAT,1842,34,45-49,1876,1.4941931847042342
STAT,1859,17,25-29,1876,4.945848918784037
STAT,1880,2,na,1882,3196.3537225538844
STAT,1807,90,na,1897,29.3246068704154
STAT,1820,46,na,1866,1375.366188311599
STAT,1851,39,30-34,1890,3.7952088219245557
STAT,1864,68,na,1932,1286.6992124090725
STAT,1887,45,30-34,1932,0.10330679814275692
STAT,1867,33,na,1900,2107.9110836640693
STAT,1845,35,25-29,1880,2.4017603768359366
SIM,1891,29,25-29,1920,54
STAT,1786,106,na,1892,0.0057050472661132525
STAT,1845,24,20-24,1869,59.67173655496522
SIM,1882,84,na,1966,502
STAT,1933,30,40-44,1963,4.9876730235270985
STAT,1832,39,20-24,1871,0.5765316899606246
STAT,1928,17,50-100,1945,0.4459570067439042
STAT,1867,38,30-34,1905,4.704301846317756
SIM,1926,26,30-34,1952,48
STAT,1850,4,na,1854,2296.0
STAT,1855,21,25-29,1876,47.86833126893017
STAT,1878,34,25-29,1912,9.99771930480163
STAT,1854,42,15-19,1896,0.009868561463022724
STAT,1860,49,50-100,1909,0.18432415988103873
STAT,1868,28,30-34,1896,22.61761153764545
SIM,1824,38,25-29,1862,1
STAT,1854,68,na,1922,1093.4024572145547
STAT,1872,17,40-44,1889,0.17388487547978504
SIM,1846,34,30-34,1880,16
SIM,1923,29,30-34,1952,52
SIM,1898,36,45-49,1934,2
STAT,1878,26,25-29,1904,41.78954047870135
STAT,1868,24,15-19,1892,2.954934358428475
STAT,1862,27,25-29,1889,34.293599612721955
SIM,1926,22,15-19,1948,6
STAT,1882,22,na,1904,2172.8064900111476
STAT,1942,20,50-100,1962,0.6522035448256323
STAT,1907,25,na,1932,3334.3129852586217
STAT,1858,38,15-19,1896,0.04138634405579623
STAT,1918,22,15-19,1940,5.423730997407459
STAT,1872,15,50-100,1887,0.0471298491959799
STAT,1856,16,45-49,1872,0.05726890581556185
SIM,1900,32,45-49,1932,4
STAT,1782,109,na,1891,0.0017237923897077323
SIM,1886,39,45-49,1925,1
SIM,1917,5,na,1922,4079
STAT,1874,21,35-39,1895,5.649547060153984
STAT,1846,36,30-34,1882,4.171096569724172
STAT,1852,24,na,1876,1815.1135586099895
SIM,1938,20,40-44,1958,3
STAT,1844,23,15-19,1867,2.840234994175181
SIM,1870,27,25-29,1897,46
STAT,1938,34,35-39,1972,8.669424906223625
STAT,1816,38,25-29,1854,10.603036980597102
SIM,1945,26,40-44,1971,6
SIM,1919,38,50-100,1957,2
SIM,1912,46,na,1958,3299
SIM,1848,42,40-44,1890,9
STAT,1896,39,50-100,1935,1.5164195149803419
SIM,1883,1,na,1884,2967
STAT,1837,27,50-100,1864,0.5328637716491235
STAT,1883,29,25-29,1912,38.90011367168462
SIM,1903,22,20-24,1925,91
STAT,1903,32,20-24,1935,3.6333224952572842
SIM,1923,6,na,1929,4496
SIM,1852,23,15-19,1875,6
SIM,1911,32,20-24,1943,2
STAT,1839,24,45-49,1863,0.5880033792325887
SIM,1857,85,na,1942,161
STAT,1864,35,35-39,1899,6.011757556138022
SIM,1952,2,na,1954,4414
SIM,1902,46,na,1948,2984
SIM,1928,30,25-29,1958,13
STAT,1937,26,40-44,1963,4.294211735318629
SIM,1824,90,na,1914,27
STAT,1859,15,50-100,1874,0.04326768438390095
SIM,1864,25,35-39,1889,12
STAT,1794,98,na,1892,0.6118789749210012
SIM,1877,73,na,1950,1102
STAT,1898,38,45-49,1936,0.5473456644361906
STAT,1925,31,45-49,1956,1.766244759871108
SIM,1825,32,45-49,1857,1
SIM,1868,35,20-24,1903,3
SIM,1854,36,30-34,1890,5
STAT,1862,49,35-39,1911,0.11071955842486711
SIM,1896,24,40-44,1920,4
SIM,1868,26,30-34,1894,26
STAT,1925,12,na,1937,4521.570424207095
SIM,1927,34,25-29,1961,11
STAT,1867,53,50-100,1920,0.013182209348276783
STAT,1875,19,na,1894,2439.248887719034
SIM,1907,33,45-49,1940,3
SIM,1918,24,30-34,1942,33
STAT,1820,36,25-29,1856,7.008478412826582
STAT,1879,46,35-39,1925,0.1388353107651564
STAT,1797,63,na,1860,868.7107775910049
SIM,1867,36,30-34,1903,6
STAT,1887,21,na,1908,2506.6547593142836
STAT,1911,19,45-49,1930,0.09393134510005209
STAT,1926,24,15-19,1950,6.070955904664589
SIM,1857,35,45-49,1892,1
STAT,1850,19,20-24,1869,15.092080158391253
SIM,1886,26,25-29,1912,41
STAT,1819,45,25-29,1864,0.11251249685808658
SIM,1874,55,na,1929,1913
STAT,1821,73,na,1894,632.7943580316498
STAT,1936,22,30-34,1958,25.957604091297036
STAT,1890,51,na,1941,2498.802122202928
SIM,1882,34,40-44,1916,4
SIM,1843,20,45-49,1863,1
SIM,1946,1,na,1947,4110
SIM,1829,33,40-44,1862,5
STAT,1865,20,na,1885,2079.482237076714
SIM,1853,37,40-44,1890,5
SIM,1930,15,40-44,1945,1
STAT,1857,55,na,1912,1540.5727208446744
STAT,1932,25,50-100,1957,1.2326597837925657
SIM,1863,21,25-29,1884,51
SIM,1863,49,50-100,1912,4
STAT,1905,39,15-19,1944,0.016383859493085698
SIM,1849,24,na,1873,1949
SIM,1885,27,35-39,1912,10
STAT,1828,48,50-100,1876,0.19625681284617136
SIM,1819,58,na,1877,1134
SIM,1922,22,30-34,1944,32
STAT,1915,34,na,1949,3607.7608254155157
SIM,1933,31,45-49,1964,1
STAT,1810,47,20-24,1857,0.040045366305479925
STAT,1870,29,25-29,1899,38.92312572152534
SIM,1934,24,15-19,1958,10
STAT,1888,24,40-44,1912,2.311900586311148
SIM,1850,28,25-29,1878,37
SIM,1862,25,50-100,1887,2
SIM,1815,43,40-44,1858,7
STAT,1813,54,50-100,1867,0.037934984072486154
SIM,1818,36,35-39,1854,11
STAT,1873,26,50-100,1899,0.6150018408310229
SIM,1878,24,25-29,1902,64
STAT,1914,16,45-49,1930,0.09786102303740742
SIM,1836,48,50-100,1884,4
SIM,1915,27,30-34,1942,55
STAT,1907,43,45-49,1950,0.14318435228509424
STAT,1931,25,35-39,1956,18.326787804984757
STAT,1948,16,15-19,1964,49.080128706093944
SIM,1874,32,40-44,1906,3
STAT,1922,32,30-34,1954,16.816864010561712
STAT,1785,106,na,1891,0.008974584351994613
STAT,1934,29,40-44,1963,5.917586798026065
STAT,1891,36,na,1927,2766.875241694829
SIM,1819,35,25-29,1854,5
STAT,1842,28,25-29,1870,37.61144416049327
STAT,1857,48,15-19,1905,2.94279462267937E-4
STAT,1838,34,30-34,1872,14.266263852095063
SIM,1812,79,na,1891,258
SIM,1871,68,na,1939,1404
STAT,1835,54,na,1889,1342.337185380982
STAT,1923,0,na,1923,4997.479083104418
SIM,1903,30,20-24,1933,2
SIM,1930,32,30-34,1962,27
STAT,1927,44,25-29,1971,0.08432164937365944
SIM,1836,23,30-34,1859,25
STAT,1867,16,20-24,1883,16.172550549229328
SIM,1875,16,20-24,1891,16
SIM,1885,49,na,1934,2112
STAT,1843,27,15-19,1870,0.3771437647346326
STAT,1914,17,20-24,1931,26.49441624934818
SIM,1902,68,na,1970,2279
SIM,1831,26,35-39,1857,8
SIM,1875,38,30-34,1913,9
SIM,1922,17,20-24,1939,146
STAT,1919,34,25-29,1953,9.339584239637569
STAT,1874,19,50-100,1893,0.04703451139806286
SIM,1919,14,na,1933,4199
STAT,1840,48,45-49,1888,0.15419271665023518
SIM,1837,23,25-29,1860,49
STAT,1910,13,na,1923,3691.2027884630584
SIM,1879,36,35-39,1915,9
STAT,1842,26,45-49,1868,1.001533730877067
SIM,1800,78,na,1878,269
SIM,1820,38,40-44,1858,5
SIM,1929,25,45-49,1954,3
STAT,1951,21,45-49,1972,1.270368303333623
STAT,1887,37,30-34,1924,5.631681163801575
STAT,1892,22,40-44,1914,2.465667460056775
STAT,1926,46,50-100,1972,0.26429223008786384
SIM,1884,21,45-49,1905,1
STAT,1864,24,30-34,1888,15.020570154111185
SIM,1799,96,na,1895,4
STAT,1835,20,45-49,1855,0.8069992682101371
SIM,1878,37,45-49,1915,2
STAT,1835,42,50-100,1877,0.8056650428031786
SIM,1893,26,30-34,1919,44
STAT,1876,48,25-29,1924,0.055511496368457924
STAT,1885,43,50-100,1928,0.9876149059965191
STAT,1805,57,na,1862,1095.7517453979303
SIM,1894,25,20-24,1919,18
SIM,1888,25,45-49,1913,1
SIM,1924,25,na,1949,4149
STAT,1819,47,40-44,1866,0.32441314889969036
STAT,1890,19,15-19,1909,6.817445595695411
STAT,1928,23,35-39,1951,11.071462061480958
SIM,1932,39,25-29,1971,1
STAT,1877,21,na,1898,2324.5900955794627
SIM,1862,54,na,1916,1805
STAT,1900,18,30-34,1918,2.0833004451139714
SIM,1942,29,40-44,1971,5
STAT,1886,38,40-44,1924,4.346688496186139
STAT,1947,23,45-49,1970,1.2009650876266502
STAT,1813,44,na,1857,1295.3773797363622
STAT,1876,69,na,1945,1432.329387303512
SIM,1803,96,na,1899,2
STAT,1917,21,50-100,1938,0.6626522589994945
SIM,1888,31,30-34,1919,22
STAT,1836,21,15-19,1857,2.8398502194201662
STAT,1903,15,30-34,1918,2.1523571194935003
SIM,1826,35,30-34,1861,7
STAT,1898,15,na,1913,3243.7857998462027
STAT,1912,25,25-29,1937,61.69373857813365
SIM,1874,26,20-24,1900,7
STAT,1827,44,20-24,1871,0.1472159527387618
STAT,1824,60,na,1884,1130.31165292408
SIM,1919,36,40-44,1955,5
STAT,1821,48,35-39,1869,0.21763866648009736
SIM,1806,61,na,1867,964
STAT,1883,71,na,1954,1236.3101720154907
SIM,1877,20,15-19,1897,3
SIM,1926,28,45-49,1954,4
STAT,1840,15,45-49,1855,0.05616254390810177
SIM,1872,24,30-34,1896,24
SIM,1895,37,30-34,1932,9
SIM,1826,38,na,1864,1500
STAT,1885,26,30-34,1911,23.793748603524026
STAT,1922,14,na,1936,4317.955835075102
SIM,1850,26,45-49,1876,2
SIM,1863,39,na,1902,1936
STAT,1841,93,na,1934,20.148334892769977
STAT,1803,98,na,1901,1.0919737131128373
SIM,1894,38,40-44,1932,6
SIM,1911,15,30-34,1926,4
SIM,1914,31,35-39,1945,11
SIM,1932,34,na,1966,4681
STAT,1825,31,40-44,1856,8.44220927095845
STAT,1922,15,40-44,1937,1.5363301448308508
STAT,1886,25,20-24,1911,11.786360843417219
STAT,1864,18,45-49,1882,0.05656085874926884
STAT,1894,35,20-24,1929,0.9447365471956596
SIM,1936,23,35-39,1959,6
STAT,1849,35,45-49,1884,1.5617274519855193
STAT,1848,72,na,1920,938.4041939832605
STAT,1800,109,na,1909,2.828287604653873E-4
SIM,1845,33,25-29,1878,19
SIM,1833,31,40-44,1864,5
SIM,1856,44,40-44,1900,6
STAT,1940,20,30-34,1960,27.678288859931495
SIM,1855,23,40-44,1878,3
STAT,1836,39,na,1875,1667.3926704527978
STAT,1837,33,25-29,1870,8.248500703835376
SIM,1859,15,25-29,1874,6
SIM,1901,19,na,1920,3318
STAT,1945,21,20-24,1966,115.16567580534505
SIM,1847,30,30-34,1877,30
STAT,1872,8,na,1880,2565.4614669017856
SIM,1846,28,45-49,1874,1
STAT,1869,20,15-19,1889,3.05024809186509
SIM,1868,22,15-19,1890,2
SIM,1929,20,25-29,1949,125
SIM,1941,17,30-34,1958,13
STAT,1928,36,40-44,1964,1.7888313015929371
SIM,1916,24,20-24,1940,97
STAT,1863,19,na,1882,2148.626521770807
SIM,1817,37,30-34,1854,5
SIM,1870,29,40-44,1899,2
STAT,1834,91,na,1925,35.92590317298038
STAT,1933,17,30-34,1950,15.414045958583934
SIM,1845,22,20-24,1867,59
STAT,1795,94,na,1889,4.523392401913348
STAT,1847,26,45-49,1873,0.9912072447442052
SIM,1863,37,35-39,1900,8
STAT,1851,61,na,1912,1344.1898426636494
STAT,1862,15,30-34,1877,1.49198144704618
STAT,1887,28,40-44,1915,3.154223254379334
SIM,1842,21,40-44,1863,5
STAT,1862,29,40-44,1891,2.402279346010487
STAT,1864,47,50-100,1911,0.20582421192733374
STAT,1895,29,na,1924,2918.2316264223828
STAT,1955,10,na,1965,4927.037334553283
STAT,1846,20,20-24,1866,63.98143546476648
SIM,1837,36,45-49,1873,3
SIM,1844,57,na,1901,1338
STAT,1855,74,na,1929,788.6453677468112
SIM,1897,51,na,1948,2817
STAT,1844,39,25-29,1883,2.069670910198831
SIM,1833,94,na,1927,8
SIM,1852,39,25-29,1891,5
STAT,1902,16,na,1918,3375.4874330502325
SIM,1801,84,na,1885,100
SIM,1918,20,15-19,1938,5
STAT,1924,39,25-29,1963,1.0944565124874823
STAT,1842,24,na,1866,1925.0372252841769
SIM,1954,13,na,1967,4484
SIM,1828,37,40-44,1865,6
SIM,1825,52,50-100,1877,1
STAT,1819,36,50-100,1855,3.7759178195754037
SIM,1869,39,45-49,1908,1
SIM,1939,24,15-19,1963,4
STAT,1830,24,25-29,1854,126.69203113280861
SIM,1880,22,15-19,1902,6
STAT,1851,15,20-24,1866,15.689462547231292
SIM,1895,28,40-44,1923,4
STAT,1829,35,40-44,1864,4.122136021298341
STAT,1853,37,25-29,1890,2.1789652775648367
STAT,1852,103,na,1955,0.10404641788806923
STAT,1859,89,na,1948,78.98874729287071
STAT,1942,20,40-44,1962,3.3327598715880544
STAT,1834,21,40-44,1855,1.7420567313963786
SIM,1842,18,25-29,1860,4
STAT,1884,66,na,1950,1529.7221222528337
SIM,1852,25,30-34,1877,26
SIM,1892,19,na,1911,3306
STAT,1896,27,45-49,1923,1.3853090400090549
STAT,1812,47,30-34,1859,0.3240941842095164
SIM,1827,87,na,1914,87
SIM,1934,15,25-29,1949,72
STAT,1838,28,45-49,1866,0.9414019775143627
STAT,1965,5,na,1970,4636.04456131579
SIM,1906,29,30-34,1935,35
STAT,1837,42,15-19,1879,0.010575996569408719
STAT,1875,53,50-100,1928,0.014429529195867503
SIM,1861,17,30-34,1878,2
SIM,1863,25,40-44,1888,2
STAT,1857,21,35-39,1878,5.055570925161375
STAT,1894,19,35-39,1913,0.6625875616817984
STAT,1934,34,15-19,1968,0.16553463302773747
STAT,1846,49,na,1895,1633.873962018578
SIM,1937,28,20-24,1965,19
SIM,1844,26,35-39,1870,6
SIM,1857,107,na,1964,1
STAT,1846,47,35-39,1893,0.10335443257217378
STAT,1849,48,15-19,1897,2.9617810477137427E-4
SIM,1929,14,na,1943,4720
STAT,1871,27,40-44,1898,2.810055517140133
STAT,1889,41,50-100,1930,1.2376670768673625
STAT,1903,35,25-29,1938,0.8432557916225953
STAT,1853,17,30-34,1870,1.4510212643407632
SIM,1938,32,35-39,1970,8
STAT,1829,36,45-49,1865,1.8429935375217248
SIM,1794,97,na,1891,2
SIM,1865,21,35-39,1886,8
SIM,1895,29,45-49,1924,1
SIM,1908,25,25-29,1933,71
STAT,1899,27,20-24,1926,15.185222065892223
SIM,1835,28,35-39,1863,7
STAT,1827,28,35-39,1855,17.76777050932007
STAT,1872,48,40-44,1920,0.1601868606527807
SIM,1820,44,na,1864,1485
STAT,1819,38,na,1857,1530.2662372903937
STAT,1810,48,50-100,1858,0.8062053291867646
STAT,1855,25,40-44,1880,2.4736841947422885
STAT,1859,99,na,1958,2.2913505571685615
STAT,1898,49,15-19,1947,2.824311114583484E-4
SIM,1870,15,30-34,1885,3
STAT,1864,49,45-49,1913,0.19455652476980112
SIM,1871,36,30-34,1907,6
STAT,1847,49,50-100,1896,0.17732583771695606
SIM,1909,34,30-34,1943,19
STAT,1836,26,35-39,1862,8.14365069065913
STAT,1885,19,na,1904,2365.4668635469698
SIM,1769,98,na,1867,1
SIM,1930,35,35-39,1965,8
STAT,1907,15,15-19,1922,8.273803867983483
STAT,1941,28,na,1969,3659.1889403230193
STAT,1924,19,30-34,1943,13.638225058191136
STAT,1844,25,30-34,1869,21.72080061920592
SIM,1900,28,25-29,1928,61
STAT,1854,16,35-39,1870,0.4724176407273532
SIM,1859,36,30-34,1895,6
STAT,1887,15,35-39,1902,0.5825062289695758
STAT,1916,30,40-44,1946,3.84745859643049
STAT,1827,57,na,1884,1223.2166993655076
STAT,1837,49,35-39,1886,0.09193287725781604
SIM,1858,31,45-49,1889,1
STAT,1909,23,25-29,1932,80.85385658325606
STAT,1931,29,15-19,1960,0.8601426838026763
STAT,1880,41,na,1921,2312.259551678483
STAT,1892,16,20-24,1908,21.02881092253593
STAT,1902,18,40-44,1920,0.24321321463304418
STAT,1944,18,45-49,1962,0.507686939445553
STAT,1863,23,50-100,1886,0.3423268947218688
STAT,1842,17,20-24,1859,16.48656317925514
STAT,1937,22,25-29,1959,84.97531260054063
SIM,1828,38,45-49,1866,1
SIM,1894,36,25-29,1930,4
SIM,1927,25,35-39,1952,20
STAT,1873,16,45-49,1889,0.06295725550168495
SIM,1898,33,40-44,1931,10
SIM,1837,35,40-44,1872,9
SIM,1890,37,50-100,1927,1
STAT,1938,31,30-34,1969,14.97463491824146
SIM,1822,57,na,1879,1169
STAT,1818,49,25-29,1867,0.1191618812924117
STAT,1896,26,40-44,1922,3.7503476536181735
SIM,1840,36,50-100,1876,1
STAT,1890,73,na,1963,1603.936014657782
SIM,1861,37,25-29,1898,3
STAT,1919,31,20-24,1950,2.4961925423099234
SIM,1879,33,30-34,1912,24
SIM,1945,22,25-29,1967,102
STAT,1848,111,na,1959,1.2024160238718206E-4
STAT,1859,67,na,1926,1191.9102623693402
STAT,1804,107,na,1911,0.0015796865934150767
STAT,1817,57,na,1874,1125.6083168069526
SIM,1835,27,30-34,1862,26
SIM,1887,29,45-49,1916,1
STAT,1803,107,na,1910,0.0015852338774700252
STAT,1816,47,15-19,1863,9.446403065065267E-4
STAT,1953,17,35-39,1970,4.795149466352577
SIM,1899,32,45-49,1931,3
STAT,1908,24,20-24,1932,95.9688682797199
STAT,1879,29,45-49,1908,1.0901017489411435
SIM,1850,17,20-24,1867,11
STAT,1886,36,25-29,1922,2.887009554644408
STAT,1910,45,na,1955,3253.4229909112737
STAT,1939,30,35-39,1969,8.818395260418107
STAT,1890,39,45-49,1929,2.279236278985161
SIM,1852,86,na,1938,119
SIM,1820,76,na,1896,499
STAT,1835,47,25-29,1882,0.038642501357930785
STAT,1852,34,na,1886,1754.436522481483
SIM,1812,47,na,1859,1312
STAT,1866,29,25-29,1895,36.594697872638065
STAT,1922,35,35-39,1957,2.604514104150571
STAT,1957,2,na,1959,4900.618056760587
STAT,1833,39,15-19,1872,0.042190425691211876
SIM,1932,19,30-34,1951,15
STAT,1837,22,20-24,1859,58.54811038935336
STAT,1839,30,30-34,1869,14.605666607219455
STAT,1884,28,15-19,1912,0.42195943546190656
STAT,1928,6,na,1934,4770.848225871986
SIM,1863,26,45-49,1889,3
SIM,1869,38,40-44,1907,4
SIM,1927,31,20-24,1958,3
STAT,1827,27,30-34,1854,70.86576091859246
SIM,1897,24,35-39,1921,9
SIM,1792,84,na,1876,90
STAT,1825,104,na,1929,0.03545011625390422
STAT,1845,37,40-44,1882,3.25466959933381
STAT,1802,81,na,1883,211.668945950776
STAT,1877,27,35-39,1904,9.455319321616413
SIM,1950,20,40-44,1970,4
STAT,1867,36,15-19,1903,0.05005323442757519
STAT,1942,16,20-24,1958,133.88452191994904
STAT,1823,48,45-49,1871,0.2865487071770128
STAT,1835,46,20-24,1881,0.008154326062546248
STAT,1843,15,20-24,1858,15.484686991956615
SIM,1833,25,20-24,1858,15
SIM,1910,23,15-19,1933,4
STAT,1873,22,30-34,1895,17.06620622954392
STAT,1876,28,30-34,1904,24.49114164786114
STAT,1894,18,30-34,1912,1.9299665504655563
STAT,1919,38,50-100,1957,0.42567777840866183
STAT,1855,36,50-100,1891,0.8766659919304722
SIM,1865,34,40-44,1899,10
SIM,1884,28,30-34,1912,28
STAT,1863,93,na,1956,27.6701161798415
STAT,1838,21,25-29,1859,50.22322714172327
SIM,1883,19,25-29,1902,10
STAT,1889,24,35-39,1913,6.7630524152943465
SIM,1850,64,na,1914,1283
SIM,1846,21,25-29,1867,41
SIM,1870,19,na,1889,2321
SIM,1904,25,40-44,1929,4
STAT,1827,67,na,1894,915.6721080304907
STAT,1843,29,30-34,1872,20.633136277227273
SIM,1882,37,45-49,1919,4
STAT,1863,32,15-19,1895,0.11805842419189415
SIM,1858,27,25-29,1885,41
SIM,1920,2,na,1922,4351
STAT,1870,51,25-29,1921,0.0032983064125833425
SIM,1794,75,na,1869,358
SIM,1852,76,na,1928,669
STAT,1841,48,50-100,1889,0.1679219513144867
STAT,1887,48,35-39,1935,0.14607698358604865
STAT,1857,34,40-44,1891,3.2034547524136885
STAT,1909,36,30-34,1945,1.6376271792818973
SIM,1838,61,na,1899,1242
SIM,1879,27,45-49,1906,1
SIM,1937,20,25-29,1957,91
STAT,1836,72,na,1908,817.8085212000831
STAT,1885,29,na,1914,2231.1927174077737
STAT,1828,26,35-39,1854,23.286925608887998
SIM,1937,11,na,1948,3546
STAT,1858,33,45-49,1891,1.2861661683959762
STAT,1893,48,na,1941,2661.9988788259157
STAT,1905,66,na,1971,2578.0333121517456
SIM,1839,44,40-44,1883,6
STAT,1851,93,na,1944,21.0230811879186
STAT,1870,31,50-100,1901,0.8526110334841385
STAT,1870,15,30-34,1885,1.5089305600915432
SIM,1851,29,30-34,1880,21
SIM,1871,37,35-39,1908,13
SIM,1896,27,45-49,1923,1
STAT,1894,38,25-29,1932,3.478150171991539
STAT,1855,26,45-49,1881,0.8283600256026984
STAT,1888,30,50-100,1918,1.0311632557564294
SIM,1859,37,35-39,1896,11
STAT,1873,93,na,1966,90.60709711456676
STAT,1817,37,15-19,1854,0.20052780145204185
SIM,1895,21,20-24,1916,88
STAT,1898,35,40-44,1933,5.6494340260307405
STAT,1842,56,na,1898,1477.0668326807825
SIM,1911,8,na,1919,3750
SIM,1874,7,na,1881,2534
SIM,1948,20,35-39,1968,13
STAT,1879,7,na,1886,2639.7069919820005
SIM,1828,30,20-24,1858,2
SIM,1879,22,na,1901,2354
STAT,1877,38,25-29,1915,2.8074308115091484
STAT,1856,22,30-34,1878,15.248150112827638
SIM,1876,28,30-34,1904,29
STAT,1846,38,50-100,1884,0.9411213681011031
STAT,1851,48,20-24,1899,0.008523653007730324
SIM,1837,87,na,1924,86
SIM,1866,33,45-49,1899,2
SIM,1885,38,25-29,1923,4
STAT,1873,19,15-19,1892,5.655486236654051
STAT,1861,38,na,1899,1841.410850569306
SIM,1864,22,30-34,1886,23
STAT,1881,15,40-44,1896,0.1676940477442921
STAT,1830,24,na,1854,1501.7804928323683
STAT,1888,27,45-49,1915,1.2395959397855723
STAT,1831,47,40-44,1878,0.12196581958250965
STAT,1865,20,30-34,1885,15.661549735528862
STAT,1883,38,15-19,1921,0.05175313068305164
SIM,1950,16,20-24,1966,140
STAT,1919,25,35-39,1944,15.428823248853119
STAT,1891,49,50-100,1940,0.15854081239200368
STAT,1902,48,na,1950,2962.41958231644
SIM,1915,15,15-19,1930,8
SIM,1928,37,45-49,1965,2
SIM,1887,51,na,1938,2247
STAT,1929,20,25-29,1949,111.00291967619727
STAT,1936,25,35-39,1961,13.585037364777582
SIM,1836,26,35-39,1862,12
STAT,1863,28,45-49,1891,0.9172204670528822
SIM,1849,33,45-49,1882,2
SIM,1853,35,25-29,1888,2
SIM,1805,77,na,1882,332
SIM,1924,30,40-44,1954,8
STAT,1898,18,15-19,1916,7.566968532828805
SIM,1857,32,40-44,1889,4
SIM,1929,2,na,1931,4853
STAT,1886,16,30-34,1902,1.5944452703470007
STAT,1916,29,na,1945,3633.0162056817126
SIM,1960,5,na,1965,4857
STAT,1835,27,30-34,1862,20.888406826926264
SIM,1887,41,na,1928,2406
STAT,1924,48,na,1972,4120.231351280831
STAT,1925,36,15-19,1961,0.021792789641725884
STAT,1878,43,15-19,1921,0.01349784681080787
STAT,1927,27,35-39,1954,17.242393326079974
SIM,1829,36,45-49,1865,6
SIM,1859,34,na,1893,1903
STAT,1852,25,15-19,1877,0.3886774828911179
STAT,1861,37,25-29,1898,2.2615723655726443
SIM,1889,22,35-39,1911,9
SIM,1900,56,na,1956,2715
STAT,1833,42,na,1875,1562.7919754273878
SIM,1843,27,30-34,1870,35
SIM,1855,41,na,1896,1863
STAT,1826,44,50-100,1870,0.9918174658507911
SIM,1777,95,na,1872,1
SIM,1918,51,na,1969,3640
STAT,1866,28,20-24,1894,10.18588265477627
SIM,1871,28,45-49,1899,2
SIM,1894,16,30-34,1910,4
STAT,1853,19,na,1872,2065.1723300204426
SIM,1869,22,na,1891,2183
STAT,1852,39,25-29,1891,2.0663698545673936
SIM,1886,23,20-24,1909,66
SIM,1830,38,35-39,1868,18
STAT,1887,29,45-49,1916,1.1648545113028335
STAT,1887,21,20-24,1908,73.03859648792425
SIM,1824,41,50-100,1865,1
SIM,1860,39,25-29,1899,2
STAT,1846,27,40-44,1873,2.687854344632013
SIM,1913,19,20-24,1932,24
SIM,1944,25,35-39,1969,19
SIM,1935,27,35-39,1962,17
STAT,1878,23,20-24,1901,67.63612641206855
STAT,1822,38,35-39,1860,11.789954255135836
SIM,1818,95,na,1913,9
SIM,1854,27,40-44,1881,2
STAT,1826,35,15-19,1861,0.06534031303404617
SIM,1852,54,na,1906,1602
STAT,1857,17,15-19,1874,5.1969066189536
STAT,1861,17,30-34,1878,1.4389877826551105
STAT,1898,22,35-39,1920,7.460192136785935
SIM,1874,23,na,1897,2197
STAT,1836,39,40-44,1875,3.4079806674695527
STAT,1907,48,15-19,1955,3.091829973188396E-4
SIM,1887,22,25-29,1909,63
SIM,1876,29,35-39,1905,17
STAT,1847,32,30-34,1879,15.116798934266605
STAT,1836,25,30-34,1861,21.407109206492244
STAT,1893,26,15-19,1919,0.5454135046013581
SIM,1891,18,20-24,1909,21
STAT,1843,49,25-29,1892,0.038093407565710204
STAT,1926,15,25-29,1941,50.42441780671545
STAT,1842,23,40-44,1865,1.8896998759945884
STAT,1849,32,40-44,1881,3.426759544020052
STAT,1874,88,na,1962,247.34768919561793
STAT,1881,16,45-49,1897,0.05976015501075337
SIM,1873,20,30-34,1893,23
SIM,1937,33,na,1970,3420
STAT,1905,19,20-24,1924,24.078386585424266
STAT,1831,106,na,1937,0.007089357918995533
STAT,1862,16,35-39,1878,0.5106076498537165
SIM,1889,8,na,1897,3148
SIM,1825,39,30-34,1864,4
STAT,1826,49,25-29,1875,0.05175854095685979
STAT,1879,22,25-29,1901,56.608650875304164
STAT,1817,39,30-34,1856,15.715682706363493
SIM,1909,37,35-39,1946,5
STAT,1874,56,na,1930,1968.7024832326688
SIM,1855,32,30-34,1887,24
SIM,1943,26,30-34,1969,42
STAT,1873,71,na,1944,1278.8917844033426
SIM,1844,37,25-29,1881,1
STAT,1884,16,20-24,1900,16.587043884744357
SIM,1837,20,20-24,1857,55
STAT,1876,17,25-29,1893,5.53075415861519
STAT,1935,26,30-34,1961,50.47951027804245
STAT,1860,38,20-24,1898,0.5879324493204069
SIM,1801,62,na,1863,879
SIM,1898,14,na,1912,3245
STAT,1837,38,45-49,1875,1.5589352216546535
STAT,1929,28,20-24,1957,21.570683394708418
STAT,1807,49,15-19,1856,0.001487112235844394
SIM,1839,31,35-39,1870,10
STAT,1927,20,15-19,1947,6.232579477983714
SIM,1850,23,40-44,1873,6
SIM,1805,55,na,1860,1089
STAT,1834,31,50-100,1865,0.7359625369570973
SIM,1903,33,25-29,1936,7
STAT,1876,21,45-49,1897,0.6826439596706216
STAT,1899,34,45-49,1933,2.2378828149278984
STAT,1859,36,30-34,1895,4.026546174853999
SIM,1865,17,15-19,1882,4
STAT,1863,37,35-39,1900,5.863574204986283
STAT,1827,47,25-29,1874,0.05268588947775118
SIM,1844,25,30-34,1869,18
SIM,1838,26,45-49,1864,1
SIM,1844,39,40-44,1883,3
SIM,1838,32,30-34,1870,24
STAT,1846,28,45-49,1874,0.9890977651256887
STAT,1901,39,30-34,1940,1.5058364145141248
STAT,1799,97,na,1896,1.7150994407995355
STAT,1901,53,na,1954,2801.5852723128473
STAT,1920,39,40-44,1959,1.5450711890977604
STAT,1946,20,25-29,1966,97.172699974635
SIM,1953,15,35-39,1968,5
STAT,1861,36,20-24,1897,0.6084061558386726
STAT,1897,17,45-49,1914,0.0825273018193801
SIM,1907,30,40-44,1937,3
STAT,1916,26,20-24,1942,17.891279138625105
SIM,1899,39,30-34,1938,2
SIM,1939,30,35-39,1969,8
STAT,1827,102,na,1929,0.16934717416036948
STAT,1883,18,20-24,1901,16.377381321008805
STAT,1837,37,40-44,1874,3.4590015266303356
STAT,1897,23,30-34,1920,22.434188162195465
SIM,1860,27,30-34,1887,24
SIM,1887,73,na,1960,1375
STAT,1852,27,30-34,1879,21.264133792653077
STAT,1866,37,na,1903,2052.8131344282892
STAT,1870,53,na,1923,1963.4330074864392
SIM,1854,20,20-24,1874,64
SIM,1913,23,40-44,1936,2
STAT,1905,23,40-44,1928,2.8366369108362446
STAT,1945,15,35-39,1960,4.332551312143068
SIM,1854,28,45-49,1882,1
STAT,1842,37,15-19,1879,0.04770444943852743
SIM,1899,25,20-24,1924,17
STAT,1853,48,30-34,1901,0.07233737770802218
STAT,1900,27,20-24,1927,15.374119349725625
SIM,1924,26,20-24,1950,22
STAT,1812,43,50-100,1855,3.8933573017471397
STAT,1887,33,15-19,1920,0.14984492763121202
SIM,1877,27,35-39,1904,11
SIM,1919,32,25-29,1951,8
STAT,1866,32,40-44,1898,3.7786735404619156
STAT,1822,36,35-39,1858,13.124746101042852
STAT,1849,44,50-100,1893,0.7815062612078605
SIM,1870,1,na,1871,3071
SIM,1909,26,na,1935,3405
STAT,1867,47,20-24,1914,0.010595309820448096
SIM,1887,27,45-49,1914,1
SIM,1862,22,20-24,1884,55
STAT,1838,38,50-100,1876,0.984328648787733
STAT,1889,21,30-34,1910,20.83637933229206
SIM,1880,19,na,1899,2558
STAT,1851,18,25-29,1869,4.9268692239607255
SIM,1910,6,na,1916,3734
STAT,1846,25,50-100,1871,0.5823140796612308
STAT,1921,23,25-29,1944,98.25494892213675
STAT,1824,104,na,1928,0.03677752640791967
STAT,1825,37,15-19,1862,0.07048690498625101
SIM,1869,36,40-44,1905,12
SIM,1847,75,na,1922,724
SIM,1842,15,20-24,1857,18
SIM,1935,20,15-19,1955,5
STAT,1796,79,na,1875,279.55223551981857
STAT,1941,17,50-100,1958,0.3645587550029081
SIM,1860,42,na,1902,1926
STAT,1871,25,25-29,1896,39.951005454677485
STAT,1896,38,35-39,1934,8.781010224003841
SIM,1897,21,30-34,1918,23
STAT,1883,24,40-44,1907,1.9179691429753496
SIM,1876,15,25-29,1891,7
STAT,1862,18,35-39,1880,0.5046104057900894
STAT,1833,36,45-49,1869,1.5451590601137488
SIM,1924,17,30-34,1941,16
STAT,1916,17,30-34,1933,2.4430113728415637
SIM,1770,84,na,1854,78
STAT,1839,33,35-39,1872,8.211812618357614
SIM,1913,26,45-49,1939,2
SIM,1892,16,20-24,1908,24
STAT,1919,1,na,1920,4359.684040140129
SIM,1852,28,35-39,1880,13
SIM,1919,23,35-39,1942,13
STAT,1878,47,30-34,1925,0.09485729323834752
STAT,1956,0,na,1956,4950.6799232425155
SIM,1881,25,35-39,1906,10
STAT,1855,28,45-49,1883,0.8165074795824279
STAT,1909,59,na,1968,2998.9920319632693
STAT,1886,17,35-39,1903,0.5475625551764994
SIM,1941,29,25-29,1970,75
STAT,1892,28,15-19,1920,0.534953982576094
STAT,1901,31,na,1932,3168.414391380781
SIM,1809,100,na,1909,2
SIM,1849,34,na,1883,1860
SIM,1858,24,20-24,1882,63
STAT,1844,36,20-24,1880,0.6281835018182634
STAT,1900,67,na,1967,2350.618213991182
STAT,1818,75,na,1893,505.5675026390171
STAT,1905,26,45-49,1931,1.5213155886879626
STAT,1846,23,25-29,1869,52.012743762904904
STAT,1930,33,na,1963,4607.988682032184
SIM,1934,21,45-49,1955,2
STAT,1894,16,30-34,1910,1.9397888283206526
STAT,1829,47,35-39,1876,0.11443011533536465
STAT,1898,47,na,1945,2863.3636547057818
STAT,1850,39,15-19,1889,0.03938503000791514
SIM,1841,27,20-24,1868,10
SIM,1843,72,na,1915,869
SIM,1917,27,40-44,1944,5
STAT,1847,29,15-19,1876,0.3963744650443413
SIM,1908,31,45-49,1939,1
SIM,1951,15,25-29,1966,64
SIM,1913,30,na,1943,3447
SIM,1920,16,35-39,1936,9
STAT,1833,27,20-24,1860,9.487444988097678
STAT,1885,38,25-29,1923,2.697730069695557
STAT,1875,38,15-19,1913,0.05425644996805884
SIM,1809,58,na,1867,1051
STAT,1876,26,15-19,1902,0.4443354835055678
SIM,1893,38,25-29,1931,4
STAT,1780,100,na,1880,0.17709677689174924
STAT,1868,15,25-29,1883,5.261942622901542
STAT,1915,6,na,1921,3950.0166704568423
STAT,1942,23,45-49,1965,1.1141308321740315
STAT,1905,34,na,1939,3258.0767289113237
STAT,1824,49,15-19,1873,4.7397389352816144E-4
STAT,1920,15,30-34,1935,2.603908168181252
STAT,1808,47,15-19,1855,0.001517542634546275
STAT,1926,29,na,1955,4211.958528000131
SIM,1779,76,na,1855,322
STAT,1854,22,20-24,1876,57.93264942470092
SIM,1876,26,30-34,1902,27
SIM,1923,21,35-39,1944,13
STAT,1865,52,na,1917,1833.8697941758483
STAT,1818,47,25-29,1865,0.12281125538951528
SIM,1909,28,45-49,1937,5
STAT,1911,28,35-39,1939,13.783507799974588
STAT,1912,16,35-39,1928,0.8035781837889497
STAT,1879,26,40-44,1905,2.972398448169601
STAT,1878,48,35-39,1926,0.13610100921668708
SIM,1904,21,25-29,1925,83
STAT,1895,23,20-24,1918,84.6102816972916
STAT,1896,29,45-49,1925,1.3754079769702579
SIM,1871,27,40-44,1898,5
SIM,1921,25,40-44,1946,3
STAT,1909,27,40-44,1936,4.208334467330779
STAT,1933,29,25-29,1962,82.480475481317
STAT,1923,27,50-100,1950,1.0795566030063464
SIM,1911,39,40-44,1950,2
SIM,1946,25,45-49,1971,1
SIM,1883,37,na,1920,2173
SIM,1837,38,45-49,1875,1
STAT,1926,21,45-49,1947,1.2952130245245024
STAT,1845,49,35-39,1894,0.09699957271776559
STAT,1835,49,25-29,1884,0.0376649254027662
SIM,1954,4,na,1958,4488
STAT,1840,26,35-39,1866,7.95240630061654
STAT,1863,39,35-39,1902,5.804559938730901
STAT,1924,15,15-19,1939,51.291025228633565
SIM,1895,26,40-44,1921,3
STAT,1838,25,40-44,1863,2.5953777768323993
STAT,1914,29,15-19,1943,0.6675237902841513
STAT,1885,37,20-24,1922,0.7258648985494446
SIM,1931,27,50-100,1958,1
SIM,1946,25,na,1971,3823
STAT,1916,33,45-49,1949,1.5282751696556636
SIM,1862,27,40-44,1889,3
SIM,1852,27,30-34,1879,23
STAT,1943,19,40-44,1962,1.4002616715229341
STAT,1894,66,na,1960,2109.5499878838023
STAT,1863,27,40-44,1890,2.4833742737454356
SIM,1856,20,30-34,1876,17
STAT,1943,15,25-29,1958,43.43520427144705
STAT,1901,39,50-100,1940,0.34689047355205715
STAT,1886,15,na,1901,2532.0384132596755
STAT,1822,35,30-34,1857,10.389754178701217
SIM,1794,65,na,1859,685
STAT,1887,26,40-44,1913,3.176228040275204
SIM,1836,32,20-24,1868,1
STAT,1860,75,na,1935,789.0926423646688
SIM,1824,80,na,1904,289
SIM,1859,39,35-39,1898,12
STAT,1855,48,40-44,1903,0.12013063404593628
SIM,1871,39,35-39,1910,11
STAT,1828,32,20-24,1860,2.804603807507646
STAT,1854,27,40-44,1881,2.2468573239382397
STAT,1844,27,30-34,1871,21.410009681715973
SIM,1819,68,na,1887,794
SIM,1908,22,20-24,1930,95
SIM,1927,22,30-34,1949,40
SIM,1881,26,50-100,1907,1
STAT,1915,44,na,1959,3520.6075251955376
STAT,1931,3,na,1934,5015.285130060348
SIM,1913,52,na,1965,3201
STAT,1818,46,20-24,1864,0.025974751245825795
SIM,1869,25,35-39,1894,9
STAT,1889,11,na,1900,3016.3582001272284
STAT,1938,25,45-49,1963,1.6183287766580723
STAT,1866,38,15-19,1904,0.04868598064503832
SIM,1830,36,35-39,1866,16
SIM,1833,28,25-29,1861,29
SIM,1895,70,na,1965,1978
SIM,1830,35,30-34,1865,7
SIM,1852,37,25-29,1889,1
SIM,1855,49,50-100,1904,3
SIM,1847,33,35-39,1880,4
STAT,1895,17,35-39,1912,0.6757894668705239
SIM,1905,30,30-34,1935,18
SIM,1917,36,30-34,1953,2
SIM,1933,29,na,1962,4733
STAT,1938,20,25-29,1958,86.42320605777047
SIM,1884,17,25-29,1901,8
STAT,1776,80,na,1856,225.85770067770002
STAT,1844,28,35-39,1872,8.144754083781061
SIM,1842,76,na,1918,583
STAT,1898,69,na,1967,2159.701226421671
STAT,1948,20,35-39,1968,10.220754806319562
SIM,1891,24,40-44,1915,3
SIM,1828,35,40-44,1863,4
SIM,1928,34,40-44,1962,5
STAT,1902,23,15-19,1925,4.3847716040420845
STAT,1866,26,20-24,1892,10.256942357562883
STAT,1915,38,20-24,1953,0.25032862730925143
SIM,1891,20,25-29,1911,66
STAT,1883,20,25-29,1903,53.33800809225055
STAT,1931,16,45-49,1947,0.6191944920912061
SIM,1851,15,20-24,1866,13
STAT,1834,48,20-24,1882,0.007797370275863441
STAT,1919,22,30-34,1941,29.73152578793768
STAT,1874,37,45-49,1911,1.9241600197353126
SIM,1824,33,40-44,1857,5
SIM,1861,15,30-34,1876,4
STAT,1889,39,20-24,1928,0.889958165688465
STAT,1901,15,20-24,1916,23.552099253883508
STAT,1943,24,15-19,1967,5.3466260439121
STAT,1851,6,na,1857,2181.8911022294988
STAT,1931,22,30-34,1953,35.21454266081525
STAT,1829,38,45-49,1867,1.775052836414591
SIM,1932,15,15-19,1947,46
SIM,1846,25,40-44,1871,2
STAT,1869,37,50-100,1906,1.1236172241451767
SIM,1946,20,25-29,1966,105
STAT,1890,41,na,1931,2681.481334310298
STAT,1859,47,20-24,1906,0.008980622371966975
STAT,1895,40,na,1935,2875.2422961449993
STAT,1896,26,50-100,1922,0.8008738682635103
SIM,1858,40,35-39,1898,4
SIM,1927,20,15-19,1947,5
STAT,1838,26,45-49,1864,0.9550675109492421
STAT,1865,74,na,1939,950.2744224689566
SIM,1836,37,40-44,1873,4
STAT,1861,52,50-100,1913,0.011799862639647643
SIM,1849,30,40-44,1879,6
SIM,1831,39,na,1870,1567
STAT,1859,38,30-34,1897,3.9873830139438113
SIM,1814,69,na,1883,708
STAT,1843,20,na,1863,1839.0699477616888
STAT,1921,27,40-44,1948,4.907434753617318
STAT,1935,17,40-44,1952,1.806366812817188
SIM,1840,24,35-39,1864,8
SIM,1882,74,na,1956,1030
STAT,1870,18,35-39,1888,0.510342848930408
SIM,1899,28,25-29,1927,61
STAT,1895,28,40-44,1923,3.6763461520803244
SIM,1877,37,50-100,1914,1
STAT,1827,35,na,1862,1656.4676259661649
SIM,1905,17,20-24,1922,24
STAT,1849,89,na,1938,78.77627456063406
STAT,1941,28,20-24,1969,17.830188267269058
SIM,1840,18,15-19,1858,7
SIM,1938,23,45-49,1961,6
STAT,1841,61,na,1902,1288.2596450710073
SIM,1896,55,na,1951,2575
STAT,1905,32,30-34,1937,13.689586974042552
STAT,1878,70,na,1948,1381.3554580864707
STAT,1834,37,15-19,1871,0.04334803167187651
SIM,1951,19,40-44,1970,2
STAT,1923,20,30-34,1943,31.78027924671691
STAT,1855,34,30-34,1889,12.373578327655116
SIM,1895,24,25-29,1919,72
STAT,1881,27,35-39,1908,8.805674818696948
SIM,1943,17,40-44,1960,1
SIM,1935,24,30-34,1959,42
STAT,1887,24,25-29,1911,60.11185770583355
STAT,1786,79,na,1865,250.74234984519396
STAT,1785,94,na,1879,4.260295937876202
SIM,1924,33,45-49,1957,1
STAT,1906,27,15-19,1933,0.6242510519483517
SIM,1938,7,na,1945,3555
STAT,1892,19,25-29,1911,6.669199820444301
STAT,1919,20,15-19,1939,5.53944984660877
STAT,1826,46,20-24,1872,0.011230752700347364
SIM,1846,26,45-49,1872,2
STAT,1869,36,25-29,1905,2.6476933313805526
STAT,1939,26,15-19,1965,0.6707519184624854
STAT,1913,25,40-44,1938,4.417374530187305
SIM,1863,49,na,1912,1825
STAT,1828,37,40-44,1865,3.996449429411961
STAT,1939,32,35-39,1971,8.808433286841922
STAT,1927,24,30-34,1951,33.24230144113144
STAT,1869,27,35-39,1896,8.830597511462008
STAT,1875,52,na,1927,2079.627246275214
STAT,1860,29,30-34,1889,19.22984312325936
SIM,1893,37,na,1930,2937
STAT,1826,94,na,1920,10.914055159289937
SIM,1883,15,na,1898,2363
STAT,1869,99,na,1968,9.857536449860216
STAT,1847,23,na,1870,1918.9669801364023
STAT,1945,10,na,1955,4054.7870941040237
STAT,1879,31,15-19,1910,0.14139862386332502
SIM,1866,89,na,1955,74
STAT,1811,95,na,1906,5.7661777948328234
STAT,1926,39,35-39,1965,2.786520598875617
SIM,1833,27,20-24,1860,6
STAT,1837,46,30-34,1883,0.06605570816710318
SIM,1828,33,25-29,1861,18
STAT,1772,110,na,1882,0.0017154991537046817
STAT,1915,21,35-39,1936,9.22277363414261
SIM,1895,9,na,1904,3297
STAT,1848,38,20-24,1886,0.5841692187676845
SIM,1931,20,30-34,1951,43
SIM,1859,47,50-100,1906,2
STAT,1832,24,35-39,1856,5.048939047227904
SIM,1879,20,25-29,1899,58
STAT,1842,39,15-19,1881,0.04251880927080673
STAT,1910,25,15-19,1935,0.6538940362196175
STAT,1825,76,na,1901,503.53147004328764
STAT,1877,24,50-100,1901,0.3971063366507608
STAT,1908,31,45-49,1939,1.4089523646552005
STAT,1918,46,25-29,1964,0.05345978157231251
STAT,1877,29,35-39,1906,9.38774038438905
STAT,1881,18,45-49,1899,0.05945755462528385
STAT,1877,35,20-24,1912,0.7625554850143812
SIM,1923,30,na,1953,4181
STAT,1907,15,na,1922,3521.137582742963
STAT,1813,76,na,1889,391.1053594424046
STAT,1946,22,25-29,1968,97.10566235576921
SIM,1799,64,na,1863,814
STAT,1843,42,na,1885,1607.3487732559079
STAT,1869,38,40-44,1907,3.986373417582311
STAT,1860,27,15-19,1887,0.3514936039445875
SIM,1854,23,25-29,1877,42
SIM,1877,36,25-29,1913,4
STAT,1851,17,20-24,1868,15.505184978828545
SIM,1896,33,na,1929,2967
STAT,1893,37,20-24,1930,0.9234982858014913
SIM,1887,26,40-44,1913,4
STAT,1934,21,45-49,1955,1.42893913234021
SIM,1873,23,35-39,1896,9
SIM,1896,36,35-39,1932,15
STAT,1871,39,35-39,1910,6.56813427313187
SIM,1843,16,25-29,1859,4
STAT,1903,33,50-100,1936,0.7041853027541524
SIM,1848,39,25-29,1887,4
STAT,1846,25,40-44,1871,2.726871644671724
STAT,1788,104,na,1892,0.01799452059559945
STAT,1935,22,15-19,1957,6.847906565930717
SIM,1915,31,50-100,1946,1
STAT,1927,18,45-49,1945,0.5852194453511762
STAT,1830,106,na,1936,0.007328066104648756
SIM,1833,101,na,1934,1
STAT,1875,49,20-24,1924,0.01140888795651248
STAT,1889,48,45-49,1937,0.15330531040512335
SIM,1811,62,na,1873,872
STAT,1816,49,15-19,1865,9.150863133760973E-4
STAT,1830,38,35-39,1868,5.669052410030481
SIM,1864,23,na,1887,2067
STAT,1828,102,na,1930,0.16511036059761425
STAT,1859,48,25-29,1907,0.04276471591074586
STAT,1892,18,20-24,1910,20.922329835095983
STAT,1948,21,50-100,1969,0.7139815884297492
SIM,1841,36,45-49,1877,4
SIM,1878,48,na,1926,2251
STAT,1858,26,20-24,1884,8.959494455061552
STAT,1852,36,20-24,1888,0.5677521050539536
STAT,1911,20,50-100,1931,0.5930667365855042
SIM,1863,34,30-34,1897,9
STAT,1843,42,50-100,1885,0.7347081310610145
SIM,1883,22,40-44,1905,1
STAT,1907,31,50-100,1938,0.733078576971349
STAT,1926,33,50-100,1959,0.9438344447954546
STAT,1917,34,15-19,1951,0.12603536122063738
STAT,1821,54,50-100,1875,0.022010040817360882
SIM,1913,32,30-34,1945,18
SIM,1902,25,30-34,1927,32
STAT,1884,26,15-19,1910,0.4249031481560508
SIM,1834,57,na,1891,1215
STAT,1876,37,na,1913,2299.4450229959775
SIM,1822,36,35-39,1858,8
STAT,1860,53,na,1913,1623.9245432460432
STAT,1879,27,45-49,1906,1.0979489959512596
SIM,1854,25,40-44,1879,2
SIM,1877,38,40-44,1915,3
SIM,1844,34,20-24,1878,2
SIM,1835,25,30-34,1860,23
STAT,1837,47,35-39,1884,0.0943189531450058
SIM,1843,94,na,1937,14
SIM,1903,37,40-44,1940,3
STAT,1936,34,25-29,1970,8.469808682451653
SIM,1780,84,na,1864,87
STAT,1843,19,50-100,1862,0.04179184395509903
SIM,1814,80,na,1894,241
STAT,1904,20,20-24,1924,93.93747600995448
STAT,1929,25,na,1954,4445.753837694548
SIM,1915,39,25-29,1954,1
STAT,1836,28,35-39,1864,8.027127691479132
STAT,1951,17,25-29,1968,48.75006148099724
STAT,1844,54,50-100,1898,0.010200770699448709
STAT,1894,49,30-34,1943,0.06490695359324018
STAT,1870,17,30-34,1887,1.4912077060635496
SIM,1924,15,na,1939,4188
SIM,1925,29,40-44,1954,5
SIM,1808,95,na,1903,5
SIM,1911,33,50-100,1944,4
STAT,1917,29,40-44,1946,4.58482328099815
STAT,1946,24,40-44,1970,3.532359202993724
STAT,1859,39,35-39,1898,5.264538677122955
SIM,1866,26,20-24,1892,10
STAT,1845,86,na,1931,157.00598659331112
SIM,1942,21,45-49,1963,1
SIM,1893,15,na,1908,3160
STAT,1856,60,na,1916,1405.7397952701963
SIM,1844,28,35-39,1872,9
STAT,1907,39,25-29,1946,0.8537228548215801
STAT,1865,23,35-39,1888,5.021151048031955
SIM,1876,24,15-19,1900,2
SIM,1912,20,20-24,1932,113
STAT,1884,88,na,1972,366.98622650998925
STAT,1906,30,na,1936,3337.87976282037
STAT,1888,36,35-39,1924,7.934557083422078
STAT,1828,34,35-39,1862,9.783248243110144
SIM,1892,19,25-29,1911,7
STAT,1826,30,na,1856,1618.6194419157725
SIM,1819,49,50-100,1868,3
SIM,1873,17,na,1890,2427
SIM,1853,33,25-29,1886,12
SIM,1894,27,35-39,1921,15
STAT,1917,31,45-49,1948,1.5630276761016766
SIM,1859,29,35-39,1888,8
SIM,1850,32,45-49,1882,2
SIM,1871,29,35-39,1900,10
STAT,1919,27,na,1946,3823.8242148546365
SIM,1939,8,na,1947,3724
STAT,1908,63,na,1971,2819.9472516640194
SIM,1854,34,na,1888,1908
STAT,1864,50,25-29,1914,0.003025131449076067
STAT,1915,26,50-100,1941,0.9623974011900004
SIM,1876,36,30-34,1912,6
SIM,1887,24,40-44,1911,4
STAT,1908,20,40-44,1928,2.9376573290422625
SIM,1853,31,30-34,1884,14
STAT,1827,42,20-24,1869,0.1523471705187317
STAT,1854,39,35-39,1893,5.009637002199441
STAT,1868,36,30-34,1904,4.826893729696394
STAT,1892,38,15-19,1930,0.06611533608005014
SIM,1832,41,40-44,1873,4
SIM,1893,35,20-24,1928,1
STAT,1834,45,15-19,1879,2.9680899432560094E-4
STAT,1854,31,25-29,1885,7.583088059359727
STAT,1807,105,na,1912,0.010905770762246265
STAT,1836,48,30-34,1884,0.06476610672484813
STAT,1894,33,20-24,1927,3.2677984701402316
SIM,1916,4,na,1920,3940
STAT,1845,33,25-29,1878,8.528836226126888
SIM,1936,31,20-24,1967,2
SIM,1827,36,35-39,1863,16
SIM,1852,3,na,1855,2471
STAT,1893,60,na,1953,2284.8539937549285
SIM,1846,15,na,1861,2088
SIM,1823,43,40-44,1866,7
STAT,1871,41,50-100,1912,0.9955124196729717
SIM,1890,72,na,1962,1811
SIM,1821,35,30-34,1856,4
STAT,1897,36,50-100,1933,1.5585741459672793
STAT,1823,97,na,1920,2.8751227886719266
SIM,1882,53,na,1935,1990
STAT,1900,44,25-29,1944,0.05765011912472885
STAT,1886,27,35-39,1913,9.628765947571772
SIM,1815,44,45-49,1859,3
STAT,1882,34,40-44,1916,3.9500968762965165
STAT,1875,28,15-19,1903,0.4390010807131279
STAT,1895,25,35-39,1920,11.964230013937442
STAT,1816,42,45-49,1858,4.037217314838379
STAT,1861,27,30-34,1888,19.92376485281391
SIM,1844,33,30-34,1877,16
SIM,1882,35,45-49,1917,2
STAT,1884,19,25-29,1903,5.260511899856795
STAT,1845,31,30-34,1876,14.843481566429656
STAT,1874,35,45-49,1909,1.9424340005998455
SIM,1928,32,25-29,1960,14
STAT,1832,36,50-100,1868,0.9485575572333753
SIM,1885,29,35-39,1914,11
SIM,1916,20,40-44,1936,3
SIM,1945,0,na,1945,4093
STAT,1885,40,15-19,1925,0.013135151676135479
SIM,1818,43,30-34,1861,1
STAT,1813,53,30-34,1866,0.015253981882493953
STAT,1824,41,40-44,1865,3.0340955611972045
STAT,1848,47,50-100,1895,0.18164424934443113
STAT,1887,52,na,1939,2263.168359145544
SIM,1880,27,35-39,1907,14
STAT,1859,45,20-24,1904,0.009112638914254338
STAT,1871,46,30-34,1917,0.0910632120928968
SIM,1890,34,40-44,1924,8
STAT,1940,12,na,1952,3784.971090453879
STAT,1880,44,30-34,1924,1.129539394188413
STAT,1854,49,35-39,1903,0.09807647399863931
STAT,1815,43,40-44,1858,5.458920095733662
STAT,1926,32,50-100,1958,0.9444199851862701
STAT,1891,32,40-44,1923,5.0686728736063165
SIM,1848,93,na,1941,17
STAT,1913,10,na,1923,3826.260548619102
STAT,1819,41,30-34,1860,2.5116685395425766
STAT,1876,42,15-19,1918,0.013461865773093034
STAT,1883,33,45-49,1916,1.6083354862989998
SIM,1841,16,15-19,1857,6
STAT,1843,43,15-19,1886,0.009481769275253325
SIM,1819,37,na,1856,1526
STAT,1927,22,15-19,1949,6.195612922872683
SIM,1818,38,35-39,1856,11
SIM,1835,35,30-34,1870,8
SIM,1855,51,na,1906,1730
SIM,1867,28,30-34,1895,33
STAT,1863,47,35-39,1910,0.11552133211679479
SIM,1823,42,na,1865,1412
STAT,1854,89,na,1943,75.16422149490155
STAT,1928,31,20-24,1959,2.8828320233425613
STAT,1828,49,35-39,1877,0.11040499258745254
STAT,1811,46,50-100,1857,0.8316626142839321
STAT,1833,34,45-49,1867,1.3492267955337909
STAT,1890,40,25-29,1930,0.7491531351128032
SIM,1778,81,na,1859,165
SIM,1833,102,na,1935,1
SIM,1852,23,na,1875,1936
SIM,1827,56,na,1883,1164
SIM,1935,22,15-19,1957,5
STAT,1842,88,na,1930,99.4183448263487
STAT,1856,101,na,1957,0.5959277317371071
STAT,1906,48,50-100,1954,0.18822103715521504
STAT,1831,26,35-39,1857,8.569672409313359
STAT,1856,44,40-44,1900,1.6355128652854691
STAT,1929,30,25-29,1959,11.103036152582773
STAT,1895,71,na,1966,1924.225427138089
STAT,1857,3,na,1860,2474.147675379428
SIM,1909,57,na,1966,3116
STAT,1896,25,50-100,1921,0.803549688726971
SIM,1864,44,40-44,1908,6
STAT,1859,28,30-34,1887,19.12255890138497
STAT,1836,40,na,1876,1661.6551527872575
SIM,1824,42,45-49,1866,3
STAT,1880,39,35-39,1919,6.973272636539474
STAT,1886,32,30-34,1918,17.42323340262275
STAT,1879,33,50-100,1912,0.902227133691604
SIM,1888,78,na,1966,1190
SIM,1900,38,40-44,1938,2
STAT,1825,47,15-19,1872,4.08035244268413E-4
STAT,1862,30,20-24,1892,2.2008604083127112
STAT,1815,44,50-100,1859,2.4660556296049916
SIM,1925,31,45-49,1956,1
STAT,1889,28,15-19,1917,0.5272702462101068
SIM,1852,34,20-24,1886,4
SIM,1853,26,35-39,1879,9
SIM,1919,21,20-24,1940,116
STAT,1856,29,15-19,1885,0.3415712412084165
SIM,1836,34,35-39,1870,11
STAT,1830,45,30-34,1875,0.07443426775473147
STAT,1870,102,na,1972,2.898664991292752
STAT,1854,38,50-100,1892,0.8740745392525308
STAT,1859,13,na,1872,2074.091264040939
STAT,1835,37,30-34,1872,4.193618703357719
SIM,1872,43,35-39,1915,4
STAT,1877,36,25-29,1913,2.835004752670772
SIM,1831,61,na,1892,1118
STAT,1813,48,35-39,1861,0.3765319675319768
STAT,1850,31,40-44,1881,3.2313636896239735
STAT,1788,105,na,1893,0.007910211308619564
STAT,1835,19,30-34,1854,2.6609538323342035
STAT,1877,19,35-39,1896,0.534815532396375
STAT,1906,1,na,1907,3745.0264551738605
STAT,1952,13,na,1965,4446.211457450639
STAT,1853,15,30-34,1868,1.4682665065393243
SIM,1869,87,na,1956,174
SIM,1894,54,na,1948,2636
STAT,1895,32,25-29,1927,12.614778165028206
STAT,1875,46,15-19,1921,3.895082975725594E-4
STAT,1825,29,15-19,1854,1.5008522761556
STAT,1857,22,na,1879,1839.0680125221877
STAT,1919,16,30-34,1935,2.559212040165804
SIM,1914,48,na,1962,3442
SIM,1919,16,25-29,1935,60
SIM,1844,24,na,1868,1778
SIM,1870,23,30-34,1893,14
STAT,1881,40,30-34,1921,1.0597814560381476
STAT,1831,44,35-39,1875,1.3016621489239013
STAT,1843,25,15-19,1868,0.3826184406433721
STAT,1851,30,45-49,1881,1.3330097823543283
SIM,1885,36,25-29,1921,3
STAT,1833,29,20-24,1862,9.351367983847956
SIM,1868,27,35-39,1895,14
STAT,1852,51,45-49,1903,0.01057164118514197
STAT,1864,43,35-39,1907,1.5136403454481266
SIM,1843,19,30-34,1862,1
STAT,1828,41,25-29,1869,0.5536150224108374
SIM,1799,63,na,1862,841
STAT,1897,48,45-49,1945,0.16607281490254672
SIM,1858,16,na,1874,2207
STAT,1839,19,15-19,1858,5.108052472232365
STAT,1881,42,25-29,1923,0.5853151760618523
STAT,1836,18,35-39,1854,0.8383750576600731
SIM,1833,40,45-49,1873,3
SIM,1826,37,30-34,1863,2
SIM,1927,16,30-34,1943,17
STAT,1844,34,20-24,1878,2.1988412277836527
STAT,1844,59,na,1903,1349.7818846015462
STAT,1848,50,40-44,1898,0.007935069277128922
STAT,1852,78,na,1930,566.4554746304116
STAT,1869,47,30-34,1916,0.08817732610420585
SIM,1859,44,30-34,1903,1
SIM,1872,43,na,1915,2160
STAT,1862,23,30-34,1885,14.622382207403279
STAT,1885,28,30-34,1913,23.628906426878764
STAT,1855,23,40-44,1878,1.717532636516195
STAT,1887,47,50-100,1934,0.2583117600879352
SIM,1816,40,45-49,1856,2
STAT,1889,46,45-49,1935,0.27601759432837725
SIM,1857,43,50-100,1900,1
STAT,1850,5,na,1855,2166.0464
STAT,1853,27,50-100,1880,0.5608276044409076
SIM,1880,62,na,1942,1804
STAT,1831,51,25-29,1882,0.0022640985821287558
STAT,1844,35,30-34,1879,4.388536104455706
STAT,1913,20,20-24,1933,102.40039454940131
STAT,1881,43,35-39,1924,1.640622699166823
STAT,1892,31,45-49,1923,2.071810423433549
SIM,1873,42,40-44,1915,3
STAT,1848,27,15-19,1875,0.402466299838301
SIM,1949,22,45-49,1971,1
STAT,1867,32,na,1899,2116.8441660447784
SIM,1903,32,na,1935,3254
STAT,1843,18,25-29,1861,4.862564766235351
SIM,1843,37,30-34,1880,4
SIM,1907,46,na,1953,3145
STAT,1919,24,50-100,1943,0.6764057800697518
SIM,1861,91,na,1952,46
STAT,1853,40,na,1893,1766.7867304638785
SIM,1851,18,25-29,1869,8
STAT,1814,52,35-39,1866,0.025151925826827758
STAT,1860,17,15-19,1877,5.246328866663632
STAT,1933,39,40-44,1972,1.922129381854768
STAT,1826,50,50-100,1876,0.01399505626638065
SIM,1863,23,40-44,1886,4
SIM,1847,19,15-19,1866,4
STAT,1868,18,na,1886,2304.000967686328
STAT,1825,40,45-49,1865,1.7060607108722028
STAT,1872,45,35-39,1917,0.13398338757573086
STAT,1846,54,25-29,1900,0.0025548802541455083
STAT,1818,37,30-34,1855,16.928299659762335
SIM,1839,57,na,1896,1373
SIM,1877,32,30-34,1909,29
STAT,1844,53,50-100,1897,0.010320801622316252
STAT,1872,23,na,1895,2234.141376006068
SIM,1835,43,na,1878,1531
STAT,1801,108,na,1909,6.47522281410253E-4
STAT,1814,51,25-29,1865,0.010557830495312701
SIM,1865,43,45-49,1908,6
SIM,1937,30,25-29,1967,9
STAT,1885,18,30-34,1903,1.4969246695050986
STAT,1943,2,na,1945,4061.8288253701335
SIM,1877,34,25-29,1911,11
SIM,1894,32,30-34,1926,24
STAT,1857,43,45-49,1900,1.1070330675629876
STAT,1858,42,50-100,1900,0.7815309621876583
STAT,1928,16,25-29,1944,51.7090580497126
SIM,1831,42,35-39,1873,2
STAT,1845,21,na,1866,1891.8766355395874
SIM,1921,20,20-24,1941,104
STAT,1870,25,30-34,1895,23.49593978448247
STAT,1905,21,25-29,1926,78.40455950330622
SIM,1827,41,30-34,1868,2
SIM,1846,23,40-44,1869,1
SIM,1857,86,na,1943,138
STAT,1868,19,40-44,1887,0.16587175662540143
SIM,1882,17,15-19,1899,5
SIM,1893,28,30-34,1921,40
STAT,1878,22,50-100,1900,0.40147805805924164
STAT,1899,37,15-19,1936,0.015688767398711327
STAT,1827,35,30-34,1862,5.804155986352298
STAT,1838,23,40-44,1861,1.802027132353042
SIM,1895,16,na,1911,3228
STAT,1873,40,na,1913,2236.776682026672
STAT,1874,17,15-19,1891,5.728167287150767
STAT,1894,26,30-34,1920,30.676987192795735
SIM,1816,60,na,1876,1051
SIM,1911,51,na,1962,3211
STAT,1830,48,35-39,1878,0.10355707578687459
STAT,1841,36,45-49,1877,1.6361363469360635
STAT,1885,19,50-100,1904,0.04588548636764672
STAT,1860,35,15-19,1895,0.04345179964663172
STAT,1829,33,40-44,1862,4.210168144694108
STAT,1834,27,15-19,1861,0.36921236847268746
STAT,1855,52,25-29,1907,0.0025036493095806135
STAT,1869,38,50-100,1907,1.1180440827134164
STAT,1889,17,50-100,1906,0.05713701680980247
STAT,1947,23,50-100,1970,0.7023187914543033
STAT,1871,24,35-39,1895,5.43983337697391
SIM,1868,37,35-39,1905,15
SIM,1868,42,30-34,1910,3
STAT,1866,41,45-49,1907,1.309955031821038
STAT,1835,86,na,1921,141.21886171281116
STAT,1851,27,15-19,1878,0.3821312613422186
STAT,1858,36,15-19,1894,0.04179283122948219
SIM,1862,31,25-29,1893,12
STAT,1805,49,50-100,1854,0.912575030303493
SIM,1941,26,na,1967,3583
STAT,1780,95,na,1875,2.0597521841452586
STAT,1831,72,na,1903,737.3861539592366
STAT,1845,16,35-39,1861,0.49366274996268344
SIM,1863,70,na,1933,1127
SIM,1871,26,na,1897,2272
STAT,1819,36,35-39,1855,21.75274088696811
STAT,1866,48,15-19,1914,3.441489649151131E-4
STAT,1809,47,30-34,1856,0.273209086180519
STAT,1853,32,20-24,1885,2.106610636817618
STAT,1869,32,30-34,1901,15.978949157614823
STAT,1907,21,35-39,1928,8.122505929164676
SIM,1852,35,30-34,1887,4
STAT,1865,42,40-44,1907,1.9236076355641327
STAT,1822,52,50-100,1874,0.019544003476407952
STAT,1823,42,35-39,1865,2.4155644248042587
STAT,1879,24,40-44,1903,2.0477228474292533
STAT,1913,54,na,1967,3299.193111219311
SIM,1926,24,15-19,1950,4
STAT,1892,32,50-100,1924,1.084147837465475
STAT,1805,54,35-39,1859,0.030359573679799384
STAT,1818,44,20-24,1862,0.35009160355399355
STAT,1855,50,30-34,1905,0.0042908279337788655
SIM,1814,45,50-100,1859,2
STAT,1868,26,30-34,1894,22.775398624742362
STAT,1910,22,50-100,1932,0.5837632168312219
STAT,1890,33,35-39,1923,11.647056194608348
STAT,1853,25,30-34,1878,22.397815069046015
STAT,1876,38,30-34,1914,5.175893092804888
STAT,1815,46,45-49,1861,0.5393904375020585
STAT,1833,47,50-100,1880,0.1765140537951773
STAT,1757,99,na,1856,0.37476435239999994
SIM,1848,61,na,1909,1320
STAT,1869,34,25-29,1903,9.293667627882702
STAT,1880,26,30-34,1906,25.16559818143724
STAT,1943,21,45-49,1964,1.1312696687509602
SIM,1861,32,20-24,1893,3
SIM,1915,21,35-39,1936,12
STAT,1917,48,50-100,1965,0.22256243683686863
STAT,1901,21,na,1922,3136.8446261470026
SIM,1867,38,30-34,1905,6
SIM,1837,33,40-44,1870,7
SIM,1894,34,25-29,1928,24
STAT,1885,35,20-24,1920,0.732758525446522
SIM,1867,52,na,1919,2078
SIM,1875,71,na,1946,1243
SIM,1882,32,40-44,1914,4
SIM,1803,97,na,1900,2
STAT,1896,13,na,1909,3217.1646879788864
STAT,1896,24,40-44,1920,2.5836618845113968
SIM,1884,38,30-34,1922,6
STAT,1905,35,na,1940,3273.252715535565
SIM,1861,25,30-34,1886,25
STAT,1882,37,45-49,1919,1.8314468636908443
STAT,1865,27,15-19,1892,0.3884901405553598
STAT,1854,24,35-39,1878,4.8355184873842925
STAT,1904,31,50-100,1935,1.2466382176241595
STAT,1918,24,15-19,1942,5.389777498719237
STAT,1830,55,na,1885,1270.8886116051046
SIM,1862,24,35-39,1886,5
STAT,1875,31,45-49,1906,1.7001967356896464
SIM,1883,31,45-49,1914,3
STAT,1886,34,25-29,1920,10.133691436763439
STAT,1840,42,35-39,1882,1.2396331585226723
STAT,1844,17,30-34,1861,1.4071615235599961
STAT,1907,49,40-44,1956,0.13192153307065216
STAT,1872,52,25-29,1924,0.003338463384151155
SIM,1815,41,40-44,1856,10
SIM,1852,17,30-34,1869,1
STAT,1885,41,na,1926,2186.211592590597
SIM,1856,80,na,1936,435
STAT,1855,45,35-39,1900,0.10047958512641945
STAT,1819,43,25-29,1862,1.3049617321490923
SIM,1866,29,25-29,1895,40
STAT,1895,22,30-34,1917,21.937584730835802
STAT,1909,29,50-100,1938,0.8922523791051982
STAT,1854,46,30-34,1900,0.0694555893453417
STAT,1881,50,25-29,1931,0.0032789158522649256
STAT,1864,46,40-44,1910,0.14455482509042886
STAT,1874,32,40-44,1906,4.185900252344546
STAT,1928,21,20-24,1949,131.5465911699678
SIM,1840,37,50-100,1877,3
STAT,1899,40,45-49,1939,0.13588439182574366
STAT,1964,5,na,1969,4677.031660233098
STAT,1860,22,na,1882,1868.7714629144327
STAT,1862,38,30-34,1900,4.28344695423414
STAT,1879,54,35-39,1933,0.008279158615074939
STAT,1827,45,25-29,1872,0.054101952313611285
SIM,1833,32,45-49,1865,1
STAT,1831,43,25-29,1874,0.4678323437429705
STAT,1868,39,35-39,1907,6.310959225811028
STAT,1885,36,30-34,1921,5.04271726842813
SIM,1891,49,50-100,1940,1
SIM,1870,38,30-34,1908,5
STAT,1877,33,20-24,1910,2.6376429013187694
STAT,1883,49,50-100,1932,0.22272843557330982
STAT,1800,89,na,1889,38.726961617917496
SIM,1840,42,na,1882,1583
STAT,1892,23,45-49,1915,0.8225563917909714
STAT,1862,31,30-34,1893,14.160169237194562
STAT,1832,37,50-100,1869,0.9383541945586539
STAT,1868,40,15-19,1908,0.01257297958406312
STAT,1830,53,30-34,1883,0.0038459268254359634
STAT,1935,24,15-19,1959,6.843250780399091
SIM,1890,37,45-49,1927,4
STAT,1893,16,15-19,1909,7.127217638530017
STAT,1841,41,40-44,1882,1.6321250300200143
SIM,1859,26,30-34,1885,20
SIM,1876,89,na,1965,228
SIM,1858,38,30-34,1896,6
SIM,1880,37,35-39,1917,15
SIM,1828,93,na,1921,12
STAT,1825,32,45-49,1857,3.050437330620917
STAT,1854,36,30-34,1890,3.831586383108666
STAT,1828,101,na,1929,0.32136393124997914
STAT,1923,47,30-34,1970,0.09851629934509792
SIM,1866,90,na,1956,58
STAT,1858,29,25-29,1887,31.615370103876334
STAT,1775,84,na,1859,93.25501370849724
STAT,1762,98,na,1860,0.2631751181333991
STAT,1842,19,20-24,1861,16.292923418501985
STAT,1894,36,25-29,1930,3.5123117647904123
SIM,1830,43,30-34,1873,4
SIM,1947,20,40-44,1967,8
STAT,1856,92,na,1948,30.69885826526724
STAT,1865,44,50-100,1909,0.89239356589917
STAT,1822,36,na,1858,1467.47211822388
SIM,1849,87,na,1936,93
STAT,1891,21,50-100,1912,0.4780567292538389
SIM,1879,53,na,1932,2156
STAT,1919,41,20-24,1960,0.018105839187695944
STAT,1899,33,na,1932,3075.8124987137517
STAT,1855,53,35-39,1908,0.006019598857518851
STAT,1822,50,20-24,1872,9.936933796113605E-4
SIM,1825,51,50-100,1876,1
SIM,1850,19,20-24,1869,15
STAT,1805,53,25-29,1858,0.012743599312658652
SIM,1936,21,20-24,1957,76
SIM,1927,23,20-24,1950,125
STAT,1846,37,35-39,1883,5.478310979629879
SIM,1919,24,25-29,1943,110
STAT,1835,44,20-24,1879,0.11804913647850412
STAT,1844,42,20-24,1886,0.11296500122388894
SIM,1947,11,na,1958,4118
SIM,1862,36,30-34,1898,7
SIM,1939,21,45-49,1960,5
STAT,1868,29,35-39,1897,8.634826581684674
STAT,1816,40,na,1856,1494.7258844305243
SIM,1900,12,na,1912,3440
SIM,1839,29,50-100,1868,1
SIM,1883,18,20-24,1901,19
SIM,1860,10,na,1870,2336
STAT,1939,20,40-44,1959,3.1922287790932944
SIM,1893,18,30-34,1911,2
STAT,1803,77,na,1880,346.1044459037608
STAT,1828,39,40-44,1867,3.822633192780575
STAT,1897,45,40-44,1942,0.1232225215042781
STAT,1947,22,na,1969,3899.072561033175
SIM,1844,32,20-24,1876,3
STAT,1839,37,na,1876,1704.1002224529998
SIM,1881,40,25-29,1921,3
SIM,1823,62,na,1885,947
STAT,1856,47,45-49,1903,0.17313939499211137
STAT,1898,48,na,1946,2840.6285472874165
STAT,1895,37,30-34,1932,6.56390106424447
SIM,1885,26,30-34,1911,34
STAT,1883,30,40-44,1913,4.049011798117167
STAT,1919,23,20-24,1942,114.67045269900387
SIM,1919,47,na,1966,3834
SIM,1811,61,na,1872,913
SIM,1862,39,35-39,1901,15
SIM,1815,75,na,1890,454
STAT,1831,105,na,1936,0.017119917698612742
SIM,1770,85,na,1855,63
SIM,1864,24,na,1888,2072
STAT,1818,52,20-24,1870,0.0015104142701181358
SIM,1923,29,na,1952,4074
STAT,1877,26,30-34,1903,24.761299768725397
SIM,1841,31,40-44,1872,9
STAT,1872,27,35-39,1899,9.143105146273752
SIM,1889,63,na,1952,2101
SIM,1893,69,na,1962,1965
STAT,1850,12,na,1862,2056.3785326322395
SIM,1860,15,15-19,1875,4
STAT,1827,36,na,1863,1639.7033219686316
SIM,1836,39,40-44,1875,6
STAT,1869,67,na,1936,1450.774635301824
STAT,1828,46,30-34,1874,0.07942263603966912
STAT,1863,44,30-34,1907,0.9402298545404532
SIM,1885,33,20-24,1918,3
STAT,1818,45,30-34,1863,0.2127172877149513
STAT,1833,31,40-44,1864,3.4615919323008333
STAT,1823,45,40-44,1868,0.21700067363413883
STAT,1828,31,30-34,1859,18.804192873999845
STAT,1900,35,na,1935,3116.8411475859057
STAT,1904,49,na,1953,2985.562413322205
SIM,1882,73,na,1955,1069
SIM,1933,20,40-44,1953,9
STAT,1885,43,20-24,1928,0.14846498869889532
STAT,1813,45,30-34,1858,0.2734751321215059
STAT,1871,37,na,1908,2210.0769209427003
SIM,1905,11,na,1916,3490
STAT,1820,108,na,1928,9.649660661388671E-4
STAT,1862,88,na,1950,110.88650035470836
STAT,1792,64,na,1856,803.7688589600001
SIM,1893,36,30-34,1929,12
SIM,1868,39,50-100,1907,3
STAT,1880,36,30-34,1916,5.333459583626174
STAT,1881,26,50-100,1907,0.5857908367686816
STAT,1821,37,30-34,1858,11.258179418571599
STAT,1852,33,15-19,1885,0.10579218669704711
STAT,1890,36,40-44,1926,5.0802002703869
STAT,1940,32,na,1972,3697.7792451073346
STAT,1894,34,na,1928,2872.2958433932718
STAT,1807,52,45-49,1859,0.05317793653145932
STAT,1925,20,40-44,1945,3.824707858658027
STAT,1893,42,15-19,1935,0.01652418873201186
SIM,1836,31,30-34,1867,21
STAT,1873,40,25-29,1913,0.6214681415942439
SIM,1891,30,40-44,1921,10
STAT,1836,41,30-34,1877,0.897088170327238
SIM,1876,39,35-39,1915,13
SIM,1874,33,45-49,1907,1
STAT,1786,80,na,1866,228.06771914869307
STAT,1966,6,na,1972,4637.527164832629
STAT,1877,41,20-24,1918,0.15633056543958623
STAT,1770,85,na,1855,59.88819999999999
SIM,1906,29,na,1935,3247
STAT,1841,33,40-44,1874,3.5900284183819595
SIM,1877,35,35-39,1912,13
STAT,1855,49,50-100,1904,0.17088586048703064
SIM,1844,15,30-34,1859,1
STAT,1805,88,na,1893,47.92247423261444
STAT,1839,17,50-100,1856,0.042670006474662805
STAT,1854,29,40-44,1883,2.2147082836539944
STAT,1767,97,na,1864,0.7856704373207906
STAT,1845,26,35-39,1871,8.370826465239151
STAT,1861,46,50-100,1907,0.1934633653954068
SIM,1898,68,na,1966,2162
STAT,1945,11,na,1956,4054.300519652731
SIM,1835,75,na,1910,626
SIM,1850,95,na,1945,4
STAT,1922,47,na,1969,3987.073124879485
SIM,1869,32,25-29,1901,7
STAT,1887,38,35-39,1925,7.436774793002645
SIM,1863,42,30-34,1905,2
STAT,1863,51,20-24,1914,6.146749126856541E-4
SIM,1895,38,35-39,1933,10
STAT,1889,43,40-44,1932,2.604279267787004
SIM,1865,41,na,1906,2060
STAT,1853,18,35-39,1871,0.49658965876528943
SIM,1865,40,40-44,1905,3
STAT,1837,50,50-100,1887,0.010234862157238372
SIM,1794,64,na,1858,727
STAT,1927,43,50-100,1970,0.1389659029438531
SIM,1862,29,40-44,1891,3
SIM,1848,43,45-49,1891,2
STAT,1774,99,na,1873,0.2678091803219144
STAT,1861,34,20-24,1895,2.1050397466447537
SIM,1853,60,na,1913,1452
SIM,1798,78,na,1876,298
STAT,1842,32,50-100,1874,0.8015592300172381
STAT,1841,62,na,1903,1260.0596414404033
STAT,1863,52,30-34,1915,0.004908496168389561
STAT,1871,23,25-29,1894,53.53458793300751
STAT,1903,64,na,1967,2593.1142495101194
SIM,1947,1,na,1948,4224
STAT,1853,28,35-39,1881,7.642741840762396
STAT,1880,54,25-29,1934,0.003430607053589222
SIM,1935,18,30-34,1953,18
STAT,1832,40,35-39,1872,1.3743355588042594
STAT,1869,35,35-39,1904,6.5345385716924245
STAT,1952,19,50-100,1971,0.4238552245910526
STAT,1851,22,45-49,1873,0.5990241935840241
STAT,1887,30,25-29,1917,10.910197587183479
SIM,1818,39,50-100,1857,3
SIM,1918,22,15-19,1940,5
STAT,1811,50,45-49,1861,0.04809138363888959
STAT,1867,44,15-19,1911,0.012085039427109529
STAT,1868,18,30-34,1886,1.454017987487855
STAT,1834,69,na,1903,909.8327515797611
STAT,1880,42,na,1922,2299.0103044473667
STAT,1914,16,50-100,1930,0.07339576727805554
STAT,1852,41,15-19,1893,0.01005723833861508
STAT,1914,15,50-100,1929,0.0735561196188246
SIM,1909,28,30-34,1937,40
SIM,1928,28,na,1956,4352
STAT,1851,37,15-19,1888,0.04082696561337749
SIM,1841,42,45-49,1883,4
SIM,1924,14,na,1938,4462
STAT,1915,45,na,1960,3513.7291295650984
SIM,1829,67,na,1896,938
SIM,1940,3,na,1943,3776
SIM,1877,31,20-24,1908,2
STAT,1908,18,50-100,1926,0.06847695812786829
STAT,1877,49,30-34,1926,0.09287711839366011
SIM,1861,28,35-39,1889,11
STAT,1893,34,15-19,1927,0.16914765132114645
STAT,1840,50,35-39,1890,0.005730950452441203
SIM,1845,41,na,1886,1644
STAT,1817,49,30-34,1866,0.21148482485787762
STAT,1837,35,40-44,1872,3.531587267790282
STAT,1872,44,25-29,1916,0.6002798820163916
STAT,1864,99,na,1963,5.1092388449633726
STAT,1831,36,35-39,1867,5.4880563840812036
STAT,1810,79,na,1889,287.70774557855646
SIM,1830,44,na,1874,1500
SIM,1866,35,na,1901,2103
STAT,1843,39,30-34,1882,3.7456745570283965
SIM,1834,58,na,1892,1190
SIM,1919,17,35-39,1936,4
STAT,1840,45,na,1885,1527.5513535201094
SIM,1835,38,35-39,1873,10
SIM,1899,30,na,1929,3171
STAT,1836,33,30-34,1869,14.143841701198221
SIM,1862,21,30-34,1883,19
STAT,1853,35,25-29,1888,2.2246899782960066
STAT,1869,42,25-29,1911,0.5869717930280777
SIM,1870,72,na,1942,1070
SIM,1895,30,25-29,1925,17
STAT,1859,46,30-34,1905,0.072989647012425
STAT,1894,29,35-39,1923,11.630552282434502
STAT,1873,41,35-39,1914,1.7428172013193253
STAT,1927,18,30-34,1945,14.279357369708352
STAT,1879,65,na,1944,1671.1586315974187
SIM,1854,37,35-39,1891,12
STAT,1822,51,30-34,1873,0.007857845867021849
STAT,1871,16,35-39,1887,0.5211225682635038
STAT,1875,51,na,1926,2100.7609009386533
STAT,1851,17,na,1868,2007.5694184657052
STAT,1833,49,15-19,1882,2.5499051323364414E-4
STAT,1826,43,15-19,1869,0.01322548475379553
SIM,1888,14,na,1902,2899
SIM,1889,44,45-49,1933,2
SIM,1901,41,na,1942,3085
STAT,1917,21,45-49,1938,1.133135319713436
SIM,1877,42,na,1919,2224
STAT,1833,42,45-49,1875,1.112686597269977
SIM,1961,6,na,1967,4755
STAT,1865,50,40-44,1915,0.009144011945055553
STAT,1862,33,na,1895,1919.3337515501237
STAT,1948,22,35-39,1970,10.21370369972887
SIM,1831,29,na,1860,1686
SIM,1877,42,25-29,1919,3
SIM,1885,34,30-34,1919,20
STAT,1863,25,40-44,1888,2.519423310161094
STAT,1906,20,na,1926,3273.495072496967
SIM,1910,20,45-49,1930,6
STAT,1805,105,na,1910,0.01023515701005559
STAT,1880,47,35-39,1927,0.13878084690133471
STAT,1854,21,30-34,1875,15.082540350368772
STAT,1877,34,30-34,1911,16.962898368438502
STAT,1903,20,50-100,1923,0.5514028661572252
STAT,1868,93,na,1961,54.73140675300574
STAT,1827,38,35-39,1865,7.169498104257237
SIM,1925,21,45-49,1946,1
STAT,1851,19,15-19,1870,5.129333365823804
STAT,1797,96,na,1893,2.1070729301256965
SIM,1851,39,30-34,1890,9
STAT,1933,30,na,1963,4820.358951738861
SIM,1856,42,40-44,1898,4
STAT,1863,18,na,1881,2161.3569139942338
SIM,1881,41,35-39,1922,2
STAT,1843,46,20-24,1889,0.008171597522553286
STAT,1859,53,20-24,1912,5.459261274637185E-4
STAT,1911,33,50-100,1944,0.7573933780329665
SIM,1861,35,25-29,1896,2
STAT,1880,29,35-39,1909,9.541021858778903
SIM,1853,17,na,1870,2098
STAT,1947,22,40-44,1969,3.590033474275636
STAT,1880,21,25-29,1901,57.185027228689044
STAT,1836,40,20-24,1876,0.12551996078590819
SIM,1847,76,na,1923,655
SIM,1831,92,na,1923,21
STAT,1902,20,45-49,1922,0.9352381082502664
STAT,1821,41,50-100,1862,1.8726520492793406
STAT,1900,36,25-29,1936,0.8183320475223398
STAT,1872,37,35-39,1909,6.702139524416476
SIM,1821,38,35-39,1859,13
SIM,1843,62,na,1905,1306
SIM,1871,25,40-44,1896,4
STAT,1806,50,35-39,1856,0.031552877515615474
SIM,1876,27,50-100,1903,1
SIM,1858,48,na,1906,1818
STAT,1808,53,na,1861,1185.050376385761
SIM,1885,16,30-34,1901,1
STAT,1811,96,na,1907,3.723970605236879
STAT,1937,32,25-29,1969,8.638524672759344
STAT,1848,42,40-44,1890,1.6692847671168278
STAT,1760,102,na,1862,0.0620117355294297
STAT,1895,47,30-34,1942,0.06693578608373078
SIM,1912,13,na,1925,3753
STAT,1835,19,50-100,1854,0.08179159706972414
STAT,1920,48,45-49,1968,0.22632851166852394
SIM,1842,17,20-24,1859,15
SIM,1939,24,na,1963,3397
STAT,1870,30,50-100,1900,0.8559664218578215
STAT,1852,6,na,1858,2187.514394538458
SIM,1934,32,50-100,1966,1
STAT,1869,39,30-34,1908,4.828482752128898
STAT,1915,47,25-29,1962,0.050496609736944816
STAT,1884,47,20-24,1931,0.011147634747460519
STAT,1933,36,50-100,1969,0.540735018892245
SIM,1840,32,35-39,1872,10
SIM,1849,29,25-29,1878,44
STAT,1885,39,35-39,1924,6.593139366742342
STAT,1836,92,na,1928,26.97076803102609
STAT,1881,46,40-44,1927,0.1566818220924431
SIM,1845,36,30-34,1881,4
SIM,1948,16,15-19,1964,45
SIM,1923,26,50-100,1949,1
SIM,1929,13,na,1942,4733
STAT,1837,101,na,1938,0.37032553920967204
STAT,1829,37,35-39,1866,6.417511314118419
STAT,1904,18,na,1922,3413.372221755383
SIM,1877,24,30-34,1901,23
SIM,1886,36,40-44,1922,6
STAT,1878,36,40-44,1914,4.330484716777645
SIM,1846,59,na,1905,1401
STAT,1891,14,na,1905,3008.6165373762465
SIM,1848,28,50-100,1876,1
STAT,1867,48,30-34,1915,0.084790206883123
SIM,1822,41,30-34,1863,1
STAT,1769,105,na,1874,0.015626947202927434
STAT,1844,45,25-29,1889,0.04063543343344454
SIM,1890,17,na,1907,3149
STAT,1828,73,na,1901,668.9188266613158
STAT,1835,33,15-19,1868,0.11420097922424348
SIM,1884,16,15-19,1900,5
SIM,1863,27,35-39,1890,11
SIM,1886,22,30-34,1908,21
SIM,1929,32,40-44,1961,6
STAT,1823,41,25-29,1864,0.8806294829011049
STAT,1895,15,50-100,1910,0.060618674776912955
STAT,1878,22,30-34,1900,17.536559674139113
STAT,1925,23,45-49,1948,1.2683698135639268
SIM,1877,39,30-34,1916,5
STAT,1884,21,45-49,1905,0.6527895662200133
SIM,1769,97,na,1866,1
SIM,1893,39,35-39,1932,16
STAT,1789,77,na,1866,300.07044079828876
SIM,1806,94,na,1900,5
STAT,1880,19,40-44,1899,0.18118264784757943
SIM,1901,30,45-49,1931,3
STAT,1870,21,15-19,1891,3.066638331063716
SIM,1854,33,40-44,1887,4
SIM,1872,35,35-39,1907,9
SIM,1822,56,na,1878,1194
STAT,1818,48,35-39,1866,0.29403024511571285
SIM,1899,53,na,1952,2770
STAT,1863,94,na,1957,21.714400373292417
STAT,1876,52,45-49,1928,0.014088782516031993
STAT,1895,40,25-29,1935,0.7988600296026738
SIM,1820,42,50-100,1862,3
SIM,1914,48,50-100,1962,2
STAT,1900,15,na,1915,3325.196018829568
STAT,1858,28,15-19,1886,0.34154191426833214
STAT,1904,29,na,1933,3210.760488386607
SIM,1828,43,40-44,1871,3
SIM,1918,26,30-34,1944,36
STAT,1814,41,30-34,1855,4.257140256983112
STAT,1878,37,30-34,1915,5.247079116529656
SIM,1880,34,30-34,1914,16
STAT,1957,12,na,1969,4891.803918557934
STAT,1872,34,30-34,1906,16.402784305086282
STAT,1930,3,na,1933,4953.743259400266
SIM,1857,22,na,1879,1954
STAT,1869,31,20-24,1900,2.483920400329106
STAT,1881,32,30-34,1913,15.933851593146867
STAT,1945,3,na,1948,4138.245060773875
STAT,1900,29,35-39,1929,12.554587923335905
SIM,1909,20,20-24,1929,87
STAT,1893,38,30-34,1931,6.3533120715831854
STAT,1867,26,15-19,1893,0.4038507360875532
STAT,1821,42,na,1863,1462.2761347986732
SIM,1898,29,20-24,1927,14
STAT,1892,20,40-44,1912,2.4803790363257137
STAT,1904,30,20-24,1934,3.6922391322206516
STAT,1880,73,na,1953,1182.9242793961512
STAT,1876,36,na,1912,2310.512377283165
STAT,1873,33,35-39,1906,9.661942303981787
STAT,1853,41,30-34,1894,0.8740013035945522
SIM,1857,44,50-100,1901,3
STAT,1843,20,45-49,1863,0.599787889773075
STAT,1872,41,20-24,1913,0.1511685379173651
STAT,1897,38,15-19,1935,0.07059279831936971
SIM,1845,35,40-44,1880,8
SIM,1939,18,15-19,1957,39
STAT,1809,93,na,1902,11.727920331940547
STAT,1850,46,50-100,1896,0.17362072882119575
SIM,1867,21,na,1888,2302
STAT,1869,50,25-29,1919,0.003288196164571594
STAT,1823,34,35-39,1857,20.173052823468772
STAT,1869,98,na,1967,14.34574679084352
STAT,1873,47,45-49,1920,0.22506085535103992
STAT,1860,39,30-34,1899,4.044057488277251
SIM,1845,21,30-34,1866,22
SIM,1857,28,20-24,1885,9
STAT,1922,21,25-29,1943,100.3703400395529
STAT,1806,74,na,1880,474.9065887369532
STAT,1852,44,20-24,1896,0.11358312887289336
SIM,1930,21,25-29,1951,125
STAT,1803,108,na,1911,6.157206903481325E-4
STAT,1826,104,na,1930,0.03642375140424215
STAT,1855,27,35-39,1882,7.147055831396903
STAT,1847,39,15-19,1886,0.042080411760284285
STAT,1890,25,35-39,1915,11.219788313366793
STAT,1890,32,25-29,1922,11.829857873579845
STAT,1890,72,na,1962,1658.174916165558
SIM,1874,30,40-44,1904,4
STAT,1825,45,na,1870,1405.581911350476
SIM,1814,42,35-39,1856,3
SIM,1819,39,40-44,1858,4
STAT,1837,36,30-34,1873,4.255266057704352
STAT,1944,18,30-34,1962,12.387563840990138
STAT,1859,49,35-39,1908,0.10306682708846783
STAT,1879,53,25-29,1932,0.0034463635756426534
SIM,1875,19,25-29,1894,8
STAT,1849,28,20-24,1877,10.353191991839811
STAT,1872,53,35-39,1925,0.00802676728573904
SIM,1956,15,na,1971,4488
STAT,1880,15,50-100,1895,0.049019418033520966
SIM,1856,69,na,1925,1127
SIM,1912,30,20-24,1942,4
SIM,1886,12,na,1898,2545
STAT,1840,45,40-44,1885,0.11623791090309644
STAT,1914,28,na,1942,3555.166144692788
STAT,1899,29,15-19,1928,0.5830764305745417
STAT,1779,78,na,1857,242.3060483345927
STAT,1840,22,na,1862,1784.4054994861888
STAT,1886,67,na,1953,1581.9053453476104
STAT,1948,8,na,1956,4249.0599754290715
SIM,1933,23,45-49,1956,1
STAT,1840,31,30-34,1871,14.10152233141394
STAT,1867,19,25-29,1886,5.078570494947141
STAT,1942,29,40-44,1971,4.616935226141364
STAT,1805,50,20-24,1855,0.002819401630675243
STAT,1847,50,25-29,1897,0.0026494401401751847
STAT,1931,28,na,1959,4566.6894956652695
SIM,1843,15,15-19,1858,5
STAT,1882,53,na,1935,1946.386947144507
SIM,1790,82,na,1872,126
STAT,1857,40,40-44,1897,1.6927575970503252
SIM,1944,23,20-24,1967,104
STAT,1885,46,25-29,1931,0.0543926628430829
STAT,1932,39,25-29,1971,1.2470832844019009
STAT,1936,23,20-24,1959,100.39212354154887
SIM,1820,45,na,1865,1468
STAT,1819,37,na,1856,1542.048789027188
STAT,1837,54,30-34,1891,0.0037570343614235667
STAT,1841,44,45-49,1885,1.0450472523993988
SIM,1888,44,50-100,1932,1
SIM,1870,31,30-34,1901,19
STAT,1925,41,45-49,1966,0.19062061348114556
STAT,1823,74,na,1897,593.9379221206189
SIM,1831,34,35-39,1865,8
SIM,1873,69,na,1942,1359
SIM,1864,47,50-100,1911,1
SIM,1878,35,30-34,1913,4
SIM,1890,30,25-29,1920,18
STAT,1831,33,30-34,1864,13.756124321280273
SIM,1925,31,na,1956,4206
STAT,1848,18,na,1866,2101.9479960313784
STAT,1936,19,35-39,1955,3.774728707960297
SIM,1851,17,15-19,1868,7
STAT,1860,43,15-19,1903,0.010508901671196951
SIM,1924,39,40-44,1963,3
STAT,1831,52,35-39,1883,0.005395083181126285
STAT,1827,51,30-34,1878,0.00536207141945352
STAT,1863,73,na,1936,984.6674926713462
SIM,1895,71,na,1966,1904
STAT,1868,32,15-19,1900,0.12835803389110065
SIM,1851,37,na,1888,1754
STAT,1864,42,25-29,1906,0.5400124390210005
SIM,1897,2,na,1899,3430
STAT,1847,54,40-44,1901,0.007549683060804135
STAT,1899,47,15-19,1946,2.9069851962766234E-4
STAT,1815,55,na,1870,1183.1872903252874
STAT,1881,17,35-39,1898,0.5007555308782856
SIM,1834,29,30-34,1863,18
SIM,1842,77,na,1919,514
SIM,1850,96,na,1946,3
STAT,1898,41,40-44,1939,0.2005854056986252
STAT,1859,68,na,1927,1149.0372502319153
SIM,1896,26,35-39,1922,14
STAT,1843,17,15-19,1860,5.122552343337586
STAT,1911,47,40-44,1958,0.14100973274115827
SIM,1942,12,na,1954,3812
STAT,1866,47,na,1913,1951.195052321635
STAT,1871,20,20-24,1891,65.03060993333692
STAT,1920,35,na,1955,3898.068006679591
STAT,1855,54,na,1909,1488.0217076548668
STAT,1843,74,na,1917,749.6030285803272
STAT,1835,51,45-49,1886,0.00960143901199689
SIM,1864,88,na,1952,113
STAT,1906,21,40-44,1927,2.875776601618161
STAT,1826,29,30-34,1855,50.14645059716301
STAT,1868,46,25-29,1914,0.05206470822041662
SIM,1881,33,35-39,1914,11
STAT,1925,22,50-100,1947,0.7440358320616834
SIM,1891,4,na,1895,3101
STAT,1894,42,30-34,1936,0.096804698961562
STAT,1861,23,15-19,1884,2.6430709389621914
STAT,1893,49,na,1942,2639.5848482662022
STAT,1896,43,30-34,1939,0.09888981140404428
SIM,1944,19,35-39,1963,5
SIM,1841,47,50-100,1888,4
STAT,1882,30,25-29,1912,9.485677181158216
SIM,1843,18,na,1861,2123
STAT,1851,92,na,1943,29.960212609261223
SIM,1905,49,50-100,1954,1
SIM,1907,45,50-100,1952,1
STAT,1916,39,40-44,1955,1.4336410515977185
SIM,1918,5,na,1923,4143
STAT,1852,15,15-19,1867,5.265516814441166
STAT,1877,44,25-29,1921,0.6207779387859695
STAT,1877,42,30-34,1919,1.1252127093407625
SIM,1928,22,25-29,1950,106
SIM,1829,35,35-39,1864,7
STAT,1871,28,30-34,1899,23.53929160391633
STAT,1831,26,50-100,1857,0.568141244462965
SIM,1907,30,50-100,1937,3
SIM,1886,37,30-34,1923,10
STAT,1832,28,15-19,1860,0.36708188758529414
STAT,1859,57,na,1916,1511.0225001387219
SIM,1848,40,40-44,1888,4
SIM,1903,15,30-34,1918,5
STAT,1877,16,30-34,1893,1.565723920807718
STAT,1914,48,20-24,1962,0.010325370463416686
STAT,1829,52,30-34,1881,0.004276764145143525
STAT,1819,92,na,1911,21.9865144030449
STAT,1867,87,na,1954,156.28610695516718
STAT,1826,47,30-34,1873,0.08937434402196882
STAT,1807,59,na,1866,1064.3967703345054
STAT,1872,26,45-49,1898,1.0557085100018508
STAT,1888,44,35-39,1932,1.9943909322789555
STAT,1868,27,50-100,1895,0.5765816902108424
SIM,1828,41,na,1869,1566
STAT,1857,36,20-24,1893,0.5770937156491796
SIM,1892,21,45-49,1913,1
STAT,1828,96,na,1924,4.83583584506002
STAT,1846,33,40-44,1879,3.7619046441808974
SIM,1918,33,20-24,1951,4
STAT,1883,48,15-19,1931,3.658298779179241E-4
STAT,1913,5,na,1918,3871.036214696336
STAT,1921,30,20-24,1951,2.5848927927369343
STAT,1784,108,na,1892,0.0018490978809669592
SIM,1877,38,50-100,1915,1
SIM,1845,24,35-39,1869,5
STAT,1843,35,15-19,1878,0.04520841296132094
STAT,1795,84,na,1879,114.62793630677359
SIM,1820,34,25-29,1854,11
STAT,1836,43,25-29,1879,0.4884000762101455
STAT,1776,81,na,1857,182.78663715846264
STAT,1799,98,na,1897,1.0371034808570707
STAT,1814,60,na,1874,1116.4942254486293
STAT,1899,9,na,1908,3358.5000474664444
SIM,1830,24,40-44,1854,1
STAT,1876,45,20-24,1921,0.011828822224645888
STAT,1906,49,25-29,1955,0.043771359800690794
SIM,1938,30,40-44,1968,4
STAT,1846,39,na,1885,1787.309378675693
STAT,1884,18,15-19,1902,5.524327420338477
SIM,1869,37,30-34,1906,9
STAT,1837,24,35-39,1861,4.886889741804625
STAT,1843,73,na,1916,802.2636120770658
STAT,1847,87,na,1934,129.9169857698048
SIM,1842,44,50-100,1886,1
SIM,1889,41,40-44,1930,6
STAT,1833,50,45-49,1883,0.00954744564699749
STAT,1822,43,30-34,1865,1.6285353307886994
SIM,1841,82,na,1923,270
SIM,1813,49,50-100,1862,1
SIM,1895,34,40-44,1929,10
STAT,1893,45,20-24,1938,0.00819029645889781
STAT,1856,37,15-19,1893,0.041390280780784675
SIM,1782,86,na,1868,50
SIM,1898,13,na,1911,3250
SIM,1885,42,30-34,1927,3
STAT,1887,34,40-44,1921,4.543306353974943
SIM,1825,30,45-49,1855,1
SIM,1876,8,na,1884,2612
STAT,1826,54,20-24,1880,6.315969965808896E-4
SIM,1868,16,30-34,1884,1
SIM,1937,12,na,1949,3541
SIM,1864,55,na,1919,1867
SIM,1914,21,40-44,1935,2
STAT,1863,29,35-39,1892,7.941957262050666
STAT,1831,40,20-24,1871,0.1204492762003112
STAT,1815,78,na,1893,348.7551014338018
SIM,1878,16,na,1894,2574
STAT,1875,18,20-24,1893,17.169561696528085
SIM,1864,19,15-19,1883,4
SIM,1860,41,na,1901,1934
STAT,1896,25,30-34,1921,31.63224709124672
STAT,1907,20,45-49,1927,0.9734662487933722
SIM,1894,9,na,1903,3283
STAT,1832,46,45-49,1878,0.1708136598227484
STAT,1868,52,30-34,1920,0.005336721388999728
STAT,1877,37,35-39,1914,6.931000828226369
SIM,1830,25,30-34,1855,25
STAT,1863,21,25-29,1884,48.753430364902044
SIM,1938,30,50-100,1968,4
SIM,1904,31,25-29,1935,7
SIM,1885,37,35-39,1922,14
STAT,1856,19,15-19,1875,5.111486669805007
STAT,1832,32,35-39,1864,7.993444976160026
STAT,1930,20,20-24,1950,135.3698176637396
SIM,1871,21,25-29,1892,52
STAT,1814,44,35-39,1858,5.831851803388736
STAT,1782,108,na,1890,0.0044380741734448975
STAT,1856,91,na,1947,42.71204923236113
STAT,1824,44,45-49,1868,1.8683321314369645
SIM,1887,72,na,1959,1420
STAT,1777,96,na,1873,1.3319343295393584
SIM,1932,13,na,1945,4914
STAT,1859,108,na,1967,0.01340267671138774
SIM,1944,26,25-29,1970,73
SIM,1851,43,50-100,1894,1
STAT,1868,50,45-49,1918,0.013268624398101263
STAT,1884,24,na,1908,2193.530471290613
STAT,1843,43,50-100,1886,0.7253552965526078
SIM,1853,30,20-24,1883,2
STAT,1908,23,45-49,1931,0.9742014335336426
STAT,1855,42,30-34,1897,0.8159790752602275
STAT,1838,49,15-19,1887,2.692901442114344E-4
SIM,1845,39,35-39,1884,10
SIM,1851,92,na,1943,31
SIM,1835,39,25-29,1874,4
SIM,1891,57,na,1948,2338
STAT,1934,31,45-49,1965,2.0308135987515596
STAT,1806,53,40-44,1859,0.03631982294801197
STAT,1895,36,40-44,1931,5.417275518412805
STAT,1898,37,20-24,1935,0.9854683316680175
STAT,1817,45,15-19,1862,9.305079173114591E-4
STAT,1900,41,20-24,1941,0.014518034803320654
SIM,1802,57,na,1859,1000
SIM,1823,32,35-39,1855,10
STAT,1871,49,35-39,1920,0.1285880493887217
STAT,1938,32,40-44,1970,3.7173041927062065
SIM,1938,15,45-49,1953,1
STAT,1834,30,45-49,1864,1.4153231901187713
STAT,1814,93,na,1907,13.432751540564297
SIM,1928,15,35-39,1943,4
SIM,1890,23,35-39,1913,9
STAT,1882,23,35-39,1905,5.344579254374284
STAT,1877,86,na,1963,390.44980005281496
STAT,1901,28,40-44,1929,3.947216196567251
STAT,1937,12,na,1949,3641.4677588367294
STAT,1888,19,45-49,1907,0.07253808977695639
STAT,1825,33,50-100,1858,1.4541155996525528
STAT,1809,54,20-24,1863,0.0019052622020720414
SIM,1840,43,40-44,1883,7
STAT,1891,35,45-49,1926,2.3520776736369853
STAT,1881,35,35-39,1916,6.516096071400418
STAT,1850,105,na,1955,0.020668826649138095
SIM,1918,21,25-29,1939,91
SIM,1861,36,na,1897,2055
STAT,1894,18,50-100,1912,0.05932273026896259
SIM,1859,105,na,1964,1
SIM,1862,38,50-100,1900,1
STAT,1936,26,25-29,1962,59.53251976051927
STAT,1852,19,30-34,1871,1.3811589723064595
STAT,1859,53,50-100,1912,0.01117328763304441
STAT,1884,36,15-19,1920,0.052662469034249246
STAT,1907,46,na,1953,3131.612858781999
STAT,1835,102,na,1937,0.18659883875822136
SIM,1855,25,35-39,1880,10
STAT,1923,49,25-29,1972,0.058277665189330655
STAT,1816,39,15-19,1855,0.1844371937805745
SIM,1851,81,na,1932,355
SIM,1921,31,25-29,1952,11
STAT,1882,50,40-44,1932,0.009810902796866352
SIM,1892,18,15-19,1910,6
STAT,1860,21,na,1881,1882.2862783932976
STAT,1875,20,na,1895,2310.1991061069484
SIM,1822,44,35-39,1866,4
STAT,1872,50,30-34,1922,0.005721556884903037
SIM,1842,30,45-49,1872,1
STAT,1827,31,15-19,1858,0.1783286600642039
STAT,1837,31,25-29,1868,8.421592138585183
STAT,1848,73,na,1921,882.5691444412568
SIM,1832,23,na,1855,1686
SIM,1834,89,na,1923,68
SIM,1860,19,30-34,1879,2
STAT,1880,21,na,1901,2362.5456186992765
STAT,1949,21,40-44,1970,3.707815257869357
SIM,1844,36,35-39,1880,10
STAT,1874,51,45-49,1925,0.014074743273945017
SIM,1854,36,45-49,1890,2
STAT,1839,37,15-19,1876,0.044678659328766565
STAT,1864,51,35-39,1915,0.0072832666353623695
SIM,1830,75,na,1905,587
STAT,1759,107,na,1866,0.003263382779516776
STAT,1864,35,na,1899,2002.5054157946215
STAT,1847,25,35-39,1872,8.676238363786801
STAT,1894,22,15-19,1916,4.005178355222155
SIM,1909,24,15-19,1933,4
STAT,1845,30,20-24,1875,2.322007648419395
STAT,1837,39,35-39,1876,5.473989592001732
SIM,1853,38,30-34,1891,7
STAT,1827,39,25-29,1866,2.851274981081384
STAT,1913,31,25-29,1944,8.722980664991919
STAT,1869,17,35-39,1886,0.509126666744559
SIM,1863,24,30-34,1887,18
SIM,1902,47,na,1949,2957
SIM,1934,24,na,1958,4540
STAT,1850,34,45-49,1884,1.259500155577705
SIM,1878,34,40-44,1912,4
STAT,1840,34,35-39,1874,7.92836521148019
SIM,1831,31,30-34,1862,20
SIM,1853,4,na,1857,2312
SIM,1868,34,30-34,1902,24
SIM,1911,17,30-34,1928,2
SIM,1881,44,40-44,1925,6
STAT,1858,28,na,1886,1796.5465126422014
STAT,1855,24,30-34,1879,14.575962073681396
STAT,1860,20,45-49,1880,0.6142805986325037
STAT,1842,25,20-24,1867,10.65872467396735
STAT,1890,22,30-34,1912,20.572578134973693
SIM,1874,54,na,1928,1933
SIM,1845,31,25-29,1876,12
SIM,1878,68,na,1946,1507
STAT,1908,41,45-49,1949,0.1463053814628748
STAT,1903,17,30-34,1920,2.14240320176962
STAT,1932,13,na,1945,4948.741742427684
STAT,1936,27,na,1963,3386.760459266288
STAT,1854,69,na,1923,1050.0053136877088
STAT,1847,43,35-39,1890,1.3256612337436515
STAT,1846,36,45-49,1882,1.5601659078418892
STAT,1948,18,15-19,1966,49.05068502644983
STAT,1888,26,35-39,1914,10.80949742574209
STAT,1836,36,35-39,1872,5.680653608284285
SIM,1878,30,25-29,1908,10
SIM,1850,25,20-24,1875,17
STAT,1798,58,na,1856,1020.7567543302001
STAT,1865,21,na,1886,2064.5515546145048
STAT,1837,25,na,1862,1828.0820908099258
SIM,1918,29,35-39,1947,17
SIM,1830,27,50-100,1857,1
SIM,1855,43,35-39,1898,3
SIM,1938,27,na,1965,3335
STAT,1852,47,25-29,1899,0.04156452456301472
SIM,1916,23,45-49,1939,1
STAT,1873,44,40-44,1917,2.1259744174082913
STAT,1840,41,25-29,1881,0.4452712934526495
STAT,1828,45,40-44,1873,0.1423342949276894
SIM,1858,17,na,1875,2203
STAT,1902,7,na,1909,3473.5427642226764
STAT,1823,31,30-34,1854,52.91684239526993
STAT,1831,41,na,1872,1515.4980868770099
STAT,1835,55,na,1890,1316.0500201785294
STAT,1849,38,15-19,1887,0.042643040209531725
STAT,1863,54,25-29,1917,0.0028556411468050207
SIM,1927,24,50-100,1951,3
STAT,1870,28,35-39,1898,8.910776595825117
SIM,1773,82,na,1855,135
STAT,1842,47,15-19,1889,2.897210743681184E-4
STAT,1924,25,50-100,1949,1.1022274872689808
STAT,1847,36,50-100,1883,0.949141809766196
STAT,1878,25,35-39,1903,9.564017013214137
STAT,1871,8,na,1879,2547.7498328918173
STAT,1886,46,na,1932,2251.513853238936
STAT,1862,33,25-29,1895,8.238228699712241
STAT,1858,4,na,1862,2306.153185604214
SIM,1855,40,na,1895,1869
SIM,1777,96,na,1873,1
STAT,1873,29,15-19,1902,0.43159209404821447
STAT,1883,39,na,1922,2160.1753039341543
STAT,1854,58,na,1912,1414.941379959575
STAT,1929,20,50-100,1949,0.790731808458586
SIM,1886,25,35-39,1911,13
SIM,1881,36,na,1917,1836
STAT,1936,17,50-100,1953,0.3388464505321933
STAT,1775,85,na,1860,75.47128259428682
SIM,1937,7,na,1944,3571
SIM,1844,88,na,1932,56
SIM,1829,28,45-49,1857,3
SIM,1855,36,50-100,1891,4
STAT,1850,16,15-19,1866,5.1423409088737975
STAT,1902,47,na,1949,2986.1294501506363
STAT,1921,36,45-49,1957,0.7197483015226923
STAT,1879,50,20-24,1929,7.401949217967431E-4
STAT,1899,19,20-24,1918,22.824794010370937
STAT,1921,15,25-29,1936,46.881151493745975
STAT,1896,46,35-39,1942,0.09881153944328883
SIM,1914,39,30-34,1953,1
SIM,1929,3,na,1932,4833
STAT,1878,32,25-29,1910,10.084054957795532
STAT,1872,23,40-44,1895,1.9684684419344505
STAT,1900,36,na,1936,3126.8590548624134
STAT,1891,17,15-19,1908,6.936191594053861
STAT,1901,24,25-29,1925,75.22438305937267
SIM,1886,32,25-29,1918,15
SIM,1847,55,na,1902,1570
SIM,1903,18,35-39,1921,2
SIM,1878,38,35-39,1916,18
SIM,1860,37,30-34,1897,6
STAT,1861,41,45-49,1902,1.1809108915294995
SIM,1853,23,30-34,1876,18
STAT,1847,18,45-49,1865,0.059765909125186444
STAT,1936,16,30-34,1952,11.050881424724128
STAT,1845,23,30-34,1868,15.535304932611998
STAT,1842,29,15-19,1871,0.4005039298342774
STAT,1834,49,30-34,1883,0.06209808303661966
STAT,1914,6,na,1920,3904.0392061356542
STAT,1932,36,20-24,1968,0.33489929205191427
STAT,1829,31,50-100,1860,0.9399429291635183
STAT,1852,37,30-34,1889,3.884836216925632
SIM,1795,81,na,1876,182
SIM,1939,22,35-39,1961,12
STAT,1840,16,35-39,1856,0.46898675769773884
STAT,1849,41,45-49,1890,1.127360643831018
SIM,1886,35,na,1921,2326
STAT,1883,26,20-24,1909,10.903115665054939
SIM,1857,41,45-49,1898,1
SIM,1944,16,30-34,1960,16
STAT,1858,46,15-19,1904,2.971135123181771E-4
SIM,1891,33,45-49,1924,2
STAT,1837,21,30-34,1858,15.242773222948035
STAT,1963,4,na,1967,4718.651881148763
SIM,1787,85,na,1872,46
SIM,1830,28,35-39,1858,7
STAT,1820,45,na,1865,1393.097125883698
STAT,1868,43,20-24,1911,0.14211082733447075
STAT,1906,39,30-34,1945,1.5668309013610906
STAT,1839,52,40-44,1891,0.0069719764639678715
SIM,1807,56,na,1863,1068
STAT,1805,89,na,1894,36.67171495702352
SIM,1870,26,35-39,1896,9
SIM,1870,95,na,1965,29
SIM,1952,18,30-34,1970,15
STAT,1928,42,25-29,1970,0.08599694820304503
SIM,1845,29,40-44,1874,2
STAT,1845,38,30-34,1883,3.9216035241153815
STAT,1850,49,15-19,1899,2.760818163806979E-4
STAT,1837,29,40-44,1866,2.4596008472907513
STAT,1872,87,na,1959,241.17703357940616
SIM,1817,89,na,1906,29
STAT,1831,25,45-49,1856,1.0255147380792735
STAT,1898,44,45-49,1942,0.13107240902891334
SIM,1951,16,na,1967,4022
STAT,1836,47,40-44,1883,0.11602197472532667
SIM,1908,21,45-49,1929,1
STAT,1862,26,35-39,1888,7.878919916547945
STAT,1873,0,na,1873,3542.884127635582
STAT,1830,27,30-34,1857,25.237330833280545
STAT,1930,42,45-49,1972,0.20686433369159477
SIM,1939,23,na,1962,3403
SIM,1938,33,45-49,1971,2
SIM,1903,5,na,1908,3519
SIM,1882,21,35-39,1903,9
SIM,1861,29,25-29,1890,42
SIM,1877,83,na,1960,562
STAT,1832,26,na,1858,1733.5570271361541
STAT,1906,46,20-24,1952,0.009339935066330511
STAT,1893,48,25-29,1941,0.03843625371149835
SIM,1796,99,na,1895,1
STAT,1894,40,45-49,1934,1.8353293444429986
STAT,1886,8,na,1894,2594.1142000205305
STAT,1928,23,50-100,1951,0.7736871668289058
SIM,1936,17,35-39,1953,2
STAT,1886,31,20-24,1917,2.7084337312535935
SIM,1846,37,50-100,1883,2
SIM,1884,21,na,1905,2305
SIM,1916,50,na,1966,3442
SIM,1881,15,35-39,1896,1
STAT,1903,48,45-49,1951,0.1766900911028756
STAT,1823,50,35-39,1873,0.010618204511036951
SIM,1893,68,na,1961,2012
SIM,1936,24,25-29,1960,69
SIM,1931,9,na,1940,4905
STAT,1936,9,na,1945,3600.3848577674103
SIM,1837,22,na,1859,1775
SIM,1855,95,na,1950,7
STAT,1863,19,40-44,1882,0.15560239472411905
STAT,1832,43,40-44,1875,1.641984978300912
SIM,1926,20,20-24,1946,111
STAT,1873,15,35-39,1888,0.531974373254277
STAT,1896,28,35-39,1924,11.996450860850173
SIM,1915,10,na,1925,3755
SIM,1919,24,na,1943,3820
STAT,1872,54,na,1926,1984.1860306945252
STAT,1884,35,na,1919,2219.7653501507357
STAT,1837,66,na,1903,1063.6912392621275
STAT,1928,17,35-39,1945,4.994719400934325
SIM,1894,31,20-24,1925,3
STAT,1822,53,25-29,1875,0.00449329236375439
SIM,1862,35,40-44,1897,2
STAT,1890,41,35-39,1931,2.1008912330526885
SIM,1827,33,30-34,1860,20
STAT,1794,99,na,1893,0.35671932358919456
STAT,1853,29,25-29,1882,33.26561653203577
STAT,1921,19,50-100,1940,0.4012744797069246
SIM,1920,32,na,1952,3970
STAT,1819,40,20-24,1859,0.35881057010812717
STAT,1790,85,na,1875,82.08680820626472
SIM,1872,32,30-34,1904,24
STAT,1849,58,na,1907,1482.9370732251723
SIM,1926,28,30-34,1954,56
STAT,1886,24,30-34,1910,17.663787429968178
SIM,1871,26,30-34,1897,33
SIM,1894,39,30-34,1933,9
SIM,1879,45,50-100,1924,2
STAT,1945,16,50-100,1961,0.3867381581961693
SIM,1894,24,30-34,1918,32
STAT,1854,35,40-44,1889,3.1799613708115
STAT,1822,46,35-39,1868,0.19098794980589828
STAT,1921,33,25-29,1954,9.67573314071768
SIM,1837,37,35-39,1874,11
SIM,1895,37,45-49,1932,2
STAT,1819,48,30-34,1867,0.1806688558866687
STAT,1928,24,25-29,1952,108.26481271999722
STAT,1853,21,15-19,1874,2.9712764775858824
STAT,1876,34,15-19,1910,0.13780059129365685
STAT,1918,20,20-24,1938,113.97095260226813
SIM,1839,40,50-100,1879,4
STAT,1896,20,25-29,1916,71.8506754962321
STAT,1887,37,45-49,1924,2.1064861023295793
STAT,1844,38,35-39,1882,5.137340106191411
SIM,1835,74,na,1909,678
SIM,1839,88,na,1927,71
STAT,1880,52,30-34,1932,0.005896791897901119
SIM,1852,38,35-39,1890,14
SIM,1875,7,na,1882,2626
STAT,1842,32,45-49,1874,1.5255482213854568
STAT,1865,45,45-49,1910,0.2040934575510083
STAT,1918,28,30-34,1946,39.25449583061015
STAT,1886,39,30-34,1925,5.264913301935668
SIM,1861,21,15-19,1882,2
STAT,1820,40,45-49,1860,2.9240118755307547
STAT,1835,53,30-34,1888,0.0037852749260201225
STAT,1948,21,45-49,1969,1.2209084696947634
STAT,1838,37,50-100,1875,0.9946028967107554
STAT,1863,26,30-34,1889,21.02720567551146
SIM,1878,27,30-34,1905,23
STAT,1905,47,15-19,1952,3.0666438138390216E-4
STAT,1851,24,50-100,1875,0.34529421625552525
STAT,1859,34,na,1893,1778.8830543411432
SIM,1818,39,25-29,1857,1
STAT,1909,30,20-24,1939,2.2166557438204166
SIM,1903,43,40-44,1946,2
STAT,1930,31,25-29,1961,11.27458779571549
STAT,1802,53,20-24,1855,0.0021174142831462935
SIM,1886,56,na,1942,1965
STAT,1840,18,50-100,1858,0.041381989103218685
SIM,1880,41,na,1921,2341
STAT,1820,44,25-29,1864,1.1095250434145822
STAT,1927,21,25-29,1948,107.83262953854032
STAT,1944,15,na,1959,3743.961902023525
STAT,1862,30,50-100,1892,0.7460172911405365
STAT,1902,46,35-39,1948,0.10558642939605421
SIM,1890,20,30-34,1910,26
SIM,1852,22,na,1874,1949
STAT,1877,48,40-44,1925,0.16565684134307393
STAT,1907,42,20-24,1949,0.015285438842503144
STAT,1912,40,20-24,1952,0.016273820447993546
SIM,1932,20,45-49,1952,1
STAT,1860,46,20-24,1906,0.009224231615575066
SIM,1880,26,45-49,1906,1
SIM,1825,44,na,1869,1460
STAT,1836,61,na,1897,1210.0659267329786
STAT,1897,16,35-39,1913,0.694932047237441
STAT,1880,29,50-100,1909,0.6325385351257932
SIM,1905,31,40-44,1936,3
SIM,1795,60,na,1855,955
SIM,1923,22,45-49,1945,1
SIM,1917,30,20-24,1947,3
STAT,1899,27,50-100,1926,0.8280195461164648
SIM,1896,1,na,1897,3385
SIM,1846,91,na,1937,37
STAT,1876,91,na,1967,170.93884644488287
SIM,1930,32,45-49,1962,2
STAT,1837,46,45-49,1883,0.16104490818975487
STAT,1865,31,35-39,1896,8.706901213250015
SIM,1859,54,na,1913,1675
SIM,1871,18,30-34,1889,2
STAT,1834,32,50-100,1866,0.7283600439503304
SIM,1818,72,na,1890,561
STAT,1854,43,40-44,1897,1.5976977854059002
STAT,1913,34,45-49,1947,1.4663959889374478
STAT,1845,45,40-44,1890,0.12235383154106624
STAT,1863,18,30-34,1881,1.363997617364154
SIM,1892,46,50-100,1938,2
STAT,1904,50,na,1954,2959.6728230580343
SIM,1903,63,na,1966,2623
SIM,1887,25,30-34,1912,30
SIM,1943,28,na,1971,3649
SIM,1928,26,40-44,1954,7
STAT,1879,25,30-34,1904,25.070647003999536
STAT,1924,20,45-49,1944,1.261713043142363
STAT,1876,16,na,1892,2471.0577948675027
SIM,1838,72,na,1910,788
STAT,1864,39,15-19,1903,0.046804698703839305
STAT,1811,51,20-24,1862,0.0023968085561049575
STAT,1911,44,35-39,1955,0.17934003926311384
STAT,1922,32,45-49,1954,1.6796159982006869
SIM,1878,37,na,1915,2375
STAT,1828,42,na,1870,1490.5841634620174
STAT,1882,20,30-34,1902,16.462057610487427
STAT,1873,37,15-19,1910,0.053802498248117024
SIM,1867,16,15-19,1883,7
SIM,1921,34,45-49,1955,1
STAT,1840,76,na,1916,621.7409025530327
STAT,1870,11,na,1881,2465.561244982705
STAT,1915,22,45-49,1937,1.0987752353200309
STAT,1875,50,35-39,1925,0.008479652645816483
SIM,1895,33,50-100,1928,6
SIM,1837,55,na,1892,1321
STAT,1833,21,50-100,1854,0.36639878919910973
SIM,1886,66,na,1952,1516
SIM,1932,34,20-24,1966,3
STAT,1899,64,na,1963,2428.5436006998566
SIM,1812,42,50-100,1854,2
STAT,1929,42,40-44,1971,0.30599412666156645
STAT,1874,43,50-100,1917,1.012345912186795
SIM,1907,18,20-24,1925,20
SIM,1949,18,25-29,1967,59
STAT,1901,40,45-49,1941,0.13881740090709235
STAT,1944,25,na,1969,3828.2472836090656
STAT,1822,32,40-44,1854,12.645219280755924
SIM,1850,11,na,1861,2239
SIM,1855,40,30-34,1895,1
STAT,1855,102,na,1957,0.2995194937646588
STAT,1821,36,40-44,1857,9.734496587003392
STAT,1845,50,50-100,1895,0.01084071982500873
STAT,1889,64,na,1953,2027.368953601136
SIM,1912,41,40-44,1953,3
STAT,1929,34,50-100,1963,0.990813522255523
SIM,1878,47,na,1925,2272
SIM,1838,62,na,1900,1205
SIM,1888,47,na,1935,2535
STAT,1807,104,na,1911,0.02480896008154476
STAT,1894,3,na,1897,3209.5116539360297
STAT,1886,46,40-44,1932,0.17132731156093978
SIM,1830,32,40-44,1862,4
STAT,1811,46,25-29,1857,0.19504790816291653
STAT,1954,18,40-44,1972,1.6328566577107495
STAT,1925,36,50-100,1961,0.4764695678543404
STAT,1827,54,35-39,1881,0.006649461346671874
STAT,1870,36,35-39,1906,6.5864589315115145
STAT,1891,35,50-100,1926,1.448590720322483
STAT,1765,95,na,1860,1.6699999851444463
SIM,1906,37,30-34,1943,2
STAT,1823,38,15-19,1861,0.08624161162078309
STAT,1923,43,15-19,1966,0.0016929333997260435
SIM,1837,26,30-34,1863,21
STAT,1882,53,45-49,1935,0.013118705693984276
SIM,1867,5,na,1872,2693
STAT,1810,56,na,1866,1061.1199832104523
SIM,1859,0,na,1859,3030
STAT,1865,7,na,1872,2399.9664988834174
SIM,1941,27,na,1968,3577
SIM,1860,7,na,1867,2385
STAT,1765,108,na,1873,0.003415256993973869
SIM,1912,36,na,1948,3425
STAT,1862,41,25-29,1903,0.5210290518966993
SIM,1935,21,25-29,1956,136
SIM,1838,25,35-39,1863,11
SIM,1899,19,15-19,1918,8
SIM,1848,17,na,1865,2091
STAT,1842,46,50-100,1888,0.1801826137692167
STAT,1847,40,30-34,1887,0.8746281998424189
STAT,1863,36,45-49,1899,1.660589173245923
SIM,1896,66,na,1962,2244
SIM,1891,35,50-100,1926,1
STAT,1904,41,40-44,1945,0.21260980050999512
STAT,1780,109,na,1889,0.002639737844841181
STAT,1894,45,35-39,1939,0.09683133816469135
STAT,1870,45,50-100,1915,0.22988177102855367
SIM,1829,26,na,1855,1648
SIM,1846,36,na,1882,1762
STAT,1864,17,35-39,1881,0.477926287353182
STAT,1822,57,na,1879,1110.480818881427
STAT,1868,17,na,1885,2317.6519375987828
STAT,1873,49,na,1922,2110.597615591611
SIM,1895,39,na,1934,2940
STAT,1885,47,35-39,1932,0.13121550135018187
SIM,1828,72,na,1900,694
STAT,1844,53,25-29,1897,0.0024205137184511697
SIM,1916,16,20-24,1932,32
STAT,1899,39,50-100,1938,0.33956118412210684
SIM,1929,40,40-44,1969,3
STAT,1792,97,na,1889,0.96734561758407
STAT,1870,40,20-24,1910,0.14866688675343745
SIM,1835,20,na,1855,1783
SIM,1840,21,na,1861,1835
SIM,1906,19,15-19,1925,8
SIM,1896,56,na,1952,2556
STAT,1881,68,na,1949,1394.6430149187283
STAT,1946,16,40-44,1962,1.466001790417236
STAT,1878,44,40-44,1922,2.184567368700431
SIM,1849,18,20-24,1867,19
STAT,1852,52,20-24,1904,5.321334341684832E-4
STAT,1866,91,na,1957,64.3846252838176
STAT,1810,48,30-34,1858,0.31775519571204147
STAT,1839,41,35-39,1880,1.4143653305517916
STAT,1929,6,na,1935,4832.054464182629
SIM,1911,47,50-100,1958,1
STAT,1898,16,50-100,1914,0.06278600403367066
STAT,1934,8,na,1942,5096.353778967388
SIM,1762,97,na,1859,3
SIM,1847,41,35-39,1888,1
STAT,1840,86,na,1926,145.6079444910055
SIM,1954,16,40-44,1970,2
STAT,1830,34,40-44,1864,3.5993658306129666
SIM,1886,44,40-44,1930,7
STAT,1808,104,na,1912,0.025789919232867883
STAT,1895,44,40-44,1939,0.18977211541850936
SIM,1848,72,na,1920,910
STAT,1828,53,40-44,1881,0.00734360525112091
STAT,1839,48,50-100,1887,0.16448488978885692
SIM,1945,18,40-44,1963,1
SIM,1868,37,na,1905,2118
STAT,1840,38,15-19,1878,0.04313648457173568
STAT,1913,33,na,1946,3539.885092130241
STAT,1845,44,na,1889,1623.3271516606321
SIM,1906,30,45-49,1936,1
STAT,1858,18,20-24,1876,15.248633587136652
STAT,1826,61,na,1887,1061.641703389885
SIM,1879,26,35-39,1905,11
STAT,1838,42,na,1880,1650.6962039529635
STAT,1890,29,15-19,1919,0.520265720325887
STAT,1829,29,35-39,1858,10.809574682907025
SIM,1919,28,40-44,1947,4
STAT,1853,44,35-39,1897,1.3519188039424896
STAT,1838,17,40-44,1855,0.1621984981553806
STAT,1820,37,35-39,1857,16.27014714453306
STAT,1943,22,20-24,1965,111.76032817148932
STAT,1880,40,50-100,1920,1.0627739110077459
STAT,1861,45,25-29,1906,0.04569512291042882
STAT,1859,16,15-19,1875,5.210289463830786
SIM,1858,19,25-29,1877,9
SIM,1926,26,na,1952,4171
STAT,1923,21,40-44,1944,3.7069919609932813
SIM,1888,37,na,1925,2651
STAT,1855,22,50-100,1877,0.33854282386935686
STAT,1869,35,15-19,1904,0.05188013913029172
SIM,1931,21,40-44,1952,6
SIM,1866,18,20-24,1884,14
STAT,1889,47,20-24,1936,0.007857574713894585
SIM,1836,91,na,1927,34
SIM,1850,41,na,1891,1746
SIM,1862,22,na,1884,2050
SIM,1837,29,35-39,1866,13
SIM,1855,5,na,1860,2418
SIM,1877,28,25-29,1905,38
STAT,1895,25,15-19,1920,0.5625704011306292
STAT,1937,18,40-44,1955,1.2821005920654092
STAT,1869,46,40-44,1915,0.15712527849916705
SIM,1924,6,na,1930,4531
STAT,1792,87,na,1879,56.63684961929992
STAT,1904,41,25-29,1945,0.060699037614638816
STAT,1818,42,na,1860,1449.7822976353866
SIM,1879,64,na,1943,1746
STAT,1922,8,na,1930,4360.558678950182
SIM,1910,11,na,1921,3710
STAT,1854,80,na,1934,442.5963812992736
STAT,1933,32,20-24,1965,3.1052854967610233
SIM,1856,91,na,1947,28
STAT,1903,42,35-39,1945,0.16881451297142522
STAT,1863,37,50-100,1900,1.017819981493666
STAT,1914,31,40-44,1945,3.736603579486015
STAT,1855,19,35-39,1874,0.4583324598568538
STAT,1900,6,na,1906,3423.505915571776
SIM,1903,53,na,1956,2851
STAT,1914,45,15-19,1959,3.4676261300168405E-4
STAT,1838,24,30-34,1862,15.293030582639012
STAT,1890,47,45-49,1937,0.15303646401387497
STAT,1938,17,45-49,1955,0.46552268356673915
STAT,1911,47,50-100,1958,0.20228966317719813
STAT,1869,34,na,1903,2165.2287893521498
STAT,1908,32,na,1940,3372.604084940396
SIM,1875,19,na,1894,2449
STAT,1811,47,35-39,1858,0.46632056667301597
STAT,1772,97,na,1869,0.8005050036784711
SIM,1821,34,40-44,1855,3
STAT,1908,16,20-24,1924,24.90564531586355
STAT,1930,34,45-49,1964,1.9159320044963863
SIM,1903,28,50-100,1931,2
STAT,1892,20,na,1912,2815.141617301001
SIM,1846,24,30-34,1870,19
STAT,1828,34,15-19,1862,0.13757287883414712
STAT,1835,75,na,1910,655.2278851465801
STAT,1884,48,30-34,1932,0.08921025175408166
STAT,1848,46,20-24,1894,0.008942012796575171
STAT,1918,28,50-100,1946,0.997176641129284
SIM,1894,20,15-19,1914,3
STAT,1905,14,na,1919,3514.9854287464536
STAT,1916,51,na,1967,3514.3855408350382
SIM,1885,38,50-100,1923,1
STAT,1784,78,na,1862,274.5279948460132
SIM,1922,31,40-44,1953,7
STAT,1886,20,15-19,1906,3.311773080285843
STAT,1928,28,40-44,1956,5.422033225383869
SIM,1936,28,40-44,1964,3
SIM,1845,43,40-44,1888,8
SIM,1894,31,na,1925,3003
STAT,1877,53,na,1930,2076.085900543054
STAT,1880,25,40-44,1905,3.0036267926529243
STAT,1889,34,na,1923,2759.2195331357357
SIM,1848,92,na,1940,23
STAT,1910,48,35-39,1958,0.11332637842408094
SIM,1915,20,45-49,1935,3
STAT,1837,43,40-44,1880,1.7006370648170275
STAT,1838,19,35-39,1857,0.4808802527184896
STAT,1927,23,na,1950,4237.165677105375
STAT,1860,47,30-34,1907,0.07385222112903991
STAT,1862,77,na,1939,698.1855576791413
STAT,1869,23,50-100,1892,0.3720522750106243
SIM,1828,62,na,1890,1078
STAT,1832,22,50-100,1854,0.5879043299749878
STAT,1858,50,35-39,1908,0.006468204648111066
STAT,1904,19,40-44,1923,0.24651482329324134
STAT,1794,78,na,1872,308.14761685472627
SIM,1862,24,15-19,1886,5
STAT,1824,38,na,1862,1563.7349567754638
STAT,1870,35,25-29,1905,2.6936699163236253
STAT,1907,45,50-100,1952,0.1941708924080644
SIM,1895,27,30-34,1922,38
STAT,1854,90,na,1944,56.40924494749371
SIM,1875,40,na,1915,2269
SIM,1917,29,50-100,1946,1
SIM,1828,36,30-34,1864,9
SIM,1856,47,50-100,1903,2
STAT,1824,30,35-39,1854,34.96600195286363
STAT,1883,49,na,1932,2040.3237654739655
SIM,1809,101,na,1910,1
STAT,1826,71,na,1897,728.9117820079606
SIM,1925,32,20-24,1957,1
STAT,1877,52,25-29,1929,0.003452463559771932
STAT,1887,0,na,1887,3327.056789593229
STAT,1835,48,35-39,1883,0.0927271107306811
SIM,1873,44,50-100,1917,1
STAT,1801,65,na,1866,775.2201299060049
STAT,1823,46,15-19,1869,4.997944913687532E-4
STAT,1845,48,45-49,1893,0.16490204039065556
SIM,1832,77,na,1909,484
STAT,1860,76,na,1936,726.194067841781
STAT,1909,33,25-29,1942,8.297353570062795
STAT,1903,33,na,1936,3221.198690127105
STAT,1956,1,na,1957,4921.421404896152
SIM,1915,45,50-100,1960,1
STAT,1775,95,na,1870,2.2528128662071905
SIM,1921,31,40-44,1952,11
STAT,1921,41,40-44,1962,0.2665230054359185
STAT,1874,36,20-24,1910,0.7476224971075537
STAT,1880,18,30-34,1898,1.5832311826252845
STAT,1852,45,30-34,1897,0.0708783211317896
STAT,1910,30,45-49,1940,1.4449143311238188
STAT,1856,33,50-100,1889,0.6765509992359312
STAT,1905,32,45-49,1937,1.3672733082648965
STAT,1912,43,25-29,1955,0.0646749002537391
SIM,1836,27,25-29,1863,32
STAT,1885,82,na,1967,739.6845762001781
SIM,1846,27,35-39,1873,10
SIM,1936,26,na,1962,2798
STAT,1843,54,20-24,1897,4.8471884865335763E-4
STAT,1923,35,15-19,1958,0.02105623637734187
STAT,1895,18,25-29,1913,6.96085004879257
STAT,1933,35,25-29,1968,1.2691261377448926
SIM,1940,22,45-49,1962,4
STAT,1856,16,na,1872,2012.4376592025617
STAT,1824,105,na,1929,0.0161670328336574
STAT,1913,49,15-19,1962,3.3768257368694437E-4
STAT,1911,43,25-29,1954,0.06400268074733828
SIM,1821,42,40-44,1863,5
SIM,1853,93,na,1946,12
SIM,1949,13,na,1962,4243
STAT,1860,11,na,1871,2120.0175276135833
SIM,1832,30,35-39,1862,8
STAT,1916,18,20-24,1934,27.10230073328577
STAT,1817,51,50-100,1868,0.03328297210194687
STAT,1932,33,15-19,1965,0.16127905271854118
STAT,1880,33,40-44,1913,4.3008605991155
STAT,1845,85,na,1930,193.98542890558232
STAT,1870,33,30-34,1903,16.11270636295868
STAT,1939,24,na,1963,3462.276455664849
STAT,1880,52,50-100,1932,0.014961281884125174
STAT,1838,27,35-39,1865,8.240282742447766
STAT,1813,42,40-44,1855,7.357145461402624
STAT,1828,27,25-29,1855,73.03737201302017
SIM,1880,23,40-44,1903,3
SIM,1931,27,na,1958,4520
SIM,1933,28,na,1961,4733
STAT,1869,54,40-44,1923,0.00936984327663498
STAT,1859,54,30-34,1913,0.004352587692164099
STAT,1931,22,45-49,1953,1.378591396205249
STAT,1822,35,45-49,1857,3.8862059387753183
STAT,1811,43,20-24,1854,0.5788341000626869
STAT,1852,48,35-39,1900,0.10022274950645184
STAT,1903,45,40-44,1948,0.13110031622751198
STAT,1760,96,na,1856,1.1242930572
STAT,1913,31,40-44,1944,3.6933081629202946
SIM,1949,15,20-24,1964,135
SIM,1882,0,na,1882,3178
STAT,1788,82,na,1870,148.0456308216189
STAT,1850,20,35-39,1870,5.008989070852963
STAT,1900,46,na,1946,2957.3472679887423
STAT,1873,30,30-34,1903,16.862873219598626
STAT,1876,16,15-19,1892,5.806375655806895
STAT,1846,61,na,1907,1385.9741178595136
STAT,1893,46,30-34,1939,0.0656019461636907
SIM,1921,27,na,1948,3962
SIM,1891,67,na,1958,1934
STAT,1886,36,na,1922,2362.369847614949
SIM,1876,66,na,1942,1583
SIM,1813,63,na,1876,917
STAT,1863,33,40-44,1896,3.580041171039144
STAT,1778,82,na,1860,144.35088919791258
SIM,1941,22,50-100,1963,3
STAT,1891,21,35-39,1912,6.840990994930133
SIM,1923,37,30-34,1960,1
STAT,1843,47,30-34,1890,0.06507842048595776
STAT,1909,58,na,1967,3025.4038072001263
SIM,1928,29,45-49,1957,3
STAT,1813,53,50-100,1866,0.03870225145312687
STAT,1830,41,15-19,1871,0.010894053246642967
SIM,1806,101,na,1907,1
SIM,1883,38,na,1921,2157
STAT,1854,24,15-19,1878,2.7337068230646806
SIM,1823,73,na,1896,606
SIM,1830,35,45-49,1865,1
STAT,1875,10,na,1885,2560.7643700616572
STAT,1917,32,20-24,1949,2.412952464999888
SIM,1959,0,na,1959,4886
STAT,1906,43,15-19,1949,0.001309936677842891
STAT,1894,65,na,1959,2146.731375304068
STAT,1940,21,40-44,1961,3.236839380525829
SIM,1888,42,35-39,1930,3
STAT,1836,51,25-29,1887,0.002367230491331564
STAT,1846,18,30-34,1864,1.4763086457369736
SIM,1854,18,30-34,1872,1
STAT,1833,43,na,1876,1542.8976373720031
STAT,1876,49,35-39,1925,0.13378771905257297
STAT,1906,32,45-49,1938,1.3776962822043555
SIM,1887,17,30-34,1904,2
STAT,1886,49,45-49,1935,0.23058964869970597
STAT,1915,44,20-24,1959,0.01674110108078903
SIM,1937,16,40-44,1953,1
STAT,1888,44,50-100,1932,1.16355314265355
SIM,1869,44,40-44,1913,5
STAT,1863,40,15-19,1903,0.011564107926042818
STAT,1887,27,30-34,1914,26.609318076082015
SIM,1910,55,na,1965,3116
SIM,1914,32,45-49,1946,2
SIM,1881,30,30-34,1911,19
STAT,1833,35,20-24,1868,0.6037252748274188
STAT,1911,36,35-39,1947,2.217693339211498
STAT,1854,28,30-34,1882,18.75235927342348
SIM,1872,33,50-100,1905,4
SIM,1908,17,25-29,1925,11
SIM,1807,79,na,1886,259
SIM,1931,39,30-34,1970,4
STAT,1853,94,na,1947,15.125386249935886
SIM,1837,45,na,1882,1566
STAT,1878,47,45-49,1925,0.231263648586636
STAT,1854,17,25-29,1871,4.850100675092918
STAT,1871,42,15-19,1913,0.012938669357346668
STAT,1902,21,20-24,1923,92.15368582734183
STAT,1946,19,45-49,1965,0.5230747041886054
SIM,1838,17,na,1855,1983
SIM,1843,93,na,1936,21
STAT,1841,52,45-49,1893,0.00995176936987274
STAT,1904,15,25-29,1919,7.7144131767071995
SIM,1828,29,40-44,1857,2
SIM,1895,19,30-34,1914,4
SIM,1873,31,35-39,1904,12
STAT,1785,95,na,1880,2.6080679672490525
STAT,1841,26,15-19,1867,0.39130729005097775
STAT,1864,47,15-19,1911,3.3521830460360794E-4
STAT,1915,37,30-34,1952,1.739376240880094
STAT,1846,26,30-34,1872,22.758577604636947
SIM,1908,62,na,1970,2792
SIM,1916,19,25-29,1935,59
SIM,1862,28,30-34,1890,23
STAT,1872,77,na,1949,819.0783390600881
STAT,1901,21,20-24,1922,91.40099091952322
SIM,1845,19,na,1864,2000
STAT,1900,48,40-44,1948,0.12496661159619515
SIM,1862,17,25-29,1879,5
STAT,1888,41,30-34,1929,1.2893527848016482
STAT,1860,54,20-24,1914,5.500681075055533E-4
SIM,1862,43,40-44,1905,9
STAT,1828,52,na,1880,1299.3915324563534
STAT,1901,47,30-34,1948,0.07186755763195891
STAT,1885,44,30-34,1929,1.06796493329216
SIM,1828,28,30-34,1856,21
SIM,1870,41,na,1911,2135
SIM,1909,31,25-29,1940,12
SIM,1939,13,na,1952,3691
SIM,1912,15,25-29,1927,12
STAT,1818,53,30-34,1871,0.011943349489950173
STAT,1836,71,na,1907,864.372254552845
STAT,1919,48,na,1967,3753.888893381446
STAT,1923,39,30-34,1962,1.9907251947998346
STAT,1921,33,40-44,1954,4.096703359009926
SIM,1845,10,na,1855,2134
STAT,1888,17,na,1905,2819.7084580287474
STAT,1882,45,45-49,1927,0.21897839652233156
SIM,1855,74,na,1929,814
SIM,1815,44,na,1859,1463
SIM,1870,34,35-39,1904,8
SIM,1870,19,25-29,1889,6
SIM,1846,16,30-34,1862,1
SIM,1939,29,20-24,1968,12
STAT,1850,76,na,1926,667.8469905825419
SIM,1776,79,na,1855,239
SIM,1910,21,20-24,1931,83
SIM,1822,46,na,1868,1418
STAT,1862,19,25-29,1881,4.714354526637623
STAT,1854,35,na,1889,1711.4589548010642
STAT,1803,52,25-29,1855,0.01032091731192787
STAT,1877,45,35-39,1922,0.13855858519102038
STAT,1910,36,50-100,1946,0.3811770524545615
SIM,1924,18,20-24,1942,151
SIM,1808,96,na,1904,2
SIM,1822,77,na,1899,439
STAT,1898,30,35-39,1928,13.05070667973404
SIM,1870,33,25-29,1903,10
STAT,1823,105,na,1928,0.015691870356637747
STAT,1830,37,45-49,1867,1.620041848293175
SIM,1893,14,na,1907,3221
STAT,1887,19,30-34,1906,1.6751847072307924
STAT,1922,33,40-44,1955,4.159414810919561
SIM,1858,18,15-19,1876,5
STAT,1861,38,35-39,1899,5.528132661989224
STAT,1939,31,45-49,1970,1.517641496346939
STAT,1866,16,na,1882,2272.134885007559
STAT,1870,43,25-29,1913,0.5908272186324856
SIM,1854,26,30-34,1880,23
STAT,1770,96,na,1866,1.0943690048792516
STAT,1879,18,40-44,1897,0.18039405768355316
STAT,1906,31,na,1937,3324.795274150115
STAT,1844,80,na,1924,429.62977593343186
STAT,1908,19,25-29,1927,7.898721705210711
STAT,1895,29,30-34,1924,30.79233213360177
SIM,1887,28,35-39,1915,14
STAT,1917,17,50-100,1934,0.07616477481769396
SIM,1836,38,30-34,1874,5
STAT,1838,16,30-34,1854,1.4218185100315184
STAT,1923,46,20-24,1969,0.012243127790530895
SIM,1913,53,na,1966,3193
STAT,1859,16,50-100,1875,0.04301283772287979
STAT,1953,16,50-100,1969,0.4282581781760982
SIM,1872,22,na,1894,2251
SIM,1819,35,50-100,1854,1
STAT,1867,53,na,1920,1879.360263030252
STAT,1872,16,30-34,1888,1.524260319197554
SIM,1842,56,na,1898,1361
STAT,1941,27,30-34,1968,38.29139504110297
STAT,1811,44,30-34,1855,4.021521292190748
STAT,1815,54,45-49,1869,0.03013312793419413
STAT,1913,42,45-49,1955,0.15332926016197138
STAT,1882,3,na,1885,2747.774163638529
SIM,1844,29,25-29,1873,48
STAT,1853,63,na,1916,1350.3545467955175
STAT,1932,22,45-49,1954,1.3946624704115533
SIM,1884,1,na,1885,3002
STAT,1828,38,30-34,1866,4.757662334147647
STAT,1821,40,25-29,1861,1.1719786312198484
STAT,1951,4,na,1955,4424.022992627631
STAT,1935,20,20-24,1955,143.14297181239456
SIM,1880,16,30-34,1896,5
STAT,1873,32,50-100,1905,0.8778681233582173
SIM,1839,98,na,1937,2
STAT,1879,34,na,1913,2339.5557190854347
STAT,1906,51,na,1957,3010.5220430513414
STAT,1879,28,35-39,1907,9.507980383613875
SIM,1913,32,45-49,1945,2
STAT,1924,37,50-100,1961,0.4676920918008026
STAT,1917,40,50-100,1957,0.11614262284947438
STAT,1833,33,50-100,1866,0.716317159291134
STAT,1836,29,25-29,1865,34.9386852522279
STAT,1856,15,35-39,1871,0.483909122712256
SIM,1858,92,na,1950,25
STAT,1907,45,25-29,1952,0.04553845001548893
SIM,1943,20,20-24,1963,109
STAT,1894,48,40-44,1942,0.11576889011439884
STAT,1890,37,15-19,1927,0.06485659930383676
STAT,1949,17,20-24,1966,148.96326771920755
STAT,1931,37,15-19,1968,0.024025357351272703
STAT,1913,19,50-100,1932,0.07197951376012171
STAT,1821,33,35-39,1854,31.750458871052604
STAT,1882,27,15-19,1909,0.41682349382652983
STAT,1782,97,na,1879,0.8132908912452411
STAT,1918,32,na,1950,3796.7229220407576
STAT,1871,38,45-49,1909,1.8607592866912086
STAT,1878,17,na,1895,2486.511262567921
SIM,1869,64,na,1933,1553
SIM,1841,33,50-100,1874,3
SIM,1885,40,na,1925,2226
STAT,1846,19,40-44,1865,0.16841463482356314
STAT,1864,90,na,1954,66.38153277196102
STAT,1844,50,20-24,1894,5.19867368376191E-4
STAT,1855,75,na,1930,731.563216029297
STAT,1902,36,50-100,1938,0.35500344990956106
SIM,1828,39,35-39,1867,14
STAT,1911,40,20-24,1951,0.016104673228502113
STAT,1913,42,50-100,1955,0.10823241862770823
STAT,1804,83,na,1887,140.21144343394258
SIM,1911,20,25-29,1931,92
STAT,1810,44,15-19,1854,0.048283788104805235
STAT,1830,30,25-29,1860,9.078915772511587
SIM,1927,26,25-29,1953,90
STAT,1847,56,na,1903,1504.040893643416
STAT,1912,46,45-49,1958,0.19781813062774856
STAT,1829,68,na,1897,923.3912956949671
STAT,1870,32,20-24,1902,2.5050901963797965
SIM,1886,18,25-29,1904,7
STAT,1818,50,50-100,1868,0.0321714976131286
SIM,1801,85,na,1886,83
SIM,1844,58,na,1902,1310
SIM,1850,75,na,1925,750
STAT,1922,40,30-34,1962,0.1390102472971613
STAT,1844,31,15-19,1875,0.11950898637697108
SIM,1824,68,na,1892,771
STAT,1813,45,45-49,1858,0.6667368917350057
STAT,1853,47,40-44,1900,0.12895946543516584
STAT,1915,33,15-19,1948,0.12311936243681634
STAT,1859,88,na,1947,103.22223030052494
STAT,1852,102,na,1954,0.21254783847047973
STAT,1857,51,45-49,1908,0.010864367945311747
STAT,1837,24,15-19,1861,2.7627489928102085
STAT,1827,46,35-39,1873,0.12976543768975557
SIM,1887,33,50-100,1920,4
STAT,1847,22,50-100,1869,0.36863819914352747
STAT,1903,20,25-29,1923,77.40592626543
STAT,1869,28,25-29,1897,38.577541458473824
SIM,1920,32,35-39,1952,11
STAT,1827,56,na,1883,1247.6837782571308
STAT,1836,19,na,1855,1961.8561412182162
STAT,1878,48,na,1926,2187.182853926044
STAT,1884,46,50-100,1930,0.22987437579572728
STAT,1923,32,45-49,1955,1.704160816875704
SIM,1900,34,25-29,1934,16
STAT,1880,52,na,1932,2132.998946849136
STAT,1891,36,20-24,1927,0.905290055266936
STAT,1834,90,na,1924,48.87877982718419
STAT,1844,43,30-34,1887,0.8073581733490302
STAT,1903,34,35-39,1937,7.749274654253118
STAT,1835,45,30-34,1880,0.07321576176349026
STAT,1950,5,na,1955,4391.985589866332
SIM,1801,95,na,1896,6
STAT,1897,42,35-39,1939,0.1586704788625852
STAT,1824,45,20-24,1869,0.015050319718318803
STAT,1908,42,20-24,1950,0.015435950365002164
SIM,1824,58,na,1882,1141
STAT,1823,53,40-44,1876,0.012232009541451717
STAT,1912,32,35-39,1944,8.495079905141264
STAT,1921,44,45-49,1965,0.176496517078143
SIM,1930,33,40-44,1963,5
STAT,1834,28,na,1862,1745.905892452386
SIM,1845,24,15-19,1869,2
STAT,1885,50,45-49,1935,0.013861900660655433
STAT,1900,40,45-49,1940,0.13757473210656776
STAT,1931,31,40-44,1962,4.846878527413045
SIM,1911,34,35-39,1945,15
STAT,1890,44,40-44,1934,2.5627707896423386
SIM,1863,38,na,1901,1958
STAT,1886,42,25-29,1928,0.6400262276202618
STAT,1855,85,na,1940,194.807239536705
STAT,1823,43,na,1866,1457.4649589207395
STAT,1853,43,25-29,1896,0.48247133189320696
STAT,1935,31,25-29,1966,12.086855168314914
STAT,1835,52,20-24,1887,4.786350076374669E-4
SIM,1950,21,na,1971,3957
STAT,1890,30,30-34,1920,20.327468930370415
SIM,1855,20,na,1875,2049
STAT,1891,37,na,1928,2753.621909287108
SIM,1871,57,na,1928,1915
STAT,1883,35,50-100,1918,1.1479514277027048
STAT,1880,40,15-19,1920,0.01389247044010963
STAT,1836,44,35-39,1880,1.35970348414001
SIM,1931,32,45-49,1963,3
STAT,1887,33,50-100,1920,0.9640965606387929
SIM,1873,38,na,1911,2274
STAT,1783,83,na,1866,110.44921410540756
SIM,1868,16,15-19,1884,4
SIM,1816,39,na,1855,1480
STAT,1800,80,na,1880,260.032458191776
STAT,1813,43,na,1856,1310.9207369820379
STAT,1846,16,na,1862,2151.4037127019924
STAT,1862,45,40-44,1907,0.13966001932023245
STAT,1876,46,30-34,1922,0.09474550312743066
SIM,1894,17,20-24,1911,17
STAT,1884,55,na,1939,1929.839906200599
STAT,1903,41,25-29,1944,0.06021059202968659
SIM,1881,67,na,1948,1191
STAT,1934,32,20-24,1966,3.1460917418315537
STAT,1880,36,45-49,1916,1.9949386628026238
STAT,1831,48,15-19,1879,2.81321035598396E-4
STAT,1812,46,40-44,1858,0.5827852873274526
SIM,1844,44,35-39,1888,2
SIM,1823,44,50-100,1867,4
SIM,1859,23,na,1882,1990
SIM,1859,33,na,1892,1914
STAT,1821,62,na,1883,1015.0350589471705
SIM,1861,36,35-39,1897,9
SIM,1873,48,na,1921,2151
SIM,1871,67,na,1938,1467
STAT,1874,43,45-49,1917,1.4341567130410533
SIM,1882,43,45-49,1925,1
STAT,1893,1,na,1894,3260.8713215861726
STAT,1853,36,35-39,1889,5.408630741858826
STAT,1841,21,50-100,1862,0.3587183888765319
STAT,1868,51,20-24,1919,6.683001557455284E-4
STAT,1885,32,15-19,1917,0.13409727047892733
STAT,1929,16,40-44,1945,1.6904075062612822
STAT,1841,30,35-39,1871,8.648669036387219
STAT,1891,40,40-44,1931,2.6554380632326895
STAT,1906,47,30-34,1953,0.07477858087223593
STAT,1808,76,na,1884,402.4284448569529
SIM,1902,67,na,1969,2345
STAT,1883,18,na,1901,2333.1213238272494
STAT,1919,26,25-29,1945,67.41554650162561
SIM,1771,91,na,1862,9
SIM,1869,23,na,1892,2201
STAT,1818,41,15-19,1859,0.03368279191645199
STAT,1864,40,30-34,1904,0.977755561977622
SIM,1887,52,na,1939,2219
SIM,1917,12,na,1929,4023
STAT,1868,47,35-39,1915,0.1255996017606571
SIM,1850,40,45-49,1890,2
STAT,1852,23,na,1875,1828.2403241372942
STAT,1871,92,na,1963,94.69456296526472
STAT,1837,17,25-29,1854,6.947401929567118
STAT,1827,53,25-29,1880,0.003066567715435994
STAT,1901,52,na,1953,2832.144107229858
STAT,1871,54,30-34,1925,0.005430367625931923
STAT,1919,19,35-39,1938,4.3571345270907145
SIM,1909,1,na,1910,3784
STAT,1864,54,40-44,1918,0.008620230105023361
SIM,1833,73,na,1906,677
STAT,1900,33,20-24,1933,3.527421760622581
SIM,1966,3,na,1969,4462
STAT,1795,61,na,1856,964.3423882459998
STAT,1850,35,20-24,1885,0.5635776549781103
STAT,1856,41,35-39,1897,1.3407498845039745
SIM,1805,54,na,1859,1128
STAT,1873,18,na,1891,2413.479853679903
SIM,1889,7,na,1896,3156
STAT,1821,72,na,1893,672.8276002463051
STAT,1834,38,na,1872,1634.5707324401435
STAT,1868,18,15-19,1886,5.413833362180319
SIM,1845,17,25-29,1862,6
SIM,1836,60,na,1896,1191
STAT,1838,53,35-39,1891,0.00568703541684039
SIM,1927,19,35-39,1946,7
STAT,1926,40,15-19,1966,0.0017933924858496001
SIM,1796,76,na,1872,357
SIM,1923,7,na,1930,4485
STAT,1873,52,40-44,1925,0.010032996683600083
SIM,1932,1,na,1933,5089
STAT,1842,40,45-49,1882,1.1504545268904038
STAT,1911,33,30-34,1944,14.432675057982783
STAT,1877,30,15-19,1907,0.14067193857948593
STAT,1845,41,25-29,1886,0.46869948372176806
STAT,1945,16,25-29,1961,44.73272265968369
SIM,1880,19,35-39,1899,1
STAT,1856,52,40-44,1908,0.007718387869125064
STAT,1886,17,20-24,1903,17.69148569296909
SIM,1953,16,25-29,1969,47
SIM,1859,18,15-19,1877,7
STAT,1822,54,35-39,1876,0.010706000760991121
STAT,1872,19,35-39,1891,0.5171559500250167
SIM,1889,40,50-100,1929,2
STAT,1874,89,na,1963,212.56813061782202
SIM,1911,7,na,1918,3756
STAT,1921,41,25-29,1962,0.07609098871884251
STAT,1870,52,na,1922,1984.8495339578442
STAT,1837,56,na,1893,1323.6896919545775
STAT,1892,46,15-19,1938,2.6773846910208455E-4
STAT,1928,7,na,1935,4758.062352626649
STAT,1815,51,40-44,1866,0.02320779668859935
STAT,1915,30,45-49,1945,1.5261904493914547
SIM,1913,41,40-44,1954,2
STAT,1845,16,20-24,1861,15.950008625592414
STAT,1883,41,45-49,1924,1.392480403034959
STAT,1920,45,40-44,1965,0.16541667444879424
SIM,1944,23,40-44,1967,3
STAT,1941,23,15-19,1964,5.19512519336353
STAT,1847,51,35-39,1898,0.006378757187963273
STAT,1859,42,15-19,1901,0.010370696217478123
STAT,1910,41,15-19,1951,0.0013790221096999513
SIM,1925,41,na,1966,4216
SIM,1815,98,na,1913,1
STAT,1894,37,35-39,1931,8.586876522100352
SIM,1871,36,45-49,1907,3
STAT,1832,51,40-44,1883,0.006750646141024769
STAT,1878,25,15-19,1903,0.44970991708419444
SIM,1870,30,20-24,1900,2
STAT,1920,31,30-34,1951,16.36934890115169
STAT,1821,44,40-44,1865,3.649392908762246
SIM,1821,92,na,1913,23
SIM,1837,86,na,1923,101
SIM,1854,29,35-39,1883,10
STAT,1825,47,50-100,1872,0.25053385043944076
STAT,1811,54,25-29,1865,0.010833406969325457
STAT,1861,37,na,1898,1850.58977585756
STAT,1900,26,30-34,1926,33.114242865033304
SIM,1786,79,na,1865,260
SIM,1926,28,50-100,1954,2
STAT,1920,12,na,1932,4199.539408820155
STAT,1870,42,na,1912,2139.3304193081635
STAT,1848,53,45-49,1901,0.010610424001069528
SIM,1868,92,na,1960,47
STAT,1816,95,na,1911,6.195743307607282
SIM,1891,41,45-49,1932,6
SIM,1918,52,na,1970,3627
STAT,1905,41,40-44,1946,0.21424753309399297
SIM,1923,30,45-49,1953,4
STAT,1936,23,40-44,1959,3.0357048839839376
SIM,1811,95,na,1906,5
SIM,1847,48,50-100,1895,1
SIM,1945,9,na,1954,3895
SIM,1810,47,50-100,1857,2
STAT,1861,35,30-34,1896,4.226072766523506
STAT,1846,29,35-39,1875,8.533894359424014
STAT,1882,42,40-44,1924,2.0639001398105625
SIM,1869,15,20-24,1884,20
STAT,1842,57,na,1899,1455.3391795720486
STAT,1926,33,25-29,1959,10.551017396162699
STAT,1816,50,45-49,1866,0.034158012680913556
SIM,1896,15,30-34,1911,2
SIM,1903,32,35-39,1935,7
SIM,1794,98,na,1892,2
SIM,1879,33,na,1912,2399
SIM,1934,33,25-29,1967,12
SIM,1837,76,na,1913,566
SIM,1853,16,20-24,1869,20
STAT,1839,68,na,1907,1017.4712380973292
STAT,1851,45,15-19,1896,2.906055554957882E-4
STAT,1846,52,30-34,1898,0.004391525157913563
STAT,1854,46,45-49,1900,0.16933387469088423
STAT,1894,44,25-29,1938,0.05340698784087018
STAT,1888,15,30-34,1903,1.7877403873604572
SIM,1928,18,40-44,1946,1
STAT,1832,47,20-24,1879,0.00857473462111289
STAT,1862,34,35-39,1896,8.10978657147911
STAT,1924,42,20-24,1966,0.0198441733422414
SIM,1890,42,40-44,1932,5
STAT,1862,26,50-100,1888,0.5223466140370535
STAT,1894,30,15-19,1924,0.1742796742697315
STAT,1870,47,40-44,1917,0.15792184372989057
STAT,1916,44,20-24,1960,0.01704011398509172
SIM,1855,19,na,1874,2176
SIM,1928,35,50-100,1963,1
STAT,1922,47,15-19,1969,3.9978319111884137E-4
STAT,1858,17,50-100,1875,0.04238847760583849
STAT,1944,21,25-29,1965,94.24713108559179
STAT,1845,34,35-39,1879,8.345520441176959
STAT,1926,30,20-24,1956,2.789328501853507
STAT,1913,43,40-44,1956,0.23007192737247845
SIM,1826,91,na,1917,31
STAT,1936,30,30-34,1966,14.4727722105359
STAT,1889,40,35-39,1929,2.133179912484679
STAT,1927,5,na,1932,4722.766876667802
SIM,1781,91,na,1872,14
STAT,1846,71,na,1917,990.0266973391745
STAT,1881,39,15-19,1920,0.05073123965815591
SIM,1918,33,40-44,1951,8
SIM,1774,98,na,1872,1
SIM,1798,57,na,1855,1031
STAT,1878,40,25-29,1918,0.6385961240628379
STAT,1912,43,40-44,1955,0.2265360075105225
STAT,1902,43,30-34,1945,0.10567006797616908
SIM,1862,12,na,1874,2350
STAT,1831,41,30-34,1872,0.8603399441582592
STAT,1931,34,45-49,1965,1.9453194040155708
SIM,1911,31,30-34,1942,15
STAT,1868,54,25-29,1922,0.0031047719433103106
STAT,1941,20,45-49,1961,1.0992252497907173
STAT,1840,53,40-44,1893,0.006797921585498847
STAT,1873,48,20-24,1921,0.011352909184721656
STAT,1832,57,na,1889,1215.1363413863771
STAT,1882,23,na,1905,2166.0925179570104
STAT,1877,63,na,1940,1748.501559121291
STAT,1893,69,na,1962,1933.3644780430677
STAT,1809,104,na,1913,0.026766201182215347
SIM,1845,20,na,1865,1888
STAT,1871,35,40-44,1906,4.145413242704652
STAT,1905,45,na,1950,3103.3498214849483
SIM,1861,33,30-34,1894,19
SIM,1847,86,na,1933,135
SIM,1853,34,35-39,1887,9
SIM,1900,31,20-24,1931,3
STAT,1844,46,35-39,1890,0.09750937965093467
STAT,1847,47,15-19,1894,2.9358751739846743E-4
STAT,1899,10,na,1909,3352.92493738765
SIM,1962,8,na,1970,4631
STAT,1851,49,30-34,1900,0.0681785271952915
STAT,1860,1,na,1861,2806.3670449237607
STAT,1853,40,20-24,1893,0.12140183897818098
STAT,1865,53,45-49,1918,0.012226968715639051
STAT,1852,57,na,1909,1456.954859554174
STAT,1862,23,na,1885,1941.5054434276235
STAT,1911,52,na,1963,3230.463237723743
SIM,1907,12,na,1919,3584
SIM,1900,35,na,1935,3181
SIM,1874,41,45-49,1915,2
SIM,1812,44,40-44,1856,3
SIM,1864,41,35-39,1905,1
SIM,1826,39,50-100,1865,2
SIM,1832,46,na,1878,1430
STAT,1918,31,25-29,1949,9.316398328045484
SIM,1819,57,na,1876,1150
SIM,1817,51,50-100,1868,1
STAT,1952,20,20-24,1972,126.38414548345919
STAT,1862,48,45-49,1910,0.18822640743518473
STAT,1867,22,na,1889,2106.62552210267
STAT,1911,22,25-29,1933,82.76090111664637
SIM,1842,87,na,1929,93
STAT,1903,31,30-34,1934,23.56442565582014
SIM,1826,39,na,1865,1474
SIM,1868,27,20-24,1895,10
STAT,1818,39,50-100,1857,3.2483647091741434
STAT,1809,51,50-100,1860,0.04142022279625931
STAT,1764,108,na,1872,0.0031650101884102377
SIM,1936,16,25-29,1952,39
STAT,1854,102,na,1956,0.25247171413754177
STAT,1934,25,na,1959,4764.909677786091
STAT,1832,105,na,1937,0.017662813664481723
SIM,1876,18,15-19,1894,4
STAT,1877,22,na,1899,2317.5930793917696
STAT,1840,41,50-100,1881,0.7325430910754763
STAT,1864,89,na,1953,88.45210101796319
STAT,1861,42,20-24,1903,0.12459201243916866
STAT,1853,33,30-34,1886,13.466551747377858
STAT,1904,44,45-49,1948,0.13892974236556208
SIM,1815,54,na,1869,1245
STAT,1811,62,na,1873,958.8405252285153
STAT,1906,34,50-100,1940,0.717676790400087
STAT,1886,35,35-39,1921,7.125173851547134
STAT,1812,42,25-29,1854,2.4534872812960486
SIM,1901,31,20-24,1932,5
SIM,1820,35,35-39,1855,11
SIM,1948,19,20-24,1967,140
STAT,1814,48,15-19,1862,0.0012032198224677822
STAT,1786,105,na,1891,0.013776979633212394
STAT,1899,15,40-44,1914,0.23785018598041274
STAT,1896,36,na,1932,2953.666474111855
STAT,1894,55,na,1949,2510.3065475718895
STAT,1904,59,na,1963,2792.386389115086
STAT,1879,88,na,1967,331.56437858930576
STAT,1880,51,20-24,1931,7.384359528097682E-4
SIM,1957,9,na,1966,4912
SIM,1866,3,na,1869,2698
STAT,1819,44,35-39,1863,3.552476185112001
SIM,1813,73,na,1886,502
SIM,1864,78,na,1942,636
SIM,1775,84,na,1859,81
SIM,1894,35,35-39,1929,12
STAT,1814,83,na,1897,182.46555468525509
SIM,1921,43,40-44,1964,1
STAT,1881,37,na,1918,2150.0800791774923
SIM,1800,55,na,1855,1037
SIM,1884,85,na,1969,541
STAT,1878,6,na,1884,2657.0513554358113
SIM,1873,6,na,1879,2620
SIM,1914,34,50-100,1948,3
STAT,1922,37,na,1959,4044.1418115928595
STAT,1838,50,30-34,1888,0.004135680790906419
STAT,1867,18,15-19,1885,5.350107287072267
STAT,1824,52,45-49,1876,0.017030953275733913
STAT,1899,54,na,1953,2710.497846955995
STAT,1874,40,40-44,1914,2.1929603934101434
STAT,1888,48,15-19,1936,2.487424672996373E-4
SIM,1845,28,30-34,1873,30
STAT,1829,26,30-34,1855,44.85817785636102
STAT,1892,46,50-100,1938,0.1643915581242822
SIM,1932,33,na,1965,4677
STAT,1847,17,35-39,1864,0.5050082281301512
SIM,1823,40,35-39,1863,4
STAT,1881,54,40-44,1935,0.009343398664598566
STAT,1875,41,na,1916,2254.402408981023
STAT,1869,88,na,1957,155.7267749723336
STAT,1872,52,50-100,1924,0.014234837030065665
STAT,1929,19,45-49,1948,0.5990080361059277
SIM,1859,18,30-34,1877,1
STAT,1868,44,30-34,1912,1.0222570423129054
STAT,1845,75,na,1920,728.4770554240698
STAT,1853,102,na,1955,0.2218736967661124
SIM,1890,31,35-39,1921,12
STAT,1854,54,30-34,1908,0.004141841421497431
SIM,1853,19,25-29,1872,9
STAT,1927,43,35-39,1970,0.23819482460003175
SIM,1827,44,35-39,1871,4
SIM,1944,14,na,1958,3897
STAT,1882,31,35-39,1913,9.341912716037525
STAT,1891,43,45-49,1934,1.7366088032843183
STAT,1827,50,20-24,1877,6.780349484365097E-4
STAT,1878,18,25-29,1896,5.564393882057699
STAT,1894,41,20-24,1935,0.19367928172696108
STAT,1932,37,30-34,1969,2.313355603728519
STAT,1844,90,na,1934,54.756641245511204
STAT,1820,34,30-34,1854,52.141531032051425
STAT,1857,56,na,1913,1519.6517432956036
SIM,1876,44,30-34,1920,3
SIM,1937,19,45-49,1956,1
SIM,1882,40,40-44,1922,5
SIM,1926,31,25-29,1957,16
STAT,1895,51,na,1946,2664.599590861596
STAT,1835,41,15-19,1876,0.010667365519613264
STAT,1901,33,20-24,1934,3.5592838395167035
STAT,1839,15,35-39,1854,0.4835840040839684
SIM,1814,58,na,1872,1026
SIM,1840,65,na,1905,1109
SIM,1842,19,15-19,1861,9
SIM,1863,93,na,1956,21
STAT,1876,53,20-24,1929,7.086490719451605E-4
STAT,1837,28,30-34,1865,20.825911519830154
STAT,1864,33,50-100,1897,0.7681973702930942
STAT,1893,49,35-39,1942,0.09263484231906337
STAT,1832,54,45-49,1886,0.0087689776452556
STAT,1896,17,30-34,1913,1.9886476999783058
STAT,1806,95,na,1901,4.610672756506757
SIM,1827,29,25-29,1856,38
STAT,1931,41,35-39,1972,0.2544946581770094
SIM,1883,2,na,1885,2821
STAT,1819,51,25-29,1870,0.006571664352104056
STAT,1844,16,50-100,1860,0.043509175935696934
SIM,1861,50,50-100,1911,2
SIM,1864,34,na,1898,2074
STAT,1871,31,25-29,1902,9.647569002728236
SIM,1832,87,na,1919,103
STAT,1830,76,na,1906,571.8015105792734
STAT,1805,51,30-34,1856,0.022291998835122978
STAT,1883,70,na,1953,1299.546084486609
STAT,1920,41,25-29,1961,0.07461203965515557
STAT,1832,36,15-19,1868,0.04338517442141398
STAT,1853,15,50-100,1868,0.04513113344341293
STAT,1855,49,15-19,1904,2.7831549989568394E-4
STAT,1910,45,30-34,1955,0.07894535693351545
SIM,1905,34,na,1939,3216
STAT,1876,27,50-100,1903,0.6243428411091626
SIM,1908,52,na,1960,3030
STAT,1860,42,na,1902,1769.4065245826157
SIM,1819,38,30-34,1857,7
STAT,1865,46,20-24,1911,0.010304367733801017
STAT,1930,31,40-44,1961,4.773658080728549
STAT,1914,49,30-34,1963,0.08303394848102295
STAT,1845,19,25-29,1864,5.008686969535929
STAT,1872,29,50-100,1901,0.6018256344936601
SIM,1862,53,na,1915,1827
SIM,1903,22,40-44,1925,2
SIM,1880,29,50-100,1909,2
SIM,1934,30,20-24,1964,3
STAT,1888,18,35-39,1906,0.6110003178931426
STAT,1924,45,25-29,1969,0.05993811029684879
STAT,1867,16,50-100,1883,0.04469200616487511
STAT,1881,51,50-100,1932,0.013848813152149772
STAT,1815,40,35-39,1855,5.097694375580093
STAT,1894,34,30-34,1928,21.015480643650825
STAT,1821,47,45-49,1868,0.3722767926003028
SIM,1875,18,15-19,1893,8
STAT,1876,50,50-100,1926,0.014952181103889454
STAT,1920,34,35-39,1954,9.37502396184054
STAT,1844,38,na,1882,1711.2385669850592
SIM,1862,8,na,1870,2402
STAT,1925,11,na,1936,4528.317617457106
STAT,1879,51,30-34,1930,0.005914480424713988
STAT,1872,42,30-34,1914,1.08805824145
STAT,1820,41,20-24,1861,0.3010954332939816
SIM,1829,27,35-39,1856,8
SIM,1871,33,40-44,1904,4
SIM,1877,52,na,1929,2054
SIM,1853,38,na,1891,1768
SIM,1865,19,na,1884,2306
STAT,1905,44,45-49,1949,0.1399999177074924
STAT,1900,22,15-19,1922,4.323385733386094
STAT,1884,44,15-19,1928,0.012715022752999502
STAT,1871,21,30-34,1892,16.759655964038327
STAT,1895,29,50-100,1924,0.7822134428122919
STAT,1860,35,50-100,1895,0.9500142267460707
SIM,1886,29,30-34,1915,24
STAT,1916,37,50-100,1953,0.4061762288497073
SIM,1835,43,30-34,1878,5
STAT,1878,29,30-34,1907,24.61490526839078
STAT,1850,42,45-49,1892,1.053717761242493
STAT,1873,9,na,1882,2565.137420709692
STAT,1895,47,45-49,1942,0.16319055269521657
SIM,1863,16,30-34,1879,2
SIM,1880,42,30-34,1922,1
STAT,1827,43,30-34,1870,1.084093798937456
SIM,1918,18,30-34,1936,12
STAT,1909,40,50-100,1949,0.10498689229188032
SIM,1913,44,45-49,1957,1
STAT,1861,31,15-19,1892,0.11231652517224189
STAT,1855,16,30-34,1871,1.3551514571221996
SIM,1812,80,na,1892,228
STAT,1927,22,30-34,1949,33.45171499088241
SIM,1907,19,25-29,1926,7
STAT,1929,30,40-44,1959,4.701023151421956
STAT,1839,15,40-44,1854,0.16119467736096904
STAT,1948,22,50-100,1970,0.7137459745055674
STAT,1908,28,35-39,1936,13.360922853936362
STAT,1907,41,15-19,1948,0.0013368286952133966
STAT,1800,108,na,1908,7.281706456203172E-4
STAT,1776,108,na,1884,0.0047866636748565075
STAT,1903,19,45-49,1922,0.08733252046535046
STAT,1893,20,40-44,1913,2.511355924075697
SIM,1933,25,30-34,1958,52
SIM,1852,21,na,1873,1963
SIM,1912,37,35-39,1949,6
STAT,1850,85,na,1935,193.2437703094571
STAT,1865,25,35-39,1890,8.318103564416976
STAT,1923,28,50-100,1951,1.0757565637637645
STAT,1916,47,25-29,1963,0.05139852997875078
STAT,1887,54,na,1941,2212.7121243256033
SIM,1823,32,na,1855,1520
SIM,1816,70,na,1886,688
SIM,1869,43,50-100,1912,1
STAT,1900,15,50-100,1915,0.06450237749810167
SIM,1841,69,na,1910,981
STAT,1914,39,15-19,1953,0.017931139420061533
STAT,1882,25,50-100,1907,0.5916823427456156
SIM,1924,16,20-24,1940,150
STAT,1906,45,45-49,1951,0.18499142210699662
SIM,1897,20,20-24,1917,82
STAT,1836,62,na,1898,1183.5775835967938
STAT,1937,16,50-100,1953,0.34516750153758835
STAT,1869,30,45-49,1899,1.6087559659580133
STAT,1936,28,40-44,1964,4.211859834682001
SIM,1836,82,na,1918,291
STAT,1900,24,15-19,1924,4.296320587290656
STAT,1921,34,30-34,1955,16.42150783221909
SIM,1944,15,35-39,1959,4
SIM,1959,9,na,1968,4879
SIM,1873,25,35-39,1898,10
STAT,1923,42,40-44,1965,0.2761728614111108
STAT,1851,54,20-24,1905,5.162199944773135E-4
SIM,1895,18,na,1913,3206
STAT,1902,21,15-19,1923,4.411641585476267
SIM,1894,76,na,1970,1578
SIM,1937,30,40-44,1967,8
SIM,1835,41,na,1876,1575
SIM,1944,26,45-49,1970,1
STAT,1859,28,15-19,1887,0.3445313352308927
STAT,1867,22,35-39,1889,5.197851416237969
SIM,1799,97,na,1896,2
SIM,1916,2,na,1918,3974
SIM,1892,31,50-100,1923,1
STAT,1847,21,25-29,1868,52.12367296195836
SIM,1935,22,30-34,1957,42
SIM,1918,25,35-39,1943,19
STAT,1904,37,35-39,1941,2.068666988107802
SIM,1827,46,na,1873,1404
STAT,1878,18,na,1896,2479.9966030599935
SIM,1855,21,25-29,1876,58
STAT,1920,36,35-39,1956,2.504043251889234
STAT,1921,45,40-44,1966,0.16869553985610589
SIM,1848,16,na,1864,2113
STAT,1870,37,40-44,1907,4.05690013373631
STAT,1911,27,25-29,1938,60.641095635953675
STAT,1849,37,na,1886,1807.7725574651631
SIM,1919,34,40-44,1953,8
STAT,1911,30,25-29,1941,8.57104126591728
SIM,1900,30,45-49,1930,3
STAT,1850,33,50-100,1883,0.6686787152281077
STAT,1920,16,40-44,1936,1.486113449030489
STAT,1782,96,na,1878,1.3285159450574033
STAT,1904,48,45-49,1952,0.17812345177904118
SIM,1942,18,35-39,1960,4
STAT,1925,45,25-29,1970,0.06100743973982506
SIM,1848,31,35-39,1879,10
STAT,1914,19,20-24,1933,26.35233212635825
STAT,1917,15,25-29,1932,8.850658676937961
SIM,1870,101,na,1971,9
STAT,1897,19,50-100,1916,0.061563543613364725
STAT,1900,37,20-24,1937,0.21804299186824505
STAT,1940,29,15-19,1969,0.6793911788253695
SIM,1857,44,na,1901,1803
SIM,1846,92,na,1938,28
STAT,1904,51,na,1955,2931.7039148801346
STAT,1950,19,30-34,1969,13.606274475951277
SIM,1900,18,30-34,1918,3
STAT,1886,13,na,1899,2573.1181635794446
SIM,1888,33,30-34,1921,30
STAT,1934,18,35-39,1952,5.347745705340044
SIM,1869,33,20-24,1902,3
SIM,1902,26,40-44,1928,3
STAT,1782,88,na,1870,38.53655324533667
STAT,1921,15,45-49,1936,0.5404166228450215
STAT,1942,26,15-19,1968,0.7002803471615285
SIM,1889,32,35-39,1921,15
STAT,1841,49,na,1890,1518.6819604189511
STAT,1951,15,30-34,1966,13.719103039192046
STAT,1786,78,na,1864,275.67130605142427
SIM,1920,10,na,1930,4276
STAT,1904,17,40-44,1921,0.24784395964078315
SIM,1873,15,na,1888,2454
SIM,1903,30,na,1933,3257
SIM,1887,7,na,1894,2707
SIM,1922,19,20-24,1941,128
STAT,1879,20,50-100,1899,0.4056590416990038
SIM,1799,73,na,1872,487
STAT,1835,22,45-49,1857,0.5899562855466638
STAT,1952,16,30-34,1968,13.802534383084666
SIM,1833,42,na,1875,1544
SIM,1837,56,na,1893,1307
STAT,1930,27,35-39,1957,18.034230087930045
STAT,1932,35,45-49,1967,0.8667913944236028
STAT,1790,83,na,1873,125.32978321725243
STAT,1857,32,na,1889,1788.9239260265958
STAT,1916,16,20-24,1932,27.24023386391465
STAT,1831,39,na,1870,1539.8898114119256
STAT,1871,47,na,1918,2100.673987841861
SIM,1806,84,na,1890,101
STAT,1811,52,25-29,1863,0.01127642372094453
STAT,1902,34,20-24,1936,2.0515871897366003
STAT,1932,15,20-24,1947,170.37990090336538
SIM,1831,51,na,1882,1367
STAT,1863,22,20-24,1885,58.2681813499966
SIM,1802,70,na,1872,619
STAT,1905,16,45-49,1921,0.08941658495503478
STAT,1893,31,50-100,1924,1.1021733579666397
STAT,1915,18,25-29,1933,8.545931531420669
SIM,1923,18,25-29,1941,61
SIM,1912,15,na,1927,3687
SIM,1808,75,na,1883,419
STAT,1911,21,50-100,1932,0.5913290510473088
SIM,1940,15,20-24,1955,123
STAT,1866,48,30-34,1914,0.08328411968665247
SIM,1875,9,na,1884,2585
STAT,1840,75,na,1915,675.5923703974104
STAT,1934,34,50-100,1968,1.0650435279425783
SIM,1920,23,25-29,1943,108
STAT,1908,22,20-24,1930,96.57343476581687
STAT,1810,77,na,1887,347.75973680449766
STAT,1844,17,15-19,1861,5.23936984809084
STAT,1934,32,15-19,1966,0.1657483795855259
SIM,1897,26,35-39,1923,16
SIM,1926,19,35-39,1945,8
STAT,1913,40,30-34,1953,0.11911745758803327
STAT,1917,32,15-19,1949,0.12712374396869883
SIM,1877,18,30-34,1895,4
SIM,1852,13,na,1865,2198
STAT,1912,23,25-29,1935,83.37172089474517
SIM,1923,39,50-100,1962,1
STAT,1896,16,25-29,1912,7.0876593439767515
SIM,1847,35,35-39,1882,16
STAT,1803,75,na,1878,418.3453273818607
SIM,1827,54,na,1881,1221
STAT,1894,24,na,1918,2853.311244464915
SIM,1941,19,30-34,1960,17
STAT,1898,38,na,1936,3020.6366863192306
SIM,1943,19,35-39,1962,4
STAT,1932,15,na,1947,4625.67011400041
SIM,1852,17,15-19,1869,4
STAT,1854,67,na,1921,1134.1996174543888
SIM,1878,46,na,1924,2285
STAT,1935,19,35-39,1954,5.390038601638915
STAT,1830,52,35-39,1882,0.005673587960471423
SIM,1945,24,40-44,1969,3
STAT,1870,54,30-34,1924,0.005364889767516768
STAT,1890,18,na,1908,2909.3462366030244
STAT,1829,25,25-29,1854,120.3426822885539
STAT,1889,26,35-39,1915,11.291727431234
SIM,1902,15,30-34,1917,3
SIM,1882,51,na,1933,2038
STAT,1860,47,25-29,1907,0.043945122892916744
STAT,1937,24,40-44,1961,3.0911001501855777
STAT,1868,16,na,1884,2331.3837881107547
SIM,1837,25,25-29,1862,33
STAT,1872,21,na,1893,2247.8322458427724
STAT,1924,29,30-34,1953,42.78947601450869
STAT,1792,98,na,1890,0.5921896401726161
SIM,1849,40,40-44,1889,7
STAT,1819,49,50-100,1868,0.451494937918372
STAT,1899,31,na,1930,3101.4704194963365
SIM,1805,49,50-100,1854,2
STAT,1836,52,50-100,1888,0.009895672210487028
STAT,1885,48,40-44,1933,0.1591837776767025
STAT,1903,30,20-24,1933,3.6625276578119386
SIM,1816,62,na,1878,978
STAT,1908,41,na,1949,3264.8454829849443
SIM,1837,46,50-100,1883,3
STAT,1825,78,na,1903,415.26713946099994
STAT,1852,53,25-29,1905,0.0025266801113236555
STAT,1918,19,35-39,1937,4.291568256644177
SIM,1861,89,na,1950,70
STAT,1869,18,30-34,1887,1.4701811003858734
STAT,1877,52,na,1929,2098.7312103022145
STAT,1931,2,na,1933,5057.056416056978
STAT,1933,31,15-19,1964,0.16369348971551245
STAT,1858,40,40-44,1898,1.682807454562139
SIM,1906,27,na,1933,3273
STAT,1907,41,45-49,1948,0.14487879967211542
STAT,1761,102,na,1863,0.10123291801708333
SIM,1898,66,na,1964,2257
SIM,1933,0,na,1933,5343
STAT,1924,41,45-49,1965,0.18727944336643707
STAT,1909,29,35-39,1938,13.458467713587119
STAT,1913,43,50-100,1956,0.10806141140627645
STAT,1866,60,na,1926,1661.7663083825353
SIM,1886,33,na,1919,2325
STAT,1943,22,15-19,1965,5.3502636052081955
SIM,1911,30,20-24,1941,2
STAT,1854,103,na,1957,0.15001869254052735
STAT,1938,23,45-49,1961,1.0516669326139194
STAT,1853,42,na,1895,1746.9838291341541
STAT,1903,36,35-39,1939,2.0618968963583195
SIM,1911,36,35-39,1947,9
SIM,1840,44,na,1884,1542
SIM,1936,34,40-44,1970,3
STAT,1866,92,na,1958,52.604170395637496
SIM,1853,62,na,1915,1389
SIM,1857,76,na,1933,652
STAT,1823,39,20-24,1862,1.1184523379769744
STAT,1915,11,na,1926,3910.711677793395
STAT,1919,25,na,1944,3849.7662938899757
SIM,1932,29,30-34,1961,59
STAT,1890,39,50-100,1929,1.4037293751676607
SIM,1762,96,na,1858,3
SIM,1911,41,na,1952,3337
SIM,1915,55,na,1970,3219
STAT,1952,5,na,1957,4451.105324656485
STAT,1849,8,na,1857,2266.6313252785617
SIM,1828,35,25-29,1863,3
STAT,1840,39,20-24,1879,0.5860293433230421
STAT,1910,34,25-29,1944,8.347166275298026
SIM,1916,28,35-39,1944,16
SIM,1856,25,35-39,1881,9
STAT,1786,107,na,1893,0.002215897408631049
SIM,1932,23,50-100,1955,4
STAT,1918,44,25-29,1962,0.07148677354964604
SIM,1930,30,30-34,1960,19
SIM,1844,26,na,1870,1794
STAT,1857,43,50-100,1900,0.7814351042757475
SIM,1946,23,45-49,1969,1
STAT,1889,20,20-24,1909,80.84906156121556
SIM,1915,29,30-34,1944,31
STAT,1878,20,15-19,1898,3.2673362776547163
STAT,1839,35,35-39,1874,5.745569935066523
STAT,1928,34,40-44,1962,4.616496399082848
SIM,1853,94,na,1947,11
SIM,1939,27,20-24,1966,19
STAT,1905,24,50-100,1929,0.5533496303678294
SIM,1878,26,25-29,1904,42
STAT,1907,29,30-34,1936,34.40382133075233
SIM,1910,32,na,1942,3454
SIM,1916,22,20-24,1938,93
STAT,1871,53,35-39,1924,0.00794625239442774
STAT,1871,39,na,1910,2187.8334797756247
SIM,1836,90,na,1926,46
STAT,1857,24,na,1881,1824.679658165075
STAT,1923,30,na,1953,4128.837376362383
STAT,1917,45,20-24,1962,0.010956025377078916
SIM,1917,29,35-39,1946,19
STAT,1922,30,30-34,1952,16.952040353352388
STAT,1800,100,na,1900,0.4220389762987447
STAT,1933,31,45-49,1964,2.004473019962532
SIM,1911,16,40-44,1927,1
STAT,1919,28,40-44,1947,4.740939861234033
STAT,1863,5,na,1868,2378.731001889211
SIM,1819,67,na,1886,826
STAT,1893,23,45-49,1916,0.8328291108566367
STAT,1891,67,na,1958,1927.7278240722912
SIM,1870,74,na,1944,928
SIM,1829,80,na,1909,347
SIM,1914,42,40-44,1956,1
STAT,1856,15,40-44,1871,0.16130305024333952
SIM,1924,19,25-29,1943,52
STAT,1835,21,na,1856,1821.9634293143142
SIM,1871,99,na,1970,9
SIM,1878,78,na,1956,761
STAT,1918,41,20-24,1959,0.017764125516298093
STAT,1898,40,50-100,1938,0.09473400884053444
SIM,1815,77,na,1892,420
STAT,1857,101,na,1958,0.709996515523682
SIM,1935,34,25-29,1969,18
STAT,1805,107,na,1912,0.0016462286001235646
SIM,1881,26,na,1907,1855
SIM,1908,36,30-34,1944,1
STAT,1847,110,na,1957,2.5083764797543455E-4
STAT,1867,30,40-44,1897,3.8779288184572582
SIM,1941,16,20-24,1957,121
SIM,1919,45,na,1964,3849
STAT,1905,29,20-24,1934,15.904738535864102
STAT,1924,28,na,1952,4105.94229412693
SIM,1858,18,20-24,1876,15
STAT,1911,24,20-24,1935,99.00421242972268
SIM,1895,26,25-29,1921,57
STAT,1841,21,30-34,1862,15.668817526800172
STAT,1839,59,na,1898,1293.9550112818533
STAT,1847,23,50-100,1870,0.3659913768736769
STAT,1916,19,25-29,1935,8.639126742035119
STAT,1883,48,30-34,1931,0.08853090505439987
STAT,1921,37,35-39,1958,2.5513541882168287
SIM,1918,20,na,1938,3732
SIM,1927,28,40-44,1955,6
SIM,1834,21,35-39,1855,9
SIM,1910,37,30-34,1947,3
STAT,1856,90,na,1946,58.111631608654605
STAT,1878,34,50-100,1912,0.8943395214853965
STAT,1907,26,20-24,1933,16.33592849821944
STAT,1940,32,45-49,1972,1.538511488986806
SIM,1886,34,50-100,1920,5
STAT,1878,33,20-24,1911,2.649986680418942
SIM,1866,13,na,1879,2377
STAT,1910,47,30-34,1957,0.07857553589320955
SIM,1878,23,20-24,1901,56
STAT,1889,40,50-100,1929,1.2445244063463308
STAT,1887,26,25-29,1913,44.85264329566272
SIM,1911,33,25-29,1944,10
STAT,1941,25,15-19,1966,0.6904970498577132
STAT,1920,8,na,1928,4227.244258139064
STAT,1895,20,45-49,1915,0.8639445530350299
SIM,1830,77,na,1907,491
SIM,1887,74,na,1961,1321
SIM,1888,16,na,1904,2857
STAT,1923,45,45-49,1968,0.24131480980571887
STAT,1924,41,15-19,1965,0.0017280688029059621
STAT,1907,25,50-100,1932,0.8937414069527929
STAT,1826,32,45-49,1858,2.390128924084326
STAT,1875,29,na,1904,2300.786554271535
STAT,1854,59,na,1913,1390.5194917414724
STAT,1894,56,na,1950,2476.2165846558632
STAT,1807,57,na,1864,1107.4032724250576
STAT,1931,19,20-24,1950,166.73869125772276
SIM,1879,43,30-34,1922,1
STAT,1869,30,15-19,1899,0.13137761174417797
STAT,1922,16,45-49,1938,0.5474930615473194
SIM,1940,30,na,1970,3617
SIM,1834,32,45-49,1866,1
SIM,1907,16,20-24,1923,19
STAT,1844,41,50-100,1885,0.7611522885366703
STAT,1865,11,na,1876,2325.302762224189
SIM,1866,4,na,1870,2538
STAT,1900,24,45-49,1924,0.9081222212747119
SIM,1864,54,na,1918,1867
STAT,1915,43,na,1958,3526.7793891265064
STAT,1859,90,na,1949,59.279475068353605
STAT,1901,25,15-19,1926,0.6040201077897948
STAT,1903,33,25-29,1936,7.872007024591418
STAT,1949,23,na,1972,4024.3359189683774
STAT,1945,18,40-44,1963,1.4429566440487995
SIM,1858,18,na,1876,2197
STAT,1875,38,30-34,1913,5.14942973853537
SIM,1846,60,na,1906,1374
STAT,1875,21,na,1896,2303.430222726053
STAT,1878,20,45-49,1898,0.6906236668866432
SIM,1928,30,na,1958,4471
SIM,1888,30,20-24,1918,2
STAT,1841,60,na,1901,1314.8324080374437
SIM,1902,27,25-29,1929,65
SIM,1913,29,20-24,1942,18
STAT,1933,16,20-24,1949,171.87075810153647
STAT,1913,23,40-44,1936,3.1977414908593333
STAT,1850,106,na,1956,0.010733528367163904
STAT,1852,22,45-49,1874,0.6005680323838707
SIM,1883,38,30-34,1921,6
SIM,1921,27,35-39,1948,22
STAT,1838,19,40-44,1857,0.16029342685362805
SIM,1887,82,na,1969,783
STAT,1897,33,30-34,1930,21.965213314129805
SIM,1856,22,25-29,1878,60
SIM,1905,19,20-24,1924,26
STAT,1913,27,35-39,1940,14.132801964679512
STAT,1914,42,45-49,1956,0.15579601655052275
STAT,1914,18,na,1932,3764.5049488672403
STAT,1903,16,40-44,1919,0.2464533682971145
SIM,1877,21,na,1898,2327
SIM,1879,87,na,1966,328
SIM,1856,59,na,1915,1507
STAT,1907,56,na,1963,2976.883215535834
SIM,1953,18,40-44,1971,2
STAT,1902,37,25-29,1939,0.8285358975135467
STAT,1899,41,40-44,1940,0.20309316792266938
SIM,1851,28,na,1879,1858
STAT,1817,67,na,1884,817.0157063971883
STAT,1921,48,45-49,1969,0.2308147627074298
STAT,1925,42,20-24,1967,0.020198204504072986
SIM,1891,36,na,1927,2780
STAT,1904,43,50-100,1947,0.09869178523618048
STAT,1930,24,30-34,1954,34.56468581868174
STAT,1870,97,na,1967,22.553480333644863
STAT,1863,40,50-100,1903,0.8846541916974707
SIM,1902,30,25-29,1932,17
STAT,1899,30,30-34,1929,22.78156634865557
SIM,1838,42,30-34,1880,1
SIM,1874,64,na,1938,1620
STAT,1860,44,20-24,1904,0.12008857575921401
STAT,1873,62,na,1935,1751.1756536527741
STAT,1911,26,40-44,1937,4.309019953973209
SIM,1879,31,na,1910,2412
SIM,1928,40,40-44,1968,1
SIM,1901,19,30-34,1920,5
STAT,1879,67,na,1946,1567.5794224683439
STAT,1932,23,na,1955,4512.452682224332
STAT,1813,53,na,1866,1151.7585795754476
STAT,1911,15,30-34,1926,2.3149887154569333
SIM,1854,25,25-29,1879,43
SIM,1871,40,50-100,1911,3
STAT,1901,20,45-49,1921,0.927599249800299
SIM,1871,22,20-24,1893,61
STAT,1860,23,50-100,1883,0.31990692938977233
STAT,1901,36,25-29,1937,0.8257237806433444
STAT,1930,35,40-44,1965,1.8477877186691885
SIM,1837,22,20-24,1859,77
STAT,1846,25,25-29,1871,38.50712217153043
SIM,1938,6,na,1944,3564
STAT,1902,40,25-29,1942,0.060052287998925445
SIM,1823,64,na,1887,873
SIM,1914,25,20-24,1939,20
SIM,1834,56,na,1890,1235
SIM,1877,30,45-49,1907,2
SIM,1830,66,na,1896,964
SIM,1926,16,30-34,1942,24
STAT,1879,45,50-100,1924,0.24528853865710837
SIM,1874,21,35-39,1895,7
STAT,1909,38,25-29,1947,0.8760903793197579
STAT,1911,43,30-34,1954,0.11458544409495733
STAT,1937,27,45-49,1964,1.5909295580638643
SIM,1833,100,na,1933,1
SIM,1909,32,30-34,1941,16
SIM,1917,38,25-29,1955,1
SIM,1903,23,25-29,1926,83
SIM,1921,23,40-44,1944,3
SIM,1930,33,35-39,1963,16
STAT,1834,30,50-100,1864,0.7436443834380118
STAT,1909,41,25-29,1950,0.06346393863374948
STAT,1926,37,40-44,1963,1.7282851445508238
SIM,1844,34,na,1878,1685
SIM,1848,48,na,1896,1578
STAT,1849,19,50-100,1868,0.04468973925663833
STAT,1848,22,25-29,1870,51.792922221876196
SIM,1897,23,30-34,1920,26
SIM,1925,15,25-29,1940,61
STAT,1901,20,15-19,1921,4.388466288247373
SIM,1836,28,50-100,1864,1
STAT,1808,47,30-34,1855,0.3672456270101649
SIM,1853,5,na,1858,2295
STAT,1924,38,20-24,1962,0.2933479342270238
STAT,1926,20,50-100,1946,0.7596603509545111
STAT,1906,25,20-24,1931,16.250856707799592
STAT,1915,35,45-49,1950,0.6567788472851256
SIM,1929,4,na,1933,4821
STAT,1855,37,50-100,1892,0.8724667618291252
STAT,1903,66,na,1969,2508.2457110206924
STAT,1889,23,30-34,1912,20.709471215445625
STAT,1943,0,na,1943,4474.275229693804
STAT,1927,38,40-44,1965,1.7564613635521136
STAT,1869,89,na,1958,133.83003314347377
STAT,1836,30,na,1866,1811.1545338284475
SIM,1849,43,45-49,1892,2
STAT,1813,77,na,1890,355.7377017880278
STAT,1871,45,35-39,1916,0.13263942711142965
STAT,1816,42,na,1858,1458.4943774187218
STAT,1936,26,45-49,1962,1.5625749964430509
STAT,1775,86,na,1861,61.078909003556326
STAT,1872,49,15-19,1921,3.7111671434491227E-4
SIM,1833,46,50-100,1879,3
STAT,1781,108,na,1889,0.005021214070214339
SIM,1839,87,na,1926,98
SIM,1849,32,35-39,1881,9
STAT,1882,31,na,1913,2201.299915804529
STAT,1825,46,50-100,1871,0.25402740418598213
STAT,1940,10,na,1950,3796.4276472324136
STAT,1856,32,30-34,1888,13.026731576344293
STAT,1837,87,na,1924,114.33849677897878
SIM,1915,26,20-24,1941,24
STAT,1884,30,40-44,1914,4.080082109669199
SIM,1936,17,na,1953,2765
SIM,1904,4,na,1908,3620
STAT,1833,73,na,1906,728.7172683802099
STAT,1917,48,25-29,1965,0.052197053222176056
STAT,1823,50,50-100,1873,0.018627364428515644
SIM,1854,87,na,1941,124
SIM,1897,0,na,1897,3549
SIM,1910,21,15-19,1931,4
STAT,1888,22,25-29,1910,63.91176096569893
SIM,1934,37,40-44,1971,3
STAT,1767,99,na,1866,0.2944412726423508
STAT,1837,32,20-24,1869,2.199529028442492
SIM,1872,48,50-100,1920,6
STAT,1822,81,na,1903,274.7827686772234
STAT,1936,15,35-39,1951,3.8127134486635015
SIM,1896,22,25-29,1918,76
STAT,1964,3,na,1967,4679.324253973279
STAT,1910,31,20-24,1941,2.2309487950641773
SIM,1911,33,30-34,1944,21
STAT,1826,95,na,1921,7.260466054166038
STAT,1872,15,25-29,1887,5.451353657238801
STAT,1923,45,15-19,1968,4.09007807957854E-4
SIM,1886,33,20-24,1919,2
SIM,1839,21,40-44,1860,1
SIM,1857,52,na,1909,1675
SIM,1845,32,20-24,1877,1
SIM,1875,22,35-39,1897,5
SIM,1946,20,40-44,1966,2
STAT,1828,103,na,1931,0.08082482371974416
SIM,1906,15,20-24,1921,24
STAT,1922,33,35-39,1955,9.713032512069159
SIM,1919,37,45-49,1956,1
SIM,1880,15,25-29,1895,10
STAT,1918,27,40-44,1945,4.686093126226793
STAT,1820,55,na,1875,1184.8734189069949
SIM,1791,77,na,1868,312
SIM,1862,7,na,1869,2426
SIM,1905,22,45-49,1927,5
SIM,1828,95,na,1923,6
SIM,1902,37,na,1939,3157
SIM,1829,31,25-29,1860,11
STAT,1904,45,40-44,1949,0.132163839579277
STAT,1922,45,na,1967,4005.8385524907285
SIM,1936,30,25-29,1966,9
STAT,1824,69,na,1893,809.184144749872
STAT,1903,33,30-34,1936,13.41875694986013
SIM,1799,65,na,1864,789
STAT,1895,41,na,1936,2869.2747903785894
SIM,1854,37,50-100,1891,3
STAT,1866,21,35-39,1887,5.163165829946504
STAT,1916,36,15-19,1952,0.0186671248087279
SIM,1892,30,40-44,1922,4
STAT,1828,28,50-100,1856,0.905071098259138
STAT,1918,16,30-34,1934,2.5207009527269713
SIM,1926,27,40-44,1953,6
STAT,1915,35,15-19,1950,0.01850081479978007
SIM,1868,24,15-19,1892,3
STAT,1904,34,30-34,1938,13.468633357437012
STAT,1920,20,25-29,1940,97.58767113931044
STAT,1827,34,na,1861,1647.1284698351853
SIM,1938,29,25-29,1967,58
STAT,1928,30,25-29,1958,10.929824222876178
STAT,1846,37,50-100,1883,0.9509446260885983
SIM,1864,32,30-34,1896,19
STAT,1926,26,30-34,1952,44.5240735538382
STAT,1921,32,35-39,1953,9.607131320595682
SIM,1925,7,na,1932,4531
SIM,1897,23,25-29,1920,86
STAT,1889,23,25-29,1912,66.55667538543628
SIM,1842,37,30-34,1879,5
STAT,1912,44,30-34,1956,0.11558630321725266
SIM,1820,39,45-49,1859,1
STAT,1898,46,na,1944,2884.9430285594062
STAT,1911,53,na,1964,3215.861543889232
STAT,1938,28,15-19,1966,0.6604044274965598
SIM,1884,20,40-44,1904,4
STAT,1938,20,40-44,1958,3.145908227360036
SIM,1878,38,na,1916,2364
STAT,1925,25,30-34,1950,44.01507490575929
SIM,1938,18,15-19,1956,40
STAT,1842,47,30-34,1889,0.07011255907560714
SIM,1912,34,30-34,1946,21
STAT,1920,17,25-29,1937,45.930171981729714
SIM,1806,92,na,1898,11
SIM,1856,22,30-34,1878,25
SIM,1908,1,na,1909,3698
STAT,1834,37,30-34,1871,4.114121796201996
SIM,1934,26,30-34,1960,53
SIM,1875,18,20-24,1893,14
STAT,1872,32,na,1904,2261.2140803477805
STAT,1875,20,50-100,1895,0.3983330557199958
STAT,1928,38,35-39,1966,2.8847457425786462
STAT,1849,69,na,1918,1100.4638275512275
SIM,1952,12,na,1964,4386
STAT,1880,75,na,1955,1025.2771710491486
STAT,1919,44,40-44,1963,0.25521253215081663
SIM,1861,37,40-44,1898,10
STAT,1831,49,20-24,1880,0.008331670308498318
STAT,1830,44,35-39,1874,1.3699299731647725
SIM,1920,26,35-39,1946,19
STAT,1914,23,35-39,1937,9.059902958737494
SIM,1931,28,50-100,1959,2
SIM,1941,19,25-29,1960,63
STAT,1849,50,50-100,1899,0.011487814600245045
SIM,1911,34,50-100,1945,6
STAT,1802,82,na,1884,171.30367795796312
STAT,1843,32,45-49,1875,1.4160126221589908
SIM,1855,10,na,1865,2331
STAT,1829,29,40-44,1858,3.3558930292587963
SIM,1923,39,30-34,1962,2
STAT,1888,43,30-34,1931,1.2742730045846655
STAT,1903,21,30-34,1924,24.014704727108533
SIM,1868,20,20-24,1888,67
SIM,1922,34,45-49,1956,2
SIM,1918,34,25-29,1952,9
STAT,1830,105,na,1935,0.01769636827976034
STAT,1902,17,na,1919,3367.217488839261
SIM,1851,32,45-49,1883,1
SIM,1833,93,na,1926,10
STAT,1849,20,45-49,1869,0.6413778830157995
STAT,1924,25,15-19,1949,0.7817560742462634
STAT,1870,46,30-34,1916,0.08996519727714575
SIM,1847,32,25-29,1879,6
STAT,1813,45,na,1858,1300.582245660923
STAT,1843,21,35-39,1864,4.9832387973153995
STAT,1926,45,40-44,1971,0.18463781269344076
SIM,1922,23,35-39,1945,14
SIM,1837,29,40-44,1866,1
STAT,1893,19,50-100,1912,0.05837886373672456
SIM,1907,32,20-24,1939,2
SIM,1765,93,na,1858,5
SIM,1908,39,35-39,1947,8
STAT,1912,26,35-39,1938,14.025443577049765
STAT,1839,32,25-29,1871,8.392191407985699
STAT,1882,87,na,1969,393.1125959734824
SIM,1897,22,40-44,1919,1
SIM,1927,44,40-44,1971,1
STAT,1823,52,na,1875,1290.4130338200082
SIM,1934,29,35-39,1963,22
STAT,1855,31,25-29,1886,7.488542194747049
SIM,1810,46,na,1856,1290
SIM,1851,21,35-39,1872,4
SIM,1893,39,50-100,1932,1
STAT,1917,48,30-34,1965,0.08772004862159015
STAT,1853,37,40-44,1890,3.3128771816097013
STAT,1866,43,50-100,1909,0.9138595001236447
SIM,1809,89,na,1898,37
SIM,1862,32,20-24,1894,2
STAT,1856,18,45-49,1874,0.05659626488366198
SIM,1908,53,na,1961,3011
STAT,1921,9,na,1930,4286.697383565689
STAT,1869,97,na,1966,20.247768967048483
STAT,1890,82,na,1972,982.5824031536451
STAT,1832,31,30-34,1863,13.934033398654037
STAT,1889,22,40-44,1911,2.43025219192841
SIM,1902,22,25-29,1924,71
STAT,1757,109,na,1866,0.003419696411470153
SIM,1922,22,45-49,1944,1
STAT,1910,19,30-34,1929,2.2694319490807713
STAT,1855,20,15-19,1875,2.778568126239925
STAT,1831,38,50-100,1869,0.9299644801291067
STAT,1901,44,25-29,1945,0.05817085431560193
STAT,1933,19,25-29,1952,54.508095264768514
STAT,1884,31,50-100,1915,0.8586456434664986
STAT,1914,34,45-49,1948,1.483586058758523
SIM,1820,67,na,1887,835
STAT,1919,45,30-34,1964,0.0917731707134452
STAT,1938,31,na,1969,3594.690220860868
STAT,1854,50,30-34,1904,0.0043201630589958795
SIM,1896,31,50-100,1927,1
STAT,1854,32,20-24,1886,1.9805307639369316
SIM,1780,85,na,1865,69
STAT,1844,14,na,1858,2088.4998010322843
STAT,1812,44,50-100,1856,3.7184888236987135
STAT,1894,38,40-44,1932,5.2881450005849215
SIM,1913,29,na,1942,3363
STAT,1797,73,na,1870,503.53549107375346
STAT,1901,62,na,1963,2588.075177108747
STAT,1785,85,na,1870,87.37265200049586
STAT,1884,48,25-29,1932,0.053083785656104145
STAT,1838,29,na,1867,1820.9734622252781
STAT,1844,15,50-100,1859,0.0437669633498274
STAT,1881,4,na,1885,2590.5340866080905
STAT,1956,16,20-24,1972,169.49907521079916
STAT,1899,44,45-49,1943,0.13271110469987882
STAT,1914,22,45-49,1936,1.085985694567766
SIM,1861,23,15-19,1884,2
STAT,1847,54,na,1901,1544.0990559364675
STAT,1907,29,25-29,1936,57.792721775263345
STAT,1865,48,15-19,1913,3.382025815758444E-4
STAT,1825,105,na,1930,0.015583516604053764
SIM,1915,29,25-29,1944,61
STAT,1911,29,45-49,1940,1.5802962725071579
STAT,1819,47,na,1866,1423.0173327546347
STAT,1835,27,15-19,1862,0.3763466349896178
STAT,1857,15,35-39,1872,0.48621726408289995
STAT,1899,33,35-39,1932,13.053183570117735
STAT,1911,18,35-39,1929,0.7911992429457994
STAT,1848,28,na,1876,1905.195943373783
STAT,1881,39,50-100,1920,1.109169235973143
STAT,1884,8,na,1892,2426.210355750221
STAT,1853,23,15-19,1876,2.9287621238012336
SIM,1860,96,na,1956,8
SIM,1814,90,na,1904,15
SIM,1902,24,20-24,1926,82
STAT,1880,72,na,1952,1257.7610626221706
STAT,1852,34,50-100,1886,0.6736316545237714
STAT,1884,86,na,1970,478.52889584845815
STAT,1867,18,20-24,1885,15.982598963500315
STAT,1940,24,45-49,1964,1.0820757471894529
STAT,1944,17,50-100,1961,0.3808870884524696
SIM,1843,92,na,1935,21
SIM,1930,29,20-24,1959,24
STAT,1847,65,na,1912,1246.1905965885348
STAT,1838,18,na,1856,2023.558379801339
STAT,1845,17,30-34,1862,1.4255266761027703
STAT,1901,51,na,1952,2860.9250128592216
STAT,1922,29,20-24,1951,19.37359756692447
STAT,1768,92,na,1860,7.234507136980003
STAT,1910,17,35-39,1927,0.7854922712580856
STAT,1834,54,20-24,1888,4.513260587365871E-4
STAT,1827,47,40-44,1874,0.15659417272238862
STAT,1865,22,25-29,1887,49.61333013899665
STAT,1851,70,na,1921,1009.2915511410848
STAT,1910,23,20-24,1933,98.3453066381181
STAT,1884,65,na,1949,1577.277024542799
SIM,1784,75,na,1859,338
SIM,1873,22,25-29,1895,2
SIM,1859,19,20-24,1878,19
STAT,1841,50,45-49,1891,0.010148807793207744
STAT,1930,23,40-44,1953,4.056524997633849
STAT,1950,15,15-19,1965,50.721906056496394
STAT,1888,79,na,1967,1142.1079187550372
STAT,1920,33,25-29,1953,9.523504815101244
SIM,1846,15,25-29,1861,8
SIM,1901,26,25-29,1927,53
STAT,1859,98,na,1957,3.3346196658156444
SIM,1881,58,na,1939,1533
STAT,1894,24,15-19,1918,3.9801052426184644
STAT,1925,22,20-24,1947,125.73460193426948
SIM,1892,22,35-39,1914,11
SIM,1876,39,50-100,1915,2
SIM,1901,15,15-19,1916,8
SIM,1937,34,35-39,1971,6
STAT,1861,17,15-19,1878,5.35787048891181
STAT,1860,48,50-100,1908,0.18588934819282232
STAT,1906,28,25-29,1934,57.99781257128504
SIM,1928,24,40-44,1952,4
STAT,1802,90,na,1892,27.641082079160146
STAT,1936,24,25-29,1960,83.36655280219571
STAT,1918,44,30-34,1962,0.1279843843797511
STAT,1853,101,na,1954,0.4318457253418046
STAT,1768,105,na,1873,0.013792295990297996
STAT,1783,81,na,1864,168.63338169469947
STAT,1871,54,50-100,1925,0.01377787485003723
STAT,1913,38,45-49,1951,0.6324240457154426
SIM,1892,33,45-49,1925,2
STAT,1851,37,50-100,1888,0.8926258171814954
STAT,1826,92,na,1918,22.744032428237393
STAT,1829,46,50-100,1875,0.20339082485659254
SIM,1958,8,na,1966,4784
STAT,1951,16,15-19,1967,51.068398147278316
STAT,1813,42,na,1855,1326.304131113677
STAT,1942,22,20-24,1964,110.13982950553132
SIM,1856,99,na,1955,1
STAT,1873,32,30-34,1905,16.72840789959853
SIM,1928,43,45-49,1971,1
SIM,1868,79,na,1947,551
SIM,1926,32,30-34,1958,20
STAT,1868,48,40-44,1916,0.15237086226263244
STAT,1924,23,50-100,1947,0.7312012124474692
SIM,1820,75,na,1895,499
SIM,1949,16,25-29,1965,55
STAT,1900,29,15-19,1929,0.5903296372464546
SIM,1809,60,na,1869,990
SIM,1944,24,25-29,1968,101
SIM,1872,84,na,1956,309
STAT,1858,43,45-49,1901,1.1005258530742859
STAT,1860,21,50-100,1881,0.3245507467430867
STAT,1941,29,30-34,1970,38.25349593374578
STAT,1823,44,na,1867,1439.0674827366856
SIM,1841,29,na,1870,1745
SIM,1907,38,35-39,1945,10
STAT,1879,20,30-34,1899,17.719185019717703
STAT,1941,25,45-49,1966,1.689787830125547
SIM,1887,16,25-29,1903,4
SIM,1933,22,20-24,1955,125
STAT,1935,32,30-34,1967,20.591508716108226
STAT,1843,18,50-100,1861,0.042039456353018305
SIM,1859,17,25-29,1876,7
SIM,1881,32,30-34,1913,19
SIM,1858,40,50-100,1898,1
STAT,1913,17,50-100,1930,0.07236760639787422
SIM,1946,16,na,1962,3737
STAT,1879,17,30-34,1896,1.576134770244256
SIM,1933,20,na,1953,4653
STAT,1891,48,50-100,1939,0.15988706144940773
STAT,1926,35,20-24,1961,0.30486661489354844
SIM,1814,41,30-34,1855,3
SIM,1844,66,na,1910,1073
SIM,1866,43,45-49,1909,1
SIM,1914,17,15-19,1931,7
STAT,1847,102,na,1949,0.21618936003524378
STAT,1855,19,40-44,1874,0.15277749546458602
STAT,1906,17,15-19,1923,8.165371005665815
SIM,1914,28,25-29,1942,60
SIM,1870,18,na,1888,2333
SIM,1876,90,na,1966,195
STAT,1929,34,35-39,1963,10.951249815798505
SIM,1902,48,50-100,1950,2
SIM,1850,20,35-39,1870,6
SIM,1868,68,na,1936,1349
SIM,1917,22,15-19,1939,4
STAT,1882,22,30-34,1904,16.364418172105818
SIM,1858,37,50-100,1895,1
SIM,1869,21,20-24,1890,65
SIM,1927,23,40-44,1950,5
STAT,1892,45,50-100,1937,0.16556041465172336
STAT,1926,29,35-39,1955,16.880391872917873
STAT,1842,44,50-100,1886,0.771517075179786
STAT,1902,37,30-34,1939,1.5336728399865136
STAT,1925,42,15-19,1967,0.0017563657039126577
SIM,1917,33,25-29,1950,11
SIM,1849,28,20-24,1877,14
SIM,1895,61,na,1956,2380
SIM,1937,33,45-49,1970,1
STAT,1892,34,15-19,1926,0.1670612613523184
STAT,1916,28,na,1944,3646.288696537112
SIM,1855,29,na,1884,1969
STAT,1911,34,40-44,1945,3.569217324658572
SIM,1929,23,na,1952,4334
STAT,1912,46,na,1958,3343.8238182412715
STAT,1872,19,40-44,1891,0.1723853266559103
SIM,1857,106,na,1963,1
SIM,1891,21,35-39,1912,9
STAT,1879,5,na,1884,2681.7516637853573
STAT,1884,33,45-49,1917,1.620677135849819
SIM,1840,31,30-34,1871,32
STAT,1871,19,50-100,1890,0.0457114613974219
SIM,1899,19,20-24,1918,26
STAT,1909,22,15-19,1931,4.6739930930159295
STAT,1925,34,20-24,1959,2.732698921254188
STAT,1795,63,na,1858,895.0443199159917
SIM,1824,30,35-39,1854,10
SIM,1902,4,na,1906,3518
SIM,1933,34,20-24,1967,3
SIM,1944,12,na,1956,3898
STAT,1817,42,45-49,1859,3.8033387822731415
STAT,1956,2,na,1958,4918.517766267263
STAT,1874,36,na,1910,2284.989396874585
STAT,1824,93,na,1917,16.11449816063223
STAT,1828,49,50-100,1877,0.19368190069388738
STAT,1885,28,na,1913,2239.3439293104643
SIM,1890,22,30-34,1912,31
SIM,1874,5,na,1879,2592
STAT,1919,23,40-44,1942,3.4674598068736535
STAT,1847,45,35-39,1892,0.1042662427143689
STAT,1884,22,35-39,1906,5.446374436928353
SIM,1907,19,30-34,1926,3
SIM,1938,26,20-24,1964,13
STAT,1922,0,na,1922,4925.501006439173
SIM,1851,36,na,1887,1777
STAT,1905,49,15-19,1954,3.016678540903459E-4
STAT,1862,54,na,1916,1691.327879539969
SIM,1875,33,45-49,1908,1
SIM,1825,42,45-49,1867,1
STAT,1909,35,20-24,1944,0.23796402083351365
SIM,1839,25,35-39,1864,6
STAT,1824,106,na,1930,0.006694768296417535
SIM,1933,28,35-39,1961,22
STAT,1867,33,45-49,1900,1.540378453569
STAT,1851,62,na,1913,1314.7655270077423
SIM,1868,28,30-34,1896,22
SIM,1883,36,na,1919,2187
SIM,1898,1,na,1899,3349
STAT,1837,55,na,1892,1341.9128687116815
STAT,1912,40,15-19,1952,0.0014151148979962367
SIM,1918,31,na,1949,3787
STAT,1863,95,na,1958,16.657985102367544
STAT,1897,49,50-100,1946,0.17137310450813342
STAT,1940,26,50-100,1966,0.9592800467436924
STAT,1792,66,na,1858,746.0096750968365
STAT,1827,33,15-19,1860,0.163901211161531
STAT,1898,16,35-39,1914,0.7032033754639561
STAT,1965,4,na,1969,4637.018335166175
STAT,1846,91,na,1937,42.98011631951908
STAT,1916,32,20-24,1948,2.378983563470959
STAT,1944,22,30-34,1966,29.31582955930493
SIM,1823,31,30-34,1854,20
STAT,1870,49,35-39,1919,0.12703757054976622
SIM,1924,32,20-24,1956,2
STAT,1915,39,30-34,1954,1.7218701926901876
STAT,1887,34,50-100,1921,0.9598930996344074
STAT,1883,21,35-39,1904,5.421217511170537
SIM,1825,31,35-39,1856,7
STAT,1915,39,50-100,1954,0.3966568750631501
SIM,1893,46,na,1939,2831
STAT,1813,74,na,1887,472.73908663464283
SIM,1906,39,30-34,1945,1
STAT,1848,25,35-39,1873,8.68353105063697
STAT,1888,46,35-39,1934,0.15674652297873762
SIM,1872,21,25-29,1893,59
SIM,1892,21,na,1913,3132
SIM,1866,69,na,1935,1257
STAT,1803,67,na,1870,751.509297453495
STAT,1814,49,20-24,1863,0.03549900535902323
SIM,1788,70,na,1858,594
STAT,1813,44,35-39,1857,5.218766539228888
SIM,1903,27,40-44,1930,4
STAT,1876,28,50-100,1904,0.6221451543084582
SIM,1821,44,35-39,1865,4
STAT,1858,17,na,1875,1986.0496706533058
STAT,1833,35,50-100,1868,0.9615624404797375
STAT,1867,40,50-100,1907,0.9466115206335285
STAT,1816,93,na,1909,13.619082779725929
STAT,1928,35,30-34,1963,2.1796764124436643
SIM,1875,40,50-100,1915,2
STAT,1901,41,20-24,1942,0.014649171594348835
STAT,1920,19,45-49,1939,0.5266149701992421
STAT,1929,33,45-49,1962,1.8870061707129382
SIM,1886,20,15-19,1906,3
STAT,1907,4,na,1911,3650.678185566188
SIM,1920,23,30-34,1943,30
STAT,1915,15,20-24,1930,26.930984859751796
STAT,1925,28,35-39,1953,16.69260744329781
SIM,1929,39,25-29,1968,1
STAT,1838,31,25-29,1869,8.634003518532236
STAT,1950,15,45-49,1965,0.5583037511570875
SIM,1855,18,na,1873,2185
SIM,1821,38,na,1859,1491
SIM,1938,9,na,1947,3545
SIM,1800,79,na,1879,233
SIM,1933,37,25-29,1970,1
STAT,1880,3,na,1883,3015.4401018573344
STAT,1900,69,na,1969,2248.441514668366
SIM,1868,47,na,1915,2020
STAT,1869,57,na,1926,1839.193088424233
STAT,1885,18,15-19,1903,5.573590413719102
SIM,1898,23,40-44,1921,4
SIM,1820,36,40-44,1856,9
SIM,1943,23,25-29,1966,90
SIM,1933,26,15-19,1959,3
STAT,1874,87,na,1961,284.0399728940743
STAT,1912,23,30-34,1935,25.941563998698424
STAT,1908,25,30-34,1933,35.529136136893
STAT,1931,39,15-19,1970,0.02397421051759872
STAT,1792,63,na,1855,834.3044
STAT,1841,19,20-24,1860,15.578359619019313
SIM,1839,22,30-34,1861,22
SIM,1841,35,50-100,1876,1
STAT,1796,77,na,1873,337.901962465368
STAT,1890,23,50-100,1913,0.4695286422343304
STAT,1855,15,25-29,1870,4.8465539375745825
STAT,1944,19,50-100,1963,0.3806319367625603
STAT,1882,48,15-19,1930,3.6286836384592157E-4
STAT,1925,26,15-19,1951,0.7903792886190322
SIM,1936,35,30-34,1971,1
SIM,1857,84,na,1941,185
SIM,1893,18,15-19,1911,6
STAT,1879,47,50-100,1926,0.2417349966984142
SIM,1900,33,na,1933,3140
STAT,1935,12,na,1947,5117.065419557064
STAT,1935,23,25-29,1958,118.78762694227042
SIM,1893,35,na,1928,2943
SIM,1916,25,30-34,1941,51
SIM,1919,25,50-100,1944,1
SIM,1821,60,na,1881,1018
STAT,1925,37,25-29,1962,1.1163588108241576
STAT,1917,19,40-44,1936,1.4096834786847963
STAT,1832,34,35-39,1866,7.818659543158162
STAT,1838,30,50-100,1868,0.780410850929588
STAT,1922,13,na,1935,4325.26553382727
SIM,1940,18,25-29,1958,53
STAT,1901,54,na,1955,2769.002835595849
STAT,1902,37,50-100,1939,0.3533029833844943
SIM,1846,30,50-100,1876,4
SIM,1863,15,25-29,1878,4
SIM,1839,36,na,1875,1741
STAT,1880,22,20-24,1902,68.63235508227926
SIM,1917,35,na,1952,3713
STAT,1883,16,na,1899,2344.9953979694965
STAT,1842,20,35-39,1862,5.407543193450685
SIM,1865,28,na,1893,2102
SIM,1868,17,na,1885,2318
STAT,1868,34,15-19,1902,0.12725908364545216
STAT,1903,10,na,1913,3481.7925289998075
SIM,1923,15,20-24,1938,143
STAT,1932,18,25-29,1950,54.0661611535219
SIM,1867,43,na,1910,2194
STAT,1911,61,na,1972,3026.815730099307
STAT,1822,59,na,1881,1067.3547988958085
STAT,1806,54,45-49,1860,0.049067630891794764
STAT,1827,104,na,1931,0.03852805962428078
STAT,1844,47,40-44,1891,0.1183481256191052
STAT,1908,42,15-19,1950,0.0013422566259748915
STAT,1910,44,20-24,1954,0.015574220350652234
STAT,1918,32,30-34,1950,15.81625568549369
SIM,1854,6,na,1860,2378
SIM,1876,19,20-24,1895,18
STAT,1920,30,20-24,1950,2.544224670124042
SIM,1931,24,45-49,1955,2
SIM,1932,25,50-100,1957,1
STAT,1846,40,na,1886,1780.0395959554323
SIM,1780,82,na,1862,129
SIM,1834,59,na,1893,1190
SIM,1925,19,40-44,1944,1
STAT,1864,21,25-29,1885,49.32845079800637
SIM,1892,10,na,1902,3403
STAT,1873,45,45-49,1918,0.22836928484479369
STAT,1835,77,na,1912,550.1648392992105
STAT,1925,13,na,1938,4514.561990049574
SIM,1788,81,na,1869,191
SIM,1902,29,45-49,1931,5
STAT,1796,88,na,1884,46.7924107273555
STAT,1923,24,45-49,1947,1.2290240098770553
STAT,1898,32,35-39,1930,12.946639749557612
STAT,1924,25,45-49,1949,1.913117370538036
STAT,1820,45,35-39,1865,0.24185718345685372
SIM,1867,54,na,1921,2032
STAT,1875,54,50-100,1929,0.014261713771319564
STAT,1839,18,45-49,1857,0.05655824018203608
STAT,1870,23,15-19,1893,3.0479603597406797
STAT,1874,15,35-39,1889,0.5340733707477751
SIM,1932,25,45-49,1957,2
SIM,1839,41,35-39,1880,2
SIM,1923,39,na,1962,4177
STAT,1821,54,40-44,1875,0.015342504033729979
SIM,1834,67,na,1901,940
STAT,1848,95,na,1943,9.879356464708314
STAT,1904,15,45-49,1919,0.08892693509764553
STAT,1951,18,35-39,1969,4.718956420740187
STAT,1946,17,45-49,1963,0.5234253405431311
STAT,1872,28,50-100,1900,0.6040242828833556
STAT,1861,69,na,1930,1152.7364617531184
SIM,1953,16,45-49,1969,1
SIM,1845,11,na,1856,2119
STAT,1832,44,45-49,1876,1.0784821855830018
SIM,1857,22,40-44,1879,5
SIM,1819,59,na,1878,1115
SIM,1866,32,35-39,1898,11
STAT,1860,44,na,1904,1747.6745320951698
STAT,1868,39,50-100,1907,1.095478658214966
SIM,1911,9,na,1920,3745
STAT,1884,57,na,1941,1875.6302435475588
STAT,1883,72,na,1955,1169.7101430490163
STAT,1926,38,25-29,1964,1.135589875935728
SIM,1888,8,na,1896,2923
STAT,1913,35,40-44,1948,1.408918946617468
STAT,1871,36,na,1907,2220.7141416813515
STAT,1847,42,30-34,1889,0.8525019019106369
STAT,1850,77,na,1927,609.3302372676995
STAT,1952,19,35-39,1971,4.747179394959119
STAT,1895,49,na,1944,2713.5511006592774
SIM,1908,21,na,1929,3271
STAT,1894,64,na,1958,2180.9283315426565
STAT,1910,15,15-19,1925,8.534944309711175
STAT,1945,16,45-49,1961,0.5156508775948925
STAT,1926,41,25-29,1967,0.08328183267152246
SIM,1903,45,50-100,1948,3
SIM,1902,18,35-39,1920,1
SIM,1845,51,na,1896,1521
STAT,1919,39,50-100,1958,0.4252010192968441
SIM,1928,27,45-49,1955,2
STAT,1869,43,20-24,1912,0.14429407853401907
STAT,1926,38,na,1964,4339.105986293152
STAT,1882,51,45-49,1933,0.013396570015973166
SIM,1946,2,na,1948,4082
STAT,1930,38,45-49,1968,0.839167144317215
SIM,1970,0,na,1970,4533
SIM,1846,81,na,1927,353
STAT,1884,45,20-24,1929,0.011311506707897925
STAT,1921,17,40-44,1938,1.5061690309526472
STAT,1934,15,30-34,1949,15.647096570646696
STAT,1947,18,15-19,1965,48.28130883161223
SIM,1840,34,35-39,1874,10
STAT,1915,48,20-24,1963,0.010490881564761318
STAT,1879,21,15-19,1900,3.2721656504162726
SIM,1854,25,na,1879,2003
STAT,1839,34,50-100,1873,0.7352883338750011
SIM,1901,23,20-24,1924,90
STAT,1825,47,30-34,1872,0.09874461231753265
STAT,1868,19,20-24,1887,16.077711732981577
STAT,1965,7,na,1972,4634.653851794793
SIM,1908,15,25-29,1923,7
STAT,1904,33,40-44,1937,3.3600444052054583
SIM,1818,74,na,1892,524
SIM,1840,44,45-49,1884,2
SIM,1888,33,25-29,1921,15
STAT,1873,94,na,1967,71.10482553162741
STAT,1910,26,25-29,1936,60.25201569475772
SIM,1960,7,na,1967,4856
STAT,1849,80,na,1929,463.86556475063924
STAT,1859,28,50-100,1887,0.4857677738968824
STAT,1851,37,30-34,1888,3.8748497365281773
STAT,1902,25,na,1927,3203.374100039782
STAT,1918,47,35-39,1965,0.1296147267239506
STAT,1935,27,40-44,1962,6.002190211533407
SIM,1806,49,na,1855,1272
SIM,1887,21,15-19,1908,6
STAT,1913,24,30-34,1937,27.247195573893123
SIM,1877,36,50-100,1913,1
SIM,1908,61,na,1969,2824
STAT,1849,22,40-44,1871,1.8892080571422614
STAT,1861,46,35-39,1907,0.11028042034852668
SIM,1848,19,15-19,1867,8
SIM,1921,24,30-34,1945,30
SIM,1875,30,40-44,1905,4
STAT,1924,45,30-34,1969,0.1007293252196856
SIM,1943,16,30-34,1959,12
STAT,1926,27,na,1953,4242.278889377114
STAT,1879,32,25-29,1911,10.128636867834024
STAT,1919,40,25-29,1959,0.07330806594255822
SIM,1921,35,40-44,1956,1
SIM,1943,27,40-44,1970,6
SIM,1800,90,na,1890,16
SIM,1855,42,30-34,1897,4
STAT,1935,16,30-34,1951,15.779856532678803
SIM,1887,32,25-29,1919,20
STAT,1817,54,20-24,1871,0.0015315586243731377
SIM,1824,89,na,1913,36
STAT,1856,39,na,1895,1719.0609783410398
STAT,1892,38,30-34,1930,6.27494570662658
SIM,1880,17,na,1897,2576
STAT,1949,15,na,1964,4046.370941679401
SIM,1847,77,na,1924,590
SIM,1942,15,30-34,1957,17
STAT,1919,15,35-39,1934,0.8829650584876585
SIM,1917,26,30-34,1943,49
STAT,1895,48,50-100,1943,0.1684803714181894
STAT,1852,50,20-24,1902,5.426693227100542E-4
STAT,1857,54,20-24,1911,5.346759512972926E-4
SIM,1932,35,na,1967,4720
STAT,1919,48,35-39,1967,0.13174075686564315
SIM,1806,60,na,1866,997
SIM,1846,31,25-29,1877,17
SIM,1858,69,na,1927,1170
STAT,1841,47,15-19,1888,2.7701468728379765E-4
STAT,1919,26,45-49,1945,1.7694841031211388
SIM,1917,37,40-44,1954,2
STAT,1802,109,na,1911,2.494339965613544E-4
STAT,1838,20,15-19,1858,2.9152605581527076
SIM,1932,25,15-19,1957,4
STAT,1848,21,40-44,1869,1.8989589370849336
SIM,1904,22,35-39,1926,11
SIM,1912,33,40-44,1945,5
STAT,1902,33,15-19,1935,0.18906116831024455
SIM,1865,31,35-39,1896,10
STAT,1871,50,30-34,1921,0.00566416509636348
SIM,1856,21,40-44,1877,8
SIM,1869,24,25-29,1893,55
STAT,1911,21,na,1932,3429.5116248269355
STAT,1915,35,na,1950,3624.5656260956607
STAT,1912,42,35-39,1954,0.18347712662293475
STAT,1853,104,na,1957,0.07508796304472339
STAT,1914,50,na,1964,3411.069827994108
STAT,1864,80,na,1944,520.840621378933
SIM,1814,44,35-39,1858,1
SIM,1823,37,50-100,1860,1
SIM,1882,43,na,1925,2159
STAT,1841,49,50-100,1890,0.16578430487425325
SIM,1927,15,35-39,1942,4
STAT,1824,37,na,1861,1578.5789690608465
STAT,1873,35,35-39,1908,6.841027253086768
STAT,1909,26,30-34,1935,35.79966072340177
STAT,1895,33,20-24,1928,3.3150348995194627
STAT,1857,31,35-39,1888,7.671107259644
STAT,1913,43,35-39,1956,0.18522291001375768
SIM,1866,80,na,1946,474
SIM,1888,13,na,1901,2904
SIM,1867,3,na,1870,2712
STAT,1935,35,35-39,1970,3.2006421771446867
SIM,1892,50,na,1942,2894
SIM,1927,26,45-49,1953,2
SIM,1943,27,na,1970,3670
SIM,1911,21,30-34,1932,28
SIM,1886,20,45-49,1906,3
SIM,1905,23,35-39,1928,9
SIM,1955,4,na,1959,4605
SIM,1868,23,25-29,1891,55
STAT,1868,44,25-29,1912,0.5709904223668362
STAT,1909,37,40-44,1946,1.3386387657306202
SIM,1779,96,na,1875,2
SIM,1947,12,na,1959,4117
STAT,1875,72,na,1947,1226.2894827008713
STAT,1813,41,50-100,1854,3.739709203008048
STAT,1828,42,20-24,1870,0.134644261706296
STAT,1858,32,35-39,1890,7.500930176604208
STAT,1880,35,35-39,1915,7.11106839210753
SIM,1881,35,35-39,1916,10
STAT,1860,84,na,1944,254.9895555266222
SIM,1813,97,na,1910,2
SIM,1918,38,40-44,1956,3
STAT,1836,70,na,1906,908.5839495373313
STAT,1804,60,na,1864,990.8938702299237
STAT,1897,22,50-100,1919,0.5151952177660617
STAT,1879,36,40-44,1915,4.34962991986058
SIM,1837,53,na,1890,1366
SIM,1905,20,30-34,1925,29
SIM,1890,22,25-29,1912,71
STAT,1820,42,30-34,1862,2.1126927485751033
STAT,1863,29,40-44,1892,2.4656251329233125
SIM,1884,55,na,1939,2039
STAT,1892,39,20-24,1931,0.9029272341520453
STAT,1902,44,40-44,1946,0.20543229724542472
SIM,1901,35,30-34,1936,1
STAT,1822,50,40-44,1872,0.014176691664849821
STAT,1903,34,50-100,1937,0.7011150548341443
SIM,1818,37,30-34,1855,3
SIM,1919,20,15-19,1939,5
STAT,1936,27,35-39,1963,13.573220949842295
STAT,1879,20,25-29,1899,56.946410325159015
STAT,1942,14,na,1956,3876.633677975098
SIM,1833,63,na,1896,1061
SIM,1797,61,na,1858,894
SIM,1827,37,40-44,1864,5
SIM,1924,8,na,1932,4508
STAT,1805,53,45-49,1858,0.052213358749017294
SIM,1928,20,25-29,1948,111
STAT,1837,26,35-39,1863,8.095684588091146
STAT,1855,20,na,1875,1800.815527165612
STAT,1877,28,30-34,1905,24.589754434761584
SIM,1793,71,na,1864,536
SIM,1829,58,na,1887,1138
STAT,1856,20,30-34,1876,15.469494565212468
STAT,1931,18,45-49,1949,0.6160591506257485
STAT,1869,2,na,1871,3053.6196440974413
SIM,1936,6,na,1942,3008
STAT,1851,30,na,1881,1824.1400925512555
STAT,1868,72,na,1940,1138.3003642261708
SIM,1789,66,na,1855,677
SIM,1883,15,15-19,1898,6
SIM,1888,45,na,1933,2571
STAT,1888,43,50-100,1931,1.1709535692109634
STAT,1900,25,20-24,1925,15.478422423522796
STAT,1930,20,15-19,1950,6.480512544474966
STAT,1875,15,15-19,1890,5.789309459055187
STAT,1854,45,35-39,1899,0.10116653441847402
STAT,1894,47,30-34,1941,0.06598200803067147
SIM,1823,31,25-29,1854,11
SIM,1808,64,na,1872,895
STAT,1871,24,15-19,1895,3.075349553055431
SIM,1885,28,30-34,1913,30
SIM,1924,35,25-29,1959,1
SIM,1918,17,40-44,1935,1
STAT,1843,37,15-19,1880,0.04427923128955787
STAT,1916,28,20-24,1944,17.767329043777817
SIM,1905,64,na,1969,2579
STAT,1872,44,45-49,1916,1.3990393976563413
STAT,1916,35,25-29,1951,0.9615759944005365
SIM,1871,35,35-39,1906,14
STAT,1848,48,15-19,1896,2.934883430417333E-4
STAT,1914,27,15-19,1941,0.6723290518779211
STAT,1848,20,50-100,1868,0.3743037583708958
SIM,1861,60,na,1921,1644
STAT,1814,48,45-49,1862,0.709900292767034
SIM,1887,36,40-44,1923,7
SIM,1924,15,15-19,1939,47
STAT,1856,45,45-49,1901,0.17568457096253556
SIM,1863,37,50-100,1900,3
STAT,1887,31,15-19,1918,0.15109490931391903
STAT,1787,106,na,1893,0.004474821427439761
SIM,1851,17,20-24,1868,17
SIM,1916,29,40-44,1945,5
STAT,1847,42,25-29,1889,0.4761722354478913
STAT,1867,21,45-49,1888,0.6256188914685161
SIM,1859,56,na,1915,1634
STAT,1909,38,30-34,1947,1.6216992216854755
SIM,1924,28,20-24,1952,22
STAT,1831,45,40-44,1876,0.12514739558487672
STAT,1825,48,20-24,1873,0.01207274698778042
STAT,1917,13,na,1930,4008.6510657487065
STAT,1843,17,20-24,1860,15.302814575500959
STAT,1917,15,na,1932,3944.653077925653
SIM,1885,40,45-49,1925,2
SIM,1949,16,30-34,1965,15
STAT,1848,32,50-100,1880,0.7939614077702191
SIM,1831,62,na,1893,1095
SIM,1917,38,30-34,1955,2
SIM,1950,18,20-24,1968,137
SIM,1875,21,45-49,1896,2
STAT,1908,29,40-44,1937,4.132874741795898
SIM,1836,93,na,1929,19
SIM,1892,72,na,1964,1989
STAT,1845,34,15-19,1879,0.11735542673881316
STAT,1885,42,na,1927,2173.6846001650515
STAT,1840,78,na,1918,512.7555703060674
STAT,1786,89,na,1875,33.96641275930055
STAT,1927,34,30-34,1961,18.284881127240542
SIM,1871,100,na,1971,4
SIM,1910,28,35-39,1938,16
STAT,1942,18,20-24,1960,133.80420320285023
STAT,1920,37,40-44,1957,1.5483674602748743
STAT,1946,26,na,1972,3944.003555403404
SIM,1889,42,50-100,1931,2
SIM,1951,17,25-29,1968,55
SIM,1880,44,45-49,1924,2
STAT,1934,19,40-44,1953,1.777679904475665
STAT,1844,16,25-29,1860,5.032562365608827
SIM,1919,33,35-39,1952,9
STAT,1848,9,na,1857,2244.1700928436594
STAT,1905,28,45-49,1933,1.5107759727080514
STAT,1941,29,25-29,1970,64.25953751404955
STAT,1872,24,na,1896,2227.0368064303657
SIM,1905,42,na,1947,3129
STAT,1792,95,na,1887,2.5812103296089006
STAT,1880,25,25-29,1905,42.41527982747872
STAT,1910,47,25-29,1957,0.04675569032880586
STAT,1852,17,30-34,1869,1.3975739081709329
STAT,1874,25,na,1899,2319.155970802515
SIM,1892,18,20-24,1910,20
STAT,1919,41,15-19,1960,0.0015744208839659172
STAT,1863,16,35-39,1879,0.5221470019242175
STAT,1889,49,15-19,1938,2.576514436330533E-4
STAT,1894,34,25-29,1928,12.328564551108334
SIM,1930,31,na,1961,4619
STAT,1929,31,30-34,1960,18.916014575812927
STAT,1899,49,15-19,1948,2.8596212643794373E-4
SIM,1889,33,40-44,1922,8
STAT,1875,34,15-19,1909,0.13709604315084037
STAT,1902,28,35-39,1930,12.818972550765388
STAT,1826,47,25-29,1873,0.0531814273352282
STAT,1943,17,25-29,1960,43.41218665364748
STAT,1866,49,20-24,1915,0.010237545924202122
SIM,1835,43,25-29,1878,2
STAT,1821,38,35-39,1859,14.143567821990903
STAT,1843,44,20-24,1887,0.10765225723797056
STAT,1831,43,45-49,1874,1.0903511845103737
STAT,1851,31,35-39,1882,7.66134787636449
STAT,1920,17,30-34,1937,12.91868816155713
SIM,1896,9,na,1905,3275
STAT,1837,39,40-44,1876,3.387907661338158
SIM,1865,19,15-19,1884,6
STAT,1885,50,na,1935,2056.6527779402663
STAT,1876,54,30-34,1930,0.005649953489022205
SIM,1888,67,na,1955,1763
STAT,1827,43,25-29,1870,0.6055298721542992
SIM,1860,17,30-34,1877,2
STAT,1924,22,40-44,1946,3.748019303414085
STAT,1869,17,40-44,1886,0.16970889874079584
STAT,1890,15,40-44,1905,0.2122282634830767
STAT,1820,39,30-34,1859,10.818096342175183
SIM,1806,63,na,1869,910
STAT,1868,70,na,1938,1264.6498708165966
STAT,1882,22,25-29,1904,52.59242289779269
SIM,1942,19,40-44,1961,1
SIM,1913,28,45-49,1941,1
SIM,1831,24,40-44,1855,5
STAT,1844,68,na,1912,1061.369393303993
SIM,1937,31,30-34,1968,21
STAT,1842,87,na,1929,127.58700344748429
SIM,1890,35,45-49,1925,3
STAT,1877,37,50-100,1914,1.2031076759835175
STAT,1817,80,na,1897,286.3123060939305
SIM,1910,44,40-44,1954,2
STAT,1857,19,15-19,1876,5.135867350586442
SIM,1894,28,40-44,1922,4
STAT,1872,46,40-44,1918,0.1626858137958077
STAT,1884,18,20-24,1902,16.5030540444834
STAT,1886,28,40-44,1914,2.9787819897051993
SIM,1781,78,na,1859,251
STAT,1922,25,40-44,1947,5.016360007683734
SIM,1804,82,na,1886,153
SIM,1823,44,45-49,1867,1
SIM,1930,25,40-44,1955,6
SIM,1889,20,35-39,1909,8
STAT,1895,46,35-39,1941,0.09753753589212008
STAT,1942,25,25-29,1967,65.31878910641073
STAT,1878,15,na,1893,2498.0639565270494
SIM,1844,80,na,1924,364
STAT,1909,15,50-100,1924,0.06973323351213219
SIM,1916,22,50-100,1938,1
SIM,1895,15,na,1910,3236
STAT,1819,37,40-44,1856,12.147568653874572
SIM,1875,94,na,1969,97
STAT,1877,55,na,1932,2026.2241707497003
SIM,1821,34,25-29,1855,17
SIM,1861,33,25-29,1894,13
SIM,1842,22,na,1864,1845
SIM,1884,38,25-29,1922,2
SIM,1849,38,30-34,1887,6
SIM,1942,24,20-24,1966,104
SIM,1891,25,na,1916,2824
STAT,1849,38,20-24,1887,0.5853725692271957
SIM,1884,23,na,1907,2322
SIM,1826,83,na,1909,182
STAT,1888,40,20-24,1928,0.17909561292733808
STAT,1869,46,25-29,1915,0.05286457927041638
SIM,1839,34,na,1873,1750
SIM,1809,50,50-100,1859,1
STAT,1846,54,45-49,1900,0.010467912243440538
STAT,1908,30,na,1938,3399.7135558617797
STAT,1835,43,50-100,1878,0.795408926808294
SIM,1797,93,na,1890,6
SIM,1851,41,50-100,1892,1
SIM,1923,19,15-19,1942,45
STAT,1864,28,45-49,1892,0.9315532484333812
SIM,1833,21,40-44,1854,1
SIM,1945,23,35-39,1968,11
STAT,1915,19,15-19,1934,8.925219433649593
SIM,1842,31,35-39,1873,10
STAT,1886,35,15-19,1921,0.05656941292643444
STAT,1899,29,20-24,1928,15.076690441113715
STAT,1819,61,na,1880,1083.5974724217467
STAT,1897,53,na,1950,2676.6705602009247
STAT,1951,6,na,1957,4422.386252767531
STAT,1819,44,15-19,1863,0.027092289291290986
STAT,1917,47,na,1964,3625.1152848189317
SIM,1886,24,30-34,1910,18
SIM,1795,80,na,1875,222
SIM,1925,24,20-24,1949,121
STAT,1938,17,na,1955,3430.102312559014
STAT,1894,1,na,1895,3304.480544536581
STAT,1850,6,na,1856,2148.999614832
STAT,1915,39,25-29,1954,0.9302057311746701
SIM,1904,17,na,1921,3496
SIM,1932,22,40-44,1954,4
STAT,1859,20,40-44,1879,1.8123094575906484
STAT,1878,21,20-24,1899,68.05060215335844
SIM,1888,24,35-39,1912,8
STAT,1838,35,40-44,1873,3.6206617934393943
SIM,1855,72,na,1927,939
STAT,1917,24,20-24,1941,110.94561463000551
STAT,1928,40,50-100,1968,0.14187156189423625
STAT,1934,24,20-24,1958,141.07169501724547
STAT,1904,16,35-39,1920,0.7453579628818012
SIM,1901,23,50-100,1924,2
STAT,1859,27,25-29,1886,32.35504101530005
STAT,1878,24,30-34,1902,17.42677776272494
STAT,1860,23,15-19,1883,2.5880467608192195
STAT,1871,29,35-39,1900,8.986700497407304
STAT,1904,40,na,1944,3174.3870021677403
STAT,1908,49,35-39,1957,0.1095086609349943
SIM,1923,39,25-29,1962,1
STAT,1904,36,45-49,1940,0.5858552963449883
STAT,1770,112,na,1882,5.638287120427156E-4
SIM,1852,16,25-29,1868,6
STAT,1827,88,na,1915,79.29935683832717
SIM,1902,27,30-34,1929,38
STAT,1855,46,40-44,1901,0.12200470052242236
STAT,1925,21,45-49,1946,1.276142413010321
SIM,1935,34,30-34,1969,25
STAT,1858,38,30-34,1896,3.927939829746263
STAT,1826,63,na,1889,985.3516634619388
STAT,1834,31,35-39,1865,8.134436416389034
STAT,1841,38,na,1879,1721.7377546471216
SIM,1883,33,50-100,1916,3
STAT,1917,44,15-19,1961,0.0015089643730408124
SIM,1867,27,25-29,1894,49
STAT,1767,96,na,1863,1.2833977544525967
STAT,1867,48,25-29,1915,0.050453676336750054
SIM,1862,20,na,1882,2062
STAT,1853,33,25-29,1886,7.900045462369545
SIM,1847,23,35-39,1870,5
SIM,1867,20,40-44,1887,2
SIM,1867,51,na,1918,2100
SIM,1833,41,35-39,1874,4
STAT,1868,27,na,1895,2151.0739032301785
SIM,1897,25,45-49,1922,3
SIM,1916,21,45-49,1937,1
SIM,1846,35,40-44,1881,4
STAT,1877,25,50-100,1902,0.6311095392293832
STAT,1813,49,40-44,1862,0.4529946258941113
STAT,1943,3,na,1946,4028.278119272576
STAT,1826,49,na,1875,1359.788449845628
STAT,1830,49,40-44,1879,0.1250087576521864
SIM,1816,41,35-39,1857,1
STAT,1858,94,na,1952,14.803317502839537
STAT,1892,32,35-39,1924,11.98285402717812
STAT,1881,39,45-49,1920,1.80095879368649
STAT,1918,23,25-29,1941,93.8233239723464
SIM,1905,10,na,1915,3494
SIM,1876,26,na,1902,2336
SIM,1884,77,na,1961,1015
SIM,1921,20,15-19,1941,5
STAT,1895,36,25-29,1931,3.563082663960412
STAT,1897,75,na,1972,1746.363733526654
STAT,1935,31,50-100,1966,1.0812218204908424
SIM,1797,95,na,1892,2
SIM,1883,32,35-39,1915,10
STAT,1875,32,35-39,1907,9.833529685351166
STAT,1909,18,na,1927,3568.854692407593
SIM,1916,34,20-24,1950,4
STAT,1837,26,50-100,1863,0.53671740259979
STAT,1840,38,45-49,1878,1.5313450201822436
STAT,1831,93,na,1924,17.06428663212278
STAT,1937,23,35-39,1960,8.659320623288352
STAT,1908,21,45-49,1929,0.9801713623682644
SIM,1813,43,na,1856,1398
SIM,1868,38,40-44,1906,3
STAT,1829,102,na,1931,0.17714675281505823
STAT,1889,24,na,1913,2740.9823183612325
STAT,1809,102,na,1911,0.1176488143295829
STAT,1839,99,na,1938,1.2609333344047273
STAT,1850,103,na,1953,0.10116709406604645
STAT,1899,16,15-19,1915,7.700564847611187
SIM,1821,52,na,1873,1223
STAT,1825,41,35-39,1866,2.0174113555410393
SIM,1926,23,25-29,1949,99
STAT,1867,28,30-34,1895,22.259679789875083
STAT,1889,25,45-49,1914,1.3036814186145358
SIM,1906,32,40-44,1938,2
STAT,1839,23,35-39,1862,4.956245310680095
STAT,1853,46,30-34,1899,0.07346585801311804
SIM,1854,33,na,1887,1904
STAT,1776,79,na,1855,248.31261000000003
STAT,1834,33,15-19,1867,0.1120361127247659
STAT,1896,34,na,1930,2951.8745398969477
SIM,1925,39,35-39,1964,5
STAT,1914,20,30-34,1934,26.778406643059494
SIM,1880,20,15-19,1900,3
STAT,1834,50,na,1884,1424.0253224220908
STAT,1861,43,30-34,1904,0.8965261870812874
SIM,1793,89,na,1882,32
STAT,1826,41,na,1867,1498.9551580329685
STAT,1839,81,na,1920,360.0400562491764
STAT,1862,39,35-39,1901,5.655431666110798
STAT,1858,2,na,1860,2591.172989919516
STAT,1893,71,na,1964,1835.076292104828
STAT,1908,34,20-24,1942,2.156473591802573
SIM,1848,19,na,1867,2062
SIM,1895,34,50-100,1929,1
STAT,1848,50,na,1898,1622.920178360463
SIM,1804,80,na,1884,227
STAT,1917,39,35-39,1956,2.3589413224139766
SIM,1870,39,35-39,1909,12
SIM,1914,25,na,1939,3571
SIM,1845,23,30-34,1868,20
STAT,1891,23,50-100,1914,0.47514502956322363
STAT,1904,30,15-19,1934,0.19452155354235307
STAT,1849,25,15-19,1874,0.40914965047976987
STAT,1860,17,20-24,1877,15.6725773535665
STAT,1864,66,na,1930,1380.0002933932324
SIM,1944,24,30-34,1968,35
STAT,1837,23,30-34,1860,15.0246728010088
SIM,1858,37,25-29,1895,5
STAT,1805,50,40-44,1855,0.040223461701123696
SIM,1895,47,na,1942,2848
STAT,1934,36,30-34,1970,2.378152857869811
STAT,1911,23,15-19,1934,4.754714472384268
STAT,1829,34,30-34,1863,16.501108667289998
STAT,1894,28,30-34,1922,30.464458203520362
STAT,1846,29,40-44,1875,2.6493953215854127
SIM,1892,24,15-19,1916,4
STAT,1903,24,35-39,1927,7.794670283984797
SIM,1842,54,na,1896,1392
STAT,1786,104,na,1890,0.0313405210155199
STAT,1877,87,na,1964,343.85742541251244
STAT,1852,34,20-24,1886,1.9873121653265604
STAT,1835,37,25-29,1872,2.265518137653553
STAT,1839,20,30-34,1859,15.459101248332725
STAT,1919,47,45-49,1966,0.22269637146229604
SIM,1901,38,35-39,1939,5
STAT,1809,69,na,1878,718.1106287622362
STAT,1837,45,35-39,1882,0.09676695854326114
STAT,1853,29,50-100,1882,0.5030507548428916
SIM,1925,19,na,1944,4164
STAT,1866,42,35-39,1908,1.5758581204572768
STAT,1919,27,35-39,1946,15.324854404619813
SIM,1864,32,25-29,1896,13
STAT,1898,39,15-19,1937,0.01533909425173218
SIM,1927,27,35-39,1954,21
STAT,1897,46,45-49,1943,0.16866359033244688
STAT,1872,41,40-44,1913,2.141006541699815
SIM,1853,49,na,1902,1664
SIM,1868,90,na,1958,76
STAT,1853,52,50-100,1905,0.011368856183081482
STAT,1840,24,50-100,1864,0.33545783430404036
STAT,1828,45,25-29,1873,0.04788817362155732
STAT,1864,35,50-100,1899,1.0435421725079241
SIM,1874,42,35-39,1916,1
SIM,1817,55,na,1872,1214
SIM,1909,23,25-29,1932,86
SIM,1858,21,45-49,1879,1
STAT,1856,23,35-39,1879,4.959577446696288
STAT,1856,32,25-29,1888,7.642028457600015
STAT,1858,31,45-49,1889,1.3050984583296177
SIM,1837,34,30-34,1871,21
STAT,1871,9,na,1880,2527.6990417069587
SIM,1911,24,35-39,1935,10
SIM,1936,28,na,1964,2803
SIM,1856,24,45-49,1880,1
SIM,1918,31,20-24,1949,4
STAT,1884,24,15-19,1908,3.059772096564379
SIM,1813,94,na,1907,8
STAT,1898,20,35-39,1918,7.504703891667408
STAT,1843,19,na,1862,1958.09527992075
SIM,1900,18,25-29,1918,12
SIM,1941,15,15-19,1956,36
STAT,1891,36,50-100,1927,1.4418692593801874
STAT,1932,39,50-100,1971,0.5317793064010499
STAT,1900,28,25-29,1928,55.241065671805
SIM,1843,41,na,1884,1691
SIM,1879,52,50-100,1931,1
SIM,1846,38,45-49,1884,2
STAT,1770,110,na,1880,0.001435718771280859
SIM,1953,17,35-39,1970,7
SIM,1929,35,45-49,1964,2
STAT,1924,17,na,1941,4140.658985849963
SIM,1853,91,na,1944,32
STAT,1839,67,na,1906,1055.4352438174424
SIM,1860,34,20-24,1894,2
SIM,1885,34,25-29,1919,6
STAT,1873,20,30-34,1893,17.168032935145813
SIM,1843,37,25-29,1880,2
SIM,1877,53,na,1930,2035
STAT,1897,21,na,1918,2996.981653819376
STAT,1877,34,25-29,1911,9.951149395784391
SIM,1857,42,35-39,1899,3
SIM,1933,21,45-49,1954,1
STAT,1841,71,na,1912,920.227459726824
SIM,1863,48,50-100,1911,1
STAT,1858,48,15-19,1906,2.9254966788626346E-4
SIM,1825,53,50-100,1878,1
STAT,1901,29,30-34,1930,33.06108486521416
STAT,1943,29,35-39,1972,15.090288662097931
SIM,1861,27,30-34,1888,25
SIM,1877,75,na,1952,952
SIM,1847,85,na,1932,172
STAT,1848,24,45-49,1872,0.6218739300172327
STAT,1849,44,15-19,1893,0.010215768866866424
STAT,1794,76,na,1870,372.4659338553439
STAT,1826,44,20-24,1870,0.1490967460746524
STAT,1924,29,25-29,1953,71.87923278759014
STAT,1908,46,30-34,1954,0.07673784352894177
STAT,1762,101,na,1863,0.061807617796944644
SIM,1934,17,25-29,1951,70
STAT,1817,53,50-100,1870,0.03197872666870654
STAT,1838,38,45-49,1876,1.5982550528968444
STAT,1842,27,15-19,1869,0.40631770543139484
STAT,1862,34,15-19,1896,0.11404051677361977
STAT,1920,32,50-100,1952,0.8555293043350266
STAT,1867,23,na,1890,2091.499950853973
SIM,1866,28,20-24,1894,15
STAT,1864,39,45-49,1903,1.661566606385391
STAT,1939,16,na,1955,3481.5821989950823
STAT,1858,28,20-24,1886,8.831297998128818
SIM,1851,39,na,1890,1718
SIM,1842,27,20-24,1869,13
SIM,1872,39,45-49,1911,2
STAT,1853,27,30-34,1880,22.077337105776074
STAT,1833,53,20-24,1886,4.574599389195782E-4
STAT,1834,36,na,1870,1668.8715349055617
SIM,1893,17,25-29,1910,8
STAT,1905,44,na,1949,3124.137296764812
STAT,1933,15,15-19,1948,57.658704057799355
STAT,1941,26,20-24,1967,17.846781919549347
SIM,1811,93,na,1904,14
STAT,1834,27,20-24,1861,9.54677687967614
STAT,1826,43,50-100,1869,1.0117495097332503
SIM,1854,29,40-44,1883,7
STAT,1876,38,25-29,1914,2.796172115246543
SIM,1822,79,na,1901,347
STAT,1885,17,25-29,1902,5.336038407805374
SIM,1872,52,na,1924,2003
SIM,1931,17,15-19,1948,51
STAT,1864,25,40-44,1889,2.5491385501378256
STAT,1928,20,15-19,1948,6.315990394366224
SIM,1834,43,50-100,1877,1
SIM,1862,35,25-29,1897,1
STAT,1805,79,na,1884,303.04028026460185
STAT,1931,27,15-19,1958,0.8609948579404963
SIM,1772,87,na,1859,39
SIM,1921,40,na,1961,3987
STAT,1923,17,15-19,1940,50.34297600003707
STAT,1886,16,50-100,1902,0.04900957826372773
SIM,1918,34,30-34,1952,20
STAT,1822,53,45-49,1875,0.01841001748382671
STAT,1860,21,35-39,1881,4.6443206423068615
STAT,1809,47,25-29,1856,0.16257069434223628
STAT,1844,60,na,1904,1324.5814568160354
STAT,1854,39,40-44,1893,3.1005151352632025
SIM,1864,57,na,1921,1807
STAT,1878,41,15-19,1919,0.013657580684614461
STAT,1941,22,40-44,1963,3.2825530648686483
SIM,1871,88,na,1959,188
STAT,1819,93,na,1912,15.427937156616608
STAT,1831,40,40-44,1871,1.7059283091620778
STAT,1854,35,25-29,1889,2.091543100196965
STAT,1922,16,na,1938,4034.083156023571
SIM,1936,20,15-19,1956,3
SIM,1932,29,25-29,1961,84
STAT,1893,35,20-24,1928,0.9322688609252204
SIM,1872,25,40-44,1897,2
SIM,1800,76,na,1876,326
SIM,1951,17,na,1968,4014
STAT,1926,17,25-29,1943,50.19122206908587
STAT,1829,30,15-19,1859,0.15024450491355193
SIM,1947,20,35-39,1967,9
STAT,1880,0,na,1880,3591.394311449591
SIM,1819,81,na,1900,271
SIM,1926,35,35-39,1961,4
SIM,1875,28,30-34,1903,27
SIM,1908,27,25-29,1935,70
STAT,1850,37,15-19,1887,0.04021150885498183
STAT,1806,94,na,1900,6.930841134788581
SIM,1940,19,15-19,1959,38
STAT,1875,28,20-24,1903,11.351313567424436
SIM,1886,27,35-39,1913,8
STAT,1934,27,25-29,1961,83.64713331714967
SIM,1888,21,30-34,1909,27
STAT,1801,107,na,1908,0.0016671102222142915
STAT,1815,44,45-49,1859,3.493578818618372
STAT,1884,38,15-19,1922,0.05215026113716964
STAT,1936,21,20-24,1957,100.45841515563019
STAT,1775,109,na,1884,0.0028871606138094878
SIM,1855,30,30-34,1885,24
STAT,1932,19,15-19,1951,56.465740505415134
SIM,1859,22,15-19,1881,2
STAT,1854,20,20-24,1874,58.773608522508134
SIM,1942,27,25-29,1969,67
STAT,1859,24,20-24,1883,52.990242599830786
SIM,1849,19,30-34,1868,2
STAT,1863,30,15-19,1893,0.11900739458303647
STAT,1838,52,25-29,1890,0.0023653307524218793
SIM,1904,35,40-44,1939,1
STAT,1935,28,30-34,1963,50.43257523705808
SIM,1862,76,na,1938,787
STAT,1882,35,45-49,1917,1.8488403364780495
SIM,1890,25,35-39,1915,14
SIM,1904,15,na,1919,3501
STAT,1925,25,25-29,1950,73.93803593765777
SIM,1944,21,20-24,1965,114
STAT,1831,95,na,1926,7.763073432335418
STAT,1896,21,15-19,1917,4.128571247520865
STAT,1947,20,25-29,1967,98.6921334287587
STAT,1866,22,40-44,1888,1.8304921753664554
STAT,1878,27,35-39,1905,9.49956881913909
STAT,1878,46,35-39,1924,0.13822421734602555
STAT,1914,58,na,1972,3265.2619515416113
SIM,1874,22,40-44,1896,1
STAT,1862,51,25-29,1913,0.0028746380143351
SIM,1853,17,30-34,1870,1
SIM,1837,21,na,1858,1825
SIM,1859,88,na,1947,90
STAT,1897,19,45-49,1916,0.08208472481781966
SIM,1886,36,na,1922,2315
STAT,1810,49,50-100,1859,0.7930359322318529
SIM,1833,31,na,1864,1685
STAT,1880,51,40-44,1931,0.010535019184004228
SIM,1791,90,na,1881,22
STAT,1774,90,na,1864,22.177532631810603
STAT,1901,17,20-24,1918,23.443178826100144
SIM,1828,39,40-44,1867,3
STAT,1930,26,45-49,1956,2.0761348481421336
STAT,1939,20,35-39,1959,8.939489590145703
STAT,1918,35,35-39,1953,2.4313167983099886
SIM,1810,54,na,1864,1122
STAT,1890,18,45-49,1908,0.07524759369107467
SIM,1863,20,15-19,1883,1
SIM,1876,38,30-34,1914,12
SIM,1933,25,25-29,1958,91
STAT,1913,31,na,1944,3569.414229979608
STAT,1845,27,40-44,1872,2.5801108116652363
SIM,1871,37,na,1908,2229
SIM,1887,20,25-29,1907,68
STAT,1828,49,40-44,1877,0.13500953348130867
STAT,1823,107,na,1930,0.0025238895451382922
SIM,1819,36,35-39,1855,8
STAT,1818,97,na,1915,2.63830127996157
SIM,1899,22,45-49,1921,4
SIM,1914,24,45-49,1938,2
STAT,1945,17,35-39,1962,4.330255363226224
STAT,1803,51,50-100,1854,0.04490136801735059
STAT,1877,40,45-49,1917,1.4814081900051712
STAT,1882,25,35-39,1907,8.924759286747259
STAT,1774,110,na,1884,0.001531417633416196
STAT,1915,36,20-24,1951,0.2527872976395043
SIM,1930,28,50-100,1958,2
SIM,1883,28,20-24,1911,14
STAT,1862,43,50-100,1905,0.8471516075437494
STAT,1899,32,45-49,1931,2.2572081298582596
STAT,1849,42,35-39,1891,1.3561995504497302
SIM,1937,8,na,1945,3564
STAT,1868,38,30-34,1906,4.779946195103847
SIM,1897,28,na,1925,3086
STAT,1928,16,45-49,1944,0.5960697131223551
STAT,1841,21,25-29,1862,50.35688217027386
STAT,1903,46,50-100,1949,0.18674601684702066
SIM,1875,6,na,1881,2638
SIM,1783,79,na,1862,246
STAT,1859,23,45-49,1882,0.5400830212337665
STAT,1906,24,45-49,1930,0.953441099312319
STAT,1854,24,50-100,1878,0.3379118835324552
STAT,1843,47,25-29,1890,0.038724349006854335
STAT,1881,38,na,1919,2139.4156819847735
STAT,1790,86,na,1876,66.43285388133003
STAT,1859,36,na,1895,1779.9629245613414
STAT,1871,90,na,1961,139.35596433582742
STAT,1824,49,50-100,1873,0.29102021509512105
SIM,1925,15,30-34,1940,16
SIM,1866,31,45-49,1897,2
STAT,1927,37,35-39,1964,2.840860201247906
STAT,1855,48,50-100,1903,0.1723369375007872
STAT,1871,17,40-44,1888,0.17268439544369774
SIM,1827,27,30-34,1854,26
SIM,1828,35,50-100,1863,1
SIM,1830,34,35-39,1864,14
SIM,1851,82,na,1933,299
STAT,1861,27,25-29,1888,33.46862512116372
STAT,1925,10,na,1935,4535.256559993897
SIM,1888,42,50-100,1930,1
SIM,1878,36,50-100,1914,1
SIM,1894,18,30-34,1912,2
SIM,1912,44,na,1956,3316
SIM,1943,28,30-34,1971,48
STAT,1836,49,35-39,1885,0.09247757014597592
SIM,1880,41,40-44,1921,5
STAT,1841,34,45-49,1875,1.4286618904239876
SIM,1838,42,25-29,1880,4
SIM,1862,74,na,1936,936
SIM,1944,15,na,1959,3637
STAT,1801,63,na,1864,835.2409091430227
STAT,1828,30,20-24,1858,3.0237910505086556
STAT,1933,37,50-100,1970,0.5402429500250528
SIM,1775,92,na,1867,7
STAT,1837,40,15-19,1877,0.010850491735338297
STAT,1822,34,35-39,1856,22.00845755992939
STAT,1864,88,na,1952,115.58890924031103
SIM,1847,20,30-34,1867,22
SIM,1916,5,na,1921,3930
SIM,1823,34,35-39,1857,10
STAT,1908,37,25-29,1945,0.8708943942459495
SIM,1845,26,35-39,1871,16
STAT,1847,30,30-34,1877,15.434018815831253
STAT,1886,18,30-34,1904,1.5863716675705317
SIM,1867,24,20-24,1891,64
STAT,1867,45,20-24,1912,0.010751062518760528
SIM,1907,15,15-19,1922,9
STAT,1817,47,15-19,1864,9.017451864004718E-4
STAT,1917,15,30-34,1932,2.48940717045918
SIM,1912,8,na,1920,3785
STAT,1906,28,50-100,1934,0.8770570467294446
STAT,1851,48,na,1899,1598.0717796751303
STAT,1919,28,na,1947,3810.36435361835
SIM,1939,20,40-44,1959,3
SIM,1921,29,na,1950,3931
STAT,1876,28,15-19,1904,0.44125714433832364
STAT,1891,38,15-19,1929,0.0653068614628883
SIM,1949,19,35-39,1968,4
STAT,1810,48,na,1858,1222.8751624560912
STAT,1950,19,25-29,1969,48.37476676391386
SIM,1848,32,40-44,1880,7
SIM,1916,37,25-29,1953,3
SIM,1901,52,na,1953,2848
STAT,1893,18,30-34,1911,1.9044967858681423
STAT,1827,37,30-34,1864,5.531962596671559
STAT,1851,38,20-24,1889,0.5546534467474182
SIM,1887,39,45-49,1926,2
SIM,1929,30,25-29,1959,13
SIM,1760,100,na,1860,1
STAT,1824,47,15-19,1871,4.876250763683229E-4
STAT,1874,54,20-24,1928,6.926704606418579E-4
STAT,1862,22,na,1884,1955.5462656147365
SIM,1903,23,30-34,1926,31
STAT,1924,46,15-19,1970,4.153166476098544E-4
STAT,1883,28,15-19,1911,0.4187461640693896
STAT,1907,25,15-19,1932,0.6338870893357105
SIM,1836,30,20-24,1866,3
SIM,1879,29,45-49,1908,2
SIM,1928,39,45-49,1967,3
STAT,1864,48,50-100,1912,0.2041899676846308
SIM,1834,27,30-34,1861,27
STAT,1812,45,30-34,1857,0.3350371452336308
SIM,1941,21,50-100,1962,3
SIM,1927,43,na,1970,4340
STAT,1879,39,45-49,1918,1.9514652544889788
STAT,1897,33,25-29,1930,12.885717667557955
SIM,1835,37,30-34,1872,5
SIM,1865,50,na,1915,1928
STAT,1848,22,30-34,1870,16.11564919230421
SIM,1843,39,na,1882,1734
SIM,1882,19,15-19,1901,5
SIM,1881,66,na,1947,1232
STAT,1922,15,50-100,1937,0.4115169030090491
STAT,1908,19,na,1927,3520.3839650177483
SIM,1847,19,20-24,1866,21
STAT,1902,21,50-100,1923,0.5453204070900184
SIM,1871,59,na,1930,1837
STAT,1853,74,na,1927,839.8836962829114
STAT,1928,16,50-100,1944,0.44705228484176635
STAT,1939,22,50-100,1961,0.6242713801485382
STAT,1921,7,na,1928,4304.413425065697
STAT,1878,24,25-29,1902,56.00666373860695
STAT,1933,21,50-100,1954,0.8270154920516628
STAT,1853,49,35-39,1902,0.10373927254991387
SIM,1920,27,40-44,1947,6
STAT,1835,34,20-24,1869,2.1452718049439827
STAT,1881,2,na,1883,2910.7008140597663
STAT,1846,34,30-34,1880,14.989058903464375
SIM,1826,69,na,1895,774
SIM,1900,27,20-24,1927,14
STAT,1860,27,30-34,1887,19.50898643337035
STAT,1881,51,35-39,1932,0.00789427462210136
SIM,1858,30,40-44,1888,6
SIM,1927,11,na,1938,4644
SIM,1938,24,40-44,1962,4
STAT,1865,29,15-19,1894,0.38571352879545623
STAT,1916,31,45-49,1947,1.5410237891678775
STAT,1808,84,na,1892,128.62596081380536
STAT,1895,21,20-24,1916,85.1287754533293
SIM,1885,37,50-100,1922,1
STAT,1917,36,30-34,1953,1.7969770008721473
SIM,1902,23,15-19,1925,4
STAT,1850,24,45-49,1874,0.5815521479900331
STAT,1912,27,40-44,1939,4.339385917612447
SIM,1906,41,na,1947,3200
SIM,1850,51,na,1901,1619
SIM,1843,34,20-24,1877,2
SIM,1873,30,50-100,1903,4
STAT,1804,94,na,1898,6.694666789773297
STAT,1831,61,na,1892,1091.0694088163525
STAT,1835,30,50-100,1865,0.758013775360638
SIM,1831,35,40-44,1866,8
STAT,1789,75,na,1864,362.7028438354287
SIM,1900,15,20-24,1915,20
STAT,1877,45,15-19,1922,3.9588133821555615E-4
STAT,1957,10,na,1967,4893.1249742247255
SIM,1925,36,30-34,1961,2
SIM,1875,49,na,1924,2129
STAT,1847,57,na,1904,1481.9164520979214
STAT,1919,24,30-34,1943,29.545401269166
STAT,1944,25,35-39,1969,15.342580869246502
STAT,1950,16,20-24,1966,151.48578761268865
SIM,1899,51,na,1950,2843
STAT,1931,20,30-34,1951,35.42465267707774
SIM,1929,20,40-44,1949,5
STAT,1893,47,15-19,1940,2.690544989342646E-4
STAT,1886,66,na,1952,1635.5852533629834
STAT,1912,38,na,1950,3451.8004704929
STAT,1824,34,45-49,1858,3.280616329700872
STAT,1858,34,15-19,1892,0.10457565900218743
STAT,1883,19,na,1902,2326.7052401867268
STAT,1873,15,40-44,1888,0.17732480135165354
SIM,1891,22,40-44,1913,2
SIM,1897,41,na,1938,3017
STAT,1930,1,na,1931,5100.323659283924
STAT,1908,3,na,1911,3704.7788283013256
SIM,1927,24,30-34,1951,35
SIM,1845,35,25-29,1880,1
STAT,1857,64,na,1921,1295.1830437912383
STAT,1950,16,50-100,1966,0.41862313141447344
STAT,1783,109,na,1892,0.0010630995171011892
STAT,1875,41,50-100,1916,1.0304719225353762
STAT,1895,27,50-100,1922,0.7878443136060902
STAT,1903,63,na,1966,2630.680365124091
STAT,1872,24,30-34,1896,16.77285195558793
SIM,1872,36,40-44,1908,11
STAT,1951,15,25-29,1966,48.775909298611865
STAT,1857,86,na,1943,165.31128960735123
SIM,1835,97,na,1932,2
SIM,1925,33,na,1958,4185
SIM,1932,26,20-24,1958,18
STAT,1946,26,40-44,1972,4.90721672086417
SIM,1806,95,na,1901,4
STAT,1883,22,40-44,1905,1.930051601443353
STAT,1939,19,25-29,1958,40.95126785482322
STAT,1900,21,40-44,1921,2.7390854424410103
STAT,1942,21,45-49,1963,1.1148665226700298
STAT,1837,35,25-29,1872,2.322816575852067
STAT,1840,21,na,1861,1797.3101866261663
STAT,1853,96,na,1949,6.498349176962832
STAT,1795,60,na,1855,1000.9781899999999
STAT,1853,24,20-24,1877,60.738925530392805
SIM,1950,21,45-49,1971,1
STAT,1857,35,45-49,1892,1.4993749641648386
SIM,1861,24,20-24,1885,59
STAT,1834,39,na,1873,1617.6856167740361
STAT,1855,52,na,1907,1521.952905424882
STAT,1875,33,50-100,1908,0.885933392761728
STAT,1787,97,na,1884,0.936784737030749
SIM,1873,37,na,1910,2264
STAT,1899,35,15-19,1934,0.07337692919235364
STAT,1783,84,na,1867,89.38654897550634
STAT,1847,25,40-44,1872,2.693586815331532
STAT,1849,48,30-34,1897,0.07167516174988153
SIM,1862,20,20-24,1882,69
STAT,1906,29,na,1935,3260.1577190318926
STAT,1873,23,35-39,1896,5.573781530514149
SIM,1845,23,25-29,1868,56
STAT,1837,23,25-29,1860,48.28671191002299
STAT,1839,19,20-24,1858,15.259498504913525
STAT,1836,33,25-29,1869,8.297372226247973
STAT,1821,33,15-19,1854,0.44647768539166477
STAT,1912,20,20-24,1932,101.2749713841427
STAT,1930,34,50-100,1964,1.006676131741546
STAT,1913,26,45-49,1939,1.6318437845334945
SIM,1879,34,35-39,1913,13
SIM,1860,19,na,1879,2207
STAT,1924,26,20-24,1950,20.146665781312745
STAT,1854,46,25-29,1900,0.04132894532783131
STAT,1887,36,35-39,1923,7.509817088376
STAT,1864,37,na,1901,1983.6662966080492
STAT,1841,24,35-39,1865,5.02348112892274
STAT,1842,34,na,1876,1857.0093066112593
SIM,1762,106,na,1868,1
SIM,1876,17,25-29,1893,9
SIM,1866,38,30-34,1904,6
SIM,1899,31,40-44,1930,5
STAT,1868,17,25-29,1885,5.200139486643431
STAT,1789,78,na,1867,272.93507083689946
STAT,1804,62,na,1866,919.6878007218982
STAT,1864,36,40-44,1900,3.7034734840142765
STAT,1832,27,na,1859,1721.6389669469677
SIM,1895,36,35-39,1931,16
SIM,1952,17,40-44,1969,1
SIM,1921,26,45-49,1947,2
STAT,1871,43,20-24,1914,0.1479019214355184
STAT,1944,17,40-44,1961,1.4219788093455688
STAT,1827,34,20-24,1861,2.989141558646282
STAT,1856,37,na,1893,1736.5384655848409
STAT,1877,24,15-19,1901,3.212589893661255
STAT,1853,44,15-19,1897,0.010310153657959368
SIM,1920,20,20-24,1940,116
STAT,1778,80,na,1858,220.39431238369548
STAT,1922,48,na,1970,3975.9890615923196
STAT,1926,45,50-100,1971,0.264877609605091
SIM,1939,23,45-49,1962,1
SIM,1828,42,na,1870,1549
STAT,1900,44,30-34,1944,0.1032123096235929
STAT,1836,44,15-19,1880,0.01036952205255559
STAT,1911,27,30-34,1938,36.099449125675086
SIM,1904,26,45-49,1930,1
SIM,1855,25,40-44,1880,2
SIM,1844,33,25-29,1877,13
SIM,1830,24,25-29,1854,45
SIM,1895,35,30-34,1930,8
SIM,1903,20,20-24,1923,102
SIM,1908,24,20-24,1932,87
SIM,1838,25,40-44,1863,2
SIM,1840,29,20-24,1869,9
SIM,1828,44,30-34,1872,7
STAT,1865,35,45-49,1900,1.7231664069340922
STAT,1915,32,40-44,1947,3.7652220924899646
STAT,1894,25,20-24,1919,14.339188378438973
STAT,1905,2,na,1907,3639.943703775699
SIM,1885,24,15-19,1909,3
SIM,1928,23,35-39,1951,11
STAT,1843,23,15-19,1866,2.7769088357721223
SIM,1864,35,35-39,1899,14
SIM,1919,24,30-34,1943,36
STAT,1888,47,na,1935,2500.1204347426096
STAT,1872,49,45-49,1921,0.21895904575761557
STAT,1920,44,50-100,1964,0.1221642542177089
STAT,1863,54,45-49,1917,0.011700196467137583
STAT,1897,24,35-39,1921,7.326289930683738
SIM,1824,35,na,1859,1577
STAT,1812,48,35-39,1860,0.4610189961770703
STAT,1928,39,na,1967,4482.003348529987
STAT,1836,46,30-34,1882,0.06644708147700272
STAT,1921,30,15-19,1951,0.13618223082999686
STAT,1871,93,na,1964,75.88632886910383
STAT,1876,20,40-44,1896,2.0459422793250153
STAT,1932,32,40-44,1964,4.914450326264886
STAT,1902,25,30-34,1927,33.80107265766631
SIM,1925,30,na,1955,4198
SIM,1890,44,35-39,1934,2
SIM,1924,19,30-34,1943,13
STAT,1882,85,na,1967,501.3916996005444
STAT,1847,46,40-44,1893,0.12660255016936783
STAT,1947,25,45-49,1972,1.8480721422296502
STAT,1893,2,na,1895,3193.5343287954174
STAT,1900,13,na,1913,3379.1439453311873
STAT,1879,11,na,1890,2557.584850777711
SIM,1913,30,30-34,1943,22
STAT,1897,36,35-39,1933,8.978812879504403
STAT,1843,64,na,1907,1174.1684514865494
SIM,1911,19,na,1930,3612
SIM,1838,33,35-39,1871,7
STAT,1872,25,35-39,1897,9.20513497374638
SIM,1817,87,na,1904,56
STAT,1880,54,45-49,1934,0.014055959577921896
SIM,1841,91,na,1932,39
SIM,1904,38,45-49,1942,2
STAT,1897,16,40-44,1913,0.2316440291577266
STAT,1853,71,na,1924,1010.1719373861725
SIM,1827,49,50-100,1876,1
STAT,1842,24,45-49,1866,0.6278249592915597
STAT,1819,90,na,1909,41.61953562923494
SIM,1869,20,15-19,1889,2
SIM,1835,34,20-24,1869,1
SIM,1885,38,40-44,1923,8
SIM,1903,3,na,1906,3533
SIM,1910,25,30-34,1935,48
STAT,1916,19,30-34,1935,2.4299100036663455
STAT,1909,34,15-19,1943,0.11485897314509512
STAT,1887,35,30-34,1922,5.685165922224428
STAT,1882,44,35-39,1926,1.6411666608628046
SIM,1802,59,na,1861,961
STAT,1846,35,35-39,1881,5.593271108932997
SIM,1869,36,25-29,1905,3
STAT,1815,57,na,1872,1137.2376819559165
SIM,1824,31,40-44,1855,9
SIM,1864,23,35-39,1887,6
STAT,1798,57,na,1855,1041.1741800000002
STAT,1863,35,35-39,1898,5.919261279720548
SIM,1844,23,15-19,1867,6
STAT,1837,39,50-100,1876,0.9501945043161191
SIM,1915,3,na,1918,3822
STAT,1867,77,na,1944,766.7833039967278
SIM,1934,22,15-19,1956,6
SIM,1880,22,30-34,1902,22
SIM,1854,79,na,1933,511
SIM,1899,22,na,1921,3147
SIM,1869,27,35-39,1896,11
STAT,1811,49,30-34,1860,0.31196992979488963
SIM,1908,18,35-39,1926,3
SIM,1879,26,40-44,1905,4
STAT,1906,29,15-19,1935,0.61978941282028
SIM,1829,35,40-44,1864,2
SIM,1881,32,25-29,1913,16
STAT,1811,52,30-34,1863,0.01895065671367548
SIM,1886,36,25-29,1922,2
STAT,1912,47,35-39,1959,0.11705871131967722
STAT,1917,18,35-39,1935,0.8508106564408817
SIM,1919,48,na,1967,3817
SIM,1925,18,35-39,1943,6
STAT,1939,16,20-24,1955,128.2390692445411
STAT,1877,84,na,1961,487.3537765707111
STAT,1862,36,30-34,1898,4.3255179872230185
SIM,1851,23,15-19,1874,2
SIM,1864,86,na,1950,173
STAT,1897,30,20-24,1927,3.4424470211921303
STAT,1924,26,na,1950,4134.586550984023
STAT,1898,15,45-49,1913,0.08389756874475776
STAT,1905,30,30-34,1935,24.032784756575623
STAT,1910,18,40-44,1928,0.2611447756224341
STAT,1920,33,na,1953,3896.9860087765305
STAT,1894,45,15-19,1939,2.7666073293829623E-4
STAT,1828,75,na,1903,579.7726990699057
STAT,1927,34,25-29,1961,10.726680065470365
SIM,1870,23,25-29,1893,65
STAT,1856,35,35-39,1891,5.262804666215871
SIM,1947,16,20-24,1963,129
STAT,1896,76,na,1972,1637.3797255215181
SIM,1854,35,35-39,1889,15
SIM,1928,36,40-44,1964,1
STAT,1852,46,15-19,1898,2.9081760695238426E-4
SIM,1923,32,40-44,1955,7
STAT,1852,53,30-34,1905,0.004246226339121218
STAT,1858,49,na,1907,1631.6218985912792
STAT,1831,48,45-49,1879,0.16597955070522805
SIM,1854,34,30-34,1888,18
SIM,1865,43,50-100,1908,1
SIM,1879,31,50-100,1910,1
STAT,1888,25,na,1913,2682.505978319238
SIM,1825,84,na,1909,164
STAT,1841,28,50-100,1869,0.5438247217090263
STAT,1868,35,20-24,1903,0.7013971522860929
STAT,1832,29,20-24,1861,9.385297480151246
STAT,1854,27,na,1881,1790.0393374136695
SIM,1875,27,na,1902,2323
STAT,1926,34,15-19,1960,0.14659739755097115
STAT,1862,23,25-29,1885,46.993819195831065
STAT,1916,30,na,1946,3718.39360745288
STAT,1886,69,na,1955,1464.476792977562
SIM,1943,24,15-19,1967,4
SIM,1835,21,15-19,1856,2
SIM,1924,31,45-49,1955,1
SIM,1834,23,15-19,1857,1
STAT,1838,82,na,1920,313.2401864520921
STAT,1936,24,30-34,1960,25.939955918618228
SIM,1883,78,na,1961,831
SIM,1899,54,na,1953,2739
SIM,1869,43,30-34,1912,1
SIM,1896,26,40-44,1922,9
STAT,1888,26,40-44,1914,3.355869044339052
STAT,1873,46,50-100,1919,0.2359810107717399
SIM,1824,57,na,1881,1171
STAT,1861,24,20-24,1885,54.81404161455388
STAT,1806,72,na,1878,574.0317834466874
SIM,1938,25,45-49,1963,1
STAT,1878,36,25-29,1914,2.848272156077582
SIM,1886,24,25-29,1910,74
SIM,1922,20,30-34,1942,36
SIM,1937,5,na,1942,3589
STAT,1864,34,na,1898,1992.004545132562
STAT,1926,22,15-19,1948,6.109200561961526
SIM,1855,33,35-39,1888,10
SIM,1849,15,15-19,1864,8
STAT,1906,42,40-44,1948,0.21464378426039613
STAT,1919,18,50-100,1937,0.3901025785031529
SIM,1882,11,na,1893,2464
STAT,1906,49,50-100,1955,0.1866362160223681
SIM,1907,39,40-44,1946,3
SIM,1952,10,na,1962,4388
STAT,1847,33,35-39,1880,8.67754097585418
STAT,1898,36,45-49,1934,2.5607786207744025
STAT,1820,87,na,1907,92.81339046691457
STAT,1900,40,15-19,1940,0.0012694324499690972
SIM,1830,28,40-44,1858,3
STAT,1928,37,50-100,1965,0.5012506480091189
STAT,1877,47,30-34,1924,0.0944154429141832
STAT,1908,43,50-100,1951,0.10206652863739525
SIM,1844,37,40-44,1881,9
SIM,1853,2,na,1855,2626
STAT,1891,15,35-39,1906,0.6443006216308015
STAT,1931,23,35-39,1954,11.500984158305242
SIM,1823,72,na,1895,655
SIM,1876,35,20-24,1911,1
SIM,1886,21,20-24,1907,65
STAT,1811,73,na,1884,535.4364100685104
STAT,1927,17,40-44,1944,1.6429192940037314
STAT,1866,19,50-100,1885,0.04330079877340161
SIM,1896,11,na,1907,3258
SIM,1832,24,35-39,1856,8
SIM,1826,61,na,1887,1015
STAT,1865,22,30-34,1887,15.437457271803254
SIM,1945,20,25-29,1965,110
STAT,1841,43,35-39,1884,1.2807264483078518
STAT,1916,30,50-100,1946,0.8128769380941193
SIM,1836,33,25-29,1869,14
SIM,1907,31,45-49,1938,1
STAT,1925,29,40-44,1954,5.163449892744087
SIM,1873,22,30-34,1895,2
SIM,1934,1,na,1935,5109
SIM,1866,15,15-19,1881,9
STAT,1887,33,30-34,1920,18.37155273308034
STAT,1842,48,20-24,1890,0.00858099530087157
SIM,1881,46,50-100,1927,4
SIM,1813,65,na,1878,862
STAT,1814,45,40-44,1859,0.5414374274666673
SIM,1903,26,35-39,1929,16
SIM,1838,21,25-29,1859,56
SIM,1837,24,na,1861,1818
STAT,1848,41,na,1889,1737.3878165614278
STAT,1888,47,40-44,1935,0.19024484883662973
SIM,1891,25,45-49,1916,2
SIM,1929,23,45-49,1952,1
STAT,1848,45,45-49,1893,0.1771099747471056
STAT,1947,24,40-44,1971,3.587592666161996
SIM,1880,24,30-34,1904,26
STAT,1873,18,45-49,1891,0.0624224608011411
STAT,1931,15,40-44,1946,1.7375328210085983
STAT,1933,36,15-19,1969,0.02473216615218506
STAT,1775,94,na,1869,3.679984426487619
STAT,1833,76,na,1909,581.2568790954109
STAT,1874,38,15-19,1912,0.05393285672484827
STAT,1836,37,40-44,1873,3.479495756636926
SIM,1931,29,15-19,1960,3
STAT,1848,29,15-19,1877,0.39670763187629904
STAT,1898,33,40-44,1931,5.520747117945659
SIM,1935,17,40-44,1952,5
STAT,1836,23,15-19,1859,2.7992163713637455
STAT,1892,44,na,1936,2707.1780373076085
SIM,1910,16,25-29,1926,9
SIM,1904,49,na,1953,3043
SIM,1851,27,30-34,1878,26
SIM,1868,46,50-100,1914,3
STAT,1828,33,25-29,1861,10.248286693373013
STAT,1859,107,na,1966,0.028596647416974784
SIM,1859,38,30-34,1897,5
STAT,1866,78,na,1944,680.7918431937982
SIM,1875,41,na,1916,2260
STAT,1843,27,30-34,1870,20.93265000292323
SIM,1879,31,30-34,1910,25
STAT,1881,36,40-44,1917,4.0141653741645
STAT,1820,109,na,1929,3.748024697489974E-4
SIM,1853,23,25-29,1876,47
STAT,1858,15,15-19,1873,5.195683529149656
SIM,1869,24,30-34,1893,16
STAT,1845,23,25-29,1868,49.92779567652398
STAT,1826,37,15-19,1863,0.06127636607114823
STAT,1863,34,30-34,1897,14.35048354198976
SIM,1854,32,30-34,1886,25
STAT,1902,16,25-29,1918,7.5736158663492334
STAT,1895,24,25-29,1919,70.06225588642626
STAT,1951,19,40-44,1970,1.5724350197064219
SIM,1839,42,40-44,1881,6
SIM,1913,21,25-29,1934,86
STAT,1850,53,20-24,1903,5.118246372016169E-4
SIM,1840,98,na,1938,2
STAT,1893,28,15-19,1921,0.5416349007853585
SIM,1959,1,na,1960,4886
STAT,1842,106,na,1948,0.008792796777317103
STAT,1873,32,25-29,1905,9.81358742750332
STAT,1846,16,35-39,1862,0.5142777439135621
STAT,1923,29,15-19,1952,0.7602042894233575
STAT,1840,53,na,1893,1390.3450274614418
STAT,1872,20,15-19,1892,3.1447321140138933
STAT,1918,40,na,1958,3740.7219111703434
STAT,1934,15,25-29,1949,55.63055842180125
STAT,1908,33,na,1941,3358.3716957019515
SIM,1862,23,na,1885,2038
STAT,1903,37,40-44,1940,1.2700162380981999
SIM,1936,25,na,1961,2787
SIM,1815,43,na,1858,1469
SIM,1919,30,25-29,1949,15
SIM,1862,23,25-29,1885,55
STAT,1829,38,na,1867,1636.931432115374
SIM,1868,40,45-49,1908,2
STAT,1876,23,45-49,1899,0.6784861807198354
STAT,1763,109,na,1872,0.0016199622127242336
SIM,1888,36,35-39,1924,8
SIM,1913,25,40-44,1938,5
STAT,1883,25,45-49,1908,1.0353544451583607
STAT,1877,38,40-44,1915,4.268389941849321
SIM,1906,18,25-29,1924,9
STAT,1832,31,25-29,1863,8.174289854489041
STAT,1905,25,40-44,1930,4.118176505337651
SIM,1933,29,40-44,1962,9
STAT,1830,46,na,1876,1476.2337346452848
STAT,1862,17,30-34,1879,1.4744576655695352
SIM,1824,34,45-49,1858,2
STAT,1933,19,30-34,1952,15.331383589987473
SIM,1926,18,na,1944,4159
SIM,1911,37,40-44,1948,4
SIM,1930,28,45-49,1958,1
STAT,1852,27,15-19,1879,0.38311611149387054
STAT,1953,15,35-39,1968,4.7976919072249755
SIM,1885,70,na,1955,1289
STAT,1832,35,40-44,1867,3.418750942701573
STAT,1922,28,45-49,1950,1.840279589823163
SIM,1918,22,30-34,1940,35
SIM,1941,28,20-24,1969,18
SIM,1870,71,na,1941,1150
STAT,1824,91,na,1915,31.95166494382491
STAT,1842,21,40-44,1863,1.917131045095673
SIM,1942,15,25-29,1957,57
STAT,1874,19,15-19,1893,5.697448300264073
SIM,1873,35,45-49,1908,1
STAT,1854,23,25-29,1877,47.77911933198068
SIM,1847,31,na,1878,1910
SIM,1871,29,40-44,1900,5
SIM,1895,33,30-34,1928,25
SIM,1840,35,40-44,1875,5
SIM,1898,22,35-39,1920,9
STAT,1862,56,na,1918,1647.4501979696738
STAT,1930,11,na,1941,4846.412377373762
STAT,1883,49,20-24,1932,0.010882497282982644
SIM,1840,31,25-29,1871,17
SIM,1938,30,35-39,1968,12
STAT,1875,74,na,1949,1077.6209885135315
STAT,1933,28,20-24,1961,22.885978690466192
SIM,1860,64,na,1924,1419
STAT,1921,16,35-39,1937,4.529604361928496
STAT,1899,39,30-34,1938,1.4740202887983622
SIM,1804,69,na,1873,692
STAT,1845,45,na,1890,1607.9242953251355
STAT,1847,28,45-49,1875,0.9770246078220421
STAT,1831,23,30-34,1854,32.59019203945334
STAT,1855,49,45-49,1904,0.1642062831480987
SIM,1899,34,45-49,1933,6
SIM,1827,33,25-29,1860,9
STAT,1863,25,25-29,1888,35.577670623310226
SIM,1840,76,na,1916,597
STAT,1846,30,15-19,1876,0.12744092832093395
STAT,1833,37,15-19,1870,0.04307592211762124
STAT,1832,24,na,1856,1702.775913461975
STAT,1837,20,20-24,1857,60.825389379033865
SIM,1854,22,20-24,1876,63
SIM,1850,21,40-44,1871,3
SIM,1851,68,na,1919,1119
SIM,1894,24,25-29,1918,74
SIM,1838,30,30-34,1868,15
SIM,1855,28,45-49,1883,1
SIM,1894,30,45-49,1924,5
SIM,1909,35,35-39,1944,6
SIM,1854,4,na,1858,2413
SIM,1892,28,30-34,1920,37
STAT,1886,24,25-29,1910,56.76837200830697
STAT,1908,25,25-29,1933,59.683064271686554
STAT,1839,45,45-49,1884,0.16424865739507866
STAT,1887,62,na,1949,1931.334797632987
STAT,1928,24,30-34,1952,33.68718478929619
STAT,1867,38,15-19,1905,0.049566404576671164
STAT,1907,46,15-19,1953,3.140063256478415E-4
STAT,1815,54,na,1869,1206.731166847551
STAT,1850,39,50-100,1889,0.8610998654284909
SIM,1857,21,35-39,1878,7
SIM,1864,89,na,1953,85
STAT,1846,22,20-24,1868,63.0659604480461
SIM,1811,84,na,1895,134
STAT,1871,46,25-29,1917,0.054186373615681606
SIM,1841,18,15-19,1859,9
STAT,1824,37,50-100,1861,1.9258895041216404
STAT,1872,22,30-34,1894,16.878514389149817
STAT,1900,27,50-100,1927,0.838319734190348
SIM,1910,34,20-24,1944,2
SIM,1938,20,25-29,1958,80
STAT,1884,28,30-34,1912,23.42005888436226
STAT,1893,38,25-29,1931,3.4322490313247727
STAT,1940,17,15-19,1957,43.530869447492854
STAT,1937,28,50-100,1965,0.916161550974228
STAT,1865,30,50-100,1895,0.7908564044871224
STAT,1899,65,na,1964,2390.4640370408824
STAT,1917,34,50-100,1951,0.8109067166473397
SIM,1845,20,20-24,1865,64
SIM,1871,25,25-29,1896,36
STAT,1876,35,20-24,1911,0.7594973934119222
SIM,1847,32,30-34,1879,25
SIM,1845,39,40-44,1884,2
STAT,1873,36,40-44,1909,4.2143354582485095
STAT,1831,24,35-39,1855,5.925485259905365
STAT,1820,42,50-100,1862,1.9413933322682797
SIM,1918,37,35-39,1955,7
SIM,1904,23,40-44,1927,4
STAT,1888,43,25-29,1931,0.7117560955630409
STAT,1907,38,20-24,1945,0.22974624127519136
SIM,1879,22,25-29,1901,62
STAT,1917,27,25-29,1944,65.2099845207441
STAT,1781,100,na,1881,0.21110450445702844
SIM,1866,19,30-34,1885,1
STAT,1858,19,30-34,1877,1.362841517069876
SIM,1825,37,30-34,1862,12
STAT,1846,32,30-34,1878,15.30359821240129
SIM,1832,34,45-49,1866,2
SIM,1925,34,50-100,1959,5
SIM,1947,19,25-29,1966,55
SIM,1912,12,na,1924,3757
STAT,1897,21,30-34,1918,22.571665384236734
SIM,1873,60,na,1933,1850
SIM,1925,27,25-29,1952,80
STAT,1836,27,30-34,1863,21.100806706143683
STAT,1783,106,na,1889,0.011244864091985355
STAT,1896,47,40-44,1943,0.11992857020026604
STAT,1943,26,30-34,1969,39.43959866406797
SIM,1861,27,na,1888,2050
SIM,1878,49,50-100,1927,3
SIM,1844,27,30-34,1871,23
STAT,1879,33,na,1912,2349.800850794901
STAT,1927,31,20-24,1958,2.8361082300077918
STAT,1891,25,45-49,1916,1.30650548908891
STAT,1942,1,na,1943,4092.9860409159596
STAT,1830,45,25-29,1875,0.04429146468337866
SIM,1938,22,40-44,1960,2
STAT,1821,35,30-34,1856,12.501956476571365
STAT,1823,98,na,1921,1.738557999082027
SIM,1846,38,na,1884,1723
SIM,1934,33,50-100,1967,1
STAT,1929,38,15-19,1967,0.023266032141020885
STAT,1870,24,20-24,1894,63.46562273839784
STAT,1857,32,40-44,1889,3.251066495092944
SIM,1866,67,na,1933,1371
STAT,1826,39,30-34,1865,5.452190857155855
SIM,1908,15,30-34,1923,4
STAT,1866,54,50-100,1920,0.012797474236598725
STAT,1916,15,15-19,1931,9.138474747966205
SIM,1935,25,35-39,1960,20
STAT,1807,47,15-19,1854,0.0015433229945033807
STAT,1839,32,30-34,1871,14.305472089731722
SIM,1888,6,na,1894,2932
STAT,1809,83,na,1892,159.30775479690865
STAT,1888,29,45-49,1917,1.230736315551565
SIM,1855,75,na,1930,758
SIM,1949,21,na,1970,3953
STAT,1811,45,15-19,1856,0.0013770268697056267
SIM,1851,50,na,1901,1639
SIM,1968,3,na,1971,4586
SIM,1901,20,na,1921,3123
SIM,1805,99,na,1904,1
SIM,1795,83,na,1878,115
SIM,1865,32,40-44,1897,4
STAT,1817,37,30-34,1854,19.031909105888086
SIM,1834,39,30-34,1873,3
SIM,1829,38,45-49,1867,2
STAT,1778,83,na,1861,116.82317462787066
STAT,1828,72,na,1900,711.2374552486083
STAT,1872,100,na,1972,8.840125616941256
SIM,1814,47,50-100,1861,1
SIM,1916,25,25-29,1941,64
SIM,1940,22,na,1962,3444
SIM,1849,31,45-49,1880,1
SIM,1897,73,na,1970,1931
STAT,1928,37,45-49,1965,0.8138809958798139
SIM,1939,14,na,1953,3681
STAT,1937,20,25-29,1957,85.03397594190423
SIM,1796,68,na,1864,737
SIM,1913,33,35-39,1946,13
STAT,1863,51,40-44,1914,0.008769361746851053
SIM,1935,31,20-24,1966,2
STAT,1849,21,35-39,1870,5.328782399380529
SIM,1828,26,35-39,1854,8
STAT,1926,38,30-34,1964,2.1020493563561073
SIM,1895,23,20-24,1918,87
SIM,1868,34,25-29,1902,13
SIM,1776,91,na,1867,14
SIM,1944,27,35-39,1971,19
SIM,1828,32,20-24,1860,1
SIM,1880,25,35-39,1905,11
STAT,1840,24,na,1864,1758.8734268996407
SIM,1858,71,na,1929,1046
STAT,1887,17,35-39,1904,0.5798123362952153
STAT,1851,16,na,1867,2019.4640617896462
SIM,1860,37,25-29,1897,1
STAT,1957,13,na,1970,4890.972311891779
STAT,1778,107,na,1885,0.007453486844615744
SIM,1909,27,40-44,1936,4
SIM,1864,20,30-34,1884,20
STAT,1887,23,20-24,1910,72.59374037403002
STAT,1788,90,na,1878,27.244065641330344
STAT,1862,27,40-44,1889,2.428492162075794
SIM,1870,27,40-44,1897,4
STAT,1840,35,40-44,1875,3.4690848604533606
STAT,1927,25,35-39,1952,17.359371383984925
STAT,1856,3,na,1859,2462.4025502502386
STAT,1949,23,20-24,1972,122.53820011983761
STAT,1852,37,25-29,1889,2.0987046114162857
STAT,1866,15,na,1881,2285.5970516417274
STAT,1868,22,15-19,1890,2.9735492938105974
STAT,1893,43,50-100,1936,0.08725503101034993
STAT,1886,30,45-49,1916,1.7541660847822789
SIM,1865,35,45-49,1900,4
SIM,1858,33,45-49,1891,1
STAT,1858,54,45-49,1912,0.01045348371169841
STAT,1905,33,35-39,1938,7.906789474670453
SIM,1876,22,15-19,1898,2
STAT,1918,48,40-44,1966,0.15805966321094087
STAT,1834,61,na,1895,1158.4978409159166
STAT,1923,39,25-29,1962,1.075449237264197
STAT,1891,34,35-39,1925,11.73498684881642
STAT,1845,20,20-24,1865,61.416718401497334
SIM,1939,20,35-39,1959,12
STAT,1812,58,na,1870,1094.359727701883
STAT,1854,42,35-39,1896,1.2940150314271093
STAT,1902,47,40-44,1949,0.12815132302728408
SIM,1914,23,40-44,1937,2
STAT,1875,18,15-19,1893,5.747438032963943
STAT,1896,43,25-29,1939,0.055235750739967455
SIM,1838,71,na,1909,837
STAT,1894,46,25-29,1940,0.039557914126773536
SIM,1860,29,30-34,1889,24
STAT,1898,9,na,1907,3317.029821586202
SIM,1876,38,25-29,1914,3
STAT,1854,26,30-34,1880,20.906122548635988
STAT,1857,38,20-24,1895,0.5714807627449339
STAT,1833,52,45-49,1885,0.009176666249754219
SIM,1814,81,na,1895,197
SIM,1933,2,na,1935,5200
STAT,1852,29,30-34,1881,19.073487950255604
STAT,1801,94,na,1895,7.065165638597667
SIM,1896,35,45-49,1931,3
STAT,1938,16,40-44,1954,1.306665160600144
STAT,1822,33,30-34,1855,44.184614793531026
STAT,1873,54,40-44,1927,0.0098093159156317
STAT,1837,29,35-39,1866,7.922552601386996
STAT,1901,29,na,1930,3133.2444401708617
STAT,1858,19,25-29,1877,4.845348419286867
STAT,1824,43,35-39,1867,2.319466488486056
STAT,1838,51,na,1889,1466.5940748851515
SIM,1903,52,na,1955,2869
STAT,1827,53,30-34,1880,0.005153537460332316
STAT,1894,44,30-34,1938,0.09561573590454016
STAT,1819,49,40-44,1868,0.3147228559775056
SIM,1825,45,na,1870,1454
STAT,1877,47,35-39,1924,0.13655126047495658
STAT,1829,52,25-29,1881,0.0025448513676246064
SIM,1829,35,na,1864,1587
SIM,1897,19,na,1916,3252
STAT,1875,16,20-24,1891,17.256943628402933
STAT,1868,38,25-29,1906,2.5822697693868344
SIM,1832,43,35-39,1875,6
STAT,1852,86,na,1938,160.85718436442926
SIM,1883,16,20-24,1899,15
STAT,1888,35,45-49,1923,2.2467617032659426
SIM,1871,32,35-39,1903,15
STAT,1848,45,15-19,1893,3.001861452146474E-4
STAT,1859,33,na,1892,1786.6729483961506
STAT,1877,6,na,1883,2652.6183100944722
SIM,1886,67,na,1953,1462
STAT,1863,35,40-44,1898,3.663490823645177
STAT,1879,42,40-44,1921,2.2215101723509134
SIM,1862,26,30-34,1888,27
SIM,1878,33,30-34,1911,19
SIM,1901,31,50-100,1932,1
STAT,1865,45,50-100,1910,0.2123955639500214
SIM,1884,32,na,1916,2332
SIM,1848,39,30-34,1887,9
STAT,1863,17,40-44,1880,0.1730238620455032
SIM,1834,81,na,1915,304
SIM,1853,39,40-44,1892,7
SIM,1914,16,na,1930,3821
STAT,1885,37,15-19,1922,0.05287758204385225
SIM,1834,26,25-29,1860,38
SIM,1830,33,30-34,1863,18
SIM,1876,37,na,1913,2289
SIM,1946,16,40-44,1962,1
STAT,1811,45,20-24,1856,0.04131084242956141
SIM,1851,23,20-24,1874,59
STAT,1893,17,25-29,1910,6.788897400090365
SIM,1864,39,45-49,1903,3
STAT,1843,23,20-24,1866,58.00615926402082
SIM,1846,43,35-39,1889,5
SIM,1896,65,na,1961,2281
STAT,1813,99,na,1912,0.7794146513311204
SIM,1869,63,na,1932,1597
STAT,1944,26,na,1970,3826.6394197499503
SIM,1870,32,na,1902,2178
SIM,1887,42,40-44,1929,7
SIM,1881,36,40-44,1917,4
STAT,1882,29,15-19,1911,0.41384437828679355
SIM,1926,22,20-24,1948,127
STAT,1834,20,45-49,1854,0.9485644174351603
STAT,1845,39,40-44,1884,3.1877754276243833
STAT,1876,51,50-100,1927,0.014810882992457704
SIM,1850,20,na,1870,1997
STAT,1845,51,25-29,1896,0.0025184227888514128
STAT,1918,22,20-24,1940,113.29497028783292
SIM,1837,32,30-34,1869,23
STAT,1917,24,na,1941,3643.6182477865063
STAT,1879,25,na,1904,2375.9796648239553
STAT,1906,52,na,1958,2998.058481793109
STAT,1906,60,na,1966,2839.6159734779267
SIM,1858,24,15-19,1882,5
STAT,1864,16,45-49,1880,0.06289349363009354
STAT,1828,41,na,1869,1509.7750634675085
STAT,1847,49,45-49,1896,0.17039453489385792
STAT,1914,46,20-24,1960,0.010379897159311688
SIM,1859,65,na,1924,1324
STAT,1865,44,35-39,1909,1.5296092379540942
STAT,1882,47,45-49,1929,0.21580601462324311
SIM,1845,27,40-44,1872,4
STAT,1883,30,na,1913,2227.9993637007087
STAT,1896,23,30-34,1919,22.155453772875024
STAT,1889,46,15-19,1935,4.6782603730346903E-4
SIM,1880,25,40-44,1905,7
SIM,1872,30,30-34,1902,21
STAT,1831,25,50-100,1856,0.590842229712508
SIM,1887,44,35-39,1931,4
STAT,1849,26,20-24,1875,10.503480492078335
STAT,1875,43,na,1918,2228.035775078495
STAT,1865,32,40-44,1897,3.713383669864513
STAT,1878,45,30-34,1923,0.09625171016686186
STAT,1880,16,30-34,1896,1.5912888023704805
STAT,1780,87,na,1867,45.19502861440019
STAT,1779,90,na,1869,24.161946276866225
SIM,1825,33,20-24,1858,1
STAT,1846,38,45-49,1884,1.5280993637737184
STAT,1868,26,50-100,1894,0.5785603666648362
STAT,1844,52,20-24,1896,5.097741782502812E-4
STAT,1829,32,30-34,1861,17.420755418739983
SIM,1866,19,25-29,1885,10
SIM,1855,100,na,1955,1
STAT,1843,38,20-24,1881,0.5474142269716744
SIM,1856,37,na,1893,1841
STAT,1861,21,15-19,1882,2.6814381563144574
STAT,1879,26,35-39,1905,9.574310841470046
STAT,1834,50,40-44,1884,0.006969753455651146
SIM,1835,37,25-29,1872,2
STAT,1902,70,na,1972,2262.11356690507
SIM,1804,51,na,1855,1166
SIM,1851,44,50-100,1895,1
SIM,1854,38,45-49,1892,1
STAT,1907,22,45-49,1929,0.9676924445664278
STAT,1821,35,35-39,1856,16.591437439655504
STAT,1808,103,na,1911,0.05549083232822937
STAT,1882,37,50-100,1919,1.1279461393823562
STAT,1841,28,15-19,1869,0.38570829019578534
SIM,1880,49,50-100,1929,3
STAT,1858,37,25-29,1895,2.132568008409827
STAT,1895,43,35-39,1938,0.15375063650138326
STAT,1859,47,15-19,1906,2.993538157437498E-4
SIM,1855,34,45-49,1889,1
STAT,1894,28,25-29,1922,51.175244170229234
SIM,1873,44,35-39,1917,4
STAT,1879,44,35-39,1923,1.766494590171666
STAT,1881,15,35-39,1896,0.5030821141050204
STAT,1906,23,40-44,1929,2.858261111658885
SIM,1818,71,na,1889,608
SIM,1853,20,20-24,1873,58
STAT,1821,94,na,1915,10.647904793776881
STAT,1837,27,40-44,1864,2.4953047850537216
SIM,1892,24,20-24,1916,94
STAT,1855,42,25-29,1897,0.4557720979560874
SIM,1802,88,na,1890,38
SIM,1871,19,35-39,1890,1
SIM,1938,21,30-34,1959,33
STAT,1817,89,na,1906,48.62317565449916
STAT,1820,36,30-34,1856,12.973140963042189
SIM,1922,11,na,1933,4308
SIM,1887,26,35-39,1913,9
STAT,1887,20,na,1907,2514.0208403765864
STAT,1880,31,25-29,1911,10.242654327432408
STAT,1771,111,na,1882,8.75741862551891E-4
SIM,1874,28,20-24,1902,9
STAT,1896,41,30-34,1937,0.10006007603046774
SIM,1919,27,35-39,1946,23
STAT,1903,46,45-49,1949,0.17944649856790698
SIM,1910,34,na,1944,3416
SIM,1865,73,na,1938,997
STAT,1884,24,20-24,1908,63.91481969395304
STAT,1912,49,20-24,1961,0.009974793128238084
STAT,1920,43,40-44,1963,0.260554047686633
STAT,1877,30,na,1907,2357.225509973058
SIM,1890,40,na,1930,2925
STAT,1829,50,30-34,1879,0.004889807525312502
STAT,1923,32,na,1955,4095.9138388482884
STAT,1863,19,35-39,1882,0.466807157144778
STAT,1828,52,35-39,1880,0.006731374878334012
STAT,1832,53,40-44,1885,0.0064884694038921985
STAT,1870,12,na,1882,2454.3675969304836
STAT,1943,24,50-100,1967,0.6608932829953544
STAT,1912,60,na,1972,3106.094656245726
SIM,1894,21,20-24,1915,74
SIM,1821,63,na,1884,940
SIM,1886,27,30-34,1913,30
STAT,1919,21,25-29,1940,95.84048551113368
STAT,1928,27,35-39,1955,17.473149120376114
STAT,1885,73,na,1958,1207.437388911622
SIM,1842,18,30-34,1860,2
STAT,1876,50,45-49,1926,0.014367731051764006
SIM,1863,25,35-39,1888,10
STAT,1845,53,20-24,1898,5.137889910396806E-4
STAT,1838,43,na,1881,1630.2812478487745
STAT,1840,17,45-49,1857,0.05550289753745386
STAT,1861,36,15-19,1897,0.04432098381618151
STAT,1960,0,na,1960,4872.394576014813
STAT,1835,31,15-19,1866,0.11659744035742457
STAT,1864,33,35-39,1897,8.490721130620146
SIM,1911,43,40-44,1954,2
STAT,1787,103,na,1890,0.05289248007723587
STAT,1897,40,35-39,1937,0.16046908499989163
STAT,1839,42,40-44,1881,1.578366669815182
STAT,1859,50,45-49,1909,0.011068552946805718
STAT,1890,21,40-44,1911,2.4139940989457456
STAT,1874,9,na,1883,2575.2586169312535
STAT,1878,71,na,1949,1314.1387014959828
STAT,1814,41,25-29,1855,2.37786213525111
STAT,1853,45,25-29,1898,0.044026044751687886
STAT,1844,37,25-29,1881,2.1131021130524226
STAT,1855,25,35-39,1880,7.967916084291679
SIM,1838,63,na,1901,1173
SIM,1927,21,25-29,1948,107
STAT,1858,41,50-100,1899,0.7860349424076541
STAT,1864,34,45-49,1898,1.4556785172361308
SIM,1875,27,25-29,1902,45
STAT,1887,39,45-49,1926,2.085285256674651
SIM,1941,3,na,1944,3839
STAT,1849,46,15-19,1895,3.007985536820907E-4
SIM,1819,36,30-34,1855,6
SIM,1845,44,30-34,1889,4
STAT,1890,20,30-34,1910,20.695325852248757
SIM,1846,25,35-39,1871,11
STAT,1927,14,na,1941,4638.985299282104
STAT,1947,21,30-34,1968,30.697538516146366
STAT,1844,36,15-19,1880,0.045761717810531316
STAT,1869,35,na,1904,2176.6428132439682
STAT,1873,48,na,1921,2128.5197519026324
STAT,1903,43,40-44,1946,0.20843233422208843
SIM,1852,21,15-19,1873,2
SIM,1931,28,na,1959,4537
STAT,1878,27,30-34,1905,24.792099041320018
SIM,1845,65,na,1910,1169
SIM,1878,39,45-49,1917,1
STAT,1849,31,45-49,1880,1.5300055495859208
STAT,1886,21,20-24,1907,68.97611177950222
STAT,1821,40,50-100,1861,1.9280938650483406
STAT,1895,27,30-34,1922,31.01399496141082
STAT,1849,44,20-24,1893,0.1174813356236949
SIM,1895,39,45-49,1934,2
SIM,1797,64,na,1861,801
SIM,1906,31,35-39,1937,11
STAT,1899,17,20-24,1916,22.947858672118482
SIM,1847,42,40-44,1889,6
STAT,1948,23,45-49,1971,1.2201028030616967
SIM,1936,27,35-39,1963,14
STAT,1766,107,na,1873,0.006615844428223116
STAT,1828,54,30-34,1882,0.004070706651627531
STAT,1830,28,40-44,1858,2.8261277900736252
STAT,1849,35,na,1884,1845.7079298325912
STAT,1909,29,na,1938,3358.127482277401
SIM,1836,36,30-34,1872,9
SIM,1888,40,35-39,1928,8
STAT,1845,104,na,1949,0.04719887265382454
STAT,1916,50,na,1966,3527.6495029661914
SIM,1857,31,45-49,1888,1
STAT,1858,71,na,1929,988.6620860111551
STAT,1862,25,na,1887,1962.83028911793
SIM,1846,36,50-100,1882,1
STAT,1784,77,na,1861,301.8217342766507
STAT,1851,5,na,1856,2199.19879676
STAT,1853,27,25-29,1880,37.08626982527447
SIM,1827,30,20-24,1857,2
STAT,1829,35,35-39,1864,6.660314250858301
SIM,1857,26,20-24,1883,10
STAT,1850,33,35-39,1883,7.390762734343958
STAT,1869,52,25-29,1921,0.003224356056345581
SIM,1766,92,na,1858,2
SIM,1916,15,15-19,1931,7
SIM,1861,27,25-29,1888,43
STAT,1939,15,45-49,1954,0.4735416925198421
STAT,1844,21,15-19,1865,2.881464274761884
STAT,1825,34,50-100,1859,1.3287048675710547
STAT,1889,35,na,1924,2773.7647848102292
SIM,1870,36,35-39,1906,6
STAT,1838,41,40-44,1879,1.788783483246437
STAT,1855,43,35-39,1898,1.2775169346960933
SIM,1840,38,50-100,1878,3
STAT,1838,43,35-39,1881,1.2773272003275002
STAT,1836,40,50-100,1876,0.8349805927893077
STAT,1873,24,45-49,1897,0.663931380711011
STAT,1870,27,25-29,1897,39.203319182584636
SIM,1822,88,na,1910,64
STAT,1818,46,15-19,1864,8.65824279918989E-4
STAT,1954,17,35-39,1971,4.900137733585639
STAT,1861,39,25-29,1900,2.2388106456605437
STAT,1913,34,na,1947,3524.451193128556
STAT,1938,34,40-44,1972,3.7125104144657777
STAT,1924,21,35-39,1945,10.52760862179984
SIM,1867,6,na,1873,2674
STAT,1853,6,na,1859,2271.1714092322586
STAT,1871,29,40-44,1900,2.78997152431674
SIM,1898,27,20-24,1925,15
STAT,1789,103,na,1892,0.03171063311607519
STAT,1840,31,25-29,1871,8.272545904595159
STAT,1880,10,na,1890,2579.79597034936
STAT,1908,15,15-19,1923,8.355273744632742
STAT,1835,46,15-19,1881,2.7181062965765055E-4
SIM,1945,17,35-39,1962,6
STAT,1868,53,20-24,1921,6.5443863974256E-4
STAT,1828,36,30-34,1864,4.977385111121206
STAT,1881,30,30-34,1911,16.061930156639928
STAT,1937,17,35-39,1954,3.856405335478898
STAT,1939,33,45-49,1972,1.5158208722952051
STAT,1828,51,25-29,1879,0.002824947145223681
SIM,1893,40,45-49,1933,2
STAT,1820,38,25-29,1858,6.230780763843546
SIM,1804,91,na,1895,25
STAT,1834,103,na,1937,0.08897499548350091
STAT,1885,40,45-49,1925,1.4235219629586937
SIM,1896,57,na,1953,2512
STAT,1831,27,45-49,1858,0.9550385484660324
STAT,1913,29,15-19,1942,0.6597893009402599
SIM,1893,22,15-19,1915,3
STAT,1934,9,na,1943,5086.721670325141
STAT,1899,19,15-19,1918,7.64050308962172
STAT,1895,42,25-29,1937,0.054852697648966456
STAT,1837,44,30-34,1881,0.7809420795819281
STAT,1871,40,15-19,1911,0.013085335393029683
STAT,1942,11,na,1953,3889.22341683275
STAT,1891,20,50-100,1911,0.479461551600027
SIM,1845,26,30-34,1871,26
SIM,1846,41,40-44,1887,7
SIM,1891,34,na,1925,2760
STAT,1853,43,30-34,1896,0.8637793164682057
SIM,1879,85,na,1964,437
STAT,1847,35,50-100,1882,0.9590487837018352
SIM,1929,34,40-44,1963,5
STAT,1850,21,40-44,1871,1.7758320384583581
STAT,1869,50,30-34,1919,0.005525996385386018
SIM,1887,29,na,1916,2467
STAT,1818,43,na,1861,1431.742552007998
STAT,1874,50,40-44,1924,0.010307559172749345
STAT,1854,44,30-34,1898,0.811467246371184
SIM,1797,84,na,1881,86
STAT,1848,53,50-100,1901,0.011042034450774929
SIM,1898,32,45-49,1930,4
SIM,1880,42,na,1922,2334
STAT,1822,56,na,1878,1132.6929271834956
STAT,1838,25,35-39,1863,8.359899932574246
STAT,1885,22,15-19,1907,3.106504765201057
STAT,1896,24,50-100,1920,0.5056090161414092
STAT,1875,51,40-44,1926,0.010271412917222042
SIM,1909,22,20-24,1931,90
STAT,1880,17,40-44,1897,0.18215953207539562
STAT,1885,7,na,1892,2453.316897026037
STAT,1889,55,na,1944,2411.481002610121
SIM,1932,21,35-39,1953,10
SIM,1867,18,30-34,1885,2
STAT,1842,31,50-100,1873,0.8099257631505833
SIM,1900,36,na,1936,3176
STAT,1859,18,30-34,1877,1.3829154602064726
STAT,1899,35,20-24,1934,1.0072649921833923
SIM,1876,57,na,1933,1911
SIM,1850,40,na,1890,1757
SIM,1892,75,na,1967,1740
STAT,1881,35,na,1916,2170.4996502220615
STAT,1909,49,na,1958,3170.552510335328
STAT,1849,28,15-19,1877,0.40039969350255833
SIM,1808,73,na,1881,500
STAT,1913,47,15-19,1960,3.3967353950017134E-4
STAT,1938,19,45-49,1957,0.4652108355072899
SIM,1872,75,na,1947,910
STAT,1856,54,40-44,1910,0.007546310175840683
SIM,1815,43,35-39,1858,6
STAT,1837,89,na,1926,68.17804706098444
SIM,1866,27,na,1893,2116
STAT,1880,32,35-39,1912,10.085898085934199
STAT,1877,44,30-34,1921,1.111392756827623
STAT,1930,34,na,1964,4604.901329615221
SIM,1848,41,45-49,1889,1
STAT,1852,58,na,1910,1433.7309990928802
STAT,1874,34,35-39,1908,9.691192475155944
STAT,1862,20,20-24,1882,57.80760237965659
STAT,1869,39,50-100,1908,1.112308516569097
STAT,1889,18,50-100,1907,0.05698731782576079
STAT,1802,106,na,1908,0.00425681167557529
SIM,1825,73,na,1898,635
SIM,1843,30,na,1873,1899
STAT,1830,25,35-39,1855,11.797552615838645
SIM,1858,40,na,1898,1908
STAT,1858,18,15-19,1876,5.104415487039643
STAT,1896,40,20-24,1936,0.013898694645460829
SIM,1929,31,30-34,1960,28
SIM,1888,43,40-44,1931,7
STAT,1832,22,35-39,1854,8.412909977267159
STAT,1934,24,na,1958,4633.003331634099
SIM,1896,34,35-39,1930,17
SIM,1821,41,35-39,1862,3
STAT,1814,92,na,1906,19.143154539780948
SIM,1843,29,30-34,1872,29
STAT,1846,52,25-29,1898,0.0026131389117552465
SIM,1798,58,na,1856,1005
STAT,1829,53,35-39,1882,0.006064004450989915
STAT,1861,37,30-34,1898,4.18631482733807
SIM,1845,73,na,1918,805
STAT,1857,31,50-100,1888,0.6940428655515594
STAT,1883,28,20-24,1911,10.827579298407084
STAT,1835,29,30-34,1864,20.58952615239571
SIM,1791,79,na,1870,264
STAT,1839,21,50-100,1860,0.3513760660694658
STAT,1820,39,35-39,1859,14.356774398769131
SIM,1898,12,na,1910,3259
SIM,1891,28,20-24,1919,10
STAT,1858,51,40-44,1909,0.007834943664422538
STAT,1860,25,15-19,1885,0.35659593824128566
SIM,1866,18,15-19,1884,4
STAT,1824,31,40-44,1855,12.361647457417979
STAT,1923,36,20-24,1959,0.2888076463716588
SIM,1842,17,15-19,1859,5
STAT,1894,43,20-24,1937,0.01329218657652374
STAT,1864,15,35-39,1879,0.5314356000595584
SIM,1897,59,na,1956,2549
SIM,1933,23,50-100,1956,3
SIM,1840,73,na,1913,743
SIM,1872,31,40-44,1903,5
STAT,1844,53,30-34,1897,0.004067807816046494
STAT,1856,48,na,1904,1637.4709920050843
SIM,1874,22,na,1896,2223
SIM,1837,35,35-39,1872,14
STAT,1794,67,na,1861,735.6137957545225
STAT,1854,29,35-39,1883,7.133735904060753
SIM,1830,34,40-44,1864,5
STAT,1927,4,na,1931,4740.877026910601
STAT,1867,27,25-29,1894,37.5246621451891
STAT,1875,54,45-49,1929,0.013704252669214687
SIM,1847,21,35-39,1868,8
STAT,1764,107,na,1871,0.005050521308520014
STAT,1830,42,20-24,1872,0.12354417586089252
STAT,1871,42,50-100,1913,0.9898081335082457
STAT,1896,26,35-39,1922,12.08014161810295
STAT,1834,35,15-19,1869,0.044257672498139236
STAT,1881,91,na,1972,199.31908816799813
STAT,1894,47,35-39,1941,0.09542852405454758
SIM,1880,70,na,1950,1403
SIM,1952,15,25-29,1967,64
STAT,1875,19,25-29,1894,5.472967814106117
STAT,1921,29,na,1950,3915.9890074179875
STAT,1932,24,50-100,1956,0.812787364209758
STAT,1944,15,25-29,1959,44.079307736952714
SIM,1920,45,50-100,1965,1
STAT,1822,34,40-44,1856,9.424688348002213
SIM,1870,20,20-24,1890,67
SIM,1894,37,35-39,1931,15
STAT,1876,32,15-19,1908,0.13899057309546348
SIM,1862,29,35-39,1891,12
SIM,1962,6,na,1968,4633
SIM,1882,34,35-39,1916,9
SIM,1909,49,na,1958,3225
SIM,1877,39,50-100,1916,1
STAT,1856,109,na,1965,0.0036215593716590142
STAT,1890,20,na,1910,2747.8482798313303
STAT,1865,47,45-49,1912,0.2011367166087977
SIM,1904,26,na,1930,3317
STAT,1834,53,45-49,1887,0.009053620312633934
STAT,1819,37,50-100,1856,3.4069857060848276
SIM,1888,22,35-39,1910,8
SIM,1926,25,25-29,1951,71
STAT,1880,19,35-39,1899,0.5435479120719606
SIM,1867,29,na,1896,2284
STAT,1855,41,40-44,1896,1.605627779349526
SIM,1864,46,50-100,1910,6
STAT,1847,16,45-49,1863,0.06047622096100186
SIM,1937,13,na,1950,3536
STAT,1839,21,35-39,1860,5.028190916937896
STAT,1835,23,na,1858,1795.8939610568557
SIM,1832,31,40-44,1863,3
SIM,1890,44,40-44,1934,6
SIM,1967,4,na,1971,4496
STAT,1873,39,45-49,1912,1.890765276370102
STAT,1890,26,50-100,1916,0.7413582874526761
STAT,1810,46,15-19,1856,0.0013570159169182057
STAT,1888,34,35-39,1922,11.20954436826964
STAT,1891,22,40-44,1913,2.435516670935714
STAT,1874,52,35-39,1926,0.00826542878239259
SIM,1885,73,na,1958,1147
SIM,1923,27,50-100,1950,6
STAT,1868,37,15-19,1905,0.05061447144914722
STAT,1870,42,20-24,1912,0.14700056470187742
STAT,1832,58,na,1890,1191.3075177317903
STAT,1881,32,25-29,1913,9.347467290653677
SIM,1883,21,45-49,1904,2
STAT,1876,47,15-19,1923,3.8858151870401066E-4
STAT,1832,38,15-19,1870,0.04245629261289924
STAT,1896,44,35-39,1940,0.15477448117429518
SIM,1881,39,45-49,1920,1
STAT,1846,19,35-39,1865,0.5052438752176701
STAT,1886,33,15-19,1919,0.141510392790622
SIM,1878,36,35-39,1914,12
STAT,1836,48,na,1884,1505.2599568286064
STAT,1897,30,na,1927,3039.0569162015004
SIM,1840,22,35-39,1862,5
STAT,1882,44,40-44,1926,2.038551153181399
STAT,1803,51,20-24,1854,0.0021938780030185644
SIM,1839,65,na,1904,1136
STAT,1819,42,15-19,1861,0.029088662879797656
SIM,1946,19,45-49,1965,2
STAT,1806,103,na,1909,0.04976863506228065
SIM,1841,48,50-100,1889,6
SIM,1870,32,20-24,1902,2
STAT,1918,25,25-29,1943,66.62293001155578
STAT,1956,15,45-49,1971,0.624692065171135
STAT,1865,53,na,1918,1814.0823390966912
STAT,1806,48,45-49,1854,0.8585847100919455
STAT,1849,29,25-29,1878,37.06363398085505
SIM,1829,43,35-39,1872,2
SIM,1862,42,35-39,1904,1
STAT,1891,19,15-19,1910,6.898994220454228
SIM,1928,20,30-34,1948,38
SIM,1849,19,25-29,1868,8
SIM,1954,5,na,1959,4488
STAT,1895,40,30-34,1935,1.4302171439208027
STAT,1854,81,na,1935,386.90890460419894
STAT,1873,51,35-39,1924,0.008287929957045598
STAT,1836,30,20-24,1866,2.25899070638853
STAT,1861,16,50-100,1877,0.044493238023211354
STAT,1836,49,40-44,1885,0.11308685694628785
STAT,1839,54,35-39,1893,0.005574273090256362
STAT,1854,50,50-100,1904,0.010961074840376827
STAT,1907,14,na,1921,3572.2171950719044
STAT,1818,51,na,1869,1300.6676479706564
STAT,1850,50,50-100,1900,0.01079927283029493
SIM,1885,44,30-34,1929,4
STAT,1870,26,15-19,1896,0.42191690487989925
STAT,1804,52,20-24,1856,0.0026076084980844742
STAT,1924,22,45-49,1946,1.2542295950919395
SIM,1938,24,35-39,1962,7
SIM,1837,78,na,1915,455
STAT,1915,27,50-100,1942,0.9591060020779304
STAT,1861,19,30-34,1880,1.4220864280834884
SIM,1862,45,na,1907,1936
STAT,1807,99,na,1906,0.704420428389314
SIM,1932,22,45-49,1954,1
SIM,1832,47,na,1879,1414
STAT,1866,31,45-49,1897,1.5256388026727534
SIM,1848,30,na,1878,1851
STAT,1833,48,50-100,1881,0.15858307843675887
SIM,1832,86,na,1918,122
SIM,1862,50,50-100,1912,2
STAT,1847,49,15-19,1896,2.8880405334858665E-4
STAT,1812,44,25-29,1856,2.2602579266520606
STAT,1896,37,na,1933,2939.5184117008603
SIM,1836,39,35-39,1875,9
STAT,1853,42,20-24,1895,0.12004111524334697
SIM,1831,30,40-44,1861,7
STAT,1884,39,20-24,1923,0.7122082990227728
SIM,1843,19,na,1862,2126
STAT,1902,49,50-100,1951,0.18084786817859733
SIM,1849,37,25-29,1886,2
STAT,1801,74,na,1875,440.3548280012507
STAT,1833,34,15-19,1867,0.11018339502655553
SIM,1890,26,40-44,1916,3
SIM,1881,23,35-39,1904,4
STAT,1761,100,na,1861,0.2577768701102467
SIM,1863,22,30-34,1885,15
STAT,1875,19,30-34,1894,1.5393707765083189
STAT,1850,18,15-19,1868,5.081942531572307
SIM,1869,43,35-39,1912,2
STAT,1827,37,25-29,1864,2.9885315013369755
STAT,1847,34,45-49,1881,1.3456961984845648
SIM,1819,37,40-44,1856,5
STAT,1838,100,na,1938,0.7127355602931029
SIM,1821,94,na,1915,12
SIM,1827,28,35-39,1855,10
STAT,1845,76,na,1921,670.4101493362173
STAT,1837,45,40-44,1882,0.11833216617430037
STAT,1889,63,na,1952,2080.9535063906965
SIM,1820,41,50-100,1861,1
STAT,1864,27,50-100,1891,0.5386029407318109
STAT,1878,28,40-44,1906,2.93881320436008
SIM,1886,28,40-44,1914,3
STAT,1815,53,40-44,1868,0.022299849417927762
STAT,1900,47,35-39,1947,0.10301022398105883
SIM,1856,44,35-39,1900,2
SIM,1869,55,na,1924,1877
STAT,1851,47,15-19,1898,2.8639549724953863E-4
SIM,1828,73,na,1901,694
SIM,1944,20,15-19,1964,4
STAT,1844,91,na,1935,40.24613131545074
SIM,1857,29,25-29,1886,29
STAT,1888,61,na,1949,2086.2348503104727
STAT,1820,35,15-19,1855,0.14610177157248427
STAT,1840,32,35-39,1872,8.094738733038781
SIM,1850,12,na,1862,2231
SIM,1853,36,35-39,1889,11
SIM,1931,1,na,1932,5038
STAT,1870,20,na,1890,2204.913225347973
SIM,1791,99,na,1890,1
SIM,1914,20,30-34,1934,33
STAT,1901,49,45-49,1950,0.17235950131456923
STAT,1845,36,35-39,1881,5.3136005606452565
SIM,1892,39,20-24,1931,1
STAT,1819,46,35-39,1865,0.26934742723416083
STAT,1824,46,45-49,1870,0.2918143371304138
STAT,1848,81,na,1929,401.81940523266263
STAT,1859,32,15-19,1891,0.10707498016711038
STAT,1954,16,na,1970,4299.488254996878
STAT,1849,47,25-29,1896,0.04299103140301131
SIM,1829,26,45-49,1855,1
STAT,1876,48,30-34,1924,0.09329015451833104
STAT,1906,20,30-34,1926,24.654216791479417
SIM,1878,60,na,1938,1888
STAT,1817,48,20-24,1865,0.026631357529466413
STAT,1824,51,na,1875,1350.7831623290779
STAT,1869,53,35-39,1922,0.007752415627356012
SIM,1823,103,na,1926,1
STAT,1891,37,45-49,1928,2.329949857512133
STAT,1898,39,20-24,1937,0.2105639036906084
STAT,1888,17,45-49,1905,0.07292919409439987
STAT,1871,22,15-19,1893,3.0947230572567257
SIM,1825,53,na,1878,1304
SIM,1873,32,40-44,1905,2
STAT,1876,47,20-24,1923,0.011657455815406626
STAT,1812,43,15-19,1855,0.05089356321893467
SIM,1840,38,45-49,1878,1
STAT,1822,53,50-100,1875,0.0191588995195001
STAT,1903,24,na,1927,3159.0844065531614
STAT,1949,16,15-19,1965,49.87878879405359
STAT,1832,38,45-49,1870,1.507198208515196
SIM,1817,39,30-34,1856,3
STAT,1927,42,50-100,1969,0.13918581653397685
STAT,1890,40,na,1930,2696.3381575584463
STAT,1894,10,na,1904,3144.7838979170083
STAT,1936,1,na,1937,3776.9374348286337
STAT,1901,48,35-39,1949,0.10311539355303688
SIM,1849,35,na,1884,1878
STAT,1835,47,30-34,1882,0.06494087096352444
SIM,1875,24,15-19,1899,3
SIM,1904,46,na,1950,3116
SIM,1864,36,40-44,1900,5
STAT,1837,47,50-100,1884,0.16546239158625295
STAT,1849,29,30-34,1878,22.063862060421663
SIM,1965,3,na,1968,4600
STAT,1929,22,25-29,1951,110.34454130137019
STAT,1881,33,35-39,1914,9.20302492007551
STAT,1891,45,na,1936,2656.281166295761
STAT,1886,37,35-39,1923,7.058141823390998
SIM,1833,24,15-19,1857,2
SIM,1874,43,45-49,1917,2
STAT,1852,16,25-29,1868,4.998273286796565
STAT,1855,40,30-34,1895,0.8252285902500179
SIM,1906,32,45-49,1938,2
STAT,1803,52,30-34,1855,0.01734487509415731
STAT,1949,0,na,1949,4855.048603521609
SIM,1860,16,25-29,1876,9
STAT,1874,23,50-100,1897,0.39239259442163665
STAT,1912,45,50-100,1957,0.20632093877632138
SIM,1870,33,30-34,1903,17
STAT,1853,46,35-39,1899,0.10625227403406548
SIM,1927,26,50-100,1953,1
SIM,1845,47,50-100,1892,3
STAT,1894,4,na,1898,3193.785046831743
STAT,1895,48,35-39,1943,0.09603929995996527
STAT,1846,15,na,1861,2164.1505594974305
STAT,1878,23,50-100,1901,0.4002374908598387
STAT,1874,35,15-19,1909,0.054716457228246536
SIM,1832,49,50-100,1881,1
SIM,1893,60,na,1953,2371
STAT,1832,23,45-49,1855,0.6584868965710995
STAT,1809,105,na,1914,0.011766154377690045
STAT,1793,82,na,1875,150.26937249061285
STAT,1825,39,15-19,1864,0.06490992231779671
STAT,1831,54,35-39,1885,0.005185524094736867
SIM,1883,18,15-19,1901,5
STAT,1828,39,35-39,1867,6.1763945192816205
STAT,1874,53,45-49,1927,0.013782812653471314
STAT,1855,22,30-34,1877,14.787548942862784
STAT,1886,36,50-100,1922,1.2310741052698115
STAT,1777,95,na,1872,2.175723364924301
SIM,1894,36,50-100,1930,1
SIM,1828,29,35-39,1857,11
STAT,1814,42,35-39,1856,6.416489557232683
STAT,1936,20,15-19,1956,4.810942964862114
SIM,1937,22,25-29,1959,88
STAT,1919,26,50-100,1945,1.0194743128578176
STAT,1875,36,15-19,1911,0.0547893443684924
STAT,1867,24,15-19,1891,2.908171471122774
STAT,1948,16,na,1964,3980.5849802880775
STAT,1886,19,35-39,1905,0.5446260894434115
SIM,1842,45,na,1887,1545
SIM,1871,34,30-34,1905,21
SIM,1944,0,na,1944,4112
SIM,1862,85,na,1947,200
STAT,1845,32,15-19,1877,0.11981808267099399
SIM,1921,18,na,1939,3984
STAT,1872,86,na,1958,273.8563066522151
SIM,1829,44,45-49,1873,4
SIM,1880,22,35-39,1902,7
STAT,1813,41,35-39,1854,6.41005713484646
SIM,1850,27,20-24,1877,9
STAT,1929,40,25-29,1969,0.08760228751972757
STAT,1842,27,20-24,1869,10.506214870487069
STAT,1850,36,45-49,1886,1.4424084741238956
STAT,1857,39,30-34,1896,3.9308955657345557
STAT,1839,39,15-19,1878,0.04376036583762467
STAT,1861,83,na,1944,311.8281806407145
SIM,1857,29,30-34,1886,22
STAT,1878,46,40-44,1924,0.1690284711076265
SIM,1866,34,20-24,1900,3
SIM,1881,38,50-100,1919,3
STAT,1939,30,40-44,1969,3.7763040336938123
SIM,1822,42,35-39,1864,3
SIM,1858,9,na,1867,2312
STAT,1873,1,na,1874,3342.3568860114083
STAT,1856,68,na,1924,1126.4004836936388
STAT,1892,48,15-19,1940,2.6362584321749667E-4
SIM,1878,36,40-44,1914,7
STAT,1858,49,20-24,1907,0.00870259964557627
STAT,1820,35,20-24,1855,2.005578611979768
SIM,1833,40,na,1873,1590
SIM,1784,89,na,1873,31
STAT,1841,25,40-44,1866,2.602284646633563
STAT,1851,50,40-44,1901,0.0076818176053019705
SIM,1874,31,45-49,1905,1
STAT,1823,41,na,1864,1494.9518228815075
STAT,1941,23,50-100,1964,0.6421663524650921
STAT,1910,0,na,1910,4203.446680291591
SIM,1831,93,na,1924,15
STAT,1842,48,na,1890,1608.8226983678278
SIM,1929,34,35-39,1963,13
STAT,1860,26,25-29,1886,33.0088697581637
STAT,1921,44,50-100,1965,0.12458577640402552
SIM,1827,88,na,1915,87
STAT,1883,42,35-39,1925,1.6751350217341263
STAT,1797,95,na,1892,3.2625813760985034
STAT,1819,36,na,1855,1551.7071107879083
SIM,1852,37,30-34,1889,6
SIM,1887,20,na,1907,2470
STAT,1916,6,na,1922,4004.1037320916153
STAT,1867,24,20-24,1891,60.74807186607708
STAT,1848,44,35-39,1892,1.327377451280043
STAT,1882,76,na,1958,967.28209490355
SIM,1826,29,30-34,1855,24
STAT,1924,19,15-19,1943,50.78003054730126
STAT,1862,39,40-44,1901,3.500204000713989
SIM,1866,98,na,1964,2
SIM,1930,19,15-19,1949,46
STAT,1866,43,45-49,1909,1.2946342955517711
STAT,1872,42,25-29,1914,0.6077442454586545
STAT,1822,37,45-49,1859,3.5089073417483716
STAT,1830,25,30-34,1855,30.78940723159712
STAT,1846,51,40-44,1897,0.007845757928497342
STAT,1910,38,35-39,1948,2.1745703952138045
STAT,1890,71,na,1961,1708.137951239307
STAT,1812,89,na,1901,45.633933252483544
STAT,1870,43,na,1913,2126.494436792315
STAT,1881,27,50-100,1908,0.5837874321069328
SIM,1932,19,15-19,1951,60
STAT,1895,23,15-19,1918,4.050518803924874
SIM,1891,42,35-39,1933,3
SIM,1889,32,na,1921,2874
STAT,1909,17,25-29,1926,8.028510672680664
STAT,1841,31,40-44,1872,3.665363705610752
STAT,1861,52,20-24,1913,5.765405426792385E-4
STAT,1922,19,15-19,1941,49.35180172289531
STAT,1851,84,na,1935,239.29892525971718
STAT,1900,20,35-39,1920,7.69305158936524
STAT,1833,37,20-24,1870,0.5913148564906092
STAT,1898,60,na,1958,2502.297522940825
STAT,1880,50,na,1930,2175.230909210996
STAT,1857,41,45-49,1898,1.1201337259711297
STAT,1891,19,45-49,1910,0.0759382809510436
STAT,1816,51,35-39,1867,0.019861968179069215
STAT,1893,17,na,1910,3025.74599275507
SIM,1867,20,na,1887,2286
STAT,1916,39,na,1955,3602.9990587277575
STAT,1876,18,30-34,1894,1.5515484912718347
STAT,1821,63,na,1884,977.884775789704
SIM,1832,28,45-49,1860,5
STAT,1923,26,45-49,1949,1.8801981828188683
SIM,1879,32,40-44,1911,7
STAT,1834,92,na,1926,25.821383646547904
SIM,1931,26,45-49,1957,4
STAT,1844,37,30-34,1881,3.911486911589881
STAT,1845,18,35-39,1863,0.4878645289656111
STAT,1872,16,50-100,1888,0.04685225438421558
SIM,1849,16,20-24,1865,18
SIM,1822,40,40-44,1862,6
SIM,1918,15,20-24,1933,26
STAT,1922,37,15-19,1959,0.02064245109583566
STAT,1940,23,40-44,1963,3.2347034190264896
STAT,1825,56,na,1881,1171.4936352214775
STAT,1828,32,15-19,1860,0.14775746374235194
SIM,1852,19,30-34,1871,2
SIM,1829,40,30-34,1869,1
SIM,1943,25,25-29,1968,71
SIM,1897,30,35-39,1927,22
STAT,1861,45,50-100,1906,0.19483892822870139
STAT,1856,24,45-49,1880,0.5883987001085279
SIM,1917,17,25-29,1934,9
STAT,1874,38,20-24,1912,0.7403509400750901
STAT,1872,51,50-100,1923,0.014379494747222726
STAT,1892,15,15-19,1907,7.054684572657846
STAT,1820,51,20-24,1871,0.0012134080315109718
STAT,1860,43,45-49,1903,1.138902138656041
SIM,1878,91,na,1969,154
STAT,1851,35,15-19,1886,0.04168370289306456
STAT,1898,46,50-100,1944,0.17761363662415802
STAT,1895,41,15-19,1936,0.0011864262073822437
STAT,1763,100,na,1863,0.10868127951438622
STAT,1865,84,na,1949,284.84824079961896
STAT,1834,81,na,1915,335.25772555418484
STAT,1888,31,30-34,1919,19.57253053795093
STAT,1869,33,15-19,1902,0.12978000807445245
SIM,1889,18,15-19,1907,6
SIM,1894,37,30-34,1931,16
STAT,1814,40,40-44,1854,8.50511150717556
STAT,1914,33,40-44,1947,3.705691313473196
SIM,1877,37,35-39,1914,10
SIM,1801,86,na,1887,68
STAT,1869,37,35-39,1906,6.473063107001843
SIM,1833,42,45-49,1875,3
STAT,1861,91,na,1952,45.51726505448404
SIM,1909,22,15-19,1931,8
STAT,1886,37,30-34,1923,5.318441045415196
STAT,1895,35,50-100,1930,1.5264468580536208
STAT,1873,17,na,1890,2419.819781507453
STAT,1853,30,20-24,1883,2.1508170048205244
STAT,1881,31,40-44,1912,3.97388939758474
STAT,1865,45,15-19,1910,3.4592082333729585E-4
SIM,1897,50,na,1947,2853
STAT,1872,52,30-34,1924,0.005610473241326956
SIM,1922,33,40-44,1955,5
SIM,1833,71,na,1904,754
SIM,1870,39,40-44,1909,7
SIM,1927,34,na,1961,4348
SIM,1923,21,na,1944,4108
STAT,1841,63,na,1904,1230.1206243597794
STAT,1836,27,25-29,1863,35.44586048968143
SIM,1844,27,25-29,1871,44
STAT,1805,51,25-29,1856,0.01326466033603194
STAT,1892,21,45-49,1913,0.827597036315219
STAT,1910,14,na,1924,3684.9646557505557
STAT,1889,30,35-39,1919,11.90567639344824
STAT,1851,17,15-19,1868,5.190294978437376
STAT,1851,29,15-19,1880,0.37666355621298175
STAT,1870,27,30-34,1897,23.33760977679705
SIM,1852,55,na,1907,1585
STAT,1849,66,na,1915,1229.041263632882
SIM,1875,24,20-24,1899,69
STAT,1815,41,40-44,1856,5.95913230764793
STAT,1904,39,20-24,1943,0.2231864746208348
STAT,1821,50,25-29,1871,0.005590090761396276
STAT,1912,33,40-44,1945,3.6224988730863
SIM,1902,21,20-24,1923,92
STAT,1807,47,20-24,1854,0.04629973056188617
STAT,1935,25,25-29,1960,84.832846500139
STAT,1914,15,40-44,1929,0.27460958002179364
SIM,1823,35,40-44,1858,2
SIM,1838,40,na,1878,1663
STAT,1799,99,na,1898,0.6046209583048638
STAT,1871,26,35-39,1897,9.082454488332575
STAT,1856,39,45-49,1895,1.4545663905533495
SIM,1920,33,40-44,1953,5
STAT,1848,10,na,1858,2226.5084742129798
SIM,1794,96,na,1890,2
STAT,1898,71,na,1969,2049.9065559783407
STAT,1825,42,45-49,1867,1.6295989230989436
STAT,1850,43,na,1893,1617.4776380577277
SIM,1896,31,30-34,1927,34
STAT,1902,43,25-29,1945,0.05902292109304589
SIM,1922,15,40-44,1937,2
SIM,1833,30,45-49,1863,1
STAT,1882,26,40-44,1908,2.761514959104533
SIM,1821,83,na,1904,225
STAT,1892,33,45-49,1925,2.0546706991960324
SIM,1880,21,25-29,1901,62
STAT,1857,52,35-39,1909,0.006380127706053246
STAT,1856,42,40-44,1898,1.6558501492870246
SIM,1833,24,45-49,1857,1
STAT,1915,31,35-39,1946,8.82844858485974
SIM,1891,5,na,1896,3090
SIM,1881,20,30-34,1901,14
STAT,1897,22,40-44,1919,2.6326473712494898
STAT,1852,49,25-29,1901,0.040887307729140544
SIM,1883,47,na,1930,2050
STAT,1825,30,45-49,1855,3.8411832312343788
STAT,1930,29,20-24,1959,21.904846006157854
STAT,1932,31,35-39,1963,11.482845515874985
SIM,1917,32,20-24,1949,1
STAT,1906,23,35-39,1929,8.00424945133487
SIM,1873,29,45-49,1902,1
SIM,1891,65,na,1956,2023
SIM,1868,29,35-39,1897,10
STAT,1863,38,45-49,1901,1.6444378817485885
STAT,1851,32,45-49,1883,1.3056120442584522
STAT,1811,47,50-100,1858,0.8180595059081132
STAT,1877,25,20-24,1902,11.574048639370076
SIM,1917,13,na,1930,4017
STAT,1812,45,35-39,1857,0.4845578548963286
STAT,1847,88,na,1935,101.23391365154728
SIM,1844,30,20-24,1874,1
STAT,1832,35,50-100,1867,0.958845010580218
STAT,1846,18,na,1864,2126.1348136791034
STAT,1892,15,45-49,1907,0.07765198838856438
SIM,1849,34,20-24,1883,1
STAT,1821,52,20-24,1873,0.0011191174846752535
SIM,1832,55,na,1887,1201
STAT,1836,42,20-24,1878,0.12234456345795221
SIM,1838,31,40-44,1869,3
STAT,1819,46,30-34,1865,0.18623450674607983
STAT,1845,54,30-34,1899,0.004096363090658904
STAT,1889,45,35-39,1934,0.1649034695963842
SIM,1923,31,35-39,1954,10
STAT,1865,73,na,1938,1017.0324312566424
SIM,1851,14,na,1865,2145
STAT,1880,37,35-39,1917,7.044169064931611
SIM,1919,30,30-34,1949,27
SIM,1841,32,50-100,1873,5
SIM,1863,47,na,1910,1855
SIM,1890,41,35-39,1931,3
STAT,1842,41,35-39,1883,1.3742374786206186
STAT,1840,30,40-44,1870,3.5391536380116424
STAT,1841,43,40-44,1884,1.5908356173499816
STAT,1842,23,35-39,1865,5.291899026971195
STAT,1850,52,45-49,1902,0.010175679733958064
STAT,1916,36,50-100,1952,0.4081311771884398
STAT,1860,36,50-100,1896,0.9456061607339694
SIM,1794,99,na,1893,1
STAT,1842,30,45-49,1872,1.5575612307674953
STAT,1878,40,30-34,1918,1.1432930561444004
STAT,1894,31,20-24,1925,3.2950579062454426
SIM,1886,40,30-34,1926,2
SIM,1928,17,35-39,1945,5
SIM,1914,23,35-39,1937,8
STAT,1882,41,35-39,1923,1.6711499378553294
SIM,1822,48,na,1870,1384
STAT,1813,46,35-39,1859,0.3890699070118473
STAT,1831,41,25-29,1872,0.48055024104555666
SIM,1889,42,45-49,1931,4
STAT,1827,40,20-24,1867,0.1576869329786807
SIM,1850,23,35-39,1873,6
SIM,1827,37,50-100,1864,3
STAT,1897,37,40-44,1934,5.530459925496771
STAT,1852,17,50-100,1869,0.04295820565665486
STAT,1851,20,45-49,1871,0.607719719343741
STAT,1941,21,35-39,1962,9.195467435338564
SIM,1889,36,45-49,1925,3
STAT,1818,74,na,1892,545.0157420484863
SIM,1858,28,30-34,1886,21
STAT,1863,32,35-39,1895,8.395512842702965
SIM,1767,97,na,1864,1
STAT,1866,25,15-19,1891,0.3980026808533324
STAT,1902,39,na,1941,3133.9852659153485
SIM,1869,28,40-44,1897,4
SIM,1885,31,20-24,1916,2
SIM,1859,38,25-29,1897,1
STAT,1847,52,40-44,1899,0.007721837665618878
SIM,1866,37,25-29,1903,1
SIM,1891,24,35-39,1915,6
SIM,1841,33,35-39,1874,11
SIM,1911,6,na,1917,3761
SIM,1934,16,na,1950,4613
STAT,1821,71,na,1892,711.1365248394035
SIM,1909,3,na,1912,3730
STAT,1833,51,na,1884,1388.4947130565197
SIM,1830,37,45-49,1867,1
SIM,1860,73,na,1933,935
STAT,1842,25,na,1867,1965.4605107739774
STAT,1872,25,40-44,1897,2.8577857314432444
STAT,1878,49,45-49,1927,0.2274956363807323
SIM,1824,33,35-39,1857,9
SIM,1885,25,20-24,1910,12
STAT,1854,47,35-39,1901,0.09970091549131219
SIM,1820,53,na,1873,1296
SIM,1845,96,na,1941,2
STAT,1866,28,15-19,1894,0.3939291666029164
SIM,1848,17,15-19,1865,8
SIM,1850,41,35-39,1891,4
SIM,1911,28,na,1939,3415
STAT,1787,74,na,1861,425.96476496385475
STAT,1791,70,na,1861,621.6129143182195
STAT,1824,82,na,1906,257.2674228894971
STAT,1877,31,20-24,1908,2.659645683556985
STAT,1832,50,35-39,1882,0.005630813732472396
STAT,1862,35,25-29,1897,2.3476672482560246
STAT,1929,26,40-44,1955,5.513085639866102
STAT,1811,48,25-29,1859,0.18872025079348126
STAT,1833,33,35-39,1866,7.917300261387922
STAT,1811,64,na,1875,889.9378231957631
SIM,1874,29,30-34,1903,24
SIM,1895,72,na,1967,1835
STAT,1773,85,na,1858,69.06595758669013
STAT,1896,42,40-44,1938,0.19464145900136534
STAT,1880,30,15-19,1910,0.14296880675732773
SIM,1853,36,30-34,1889,5
STAT,1905,37,15-19,1942,0.01655043223186719
STAT,1857,38,15-19,1895,0.041631054179526596
SIM,1869,40,30-34,1909,3
STAT,1909,32,20-24,1941,2.1989800298396895
SIM,1859,25,na,1884,1993
SIM,1937,26,40-44,1963,4
STAT,1831,51,30-34,1882,0.0038049434871934335
STAT,1898,42,45-49,1940,0.13270226891187042
SIM,1870,17,25-29,1887,9
SIM,1849,18,15-19,1867,6
STAT,1862,17,25-29,1879,5.242180422073577
STAT,1883,24,35-39,1907,5.371064035303506
STAT,1878,47,50-100,1925,0.24067098304913523
SIM,1801,94,na,1895,10
STAT,1914,17,50-100,1931,0.07321594764822432
STAT,1845,36,30-34,1881,4.0038967801726235
STAT,1833,51,35-39,1884,0.00555267300925123
SIM,1816,48,na,1864,1348
STAT,1897,43,40-44,1940,0.1959076722690496
SIM,1920,0,na,1920,4482
SIM,1940,31,35-39,1971,12
STAT,1877,43,20-24,1920,0.15450218255181963
STAT,1870,46,35-39,1916,0.13011495479863855
STAT,1821,38,40-44,1859,8.753597532007083
STAT,1832,38,50-100,1870,0.9282488257140575
SIM,1931,23,40-44,1954,6
STAT,1858,16,20-24,1874,15.429862067979599
SIM,1879,35,45-49,1914,1
SIM,1929,33,50-100,1962,4
STAT,1851,30,50-100,1881,0.7003949660660442
STAT,1896,45,na,1941,2835.606213273521
STAT,1909,41,50-100,1950,0.10440841451535207
STAT,1773,82,na,1855,130.2973
STAT,1955,16,40-44,1971,1.754412430593264
SIM,1850,29,na,1879,1898
SIM,1883,39,na,1922,2146
SIM,1945,8,na,1953,3905
STAT,1856,17,na,1873,2000.5844013898586
STAT,1940,26,45-49,1966,1.665005946443107
SIM,1834,23,20-24,1857,54
STAT,1887,32,25-29,1919,10.82319917411827
SIM,1842,85,na,1927,160
STAT,1830,28,35-39,1858,9.103162450022166
STAT,1843,26,25-29,1869,35.417684050352165
STAT,1874,98,na,1972,22.785980889484165
STAT,1925,36,20-24,1961,0.29915552926157074
STAT,1879,41,30-34,1920,1.1420201938906074
STAT,1877,46,25-29,1923,0.056604491050111824
STAT,1886,38,na,1924,2339.392867728491
STAT,1854,100,na,1954,0.7595911254111173
STAT,1863,10,na,1873,2286.589699793816
STAT,1851,53,45-49,1904,0.010271787056234188
SIM,1817,78,na,1895,337
STAT,1805,56,na,1861,1117.6692391782153
STAT,1854,26,35-39,1880,8.010582305319359
STAT,1914,18,45-49,1932,0.09736549582051465
STAT,1832,103,na,1935,0.08645365127875744
STAT,1900,7,na,1907,3414.3309197180433
SIM,1832,78,na,1910,435
STAT,1885,50,50-100,1935,0.014425774562142692
SIM,1860,28,20-24,1888,17
STAT,1829,51,40-44,1880,0.008478342776344619
SIM,1876,65,na,1941,1625
STAT,1835,35,30-34,1870,4.281620087393525
SIM,1851,26,25-29,1877,51
SIM,1848,35,45-49,1883,2
SIM,1895,32,25-29,1927,19
STAT,1850,33,40-44,1883,3.164948531061162
STAT,1871,26,30-34,1897,23.703508601291354
STAT,1903,32,na,1935,3207.5653713846573
SIM,1918,18,25-29,1936,50
STAT,1841,22,50-100,1863,0.3561427908443986
SIM,1832,25,40-44,1857,2
STAT,1830,40,25-29,1870,0.5136971989110686
SIM,1843,17,30-34,1860,1
STAT,1852,28,20-24,1880,9.835160798886578
SIM,1907,14,na,1921,3570
SIM,1907,28,20-24,1935,3
STAT,1866,46,15-19,1912,3.495177706588519E-4
SIM,1883,33,45-49,1916,2
SIM,1917,21,na,1938,3673
STAT,1912,36,45-49,1948,0.6316166975393264
SIM,1866,58,na,1924,1760
STAT,1900,49,30-34,1949,0.07006374554997888
STAT,1862,53,20-24,1915,5.864612453189975E-4
STAT,1804,50,25-29,1854,0.013031057539060524
SIM,1887,41,30-34,1928,1
SIM,1845,42,35-39,1887,2
STAT,1806,97,na,1903,1.8630047534703422
SIM,1839,25,na,1864,1870
SIM,1927,25,40-44,1952,7
SIM,1862,26,35-39,1888,9
STAT,1834,29,15-19,1863,0.3639295126451243
SIM,1828,27,40-44,1855,2
SIM,1811,53,na,1864,1118
STAT,1911,50,na,1961,3256.1360260134134
STAT,1867,17,50-100,1884,0.044428770248563995
SIM,1861,5,na,1866,2476
SIM,1944,23,na,1967,3633
STAT,1815,50,35-39,1865,0.019360840599915146
STAT,1837,58,na,1895,1283.4289782135454
STAT,1951,19,na,1970,4137.9076805569275
STAT,1891,16,40-44,1907,0.21429869449952096
SIM,1833,28,30-34,1861,21
SIM,1836,37,na,1873,1638
SIM,1887,32,50-100,1919,1
STAT,1852,46,20-24,1898,0.00872453588296381
STAT,1910,35,30-34,1945,1.6623864310076926
STAT,1879,32,50-100,1911,0.90605066750849
STAT,1919,25,40-44,1944,4.789964629447173
SIM,1816,42,45-49,1858,1
STAT,1837,42,35-39,1879,1.386777453270741
SIM,1849,32,na,1881,1910
STAT,1869,43,na,1912,2099.9423516495217
STAT,1872,28,45-49,1900,1.0483946019837649
SIM,1917,4,na,1921,4089
STAT,1892,19,30-34,1911,1.8758325747551032
SIM,1778,89,na,1867,28
STAT,1848,48,20-24,1896,0.008804658036122385
SIM,1880,28,45-49,1908,1
STAT,1861,25,30-34,1886,20.212981235664188
STAT,1879,23,30-34,1902,17.55966179547465
STAT,1880,16,35-39,1896,0.5478207253628671
SIM,1838,43,50-100,1881,3
STAT,1887,46,50-100,1933,0.2602584936202144
STAT,1893,29,20-24,1922,13.954152217274874
SIM,1864,21,40-44,1885,1
STAT,1862,32,20-24,1894,2.1833106470575907
STAT,1875,33,45-49,1908,1.6861313063097931
STAT,1914,36,45-49,1950,0.6461220807839705
SIM,1844,24,20-24,1868,55
SIM,1877,37,30-34,1914,5
STAT,1860,19,15-19,1879,5.18470911878001
STAT,1895,45,30-34,1940,0.06791975252481447
SIM,1953,15,40-44,1968,3
STAT,1871,41,25-29,1912,0.6051153961539297
STAT,1925,18,20-24,1943,154.30738972285013
STAT,1870,32,50-100,1902,0.849140906577858
SIM,1854,31,25-29,1885,14
STAT,1779,99,na,1878,0.29177235965863135
STAT,1901,42,25-29,1943,0.05889419756158919
STAT,1860,40,40-44,1900,1.7414884017429624
SIM,1872,98,na,1970,11
SIM,1849,66,na,1915,1245
STAT,1863,17,50-100,1880,0.04634566606350731
STAT,1830,46,35-39,1876,0.10626988748717028
STAT,1944,2,na,1946,4116.537557190285
SIM,1943,22,20-24,1965,108
SIM,1770,86,na,1856,55
STAT,1846,17,40-44,1863,0.17041622586753327
STAT,1858,34,20-24,1892,1.9849643055702306
STAT,1887,18,40-44,1905,0.19276442048553738
STAT,1945,15,40-44,1960,1.4441838543308791
STAT,1816,96,na,1912,4.0013969003520105
SIM,1846,40,30-34,1886,3
SIM,1870,40,na,1910,2146
STAT,1886,35,na,1921,2373.3823416803466
STAT,1909,57,na,1966,3049.2182013526904
SIM,1881,80,na,1961,617
STAT,1832,55,na,1887,1264.233412199282
SIM,1890,32,40-44,1922,5
STAT,1846,35,40-44,1881,3.4617322016072767
STAT,1923,23,40-44,1946,3.6844137883927535
STAT,1891,34,40-44,1925,5.02527691987671
STAT,1884,27,25-29,1911,39.48079241714285
SIM,1909,0,na,1909,3858
SIM,1934,13,na,1947,4945
STAT,1856,36,40-44,1892,3.2420897467791376
SIM,1887,23,30-34,1910,22
STAT,1803,78,na,1881,314.8062208606836
SIM,1902,24,25-29,1926,79
STAT,1845,84,na,1929,235.4020689095239
STAT,1859,48,30-34,1907,0.07186848159821706
STAT,1935,22,20-24,1957,143.04422016722893
STAT,1811,110,na,1921,1.1984580834388524E-4
SIM,1866,16,20-24,1882,13
STAT,1860,37,15-19,1897,0.04304301491828221
STAT,1833,96,na,1929,5.268138594537532
STAT,1925,20,50-100,1945,0.7484751735655646
STAT,1843,41,50-100,1884,0.7441815623497264
SIM,1812,78,na,1890,299
SIM,1877,50,na,1927,2107
STAT,1905,41,50-100,1946,0.10062892540108857
STAT,1773,111,na,1884,0.0010376026223789844
STAT,1824,43,40-44,1867,2.881091358742956
SIM,1899,29,30-34,1928,41
STAT,1836,24,20-24,1860,58.0523059015283
STAT,1914,49,25-29,1963,0.049408630024911325
SIM,1865,17,na,1882,2333
STAT,1897,42,50-100,1939,0.09257038393969273
SIM,1861,8,na,1869,2419
SIM,1933,18,20-24,1951,174
STAT,1856,21,40-44,1877,1.7967387218005484
SIM,1825,36,25-29,1861,2
STAT,1863,50,30-34,1913,0.0050056811321904015
STAT,1901,46,40-44,1947,0.12806251342472807
SIM,1832,43,40-44,1875,5
STAT,1837,48,45-49,1885,0.15697080262164612
STAT,1836,45,25-29,1881,0.04004857723309352
STAT,1846,31,25-29,1877,9.071442155683469
SIM,1849,55,na,1904,1565
STAT,1870,51,na,1921,2005.0200355151258
SIM,1854,35,40-44,1889,4
STAT,1826,38,20-24,1864,0.8142324913022604
STAT,1869,37,30-34,1906,4.877573358436935
STAT,1882,32,40-44,1914,3.984208075341729
STAT,1850,34,15-19,1884,0.10285594952412937
STAT,1933,31,na,1964,4817.707754315405
STAT,1866,25,45-49,1891,0.973994149000187
STAT,1923,8,na,1931,4424.281054904723
STAT,1925,47,50-100,1972,0.2589103672379751
STAT,1887,36,40-44,1923,4.6479019408682145
STAT,1812,42,30-34,1854,4.39253366305799
STAT,1894,40,15-19,1934,0.016934989372988415
STAT,1858,109,na,1967,0.005025868070443948
STAT,1825,45,15-19,1870,4.194950915391935E-4
STAT,1949,22,15-19,1971,5.868165442518317
SIM,1823,38,45-49,1861,3
SIM,1831,32,35-39,1863,11
SIM,1836,36,35-39,1872,12
SIM,1861,30,20-24,1891,2
STAT,1934,16,na,1950,4714.789193438648
STAT,1781,89,na,1870,35.28552548103388
SIM,1853,39,35-39,1892,14
SIM,1892,27,25-29,1919,64
STAT,1867,39,20-24,1906,0.6769209572963126
SIM,1893,38,30-34,1931,7
STAT,1831,104,na,1935,0.038945193700067646
STAT,1893,47,20-24,1940,0.008071642068113075
SIM,1805,53,na,1858,1149
STAT,1856,51,35-39,1907,0.006375907424068354
SIM,1828,70,na,1898,777
SIM,1886,43,35-39,1929,7
SIM,1823,41,40-44,1864,3
STAT,1927,44,40-44,1971,0.2953524430786672
SIM,1890,29,45-49,1919,1
STAT,1878,43,35-39,1921,1.7699050394054017
STAT,1854,22,15-19,1876,2.7733897246136934
STAT,1882,29,45-49,1911,1.012762030104255
STAT,1845,39,35-39,1884,5.150627247485959
STAT,1892,36,15-19,1928,0.06676470573841486
STAT,1841,46,45-49,1887,0.1655462062668882
STAT,1838,22,30-34,1860,15.515026526709034
STAT,1883,61,na,1944,1730.7552459596805
SIM,1810,48,50-100,1858,1
STAT,1844,19,30-34,1863,1.3906339782007504
STAT,1883,21,30-34,1904,16.54778357247796
STAT,1911,39,na,1950,3398.399379878792
SIM,1945,20,30-34,1965,32
SIM,1838,34,45-49,1872,1
SIM,1915,22,45-49,1937,1
STAT,1823,32,35-39,1855,26.545275161334438
STAT,1851,18,30-34,1869,1.3857707117325844
SIM,1895,36,40-44,1931,5
SIM,1818,37,25-29,1855,2
STAT,1872,21,25-29,1893,54.40840894950188
STAT,1900,4,na,1904,3447.528045529025
STAT,1834,47,15-19,1881,2.6326345771798007E-4
STAT,1877,28,25-29,1905,41.30671482414501
STAT,1897,25,45-49,1922,1.4122540331663938
STAT,1838,40,30-34,1878,0.9260867033142356
STAT,1909,35,25-29,1944,0.888819259337364
STAT,1876,36,30-34,1912,5.22672952696197
STAT,1832,66,na,1898,987.3420277935892
STAT,1890,23,35-39,1913,6.71895408396457
STAT,1927,30,15-19,1957,0.14949946426088803
SIM,1846,22,30-34,1868,19
STAT,1852,55,na,1907,1499.0639222059658
STAT,1929,29,45-49,1958,2.040479223245042
STAT,1810,52,45-49,1862,0.04629069400867732
SIM,1864,32,na,1896,2074
STAT,1892,18,15-19,1910,7.0036612674138885
SIM,1858,91,na,1949,41
SIM,1937,29,45-49,1966,1
SIM,1884,36,30-34,1920,11
SIM,1862,44,30-34,1906,2
STAT,1809,45,30-34,1854,0.28296871582783356
STAT,1819,49,35-39,1868,0.25736682207044964
STAT,1865,44,40-44,1909,1.8999817326955235
STAT,1868,54,30-34,1922,0.005217741788351006
STAT,1947,24,35-39,1971,10.046663166149266
SIM,1869,24,na,1893,2189
SIM,1824,30,30-34,1854,21
SIM,1885,28,25-29,1913,46
STAT,1892,75,na,1967,1558.20526565564
SIM,1891,21,30-34,1912,24
STAT,1849,91,na,1940,43.45321362121451
STAT,1937,20,30-34,1957,26.458783689323212
SIM,1869,32,na,1901,2211
STAT,1866,29,30-34,1895,21.784705903953164
SIM,1830,31,35-39,1861,10
STAT,1813,43,30-34,1856,3.5114660032696627
STAT,1938,30,25-29,1968,8.78958473004972
STAT,1902,29,45-49,1931,1.4697111093435498
STAT,1831,24,40-44,1855,2.11594905794333
STAT,1875,48,15-19,1923,3.835252129891934E-4
SIM,1905,33,40-44,1938,3
SIM,1901,29,na,1930,3120
STAT,1842,20,30-34,1862,16.50604393564118
SIM,1871,1,na,1872,3138
SIM,1873,44,40-44,1917,5
STAT,1838,40,na,1878,1693.5392708384054
STAT,1899,38,25-29,1937,0.8004159405939338
STAT,1856,39,15-19,1895,0.04097370601512298
STAT,1925,46,30-34,1971,0.10229980944508975
STAT,1948,20,40-44,1968,3.649759564881113
STAT,1949,22,45-49,1971,1.2403663386367114
STAT,1821,34,25-29,1855,27.458442159796995
STAT,1875,83,na,1958,475.3161065623211
SIM,1841,19,20-24,1860,16
SIM,1885,17,na,1902,2427
STAT,1885,38,30-34,1923,4.9936705819549045
STAT,1880,34,30-34,1914,17.239865771176166
SIM,1857,43,45-49,1900,1
SIM,1910,29,45-49,1939,5
STAT,1869,36,50-100,1905,1.1290252551171873
STAT,1876,68,na,1944,1491.5281391462254
STAT,1910,25,20-24,1935,16.90783137239713
STAT,1870,44,15-19,1914,0.0126256608563719
SIM,1872,33,35-39,1905,12
STAT,1818,47,30-34,1865,0.20639113951877008
SIM,1884,18,30-34,1902,3
SIM,1819,48,50-100,1867,1
SIM,1853,40,na,1893,1772
SIM,1862,22,15-19,1884,6
SIM,1866,41,50-100,1907,3
SIM,1850,20,30-34,1870,19
STAT,1839,36,na,1875,1721.8873184526149
STAT,1934,27,na,1961,4760.765106934352
STAT,1855,43,na,1898,1630.5640962075308
SIM,1913,54,na,1967,3176
STAT,1891,35,15-19,1926,0.06625571699595899
SIM,1924,46,na,1970,4144
STAT,1864,30,30-34,1894,14.818754807675633
SIM,1820,42,30-34,1862,1
STAT,1939,33,40-44,1972,3.769699351207563
SIM,1843,35,30-34,1878,9
SIM,1864,42,40-44,1906,6
STAT,1889,49,20-24,1938,0.0077295501081612586
STAT,1945,19,na,1964,3795.8526221016805
SIM,1856,14,na,1870,2226
SIM,1908,39,na,1947,3250
STAT,1907,19,15-19,1926,8.191374831868876
SIM,1818,63,na,1881,903
SIM,1915,19,15-19,1934,9
STAT,1895,27,35-39,1922,11.8836077171733
SIM,1829,66,na,1895,976
SIM,1859,35,20-24,1894,5
STAT,1865,76,na,1941,811.2297081213345
SIM,1841,15,na,1856,1981
SIM,1863,41,40-44,1904,3
STAT,1809,52,50-100,1861,0.04059528652444694
STAT,1828,36,35-39,1864,6.605524010501779
STAT,1919,21,20-24,1940,115.37315587565989
STAT,1854,40,15-19,1894,0.009980426350183938
STAT,1929,35,50-100,1964,0.510076339743233
STAT,1824,44,15-19,1868,0.017239513380471902
STAT,1841,28,45-49,1869,0.9439072547604317
SIM,1927,21,20-24,1948,119
STAT,1914,40,50-100,1954,0.11074243970755566
SIM,1842,14,na,1856,2103
SIM,1881,0,na,1881,2616
STAT,1891,31,35-39,1922,11.884695446614193
SIM,1935,16,30-34,1951,19
STAT,1854,23,30-34,1877,14.866732612090638
STAT,1933,15,45-49,1948,0.6346581440861051
SIM,1920,33,na,1953,3942
STAT,1897,61,na,1958,2426.2119717444184
STAT,1936,25,40-44,1961,4.217550970508382
SIM,1935,30,50-100,1965,6
STAT,1885,41,20-24,1926,0.15022192727598285
SIM,1935,18,25-29,1953,66
SIM,1835,52,na,1887,1366
STAT,1760,101,na,1861,0.09895437076839436
SIM,1918,19,35-39,1937,3
STAT,1850,38,30-34,1888,3.777013504616081
SIM,1867,29,20-24,1896,9
STAT,1866,47,25-29,1913,0.0499541280048377
SIM,1924,23,na,1947,4095
SIM,1871,90,na,1961,133
SIM,1827,57,na,1884,1142
STAT,1896,45,50-100,1941,0.17457617935181943
SIM,1853,16,15-19,1869,6
SIM,1873,91,na,1964,91
STAT,1889,66,na,1955,1911.503552824604
STAT,1865,26,40-44,1891,2.5738024619474236
STAT,1898,32,30-34,1930,22.320845056246597
SIM,1944,25,40-44,1969,5
STAT,1757,98,na,1855,0.61218
STAT,1927,16,30-34,1943,14.35203003631165
SIM,1918,29,na,1947,3710
SIM,1832,40,35-39,1872,3
STAT,1920,24,35-39,1944,9.826944227816591
SIM,1849,26,50-100,1875,1
STAT,1807,50,45-49,1857,0.05536641259030899
STAT,1846,69,na,1915,1088.4825165263098
STAT,1845,16,15-19,1861,5.339197809538145
SIM,1944,9,na,1953,3916
STAT,1906,42,45-49,1948,0.14282130532615936
SIM,1862,23,30-34,1885,17
STAT,1885,39,50-100,1924,1.1444604866663495
STAT,1850,74,na,1924,782.3159173289716
STAT,1864,42,30-34,1906,0.9667964594529226
STAT,1894,17,50-100,1911,0.05947856410692272
SIM,1881,42,40-44,1923,1
STAT,1841,47,20-24,1888,0.00831044792866065
STAT,1852,35,30-34,1887,3.966357925985197
SIM,1869,86,na,1955,187
STAT,1780,84,na,1864,85.26328176204028
SIM,1915,46,50-100,1961,2
STAT,1816,53,20-24,1869,0.00163569708492506
STAT,1911,24,25-29,1935,82.24280349181154
SIM,1860,35,30-34,1895,9
SIM,1910,15,15-19,1925,7
STAT,1876,14,na,1890,2512.381347504697
STAT,1902,15,15-19,1917,7.948890562069267
STAT,1927,45,na,1972,4376.916347877149
STAT,1948,24,20-24,1972,120.53391455427274
SIM,1878,30,30-34,1908,19
STAT,1883,44,20-24,1927,0.1451092500643378
STAT,1839,42,50-100,1881,0.7413356857776106
SIM,1919,31,40-44,1950,7
STAT,1862,54,30-34,1916,0.004675768148642679
STAT,1873,42,40-44,1915,2.1524104953044603
SIM,1848,39,na,1887,1702
STAT,1907,17,na,1924,3504.8535221306943
STAT,1918,25,20-24,1943,18.476534414477854
STAT,1790,94,na,1884,4.002557866188926
STAT,1858,74,na,1932,821.999836307459
SIM,1820,44,50-100,1864,1
STAT,1865,41,35-39,1906,1.5575544177859773
STAT,1894,29,50-100,1923,0.7710675661712214
SIM,1865,31,30-34,1896,23
STAT,1868,19,na,1887,2290.430401986653
STAT,1949,9,na,1958,4317.68493927301
STAT,1886,15,20-24,1901,17.77368291562799
SIM,1856,29,45-49,1885,1
STAT,1888,31,50-100,1919,1.0271210957938641
STAT,1931,36,45-49,1967,0.8536769305462992
SIM,1812,89,na,1901,38
STAT,1887,31,na,1918,2531.882181040583
SIM,1910,26,40-44,1936,7
STAT,1882,40,25-29,1922,0.5959124372986944
SIM,1838,94,na,1932,6
SIM,1876,34,na,1910,2298
SIM,1848,34,35-39,1882,2
STAT,1909,45,35-39,1954,0.11300096166233119
SIM,1879,3,na,1882,2914
SIM,1852,44,na,1896,1746
SIM,1873,26,40-44,1899,6
STAT,1896,20,30-34,1916,22.356728117539653
STAT,1907,25,45-49,1932,1.551251651913518
STAT,1772,89,na,1861,30.697326345425374
STAT,1951,18,30-34,1969,13.707445088398512
STAT,1871,45,40-44,1916,0.16219907049364146
SIM,1889,35,35-39,1924,12
STAT,1825,87,na,1912,93.63756260469577
STAT,1870,49,40-44,1919,0.15534880019974773
STAT,1854,48,45-49,1902,0.16673280328516937
STAT,1873,31,na,1904,2295.7026605586543
STAT,1906,21,50-100,1927,0.5627743269749158
STAT,1944,15,20-24,1959,137.9034479614183
SIM,1778,80,na,1858,201
SIM,1870,43,na,1913,2104
STAT,1879,23,35-39,1902,5.752718821763302
STAT,1880,52,25-29,1932,0.0035088348145202114
STAT,1801,97,na,1898,1.8991110765323116
STAT,1911,48,50-100,1959,0.20172729791356553
STAT,1932,32,45-49,1964,1.9761327592408626
SIM,1873,41,35-39,1914,1
STAT,1927,18,25-29,1945,50.76779713058979
STAT,1865,24,50-100,1889,0.34836476359047164
STAT,1848,29,45-49,1877,0.9708248986735437
STAT,1844,40,20-24,1884,0.11589695629324648
STAT,1859,44,15-19,1903,0.010243322496879358
SIM,1851,19,15-19,1870,5
SIM,1952,15,20-24,1967,167
STAT,1921,20,na,1941,3919.7694643331547
STAT,1934,31,50-100,1965,1.067037646994535
STAT,1892,37,25-29,1929,3.406810961593795
SIM,1887,23,35-39,1910,7
STAT,1883,41,na,1924,2150.3873281953947
SIM,1863,61,na,1924,1549
STAT,1902,31,20-24,1933,3.6185303102035755
SIM,1840,41,40-44,1881,5
SIM,1808,50,na,1858,1265
STAT,1842,43,20-24,1885,0.11747515193511399
STAT,1887,51,na,1938,2286.1672011895103
STAT,1934,37,40-44,1971,1.9515424690335208
STAT,1843,19,15-19,1862,5.062386388831221
STAT,1782,99,na,1881,0.3047924341703416
SIM,1909,26,30-34,1935,44
STAT,1900,43,20-24,1943,0.014348237385114246
STAT,1889,32,na,1921,2783.0468694395677
STAT,1856,34,50-100,1890,0.6695622274138241
SIM,1920,20,25-29,1940,102
STAT,1825,46,25-29,1871,0.05957645919336212
SIM,1911,50,na,1961,3226
SIM,1936,30,30-34,1966,13
STAT,1859,29,20-24,1888,8.844632163962487
SIM,1861,80,na,1941,490
STAT,1833,40,45-49,1873,1.1415672251763593
STAT,1914,5,na,1919,3916.415077781444
STAT,1840,41,30-34,1881,0.7971792479197017
SIM,1863,22,35-39,1885,6
SIM,1913,51,na,1964,3220
STAT,1919,24,25-29,1943,94.9538334874392
SIM,1909,46,na,1955,3248
STAT,1942,22,na,1964,3617.1550712732187
STAT,1856,50,25-29,1906,0.0026482564803131225
SIM,1922,14,na,1936,4284
STAT,1861,33,15-19,1894,0.11138735025981042
SIM,1847,36,40-44,1883,7
STAT,1877,40,15-19,1917,0.013669280682922544
SIM,1846,22,35-39,1868,8
SIM,1897,27,40-44,1924,7
STAT,1924,47,25-29,1971,0.05965732906835148
SIM,1883,16,na,1899,2356
STAT,1838,109,na,1947,4.7763862197080544E-4
STAT,1844,33,15-19,1877,0.11705268339089929
SIM,1868,28,25-29,1896,32
STAT,1905,46,45-49,1951,0.18229570920889784
STAT,1840,48,15-19,1888,2.6134336757430377E-4
STAT,1832,41,40-44,1873,1.6851217320333143
STAT,1848,64,na,1912,1291.701169115038
SIM,1848,31,50-100,1879,1
SIM,1945,21,40-44,1966,2
STAT,1844,18,20-24,1862,15.559599353119934
STAT,1805,52,50-100,1857,0.0554370353474225
SIM,1833,23,35-39,1856,5
STAT,1830,47,45-49,1877,0.17683935156523886
SIM,1876,68,na,1944,1474
STAT,1881,60,na,1941,1740.5045671128157
STAT,1855,22,35-39,1877,4.844547242548599
SIM,1882,39,30-34,1921,8
STAT,1806,106,na,1912,0.004210537192922673
SIM,1831,39,50-100,1870,1
STAT,1849,25,45-49,1874,1.0012730687601115
SIM,1855,47,50-100,1902,2
STAT,1889,27,40-44,1916,3.4935909678317563
STAT,1804,54,40-44,1858,0.035732968440329006
STAT,1926,42,30-34,1968,0.1488866390425211
STAT,1857,31,30-34,1888,13.22548552092159
STAT,1850,30,35-39,1880,8.378700296608583
STAT,1852,89,na,1941,76.16235973182346
STAT,1928,33,35-39,1961,10.787633529827433
STAT,1900,45,15-19,1945,2.986411489550822E-4
SIM,1868,39,na,1907,2105
STAT,1841,34,50-100,1875,0.7506528530466422
STAT,1865,49,30-34,1914,0.08115595801698725
SIM,1894,15,20-24,1909,25
STAT,1898,49,na,1947,2816.7104549192577
SIM,1872,44,na,1916,2151
STAT,1937,21,40-44,1958,3.0942242650844216
SIM,1915,22,40-44,1937,4
STAT,1937,9,na,1946,3658.563166766988
STAT,1896,14,na,1910,3211.727679656203
STAT,1813,47,45-49,1860,0.6451920316229209
SIM,1857,25,45-49,1882,4
SIM,1823,41,na,1864,1430
SIM,1836,33,30-34,1869,22
SIM,1863,16,na,1879,2180
SIM,1901,17,30-34,1918,2
STAT,1859,51,20-24,1910,5.574892646208607E-4
STAT,1865,48,20-24,1913,0.010146086372110756
SIM,1894,53,na,1947,2679
STAT,1908,21,15-19,1929,4.637184626210809
SIM,1932,9,na,1941,4947
SIM,1916,21,15-19,1937,5
STAT,1890,29,na,1919,2736.6525935801355
STAT,1907,48,35-39,1955,0.10821414029446179
STAT,1924,40,40-44,1964,0.2818340259392312
SIM,1848,70,na,1918,1008
SIM,1903,21,na,1924,3200
STAT,1856,46,50-100,1902,0.1815402743889783
STAT,1902,26,40-44,1928,4.0074855626217865
STAT,1829,32,35-39,1861,10.104467102532999
STAT,1839,36,40-44,1875,3.5192580972320027
STAT,1880,38,45-49,1918,1.9755354073910247
SIM,1936,31,40-44,1967,3
STAT,1818,43,15-19,1861,0.03148621097303538
STAT,1896,23,35-39,1919,7.258345713513194
STAT,1905,36,na,1941,3258.064822935479
STAT,1807,48,30-34,1855,0.36661083366382463
STAT,1807,82,na,1889,182.4522397037139
STAT,1821,97,na,1918,2.862148599213432
STAT,1835,43,15-19,1878,0.010397503071001726
STAT,1907,22,40-44,1929,2.891759193209812
STAT,1903,39,35-39,1942,2.0313677375345285
STAT,1875,30,40-44,1905,4.244864091218499
STAT,1814,51,30-34,1865,0.017743020864516304
STAT,1824,48,30-34,1872,0.11634163373113465
STAT,1923,49,30-34,1972,0.09793885494265682
SIM,1900,34,30-34,1934,23
STAT,1886,17,15-19,1903,5.922149879456107
STAT,1828,33,30-34,1861,17.46940365541609
STAT,1926,5,na,1931,4656.896810069672
SIM,1926,25,20-24,1951,30
STAT,1959,2,na,1961,4861.767333160637
STAT,1867,52,50-100,1919,0.013325996854335055
SIM,1852,24,na,1876,1932
STAT,1865,22,na,1887,2049.7280744523714
STAT,1860,98,na,1958,3.9401425827310717
STAT,1865,40,25-29,1905,0.5554056092174187
STAT,1871,47,35-39,1918,0.1307178543702079
SIM,1852,18,20-24,1870,12
SIM,1873,40,25-29,1913,1
STAT,1923,41,35-39,1964,0.222657796483472
STAT,1763,92,na,1855,5.50962
SIM,1859,2,na,1861,2703
SIM,1863,44,45-49,1907,2
SIM,1883,30,40-44,1913,4
STAT,1871,101,na,1972,5.18130805232593
STAT,1808,106,na,1914,0.0046946478056281845
STAT,1895,24,30-34,1919,21.800251637668534
STAT,1917,26,15-19,1943,0.7018077910219584
STAT,1848,51,45-49,1899,0.010835160978927312
STAT,1885,34,15-19,1919,0.13294918318071716
STAT,1925,35,50-100,1960,0.4768605935410442
STAT,1908,47,40-44,1955,0.13470299738924568
SIM,1888,37,40-44,1925,7
STAT,1881,46,na,1927,2059.048786663393
SIM,1774,90,na,1864,20
SIM,1858,15,na,1873,2212
STAT,1891,39,30-34,1930,6.166417286227553
STAT,1924,48,35-39,1972,0.14459735279760533
STAT,1878,94,na,1972,98.0883592929995
STAT,1928,31,40-44,1959,4.625140030240802
SIM,1927,24,25-29,1951,118
SIM,1865,96,na,1961,18
SIM,1785,82,na,1867,131
SIM,1911,39,35-39,1950,9
STAT,1867,31,na,1898,2125.4949304115535
STAT,1818,50,20-24,1868,0.0015718973397499535
STAT,1837,20,50-100,1857,0.35993488268857027
STAT,1874,39,30-34,1913,5.092458779277399
STAT,1838,22,35-39,1860,5.082876091802502
STAT,1874,19,45-49,1893,0.06271268186408382
STAT,1869,19,35-39,1888,0.5031468172835437
STAT,1824,40,35-39,1864,2.5064918275234844
STAT,1933,38,35-39,1971,3.109150195082738
STAT,1936,28,na,1964,3385.134814245839
STAT,1917,42,20-24,1959,0.017411019907535966
STAT,1854,98,na,1952,2.324282566473399
STAT,1845,22,na,1867,1878.2929612964142
SIM,1939,24,20-24,1963,102
STAT,1960,9,na,1969,4833.871196596171
STAT,1881,49,15-19,1930,3.574204883377481E-4
SIM,1832,24,na,1856,1671
SIM,1880,73,na,1953,1190
STAT,1918,41,25-29,1959,0.07182885443076932
SIM,1840,35,50-100,1875,4
SIM,1909,25,20-24,1934,17
STAT,1850,15,40-44,1865,0.15942614307111172
SIM,1902,34,35-39,1936,9
STAT,1890,32,30-34,1922,20.16537676618707
STAT,1890,43,na,1933,2650.1197475871118
SIM,1894,17,15-19,1911,7
STAT,1832,89,na,1921,63.28439001048369
SIM,1817,47,na,1864,1374
STAT,1782,107,na,1889,0.007081995585307893
SIM,1898,26,45-49,1924,1
STAT,1823,41,30-34,1864,1.576610841969025
STAT,1883,47,25-29,1930,0.05310116958804083
STAT,1918,40,15-19,1958,0.001546763845980715
STAT,1887,30,30-34,1917,18.59770821342277
SIM,1903,24,40-44,1927,2
STAT,1812,48,40-44,1860,0.5637603711678644
STAT,1863,41,na,1904,1924.7274359089693
STAT,1818,53,25-29,1871,0.007106786404864595
STAT,1920,21,30-34,1941,30.275964909722326
SIM,1891,31,45-49,1922,1
SIM,1954,2,na,1956,4489
STAT,1900,44,na,1944,2998.3249339468052
SIM,1869,18,30-34,1887,2
SIM,1882,82,na,1964,624
STAT,1901,35,20-24,1936,0.22210199028527558
SIM,1918,16,30-34,1934,2
STAT,1845,17,25-29,1862,5.068214711829676
SIM,1913,31,na,1944,3448
STAT,1874,44,50-100,1918,1.0059478860217745
STAT,1908,28,30-34,1936,34.869511341489066
STAT,1868,41,20-24,1909,0.14379257059902012
STAT,1841,40,35-39,1881,1.3309095981593853
STAT,1767,106,na,1873,0.010917199607316116
STAT,1918,29,50-100,1947,0.9935469181555732
STAT,1932,39,30-34,1971,2.308430773160436
SIM,1886,23,15-19,1909,3
SIM,1891,34,50-100,1925,1
STAT,1807,68,na,1875,774.3825477689217
STAT,1878,23,15-19,1901,3.237920928296507
STAT,1869,18,25-29,1887,5.226975830715673
SIM,1882,44,50-100,1926,4
STAT,1871,23,30-34,1894,16.657577942541856
SIM,1935,15,20-24,1950,166
STAT,1883,31,45-49,1914,1.6217519557738236
SIM,1913,19,15-19,1932,8
SIM,1876,88,na,1964,255
SIM,1783,81,na,1864,159
STAT,1881,42,30-34,1923,1.047902972210343
SIM,1870,63,na,1933,1622
STAT,1925,43,25-29,1968,0.08154195959767753
SIM,1898,35,na,1933,2972
SIM,1858,0,na,1858,3049
STAT,1881,15,50-100,1896,0.04491803757998939
STAT,1864,45,35-39,1909,0.11905122336199672
STAT,1850,40,45-49,1890,1.0656621584986519
SIM,1951,16,15-19,1967,46
STAT,1824,50,45-49,1874,0.01772221413358277
STAT,1836,26,15-19,1862,0.3829228316719813
STAT,1947,8,na,1955,4182.412066357679
SIM,1889,32,30-34,1921,33
STAT,1905,19,15-19,1924,8.060137892830449
STAT,1895,49,45-49,1944,0.1605316653248852
SIM,1896,34,na,1930,2946
SIM,1869,27,30-34,1896,23
SIM,1824,40,45-49,1864,2
STAT,1857,19,45-49,1876,0.05653127475303888
STAT,1800,78,na,1878,314.3079065860866
SIM,1905,22,50-100,1927,1
SIM,1930,23,na,1953,4428
SIM,1919,18,40-44,1937,2
SIM,1920,30,50-100,1950,1
STAT,1853,17,na,1870,2089.7166960391933
STAT,1875,15,45-49,1890,0.06372381164066578
STAT,1943,16,15-19,1959,45.47667767222433
STAT,1935,8,na,1943,5150.823294553088
SIM,1853,17,25-29,1870,5
STAT,1896,68,na,1964,2121.158317821611
STAT,1770,94,na,1864,2.9201523513933116
STAT,1885,44,25-29,1929,0.596520956171418
STAT,1918,54,na,1972,3596.9297682495653
STAT,1879,53,30-34,1932,0.005791805509331155
SIM,1916,28,30-34,1944,42
STAT,1865,29,45-49,1894,0.9439200746877181
STAT,1814,43,45-49,1857,5.059104307538842
SIM,1843,95,na,1938,10
STAT,1903,35,na,1938,3222.0930557266274
STAT,1891,41,45-49,1932,1.7571598774906954
STAT,1891,38,20-24,1929,0.8964849854713319
STAT,1892,30,40-44,1922,5.172668248111857
SIM,1848,31,30-34,1879,20
STAT,1878,40,na,1918,2298.423400871556
STAT,1867,46,30-34,1913,0.08611295428653064
SIM,1803,98,na,1901,2
SIM,1877,34,30-34,1911,23
SIM,1883,37,25-29,1920,1
STAT,1884,42,15-19,1926,0.01287313158497672
STAT,1871,48,45-49,1919,0.2186033517462183
STAT,1906,41,35-39,1947,0.173798111550454
SIM,1818,40,na,1858,1445
STAT,1927,15,20-24,1942,159.9856927076945
STAT,1927,19,50-100,1946,0.43770756890734547
SIM,1874,53,na,1927,1967
STAT,1820,54,25-29,1874,0.005486359703243323
SIM,1850,30,45-49,1880,2
STAT,1816,40,45-49,1856,4.425193964995606
STAT,1932,12,na,1944,4956.424199937587
STAT,1824,47,20-24,1871,0.014628765158998627
STAT,1850,54,na,1904,1476.0792554393934
STAT,1912,30,50-100,1942,0.7747697796499887
SIM,1936,33,35-39,1969,11
STAT,1907,45,na,1952,3153.8792462605966
STAT,1912,48,45-49,1960,0.19677897109796644
SIM,1839,29,45-49,1868,1
SIM,1909,29,35-39,1938,19
STAT,1925,23,50-100,1948,0.7417367613406128
SIM,1891,11,na,1902,3064
STAT,1875,37,25-29,1912,2.795742704303108
SIM,1845,76,na,1921,630
SIM,1943,25,20-24,1968,19
SIM,1861,35,na,1896,2058
SIM,1895,30,30-34,1925,33
STAT,1810,88,na,1898,58.07630787816115
SIM,1866,44,na,1910,2028
SIM,1898,25,35-39,1923,14
STAT,1935,25,20-24,1960,23.52668979833319
SIM,1870,2,na,1872,2894
SIM,1839,44,35-39,1883,2
STAT,1822,51,25-29,1873,0.004675742950188531
STAT,1947,11,na,1958,4180.948392770241
SIM,1910,7,na,1917,3731
SIM,1827,27,25-29,1854,36
STAT,1862,16,15-19,1878,5.522464973989757
STAT,1898,35,35-39,1933,9.128035988731156
SIM,1822,43,45-49,1865,2
STAT,1892,34,20-24,1926,3.171011722918764
STAT,1915,7,na,1922,3939.430625780018
STAT,1838,74,na,1912,745.0567298150536
SIM,1835,66,na,1901,1034
SIM,1858,94,na,1952,10
STAT,1838,52,30-34,1890,0.00397506977502014
SIM,1877,18,25-29,1895,6
STAT,1853,49,40-44,1902,0.12685831013991633
STAT,1912,20,25-29,1932,84.12912305218582
STAT,1909,42,30-34,1951,0.11296987404515482
STAT,1780,101,na,1881,0.1109812371747525
STAT,1844,43,25-29,1887,0.45095681939139254
SIM,1871,38,45-49,1909,2
SIM,1894,18,25-29,1912,8
SIM,1887,20,30-34,1907,25
SIM,1926,29,50-100,1955,1
STAT,1881,34,45-49,1915,1.5777983358127572
SIM,1830,74,na,1904,633
SIM,1853,71,na,1924,1024
STAT,1869,34,30-34,1903,15.842143773723828
STAT,1841,91,na,1932,39.94991586163706
STAT,1920,38,50-100,1958,0.43382654888552535
STAT,1855,52,30-34,1907,0.004207521796930019
SIM,1791,68,na,1859,648
STAT,1879,16,25-29,1895,5.617438589957493
SIM,1870,16,15-19,1886,5
STAT,1886,18,25-29,1904,5.640071391712855
SIM,1889,52,na,1941,2564
SIM,1890,49,na,1939,2767
STAT,1837,22,15-19,1859,2.802853474886095
STAT,1865,51,45-49,1916,0.01248594535947887
SIM,1857,24,35-39,1881,6
SIM,1874,25,na,1899,2316
STAT,1929,26,na,1955,4430.949477415021
STAT,1840,33,45-49,1873,1.3794685420283905
STAT,1870,29,na,1899,2195.9296446811327
STAT,1804,53,30-34,1857,0.020615247572608977
STAT,1863,27,na,1890,1978.469034132417
STAT,1833,65,na,1898,1036.8361281895639
STAT,1928,30,30-34,1958,18.631164110156735
SIM,1866,53,50-100,1919,1
SIM,1879,62,na,1941,1847
STAT,1900,28,30-34,1928,32.88482866205129
STAT,1919,50,na,1969,3730.425298798942
STAT,1902,41,30-34,1943,0.1069205703370141
SIM,1910,31,20-24,1941,2
SIM,1910,49,50-100,1959,2
STAT,1907,45,30-34,1952,0.076529895902503
STAT,1823,44,35-39,1867,2.287433498394344
STAT,1839,39,45-49,1878,1.55349280248739
SIM,1847,39,45-49,1886,2
STAT,1825,43,20-24,1868,0.16902908966614955
SIM,1928,24,45-49,1952,1
STAT,1834,45,50-100,1879,0.18224087560567476
STAT,1926,35,25-29,1961,1.138707094867725
STAT,1830,51,50-100,1881,0.010152247926826624
STAT,1910,32,25-29,1942,8.419248520163656
STAT,1856,79,na,1935,515.2949596522894
STAT,1902,40,20-24,1942,0.014851641307769744
STAT,1922,43,40-44,1965,0.27078614792067246
STAT,1890,35,35-39,1925,8.24656433859191
STAT,1829,110,na,1939,1.6697329783319637E-4
SIM,1904,20,40-44,1924,3
STAT,1863,31,25-29,1894,8.525996913378576
STAT,1923,25,50-100,1948,1.0868806694761184
STAT,1859,54,25-29,1913,0.002589969510871429
SIM,1792,64,na,1856,777
SIM,1868,25,20-24,1893,8
STAT,1830,44,40-44,1874,1.7016384704674825
STAT,1879,56,na,1935,2016.9394060334007
SIM,1904,57,na,1961,2907
STAT,1842,46,25-29,1888,0.04225781140020573
STAT,1863,53,35-39,1916,0.007022465801349451
STAT,1867,29,50-100,1896,0.5634013578927304
SIM,1887,20,50-100,1907,1
SIM,1902,31,30-34,1933,28
SIM,1921,49,na,1970,3915
STAT,1910,31,15-19,1941,0.11753508100335859
SIM,1842,45,50-100,1887,3
STAT,1860,13,na,1873,2100.811465416124
STAT,1942,27,50-100,1969,0.9869074665882487
SIM,1842,36,25-29,1878,1
STAT,1802,59,na,1861,999.3578695497182
SIM,1814,50,na,1864,1211
STAT,1834,36,25-29,1870,2.2457703404914193
STAT,1849,42,50-100,1891,0.7912241393857273
SIM,1915,25,45-49,1940,3
SIM,1798,80,na,1878,219
SIM,1881,35,na,1916,1845
STAT,1916,46,20-24,1962,0.010734649509188928
STAT,1926,45,35-39,1971,0.15098886586853472
SIM,1885,62,na,1947,1727
STAT,1806,51,40-44,1857,0.03781443772153003
STAT,1830,28,50-100,1858,0.6035098888124854
STAT,1829,25,50-100,1854,1.8198513503206843
STAT,1830,43,30-34,1873,0.8819605930639284
STAT,1842,45,15-19,1887,2.9724065267547204E-4
SIM,1909,28,25-29,1937,51
STAT,1816,73,na,1889,568.5800414789456
STAT,1850,18,45-49,1868,0.05593771605075895
STAT,1863,52,25-29,1915,0.002920758022462126
STAT,1914,27,na,1941,3567.7245350561857
STAT,1913,22,35-39,1935,8.61979038021725
STAT,1903,55,na,1958,2836.2309983472087
SIM,1850,43,na,1893,1730
STAT,1933,35,30-34,1968,2.3492335019129342
SIM,1807,57,na,1864,1046
STAT,1817,58,na,1875,1103.5351377143686
STAT,1896,45,45-49,1941,0.16775235502725383
STAT,1838,24,50-100,1862,0.35011520698742254
STAT,1855,21,50-100,1876,0.3409911402563978
SIM,1928,39,na,1967,4480
SIM,1946,24,na,1970,3728
SIM,1926,17,35-39,1943,4
SIM,1900,37,35-39,1937,4
SIM,1942,18,30-34,1960,19
STAT,1856,100,na,1956,0.92822188398484
SIM,1865,34,35-39,1899,6
STAT,1883,47,na,1930,2074.1176657641445
SIM,1825,42,na,1867,1488
STAT,1862,79,na,1941,564.6802689025824
STAT,1861,94,na,1955,15.69880709604358
STAT,1934,18,30-34,1952,15.533928281365561
SIM,1890,18,na,1908,3150
SIM,1831,44,35-39,1875,4
STAT,1857,34,35-39,1891,7.480682157367636
STAT,1872,55,na,1927,1959.318349062247
SIM,1835,19,30-34,1854,3
STAT,1785,93,na,1878,6.9592210426283145
STAT,1948,23,40-44,1971,3.6460380746235375
STAT,1869,12,na,1881,2434.096894807698
STAT,1928,34,45-49,1962,1.8563235278600687
STAT,1871,44,30-34,1915,1.0639145770590765
STAT,1826,45,30-34,1871,0.09183194361504984
STAT,1883,46,15-19,1929,3.715369110635315E-4
STAT,1924,28,15-19,1952,0.7737548856563682
STAT,1843,41,na,1884,1628.0741572780573
STAT,1829,91,na,1920,35.01413134441102
STAT,1850,37,20-24,1887,0.55199427937789
SIM,1767,94,na,1861,3
STAT,1849,24,35-39,1873,5.214822588634444
SIM,1931,25,50-100,1956,1
STAT,1887,85,na,1972,646.1376800533365
STAT,1858,40,na,1898,1729.1660853270075
STAT,1886,0,na,1886,3314.1896626260914
SIM,1845,22,15-19,1867,7
SIM,1921,22,35-39,1943,14
STAT,1829,54,45-49,1883,0.010021552625196883
SIM,1878,69,na,1947,1431
STAT,1883,34,50-100,1917,0.8413731719408181
SIM,1852,78,na,1930,525
STAT,1927,19,35-39,1946,4.902325680046512
SIM,1935,19,35-39,1954,5
STAT,1846,103,na,1949,0.10644563720490326
STAT,1866,44,20-24,1910,0.1365093482617466
SIM,1865,41,45-49,1906,3
STAT,1854,13,na,1867,2033.9382793768143
STAT,1893,36,30-34,1929,6.415712844747418
STAT,1888,39,na,1927,2603.853440495326
SIM,1918,35,40-44,1953,5
STAT,1957,4,na,1961,4897.384170268887
SIM,1794,73,na,1867,423
STAT,1820,49,45-49,1869,0.38434138145119423
STAT,1822,52,35-39,1874,0.011140718627871589
STAT,1841,107,na,1948,0.003251234757536293
SIM,1952,4,na,1956,4392
SIM,1910,57,na,1967,3064
SIM,1931,25,na,1956,4518
STAT,1887,8,na,1895,2746.8996933979015
STAT,1910,23,50-100,1933,0.5819593884912135
STAT,1936,18,50-100,1954,0.3379586728317991
STAT,1910,36,40-44,1946,1.3590824304614935
SIM,1883,67,na,1950,1392
STAT,1927,30,50-100,1957,0.9618738624639452
SIM,1920,29,35-39,1949,18
STAT,1930,17,50-100,1947,0.4575735230817079
STAT,1872,40,30-34,1912,1.1003919045538573
STAT,1874,33,na,1907,2293.603246693448
STAT,1916,24,50-100,1940,0.647279504333653
STAT,1809,91,na,1900,23.254002526091345
SIM,1920,24,40-44,1944,7
STAT,1846,53,35-39,1899,0.006282847980164947
STAT,1816,38,30-34,1854,19.62689834841891
SIM,1948,17,20-24,1965,140
STAT,1941,26,na,1967,3662.594361959257
STAT,1947,24,50-100,1971,0.7020729798772944
SIM,1792,95,na,1887,1
STAT,1764,91,na,1855,11.01924
STAT,1896,2,na,1898,3325.9050948543745
STAT,1893,32,15-19,1925,0.17060833175075027
STAT,1912,49,na,1961,3315.9802202881274
STAT,1936,7,na,1943,3615.264510294492
STAT,1883,29,30-34,1912,23.157112511690414
STAT,1887,17,30-34,1904,1.6842168167545994
STAT,1846,38,na,1884,1805.9649970956912
SIM,1856,41,35-39,1897,5
STAT,1883,40,40-44,1923,2.104330694031686
SIM,1877,15,20-24,1892,14
SIM,1835,83,na,1918,233
SIM,1843,28,20-24,1871,13
STAT,1912,24,40-44,1936,3.152539916034667
STAT,1835,53,25-29,1888,0.0022523949755929714
STAT,1872,49,50-100,1921,0.2278658540243714
SIM,1862,39,50-100,1901,1
STAT,1876,45,na,1921,2217.7471287083913
STAT,1909,40,na,1949,3318.9834604026646
SIM,1891,2,na,1893,3130
SIM,1807,88,na,1895,37
STAT,1898,17,40-44,1915,0.2338268559363192
SIM,1911,17,25-29,1928,10
STAT,1847,15,35-39,1862,0.511010200272391
SIM,1852,75,na,1927,741
STAT,1929,17,45-49,1946,0.6022377135047224
SIM,1880,40,30-34,1920,2
STAT,1901,24,30-34,1925,23.406475558552597
SIM,1863,43,35-39,1906,7
STAT,1910,34,na,1944,3415.632250869178
STAT,1881,52,40-44,1933,0.009556455171974555
STAT,1837,41,25-29,1878,0.49812493809436975
SIM,1858,20,35-39,1878,8
STAT,1864,4,na,1868,2551.183858302829
STAT,1835,28,20-24,1863,9.661378261566494
SIM,1872,34,45-49,1906,1
STAT,1895,20,15-19,1915,4.087316313295223
SIM,1828,26,30-34,1854,22
STAT,1826,103,na,1929,0.07837109778002017
SIM,1873,45,50-100,1918,2
SIM,1908,30,na,1938,3342
STAT,1893,44,15-19,1937,0.0011333802032692953
STAT,1933,16,25-29,1949,54.93658171230446
SIM,1788,79,na,1867,279
SIM,1868,44,30-34,1912,4
STAT,1861,40,20-24,1901,0.1260043227809464
STAT,1912,29,35-39,1941,13.877576918458203
STAT,1832,80,na,1912,372.6432796656037
STAT,1866,38,na,1904,2042.6311812815227
SIM,1935,32,na,1967,4860
STAT,1903,17,25-29,1920,7.616945798281926
SIM,1790,83,na,1873,102
STAT,1848,41,35-39,1889,1.361211351920629
STAT,1821,40,na,1861,1499.7185508122477
STAT,1942,28,35-39,1970,14.879071325982498
SIM,1839,26,40-44,1865,3
SIM,1941,16,25-29,1957,57
STAT,1851,33,20-24,1884,2.002893407978093
STAT,1811,49,35-39,1860,0.45119617965989045
SIM,1894,34,30-34,1928,39
STAT,1884,46,30-34,1930,0.09060195290923646
STAT,1912,45,40-44,1957,0.14381980759080773
SIM,1937,17,45-49,1954,1
STAT,1840,51,40-44,1891,0.0069419068166908585
STAT,1957,1,na,1958,4903.5111283262995
SIM,1850,28,30-34,1878,22
SIM,1879,28,35-39,1907,9
SIM,1932,23,20-24,1955,131
SIM,1827,43,30-34,1870,1
STAT,1867,42,15-19,1909,0.012235314539103965
SIM,1899,21,35-39,1920,9
STAT,1928,18,40-44,1946,1.6605445081781722
SIM,1929,15,na,1944,4421
STAT,1843,44,50-100,1887,0.7161215236274928
STAT,1870,33,25-29,1903,9.452391018656286
SIM,1916,18,20-24,1934,18
STAT,1873,21,40-44,1894,2.0025550934461327
SIM,1899,62,na,1961,2551
STAT,1842,28,30-34,1870,22.389971697838117
STAT,1907,46,50-100,1953,0.19280004590766342
SIM,1898,22,30-34,1920,27
STAT,1908,18,20-24,1926,24.779533563449395
SIM,1884,29,20-24,1913,17
STAT,1886,34,30-34,1920,17.27406263358426
SIM,1900,17,15-19,1917,10
STAT,1853,26,15-19,1879,0.4006442292966576
STAT,1857,16,40-44,1873,0.16111782412768036
STAT,1889,42,35-39,1931,2.109270319664502
SIM,1915,26,25-29,1941,64
STAT,1876,29,20-24,1905,11.368117804316073
SIM,1936,18,40-44,1954,1
SIM,1881,89,na,1970,212
SIM,1828,42,35-39,1870,6
STAT,1861,15,na,1876,2097.0165466934345
SIM,1879,46,50-100,1925,3
STAT,1890,45,45-49,1935,0.27528935798071263
STAT,1852,7,na,1859,2170.29865625344
STAT,1924,23,20-24,1947,123.56567979553407
SIM,1882,8,na,1890,2482
STAT,1836,93,na,1929,18.925387927371006
STAT,1887,33,35-39,1920,10.65595295679131
SIM,1895,33,35-39,1928,10
STAT,1813,44,40-44,1857,6.482414492344418
STAT,1855,44,45-49,1899,1.0491964772316902
SIM,1937,10,na,1947,3554
STAT,1907,26,25-29,1933,58.90430513624058
STAT,1934,33,25-29,1967,11.913982252896389
STAT,1870,45,25-29,1915,0.05391363973059169
STAT,1858,15,45-49,1873,0.057189680547855164
SIM,1900,33,20-24,1933,3
STAT,1919,43,35-39,1962,0.2058229270011564
SIM,1943,28,25-29,1971,65
SIM,1821,44,40-44,1865,4
STAT,1921,41,50-100,1962,0.12518194839573132
SIM,1906,52,na,1958,2992
STAT,1935,28,25-29,1963,84.71837360927243
STAT,1823,54,45-49,1877,0.01652962761781096
STAT,1922,46,45-49,1968,0.23645869886299767
STAT,1869,15,20-24,1884,16.64514274754179
SIM,1823,95,na,1918,8
STAT,1803,54,25-29,1857,0.009913970427370014
STAT,1892,33,50-100,1925,1.0795727335913705
SIM,1841,38,na,1879,1640
SIM,1798,89,na,1887,30
STAT,1861,60,na,1921,1498.0651129815278
STAT,1950,18,15-19,1968,50.67880458818088
SIM,1825,76,na,1901,490
SIM,1939,22,na,1961,3410
STAT,1911,46,35-39,1957,0.11559838158731787
STAT,1873,39,15-19,1912,0.05326100003460093
STAT,1896,65,na,1961,2247.8245656594454
SIM,1867,23,na,1890,2273
SIM,1871,35,40-44,1906,5
STAT,1936,21,25-29,1957,83.45080975830209
SIM,1939,26,45-49,1965,2
STAT,1873,50,25-29,1923,0.0034424220361597203
STAT,1890,39,15-19,1929,0.064203846480059
SIM,1878,15,na,1893,2568
SIM,1829,25,35-39,1854,6
STAT,1872,52,na,1924,2029.4312097625814
STAT,1861,18,20-24,1879,15.911516195740635
STAT,1891,59,na,1950,2271.4844313842345
STAT,1942,21,15-19,1963,5.274426592826922
STAT,1920,46,45-49,1966,0.22752371778455077
SIM,1860,50,na,1910,1829
SIM,1900,67,na,1967,2362
SIM,1934,32,20-24,1966,7
STAT,1888,16,35-39,1904,0.6141099131814397
STAT,1925,21,15-19,1946,6.037421828126884
STAT,1890,74,na,1964,1545.552743724239
SIM,1868,70,na,1938,1230
STAT,1900,46,25-29,1946,0.042700750480990465
STAT,1847,31,40-44,1878,3.793964416459972
SIM,1874,21,30-34,1895,15
SIM,1904,23,45-49,1927,1
STAT,1838,36,50-100,1874,1.004984385412062
STAT,1843,75,na,1918,695.3467613716831
STAT,1877,27,15-19,1904,0.4445988398236549
STAT,1819,43,30-34,1862,2.336302446385372
STAT,1905,67,na,1972,2528.7928758896473
STAT,1808,46,25-29,1854,0.22243404014128568
SIM,1909,9,na,1918,3682
SIM,1924,38,35-39,1962,4
STAT,1833,30,35-39,1863,8.167875328684694
SIM,1824,35,50-100,1859,1
SIM,1933,21,15-19,1954,7
SIM,1844,52,50-100,1896,1
SIM,1898,15,na,1913,3195
STAT,1926,32,20-24,1958,2.7861774504422043
STAT,1854,39,50-100,1893,0.8695905368661655
STAT,1927,38,45-49,1965,0.7998812399938094
STAT,1925,47,40-44,1972,0.18047823657782047
STAT,1912,15,na,1927,3706.8017483860976
SIM,1838,27,35-39,1865,6
STAT,1778,91,na,1869,16.26203620586866
STAT,1892,52,na,1944,2534.242887913005
STAT,1809,94,na,1903,8.020255598200862
STAT,1941,29,na,1970,3657.322753963453
STAT,1836,43,30-34,1879,0.8743936812502638
SIM,1944,21,25-29,1965,107
STAT,1779,106,na,1885,0.010818242502843833
SIM,1818,94,na,1912,11
STAT,1814,103,na,1917,0.06596323853252074
STAT,1941,22,45-49,1963,1.0984669149563215
SIM,1865,39,30-34,1904,7
STAT,1857,50,40-44,1907,0.007956458834892387
STAT,1969,1,na,1970,4646.003445952359
STAT,1823,48,15-19,1871,4.8567536609122556E-4
SIM,1811,70,na,1881,593
SIM,1844,43,30-34,1887,1
STAT,1843,48,35-39,1891,0.09337435640411147
STAT,1852,31,15-19,1883,0.10801219273671404
STAT,1872,22,35-39,1894,5.529568196745567
SIM,1855,31,40-44,1886,4
STAT,1880,19,na,1899,2501.8499435062176
STAT,1849,21,30-34,1870,16.265633627147942
STAT,1947,14,na,1961,4178.77467377956
STAT,1850,23,na,1873,1796.0511538578155
STAT,1916,31,15-19,1947,0.1258463243312834
SIM,1857,21,30-34,1878,17
STAT,1823,75,na,1898,550.9486953175289
STAT,1899,16,45-49,1915,0.08476129102208868
SIM,1902,45,na,1947,3016
STAT,1943,21,na,1964,3671.5862702027503
SIM,1911,59,na,1970,3052
STAT,1812,54,35-39,1866,0.026458917116330284
SIM,1856,68,na,1924,1173
SIM,1805,76,na,1881,366
SIM,1844,40,50-100,1884,1
STAT,1840,54,50-100,1894,0.009638740925390929
STAT,1829,46,na,1875,1503.011129639425
STAT,1838,71,na,1909,896.1185977901835
STAT,1846,16,30-34,1862,1.493854425927267
STAT,1827,52,20-24,1879,6.516657856078114E-4
STAT,1927,31,25-29,1958,10.746764011827114
STAT,1948,7,na,1955,4249.612425044327
STAT,1901,45,30-34,1946,0.07292402188000759
STAT,1846,32,35-39,1878,8.876463791073439
STAT,1878,42,25-29,1920,0.631438465576779
SIM,1841,30,35-39,1871,7
SIM,1843,16,na,1859,2149
SIM,1854,32,35-39,1886,13
STAT,1884,49,35-39,1933,0.12793671700842954
SIM,1895,17,30-34,1912,2
STAT,1911,34,35-39,1945,8.334808018194485
STAT,1916,38,35-39,1954,2.3283405167301807
STAT,1862,33,30-34,1895,14.043024640788932
STAT,1882,45,na,1927,2087.5700220967688
STAT,1769,103,na,1872,0.03979205201482908
STAT,1804,106,na,1910,0.004067059533521477
SIM,1854,16,30-34,1870,1
SIM,1891,40,40-44,1931,5
SIM,1857,30,na,1887,1951
STAT,1826,41,15-19,1867,0.013767190452207827
STAT,1876,51,20-24,1927,7.236588067846573E-4
SIM,1801,63,na,1864,846
STAT,1852,43,15-19,1895,0.00993961270075721
STAT,1864,49,15-19,1913,3.2975654409300357E-4
SIM,1853,51,50-100,1904,2
SIM,1938,29,na,1967,3356
STAT,1897,18,35-39,1915,0.6914132025267581
SIM,1812,55,na,1867,1135
SIM,1918,31,25-29,1949,10
STAT,1922,49,15-19,1971,3.9743989800454207E-4
SIM,1829,41,40-44,1870,6
SIM,1886,42,25-29,1928,3
STAT,1825,53,na,1878,1243.1497536209608
STAT,1902,44,35-39,1946,0.16538640042340302
STAT,1843,41,15-19,1884,0.00972786427097647
SIM,1810,44,30-34,1854,3
STAT,1888,32,40-44,1920,4.8417193983191655
SIM,1853,33,30-34,1886,24
STAT,1913,6,na,1919,3858.8037402578952
STAT,1910,35,50-100,1945,0.3829539588235024
STAT,1795,83,na,1878,141.6383742824337
SIM,1863,30,na,1893,1995
SIM,1847,23,na,1870,1979
STAT,1920,44,na,1964,3862.016775139467
STAT,1806,48,15-19,1854,0.0014552270973487251
STAT,1866,21,30-34,1887,15.760103800801105
SIM,1809,69,na,1878,714
SIM,1891,29,30-34,1920,35
STAT,1815,46,na,1861,1372.8469051494546
SIM,1850,97,na,1947,2
SIM,1874,40,40-44,1914,4
STAT,1930,40,30-34,1970,0.15934725296736804
STAT,1857,35,15-19,1892,0.04223591950639972
SIM,1896,32,40-44,1928,14
STAT,1926,16,15-19,1942,52.692468621694644
STAT,1870,74,na,1944,1028.5090853013448
SIM,1824,38,30-34,1862,5
STAT,1759,106,na,1865,0.0052074980125373415
STAT,1819,39,na,1858,1518.334070169451
STAT,1779,76,na,1855,292.88154
STAT,1874,67,na,1941,1530.0893484683857
SIM,1950,21,15-19,1971,5
STAT,1845,33,30-34,1878,14.53839916885734
STAT,1827,36,15-19,1863,0.059701240778972646
STAT,1867,88,na,1955,121.78126026160535
STAT,1910,37,na,1947,3399.2589504446905
SIM,1934,16,15-19,1950,54
STAT,1866,40,40-44,1906,1.9796175050321745
STAT,1894,27,15-19,1921,0.5508173255278264
SIM,1928,21,40-44,1949,7
SIM,1787,94,na,1881,2
STAT,1762,99,na,1861,0.16111054381890427
STAT,1816,52,45-49,1868,0.03281859037758215
STAT,1846,50,30-34,1896,0.004478474439090722
STAT,1901,20,na,1921,3146.0625895343396
STAT,1833,38,30-34,1871,4.046057139939907
STAT,1837,26,30-34,1863,21.128223600093165
STAT,1892,55,na,1947,2446.6227243530543
SIM,1893,19,20-24,1912,22
SIM,1815,40,35-39,1855,6
STAT,1841,94,na,1935,13.778640299769677
STAT,1916,15,45-49,1931,0.10058858446606798
SIM,1847,20,na,1867,1991
STAT,1912,27,45-49,1939,1.6083895695649273
STAT,1835,46,na,1881,1528.7943578313043
STAT,1845,53,na,1898,1499.1798250072284
STAT,1854,27,50-100,1881,0.47980866913033676
STAT,1874,31,35-39,1905,9.814827452777601
STAT,1861,43,25-29,1904,0.5007623768149913
SIM,1859,106,na,1965,1
SIM,1846,44,45-49,1890,3
SIM,1952,18,25-29,1970,54
SIM,1838,49,na,1887,1493
SIM,1843,61,na,1904,1337
SIM,1871,31,25-29,1902,13
STAT,1860,23,20-24,1883,54.06106626797887
STAT,1834,33,50-100,1867,0.7208360846963239
STAT,1894,40,50-100,1934,1.2955265923649122
STAT,1898,36,15-19,1934,0.07213461761446777
STAT,1899,8,na,1907,3364.859632171248
STAT,1805,52,35-39,1857,0.03160091601060839
SIM,1777,87,na,1864,42
STAT,1942,25,30-34,1967,38.88406499864675
STAT,1885,18,50-100,1903,0.0460120194210546
SIM,1935,31,25-29,1966,16
STAT,1876,30,50-100,1906,0.9014482461398184
STAT,1902,56,na,1958,2778.5002430306185
STAT,1853,52,30-34,1905,0.004480884696112249
STAT,1909,16,15-19,1925,8.428606223551782
SIM,1929,16,40-44,1945,1
STAT,1901,27,35-39,1928,12.759181783884733
STAT,1910,39,45-49,1949,0.609753516942207
STAT,1911,21,20-24,1932,99.92868574566002
SIM,1844,97,na,1941,3
SIM,1894,22,na,1916,2971
STAT,1872,43,35-39,1915,1.703490777560356
SIM,1836,68,na,1904,974
STAT,1907,23,20-24,1930,95.33627273169849
STAT,1820,46,40-44,1866,0.291422886217206
SIM,1917,16,15-19,1933,11
STAT,1907,48,na,1955,3083.5093787451983
STAT,1921,39,20-24,1960,0.2774697388230749
STAT,1883,43,45-49,1926,1.3761944813836156
SIM,1849,89,na,1938,39
SIM,1917,44,na,1961,3613
SIM,1941,18,15-19,1959,35
STAT,1814,61,na,1875,1075.6305367972093
STAT,1829,60,na,1889,1171.9909233260043
STAT,1884,26,na,1910,2235.035400166767
SIM,1900,15,25-29,1915,11
SIM,1772,95,na,1867,1
SIM,1864,17,35-39,1881,1
SIM,1880,43,35-39,1923,2
STAT,1840,54,45-49,1894,0.009261982337655328
STAT,1933,18,15-19,1951,57.24168503635164
SIM,1858,49,na,1907,1818
STAT,1759,109,na,1868,0.001281580311049216
STAT,1906,49,30-34,1955,0.07356020259623465
STAT,1835,50,20-24,1885,4.979740530294436E-4
STAT,1830,54,na,1884,1296.2718580840349
STAT,1945,17,50-100,1962,0.38662987151187445
SIM,1818,43,na,1861,1390
SIM,1842,33,50-100,1875,4
STAT,1874,16,40-44,1890,0.17697590311138395
STAT,1859,59,na,1918,1461.2722722928531
SIM,1841,38,30-34,1879,6
STAT,1894,33,na,1927,2884.8738935692336
STAT,1811,46,30-34,1857,0.3277888488218609
STAT,1917,55,na,1972,3511.3451995510113
SIM,1891,43,45-49,1934,3
SIM,1929,41,45-49,1970,1
STAT,1777,98,na,1875,0.4991615064491459
SIM,1907,37,na,1944,3304
STAT,1820,47,na,1867,1357.8609068096732
SIM,1837,32,35-39,1869,10
SIM,1920,27,45-49,1947,1
SIM,1859,96,na,1955,5
SIM,1882,31,35-39,1913,10
SIM,1915,23,20-24,1938,94
STAT,1944,18,25-29,1962,44.041850885791064
STAT,1838,44,45-49,1882,1.0422735338064983
STAT,1856,17,35-39,1873,0.47822546107038194
STAT,1883,22,50-100,1905,0.37770092795732485
STAT,1900,21,45-49,1921,0.9166020095642671
STAT,1834,33,20-24,1867,2.126572156612957
STAT,1856,93,na,1949,21.541388844738016
STAT,1869,66,na,1935,1500.0047925947845
SIM,1926,28,25-29,1954,82
SIM,1840,20,40-44,1860,1
SIM,1851,90,na,1941,60
STAT,1836,100,na,1936,0.6874858357696755
STAT,1838,20,na,1858,1889.356743978118
STAT,1931,33,40-44,1964,4.841064016117671
SIM,1869,23,15-19,1892,2
SIM,1810,77,na,1887,342
SIM,1932,26,25-29,1958,82
SIM,1856,26,40-44,1882,4
SIM,1942,11,na,1953,3818
STAT,1921,18,50-100,1939,0.4023810275326393
STAT,1918,31,50-100,1949,0.8333923936702144
STAT,1864,26,na,1890,2016.2809069088023
STAT,1924,26,25-29,1950,72.64511158883022
STAT,1842,24,15-19,1866,2.970235982149023
STAT,1863,16,30-34,1879,1.5167127472275899
STAT,1913,44,45-49,1957,0.15281909768103635
SIM,1849,86,na,1935,120
STAT,1843,72,na,1915,853.0181946592938
STAT,1890,42,40-44,1932,2.5946383453712554
SIM,1850,24,15-19,1874,2
SIM,1871,16,30-34,1887,5
SIM,1841,83,na,1924,233
STAT,1791,79,na,1870,264.87756680981045
STAT,1919,40,30-34,1959,0.13124508526339787
SIM,1861,38,na,1899,2030
STAT,1886,30,15-19,1916,0.14325239856008445
STAT,1918,28,25-29,1946,65.94105155228341
STAT,1949,19,20-24,1968,148.86347901372167
STAT,1811,87,na,1898,76.40831808315365
STAT,1823,51,40-44,1874,0.012728692721914906
STAT,1842,42,45-49,1884,1.1213503891281749
SIM,1830,30,25-29,1860,12
STAT,1876,44,15-19,1920,0.013296526060718648
SIM,1865,42,na,1907,2041
SIM,1878,33,35-39,1911,10
STAT,1901,23,na,1924,3117.7390494056885
STAT,1870,30,20-24,1900,2.5252264673810205
STAT,1808,98,na,1906,1.2560654171552985
SIM,1884,30,50-100,1914,4
STAT,1902,34,25-29,1936,7.77400634591658
SIM,1842,33,20-24,1875,2
SIM,1888,15,30-34,1903,2
STAT,1882,48,20-24,1930,0.010886060491118945
SIM,1901,32,25-29,1933,18
STAT,1885,19,20-24,1904,16.60443133877415
SIM,1809,80,na,1889,240
STAT,1827,41,50-100,1868,1.0310315868783269
SIM,1909,15,na,1924,3610
SIM,1826,28,20-24,1854,8
STAT,1854,41,25-29,1895,0.4615326595215661
STAT,1848,26,40-44,1874,2.6764946615745107
SIM,1835,41,50-100,1876,1
STAT,1909,26,na,1935,3392.7830371840714
STAT,1937,21,na,1958,3360.5828514197874
SIM,1871,38,50-100,1909,1
STAT,1836,29,50-100,1865,0.528351307495693
STAT,1854,45,40-44,1899,0.12371221894643938
STAT,1864,31,40-44,1895,3.6663148227727786
SIM,1924,15,45-49,1939,1
STAT,1861,47,40-44,1908,0.13384846757775531
STAT,1863,38,50-100,1901,1.012771594385457
STAT,1881,15,na,1896,2315.593401793809
STAT,1839,51,35-39,1890,0.005759321408925464
SIM,1863,40,30-34,1903,4
STAT,1911,30,na,1941,3507.241140988583
SIM,1874,24,35-39,1898,8
SIM,1945,24,45-49,1969,1
SIM,1884,63,na,1947,1706
STAT,1810,53,20-24,1863,0.002307066227999501
SIM,1910,34,25-29,1944,16
STAT,1874,0,na,1874,3556.863193691285
STAT,1905,43,40-44,1948,0.21174177536098832
SIM,1957,10,na,1967,4912
STAT,1847,34,na,1881,1841.5006555420864
STAT,1890,24,45-49,1914,0.8003407448746891
STAT,1883,25,15-19,1908,0.42307630413328384
SIM,1939,23,40-44,1962,4
STAT,1924,44,20-24,1968,0.019778147114151032
STAT,1823,33,45-49,1856,3.964423176252326
STAT,1855,12,na,1867,2017.739695865266
SIM,1831,33,45-49,1864,1
SIM,1892,41,na,1933,3066
STAT,1821,53,30-34,1874,0.008849501485360668
SIM,1930,31,40-44,1961,6
SIM,1935,35,40-44,1970,1
STAT,1878,26,na,1904,2357.6444356326024
SIM,1881,21,40-44,1902,1
STAT,1858,100,na,1958,1.2881524918559237
STAT,1904,32,35-39,1936,7.879600990110016
STAT,1880,35,40-44,1915,4.401112329684
SIM,1903,20,25-29,1923,91
SIM,1874,56,na,1930,1875
STAT,1932,35,15-19,1967,0.024416661901585847
SIM,1869,4,na,1873,2610
STAT,1820,42,25-29,1862,1.1800626211494494
SIM,1900,25,50-100,1925,4
STAT,1893,48,30-34,1941,0.06459426033215157
SIM,1937,26,50-100,1963,4
SIM,1879,40,25-29,1919,4
STAT,1915,32,45-49,1947,1.5140205371537225
STAT,1848,49,30-34,1897,0.07042621477160016
SIM,1892,4,na,1896,3440
SIM,1905,56,na,1961,2833
STAT,1805,87,na,1892,61.50057009909196
STAT,1862,36,35-39,1898,5.740426405547459
STAT,1937,24,45-49,1961,1.0343994990165502
SIM,1906,47,50-100,1953,1
STAT,1831,42,35-39,1873,1.3370500148246145
SIM,1898,69,na,1967,2109
STAT,1861,30,45-49,1891,1.3807601565252168
STAT,1840,44,35-39,1884,1.2082729844549598
STAT,1927,35,40-44,1962,1.7612828882344063
SIM,1883,34,20-24,1917,1
SIM,1834,87,na,1921,102
SIM,1812,58,na,1870,1071
STAT,1875,34,20-24,1909,2.6022379843061003
STAT,1906,30,45-49,1936,1.3887704007075283
SIM,1923,32,45-49,1955,1
STAT,1912,19,50-100,1931,0.07118842879832882
STAT,1849,12,na,1861,2203.4867647523292
STAT,1848,19,na,1867,2089.5675223347516
STAT,1906,45,15-19,1951,3.135445193268684E-4
SIM,1819,39,35-39,1858,11
STAT,1845,51,50-100,1896,0.010738275022662402
SIM,1889,55,na,1944,2458
STAT,1846,40,20-24,1886,0.12231248779315293
STAT,1930,22,35-39,1952,11.395067931176134
SIM,1924,35,30-34,1959,2
SIM,1893,77,na,1970,1617
STAT,1850,51,35-39,1901,0.006097763692321641
STAT,1916,35,30-34,1951,1.7799385525972522
SIM,1890,63,na,1953,2247
STAT,1852,47,30-34,1899,0.06985149334161836
STAT,1911,31,30-34,1942,14.55307005393047
STAT,1917,45,25-29,1962,0.05258891935685177
SIM,1853,28,50-100,1881,2
STAT,1857,78,na,1935,582.140520401927
STAT,1940,27,20-24,1967,17.584518995031694
STAT,1867,85,na,1952,243.1786371526666
STAT,1845,28,50-100,1873,0.5470178155950146
STAT,1779,79,na,1858,220.3943123836955
SIM,1904,41,40-44,1945,2
SIM,1941,18,na,1959,3526
SIM,1925,18,30-34,1943,13
STAT,1879,45,45-49,1924,0.23570071342894616
STAT,1874,41,45-49,1915,1.4511285612647529
STAT,1897,30,25-29,1927,13.04434202070892
SIM,1858,60,na,1918,1563
STAT,1812,80,na,1892,268.71047581290776
STAT,1895,46,40-44,1941,0.11927447218730335
SIM,1919,34,45-49,1953,1
SIM,1900,64,na,1964,2504
STAT,1851,36,25-29,1887,2.115159210937642
SIM,1845,29,35-39,1874,7
SIM,1856,34,na,1890,1827
SIM,1914,30,45-49,1944,2
SIM,1839,22,25-29,1861,52
SIM,1820,36,na,1856,1599
STAT,1914,8,na,1922,3884.8937057334397
STAT,1902,5,na,1907,3493.917654032398
SIM,1912,32,35-39,1944,8
STAT,1832,35,na,1867,1652.6581437449497
STAT,1920,33,30-34,1953,16.233928148876263
SIM,1859,16,15-19,1875,2
SIM,1803,95,na,1898,3
SIM,1882,41,45-49,1923,1
STAT,1960,10,na,1970,4833.339470764546
SIM,1830,43,na,1873,1522
STAT,1908,43,25-29,1951,0.062040439365651304
SIM,1870,49,na,1919,2008
STAT,1843,45,30-34,1888,0.06676750119929674
STAT,1950,16,25-29,1966,48.42075197294935
STAT,1910,43,15-19,1953,0.0013628935911333023
STAT,1907,28,15-19,1935,0.6273993237607964
STAT,1849,110,na,1959,3.914489437586869E-4
STAT,1857,53,45-49,1910,0.010639025172545103
STAT,1864,52,40-44,1916,0.008816796278091876
STAT,1814,54,35-39,1868,0.024163135108778027
SIM,1946,25,50-100,1971,4
STAT,1864,7,na,1871,2369.053095790191
STAT,1866,24,35-39,1890,5.052747847613475
STAT,1797,64,na,1861,836.9159631311743
STAT,1781,80,na,1861,236.92491086563018
STAT,1836,46,35-39,1882,0.09610115094004226
STAT,1901,24,50-100,1925,0.5358625937969282
STAT,1818,42,50-100,1860,2.4916476097899634
STAT,1892,21,50-100,1913,0.483974893478968
STAT,1812,51,30-34,1863,0.019428370858005188
STAT,1842,79,na,1921,506.27964189338337
STAT,1895,18,na,1913,3102.3836272769013
SIM,1935,18,na,1953,4666
SIM,1845,42,na,1887,1632
SIM,1885,48,na,1933,2128
STAT,1901,41,15-19,1942,0.001273841077005506
STAT,1938,25,50-100,1963,0.932387363441926
STAT,1881,45,35-39,1926,0.12903867156992682
STAT,1876,54,25-29,1930,0.003361955762718605
STAT,1917,18,30-34,1935,2.4714024275643505
STAT,1850,20,na,1870,1835.300360538405
SIM,1867,26,20-24,1893,14
STAT,1902,16,20-24,1918,23.694286392553654
STAT,1904,24,30-34,1928,23.98554863204011
SIM,1859,79,na,1938,511
STAT,1840,44,45-49,1884,0.998639349063485
STAT,1917,38,na,1955,3673.2893406677013
STAT,1822,53,40-44,1875,0.013355063518460272
STAT,1843,12,na,1855,2060.6022
SIM,1847,28,45-49,1875,3
STAT,1841,37,15-19,1878,0.04561226059264402
STAT,1883,47,20-24,1930,0.011062744180221438
STAT,1884,10,na,1894,2417.604920979678
STAT,1934,36,35-39,1970,3.156063967845928
STAT,1886,1,na,1887,3126.6065277214543
STAT,1913,24,na,1937,3461.966924356611
STAT,1929,32,35-39,1961,10.965390614668172
SIM,1855,65,na,1920,1304
SIM,1901,32,30-34,1933,32
STAT,1839,108,na,1947,0.0012195583511492348
STAT,1907,24,50-100,1931,0.5623593908301305
STAT,1836,33,15-19,1869,0.11536221063814309
STAT,1898,18,na,1916,3220.3249815336403
STAT,1827,97,na,1924,3.1031775680126863
STAT,1869,3,na,1872,2880.7847722415263
STAT,1839,20,35-39,1859,5.064554417656669
SIM,1851,51,na,1902,1628
SIM,1924,18,15-19,1942,54
STAT,1835,40,45-49,1875,1.170982261207616
SIM,1933,38,35-39,1971,5
STAT,1909,19,na,1928,3559.0403420034722
STAT,1825,54,20-24,1879,6.971691364590118E-4
STAT,1839,28,45-49,1867,0.9245871641843997
SIM,1910,38,40-44,1948,1
STAT,1916,45,30-34,1961,0.08678463020212472
STAT,1865,23,40-44,1888,1.7930176793729913
STAT,1848,26,45-49,1874,0.9920403896782708
STAT,1906,32,40-44,1938,3.426196904996438
STAT,1859,36,50-100,1895,0.9275712128564854
STAT,1902,38,40-44,1940,1.2534496544300937
SIM,1864,25,40-44,1889,2
SIM,1905,34,40-44,1939,5
STAT,1822,66,na,1888,836.6571593502963
SIM,1842,15,na,1857,2052
STAT,1854,17,30-34,1871,1.3641781746126935
STAT,1871,67,na,1938,1487.0489372193135
STAT,1856,25,40-44,1881,2.3211681703878004
STAT,1788,89,na,1877,33.66374106181928
STAT,1805,70,na,1875,711.1729167549574
STAT,1872,25,na,1897,2276.757327971538
SIM,1881,1,na,1882,2485
STAT,1846,36,50-100,1882,0.9608704175013878
STAT,1845,31,15-19,1876,0.12106872257519573
SIM,1914,32,40-44,1946,6
STAT,1898,42,35-39,1940,0.1605590312983924
SIM,1921,17,35-39,1938,5
SIM,1846,29,na,1875,1824
STAT,1792,94,na,1886,4.216423812618675
STAT,1846,18,35-39,1864,0.50823739346518
STAT,1925,38,35-39,1963,2.739632903524821
STAT,1943,4,na,1947,4008.5395564881405
SIM,1899,29,20-24,1928,21
STAT,1806,49,15-19,1855,0.0014285860052101766
SIM,1923,25,45-49,1948,5
STAT,1872,47,45-49,1919,0.2225856663387109
STAT,1926,6,na,1932,4642.1810161498515
SIM,1889,30,40-44,1919,9
SIM,1871,15,30-34,1886,1
SIM,1940,22,40-44,1962,3
STAT,1777,114,na,1891,1.6703040090883386E-4
STAT,1784,75,na,1859,364.8196772139597
STAT,1892,45,20-24,1937,0.008089271394463849
STAT,1809,84,na,1893,133.49511928716552
STAT,1955,2,na,1957,4934.582348751683
SIM,1930,40,na,1970,4646
STAT,1915,25,45-49,1940,1.6759977576941791
STAT,1863,48,na,1911,1841.7211457347548
STAT,1972,0,na,1972,4790.528731859339
STAT,1913,17,35-39,1930,0.8105173418257593
SIM,1806,64,na,1870,870
SIM,1862,17,30-34,1879,2
STAT,1838,41,25-29,1879,0.5106887625761907
STAT,1839,82,na,1921,310.6497613329144
STAT,1863,15,30-34,1878,1.5256991150150283
STAT,1932,28,25-29,1960,81.40302972321497
STAT,1857,42,50-100,1899,0.7861520163739911
STAT,1798,83,na,1881,138.82776319719537
SIM,1940,28,25-29,1968,66
STAT,1927,37,30-34,1964,2.1406409614116293
STAT,1831,51,40-44,1882,0.006729404171492763
SIM,1896,63,na,1959,2341
STAT,1814,54,45-49,1868,0.04073214198372718
STAT,1844,42,50-100,1886,0.7514628199035988
STAT,1932,22,40-44,1954,4.167675425061631
STAT,1810,46,50-100,1856,0.8332084729168213
SIM,1858,14,na,1872,2256
SIM,1917,28,25-29,1945,66
SIM,1910,25,35-39,1935,16
SIM,1814,83,na,1897,133
STAT,1877,24,na,1901,2303.0845439171
STAT,1905,25,50-100,1930,0.8794224569660267
STAT,1920,34,40-44,1954,4.014669308596632
STAT,1888,20,30-34,1908,20.005145856271145
STAT,1897,48,50-100,1945,0.17282831895372375
SIM,1856,26,45-49,1882,3
STAT,1928,38,50-100,1966,0.5007443848546296
STAT,1892,29,na,1921,2803.671754670187
STAT,1903,37,45-49,1940,0.5783572496510091
STAT,1894,48,35-39,1942,0.09467082157355448
SIM,1884,78,na,1962,950
SIM,1955,16,na,1971,4309
STAT,1875,48,25-29,1923,0.055227676674331795
SIM,1934,25,20-24,1959,17
STAT,1830,54,50-100,1884,0.009566430580881418
SIM,1905,21,35-39,1926,7
STAT,1881,61,na,1942,1705.3289698114656
STAT,1831,46,45-49,1877,0.1703092382867284
STAT,1885,75,na,1960,1117.6685629711615
STAT,1837,25,30-34,1862,21.281021333266004
SIM,1809,48,50-100,1857,1
STAT,1874,35,50-100,1909,1.196300572742942
STAT,1879,42,25-29,1921,0.6342300740105894
SIM,1829,33,na,1862,1587
STAT,1888,23,50-100,1911,0.45387006895443893
STAT,1912,30,15-19,1942,0.12041876955310368
STAT,1826,28,50-100,1854,2.0412594442530687
STAT,1871,21,15-19,1892,3.104066296810123
SIM,1910,16,20-24,1926,23
SIM,1911,37,45-49,1948,3
SIM,1912,24,30-34,1936,34
STAT,1902,25,35-39,1927,12.951530055485193
STAT,1859,26,20-24,1885,9.037914407105456
STAT,1909,28,25-29,1937,59.21820001962971
SIM,1867,50,na,1917,2125
STAT,1929,26,50-100,1955,1.1773005145824003
SIM,1873,23,40-44,1896,2
SIM,1937,32,35-39,1969,6
STAT,1822,50,na,1872,1275.5335828156663
STAT,1873,47,50-100,1920,0.2342158728111672
STAT,1877,34,15-19,1911,0.13835544090170615
STAT,1929,23,na,1952,4348.958878928364
STAT,1900,17,25-29,1917,7.426272955873891
SIM,1764,91,na,1855,9
STAT,1844,54,30-34,1898,0.004020499211145871
STAT,1818,45,na,1863,1412.4758134608014
STAT,1816,40,35-39,1856,5.354127417361972
SIM,1846,9,na,1855,2179
STAT,1842,46,20-24,1888,0.00880371111904485
STAT,1875,46,50-100,1921,0.23915829561225743
SIM,1887,11,na,1898,2694
SIM,1899,16,15-19,1915,7
SIM,1837,52,na,1889,1385
SIM,1838,22,35-39,1860,4
STAT,1914,37,20-24,1951,0.24864814312277153
STAT,1882,15,40-44,1897,0.16881656877378828
SIM,1916,25,na,1941,3587
STAT,1824,34,50-100,1858,1.72371365411765
SIM,1912,11,na,1923,3766
STAT,1899,21,45-49,1920,0.9053399901910387
STAT,1945,20,25-29,1965,95.70258473837174
STAT,1803,53,30-34,1856,0.01699948714654934
STAT,1865,18,45-49,1883,0.05729891254338696
SIM,1875,5,na,1880,2657
STAT,1825,49,25-29,1874,0.0571524805681736
STAT,1840,79,na,1919,458.7931740870568
STAT,1857,41,35-39,1898,1.3552713713284212
STAT,1886,32,15-19,1918,0.14211009740165692
STAT,1843,44,na,1887,1566.6861490188294
STAT,1827,81,na,1908,312.36273301682917
STAT,1871,35,35-39,1906,6.697924268735393
STAT,1869,23,25-29,1892,52.22869291025086
SIM,1828,28,35-39,1856,11
STAT,1860,37,25-29,1897,2.2069324939733703
SIM,1925,27,20-24,1952,23
SIM,1920,32,40-44,1952,9
SIM,1942,27,20-24,1969,17
SIM,1847,33,40-44,1880,4
SIM,1808,71,na,1879,613
STAT,1842,86,na,1928,160.67880290596855
SIM,1936,16,40-44,1952,1
SIM,1897,24,40-44,1921,2
STAT,1919,38,35-39,1957,2.452293417790824
STAT,1844,15,20-24,1859,15.83780832191982
SIM,1901,27,35-39,1928,14
SIM,1941,24,na,1965,3496
STAT,1864,50,50-100,1914,0.012898824464139898
SIM,1785,69,na,1854,650
SIM,1793,88,na,1881,37
SIM,1937,19,na,1956,3275
SIM,1826,84,na,1910,153
SIM,1919,16,40-44,1935,1
SIM,1927,38,35-39,1965,3
STAT,1944,0,na,1944,4534.539198008264
STAT,1910,27,35-39,1937,13.696445642323244
SIM,1874,31,35-39,1905,10
STAT,1912,32,40-44,1944,3.6378506026293946
SIM,1900,26,na,1926,3198
STAT,1926,25,20-24,1951,20.811661655414838
STAT,1889,24,40-44,1913,2.4150383908291078
STAT,1882,49,50-100,1931,0.22092537509082658
STAT,1883,42,50-100,1925,0.977295166841013
STAT,1917,27,20-24,1944,18.08468230016473
STAT,1919,41,50-100,1960,0.12044318882218372
SIM,1859,3,na,1862,2541
SIM,1852,15,20-24,1867,15
SIM,1843,17,20-24,1860,13
STAT,1887,19,35-39,1906,0.5767029215971935
STAT,1819,41,15-19,1860,0.030170194805615096
STAT,1858,20,45-49,1878,0.601205386648389
SIM,1902,44,40-44,1946,1
STAT,1855,38,50-100,1893,0.8681393266904527
STAT,1882,38,15-19,1920,0.05133417194282964
STAT,1914,21,35-39,1935,8.747166270894832
SIM,1928,4,na,1932,4804
SIM,1888,29,45-49,1917,1
STAT,1919,30,25-29,1949,9.495957744441906
STAT,1868,19,25-29,1887,5.139062247249854
STAT,1856,48,15-19,1904,2.911263112279055E-4
SIM,1880,32,na,1912,2395
SIM,1884,46,na,1930,2219
STAT,1918,48,45-49,1966,0.21788598453155603
SIM,1916,24,15-19,1940,5
SIM,1879,23,35-39,1902,7
STAT,1943,25,20-24,1968,18.38138283096408
SIM,1876,27,na,1903,2327
STAT,1821,44,35-39,1865,2.9379993555240382
SIM,1888,21,35-39,1909,8
STAT,1934,27,20-24,1961,23.19785601051565
STAT,1903,42,40-44,1945,0.20969047708459598
SIM,1931,24,40-44,1955,6
STAT,1902,40,na,1942,3123.2593302742725
SIM,1886,18,30-34,1904,2
SIM,1945,2,na,1947,3981
STAT,1908,35,50-100,1943,0.37489232986799137
STAT,1923,24,40-44,1947,3.672697352545663
STAT,1855,52,40-44,1907,0.007441402172517521
STAT,1881,45,45-49,1926,0.21752233177177344
STAT,1834,67,na,1901,982.7873681562673
SIM,1893,39,na,1932,2906
SIM,1936,20,25-29,1956,80
STAT,1839,33,40-44,1872,3.516546967885778
SIM,1817,48,na,1865,1361
STAT,1903,31,50-100,1934,1.2366065110706381
STAT,1908,24,15-19,1932,4.594284497824075
STAT,1869,32,15-19,1901,0.13033000067731076
STAT,1828,27,50-100,1855,1.104488927403697
STAT,1906,54,na,1960,2969.79363667615
STAT,1843,31,50-100,1874,0.7517724366598073
SIM,1800,75,na,1875,369
SIM,1825,67,na,1892,853
STAT,1906,35,20-24,1941,0.231098317372711
SIM,1821,53,na,1874,1194
SIM,1927,30,25-29,1957,15
STAT,1885,41,50-100,1926,0.9993023667430467
SIM,1876,19,25-29,1895,7
STAT,1838,45,50-100,1883,0.17403854078635397
STAT,1917,49,40-44,1966,0.15466185628919615
SIM,1836,27,30-34,1863,28
STAT,1895,18,30-34,1913,1.9578644546656976
STAT,1923,35,20-24,1958,0.2890446629953148
STAT,1811,105,na,1916,0.012716160698921616
STAT,1815,47,15-19,1862,9.005369677463482E-4
STAT,1888,46,50-100,1934,0.2749781851906059
SIM,1866,20,45-49,1886,2
STAT,1901,39,na,1940,3108.3874319312295
STAT,1834,51,na,1885,1396.1001858493937
STAT,1914,27,50-100,1941,0.947942185398221
STAT,1801,88,na,1889,45.88765366891252
SIM,1922,21,35-39,1943,17
STAT,1851,47,25-29,1898,0.0412409859571023
STAT,1864,31,25-29,1895,8.659226877383752
STAT,1860,99,na,1959,2.7074295742978283
STAT,1832,25,50-100,1857,0.5401740560208662
SIM,1884,18,20-24,1902,15
STAT,1908,46,35-39,1954,0.11098448449297986
STAT,1895,22,15-19,1917,4.063073701663014
SIM,1873,94,na,1967,56
STAT,1819,62,na,1881,1043.937804931111
STAT,1899,19,50-100,1918,0.06307513657282174
STAT,1903,32,15-19,1935,0.19141759539089057
STAT,1855,47,45-49,1902,0.1669260332454264
STAT,1881,45,na,1926,2073.689031223834
STAT,1938,16,na,1954,3438.5267029813167
STAT,1879,21,50-100,1900,0.40447046070682563
STAT,1885,59,na,1944,1830.0505200672555
SIM,1869,57,na,1926,1831
SIM,1917,42,na,1959,3631
STAT,1828,27,30-34,1855,43.47891256921487
STAT,1835,40,50-100,1875,0.8265757114249519
SIM,1888,34,40-44,1922,5
SIM,1865,43,na,1908,2026
STAT,1868,38,50-100,1906,1.1011274419923873
SIM,1842,31,na,1873,1785
STAT,1928,16,40-44,1944,1.6689956026005837
SIM,1925,36,35-39,1961,11
STAT,1875,20,45-49,1895,0.6811494993274466
STAT,1942,21,na,1963,3618.349126484957
SIM,1905,41,na,1946,3152
STAT,1938,33,50-100,1971,0.7848914585347456
SIM,1846,45,na,1891,1602
STAT,1865,38,15-19,1903,0.0478447591576077
STAT,1928,39,15-19,1967,0.02287742103112881
STAT,1914,34,40-44,1948,3.6895344993464523
STAT,1874,16,45-49,1890,0.06320566431259661
STAT,1938,30,35-39,1968,8.690436720435098
STAT,1915,20,50-100,1935,0.6202787567702299
STAT,1920,32,15-19,1952,0.13297083708038793
STAT,1876,41,45-49,1917,1.4673374442863336
SIM,1884,41,45-49,1925,1
STAT,1908,37,20-24,1945,0.23316498781837483
STAT,1834,47,25-29,1881,0.037909969489867405
STAT,1927,41,15-19,1968,0.0018220463180021803
SIM,1847,20,35-39,1867,5
STAT,1890,35,45-49,1925,2.324275258751302
SIM,1922,34,40-44,1956,4
STAT,1952,15,20-24,1967,153.56330161026273
STAT,1798,67,na,1865,755.7297200577677
STAT,1930,17,35-39,1947,5.124824408023086
SIM,1902,17,25-29,1919,7
STAT,1862,45,35-39,1907,0.11420795998786584
STAT,1809,50,45-49,1859,0.040609987018992356
SIM,1796,69,na,1865,707
SIM,1860,12,na,1872,2315
SIM,1900,10,na,1910,3449
STAT,1915,28,25-29,1943,63.200274890557736
STAT,1890,5,na,1895,3026.747905045885
STAT,1853,33,15-19,1886,0.10983799253910258
SIM,1830,46,na,1876,1474
SIM,1855,22,35-39,1877,3
STAT,1917,54,na,1971,3530.5159008928604
STAT,1891,28,15-19,1919,0.5284124334907389
SIM,1893,16,20-24,1909,26
STAT,1879,63,na,1942,1764.4506421329936
STAT,1913,40,na,1953,3460.3706133217943
SIM,1945,22,na,1967,3620
STAT,1838,65,na,1903,1134.556594410089
SIM,1905,4,na,1909,3549
SIM,1889,42,35-39,1931,4
SIM,1864,26,na,1890,2062
STAT,1837,50,20-24,1887,5.000747180356683E-4
SIM,1934,0,na,1934,5212
SIM,1832,22,40-44,1854,2
STAT,1886,24,15-19,1910,3.2715210475102765
STAT,1931,37,20-24,1968,0.32980259123673855
STAT,1898,30,40-44,1928,5.5887080156688
SIM,1926,19,na,1945,4156
SIM,1907,1,na,1908,3704
STAT,1920,46,35-39,1966,0.13497169717899818
STAT,1892,44,50-100,1936,0.08563411430296068
STAT,1855,41,25-29,1896,0.4583987226367965
STAT,1824,37,15-19,1861,0.08808643335928915
SIM,1920,26,30-34,1946,54
STAT,1947,20,35-39,1967,10.060438891526243
SIM,1894,24,15-19,1918,1
SIM,1786,70,na,1856,610
STAT,1813,73,na,1886,519.7390927962035
STAT,1912,26,30-34,1938,36.6037862223915
STAT,1902,19,25-29,1921,7.514544266762485
STAT,1843,71,na,1914,901.5866684908985
STAT,1903,40,15-19,1943,0.0013020256895280003
SIM,1910,19,25-29,1929,6
STAT,1849,30,45-49,1879,1.5459754762556415
STAT,1842,54,20-24,1896,5.196928292139979E-4
STAT,1868,15,50-100,1883,0.04549229015181191
STAT,1892,21,35-39,1913,6.925679915079457
STAT,1931,21,na,1952,4487.7882328819505
STAT,1847,22,35-39,1869,5.275212012315547
STAT,1897,44,na,1941,2890.5135258012933
STAT,1893,30,na,1923,2881.846612230463
STAT,1782,106,na,1888,0.011300996673381351
STAT,1910,32,30-34,1942,14.351594102954893
STAT,1954,18,35-39,1972,4.898569689510891
STAT,1886,46,35-39,1932,0.14010411024442543
STAT,1825,30,35-39,1855,22.307272101220338
STAT,1914,49,15-19,1963,3.431152004736699E-4
STAT,1921,25,45-49,1946,1.8312766320565441
SIM,1872,77,na,1949,746
SIM,1821,37,na,1858,1507
SIM,1933,33,50-100,1966,1
SIM,1780,81,na,1861,157
STAT,1879,44,50-100,1923,1.0305955059302516
STAT,1869,20,45-49,1889,0.6447372853919852
SIM,1850,38,50-100,1888,2
STAT,1930,36,na,1966,4640.016544031899
SIM,1930,18,15-19,1948,50
SIM,1869,15,15-19,1884,5
SIM,1936,28,35-39,1964,13
STAT,1937,8,na,1945,3665.4909446523807
STAT,1871,99,na,1970,12.136923952659657
STAT,1827,43,15-19,1870,0.01302214865798294
STAT,1848,51,35-39,1899,0.006427637877815903
SIM,1833,30,35-39,1863,6
STAT,1903,34,40-44,1937,3.3184741975003957
STAT,1778,108,na,1886,0.004670876600915349
STAT,1925,35,30-34,1960,2.0700310361597847
SIM,1880,48,na,1928,2248
STAT,1888,23,35-39,1911,6.494879926555705
STAT,1814,90,na,1904,36.23717647186611
SIM,1847,46,na,1893,1688
SIM,1912,27,35-39,1939,12
STAT,1922,18,15-19,1940,49.48789342982733
SIM,1876,16,20-24,1892,23
STAT,1928,20,25-29,1948,109.59687775236566
STAT,1894,34,15-19,1928,0.1714097453783916
STAT,1814,51,40-44,1865,0.03138021866091625
STAT,1901,55,na,1956,2753.967150198564
STAT,1928,28,35-39,1956,17.46476200879833
STAT,1832,47,15-19,1879,2.85824235949693E-4
STAT,1923,27,45-49,1950,1.8737679050336264
SIM,1911,34,40-44,1945,3
STAT,1841,27,50-100,1868,0.5477576214309
STAT,1877,50,50-100,1927,0.015012385575779538
STAT,1856,94,na,1950,14.731294175362544
STAT,1925,33,50-100,1958,0.9269136034362779
SIM,1931,27,45-49,1958,4
STAT,1881,42,40-44,1923,2.050176538350435
STAT,1943,17,20-24,1960,135.81633946723423
STAT,1875,45,20-24,1920,0.01176834371253035
SIM,1879,36,40-44,1915,5
SIM,1933,35,30-34,1968,3
STAT,1853,47,35-39,1900,0.10545750702429067
STAT,1877,53,30-34,1930,0.005739452678002142
STAT,1916,48,35-39,1964,0.12457968683278652
SIM,1896,23,35-39,1919,11
SIM,1896,32,25-29,1928,16
STAT,1885,16,20-24,1901,16.73495825891594
STAT,1945,25,30-34,1970,40.644986173938996
STAT,1904,27,35-39,1931,13.074842234015186
SIM,1918,32,25-29,1950,10
SIM,1887,27,na,1914,2495
STAT,1896,42,25-29,1938,0.055569165734373704
SIM,1904,17,35-39,1921,2
STAT,1856,33,40-44,1889,3.202209136400091
STAT,1908,38,35-39,1946,2.128793143771596
SIM,1916,38,35-39,1954,7
STAT,1888,32,25-29,1920,11.435337327351482
STAT,1943,22,na,1965,3670.3746467335836
STAT,1848,23,40-44,1871,1.8717877826391016
STAT,1868,47,na,1915,2018.4221778508806
SIM,1951,17,20-24,1968,146
STAT,1808,54,20-24,1862,0.002560706622515647
STAT,1870,44,30-34,1914,1.0510861917928869
SIM,1863,7,na,1870,2329
STAT,1924,22,50-100,1946,0.7334676274161859
STAT,1872,36,50-100,1908,1.1689805369269894
SIM,1932,8,na,1940,4957
STAT,1829,51,25-29,1880,0.0028525265193672074
STAT,1830,34,35-39,1864,8.405210570437305
STAT,1852,40,45-49,1892,1.0959920445897784
SIM,1857,29,na,1886,1929
STAT,1941,18,25-29,1959,42.15381096844744
SIM,1853,15,na,1868,2118
STAT,1872,84,na,1956,341.8234694104347
STAT,1842,38,50-100,1880,1.0322184900308617
STAT,1941,15,45-49,1956,0.48633606407431224
SIM,1922,30,25-29,1952,10
STAT,1879,30,30-34,1909,17.404228642317257
SIM,1877,20,20-24,1897,71
STAT,1901,46,25-29,1947,0.043086452779437324
SIM,1892,3,na,1895,3452
STAT,1860,34,20-24,1894,2.054181722723457
SIM,1845,25,30-34,1870,26
SIM,1905,57,na,1962,2816
STAT,1843,28,na,1871,1785.3240654678996
SIM,1836,22,25-29,1858,48
SIM,1888,12,na,1900,2908
STAT,1932,2,na,1934,5116.009583145956
STAT,1845,45,35-39,1890,0.10005570359376141
SIM,1880,36,50-100,1916,1
STAT,1804,54,50-100,1858,0.05126178179051155
STAT,1804,109,na,1913,2.3831519715095665E-4
STAT,1858,53,50-100,1911,0.01100671828353857
STAT,1789,101,na,1890,0.12608321616565796
STAT,1934,28,35-39,1962,19.07070204212267
SIM,1908,22,na,1930,3294
STAT,1876,18,20-24,1894,17.257797523968804
SIM,1841,40,35-39,1881,2
SIM,1943,18,25-29,1961,59
STAT,1816,97,na,1913,2.5034739707052354
SIM,1868,33,50-100,1901,4
STAT,1855,13,na,1868,2008.5791576460379
STAT,1859,27,na,1886,1825.3773920597403
SIM,1839,59,na,1898,1333
STAT,1840,30,25-29,1870,8.35889327209591
STAT,1917,22,15-19,1939,5.344719981111353
STAT,1851,39,25-29,1890,2.050285214382646
STAT,1821,41,30-34,1862,2.0378860580994553
STAT,1869,20,20-24,1889,63.715875124256854
STAT,1937,17,45-49,1954,0.4590957882117616
SIM,1805,79,na,1884,279
SIM,1878,46,50-100,1924,2
SIM,1835,45,na,1880,1508
SIM,1848,41,35-39,1889,1
STAT,1870,77,na,1947,801.0851768405461
SIM,1831,31,na,1862,1693
STAT,1868,16,20-24,1884,16.36518466209641
SIM,1901,26,20-24,1927,14
STAT,1880,44,na,1924,2270.773675967317
SIM,1898,31,45-49,1929,6
STAT,1848,40,50-100,1888,0.8043879469401336
STAT,1833,40,35-39,1873,1.381204174873868
STAT,1877,56,na,1933,1998.7080465109193
STAT,1783,100,na,1883,0.18566104182124382
STAT,1867,62,na,1929,1621.3401840085585
STAT,1889,27,45-49,1916,1.2948964161450918
SIM,1860,28,na,1888,1969
SIM,1838,35,40-44,1873,2
STAT,1860,83,na,1943,304.2943727420101
SIM,1840,20,25-29,1860,43
STAT,1878,51,20-24,1929,7.299728478863724E-4
SIM,1869,29,35-39,1898,8
STAT,1843,106,na,1949,0.008201064341776953
STAT,1850,27,15-19,1877,0.37637072381869857
STAT,1925,43,30-34,1968,0.1459864109404749
STAT,1897,26,40-44,1923,3.7975302062161456
STAT,1862,42,30-34,1904,0.9274650712481164
STAT,1830,31,50-100,1861,0.7989677398293181
STAT,1896,59,na,1955,2424.8319224313755
STAT,1903,45,45-49,1948,0.18072239870274828
STAT,1823,51,na,1874,1316.2241833111716
STAT,1834,44,20-24,1878,0.11581132185913237
STAT,1827,65,na,1892,976.1759596452351
STAT,1812,46,35-39,1858,0.4765767547546681
STAT,1892,45,na,1937,2689.164937631421
STAT,1869,28,30-34,1897,22.96508631100852
SIM,1881,21,25-29,1902,41
STAT,1821,49,40-44,1870,0.26228155081173005
SIM,1776,92,na,1868,7
STAT,1886,76,na,1962,1156.999414713543
SIM,1847,30,na,1877,1917
SIM,1853,23,15-19,1876,2
SIM,1819,35,30-34,1854,7
SIM,1925,22,15-19,1947,6
SIM,1818,49,na,1867,1295
SIM,1914,18,na,1932,3781
STAT,1762,96,na,1858,0.7022415991489568
STAT,1881,29,na,1910,2162.3903581718914
STAT,1943,28,25-29,1971,66.19039361155718
SIM,1942,28,35-39,1970,15
STAT,1878,17,40-44,1895,0.18007182869789254
STAT,1882,62,na,1944,1679.1646780627582
SIM,1857,13,na,1870,2224
SIM,1888,30,25-29,1918,12
STAT,1916,18,15-19,1934,9.072380341940336
SIM,1869,21,25-29,1890,57
STAT,1851,20,35-39,1871,5.085654091991668
SIM,1850,34,na,1884,1845
SIM,1896,8,na,1904,3280
STAT,1889,41,na,1930,2707.691086566692
SIM,1923,28,25-29,1951,81
STAT,1914,30,25-29,1944,8.85996832623492
SIM,1884,62,na,1946,1760
SIM,1887,30,30-34,1917,24
STAT,1936,29,50-100,1965,0.8989695019897367
STAT,1869,49,50-100,1918,0.2200774913230483
STAT,1863,54,40-44,1917,0.008487600141301297
SIM,1931,38,25-29,1969,4
STAT,1919,35,30-34,1954,1.8600322072381936
STAT,1814,40,25-29,1854,2.4281669144714586
STAT,1935,18,25-29,1953,55.81848373881521
SIM,1859,31,na,1890,1929
STAT,1923,38,25-29,1961,1.0766550909660788
SIM,1875,15,15-19,1890,7
STAT,1899,20,30-34,1919,23.19383395075052
STAT,1840,41,40-44,1881,1.5596464885460382
SIM,1878,93,na,1971,94
STAT,1771,113,na,1884,3.4391721855389E-4
SIM,1858,28,20-24,1886,7
SIM,1886,26,30-34,1912,29
STAT,1832,39,15-19,1871,0.04199900256603617
SIM,1863,44,40-44,1907,5
SIM,1806,48,na,1854,1292
STAT,1831,86,na,1917,129.5503094913701
STAT,1769,86,na,1855,50.9859
STAT,1902,24,na,1926,3133.417838567087
STAT,1922,40,25-29,1962,0.07764536367285682
STAT,1936,22,25-29,1958,83.42327099108185
STAT,1878,26,30-34,1904,24.877178993477717
STAT,1839,48,15-19,1887,2.6789047494275614E-4
SIM,1944,22,25-29,1966,91
STAT,1828,82,na,1910,262.7700049353121
STAT,1845,23,15-19,1868,2.8773034813758476
SIM,1817,64,na,1881,932
STAT,1848,59,na,1907,1444.1066320444645
STAT,1867,15,15-19,1882,5.445768351186155
STAT,1861,40,50-100,1901,0.8382026529557493
STAT,1918,45,40-44,1963,0.15924628631410678
STAT,1927,45,30-34,1972,0.10620728516291596
STAT,1910,24,30-34,1934,25.339147785431347
SIM,1800,91,na,1891,13
SIM,1820,68,na,1888,804
STAT,1869,36,30-34,1905,4.90104938499104
STAT,1840,47,na,1887,1488.9074401862233
STAT,1920,43,30-34,1963,0.13317651230754074
SIM,1945,18,35-39,1963,5
SIM,1948,19,15-19,1967,45
SIM,1856,66,na,1922,1255
SIM,1822,48,50-100,1870,2
STAT,1838,81,na,1919,363.0423338032175
SIM,1888,15,25-29,1903,6
STAT,1860,29,25-29,1889,32.30295154483605
SIM,1938,20,35-39,1958,8
STAT,1810,47,15-19,1857,0.001334844369341409
SIM,1926,30,50-100,1956,1
STAT,1881,31,25-29,1912,9.385666955161183
STAT,1890,32,40-44,1922,5.008759313892145
STAT,1926,39,40-44,1965,1.724605852229086
SIM,1919,27,45-49,1946,1
SIM,1936,24,40-44,1960,4
STAT,1859,2,na,1861,2613.8528032310974
STAT,1917,38,25-29,1955,0.9613386259339565
SIM,1842,20,35-39,1862,3
STAT,1910,35,35-39,1945,2.206165132816114
STAT,1866,30,45-49,1896,1.5316428426158082
SIM,1837,84,na,1921,175
SIM,1882,41,35-39,1923,1
SIM,1934,16,30-34,1950,17
STAT,1830,31,30-34,1861,15.224904396068757
STAT,1839,50,na,1889,1469.2462940609219
STAT,1874,32,na,1906,2303.32327089663
SIM,1879,20,30-34,1899,24
STAT,1940,20,25-29,1960,88.95325562445353
SIM,1925,33,30-34,1958,21
STAT,1863,40,20-24,1903,0.13298723396673628
STAT,1771,89,na,1860,25.006174011769286
SIM,1801,60,na,1861,956
SIM,1875,38,25-29,1913,4
STAT,1917,33,30-34,1950,15.520077717164183
STAT,1891,16,45-49,1907,0.07653522942408506
STAT,1902,17,35-39,1919,0.7315562791051228
STAT,1903,62,na,1965,2665.3836603822683
STAT,1878,15,15-19,1893,5.869833467252047
SIM,1832,25,45-49,1857,4
SIM,1807,86,na,1893,69
SIM,1820,54,50-100,1874,1
SIM,1879,32,25-29,1911,12
STAT,1926,17,20-24,1943,157.0247568775152
SIM,1877,36,30-34,1913,7
SIM,1887,43,na,1930,2377
STAT,1823,41,40-44,1864,3.084570465045882
STAT,1921,27,35-39,1948,15.807203033058588
SIM,1843,25,20-24,1868,12
STAT,1916,5,na,1921,4016.796810011251
STAT,1936,31,15-19,1967,0.11798016023329723
SIM,1840,24,40-44,1864,2
STAT,1823,67,na,1890,848.3786979794779
STAT,1867,38,25-29,1905,2.541404431761202
SIM,1911,5,na,1916,3770
STAT,1953,5,na,1958,4493.071706134583
STAT,1822,82,na,1904,237.08806847008174
STAT,1826,96,na,1922,4.689026791762052
STAT,1837,21,15-19,1858,2.823123501627781
SIM,1845,21,15-19,1866,2
STAT,1908,45,20-24,1953,0.009580595163294271
STAT,1783,74,na,1857,367.9740920360741
STAT,1914,37,45-49,1951,0.6430271560170152
STAT,1866,31,35-39,1897,8.859988667727404
STAT,1965,3,na,1968,4638.31706394408
STAT,1835,25,20-24,1860,9.87250890302572
STAT,1787,88,na,1875,44.388121503156455
STAT,1901,30,15-19,1931,0.18982530099473074
SIM,1854,36,50-100,1890,1
STAT,1840,108,na,1948,0.001202082638484352
STAT,1862,27,30-34,1889,20.414869513369048
SIM,1831,41,40-44,1872,4
SIM,1932,18,25-29,1950,69
STAT,1874,28,15-19,1902,0.43638281535362594
STAT,1914,25,na,1939,3591.9291497728373
STAT,1918,39,na,1957,3738.197497446114
SIM,1918,43,40-44,1961,1
SIM,1828,48,na,1876,1445
SIM,1838,31,25-29,1869,9
STAT,1851,63,na,1914,1283.526698086038
SIM,1824,47,50-100,1871,3
STAT,1920,30,25-29,1950,9.640740023104351
STAT,1927,33,15-19,1960,0.14923799259851725
STAT,1855,77,na,1932,614.260119735187
SIM,1847,14,na,1861,2216
STAT,1789,74,na,1863,398.762980128444
STAT,1864,42,40-44,1906,1.891495177601985
SIM,1934,17,20-24,1951,171
STAT,1904,15,40-44,1919,0.24899547882288062
SIM,1838,35,50-100,1873,4
STAT,1843,50,45-49,1893,0.009943226221644034
STAT,1846,51,25-29,1897,0.002639694235767062
SIM,1882,35,50-100,1917,1
SIM,1913,18,15-19,1931,9
SIM,1854,2,na,1856,2720
STAT,1847,58,na,1905,1458.2947038514806
SIM,1832,34,50-100,1866,1
SIM,1883,21,35-39,1904,6
STAT,1929,41,25-29,1970,0.08748577647732629
STAT,1881,0,na,1881,3270.4372711270576
STAT,1819,52,30-34,1871,0.010825852944271746
STAT,1924,18,25-29,1942,48.622072257918234
SIM,1929,22,35-39,1951,14
SIM,1902,28,40-44,1930,7
STAT,1920,40,15-19,1960,0.001606697006767758
STAT,1876,26,20-24,1902,11.48924598138015
STAT,1907,16,20-24,1923,24.66279751532834
STAT,1874,41,35-39,1915,1.7557483982495576
SIM,1884,26,20-24,1910,14
STAT,1870,53,20-24,1923,6.728947702358518E-4
SIM,1820,52,na,1872,1318
STAT,1832,24,40-44,1856,1.8029405781976091
STAT,1807,50,35-39,1857,0.03284448209088678
SIM,1912,20,15-19,1932,5
SIM,1913,25,50-100,1938,5
STAT,1853,44,30-34,1897,0.8583202311881265
STAT,1886,43,30-34,1929,1.1389782824084884
STAT,1928,24,40-44,1952,3.940968874051734
SIM,1863,41,25-29,1904,3
STAT,1922,18,50-100,1940,0.40854058956242734
SIM,1872,42,40-44,1914,4
STAT,1830,39,40-44,1869,3.4606638944222796
STAT,1934,35,20-24,1969,0.34424883430325126
STAT,1873,20,35-39,1893,5.624417334969286
STAT,1922,47,20-24,1969,0.011993506283452731
STAT,1940,27,45-49,1967,1.664256693767208
STAT,1899,26,15-19,1925,0.5892891551733062
SIM,1883,46,50-100,1929,1
STAT,1857,79,na,1936,520.8760520348284
STAT,1937,18,35-39,1955,3.846301553499944
SIM,1872,13,na,1885,2502
SIM,1896,36,40-44,1932,7
STAT,1926,16,30-34,1942,14.151857298804606
SIM,1831,90,na,1921,34
SIM,1888,41,50-100,1929,3
SIM,1848,40,45-49,1888,2
SIM,1881,47,50-100,1928,3
STAT,1869,80,na,1949,566.1327986571844
STAT,1915,17,45-49,1932,0.09877093901422684
STAT,1856,36,45-49,1892,1.4764268777199154
SIM,1925,38,25-29,1963,4
SIM,1927,20,na,1947,4215
STAT,1833,27,15-19,1860,0.366917764912581
STAT,1910,26,20-24,1936,16.709689011467333
STAT,1880,18,50-100,1898,0.04866488301449275
STAT,1774,111,na,1885,9.596934883329274E-4
SIM,1908,30,50-100,1938,3
STAT,1905,18,15-19,1923,8.082364394916466
STAT,1880,76,na,1956,981.8361773117963
SIM,1859,16,20-24,1875,14
STAT,1873,10,na,1883,2544.9497892087065
STAT,1826,37,25-29,1863,3.1418060201351086
SIM,1870,70,na,1940,1228
STAT,1861,15,20-24,1876,16.19601751305587
STAT,1849,65,na,1914,1267.2488154177265
SIM,1866,65,na,1931,1468
SIM,1911,10,na,1921,3738
STAT,1892,49,15-19,1941,2.614061136176053E-4
SIM,1874,84,na,1958,335
STAT,1863,29,50-100,1892,0.5265257838128586
SIM,1920,22,15-19,1942,5
STAT,1772,90,na,1862,24.843346211352756
STAT,1918,47,30-34,1965,0.08961932529423249
STAT,1925,24,15-19,1949,5.981567642359177
SIM,1882,2,na,1884,2846
SIM,1864,21,25-29,1885,40
SIM,1908,27,20-24,1935,19
STAT,1901,43,20-24,1944,0.014477840450066535
STAT,1921,20,15-19,1941,5.713803609800909
SIM,1898,0,na,1898,3426
SIM,1853,42,30-34,1895,3
STAT,1832,71,na,1903,804.0857765138942
STAT,1916,41,15-19,1957,0.0014888396372848287
SIM,1794,89,na,1883,29
SIM,1886,37,50-100,1923,1
SIM,1919,49,na,1968,3795
STAT,1884,9,na,1893,2421.6248181778533
STAT,1877,83,na,1960,536.3315761001795
SIM,1790,75,na,1865,347
STAT,1836,37,30-34,1873,4.2362607350577575
SIM,1935,23,na,1958,4585
SIM,1862,51,na,1913,1840
STAT,1810,49,40-44,1859,0.5528002919268965
SIM,1919,20,25-29,1939,105
SIM,1915,35,na,1950,3470
STAT,1911,28,40-44,1939,4.2791672291984515
SIM,1933,24,15-19,1957,5
STAT,1894,45,30-34,1939,0.06695195378638845
STAT,1905,47,20-24,1952,0.00919993953409022
STAT,1949,20,45-49,1969,1.2412226347974729
STAT,1848,18,45-49,1866,0.05981614449693289
STAT,1867,51,45-49,1918,0.012935239514351958
STAT,1857,95,na,1952,9.905986990339251
STAT,1808,49,25-29,1857,0.21092952278741844
STAT,1841,85,na,1926,188.9915449939515
STAT,1936,30,25-29,1966,8.490336693059902
SIM,1844,37,30-34,1881,4
STAT,1890,48,15-19,1938,2.573241130578715E-4
STAT,1856,14,na,1870,2061.7392049306864
STAT,1900,26,15-19,1926,0.5966196453249613
STAT,1871,25,30-34,1896,23.782705008971217
STAT,1886,60,na,1946,1903.1944118382714
STAT,1893,41,45-49,1934,1.8011292989860472
STAT,1828,38,35-39,1866,6.313928313855744
STAT,1902,22,30-34,1924,23.747895824067907
STAT,1785,104,na,1889,0.03458360074051027
SIM,1777,93,na,1870,2
SIM,1903,34,30-34,1937,18
STAT,1937,29,15-19,1966,0.6494572092929323
SIM,1899,24,15-19,1923,4
STAT,1888,39,45-49,1927,2.203224753624659
STAT,1853,41,15-19,1894,0.010498514901417464
STAT,1929,40,35-39,1969,0.24702903044359656
SIM,1833,31,50-100,1864,4
STAT,1869,64,na,1933,1590.9272793481543
SIM,1953,16,40-44,1969,1
STAT,1914,45,20-24,1959,0.010402887540776807
STAT,1873,21,25-29,1894,55.01343935521173
SIM,1896,46,50-100,1942,3
STAT,1955,17,50-100,1972,0.46980020587578436
STAT,1945,16,40-44,1961,1.443822808367296
STAT,1836,52,30-34,1888,0.0039002486663259066
STAT,1920,37,45-49,1957,0.7051166110400963
STAT,1820,86,na,1906,116.88607829093202
STAT,1827,54,30-34,1881,0.004597627557615302
STAT,1900,16,50-100,1916,0.0643617623151558
SIM,1910,22,30-34,1932,31
STAT,1888,24,na,1912,2623.924593891162
SIM,1836,30,na,1866,1766
SIM,1949,7,na,1956,4247
SIM,1910,17,35-39,1927,1
SIM,1846,45,50-100,1891,4
STAT,1896,75,na,1971,1709.8250112481
STAT,1901,37,35-39,1938,2.0187240258181838
SIM,1854,59,na,1913,1557
STAT,1847,38,45-49,1885,1.5094470276296803
STAT,1892,61,na,1953,2211.06362549789
SIM,1869,25,40-44,1894,3
SIM,1938,33,40-44,1971,2
STAT,1826,50,45-49,1876,0.01344801825851053
STAT,1852,48,na,1900,1610.6087717897674
STAT,1878,22,15-19,1900,3.2479571157842795
STAT,1897,22,25-29,1919,72.32309711522409
STAT,1775,110,na,1885,0.001809296941855992
STAT,1931,30,50-100,1961,1.0245942416358973
SIM,1870,27,30-34,1897,29
STAT,1892,48,25-29,1940,0.03796215304526596
SIM,1886,22,15-19,1908,2
SIM,1908,26,30-34,1934,44
STAT,1912,44,35-39,1956,0.18205710540143646
SIM,1875,58,na,1933,1870
SIM,1919,28,35-39,1947,20
STAT,1920,18,40-44,1938,1.4785883932061339
STAT,1852,25,20-24,1877,10.050089119888561
STAT,1853,100,na,1953,0.8034488554983433
SIM,1823,32,50-100,1855,6
STAT,1894,42,15-19,1936,0.0011628192891651025
SIM,1816,90,na,1906,30
SIM,1927,26,40-44,1953,7
STAT,1925,37,20-24,1962,0.2988832977299426
SIM,1954,15,na,1969,4209
SIM,1855,31,25-29,1886,13
SIM,1917,17,20-24,1934,35
STAT,1804,53,na,1857,1138.0387521741836
SIM,1966,5,na,1971,4457
SIM,1834,37,25-29,1871,1
STAT,1871,83,na,1954,372.4025034204226
STAT,1856,21,25-29,1877,49.359329504805906
SIM,1862,99,na,1961,5
STAT,1921,22,40-44,1943,3.5876837838280413
STAT,1777,89,na,1866,31.267880971667594
STAT,1912,22,15-19,1934,4.819545586098722
SIM,1890,49,50-100,1939,1
STAT,1875,97,na,1972,34.50403245742342
STAT,1852,32,na,1884,1791.2526598326733
SIM,1874,30,50-100,1904,4
STAT,1919,26,40-44,1945,4.774014047231111
SIM,1835,29,na,1864,1705
STAT,1847,30,35-39,1877,8.952110952472244
STAT,1847,31,25-29,1878,8.960714023462304
STAT,1837,17,30-34,1854,1.9540819289067657
SIM,1855,38,45-49,1893,1
SIM,1849,80,na,1929,430
STAT,1817,37,20-24,1854,2.7526994735995585
SIM,1865,4,na,1869,2535
SIM,1910,27,25-29,1937,56
STAT,1936,26,40-44,1962,4.215779599100771
SIM,1858,23,15-19,1881,3
STAT,1845,42,30-34,1887,0.8284412266367739
SIM,1849,10,na,1859,2259
SIM,1938,28,45-49,1966,2
STAT,1851,48,15-19,1899,2.841215170013771E-4
STAT,1791,88,na,1879,44.33611441375334
SIM,1850,66,na,1916,1208
STAT,1893,28,25-29,1921,50.49988457815939
SIM,1845,17,30-34,1862,1
STAT,1889,19,45-49,1908,0.07577413693565324
STAT,1925,46,35-39,1971,0.1479542699256502
STAT,1888,56,na,1944,2277.1457578923073
SIM,1855,30,35-39,1885,8
STAT,1853,70,na,1923,1061.8411266068626
STAT,1902,27,25-29,1929,56.39758410461102
SIM,1881,25,40-44,1906,2
SIM,1890,6,na,1896,3259
STAT,1884,51,45-49,1935,0.013609543082791695
SIM,1944,26,40-44,1970,5
STAT,1871,16,50-100,1887,0.04652879211713374
SIM,1906,58,na,1964,2863
STAT,1873,48,15-19,1921,3.784299732774901E-4
STAT,1805,53,40-44,1858,0.03787680936304769
SIM,1897,20,25-29,1917,77
SIM,1859,95,na,1954,9
STAT,1842,70,na,1912,1016.0814910809229
STAT,1854,28,na,1882,1777.1868549710396
SIM,1936,27,45-49,1963,1
SIM,1855,81,na,1936,380
STAT,1851,8,na,1859,2147.683275851416
SIM,1924,30,35-39,1954,9
STAT,1869,27,40-44,1896,2.7415084776430634
STAT,1877,30,20-24,1907,2.670112524653627
STAT,1779,85,na,1864,69.59598925557913
SIM,1901,35,35-39,1936,5
STAT,1934,38,25-29,1972,1.282283700279708
SIM,1862,21,15-19,1883,2
STAT,1829,38,50-100,1867,1.0932143507558045
STAT,1823,44,45-49,1867,1.8905670566597774
SIM,1924,16,25-29,1940,59
STAT,1934,33,30-34,1967,20.308776612767502
SIM,1907,33,50-100,1940,4
STAT,1939,29,25-29,1968,62.448230024673904
SIM,1878,40,30-34,1918,1
STAT,1922,31,35-39,1953,9.79405702798407
SIM,1831,44,45-49,1875,1
STAT,1880,15,30-34,1895,1.5947653909226924
STAT,1927,40,25-29,1967,0.08483798264542765
STAT,1858,80,na,1938,458.1828120496144
SIM,1940,25,45-49,1965,1
SIM,1951,16,30-34,1967,12
STAT,1848,38,15-19,1886,0.04255537890675005
SIM,1919,24,40-44,1943,3
STAT,1892,20,45-49,1912,0.8300290213477679
STAT,1909,35,na,1944,3396.191750781053
STAT,1875,21,35-39,1896,5.683443934283842
STAT,1853,48,25-29,1901,0.043043728469263125
STAT,1921,24,30-34,1945,30.475340530093618
SIM,1837,38,50-100,1875,3
STAT,1868,79,na,1947,630.1330054112248
STAT,1848,43,na,1891,1704.9792444386608
SIM,1946,23,na,1969,3711
STAT,1828,31,15-19,1859,0.1533736947173881
STAT,1766,89,na,1855,29.1348
STAT,1887,82,na,1969,861.4634602632173
SIM,1896,31,35-39,1927,16
STAT,1873,25,40-44,1898,2.889564776151787
STAT,1865,26,45-49,1891,0.9539776163062353
STAT,1917,26,30-34,1943,38.95251156843086
STAT,1916,30,35-39,1946,8.98455483157437
STAT,1818,77,na,1895,424.5018720198003
SIM,1820,90,na,1910,37
STAT,1932,27,50-100,1959,1.2315876027533657
STAT,1865,51,35-39,1916,0.007406916748999829
STAT,1872,44,40-44,1916,2.102593236748269
SIM,1911,30,25-29,1941,11
SIM,1864,58,na,1922,1774
SIM,1930,31,35-39,1961,15
STAT,1880,40,20-24,1920,0.1597634014323006
STAT,1780,102,na,1882,0.06954861190030215
STAT,1923,20,25-29,1943,102.13634657676316
SIM,1948,20,40-44,1968,2
STAT,1898,45,na,1943,2905.4555447050207
SIM,1901,11,na,1912,3413
STAT,1894,31,na,1925,2908.9390359860404
STAT,1805,50,25-29,1855,0.013533127195958367
STAT,1922,17,na,1939,4024.199652291316
SIM,1873,62,na,1935,1759
SIM,1869,44,50-100,1913,1
SIM,1873,26,45-49,1899,1
STAT,1930,33,50-100,1963,1.0073510569497026
STAT,1858,58,na,1916,1464.7698168071395
STAT,1915,37,15-19,1952,0.018326763307927568
STAT,1908,43,30-34,1951,0.11107239905502034
STAT,1824,50,35-39,1874,0.010513177890510527
SIM,1835,39,50-100,1874,1
STAT,1831,43,40-44,1874,1.6386708123248435
SIM,1859,19,25-29,1878,8
STAT,1827,39,50-100,1866,1.2158362242224379
STAT,1921,38,15-19,1959,0.020235693851713893
STAT,1888,31,35-39,1919,11.352549655872053
STAT,1845,51,na,1896,1530.9336119533043
SIM,1807,49,na,1856,1243
SIM,1878,16,30-34,1894,1
STAT,1915,22,40-44,1937,3.2834744198417245
STAT,1941,20,na,1961,3567.5846762937063
SIM,1787,92,na,1879,7
SIM,1868,13,na,1881,2394
SIM,1898,30,30-34,1928,28
STAT,1802,89,na,1891,36.831204134900524
SIM,1883,61,na,1944,1663
STAT,1812,43,30-34,1855,4.236888837669316
SIM,1869,28,45-49,1897,2
SIM,1820,43,30-34,1863,4
SIM,1860,27,25-29,1887,40
STAT,1939,27,20-24,1966,17.335923360707596
STAT,1852,27,25-29,1879,35.720222944312724
STAT,1893,46,na,1939,2703.5266947645505
STAT,1838,52,40-44,1890,0.007030288679984132
STAT,1882,46,na,1928,2072.831777740768
STAT,1943,16,30-34,1959,12.21387932043245
STAT,1932,38,na,1970,4770.466898953431
STAT,1938,22,35-39,1960,8.803696224258363
SIM,1829,40,35-39,1869,4
SIM,1843,96,na,1939,6
STAT,1850,102,na,1952,0.2066659055116164
STAT,1902,20,50-100,1922,0.5469228911611206
SIM,1946,22,35-39,1968,9
STAT,1903,30,25-29,1933,13.878285746939442
STAT,1908,48,25-29,1956,0.04519464291951045
STAT,1851,101,na,1952,0.4104740634568108
STAT,1864,45,45-49,1909,0.20068634767330493
STAT,1879,42,na,1921,2282.709193986583
STAT,1916,16,25-29,1932,8.7070386496064
STAT,1949,6,na,1955,4319.369274739507
SIM,1910,47,50-100,1957,1
STAT,1830,85,na,1915,165.4526880125619
STAT,1870,42,50-100,1912,0.9778733030716229
SIM,1895,46,na,1941,2867
STAT,1917,35,20-24,1952,0.2611191838305925
SIM,1885,30,20-24,1915,1
SIM,1891,32,na,1923,2772
STAT,1876,39,na,1915,2276.30213163267
STAT,1839,36,45-49,1875,1.6026475669122626
STAT,1854,21,15-19,1875,2.793446671716619
STAT,1797,66,na,1863,776.7748137775441
STAT,1866,13,na,1879,2335.5058379450493
STAT,1940,24,40-44,1964,3.233571272829831
STAT,1873,27,45-49,1900,1.0637974885766954
STAT,1916,53,na,1969,3484.0167260451553
SIM,1930,24,na,1954,4378
SIM,1816,63,na,1879,944
SIM,1862,25,30-34,1887,28
STAT,1891,41,35-39,1932,2.1260215825976068
STAT,1854,25,30-34,1879,21.05731406361274
STAT,1877,38,30-34,1915,5.196733658341559
SIM,1840,27,45-49,1867,2
SIM,1841,30,na,1871,1760
STAT,1832,27,45-49,1859,0.9095738667060648
SIM,1885,38,30-34,1923,6
STAT,1918,43,15-19,1961,0.0015400451504989326
STAT,1839,66,na,1905,1091.2500711526734
SIM,1845,44,na,1889,1591
SIM,1923,22,40-44,1945,10
STAT,1927,43,40-44,1970,0.29587021595659113
STAT,1873,7,na,1880,2605.994364799259
STAT,1876,17,30-34,1893,1.5556242267459095
STAT,1928,27,45-49,1955,2.0106369466616263
STAT,1849,31,35-39,1880,8.885348096248565
STAT,1906,35,45-49,1941,0.5976416791784305
SIM,1924,17,na,1941,4132
SIM,1874,30,45-49,1904,1
SIM,1857,31,35-39,1888,11
STAT,1812,47,25-29,1859,0.19284943006766891
STAT,1924,24,na,1948,4045.175178783846
STAT,1928,38,na,1966,4487.028820809296
SIM,1877,38,35-39,1915,15
SIM,1896,31,na,1927,3000
SIM,1847,36,45-49,1883,1
STAT,1851,47,na,1898,1610.8620241468561
SIM,1903,37,35-39,1940,4
STAT,1902,24,20-24,1926,91.30114160666145
STAT,1904,20,15-19,1924,4.497036357033452
STAT,1844,29,na,1873,1812.9266288638655
STAT,1884,15,15-19,1899,5.564573433598272
SIM,1905,30,25-29,1935,8
STAT,1812,110,na,1922,1.2003780163914759E-4
STAT,1944,23,na,1967,3723.573685834415
STAT,1912,35,45-49,1947,0.6345610608617248
SIM,1881,20,35-39,1901,5
SIM,1867,18,20-24,1885,18
SIM,1785,85,na,1870,71
SIM,1922,7,na,1929,4340
STAT,1941,27,15-19,1968,0.6898964479282791
SIM,1892,27,20-24,1919,22
SIM,1907,21,na,1928,3305
STAT,1850,40,35-39,1890,1.2893651725994881
STAT,1871,28,35-39,1899,9.01953159240366
SIM,1877,28,na,1905,2320
SIM,1842,39,25-29,1881,6
SIM,1858,27,30-34,1885,32
STAT,1888,36,40-44,1924,4.910777830401491
STAT,1920,10,na,1930,4212.250803578806
STAT,1865,28,na,1893,2036.3060204869098
STAT,1869,38,35-39,1907,6.440956713991116
SIM,1847,51,na,1898,1616
STAT,1870,47,35-39,1917,0.1291416949367447
SIM,1910,24,20-24,1934,95
SIM,1938,5,na,1943,3576
STAT,1889,39,15-19,1928,0.06483139771027581
STAT,1828,35,30-34,1863,5.091545284007538
SIM,1932,16,20-24,1948,140
SIM,1880,41,25-29,1921,4
STAT,1863,32,na,1895,1978.2931264227
SIM,1826,52,na,1878,1262
STAT,1897,20,20-24,1917,87.58229705297695
SIM,1939,27,25-29,1966,76
STAT,1889,40,40-44,1929,2.6496982142282035
SIM,1925,28,35-39,1953,18
STAT,1924,16,20-24,1940,152.8897940719124
STAT,1834,39,25-29,1873,2.1768903731684084
SIM,1861,44,30-34,1905,3
STAT,1859,43,na,1902,1725.2457951846866
STAT,1882,83,na,1965,613.1573221964188
SIM,1926,18,25-29,1944,69
STAT,1901,34,30-34,1935,22.89004702037593
STAT,1918,18,25-29,1936,44.44287892013803
SIM,1868,30,45-49,1898,1
STAT,1936,35,30-34,1971,1.6931824562040134
STAT,1861,84,na,1945,261.3026605314995
STAT,1865,98,na,1963,8.556504229391258
STAT,1872,41,25-29,1913,0.6112466889865472
SIM,1844,81,na,1925,311
STAT,1846,54,40-44,1900,0.007593671925604144
SIM,1848,95,na,1943,8
STAT,1896,30,30-34,1926,21.95933997070382
STAT,1840,53,35-39,1893,0.00555904803834456
STAT,1859,18,20-24,1877,15.382100617071888
STAT,1917,28,35-39,1945,14.822000177466998
STAT,1841,29,15-19,1870,0.38293890467217956
STAT,1943,18,35-39,1961,4.202255560794639
SIM,1927,22,25-29,1949,123
SIM,1911,36,30-34,1947,2
SIM,1908,22,15-19,1930,2
STAT,1870,98,na,1968,15.979366351190722
STAT,1936,29,45-49,1965,1.5603259669215594
SIM,1879,30,20-24,1909,3
SIM,1916,6,na,1922,3926
STAT,1927,7,na,1934,4695.225914276187
SIM,1836,35,30-34,1871,5
STAT,1916,31,50-100,1947,0.8096904604967906
SIM,1810,53,na,1863,1147
SIM,1840,26,45-49,1866,5
STAT,1858,25,15-19,1883,0.3490056488921531
SIM,1814,67,na,1881,761
STAT,1810,46,25-29,1856,0.1954104548104177
STAT,1862,47,na,1909,1808.7660356783929
STAT,1850,15,45-49,1865,0.05693789439380751
STAT,1853,44,50-100,1897,0.7887266971988478
STAT,1873,28,45-49,1901,1.0600529214169063
SIM,1831,52,na,1883,1336
SIM,1950,20,35-39,1970,15
SIM,1889,41,45-49,1930,1
STAT,1895,26,30-34,1921,31.12042682113913
STAT,1849,48,20-24,1897,0.008885350958991805
SIM,1881,28,45-49,1909,4
STAT,1799,73,na,1872,486.7919162629963
SIM,1890,10,na,1900,3236
SIM,1931,20,25-29,1951,112
SIM,1874,9,na,1883,2497
SIM,1855,35,40-44,1890,4
STAT,1812,67,na,1879,810.2225796206716
STAT,1932,25,45-49,1957,2.1395064735504388
SIM,1898,32,35-39,1930,15
SIM,1857,51,na,1908,1696
SIM,1870,23,15-19,1893,2
SIM,1951,18,35-39,1969,10
STAT,1850,52,40-44,1902,0.007381679529088164
STAT,1931,41,40-44,1972,0.3161168157245537
STAT,1919,22,25-29,1941,95.5520056497452
STAT,1862,23,15-19,1885,2.7082204960811054
STAT,1815,39,15-19,1854,0.1721621171074949
SIM,1944,16,na,1960,3633
STAT,1867,94,na,1961,37.82486070813134
SIM,1880,44,40-44,1924,6
STAT,1907,0,na,1907,4074.835422498005
SIM,1894,24,na,1918,2951
STAT,1832,26,45-49,1858,0.922439784774119
STAT,1927,16,na,1943,4334.007380265253
STAT,1954,17,45-49,1971,0.583349622107949
SIM,1888,37,45-49,1925,2
STAT,1914,48,25-29,1962,0.04956177591248089
SIM,1876,43,na,1919,2220
STAT,1903,36,30-34,1939,1.5536776334904772
STAT,1897,60,na,1957,2452.601968930106
SIM,1797,70,na,1867,600
STAT,1896,38,na,1934,2924.9384003788223
STAT,1889,20,25-29,1909,67.16131889030827
SIM,1906,28,25-29,1934,63
STAT,1879,53,40-44,1932,0.010243358485126022
STAT,1912,41,30-34,1953,0.11715918313697317
SIM,1907,18,15-19,1925,6
STAT,1833,66,na,1899,1005.5755189246486
STAT,1881,54,35-39,1935,0.0076406297667077835
STAT,1923,39,15-19,1962,0.020975076351373256
SIM,1878,17,30-34,1895,2
STAT,1892,2,na,1894,3154.14295719395
STAT,1892,24,na,1916,2780.925754710053
STAT,1831,40,25-29,1871,0.4870340236307131
STAT,1846,95,na,1941,9.861351409285756
STAT,1765,93,na,1858,4.45613349949035
STAT,1878,18,30-34,1896,1.5650860048809379
STAT,1834,20,35-39,1854,7.937985814013389
STAT,1847,35,40-44,1882,3.419477493441204
STAT,1786,103,na,1889,0.05001120368857596
STAT,1871,32,30-34,1903,16.378477252443233
STAT,1829,29,na,1858,1709.308657797706
STAT,1912,39,na,1951,3434.092734079271
STAT,1918,30,50-100,1948,0.8366721484923045
STAT,1911,36,50-100,1947,0.3849550657268699
STAT,1852,28,25-29,1880,35.46375174357257
STAT,1942,20,35-39,1962,9.33303163408578
STAT,1851,44,20-24,1895,0.11269899685028378
STAT,1933,24,50-100,1957,0.8239655928540743
SIM,1860,28,25-29,1888,44
SIM,1920,35,45-49,1955,1
STAT,1862,43,20-24,1905,0.12734959048975417
SIM,1866,21,35-39,1887,7
SIM,1839,27,20-24,1866,17
STAT,1864,51,30-34,1915,0.005035858642739851
STAT,1899,62,na,1961,2496.2264709525116
STAT,1782,73,na,1855,406.57779000000005
SIM,1949,16,15-19,1965,48
STAT,1898,18,20-24,1916,22.605121157450817
SIM,1910,26,25-29,1936,64
STAT,1854,50,na,1904,1562.6977201509633
SIM,1818,70,na,1888,673
STAT,1890,47,15-19,1937,2.593836189926733E-4
SIM,1907,16,25-29,1923,6
SIM,1859,40,45-49,1899,3
STAT,1925,28,30-34,1953,43.56458539026827
SIM,1799,98,na,1897,2
STAT,1845,34,30-34,1879,14.388217505443048
SIM,1838,96,na,1934,4
STAT,1837,80,na,1917,401.45904944003325
SIM,1922,10,na,1932,4317
SIM,1871,25,35-39,1896,10
STAT,1945,27,45-49,1972,1.7905321861864911
SIM,1811,48,na,1859,1219
STAT,1841,48,na,1889,1538.2640619272859
STAT,1847,42,40-44,1889,1.667882852273736
SIM,1933,28,30-34,1961,57
STAT,1897,21,50-100,1918,0.5167506371839854
SIM,1836,83,na,1919,235
STAT,1839,18,40-44,1857,0.15836311101964892
STAT,1922,42,50-100,1964,0.12738555309655988
SIM,1783,89,na,1872,24
STAT,1852,85,na,1937,198.7436949286843
STAT,1927,36,40-44,1963,1.7598386362660536
SIM,1853,34,30-34,1887,21
STAT,1894,30,20-24,1924,3.3080253656789047
SIM,1948,23,45-49,1971,1
STAT,1902,26,25-29,1928,56.59112575469206
STAT,1842,65,na,1907,1223.840924272106
STAT,1882,51,35-39,1933,0.007947117817164787
SIM,1910,15,30-34,1925,3
STAT,1906,4,na,1910,3619.5732827959328
STAT,1887,77,na,1964,1188.798656286882
STAT,1853,40,50-100,1893,0.8075861308514208
STAT,1851,51,20-24,1902,5.333568732227012E-4
SIM,1945,17,na,1962,3648
SIM,1852,20,na,1872,1989
STAT,1867,41,50-100,1908,0.9413956911548376
SIM,1935,36,40-44,1971,4
SIM,1901,4,na,1905,3454
SIM,1886,42,na,1928,2251
SIM,1846,40,35-39,1886,2
STAT,1910,34,20-24,1944,2.2028460794861497
STAT,1871,30,na,1901,2256.5259365504617
SIM,1928,15,30-34,1943,20
STAT,1879,45,40-44,1924,0.17098289026370198
STAT,1828,44,na,1872,1452.9293045012496
STAT,1852,24,20-24,1876,58.50164957450212
STAT,1912,48,15-19,1960,3.335233991058338E-4
SIM,1901,37,25-29,1938,2
STAT,1858,21,35-39,1879,4.995015836406352
STAT,1902,61,na,1963,2658.6079048777856
STAT,1894,41,15-19,1935,0.016841677581543254
SIM,1827,31,na,1858,1630
SIM,1926,29,40-44,1955,6
SIM,1865,17,20-24,1882,11
STAT,1902,15,30-34,1917,2.1348698943268665
STAT,1904,23,40-44,1927,2.814953334690658
STAT,1819,44,30-34,1863,2.2554329236368513
STAT,1882,45,50-100,1927,0.2278859919388055
STAT,1841,50,35-39,1891,0.006020479207753626
STAT,1843,46,15-19,1889,2.7238634448480006E-4
STAT,1883,30,45-49,1913,1.6281342420024731
SIM,1942,26,30-34,1968,39
SIM,1906,26,20-24,1932,13
STAT,1769,91,na,1860,13.389593381588885
STAT,1920,39,35-39,1959,2.49643864398661
SIM,1948,0,na,1948,4438
STAT,1867,18,50-100,1885,0.04416708479179996
STAT,1929,19,15-19,1948,54.41989109240747
STAT,1812,104,na,1916,0.0289736618696626
STAT,1853,40,15-19,1893,0.010556682220452153
STAT,1919,37,45-49,1956,0.691872070249427
STAT,1936,34,40-44,1970,3.5861151992248335
STAT,1849,28,na,1877,1909.1205226570848
STAT,1921,18,45-49,1939,0.5365080367101858
SIM,1845,50,na,1895,1538
STAT,1803,52,50-100,1855,0.04400724495992398
STAT,1899,22,35-39,1921,7.553461076066856
STAT,1895,74,na,1969,1741.0724270247
STAT,1896,33,50-100,1929,1.1383619904507125
STAT,1837,19,45-49,1856,0.05900603926739834
STAT,1837,96,na,1933,5.57260271831277
SIM,1824,98,na,1922,1
SIM,1868,47,50-100,1915,4
STAT,1918,29,40-44,1947,4.652600741417017
STAT,1900,18,15-19,1918,7.756878904015163
STAT,1897,36,45-49,1933,2.530657831786589
SIM,1824,88,na,1912,52
SIM,1874,57,na,1931,1849
STAT,1829,83,na,1912,239.87365806740405
STAT,1864,46,35-39,1910,0.11821072172506099
STAT,1910,21,15-19,1931,4.736901955364693
STAT,1932,16,na,1948,4615.5861531518885
STAT,1776,109,na,1885,0.002999658525122328
SIM,1869,36,35-39,1905,11
STAT,1934,26,30-34,1960,49.81728711696405
STAT,1887,55,na,1942,2184.920460044073
SIM,1907,38,30-34,1945,4
STAT,1847,54,35-39,1901,0.006173806255549298
STAT,1887,45,na,1932,2401.072794612625
SIM,1909,15,20-24,1924,27
SIM,1766,93,na,1859,1
STAT,1902,34,50-100,1936,0.6954187153556439
STAT,1828,66,na,1894,923.0581261420906
STAT,1895,22,50-100,1917,0.5022341371343347
STAT,1908,40,na,1948,3282.934451814441
SIM,1855,42,40-44,1897,7
STAT,1849,38,na,1887,1789.0982669465488
SIM,1837,31,na,1868,1758
SIM,1840,35,na,1875,1692
STAT,1779,91,na,1870,14.791460271771962
SIM,1887,41,35-39,1928,3
SIM,1795,74,na,1869,422
STAT,1823,33,40-44,1856,9.859135567121385
STAT,1863,25,35-39,1888,8.115245090234062
STAT,1903,25,na,1928,3229.6136963398744
STAT,1879,41,35-39,1920,1.7987675444461975
STAT,1853,33,na,1886,1840.5441809640347
SIM,1869,19,30-34,1888,2
SIM,1870,33,na,1903,2174
STAT,1782,95,na,1877,2.170139411704733
STAT,1907,44,15-19,1951,0.0013128437108908182
STAT,1881,43,30-34,1924,1.041615554377081
STAT,1864,34,40-44,1898,3.6201311528867453
SIM,1920,37,35-39,1957,6
STAT,1862,85,na,1947,221.4234602020139
STAT,1890,24,40-44,1914,2.391661441284404
STAT,1913,16,45-49,1929,0.09672712331595634
SIM,1828,36,50-100,1864,1
SIM,1926,16,35-39,1942,4
STAT,1895,33,30-34,1928,21.412621032524452
SIM,1911,31,25-29,1942,12
SIM,1920,25,na,1945,3960
SIM,1839,42,50-100,1881,4
SIM,1886,64,na,1950,1627
SIM,1927,15,25-29,1942,61
STAT,1924,27,15-19,1951,0.7764881238523285
STAT,1810,53,25-29,1863,0.011073917377830119
STAT,1812,44,20-24,1856,0.5589885266366602
SIM,1853,85,na,1938,169
STAT,1803,90,na,1893,26.501688541538716
STAT,1908,36,30-34,1944,1.6198401559494342
SIM,1827,53,na,1880,1245
SIM,1877,35,30-34,1912,4
SIM,1903,55,na,1958,2841
STAT,1886,20,45-49,1906,0.7000163663120772
SIM,1873,19,20-24,1892,22
STAT,1910,25,50-100,1935,0.9219499588505634
STAT,1865,19,20-24,1884,15.459333025122914
STAT,1910,17,30-34,1927,2.2816680671831193
SIM,1847,21,25-29,1868,55
SIM,1840,45,na,1885,1538
STAT,1782,89,na,1871,31.187632541450967
STAT,1913,40,50-100,1953,0.10945928511096824
STAT,1881,46,35-39,1927,0.1281276585486432
SIM,1886,33,30-34,1919,23
STAT,1847,80,na,1927,456.15738428047206
STAT,1930,16,45-49,1946,0.611596442058654
STAT,1878,33,30-34,1911,17.11691196290984
STAT,1830,35,25-29,1865,2.4046940526376543
SIM,1864,35,50-100,1899,1
STAT,1870,51,30-34,1921,0.0055429872190139624
STAT,1879,26,na,1905,2368.067652540089
STAT,1866,5,na,1871,2471.279335603763
SIM,1932,10,na,1942,4942
SIM,1827,44,30-34,1871,3
STAT,1866,54,45-49,1920,0.012297247250804085
STAT,1857,17,20-24,1874,15.52493620869958
STAT,1939,18,45-49,1957,0.4722259083440106
STAT,1841,24,45-49,1865,0.6002902451829804
SIM,1874,79,na,1953,601
SIM,1881,33,50-100,1914,3
STAT,1849,47,20-24,1896,0.008956465293421569
SIM,1861,50,na,1911,1892
STAT,1919,34,na,1953,3821.7263304098506
SIM,1849,29,30-34,1878,27
STAT,1838,44,na,1882,1609.5277675636603
SIM,1866,38,20-24,1904,3
STAT,1825,31,50-100,1856,1.7836390050547175
STAT,1886,35,30-34,1921,5.368950924477352
SIM,1860,33,na,1893,1977
STAT,1878,19,30-34,1897,1.5607820183675152
STAT,1933,38,50-100,1971,0.5396973046455282
STAT,1860,44,25-29,1904,0.48557553925708535
SIM,1865,40,45-49,1905,1
SIM,1866,29,30-34,1895,29
SIM,1894,35,30-34,1929,4
STAT,1864,30,35-39,1894,8.59524267779953
SIM,1809,99,na,1908,2
STAT,1881,30,25-29,1911,9.422603561120775
STAT,1811,43,50-100,1854,3.8505050270161356
STAT,1878,37,50-100,1915,1.2087380421633505
STAT,1848,19,20-24,1867,16.138486002797332
SIM,1856,19,20-24,1875,11
SIM,1893,12,na,1905,3230
SIM,1831,68,na,1899,914
SIM,1840,19,na,1859,1974
STAT,1891,15,45-49,1906,0.07670244074490891
STAT,1921,31,50-100,1952,0.8727566196258313
SIM,1937,19,15-19,1956,35
STAT,1850,31,45-49,1881,1.2993525664426826
SIM,1836,42,30-34,1878,1
STAT,1853,11,na,1864,2183.1964802628668
STAT,1919,15,25-29,1934,9.118716677576849
STAT,1918,16,35-39,1934,0.8677822795514545
STAT,1828,42,30-34,1870,0.9747073563452653
STAT,1903,44,30-34,1947,0.10586233131877745
SIM,1915,15,20-24,1930,25
STAT,1801,101,na,1902,0.2017179283519544
SIM,1934,15,30-34,1949,18
STAT,1869,24,15-19,1893,3.0003310681910738
STAT,1871,36,25-29,1907,2.7138946730296234
STAT,1867,57,na,1924,1782.6995581745293
SIM,1862,32,30-34,1894,21
SIM,1925,26,30-34,1951,57
STAT,1890,41,30-34,1931,1.3338356146805999
STAT,1917,37,25-29,1954,0.9661306338779911
STAT,1840,45,35-39,1885,0.09505436661192533
STAT,1839,29,20-24,1868,9.69903570288033
SIM,1833,65,na,1898,1004
SIM,1903,28,45-49,1931,2
STAT,1871,27,35-39,1898,9.051392493982476
SIM,1806,85,na,1891,83
STAT,1823,45,35-39,1868,0.17745382230630508
SIM,1845,32,30-34,1877,22
STAT,1871,62,na,1933,1714.5439530484382
STAT,1808,46,na,1854,1320.2486113044874
STAT,1855,53,30-34,1908,0.004162122636741147
STAT,1821,45,25-29,1866,0.09355659147597632
STAT,1869,35,30-34,1904,4.923896263654398
STAT,1890,36,35-39,1926,8.208300280060843
STAT,1838,44,40-44,1882,1.5664157040140587
STAT,1838,40,35-39,1878,1.4586560852218948
STAT,1894,25,na,1919,2917.0138841269313
STAT,1899,40,na,1939,3032.29818633165
STAT,1915,10,na,1925,3916.704235273364
SIM,1786,91,na,1877,22
SIM,1881,27,na,1908,1861
STAT,1933,34,15-19,1967,0.1633875733240501
STAT,1854,32,30-34,1886,12.792732498105837
STAT,1903,18,40-44,1921,0.24520543170401926
STAT,1948,19,25-29,1967,46.82066727986896
STAT,1858,29,30-34,1887,18.820528103677706
SIM,1825,46,na,1871,1445
STAT,1770,88,na,1858,31.744601623696084
STAT,1839,21,25-29,1860,49.32616700228508
STAT,1837,32,30-34,1869,14.207295839601246
STAT,1907,15,20-24,1922,24.716679877461207
STAT,1910,37,25-29,1947,0.8896219778919467
SIM,1936,34,na,1970,2868
SIM,1929,20,30-34,1949,42
STAT,1871,50,20-24,1921,7.02169252808757E-4
STAT,1886,15,50-100,1901,0.049116652566322284
SIM,1892,28,20-24,1920,18
STAT,1903,31,25-29,1934,13.823882866811433
STAT,1823,50,30-34,1873,0.007341729972875601
SIM,1890,25,45-49,1915,2
STAT,1850,84,na,1934,234.50206333210815
SIM,1781,76,na,1857,300
STAT,1842,34,50-100,1876,0.7850845498288019
STAT,1921,22,na,1943,3896.520603337853
STAT,1854,50,20-24,1904,5.355574238283939E-4
STAT,1874,53,40-44,1927,0.009998379339501116
SIM,1877,39,35-39,1916,17
STAT,1814,68,na,1882,828.5326303694969
STAT,1839,52,45-49,1891,0.009610902143674346
SIM,1932,26,50-100,1958,1
SIM,1916,36,30-34,1952,2
STAT,1922,44,40-44,1966,0.27031227216181125
STAT,1899,30,na,1929,3113.676029532104
SIM,1856,28,na,1884,1910
SIM,1846,44,40-44,1890,5
STAT,1845,39,50-100,1884,0.8940641230836428
SIM,1847,29,20-24,1876,13
STAT,1884,16,50-100,1900,0.04583743703861072
STAT,1882,25,45-49,1907,1.0269729078812577
STAT,1869,39,35-39,1908,6.407914606048341
SIM,1875,19,30-34,1894,2
STAT,1855,40,35-39,1895,1.2997969850548987
STAT,1794,74,na,1868,450.20913450106934
STAT,1942,28,30-34,1970,38.831595094444836
STAT,1943,27,25-29,1970,66.22218025808107
SIM,1843,28,25-29,1871,40
SIM,1836,67,na,1903,1013
SIM,1913,55,na,1968,3161
SIM,1909,27,50-100,1936,5
SIM,1814,41,40-44,1855,3
SIM,1879,78,na,1957,792
STAT,1878,24,50-100,1902,0.39896473563890444
STAT,1884,28,20-24,1912,10.91066531517598
SIM,1896,35,40-44,1931,5
STAT,1808,99,na,1907,0.7322735775473675
STAT,1916,47,20-24,1963,0.010708027578406136
SIM,1871,22,30-34,1893,22
STAT,1860,26,20-24,1886,9.154348479779305
SIM,1895,39,50-100,1934,2
STAT,1873,32,40-44,1905,4.1550708347882805
STAT,1845,37,35-39,1882,5.258711066853793
STAT,1849,20,40-44,1869,1.9166320869265272
STAT,1915,47,50-100,1962,0.21531193470285823
STAT,1830,52,25-29,1882,0.0023342761658958454
STAT,1925,32,15-19,1957,0.14415513421814372
SIM,1908,15,15-19,1923,6
SIM,1877,43,30-34,1920,4
SIM,1948,17,25-29,1965,51
STAT,1931,37,45-49,1968,0.8529000845395024
SIM,1865,27,na,1892,2104
STAT,1812,52,20-24,1864,0.0023606772137565566
STAT,1863,11,na,1874,2268.5942388564386
STAT,1847,33,50-100,1880,0.7850998820608862
SIM,1876,64,na,1940,1672
STAT,1809,51,20-24,1860,0.0020237894675664966
STAT,1900,8,na,1908,3406.7169617670725
SIM,1910,41,na,1951,3344
SIM,1918,36,40-44,1954,3
SIM,1901,34,20-24,1935,1
STAT,1891,32,45-49,1923,2.0381466586155677
SIM,1885,30,45-49,1915,1
STAT,1829,54,40-44,1883,0.007269872067241347
SIM,1881,32,40-44,1913,2
SIM,1883,32,50-100,1915,1
SIM,1923,47,50-100,1970,4
SIM,1928,18,35-39,1946,4
SIM,1829,44,40-44,1873,6
SIM,1911,42,na,1953,3317
STAT,1823,37,50-100,1860,1.997841216273744
STAT,1824,41,45-49,1865,2.0188494627395768
STAT,1835,28,25-29,1863,34.83712439228561
SIM,1897,10,na,1907,3363
STAT,1883,46,45-49,1929,0.21920696203026782
SIM,1925,40,na,1965,4224
STAT,1863,22,30-34,1885,15.060974939842607
STAT,1950,17,15-19,1967,50.69502699681985
STAT,1880,22,30-34,1902,17.739873735679023
STAT,1832,23,40-44,1855,1.9677590203991324
STAT,1946,15,50-100,1961,0.3927771498023429
SIM,1900,16,15-19,1916,7
STAT,1872,53,30-34,1925,0.0055499362350530405
SIM,1902,12,na,1914,3461
STAT,1877,30,45-49,1907,1.7225676234189586
STAT,1887,39,na,1926,2464.4681306678376
SIM,1781,92,na,1873,11
SIM,1832,41,45-49,1873,2
STAT,1875,32,50-100,1907,0.8896878755967464
STAT,1909,17,20-24,1926,25.117438557900766
SIM,1889,18,20-24,1907,16
STAT,1864,54,35-39,1918,0.007049253606812874
SIM,1917,39,40-44,1956,3
STAT,1909,39,40-44,1948,1.3251659619800638
STAT,1887,39,50-100,1926,1.28427938664682
STAT,1921,23,40-44,1944,3.5765978409360133
SIM,1800,54,na,1854,1060
SIM,1888,39,na,1927,2632
SIM,1853,37,35-39,1890,7
SIM,1834,66,na,1900,978
SIM,1864,79,na,1943,555
STAT,1856,44,35-39,1900,1.3166945473650646
STAT,1838,47,45-49,1885,0.16300501095667605
SIM,1836,38,35-39,1874,14
SIM,1864,44,35-39,1908,4
SIM,1881,41,30-34,1922,3
STAT,1946,19,15-19,1965,47.521346491757775
STAT,1857,40,45-49,1897,1.1263398585919715
STAT,1842,45,45-49,1887,0.1753721326862799
SIM,1817,38,25-29,1855,2
STAT,1876,29,25-29,1905,40.99130821019144
SIM,1895,25,na,1920,3035
STAT,1907,49,na,1956,3073.981334764875
STAT,1836,40,15-19,1876,0.01091477978829133
SIM,1840,23,40-44,1863,2
STAT,1809,47,na,1856,1269.7249223718436
STAT,1824,36,na,1860,1593.5913050278818
STAT,1922,38,na,1960,4040.057228363149
STAT,1834,36,20-24,1870,0.6012612063451513
STAT,1934,29,35-39,1963,19.06097598408119
STAT,1895,29,35-39,1924,11.798673348207299
STAT,1862,63,na,1925,1441.2156116313095
SIM,1879,56,na,1935,2063
STAT,1918,46,40-44,1964,0.15889435202135263
STAT,1792,67,na,1859,718.7057209882922
STAT,1840,51,45-49,1891,0.009569450994352809
STAT,1937,15,na,1952,3398.463873079956
STAT,1849,102,na,1951,0.21984254347654691
STAT,1918,42,25-29,1960,0.07172542088038901
STAT,1919,17,50-100,1936,0.3911273321132896
STAT,1768,104,na,1872,0.02200886589480587
STAT,1843,27,20-24,1870,9.751860124233502
STAT,1881,52,45-49,1933,0.01317361812291414
STAT,1900,37,30-34,1937,1.5075290427494057
STAT,1920,44,30-34,1964,0.13294345341100255
SIM,1903,33,40-44,1936,3
SIM,1851,27,20-24,1878,10
SIM,1923,26,20-24,1949,21
STAT,1935,29,40-44,1964,5.996249512560151
STAT,1904,20,na,1924,3223.8957570502407
STAT,1833,32,50-100,1865,0.7237957889403414
STAT,1901,44,20-24,1945,0.014386340498422117
SIM,1908,28,35-39,1936,18
SIM,1865,42,50-100,1907,4
STAT,1834,54,25-29,1888,0.002166364980880708
STAT,1912,37,35-39,1949,2.2302514281066825
STAT,1901,49,40-44,1950,0.1250336720260268
SIM,1854,80,na,1934,448
STAT,1853,5,na,1858,2289.187313388627
STAT,1911,47,45-49,1958,0.1943825756849528
SIM,1888,22,25-29,1910,68
STAT,1928,17,na,1945,4381.249189732515
STAT,1835,30,na,1865,1792.936957896134
SIM,1869,33,30-34,1902,22
STAT,1863,51,25-29,1914,0.0029504394432613348
STAT,1848,41,30-34,1889,0.8642199804228174
STAT,1869,43,30-34,1912,1.0445636378545595
STAT,1870,21,45-49,1891,0.6482017243522223
STAT,1819,47,35-39,1866,0.26529112704845426
SIM,1870,11,na,1881,2440
SIM,1885,25,na,1910,2289
SIM,1830,24,35-39,1854,4
STAT,1911,16,25-29,1927,8.212601298278297
SIM,1815,68,na,1883,825
STAT,1898,32,50-100,1930,1.1713462798672554
STAT,1799,68,na,1867,696.9822056625698
STAT,1867,35,20-24,1902,0.6902972928610133
STAT,1829,61,na,1890,1129.0960555322729
STAT,1886,38,35-39,1924,7.02313343994698
SIM,1848,17,20-24,1865,17
SIM,1884,29,25-29,1913,53
SIM,1942,29,35-39,1971,19
SIM,1816,85,na,1901,120
STAT,1851,54,25-29,1905,0.0024778558579060116
STAT,1853,53,20-24,1906,5.494879480520509E-4
STAT,1832,65,na,1897,1018.0358073862859
SIM,1889,40,30-34,1929,1
STAT,1869,42,na,1911,2112.6180600095786
STAT,1921,15,40-44,1936,1.5131669119304083
STAT,1810,50,20-24,1860,0.0024500150461585404
SIM,1823,43,35-39,1866,3
SIM,1912,26,35-39,1938,15
STAT,1893,25,20-24,1918,14.149954138898037
SIM,1929,23,35-39,1952,13
STAT,1908,39,35-39,1947,2.117872434944047
STAT,1849,81,na,1930,405.5019993937138
SIM,1834,34,20-24,1868,1
SIM,1931,28,20-24,1959,23
STAT,1823,36,45-49,1859,3.425586338646649
SIM,1894,38,35-39,1932,14
SIM,1866,81,na,1947,407
STAT,1808,46,20-24,1854,0.046340427191086615
STAT,1846,63,na,1909,1323.4252533881597
STAT,1923,28,20-24,1951,19.728522576804277
SIM,1899,20,35-39,1919,12
STAT,1847,9,na,1856,2242.2853722581995
STAT,1876,53,50-100,1929,0.014503683764905493
STAT,1848,15,40-44,1863,0.1704799173759068
STAT,1917,18,50-100,1935,0.07596522310767158
STAT,1911,49,50-100,1960,0.20110396056301255
SIM,1935,19,40-44,1954,5
STAT,1792,73,na,1865,483.59233774440423
STAT,1864,27,na,1891,2009.3852262071744
SIM,1918,44,40-44,1962,2
STAT,1926,40,50-100,1966,0.13719451514220693
STAT,1911,44,na,1955,3307.6778183883002
STAT,1826,34,20-24,1860,3.2598632373101313
SIM,1862,28,35-39,1890,5
SIM,1890,34,35-39,1924,12
SIM,1909,18,25-29,1927,12
SIM,1881,24,40-44,1905,1
SIM,1852,31,45-49,1883,1
STAT,1854,28,35-39,1882,7.185326548680272
STAT,1882,34,35-39,1916,9.224234929530551
STAT,1818,41,45-49,1859,3.650372317660504
STAT,1829,50,25-29,1879,0.0029096375076804746
STAT,1831,52,30-34,1883,0.003730314654973972
SIM,1831,36,45-49,1867,2
STAT,1909,56,na,1965,3070.403988875935
STAT,1815,43,35-39,1858,4.3947867834714405
STAT,1901,36,20-24,1937,0.22107143705035195
STAT,1915,26,20-24,1941,17.64960540032007
STAT,1878,78,na,1956,807.5081475675555
SIM,1880,16,na,1896,2573
SIM,1916,39,35-39,1955,8
SIM,1924,38,30-34,1962,2
STAT,1875,37,20-24,1912,0.748505579894742
STAT,1888,43,40-44,1931,2.4930596503054883
SIM,1785,90,na,1875,17
SIM,1891,30,45-49,1921,2
STAT,1830,32,20-24,1862,2.3185612784273615
STAT,1898,41,45-49,1939,0.1334670350225497
SIM,1854,96,na,1950,8
SIM,1815,46,na,1861,1429
STAT,1780,88,na,1868,36.57633665763407
STAT,1850,78,na,1928,550.7796947686464
STAT,1899,39,20-24,1938,0.21319641925964214
SIM,1896,43,40-44,1939,2
STAT,1855,40,25-29,1895,0.46093849373728896
SIM,1886,36,35-39,1922,11
SIM,1915,40,na,1955,3397
SIM,1955,3,na,1958,4605
SIM,1865,70,na,1935,1185
STAT,1890,20,35-39,1910,6.779993369999749
STAT,1889,42,30-34,1931,1.3391554160894
SIM,1852,30,na,1882,1896
STAT,1906,39,15-19,1945,0.016508756643854268
STAT,1814,84,na,1898,152.90066085960316
STAT,1890,27,45-49,1917,1.2823621523831614
STAT,1835,52,na,1887,1396.5737525881254
STAT,1844,31,45-49,1875,1.4634212958134953
SIM,1840,51,na,1891,1414
STAT,1868,40,20-24,1908,0.14458925740733453
SIM,1845,82,na,1927,298
STAT,1878,36,35-39,1914,6.996952289602954
STAT,1870,54,35-39,1924,0.00775913809703224
SIM,1923,38,na,1961,4182
STAT,1830,26,35-39,1856,10.501014877096539
STAT,1876,12,na,1888,2535.3500685052522
SIM,1935,17,na,1952,4656
SIM,1885,47,na,1932,2135
STAT,1916,38,30-34,1954,1.7544478535190013
STAT,1866,51,40-44,1917,0.009216854600318783
STAT,1805,51,50-100,1856,0.05655903822069346
STAT,1861,18,25-29,1879,5.085939686945193
STAT,1871,53,25-29,1924,0.0032693152378595078
STAT,1856,35,45-49,1891,1.4833094334913153
SIM,1896,30,20-24,1926,2
SIM,1877,12,na,1889,2523
STAT,1869,58,na,1927,1809.8763505947506
SIM,1826,41,45-49,1867,3
SIM,1840,31,40-44,1871,3
STAT,1948,16,20-24,1964,146.61911847673252
STAT,1899,24,na,1923,3042.16084037819
SIM,1918,22,20-24,1940,108
STAT,1879,48,45-49,1927,0.23044172071483213
STAT,1926,18,35-39,1944,4.8472812680675466
SIM,1796,91,na,1887,11
SIM,1860,24,20-24,1884,52
SIM,1841,30,30-34,1871,18
STAT,1819,67,na,1886,866.3788369052542
STAT,1885,32,45-49,1917,1.6420589553852956
SIM,1893,32,45-49,1925,2
SIM,1872,30,35-39,1902,10
STAT,1878,25,na,1903,2365.5216226359826
STAT,1908,31,50-100,1939,0.7402970005879858
SIM,1856,40,50-100,1896,2
STAT,1823,53,35-39,1876,0.010002811563974411
STAT,1871,33,20-24,1904,2.5249640278379815
SIM,1915,18,25-29,1933,10
STAT,1810,106,na,1916,0.005136407909843149
STAT,1907,18,25-29,1925,7.843272535959284
STAT,1870,9,na,1879,2504.8321616682497
SIM,1786,75,na,1861,371
SIM,1903,25,40-44,1928,4
SIM,1934,18,35-39,1952,5
STAT,1837,35,35-39,1872,5.706138974134294
STAT,1890,44,35-39,1934,2.0631976650819848
STAT,1932,29,15-19,1961,0.8726403243827803
STAT,1871,39,50-100,1910,1.1401200139399674
STAT,1896,41,25-29,1937,0.055889412065509056
STAT,1857,57,na,1914,1497.2976661517255
STAT,1870,41,15-19,1911,0.01285632523415743
STAT,1844,50,na,1894,1516.9158622337907
STAT,1920,36,30-34,1956,1.886843130044158
SIM,1864,35,45-49,1899,3
STAT,1822,50,25-29,1872,0.004769727999639968
STAT,1842,53,45-49,1895,0.010340889801727095
STAT,1877,41,15-19,1918,0.013593962946359641
STAT,1815,102,na,1917,0.13086137619849525
SIM,1811,91,na,1902,26
STAT,1903,35,40-44,1938,1.2820777362036666
SIM,1833,97,na,1930,3
STAT,1888,30,20-24,1918,3.0420828190611418
STAT,1880,18,35-39,1898,0.5450467907465134
STAT,1884,47,15-19,1931,3.7158749805432656E-4
SIM,1877,49,50-100,1926,1
STAT,1865,42,45-49,1907,1.2799446040018745
SIM,1863,63,na,1926,1460
STAT,1840,49,15-19,1889,2.5801646650508285E-4
SIM,1845,35,35-39,1880,8
SIM,1823,33,na,1856,1512
STAT,1887,40,30-34,1927,1.2270945083923173
STAT,1904,26,35-39,1930,13.119711647850835
STAT,1833,30,30-34,1863,14.081945831275636
STAT,1941,16,20-24,1957,131.9586364198065
SIM,1907,11,na,1918,3592
SIM,1846,67,na,1913,1107
SIM,1825,99,na,1924,2
STAT,1871,24,30-34,1895,16.604606844684564
STAT,1927,39,45-49,1966,0.7989853730050164
STAT,1832,31,40-44,1863,3.4609925901617125
STAT,1858,38,20-24,1896,0.5681215605600031
SIM,1841,36,na,1877,1666
SIM,1873,42,45-49,1915,3
STAT,1905,47,45-49,1952,0.1809321373040153
STAT,1859,42,45-49,1901,1.1239241236608382
SIM,1911,35,40-44,1946,2
STAT,1928,3,na,1931,4827.981525813612
STAT,1910,39,40-44,1949,1.3389593857799371
STAT,1910,38,50-100,1948,0.37746963235001246
STAT,1841,41,45-49,1882,1.0859957023501148
STAT,1844,42,25-29,1886,0.4567715208518365
STAT,1890,20,25-29,1910,66.51121462322232
STAT,1812,50,30-34,1862,0.01982175401643214
STAT,1924,26,50-100,1950,1.0985570697363747
STAT,1926,27,25-29,1953,74.53727706737503
SIM,1871,34,na,1905,2255
SIM,1810,47,na,1857,1273
STAT,1846,50,35-39,1896,0.006477132456165661
STAT,1785,87,na,1872,57.22615920275625
STAT,1898,61,na,1959,2475.3728015939823
SIM,1880,11,na,1891,2636
SIM,1815,40,30-34,1855,2
STAT,1873,35,45-49,1908,1.9281278525146295
SIM,1893,19,25-29,1912,5
STAT,1915,48,30-34,1963,0.08462644149043702
STAT,1882,18,45-49,1900,0.05985555536727245
SIM,1858,19,30-34,1877,1
STAT,1826,51,20-24,1877,6.703562634406624E-4
STAT,1879,40,20-24,1919,0.15863060057042533
STAT,1866,20,40-44,1886,1.8570638765336913
STAT,1874,31,30-34,1905,16.92139791212853
STAT,1883,43,40-44,1926,2.068259988857196
SIM,1860,71,na,1931,1072
SIM,1882,31,30-34,1913,21
STAT,1834,43,45-49,1877,1.1054684219852373
STAT,1859,64,na,1923,1307.055213674795
STAT,1879,54,30-34,1933,0.0057244468112576325
STAT,1910,25,30-34,1935,36.293149401038264
SIM,1826,28,25-29,1854,37
SIM,1839,97,na,1936,2
SIM,1913,31,35-39,1944,11
STAT,1875,52,20-24,1927,7.127160910114428E-4
SIM,1842,43,45-49,1885,2
STAT,1880,41,50-100,1921,1.056918026758093
STAT,1816,52,40-44,1868,0.02380738418439758
STAT,1848,27,na,1875,1918.9741779716205
STAT,1870,43,30-34,1913,1.0577713064496488
STAT,1911,42,15-19,1953,0.0013847100889622886
STAT,1821,33,30-34,1854,54.739846526563895
STAT,1889,16,40-44,1905,0.21383547821693574
SIM,1911,26,na,1937,3423
STAT,1885,11,na,1896,2435.4319062613017
SIM,1875,28,20-24,1903,10
STAT,1901,27,30-34,1928,33.299079620852105
STAT,1930,16,35-39,1946,5.137411065132659
SIM,1830,51,na,1881,1350
STAT,1864,52,45-49,1916,0.012153994880416982
STAT,1872,31,na,1903,2270.454831512034
SIM,1863,40,35-39,1903,2
SIM,1881,35,45-49,1916,1
SIM,1809,50,na,1859,1234
STAT,1894,30,45-49,1924,2.1341038401017722
STAT,1949,16,na,1965,4045.3593489439827
STAT,1931,34,40-44,1965,4.83782050322687
STAT,1858,45,20-24,1903,0.008976789342840828
STAT,1912,21,25-29,1933,83.88262472164291
STAT,1909,15,30-34,1924,2.268654991502171
STAT,1912,23,na,1935,3444.42423950586
STAT,1842,49,na,1891,1595.27641124757
SIM,1871,0,na,1871,3312
STAT,1823,42,30-34,1865,1.5336185941800133
STAT,1923,35,45-49,1958,0.7474963025000454
SIM,1854,64,na,1918,1399
SIM,1892,35,20-24,1927,3
STAT,1933,30,35-39,1963,11.647174527990568
STAT,1905,31,35-39,1936,7.972746608946513
STAT,1928,33,na,1961,4464.624937886401
STAT,1857,42,35-39,1899,1.3475056663707095
STAT,1864,37,45-49,1901,1.678459555229971
SIM,1822,54,na,1876,1242
SIM,1887,48,50-100,1935,1
STAT,1825,107,na,1932,0.002506461864619154
STAT,1940,32,40-44,1972,3.8261287120800715
SIM,1868,38,30-34,1906,7
SIM,1872,37,45-49,1909,6
STAT,1885,19,25-29,1904,5.307422327712189
STAT,1855,54,45-49,1909,0.010029310398748175
STAT,1886,31,15-19,1917,0.14269084915772892
SIM,1822,43,40-44,1865,9
SIM,1841,14,na,1855,2010
STAT,1884,35,20-24,1919,0.7262819321360742
SIM,1827,29,50-100,1856,2
STAT,1829,45,na,1874,1522.390933990192
SIM,1941,30,35-39,1971,6
SIM,1900,48,50-100,1948,3
STAT,1873,26,na,1899,2294.4093312542986
STAT,1898,17,50-100,1915,0.06263217832378815
SIM,1814,44,45-49,1858,4
STAT,1872,51,40-44,1923,0.010023491459781712
SIM,1839,23,40-44,1862,2
STAT,1901,47,25-29,1948,0.04276416611264711
STAT,1909,42,50-100,1951,0.10381015430017912
STAT,1860,48,40-44,1908,0.12957759134304886
SIM,1939,16,20-24,1955,128
SIM,1920,28,45-49,1948,2
STAT,1890,33,30-34,1923,20.08027887623376
STAT,1892,41,40-44,1933,2.673498801467558
STAT,1819,40,15-19,1859,0.031200920825025878
STAT,1817,45,50-100,1862,0.5713323411716648
STAT,1839,51,30-34,1890,0.0039821593723667024
SIM,1917,15,30-34,1932,2
SIM,1942,22,15-19,1964,5
SIM,1821,34,35-39,1855,10
SIM,1842,79,na,1921,411
SIM,1852,42,50-100,1894,2
STAT,1808,53,45-49,1861,0.05138377253816959
STAT,1817,44,20-24,1861,0.3727190735727252
SIM,1826,47,na,1873,1377
STAT,1919,37,35-39,1956,2.4547727382564632
STAT,1823,51,45-49,1874,0.017546562413035094
STAT,1920,47,35-39,1967,0.13463696736999425
STAT,1814,43,40-44,1857,7.603244425321132
STAT,1852,41,20-24,1893,0.11565823464727171
STAT,1900,38,na,1938,3096.446468245675
STAT,1920,24,50-100,1944,0.6867187545768536
STAT,1899,49,25-29,1948,0.041178580508249775
SIM,1805,84,na,1889,92
SIM,1810,69,na,1879,729
SIM,1855,12,na,1867,2303
SIM,1867,17,30-34,1884,1
SIM,1905,19,na,1924,3386
SIM,1879,39,45-49,1918,1
STAT,1927,19,40-44,1946,1.6341086546284453
STAT,1837,52,35-39,1889,0.005607630872741393
STAT,1797,72,na,1869,553.5972944069762
STAT,1912,28,45-49,1940,1.602728038280059
SIM,1864,41,30-34,1905,3
SIM,1850,42,40-44,1892,5
SIM,1930,18,na,1948,4523
STAT,1917,15,15-19,1932,9.268960705752884
STAT,1914,42,40-44,1956,0.23414326377098638
SIM,1926,7,na,1933,4550
STAT,1836,47,35-39,1883,0.09487778328857552
STAT,1875,44,45-49,1919,1.4336432966944268
STAT,1933,17,15-19,1950,57.39205221315011
STAT,1934,22,15-19,1956,6.758071258339933
SIM,1901,28,35-39,1929,23
SIM,1831,42,30-34,1873,5
SIM,1931,35,45-49,1966,1
STAT,1881,34,40-44,1915,3.9238312861095044
STAT,1861,31,45-49,1892,1.3753475767116383
SIM,1941,17,15-19,1958,44
STAT,1841,64,na,1905,1198.4450182825146
STAT,1897,39,na,1936,2969.7932848855235
STAT,1859,17,30-34,1876,1.391109092762845
STAT,1880,25,35-39,1905,9.674899602486237
SIM,1919,17,40-44,1936,2
SIM,1870,34,30-34,1904,15
SIM,1963,6,na,1969,4692
STAT,1870,48,25-29,1918,0.05271070981828988
STAT,1880,66,na,1946,1632.3473419895902
STAT,1885,43,25-29,1928,0.6003149466341462
STAT,1866,30,50-100,1896,0.8047614886100282
STAT,1844,18,50-100,1862,0.04299814726785691
SIM,1822,32,na,1854,1596
SIM,1858,39,25-29,1897,2
STAT,1811,66,na,1877,825.9864996482735
STAT,1869,46,35-39,1915,0.12849029813441723
STAT,1872,78,na,1950,740.3731014598043
SIM,1882,40,45-49,1922,2
SIM,1883,44,45-49,1927,2
SIM,1877,24,15-19,1901,2
STAT,1890,42,45-49,1932,1.7264400952122174
STAT,1906,36,20-24,1942,0.2300260211801016
STAT,1825,50,40-44,1875,0.010769108323277645
STAT,1764,92,na,1856,6.7457583431999995
STAT,1912,34,30-34,1946,14.520673918398629
STAT,1834,51,20-24,1885,4.789539852290841E-4
STAT,1940,28,20-24,1968,17.57607842591409
STAT,1907,40,35-39,1947,0.17626285876416667
STAT,1842,42,40-44,1884,1.6852590056831946
SIM,1935,33,na,1968,4846
STAT,1847,79,na,1926,515.525274942896
STAT,1858,21,45-49,1879,0.5968887319722537
SIM,1925,15,15-19,1940,49
SIM,1927,37,35-39,1964,5
STAT,1935,32,50-100,1967,1.080594711834957
SIM,1903,36,45-49,1939,3
STAT,1820,54,20-24,1874,0.0011429916581597432
STAT,1952,17,25-29,1969,49.05879477042705
STAT,1874,40,45-49,1914,1.4591685801413314
STAT,1893,14,na,1907,3083.901165909131
SIM,1867,42,45-49,1909,4
STAT,1818,52,25-29,1870,0.007249988158375241
STAT,1831,64,na,1895,1015.002451252235
STAT,1862,30,15-19,1892,0.11594990747453614
STAT,1892,51,na,1943,2559.996452222361
STAT,1924,40,na,1964,4184.758856813288
STAT,1864,43,30-34,1907,0.9609956806962052
SIM,1869,26,30-34,1895,29
STAT,1789,68,na,1857,627.7070957770082
STAT,1843,37,25-29,1880,2.270316671046695
STAT,1894,15,50-100,1909,0.05975491019012768
STAT,1847,20,30-34,1867,16.33585552505161
SIM,1890,31,30-34,1921,35
STAT,1922,1,na,1923,4565.742412928856
SIM,1848,30,40-44,1878,4
SIM,1847,24,na,1871,1951
STAT,1942,24,15-19,1966,5.2691012145447305
SIM,1839,19,20-24,1858,16
SIM,1909,16,35-39,1925,4
SIM,1845,28,35-39,1873,9
SIM,1857,104,na,1961,1
SIM,1829,97,na,1926,4
SIM,1827,37,30-34,1864,3
STAT,1840,33,40-44,1873,3.43060434312514
STAT,1928,24,50-100,1952,0.77122684163839
STAT,1850,34,50-100,1884,0.661771264099801
STAT,1831,50,40-44,1881,0.006864032916651767
SIM,1823,40,30-34,1863,3
STAT,1842,27,na,1869,1937.3378220456987
STAT,1911,60,na,1971,3059.738516537249
STAT,1888,46,45-49,1934,0.2642298526529399
STAT,1911,44,40-44,1955,0.2227646055515262
SIM,1902,6,na,1908,3495
STAT,1845,30,15-19,1875,0.12233241643698983
SIM,1851,37,25-29,1888,3
SIM,1864,64,na,1928,1554
SIM,1920,34,30-34,1954,28
STAT,1945,27,35-39,1972,15.560360584249638
SIM,1902,47,50-100,1949,1
SIM,1944,15,25-29,1959,55
STAT,1806,50,30-34,1856,0.02181656101519595
STAT,1880,82,na,1962,678.5390006310616
STAT,1842,53,20-24,1895,5.258079759745823E-4
STAT,1876,6,na,1882,2649.5444463271238
SIM,1872,43,30-34,1915,1
STAT,1849,54,45-49,1903,0.01058313624609191
SIM,1830,41,35-39,1871,1
SIM,1894,28,30-34,1922,39
SIM,1888,9,na,1897,2919
STAT,1863,26,na,1889,1992.7771742434836
STAT,1851,79,na,1930,502.8964404559063
STAT,1912,55,na,1967,3230.8493162926416
STAT,1898,43,35-39,1941,0.1595956771106021
SIM,1908,37,25-29,1945,1
STAT,1859,53,25-29,1912,0.0026204452895893554
STAT,1877,17,50-100,1894,0.04800883953854282
STAT,1819,37,30-34,1856,14.789576339235346
STAT,1907,27,15-19,1934,0.6296155705691997
STAT,1867,52,20-24,1919,6.511073639387365E-4
SIM,1933,36,30-34,1969,4
STAT,1779,75,na,1854,322.0
STAT,1856,32,40-44,1888,3.23563322764163
STAT,1832,49,na,1881,1413.2210658939584
STAT,1860,46,15-19,1906,3.074741167211261E-4
STAT,1860,33,50-100,1893,0.6993473286982251
STAT,1886,28,30-34,1914,25.040824334646356
STAT,1893,18,20-24,1911,21.18362403782798
SIM,1815,84,na,1899,151
SIM,1967,1,na,1968,4498
SIM,1816,47,na,1863,1368
STAT,1925,36,30-34,1961,2.0683336107101336
STAT,1841,17,45-49,1858,0.05808218014452998
STAT,1903,41,na,1944,3131.4925643036513
STAT,1910,38,na,1948,3382.398626050486
SIM,1855,20,30-34,1875,22
SIM,1909,29,40-44,1938,10
STAT,1822,41,35-39,1863,2.708503174455631
STAT,1851,36,20-24,1887,0.5662926238940965
STAT,1939,30,50-100,1969,0.7978436631051493
STAT,1896,46,50-100,1942,0.17334367152559563
STAT,1857,53,40-44,1910,0.00771780130457018
SIM,1765,92,na,1857,6
SIM,1834,27,20-24,1861,11
STAT,1878,29,35-39,1907,9.431673622469425
STAT,1914,19,na,1933,3754.1525602578554
STAT,1860,46,na,1906,1729.420967825492
STAT,1823,35,na,1858,1564.7044760871897
SIM,1913,44,40-44,1957,1
STAT,1778,90,na,1868,26.56414160192862
SIM,1796,75,na,1871,400
SIM,1940,29,25-29,1969,65
SIM,1828,32,na,1860,1682
SIM,1876,40,45-49,1916,1
SIM,1840,34,45-49,1874,1
STAT,1941,29,50-100,1970,0.9717483763202476
STAT,1884,29,50-100,1913,0.5927710147645142
SIM,1920,21,25-29,1941,97
SIM,1831,36,na,1867,1603
STAT,1817,47,25-29,1864,0.12985141500609396
STAT,1932,29,25-29,1961,81.36151417805614
SIM,1876,38,50-100,1914,1
STAT,1779,107,na,1886,0.006779468029257146
STAT,1947,9,na,1956,4181.910176909716
SIM,1895,41,na,1936,2970
STAT,1873,41,30-34,1914,1.106497859777296
STAT,1900,15,20-24,1915,23.34126503037541
STAT,1901,42,30-34,1943,0.10543961133208467
STAT,1899,22,45-49,1921,0.9026149168205638
STAT,1931,37,na,1968,4706.899958326316
SIM,1891,43,40-44,1934,5
SIM,1838,38,45-49,1876,2
SIM,1870,41,30-34,1911,1
STAT,1896,45,40-44,1941,0.121691538790141
STAT,1921,26,45-49,1947,1.8251784808717955
SIM,1819,38,35-39,1857,11
STAT,1832,34,45-49,1866,1.3463279504384946
STAT,1893,42,20-24,1935,0.19002816015455037
STAT,1905,44,40-44,1949,0.21040356734070684
STAT,1920,42,40-44,1962,0.26096637455843535
STAT,1844,34,na,1878,1762.9821560273783
STAT,1877,45,30-34,1922,0.0958033645743755
SIM,1886,29,35-39,1915,8
STAT,1832,40,30-34,1872,0.8725524130021024
SIM,1816,69,na,1885,747
SIM,1939,19,25-29,1958,53
STAT,1781,94,na,1875,4.010723087241537
STAT,1853,51,30-34,1904,0.004526420486203455
STAT,1888,21,30-34,1909,19.946530778912265
SIM,1872,30,25-29,1902,17
SIM,1934,27,25-29,1961,86
STAT,1878,41,na,1919,2285.7590879327527
SIM,1910,9,na,1919,3721
STAT,1760,95,na,1855,1.83654
STAT,1863,64,na,1927,1441.1291845902592
STAT,1851,40,40-44,1891,1.6343269512693603
STAT,1846,41,20-24,1887,0.12075544982354608
STAT,1863,6,na,1869,2360.0103889043426
STAT,1829,67,na,1896,957.8449796115966
STAT,1912,45,na,1957,3351.2300366222044
SIM,1896,26,na,1922,2989
STAT,1901,4,na,1905,3478.6684699042944
STAT,1853,110,na,1963,9.129310184069026E-4
SIM,1874,20,40-44,1894,2
STAT,1904,26,na,1930,3244.9713904587156
SIM,1903,21,25-29,1924,81
STAT,1911,49,35-39,1960,0.11463580848660825
STAT,1815,40,30-34,1855,3.236477074077631
STAT,1871,20,15-19,1891,3.113187937466903
STAT,1845,27,30-34,1872,21.68943609237581
STAT,1869,26,na,1895,2191.6162178081136
STAT,1897,29,45-49,1926,1.3927117752339893
STAT,1909,41,na,1950,3300.6958615358444
STAT,1862,37,35-39,1899,5.712929763064888
STAT,1868,40,45-49,1908,1.3625965667577964
SIM,1918,25,25-29,1943,84
STAT,1878,53,35-39,1931,0.008339708119529625
STAT,1931,21,35-39,1952,11.571462454261098
SIM,1853,27,30-34,1880,1
SIM,1906,49,50-100,1955,4
STAT,1882,31,30-34,1913,16.106062290856478
STAT,1884,63,na,1947,1665.3281179632434
SIM,1872,50,50-100,1922,1
SIM,1780,91,na,1871,6
STAT,1833,52,40-44,1885,0.006656971442902938
STAT,1836,53,20-24,1889,4.74020446053021E-4
STAT,1829,50,35-39,1879,0.007072035680309735
STAT,1852,27,na,1879,1826.7117654745537
STAT,1864,30,25-29,1894,8.693304631539387
SIM,1832,40,30-34,1872,3
SIM,1877,22,na,1899,2285
STAT,1870,32,25-29,1902,9.492449154086534
STAT,1885,81,na,1966,799.339265591253
STAT,1862,34,30-34,1896,13.981797053355091
STAT,1898,45,50-100,1943,0.1788765047476766
SIM,1842,40,40-44,1882,4
SIM,1896,21,30-34,1917,27
STAT,1941,19,15-19,1960,44.13064371987415
SIM,1892,38,25-29,1930,5
STAT,1903,38,45-49,1941,0.57548859769274
SIM,1794,68,na,1862,620
STAT,1862,53,na,1915,1711.2294783734526
STAT,1929,18,na,1947,4425.831040381648
STAT,1834,43,50-100,1877,0.7803306485769708
STAT,1906,39,25-29,1945,0.8464488731003319
STAT,1872,54,45-49,1926,0.013373472637074656
STAT,1846,15,30-34,1861,1.5027053605006155
STAT,1876,42,45-49,1918,1.4589296007305737
STAT,1851,43,45-49,1894,1.0688204746014773
SIM,1855,49,na,1904,1761
SIM,1847,25,40-44,1872,8
STAT,1831,30,20-24,1861,2.2129613657589524
STAT,1909,27,25-29,1936,59.427384412762635
STAT,1867,19,30-34,1886,1.4284394266323444
STAT,1897,33,40-44,1930,5.45581012665493
STAT,1809,51,45-49,1860,0.039801191351674654
SIM,1898,11,na,1909,3259
SIM,1917,27,25-29,1944,69
STAT,1859,29,25-29,1888,31.892090606336804
SIM,1867,29,25-29,1896,41
STAT,1911,40,25-29,1951,0.06511889526584755
SIM,1871,42,35-39,1913,4
SIM,1917,2,na,1919,4130
STAT,1862,46,25-29,1908,0.04665667912293058
STAT,1819,83,na,1902,209.56742201553791
SIM,1914,56,na,1970,3297
SIM,1884,42,45-49,1926,1
SIM,1886,7,na,1893,2571
SIM,1829,30,30-34,1859,15
STAT,1864,12,na,1876,2284.9301912072415
STAT,1863,18,35-39,1881,0.4695729417718141
STAT,1824,40,30-34,1864,1.5913475266393473
STAT,1834,40,40-44,1874,1.7264890915471012
STAT,1823,49,15-19,1872,4.7876914848822707E-4
SIM,1872,34,40-44,1906,4
STAT,1884,38,25-29,1922,2.6738857882358005
STAT,1852,33,50-100,1885,0.6806629023045772
SIM,1868,45,na,1913,2051
SIM,1971,0,na,1971,4501
SIM,1838,42,40-44,1880,6
STAT,1913,16,35-39,1929,0.8125079863924203
SIM,1936,17,40-44,1953,4
STAT,1910,9,na,1919,3714.2888325219587
STAT,1948,21,na,1969,3962.5130049273603
STAT,1850,68,na,1918,1077.262186485438
STAT,1919,34,40-44,1953,3.95437798560879
STAT,1936,36,na,1972,3492.246103991979
SIM,1849,8,na,1857,2271
SIM,1889,31,40-44,1920,12
STAT,1896,41,35-39,1937,0.1576021319248798
STAT,1873,96,na,1969,40.831423227754904
STAT,1910,28,35-39,1938,13.64823415366227
SIM,1878,77,na,1955,791
STAT,1846,104,na,1950,0.04947167434735082
STAT,1899,46,20-24,1945,0.00878668768395554
SIM,1864,28,45-49,1892,4
STAT,1857,16,45-49,1873,0.057542066052805416
STAT,1909,18,35-39,1927,0.7753636550351115
STAT,1854,35,35-39,1889,5.138001736421074
SIM,1910,31,na,1941,3456
STAT,1847,45,45-49,1892,0.17576309461633488
STAT,1856,28,45-49,1884,0.8419399770053517
SIM,1912,26,45-49,1938,1
STAT,1891,31,30-34,1922,20.48998433076964
STAT,1816,41,35-39,1857,5.118947913582465
STAT,1836,27,50-100,1863,0.5360209349560145
STAT,1855,44,40-44,1899,1.5768200815094913
SIM,1876,11,na,1887,2560
SIM,1795,90,na,1885,23
STAT,1807,98,na,1905,1.208289041646193
STAT,1825,53,45-49,1878,0.01398616541733903
STAT,1843,51,20-24,1894,5.008099885236509E-4
SIM,1864,32,40-44,1896,8
STAT,1904,26,45-49,1930,1.509686478778701
STAT,1928,17,40-44,1945,1.6649065633742124
SIM,1801,55,na,1856,1073
STAT,1890,44,na,1934,2633.370990782363
STAT,1883,32,35-39,1915,9.379823913677525
STAT,1810,87,na,1897,74.53133630830978
SIM,1879,88,na,1967,272
STAT,1803,54,20-24,1857,0.002065410602047748
STAT,1887,42,20-24,1929,0.16760862920096242
STAT,1891,24,50-100,1915,0.47363406836921274
SIM,1929,30,35-39,1959,16
STAT,1839,45,na,1884,1565.8191803073248
STAT,1865,41,30-34,1906,0.9888763023811148
STAT,1836,44,30-34,1880,0.8632626496879479
STAT,1875,41,40-44,1916,2.1939622871441333
SIM,1858,30,na,1888,1979
STAT,1814,46,45-49,1860,0.7340112440406202
STAT,1916,34,15-19,1950,0.12426106900536694
STAT,1842,31,35-39,1873,8.951936126509453
STAT,1852,17,20-24,1869,15.545145812506883
STAT,1885,40,20-24,1925,0.15105423611698748
STAT,1863,42,35-39,1905,1.499347718854616
STAT,1870,82,na,1952,432.41053299046985
STAT,1861,53,30-34,1914,0.00460057850287359
STAT,1870,45,20-24,1915,0.01123200880114859
SIM,1911,42,40-44,1953,2
SIM,1873,41,30-34,1914,2
STAT,1842,49,25-29,1891,0.04084196603293923
STAT,1925,45,20-24,1970,0.012709883872010976
STAT,1924,40,35-39,1964,0.2268947760012627
SIM,1883,41,40-44,1924,3
STAT,1903,47,35-39,1950,0.10565505703799899
SIM,1861,34,na,1895,2055
SIM,1888,26,40-44,1914,4
SIM,1901,21,15-19,1922,3
STAT,1892,37,20-24,1929,0.9121071872868102
STAT,1933,22,na,1955,4576.022331601846
STAT,1855,51,40-44,1906,0.0075170234282052675
STAT,1936,15,25-29,1951,39.375344898356886
STAT,1805,54,na,1859,1162.6200996879106
SIM,1877,28,30-34,1905,26
STAT,1808,50,40-44,1858,0.039593531223617646
SIM,1875,63,na,1938,1680
SIM,1954,1,na,1955,4489
SIM,1803,99,na,1902,2
SIM,1901,25,30-34,1926,41
SIM,1846,61,na,1907,1347
STAT,1871,17,30-34,1888,1.5048211003057572
STAT,1959,1,na,1960,4864.6374692675045
STAT,1835,20,na,1855,1788.4123789686664
SIM,1844,44,30-34,1888,3
STAT,1945,24,40-44,1969,3.47891852381499
STAT,1812,53,35-39,1865,0.026994650929619154
SIM,1850,31,35-39,1881,9
STAT,1923,32,40-44,1955,4.238082509051631
SIM,1885,63,na,1948,1680
STAT,1847,20,50-100,1867,0.3739894069762014
STAT,1860,41,20-24,1901,0.12228253272683443
STAT,1814,52,30-34,1866,0.017390760135239835
SIM,1914,39,25-29,1953,1
STAT,1858,48,25-29,1906,0.04212718726698409
STAT,1881,37,45-49,1918,1.8192689262180557
STAT,1898,17,45-49,1915,0.08350957109838421
SIM,1931,32,40-44,1963,8
STAT,1832,87,na,1919,106.13155312150485
STAT,1837,28,35-39,1865,7.979847909376317
SIM,1849,21,35-39,1870,6
STAT,1914,45,45-49,1959,0.20459011387102458
STAT,1842,42,15-19,1884,0.010346947800284492
STAT,1840,36,45-49,1876,1.5634796730309823
STAT,1909,17,30-34,1926,2.2581632357778254
SIM,1890,42,45-49,1932,1
SIM,1840,43,35-39,1883,5
STAT,1828,45,35-39,1873,0.11639486761582937
STAT,1804,91,na,1895,19.410578195992954
SIM,1831,33,40-44,1864,5
SIM,1871,12,na,1883,2508
STAT,1824,46,na,1870,1449.1397300884844
SIM,1880,31,20-24,1911,2
SIM,1904,56,na,1960,2929
STAT,1817,98,na,1915,1.5035610993189352
STAT,1927,32,25-29,1959,10.740530888700253
SIM,1873,47,50-100,1920,2
STAT,1898,40,30-34,1938,0.10309289219974982
STAT,1908,55,na,1963,3040.2864273844375
SIM,1895,16,30-34,1911,4
STAT,1822,87,na,1909,89.5240776251816
SIM,1874,34,50-100,1908,1
STAT,1847,64,na,1911,1281.8780824026242
SIM,1868,31,20-24,1899,2
STAT,1848,50,45-49,1898,0.010938530088261384
STAT,1849,51,40-44,1900,0.00793211895363124
STAT,1875,11,na,1886,2540.6111544692717
STAT,1911,46,30-34,1957,0.07992802380415262
SIM,1865,42,35-39,1907,2
SIM,1860,17,20-24,1877,16
STAT,1907,48,30-34,1955,0.07482234839826306
STAT,1889,62,na,1951,2131.600330237131
SIM,1905,42,40-44,1947,2
STAT,1890,59,na,1949,2244.634657979403
SIM,1870,37,35-39,1907,9
STAT,1825,46,20-24,1871,0.012411762910924677
STAT,1838,97,na,1935,3.606655683975019
STAT,1865,15,40-44,1880,0.17945675040224943
STAT,1865,47,50-100,1912,0.2093185488050456
STAT,1850,30,30-34,1880,14.445421724175032
SIM,1850,13,na,1863,2224
STAT,1925,39,35-39,1964,2.736564514672874
SIM,1915,19,na,1934,3642
STAT,1901,23,15-19,1924,4.3489575698156795
STAT,1791,72,na,1863,514.2712950164001
STAT,1853,54,35-39,1907,0.006336136139230729
STAT,1882,42,45-49,1924,1.3732934920350965
SIM,1936,18,na,1954,2742
STAT,1773,91,na,1864,14.678810930092776
STAT,1880,51,25-29,1931,0.0035444924081461616
STAT,1837,86,na,1923,143.99407692082207
STAT,1931,30,25-29,1961,11.45382193574351
STAT,1839,33,50-100,1872,0.7429631431436756
STAT,1912,25,40-44,1937,4.368825736525209
STAT,1944,19,40-44,1963,1.421026242804934
SIM,1916,41,na,1957,3510
STAT,1860,50,45-49,1910,0.011283760979038712
STAT,1918,49,45-49,1967,0.2172127168393536
STAT,1932,26,20-24,1958,22.596508726235665
SIM,1902,16,25-29,1918,9
STAT,1822,72,na,1894,641.7243647347822
STAT,1875,21,45-49,1896,0.6791537312944171
STAT,1905,40,25-29,1945,0.0615054973894901
STAT,1835,52,25-29,1887,0.0022974479294902766
SIM,1852,79,na,1931,449
STAT,1879,41,25-29,1920,0.6378851559542068
SIM,1862,35,35-39,1897,10
STAT,1918,33,na,1951,3780.7007513097465
SIM,1830,73,na,1903,672
SIM,1858,15,15-19,1873,6
STAT,1868,63,na,1931,1608.2685633194785
SIM,1935,32,25-29,1967,13
STAT,1854,12,na,1866,2043.2144730846185
SIM,1823,31,40-44,1854,4
STAT,1877,48,35-39,1925,0.13546704346678543
STAT,1877,77,na,1954,847.0478159587443
STAT,1832,43,35-39,1875,1.3219050205433827
STAT,1837,34,50-100,1871,0.7302421633654413
STAT,1887,16,30-34,1903,1.6883532822962257
STAT,1847,51,30-34,1898,0.004410454967964467
STAT,1877,54,20-24,1931,7.032276512355514E-4
SIM,1952,19,40-44,1971,1
STAT,1831,53,45-49,1884,0.008916191085886097
SIM,1940,26,20-24,1966,19
SIM,1885,41,na,1926,2213
SIM,1920,25,40-44,1945,4
STAT,1892,44,45-49,1936,0.12131499561017135
STAT,1794,90,na,1884,30.727446611266874
SIM,1843,41,45-49,1884,3
STAT,1802,99,na,1901,0.6639796729547893
STAT,1896,48,45-49,1944,0.16400943715471303
SIM,1836,23,15-19,1859,2
SIM,1859,35,50-100,1894,1
STAT,1921,37,na,1958,3968.460584116556
STAT,1873,44,35-39,1917,1.7115480915220578
SIM,1894,77,na,1971,1489
STAT,1901,45,35-39,1946,0.10546862673375718
STAT,1876,92,na,1968,139.66216571086264
SIM,1890,22,40-44,1912,3
STAT,1815,51,45-49,1866,0.03199205621205975
STAT,1838,40,25-29,1878,0.5172736562198695
STAT,1854,34,na,1888,1712.513376730776
STAT,1897,49,15-19,1946,2.7910905626669035E-4
STAT,1881,30,35-39,1911,9.316314991505102
SIM,1841,36,50-100,1877,3
STAT,1867,28,20-24,1895,10.37008136527267
SIM,1909,25,25-29,1934,61
SIM,1891,32,35-39,1923,13
SIM,1806,69,na,1875,728
STAT,1922,47,45-49,1969,0.2358722812898174
SIM,1879,4,na,1883,2741
STAT,1840,42,30-34,1882,0.787031156093684
STAT,1841,21,40-44,1862,1.8330508337976752
STAT,1913,16,50-100,1929,0.07254534248696727
SIM,1824,41,35-39,1865,5
STAT,1933,38,30-34,1971,2.3428024581609024
SIM,1884,0,na,1884,3177
SIM,1919,26,50-100,1945,1
SIM,1921,16,35-39,1937,5
STAT,1882,22,40-44,1904,1.9144271942464972
STAT,1856,52,45-49,1908,0.010639833754525707
SIM,1927,34,40-44,1961,4
STAT,1951,3,na,1954,4445.80744912836
STAT,1856,78,na,1934,575.9029903575143
STAT,1879,48,50-100,1927,0.23981562082462887
STAT,1878,50,30-34,1928,0.0059446241196194315
SIM,1873,78,na,1951,663
STAT,1914,38,20-24,1952,0.24741484833288271
STAT,1855,24,50-100,1879,0.3336988016136661
STAT,1835,41,45-49,1876,1.1560756570224426
SIM,1917,17,30-34,1934,5
STAT,1821,42,20-24,1863,0.27330274706767665
SIM,1881,44,35-39,1925,1
STAT,1919,18,na,1937,3832.51430100524
SIM,1891,59,na,1950,2252
STAT,1835,79,na,1914,444.963700522426
SIM,1854,86,na,1940,163
STAT,1859,50,20-24,1909,5.628077983149369E-4
STAT,1844,18,25-29,1862,4.973453371098798
STAT,1806,53,35-39,1859,0.029700789862428457
STAT,1895,36,35-39,1931,8.752927402125444
STAT,1883,43,15-19,1926,0.01269845054674363
STAT,1843,34,20-24,1877,2.149815647794895
STAT,1866,47,20-24,1913,0.010407110486470632
STAT,1836,31,na,1867,1792.4453074940004
SIM,1851,34,20-24,1885,2
STAT,1849,51,50-100,1900,0.011379254752272729
SIM,1879,43,40-44,1922,7
STAT,1821,36,35-39,1857,15.728449039129307
STAT,1820,52,30-34,1872,0.009595030272977855
STAT,1920,45,45-49,1965,0.2280276589107435
SIM,1800,70,na,1870,608
SIM,1869,22,15-19,1891,3
STAT,1859,96,na,1955,6.456226407990865
STAT,1833,36,50-100,1869,0.9516280440015946
STAT,1902,37,40-44,1939,1.2596977552963633
STAT,1839,25,40-44,1864,2.549020541686793
STAT,1915,29,15-19,1944,0.6753851486442566
STAT,1868,41,na,1909,2092.64380022529
SIM,1852,18,25-29,1870,6
SIM,1886,26,na,1912,2350
STAT,1872,31,20-24,1903,2.571824314912456
STAT,1881,38,50-100,1919,1.1148886145658656
STAT,1908,32,15-19,1940,0.11459253243374376
STAT,1863,16,50-100,1879,0.046620259391322194
SIM,1838,39,45-49,1877,5
SIM,1858,24,na,1882,1994
STAT,1859,37,15-19,1896,0.042222082734487576
STAT,1879,39,40-44,1918,4.2852277943795904
STAT,1856,36,35-39,1892,5.238385252564629
STAT,1906,5,na,1911,3605.7465128556523
STAT,1824,30,30-34,1854,60.28365096456428
SIM,1855,36,40-44,1891,5
SIM,1935,15,25-29,1950,70
STAT,1788,101,na,1889,0.12621244876459986
SIM,1937,21,40-44,1958,2
STAT,1886,16,25-29,1902,5.668775696623539
STAT,1829,98,na,1927,1.962884093094691
SIM,1890,23,30-34,1913,25
STAT,1874,22,50-100,1896,0.39360884575501964
STAT,1892,39,na,1931,2759.653654309318
STAT,1834,43,20-24,1877,0.11730460953855824
SIM,1844,22,20-24,1866,59
STAT,1845,13,na,1858,2125.406584533139
STAT,1915,37,na,1952,3590.466530387359
STAT,1945,17,40-44,1962,1.443418537980953
SIM,1894,62,na,1956,2289
SIM,1823,32,30-34,1855,23
SIM,1924,9,na,1933,4500
STAT,1763,91,na,1854,9.0
STAT,1820,41,25-29,1861,1.2174728234159533
STAT,1890,27,50-100,1917,0.738822842109588
SIM,1894,16,25-29,1910,8
SIM,1919,32,30-34,1951,25
SIM,1888,42,30-34,1930,4
STAT,1945,18,50-100,1963,0.38650614995299076
STAT,1873,32,na,1905,2286.359150730181
STAT,1833,41,35-39,1874,1.3636206425127366
STAT,1877,46,na,1923,2210.9564772197896
STAT,1770,89,na,1859,25.690906094057237
STAT,1899,61,na,1960,2526.1870493578967
SIM,1800,85,na,1885,64
SIM,1827,32,na,1859,1595
STAT,1817,46,25-29,1863,0.1319054752790675
STAT,1788,99,na,1887,0.32899110145263444
STAT,1891,21,30-34,1912,20.881515669149355
STAT,1790,93,na,1883,6.5382042310904085
STAT,1887,45,25-29,1932,0.0614718131784402
SIM,1846,39,na,1885,1701
STAT,1927,22,na,1949,4250.299101328477
SIM,1835,51,na,1886,1398
SIM,1887,39,40-44,1926,2
STAT,1854,20,15-19,1874,2.8136486691611955
STAT,1929,21,40-44,1950,4.028800174257092
STAT,1836,22,20-24,1858,58.89500195084384
SIM,1900,21,45-49,1921,1
SIM,1903,22,25-29,1925,79
STAT,1820,54,30-34,1874,0.009220132367924006
SIM,1864,42,45-49,1906,2
SIM,1949,22,15-19,1971,4
STAT,1865,34,35-39,1899,8.597222511119641
STAT,1780,108,na,1888,0.004212325218761359
STAT,1910,40,20-24,1950,0.01594661927722188
STAT,1852,18,20-24,1870,15.453584903671215
SIM,1825,39,35-39,1864,11
STAT,1879,31,30-34,1910,17.336004066039376
STAT,1881,51,na,1932,1974.3965856287432
STAT,1889,31,na,1920,2794.4201594886867
SIM,1860,18,20-24,1878,24
STAT,1882,23,30-34,1905,16.313852119954014
STAT,1902,49,35-39,1951,0.10308917598486153
STAT,1807,49,50-100,1856,0.9130876798392862
SIM,1872,32,25-29,1904,12
SIM,1935,33,25-29,1968,20
STAT,1882,41,30-34,1923,1.0609970042779495
STAT,1843,41,20-24,1884,0.11187043307401011
SIM,1812,70,na,1882,646
STAT,1847,43,30-34,1890,0.8416495526993144
STAT,1850,20,30-34,1870,15.28949297654824
SIM,1825,45,50-100,1870,1
SIM,1945,16,na,1961,3644
SIM,1823,66,na,1889,822
SIM,1870,48,na,1918,2034
SIM,1949,15,25-29,1964,49
STAT,1832,50,na,1882,1395.7926000428408
STAT,1840,40,40-44,1880,1.7359963200356407
STAT,1887,76,na,1963,1246.5252401586283
STAT,1901,42,20-24,1943,0.014565231841113217
STAT,1958,14,na,1972,4871.124579747216
STAT,1879,57,na,1936,1987.2702273706495
STAT,1894,17,15-19,1911,7.204838190093142
STAT,1817,39,35-39,1856,20.856396911374876
STAT,1895,75,na,1970,1672.5089948484672
STAT,1888,37,40-44,1925,4.8872552045938695
STAT,1891,81,na,1972,1087.968266592914
STAT,1850,39,20-24,1889,0.5406489802683013
SIM,1841,41,35-39,1882,3
SIM,1861,0,na,1861,3123
SIM,1842,36,30-34,1878,10
SIM,1815,47,na,1862,1415
STAT,1826,44,25-29,1870,0.602869443816525
STAT,1834,36,30-34,1870,4.157064270112256
STAT,1917,19,30-34,1936,12.284384110253555
STAT,1933,30,45-49,1963,2.0055760868102777
STAT,1870,48,35-39,1918,0.12811630987894695
SIM,1916,19,na,1935,3570
STAT,1847,52,45-49,1899,0.01064458931511731
SIM,1841,67,na,1908,1015
STAT,1927,15,25-29,1942,51.13765236925034
STAT,1890,18,40-44,1908,0.2106933135703535
STAT,1909,42,20-24,1951,0.015605448329534415
STAT,1841,18,45-49,1859,0.057740076103478706
SIM,1885,10,na,1895,2491
STAT,1847,36,40-44,1883,3.384154290933957
STAT,1809,53,50-100,1862,0.039786776201774995
STAT,1944,25,25-29,1969,67.26269910620893
SIM,1872,20,30-34,1892,21
STAT,1876,53,25-29,1929,0.0034015153866655255
SIM,1808,65,na,1873,861
SIM,1894,37,50-100,1931,2
STAT,1862,84,na,1946,268.69822610248514
SIM,1762,94,na,1856,6
SIM,1890,41,30-34,1931,3
STAT,1862,53,25-29,1915,0.002815013846218611
SIM,1920,24,na,1944,3838
STAT,1897,37,35-39,1934,8.935804365811576
SIM,1891,26,na,1917,2800
STAT,1952,3,na,1955,4453.287173518223
SIM,1882,45,na,1927,2140
STAT,1820,53,na,1873,1232.654488177986
STAT,1950,22,45-49,1972,1.2610173179514774
STAT,1882,50,45-49,1932,0.01352437536315498
STAT,1831,33,25-29,1864,8.069920909432664
SIM,1831,27,40-44,1858,1
SIM,1890,32,45-49,1922,4
SIM,1836,23,25-29,1859,47
SIM,1876,29,40-44,1905,4
SIM,1920,46,50-100,1966,1
SIM,1869,25,30-34,1894,28
STAT,1861,18,15-19,1879,5.32631263173212
SIM,1841,23,35-39,1864,6
STAT,1870,18,40-44,1888,0.17011429282621723
STAT,1871,39,40-44,1910,4.0650848984358365
STAT,1866,39,30-34,1905,4.597037216634704
STAT,1919,27,40-44,1946,4.757686919189579
SIM,1837,62,na,1899,1155
STAT,1837,81,na,1918,350.94747183948806
SIM,1882,77,na,1959,897
STAT,1815,50,30-34,1865,0.013386638351589113
SIM,1840,14,na,1854,2061
STAT,1830,79,na,1909,421.94204838254456
SIM,1936,24,30-34,1960,22
SIM,1851,36,25-29,1887,5
SIM,1853,15,25-29,1868,6
SIM,1901,5,na,1906,3443
SIM,1845,48,50-100,1893,4
STAT,1828,30,15-19,1858,0.15930510231569048
SIM,1927,27,40-44,1954,7
STAT,1927,33,25-29,1960,10.733871759549258
SIM,1908,3,na,1911,3666
STAT,1854,47,40-44,1901,0.121919976376786
SIM,1930,1,na,1931,5041
SIM,1941,30,45-49,1971,3
STAT,1843,36,25-29,1879,2.2940138339514133
STAT,1860,33,20-24,1893,2.063177175207362
SIM,1823,41,45-49,1864,1
SIM,1889,34,45-49,1923,4
STAT,1935,1,na,1936,5393.19250328374
STAT,1874,45,15-19,1919,3.899381777998856E-4
STAT,1833,23,35-39,1856,4.780968141390378
STAT,1782,74,na,1856,369.81096045030006
STAT,1890,28,na,1918,2746.6504010399235
STAT,1828,45,na,1873,1440.580582713451
STAT,1845,15,25-29,1860,5.1284499353703366
SIM,1874,39,30-34,1913,4
STAT,1861,47,na,1908,1758.9821274871695
SIM,1787,86,na,1873,37
SIM,1873,31,30-34,1904,20
STAT,1818,38,40-44,1856,12.589153612997338
STAT,1949,16,50-100,1965,0.41176757320408636
STAT,1814,50,40-44,1864,0.03201584547976604
STAT,1949,17,25-29,1966,47.61445646474387
STAT,1885,19,15-19,1904,5.558263040081375
STAT,1835,28,15-19,1863,0.3736444661503924
STAT,1933,28,30-34,1961,49.12541564366857
STAT,1843,29,35-39,1872,7.905982373397289
SIM,1889,29,50-100,1918,4
SIM,1941,28,30-34,1969,40
STAT,1864,20,30-34,1884,15.459817002899355
STAT,1860,29,35-39,1889,7.368283654651159
STAT,1920,21,20-24,1941,117.13221892687581
STAT,1881,67,na,1948,1446.680098045423
STAT,1848,65,na,1913,1255.740208566875
SIM,1925,19,30-34,1944,16
STAT,1828,50,50-100,1878,0.012286503703182811
STAT,1858,44,20-24,1902,0.11604208807425791
STAT,1806,107,na,1913,0.0016354147511030961
STAT,1824,49,20-24,1873,0.014219229313552429
SIM,1806,54,na,1860,1160
STAT,1852,20,50-100,1872,0.35630759763541303
STAT,1872,34,25-29,1906,9.622562935968745
SIM,1880,34,25-29,1914,13
STAT,1828,105,na,1933,0.016512822532195326
STAT,1893,40,na,1933,2796.868648670202
STAT,1929,5,na,1934,4847.372160208889
STAT,1839,44,35-39,1883,1.2385423309972163
STAT,1894,25,50-100,1919,0.7818870347284519
STAT,1867,29,20-24,1896,10.332334269103082
STAT,1875,44,20-24,1919,0.1521282415596282
SIM,1851,29,35-39,1880,6
STAT,1861,31,na,1892,1882.0767027244808
SIM,1846,35,na,1881,1792
STAT,1918,40,20-24,1958,0.01778778326804459
STAT,1841,25,35-39,1866,8.382147460814828
STAT,1883,19,50-100,1902,0.045133585773437006
SIM,1914,24,na,1938,3480
STAT,1775,92,na,1867,9.819462291226234
STAT,1808,53,20-24,1861,0.0026127342960100817
SIM,1831,31,25-29,1862,10
SIM,1911,21,20-24,1932,92
SIM,1897,35,35-39,1932,17
STAT,1777,108,na,1885,0.004449493715634595
SIM,1826,38,40-44,1864,2
SIM,1847,44,35-39,1891,2
STAT,1858,79,na,1937,517.814307727515
STAT,1878,18,40-44,1896,0.17960004050670403
STAT,1931,40,50-100,1971,0.14867316935265285
STAT,1890,22,25-29,1912,66.11672459071548
STAT,1809,78,na,1887,324.1059610126449
SIM,1859,33,20-24,1892,1
STAT,1854,65,na,1919,1209.1428692517616
STAT,1864,41,40-44,1905,1.902395906144191
SIM,1883,8,na,1891,2419
SIM,1886,63,na,1949,1684
SIM,1861,16,15-19,1877,4
STAT,1861,42,25-29,1903,0.5037850873390254
SIM,1893,29,40-44,1922,5
STAT,1855,38,40-44,1893,3.095340861943187
STAT,1833,44,15-19,1877,0.010007258863334685
STAT,1853,16,15-19,1869,5.434685780375357
STAT,1960,8,na,1968,4834.451330755862
STAT,1798,89,na,1887,39.00619330532324
SIM,1869,30,50-100,1899,1
STAT,1879,16,35-39,1895,0.5439364077764823
STAT,1935,17,25-29,1952,55.96511233312801
SIM,1887,31,30-34,1918,22
STAT,1867,45,25-29,1912,0.05160509768281608
STAT,1899,48,25-29,1947,0.04152824835943624
SIM,1856,29,na,1885,1917
STAT,1903,21,20-24,1924,92.90853850397576
SIM,1829,27,na,1856,1651
STAT,1889,35,35-39,1924,8.327169191407899
STAT,1856,84,na,1940,245.19865347377387
STAT,1807,49,20-24,1856,0.04461340631876955
SIM,1894,30,na,1924,3010
SIM,1888,37,35-39,1925,13
SIM,1872,41,40-44,1913,4
STAT,1885,29,40-44,1914,2.8005930335970044
SIM,1862,20,15-19,1882,2
STAT,1856,51,30-34,1907,0.004408484559786587
SIM,1854,26,50-100,1880,1
SIM,1932,32,45-49,1964,3
SIM,1855,71,na,1926,1001
STAT,1820,49,35-39,1869,0.2279991249075432
STAT,1879,41,na,1920,2295.864497557589
STAT,1880,37,40-44,1917,4.359707657777277
STAT,1809,101,na,1910,0.22898675372646426
STAT,1833,39,20-24,1872,0.5791594070756099
STAT,1842,64,na,1906,1258.888376678845
STAT,1907,38,30-34,1945,1.5884442247708133
STAT,1823,31,25-29,1854,31.04324466202542
SIM,1846,38,40-44,1884,4
SIM,1860,34,na,1894,1973
SIM,1852,18,15-19,1870,5
SIM,1926,17,25-29,1943,67
SIM,1915,32,45-49,1947,1
STAT,1894,19,40-44,1913,0.2208625333482766
STAT,1844,28,40-44,1872,2.5285845425545763
STAT,1870,45,30-34,1915,0.09060486764270323
SIM,1814,89,na,1903,27
STAT,1827,28,40-44,1855,5.516103912208858
STAT,1848,34,35-39,1882,7.821559486965868
SIM,1835,28,40-44,1863,2
STAT,1813,46,40-44,1859,0.4757769137630057
STAT,1838,30,30-34,1868,14.871289543675326
STAT,1891,16,35-39,1907,0.6428960462756468
STAT,1831,92,na,1923,24.31849313399286
STAT,1769,92,na,1861,8.196841276341083
STAT,1803,54,30-34,1857,0.016660978239906248
STAT,1809,90,na,1899,31.638098674954197
STAT,1838,54,45-49,1892,0.00947522331540809
STAT,1890,31,40-44,1921,5.029228272963104
STAT,1838,38,40-44,1876,3.509612563906329
STAT,1951,7,na,1958,4421.767118692143
SIM,1878,44,na,1922,2300
SIM,1832,30,30-34,1862,20
STAT,1918,17,25-29,1935,8.939961633075718
SIM,1835,40,50-100,1875,1
SIM,1924,5,na,1929,4540
STAT,1924,32,45-49,1956,1.7342798151033614
SIM,1799,71,na,1870,584
STAT,1924,38,30-34,1962,2.028180436750766
STAT,1823,40,40-44,1863,3.171351897753938
STAT,1894,0,na,1894,3564.8577549587694
SIM,1932,38,30-34,1970,6
STAT,1833,28,na,1861,1736.454538054372
STAT,1882,19,45-49,1901,0.059690952590012475
SIM,1893,19,15-19,1912,6
STAT,1907,32,45-49,1939,1.3895355531782545
SIM,1953,5,na,1958,4445
STAT,1881,41,40-44,1922,2.0619917510841494
STAT,1920,34,50-100,1954,0.8482046039586081
STAT,1937,22,30-34,1959,26.44053027188108
SIM,1831,40,40-44,1871,6
SIM,1915,38,30-34,1953,2
STAT,1870,16,15-19,1886,5.585200930471336
SIM,1914,49,50-100,1963,2
STAT,1850,44,15-19,1894,0.00960346932846307
STAT,1866,31,50-100,1897,0.8016068235746765
SIM,1926,35,25-29,1961,3
STAT,1884,34,20-24,1918,2.501221338707506
STAT,1929,24,45-49,1953,1.3357169902877495
STAT,1827,87,na,1914,101.7676097101296
STAT,1875,37,30-34,1912,5.175098225735014
STAT,1772,113,na,1885,4.221892996821855E-4
STAT,1830,46,40-44,1876,0.12995289068462482
SIM,1883,37,30-34,1920,5
STAT,1829,48,40-44,1877,0.1381101600280285
SIM,1856,34,35-39,1890,10
SIM,1846,30,30-34,1876,20
SIM,1902,31,20-24,1933,2
SIM,1945,22,30-34,1967,28
STAT,1879,43,25-29,1922,0.6304246935665261
SIM,1882,21,30-34,1903,15
STAT,1900,26,50-100,1926,0.841196626653503
SIM,1837,22,30-34,1859,24
STAT,1817,44,50-100,1861,2.47939205085041
STAT,1808,46,30-34,1854,0.3738127655068587
SIM,1852,28,40-44,1880,2
STAT,1902,62,na,1964,2627.0768151259344
SIM,1820,40,50-100,1860,1
STAT,1817,43,20-24,1860,0.3877790379856528
SIM,1892,34,20-24,1926,2
STAT,1918,35,25-29,1953,0.989724047357054
STAT,1873,26,40-44,1899,2.8799425254472024
SIM,1832,25,35-39,1857,11
STAT,1870,52,20-24,1922,6.80234500496206E-4
STAT,1834,45,na,1879,1517.5611486663436
STAT,1838,59,na,1897,1304.7449553974654
SIM,1823,35,35-39,1858,12
SIM,1891,39,30-34,1930,7
STAT,1935,35,25-29,1970,1.30289583484441
SIM,1866,6,na,1872,2489
SIM,1831,37,50-100,1868,4
SIM,1936,32,30-34,1968,22
SIM,1926,32,20-24,1958,2
STAT,1832,33,45-49,1865,1.361301735420521
STAT,1942,20,45-49,1962,1.1152680191569262
SIM,1855,39,45-49,1894,1
SIM,1776,86,na,1862,66
STAT,1916,54,na,1970,3466.8405235857535
SIM,1863,30,30-34,1893,19
STAT,1849,47,30-34,1896,0.07224881735971767
SIM,1918,15,25-29,1933,13
STAT,1841,30,30-34,1871,14.910865308548733
STAT,1856,33,30-34,1889,12.892165439160658
SIM,1867,39,40-44,1906,7
STAT,1902,46,30-34,1948,0.07300547400647316
SIM,1838,36,40-44,1874,3
STAT,1851,50,45-49,1901,0.01058942147491051
STAT,1928,32,30-34,1960,18.610116838053607
STAT,1918,32,20-24,1950,2.4486231506873732
SIM,1864,33,30-34,1897,16
STAT,1910,43,25-29,1953,0.06337454775506245
STAT,1882,26,35-39,1908,8.895039838322392
SIM,1881,42,45-49,1923,2
STAT,1900,43,15-19,1943,0.0012476728834847836
SIM,1944,23,25-29,1967,97
STAT,1808,49,35-39,1857,0.5126759286150713
STAT,1839,36,35-39,1875,5.686218197637283
STAT,1953,19,40-44,1972,1.5973125102381096
STAT,1893,27,25-29,1920,50.67827209593706
SIM,1893,45,na,1938,2853
SIM,1859,9,na,1868,2277
STAT,1866,23,45-49,1889,0.608154072549801
SIM,1924,18,na,1942,4139
STAT,1846,30,na,1876,1939.4789176770125
STAT,1827,28,na,1855,1624.447046284475
STAT,1883,39,30-34,1922,4.886644259297544
SIM,1843,86,na,1929,121
SIM,1871,37,40-44,1908,7
SIM,1807,48,na,1855,1257
SIM,1890,26,35-39,1916,12
STAT,1860,36,25-29,1896,2.2175545804135517
SIM,1914,27,50-100,1941,1
STAT,1929,17,na,1946,4437.4571781885015
STAT,1933,22,45-49,1955,1.4099397062464645
STAT,1865,50,45-49,1915,0.012605063206782969
SIM,1927,34,30-34,1961,22
STAT,1834,46,25-29,1880,0.042196443828260294
STAT,1870,83,na,1953,367.9121778896114
SIM,1866,37,30-34,1903,2
SIM,1788,71,na,1859,552
STAT,1936,23,25-29,1959,83.39574131165479
SIM,1841,20,30-34,1861,16
STAT,1862,50,20-24,1912,6.045963834126198E-4
STAT,1871,61,na,1932,1752.915268270888
SIM,1888,5,na,1893,2942
STAT,1957,9,na,1966,4893.663277185216
STAT,1861,28,40-44,1889,2.353054696623547
STAT,1871,47,40-44,1918,0.1598492615469378
SIM,1943,17,25-29,1960,47
SIM,1941,22,45-49,1963,1
STAT,1866,43,15-19,1909,0.011945876691537047
SIM,1919,35,35-39,1954,4
STAT,1861,47,30-34,1908,0.07568067573326155
STAT,1909,25,na,1934,3404.118752630333
SIM,1834,36,25-29,1870,2
STAT,1815,53,35-39,1868,0.01823585821092013
STAT,1820,49,na,1869,1323.5158662015385
STAT,1841,15,40-44,1856,0.16456298690237967
STAT,1862,49,40-44,1911,0.13539420256160295
STAT,1863,37,40-44,1900,3.6290255284598536
SIM,1950,20,45-49,1970,1
STAT,1844,18,15-19,1862,5.2085099596855855
STAT,1847,39,45-49,1886,1.4938544398342652
STAT,1853,18,40-44,1871,0.16552989583907998
STAT,1927,29,40-44,1956,5.331434651127804
STAT,1855,30,30-34,1885,12.89833609623604
STAT,1844,19,50-100,1863,0.04274488818044922
STAT,1876,29,15-19,1905,0.43965096833293227
SIM,1810,45,50-100,1855,1
STAT,1895,36,50-100,1931,1.5193641446322521
STAT,1888,8,na,1896,2902.2587585303663
STAT,1846,94,na,1940,14.823749938797658
SIM,1812,54,na,1866,1155
STAT,1806,51,45-49,1857,0.052127379149650516
STAT,1843,50,na,1893,1475.249630700049
STAT,1834,39,35-39,1873,5.34766245853805
STAT,1832,34,na,1866,1651.8114690216898
STAT,1888,45,45-49,1933,0.26610857922224895
SIM,1928,31,40-44,1959,6
STAT,1848,52,35-39,1900,0.006362975840765075
STAT,1892,3,na,1895,3128.089736367528
SIM,1823,70,na,1893,742
SIM,1896,25,na,1921,3011
SIM,1866,59,na,1925,1731
STAT,1835,101,na,1936,0.3631882104368044
STAT,1816,48,30-34,1864,0.22499784822557717
STAT,1916,30,45-49,1946,1.5470883756002298
STAT,1932,37,na,1969,4775.289941794641
STAT,1832,51,45-49,1883,0.00930579725896517
STAT,1886,39,na,1925,2327.3917823170445
STAT,1802,68,na,1870,727.0646761842632
STAT,1840,43,45-49,1883,1.011515947069682
SIM,1868,14,na,1882,2385
STAT,1847,46,35-39,1893,0.1035301230408055
STAT,1858,39,20-24,1897,0.5652070969543302
STAT,1826,36,25-29,1862,3.2455064442716393
STAT,1850,15,35-39,1865,0.47827840152158474
SIM,1946,22,45-49,1968,1
STAT,1838,42,25-29,1880,0.5041876946285955
STAT,1857,49,30-34,1906,0.07061605376812433
SIM,1811,85,na,1896,112
STAT,1861,99,na,1960,3.199446714818243
STAT,1897,42,30-34,1939,0.1007383592142553
STAT,1919,34,30-34,1953,15.920414010421386
STAT,1851,102,na,1953,0.2108933643228402
STAT,1911,32,50-100,1943,0.760603123212925
SIM,1911,24,25-29,1935,95
SIM,1800,69,na,1869,664
SIM,1824,51,na,1875,1309
SIM,1842,39,35-39,1881,14
SIM,1799,67,na,1866,736
STAT,1938,22,45-49,1960,1.0520140972660175
STAT,1811,72,na,1883,588.6698220791258
SIM,1873,32,45-49,1905,3
SIM,1864,36,35-39,1900,14
SIM,1869,28,35-39,1897,10
SIM,1908,19,30-34,1927,1
SIM,1840,33,45-49,1873,1
STAT,1838,46,40-44,1884,0.11977240547736935
STAT,1873,42,45-49,1915,1.4321871821089969
STAT,1901,45,25-29,1946,0.04339280598972478
STAT,1903,24,25-29,1927,76.46511727715527
STAT,1824,108,na,1932,0.0010099883312876196
SIM,1847,36,35-39,1883,5
SIM,1836,20,20-24,1856,54
SIM,1829,82,na,1911,259
SIM,1925,5,na,1930,4555
SIM,1834,29,35-39,1863,6
STAT,1895,48,40-44,1943,0.11744234368020769
STAT,1895,21,15-19,1916,4.075340476497268
STAT,1897,27,40-44,1924,3.7845426529108863
STAT,1812,47,35-39,1859,0.4687312583666771
STAT,1936,30,15-19,1966,0.11804508503006378
SIM,1841,51,na,1892,1447
STAT,1846,44,25-29,1890,0.4698612916012917
STAT,1821,48,40-44,1869,0.2661409972533388
SIM,1872,83,na,1955,340
STAT,1889,32,30-34,1921,20.36248033071161
SIM,1806,70,na,1876,654
SIM,1847,52,na,1899,1601
SIM,1887,80,na,1967,946
SIM,1922,8,na,1930,4330
STAT,1875,47,25-29,1922,0.055669694045049484
STAT,1879,47,40-44,1926,0.16850582844052311
STAT,1910,32,20-24,1942,2.2218688334682684
STAT,1848,17,50-100,1865,0.04512791177304288
STAT,1933,9,na,1942,5034.240788875145
STAT,1829,82,na,1911,281.9256946869023
STAT,1874,42,35-39,1916,1.7456879599275879
STAT,1822,88,na,1910,69.758951767094
STAT,1817,51,20-24,1868,0.001626203913014989
STAT,1923,15,50-100,1938,0.4175305440894403
SIM,1929,21,na,1950,4367
STAT,1864,8,na,1872,2350.408647926322
STAT,1892,23,na,1915,2789.7973101563502
STAT,1881,25,50-100,1906,0.587748037734337
SIM,1902,39,na,1941,3122
SIM,1854,49,50-100,1903,1
SIM,1899,61,na,1960,2572
SIM,1910,34,50-100,1944,3
STAT,1892,33,15-19,1925,0.16779283812655016
SIM,1864,48,na,1912,1984
SIM,1909,39,40-44,1948,2
SIM,1869,95,na,1964,56
STAT,1891,40,45-49,1931,1.7668954715388756
STAT,1814,53,45-49,1867,0.041557194771985585
SIM,1900,27,30-34,1927,42
STAT,1849,18,15-19,1867,5.4454921260132405
SIM,1881,34,45-49,1915,1
STAT,1877,40,50-100,1917,1.0456998958305923
SIM,1857,18,15-19,1875,6
SIM,1885,40,50-100,1925,1
SIM,1897,32,30-34,1929,27
STAT,1871,43,25-29,1914,0.5980381964243637
STAT,1922,23,na,1945,3943.9431425808602
STAT,1926,37,na,1963,4343.492914136429
STAT,1825,42,15-19,1867,0.01503666931958167
STAT,1901,38,35-39,1939,2.0087111546501264
SIM,1924,30,45-49,1954,1
STAT,1840,69,na,1909,963.0865838821519
SIM,1824,83,na,1907,182
STAT,1804,52,25-29,1856,0.01251652020694458
STAT,1859,29,15-19,1888,0.3420576002439348
SIM,1860,98,na,1958,8
STAT,1944,22,20-24,1966,113.41762933741543
SIM,1916,51,na,1967,3428
STAT,1876,50,20-24,1926,7.305626235774641E-4
STAT,1893,35,25-29,1928,3.4821168156784816
STAT,1856,54,35-39,1910,0.006171048055222356
STAT,1884,42,20-24,1926,0.14804100523140898
STAT,1804,90,na,1894,26.408949926521032
STAT,1864,32,25-29,1896,8.623983823992798
STAT,1925,43,50-100,1968,0.1341496746238962
SIM,1838,43,30-34,1881,4
SIM,1876,33,na,1909,2319
STAT,1830,41,50-100,1871,0.8333950124690719
STAT,1927,8,na,1935,4684.755560487351
STAT,1860,26,30-34,1886,19.650073964434988
STAT,1817,38,20-24,1855,2.5214982645307047
SIM,1816,38,30-34,1854,1
SIM,1840,41,45-49,1881,4
STAT,1886,7,na,1893,2599.9120037889797
STAT,1840,14,na,1854,2010.0
STAT,1844,28,na,1872,1826.0375786787797
STAT,1944,22,na,1966,3724.8028707817757
STAT,1814,53,na,1867,1282.3516896941053
SIM,1895,56,na,1951,2593
STAT,1839,29,45-49,1868,0.917948628345556
SIM,1880,26,50-100,1906,3
SIM,1883,62,na,1945,1628
STAT,1812,54,25-29,1866,0.010885954360868233
SIM,1883,29,30-34,1912,27
SIM,1884,32,20-24,1916,2
STAT,1837,24,30-34,1861,14.916795650297558
SIM,1929,25,50-100,1954,1
STAT,1875,29,30-34,1904,24.277231151287623
STAT,1884,29,20-24,1913,10.87095049342874
SIM,1875,95,na,1970,97
STAT,1937,25,35-39,1962,13.837779111842874
STAT,1897,34,30-34,1931,21.869444984080204
STAT,1898,24,na,1922,3004.596720851177
SIM,1877,24,25-29,1901,49
SIM,1887,76,na,1963,1194
STAT,1838,53,30-34,1891,0.003932178772147674
STAT,1775,88,na,1863,40.00463864308868
SIM,1860,47,50-100,1907,2
STAT,1945,24,30-34,1969,29.737603854295923
SIM,1848,33,45-49,1881,1
STAT,1875,27,na,1902,2317.3490819681087
STAT,1913,21,30-34,1934,26.39057799071898
STAT,1918,43,25-29,1961,0.07161209471539798
STAT,1924,48,30-34,1972,0.09997874103189344
SIM,1921,21,30-34,1942,37
STAT,1832,41,45-49,1873,1.1212590489483028
STAT,1823,73,na,1896,635.662830301617
SIM,1884,19,20-24,1903,11
SIM,1918,33,25-29,1951,11
SIM,1873,68,na,1941,1424
SIM,1847,29,45-49,1876,1
STAT,1901,37,50-100,1938,0.35041726748367985
SIM,1903,6,na,1909,3506
STAT,1823,35,40-44,1858,7.896673294043694
SIM,1874,23,45-49,1897,1
SIM,1882,24,35-39,1906,9
STAT,1910,48,30-34,1958,0.0783570959034264
SIM,1935,29,40-44,1964,5
STAT,1828,51,50-100,1879,0.012045260829192208
STAT,1848,30,50-100,1878,0.8106223652146464
STAT,1877,23,20-24,1900,67.32107373282643
STAT,1900,18,25-29,1918,7.406816120729503
STAT,1941,24,50-100,1965,0.6419415942417295
SIM,1872,28,40-44,1900,3
SIM,1873,26,35-39,1899,15
SIM,1885,23,20-24,1908,55
STAT,1834,28,30-34,1862,20.345297214696558
STAT,1905,11,na,1916,3531.6639121810285
STAT,1800,102,na,1902,0.11654674371613592
STAT,1897,9,na,1906,3278.0137369814092
STAT,1921,45,50-100,1966,0.24200715279440194
STAT,1891,22,45-49,1913,0.8150163701784655
STAT,1853,48,35-39,1901,0.10462017441851777
STAT,1863,32,30-34,1895,14.474407642037352
STAT,1916,49,35-39,1965,0.12419473560047324
SIM,1945,25,35-39,1970,18
SIM,1953,17,40-44,1970,1
STAT,1865,4,na,1869,2584.473857212854
STAT,1868,73,na,1941,1070.5714925547136
SIM,1901,21,na,1922,3120
SIM,1856,31,30-34,1887,30
SIM,1879,37,40-44,1916,7
SIM,1879,44,30-34,1923,5
SIM,1830,83,na,1913,213
STAT,1926,42,20-24,1968,0.020566923457907088
STAT,1951,20,50-100,1971,0.7431730111368121
STAT,1865,19,45-49,1884,0.05696142194850642
STAT,1873,34,45-49,1907,1.6564767150295037
STAT,1869,31,15-19,1900,0.13086261150614076
STAT,1890,26,40-44,1916,3.4716469396947747
SIM,1867,2,na,1869,2887
STAT,1881,44,45-49,1925,1.3474072317026964
STAT,1907,1,na,1908,3777.2094432387507
STAT,1868,29,40-44,1897,2.6807302955365895
STAT,1811,88,na,1899,59.53888961675499
STAT,1837,17,40-44,1854,0.22423891881377594
SIM,1843,18,20-24,1861,16
STAT,1946,21,40-44,1967,3.5359292898488777
SIM,1814,43,45-49,1857,4
SIM,1887,9,na,1896,2701
STAT,1809,62,na,1871,932.2767659142548
STAT,1841,40,30-34,1881,0.8449816887311054
STAT,1807,51,35-39,1858,0.03218881009586653
STAT,1867,84,na,1951,295.09821754807496
SIM,1898,19,15-19,1917,6
STAT,1938,22,na,1960,3414.3587707485517
SIM,1851,28,20-24,1879,9
SIM,1868,26,25-29,1894,40
SIM,1917,36,na,1953,3682
STAT,1850,20,50-100,1870,0.35003421782820926
STAT,1856,41,30-34,1897,0.8512291917805592
STAT,1817,97,na,1914,2.4864990314358355
SIM,1907,42,na,1949,3236
STAT,1863,70,na,1933,1163.172778337808
STAT,1843,28,20-24,1871,9.681841768541503
STAT,1858,52,20-24,1910,5.436535817228491E-4
SIM,1860,34,25-29,1894,12
STAT,1867,37,25-29,1904,2.554072632016004
STAT,1900,25,15-19,1925,0.5986130267038853
STAT,1841,22,30-34,1863,15.556315416957748
STAT,1820,46,30-34,1866,0.16477649204495592
STAT,1852,54,na,1906,1518.090051564522
SIM,1875,37,25-29,1912,1
STAT,1848,31,30-34,1879,15.28742423361982
SIM,1851,45,50-100,1896,3
STAT,1865,26,35-39,1891,8.290404279547468
STAT,1830,42,25-29,1872,0.4995481829679559
STAT,1842,38,30-34,1880,4.480815440410178
SIM,1900,32,na,1932,3145
STAT,1873,52,45-49,1925,0.01383053282411855
SIM,1842,28,30-34,1870,22
STAT,1852,34,25-29,1886,7.530451282720974
SIM,1850,38,30-34,1888,6
STAT,1813,49,45-49,1862,0.6244552091618677
SIM,1882,42,35-39,1924,6
SIM,1780,75,na,1855,322
STAT,1842,34,15-19,1876,0.12202194505862857
STAT,1912,24,na,1936,3423.9184598836528
STAT,1849,49,20-24,1898,0.00881053630391709
SIM,1881,29,45-49,1910,4
SIM,1884,27,25-29,1911,44
SIM,1888,43,45-49,1931,8
STAT,1851,85,na,1936,197.19667234952254
SIM,1927,23,25-29,1950,112
SIM,1840,35,35-39,1875,11
SIM,1817,70,na,1887,715
STAT,1931,40,40-44,1971,0.31653781101320116
SIM,1820,44,30-34,1864,4
SIM,1913,39,na,1952,3342
STAT,1832,30,40-44,1862,3.4992700881391667
SIM,1854,22,30-34,1876,20
SIM,1900,63,na,1963,2547
STAT,1900,31,45-49,1931,2.2946259039430346
STAT,1856,45,50-100,1901,0.18283106168447072
STAT,1859,65,na,1924,1270.666796526089
STAT,1837,42,30-34,1879,0.8804516519976293
STAT,1921,16,40-44,1937,1.5098682080623997
SIM,1866,39,20-24,1905,1
STAT,1915,36,15-19,1951,0.0184149710191091
SIM,1835,82,na,1917,281
STAT,1855,99,na,1954,1.3458324339636394
STAT,1878,25,30-34,1903,24.960296781760988
SIM,1868,23,20-24,1891,65
STAT,1846,48,40-44,1894,0.12538418744111174
STAT,1823,66,na,1889,880.6089869000178
SIM,1876,80,na,1956,574
SIM,1891,1,na,1892,3149
STAT,1878,48,40-44,1926,0.16643209088688019
SIM,1940,17,na,1957,3435
SIM,1794,95,na,1889,2
STAT,1886,37,50-100,1923,1.2251772603055688
SIM,1920,18,40-44,1938,1
STAT,1876,27,25-29,1903,41.286389766665955
STAT,1812,44,30-34,1856,4.046590787610793
SIM,1871,33,na,1904,2270
STAT,1824,31,45-49,1855,4.970699646354213
STAT,1897,45,35-39,1942,0.10076608090176445
STAT,1873,29,45-49,1902,1.0561943287829483
STAT,1854,51,50-100,1905,0.010857492683135262
SIM,1880,10,na,1890,2638
STAT,1937,31,40-44,1968,3.6596721235585776
STAT,1903,32,25-29,1935,13.767619663543513
STAT,1881,20,30-34,1901,16.352595571359554
STAT,1881,21,20-24,1902,63.07986027446861
STAT,1907,61,na,1968,2848.4306483590813
STAT,1846,22,30-34,1868,16.301089683232103
SIM,1886,25,30-34,1911,32
STAT,1896,60,na,1956,2401.286804464567
SIM,1856,26,35-39,1882,10
SIM,1862,84,na,1946,235
STAT,1945,20,15-19,1965,5.515272134753202
SIM,1896,33,25-29,1929,14
SIM,1840,30,40-44,1870,6
SIM,1790,81,na,1871,155
SIM,1923,29,25-29,1952,73
SIM,1866,50,na,1916,1925
STAT,1920,43,na,1963,3868.7871526566164
STAT,1825,49,35-39,1874,0.13891228056052354
STAT,1916,44,50-100,1960,0.11335379956608956
STAT,1855,34,25-29,1889,7.2588612997904
STAT,1911,31,20-24,1942,2.253060708945977
SIM,1830,52,na,1882,1324
SIM,1828,32,30-34,1860,20
SIM,1918,37,40-44,1955,4
STAT,1923,41,45-49,1964,0.1840269871170433
STAT,1840,20,20-24,1860,58.34677142184736
SIM,1845,24,30-34,1869,21
STAT,1878,21,15-19,1899,3.257762982361188
STAT,1880,29,40-44,1909,2.962063696966026
SIM,1832,31,45-49,1863,1
SIM,1910,30,20-24,1940,1
STAT,1936,34,30-34,1970,14.437779814803044
SIM,1949,19,40-44,1968,3
STAT,1860,40,45-49,1900,1.1587647301519761
SIM,1893,76,na,1969,1715
STAT,1837,47,40-44,1884,0.11533860529419446
SIM,1833,96,na,1929,4
SIM,1822,53,na,1875,1263
SIM,1896,42,40-44,1938,1
STAT,1851,32,15-19,1883,0.1066216355175811
STAT,1953,4,na,1957,4494.015449378953
SIM,1821,38,40-44,1859,4
STAT,1838,49,45-49,1887,0.15888131881245923
STAT,1873,36,35-39,1909,6.809284886632443
STAT,1921,49,20-24,1970,0.011700079007953347
SIM,1892,29,20-24,1921,15
STAT,1888,42,40-44,1930,2.5081083001061257
STAT,1936,6,na,1942,3624.9794552345206
STAT,1816,44,15-19,1860,0.03407556457861462
SIM,1857,39,30-34,1896,7
STAT,1943,16,na,1959,3688.3314055568453
SIM,1877,21,20-24,1898,60
SIM,1911,32,25-29,1943,8
STAT,1848,102,na,1950,0.21784602837139883
SIM,1857,14,na,1871,2217
SIM,1929,6,na,1935,4791
SIM,1822,37,40-44,1859,3
STAT,1891,13,na,1904,3013.7097067807063
STAT,1912,18,40-44,1930,0.2665030822853778
STAT,1919,30,15-19,1949,0.13202670046063256
SIM,1885,57,na,1942,1919
STAT,1851,39,35-39,1890,5.036649252250381
STAT,1918,49,na,1967,3671.660701106856
SIM,1869,3,na,1872,2765
SIM,1927,35,na,1962,4390
STAT,1811,44,50-100,1855,3.695451990120037
STAT,1869,28,40-44,1897,2.731858367801759
SIM,1926,6,na,1932,4563
STAT,1787,73,na,1860,468.3144397504917
STAT,1866,54,20-24,1920,6.252837822451572E-4
STAT,1924,40,45-49,1964,0.18752885674590913
STAT,1910,49,45-49,1959,0.19044559387650936
STAT,1953,15,25-29,1968,49.54759283818176
STAT,1841,33,35-39,1874,8.383405919374312
SIM,1843,26,25-29,1869,43
STAT,1852,52,25-29,1904,0.0025542403648605005
SIM,1805,85,na,1890,75
STAT,1817,54,25-29,1871,0.007351481054064888
SIM,1929,21,30-34,1950,37
STAT,1869,21,20-24,1890,63.2583951408647
STAT,1838,28,na,1866,1834.142606137344
SIM,1880,32,35-39,1912,17
SIM,1831,23,25-29,1854,49
STAT,1860,18,30-34,1878,1.4007313491320064
STAT,1881,28,40-44,1909,2.724148213795759
SIM,1843,15,na,1858,2159
STAT,1900,39,na,1939,3080.5616978635753
SIM,1818,48,na,1866,1316
STAT,1896,1,na,1897,3396.0331800218255
SIM,1897,27,35-39,1924,17
SIM,1813,41,35-39,1854,2
STAT,1874,49,30-34,1923,0.09148280257153309
STAT,1915,24,50-100,1939,0.6385361128562467
STAT,1864,26,50-100,1890,0.5404512841235132
SIM,1844,16,15-19,1860,6
SIM,1864,95,na,1959,17
STAT,1826,29,35-39,1855,19.214575485898237
STAT,1846,49,50-100,1895,0.17835904165916877
STAT,1835,51,na,1886,1424.5083615582828
STAT,1877,93,na,1970,118.51322511719651
SIM,1845,42,30-34,1887,6
SIM,1855,44,na,1899,1843
STAT,1840,109,na,1949,4.669009176137072E-4
STAT,1872,46,na,1918,2137.9508039290336
SIM,1777,92,na,1869,6
SIM,1878,41,30-34,1919,1
SIM,1929,16,35-39,1945,8
STAT,1912,46,50-100,1958,0.2058649695016257
STAT,1884,45,25-29,1929,0.05429522966518837
STAT,1942,18,30-34,1960,12.029559931786084
SIM,1889,56,na,1945,2432
STAT,1851,46,25-29,1897,0.04155179337152128
STAT,1857,32,50-100,1889,0.6868734027504114
STAT,1889,27,35-39,1916,11.253109723419179
SIM,1950,18,30-34,1968,14
STAT,1871,40,20-24,1911,0.15048134889221304
STAT,1889,19,na,1908,2929.7043175977838
STAT,1919,23,25-29,1942,95.25674995228742
STAT,1947,15,na,1962,3919.1279721790015
STAT,1900,47,30-34,1947,0.07122421197748358
STAT,1887,41,30-34,1928,1.2203332176510753
SIM,1902,43,na,1945,3056
STAT,1852,26,25-29,1878,35.97854892559853
STAT,1930,42,na,1972,4616.235429556445
SIM,1772,89,na,1861,25
SIM,1830,36,40-44,1866,8
STAT,1848,80,na,1928,459.65293787625274
STAT,1884,32,na,1916,2227.1935394298685
SIM,1858,29,20-24,1887,12
STAT,1789,84,na,1873,96.86564196855379
STAT,1835,26,25-29,1861,35.34282535694136
STAT,1896,32,20-24,1928,3.3725670394371465
STAT,1856,42,45-49,1898,1.101782101729947
SIM,1898,21,40-44,1919,2
SIM,1889,20,25-29,1909,66
STAT,1904,25,na,1929,3255.8132485764745
SIM,1820,39,35-39,1859,11
STAT,1837,48,50-100,1885,0.1633560553413599
SIM,1924,28,30-34,1952,56
STAT,1812,82,na,1894,202.67756015463394
STAT,1849,39,30-34,1888,4.005404008343586
STAT,1856,35,50-100,1891,0.913536276801523
STAT,1890,75,na,1965,1484.6888766763784
STAT,1898,20,25-29,1918,73.6205692222441
STAT,1916,28,30-34,1944,38.13808602893661
SIM,1881,22,25-29,1903,58
STAT,1832,28,45-49,1860,0.8983246292347858
STAT,1873,51,30-34,1924,0.0057305115677031716
SIM,1790,74,na,1864,373
STAT,1866,46,na,1912,1965.8999842034773
SIM,1880,27,40-44,1907,2
SIM,1810,90,na,1900,35
STAT,1872,32,35-39,1904,9.596177430990208
STAT,1941,19,25-29,1960,42.13905713460846
SIM,1919,41,40-44,1960,2
STAT,1827,59,na,1886,1175.7125309668875
STAT,1856,13,na,1869,2071.1421904754447
SIM,1838,28,40-44,1866,3
SIM,1881,36,35-39,1917,11
STAT,1904,18,50-100,1922,0.06621282545222619
SIM,1815,74,na,1889,493
SIM,1878,15,30-34,1893,5
SIM,1840,28,45-49,1868,2
STAT,1853,52,20-24,1905,5.554815944562336E-4
STAT,1953,15,na,1968,4208.421353396473
SIM,1854,58,na,1912,1591
STAT,1816,101,na,1917,0.26591155688260193
SIM,1860,26,25-29,1886,39
STAT,1883,35,15-19,1918,0.05250506154149975
STAT,1878,43,30-34,1921,1.1236956673531848
STAT,1884,31,na,1915,2236.2952611427195
SIM,1911,11,na,1922,3734
STAT,1911,36,30-34,1947,1.6710731487880073
STAT,1887,49,40-44,1936,0.09991449574713292
STAT,1904,23,30-34,1927,24.062066001926233
SIM,1841,15,35-39,1856,1
STAT,1937,16,na,1953,3391.055221836641
SIM,1831,37,na,1868,1605
SIM,1882,3,na,1885,2689
STAT,1866,47,30-34,1913,0.083950688150568
STAT,1927,25,25-29,1952,76.10441711370663
STAT,1872,15,35-39,1887,0.5278544087938305
STAT,1893,4,na,1897,3151.636672136893
SIM,1886,43,30-34,1929,1
STAT,1860,54,25-29,1914,0.002640326792862745
SIM,1784,74,na,1858,364
STAT,1931,27,na,1958,4568.882559293727
STAT,1897,19,40-44,1916,0.22983728538057457
STAT,1829,41,20-24,1870,0.13760885029322986
SIM,1849,21,45-49,1870,2
STAT,1842,52,45-49,1894,0.01045368506356294
SIM,1904,24,35-39,1928,8
SIM,1855,43,na,1898,1858
SIM,1862,39,40-44,1901,8
STAT,1915,29,25-29,1944,62.970225889956126
STAT,1804,63,na,1867,886.0272272154768
STAT,1872,47,na,1919,2121.958931915644
SIM,1903,26,40-44,1929,4
STAT,1840,27,40-44,1867,2.4511426153892053
STAT,1888,47,35-39,1935,0.15557405898685672
SIM,1906,57,na,1963,2890
STAT,1845,29,50-100,1874,0.5430902276790424
SIM,1889,25,35-39,1914,10
STAT,1811,51,25-29,1862,0.0115046805326424
STAT,1840,25,50-100,1865,0.5310313258043008
SIM,1909,17,25-29,1926,10
STAT,1898,46,15-19,1944,2.892727808167287E-4
STAT,1812,51,20-24,1863,0.0024084758153351503
STAT,1825,52,na,1877,1268.015534501536
STAT,1877,26,25-29,1903,41.59488257336985
STAT,1857,94,na,1951,14.890846897870317
STAT,1888,33,25-29,1921,11.38708020383006
STAT,1916,46,30-34,1962,0.08659283616937799
SIM,1830,31,30-34,1861,15
SIM,1866,43,na,1909,2057
STAT,1905,20,40-44,1925,2.862406738939656
STAT,1896,31,30-34,1927,21.87325935801865
STAT,1861,16,25-29,1877,5.146385570037401
STAT,1887,23,30-34,1910,18.763800057452283
SIM,1823,97,na,1920,1
SIM,1904,62,na,1966,2759
SIM,1838,47,na,1885,1532
STAT,1814,102,na,1916,0.1347508549855384
SIM,1895,23,30-34,1918,30
SIM,1863,31,20-24,1894,2
STAT,1846,26,50-100,1872,0.5781330645692633
SIM,1867,19,20-24,1886,17
SIM,1879,29,40-44,1908,5
STAT,1827,40,50-100,1867,1.0489608819926302
SIM,1814,40,40-44,1854,6
STAT,1916,22,45-49,1938,1.113820620905364
STAT,1900,29,30-34,1929,32.76512788572142
STAT,1853,80,na,1933,468.151277847203
SIM,1935,25,25-29,1960,78
STAT,1832,53,35-39,1885,0.005305991347194796
SIM,1857,20,40-44,1877,1
STAT,1852,19,35-39,1871,0.47548094910442285
STAT,1822,36,40-44,1858,8.123038438694048
STAT,1829,40,30-34,1869,1.0118980545676362
SIM,1885,26,25-29,1911,50
STAT,1957,0,na,1957,4932.663167647093
STAT,1890,29,45-49,1919,1.2731968700218843
STAT,1921,23,30-34,1944,30.57256127494795
SIM,1922,40,40-44,1962,1
SIM,1853,39,50-100,1892,4
SIM,1840,21,25-29,1861,53
STAT,1823,38,45-49,1861,3.0615768484414425
STAT,1888,40,15-19,1928,0.015573532400038939
SIM,1881,31,40-44,1912,4
SIM,1887,21,na,1908,2484
STAT,1897,40,40-44,1937,0.19932432584544152
STAT,1903,44,50-100,1947,0.09727889883621857
STAT,1878,31,na,1909,2358.9734097595447
STAT,1846,40,30-34,1886,0.8854360380016246
SIM,1794,67,na,1861,647
SIM,1831,38,45-49,1869,3
STAT,1831,31,35-39,1862,8.186620437941947
STAT,1915,42,45-49,1957,0.15829335748136342
SIM,1810,68,na,1878,760
STAT,1876,19,20-24,1895,17.210338580777893
STAT,1969,2,na,1971,4643.262303919247
STAT,1832,81,na,1913,325.7573022180773
STAT,1892,44,20-24,1936,0.012873102395513838
SIM,1828,49,50-100,1877,1
SIM,1825,44,50-100,1869,3
SIM,1939,20,na,1959,3408
SIM,1803,89,na,1892,34
SIM,1913,20,40-44,1933,3
STAT,1930,4,na,1934,4929.4699174292045
STAT,1908,2,na,1910,3735.63517484555
STAT,1832,35,35-39,1867,5.523824421649904
STAT,1941,26,15-19,1967,0.6902070410967728
STAT,1777,99,na,1876,0.30557669101803814
STAT,1843,21,50-100,1864,0.3482347575520766
STAT,1896,39,40-44,1935,5.406776474993596
STAT,1903,40,na,1943,3148.84268751184
SIM,1870,17,na,1887,2343
STAT,1825,53,20-24,1878,7.111609804127773E-4
SIM,1903,2,na,1905,3557
SIM,1862,29,na,1891,2007
STAT,1873,31,40-44,1904,4.172051082694848
SIM,1949,17,15-19,1966,40
STAT,1836,95,na,1931,8.609746154817064
STAT,1825,46,30-34,1871,0.10012155044269064
SIM,1858,1,na,1859,2876
SIM,1854,25,35-39,1879,14
STAT,1831,51,50-100,1882,0.009653864855792097
STAT,1938,21,30-34,1959,26.881369410889526
SIM,1844,25,25-29,1869,36
STAT,1904,16,40-44,1920,0.24845266867904678
SIM,1883,83,na,1966,563
STAT,1819,52,na,1871,1317.7559662481751
SIM,1858,95,na,1953,7
SIM,1877,28,40-44,1905,3
STAT,1892,37,30-34,1929,6.306224580546088
SIM,1840,41,na,1881,1606
STAT,1875,39,20-24,1914,0.7409722041683836
STAT,1899,34,na,1933,3062.401956219363
SIM,1810,75,na,1885,409
SIM,1933,38,na,1971,4881
SIM,1840,32,30-34,1872,18
SIM,1848,24,35-39,1872,8
SIM,1835,67,na,1902,998
STAT,1873,22,25-29,1895,54.84784890275254
STAT,1855,25,50-100,1880,0.5282467688013603
STAT,1859,19,20-24,1878,15.291500044437335
STAT,1897,43,45-49,1940,0.13035452935795838
STAT,1887,43,35-39,1930,1.899636092914351
SIM,1881,26,40-44,1907,2
SIM,1888,40,40-44,1928,6
STAT,1851,14,na,1865,2068.9377432889673
SIM,1930,20,40-44,1950,3
SIM,1871,32,30-34,1903,23
SIM,1804,90,na,1894,34
SIM,1853,48,na,1901,1679
STAT,1852,31,20-24,1883,2.0501936033151362
STAT,1805,108,na,1913,6.394116505739938E-4
SIM,1815,78,na,1893,384
STAT,1914,21,45-49,1935,1.0452589450729697
STAT,1860,22,15-19,1882,2.606763321467354
STAT,1906,21,na,1927,3263.903731934553
SIM,1871,98,na,1969,13
SIM,1886,8,na,1894,2562
STAT,1901,17,30-34,1918,2.107640252919521
SIM,1908,21,15-19,1929,5
SIM,1888,61,na,1949,2110
STAT,1879,52,40-44,1931,0.010355089905203167
SIM,1863,25,50-100,1888,1
SIM,1939,16,na,1955,3418
STAT,1855,31,20-24,1886,1.9762522119132193
STAT,1865,31,30-34,1896,15.011261351242888
STAT,1876,61,na,1937,1823.7972855894366
SIM,1927,20,20-24,1947,131
STAT,1835,19,35-39,1854,0.9160660569061424
STAT,1829,48,50-100,1877,0.19812999578336302
STAT,1883,50,40-44,1933,0.009890973504557766
STAT,1832,32,30-34,1864,13.781216611406618
STAT,1949,19,50-100,1968,0.4113765173621943
SIM,1906,36,na,1942,3275
STAT,1837,20,15-19,1857,2.911872865726618
STAT,1920,32,25-29,1952,9.563864322542372
SIM,1848,62,na,1910,1285
STAT,1862,19,40-44,1881,0.15216361060945835
SIM,1867,28,na,1895,2282
STAT,1851,43,20-24,1894,0.11341578460901272
SIM,1863,14,na,1877,2234
SIM,1946,21,30-34,1967,37
STAT,1846,25,35-39,1871,8.783451211581324
STAT,1906,29,20-24,1935,16.025983260142077
STAT,1802,67,na,1869,754.6861907663101
STAT,1836,25,25-29,1861,35.96039795956093
STAT,1875,51,45-49,1926,0.014159190716560719
STAT,1910,46,40-44,1956,0.13931380111924985
STAT,1926,15,30-34,1941,14.18277574993947
STAT,1824,33,35-39,1857,21.517146389598143
STAT,1838,66,na,1904,1100.349713088625
STAT,1924,44,15-19,1968,0.001719838972381386
STAT,1922,20,40-44,1942,3.6643371194090544
SIM,1822,33,25-29,1855,14
SIM,1827,63,na,1890,961
STAT,1813,51,50-100,1864,0.040283674916874714
STAT,1834,32,15-19,1866,0.11320552580634537
SIM,1832,33,35-39,1865,9
SIM,1885,17,15-19,1902,6
SIM,1851,29,na,1880,1862
SIM,1860,31,20-24,1891,4
STAT,1843,81,na,1924,365.25759990023164
STAT,1869,27,na,1896,2184.1208903432084
STAT,1921,19,45-49,1940,0.5350326396092328
STAT,1947,25,50-100,1972,1.064752191889154
STAT,1842,50,40-44,1892,0.007733496508300637
STAT,1830,38,40-44,1868,3.5086340172317483
STAT,1832,50,30-34,1882,0.0038933054932594182
STAT,1843,18,30-34,1861,1.3676839247490173
SIM,1914,29,20-24,1943,17
STAT,1854,42,30-34,1896,0.8215576835653483
STAT,1902,47,45-49,1949,0.17665719779218456
SIM,1851,18,30-34,1869,1
SIM,1931,24,na,1955,4418
SIM,1814,42,30-34,1856,4
SIM,1942,3,na,1945,3893
STAT,1834,50,45-49,1884,0.009607837716319054
STAT,1919,20,20-24,1939,115.71219259997781
STAT,1883,46,na,1929,2089.7489881958504
STAT,1910,39,50-100,1949,0.37553321313605703
SIM,1845,20,15-19,1865,2
STAT,1849,54,20-24,1903,5.381255922571991E-4
STAT,1912,43,50-100,1955,0.10640064168410236
SIM,1876,32,45-49,1908,1
STAT,1873,33,30-34,1906,16.657814018262222
STAT,1911,39,35-39,1950,2.1848574043522793
STAT,1817,66,na,1883,848.0545011388708
STAT,1868,27,15-19,1895,0.4089412066272543
STAT,1901,39,25-29,1940,0.8134978286627363
STAT,1868,32,45-49,1900,1.5717803822088432
STAT,1930,18,50-100,1948,0.4563746804512338
SIM,1906,29,25-29,1935,58
STAT,1814,52,na,1866,1308.0015582807498
STAT,1870,19,50-100,1889,0.04529793174578151
SIM,1880,47,na,1927,2273
STAT,1850,23,35-39,1873,4.901868268432888
SIM,1878,23,30-34,1901,16
STAT,1840,23,25-29,1863,47.43212854341992
SIM,1925,33,50-100,1958,1
STAT,1767,105,na,1872,0.01742097053842711
STAT,1849,101,na,1950,0.42789237314910444
SIM,1916,10,na,1926,3897
STAT,1828,52,30-34,1880,0.004654264913767458
STAT,1891,24,35-39,1915,6.777702725078602
STAT,1803,53,na,1856,1120.547950792852
STAT,1881,24,25-29,1905,51.91566880053123
SIM,1870,15,25-29,1885,3
SIM,1880,15,35-39,1895,2
SIM,1922,21,45-49,1943,3
STAT,1807,67,na,1874,803.8016896085962
SIM,1921,24,35-39,1945,14
STAT,1917,33,50-100,1950,0.8144577524480131
SIM,1836,27,40-44,1863,3
STAT,1913,47,20-24,1960,0.010190215148657705
STAT,1821,34,na,1855,1484.9892187374503
STAT,1849,27,50-100,1876,0.5686213890380605
STAT,1901,31,15-19,1932,0.18908118581483144
STAT,1914,37,50-100,1951,0.39602568467956506
STAT,1850,41,35-39,1891,1.2822607704984645
SIM,1901,58,na,1959,2694
STAT,1808,48,20-24,1856,0.04472749746121219
STAT,1901,35,30-34,1936,1.5355925817135239
STAT,1903,28,40-44,1931,4.012320701262243
SIM,1945,23,na,1968,3643
STAT,1873,54,35-39,1927,0.008021636865393896
STAT,1847,32,25-29,1879,8.868149847599938
STAT,1895,43,30-34,1938,0.0976147986715945
SIM,1836,34,30-34,1870,16
STAT,1913,24,35-39,1937,8.926450671082737
STAT,1869,24,25-29,1893,52.06260566679627
STAT,1925,21,20-24,1946,126.11420569340662
STAT,1856,18,40-44,1874,0.15846958021009208
STAT,1851,36,30-34,1887,3.915294731100445
SIM,1933,21,20-24,1954,143
STAT,1893,32,20-24,1925,3.2383391315854873
STAT,1895,25,30-34,1920,31.22440408674799
SIM,1911,28,40-44,1939,5
SIM,1918,19,40-44,1937,2
SIM,1855,32,25-29,1887,15
STAT,1810,45,25-29,1855,0.19865631701041014
STAT,1852,36,15-19,1888,0.04135943007514815
SIM,1876,25,25-29,1901,41
STAT,1828,34,30-34,1862,16.866953310315154
SIM,1854,42,35-39,1896,5
SIM,1881,33,30-34,1914,18
STAT,1826,41,20-24,1867,0.15832268164924435
SIM,1885,0,na,1885,3239
STAT,1910,47,40-44,1957,0.13896830289247408
SIM,1947,0,na,1947,4315
STAT,1891,42,35-39,1933,2.113839478929324
SIM,1916,16,25-29,1932,10
SIM,1937,32,45-49,1969,1
STAT,1892,47,25-29,1939,0.03826598496589518
STAT,1821,52,25-29,1873,0.00537176367586336
SIM,1831,30,na,1861,1708
STAT,1846,42,35-39,1888,1.3593470041138362
STAT,1887,26,50-100,1913,0.6782725955147444
SIM,1944,27,40-44,1971,5
STAT,1870,76,na,1946,878.0170289139897
STAT,1832,25,40-44,1857,2.529537526222181
STAT,1822,39,45-49,1861,3.1473337010720708
STAT,1830,48,na,1878,1438.8882189752744
STAT,1859,23,50-100,1882,0.31583803614764683
STAT,1918,39,40-44,1957,1.4874368002779836
STAT,1934,21,50-100,1955,0.8356369513373579
SIM,1844,29,40-44,1873,4
SIM,1830,39,45-49,1869,1
SIM,1908,25,30-34,1933,41
STAT,1896,35,25-29,1931,3.6264492145013216
SIM,1869,94,na,1963,78
STAT,1859,39,40-44,1898,3.258276366417734
SIM,1903,29,45-49,1932,2
STAT,1828,27,40-44,1855,5.172122129939191
STAT,1906,28,20-24,1934,16.08453095281032
SIM,1914,28,20-24,1942,15
STAT,1815,41,45-49,1856,3.9651325461028026
STAT,1829,51,na,1880,1400.617853590326
STAT,1874,16,35-39,1890,0.5309276785940708
STAT,1883,51,40-44,1934,0.009797503804939696
STAT,1829,44,25-29,1873,0.530957330877592
STAT,1882,32,45-49,1914,1.6020762393784775
STAT,1813,67,na,1880,772.4263398303164
SIM,1791,102,na,1893,1
STAT,1836,29,40-44,1865,2.4741737305637708
STAT,1860,51,20-24,1911,5.68328637048916E-4
SIM,1824,82,na,1906,212
STAT,1844,99,na,1943,1.3153355082907072
STAT,1897,38,na,1935,2961.736604883563
STAT,1921,26,35-39,1947,15.861449189285944
SIM,1886,21,15-19,1907,3
STAT,1805,104,na,1909,0.02328341638812437
SIM,1839,81,na,1920,335
STAT,1834,38,20-24,1872,0.5889033097440022
STAT,1912,17,na,1929,3689.6590543192106
SIM,1898,24,45-49,1922,1
STAT,1936,27,40-44,1963,4.213882498281178
STAT,1887,44,35-39,1931,1.8876303928071332
SIM,1831,43,45-49,1874,2
STAT,1845,49,40-44,1894,0.11861662007846696
SIM,1859,36,25-29,1895,2
SIM,1879,57,na,1936,2033
STAT,1824,51,35-39,1875,0.010306103478407203
STAT,1895,18,40-44,1913,0.22467297916407178
STAT,1867,42,20-24,1909,0.1407061096000364
STAT,1893,37,15-19,1930,0.06727471802591772
STAT,1867,47,15-19,1914,3.531766833486923E-4
SIM,1965,4,na,1969,4599
STAT,1862,15,25-29,1877,5.3044832106328395
STAT,1838,108,na,1946,0.0012297279214510582
STAT,1890,34,45-49,1924,1.9968114875885754
STAT,1830,52,na,1882,1348.6471746598772
STAT,1860,28,20-24,1888,9.023363964244243
STAT,1808,52,na,1860,1208.7539772445205
STAT,1843,44,25-29,1887,0.43528955631368005
STAT,1839,41,30-34,1880,0.8979669296436003
SIM,1846,66,na,1912,1152
STAT,1769,85,na,1854,63.0
STAT,1842,33,na,1875,1876.3924405218502
STAT,1929,32,45-49,1961,1.8881768403539583
STAT,1857,45,15-19,1902,3.0099531885492903E-4
STAT,1823,43,45-49,1866,1.9425237454046698
STAT,1907,40,45-49,1947,0.1456815047633616
SIM,1878,13,na,1891,2616
STAT,1838,51,40-44,1889,0.0071709102295863195
STAT,1841,108,na,1949,0.001262812092174672
STAT,1870,52,50-100,1922,0.013922132225608699
SIM,1896,37,40-44,1933,7
STAT,1908,16,25-29,1924,7.960813311734496
STAT,1949,19,15-19,1968,49.83141888682015
STAT,1822,50,50-100,1872,0.020337590364160746
STAT,1826,46,15-19,1872,3.743580940467773E-4
STAT,1894,15,25-29,1909,6.911652673624812
STAT,1850,99,na,1949,1.335031153679917
SIM,1767,93,na,1860,4
SIM,1872,44,45-49,1916,6
STAT,1821,93,na,1914,15.570299174943523
SIM,1818,39,40-44,1857,3
SIM,1863,34,25-29,1897,2
STAT,1843,18,na,1861,1969.6967940376314
SIM,1862,24,30-34,1886,20
SIM,1835,24,25-29,1859,41
STAT,1846,43,35-39,1889,1.3420425167514665
STAT,1884,19,30-34,1903,1.4796137238816207
STAT,1861,53,50-100,1914,0.011672542121765847
STAT,1827,31,45-49,1858,2.183684814869531
STAT,1848,26,35-39,1874,8.621183297693394
SIM,1828,35,35-39,1863,12
SIM,1854,43,35-39,1897,5
STAT,1831,96,na,1927,5.013625714805185
STAT,1762,97,na,1859,0.4298982621670083
STAT,1833,48,30-34,1881,0.06250342847041254
SIM,1907,31,20-24,1938,2
STAT,1882,61,na,1943,1716.7442087932418
STAT,1939,15,40-44,1954,1.3259170614854257
STAT,1905,38,50-100,1943,0.36005779741578875
STAT,1854,24,30-34,1878,14.759989471935823
SIM,1907,43,na,1950,3213
STAT,1865,52,35-39,1917,0.007332403166504891
SIM,1891,10,na,1901,3068
SIM,1900,11,na,1911,3447
SIM,1904,21,30-34,1925,26
STAT,1812,54,50-100,1866,0.046416500171707696
STAT,1888,44,30-34,1932,1.2662195991956908
SIM,1892,19,30-34,1911,4
SIM,1861,44,na,1905,1983
SIM,1866,28,na,1894,2106
STAT,1844,66,na,1910,1138.331367605164
SIM,1850,44,na,1894,1707
STAT,1894,22,45-49,1916,0.8465828819444369
SIM,1925,24,na,1949,4064
STAT,1849,23,45-49,1872,0.6276615597195618
STAT,1864,44,45-49,1908,1.2431194257457916
SIM,1921,10,na,1931,4303
SIM,1904,25,na,1929,3311
STAT,1927,22,20-24,1949,129.41862019840173
SIM,1895,26,35-39,1921,16
SIM,1936,35,35-39,1971,3
STAT,1841,31,45-49,1872,1.4738668238193282
SIM,1873,34,35-39,1907,8
SIM,1947,15,40-44,1962,1
SIM,1863,38,40-44,1901,3
SIM,1935,22,20-24,1957,131
STAT,1854,17,40-44,1871,0.1565450426715942
SIM,1845,81,na,1926,349
STAT,1848,19,45-49,1867,0.059463827405845965
STAT,1875,33,15-19,1908,0.13769639945245304
SIM,1869,49,50-100,1918,3
STAT,1887,26,35-39,1913,10.230860731243684
SIM,1897,42,na,1939,3000
SIM,1926,39,40-44,1965,2
STAT,1846,50,25-29,1896,0.0026648773265025103
SIM,1835,31,45-49,1866,1
SIM,1845,29,na,1874,1825
STAT,1930,0,na,1930,5502.204689829036
SIM,1840,25,40-44,1865,2
STAT,1916,42,15-19,1958,0.001486695708207138
STAT,1861,62,na,1923,1435.6593110869867
STAT,1928,35,35-39,1963,2.892664432444875
SIM,1912,34,35-39,1946,6
STAT,1909,47,30-34,1956,0.07738808128445256
STAT,1833,29,na,1862,1723.987945882095
STAT,1942,21,50-100,1963,0.6519687515494949
SIM,1821,41,30-34,1862,7
SIM,1930,23,45-49,1953,1
SIM,1933,24,25-29,1957,122
STAT,1828,37,35-39,1865,6.457236964044506
SIM,1830,32,25-29,1862,9
SIM,1895,19,na,1914,3199
SIM,1901,20,15-19,1921,4
STAT,1814,48,50-100,1862,0.7387775915984749
STAT,1871,68,na,1939,1433.5597869475348
SIM,1878,43,35-39,1921,3
SIM,1924,24,15-19,1948,5
STAT,1859,32,20-24,1891,2.032404248553756
SIM,1846,44,50-100,1890,1
SIM,1884,31,na,1915,2344
STAT,1900,60,na,1960,2605.114801899671
STAT,1901,23,50-100,1924,0.5375720729890334
SIM,1834,82,na,1916,265
STAT,1906,20,25-29,1926,79.23440858542264
STAT,1788,102,na,1890,0.0790935552673118
STAT,1880,32,30-34,1912,17.388741232019214
SIM,1858,34,20-24,1892,2
SIM,1835,38,50-100,1873,1
SIM,1937,26,35-39,1963,14
SIM,1851,22,15-19,1873,2
STAT,1852,47,50-100,1899,0.17722651570645093
STAT,1874,22,45-49,1896,0.6730711005951476
STAT,1853,43,na,1896,1736.5019261593493
STAT,1839,34,45-49,1873,1.3994197408522895
STAT,1886,39,35-39,1925,6.987104765400051
STAT,1898,17,na,1915,3228.7843966528712
SIM,1892,41,45-49,1933,1
STAT,1916,24,15-19,1940,5.236490587218074
SIM,1910,25,na,1935,3422
STAT,1829,104,na,1933,0.04030253642285757
STAT,1834,48,15-19,1882,2.5991211390123025E-4
STAT,1918,47,40-44,1965,0.15850029402833968
SIM,1795,84,na,1879,91
SIM,1886,32,na,1918,2330
SIM,1917,45,50-100,1962,3
STAT,1853,21,45-49,1874,0.6280448909768586
STAT,1920,28,40-44,1948,4.813223678683919
SIM,1915,33,20-24,1948,2
STAT,1836,45,30-34,1881,0.06730385960983595
STAT,1949,21,45-49,1970,1.2407757946489457
STAT,1819,48,35-39,1867,0.2612979321859099
STAT,1907,33,20-24,1940,2.1447977548430526
STAT,1856,31,40-44,1887,3.2694061936217422
STAT,1840,21,35-39,1861,4.905304480571301
STAT,1931,15,50-100,1946,0.4654104638796622
STAT,1951,21,15-19,1972,6.010104551117136
STAT,1868,48,30-34,1916,0.08615361854178
STAT,1845,45,25-29,1890,0.04116577477745669
STAT,1847,24,25-29,1871,51.00897105429064
STAT,1904,34,35-39,1938,7.812138991969408
SIM,1867,99,na,1966,6
STAT,1908,18,30-34,1926,2.2277841573579935
SIM,1929,22,50-100,1951,3
STAT,1813,41,30-34,1854,4.069683553380452
STAT,1922,23,45-49,1945,1.215186822297844
STAT,1925,24,25-29,1949,103.79387819397196
SIM,1864,22,25-29,1886,46
SIM,1872,46,na,1918,2131
SIM,1899,28,30-34,1927,33
STAT,1875,25,15-19,1900,0.443540671354903
STAT,1895,28,35-39,1923,11.841777418008848
SIM,1822,87,na,1909,80
STAT,1894,38,30-34,1932,6.438278013283823
STAT,1864,21,20-24,1885,59.38178435419206
STAT,1869,35,50-100,1904,1.1342883530754582
STAT,1917,18,40-44,1935,0.2836035685672689
STAT,1812,57,na,1869,1116.2493780045527
SIM,1802,71,na,1873,557
SIM,1872,21,20-24,1893,68
SIM,1925,18,40-44,1943,1
SIM,1797,85,na,1882,64
STAT,1872,33,35-39,1905,9.555681562231424
STAT,1825,54,50-100,1879,0.014268727761258168
STAT,1948,15,na,1963,3981.5803753819227
SIM,1865,74,na,1939,918
SIM,1903,36,35-39,1939,6
SIM,1920,33,30-34,1953,28
STAT,1871,32,20-24,1903,2.5356645321637123
STAT,1855,44,na,1899,1620.2589311195
STAT,1856,22,25-29,1878,49.004929518961404
STAT,1923,33,na,1956,4093.3743722682
STAT,1921,31,30-34,1952,16.631004523008702
SIM,1855,24,25-29,1879,63
STAT,1848,32,45-49,1880,1.5110878499228344
STAT,1849,21,40-44,1870,1.9028706685423953
STAT,1907,26,15-19,1933,0.6317762453282223
STAT,1857,28,15-19,1885,0.34568246188808893
SIM,1879,84,na,1963,479
STAT,1827,47,30-34,1874,0.08854156511457154
STAT,1925,31,15-19,1956,0.14423879271792006
STAT,1851,42,45-49,1893,1.0752721072449472
STAT,1865,24,45-49,1889,0.5957037230416894
STAT,1822,51,na,1873,1250.520376764911
STAT,1845,52,30-34,1897,0.004189772014367413
SIM,1924,45,na,1969,4156
STAT,1845,38,35-39,1883,5.204388581533196
STAT,1889,30,25-29,1919,12.041506634838816
STAT,1913,39,na,1952,3472.2542606811335
SIM,1835,21,20-24,1856,45
STAT,1880,30,20-24,1910,2.7137096809241963
SIM,1764,92,na,1856,7
SIM,1882,76,na,1958,937
SIM,1939,30,40-44,1969,3
SIM,1899,35,20-24,1934,3
STAT,1901,15,25-29,1916,7.5281673243850635
STAT,1952,20,na,1972,4150.642458921438
STAT,1845,14,na,1859,2115.7572386393585
SIM,1873,93,na,1966,74
SIM,1894,61,na,1955,2317
STAT,1884,41,45-49,1925,1.4031656769016625
SIM,1853,38,35-39,1891,6
SIM,1897,30,25-29,1927,17
SIM,1889,22,30-34,1911,30
STAT,1817,50,45-49,1867,0.03262768295679352
STAT,1903,19,na,1922,3376.5935531711407
STAT,1850,8,na,1858,2115.307463268788
STAT,1913,41,35-39,1954,0.18658515829079134
SIM,1968,1,na,1969,4589
SIM,1862,42,30-34,1904,1
STAT,1843,22,15-19,1865,2.796991232823796
STAT,1903,5,na,1908,3522.5371614281894
SIM,1836,37,35-39,1873,11
STAT,1930,24,35-39,1954,11.323732825464168
STAT,1955,16,50-100,1971,0.46993178677608183
STAT,1831,28,50-100,1859,0.5357976968723097
SIM,1854,31,na,1885,1950
STAT,1866,50,40-44,1916,0.009304784816837901
STAT,1831,32,35-39,1863,8.082511989878382
STAT,1902,39,45-49,1941,0.5678846633475538
STAT,1851,36,50-100,1887,0.9019428872063365
SIM,1843,16,30-34,1859,1
STAT,1896,33,35-39,1929,12.58207145766061
STAT,1849,53,45-49,1902,0.01070766640639832
STAT,1932,1,na,1933,5223.882762185078
SIM,1867,32,20-24,1899,2
STAT,1830,31,20-24,1861,2.357071996844886
STAT,1930,39,20-24,1969,0.324128855242516
SIM,1929,31,25-29,1960,11
STAT,1844,105,na,1949,0.02036390052125684
STAT,1884,49,40-44,1933,0.1564483278666631
STAT,1875,49,15-19,1924,3.8029593069582445E-4
SIM,1856,32,45-49,1888,1
STAT,1920,26,30-34,1946,40.744143524541585
STAT,1911,38,na,1949,3415.923065203286
STAT,1946,23,30-34,1969,30.204983579604626
SIM,1857,21,40-44,1878,1
SIM,1945,3,na,1948,3962
STAT,1878,51,30-34,1929,0.005888447421689031
STAT,1917,39,na,1956,3669.175256606153
STAT,1798,82,na,1880,171.54054515902064
STAT,1932,18,20-24,1950,169.1476210470951
SIM,1853,79,na,1932,502
SIM,1874,47,na,1921,2107
SIM,1947,18,na,1965,3860
STAT,1803,84,na,1887,111.72586427189857
STAT,1929,26,35-39,1955,17.75804843533919
STAT,1824,52,na,1876,1324.2943106359937
STAT,1862,35,30-34,1897,4.345681951477872
SIM,1940,18,20-24,1958,116
STAT,1903,29,35-39,1932,12.876932520528579
SIM,1932,19,25-29,1951,67
STAT,1855,108,na,1963,0.006636389329263588
STAT,1819,99,na,1918,0.9997628014883154
STAT,1828,50,20-24,1878,6.003177942819698E-4
SIM,1943,16,35-39,1959,5
STAT,1879,32,20-24,1911,2.672982336637407
STAT,1907,39,na,1946,3262.08786155228
SIM,1847,79,na,1926,467
SIM,1888,35,45-49,1923,2
STAT,1914,15,35-39,1929,0.8238286923666797
SIM,1884,47,na,1931,2201
STAT,1845,50,20-24,1895,5.296768853854007E-4
STAT,1950,16,15-19,1966,50.70922557998224
SIM,1888,23,25-29,1911,64
SIM,1838,32,25-29,1870,16
STAT,1886,46,25-29,1932,0.05764283334745937
SIM,1950,16,25-29,1966,53
STAT,1825,52,45-49,1877,0.014266861067922642
SIM,1884,17,30-34,1901,1
SIM,1768,88,na,1856,38
SIM,1853,29,50-100,1882,1
SIM,1865,64,na,1929,1520
SIM,1887,32,20-24,1919,3
STAT,1803,74,na,1877,459.93747307173794
STAT,1880,17,35-39,1897,0.5464785645857282
SIM,1851,40,45-49,1891,1
SIM,1885,19,na,1904,2403
STAT,1897,23,25-29,1920,72.09961874513809
SIM,1843,23,20-24,1866,62
STAT,1808,52,45-49,1860,0.05242777731415473
STAT,1849,43,15-19,1892,0.010280743163660762
STAT,1835,23,20-24,1858,57.88355764822596
SIM,1911,26,30-34,1937,48
STAT,1837,50,30-34,1887,0.004033935909527646
STAT,1874,11,na,1885,2534.8835498361864
STAT,1935,16,35-39,1951,5.4324095280358025
STAT,1861,43,15-19,1904,0.010769084091607003
STAT,1829,42,35-39,1871,1.544673940975626
STAT,1910,60,na,1970,3015.441988805411
STAT,1922,37,20-24,1959,0.2833645203001992
STAT,1917,25,30-34,1942,39.08265681562688
STAT,1926,39,30-34,1965,2.0996950610769898
STAT,1889,43,50-100,1932,1.223191793049811
STAT,1942,16,25-29,1958,42.79470259928031
SIM,1892,66,na,1958,2276
STAT,1889,30,40-44,1919,5.098371354506525
SIM,1922,15,35-39,1937,4
STAT,1913,39,20-24,1952,0.24329356110059377
STAT,1899,34,15-19,1933,0.18275469108422793
SIM,1842,42,45-49,1884,2
SIM,1837,42,35-39,1879,3
STAT,1848,23,30-34,1871,15.999938831103453
STAT,1907,19,25-29,1926,7.821703536485391
STAT,1835,85,na,1920,174.4799803709196
STAT,1878,72,na,1950,1243.3460496463942
STAT,1962,10,na,1972,4754.77824039388
STAT,1880,11,na,1891,2575.848882514725
STAT,1895,41,20-24,1936,0.013643900647976872
STAT,1948,16,45-49,1964,0.5402324576163151
STAT,1938,31,25-29,1969,8.784750458448194
SIM,1916,18,15-19,1934,7
STAT,1772,112,na,1884,6.737027457548396E-4
STAT,1903,36,40-44,1939,1.2761288955076817
STAT,1777,90,na,1867,25.30509607037058
STAT,1908,18,15-19,1926,8.294843873066053
SIM,1907,34,25-29,1941,7
SIM,1911,36,40-44,1947,1
STAT,1843,40,45-49,1883,1.067850959058706
STAT,1912,33,30-34,1945,14.584261297656415
SIM,1880,33,35-39,1913,17
STAT,1787,102,na,1889,0.08440244479109558
STAT,1858,42,na,1900,1709.7848522783272
STAT,1854,43,25-29,1897,0.4561347489182126
SIM,1915,19,25-29,1934,12
SIM,1892,76,na,1968,1648
STAT,1933,23,20-24,1956,139.29068251789838
SIM,1931,29,20-24,1960,18
STAT,1854,27,35-39,1881,7.2372902929839
SIM,1836,77,na,1913,550
SIM,1852,21,20-24,1873,56
SIM,1896,22,20-24,1918,87
STAT,1848,16,40-44,1864,0.16947579066256271
STAT,1937,34,45-49,1971,1.4688280620255523
STAT,1860,38,15-19,1898,0.042829521564287515
STAT,1912,26,40-44,1938,4.354277546822581
STAT,1870,33,15-19,1903,0.13142097208544942
SIM,1840,82,na,1922,271
SIM,1880,40,25-29,1920,2
SIM,1916,18,30-34,1934,3
STAT,1834,102,na,1936,0.18175967372834795
STAT,1924,26,15-19,1950,0.7791528265190235
SIM,1834,72,na,1906,710
SIM,1813,42,35-39,1855,4
SIM,1898,22,40-44,1920,2
SIM,1941,23,20-24,1964,105
STAT,1881,22,35-39,1903,5.325497043878364
STAT,1844,47,30-34,1891,0.0669164636749815
STAT,1851,24,15-19,1875,2.7934298879188106
STAT,1858,33,15-19,1891,0.1050336055222645
SIM,1951,15,30-34,1966,11
STAT,1909,26,35-39,1935,13.71732745085383
SIM,1946,24,35-39,1970,11
SIM,1894,39,35-39,1933,14
STAT,1830,27,35-39,1857,9.670167929813367
SIM,1846,31,20-24,1877,2
STAT,1843,48,40-44,1891,0.11418349842513602
STAT,1904,49,20-24,1953,0.008980864017863346
STAT,1801,89,na,1890,37.13687811425089
STAT,1862,16,na,1878,2136.0504253397357
SIM,1902,36,30-34,1938,5
STAT,1919,24,na,1943,3753.971732000966
STAT,1844,21,20-24,1865,60.190191871729176
SIM,1883,43,45-49,1926,6
STAT,1873,25,50-100,1898,0.6170566394403592
SIM,1857,45,na,1902,1809
SIM,1920,26,40-44,1946,6
STAT,1924,19,25-29,1943,48.48836155920895
STAT,1923,29,20-24,1952,19.656710754624708
STAT,1872,40,25-29,1912,0.6146333185718785
STAT,1869,51,20-24,1920,6.785672630733587E-4
STAT,1892,43,45-49,1935,1.758107373357127
STAT,1869,53,30-34,1922,0.0053602416599141675
STAT,1878,62,na,1940,1799.438957735024
SIM,1884,24,20-24,1908,59
STAT,1910,20,15-19,1930,4.750821863424529
SIM,1859,64,na,1923,1378
SIM,1897,30,40-44,1927,8
STAT,1830,41,30-34,1871,0.9069298685006274
STAT,1876,24,20-24,1900,66.83787219541544
STAT,1875,43,45-49,1918,1.4427615496884576
STAT,1938,24,35-39,1962,8.797710727652781
SIM,1917,26,35-39,1943,19
STAT,1862,26,na,1888,1948.7371676420642
SIM,1879,33,25-29,1912,11
SIM,1861,37,30-34,1898,6
SIM,1847,34,45-49,1881,2
STAT,1933,16,15-19,1949,57.533008082953344
SIM,1842,24,15-19,1866,4
SIM,1862,27,35-39,1889,12
STAT,1834,66,na,1900,1016.1369839701683
STAT,1838,31,20-24,1869,2.278543421059299
STAT,1820,42,15-19,1862,0.02537769247232345
STAT,1834,24,15-19,1858,2.6989910782443243
SIM,1941,16,15-19,1957,44
STAT,1943,15,30-34,1958,12.216933553820905
STAT,1851,4,na,1855,2331.1414
STAT,1798,88,na,1886,48.19744631820491
STAT,1893,79,na,1972,1304.3491101269574
STAT,1947,21,25-29,1968,98.65660426072434
SIM,1926,40,na,1966,4291
STAT,1853,37,30-34,1890,4.033403833803382
STAT,1830,86,na,1916,133.91244209672723
STAT,1864,11,na,1875,2295.3510851337487
STAT,1839,31,40-44,1870,3.590340276741703
STAT,1933,23,na,1956,4574.512244232422
STAT,1907,36,25-29,1943,0.8665533434351192
STAT,1858,48,na,1906,1645.4768133597684
STAT,1836,48,35-39,1884,0.09366998910731195
STAT,1860,52,na,1912,1641.6378152728357
SIM,1872,24,25-29,1896,53
STAT,1825,34,15-19,1859,0.2065142568214372
STAT,1860,32,45-49,1892,1.336656582646552
STAT,1873,6,na,1879,2626.666228013727
STAT,1818,76,na,1894,465.2687170036612
SIM,1875,64,na,1939,1634
STAT,1863,33,25-29,1896,8.455462836374055
STAT,1889,24,30-34,1913,20.643615096980497
STAT,1845,42,20-24,1887,0.11443933053487153
STAT,1910,8,na,1918,3721.3221313502104
SIM,1840,72,na,1912,786
STAT,1903,43,30-34,1946,0.10653563654172113
SIM,1916,20,na,1936,3571
STAT,1806,98,na,1904,1.126540344375981
SIM,1839,26,na,1865,1858
STAT,1853,45,30-34,1898,0.07398821480967434
STAT,1817,48,15-19,1865,8.877111367879182E-4
SIM,1838,24,25-29,1862,51
STAT,1867,25,na,1892,2131.3950364553666
STAT,1946,20,na,1966,3841.6939625217483
STAT,1757,115,na,1872,2.0711949585985726E-4
STAT,1809,99,na,1908,0.759993923209888
STAT,1873,20,50-100,1893,0.3930410896764338
STAT,1897,15,25-29,1912,7.192507773576675
STAT,1862,42,50-100,1904,0.8522651987361664
STAT,1892,25,15-19,1917,0.5404857960493953
STAT,1793,89,na,1882,34.169392348641686
STAT,1849,35,15-19,1884,0.04399232782290443
SIM,1847,31,40-44,1878,2
STAT,1859,35,25-29,1894,2.185400825107682
SIM,1861,13,na,1874,2350
STAT,1927,44,30-34,1971,0.1509629522932422
STAT,1911,34,25-29,1945,8.429898708352871
SIM,1837,25,na,1862,1843
STAT,1878,54,35-39,1932,0.008242717314099498
SIM,1913,23,45-49,1936,6
SIM,1914,55,na,1969,3327
STAT,1871,35,25-29,1906,2.726545845753922
SIM,1907,24,15-19,1931,4
SIM,1816,53,na,1869,1249
SIM,1918,21,na,1939,3727
SIM,1844,21,45-49,1865,1
STAT,1892,34,50-100,1926,1.0748657964729127
STAT,1940,29,20-24,1969,17.56711462591687
STAT,1915,18,20-24,1933,26.73620537005709
STAT,1893,39,40-44,1932,5.191587188621076
SIM,1892,15,15-19,1907,8
STAT,1884,39,15-19,1923,0.051882730297535935
SIM,1897,24,30-34,1921,32
STAT,1946,26,35-39,1972,15.806500733757654
SIM,1906,26,na,1932,3287
SIM,1848,31,40-44,1879,8
STAT,1905,23,45-49,1928,0.9492464355400159
STAT,1862,19,50-100,1881,0.04075810007332337
STAT,1912,19,35-39,1931,0.7973105502639461
STAT,1868,42,na,1910,2080.652951249995
SIM,1814,52,na,1866,1165
SIM,1920,19,35-39,1939,4
STAT,1883,25,na,1908,2225.426007816567
SIM,1874,21,40-44,1895,2
SIM,1937,23,30-34,1960,27
STAT,1852,16,30-34,1868,1.4058543905311613
STAT,1888,22,20-24,1910,76.93723086708387
SIM,1873,21,40-44,1894,2
STAT,1890,65,na,1955,1951.8489362361051
SIM,1860,16,30-34,1876,2
STAT,1897,30,15-19,1927,0.1813615311928071
STAT,1773,112,na,1885,6.502344353662383E-4
STAT,1922,41,50-100,1963,0.12756925282062168
SIM,1860,65,na,1925,1375
STAT,1857,22,45-49,1879,0.5997872586207813
SIM,1845,27,35-39,1872,7
SIM,1864,34,45-49,1898,2
STAT,1827,54,50-100,1881,0.01166505501274143
SIM,1929,24,35-39,1953,11
STAT,1820,45,50-100,1865,0.42428660054742245
STAT,1847,70,na,1917,1034.6370794111247
STAT,1906,27,50-100,1933,0.8801551930088355
STAT,1920,18,30-34,1938,12.88484119857385
STAT,1866,53,45-49,1919,0.012441947095525043
STAT,1923,39,na,1962,4109.307701886903
STAT,1848,96,na,1944,6.380384785602569
SIM,1804,68,na,1872,720
STAT,1856,34,45-49,1890,1.274328118105604
STAT,1836,21,45-49,1857,0.6002650493485738
STAT,1834,42,45-49,1876,1.1197224892736908
STAT,1883,18,15-19,1901,5.482259008612505
SIM,1923,18,20-24,1941,154
STAT,1866,21,40-44,1887,1.8437301579001792
STAT,1900,66,na,1966,2396.38924864021
SIM,1903,33,30-34,1936,12
SIM,1861,9,na,1870,2406
SIM,1890,47,na,1937,2811
SIM,1853,35,30-34,1888,6
STAT,1849,7,na,1856,2284.6112155449
STAT,1865,32,45-49,1897,1.4931759668891609
STAT,1855,32,35-39,1887,7.327586121237812
STAT,1918,15,20-24,1933,28.09888824163919
SIM,1830,42,35-39,1872,11
SIM,1855,46,50-100,1901,4
SIM,1829,31,20-24,1860,2
STAT,1879,10,na,1889,2577.8727089975214
STAT,1830,34,25-29,1864,8.50110447373115
STAT,1837,43,25-29,1880,0.4855233997612676
SIM,1928,28,50-100,1956,1
STAT,1866,77,na,1943,753.1633051894527
STAT,1826,48,40-44,1874,0.15593798363134015
STAT,1865,21,40-44,1886,1.8190453950906675
STAT,1872,1,na,1873,3316.471444387112
STAT,1898,23,45-49,1921,0.8887149300208514
SIM,1946,16,35-39,1962,4
SIM,1941,26,25-29,1967,69
STAT,1881,82,na,1963,643.885964948709
SIM,1891,18,15-19,1909,6
STAT,1849,44,na,1893,1709.7308130103547
STAT,1933,26,25-29,1959,82.59936155271272
SIM,1841,20,na,1861,1797
STAT,1929,23,30-34,1952,34.22821064040126
SIM,1856,23,30-34,1879,16
STAT,1914,56,na,1970,3313.8298090582784
STAT,1867,49,40-44,1916,0.14869687984852137
STAT,1912,6,na,1918,3816.393873200424
SIM,1917,39,30-34,1956,1
STAT,1843,43,na,1886,1586.88722337236
STAT,1866,35,15-19,1901,0.04939334831029152
STAT,1887,83,na,1970,790.1687442918333
SIM,1785,84,na,1869,91
SIM,1926,15,20-24,1941,136
STAT,1921,38,na,1959,3964.4524389265966
SIM,1842,46,50-100,1888,3
STAT,1839,44,na,1883,1580.8186973565785
STAT,1822,42,35-39,1864,2.635543924143454
STAT,1864,24,25-29,1888,48.27352670915789
STAT,1927,37,40-44,1964,1.7582371831070511
SIM,1916,20,45-49,1936,1
STAT,1763,108,na,1871,0.002585032333962426
STAT,1845,105,na,1950,0.02074815242989473
STAT,1904,18,45-49,1922,0.08828376726963495
SIM,1925,25,30-34,1950,46
SIM,1819,37,35-39,1856,11
SIM,1888,40,25-29,1928,1
STAT,1917,49,30-34,1966,0.0874489936713495
SIM,1934,17,na,1951,4593
STAT,1930,20,50-100,1950,0.8010523226862603
SIM,1863,79,na,1942,538
STAT,1783,90,na,1873,25.114781999921902
SIM,1811,54,na,1865,1096
SIM,1899,39,na,1938,3114
STAT,1850,19,15-19,1869,5.052009890061346
STAT,1878,28,35-39,1906,9.466130336895723
STAT,1861,68,na,1929,1200.3795251045165
SIM,1836,36,na,1872,1660
SIM,1876,12,na,1888,2545
SIM,1886,28,35-39,1914,12
STAT,1889,17,40-44,1906,0.21331158129530428
STAT,1851,78,na,1929,562.0461804907532
STAT,1908,20,45-49,1928,0.9830517038605762
SIM,1801,54,na,1855,1097
STAT,1783,105,na,1888,0.01794383661573931
STAT,1909,39,30-34,1948,1.613379904678228
STAT,1949,7,na,1956,4318.764563041043
SIM,1933,16,25-29,1949,67
STAT,1793,73,na,1866,445.44952260449196
STAT,1905,38,na,1943,3226.376097319147
SIM,1827,29,40-44,1856,3
STAT,1773,90,na,1863,23.977932846699957
SIM,1820,36,30-34,1856,10
STAT,1902,38,30-34,1940,1.5260658227001807
STAT,1852,23,20-24,1875,58.924729129653
STAT,1826,47,na,1873,1395.0798139603155
STAT,1880,40,30-34,1920,1.1565480821640055
STAT,1867,27,30-34,1894,22.33831064333962
STAT,1926,30,50-100,1956,0.9454880851117473
STAT,1862,57,na,1919,1623.21620555754
STAT,1796,87,na,1883,57.81837480211973
SIM,1888,32,40-44,1920,7
STAT,1840,53,50-100,1893,0.009752158529084178
STAT,1841,51,35-39,1892,0.005963585679240355
STAT,1874,8,na,1882,2595.6866710322774
STAT,1945,19,45-49,1964,0.5151611637340096
SIM,1934,30,50-100,1964,1
SIM,1910,38,30-34,1948,1
STAT,1875,82,na,1957,518.2025495642591
STAT,1839,42,45-49,1881,1.0502255578611717
STAT,1843,45,50-100,1888,0.1694018414482117
STAT,1905,42,na,1947,3162.985335696666
STAT,1925,16,25-29,1941,49.57366606838052
STAT,1934,16,15-19,1950,58.132777363623305
SIM,1888,20,20-24,1908,80
STAT,1952,16,35-39,1968,4.7516920789762125
SIM,1855,41,40-44,1896,8
STAT,1858,49,15-19,1907,2.900863996826611E-4
STAT,1876,67,na,1943,1547.1802113484287
SIM,1915,16,20-24,1931,26
STAT,1923,23,na,1946,4001.5773693344354
SIM,1847,42,45-49,1889,5
SIM,1865,33,na,1898,2098
SIM,1871,33,25-29,1904,11
SIM,1878,26,35-39,1904,11
SIM,1896,32,na,1928,2976
STAT,1886,43,20-24,1929,0.15733634196567334
SIM,1839,32,45-49,1871,2
STAT,1876,43,50-100,1919,1.0236536604497823
STAT,1842,17,15-19,1859,5.518807173072728
STAT,1898,55,na,1953,2643.4055646040106
SIM,1863,32,35-39,1895,11
SIM,1814,68,na,1882,732
SIM,1887,35,25-29,1922,4
STAT,1908,56,na,1964,3021.8318887702144
STAT,1845,35,30-34,1880,4.445811785781829
STAT,1938,16,35-39,1954,3.9199952548373687
STAT,1910,29,25-29,1939,59.61679412866279
SIM,1846,8,na,1854,2193
SIM,1899,27,50-100,1926,5
SIM,1884,43,50-100,1927,1
SIM,1881,33,na,1914,1839
SIM,1910,35,na,1945,3445
SIM,1850,17,15-19,1867,6
STAT,1879,35,25-29,1914,2.8742007443363935
STAT,1943,23,30-34,1966,28.87792274340257
STAT,1819,52,20-24,1871,0.0013420479353218643
STAT,1830,70,na,1900,846.8195641185976
STAT,1878,44,25-29,1922,0.6236830878274878
STAT,1956,15,40-44,1971,1.749138207825844
SIM,1879,25,25-29,1904,47
STAT,1830,24,30-34,1854,39.42091393202845
STAT,1907,15,45-49,1922,0.0910710202942298
STAT,1911,37,45-49,1948,0.6220577869344779
SIM,1917,23,30-34,1940,43
SIM,1938,25,40-44,1963,4
SIM,1886,44,25-29,1930,2
STAT,1912,36,35-39,1948,2.2409857498484564
STAT,1895,10,na,1905,3190.242136503098
STAT,1919,45,35-39,1964,0.13272979241430624
STAT,1847,41,40-44,1888,1.6893887713328026
STAT,1929,24,na,1953,4335.129189693378
SIM,1902,28,30-34,1930,36
SIM,1922,20,na,1942,3921
STAT,1891,47,50-100,1938,0.1611667252478759
STAT,1767,90,na,1857,24.382961496422002
STAT,1884,23,15-19,1907,3.0695332121791084
SIM,1880,30,30-34,1910,24
STAT,1936,19,50-100,1955,0.33702928648151165
STAT,1908,26,15-19,1934,0.6379971726789413
STAT,1919,29,45-49,1948,1.7508288855287668
STAT,1949,19,30-34,1968,13.383452085842986
STAT,1838,34,25-29,1872,8.369190207259662
STAT,1838,96,na,1934,5.764653854351504
STAT,1847,43,50-100,1890,0.7734076953778797
STAT,1845,15,50-100,1860,0.044338174930584735
STAT,1882,22,50-100,1904,0.3746433138020233
STAT,1877,25,na,1902,2354.5028969260534
STAT,1935,37,30-34,1972,2.407572850717679
SIM,1890,31,na,1921,2985
SIM,1892,23,15-19,1915,4
STAT,1880,17,50-100,1897,0.04879271994073748
SIM,1920,36,35-39,1956,6
STAT,1872,30,30-34,1902,16.67741760829587
STAT,1909,49,40-44,1958,0.136065936092105
STAT,1781,88,na,1869,43.6000561979907
SIM,1915,36,25-29,1951,2
STAT,1852,26,na,1878,1839.9224083666265
STAT,1928,4,na,1932,4804.3244163371255
SIM,1848,21,30-34,1869,16
STAT,1842,71,na,1913,966.6389657249251
STAT,1848,33,40-44,1881,3.3843894964807277
STAT,1898,29,15-19,1927,0.5758766952940219
STAT,1909,23,30-34,1932,25.15811683609283
STAT,1874,42,na,1916,2228.116147295406
STAT,1894,46,30-34,1940,0.06647927299265656
SIM,1849,37,30-34,1886,7
SIM,1908,16,15-19,1924,8
STAT,1912,29,45-49,1941,1.5968941082207193
SIM,1872,50,na,1922,2044
SIM,1894,36,30-34,1930,10
STAT,1858,29,50-100,1887,0.47809532644844344
SIM,1920,29,45-49,1949,1
STAT,1892,40,40-44,1932,2.688311397266496
STAT,1917,23,na,1940,3655.2419170828316
STAT,1844,24,25-29,1868,48.93070941786432
STAT,1876,37,15-19,1913,0.05480712177010601
STAT,1819,45,30-34,1864,0.18908350348664393
SIM,1852,24,25-29,1876,57
STAT,1858,51,45-49,1909,0.010800506463143058
STAT,1896,32,50-100,1928,1.1431862363681862
SIM,1846,34,25-29,1880,12
STAT,1837,59,na,1896,1261.2769940495796
STAT,1787,89,na,1876,35.92330673250452
STAT,1837,53,35-39,1890,0.005497665231326935
SIM,1856,33,40-44,1889,4
STAT,1873,25,na,1898,2302.0752418095253
STAT,1809,46,15-19,1855,0.0011489712398852889
STAT,1886,36,30-34,1922,5.344038992187778
STAT,1822,32,25-29,1854,29.865908401047047
STAT,1906,22,50-100,1928,0.5610803762507213
SIM,1900,15,15-19,1915,7
STAT,1882,52,35-39,1934,0.007867169811924113
SIM,1927,29,45-49,1956,2
SIM,1807,70,na,1877,635
SIM,1902,61,na,1963,2607
SIM,1907,26,25-29,1933,59
SIM,1914,20,25-29,1934,100
STAT,1925,20,45-49,1945,1.2798924980295472
SIM,1902,34,25-29,1936,9
STAT,1912,16,30-34,1928,2.3342033378630536
STAT,1903,46,35-39,1949,0.10645131285817819
STAT,1862,38,35-39,1900,5.684593631440087
SIM,1837,25,35-39,1862,8
STAT,1813,46,na,1859,1284.0355460927462
SIM,1888,27,40-44,1915,2
SIM,1854,65,na,1919,1359
STAT,1896,16,35-39,1912,0.686297838662319
STAT,1857,31,40-44,1888,3.285000550782528
STAT,1917,21,15-19,1938,5.360856158147376
STAT,1906,47,15-19,1953,3.090021399256679E-4
STAT,1864,22,35-39,1886,4.992319639264017
SIM,1877,35,50-100,1912,1
STAT,1835,36,15-19,1871,0.04464684476727254
STAT,1882,24,45-49,1906,0.6366295241838835
SIM,1847,33,30-34,1880,10
SIM,1916,21,20-24,1937,108
STAT,1863,50,25-29,1913,0.0029785870912738734
STAT,1801,53,20-24,1854,0.0020204446765005046
STAT,1812,88,na,1900,59.634271072074455
SIM,1870,27,na,1897,2186
SIM,1864,85,na,1949,221
SIM,1862,5,na,1867,2455
STAT,1872,7,na,1879,2585.8118058135383
SIM,1837,83,na,1920,220
STAT,1946,24,45-49,1970,1.182061535503418
STAT,1951,18,40-44,1969,1.57298556465405
SIM,1929,35,40-44,1964,2
SIM,1843,31,20-24,1874,2
STAT,1850,21,45-49,1871,0.5942608397235475
STAT,1885,10,na,1895,2439.163826916484
STAT,1922,44,na,1966,4013.6802902512914
SIM,1872,22,35-39,1894,8
STAT,1827,38,50-100,1865,1.2445068780042914
STAT,1909,48,45-49,1957,0.18814890902505133
STAT,1908,18,na,1926,3530.09171724016
STAT,1869,95,na,1964,37.10520122723276
STAT,1824,83,na,1907,218.89341409129966
SIM,1916,35,30-34,1951,4
STAT,1829,25,35-39,1854,27.450092838509697
STAT,1857,24,35-39,1881,4.502183062847994
SIM,1925,34,na,1959,4183
SIM,1870,38,35-39,1908,14
STAT,1877,22,45-49,1899,0.6833295716803814
STAT,1909,45,50-100,1954,0.1982359721428463
STAT,1873,18,40-44,1891,0.1747829327460329
STAT,1885,25,25-29,1910,40.10310018808043
SIM,1834,33,20-24,1867,1
STAT,1904,15,50-100,1919,0.06669520132323417
STAT,1882,77,na,1959,922.4872610885667
SIM,1815,49,50-100,1864,2
STAT,1863,30,20-24,1893,2.2588949723118485
STAT,1874,21,30-34,1895,17.244739182909417
SIM,1908,36,35-39,1944,8
SIM,1908,55,na,1963,2976
STAT,1835,31,20-24,1866,2.2131513149298017
STAT,1899,38,30-34,1937,1.4816210045517118
SIM,1902,39,35-39,1941,6
STAT,1910,59,na,1969,3045.009026452262
SIM,1875,23,15-19,1898,3
SIM,1823,33,45-49,1856,1
STAT,1821,65,na,1886,907.6135455321551
SIM,1825,98,na,1923,2
STAT,1904,38,15-19,1942,0.016342456202393465
SIM,1850,65,na,1915,1255
STAT,1800,70,na,1870,670.9131189435107
STAT,1888,55,na,1943,2308.4951216442355
STAT,1821,51,30-34,1872,0.009209175579048755
SIM,1865,24,35-39,1889,7
SIM,1877,16,25-29,1893,7
STAT,1825,31,na,1856,1553.7436077202651
STAT,1838,44,50-100,1882,0.7357224923433384
STAT,1893,15,na,1908,3039.8040499127346
STAT,1877,42,15-19,1919,0.013516069538676992
SIM,1909,37,30-34,1946,3
SIM,1882,12,na,1894,2460
STAT,1893,24,20-24,1917,82.04223940567286
STAT,1867,23,15-19,1890,2.917448958811795
STAT,1858,11,na,1869,2074.8920936583268
STAT,1793,83,na,1876,121.61300315665294
STAT,1804,54,35-39,1858,0.029220885474197805
STAT,1889,34,40-44,1923,5.014414557419381
STAT,1838,32,35-39,1870,8.448427305049364
STAT,1932,37,15-19,1969,0.02437443929620921
STAT,1908,35,30-34,1943,1.6273912513557254
STAT,1809,48,40-44,1857,0.4747652061865733
STAT,1919,42,30-34,1961,0.13088178773780562
SIM,1879,22,20-24,1901,83
STAT,1837,24,50-100,1861,0.34150176895754225
STAT,1887,18,35-39,1905,0.5782932279741221
STAT,1898,20,40-44,1918,2.6798769101943414
STAT,1936,20,20-24,1956,100.49459320918547
STAT,1899,30,35-39,1929,13.213869443717433
STAT,1893,18,na,1911,3017.818538254051
STAT,1894,62,na,1956,2241.7102294882425
SIM,1828,27,35-39,1855,14
STAT,1841,23,45-49,1864,0.6046314993483011
SIM,1906,22,40-44,1928,3
STAT,1799,74,na,1873,442.7713232753335
STAT,1870,45,na,1915,2105.8525350456352
STAT,1833,50,na,1883,1416.2677231064931
STAT,1845,78,na,1923,552.8935559013611
STAT,1867,28,50-100,1895,0.565459630949386
SIM,1893,25,25-29,1918,58
SIM,1946,8,na,1954,4009
STAT,1908,21,20-24,1929,96.86499841103408
STAT,1911,15,35-39,1926,0.7969633138995783
SIM,1786,76,na,1862,331
SIM,1869,30,na,1899,2214
SIM,1902,34,40-44,1936,4
SIM,1775,91,na,1866,15
STAT,1808,83,na,1891,153.49709513921184
SIM,1832,53,na,1885,1258
STAT,1844,35,na,1879,1763.6277084488854
SIM,1932,19,na,1951,4512
STAT,1876,32,20-24,1908,2.638198305778538
SIM,1881,64,na,1945,1308
SIM,1845,13,na,1858,2104
STAT,1867,5,na,1872,2505.8732915375967
SIM,1920,16,30-34,1936,14
STAT,1855,78,na,1933,555.235864829833
SIM,1942,16,15-19,1958,43
SIM,1933,20,45-49,1953,1
STAT,1793,80,na,1873,229.43062703958006
STAT,1863,97,na,1960,9.090020338219515
STAT,1920,24,25-29,1944,96.40156869751762
SIM,1879,31,35-39,1910,13
SIM,1826,34,25-29,1860,15
SIM,1826,46,na,1872,1389
SIM,1847,26,40-44,1873,5
STAT,1942,26,50-100,1968,0.9873517748869475
SIM,1851,20,na,1871,1908
STAT,1845,19,40-44,1864,0.16166367832346876
SIM,1866,40,40-44,1906,4
STAT,1843,26,30-34,1869,21.084033362465725
STAT,1945,17,na,1962,3798.397122753448
STAT,1876,39,40-44,1915,4.229463304732982
STAT,1867,39,15-19,1906,0.04931212892119285
STAT,1826,40,45-49,1866,1.5223762454995307
SIM,1887,58,na,1945,2047
STAT,1784,105,na,1889,0.019558709255130292
SIM,1819,47,50-100,1866,4
SIM,1925,21,15-19,1946,6
STAT,1889,10,na,1899,3020.9802999862072
SIM,1846,32,35-39,1878,10
STAT,1867,51,50-100,1918,0.01346141872672592
STAT,1837,40,20-24,1877,0.12478064821687919
STAT,1839,33,30-34,1872,14.157696563044796
SIM,1865,31,40-44,1896,9
STAT,1821,44,25-29,1865,1.0418834734250264
SIM,1851,26,30-34,1877,33
SIM,1860,23,20-24,1883,47
SIM,1944,20,20-24,1964,100
STAT,1855,15,35-39,1870,0.46929167033746466
SIM,1884,39,40-44,1923,6
STAT,1939,26,45-49,1965,1.6414674459287408
STAT,1863,43,35-39,1906,1.4903516325414887
STAT,1833,22,40-44,1855,1.7214029320576403
SIM,1838,30,35-39,1868,5
SIM,1855,28,40-44,1883,5
SIM,1916,28,40-44,1944,4
STAT,1852,28,15-19,1880,0.3803653378133445
STAT,1902,36,40-44,1938,1.265760749285441
STAT,1839,26,40-44,1865,2.5307185741974827
STAT,1893,31,45-49,1924,2.0976847910144873
SIM,1907,28,30-34,1935,1
STAT,1930,28,15-19,1958,0.8475810136790691
SIM,1826,53,na,1879,1228
SIM,1850,37,50-100,1887,3
STAT,1897,21,35-39,1918,7.394700752602499
STAT,1916,16,15-19,1932,9.118552873015636
SIM,1838,44,45-49,1882,1
STAT,1934,25,30-34,1959,49.83821916901503
SIM,1847,83,na,1930,249
STAT,1905,37,20-24,1942,0.2271922684167147
STAT,1931,39,20-24,1970,0.3291004847900955
SIM,1891,42,50-100,1933,1
STAT,1866,18,15-19,1884,5.276248255031311
SIM,1834,26,30-34,1860,25
SIM,1933,28,40-44,1961,7
STAT,1856,26,40-44,1882,2.304502182924417
SIM,1901,29,25-29,1930,54
STAT,1898,32,40-44,1930,5.54414340310677
STAT,1863,17,35-39,1880,0.5190715560828839
STAT,1889,20,15-19,1909,3.8704592109148614
STAT,1897,35,45-49,1932,2.5424548221614183
STAT,1906,24,40-44,1930,2.84917184132381
STAT,1827,50,na,1877,1405.0589093972355
STAT,1836,41,15-19,1877,0.010775834641586386
STAT,1845,53,25-29,1898,0.0024661870419496927
SIM,1950,18,15-19,1968,40
STAT,1893,17,30-34,1910,1.909499675016686
STAT,1910,15,50-100,1925,0.07045907470513348
SIM,1951,4,na,1955,4297
STAT,1878,41,20-24,1919,0.1570621693900021
STAT,1905,3,na,1908,3609.877768782511
SIM,1906,20,na,1926,3268
SIM,1839,41,40-44,1880,5
SIM,1856,50,na,1906,1719
SIM,1816,91,na,1907,21
SIM,1933,18,15-19,1951,50
SIM,1868,78,na,1946,626
STAT,1835,38,40-44,1873,3.4088899026082236
STAT,1948,17,20-24,1965,146.57806512355913
SIM,1843,38,40-44,1881,6
STAT,1865,23,30-34,1888,15.326616328591708
SIM,1943,15,20-24,1958,112
SIM,1869,21,15-19,1890,1
STAT,1821,37,35-39,1858,14.940811852744076
STAT,1846,23,50-100,1869,0.37051395637617685
STAT,1956,4,na,1960,4915.272067871817
STAT,1847,28,40-44,1875,2.6359825409030946
STAT,1861,26,15-19,1887,0.36156269100294003
STAT,1831,65,na,1896,986.7447830093724
STAT,1879,33,35-39,1912,9.972123421525618
SIM,1835,98,na,1933,1
SIM,1873,37,50-100,1910,1
STAT,1941,21,na,1962,3566.300345810242
SIM,1829,32,35-39,1861,10
SIM,1928,34,45-49,1962,3
STAT,1920,29,35-39,1949,15.44730871017486
SIM,1867,38,na,1905,2238
STAT,1849,50,40-44,1899,0.008007792593641143
STAT,1813,52,35-39,1865,0.022507761103796996
SIM,1924,16,15-19,1940,46
SIM,1786,69,na,1855,674
STAT,1914,39,20-24,1953,0.24614561016093497
STAT,1926,26,35-39,1952,17.060253757786587
SIM,1897,20,15-19,1917,3
SIM,1867,35,25-29,1902,2
SIM,1859,32,45-49,1891,1
STAT,1859,37,50-100,1896,0.9231281467469028
SIM,1856,60,na,1916,1479
STAT,1812,98,na,1910,1.4111255779527068
STAT,1880,43,35-39,1923,1.7904248328419752
SIM,1890,5,na,1895,3260
STAT,1916,28,15-19,1944,0.6871342779207505
STAT,1868,44,15-19,1912,0.012279364741977113
SIM,1942,25,30-34,1967,39
STAT,1863,53,50-100,1916,0.012319411396960337
SIM,1864,26,40-44,1890,5
STAT,1925,28,40-44,1953,5.182313513934807
SIM,1829,38,40-44,1867,2
STAT,1849,75,na,1924,771.9606712774173
STAT,1911,17,25-29,1928,8.19248042509751
SIM,1907,23,20-24,1930,83
STAT,1882,16,40-44,1898,0.1684485486538614
SIM,1875,26,na,1901,2338
SIM,1907,15,na,1922,3509
STAT,1884,27,30-34,1911,23.50278870058833
STAT,1898,25,35-39,1923,12.419066571891264
SIM,1873,23,30-34,1896,22
SIM,1924,23,20-24,1947,116
SIM,1860,30,45-49,1890,1
STAT,1826,33,20-24,1859,3.4689294901704075
STAT,1900,45,20-24,1945,0.008959242349500365
STAT,1930,41,35-39,1971,0.2506500781147803
STAT,1934,35,50-100,1969,0.5482903616045617
STAT,1781,95,na,1876,2.4552844595475234
STAT,1837,27,35-39,1864,8.03755757274865
SIM,1864,20,35-39,1884,5
SIM,1887,33,35-39,1920,12
STAT,1918,44,50-100,1962,0.11760727187466685
SIM,1868,22,45-49,1890,3
STAT,1858,52,50-100,1910,0.011126776198722791
STAT,1863,63,na,1926,1479.2190757919009
STAT,1909,45,25-29,1954,0.046491823757637205
STAT,1928,32,na,1960,4467.39472261442
SIM,1938,21,25-29,1959,97
STAT,1851,31,50-100,1882,0.6931598860665822
STAT,1931,27,20-24,1958,22.262866862528814
STAT,1935,15,20-24,1950,175.90203419456083
SIM,1947,19,20-24,1966,142
SIM,1895,40,na,1935,2980
STAT,1939,19,20-24,1958,128.1172805451623
SIM,1850,20,40-44,1870,5
SIM,1829,33,50-100,1862,3
STAT,1854,54,50-100,1908,0.010508638951363567
SIM,1879,23,na,1902,2349
SIM,1934,26,35-39,1960,22
STAT,1847,21,20-24,1868,62.746683861000875
SIM,1915,34,na,1949,3462
SIM,1875,34,20-24,1909,2
STAT,1831,54,45-49,1885,0.008741312033227384
SIM,1862,50,na,1912,1857
SIM,1942,18,40-44,1960,1
SIM,1918,30,20-24,1948,2
STAT,1854,53,35-39,1907,0.0060607530797264966
STAT,1919,49,15-19,1968,3.752387634357334E-4
STAT,1867,34,20-24,1901,2.377294880347515
SIM,1825,36,30-34,1861,4
SIM,1839,34,35-39,1873,11
STAT,1826,38,15-19,1864,0.05931495716027197
STAT,1828,76,na,1904,533.5590172270435
SIM,1871,43,35-39,1914,2
STAT,1877,49,35-39,1926,0.13432641096079512
STAT,1916,23,20-24,1939,109.73270183627459
STAT,1847,44,45-49,1891,1.08873632800596
STAT,1942,18,15-19,1960,44.79039011310381
SIM,1838,21,20-24,1859,60
SIM,1938,29,20-24,1967,16
STAT,1852,30,45-49,1882,1.336445290042691
STAT,1894,49,35-39,1943,0.0938736932559052
STAT,1893,29,15-19,1922,0.5396633497464993
STAT,1925,18,15-19,1943,51.653744931638855
STAT,1897,43,50-100,1940,0.0920149616360546
STAT,1934,18,40-44,1952,1.7825820049893855
SIM,1828,46,50-100,1874,2
STAT,1883,15,na,1898,2350.1186566409747
SIM,1829,98,na,1927,1
SIM,1864,27,na,1891,2068
SIM,1914,24,40-44,1938,3
STAT,1841,49,20-24,1890,0.008100210656584086
STAT,1892,30,na,1922,2846.2998232771683
STAT,1900,29,50-100,1929,0.8323281061166355
STAT,1842,20,40-44,1862,1.9309955934566931
STAT,1880,50,25-29,1930,0.00357830741320091
STAT,1926,45,25-29,1971,0.0621211327590451
STAT,1874,36,50-100,1910,1.1907497380854148
STAT,1846,17,35-39,1863,0.5112486480019109
STAT,1862,42,20-24,1904,0.12811830029150312
SIM,1854,17,35-39,1871,1
SIM,1855,44,45-49,1899,4
STAT,1861,21,20-24,1882,56.01189594275994
SIM,1896,29,40-44,1925,4
STAT,1843,38,15-19,1881,0.0398778626112266
STAT,1888,29,40-44,1917,3.3204889767118693
STAT,1911,24,15-19,1935,4.739594480362086
SIM,1889,32,40-44,1921,14
STAT,1852,38,40-44,1890,3.157888184388633
SIM,1844,65,na,1909,1099
STAT,1921,21,50-100,1942,0.7042104846832898
SIM,1878,21,25-29,1899,60
SIM,1967,2,na,1969,4497
SIM,1860,38,40-44,1898,11
STAT,1857,63,na,1920,1329.41549272901
STAT,1865,16,40-44,1881,0.16234377172024955
STAT,1920,24,40-44,1944,3.509132580585012
SIM,1875,27,30-34,1902,27
SIM,1916,24,25-29,1940,95
STAT,1882,21,40-44,1903,1.9202070173687777
SIM,1897,11,na,1908,3355
STAT,1835,34,25-29,1869,8.129002125174908
STAT,1885,27,15-19,1912,0.4272260795268842
SIM,1816,84,na,1900,141
STAT,1917,36,35-39,1953,2.3847812577449137
STAT,1934,21,15-19,1955,6.760302158052089
SIM,1834,22,15-19,1856,2
STAT,1816,48,50-100,1864,0.5708623076596351
SIM,1944,1,na,1945,4039
STAT,1926,35,15-19,1961,0.022208829044744083
STAT,1869,54,25-29,1923,0.003152470610587804
STAT,1885,22,20-24,1907,64.89100680706657
SIM,1937,24,45-49,1961,5
SIM,1817,79,na,1896,297
STAT,1839,22,25-29,1861,48.97200512320868
SIM,1908,33,30-34,1941,15
SIM,1900,19,30-34,1919,3
STAT,1836,64,na,1900,1125.7027938701121
STAT,1927,30,20-24,1957,2.837668947929154
SIM,1855,21,20-24,1876,56
SIM,1908,38,25-29,1946,1
STAT,1821,41,20-24,1862,0.2815097905521085
STAT,1921,34,35-39,1955,9.524878897395565
SIM,1865,21,30-34,1886,17
SIM,1901,32,50-100,1933,1
STAT,1865,33,40-44,1898,3.6977131907776846
STAT,1867,56,na,1923,1809.3145755813307
SIM,1851,33,20-24,1884,3
SIM,1890,21,40-44,1911,1
STAT,1834,53,50-100,1887,0.009421903157334955
SIM,1806,91,na,1897,18
SIM,1920,22,25-29,1942,91
STAT,1848,54,50-100,1902,0.010913615590112414
SIM,1843,34,25-29,1877,19
STAT,1857,34,45-49,1891,1.2881301994564731
SIM,1856,54,50-100,1910,1
SIM,1942,21,15-19,1963,5
STAT,1810,105,na,1915,0.01240378630727637
STAT,1901,45,na,1946,3005.27730305834
STAT,1949,22,20-24,1971,122.5786510746922
SIM,1865,41,35-39,1906,1
SIM,1847,45,na,1892,1700
SIM,1928,24,35-39,1952,15
SIM,1892,27,30-34,1919,54
STAT,1818,83,na,1901,194.95980298747799
STAT,1901,19,40-44,1920,0.2405633189697604
SIM,1875,41,45-49,1916,5
STAT,1818,36,15-19,1854,0.19624253412898746
SIM,1947,23,40-44,1970,4
STAT,1851,28,30-34,1879,21.057187545463947
STAT,1898,22,30-34,1920,22.771572000987753
SIM,1885,26,na,1911,2275
STAT,1923,47,15-19,1970,4.070918030285254E-4
STAT,1860,30,50-100,1890,0.707956357741435
SIM,1935,30,20-24,1965,2
STAT,1799,67,na,1866,723.4608736377102
STAT,1894,58,na,1952,2400.9011631627686
STAT,1923,29,50-100,1952,1.071840809871664
STAT,1771,95,na,1866,1.740012926173924
STAT,1909,45,40-44,1954,0.13818403279983957
STAT,1812,51,na,1863,1256.9020958191682
STAT,1881,28,50-100,1909,0.5817325003459165
SIM,1824,48,50-100,1872,5
STAT,1856,20,35-39,1876,5.0679593710282695
SIM,1869,26,na,1895,2202
STAT,1867,41,45-49,1908,1.3336438996244144
SIM,1848,31,na,1879,1832
STAT,1804,69,na,1873,708.4136481656172
SIM,1859,30,na,1889,1937
STAT,1907,38,50-100,1945,0.36592033771448507
STAT,1880,45,na,1925,2263.0336267934595
SIM,1874,78,na,1952,679
SIM,1785,91,na,1876,12
SIM,1839,31,30-34,1870,20
SIM,1866,12,na,1878,2388
SIM,1931,29,50-100,1960,1
SIM,1875,29,20-24,1904,12
STAT,1949,1,na,1950,4500.435853520391
SIM,1934,28,25-29,1962,90
STAT,1935,35,40-44,1970,1.9809098959549307
SIM,1933,18,30-34,1951,22
STAT,1834,35,na,1869,1686.2909201103016
STAT,1887,15,30-34,1902,1.6920419337117174
SIM,1917,25,20-24,1942,6
SIM,1937,18,na,1955,3282
STAT,1911,35,50-100,1946,0.38674958379568186
STAT,1903,26,30-34,1929,33.964465695352466
STAT,1783,80,na,1863,208.36943246595757
SIM,1836,46,na,1882,1499
STAT,1943,26,35-39,1969,15.112039568900977
STAT,1804,51,30-34,1855,0.021462706079578845
STAT,1856,21,50-100,1877,0.3516122999060875
STAT,1861,78,na,1939,613.7267944033005
STAT,1939,23,40-44,1962,3.1889738117207416
STAT,1871,42,30-34,1913,1.0771441476520707
STAT,1877,53,20-24,1930,7.115024244316923E-4
SIM,1865,34,45-49,1899,1
STAT,1853,49,na,1902,1667.1203211923917
SIM,1879,42,40-44,1921,6
STAT,1786,94,na,1880,3.860786370256167
STAT,1843,33,20-24,1876,2.1722550423827074
STAT,1925,18,30-34,1943,13.872882526525572
STAT,1854,40,20-24,1894,0.11477489682802339
SIM,1856,97,na,1953,1
STAT,1908,31,15-19,1939,0.11506083001189217
STAT,1932,17,45-49,1949,0.6248781056101121
SIM,1833,32,na,1865,1689
SIM,1847,22,25-29,1869,58
STAT,1908,24,25-29,1932,79.72134297682692
STAT,1876,35,25-29,1911,2.8367982198171515
STAT,1895,44,25-29,1939,0.05417899242822603
STAT,1841,20,40-44,1861,1.8463073203578444
STAT,1885,44,15-19,1929,0.012828408516379392
STAT,1927,27,50-100,1954,1.1431142678397794
SIM,1935,27,50-100,1962,2
STAT,1908,28,40-44,1936,4.147973364843927
STAT,1865,37,50-100,1902,1.0512746059604117
STAT,1911,38,40-44,1949,1.3592031126159025
SIM,1891,31,35-39,1922,16
STAT,1874,24,35-39,1898,5.597281232126006
SIM,1874,85,na,1959,335
STAT,1776,115,na,1891,1.1260475866731846E-4
STAT,1844,26,15-19,1870,0.3885340332064263
STAT,1835,24,na,1859,1782.9994424164663
SIM,1905,3,na,1908,3564
SIM,1796,90,na,1886,18
STAT,1862,31,15-19,1893,0.11549538383723595
STAT,1836,37,50-100,1873,0.9758818941487267
STAT,1872,52,40-44,1924,0.009922655135696314
STAT,1891,44,na,1935,2664.870733576591
STAT,1809,68,na,1877,745.3919750490305
STAT,1849,34,na,1883,1846.8450619335977
SIM,1871,30,20-24,1901,2
STAT,1886,29,na,1915,2364.5150513523167
STAT,1821,34,30-34,1855,46.806127130359414
STAT,1909,25,20-24,1934,16.733653659366347
SIM,1829,64,na,1893,1028
SIM,1801,92,na,1893,18
SIM,1889,77,na,1966,1270
STAT,1924,18,na,1942,4129.810459307038
SIM,1770,92,na,1862,11
SIM,1906,25,45-49,1931,1
STAT,1885,26,50-100,1911,0.6044293732549992
SIM,1824,40,35-39,1864,4
STAT,1876,77,na,1953,843.6508830617022
SIM,1895,15,30-34,1910,1
STAT,1853,12,na,1865,2173.2847682424735
SIM,1826,31,20-24,1857,1
STAT,1885,48,30-34,1933,0.09000578100266776
SIM,1893,22,20-24,1915,97
SIM,1874,18,15-19,1892,3
STAT,1864,28,40-44,1892,2.5133022025574383
STAT,1867,63,na,1930,1582.8171412365152
SIM,1851,13,na,1864,2157
STAT,1825,38,30-34,1863,6.416882851989707
STAT,1883,31,35-39,1914,9.418155807815333
STAT,1865,20,50-100,1885,0.3585520016956822
SIM,1821,47,na,1868,1339
SIM,1873,20,50-100,1893,1
SIM,1939,17,20-24,1956,112
SIM,1901,24,30-34,1925,29
STAT,1913,28,15-19,1941,0.662199707876932
STAT,1898,35,45-49,1933,2.572716023121686
STAT,1846,64,na,1910,1289.3470531134149
SIM,1842,46,na,1888,1531
STAT,1788,68,na,1856,628.3504821200002
SIM,1872,12,na,1884,2517
SIM,1911,29,35-39,1940,16
STAT,1858,47,25-29,1905,0.042464354239646875
SIM,1901,27,na,1928,3142
STAT,1863,40,30-34,1903,0.9627119166068817
STAT,1924,15,45-49,1939,0.5645681326317445
STAT,1927,40,15-19,1967,0.0018244728669151785
SIM,1921,41,na,1962,3984
SIM,1933,22,na,1955,4651
STAT,1930,21,30-34,1951,34.88744107251305
SIM,1903,56,na,1959,2814
SIM,1834,28,20-24,1862,12
STAT,1920,27,45-49,1947,1.7903190415214794
STAT,1939,17,na,1956,3480.607355979363
STAT,1832,39,50-100,1871,0.9182508036803957
STAT,1773,102,na,1875,0.06961148830625656
SIM,1888,34,30-34,1922,21
SIM,1900,42,na,1942,3088
SIM,1850,72,na,1922,933
STAT,1888,62,na,1950,2040.5671694371767
STAT,1892,29,30-34,1921,29.583529656020186
SIM,1858,38,50-100,1896,3
SIM,1840,39,50-100,1879,3
STAT,1828,53,25-29,1881,0.0024707456727313644
STAT,1898,14,na,1912,3290.8419904211805
SIM,1854,27,na,1881,1983
STAT,1850,22,40-44,1872,1.7630815644222266
SIM,1791,91,na,1882,15
SIM,1871,40,30-34,1911,1
STAT,1880,54,40-44,1934,0.0101965265997693
STAT,1899,45,20-24,1944,0.008849162773133858
STAT,1819,68,na,1887,834.6693714745214
SIM,1921,0,na,1921,4530
STAT,1862,45,25-29,1907,0.04698841734941747
SIM,1925,16,15-19,1941,49
STAT,1906,27,45-49,1933,1.5276702930776647
STAT,1889,33,45-49,1922,2.0251587252959284
SIM,1907,30,45-49,1937,2
SIM,1838,41,40-44,1879,4
STAT,1859,37,na,1896,1771.436902152692
STAT,1955,16,35-39,1971,5.263236987044628
SIM,1769,91,na,1860,6
STAT,1897,32,40-44,1929,5.4789312163880854
SIM,1845,9,na,1854,2134
SIM,1833,38,30-34,1871,7
SIM,1847,43,40-44,1890,6
STAT,1877,46,30-34,1923,0.09512699282048036
STAT,1918,18,na,1936,3774.842528975351
STAT,1944,27,30-34,1971,40.006440031518906
SIM,1841,19,15-19,1860,4
STAT,1868,48,na,1916,2002.3959057587447
STAT,1869,16,25-29,1885,5.289097914231569
STAT,1873,63,na,1936,1709.5677201219842
SIM,1883,40,40-44,1923,2
STAT,1875,40,40-44,1915,2.2061179973093075
STAT,1916,26,25-29,1942,64.5126088654279
SIM,1916,26,na,1942,3566
SIM,1890,41,na,1931,2903
STAT,1928,19,45-49,1947,0.5914205743172307
STAT,1844,43,15-19,1887,0.009697996763650145
STAT,1885,44,na,1929,2146.9872320110585
STAT,1917,16,15-19,1933,9.248754371414343
STAT,1926,28,25-29,1954,74.27490585209789
SIM,1839,44,45-49,1883,3
SIM,1896,20,30-34,1916,35
STAT,1830,49,45-49,1879,0.17232515673377646
STAT,1858,37,30-34,1895,3.9475195265981906
SIM,1934,23,30-34,1957,43
STAT,1888,25,25-29,1913,47.54775167581678
STAT,1870,37,30-34,1907,4.939246357698895
SIM,1850,30,35-39,1880,13
SIM,1906,18,20-24,1924,24
STAT,1842,23,45-49,1865,0.6323653424503528
STAT,1794,68,na,1862,708.6903308299069
SIM,1848,30,50-100,1878,4
SIM,1929,22,45-49,1951,1
SIM,1897,33,45-49,1930,2
STAT,1884,37,25-29,1921,2.687214371518531
SIM,1914,27,45-49,1941,1
STAT,1913,30,na,1943,3583.461398662366
STAT,1861,24,25-29,1885,45.53402670919424
SIM,1838,31,na,1869,1788
STAT,1813,42,25-29,1855,2.1004283340976695
STAT,1839,43,40-44,1882,1.558274062108435
SIM,1926,37,30-34,1963,1
STAT,1852,64,na,1916,1260.2859620517117
STAT,1831,102,na,1933,0.17118065546385003
STAT,1857,21,30-34,1878,15.431679937671277
STAT,1904,31,30-34,1935,23.755587032672985
STAT,1826,28,20-24,1854,37.43508000561465
STAT,1837,49,na,1886,1477.3258088282644
SIM,1892,37,25-29,1929,2
SIM,1924,26,25-29,1950,72
SIM,1832,22,30-34,1854,18
STAT,1938,32,na,1970,3592.6053005327703
STAT,1880,33,25-29,1913,10.157918644743129
STAT,1821,54,35-39,1875,0.012546440243432348
STAT,1912,22,25-29,1934,83.63013802123078
SIM,1829,34,25-29,1863,16
STAT,1903,39,45-49,1942,0.5725363411865763
SIM,1804,99,na,1903,2
SIM,1807,80,na,1887,207
STAT,1926,23,30-34,1949,32.88322820643679
STAT,1952,18,25-29,1970,49.04309595610048
STAT,1911,28,30-34,1939,35.97237906475274
STAT,1833,21,45-49,1854,0.6265419056574371
SIM,1896,25,25-29,1921,43
STAT,1856,29,45-49,1885,0.8358948479704535
STAT,1917,47,40-44,1964,0.15557373772009134
STAT,1842,30,35-39,1872,9.045374848696484
STAT,1850,90,na,1940,55.57655934388081
SIM,1860,27,na,1887,1993
STAT,1947,25,40-44,1972,4.986042175648095
STAT,1893,19,20-24,1912,21.12536907172395
SIM,1864,31,40-44,1895,5
SIM,1915,41,na,1956,3393
SIM,1865,71,na,1936,1121
SIM,1837,20,25-29,1857,50
STAT,1843,49,na,1892,1487.9184431181966
STAT,1918,37,30-34,1955,1.814806954041067
STAT,1836,52,20-24,1888,4.8350191867830227E-4
STAT,1935,32,20-24,1967,3.1879128633516127
SIM,1912,31,30-34,1943,13
STAT,1882,30,na,1912,2209.962970649475
STAT,1900,48,25-29,1948,0.04204484095738558
SIM,1819,98,na,1917,2
SIM,1912,39,na,1951,3404
STAT,1911,38,35-39,1949,2.196123517999617
SIM,1837,30,20-24,1867,2
STAT,1861,39,40-44,1900,3.40386548529248
SIM,1928,21,30-34,1949,35
SIM,1928,32,40-44,1960,3
STAT,1859,31,15-19,1890,0.10751255627113389
SIM,1926,24,30-34,1950,38
STAT,1904,40,35-39,1944,0.17211310195939078
SIM,1818,36,25-29,1854,2
STAT,1870,29,35-39,1899,8.878341369016315
STAT,1883,40,na,1923,2162.3016100668615
STAT,1896,21,20-24,1917,86.24069981395844
SIM,1931,17,20-24,1948,165
STAT,1868,26,15-19,1894,0.4103445851083249
STAT,1854,99,na,1953,1.3550334934283268
SIM,1883,19,15-19,1902,5
SIM,1909,27,35-39,1936,17
STAT,1902,43,35-39,1945,0.1664382904188502
STAT,1866,20,50-100,1886,0.363417614802766
STAT,1879,35,na,1914,2351.888709024052
STAT,1866,29,15-19,1895,0.3924952644364819
STAT,1923,17,20-24,1940,150.39167494490002
STAT,1900,35,25-29,1935,3.8090353136169997
STAT,1940,26,na,1966,3610.396299980652
SIM,1880,29,45-49,1909,2
SIM,1852,20,45-49,1872,1
SIM,1885,27,25-29,1912,43
STAT,1877,27,25-29,1904,41.45262807496891
STAT,1908,17,25-29,1925,7.941309319120745
STAT,1932,40,40-44,1972,0.3211370198032668
SIM,1856,35,na,1891,1850
SIM,1961,8,na,1969,4755
STAT,1928,40,20-24,1968,0.021327097946207633
SIM,1835,33,20-24,1868,1
STAT,1757,97,na,1854,1.0
STAT,1941,22,35-39,1963,9.192432931084904
STAT,1873,50,35-39,1923,0.008366998088986518
SIM,1852,45,na,1897,1750
STAT,1944,16,na,1960,3743.025911548021
STAT,1877,8,na,1885,2611.0303928485955
STAT,1859,47,30-34,1906,0.07244368445277205
STAT,1891,23,40-44,1914,2.427990924422521
STAT,1894,24,20-24,1918,83.1394302963126
STAT,1912,17,45-49,1929,0.09542967484756254
SIM,1890,62,na,1952,2305
SIM,1910,32,25-29,1942,10
STAT,1910,28,50-100,1938,0.9048332732481801
STAT,1920,0,na,1920,4774.914725592219
STAT,1936,17,30-34,1953,11.023806765233555
STAT,1913,35,35-39,1948,2.276451550840621
STAT,1921,34,50-100,1955,0.8617627182398155
SIM,1877,80,na,1957,673
STAT,1866,84,na,1950,289.8565314679476
SIM,1882,67,na,1949,1467
SIM,1839,45,50-100,1884,4
SIM,1907,52,na,1959,3063
SIM,1928,38,na,1966,4497
STAT,1930,32,30-34,1962,19.20770701998654
SIM,1869,44,30-34,1913,3
STAT,1868,34,20-24,1902,2.4155213651631398
STAT,1860,52,20-24,1912,5.626112509602041E-4
SIM,1890,32,50-100,1922,1
STAT,1845,23,na,1868,1864.8068178343049
STAT,1765,92,na,1857,7.279122969535678
STAT,1929,27,40-44,1956,5.510604751328163
SIM,1828,39,50-100,1867,3
STAT,1824,32,40-44,1856,10.561166317044128
SIM,1864,30,na,1894,2090
SIM,1832,32,40-44,1864,3
SIM,1937,27,40-44,1964,2
STAT,1902,32,25-29,1934,13.655762080578091
STAT,1913,46,45-49,1959,0.20090580337712005
STAT,1864,21,50-100,1885,0.3513923347399307
STAT,1902,45,30-34,1947,0.07352455738158718
SIM,1871,20,25-29,1891,53
SIM,1891,29,20-24,1920,15
SIM,1898,42,na,1940,2900
STAT,1937,33,25-29,1970,8.633168787462235
SIM,1795,99,na,1894,1
STAT,1829,76,na,1905,572.4549749322649
STAT,1930,30,35-39,1960,11.153542977811972
STAT,1918,35,40-44,1953,1.5047666185135062
SIM,1944,17,30-34,1961,12
STAT,1833,81,na,1914,331.77314345006096
SIM,1935,17,35-39,1952,5
STAT,1876,20,35-39,1896,5.729438888543528
SIM,1826,30,45-49,1856,1
STAT,1822,35,40-44,1857,8.53373006012548
SIM,1872,8,na,1880,2582
SIM,1889,21,25-29,1910,69
SIM,1937,25,45-49,1962,1
SIM,1853,86,na,1939,135
STAT,1895,25,50-100,1920,0.7931893081201469
STAT,1885,21,45-49,1906,0.6586107939700637
SIM,1893,21,45-49,1914,4
SIM,1939,22,45-49,1961,2
SIM,1924,24,na,1948,4053
SIM,1848,20,25-29,1868,53
SIM,1905,27,20-24,1932,20
STAT,1904,42,30-34,1946,0.10804817320841938
STAT,1918,24,30-34,1942,29.100801324403868
SIM,1921,35,35-39,1956,9
STAT,1924,46,20-24,1970,0.012459510388095854
STAT,1851,44,50-100,1895,0.7496933125824783
STAT,1827,33,20-24,1860,3.1110303955967726
SIM,1835,20,15-19,1855,5
SIM,1830,35,40-44,1865,4
STAT,1877,15,30-34,1892,1.5691446561581428
STAT,1900,48,30-34,1948,0.07065869173438236
STAT,1807,103,na,1910,0.05338015337280482
STAT,1829,30,20-24,1859,2.8518106623189765
SIM,1878,22,na,1900,2383
STAT,1863,20,25-29,1883,49.106011527670724
SIM,1924,27,30-34,1951,49
STAT,1862,94,na,1956,18.524959927275653
STAT,1863,33,30-34,1896,14.413325641787956
SIM,1920,34,na,1954,3917
STAT,1907,49,25-29,1956,0.044384814519360216
STAT,1872,29,45-49,1901,1.0445784456325444
SIM,1885,16,15-19,1901,5
STAT,1915,43,45-49,1958,0.1580432539765428
SIM,1869,31,25-29,1900,12
STAT,1887,30,na,1917,2541.8462182159915
STAT,1811,49,25-29,1860,0.18563499775824896
STAT,1837,71,na,1908,866.264143545523
STAT,1932,40,50-100,1972,0.15083335029642356
STAT,1846,36,35-39,1882,5.535492618377723
SIM,1887,24,25-29,1911,57
STAT,1880,48,35-39,1928,0.13767892697693812
STAT,1820,38,40-44,1858,9.473217232363963
STAT,1917,40,45-49,1957,0.16453538284158603
SIM,1903,62,na,1965,2652
STAT,1907,38,15-19,1945,0.01673648325821073
STAT,1865,30,30-34,1895,15.070337072567353
STAT,1915,32,35-39,1947,8.792516799119358
SIM,1907,24,20-24,1931,85
STAT,1821,108,na,1929,9.758802492384432E-4
SIM,1880,23,30-34,1903,25
SIM,1916,29,na,1945,3558
STAT,1806,49,50-100,1855,0.8771525440428997
SIM,1900,29,40-44,1929,5
STAT,1909,46,25-29,1955,0.04616359148190828
STAT,1830,54,30-34,1884,0.0037704824210972702
SIM,1888,44,40-44,1932,7
SIM,1923,32,35-39,1955,17
STAT,1916,27,30-34,1943,38.27280630713776
STAT,1926,43,20-24,1969,0.020534427718843597
STAT,1849,13,na,1862,2193.4829348403537
STAT,1879,24,25-29,1903,56.25427088224122
SIM,1882,36,50-100,1918,3
STAT,1828,51,na,1879,1325.3822777568234
SIM,1911,24,40-44,1935,1
SIM,1837,36,35-39,1873,11
STAT,1891,75,na,1966,1521.2413319664577
STAT,1890,10,na,1900,2991.737988842626
SIM,1916,19,20-24,1935,130
SIM,1767,100,na,1867,1
STAT,1878,47,40-44,1925,0.16776413814374136
STAT,1830,41,25-29,1871,0.5065734421360558
STAT,1895,47,40-44,1942,0.11838229913534229
STAT,1896,27,35-39,1923,12.03882753376904
STAT,1891,51,na,1942,2528.692184947062
STAT,1925,37,na,1962,4265.623797417833
SIM,1823,48,na,1871,1325
STAT,1922,36,15-19,1958,0.02066125283591633
STAT,1806,48,na,1854,1256.410588559943
STAT,1895,65,na,1960,2198.766996724705
STAT,1914,16,40-44,1930,0.2740109311373462
STAT,1924,33,15-19,1957,0.141540594588496
STAT,1807,89,na,1896,39.07446816759327
STAT,1850,53,na,1903,1493.4480563345646
STAT,1942,17,30-34,1959,12.033410623185505
STAT,1946,22,40-44,1968,3.5347624331832277
STAT,1810,53,na,1863,1125.8919588422775
STAT,1835,46,30-34,1881,0.06577822780346254
STAT,1917,43,25-29,1960,0.0702898458904289
STAT,1944,28,45-49,1972,1.7630899367078698
STAT,1844,20,15-19,1864,2.9023028089300005
SIM,1950,17,30-34,1967,18
SIM,1919,3,na,1922,4287
STAT,1929,27,na,1956,4428.955550150184
STAT,1842,37,50-100,1879,1.0429926036263217
STAT,1808,105,na,1913,0.011336990595576394
STAT,1873,78,na,1951,748.606171431923
SIM,1852,39,35-39,1891,15
SIM,1874,32,na,1906,2229
STAT,1828,35,na,1863,1595.9765194498425
SIM,1849,15,20-24,1864,14
SIM,1859,48,50-100,1907,3
STAT,1858,73,na,1931,879.7463893011893
STAT,1903,24,40-44,1927,2.7834218668936344
STAT,1914,4,na,1918,3931.4331524237027
STAT,1875,17,50-100,1892,0.047571833056235587
STAT,1944,17,35-39,1961,4.265936181044077
STAT,1899,71,na,1970,2091.986867906016
STAT,1952,20,15-19,1972,6.050344562499136
STAT,1853,109,na,1962,0.0021804461974417886
SIM,1922,16,40-44,1938,1
STAT,1891,46,15-19,1937,2.644644971442816E-4
STAT,1885,37,30-34,1922,5.018562652712358
STAT,1927,17,35-39,1944,4.928757596641992
SIM,1858,41,45-49,1899,2
STAT,1892,20,50-100,1912,0.4853971070024853
SIM,1879,63,na,1942,1800
STAT,1844,39,35-39,1883,5.0842713828944515
SIM,1935,28,45-49,1963,2
SIM,1799,89,na,1888,31
SIM,1957,11,na,1968,4912
STAT,1848,30,30-34,1878,15.44699165744119
STAT,1838,23,25-29,1861,49.50461072786301
STAT,1851,18,15-19,1869,5.159724141014379
SIM,1866,15,20-24,1881,16
STAT,1774,85,na,1859,63.88009082846666
STAT,1818,46,30-34,1864,0.20952965229510181
SIM,1832,25,na,1857,1705
SIM,1836,39,na,1875,1607
STAT,1778,99,na,1877,0.32078054427766
STAT,1924,39,50-100,1963,0.46669643669856103
STAT,1882,15,na,1897,2331.0936674516556
STAT,1920,25,25-29,1945,68.6720910214298
STAT,1927,28,45-49,1955,1.9770998800894573
SIM,1858,30,35-39,1888,12
SIM,1819,37,50-100,1856,1
SIM,1861,81,na,1942,412
STAT,1841,17,na,1858,2041.0162371161884
STAT,1901,26,50-100,1927,0.848794888245894
SIM,1856,30,30-34,1886,21
SIM,1910,0,na,1910,3909
SIM,1820,83,na,1903,181
STAT,1796,72,na,1868,542.7628013841377
STAT,1878,93,na,1971,124.99153791350156
STAT,1900,32,45-49,1932,2.2852867765139853
SIM,1846,23,25-29,1869,56
STAT,1866,6,na,1872,2451.830367232561
SIM,1783,74,na,1857,377
SIM,1865,95,na,1960,23
SIM,1893,37,30-34,1930,9
STAT,1953,18,45-49,1971,0.5706683488548338
SIM,1873,33,40-44,1906,6
STAT,1903,25,25-29,1928,57.24530393725379
SIM,1936,33,na,1969,2872
SIM,1863,23,25-29,1886,46
STAT,1874,23,35-39,1897,5.615137368959297
STAT,1840,15,35-39,1855,0.47176545623496274
STAT,1869,33,na,1902,2174.7105272509625
SIM,1916,17,25-29,1933,7
STAT,1858,15,20-24,1873,15.521282421441892
SIM,1838,65,na,1903,1104
SIM,1952,17,35-39,1969,7
STAT,1933,28,15-19,1961,0.8850931056230072
STAT,1949,15,15-19,1964,49.89126160945595
STAT,1821,51,25-29,1872,0.005479839961165511
SIM,1928,14,na,1942,4711
SIM,1878,31,20-24,1909,3
STAT,1861,20,45-49,1881,0.5708800809659577
STAT,1820,71,na,1891,703.1832188400758
STAT,1839,40,30-34,1879,0.9095454431347048
STAT,1915,19,na,1934,3798.364825115308
SIM,1931,18,na,1949,4505
STAT,1821,96,na,1917,4.5746800914463845
SIM,1911,25,25-29,1936,68
SIM,1841,61,na,1902,1228
STAT,1908,19,20-24,1927,24.71138984614991
SIM,1878,37,35-39,1915,10
STAT,1845,82,na,1927,330.1671840639118
STAT,1933,39,25-29,1972,1.2642343656137787
SIM,1897,31,30-34,1928,29
STAT,1900,21,35-39,1921,7.6705109482084
SIM,1847,40,30-34,1887,5
SIM,1861,23,20-24,1884,58
STAT,1849,96,na,1945,6.438859730940548
STAT,1939,20,50-100,1959,0.6247023505557827
STAT,1804,51,25-29,1855,0.012771196882943434
STAT,1840,38,50-100,1878,0.943120293479904
STAT,1889,31,30-34,1920,20.44569430653923
STAT,1848,49,20-24,1897,0.008730522815458238
STAT,1844,20,45-49,1864,0.6134657831294281
STAT,1875,45,na,1920,2206.4082105941834
SIM,1861,6,na,1867,2455
STAT,1927,44,na,1971,4385.484499027083
SIM,1894,52,na,1946,2713
STAT,1847,30,na,1877,1915.8051870450915
STAT,1884,19,50-100,1903,0.045479920790809154
SIM,1862,47,na,1909,1898
SIM,1914,46,na,1960,3458
STAT,1876,47,30-34,1923,0.09403680676403751
STAT,1923,40,45-49,1963,0.18427206896877185
SIM,1907,36,na,1943,3323
STAT,1855,23,25-29,1878,47.18340975926923
STAT,1895,40,15-19,1935,0.017179786730250432
SIM,1836,98,na,1934,2
STAT,1837,46,40-44,1883,0.11682579769890152
STAT,1871,42,25-29,1913,0.6016480849339675
STAT,1935,7,na,1942,5162.335302277166
SIM,1937,27,50-100,1964,4
SIM,1842,18,15-19,1860,3
STAT,1853,23,20-24,1876,61.178184897960165
SIM,1903,22,na,1925,3184
STAT,1816,66,na,1882,877.1152454331097
SIM,1835,36,25-29,1871,4
SIM,1815,53,na,1868,1272
SIM,1935,23,15-19,1958,6
STAT,1871,52,50-100,1923,0.014092050237386869
STAT,1850,45,15-19,1895,2.8478022751491033E-4
STAT,1836,46,na,1882,1544.3282922715227
SIM,1897,34,35-39,1931,12
SIM,1926,27,35-39,1953,18
STAT,1839,35,na,1874,1739.8600730067744
SIM,1874,47,50-100,1921,4
STAT,1838,23,50-100,1861,0.3526472139838263
STAT,1856,107,na,1963,0.017421534127387447
SIM,1854,39,45-49,1893,2
STAT,1840,51,na,1891,1419.7936093107428
STAT,1810,47,50-100,1857,0.8195951312689065
STAT,1894,27,25-29,1921,51.35601735130583
SIM,1785,81,na,1866,166
STAT,1940,19,50-100,1959,0.3591224532547718
STAT,1924,38,15-19,1962,0.021369719751543278
SIM,1899,24,na,1923,3102
STAT,1817,51,na,1868,1267.5044757815156
SIM,1874,88,na,1962,212
STAT,1911,35,30-34,1946,1.6788630734488095
STAT,1907,37,30-34,1944,1.5963621811895128
STAT,1899,7,na,1906,3372.380039659689
SIM,1777,86,na,1863,54
SIM,1915,31,na,1946,3493
STAT,1921,40,35-39,1961,0.2148541617343003
SIM,1811,63,na,1874,838
SIM,1885,16,na,1901,2436
STAT,1906,17,20-24,1923,24.39275385880447
SIM,1892,45,na,1937,3004
SIM,1914,17,20-24,1931,22
STAT,1772,103,na,1875,0.04519789155937261
SIM,1896,59,na,1955,2413
STAT,1815,42,40-44,1857,5.693334125155178
STAT,1896,24,25-29,1920,70.9773862717266
SIM,1899,31,35-39,1930,11
STAT,1917,40,15-19,1957,0.0015182043311951078
STAT,1790,105,na,1895,0.0058184460547865795
STAT,1888,16,45-49,1904,0.07310830945255865
STAT,1853,29,35-39,1882,7.587866954345722
STAT,1878,44,30-34,1922,1.1165939107355132
STAT,1832,56,na,1888,1239.4417949860535
STAT,1909,19,50-100,1928,0.06903850551092802
SIM,1939,31,50-100,1970,3
STAT,1835,49,40-44,1884,0.11194852915195395
SIM,1919,21,na,1940,3857
STAT,1829,33,25-29,1862,9.943718125457746
STAT,1835,30,45-49,1865,1.4426713878177506
SIM,1941,27,30-34,1968,45
SIM,1882,27,na,1909,2255
STAT,1915,43,15-19,1958,0.001458300023736359
STAT,1827,36,25-29,1863,3.0610450605234027
SIM,1920,18,na,1938,3936
SIM,1773,96,na,1869,1
STAT,1833,22,35-39,1855,4.820601735175894
STAT,1902,40,30-34,1942,0.10751296678399389
SIM,1831,47,50-100,1878,2
SIM,1886,44,30-34,1930,2
STAT,1851,7,na,1858,2164.7196192549527
STAT,1874,20,30-34,1894,17.295414748121413
STAT,1846,39,45-49,1885,1.5123140973459368
STAT,1930,35,35-39,1965,2.985550891971071
SIM,1861,29,35-39,1890,12
SIM,1886,73,na,1959,1263
STAT,1915,37,50-100,1952,0.400689638043305
STAT,1954,18,na,1972,4296.908947278026
STAT,1776,100,na,1876,0.20124341423266726
SIM,1930,25,35-39,1955,23
SIM,1907,27,30-34,1934,45
STAT,1919,17,30-34,1936,12.724678458476523
SIM,1895,37,35-39,1932,16
SIM,1921,30,35-39,1951,10
SIM,1903,46,na,1949,3038
SIM,1888,41,30-34,1929,1
STAT,1862,52,25-29,1914,0.002845719155910889
SIM,1790,68,na,1858,620
STAT,1887,37,35-39,1924,7.473845064522675
SIM,1906,11,na,1917,3543
STAT,1846,20,25-29,1866,53.149381171917376
STAT,1901,28,25-29,1929,55.74004064901889
SIM,1824,73,na,1897,575
STAT,1894,16,15-19,1910,7.222533396915584
SIM,1915,37,30-34,1952,1
SIM,1835,20,45-49,1855,1
STAT,1813,54,30-34,1867,0.01495157356556445
STAT,1852,17,na,1869,2012.7434391393435
STAT,1859,20,35-39,1879,5.075175575246802
SIM,1885,15,30-34,1900,2
SIM,1843,30,45-49,1873,1
SIM,1904,32,25-29,1936,9
STAT,1904,35,na,1939,3248.231598370404
STAT,1908,49,na,1957,3120.3961157760455
STAT,1785,69,na,1854,673.9999999999999
STAT,1781,79,na,1860,260.48012892425015
SIM,1902,21,na,1923,3151
STAT,1878,10,na,1888,2574.3896254555775
SIM,1850,39,30-34,1889,9
SIM,1860,40,na,1900,1955
STAT,1868,37,25-29,1905,2.5951416720803526
STAT,1842,39,30-34,1881,4.0354210611844605
STAT,1833,97,na,1930,3.296010911672409
SIM,1846,76,na,1922,638
SIM,1849,65,na,1914,1245
STAT,1938,28,20-24,1966,17.07617148835117
SIM,1845,37,50-100,1882,3
STAT,1808,53,50-100,1861,0.05347395980783238
STAT,1832,101,na,1933,0.34374445828911004
STAT,1880,45,30-34,1925,0.09736762608696367
STAT,1933,27,30-34,1960,49.149007167108785
SIM,1941,1,na,1942,3900
STAT,1902,48,35-39,1950,0.10396455755951262
STAT,1823,47,50-100,1870,0.3025078015161359
STAT,1822,32,30-34,1854,50.90993499732516
SIM,1876,37,25-29,1913,1
STAT,1842,28,20-24,1870,10.430780247716973
STAT,1913,30,35-39,1943,8.6585253800408
SIM,1860,41,50-100,1901,1
SIM,1850,28,20-24,1878,10
STAT,1917,41,50-100,1958,0.11598815316108457
SIM,1867,20,35-39,1887,8
SIM,1918,28,45-49,1946,1
STAT,1933,32,na,1965,4814.913483817903
SIM,1902,38,35-39,1940,4
SIM,1830,32,30-34,1862,26
SIM,1875,73,na,1948,1081
STAT,1946,1,na,1947,4319.438524103142
STAT,1890,16,50-100,1906,0.05672291634979941
STAT,1831,31,na,1862,1654.0122652201733
STAT,1836,101,na,1937,0.36951676186784294
STAT,1937,30,20-24,1967,2.282314857042925
STAT,1862,52,30-34,1914,0.004782389183108889
SIM,1837,33,25-29,1870,14
SIM,1847,41,50-100,1888,1
STAT,1835,45,na,1880,1548.4415280368805
STAT,1918,38,45-49,1956,0.6781286833783137
SIM,1842,86,na,1928,121
STAT,1841,32,40-44,1873,3.6275004985317927
SIM,1837,22,15-19,1859,3
STAT,1811,94,na,1905,8.667815818099962
SIM,1926,38,45-49,1964,3
STAT,1899,16,20-24,1915,23.004219008689763
SIM,1835,39,35-39,1874,10
SIM,1829,25,45-49,1854,1
SIM,1904,35,35-39,1939,9
STAT,1827,39,35-39,1866,7.0043289102818465
SIM,1928,37,40-44,1965,1
STAT,1891,20,30-34,1911,20.942878302575913
STAT,1852,42,15-19,1894,0.009999610362934818
SIM,1885,24,20-24,1909,74
STAT,1834,46,50-100,1880,0.1799209492592145
STAT,1859,31,45-49,1890,1.3165216205435262
STAT,1918,27,35-39,1945,15.09424560835709
STAT,1877,24,20-24,1901,67.10699271835608
STAT,1904,45,35-39,1949,0.10807790644724691
SIM,1867,31,45-49,1898,1
STAT,1857,48,na,1905,1655.206226377014
SIM,1918,17,35-39,1935,5
STAT,1953,17,30-34,1970,13.928767748692517
SIM,1854,36,35-39,1890,15
SIM,1817,40,45-49,1857,5
SIM,1830,42,na,1872,1542
SIM,1866,37,na,1903,2097
STAT,1848,33,35-39,1881,7.90319953819543
STAT,1903,16,35-39,1919,0.7393600620832752
STAT,1921,43,45-49,1964,0.17680592745118248
SIM,1828,30,25-29,1858,14
STAT,1806,88,na,1894,47.60767809737544
SIM,1809,49,50-100,1858,1
SIM,1935,27,30-34,1962,51
SIM,1863,48,na,1911,1847
STAT,1816,49,30-34,1865,0.22145107443699777
SIM,1837,33,30-34,1870,14
STAT,1812,51,50-100,1863,0.04929346973553527
SIM,1943,20,15-19,1963,4
STAT,1903,27,45-49,1930,1.4924164409755312
STAT,1905,21,40-44,1926,2.854019887194563
STAT,1944,25,40-44,1969,4.763190199459078
STAT,1912,19,40-44,1931,0.265770198809093
SIM,1878,23,15-19,1901,2
STAT,1847,15,45-49,1862,0.060834536380281704
STAT,1802,74,na,1876,461.88179004488217
SIM,1930,22,25-29,1952,118
SIM,1949,16,na,1965,3976
SIM,1911,27,45-49,1938,1
STAT,1806,64,na,1870,867.8083649701016
SIM,1920,19,40-44,1939,1
STAT,1876,31,45-49,1907,1.7089341902873325
SIM,1893,67,na,1960,2058
SIM,1844,10,na,1854,2079
SIM,1895,21,25-29,1916,93
SIM,1913,21,40-44,1934,2
SIM,1848,24,na,1872,1873
STAT,1887,21,25-29,1908,60.673165220500266
STAT,1853,26,25-29,1879,37.35447495545465
SIM,1856,33,35-39,1889,7
STAT,1858,19,50-100,1877,0.04189061188494567
STAT,1893,43,15-19,1936,0.0011405887240050069
SIM,1878,62,na,1940,1801
SIM,1884,31,45-49,1915,2
STAT,1911,32,20-24,1943,2.2438907518605675
STAT,1927,27,30-34,1954,44.999423783142845
STAT,1795,87,na,1882,60.76018603005162
STAT,1855,20,20-24,1875,58.04081977066069
STAT,1929,25,45-49,1954,2.050247662901534
SIM,1841,45,na,1886,1528
SIM,1862,30,25-29,1892,12
SIM,1889,35,45-49,1924,2
STAT,1865,27,na,1892,2043.4991374507356
SIM,1909,21,20-24,1930,91
STAT,1909,30,15-19,1939,0.11678206733516613
STAT,1909,49,35-39,1958,0.11126887322911459
SIM,1918,36,na,1954,3765
SIM,1853,16,25-29,1869,5
STAT,1911,29,na,1940,3426.711975006164
STAT,1886,17,25-29,1903,5.65488719616681
SIM,1835,73,na,1908,734
STAT,1803,106,na,1909,0.004081341565536483
STAT,1883,29,20-24,1912,10.788166909760884
SIM,1840,20,na,1860,1858
STAT,1897,44,40-44,1941,0.1946695357803092
STAT,1854,30,25-29,1884,7.662238988106871
STAT,1935,36,25-29,1971,1.3018274602598374
STAT,1937,22,na,1959,3359.4738590788193
SIM,1871,83,na,1954,325
STAT,1886,45,na,1931,2267.5225625304033
STAT,1811,44,25-29,1855,2.2462551453691595
STAT,1849,111,na,1960,1.5432483158742474E-4
STAT,1917,40,20-24,1957,0.017459348865749146
STAT,1816,38,20-24,1854,2.8387563460656646
STAT,1831,28,45-49,1859,0.929974885239406
STAT,1837,43,30-34,1880,0.8692435024676995
SIM,1911,57,na,1968,3104
STAT,1896,24,30-34,1920,22.084999429877286
SIM,1849,18,25-29,1867,9
SIM,1905,19,15-19,1924,7
SIM,1962,4,na,1966,4635
STAT,1829,33,30-34,1862,16.950230898753787
STAT,1861,36,30-34,1897,4.206463788886837
STAT,1881,14,na,1895,2349.184708721084
STAT,1967,4,na,1971,4639.781245033143
SIM,1878,34,25-29,1912,19
SIM,1845,43,30-34,1888,1
SIM,1946,17,40-44,1963,1
STAT,1908,25,na,1933,3367.1450504070594
STAT,1895,2,na,1897,3283.0233127713564
STAT,1874,20,25-29,1894,55.58448562359559
SIM,1859,25,30-34,1884,23
SIM,1894,17,25-29,1911,10
STAT,1907,40,na,1947,3250.9235000477534
SIM,1854,20,25-29,1874,57
SIM,1863,20,20-24,1883,60
SIM,1841,22,35-39,1863,5
STAT,1903,22,20-24,1925,92.62888380307884
SIM,1861,15,15-19,1876,4
STAT,1765,107,na,1872,0.0054498491933136555
STAT,1901,17,15-19,1918,7.847504786680072
SIM,1861,26,25-29,1887,35
STAT,1814,50,50-100,1864,0.04592927362200956
SIM,1911,22,20-24,1933,93
STAT,1828,40,25-29,1868,0.5629820904609841
STAT,1845,16,25-29,1861,5.0982433652510055
STAT,1825,86,na,1911,117.92401310332575
STAT,1895,31,25-29,1926,12.66633012865182
SIM,1873,90,na,1963,118
STAT,1902,6,na,1908,3482.876874245655
STAT,1853,15,15-19,1868,5.466885737368456
SIM,1816,94,na,1910,12
SIM,1833,23,45-49,1856,2
STAT,1837,28,na,1865,1788.9872519737153
SIM,1927,17,30-34,1944,15
SIM,1873,30,30-34,1903,21
SIM,1878,34,30-34,1912,21
STAT,1949,18,25-29,1967,47.59921983867517
STAT,1903,30,50-100,1933,1.2414730855660578
SIM,1911,16,35-39,1927,2
STAT,1955,16,na,1971,4616.786436600602
SIM,1843,49,40-44,1892,1
STAT,1861,13,na,1874,2145.4765874177315
STAT,1899,55,na,1954,2676.453993998228
STAT,1922,22,25-29,1944,100.0682253160338
STAT,1923,9,na,1932,4415.9191637109525
STAT,1938,17,40-44,1955,1.3034638309566735
STAT,1858,108,na,1966,0.01133126227723305
STAT,1889,34,35-39,1923,11.70962114606685
STAT,1820,35,50-100,1855,3.1943156020103807
STAT,1800,54,20-24,1854,0.002065636356123999
STAT,1854,83,na,1937,284.03824941250497
STAT,1845,52,25-29,1897,0.002493087455595568
SIM,1889,24,35-39,1913,8
SIM,1879,15,30-34,1894,4
SIM,1879,47,na,1926,2276
SIM,1906,25,50-100,1931,4
STAT,1872,26,35-39,1898,9.174481874283801
SIM,1858,61,na,1919,1521
SIM,1875,33,na,1908,2313
SIM,1789,71,na,1860,498
SIM,1924,34,50-100,1958,5
SIM,1871,36,40-44,1907,3
STAT,1952,11,na,1963,4447.63458710383
STAT,1856,43,40-44,1899,1.645915048391302
STAT,1915,46,25-29,1961,0.050622152675580234
STAT,1920,28,35-39,1948,15.503742332264306
STAT,1955,15,45-49,1970,0.6267323988011426
STAT,1815,84,na,1899,148.48730202041725
STAT,1928,41,35-39,1969,0.24285185286976496
SIM,1853,30,na,1883,1863
SIM,1890,2,na,1892,3300
SIM,1782,92,na,1874,8
STAT,1842,58,na,1900,1432.1410730496698
SIM,1876,95,na,1971,72
SIM,1861,65,na,1926,1458
STAT,1876,46,na,1922,2202.089833979709
SIM,1859,34,20-24,1893,1
SIM,1878,43,50-100,1921,2
STAT,1839,51,na,1890,1440.4343742343876
STAT,1849,17,45-49,1866,0.06029449643414562
STAT,1895,44,30-34,1939,0.09699787314399
STAT,1937,24,35-39,1961,8.656289861070201
STAT,1833,45,15-19,1878,2.949434313361365E-4
STAT,1880,51,na,1931,2154.674977118953
STAT,1924,36,25-29,1960,1.09779042684744
STAT,1846,33,25-29,1879,8.884994164360894
SIM,1838,41,na,1879,1644
SIM,1880,20,20-24,1900,65
SIM,1934,9,na,1943,4968
SIM,1867,37,50-100,1904,1
SIM,1859,24,na,1883,1954
STAT,1939,32,45-49,1971,1.516761264279058
SIM,1834,51,na,1885,1359
STAT,1937,35,45-49,1972,0.6451041790438156
SIM,1904,20,30-34,1924,32
STAT,1897,40,25-29,1937,0.05690610086168721
SIM,1847,43,35-39,1890,4
STAT,1769,104,na,1873,0.02493648523613294
SIM,1816,38,na,1854,1493
STAT,1838,26,35-39,1864,8.299875851058365
STAT,1855,23,30-34,1878,14.681374341453024
SIM,1854,36,40-44,1890,7
SIM,1918,23,15-19,1941,5
SIM,1885,32,na,1917,2276
SIM,1801,61,na,1862,920
SIM,1796,84,na,1880,104
STAT,1864,17,40-44,1881,0.15930877167484855
STAT,1887,9,na,1896,2741.70805297738
STAT,1840,48,na,1888,1469.9536484726525
SIM,1824,33,na,1857,1599
STAT,1865,83,na,1948,339.92653770375915
STAT,1941,27,na,1968,3660.946194496375
SIM,1805,75,na,1880,405
SIM,1927,13,na,1940,4630
STAT,1827,66,na,1893,946.7442544619311
SIM,1854,22,15-19,1876,2
STAT,1857,109,na,1966,0.004314775765082804
SIM,1782,89,na,1871,24
SIM,1851,44,na,1895,1707
STAT,1900,29,na,1929,3105.1961905654457
STAT,1926,34,30-34,1960,17.973393308770376
SIM,1883,68,na,1951,1346
SIM,1913,25,35-39,1938,19
STAT,1854,43,na,1897,1641.7117820795445
SIM,1854,39,50-100,1893,4
SIM,1906,51,na,1957,2992
STAT,1853,98,na,1951,2.458483393782516
SIM,1861,26,30-34,1887,24
STAT,1905,25,35-39,1930,13.264945009785489
SIM,1854,33,25-29,1887,16
STAT,1928,42,40-44,1970,0.30122049245651106
STAT,1902,42,20-24,1944,0.014685177759945274
STAT,1931,26,15-19,1957,0.8613824800565215
SIM,1920,15,25-29,1935,60
STAT,1856,32,50-100,1888,0.6836127186192681
STAT,1912,15,25-29,1927,8.316989202836194
STAT,1891,39,20-24,1930,0.891886017495864
STAT,1911,46,50-100,1957,0.20279258879741577
STAT,1839,43,35-39,1882,1.2545122722226105
STAT,1853,26,30-34,1879,22.23699875685027
SIM,1873,47,na,1920,2153
STAT,1846,22,15-19,1868,3.0191349509544305
STAT,1928,31,30-34,1959,18.62091696989615
STAT,1949,15,20-24,1964,149.04224967857974
STAT,1832,42,40-44,1874,1.6634137487683347
STAT,1824,48,20-24,1872,0.014422517112008038
STAT,1863,45,30-34,1908,0.08104892081118902
SIM,1871,33,30-34,1904,22
SIM,1827,78,na,1905,422
SIM,1934,34,30-34,1968,29
SIM,1843,49,35-39,1892,1
SIM,1864,70,na,1934,1209
SIM,1909,36,25-29,1945,4
STAT,1827,36,30-34,1863,5.666189823987509
STAT,1830,92,na,1922,25.137329400995473
STAT,1899,19,25-29,1918,7.295692269399791
STAT,1863,17,na,1880,2171.4579060267724
SIM,1900,25,25-29,1925,53
SIM,1846,26,35-39,1872,14
SIM,1898,9,na,1907,3267
SIM,1915,21,45-49,1936,2
SIM,1848,34,45-49,1882,1
SIM,1902,33,35-39,1935,10
STAT,1854,28,50-100,1882,0.47636364288598076
STAT,1883,29,15-19,1912,0.4172219280321771
SIM,1837,21,30-34,1858,27
SIM,1937,34,na,1971,3435
SIM,1788,89,na,1877,34
SIM,1917,14,na,1931,4011
STAT,1882,32,50-100,1914,0.8417688663416294
STAT,1852,47,20-24,1899,0.008659276354559238
STAT,1918,24,na,1942,3697.4818705338253
SIM,1884,20,35-39,1904,7
STAT,1816,38,15-19,1854,0.20679684593037026
SIM,1848,23,35-39,1871,13
STAT,1854,43,30-34,1897,0.816628337463956
STAT,1851,105,na,1956,0.026127140774783092
SIM,1813,89,na,1902,44
SIM,1842,32,50-100,1874,3
STAT,1909,50,na,1959,3160.500994220875
STAT,1917,45,15-19,1962,3.652005246598058E-4
SIM,1904,31,40-44,1935,3
STAT,1835,30,15-19,1865,0.11781446376814954
STAT,1917,20,50-100,1937,0.6645995356389159
STAT,1852,3,na,1855,2477.3684
STAT,1893,39,na,1932,2794.1183390314573
STAT,1915,21,50-100,1936,0.6444985823624504
SIM,1863,23,30-34,1886,12
SIM,1913,24,na,1937,3348
STAT,1816,42,50-100,1858,2.849800449366505
STAT,1887,34,25-29,1921,10.730535263410575
STAT,1894,27,30-34,1921,30.572071896596377
SIM,1859,22,20-24,1881,50
SIM,1895,34,25-29,1929,20
SIM,1863,32,na,1895,1979
STAT,1900,44,15-19,1944,0.00123978759086116
SIM,1885,18,35-39,1903,1
SIM,1830,44,30-34,1874,4
SIM,1847,39,na,1886,1769
SIM,1903,19,35-39,1922,2
STAT,1800,94,na,1894,7.9451261712068115
SIM,1902,35,30-34,1937,3
STAT,1822,97,na,1919,2.7298382095716818
STAT,1875,50,45-49,1925,0.014294271583020254
SIM,1882,23,35-39,1905,8
STAT,1918,33,20-24,1951,2.4382899609914714
STAT,1900,39,40-44,1939,1.225762105415662
SIM,1945,24,35-39,1969,12
STAT,1841,47,45-49,1888,0.16343880306111072
SIM,1926,33,20-24,1959,2
STAT,1855,84,na,1939,236.3993392916839
STAT,1835,49,35-39,1884,0.0915466946110795
STAT,1789,99,na,1888,0.32865423789055603
STAT,1931,15,35-39,1946,5.21259816122256
SIM,1950,19,20-24,1969,137
SIM,1926,21,20-24,1947,119
STAT,1862,50,50-100,1912,0.012374072157256388
STAT,1865,33,35-39,1898,8.63487054670327
STAT,1878,40,15-19,1918,0.013733250897057256
STAT,1857,106,na,1963,0.04201841359255167
STAT,1836,23,20-24,1859,58.47213583683679
SIM,1943,21,20-24,1964,91
STAT,1885,42,50-100,1927,0.9935763641816089
SIM,1805,78,na,1883,301
STAT,1822,47,35-39,1869,0.18827072710433923
STAT,1873,43,40-44,1916,2.139496032332634
STAT,1843,59,na,1902,1312.7064436202381
SIM,1907,27,25-29,1934,57
SIM,1933,19,20-24,1952,169
STAT,1850,49,30-34,1899,0.06681185586139976
STAT,1906,40,45-49,1946,0.14444025346408113
STAT,1852,30,50-100,1882,0.7022000633148892
SIM,1822,63,na,1885,975
STAT,1901,19,35-39,1920,0.7216899151242933
STAT,1850,38,20-24,1888,0.5462921784719162
SIM,1918,25,40-44,1943,6
STAT,1942,19,20-24,1961,133.75737173172922
STAT,1921,45,35-39,1966,0.1379519604808365
STAT,1821,56,na,1877,1183.7834603269089
STAT,1829,36,na,1865,1670.9167706922672
SIM,1937,23,25-29,1960,77
STAT,1787,95,na,1882,2.499663404567582
STAT,1831,25,40-44,1856,2.766807430819748
SIM,1881,43,40-44,1924,5
STAT,1906,42,35-39,1948,0.17280224837126987
SIM,1801,64,na,1865,810
STAT,1858,50,45-49,1908,0.010903544963043825
SIM,1940,30,45-49,1970,1
SIM,1852,85,na,1937,159
STAT,1931,26,45-49,1957,2.1079795086493256
STAT,1900,32,15-19,1932,0.1866258930515718
SIM,1919,34,35-39,1953,7
STAT,1918,21,20-24,1939,113.6370177111435
SIM,1835,36,30-34,1871,7
SIM,1895,31,20-24,1926,3
STAT,1818,73,na,1891,583.3038037249954
STAT,1898,30,na,1928,3075.2288517927445
SIM,1844,23,20-24,1867,65
SIM,1831,86,na,1917,104
STAT,1818,41,50-100,1859,2.57673339331757
STAT,1898,42,50-100,1940,0.09367218955171414
SIM,1871,43,na,1914,2186
SIM,1875,57,na,1932,1905
STAT,1920,23,35-39,1943,9.858293601469267
SIM,1879,18,35-39,1897,1
STAT,1923,26,50-100,1949,1.083261356846763
SIM,1864,43,40-44,1907,5
STAT,1929,23,25-29,1952,110.00357666874895
SIM,1887,27,35-39,1914,12
STAT,1879,27,35-39,1906,9.54156669839222
STAT,1865,34,50-100,1899,0.7778330748667905
STAT,1935,21,20-24,1956,143.09144034254206
SIM,1928,36,35-39,1964,6
STAT,1902,48,40-44,1950,0.1271338015224474
SIM,1920,1,na,1921,4380
STAT,1842,21,50-100,1863,0.3751724431652113
STAT,1861,20,15-19,1881,2.7008301165512965
STAT,1905,36,45-49,1941,0.5903681377381433
STAT,1925,19,20-24,1944,153.88304440111224
STAT,1926,46,30-34,1972,0.10416729616691273
STAT,1852,45,25-29,1897,0.042175529523178254
STAT,1852,33,na,1885,1772.7490198566024
SIM,1871,37,50-100,1908,1
SIM,1882,9,na,1891,2480
STAT,1877,16,15-19,1893,5.829754838919007
STAT,1914,27,20-24,1941,17.384508202025554
SIM,1887,42,na,1929,2383
SIM,1918,18,40-44,1936,1
SIM,1876,37,30-34,1913,3
SIM,1871,39,45-49,1910,4
STAT,1912,14,na,1926,3760.57471006069
SIM,1803,71,na,1874,556
STAT,1922,36,45-49,1958,0.7334743884469874
STAT,1941,30,40-44,1971,3.8858355252298677
SIM,1907,29,20-24,1936,16
STAT,1932,30,45-49,1962,1.978367683624067
SIM,1844,19,30-34,1863,1
STAT,1893,48,20-24,1941,0.008007553230092258
SIM,1890,33,40-44,1923,3
SIM,1840,42,40-44,1882,6
SIM,1895,37,40-44,1932,7
STAT,1846,36,40-44,1882,3.425972507964674
SIM,1889,20,40-44,1909,3
STAT,1872,23,25-29,1895,54.07702370208072
SIM,1849,81,na,1930,365
STAT,1799,77,na,1876,333.1868622941756
SIM,1922,27,20-24,1949,24
SIM,1900,29,35-39,1929,8
STAT,1909,46,30-34,1955,0.07758048087702757
STAT,1887,37,40-44,1924,4.625638490571456
STAT,1944,23,20-24,1967,113.38020151973406
STAT,1866,24,45-49,1890,0.6037875263088935
STAT,1922,25,35-39,1947,16.15805917132638
STAT,1882,33,40-44,1915,3.9673947172637876
SIM,1888,83,na,1971,812
SIM,1897,57,na,1954,2620
STAT,1876,43,na,1919,2239.4858390729255
STAT,1920,25,30-34,1945,40.880274839758
STAT,1874,46,15-19,1920,3.871852142646184E-4
STAT,1893,46,25-29,1939,0.03903586841539551
STAT,1944,9,na,1953,4006.8518967455566
SIM,1828,63,na,1891,1045
STAT,1806,52,40-44,1858,0.037059593920760615
STAT,1868,37,30-34,1905,4.803772908731151
STAT,1889,33,50-100,1922,1.0640664423158508
STAT,1901,25,20-24,1926,15.618234090480303
SIM,1839,63,na,1902,1206
STAT,1845,52,50-100,1897,0.010630247975934419
STAT,1909,10,na,1919,3669.923512576387
SIM,1930,24,45-49,1954,2
STAT,1857,46,15-19,1903,2.988702919038133E-4
STAT,1866,68,na,1934,1331.5511020217652
STAT,1870,29,50-100,1899,0.5886049866594745
STAT,1916,20,na,1936,3636.523483463055
SIM,1829,88,na,1917,69
STAT,1882,45,40-44,1927,0.1588521247899671
STAT,1925,17,25-29,1942,49.452210586512976
SIM,1868,17,20-24,1885,16
SIM,1877,6,na,1883,2631
SIM,1803,68,na,1871,698
STAT,1837,34,40-44,1871,3.456336817112478
STAT,1804,105,na,1909,0.00982144296914146
STAT,1929,27,50-100,1956,1.1767707293508383
SIM,1924,29,20-24,1953,21
STAT,1833,41,na,1874,1582.9428338902326
STAT,1852,49,40-44,1901,0.12152616558546105
STAT,1921,40,40-44,1961,0.2668779531135595
SIM,1932,33,20-24,1965,3
SIM,1810,78,na,1888,303
STAT,1916,29,20-24,1945,17.702655966058472
SIM,1823,42,40-44,1865,3
SIM,1868,4,na,1872,2536
STAT,1859,58,na,1917,1486.9368014865108
STAT,1853,18,na,1871,2077.4082646995216
STAT,1922,24,45-49,1946,1.2113225282029372
STAT,1842,28,15-19,1870,0.4034003443063975
SIM,1933,17,25-29,1950,57
STAT,1815,54,40-44,1869,0.021859286006902956
STAT,1836,19,30-34,1855,1.968092306000819
STAT,1952,20,45-49,1972,1.2788739182610667
SIM,1816,78,na,1894,300
STAT,1841,44,40-44,1885,1.570584279941117
SIM,1842,30,na,1872,1826
STAT,1860,46,50-100,1906,0.18878926625744197
STAT,1856,47,na,1903,1650.5765699706508
SIM,1934,30,45-49,1964,2
SIM,1852,48,na,1900,1702
STAT,1877,53,50-100,1930,0.014562082376817687
STAT,1902,34,15-19,1936,0.10808561230299651
STAT,1818,52,na,1870,1275.161572893284
STAT,1838,23,30-34,1861,15.403628636247264
STAT,1843,40,na,1883,1649.0667773537714
STAT,1915,40,40-44,1955,0.23855682178026488
SIM,1870,98,na,1968,10
STAT,1870,26,30-34,1896,23.41769830500015
STAT,1924,33,20-24,1957,2.686600598342628
SIM,1896,35,na,1931,2975
STAT,1849,17,50-100,1866,0.0452208723256092
SIM,1904,23,35-39,1927,9
SIM,1774,97,na,1871,1
SIM,1904,34,45-49,1938,1
SIM,1885,72,na,1957,1197
STAT,1925,30,50-100,1955,0.9285375976789281
STAT,1937,21,30-34,1958,26.449258527195056
SIM,1880,23,25-29,1903,60
SIM,1868,15,30-34,1883,1
SIM,1909,24,30-34,1933,35
SIM,1841,85,na,1926,157
STAT,1892,19,15-19,1911,6.984401198928504
SIM,1945,21,30-34,1966,44
STAT,1863,48,35-39,1911,0.11460409273978742
SIM,1854,30,20-24,1884,2
STAT,1855,35,50-100,1890,0.8807526843860236
STAT,1811,48,40-44,1859,0.5609185275584403
STAT,1874,39,20-24,1913,0.736552939752505
SIM,1903,16,30-34,1919,3
STAT,1909,31,50-100,1940,0.7484260002143049
SIM,1886,31,25-29,1917,12
STAT,1902,45,25-29,1947,0.043750149425237216
SIM,1868,1,na,1869,3050
STAT,1855,26,35-39,1881,7.1987428047349
STAT,1831,55,na,1886,1228.3123253720337
SIM,1909,35,40-44,1944,1
STAT,1802,54,30-34,1856,0.01674022612196335
STAT,1926,30,45-49,1956,1.7994773343853174
SIM,1873,33,35-39,1906,13
STAT,1863,39,45-49,1902,1.6360019154152183
SIM,1904,47,na,1951,3096
STAT,1846,30,20-24,1876,2.418972982809478
SIM,1901,36,na,1937,3149
STAT,1868,32,na,1900,2150.882649044633
SIM,1825,74,na,1899,585
SIM,1865,20,25-29,1885,58
STAT,1806,67,na,1873,775.9679037982565
SIM,1893,21,15-19,1914,4
STAT,1940,17,20-24,1957,130.041584510447
STAT,1885,21,15-19,1906,3.115883574761089
STAT,1849,24,45-49,1873,0.6231549497207752
STAT,1870,73,na,1943,1100.7631804672126
STAT,1877,18,35-39,1895,0.5362903308060919
STAT,1939,26,na,1965,3559.3554521412184
SIM,1853,70,na,1923,1067
STAT,1841,92,na,1933,28.713602526393018
STAT,1911,23,30-34,1934,25.67193195785949
STAT,1853,58,na,1911,1496.638117922286
STAT,1861,8,na,1869,2217.024059522359
STAT,1888,18,40-44,1906,0.20366678442311134
SIM,1895,0,na,1895,3467
STAT,1844,84,na,1928,231.0424665506428
STAT,1876,46,25-29,1922,0.05637748892089815
SIM,1863,26,35-39,1889,8
SIM,1880,26,40-44,1906,5
STAT,1856,50,35-39,1906,0.006436734565714354
STAT,1842,18,na,1860,2122.0626100290206
SIM,1839,66,na,1905,1093
STAT,1857,39,15-19,1896,0.04141748687158561
SIM,1913,33,40-44,1946,12
STAT,1868,22,20-24,1890,62.11373297324495
SIM,1926,36,25-29,1962,1
STAT,1811,46,20-24,1857,0.04063498276278329
STAT,1862,16,25-29,1878,5.273239804522213
STAT,1916,23,15-19,1939,5.253195749702126
STAT,1887,31,20-24,1918,2.867952299829417
STAT,1878,31,25-29,1909,10.125264785472401
STAT,1905,22,30-34,1927,24.322572765907406
STAT,1932,32,35-39,1964,11.476185465475778
SIM,1898,25,45-49,1923,1
STAT,1844,36,30-34,1880,4.343202526496677
SIM,1913,21,na,1934,3382
SIM,1829,27,40-44,1856,3
STAT,1935,34,35-39,1969,11.9281798304624
SIM,1821,42,30-34,1863,4
SIM,1876,22,20-24,1898,65
SIM,1819,44,40-44,1863,8
SIM,1859,28,35-39,1887,11
STAT,1928,34,35-39,1962,10.780405815362451
SIM,1854,100,na,1954,2
SIM,1777,89,na,1866,27
STAT,1806,104,na,1910,0.023130470831545544
STAT,1948,22,45-49,1970,1.2205055698997636
SIM,1849,19,15-19,1868,5
STAT,1832,45,45-49,1877,0.17301899103394017
SIM,1917,31,50-100,1948,3
SIM,1923,40,40-44,1963,3
STAT,1865,43,na,1908,1964.740323333362
STAT,1905,33,40-44,1938,3.3859268160486313
STAT,1863,36,40-44,1899,3.646492226223463
STAT,1907,24,na,1931,3261.497240439539
SIM,1837,48,50-100,1885,1
SIM,1846,23,30-34,1869,17
STAT,1765,89,na,1854,24.0
SIM,1830,38,45-49,1868,2
STAT,1831,41,50-100,1872,0.790582649653816
STAT,1921,28,na,1949,3930.2952822453603
SIM,1924,23,15-19,1947,4
STAT,1876,83,na,1959,506.5050986766036
STAT,1888,71,na,1959,1606.8207111580398
STAT,1962,6,na,1968,4757.156373823537
STAT,1929,38,20-24,1967,0.31937912829835424
SIM,1830,45,na,1875,1497
SIM,1839,30,25-29,1869,12
SIM,1852,36,30-34,1888,7
STAT,1829,36,35-39,1865,6.5389693951082215
SIM,1935,25,40-44,1960,4
STAT,1937,32,40-44,1969,3.6575495137269134
SIM,1863,69,na,1932,1185
STAT,1898,21,25-29,1919,73.40486095442294
STAT,1868,102,na,1970,2.3108669380914906
SIM,1882,83,na,1965,562
STAT,1833,38,20-24,1871,0.5852055775014483
STAT,1842,55,na,1897,1497.401545670995
SIM,1859,37,25-29,1896,5
STAT,1760,108,na,1868,0.0037558419973101123
STAT,1928,43,25-29,1971,0.08586107302488422
STAT,1813,42,30-34,1855,3.760444260176121
STAT,1907,32,50-100,1939,0.7300949471630755
STAT,1907,46,20-24,1953,0.009420198055755134
SIM,1935,8,na,1943,5078
SIM,1852,20,15-19,1872,2
STAT,1821,53,50-100,1874,0.022452867347004603
STAT,1822,38,45-49,1860,3.322971585728377
SIM,1913,22,30-34,1935,39
SIM,1850,81,na,1931,347
STAT,1897,45,na,1942,2871.280543138871
SIM,1851,5,na,1856,2284
STAT,1844,81,na,1925,375.57375752548745
STAT,1880,33,30-34,1913,17.315360744020087
STAT,1878,27,50-100,1905,0.6297903342141529
STAT,1820,34,25-29,1854,30.588414418038834
SIM,1895,3,na,1898,3349
STAT,1856,5,na,1861,2191.547035875791
STAT,1921,42,30-34,1963,0.13603124725237561
STAT,1913,8,na,1921,3839.8800756479027
SIM,1849,25,na,1874,1968
STAT,1841,24,50-100,1865,0.3510469403834838
STAT,1864,58,na,1922,1665.0812765109238
STAT,1933,36,20-24,1969,0.33950514719216457
SIM,1922,19,15-19,1941,47
STAT,1833,49,30-34,1882,0.06170775619897607
SIM,1895,23,15-19,1918,4
SIM,1866,18,25-29,1884,7
STAT,1922,21,40-44,1943,3.6536006116491873
STAT,1847,46,50-100,1893,0.1816214152972473
SIM,1845,30,25-29,1875,18
STAT,1916,23,45-49,1939,1.110378915186766
STAT,1843,99,na,1942,1.279206230987029
SIM,1826,37,na,1863,1520
SIM,1882,20,30-34,1902,22
SIM,1887,24,30-34,1911,23
STAT,1873,46,45-49,1919,0.22675699769378954
STAT,1822,44,30-34,1866,1.5853298992817253
STAT,1891,35,na,1926,2779.773390225474
STAT,1935,24,25-29,1959,118.74605127284057
SIM,1918,27,30-34,1945,44
STAT,1891,23,35-39,1914,6.799324577234204
STAT,1786,70,na,1856,588.44048104
STAT,1882,48,45-49,1930,0.2140925148671345
STAT,1887,23,15-19,1910,3.4752550698771785
STAT,1824,32,35-39,1856,24.662351909099634
STAT,1804,108,na,1912,6.135660697483499E-4
STAT,1879,24,30-34,1903,17.503822070965047
SIM,1848,40,na,1888,1694
SIM,1832,32,35-39,1864,8
STAT,1890,50,na,1940,2522.641080412829
STAT,1954,15,na,1969,4300.5633958458375
STAT,1927,25,40-44,1952,5.389314115378572
SIM,1804,53,na,1857,1120
STAT,1905,36,15-19,1941,0.016630090364714165
SIM,1943,24,25-29,1967,95
STAT,1921,50,na,1971,3877.1964759070597
SIM,1895,36,50-100,1931,2
STAT,1887,36,50-100,1923,1.3035806528058695
STAT,1933,16,na,1949,4666.145625191921
SIM,1870,16,25-29,1886,9
STAT,1818,49,35-39,1867,0.2896295755083842
STAT,1906,35,50-100,1941,0.368073809908302
STAT,1914,19,45-49,1933,0.09709774070700822
STAT,1924,34,20-24,1958,2.6848005759417393
STAT,1918,36,25-29,1954,0.9851317277773171
STAT,1907,21,45-49,1928,0.9706139926844078
SIM,1924,23,45-49,1947,1
SIM,1858,39,na,1897,1901
STAT,1926,30,15-19,1956,0.14695270108200648
STAT,1869,54,30-34,1923,0.005297902049409365
STAT,1930,41,50-100,1971,0.14623245692535972
SIM,1930,21,40-44,1951,5
SIM,1909,33,20-24,1942,1
STAT,1811,97,na,1908,2.3299022091664523
STAT,1957,3,na,1960,4898.755821899018
SIM,1817,63,na,1880,970
SIM,1794,74,na,1868,392
SIM,1897,20,na,1917,3079
SIM,1798,88,na,1886,37
SIM,1952,3,na,1955,4391
SIM,1821,38,50-100,1859,4
SIM,1900,22,20-24,1922,87
STAT,1906,39,na,1945,3234.293868051897
SIM,1908,40,45-49,1948,1
SIM,1904,33,45-49,1937,1
STAT,1943,20,50-100,1963,0.6617994828170733
SIM,1890,40,35-39,1930,6
SIM,1928,33,30-34,1961,23
STAT,1829,92,na,1921,25.166056762481986
SIM,1844,15,15-19,1859,7
STAT,1887,6,na,1893,2760.4369413043696
SIM,1828,100,na,1928,2
SIM,1854,55,na,1909,1679
STAT,1902,44,25-29,1946,0.058649896231737844
STAT,1919,49,na,1968,3742.289376700899
STAT,1938,15,45-49,1953,0.46768556984649995
STAT,1848,43,50-100,1891,0.7793343517113013
STAT,1881,16,35-39,1897,0.5019853950962714
SIM,1844,26,25-29,1870,36
STAT,1913,32,25-29,1945,8.687478133685401
STAT,1833,103,na,1936,0.08805021238875244
SIM,1888,44,35-39,1932,2
SIM,1921,32,25-29,1953,16
STAT,1807,48,20-24,1855,0.045447625689899934
STAT,1832,96,na,1928,5.172614631858521
STAT,1837,49,45-49,1886,0.15497256430427248
STAT,1955,17,40-44,1972,1.7539211951126972
STAT,1868,94,na,1962,42.95101876348879
STAT,1840,17,50-100,1857,0.04162717315309039
STAT,1857,20,25-29,1877,49.95342839754934
STAT,1903,29,40-44,1932,3.9977158539096487
SIM,1852,29,na,1881,1902
STAT,1858,18,25-29,1876,4.874056612735882
STAT,1914,19,15-19,1933,8.821331528279833
STAT,1910,49,50-100,1959,0.19819253296293673
STAT,1931,23,40-44,1954,4.106920450862081
STAT,1944,26,25-29,1970,67.2344487725843
STAT,1872,20,20-24,1892,65.68952840594439
SIM,1878,22,30-34,1900,25
SIM,1919,31,30-34,1950,28
STAT,1837,30,25-29,1867,8.509495224251703
STAT,1906,61,na,1967,2809.061705603305
SIM,1856,43,50-100,1899,3
STAT,1847,17,40-44,1864,0.1683360857898423
SIM,1886,57,na,1943,1930
STAT,1882,40,35-39,1922,1.6804089913979319
SIM,1802,86,na,1888,61
SIM,1911,29,40-44,1940,5
STAT,1901,16,30-34,1917,2.112816653721138
STAT,1861,43,50-100,1904,0.8238348728074136
SIM,1908,9,na,1917,3617
SIM,1775,82,na,1857,126
SIM,1950,16,na,1966,4000
STAT,1836,26,25-29,1862,35.702202302211305
STAT,1878,4,na,1882,2838.804562818659
STAT,1830,30,na,1860,1727.24077904642
SIM,1919,42,40-44,1961,1
SIM,1900,38,25-29,1938,4
SIM,1901,21,50-100,1922,1
STAT,1808,74,na,1882,486.4255906099174
STAT,1828,53,30-34,1881,0.004152225406692093
STAT,1880,46,45-49,1926,0.23570795135510264
STAT,1850,22,35-39,1872,4.937318213203688
STAT,1888,31,na,1919,2675.0802925760795
SIM,1795,59,na,1854,986
STAT,1841,33,na,1874,1794.0989148493939
STAT,1953,15,40-44,1968,1.5992307283352096
STAT,1864,98,na,1962,7.435513643454571
STAT,1868,33,15-19,1901,0.12781636298808022
SIM,1892,30,35-39,1922,15
SIM,1883,12,na,1895,2409
SIM,1921,23,35-39,1944,19
STAT,1934,19,25-29,1953,55.07633047750943
SIM,1898,15,35-39,1913,2
STAT,1918,36,30-34,1954,1.8235417188744758
SIM,1862,34,40-44,1896,4
STAT,1836,50,25-29,1886,0.0024145804132351054
STAT,1913,49,na,1962,3367.738174582545
STAT,1883,77,na,1960,956.5074153967065
STAT,1818,36,na,1854,1489.2768084555635
SIM,1902,34,50-100,1936,3
STAT,1852,49,35-39,1901,0.09937887395560752
STAT,1866,36,15-19,1902,0.04916416317413175
SIM,1869,43,25-29,1912,4
STAT,1879,17,25-29,1896,5.603675865412099
STAT,1838,50,na,1888,1495.9292474271986
SIM,1800,60,na,1860,917
STAT,1814,46,na,1860,1429.6122853144159
STAT,1891,20,25-29,1911,67.3068055828314
STAT,1880,43,40-44,1923,2.2239500074634635
SIM,1942,19,25-29,1961,47
STAT,1905,28,50-100,1933,0.8704216635469819
STAT,1921,42,25-29,1963,0.07598141769508737
SIM,1923,31,45-49,1954,1
STAT,1940,16,45-49,1956,0.4792851149534447
SIM,1885,15,25-29,1900,8
STAT,1884,30,35-39,1914,9.527775416649849
STAT,1900,47,25-29,1947,0.04238134886739266
STAT,1921,44,na,1965,3938.5691133403047
STAT,1930,20,30-34,1950,34.98996166017739
SIM,1863,85,na,1948,186
STAT,1822,47,40-44,1869,0.23022820289951626
STAT,1919,15,40-44,1934,0.2943217032034285
SIM,1888,21,na,1909,2649
STAT,1861,24,30-34,1885,14.168159842667432
STAT,1870,19,30-34,1889,1.47369301241298
STAT,1898,8,na,1906,3323.310879147791
SIM,1939,7,na,1946,3734
SIM,1821,68,na,1889,795
SIM,1874,17,15-19,1891,6
SIM,1937,15,40-44,1952,1
STAT,1915,31,45-49,1946,1.5202077828298395
SIM,1878,38,40-44,1916,6
STAT,1851,32,na,1883,1786.6480102218682
STAT,1908,62,na,1970,2857.147309635473
STAT,1834,60,na,1894,1182.3940241438645
SIM,1871,27,na,1898,2265
SIM,1793,73,na,1866,433
SIM,1869,88,na,1957,174
SIM,1909,39,35-39,1948,3
STAT,1871,43,30-34,1914,1.0706812827661578
STAT,1822,107,na,1929,0.0023963533467868123
STAT,1805,85,na,1890,95.69388547824953
STAT,1873,51,25-29,1924,0.003409891147918011
STAT,1854,34,40-44,1888,3.1122032527419705
STAT,1951,16,20-24,1967,152.558758824996
STAT,1909,41,30-34,1950,0.11362092192780116
SIM,1926,36,30-34,1962,2
STAT,1872,27,40-44,1899,2.8385282239345853
STAT,1913,23,35-39,1936,8.954927340024014
STAT,1856,63,na,1919,1315.1710469521045
STAT,1804,52,30-34,1856,0.021034707772733564
SIM,1842,19,20-24,1861,13
STAT,1877,5,na,1882,2673.660014407862
STAT,1944,26,30-34,1970,40.02445103448443
SIM,1920,31,na,1951,3975
SIM,1875,70,na,1945,1303
STAT,1817,88,na,1905,63.54060302719334
STAT,1864,53,40-44,1917,0.00872166304625126
STAT,1909,34,25-29,1943,8.26117710849732
SIM,1832,71,na,1903,769
SIM,1927,15,40-44,1942,6
STAT,1870,27,na,1897,2211.737345526846
STAT,1892,26,15-19,1918,0.538685978348551
STAT,1826,65,na,1891,922.8596204338257
STAT,1861,35,25-29,1896,2.2830507923710113
STAT,1929,37,45-49,1966,0.8267790896618539
STAT,1920,20,30-34,1940,30.364934166831137
STAT,1854,40,50-100,1894,0.763502559997244
SIM,1832,44,50-100,1876,1
STAT,1872,39,50-100,1911,1.1516722066526703
STAT,1925,34,na,1959,4237.197802548467
STAT,1850,50,na,1900,1539.6299429527462
STAT,1926,31,20-24,1957,2.7877943711774864
SIM,1888,43,na,1931,2584
STAT,1843,40,15-19,1883,0.009853296738457022
STAT,1927,29,35-39,1956,17.172937434520364
SIM,1912,30,30-34,1942,16
STAT,1878,48,50-100,1926,0.2387600554437252
STAT,1849,43,50-100,1892,0.7864767945494132
STAT,1856,40,25-29,1896,0.47809565939251636
STAT,1786,73,na,1859,442.80337776679886
SIM,1915,37,25-29,1952,3
SIM,1910,59,na,1969,3014
STAT,1877,51,25-29,1928,0.0034875482956259283
SIM,1822,38,50-100,1860,3
STAT,1878,40,20-24,1918,0.15793237678609356
SIM,1917,34,25-29,1951,16
STAT,1899,15,45-49,1914,0.08494647433614148
STAT,1859,46,25-29,1905,0.04343185565491912
STAT,1835,34,30-34,1869,13.85683516565208
STAT,1927,40,50-100,1967,0.13957216411998047
STAT,1825,83,na,1908,210.9929006829445
STAT,1867,40,45-49,1907,1.3410329914070673
SIM,1935,29,35-39,1964,23
STAT,1904,30,30-34,1934,23.849075408273414
SIM,1867,75,na,1942,902
SIM,1870,79,na,1949,638
SIM,1941,17,na,1958,3500
STAT,1872,26,50-100,1898,0.608238133314615
STAT,1930,42,35-39,1972,0.25028914200229485
STAT,1825,35,15-19,1860,0.076598233152797
STAT,1854,53,40-44,1907,0.007411435177545353
STAT,1922,48,15-19,1970,3.98671793847531E-4
STAT,1853,29,40-44,1882,2.3556958128332126
STAT,1848,21,35-39,1869,5.317828020774445
SIM,1934,31,20-24,1965,2
STAT,1840,16,40-44,1856,0.15632892828383815
SIM,1856,21,35-39,1877,6
SIM,1875,40,45-49,1915,6
SIM,1861,84,na,1945,233
SIM,1873,30,25-29,1903,8
SIM,1890,65,na,1955,2118
SIM,1905,32,na,1937,3241
SIM,1843,65,na,1908,1195
STAT,1870,22,15-19,1892,3.057407749687213
SIM,1902,23,25-29,1925,83
SIM,1922,26,45-49,1948,4
SIM,1941,27,25-29,1968,66
STAT,1890,43,40-44,1933,2.5790705152990285
STAT,1953,19,35-39,1972,4.79193725326686
SIM,1843,34,30-34,1877,18
STAT,1818,45,25-29,1863,0.12657557494104565
STAT,1765,104,na,1869,0.022144596478370228
STAT,1835,45,25-29,1880,0.04356640327409096
STAT,1844,29,30-34,1873,21.103665680069653
STAT,1871,52,na,1923,2009.074392695256
STAT,1871,49,45-49,1920,0.2167627115245152
STAT,1805,63,na,1868,923.2699813689014
SIM,1868,17,15-19,1885,5
STAT,1820,48,45-49,1868,0.3900490658701447
STAT,1835,27,50-100,1862,0.5306253695907568
SIM,1892,42,na,1934,3040
STAT,1860,19,30-34,1879,1.3924810414856186
STAT,1900,20,45-49,1920,0.919295545512619
STAT,1809,45,15-19,1854,0.00116929122889096
STAT,1933,20,40-44,1953,4.238467566893906
STAT,1870,38,30-34,1908,4.914747695764707
SIM,1877,17,25-29,1894,5
SIM,1852,29,30-34,1881,33
STAT,1839,50,35-39,1889,0.005874520761049651
SIM,1812,85,na,1897,96
STAT,1919,44,35-39,1963,0.20546273687890435
SIM,1920,15,30-34,1935,14
SIM,1924,20,40-44,1944,4
SIM,1896,72,na,1968,1937
STAT,1846,33,50-100,1879,0.794801412912115
SIM,1907,23,15-19,1930,3
SIM,1821,62,na,1883,967
STAT,1841,30,na,1871,1850.8668054846985
SIM,1863,91,na,1954,37
SIM,1916,29,25-29,1945,60
STAT,1876,36,15-19,1912,0.05507091143588386
SIM,1897,33,50-100,1930,1
SIM,1911,20,30-34,1931,31
STAT,1854,32,15-19,1886,0.10434208274254647
STAT,1885,16,50-100,1901,0.04624619075387832
STAT,1903,25,30-34,1928,34.077945253045115
STAT,1873,39,50-100,1912,1.164478989940205
SIM,1880,22,25-29,1902,55
STAT,1843,34,50-100,1877,0.728714842596054
SIM,1772,93,na,1865,5
STAT,1831,71,na,1902,779.3708623119829
SIM,1830,98,na,1928,4
SIM,1836,44,40-44,1880,4
STAT,1841,35,50-100,1876,1.018176634027756
STAT,1916,20,40-44,1936,3.3482939420246267
STAT,1907,37,25-29,1944,0.862402552920065
STAT,1776,89,na,1865,33.63727192397487
STAT,1840,52,40-44,1892,0.006872071234114948
STAT,1889,41,35-39,1930,2.1214260911668883
SIM,1852,35,25-29,1887,2
STAT,1827,29,30-34,1856,37.17138301781648
STAT,1832,28,50-100,1860,0.5175626514513482
STAT,1848,34,40-44,1882,3.349428752982081
SIM,1868,23,na,1891,2104
SIM,1835,29,30-34,1864,25
SIM,1789,74,na,1863,364
SIM,1936,34,35-39,1970,6
SIM,1876,58,na,1934,1875
STAT,1952,14,na,1966,4445.322215159149
SIM,1941,20,40-44,1961,4
STAT,1928,44,45-49,1972,0.1997614982402237
SIM,1926,28,na,1954,4143
SIM,1905,26,45-49,1931,2
STAT,1868,88,na,1956,138.2854846419323
STAT,1923,6,na,1929,4446.0847594928755
STAT,1830,45,35-39,1875,0.1076528666362072
SIM,1931,26,50-100,1957,1
STAT,1874,24,40-44,1898,1.9987497108971057
SIM,1922,44,na,1966,4000
STAT,1876,35,30-34,1911,5.251094605933505
STAT,1941,16,50-100,1957,0.3646608600437203
STAT,1908,29,25-29,1937,58.361790850308175
SIM,1826,93,na,1919,13
STAT,1899,41,35-39,1940,0.16350324872816033
SIM,1932,37,25-29,1969,1
STAT,1871,30,25-29,1901,9.685536305044012
SIM,1861,19,30-34,1880,3
STAT,1788,74,na,1862,399.17170365129624
STAT,1868,25,25-29,1893,38.3867253576108
SIM,1921,30,40-44,1951,3
STAT,1883,45,50-100,1928,0.22974586080360848
SIM,1887,31,50-100,1918,3
SIM,1899,30,45-49,1929,3
STAT,1848,40,35-39,1888,1.3787630049739477
SIM,1856,38,na,1894,1836
STAT,1916,23,50-100,1939,0.6493444195879425
SIM,1902,30,30-34,1932,29
STAT,1798,98,na,1896,0.922743228646811
STAT,1813,52,40-44,1865,0.027523776372027322
SIM,1928,35,na,1963,4500
STAT,1849,50,35-39,1899,0.006548428537938811
SIM,1878,25,35-39,1903,14
SIM,1893,36,25-29,1929,5
STAT,1791,78,na,1869,291.2118548432891
STAT,1885,49,30-34,1934,0.08924793232662528
STAT,1924,37,25-29,1961,1.0967914375590087
STAT,1895,35,40-44,1930,5.44252885228742
SIM,1877,25,50-100,1902,3
STAT,1884,45,50-100,1929,0.23150882812227053
SIM,1844,96,na,1940,3
SIM,1941,4,na,1945,3822
STAT,1853,19,30-34,1872,1.4339785728216334
STAT,1920,37,50-100,1957,0.4342651566937858
STAT,1906,45,na,1951,3127.0072234972854
SIM,1871,22,15-19,1893,3
STAT,1881,53,40-44,1934,0.00945334102066895
STAT,1828,44,40-44,1872,1.8446064388523018
SIM,1919,40,na,1959,3878
SIM,1909,36,30-34,1945,1
SIM,1898,45,na,1943,2851
STAT,1830,29,50-100,1859,0.576535720006025
STAT,1861,49,45-49,1910,0.18150447793614588
SIM,1900,23,20-24,1923,89
STAT,1885,36,25-29,1921,2.7242265553459877
SIM,1833,44,50-100,1877,1
STAT,1869,17,25-29,1886,5.257945127516744
STAT,1902,41,20-24,1943,0.014769808764163936
SIM,1901,15,20-24,1916,26
STAT,1912,15,30-34,1927,2.339303018443261
STAT,1823,52,40-44,1875,0.012477879953209486
STAT,1826,31,na,1857,1606.4960382193422
SIM,1855,50,na,1905,1749
STAT,1914,26,45-49,1940,1.6509733435372298
SIM,1876,36,na,1912,2311
SIM,1831,46,na,1877,1468
SIM,1884,87,na,1971,411
STAT,1885,20,na,1905,2240.3205598268846
STAT,1909,28,na,1937,3370.3957227080577
STAT,1933,27,25-29,1960,82.56219184001408
SIM,1856,40,35-39,1896,7
STAT,1813,98,na,1911,1.336926278891782
STAT,1929,18,45-49,1947,0.6006598506953399
STAT,1830,52,40-44,1882,0.006937987547090976
STAT,1913,30,40-44,1943,3.7078429071161914
STAT,1866,47,50-100,1913,0.2129988528565836
STAT,1917,41,20-24,1958,0.017436127931757694
STAT,1918,30,na,1948,3827.2415204470153
SIM,1942,16,20-24,1958,118
STAT,1883,20,35-39,1903,5.437148355853188
SIM,1842,29,30-34,1871,23
STAT,1816,45,15-19,1861,9.751677537785709E-4
SIM,1838,25,na,1863,1815
SIM,1890,41,25-29,1931,3
STAT,1878,43,25-29,1921,0.6276498347833184
SIM,1906,31,45-49,1937,1
STAT,1951,19,25-29,1970,48.717404399811855
SIM,1846,16,25-29,1862,5
SIM,1897,35,40-44,1932,6
STAT,1883,36,15-19,1919,0.0522614380559472
SIM,1835,36,na,1871,1658
STAT,1872,38,40-44,1910,4.127447917534105
STAT,1894,28,50-100,1922,0.7738845057722319
STAT,1909,44,35-39,1953,0.17575060843013743
STAT,1814,62,na,1876,1036.2624591504316
STAT,1935,36,30-34,1971,2.4097657375388386
STAT,1861,25,15-19,1886,0.3641774853477369
SIM,1921,20,30-34,1941,40
STAT,1784,90,na,1874,27.375010688159534
STAT,1871,46,35-39,1917,0.13170299275602296
SIM,1880,38,40-44,1918,9
SIM,1822,32,35-39,1854,8
STAT,1900,44,20-24,1944,0.014257556524840322
STAT,1863,22,15-19,1885,2.7894525286307004
STAT,1932,31,45-49,1963,1.9772795813980728
STAT,1825,29,20-24,1854,38.80775140086223
STAT,1903,18,50-100,1921,0.06568001037755111
SIM,1833,29,20-24,1862,8
STAT,1785,91,na,1876,18.569591792979498
STAT,1889,35,40-44,1924,5.153769444876386
STAT,1895,40,20-24,1935,0.19756753672708569
STAT,1899,16,50-100,1915,0.0635709682665665
STAT,1820,43,15-19,1863,0.024604381515761522
STAT,1818,42,15-19,1860,0.032570559370764064
STAT,1834,29,30-34,1863,20.199217980695046
SIM,1857,17,15-19,1874,6
STAT,1888,15,na,1903,2832.809234751525
SIM,1934,34,25-29,1968,12
STAT,1885,33,15-19,1918,0.1335313799975063
STAT,1770,92,na,1862,7.791969360726508
STAT,1884,40,45-49,1924,1.4109399560595508
SIM,1937,34,40-44,1971,3
SIM,1891,20,35-39,1911,6
STAT,1892,54,na,1946,2477.743178677241
SIM,1938,18,20-24,1956,106
STAT,1838,16,25-29,1854,5.055030965673763
STAT,1810,72,na,1882,558.597078216037
STAT,1823,109,na,1932,3.8075985264681295E-4
STAT,1880,24,40-44,1904,2.062345891142812
STAT,1776,95,na,1871,2.340593483889074
SIM,1820,37,30-34,1857,8
SIM,1940,19,20-24,1959,115
STAT,1863,79,na,1942,579.5703423851629
STAT,1923,16,45-49,1939,0.5554937700044336
SIM,1867,59,na,1926,1887
STAT,1937,33,30-34,1970,14.71624622592194
STAT,1857,27,15-19,1884,0.34818241160340135
STAT,1932,19,20-24,1951,168.68246508921558
STAT,1936,15,40-44,1951,1.2709045564716919
SIM,1821,33,40-44,1854,3
STAT,1908,26,20-24,1934,16.496783904141143
SIM,1856,81,na,1937,373
SIM,1940,31,45-49,1971,1
STAT,1869,50,20-24,1919,6.850408995743361E-4
STAT,1831,26,40-44,1857,2.6605028176475853
STAT,1845,53,30-34,1898,0.0041445643743323905
SIM,1904,30,40-44,1934,11
STAT,1904,42,25-29,1946,0.06035123212910694
SIM,1901,18,25-29,1919,6
STAT,1876,30,45-49,1906,1.715659575824565
SIM,1884,30,45-49,1914,2
STAT,1914,24,50-100,1938,0.6311036704652523
STAT,1881,36,na,1917,2160.428531845031
STAT,1878,7,na,1885,2636.1403612685313
STAT,1905,17,50-100,1922,0.0668981357414212
STAT,1914,40,na,1954,3500.9353808870023
SIM,1892,40,45-49,1932,2
SIM,1911,25,30-34,1936,47
STAT,1849,17,15-19,1866,5.477756109498183
STAT,1875,26,15-19,1901,0.44206368091929127
STAT,1929,34,40-44,1963,4.689656976367801
SIM,1850,19,na,1869,2132
STAT,1847,53,40-44,1900,0.007638519037206852
STAT,1835,35,15-19,1870,0.04511286061745083
STAT,1897,41,25-29,1938,0.056592548245939324
STAT,1938,23,50-100,1961,0.6150099255470411
SIM,1868,24,20-24,1892,58
SIM,1878,5,na,1883,2750
SIM,1848,20,30-34,1868,18
STAT,1835,48,na,1883,1490.11899904011
STAT,1896,10,na,1906,3231.9120410564433
SIM,1816,39,30-34,1855,5
STAT,1920,29,40-44,1949,4.79570354449351
STAT,1926,34,25-29,1960,10.543948214507271
STAT,1861,44,15-19,1905,0.010701023480148049
STAT,1859,43,20-24,1902,0.11854742205914313
STAT,1921,30,30-34,1951,16.69645462513924
SIM,1809,81,na,1890,197
SIM,1916,26,20-24,1942,21
SIM,1878,44,35-39,1922,3
STAT,1839,41,50-100,1880,0.8251587984023094
STAT,1832,104,na,1936,0.04018019896831529
SIM,1856,34,40-44,1890,7
STAT,1842,35,15-19,1877,0.048705507921001145
STAT,1891,49,30-34,1940,0.062486769866410656
STAT,1903,31,na,1934,3220.6735125808605
SIM,1898,18,15-19,1916,7
STAT,1909,31,20-24,1940,2.2079664533046395
STAT,1843,96,na,1939,5.799829482798986
STAT,1856,51,25-29,1907,0.002623230456574164
STAT,1901,47,50-100,1948,0.18234165401666327
STAT,1913,20,30-34,1933,26.46812961047768
SIM,1895,30,20-24,1925,3
SIM,1917,31,20-24,1948,1
SIM,1872,28,na,1900,2258
SIM,1887,28,40-44,1915,3
SIM,1859,25,25-29,1884,36
STAT,1861,39,35-39,1900,5.499773341433219
SIM,1815,50,na,1865,1350
STAT,1841,95,na,1936,9.166102673018784
STAT,1907,34,20-24,1941,2.135446436631936
SIM,1934,37,35-39,1971,7
SIM,1930,31,50-100,1961,4
STAT,1859,24,15-19,1883,2.53678358905672
SIM,1837,24,35-39,1861,5
SIM,1935,26,30-34,1961,60
SIM,1938,13,na,1951,3521
STAT,1831,37,40-44,1868,3.3560751679527874
SIM,1847,21,na,1868,1991
STAT,1837,32,15-19,1869,0.11587976519191694
STAT,1911,45,35-39,1956,0.11585441985519783
STAT,1869,45,40-44,1914,0.15824247033976585
STAT,1874,82,na,1956,483.00478832950574
STAT,1829,35,50-100,1864,1.1561209410099813
SIM,1905,26,na,1931,3223
STAT,1896,15,35-39,1911,0.6877972366381901
STAT,1858,70,na,1928,1039.2310698710821
SIM,1797,69,na,1866,665
SIM,1832,22,na,1854,1668
SIM,1834,88,na,1922,84
SIM,1895,38,40-44,1933,5
SIM,1861,29,40-44,1890,3
STAT,1887,38,40-44,1925,4.602695323658223
STAT,1844,48,30-34,1892,0.06638514695340215
STAT,1877,17,15-19,1894,5.815471939563655
SIM,1867,24,15-19,1891,3
STAT,1906,41,45-49,1947,0.1436443876674941
STAT,1881,23,35-39,1904,5.309041258012781
STAT,1822,40,15-19,1862,0.021218008900329235
STAT,1926,37,35-39,1963,2.792465391322283
SIM,1915,34,20-24,1949,5
STAT,1927,26,30-34,1953,45.153849949971764
STAT,1844,32,15-19,1876,0.11827445854769696
STAT,1922,31,50-100,1953,0.8861165898223815
STAT,1949,18,30-34,1967,13.388137934119932
STAT,1851,19,20-24,1870,15.32307180720575
STAT,1885,33,20-24,1918,2.5345766452501195
SIM,1859,102,na,1961,1
STAT,1923,42,35-39,1965,0.22233716925653588
SIM,1803,65,na,1868,788
STAT,1879,28,40-44,1907,2.9518057858607825
STAT,1933,23,45-49,1956,1.4094744261434036
STAT,1938,27,45-49,1965,1.6169211364865181
SIM,1920,18,35-39,1938,5
STAT,1841,40,25-29,1881,0.47197175599709273
STAT,1916,36,20-24,1952,0.25624868104332044
SIM,1909,62,na,1971,2946
SIM,1929,17,na,1946,4397
STAT,1915,3,na,1918,3997.320100900049
SIM,1806,79,na,1885,284
STAT,1799,107,na,1906,0.0015055779755083077
SIM,1860,34,30-34,1894,16
STAT,1901,24,na,1925,3107.82463922858
SIM,1941,24,20-24,1965,97
STAT,1898,47,15-19,1945,2.871090204162195E-4
STAT,1863,57,na,1920,1666.0188496553044
STAT,1958,2,na,1960,4881.707523359647
STAT,1928,41,40-44,1969,0.3016548754771982
STAT,1830,42,30-34,1872,0.8943523884285535
STAT,1846,37,40-44,1883,3.3905822119574
STAT,1902,49,40-44,1951,0.12606333491362848
STAT,1852,34,30-34,1886,12.836535227919212
STAT,1869,36,na,1905,2166.543190590515
STAT,1953,16,30-34,1969,13.932668895983394
SIM,1909,20,15-19,1929,4
STAT,1931,19,15-19,1950,55.815070450811426
STAT,1924,21,45-49,1945,1.2580162239259558
STAT,1839,31,35-39,1870,8.384134168545176
SIM,1796,78,na,1874,304
STAT,1858,19,15-19,1877,5.07435047982098
SIM,1893,33,20-24,1926,3
SIM,1882,24,40-44,1906,2
SIM,1898,39,na,1937,2947
STAT,1902,30,20-24,1932,3.6327707716283593
SIM,1854,37,40-44,1891,5
STAT,1914,23,40-44,1937,3.235227545044094
STAT,1935,31,30-34,1966,20.60345872216709
SIM,1850,48,50-100,1898,2
SIM,1936,31,30-34,1967,17
STAT,1875,42,na,1917,2241.484683177562
STAT,1898,70,na,1968,2106.205427043206
STAT,1934,17,na,1951,4703.237959914727
STAT,1860,15,na,1875,2053.360279155142
STAT,1863,41,15-19,1904,0.01150038969137032
STAT,1905,48,15-19,1953,3.04229466195714E-4
STAT,1834,25,15-19,1859,0.3745719110341515
STAT,1834,82,na,1916,289.2670707626619
SIM,1818,64,na,1882,863
STAT,1847,33,na,1880,1857.0455728932513
STAT,1851,54,na,1905,1506.2732259398715
SIM,1902,20,20-24,1922,83
STAT,1859,43,15-19,1902,0.010308472040173253
STAT,1863,32,25-29,1895,8.491296105941124
STAT,1891,30,35-39,1921,11.931466796456302
SIM,1851,60,na,1911,1426
STAT,1855,81,na,1936,384.28168405507915
SIM,1839,21,35-39,1860,6
SIM,1847,31,35-39,1878,8
STAT,1890,46,45-49,1936,0.15418980374589422
STAT,1905,29,15-19,1934,0.6151003902967945
SIM,1860,80,na,1940,458
STAT,1840,22,35-39,1862,4.870084394400803
SIM,1880,57,na,1937,2016
STAT,1895,19,na,1914,3093.8520723018905
SIM,1914,49,na,1963,3431
SIM,1823,94,na,1917,13
STAT,1910,42,25-29,1952,0.06375709029684348
STAT,1896,22,50-100,1918,0.5087941559863081
SIM,1922,23,40-44,1945,8
SIM,1815,46,50-100,1861,3
STAT,1818,42,20-24,1860,0.37456141253339914
STAT,1883,1,na,1884,3094.977510977811
STAT,1920,48,50-100,1968,0.23553509480719592
SIM,1929,39,na,1968,4520
SIM,1944,15,40-44,1959,2
SIM,1953,2,na,1955,4447
SIM,1866,19,15-19,1885,4
STAT,1876,31,15-19,1907,0.13955857650182593
SIM,1846,27,40-44,1873,2
STAT,1831,48,20-24,1879,0.008439638491738925
SIM,1852,32,20-24,1884,4
STAT,1878,33,15-19,1911,0.1396116306344456
SIM,1840,66,na,1906,1062
SIM,1838,19,na,1857,1969
SIM,1841,23,40-44,1864,1
STAT,1849,99,na,1948,1.4201502841934643
STAT,1880,48,40-44,1928,0.16836165888639448
SIM,1866,40,35-39,1906,2
SIM,1909,16,na,1925,3607
STAT,1865,49,20-24,1914,0.010060656324857585
SIM,1908,31,na,1939,3340
SIM,1932,21,45-49,1953,2
STAT,1860,45,20-24,1905,0.009289817728739972
STAT,1815,50,25-29,1865,0.007965602909298222
STAT,1820,38,35-39,1858,15.306288634870763
STAT,1916,23,na,1939,3603.784395831654
STAT,1930,32,25-29,1962,11.268048534793975
STAT,1827,39,40-44,1866,4.335050182110159
SIM,1835,39,40-44,1874,6
STAT,1933,24,20-24,1957,139.24193077901717
STAT,1911,26,35-39,1937,13.879665590204356
STAT,1914,7,na,1921,3893.5763810632106
SIM,1926,34,na,1960,4241
STAT,1913,33,45-49,1946,1.4728174731202521
SIM,1820,37,na,1857,1583
SIM,1887,17,25-29,1904,6
STAT,1924,48,25-29,1972,0.05949148169354146
SIM,1921,33,45-49,1954,3
SIM,1901,18,30-34,1919,3
STAT,1833,23,40-44,1856,1.7072500548239686
STAT,1838,27,40-44,1865,2.558241949910387
STAT,1844,32,20-24,1876,2.2449830172517835
STAT,1931,12,na,1943,4899.309978536324
SIM,1873,40,35-39,1913,5
STAT,1872,49,20-24,1921,0.01113351122375457
STAT,1902,55,na,1957,2795.4687382719303
STAT,1808,102,na,1910,0.11335764080779004
STAT,1929,15,40-44,1944,1.6941006456688406
STAT,1865,23,50-100,1888,0.3508841115111214
SIM,1902,39,40-44,1941,2
SIM,1941,23,45-49,1964,1
STAT,1846,85,na,1931,203.32655055841718
STAT,1802,101,na,1903,0.2000575862608405
SIM,1871,9,na,1880,2539
STAT,1882,41,25-29,1923,0.5926289597691785
STAT,1884,25,na,1909,2242.502934940117
STAT,1948,15,45-49,1963,0.5403675495036909
SIM,1837,43,35-39,1880,3
STAT,1860,15,15-19,1875,5.308680959070784
STAT,1788,80,na,1868,226.0354278913092
STAT,1878,56,na,1934,2008.0617048850447
STAT,1864,16,35-39,1880,0.5283054443752075
STAT,1894,39,50-100,1933,1.47553881807949
STAT,1865,40,35-39,1905,1.5661840921336334
STAT,1871,46,40-44,1917,0.16105394505595633
SIM,1900,26,25-29,1926,50
STAT,1850,48,30-34,1898,0.06737918862966152
STAT,1884,41,15-19,1925,0.012947319727012496
SIM,1918,15,30-34,1933,1
STAT,1858,27,na,1885,1809.5390026814546
STAT,1837,42,25-29,1879,0.49178380763242846
STAT,1942,26,20-24,1968,18.10724883142103
STAT,1863,24,50-100,1887,0.33986898761776546
STAT,1934,16,20-24,1950,173.6624739250187
SIM,1793,95,na,1888,7
STAT,1896,34,35-39,1930,12.52721362610521
SIM,1818,42,na,1860,1410
STAT,1866,41,50-100,1907,0.9246741374591952
STAT,1912,18,35-39,1930,0.7995092005655013
SIM,1879,60,na,1939,1920
STAT,1829,43,35-39,1872,1.5207394968396097
SIM,1864,33,na,1897,2077
STAT,1926,17,50-100,1943,0.4339297862168279
STAT,1916,34,50-100,1950,0.799490988071459
STAT,1892,76,na,1968,1492.1841085498102
STAT,1947,18,20-24,1965,144.23277050035367
STAT,1850,26,50-100,1876,0.5344970219605855
STAT,1818,49,40-44,1867,0.3541755943763402
SIM,1863,33,35-39,1896,9
STAT,1886,43,15-19,1929,0.01368142177943877
STAT,1893,47,30-34,1940,0.06511124360638626
SIM,1850,29,20-24,1879,10
SIM,1858,79,na,1937,511
SIM,1847,44,40-44,1891,6
STAT,1848,30,25-29,1878,9.06185478211896
STAT,1878,47,na,1925,2204.6880772594836
SIM,1854,89,na,1943,73
STAT,1895,43,25-29,1938,0.05452358146307265
STAT,1926,44,35-39,1970,0.2337273723954622
SIM,1861,25,25-29,1886,37
STAT,1815,47,na,1862,1355.3754707706364
STAT,1842,29,20-24,1871,10.355887245538362
SIM,1896,19,na,1915,3153
STAT,1835,42,15-19,1877,0.010531569956548586
STAT,1867,45,30-34,1912,0.08672523444168899
STAT,1935,27,35-39,1962,19.333489711057297
STAT,1835,61,na,1896,1189.3416586008168
SIM,1855,34,na,1889,1891
STAT,1844,25,15-19,1869,0.3913438822812054
STAT,1912,48,na,1960,3326.258358616253
STAT,1813,48,45-49,1861,0.6347253158118954
STAT,1861,93,na,1954,22.956170994126836
STAT,1855,33,35-39,1888,7.25189215660543
STAT,1809,49,30-34,1858,0.26374984567983134
STAT,1830,45,40-44,1875,0.131644076611547
STAT,1861,32,50-100,1893,0.719699101901506
STAT,1851,29,30-34,1880,20.90599693888752
SIM,1890,16,na,1906,3160
STAT,1905,40,50-100,1945,0.10118646281117817
STAT,1872,56,na,1928,1932.7108058819817
SIM,1943,27,35-39,1970,14
SIM,1923,23,na,1946,4045
STAT,1904,19,45-49,1923,0.08804098690964343
SIM,1857,2,na,1859,2673
SIM,1803,74,na,1877,421
STAT,1828,97,na,1925,3.0255406964618006
SIM,1904,32,30-34,1936,22
STAT,1823,42,na,1865,1476.0921062621683
SIM,1854,21,25-29,1875,56
STAT,1804,84,na,1888,113.47312117108982
SIM,1889,22,na,1911,2849
STAT,1884,41,na,1925,2166.8884419426145
SIM,1904,41,na,1945,3228
STAT,1762,109,na,1871,0.0014701215444297734
STAT,1896,38,50-100,1934,1.5242388603338546
SIM,1930,22,30-34,1952,44
SIM,1843,39,30-34,1882,7
STAT,1939,22,40-44,1961,3.1900265204724985
SIM,1866,96,na,1962,15
STAT,1810,54,20-24,1864,0.002261294774026675
STAT,1930,33,45-49,1963,1.9172165395779044
SIM,1950,17,25-29,1967,58
SIM,1821,84,na,1905,195
STAT,1850,23,40-44,1873,1.7504226387896755
STAT,1942,17,25-29,1959,42.78272008255251
SIM,1883,31,na,1914,2216
STAT,1828,52,25-29,1880,0.002769479921996226
SIM,1841,39,na,1880,1625
STAT,1897,29,na,1926,2993.5419898873815
SIM,1825,77,na,1902,453
SIM,1852,39,40-44,1891,7
SIM,1891,45,50-100,1936,1
SIM,1935,30,na,1965,4869
SIM,1906,40,40-44,1946,1
STAT,1841,79,na,1920,481.9714963813415
STAT,1868,21,45-49,1889,0.6330707488477265
STAT,1901,7,na,1908,3445.1714850139538
STAT,1835,39,30-34,1874,4.107426037385202
SIM,1895,22,25-29,1917,81
STAT,1797,97,na,1894,1.318290178733142
STAT,1893,35,30-34,1928,6.4456205239786835
SIM,1868,27,25-29,1895,46
STAT,1922,22,30-34,1944,31.13677207826094
STAT,1924,30,40-44,1954,4.332471806466961
SIM,1885,78,na,1963,947
STAT,1915,48,15-19,1963,3.4969574455441884E-4
SIM,1916,29,30-34,1945,36
STAT,1921,33,35-39,1954,9.56658922642277
SIM,1881,88,na,1969,248
STAT,1869,53,25-29,1922,0.003189565254497612
STAT,1937,23,50-100,1960,0.6051238041092937
SIM,1947,22,40-44,1969,6
STAT,1844,39,40-44,1883,3.1467071102215227
STAT,1814,99,na,1913,0.8704705739698644
SIM,1865,20,30-34,1885,28
SIM,1891,63,na,1954,2108
STAT,1826,87,na,1913,96.20931220604905
SIM,1859,27,na,1886,1959
STAT,1827,32,na,1859,1678.3187761932088
SIM,1878,84,na,1962,454
STAT,1907,33,45-49,1940,1.3836717131438423
STAT,1909,37,35-39,1946,2.1628968093437235
STAT,1861,32,15-19,1893,0.1118593969147909
STAT,1831,29,45-49,1860,0.9093113365996978
SIM,1923,45,na,1968,4154
SIM,1909,8,na,1917,3686
SIM,1856,30,25-29,1886,7
STAT,1924,8,na,1932,4486.752158790269
STAT,1905,60,na,1965,2802.5800671104935
STAT,1861,48,30-34,1909,0.07507977116793949
STAT,1848,49,na,1897,1636.8571222385783
SIM,1880,39,50-100,1919,1
STAT,1836,50,50-100,1886,0.010295502667952615
SIM,1811,44,50-100,1855,3
SIM,1931,3,na,1934,4968
STAT,1870,22,20-24,1892,63.865431439018074
STAT,1910,18,25-29,1928,8.090824410201412
SIM,1932,30,40-44,1962,4
SIM,1909,19,na,1928,3585
STAT,1837,21,50-100,1858,0.348964626283633
SIM,1902,23,30-34,1925,31
SIM,1892,29,na,1921,3132
STAT,1887,22,25-29,1909,60.49053899318657
SIM,1915,33,45-49,1948,2
STAT,1880,39,45-49,1919,1.9654009107511088
STAT,1797,94,na,1891,4.904367410406024
STAT,1872,53,na,1925,2007.5336470092423
STAT,1908,29,30-34,1937,34.742586320206044
STAT,1845,42,15-19,1887,0.009951246670942543
STAT,1885,26,15-19,1911,0.42869220687439447
SIM,1792,94,na,1886,1
STAT,1830,33,40-44,1863,3.65898784399615
SIM,1929,28,20-24,1957,26
STAT,1821,42,50-100,1863,1.8180573697497093
STAT,1890,37,50-100,1927,1.4180009237382754
SIM,1821,87,na,1908,107
SIM,1946,24,40-44,1970,3
SIM,1916,17,30-34,1933,3
STAT,1839,18,50-100,1857,0.042418680136527054
STAT,1852,46,30-34,1898,0.07037792018459914
STAT,1867,54,50-100,1921,0.013028900253556321
STAT,1870,34,15-19,1904,0.13084797664715683
STAT,1825,39,30-34,1864,6.160540995698363
STAT,1917,47,50-100,1964,0.22318288525788563
SIM,1833,39,30-34,1872,5
STAT,1867,30,35-39,1897,9.0557086526405
STAT,1869,41,25-29,1910,0.5903545244531945
STAT,1881,11,na,1892,2360.331508343276
SIM,1789,90,na,1879,14
STAT,1839,20,50-100,1859,0.35391719150446793
SIM,1828,31,25-29,1859,11
STAT,1853,25,25-29,1878,37.62461972508073
STAT,1935,20,15-19,1955,6.852634069345638
STAT,1839,44,40-44,1883,1.5384372332977951
SIM,1877,37,na,1914,2289
SIM,1931,40,na,1971,4677
STAT,1804,87,na,1891,59.01466300951617
STAT,1857,20,30-34,1877,15.543280693047354
STAT,1917,44,25-29,1961,0.07016683866012063
SIM,1771,92,na,1863,5
SIM,1843,27,50-100,1870,1
SIM,1924,27,25-29,1951,89
SIM,1827,84,na,1911,174
STAT,1905,24,45-49,1929,0.9462278318749988
SIM,1889,25,na,1914,2909
STAT,1811,45,30-34,1856,0.33324078326543183
SIM,1839,30,30-34,1869,21
STAT,1861,29,30-34,1890,19.638686707422703
STAT,1813,41,25-29,1854,2.2731565886662644
STAT,1921,46,40-44,1967,0.16832272271302387
SIM,1918,4,na,1922,4159
SIM,1792,91,na,1883,11
STAT,1836,54,40-44,1890,0.006630075055184475
SIM,1807,55,na,1862,1096
STAT,1925,17,30-34,1942,13.909324957915306
SIM,1809,68,na,1877,746
SIM,1809,84,na,1893,144
SIM,1897,31,25-29,1928,16
SIM,1822,47,na,1869,1400
SIM,1854,33,50-100,1887,6
STAT,1819,54,40-44,1873,0.018397478746715767
STAT,1898,21,30-34,1919,22.84032136830636
STAT,1889,31,25-29,1920,11.994303928830245
SIM,1873,21,35-39,1894,5
STAT,1938,24,40-44,1962,3.1416005457301805
SIM,1909,2,na,1911,3749
STAT,1847,89,na,1936,77.46722774357352
STAT,1826,107,na,1933,0.002575301677636863
STAT,1865,34,40-44,1899,3.6815911612658936
STAT,1873,19,na,1892,2406.8427840822837
SIM,1834,32,na,1866,1708
SIM,1890,19,15-19,1909,7
STAT,1884,0,na,1884,3288.6339835352064
STAT,1920,35,35-39,1955,2.5060982524562494
SIM,1836,61,na,1897,1170
SIM,1933,17,30-34,1950,19
STAT,1911,30,30-34,1941,14.610342596910357
STAT,1968,3,na,1971,4640.695078754167
STAT,1961,7,na,1968,4796.1723703207335
STAT,1883,23,45-49,1906,0.6438728283403937
STAT,1911,23,25-29,1934,82.50516993219594
STAT,1916,27,25-29,1943,64.29197574310815
SIM,1895,47,50-100,1942,2
SIM,1927,25,50-100,1952,2
SIM,1913,24,45-49,1937,1
SIM,1918,18,35-39,1936,9
STAT,1820,47,30-34,1867,0.16236313981529385
STAT,1896,66,na,1962,2208.8922441822233
STAT,1882,19,15-19,1901,5.422924140163118
STAT,1854,37,na,1891,1685.6663795915767
STAT,1870,29,40-44,1899,2.756330825742456
STAT,1904,40,40-44,1944,0.21378777112891545
STAT,1934,19,30-34,1953,15.491209978591804
STAT,1886,45,40-44,1931,0.17254548266857997
STAT,1935,33,20-24,1968,3.1859363573763337
SIM,1867,22,na,1889,2265
SIM,1830,31,25-29,1861,13
SIM,1889,39,50-100,1928,2
STAT,1936,21,na,1957,3299.2030899594693
STAT,1865,21,35-39,1886,5.094038835786166
STAT,1880,32,25-29,1912,10.200966724319757
STAT,1934,32,50-100,1966,1.0664187651592782
STAT,1916,39,25-29,1955,0.9429429165874212
SIM,1924,39,25-29,1963,5
SIM,1858,64,na,1922,1412
SIM,1876,36,25-29,1912,4
STAT,1826,44,30-34,1870,1.0793307740296378
STAT,1880,20,25-29,1900,57.35307172885458
SIM,1858,45,na,1903,1860
SIM,1940,5,na,1945,3746
STAT,1874,66,na,1940,1582.0109477743392
SIM,1868,15,25-29,1883,4
STAT,1868,36,25-29,1904,2.6076322304642754
SIM,1942,19,30-34,1961,17
STAT,1860,68,na,1928,1171.3782054383666
STAT,1822,43,25-29,1865,0.9096323506487771
STAT,1910,44,15-19,1954,0.0013542801036373398
STAT,1840,91,na,1931,38.02869846097578
SIM,1912,40,40-44,1952,1
STAT,1862,53,30-34,1915,0.004730787203823144
STAT,1861,16,na,1877,2084.6651192334098
STAT,1886,51,na,1937,2159.0081408800183
STAT,1915,43,20-24,1958,0.01677044936718159
STAT,1863,44,25-29,1907,0.5251734344145829
STAT,1891,29,na,1920,2769.3877657669163
STAT,1930,30,50-100,1960,1.0091159812217694
STAT,1836,24,na,1860,1801.1153709984828
SIM,1911,20,na,1931,3406
SIM,1932,2,na,1934,5054
SIM,1834,44,30-34,1878,4
STAT,1816,39,20-24,1855,2.5318193415359818
STAT,1845,26,50-100,1871,0.5549584089090696
SIM,1928,22,30-34,1950,37
STAT,1866,22,na,1888,2077.5432413956537
STAT,1936,18,45-49,1954,0.45061156377573214
SIM,1854,71,na,1925,1044
STAT,1845,44,40-44,1889,1.579806043611495
STAT,1919,18,45-49,1937,0.5201367713375374
SIM,1843,49,na,1892,1541
STAT,1902,33,25-29,1935,13.59813476459805
SIM,1910,33,25-29,1943,9
SIM,1833,72,na,1905,715
STAT,1879,31,50-100,1910,0.9097533636987438
STAT,1861,90,na,1951,61.92825177480822
STAT,1832,54,40-44,1886,0.006361224455502481
STAT,1827,35,25-29,1862,3.1355785041504114
STAT,1942,29,25-29,1971,65.19738072690652
STAT,1835,50,50-100,1885,0.010191868548479865
SIM,1851,34,50-100,1885,5
STAT,1846,21,25-29,1867,52.767768615103
SIM,1917,34,30-34,1951,26
STAT,1894,26,25-29,1920,51.53225767254592
SIM,1873,53,na,1926,2046
SIM,1853,24,na,1877,1876
STAT,1924,45,20-24,1969,0.012487106894332326
STAT,1836,18,40-44,1854,0.279458368733664
STAT,1838,72,na,1910,847.8446889272268
SIM,1917,11,na,1928,4031
SIM,1907,17,20-24,1924,20
STAT,1908,48,50-100,1956,0.19270493714125878
SIM,1866,74,na,1940,945
STAT,1796,109,na,1905,1.532264787195876E-4
STAT,1896,44,na,1940,2854.6002350411486
STAT,1911,35,25-29,1946,0.9069720002177858
SIM,1889,21,30-34,1910,27
SIM,1891,66,na,1957,1978
SIM,1933,29,25-29,1962,87
SIM,1853,44,40-44,1897,4
SIM,1835,35,25-29,1870,1
SIM,1824,32,45-49,1856,3
SIM,1897,46,50-100,1943,3
SIM,1871,32,25-29,1903,13
STAT,1762,106,na,1868,0.005973605364254363
STAT,1854,49,45-49,1903,0.1653289130815083
SIM,1944,22,na,1966,3636
STAT,1915,19,20-24,1934,26.662680805289437
SIM,1790,84,na,1874,77
SIM,1923,19,20-24,1942,145
STAT,1876,17,50-100,1893,0.04781630872351124
STAT,1825,44,50-100,1869,1.0993043636735882
SIM,1900,22,45-49,1922,4
STAT,1950,20,40-44,1970,3.7709045588805563
STAT,1925,29,25-29,1954,72.91490827409609
STAT,1877,15,25-29,1892,5.578823718032115
STAT,1823,76,na,1899,507.0325748137682
STAT,1903,41,50-100,1944,0.09905613465198923
SIM,1783,80,na,1863,196
STAT,1813,45,40-44,1858,0.48366676169885503
STAT,1915,41,na,1956,3537.454453158677
SIM,1881,82,na,1963,510
STAT,1850,47,50-100,1897,0.17232204576961316
STAT,1817,54,30-34,1871,0.012354572446041746
STAT,1879,15,35-39,1894,0.5451247797964384
STAT,1819,50,25-29,1869,0.006704115930962081
SIM,1898,36,na,1934,2982
SIM,1818,79,na,1897,313
STAT,1879,21,20-24,1900,68.3514559106975
STAT,1841,18,15-19,1859,5.245686975496545
STAT,1899,58,na,1957,2601.41403654195
SIM,1819,43,na,1862,1442
STAT,1877,19,40-44,1896,0.17827185445385274
SIM,1857,82,na,1939,296
SIM,1932,37,na,1969,4720
STAT,1844,44,15-19,1888,0.009574541264848873
STAT,1901,16,25-29,1917,7.511755919617905
SIM,1846,33,35-39,1879,10
SIM,1873,34,40-44,1907,1
STAT,1842,22,45-49,1864,0.6369385613206351
SIM,1887,21,20-24,1908,59
SIM,1834,35,na,1869,1660
STAT,1865,30,25-29,1895,8.840893366016825
STAT,1870,25,25-29,1895,39.46928737242231
STAT,1930,23,35-39,1953,11.3598571712688
STAT,1911,25,50-100,1936,0.9232508456630676
STAT,1849,29,15-19,1878,0.39752482370321013
STAT,1862,78,na,1940,631.0969074417526
SIM,1928,35,45-49,1963,2
STAT,1808,68,na,1876,765.6999521244865
STAT,1893,15,50-100,1908,0.05896632476323773
STAT,1926,46,25-29,1972,0.061983845055647614
SIM,1875,30,35-39,1905,12
STAT,1884,45,30-34,1929,0.09124615073341438
STAT,1876,40,50-100,1916,1.0415063045012065
SIM,1778,87,na,1865,44
SIM,1845,75,na,1920,688
SIM,1793,79,na,1872,259
STAT,1863,42,na,1905,1913.6987477012103
STAT,1858,40,35-39,1898,1.3547697769411966
SIM,1818,98,na,1916,2
SIM,1921,19,na,1940,3985
STAT,1930,30,40-44,1960,4.776285037499173
STAT,1903,34,na,1937,3207.1542638381543
SIM,1807,58,na,1865,1022
SIM,1882,20,25-29,1902,63
STAT,1853,22,20-24,1875,61.62062095642728
SIM,1808,80,na,1888,229
STAT,1851,38,na,1889,1695.2101490539635
SIM,1902,26,35-39,1928,13
STAT,1838,33,35-39,1871,8.361155050988204
STAT,1909,34,30-34,1943,14.082142888385896
SIM,1843,31,na,1874,1892
STAT,1886,41,25-29,1927,0.6437147129253239
SIM,1906,19,20-24,1925,26
SIM,1837,21,25-29,1858,58
STAT,1828,35,50-100,1863,1.1729086490785952
STAT,1909,43,20-24,1952,0.015511815639557208
STAT,1925,18,na,1943,4189.315037900125
STAT,1820,35,30-34,1855,13.866384694003408
STAT,1835,23,15-19,1858,2.771039570947485
STAT,1900,19,50-100,1919,0.06385976269974475
STAT,1893,55,na,1948,2477.1780372261655
STAT,1826,40,15-19,1866,0.014047301982766977
STAT,1844,35,25-29,1879,2.3708183422663898
STAT,1924,33,45-49,1957,1.7332045616179976
SIM,1843,23,15-19,1866,5
STAT,1847,16,35-39,1863,0.5080003501927867
SIM,1908,15,na,1923,3538
STAT,1910,15,20-24,1925,25.49679562642388
STAT,1932,36,15-19,1968,0.024396640238826546
SIM,1861,22,20-24,1883,65
SIM,1856,3,na,1859,2526
STAT,1880,36,40-44,1916,4.380691168474267
SIM,1861,68,na,1929,1298
SIM,1865,12,na,1877,2411
SIM,1932,33,45-49,1965,1
STAT,1900,32,20-24,1932,3.5423705644043686
SIM,1878,22,25-29,1900,60
STAT,1818,39,30-34,1857,14.101009510608401
SIM,1870,64,na,1934,1572
SIM,1791,69,na,1860,626
SIM,1872,23,35-39,1895,9
STAT,1927,17,50-100,1944,0.44006756102326305
STAT,1884,59,na,1943,1813.8753511071577
STAT,1773,84,na,1857,85.34036523747699
STAT,1900,42,na,1942,3035.608520646062
STAT,1904,33,35-39,1937,7.846349073931752
SIM,1842,83,na,1925,227
STAT,1860,12,na,1872,2110.3926480382174
STAT,1843,44,30-34,1887,0.7793087185988573
STAT,1891,45,15-19,1936,2.6634489208238334E-4
STAT,1961,10,na,1971,4794.445954974217
STAT,1898,34,45-49,1932,2.210249792889211
SIM,1829,26,35-39,1855,9
SIM,1845,72,na,1917,847
STAT,1847,86,na,1933,163.61310467830089
STAT,1918,20,15-19,1938,5.456092065362962
STAT,1871,53,40-44,1924,0.009717131477062817
SIM,1846,20,20-24,1866,62
SIM,1865,23,35-39,1888,9
STAT,1828,42,15-19,1870,0.011708197302482575
STAT,1895,33,15-19,1928,0.174648963842656
SIM,1845,97,na,1942,1
STAT,1857,23,35-39,1880,4.983233553490622
STAT,1795,68,na,1863,742.8100153137395
SIM,1926,39,35-39,1965,7
STAT,1840,19,45-49,1859,0.054850998916534305
STAT,1883,32,50-100,1915,0.8486388792483015
STAT,1913,46,15-19,1959,3.4051802420018786E-4
STAT,1907,48,50-100,1955,0.1898385198258537
STAT,1906,46,15-19,1952,3.113308950204206E-4
SIM,1771,95,na,1866,1
STAT,1903,56,na,1959,2819.015076187241
SIM,1937,22,40-44,1959,4
STAT,1946,15,35-39,1961,4.399104892835648
STAT,1864,23,35-39,1887,4.956474784254103
SIM,1826,39,30-34,1865,10
STAT,1824,39,na,1863,1548.9627552036095
STAT,1839,38,na,1877,1686.4968671550591
STAT,1821,52,30-34,1873,0.009027547375609903
STAT,1885,26,na,1911,2254.966248892086
STAT,1775,101,na,1876,0.1213835144535243
SIM,1915,30,40-44,1945,5
SIM,1891,32,50-100,1923,1
STAT,1802,107,na,1909,0.0016533882229101983
STAT,1852,30,15-19,1882,0.10913960485486483
STAT,1900,45,na,1945,2978.374592612586
STAT,1893,20,35-39,1913,7.032779194103407
SIM,1915,48,50-100,1963,3
STAT,1841,48,20-24,1889,0.008204655926528807
STAT,1918,39,35-39,1957,2.4033162581137253
SIM,1908,37,na,1945,3286
STAT,1881,17,40-44,1898,0.16691851995714507
STAT,1935,24,30-34,1959,36.94847912010986
SIM,1805,91,na,1896,11
STAT,1854,17,50-100,1871,0.041931697661720085
STAT,1845,20,na,1865,1905.558545899142
STAT,1908,17,30-34,1925,2.233636284423181
STAT,1852,18,50-100,1870,0.04270518182533718
STAT,1830,48,45-49,1878,0.17456764179736806
SIM,1843,46,na,1889,1600
SIM,1912,33,35-39,1945,7
SIM,1857,60,na,1917,1470
STAT,1913,32,30-34,1945,14.808822860419074
STAT,1802,58,na,1860,1019.3472695047062
STAT,1929,22,40-44,1951,4.016673485732577
SIM,1928,25,50-100,1953,1
STAT,1863,106,na,1969,0.1118073327389382
STAT,1888,17,35-39,1905,0.6126053438941449
STAT,1859,36,15-19,1895,0.04242529992110972
STAT,1839,40,25-29,1879,0.5080343937394463
STAT,1907,30,40-44,1937,3.4834169481222728
STAT,1911,33,35-39,1944,8.371306916349763
SIM,1921,32,30-34,1953,18
SIM,1943,24,30-34,1967,35
STAT,1857,26,na,1883,1844.7213285484027
STAT,1888,18,na,1906,2812.320821868714
STAT,1848,34,na,1882,1843.0485023222416
SIM,1891,41,na,1932,2729
SIM,1867,78,na,1945,651
STAT,1824,33,40-44,1857,9.214294018928687
STAT,1904,43,45-49,1947,0.13981336281857554
STAT,1880,54,50-100,1934,0.01462772740113578
STAT,1892,31,50-100,1923,1.088578351355492
STAT,1818,52,50-100,1870,0.030913144171152252
SIM,1892,26,na,1918,3155
STAT,1820,45,40-44,1865,0.2957567836594749
STAT,1928,43,30-34,1971,0.15371901720593278
SIM,1905,23,40-44,1928,2
SIM,1837,37,40-44,1874,8
STAT,1936,16,50-100,1952,0.3396786632571735
SIM,1832,33,40-44,1865,7
SIM,1876,33,20-24,1909,2
STAT,1920,16,35-39,1936,4.458340088958879
STAT,1867,41,15-19,1908,0.012305826927397956
STAT,1854,42,25-29,1896,0.4588880773825075
SIM,1870,42,na,1912,2122
STAT,1868,33,20-24,1901,2.426099157489796
SIM,1865,49,na,1914,1943
STAT,1854,46,40-44,1900,0.12283881068067747
SIM,1954,15,35-39,1969,5
STAT,1881,30,na,1911,2195.2681458050824
SIM,1840,49,50-100,1889,2
SIM,1859,29,40-44,1888,2
SIM,1810,44,na,1854,1319
STAT,1912,32,50-100,1944,0.7685917300975574
STAT,1782,80,na,1862,209.40957968629337
STAT,1946,25,45-49,1971,1.8196197971340329
STAT,1851,25,15-19,1876,0.38767833650576644
SIM,1924,24,20-24,1948,125
SIM,1839,33,35-39,1872,16
STAT,1852,41,50-100,1893,0.7693786766828383
SIM,1887,34,35-39,1921,16
STAT,1880,41,15-19,1921,0.01381592292798463
SIM,1901,42,na,1943,3080
STAT,1880,22,15-19,1902,3.285613039476735
SIM,1902,32,20-24,1934,6
STAT,1898,24,35-39,1922,7.413490037428261
STAT,1829,37,40-44,1866,3.971862821879333
SIM,1894,55,na,1949,2600
SIM,1917,37,35-39,1954,5
STAT,1869,25,50-100,1894,0.5894115404265574
STAT,1838,20,20-24,1858,60.89615404508044
STAT,1916,24,20-24,1940,109.38375184443524
SIM,1926,20,15-19,1946,5
STAT,1801,73,na,1874,484.1351715659606
STAT,1859,74,na,1933,834.4395094689331
SIM,1929,17,40-44,1946,1
STAT,1811,48,35-39,1859,0.4586950586406399
STAT,1896,28,40-44,1924,3.724365389087257
STAT,1870,15,15-19,1885,5.618292674323098
SIM,1910,56,na,1966,3094
SIM,1886,19,25-29,1905,7
SIM,1888,77,na,1965,1251
STAT,1874,63,na,1937,1722.252215568629
STAT,1882,49,20-24,1931,0.010794399861783726
STAT,1848,12,na,1860,2198.9570567504784
SIM,1897,22,35-39,1919,14
STAT,1893,31,15-19,1924,0.17130554532020356
STAT,1925,46,50-100,1971,0.2595540613100239
STAT,1912,30,na,1942,3544.077659101489
STAT,1920,22,20-24,1942,116.77965094790592
SIM,1886,11,na,1897,2549
STAT,1856,48,50-100,1904,0.17875170525264458
STAT,1903,28,35-39,1931,12.92397579241296
SIM,1933,26,20-24,1959,20
SIM,1812,43,40-44,1855,7
SIM,1835,32,20-24,1867,1
SIM,1911,28,35-39,1939,16
STAT,1922,29,15-19,1951,0.7492551605294805
STAT,1838,75,na,1913,691.1295237110402
SIM,1845,18,25-29,1863,8
STAT,1832,50,25-29,1882,0.0023166776265538323
STAT,1889,22,35-39,1911,6.805657011006435
SIM,1809,65,na,1874,827
SIM,1948,18,20-24,1966,137
STAT,1833,35,na,1868,1677.119992183236
STAT,1791,94,na,1885,4.078432304544085
STAT,1837,54,25-29,1891,0.002235590672854499
STAT,1871,34,40-44,1905,4.033323712492119
STAT,1939,32,na,1971,3645.5030482271304
STAT,1861,46,40-44,1907,0.13485719942948787
STAT,1939,25,45-49,1964,1.6421571519325526
STAT,1904,19,na,1923,3403.985448145555
STAT,1925,26,20-24,1951,20.436950013285465
SIM,1848,86,na,1934,154
STAT,1879,34,35-39,1913,9.928644963407764
STAT,1853,64,na,1917,1315.582917215533
STAT,1874,30,35-39,1904,9.853452988492494
STAT,1866,17,15-19,1883,5.307509485903279
SIM,1931,0,na,1931,5143
STAT,1837,18,25-29,1855,5.524760407134278
STAT,1869,11,na,1880,2445.1980941551624
STAT,1832,49,50-100,1881,0.1556564476282051
STAT,1836,49,na,1885,1486.0979975781788
SIM,1828,57,na,1885,1239
SIM,1890,19,na,1909,3154
SIM,1833,87,na,1920,85
STAT,1886,23,50-100,1909,0.4056808468157438
STAT,1827,32,20-24,1859,3.243179575715213
STAT,1900,37,15-19,1937,0.015883928558386905
STAT,1936,0,na,1936,4074.541981130398
SIM,1922,41,na,1963,4025
STAT,1816,72,na,1888,625.1086133875851
SIM,1812,88,na,1900,52
STAT,1885,45,15-19,1930,3.8041222093780614E-4
STAT,1913,45,45-49,1958,0.20135078861997016
STAT,1911,39,40-44,1950,1.3522304006481831
SIM,1882,30,35-39,1912,1
STAT,1893,30,45-49,1923,2.10594007611285
STAT,1801,95,na,1896,4.700030789420711
STAT,1924,33,na,1957,4165.719854128013
SIM,1942,18,na,1960,3575
SIM,1823,104,na,1927,1
SIM,1869,85,na,1954,234
SIM,1940,2,na,1942,3794
STAT,1919,41,30-34,1960,0.1310705292999976
STAT,1855,27,40-44,1882,2.2188435297306324
STAT,1926,41,30-34,1967,0.14910134497929126
SIM,1846,20,na,1866,1909
STAT,1891,24,40-44,1915,2.420269913282858
STAT,1894,23,20-24,1917,83.4046571059094
STAT,1863,48,40-44,1911,0.1401444330843223
STAT,1845,40,25-29,1885,0.4747429616232317
STAT,1911,20,20-24,1931,100.2223371936374
STAT,1941,21,45-49,1962,1.098829528700792
STAT,1875,19,15-19,1894,5.731632578373293
STAT,1869,43,15-19,1912,0.012547311854562402
SIM,1865,33,45-49,1898,1
SIM,1928,25,35-39,1953,28
SIM,1863,27,40-44,1890,3
STAT,1896,69,na,1965,2072.5201575939614
STAT,1945,2,na,1947,4172.711659077858
STAT,1770,95,na,1865,1.7876588664759574
STAT,1852,110,na,1962,7.2048779650515E-4
STAT,1857,33,45-49,1890,1.2937710411960879
SIM,1864,48,50-100,1912,4
STAT,1876,43,15-19,1919,0.013381094578454485
STAT,1850,26,15-19,1876,0.3790926087495201
STAT,1867,34,45-49,1901,1.5336624035114388
SIM,1857,54,na,1911,1635
SIM,1917,24,20-24,1941,104
STAT,1862,7,na,1869,2289.6917805772064
STAT,1893,42,45-49,1935,1.7908088281028567
STAT,1766,103,na,1869,0.042897271123426284
STAT,1890,16,45-49,1906,0.07563055513306588
STAT,1888,24,35-39,1912,6.47422620838926
STAT,1872,15,40-44,1887,0.17595147978532436
STAT,1905,48,20-24,1953,0.009126892014189545
SIM,1825,40,40-44,1865,8
STAT,1913,24,40-44,1937,3.1875726729184017
SIM,1873,37,45-49,1910,2
STAT,1894,35,15-19,1929,0.0688218763353816
SIM,1853,44,35-39,1897,1
STAT,1840,22,40-44,1862,1.7390728412007674
STAT,1884,31,40-44,1915,4.064088187799294
STAT,1915,21,40-44,1936,3.293387516265684
STAT,1873,29,20-24,1902,11.159738342339157
SIM,1875,34,45-49,1909,1
SIM,1892,31,40-44,1923,5
STAT,1886,11,na,1897,2580.9583161372707
STAT,1829,41,15-19,1870,0.011965987628313354
STAT,1862,42,15-19,1904,0.011140722366198594
STAT,1836,51,30-34,1887,0.003978262391829687
STAT,1920,38,45-49,1958,0.7044044432629455
SIM,1880,66,na,1946,1595
STAT,1897,19,35-39,1916,0.6895118162198096
SIM,1853,28,30-34,1881,22
SIM,1853,64,na,1917,1334
STAT,1915,13,na,1928,3898.832146081523
STAT,1820,77,na,1897,455.3684238726007
STAT,1878,52,20-24,1930,7.226293210366357E-4
STAT,1824,67,na,1891,874.0682884757523
SIM,1915,27,20-24,1942,17
SIM,1949,17,20-24,1966,135
STAT,1911,23,na,1934,3408.6235014601634
SIM,1874,18,20-24,1892,21
STAT,1854,52,35-39,1906,0.006126861919841587
STAT,1857,15,45-49,1872,0.05788299690457333
STAT,1911,27,40-44,1938,4.294283105730621
SIM,1922,35,na,1957,4042
STAT,1819,38,30-34,1857,13.704570902454586
STAT,1909,24,20-24,1933,97.02267626997859
STAT,1884,48,35-39,1932,0.12902309143834034
SIM,1942,24,50-100,1966,1
STAT,1864,95,na,1959,19.231918281473725
SIM,1931,28,15-19,1959,3
STAT,1845,28,30-34,1873,21.533705941232558
STAT,1843,49,30-34,1892,0.06401808833159338
SIM,1797,60,na,1857,931
STAT,1847,41,35-39,1888,1.360068166266249
STAT,1896,32,15-19,1928,0.17767998129159165
STAT,1866,18,20-24,1884,15.761956792118937
STAT,1923,28,15-19,1951,0.7629815422371005
STAT,1826,51,45-49,1877,0.013183672680675601
STAT,1950,10,na,1960,4389.087641286784
STAT,1925,43,na,1968,4240.915618849551
SIM,1878,44,40-44,1922,4
SIM,1892,51,na,1943,2864
STAT,1855,18,45-49,1873,0.05488666039864806
STAT,1878,16,na,1894,2492.6181771018214
STAT,1782,100,na,1882,0.1865878323503997
SIM,1848,18,na,1866,2083
SIM,1848,28,20-24,1876,9
STAT,1782,98,na,1880,0.4978804178025117
STAT,1865,37,45-49,1902,1.7069552461239976
SIM,1855,41,35-39,1896,2
SIM,1857,20,35-39,1877,10
SIM,1842,25,20-24,1867,10
SIM,1880,15,40-44,1895,1
STAT,1883,48,50-100,1931,0.22461973373132754
STAT,1827,44,15-19,1871,0.012801387886088996
SIM,1774,91,na,1865,11
SIM,1839,40,40-44,1879,5
STAT,1883,62,na,1945,1692.8690136256232
SIM,1840,28,20-24,1868,11
STAT,1813,51,35-39,1864,0.022963006944165466
SIM,1896,41,na,1937,2918
SIM,1907,17,15-19,1924,6
SIM,1878,26,40-44,1904,4
SIM,1807,95,na,1902,4
SIM,1934,20,na,1954,4591
STAT,1922,17,45-49,1939,0.5461517035465283
STAT,1843,47,35-39,1890,0.09412168256366697
SIM,1837,43,40-44,1880,4
STAT,1850,75,na,1925,725.6918912327005
SIM,1827,38,30-34,1865,9
STAT,1834,25,20-24,1859,9.685359336225694
STAT,1872,23,50-100,1895,0.3852189012031308
STAT,1931,38,20-24,1969,0.3294694906195895
STAT,1898,31,40-44,1929,5.566800280247377
SIM,1871,26,25-29,1897,49
STAT,1832,28,20-24,1860,9.491688731458094
STAT,1876,37,20-24,1913,0.7523522132773149
STAT,1896,34,40-44,1930,5.364532429107997
SIM,1781,85,na,1866,68
STAT,1821,46,45-49,1867,0.3777581924693159
SIM,1894,29,30-34,1923,33
SIM,1930,30,na,1960,4619
SIM,1887,37,45-49,1924,2
STAT,1882,52,40-44,1934,0.009620424776395681
STAT,1879,37,45-49,1916,1.9713055681961562
SIM,1888,46,na,1934,2551
STAT,1817,40,40-44,1857,6.184742859809665
STAT,1863,26,25-29,1889,35.32222294823489
STAT,1924,33,50-100,1957,0.910666797940479
SIM,1905,63,na,1968,2617
SIM,1917,22,25-29,1939,97
SIM,1930,17,45-49,1947,2
STAT,1807,83,na,1890,147.65859759221573
STAT,1871,31,30-34,1902,16.44541007143397
STAT,1827,28,50-100,1855,1.177945056280897
STAT,1886,29,30-34,1915,24.949675734068247
STAT,1794,83,na,1877,135.13246221650857
SIM,1855,23,35-39,1878,6
STAT,1853,34,15-19,1887,0.10870336607617363
STAT,1847,23,35-39,1870,5.23733599006712
STAT,1868,47,40-44,1915,0.15359036979883506
STAT,1826,33,15-19,1859,0.18275673091384825
STAT,1923,46,15-19,1969,4.0810390070226716E-4
SIM,1909,53,na,1962,3165
STAT,1849,40,50-100,1889,0.8060449336050897
STAT,1861,29,25-29,1890,32.989741052373496
SIM,1844,28,na,1872,1764
STAT,1929,33,na,1962,4535.378710786872
STAT,1925,25,15-19,1950,0.7930200453701147
SIM,1869,37,25-29,1906,3
SIM,1886,34,20-24,1920,1
STAT,1845,46,30-34,1891,0.06869295168025932
STAT,1849,90,na,1939,59.120018532264645
SIM,1838,87,na,1925,93
STAT,1831,49,na,1880,1372.9913824523069
STAT,1860,45,15-19,1905,3.096603185702318E-4
STAT,1880,42,35-39,1922,1.8012322261991698
STAT,1882,21,35-39,1903,5.377330959207934
STAT,1847,25,30-34,1872,22.643360442605495
SIM,1811,69,na,1880,654
SIM,1847,47,50-100,1894,1
STAT,1845,44,35-39,1889,1.271846921946748
SIM,1849,59,na,1908,1474
STAT,1858,26,15-19,1884,0.34649978833310746
SIM,1926,25,na,1951,4183
STAT,1912,43,35-39,1955,0.1823762638631971
STAT,1867,52,45-49,1919,0.012805111004837572
STAT,1878,34,20-24,1912,2.6384327384923165
SIM,1836,92,na,1928,26
SIM,1874,26,na,1900,2229
SIM,1896,36,50-100,1932,1
STAT,1841,39,na,1880,1703.9522036416174
SIM,1890,21,35-39,1911,6
STAT,1855,31,15-19,1886,0.10411667193984378
STAT,1829,32,50-100,1861,0.9142009185045508
STAT,1907,18,na,1925,3495.6708059027105
SIM,1838,28,35-39,1866,9
SIM,1855,25,30-34,1880,29
SIM,1959,12,na,1971,4878
STAT,1918,3,na,1921,4170.670005801027
STAT,1786,88,na,1874,41.97011338107074
SIM,1919,38,45-49,1957,1
STAT,1801,98,na,1899,1.148373476868324
SIM,1846,82,na,1928,301
SIM,1822,35,50-100,1857,1
SIM,1865,30,40-44,1895,4
SIM,1826,39,25-29,1865,2
SIM,1862,33,20-24,1895,2
STAT,1827,46,40-44,1873,0.15868459200895624
STAT,1950,17,20-24,1967,151.4433715921572
SIM,1833,41,50-100,1874,2
SIM,1868,38,na,1906,2112
SIM,1846,36,45-49,1882,1
STAT,1830,33,35-39,1863,8.544439423713865
STAT,1866,62,na,1928,1592.5411070629832
STAT,1844,46,40-44,1890,0.11924004112673321
STAT,1880,24,35-39,1904,5.775375419799174
SIM,1884,24,15-19,1908,2
SIM,1839,22,40-44,1861,5
STAT,1860,18,25-29,1878,4.980059194963859
STAT,1903,32,30-34,1935,23.468518443400946
STAT,1778,114,na,1892,1.0867629344620368E-4
STAT,1876,24,15-19,1900,3.199706379780601
SIM,1843,39,25-29,1882,2
SIM,1845,33,20-24,1878,1
STAT,1824,36,45-49,1860,3.282860885804015
SIM,1837,28,45-49,1865,6
STAT,1917,48,40-44,1965,0.15514124272922947
STAT,1908,31,na,1939,3386.3866787228017
SIM,1869,79,na,1948,651
STAT,1862,47,45-49,1909,0.18973288655442694
STAT,1866,90,na,1956,77.4142111649985
STAT,1846,110,na,1956,2.209395374405631E-4
STAT,1923,48,na,1971,4048.6758619728043
STAT,1812,42,na,1854,1387.8594918152132
SIM,1861,99,na,1960,2
SIM,1921,42,40-44,1963,2
STAT,1891,27,45-49,1918,1.2977014563059732
STAT,1860,30,40-44,1890,3.3508550271782003
SIM,1863,36,45-49,1899,1
SIM,1873,13,na,1886,2516
STAT,1835,39,25-29,1874,2.218954283878029
STAT,1897,54,na,1951,2645.540881585788
SIM,1821,33,35-39,1854,8
SIM,1837,46,na,1883,1541
STAT,1855,36,45-49,1891,1.4234431285031626
STAT,1813,83,na,1896,163.37867233852197
STAT,1848,22,40-44,1870,1.8853244119166641
STAT,1919,25,50-100,1944,1.0228805049392655
SIM,1842,21,na,1863,1853
SIM,1920,40,na,1960,3960
SIM,1941,17,20-24,1958,129
STAT,1935,33,na,1968,4939.967014858198
STAT,1891,27,15-19,1918,0.5302790156257412
SIM,1838,16,na,1854,2003
SIM,1851,97,na,1948,2
STAT,1829,46,45-49,1875,0.19544069521575033
STAT,1788,83,na,1871,119.81332902393618
STAT,1870,50,25-29,1920,0.00332977276521462
STAT,1894,37,40-44,1931,5.314504945112677
STAT,1905,32,35-39,1937,7.940297530248101
STAT,1838,49,20-24,1887,0.008078711432646614
STAT,1844,47,25-29,1891,0.03981806064598032
STAT,1849,20,35-39,1869,5.367319755223028
STAT,1837,33,20-24,1870,2.1768078935786828
SIM,1842,92,na,1934,22
SIM,1910,10,na,1920,3715
STAT,1839,47,15-19,1886,2.713446928831587E-4
STAT,1850,44,45-49,1894,1.0407759154014924
SIM,1879,29,35-39,1908,9
STAT,1848,40,40-44,1888,1.7126102916786294
STAT,1824,36,15-19,1860,0.09247496552722423
SIM,1911,32,30-34,1943,25
STAT,1899,42,40-44,1941,0.20192944407047253
STAT,1837,51,20-24,1888,4.902682528149886E-4
SIM,1856,22,40-44,1878,2
STAT,1852,70,na,1922,1017.2095185183688
STAT,1933,17,20-24,1950,171.44967474418772
SIM,1913,32,35-39,1945,10
STAT,1928,38,45-49,1966,0.8130589760739754
STAT,1886,47,30-34,1933,0.09614738230771666
SIM,1868,23,15-19,1891,2
STAT,1809,49,25-29,1858,0.15694205542086845
STAT,1926,38,40-44,1964,1.726539576554827
STAT,1820,43,20-24,1863,0.282950372148862
STAT,1845,29,na,1874,1836.5875046982974
STAT,1800,57,na,1857,1033.720778410951
STAT,1881,53,35-39,1934,0.0077305358992156605
SIM,1830,36,na,1866,1655
STAT,1867,34,15-19,1901,0.12524516338012892
STAT,1772,96,na,1868,1.3076301148003386
STAT,1913,27,50-100,1940,0.9369585338215988
STAT,1843,34,na,1877,1723.6745327133503
SIM,1871,23,20-24,1894,69
STAT,1839,29,na,1868,1788.4946135401601
SIM,1938,22,na,1960,3282
SIM,1883,26,20-24,1909,11
SIM,1867,84,na,1951,267
STAT,1878,19,25-29,1897,5.549091798882042
STAT,1886,45,35-39,1931,0.141100278208578
STAT,1899,1,na,1900,3523.1912851715524
STAT,1913,42,40-44,1955,0.230436016278198
SIM,1906,24,45-49,1930,5
STAT,1896,37,45-49,1933,2.4872443385918
SIM,1877,29,30-34,1906,35
STAT,1939,22,35-39,1961,8.933322404339863
SIM,1834,100,na,1934,1
STAT,1922,7,na,1929,4370.3044578912795
STAT,1829,28,45-49,1857,1.380935592265957
STAT,1907,27,20-24,1934,16.28005962275553
SIM,1936,7,na,1943,3004
STAT,1869,45,35-39,1914,0.12940388959495772
STAT,1889,46,50-100,1935,0.2872454282021854
SIM,1789,65,na,1854,704
SIM,1855,4,na,1859,2429
SIM,1861,36,40-44,1897,3
STAT,1870,34,20-24,1904,2.4836426141504
SIM,1815,90,na,1905,37
STAT,1853,36,40-44,1889,3.347456406286642
STAT,1861,17,50-100,1878,0.04423117285125465
SIM,1851,30,40-44,1881,3
STAT,1815,45,50-100,1860,0.5698196824929477
SIM,1855,99,na,1954,1
STAT,1868,97,na,1965,17.980032945674353
STAT,1881,23,40-44,1904,1.8958212459807608
STAT,1917,48,na,1965,3615.0374643271352
STAT,1885,48,25-29,1933,0.053557158427559995
STAT,1918,16,40-44,1934,0.28926077659833865
SIM,1828,33,50-100,1861,4
STAT,1908,19,50-100,1927,0.06828864649301668
STAT,1933,35,50-100,1968,0.5411787854963519
SIM,1890,56,na,1946,2584
STAT,1840,20,15-19,1860,2.7932148440071236
STAT,1857,30,40-44,1887,3.319288804129182
STAT,1861,44,20-24,1905,0.12306176337502979
STAT,1841,54,45-49,1895,0.009729899525249346
STAT,1819,54,35-39,1873,0.01504466723411182
STAT,1873,15,30-34,1888,1.5452589216058994
SIM,1832,36,45-49,1868,2
STAT,1879,32,15-19,1911,0.14082313146420128
STAT,1937,28,45-49,1965,1.5901659118759939
STAT,1875,26,20-24,1901,11.43050365783457
STAT,1818,39,25-29,1857,7.617786705293499
STAT,1896,19,45-49,1915,0.08106486015950377
STAT,1765,113,na,1878,3.30079013343207E-4
STAT,1824,54,45-49,1878,0.016366656252309007
SIM,1947,22,35-39,1969,13
STAT,1880,26,na,1906,2384.978318377137
SIM,1884,56,na,1940,2000
STAT,1868,15,20-24,1883,16.46214670619591
STAT,1918,46,35-39,1964,0.12993697041056873
STAT,1924,27,20-24,1951,20.077764184340662
SIM,1898,21,35-39,1919,8
STAT,1923,39,50-100,1962,0.4585913840840037
SIM,1793,70,na,1863,597
SIM,1932,27,20-24,1959,29
STAT,1849,39,25-29,1888,2.1638389351580956
SIM,1857,39,25-29,1896,2
SIM,1822,32,40-44,1854,4
STAT,1801,70,na,1871,643.3662152294843
STAT,1826,62,na,1888,1022.7856170458158
STAT,1843,30,40-44,1873,3.5953828734695605
SIM,1873,84,na,1957,307
STAT,1847,39,20-24,1886,0.5776492160319737
STAT,1854,33,20-24,1887,1.960071881145463
SIM,1818,37,50-100,1855,4
SIM,1876,15,20-24,1891,10
SIM,1868,39,30-34,1907,6
SIM,1887,34,50-100,1921,1
STAT,1838,36,45-49,1874,1.6317937855871893
SIM,1921,24,40-44,1945,4
STAT,1891,45,45-49,1936,0.1571436185937262
SIM,1849,31,na,1880,1929
STAT,1830,35,30-34,1865,4.451242206976517
SIM,1934,24,20-24,1958,130
STAT,1833,75,na,1908,631.6018636466883
STAT,1855,59,na,1914,1381.077472343154
SIM,1859,15,20-24,1874,13
SIM,1917,20,na,1937,3677
STAT,1877,62,na,1939,1791.0570752287263
STAT,1878,87,na,1965,362.65377457060447
STAT,1823,38,20-24,1861,1.1838619742095116
STAT,1930,24,40-44,1954,4.043625248141373
STAT,1847,28,35-39,1875,8.490690820685769
SIM,1881,31,35-39,1912,12
STAT,1846,41,15-19,1887,0.01050047446483938
STAT,1890,29,20-24,1919,13.452584946277753
STAT,1848,46,50-100,1894,0.18301318799060082
STAT,1868,18,25-29,1886,5.1695106650671026
STAT,1868,25,50-100,1893,0.5804934097192013
SIM,1872,25,30-34,1897,22
SIM,1908,16,20-24,1924,23
SIM,1818,67,na,1885,786
STAT,1840,25,45-49,1865,0.9217019766157682
STAT,1833,26,15-19,1859,0.3695806093191385
STAT,1897,16,30-34,1913,2.018612173617283
STAT,1862,41,30-34,1903,0.932810072966213
SIM,1938,17,15-19,1955,38
SIM,1872,99,na,1971,7
STAT,1855,90,na,1945,56.02621027002103
STAT,1864,26,45-49,1890,0.9380520369239919
STAT,1943,23,50-100,1966,0.6611246766321758
SIM,1870,28,30-34,1898,26
STAT,1837,65,na,1902,1096.7585082869787
SIM,1838,25,30-34,1863,26
SIM,1876,18,25-29,1894,6
STAT,1861,26,20-24,1887,9.348978078115767
SIM,1862,13,na,1875,2335
SIM,1882,49,50-100,1931,2
STAT,1885,47,40-44,1932,0.16045781270961687
SIM,1842,28,25-29,1870,38
STAT,1966,2,na,1968,4642.306957710427
STAT,1838,18,45-49,1856,0.05758682492533723
STAT,1855,15,40-44,1870,0.156430565836298
STAT,1873,31,35-39,1904,9.74254063380362
STAT,1845,60,na,1905,1349.5753401045854
SIM,1929,42,40-44,1971,1
STAT,1874,15,45-49,1889,0.0635801514043683
STAT,1862,28,30-34,1890,20.268290750263063
SIM,1916,48,50-100,1964,2
SIM,1850,28,na,1878,1931
SIM,1853,3,na,1856,2473
SIM,1906,21,40-44,1927,4
STAT,1928,27,50-100,1955,1.1584126220681124
SIM,1855,28,35-39,1883,8
STAT,1874,45,45-49,1919,0.23006371854266472
SIM,1872,26,45-49,1898,1
STAT,1839,47,45-49,1886,0.16009350354905194
SIM,1809,90,na,1899,29
SIM,1826,62,na,1888,983
STAT,1846,26,25-29,1872,38.230641034338845
SIM,1880,26,na,1906,2415
STAT,1874,97,na,1971,32.16042242097382
STAT,1844,29,25-29,1873,35.4506630923655
STAT,1871,36,30-34,1907,5.023592294673707
STAT,1939,33,50-100,1972,0.7964482500183167
SIM,1899,20,40-44,1919,4
SIM,1814,40,35-39,1854,1
SIM,1817,85,na,1902,104
STAT,1858,3,na,1861,2444.512598690072
STAT,1851,69,na,1920,1055.6670025637086
SIM,1942,15,15-19,1957,36
STAT,1865,19,15-19,1884,5.174946231202509
SIM,1873,19,15-19,1892,5
STAT,1865,77,na,1942,740.1497610957433
SIM,1890,19,20-24,1909,16
STAT,1934,15,15-19,1949,58.25978369207203
STAT,1942,25,15-19,1967,0.7005745884886939
STAT,1872,62,na,1934,1731.9164593792127
SIM,1844,87,na,1931,77
STAT,1807,54,45-49,1861,0.05107600577991932
STAT,1821,43,40-44,1864,3.7581284574668716
STAT,1902,46,na,1948,3008.6340327153484
SIM,1852,29,25-29,1881,35
SIM,1884,84,na,1968,606
STAT,1864,25,30-34,1889,21.429070962320974
SIM,1775,85,na,1860,66
STAT,1882,19,20-24,1901,16.200127790173998
STAT,1826,47,35-39,1873,0.1292604149663839
STAT,1850,26,45-49,1876,0.9277173260732776
STAT,1922,29,50-100,1951,1.056403218497503
SIM,1844,38,30-34,1882,3
SIM,1852,82,na,1934,301
SIM,1938,8,na,1946,3553
STAT,1868,48,25-29,1916,0.05126496260515668
STAT,1842,80,na,1922,447.9764783329413
STAT,1761,96,na,1857,1.8353859300178557
STAT,1944,22,15-19,1966,5.429603011739982
SIM,1875,16,15-19,1891,4
SIM,1898,19,20-24,1917,17
SIM,1892,11,na,1903,3396
SIM,1820,38,45-49,1858,1
SIM,1938,30,45-49,1968,2
STAT,1891,69,na,1960,1843.9333290394195
STAT,1870,19,25-29,1889,5.239461829400099
STAT,1813,103,na,1916,0.0590631275759542
STAT,1881,21,15-19,1902,3.0198003725458293
SIM,1863,54,na,1917,1743
SIM,1930,29,50-100,1959,1
SIM,1924,17,15-19,1941,47
SIM,1949,22,na,1971,3965
SIM,1855,59,na,1914,1538
STAT,1814,77,na,1891,397.29712666973194
SIM,1837,35,50-100,1872,1
SIM,1874,20,35-39,1894,6
SIM,1885,37,40-44,1922,3
STAT,1820,46,25-29,1866,0.0980488207677207
SIM,1867,44,na,1911,2186
STAT,1834,40,50-100,1874,0.8109066157735731
STAT,1825,49,na,1874,1335.3687416056193
STAT,1838,31,15-19,1869,0.12004255147244218
SIM,1804,59,na,1863,998
STAT,1867,16,15-19,1883,5.413692775597669
STAT,1888,29,35-39,1917,10.69553566356197
STAT,1871,32,15-19,1903,0.13358869412179028
SIM,1840,30,35-39,1870,11
STAT,1838,35,30-34,1873,4.408129356449042
STAT,1874,27,15-19,1901,0.4379243089210282
STAT,1844,31,50-100,1875,0.7689162693249999
SIM,1911,35,35-39,1946,5
SIM,1914,40,na,1954,3501
SIM,1820,36,25-29,1856,1
STAT,1908,25,15-19,1933,0.6401288015882303
SIM,1849,44,45-49,1893,2
STAT,1895,19,30-34,1914,1.9524803274153668
STAT,1919,45,40-44,1964,0.16230957434947574
STAT,1893,38,35-39,1931,8.431526694867303
STAT,1839,29,15-19,1868,0.3751008312957539
STAT,1858,95,na,1953,9.847758935588978
SIM,1909,25,na,1934,3427
STAT,1872,18,45-49,1890,0.06173594697421846
SIM,1802,80,na,1882,217
STAT,1867,16,na,1883,2303.9411373220005
STAT,1872,16,25-29,1888,5.419245184197665
STAT,1834,28,25-29,1862,34.176729673717496
SIM,1836,28,30-34,1864,27
SIM,1908,34,20-24,1942,2
STAT,1828,28,30-34,1856,35.62870226561281
STAT,1796,78,na,1874,307.34548799962465
STAT,1866,20,35-39,1886,5.200505459143155
STAT,1793,98,na,1891,0.538807387708802
STAT,1911,51,na,1962,3243.892954555604
STAT,1914,22,35-39,1936,9.087984831867967
STAT,1826,51,50-100,1877,0.013719957648543205
SIM,1922,22,35-39,1944,18
STAT,1821,40,30-34,1861,2.0982197989216442
STAT,1906,36,na,1942,3282.9016456374607
STAT,1836,38,30-34,1874,4.19250016166461
SIM,1880,16,25-29,1896,10
SIM,1861,28,na,1889,2027
STAT,1916,17,15-19,1933,9.096212418476746
STAT,1862,44,40-44,1906,1.7922586418974846
STAT,1903,35,35-39,1938,2.071508696711057
STAT,1854,36,25-29,1890,2.069937459971931
STAT,1828,38,50-100,1866,1.0959940430353983
STAT,1870,36,40-44,1906,4.0764262153076345
SIM,1890,38,50-100,1928,1
STAT,1898,29,20-24,1927,14.890525858924372
SIM,1902,15,na,1917,3390
SIM,1891,20,40-44,1911,2
STAT,1889,59,na,1948,2266.5745154525785
SIM,1900,16,20-24,1916,23
STAT,1866,50,35-39,1916,0.007609053021970868
STAT,1831,47,45-49,1878,0.16813045238156477
STAT,1860,15,20-24,1875,15.85884436355463
SIM,1914,31,40-44,1945,6
SIM,1939,4,na,1943,3754
SIM,1937,15,35-39,1952,4
STAT,1832,30,35-39,1862,8.171467785655336
STAT,1880,21,30-34,1901,17.79343196589637
STAT,1887,40,25-29,1927,0.6854041426270632
STAT,1800,85,na,1885,90.27661438934837
STAT,1864,21,15-19,1885,2.8427636607781936
SIM,1843,34,na,1877,1822
STAT,1827,49,45-49,1876,0.21021632631743967
SIM,1832,31,na,1863,1655
SIM,1828,97,na,1925,3
STAT,1854,18,30-34,1872,1.3561431651642257
SIM,1935,21,30-34,1956,44
STAT,1887,27,25-29,1914,44.699247255591565
STAT,1826,93,na,1919,15.959487554894176
STAT,1829,43,40-44,1872,1.8889643135579417
SIM,1872,39,20-24,1911,3
STAT,1813,49,15-19,1862,0.0010583977687601733
STAT,1875,40,50-100,1915,1.0361812813958682
SIM,1856,25,45-49,1881,4
SIM,1862,36,25-29,1898,2
SIM,1791,75,na,1866,365
SIM,1872,21,15-19,1893,3
STAT,1809,46,20-24,1855,0.03446916751678621
STAT,1893,24,15-19,1917,3.9275798019169317
STAT,1909,22,25-29,1931,81.10446939368254
SIM,1929,24,40-44,1953,4
STAT,1835,54,20-24,1889,4.6004700273524594E-4
SIM,1852,7,na,1859,2279
SIM,1822,35,45-49,1857,2
STAT,1818,67,na,1885,838.3856325082677
STAT,1842,48,50-100,1890,0.1756243635377433
STAT,1890,47,20-24,1937,0.00778151541466027
STAT,1913,58,na,1971,3213.56226141091
STAT,1862,27,50-100,1889,0.518596165348267
SIM,1837,25,40-44,1862,2
STAT,1852,41,45-49,1893,1.089953128424088
STAT,1835,39,na,1874,1650.620997182474
STAT,1884,56,na,1940,1903.632680274395
SIM,1895,27,25-29,1922,60
STAT,1927,21,30-34,1948,33.552708643900566
STAT,1852,23,45-49,1875,0.5962559539113543
STAT,1896,16,40-44,1912,0.2287659594660492
STAT,1921,49,15-19,1970,3.900022905391418E-4
SIM,1846,35,30-34,1881,3
SIM,1828,36,25-29,1864,2
SIM,1865,18,na,1883,2327
SIM,1866,41,40-44,1907,4
STAT,1896,41,na,1937,2906.7523239125917
STAT,1913,18,na,1931,3720.8862436827458
STAT,1947,22,50-100,1969,0.7025506331632471
SIM,1820,46,na,1866,1447
STAT,1918,32,15-19,1950,0.12900301477087928
STAT,1877,52,30-34,1929,0.0058020568716472196
STAT,1853,39,45-49,1892,1.4934789992918622
STAT,1882,38,50-100,1920,1.1223515265310204
STAT,1906,31,40-44,1937,3.440198512944121
STAT,1860,33,45-49,1893,1.3310158918677835
STAT,1929,15,35-39,1944,5.082301642747302
STAT,1881,26,45-49,1907,1.0167471218676756
STAT,1963,5,na,1968,4717.660964253721
SIM,1863,94,na,1957,21
SIM,1865,28,20-24,1893,10
STAT,1848,43,45-49,1891,1.1040570014214945
STAT,1802,52,na,1854,1147.792976078828
SIM,1896,2,na,1898,3359
SIM,1874,32,35-39,1906,8
STAT,1819,39,45-49,1858,4.7472568915852795
STAT,1828,46,25-29,1874,0.04725974991522953
STAT,1829,25,40-44,1854,8.522035131958376
SIM,1856,13,na,1869,2240
SIM,1906,21,35-39,1927,10
STAT,1895,59,na,1954,2393.5679172598175
STAT,1776,86,na,1862,63.4588423038727
STAT,1853,28,50-100,1881,0.5066887802853403
STAT,1830,31,15-19,1861,0.12417974302809678
SIM,1785,75,na,1860,366
STAT,1863,41,20-24,1904,0.13225447430757964
STAT,1847,24,na,1871,1905.188797219023
STAT,1873,18,35-39,1891,0.5243487678789288
STAT,1888,42,35-39,1930,2.019190795160379
STAT,1911,45,40-44,1956,0.14167340452478397
SIM,1883,29,25-29,1912,39
STAT,1929,33,35-39,1962,10.958592072487075
SIM,1905,35,na,1940,3240
STAT,1875,29,25-29,1904,40.78172746891894
SIM,1834,97,na,1931,1
SIM,1850,6,na,1856,2307
SIM,1866,99,na,1965,1
STAT,1868,45,15-19,1913,3.6413093699321023E-4
STAT,1887,23,50-100,1910,0.429574223727987
SIM,1841,49,50-100,1890,3
STAT,1861,47,25-29,1908,0.04503312892791794
STAT,1891,37,50-100,1928,1.434962705627756
STAT,1833,49,50-100,1882,0.1565643066458498
STAT,1870,54,40-44,1924,0.009488317422489708
SIM,1848,46,na,1894,1611
STAT,1897,35,50-100,1932,1.5658396419057217
STAT,1876,21,na,1897,2315.2677451536233
SIM,1860,23,15-19,1883,2
STAT,1918,43,30-34,1961,0.12820874969171156
SIM,1854,26,25-29,1880,34
SIM,1927,19,na,1946,4252
STAT,1822,40,20-24,1862,0.24400708917475133
STAT,1853,103,na,1956,0.131837350618424
STAT,1942,2,na,1944,4008.465879171045
STAT,1838,34,50-100,1872,0.7486605031595641
STAT,1857,28,20-24,1885,8.938360728581236
SIM,1879,26,30-34,1905,33
STAT,1883,20,40-44,1903,1.9415673884655693
SIM,1851,69,na,1920,1075
STAT,1773,81,na,1854,161.0
SIM,1870,44,40-44,1914,7
STAT,1878,21,50-100,1899,0.4026901554270772
STAT,1849,36,20-24,1885,0.5976563746736338
STAT,1942,15,na,1957,3635.760401386227
SIM,1827,39,45-49,1866,3
STAT,1881,50,30-34,1931,0.005510400304831443
SIM,1904,27,45-49,1931,1
STAT,1943,22,25-29,1965,92.8393093830494
STAT,1866,104,na,1970,0.6023674657642387
SIM,1863,33,40-44,1896,7
STAT,1871,77,na,1948,810.8623286667101
STAT,1864,39,20-24,1903,0.6425007831886969
STAT,1826,33,45-49,1859,2.237907793217789
STAT,1852,23,15-19,1875,2.8208832138125284
STAT,1829,39,na,1868,1620.1942765481913
SIM,1826,90,na,1916,38
STAT,1879,36,30-34,1915,5.29564273972486
SIM,1888,32,35-39,1920,18
STAT,1879,19,45-49,1898,0.06424926081365549
STAT,1867,48,35-39,1915,0.12263046455595765
STAT,1932,21,40-44,1953,4.180258001646589
STAT,1926,24,20-24,1950,126.81469069289967
STAT,1848,25,45-49,1873,0.9992147515947214
STAT,1872,48,45-49,1920,0.2208183361479816
SIM,1859,18,na,1877,2142
SIM,1937,33,35-39,1970,12
STAT,1841,51,40-44,1892,0.00729261332808203
STAT,1921,30,25-29,1951,9.79484229321539
STAT,1893,24,45-49,1917,0.8301807142841127
STAT,1921,49,45-49,1970,0.23010154509066386
SIM,1940,21,40-44,1961,4
STAT,1918,19,45-49,1937,0.5109008882760411
SIM,1857,18,20-24,1875,18
SIM,1874,41,50-100,1915,3
STAT,1831,29,15-19,1860,0.3715713796314984
STAT,1835,36,20-24,1871,0.6128793374226712
STAT,1849,18,20-24,1867,16.267546076930234
STAT,1855,33,40-44,1888,3.1054799421185373
SIM,1896,24,35-39,1920,5
SIM,1779,75,na,1854,352
SIM,1832,62,na,1894,1057
SIM,1887,36,30-34,1923,5
SIM,1829,33,35-39,1862,11
SIM,1911,35,na,1946,3455
SIM,1840,97,na,1937,3
SIM,1925,16,20-24,1941,160
SIM,1939,28,20-24,1967,18
STAT,1854,51,20-24,1905,5.304964061732157E-4
STAT,1913,39,15-19,1952,0.01772337423058528
SIM,1814,46,50-100,1860,2
STAT,1935,28,40-44,1963,5.99930916023187
STAT,1811,57,na,1868,1096.3178337309637
STAT,1864,23,40-44,1887,1.7699222410401947
SIM,1879,21,30-34,1900,22
STAT,1823,52,35-39,1875,0.010203873817043737
STAT,1842,24,50-100,1866,0.36714911299034386
STAT,1889,38,45-49,1927,2.3133819946409577
STAT,1844,26,20-24,1870,10.04637992092842
STAT,1845,29,45-49,1874,0.9426324060531102
STAT,1840,38,20-24,1878,0.5921462137106732
SIM,1879,38,na,1917,2357
STAT,1916,38,na,1954,3621.5777525985895
STAT,1947,17,15-19,1964,48.296763796026966
STAT,1837,62,na,1899,1186.1681311191062
STAT,1819,53,20-24,1872,0.0013155335051289272
SIM,1849,41,40-44,1890,11
SIM,1871,58,na,1929,1873
SIM,1883,43,na,1926,2101
STAT,1895,28,na,1923,2928.892796200552
STAT,1803,109,na,1912,2.3915207333811817E-4
SIM,1761,93,na,1854,9
SIM,1798,73,na,1871,448
SIM,1863,16,25-29,1879,6
STAT,1796,100,na,1896,0.22864558086054368
STAT,1874,57,na,1931,1939.742869704316
SIM,1954,12,na,1966,4484
STAT,1837,53,40-44,1890,0.006722859181661822
SIM,1833,31,35-39,1864,9
STAT,1846,14,na,1860,2204.1097073629453
STAT,1872,31,15-19,1903,0.13549373246414956
STAT,1943,24,20-24,1967,111.68434405665062
STAT,1857,45,45-49,1902,0.17758738759670215
STAT,1848,19,15-19,1867,5.402289813006113
STAT,1917,16,20-24,1933,27.629190238374967
STAT,1856,32,na,1888,1780.4316538930982
STAT,1864,28,35-39,1892,8.095528558983833
SIM,1893,61,na,1954,2318
SIM,1886,19,30-34,1905,2
SIM,1923,18,15-19,1941,52
STAT,1855,16,25-29,1871,4.818007734882269
STAT,1932,24,45-49,1956,1.3898663398407998
STAT,1825,38,25-29,1863,3.4665918665282773
STAT,1862,44,35-39,1906,1.4428851226691115
SIM,1864,29,20-24,1893,7
STAT,1951,20,na,1971,4124.521933425729
STAT,1829,30,na,1859,1751.3617245390149
STAT,1869,42,30-34,1911,1.0508688509603208
STAT,1934,24,50-100,1958,0.8347932420176564
SIM,1852,26,20-24,1878,8
SIM,1872,23,40-44,1895,2
SIM,1896,22,15-19,1918,3
SIM,1888,33,40-44,1921,7
STAT,1923,18,50-100,1941,0.41451073672876576
STAT,1928,23,na,1951,4293.87187286915
STAT,1847,55,na,1902,1524.7469573238743
SIM,1865,30,35-39,1895,8
STAT,1821,45,30-34,1866,0.15722705107912524
STAT,1895,37,25-29,1932,3.5460154980000405
STAT,1891,38,na,1929,2739.963944617044
SIM,1847,92,na,1939,22
STAT,1876,38,35-39,1914,6.868965397899749
SIM,1877,22,50-100,1899,1
SIM,1884,38,35-39,1922,15
STAT,1850,44,na,1894,1607.2551793852022
STAT,1883,17,15-19,1900,5.496660258489747
STAT,1905,51,na,1956,2971.2570813294305
SIM,1762,107,na,1869,1
SIM,1856,43,45-49,1899,3
SIM,1891,17,15-19,1908,5
STAT,1917,34,20-24,1951,2.3922937292451842
SIM,1877,42,30-34,1919,1
SIM,1836,52,na,1888,1353
SIM,1853,29,45-49,1882,3
STAT,1892,29,25-29,1921,49.695430112363034
SIM,1928,28,45-49,1956,3
SIM,1942,27,na,1969,3633
SIM,1853,33,na,1886,1825
SIM,1909,31,30-34,1940,16
STAT,1857,30,35-39,1887,7.751176917198658
STAT,1849,36,15-19,1885,0.043537887076493795
SIM,1861,38,30-34,1899,5
SIM,1923,20,na,1943,4092
STAT,1865,80,na,1945,529.683082494914
STAT,1909,38,40-44,1947,1.3319991174525962
STAT,1884,87,na,1971,421.42604270686155
SIM,1847,32,40-44,1879,3
STAT,1915,18,15-19,1933,8.949831470192626
SIM,1889,31,na,1920,2890
SIM,1920,22,30-34,1942,37
SIM,1911,21,15-19,1932,3
SIM,1860,18,na,1878,2197
STAT,1930,39,45-49,1969,0.8382272771155796
STAT,1869,17,30-34,1886,1.478891772928421
STAT,1825,31,35-39,1856,19.714180203244215
STAT,1870,16,20-24,1886,16.684904023885675
STAT,1833,26,45-49,1859,0.9044395135454301
SIM,1932,33,50-100,1965,2
SIM,1930,32,35-39,1962,14
STAT,1892,40,35-39,1932,2.164266043717315
STAT,1939,20,45-49,1959,1.0682409787473486
SIM,1856,44,na,1900,1793
STAT,1884,34,15-19,1918,0.1317740923963513
STAT,1851,28,25-29,1879,35.37258752407103
STAT,1852,101,na,1953,0.41369426305126655
STAT,1853,50,25-29,1903,0.002719102726264434
SIM,1844,56,na,1900,1357
SIM,1927,10,na,1937,4650
STAT,1817,43,15-19,1860,0.03371991816782047
STAT,1871,19,45-49,1890,0.06094861519656257
STAT,1919,41,25-29,1960,0.07321056621485462
STAT,1922,44,35-39,1966,0.21761901260201622
SIM,1894,1,na,1895,3364
STAT,1853,38,30-34,1891,4.013398150787716
STAT,1839,32,40-44,1871,3.5532520616829624
STAT,1859,26,50-100,1885,0.492819252345337
STAT,1873,16,na,1889,2434.1569660374125
STAT,1903,21,15-19,1924,4.4477783870512555
STAT,1888,33,50-100,1921,1.0186239031254016
SIM,1834,30,50-100,1864,1
SIM,1889,43,35-39,1932,7
STAT,1821,43,35-39,1864,3.025538565470359
STAT,1889,26,45-49,1915,1.2993401594905494
STAT,1857,54,na,1911,1560.1256801540558
STAT,1869,47,25-29,1916,0.052469152217473676
STAT,1886,42,na,1928,2303.570603239681
STAT,1892,22,35-39,1914,6.904833618535069
STAT,1889,44,45-49,1933,1.7219034012344616
STAT,1922,32,35-39,1954,9.754195215880173
STAT,1890,43,35-39,1933,2.076320007529573
STAT,1882,49,15-19,1931,3.5981301222233914E-4
SIM,1846,38,35-39,1884,10
STAT,1886,44,20-24,1930,0.15634197628445026
SIM,1897,26,45-49,1923,1
STAT,1901,61,na,1962,2619.1381556345727
SIM,1857,40,50-100,1897,1
SIM,1856,19,15-19,1875,5
SIM,1852,51,na,1903,1660
STAT,1888,36,50-100,1924,1.3773085257352844
SIM,1948,21,40-44,1969,4
SIM,1917,38,40-44,1955,1
STAT,1910,10,na,1920,3708.123113059972
STAT,1864,34,50-100,1898,0.7648480297586163
STAT,1806,70,na,1876,693.8469505831573
STAT,1868,45,20-24,1913,0.010923937718855676
STAT,1862,46,30-34,1908,0.07840914205950988
SIM,1843,37,35-39,1880,16
SIM,1900,19,25-29,1919,12
SIM,1929,27,45-49,1956,2
STAT,1834,29,na,1863,1733.3702881445813
SIM,1805,60,na,1865,983
SIM,1877,17,30-34,1894,2
STAT,1912,22,30-34,1934,26.021971891844228
STAT,1839,47,50-100,1886,0.16660578138589946
STAT,1839,50,40-44,1889,0.007183699656945708
SIM,1855,21,15-19,1876,6
STAT,1838,38,35-39,1876,5.670633490404386
STAT,1869,29,30-34,1898,22.881493396836444
SIM,1892,16,15-19,1908,7
STAT,1841,50,50-100,1891,0.010561640635246719
SIM,1873,44,na,1917,2167
SIM,1919,23,40-44,1942,4
SIM,1878,24,20-24,1902,74
SIM,1947,20,45-49,1967,2
STAT,1848,37,15-19,1885,0.04299956440707515
STAT,1877,39,30-34,1916,5.170074414674265
STAT,1893,44,50-100,1937,0.08670357921436452
STAT,1833,22,50-100,1855,0.33686948283683665
STAT,1825,41,50-100,1866,1.1769835516061251
SIM,1821,35,25-29,1856,2
STAT,1839,44,50-100,1883,0.7225814148154666
STAT,1822,42,40-44,1864,3.2737023203958464
STAT,1823,45,na,1868,1430.2292268621463
STAT,1894,39,30-34,1933,6.405249647075676
SIM,1869,25,25-29,1894,45
STAT,1826,30,40-44,1856,6.859447612945075
SIM,1914,34,45-49,1948,2
STAT,1870,39,45-49,1909,1.8288921743291298
SIM,1841,32,45-49,1873,1
STAT,1849,50,na,1899,1637.7939159023877
STAT,1841,48,15-19,1889,2.734882903146749E-4
SIM,1889,31,35-39,1920,17
SIM,1921,25,na,1946,4001
SIM,1811,60,na,1871,953
STAT,1827,48,30-34,1875,0.08737523122459567
STAT,1906,34,45-49,1940,1.3659009966124778
SIM,1874,6,na,1880,2556
STAT,1795,101,na,1896,0.11884671924590672
SIM,1872,34,50-100,1906,6
STAT,1835,37,35-39,1872,5.5653819058575476
STAT,1860,6,na,1866,2205.446573094279
SIM,1861,59,na,1920,1681
SIM,1878,35,50-100,1913,1
SIM,1860,74,na,1934,860
STAT,1833,44,45-49,1877,1.0845366031708592
SIM,1896,29,35-39,1925,16
STAT,1831,44,40-44,1875,1.61684059152553
STAT,1888,46,na,1934,2518.962272541217
SIM,1820,74,na,1894,536
SIM,1866,44,45-49,1910,1
STAT,1912,40,30-34,1952,0.11780830690803648
SIM,1868,94,na,1962,24
STAT,1868,43,25-29,1911,0.5746220336193104
STAT,1939,6,na,1945,3781.890687821019
STAT,1898,28,15-19,1926,0.5779805444759141
STAT,1916,17,20-24,1933,27.173495290948054
STAT,1797,88,na,1885,47.72646893151849
SIM,1839,40,35-39,1879,6
SIM,1855,28,na,1883,1983
SIM,1885,39,30-34,1924,10
SIM,1905,22,35-39,1927,8
STAT,1833,32,45-49,1865,1.3775468326158193
STAT,1879,39,35-39,1918,6.923828713951797
SIM,1850,34,45-49,1884,1
STAT,1859,37,20-24,1896,0.5795939718877198
STAT,1873,33,50-100,1906,0.8741635198776451
STAT,1841,18,20-24,1859,15.670659805272368
STAT,1893,21,40-44,1914,2.5039976512181563
SIM,1830,67,na,1897,923
STAT,1832,46,15-19,1878,2.895144339860784E-4
STAT,1862,24,15-19,1886,2.688775472919243
SIM,1873,7,na,1880,2590
SIM,1858,76,na,1934,705
STAT,1866,31,na,1897,2087.7407979647664
SIM,1829,38,35-39,1867,16
STAT,1831,30,15-19,1861,0.11658743309449152
STAT,1931,38,15-19,1969,0.02400109174034791
SIM,1912,34,40-44,1946,3
SIM,1895,31,na,1926,3017
STAT,1900,11,na,1911,3389.440015065271
STAT,1915,49,20-24,1964,0.010458464740726207
STAT,1852,37,35-39,1889,5.155594420538752
STAT,1824,44,50-100,1868,1.3188226772350726
STAT,1866,36,20-24,1902,0.6748897913876631
STAT,1805,54,40-44,1859,0.03712542144282491
STAT,1839,69,na,1908,977.0878046572462
SIM,1874,36,20-24,1910,1
SIM,1837,77,na,1914,505
SIM,1860,37,35-39,1897,7
SIM,1870,24,15-19,1894,3
STAT,1808,77,na,1885,366.0368405885386
STAT,1813,52,na,1865,1174.7963018816056
STAT,1878,54,40-44,1932,0.010079665720853951
STAT,1927,36,35-39,1963,2.8434477386901142
SIM,1915,25,na,1940,3479
STAT,1851,21,35-39,1872,5.049139095611168
SIM,1841,26,45-49,1867,4
SIM,1834,30,40-44,1864,1
STAT,1918,15,50-100,1933,0.07764982293292738
STAT,1880,26,25-29,1906,42.274036945653215
STAT,1904,46,40-44,1950,0.13123076287184726
SIM,1867,13,na,1880,2560
SIM,1815,42,45-49,1857,2
SIM,1887,39,35-39,1926,10
STAT,1856,29,20-24,1885,8.83205630900206
SIM,1940,24,45-49,1964,1
STAT,1872,45,40-44,1917,0.16384254214333974
STAT,1911,48,45-49,1959,0.1938421921245486
STAT,1852,20,40-44,1872,1.8207316914518221
STAT,1897,23,na,1920,2978.7279403577413
STAT,1874,33,45-49,1907,1.67607497755609
SIM,1935,36,35-39,1971,4
SIM,1842,52,na,1894,1429
SIM,1874,94,na,1968,70
STAT,1822,54,40-44,1876,0.013091909471820547
STAT,1845,43,20-24,1888,0.11298251785716262
SIM,1850,16,15-19,1866,6
STAT,1889,38,15-19,1927,0.06516569773968038
SIM,1837,23,20-24,1860,59
STAT,1883,17,45-49,1900,0.060502577283525864
STAT,1879,6,na,1885,2660.6462781913665
SIM,1848,42,35-39,1890,2
SIM,1869,19,25-29,1888,4
STAT,1930,42,40-44,1972,0.3108929953459578
SIM,1904,10,na,1914,3570
SIM,1882,27,45-49,1909,1
STAT,1813,53,25-29,1866,0.009076749462433352
STAT,1888,22,15-19,1910,3.683189490657469
SIM,1830,100,na,1930,1
STAT,1946,18,45-49,1964,0.5232578444341573
SIM,1824,67,na,1891,809
SIM,1840,17,35-39,1857,1
SIM,1921,27,50-100,1948,1
STAT,1852,39,30-34,1891,3.824982517749121
SIM,1841,44,45-49,1885,3
STAT,1874,30,50-100,1904,0.8914904349842556
SIM,1882,33,45-49,1915,1
SIM,1937,19,20-24,1956,118
STAT,1880,44,25-29,1924,0.6309138984343685
STAT,1852,104,na,1956,0.05925963730814982
STAT,1930,36,40-44,1966,1.8462725327398797
STAT,1904,34,40-44,1938,3.345394611598761
SIM,1877,46,na,1923,2182
STAT,1842,16,15-19,1858,5.5515055407074945
SIM,1808,49,na,1857,1288
STAT,1833,25,50-100,1858,0.5248715066953239
STAT,1923,17,na,1940,4083.0066956175106
STAT,1951,19,30-34,1970,13.702647482617573
STAT,1865,22,40-44,1887,1.805984649153916
SIM,1824,44,45-49,1868,3
SIM,1860,39,30-34,1899,6
SIM,1849,28,na,1877,1944
SIM,1823,45,50-100,1868,4
SIM,1838,20,30-34,1858,15
STAT,1899,49,na,1948,2851.9255796204507
SIM,1830,42,40-44,1872,7
STAT,1853,54,50-100,1907,0.011115393079070841
STAT,1906,16,45-49,1922,0.0900982238995736
SIM,1860,20,40-44,1880,4
STAT,1864,53,35-39,1917,0.007132201105671839
STAT,1887,42,15-19,1929,0.014574664195969575
STAT,1883,35,45-49,1918,1.8639294630564438
SIM,1943,28,40-44,1971,5
STAT,1861,27,35-39,1888,7.634173090394898
SIM,1915,4,na,1919,3807
SIM,1807,64,na,1871,836
STAT,1801,67,na,1868,719.5124702741026
STAT,1879,34,50-100,1913,0.8982934233887087
STAT,1886,82,na,1968,799.5928900684016
STAT,1902,18,na,1920,3358.395379018501
STAT,1915,24,45-49,1939,1.0918967113797908
STAT,1929,19,20-24,1948,162.57081368610747
SIM,1848,30,35-39,1878,10
STAT,1846,70,na,1916,1040.6654795753093
SIM,1883,46,na,1929,2063
SIM,1924,17,20-24,1941,161
STAT,1874,27,45-49,1901,1.0716905566553554
STAT,1921,2,na,1923,4404.043680798434
STAT,1898,31,35-39,1929,12.999547909549479
SIM,1875,79,na,1954,598
STAT,1917,19,25-29,1936,43.67501311414626
STAT,1937,16,45-49,1953,0.4602233353834511
STAT,1858,44,15-19,1902,0.010090616899286252
SIM,1809,59,na,1868,1033
STAT,1845,69,na,1914,1038.4760241330073
SIM,1762,104,na,1866,1
SIM,1892,45,50-100,1937,1
STAT,1816,44,45-49,1860,3.6929390519338603
SIM,1923,24,45-49,1947,2
STAT,1890,18,35-39,1908,0.6320799041143855
SIM,1890,25,na,1915,2991
SIM,1891,35,45-49,1926,2
STAT,1921,34,40-44,1955,4.0788417323646415
SIM,1962,7,na,1969,4633
STAT,1868,49,30-34,1917,0.0854282050736582
STAT,1766,96,na,1862,1.2410703603300077
STAT,1844,44,na,1888,1602.4137227737172
SIM,1868,69,na,1937,1294
SIM,1871,43,40-44,1914,3
SIM,1838,41,35-39,1879,4
STAT,1859,80,na,1939,465.11668743297935
SIM,1887,20,15-19,1907,3
SIM,1908,32,25-29,1940,10
STAT,1873,47,15-19,1920,3.814587557985302E-4
SIM,1863,35,50-100,1898,4
SIM,1897,30,50-100,1927,1
SIM,1825,43,45-49,1868,1
STAT,1816,63,na,1879,980.9271018863578
STAT,1889,30,50-100,1919,1.0771651967256997
SIM,1936,27,na,1963,2796
STAT,1897,32,35-39,1929,12.794356767798053
STAT,1884,34,45-49,1918,1.6136109835375143
STAT,1930,39,15-19,1969,0.023612038783135277
SIM,1875,31,40-44,1906,3
SIM,1939,31,40-44,1970,6
STAT,1857,19,50-100,1876,0.04239845606477915
STAT,1867,46,15-19,1913,3.558383542383953E-4
STAT,1828,29,45-49,1857,1.3596959672839295
STAT,1840,52,35-39,1892,0.005619684433380739
STAT,1940,28,15-19,1968,0.6797378451263842
STAT,1934,23,na,1957,4634.625450541789
STAT,1839,53,45-49,1892,0.009507200509544103
STAT,1879,16,40-44,1895,0.1813121464232511
STAT,1882,24,na,1906,2159.204343749907
SIM,1836,29,45-49,1865,4
STAT,1843,15,15-19,1858,5.183433364179001
STAT,1889,41,40-44,1930,2.635098377067805
SIM,1860,41,45-49,1901,5
SIM,1813,64,na,1877,885
STAT,1922,48,20-24,1970,0.011960164335984735
SIM,1787,70,na,1857,565
STAT,1819,51,30-34,1870,0.0110440471426158
STAT,1873,72,na,1945,1209.997883977535
SIM,1850,59,na,1909,1443
STAT,1825,35,20-24,1860,1.0514847046223046
SIM,1809,102,na,1911,1
STAT,1926,26,40-44,1952,5.296451372288893
STAT,1860,77,na,1937,662.5649436174842
SIM,1821,90,na,1911,39
STAT,1877,35,15-19,1912,0.05555040655970062
SIM,1879,24,35-39,1903,7
SIM,1894,46,na,1940,2855
SIM,1910,23,20-24,1933,95
STAT,1862,40,25-29,1902,0.5239158281095834
STAT,1866,32,35-39,1898,8.823928513849749
STAT,1902,36,35-39,1938,2.045144632075389
STAT,1949,22,na,1971,4025.66438821649
STAT,1863,43,40-44,1906,1.8512184725748637
SIM,1948,12,na,1960,4236
STAT,1902,47,50-100,1949,0.1838432529936634
STAT,1904,10,na,1914,3510.0378282267434
STAT,1892,26,20-24,1918,13.928880185616269
STAT,1792,88,na,1880,45.836202396899424
STAT,1907,21,na,1928,3291.9521786163336
STAT,1913,42,35-39,1955,0.18551602533378506
STAT,1836,54,35-39,1890,0.00542179036136908
STAT,1902,23,20-24,1925,91.59240545601155
STAT,1902,18,35-39,1920,0.7296396016538674
SIM,1847,35,45-49,1882,6
SIM,1897,41,40-44,1938,1
STAT,1869,44,20-24,1913,0.14338213995768406
STAT,1817,43,45-49,1860,3.6543958748700804
STAT,1920,21,15-19,1941,5.607430276691097
STAT,1854,54,25-29,1908,0.002464566772509795
STAT,1890,40,30-34,1930,1.3412257686659486
STAT,1861,32,20-24,1893,2.1232178906357957
STAT,1833,44,na,1877,1523.2565541978959
STAT,1847,95,na,1942,9.804226258484091
STAT,1894,33,25-29,1927,12.382552479920788
SIM,1907,39,30-34,1946,4
SIM,1862,44,na,1906,1932
SIM,1883,22,35-39,1905,7
STAT,1892,79,na,1971,1274.241885083396
STAT,1920,35,40-44,1955,1.5510496187220386
SIM,1892,34,45-49,1926,6
SIM,1912,30,25-29,1942,11
STAT,1853,54,40-44,1907,0.007748189318105365
STAT,1827,42,25-29,1869,0.6160124642268341
STAT,1900,38,20-24,1938,0.21696149862857858
STAT,1828,29,na,1857,1602.0201760436132
SIM,1897,7,na,1904,3385
STAT,1840,29,na,1869,1744.7847120767058
STAT,1950,19,na,1969,4108.805085238123
STAT,1895,34,20-24,1929,3.3005813473575576
STAT,1851,25,20-24,1876,10.024254049274479
STAT,1845,41,30-34,1886,0.8391232658105419
STAT,1903,20,30-34,1923,24.08527458163272
SIM,1910,36,35-39,1946,6
STAT,1889,23,40-44,1912,2.4227427126553502
STAT,1921,13,na,1934,4260.053552370425
SIM,1887,34,40-44,1921,6
STAT,1885,45,20-24,1930,0.011412376666840718
STAT,1912,25,35-39,1937,14.07230435053705
SIM,1933,29,30-34,1962,60
STAT,1830,51,35-39,1881,0.005787112027978197
SIM,1864,31,35-39,1895,12
STAT,1892,47,50-100,1939,0.16316190926951266
STAT,1868,57,na,1925,1811.3650544723305
STAT,1834,85,na,1919,169.95510001773604
SIM,1919,26,45-49,1945,1
SIM,1916,35,na,1951,3574
STAT,1858,44,45-49,1902,1.0935705296828566
SIM,1928,25,40-44,1953,7
SIM,1930,39,na,1969,4642
STAT,1886,47,25-29,1933,0.05721166495402038
SIM,1856,40,40-44,1896,4
STAT,1828,43,20-24,1871,0.13241943813645826
STAT,1832,59,na,1891,1170.7455499757398
SIM,1877,43,na,1920,2223
SIM,1888,36,45-49,1924,1
SIM,1849,62,na,1911,1384
SIM,1920,25,35-39,1945,16
SIM,1813,67,na,1880,787
STAT,1855,3,na,1858,2388.0207080479136
STAT,1871,52,35-39,1923,0.008032927684139608
STAT,1882,21,na,1903,2179.366382823444
STAT,1925,29,30-34,1954,43.4060102994477
STAT,1893,36,15-19,1929,0.06759851491234788
STAT,1914,38,15-19,1952,0.018023600490578197
STAT,1867,15,50-100,1882,0.04495680172704741
STAT,1817,100,na,1917,0.4913738475821063
SIM,1897,23,40-44,1920,2
STAT,1778,81,na,1859,178.36511701212476
SIM,1873,31,50-100,1904,3
SIM,1842,21,35-39,1863,6
STAT,1858,41,40-44,1899,1.673535185487502
STAT,1836,34,15-19,1870,0.11417051900225109
STAT,1855,28,na,1883,1755.0289073821116
SIM,1921,50,na,1971,3901
SIM,1865,42,40-44,1907,10
STAT,1826,49,30-34,1875,0.08698310439083104
STAT,1850,47,na,1897,1578.5715209368032
STAT,1932,17,50-100,1949,0.468658579207584
STAT,1871,34,35-39,1905,9.418585578021368
STAT,1939,23,na,1962,3463.488676701697
STAT,1887,24,na,1911,2483.46486724314
STAT,1826,45,15-19,1871,3.7947052163327875E-4
SIM,1889,29,20-24,1918,13
STAT,1904,49,15-19,1953,2.993618705998769E-4
SIM,1853,92,na,1945,24
STAT,1847,21,15-19,1868,3.00385033313332
STAT,1884,16,15-19,1900,5.5524426635130295
STAT,1807,52,na,1859,1222.4599169662717
STAT,1879,34,40-44,1913,4.251746595292987
SIM,1801,79,na,1880,276
SIM,1906,18,15-19,1924,8
STAT,1854,19,45-49,1873,0.05525226261588468
SIM,1854,18,na,1872,2188
STAT,1856,31,35-39,1887,7.634691440353772
SIM,1848,77,na,1925,612
STAT,1841,70,na,1911,967.2960873366243
SIM,1847,44,50-100,1891,1
STAT,1929,21,35-39,1950,11.282216818049651
STAT,1930,20,25-29,1950,112.4517133121391
STAT,1909,24,15-19,1933,4.64473308391365
STAT,1876,25,20-24,1901,11.527632999267711
SIM,1893,27,20-24,1920,16
SIM,1907,20,40-44,1927,2
SIM,1828,26,na,1854,1740
STAT,1917,47,35-39,1964,0.1272215147841163
STAT,1943,1,na,1944,4147.474166916969
STAT,1866,39,25-29,1905,2.4834568735148914
SIM,1873,25,45-49,1898,2
SIM,1928,20,na,1948,4347
SIM,1889,41,50-100,1930,1
SIM,1865,80,na,1945,504
SIM,1938,32,40-44,1970,6
STAT,1812,53,40-44,1865,0.03301060163209374
STAT,1893,64,na,1957,2130.301511140946
SIM,1961,5,na,1966,4755
SIM,1869,22,20-24,1891,66
STAT,1920,17,40-44,1937,1.482472471080364
SIM,1912,7,na,1919,3795
STAT,1927,33,30-34,1960,18.297140211182036
SIM,1937,21,35-39,1958,10
STAT,1944,19,na,1963,3739.4711582252316
STAT,1764,114,na,1878,1.916940089816396E-4
STAT,1935,32,15-19,1967,0.16795167932794336
SIM,1846,11,na,1857,2148
SIM,1956,2,na,1958,4794
STAT,1865,25,45-49,1890,0.9571649756752336
STAT,1927,38,na,1965,4414.304844659076
SIM,1895,15,25-29,1910,8
STAT,1880,23,20-24,1903,68.42028110507499
STAT,1893,24,na,1917,2815.656101839699
STAT,1904,49,45-49,1953,0.17662365231506172
STAT,1816,41,40-44,1857,6.3584262471082456
STAT,1894,49,na,1943,2674.885304123674
SIM,1874,39,25-29,1913,5
SIM,1882,21,na,1903,2247
STAT,1848,37,45-49,1885,1.5264843549148468
STAT,1879,20,15-19,1899,3.281781269536014
SIM,1819,89,na,1908,49
STAT,1840,85,na,1925,179.90281884799964
STAT,1883,32,40-44,1915,4.0167247934040455
SIM,1798,70,na,1868,617
SIM,1846,33,40-44,1879,4
STAT,1870,37,25-29,1907,2.6683284774427865
STAT,1868,49,50-100,1917,0.21674759413110378
SIM,1878,27,25-29,1905,38
STAT,1818,54,20-24,1872,0.0014513361787756693
STAT,1810,78,na,1888,316.3118238052669
STAT,1899,45,45-49,1944,0.17403352793367777
SIM,1876,49,50-100,1925,3
STAT,1855,49,20-24,1904,0.008349472341344418
STAT,1944,21,30-34,1965,29.325506976607215
STAT,1938,23,35-39,1961,8.800791004504356
SIM,1859,58,na,1917,1570
SIM,1937,0,na,1937,3731
STAT,1885,27,20-24,1912,11.046845682049934
STAT,1966,5,na,1971,4638.269287918696
SIM,1896,26,30-34,1922,38
STAT,1916,35,na,1951,3674.1963291466523
SIM,1884,25,20-24,1909,10
STAT,1900,51,na,1951,2835.314518563192
SIM,1799,95,na,1894,4
STAT,1937,29,50-100,1966,0.9156943085832306
SIM,1819,52,na,1871,1272
STAT,1921,37,45-49,1958,0.7190933305683069
SIM,1824,41,40-44,1865,6
SIM,1845,18,30-34,1863,1
SIM,1891,32,40-44,1923,8
STAT,1830,30,30-34,1860,15.476074111596446
SIM,1894,29,50-100,1923,4
STAT,1926,22,25-29,1948,106.00860124030743
SIM,1948,18,15-19,1966,41
SIM,1934,22,25-29,1956,123
STAT,1823,34,50-100,1857,1.8251554716460832
SIM,1925,34,20-24,1959,2
STAT,1858,98,na,1956,2.8192465461821827
STAT,1911,54,na,1965,3200.007346477858
STAT,1915,34,50-100,1949,0.7886915379968527
STAT,1835,70,na,1905,893.0230309338065
STAT,1911,15,40-44,1926,0.265654453347602
STAT,1821,41,15-19,1862,0.024479113544060606
SIM,1923,34,50-100,1957,4
SIM,1946,23,35-39,1969,14
SIM,1879,42,35-39,1921,1
STAT,1809,47,35-39,1856,0.3951371082913873
STAT,1874,30,40-44,1904,4.219547113438454
STAT,1856,69,na,1925,1081.693648495838
SIM,1828,66,na,1894,949
STAT,1888,26,30-34,1914,28.21076786411224
STAT,1839,35,45-49,1874,1.619375718080029
SIM,1783,71,na,1854,493
STAT,1843,33,15-19,1876,0.11444286526489321
STAT,1886,29,50-100,1915,0.6337932335985439
STAT,1837,18,30-34,1855,1.5539383761827867
STAT,1910,18,30-34,1928,2.2756900968471
STAT,1878,50,25-29,1928,0.003537296962706381
STAT,1841,20,35-39,1861,5.170382893182479
SIM,1771,86,na,1857,53
SIM,1926,31,30-34,1957,24
SIM,1837,26,25-29,1863,42
STAT,1798,73,na,1871,508.50451214317445
STAT,1785,107,na,1892,0.003485818308158229
STAT,1880,41,20-24,1921,0.15888310509040868
STAT,1946,15,40-44,1961,1.4663683825128637
STAT,1822,39,15-19,1861,0.08865729789766247
SIM,1820,35,40-44,1855,7
SIM,1843,24,20-24,1867,60
STAT,1905,17,45-49,1922,0.08919751432189495
SIM,1792,85,na,1877,76
STAT,1853,32,25-29,1885,7.982504736295477
STAT,1904,30,25-29,1934,13.9908703798302
STAT,1814,48,20-24,1862,0.03609662642582802
STAT,1896,17,25-29,1913,7.07029457858401
STAT,1933,38,na,1971,4836.074919063949
SIM,1856,37,45-49,1893,1
SIM,1833,38,25-29,1871,5
SIM,1851,33,45-49,1884,1
STAT,1818,36,20-24,1854,2.693874447747837
STAT,1947,17,45-49,1964,0.5316098406482526
SIM,1838,23,35-39,1861,7
STAT,1864,36,na,1900,1993.2137906653356
STAT,1845,46,25-29,1891,0.04087514440752787
STAT,1899,27,15-19,1926,0.5872737862626136
SIM,1850,31,40-44,1881,4
SIM,1859,80,na,1939,454
STAT,1869,46,50-100,1915,0.22540869375708378
STAT,1830,44,50-100,1874,0.7992346433654024
SIM,1883,40,35-39,1923,1
STAT,1882,2,na,1884,2912.6289629409885
STAT,1838,33,40-44,1871,3.5804999223735314
SIM,1844,59,na,1903,1288
SIM,1851,15,15-19,1866,5
SIM,1829,35,30-34,1864,12
STAT,1862,32,na,1894,1927.4676650968322
STAT,1875,40,35-39,1915,1.7760689014171027
STAT,1888,49,na,1937,2459.842875166033
STAT,1852,35,15-19,1887,0.041791132473600466
SIM,1923,21,40-44,1944,4
STAT,1858,16,50-100,1874,0.04263962499707123
STAT,1804,78,na,1882,319.7294080285943
STAT,1843,33,45-49,1876,1.4013852117720884
STAT,1918,31,30-34,1949,15.880890911503508
SIM,1935,33,30-34,1968,27
STAT,1853,95,na,1948,10.06201194890735
SIM,1917,24,15-19,1941,5
STAT,1835,24,20-24,1859,57.46795370431171
STAT,1829,26,25-29,1855,75.35430925751938
STAT,1886,42,30-34,1928,1.1458534028254412
STAT,1874,94,na,1968,76.82538241273313
STAT,1813,50,20-24,1863,0.0020080684460601662
STAT,1844,49,45-49,1893,0.1604853245162371
STAT,1864,50,30-34,1914,0.005083901512028522
SIM,1846,51,na,1897,1541
STAT,1887,15,25-29,1902,6.015763833276888
STAT,1844,44,20-24,1888,0.11010721859877552
STAT,1881,39,20-24,1920,0.6964014749618489
STAT,1951,15,15-19,1966,51.08116843938815
SIM,1877,46,50-100,1923,3
STAT,1835,42,20-24,1877,0.12111304795888782
SIM,1859,18,25-29,1877,5
SIM,1860,17,15-19,1877,5
STAT,1870,36,na,1906,2193.937389872657
STAT,1843,51,45-49,1894,0.009849262733849494
STAT,1881,39,na,1920,2128.440479536191
SIM,1786,85,na,1871,88
SIM,1861,32,25-29,1893,11
STAT,1823,106,na,1929,0.006498003514683692
SIM,1825,52,na,1877,1327
SIM,1834,26,na,1860,1746
SIM,1902,27,40-44,1929,5
SIM,1954,15,40-44,1969,1
STAT,1909,42,15-19,1951,0.0013569955802085426
STAT,1899,45,15-19,1944,2.949718329705207E-4
SIM,1865,58,na,1923,1733
STAT,1791,63,na,1854,807.0000000000001
STAT,1819,77,na,1896,456.3082317316113
STAT,1840,40,50-100,1880,0.8153720216175914
SIM,1836,26,40-44,1862,5
STAT,1858,64,na,1922,1287.5698711453372
STAT,1900,36,30-34,1936,1.5147848622395326
STAT,1939,26,20-24,1965,17.34372803832483
SIM,1930,29,45-49,1959,2
STAT,1865,43,45-49,1908,1.2722649363778629
STAT,1907,39,20-24,1946,0.22856764305744967
STAT,1886,17,30-34,1903,1.5905388794346507
STAT,1882,40,40-44,1922,2.08729543983651
SIM,1919,31,25-29,1950,9
SIM,1881,11,na,1892,2004
SIM,1857,32,35-39,1889,8
SIM,1899,39,25-29,1938,1
STAT,1854,74,na,1928,794.0371035543798
STAT,1895,17,40-44,1912,0.2252631686659768
STAT,1954,16,45-49,1970,0.5835130057495589
STAT,1809,50,50-100,1859,0.04226191862493301
SIM,1924,39,30-34,1963,3
STAT,1916,39,30-34,1955,1.7454475360304493
STAT,1863,46,45-49,1909,0.19620356222801122
STAT,1892,44,15-19,1936,0.0011194002687653288
SIM,1909,28,40-44,1937,4
STAT,1871,54,25-29,1925,0.003231293101643201
STAT,1963,8,na,1971,4715.632659689737
SIM,1861,96,na,1957,14
STAT,1937,29,20-24,1966,16.79310770564127
SIM,1953,16,35-39,1969,5
STAT,1807,106,na,1913,0.004516079672646178
STAT,1873,40,30-34,1913,1.1126284424954462
STAT,1840,27,35-39,1867,7.8953080233781145
SIM,1852,4,na,1856,2339
STAT,1945,16,35-39,1961,4.331468174315033
SIM,1873,16,na,1889,2448
STAT,1952,19,45-49,1971,0.5651402994547371
SIM,1904,19,na,1923,3474
SIM,1804,50,na,1854,1188
STAT,1890,13,na,1903,2978.086560252823
STAT,1840,34,40-44,1874,3.395166200260658
SIM,1873,43,45-49,1916,2
SIM,1890,40,40-44,1930,4
STAT,1870,17,35-39,1887,0.5133665780752714
STAT,1847,27,na,1874,1917.362566557794
SIM,1826,99,na,1925,1
STAT,1923,16,15-19,1939,50.466619217118996
SIM,1841,46,50-100,1887,1
STAT,1823,37,45-49,1860,3.24389605313993
SIM,1945,26,50-100,1971,1
STAT,1849,32,35-39,1881,8.002141737518029
STAT,1887,20,50-100,1907,0.43347675135175057
STAT,1891,60,na,1951,2229.0758170502913
SIM,1823,57,na,1880,1109
STAT,1892,14,na,1906,3045.8620893558677
STAT,1846,79,na,1925,518.5290264166745
SIM,1869,32,30-34,1901,16
STAT,1881,76,na,1957,931.6937329497663
STAT,1922,29,45-49,1951,1.833580972116207
STAT,1817,109,na,1926,3.2929341610946577E-4
STAT,1834,37,20-24,1871,0.5950501780836058
STAT,1943,19,35-39,1962,4.20078477134836
SIM,1951,19,35-39,1970,3
STAT,1889,56,na,1945,2378.7330905946756
STAT,1926,42,15-19,1968,0.0017884282233690864
STAT,1824,30,na,1854,1572.987642879019
SIM,1875,8,na,1883,2601
STAT,1831,34,30-34,1865,13.578814943531658
STAT,1844,27,35-39,1871,8.20365633627552
STAT,1924,36,50-100,1960,0.46811807925292287
SIM,1890,35,50-100,1925,2
STAT,1857,49,25-29,1906,0.042019469605807123
SIM,1912,14,na,1926,3751
STAT,1858,32,45-49,1890,1.2916167912550727
STAT,1940,4,na,1944,3855.582527988853
SIM,1852,27,35-39,1879,9
STAT,1854,46,35-39,1900,0.10045229868547956
SIM,1866,32,45-49,1898,2
SIM,1808,74,na,1882,452
SIM,1931,16,15-19,1947,48
STAT,1846,39,50-100,1885,0.9313995843686186
STAT,1896,20,15-19,1916,4.140703508801652
SIM,1831,37,45-49,1868,1
STAT,1809,52,20-24,1861,0.0019834831334716884
STAT,1874,46,20-24,1920,0.011615566645377752
STAT,1924,45,15-19,1969,4.1623653034191004E-4
STAT,1942,12,na,1954,3883.4284739416694
STAT,1846,24,35-39,1870,5.263985346769729
SIM,1887,30,25-29,1917,15
STAT,1786,85,na,1871,79.1792750774986
STAT,1827,32,15-19,1859,0.1708633452204177
SIM,1909,56,na,1965,3130
SIM,1884,53,na,1937,2083
SIM,1959,8,na,1967,4879
STAT,1869,22,50-100,1891,0.37320547994365005
SIM,1889,28,45-49,1917,1
STAT,1897,51,na,1948,2733.3645106368213
STAT,1919,26,35-39,1945,15.377445267434435
STAT,1936,23,30-34,1959,25.949038081946906
STAT,1851,43,15-19,1894,0.009862242672582415
SIM,1851,66,na,1917,1218
STAT,1918,18,30-34,1936,12.500360198944813
SIM,1839,32,na,1871,1797
SIM,1871,80,na,1951,506
STAT,1899,33,45-49,1932,2.247682711550257
STAT,1875,43,50-100,1918,1.0184199145087338
SIM,1925,29,35-39,1954,20
STAT,1866,93,na,1959,42.15593007165598
STAT,1880,51,50-100,1931,0.01511332190246396
STAT,1863,21,30-34,1884,15.16989478439456
STAT,1780,94,na,1874,3.3646185503369255
STAT,1894,23,15-19,1917,3.9928023541045174
STAT,1917,29,35-39,1946,14.768048096821023
STAT,1826,30,50-100,1856,1.4492389282111793
SIM,1896,33,50-100,1929,1
SIM,1823,42,35-39,1865,2
STAT,1823,82,na,1905,249.70612038121303
STAT,1890,28,45-49,1918,1.277848237606773
STAT,1929,20,20-24,1949,133.62575414924746
STAT,1811,54,50-100,1865,0.04619244393118774
STAT,1896,39,35-39,1935,8.735963641554697
SIM,1871,21,30-34,1892,22
STAT,1876,43,20-24,1919,0.1538825793408948
STAT,1880,36,35-39,1916,7.078073034768152
SIM,1926,18,30-34,1944,13
SIM,1854,24,35-39,1878,3
SIM,1922,41,40-44,1963,1
STAT,1856,50,40-44,1906,0.007871206822207363
STAT,1813,45,35-39,1858,0.39552188547893913
STAT,1898,25,40-44,1923,3.8555688046093053
STAT,1879,32,na,1911,2359.7590339180347
STAT,1879,30,25-29,1909,10.210052290375867
SIM,1894,17,30-34,1911,4
SIM,1875,17,na,1892,2455
SIM,1907,23,45-49,1930,3
STAT,1861,17,25-29,1878,5.11607335902988
STAT,1879,49,45-49,1928,0.22850140142641323
STAT,1896,46,40-44,1942,0.12083239652628262
STAT,1860,27,20-24,1887,9.088620257694489
STAT,1878,22,20-24,1900,67.84576984087684
STAT,1905,20,35-39,1925,8.015858829761568
STAT,1877,33,25-29,1910,9.99472640290104
STAT,1883,31,na,1914,2219.265606194998
STAT,1875,22,35-39,1897,5.666336768041647
SIM,1830,29,40-44,1859,2
SIM,1886,22,20-24,1908,63
STAT,1903,23,35-39,1926,7.819536409767859
STAT,1818,37,35-39,1855,22.465669696661376
SIM,1890,33,35-39,1923,15
SIM,1885,33,25-29,1918,15
STAT,1902,33,30-34,1935,23.179611604456813
SIM,1910,33,30-34,1943,14
STAT,1781,101,na,1882,0.13229285980808603
STAT,1878,19,na,1897,2473.1766124015794
STAT,1772,99,na,1871,0.30000073929652177
STAT,1815,42,35-39,1857,4.583505368886735
STAT,1815,87,na,1902,78.63992726850856
SIM,1928,23,na,1951,4281
STAT,1900,29,25-29,1929,55.03998819275963
SIM,1825,29,30-34,1854,27
SIM,1909,20,45-49,1929,4
STAT,1925,37,15-19,1962,0.021772958203151907
SIM,1917,51,na,1968,3548
STAT,1919,33,40-44,1952,3.971694573951218
STAT,1895,15,15-19,1910,7.342943623864403
STAT,1873,41,na,1914,2224.4520425087057
STAT,1882,33,35-39,1915,9.264628710709243
STAT,1874,39,15-19,1913,0.05365618116984981
SIM,1839,34,40-44,1873,4
SIM,1911,23,35-39,1934,7
STAT,1867,47,na,1914,1986.4799289244554
STAT,1910,28,40-44,1938,4.2371707677262185
SIM,1845,66,na,1911,1127
STAT,1821,87,na,1908,93.86315001100051
STAT,1834,21,35-39,1855,4.878440454441516
STAT,1866,99,na,1965,6.742233088068598
STAT,1815,48,50-100,1863,0.5446316546231879
STAT,1855,51,35-39,1906,0.006147098612007326
SIM,1924,39,na,1963,4172
SIM,1826,34,30-34,1860,20
STAT,1838,48,45-49,1886,0.16092995716719763
STAT,1853,22,15-19,1875,2.949942712476816
SIM,1802,89,na,1891,31
STAT,1885,25,30-34,1910,23.873246514417044
STAT,1826,54,50-100,1880,0.01292668468488759
STAT,1845,91,na,1936,41.005546377271074
STAT,1914,34,35-39,1948,8.615771731271542
STAT,1895,28,50-100,1923,0.7850711016221964
STAT,1872,35,30-34,1907,5.098148931541904
STAT,1929,37,15-19,1966,0.023289554591157956
SIM,1872,35,40-44,1907,4
SIM,1909,22,na,1931,3353
SIM,1822,44,40-44,1866,6
STAT,1876,28,25-29,1904,41.14106167468728
SIM,1930,33,na,1963,4605
STAT,1872,93,na,1965,83.1236028694285
STAT,1887,61,na,1948,1974.5578693940215
STAT,1829,48,35-39,1877,0.11294055168524356
STAT,1891,39,15-19,1930,0.0649718372635837
SIM,1861,22,15-19,1883,6
SIM,1840,29,na,1869,1760
STAT,1904,28,50-100,1932,0.8637680610544708
SIM,1903,31,na,1934,3224
STAT,1890,19,na,1909,2901.345534452367
STAT,1917,44,30-34,1961,0.12562127515172106
SIM,1922,34,35-39,1956,9
SIM,1813,44,30-34,1857,1
SIM,1913,20,35-39,1933,8
STAT,1850,32,45-49,1882,1.2859302544313291
STAT,1859,38,35-39,1897,5.291685021282132
STAT,1824,48,15-19,1872,4.807501475160578E-4
SIM,1848,49,na,1897,1569
SIM,1853,61,na,1914,1423
SIM,1946,20,30-34,1966,35
STAT,1917,17,na,1934,3926.410402566947
SIM,1828,34,35-39,1862,12
SIM,1936,24,na,1960,2735
STAT,1850,45,20-24,1895,0.00854341434051905
STAT,1924,15,20-24,1939,153.2238220038809
STAT,1945,21,15-19,1966,5.51328663678469
SIM,1859,86,na,1945,149
STAT,1854,16,40-44,1870,0.15747255602659083
SIM,1877,27,40-44,1904,2
STAT,1867,103,na,1970,1.2092370762779745
SIM,1927,26,35-39,1953,18
SIM,1817,37,25-29,1854,2
STAT,1833,100,na,1933,0.6513469512215533
STAT,1928,21,15-19,1949,6.29748454251073
SIM,1936,26,45-49,1962,2
STAT,1953,17,50-100,1970,0.42813826588620874
SIM,1836,31,20-24,1867,1
SIM,1898,33,35-39,1931,16
STAT,1887,25,35-39,1912,10.265043325517658
STAT,1920,31,25-29,1951,9.602948322213779
STAT,1906,47,20-24,1953,0.009270072352034356
SIM,1935,23,20-24,1958,137
STAT,1841,42,45-49,1883,1.0721709770591978
STAT,1918,20,45-49,1938,1.1532655315653093
SIM,1853,95,na,1948,2
STAT,1908,47,25-29,1955,0.04532063428281668
STAT,1927,23,20-24,1950,129.0187166619887
SIM,1822,37,35-39,1859,10
STAT,1942,29,30-34,1971,38.811790980946675
SIM,1893,25,30-34,1918,34
STAT,1937,21,25-29,1958,85.00336371056511
SIM,1897,26,na,1923,3091
STAT,1919,28,50-100,1947,1.012411433966152
STAT,1895,22,20-24,1917,84.87253783921477
SIM,1895,25,35-39,1920,12
STAT,1830,53,25-29,1883,0.0022884853616743986
STAT,1877,31,na,1908,2347.985185973964
SIM,1834,29,na,1863,1727
SIM,1904,36,40-44,1940,1
STAT,1871,26,50-100,1897,0.6021370186999905
SIM,1945,21,25-29,1966,100
STAT,1836,55,na,1891,1338.9821804171645
SIM,1829,42,na,1871,1461
SIM,1856,46,50-100,1902,2
STAT,1770,114,na,1884,2.2142415553997002E-4
STAT,1828,31,20-24,1859,2.911206224586859
STAT,1860,51,45-49,1911,0.011177129437786796
STAT,1873,47,na,1920,2145.555462273077
STAT,1891,33,45-49,1924,2.029545679716211
STAT,1891,46,20-24,1937,0.00793394189328793
SIM,1932,15,20-24,1947,148
STAT,1881,28,35-39,1909,8.774678843335137
SIM,1891,35,na,1926,2786
STAT,1854,21,20-24,1875,58.35161401331654
SIM,1819,83,na,1902,203
STAT,1857,24,40-44,1881,1.6076978665328376
SIM,1884,25,na,1909,2374
STAT,1797,57,na,1854,1030.9999999999998
STAT,1822,35,na,1857,1481.0243153133351
STAT,1933,29,20-24,1962,22.874306841334047
SIM,1934,26,40-44,1960,7
STAT,1914,44,45-49,1958,0.1552776465913952
SIM,1835,42,na,1877,1564
SIM,1875,11,na,1886,2555
STAT,1859,12,na,1871,2083.550583690896
SIM,1867,52,50-100,1919,1
SIM,1935,18,40-44,1953,3
SIM,1797,63,na,1860,840
STAT,1875,76,na,1951,919.9428494623239
STAT,1884,19,na,1903,2344.5593389907744
STAT,1885,18,25-29,1903,5.3220579871769225
STAT,1835,27,25-29,1862,35.089063870878505
STAT,1934,37,25-29,1971,1.283580116197067
STAT,1837,21,20-24,1858,58.97152594564308
STAT,1938,20,30-34,1958,26.891050188957568
SIM,1901,33,20-24,1934,2
SIM,1921,36,40-44,1957,2
STAT,1833,38,15-19,1871,0.04263087524784741
STAT,1845,19,35-39,1864,0.48499100689000374
SIM,1880,63,na,1943,1765
STAT,1875,38,20-24,1913,0.7447929922184645
SIM,1864,43,35-39,1907,2
SIM,1884,28,25-29,1912,49
SIM,1912,4,na,1916,3833
STAT,1893,61,na,1954,2238.6770945411417
SIM,1843,27,25-29,1870,48
STAT,1913,55,na,1968,3281.27849262539
SIM,1845,21,20-24,1866,60
STAT,1766,106,na,1872,0.010557142400662415
SIM,1952,18,40-44,1970,1
STAT,1839,91,na,1930,38.58155446774866
STAT,1944,18,40-44,1962,1.4215237761265782
STAT,1857,100,na,1957,1.1058963497822185
SIM,1936,21,15-19,1957,3
SIM,1838,48,50-100,1886,1
STAT,1848,40,na,1888,1759.7899425298317
STAT,1918,34,35-39,1952,9.095275183501414
SIM,1817,57,na,1874,1176
SIM,1941,29,20-24,1970,22
SIM,1865,24,40-44,1889,2
STAT,1808,47,20-24,1855,0.04552631908285449
STAT,1857,4,na,1861,2334.1109169529527
STAT,1928,26,45-49,1954,2.0175369229380746
SIM,1851,19,30-34,1870,1
SIM,1831,34,40-44,1865,6
SIM,1846,14,na,1860,2129
STAT,1864,37,50-100,1901,1.0337247631720832
STAT,1852,79,na,1931,506.8417004803069
STAT,1814,44,40-44,1858,7.2439493821614755
SIM,1893,18,25-29,1911,10
STAT,1932,37,20-24,1969,0.3345945336961469
STAT,1828,26,40-44,1854,7.229556538178141
STAT,1833,45,20-24,1878,0.008848310723352844
STAT,1860,37,30-34,1897,4.085172936801231
STAT,1930,27,na,1957,4499.861720428381
STAT,1940,16,15-19,1956,43.54306150471418
SIM,1867,35,30-34,1902,4
SIM,1862,21,20-24,1883,51
STAT,1868,27,20-24,1895,10.574051115150382
STAT,1824,42,45-49,1866,1.9672277384781318
STAT,1898,39,na,1937,3005.1408201184126
SIM,1814,74,na,1888,424
STAT,1859,24,45-49,1883,0.5362052251413082
STAT,1895,56,na,1951,2512.010600381618
STAT,1843,19,30-34,1862,1.3596282664322457
SIM,1926,34,35-39,1960,16
SIM,1925,19,25-29,1944,59
STAT,1850,38,15-19,1888,0.039796123968509865
SIM,1852,14,na,1866,2187
SIM,1861,30,50-100,1891,6
SIM,1931,34,45-49,1965,2
STAT,1919,31,15-19,1950,0.1315091557948269
SIM,1860,49,na,1909,1843
STAT,1923,34,45-49,1957,1.701963157330338
SIM,1910,19,na,1929,3627
STAT,1828,26,na,1854,1527.7240640349798
STAT,1881,35,40-44,1916,4.032877927749256
STAT,1927,18,40-44,1945,1.6386148454534424
STAT,1913,36,40-44,1949,1.4023815627051632
SIM,1832,42,45-49,1874,2
STAT,1842,107,na,1949,0.0034152101962777364
SIM,1918,39,na,1957,3728
STAT,1886,26,50-100,1912,0.6405463496677839
SIM,1831,27,35-39,1858,9
SIM,1915,56,na,1971,3219
STAT,1861,22,na,1883,1908.5032078893043
SIM,1799,58,na,1857,1006
STAT,1909,28,30-34,1937,35.252403943295874
STAT,1874,49,50-100,1923,0.232109258817434
SIM,1852,29,50-100,1881,1
SIM,1869,35,35-39,1904,13
SIM,1853,26,40-44,1879,3
STAT,1844,29,50-100,1873,0.536093561083449
STAT,1917,4,na,1921,4089.7745693855013
SIM,1913,29,45-49,1942,2
STAT,1865,40,40-44,1905,1.9454126526277769
SIM,1934,19,35-39,1953,6
SIM,1821,39,40-44,1860,8
SIM,1858,70,na,1928,1104
SIM,1914,16,15-19,1930,7
STAT,1918,28,40-44,1946,4.669598078422474
SIM,1945,15,30-34,1960,13
STAT,1844,24,30-34,1868,15.225056125058927
STAT,1851,37,20-24,1888,0.5604428210892707
SIM,1912,42,na,1954,3338
STAT,1774,94,na,1868,3.11479719610817
STAT,1779,113,na,1892,1.5773644219423862E-4
STAT,1919,16,25-29,1935,9.09883787521973
SIM,1904,28,20-24,1932,19
STAT,1886,14,na,1900,2568.7695938829957
STAT,1900,39,35-39,1939,1.9805170854819638
STAT,1869,32,20-24,1901,2.4738108442997655
STAT,1905,29,45-49,1934,1.5052767481673937
STAT,1778,84,na,1862,94.54499522633573
STAT,1926,19,35-39,1945,4.83395124458036
STAT,1831,39,50-100,1870,0.9187775065981308
SIM,1877,32,20-24,1909,2
STAT,1840,40,35-39,1880,1.3975902833621412
SIM,1844,19,25-29,1863,7
SIM,1917,28,30-34,1945,43
SIM,1829,46,50-100,1875,3
SIM,1868,27,30-34,1895,28
STAT,1803,68,na,1871,724.0040571666973
STAT,1806,79,na,1885,295.6574546242288
SIM,1927,16,25-29,1943,64
STAT,1877,23,15-19,1900,3.2228385201553476
STAT,1904,44,na,1948,3100.2560348715892
STAT,1920,47,40-44,1967,0.1646417768613387
STAT,1814,50,35-39,1864,0.026181182111587365
STAT,1865,49,15-19,1914,3.3535491583897584E-4
STAT,1913,15,45-49,1928,0.09693844913507081
SIM,1866,68,na,1934,1324
STAT,1845,26,40-44,1871,2.598769980122515
STAT,1899,30,40-44,1929,5.658579254775621
STAT,1905,20,na,1925,3248.7294153109083
SIM,1885,23,15-19,1908,7
STAT,1895,47,35-39,1942,0.096807955123647
STAT,1823,34,40-44,1857,8.63871243004042
SIM,1833,47,na,1880,1456
STAT,1928,23,40-44,1951,3.953541134860591
SIM,1846,85,na,1931,171
SIM,1825,31,45-49,1856,5
SIM,1909,18,30-34,1927,4
SIM,1922,44,45-49,1966,1
STAT,1890,25,40-44,1915,3.4832461493721847
STAT,1893,43,20-24,1936,0.01311676961760946
STAT,1871,51,20-24,1922,6.955337533697144E-4
STAT,1851,23,50-100,1874,0.3477913582074545
STAT,1875,44,15-19,1919,0.013228543458800583
STAT,1952,16,40-44,1968,1.5838974513645105
SIM,1906,25,20-24,1931,19
STAT,1851,111,na,1962,2.299801879305238E-4
SIM,1843,17,15-19,1860,5
STAT,1905,44,35-39,1949,0.16938859714522123
STAT,1953,16,25-29,1969,49.535205939972215
SIM,1926,28,40-44,1954,6
SIM,1915,7,na,1922,3770
STAT,1911,18,45-49,1929,0.0941903686137399
STAT,1901,30,na,1931,3180.8834545225113
STAT,1836,19,25-29,1855,6.9972134136289155
STAT,1881,41,35-39,1922,1.6600378712950994
STAT,1851,91,na,1942,41.68435402128896
SIM,1854,21,30-34,1875,20
SIM,1871,52,na,1923,2053
SIM,1886,82,na,1968,740
STAT,1935,18,30-34,1953,15.699953950957203
STAT,1793,67,na,1860,662.018595663857
SIM,1773,87,na,1860,48
SIM,1886,25,25-29,1911,50
SIM,1788,80,na,1868,240
SIM,1843,71,na,1914,930
STAT,1900,26,20-24,1926,15.426879276852464
SIM,1936,23,40-44,1959,3
SIM,1875,42,na,1917,2231
SIM,1903,22,30-34,1925,32
STAT,1855,38,35-39,1893,5.001276704006204
STAT,1914,26,15-19,1940,0.6746363080514572
SIM,1871,36,35-39,1907,12
STAT,1845,24,15-19,1869,2.8566444423795696
SIM,1852,24,30-34,1876,14
SIM,1839,37,45-49,1876,5
STAT,1834,47,30-34,1881,0.06370981045116426
STAT,1853,16,20-24,1869,16.235263829243618
STAT,1856,43,35-39,1899,1.3250689833397717
STAT,1928,31,25-29,1959,10.923812819553596
SIM,1861,16,20-24,1877,17
STAT,1855,45,40-44,1900,0.12287217809980704
STAT,1842,38,25-29,1880,2.4206703970485983
SIM,1850,38,25-29,1888,1
SIM,1889,25,40-44,1914,7
STAT,1864,64,na,1928,1463.6487317283136
STAT,1938,27,15-19,1965,0.6607215738520085
STAT,1908,34,na,1942,3343.729195108689
STAT,1906,16,15-19,1922,8.185425297645049
SIM,1880,35,30-34,1915,5
SIM,1928,21,25-29,1949,118
STAT,1867,53,20-24,1920,6.440819154818378E-4
STAT,1856,38,na,1894,1727.9252347955405
SIM,1893,28,35-39,1921,12
SIM,1827,29,35-39,1856,7
SIM,1899,21,na,1920,3100
STAT,1837,109,na,1946,4.617259510137756E-4
SIM,1872,28,35-39,1900,7
SIM,1927,41,na,1968,4364
STAT,1893,18,50-100,1911,0.05853984831960348
STAT,1858,0,na,1858,2911.418680077545
STAT,1869,25,15-19,1894,0.418040792197068
SIM,1839,19,15-19,1858,4
STAT,1871,16,40-44,1887,0.17370753281196022
SIM,1854,5,na,1859,2393
SIM,1896,10,na,1906,3270
STAT,1879,46,40-44,1925,0.16977575105844026
SIM,1884,18,15-19,1902,4
SIM,1860,43,na,1903,1913
STAT,1937,15,30-34,1952,11.25398535449157
STAT,1834,43,15-19,1877,0.01020040138037236
SIM,1842,40,50-100,1882,2
STAT,1901,18,20-24,1919,23.381757697575765
SIM,1817,88,na,1905,37
SIM,1943,21,50-100,1964,1
SIM,1792,88,na,1880,39
SIM,1936,31,25-29,1967,10
STAT,1873,50,40-44,1923,0.010231643353793883
SIM,1878,53,na,1931,2164
SIM,1943,18,30-34,1961,17
STAT,1846,21,30-34,1867,16.418977944876314
STAT,1944,24,35-39,1968,9.597625901359034
SIM,1873,40,40-44,1913,6
STAT,1854,31,30-34,1885,12.92626077187935
SIM,1867,81,na,1948,436
STAT,1825,77,na,1902,459.41204263809476
STAT,1931,19,45-49,1950,0.6143649879615274
SIM,1918,23,20-24,1941,111
STAT,1842,16,45-49,1858,0.06110626766458789
STAT,1848,74,na,1922,824.6373058001326
SIM,1957,1,na,1958,4917
STAT,1880,28,50-100,1908,0.6348493868940879
SIM,1844,22,15-19,1866,2
STAT,1931,34,35-39,1965,11.29724010984346
STAT,1946,21,35-39,1967,9.901985498380705
STAT,1883,39,25-29,1922,2.6399112520256347
STAT,1790,84,na,1874,101.42939355772239
STAT,1887,22,30-34,1909,18.82195991358526
STAT,1885,28,35-39,1913,9.053869232654597
SIM,1836,38,50-100,1874,2
STAT,1809,53,na,1862,1153.66827872391
STAT,1831,40,na,1871,1535.0352947863762
SIM,1849,96,na,1945,1
SIM,1922,38,na,1960,4023
SIM,1935,26,25-29,1961,91
STAT,1936,33,40-44,1969,3.5885195072947216
SIM,1887,36,na,1923,2459
SIM,1937,20,20-24,1957,104
SIM,1886,15,15-19,1901,8
STAT,1908,44,20-24,1952,0.015246364787743182
STAT,1843,21,45-49,1864,0.5954814127245045
STAT,1902,23,50-100,1925,0.5419990245773437
SIM,1829,73,na,1902,700
STAT,1771,104,na,1875,0.023072984706605827
STAT,1843,45,15-19,1888,2.7589853280743875E-4
STAT,1850,48,25-29,1898,0.040093401112227166
STAT,1846,45,30-34,1891,0.07251271317195668
SIM,1790,90,na,1880,20
STAT,1860,33,15-19,1893,0.10869621792700168
STAT,1852,42,20-24,1894,0.11499551296274287
STAT,1910,44,na,1954,3275.2157161562
STAT,1911,31,15-19,1942,0.11870002284110334
STAT,1940,27,50-100,1967,0.9588483707226575
STAT,1865,46,na,1911,1931.932150199909
STAT,1911,20,na,1931,3439.589622420629
SIM,1826,37,35-39,1863,8
STAT,1901,28,30-34,1929,33.18186686058669
SIM,1876,27,20-24,1903,11
SIM,1828,31,30-34,1859,21
STAT,1840,54,na,1894,1374.1753147920645
SIM,1895,22,30-34,1917,29
SIM,1903,29,50-100,1932,1
STAT,1867,31,40-44,1898,3.8627273374889044
SIM,1934,23,na,1957,4545
STAT,1915,47,30-34,1962,0.08486235884803456
SIM,1940,23,na,1963,3411
SIM,1930,18,20-24,1948,143
STAT,1917,45,na,1962,3642.177133530758
STAT,1860,43,50-100,1903,0.8039309191004969
STAT,1903,17,40-44,1920,0.2458495575447866
SIM,1926,24,25-29,1950,102
STAT,1914,31,30-34,1945,15.043649391822477
STAT,1914,41,40-44,1955,0.2344809162904446
STAT,1822,45,45-49,1867,0.32659917672628264
STAT,1841,32,35-39,1873,8.470910424054795
STAT,1875,48,30-34,1923,0.0928131797499943
STAT,1922,18,20-24,1940,147.83725106757626
STAT,1761,107,na,1868,0.009783996271991325
STAT,1862,22,25-29,1884,47.33367498220328
STAT,1845,16,30-34,1861,1.4339727757519485
STAT,1837,37,50-100,1874,0.9701339497921906
STAT,1856,2,na,1858,2610.136262720202
STAT,1918,24,25-29,1942,93.52496580211432
SIM,1871,24,35-39,1895,10
STAT,1878,25,25-29,1903,41.92916459680872
SIM,1870,22,25-29,1892,59
STAT,1859,35,30-34,1894,4.045316443150213
SIM,1813,98,na,1911,1
SIM,1913,6,na,1919,3728
SIM,1944,23,30-34,1967,29
STAT,1859,21,40-44,1880,1.7992970756851479
STAT,1787,67,na,1854,696.0
STAT,1898,28,45-49,1926,1.4144368760242965
SIM,1858,38,25-29,1896,2
SIM,1922,31,30-34,1953,24
STAT,1838,45,40-44,1883,0.12131676793315845
STAT,1826,52,20-24,1878,6.571791806638108E-4
SIM,1867,21,40-44,1888,1
STAT,1855,22,na,1877,1775.0486525578958
STAT,1828,41,30-34,1869,0.9911494715512162
STAT,1784,84,na,1868,97.43097645003611
SIM,1853,16,30-34,1869,1
SIM,1797,91,na,1888,9
STAT,1880,29,na,1909,2359.834102950763
STAT,1913,39,45-49,1952,0.6291797103609227
STAT,1944,20,50-100,1964,0.671613350335421
STAT,1868,23,na,1891,2125.1309033176867
SIM,1908,29,35-39,1937,17
SIM,1869,36,50-100,1905,2
SIM,1901,36,25-29,1937,3
STAT,1863,24,35-39,1887,4.863524643567151
STAT,1885,15,20-24,1900,16.77152017289285
SIM,1934,29,45-49,1963,5
STAT,1837,24,25-29,1861,47.940013318509024
STAT,1957,14,na,1971,4889.994117429401
STAT,1836,32,25-29,1868,8.383978726492646
STAT,1934,34,20-24,1968,3.1420345903711
STAT,1871,46,na,1917,2116.5054485973706
STAT,1916,49,40-44,1965,0.15187241918405772
STAT,1946,25,50-100,1971,1.048359597621489
STAT,1815,53,na,1868,1230.8684794377148
STAT,1860,9,na,1869,2153.784700044699
SIM,1844,32,25-29,1876,18
STAT,1891,30,40-44,1921,5.109415586482279
STAT,1817,82,na,1899,215.95391644413547
STAT,1830,50,20-24,1880,5.560035709098793E-4
SIM,1887,67,na,1954,1621
STAT,1842,89,na,1931,76.07790001146681
STAT,1908,21,50-100,1929,0.5731996489564908
SIM,1855,96,na,1951,3
STAT,1895,32,30-34,1927,21.503365233811127
SIM,1893,15,20-24,1908,28
SIM,1903,37,na,1940,3209
STAT,1860,74,na,1934,850.663679485855
STAT,1927,26,25-29,1953,75.850989404718
STAT,1864,35,40-44,1899,3.720737706974639
STAT,1919,2,na,1921,4269.656564711235
STAT,1871,29,50-100,1900,0.5957888423674328
STAT,1906,38,50-100,1944,0.3628025837116074
SIM,1918,33,30-34,1951,25
STAT,1884,22,45-49,1906,0.650824669625691
SIM,1891,39,25-29,1930,4
SIM,1845,24,25-29,1869,59
SIM,1835,26,20-24,1861,9
SIM,1836,41,30-34,1877,2
STAT,1832,25,na,1857,1745.3772605528202
SIM,1876,4,na,1880,2704
SIM,1921,39,45-49,1960,3
SIM,1928,31,35-39,1959,17
STAT,1940,31,40-44,1971,3.8283491545897332
SIM,1881,40,30-34,1921,1
SIM,1905,66,na,1971,2492
STAT,1894,17,20-24,1911,21.52331405903163
SIM,1867,38,35-39,1905,15
SIM,1872,38,45-49,1910,1
STAT,1802,83,na,1885,138.63606657137953
SIM,1872,68,na,1940,1396
STAT,1816,48,25-29,1864,0.13388301583561799
SIM,1841,41,40-44,1882,5
SIM,1921,20,25-29,1941,92
STAT,1931,28,50-100,1959,1.2133665528322133
STAT,1857,27,45-49,1884,0.8520737371903763
STAT,1851,49,20-24,1900,0.008451883849405234
STAT,1897,44,35-39,1941,0.15672167534755665
SIM,1784,90,na,1874,16
SIM,1848,15,na,1863,2115
SIM,1827,47,na,1874,1386
SIM,1919,25,30-34,1944,47
SIM,1929,35,50-100,1964,1
STAT,1799,83,na,1882,132.89996698837612
STAT,1891,49,25-29,1940,0.03718220981008594
STAT,1800,54,na,1854,1096.834817952602
STAT,1864,38,45-49,1902,1.6701343958360295
STAT,1874,29,na,1903,2287.064333531506
SIM,1959,2,na,1961,4885
STAT,1887,46,30-34,1933,0.10257745214786905
STAT,1904,37,45-49,1941,0.583049049475496
STAT,1926,28,na,1954,4227.346067686507
STAT,1913,20,25-29,1933,85.06401212360991
SIM,1893,36,na,1929,2936
STAT,1833,41,40-44,1874,1.6938014277202527
STAT,1926,29,45-49,1955,1.9424283132933482
STAT,1857,88,na,1945,102.28464798489956
SIM,1917,19,35-39,1936,5
STAT,1862,107,na,1969,0.04711824314808432
STAT,1856,47,15-19,1903,2.9345635468409735E-4
SIM,1831,40,35-39,1871,3
SIM,1875,48,na,1923,2147
SIM,1923,25,20-24,1948,17
STAT,1781,73,na,1854,460.0
STAT,1855,50,na,1905,1552.0865620370312
SIM,1812,48,na,1860,1292
SIM,1908,19,25-29,1927,10
STAT,1838,19,na,1857,2011.6396209443092
STAT,1899,18,na,1917,3260.5861825403085
SIM,1886,35,35-39,1921,9
SIM,1870,26,40-44,1896,4
SIM,1917,30,45-49,1947,2
STAT,1884,46,15-19,1930,3.74387919693635E-4
STAT,1937,25,40-44,1962,4.296016062064696
STAT,1827,29,25-29,1856,62.4417670379594
STAT,1858,33,na,1891,1760.0375514952523
SIM,1958,3,na,1961,4785
STAT,1759,113,na,1872,1.976521055565501E-4
STAT,1890,15,30-34,1905,1.8494176509116595
SIM,1881,42,na,1923,1806
STAT,1879,3,na,1882,3013.192063844506
STAT,1853,30,50-100,1883,0.7290542687826962
SIM,1882,42,40-44,1924,5
STAT,1887,47,45-49,1934,0.24821488387977197
STAT,1810,48,20-24,1858,0.03939114142214381
STAT,1921,15,35-39,1936,4.539500472959547
SIM,1900,38,30-34,1938,1
STAT,1775,79,na,1854,239.0
STAT,1862,26,40-44,1888,2.446054835796815
STAT,1937,26,50-100,1963,0.9170141760829227
STAT,1930,27,45-49,1957,2.07520058746047
STAT,1878,35,35-39,1913,7.029569492046048
SIM,1902,52,na,1954,2817
SIM,1952,11,na,1963,4387
STAT,1861,54,30-34,1915,0.00454707377488517
SIM,1895,62,na,1957,2339
STAT,1882,35,50-100,1917,1.1386583805451955
STAT,1795,93,na,1888,7.3889908228190215
STAT,1848,52,40-44,1900,0.0077810104387631045
STAT,1837,100,na,1937,0.6889905657959626
SIM,1823,88,na,1911,58
SIM,1844,29,35-39,1873,16
STAT,1843,68,na,1911,1032.2159880392412
SIM,1826,68,na,1894,821
STAT,1874,42,40-44,1916,2.1683807553916425
STAT,1901,24,15-19,1925,4.335127884743665
STAT,1832,28,na,1860,1709.6773420873974
STAT,1909,26,40-44,1935,4.25862116898764
SIM,1945,25,40-44,1970,5
SIM,1826,31,na,1857,1595
STAT,1855,48,45-49,1903,0.1656006405414578
STAT,1871,12,na,1883,2476.7737805737524
STAT,1910,36,25-29,1946,0.8939037769836987
STAT,1941,27,20-24,1968,17.838750867685558
STAT,1893,41,50-100,1934,1.2713853838762446
STAT,1806,73,na,1879,522.1220892696032
STAT,1842,35,20-24,1877,0.6685937064322898
STAT,1851,47,30-34,1898,0.0693077687347752
STAT,1877,27,50-100,1904,0.6268567372936831
STAT,1905,42,45-49,1947,0.141740789422442
STAT,1920,21,50-100,1941,0.6931311399550077
STAT,1882,52,na,1934,1967.617540405482
STAT,1833,46,50-100,1879,0.17879006271135564
STAT,1876,18,15-19,1894,5.776974602357289
SIM,1919,18,na,1937,3887
STAT,1901,38,40-44,1939,1.2432117006941563
STAT,1928,25,30-34,1953,45.911029864624815
STAT,1836,29,35-39,1865,7.969492914654308
SIM,1868,60,na,1928,1698
STAT,1824,98,na,1922,1.7912029360150368
SIM,1831,24,30-34,1855,13
STAT,1852,54,20-24,1906,5.202697787751729E-4
SIM,1858,16,15-19,1874,4
STAT,1849,59,na,1908,1457.3415793413053
STAT,1901,36,15-19,1937,0.016104543798085333
SIM,1914,5,na,1919,3937
STAT,1855,35,30-34,1890,3.823308984962683
STAT,1856,40,30-34,1896,0.8559454512167636
STAT,1917,44,50-100,1961,0.11543576610232328
SIM,1928,30,20-24,1958,2
STAT,1902,41,15-19,1943,0.0012843312662516643
STAT,1807,51,40-44,1858,0.039362316255028444
SIM,1900,26,30-34,1926,28
STAT,1965,6,na,1971,4635.302794185979
SIM,1831,83,na,1914,198
STAT,1868,28,35-39,1896,8.666372176406796
STAT,1846,48,na,1894,1647.748000180094
STAT,1886,25,15-19,1911,0.4558261136212327
SIM,1848,100,na,1948,2
SIM,1851,35,na,1886,1799
SIM,1917,26,40-44,1943,5
SIM,1858,34,45-49,1892,1
SIM,1906,42,na,1948,3185
STAT,1819,39,50-100,1858,2.923726693729394
SIM,1894,20,20-24,1914,71
SIM,1819,80,na,1899,315
STAT,1787,98,na,1885,0.5734808803154838
STAT,1902,15,na,1917,3382.8620723679946
SIM,1899,35,45-49,1934,2
STAT,1923,24,35-39,1947,10.284989586543071
STAT,1855,53,na,1908,1505.5310335753488
STAT,1886,20,20-24,1906,69.17880568014502
STAT,1919,48,45-49,1967,0.22207727554963091
STAT,1871,24,25-29,1895,53.36434794338056
SIM,1931,24,35-39,1955,12
STAT,1768,91,na,1859,11.817614324185701
STAT,1859,29,50-100,1888,0.482279961280303
STAT,1837,46,35-39,1883,0.09553511516100545
STAT,1860,49,30-34,1909,0.072648936166842
STAT,1940,21,30-34,1961,27.668324675941918
SIM,1927,36,45-49,1963,1
SIM,1820,77,na,1897,460
STAT,1844,52,50-100,1896,0.010433377768437693
STAT,1954,15,30-34,1969,14.241280555102408
SIM,1874,0,na,1874,3337
STAT,1888,40,na,1928,2606.4164683797394
SIM,1884,21,40-44,1905,2
STAT,1831,35,45-49,1866,1.5652571997839628
STAT,1914,34,na,1948,3565.7671559025375
STAT,1933,23,15-19,1956,6.668214753956285
SIM,1850,50,na,1900,1629
STAT,1894,15,30-34,1909,1.9440268067593887
SIM,1845,34,35-39,1879,9
SIM,1868,63,na,1931,1589
STAT,1869,73,na,1942,1087.0187016742636
STAT,1909,19,35-39,1928,0.773231404983765
SIM,1835,24,30-34,1859,22
SIM,1862,31,30-34,1893,22
STAT,1870,40,15-19,1910,0.012927556068092622
STAT,1882,37,15-19,1919,0.05159005863365255
SIM,1868,37,40-44,1905,2
STAT,1881,3,na,1884,2745.955147983984
SIM,1932,37,30-34,1969,6
SIM,1861,19,25-29,1880,7
STAT,1872,38,35-39,1910,6.668896912375374
STAT,1930,15,45-49,1945,0.6129326352033976
SIM,1941,23,15-19,1964,3
STAT,1851,60,na,1911,1371.9162704902574
SIM,1877,23,25-29,1900,52
SIM,1909,24,25-29,1933,83
STAT,1898,47,20-24,1945,0.008613278189012892
SIM,1877,35,25-29,1912,1
STAT,1890,31,35-39,1921,11.744214017237818
SIM,1880,38,35-39,1918,18
STAT,1836,22,15-19,1858,2.81946009484473
STAT,1869,35,25-29,1904,2.660035897947029
STAT,1871,15,na,1886,2412.8418956640558
SIM,1930,20,35-39,1950,13
STAT,1933,35,15-19,1968,0.02475246317198609
SIM,1903,25,35-39,1928,16
STAT,1843,65,na,1908,1141.4796017971642
STAT,1830,27,40-44,1857,3.0021578183587976
STAT,1924,37,30-34,1961,2.030230970030497
SIM,1919,15,na,1934,4142
STAT,1910,43,30-34,1953,0.11346088341983877
STAT,1853,19,25-29,1872,5.098263975734382
STAT,1815,46,15-19,1861,9.142203110275765E-4
SIM,1863,35,30-34,1898,4
STAT,1823,40,35-39,1863,2.5531451572040162
STAT,1926,22,na,1948,4191.018706556162
STAT,1909,30,45-49,1939,1.4300294018755038
SIM,1935,24,35-39,1959,17
SIM,1880,26,35-39,1906,11
STAT,1867,22,45-49,1889,0.6211269478277718
STAT,1902,49,na,1951,2937.4760094333365
SIM,1918,24,35-39,1942,10
STAT,1820,53,30-34,1873,0.009405713541967283
SIM,1825,83,na,1908,194
SIM,1767,87,na,1854,45
STAT,1907,55,na,1962,2995.063249460057
STAT,1919,36,45-49,1955,0.692502247294465
STAT,1887,24,20-24,1911,72.36289227964058
SIM,1824,36,na,1860,1585
STAT,1826,110,na,1936,1.509035021422013E-4
SIM,1788,86,na,1874,67
SIM,1960,6,na,1966,4856
SIM,1773,81,na,1854,163
STAT,1902,44,50-100,1946,0.09648853835537449
STAT,1837,34,35-39,1871,8.07121035130737
STAT,1868,51,50-100,1919,0.013677875979382245
STAT,1936,36,45-49,1972,0.6328022740442134
SIM,1895,24,20-24,1919,80
STAT,1811,53,20-24,1864,0.0023026450701085915
SIM,1853,24,15-19,1877,2
SIM,1845,35,na,1880,1763
SIM,1858,23,20-24,1881,71
STAT,1848,49,15-19,1897,2.9101717119332175E-4
SIM,1919,35,40-44,1954,2
STAT,1895,25,na,1920,2959.1796791093534
STAT,1920,34,na,1954,3879.995149778265
STAT,1894,40,na,1934,2834.2725375190075
STAT,1877,37,40-44,1914,4.289666688624902
SIM,1876,25,30-34,1901,28
STAT,1919,5,na,1924,4197.5445869468285
STAT,1946,23,25-29,1969,97.07361748719187
STAT,1872,33,40-44,1905,4.092032366718523
STAT,1935,20,45-49,1955,1.448455520532115
STAT,1925,47,25-29,1972,0.060721649217021
SIM,1794,80,na,1874,198
STAT,1916,35,15-19,1951,0.018754144037059866
SIM,1844,50,na,1894,1463
SIM,1828,33,20-24,1861,2
SIM,1944,26,35-39,1970,17
STAT,1931,16,40-44,1947,1.7337449994588001
STAT,1858,22,35-39,1880,4.959151622700954
SIM,1907,46,50-100,1953,1
SIM,1836,21,na,1857,1821
SIM,1894,27,40-44,1921,8
STAT,1916,47,15-19,1963,3.5693393864228383E-4
STAT,1941,15,20-24,1956,131.9916343283886
SIM,1952,17,na,1969,4133
STAT,1857,85,na,1942,204.2468705380126
STAT,1883,48,20-24,1931,0.010974905991430485
STAT,1858,9,na,1867,2107.940518112339
STAT,1873,53,45-49,1926,0.013681301374946308
STAT,1866,48,20-24,1914,0.010324478029208056
STAT,1927,24,35-39,1951,10.890506628573528
SIM,1848,24,40-44,1872,3
SIM,1813,42,40-44,1855,6
SIM,1818,36,30-34,1854,7
SIM,1838,56,na,1894,1358
STAT,1859,52,50-100,1911,0.01129516243572589
SIM,1885,27,30-34,1912,30
SIM,1905,34,35-39,1939,13
SIM,1918,30,na,1948,3790
SIM,1830,35,35-39,1865,8
SIM,1827,36,40-44,1863,3
STAT,1877,27,30-34,1904,24.676616123516347
SIM,1899,55,na,1954,2706
STAT,1822,35,35-39,1857,13.788318395793661
STAT,1886,39,40-44,1925,4.324389984200701
SIM,1867,25,20-24,1892,11
SIM,1894,39,40-44,1933,5
SIM,1937,6,na,1943,3581
STAT,1851,94,na,1945,14.376844301170015
STAT,1864,33,na,1897,2000.7277179829684
SIM,1857,20,na,1877,1980
STAT,1916,45,25-29,1961,0.051640440614304964
SIM,1782,95,na,1877,4
STAT,1907,33,15-19,1940,0.11299630830121665
STAT,1874,26,na,1900,2311.4331814197426
STAT,1819,48,40-44,1867,0.31953004205046837
STAT,1836,24,50-100,1860,0.3435251319849334
STAT,1835,20,40-44,1855,2.4115591331353627
STAT,1911,22,50-100,1933,0.5895491506036561
STAT,1825,47,20-24,1872,0.012241068095703498
STAT,1945,26,45-49,1971,1.791338288416278
STAT,1842,47,20-24,1889,0.008691639876499407
STAT,1901,31,20-24,1932,3.5889747985186684
SIM,1862,78,na,1940,637
STAT,1929,21,50-100,1950,0.7884149642598022
STAT,1831,32,40-44,1863,3.4611765211700445
STAT,1886,27,40-44,1913,2.989304340985467
STAT,1862,19,35-39,1881,0.4564908053981005
STAT,1907,45,15-19,1952,3.1623897279577963E-4
SIM,1919,21,15-19,1940,5
SIM,1937,30,30-34,1967,12
SIM,1943,20,45-49,1963,1
SIM,1883,77,na,1960,888
STAT,1864,41,35-39,1905,1.5315528050661134
STAT,1887,30,15-19,1917,0.15168953228045834
STAT,1802,80,na,1882,261.54571351881395
STAT,1942,5,na,1947,3940.765257828983
STAT,1881,9,na,1890,2367.8790285050504
SIM,1909,34,35-39,1943,9
SIM,1849,22,35-39,1871,5
STAT,1819,36,40-44,1855,13.462991894201563
STAT,1929,42,30-34,1971,0.15640221649671154
SIM,1835,29,25-29,1864,43
SIM,1814,43,na,1857,1323
SIM,1870,19,35-39,1889,1
STAT,1841,36,15-19,1877,0.046088353282047544
SIM,1912,22,40-44,1934,3
SIM,1880,33,40-44,1913,6
STAT,1877,17,20-24,1894,17.372802227373292
SIM,1844,36,40-44,1880,4
STAT,1831,37,35-39,1868,5.4225564495145635
SIM,1904,30,35-39,1934,18
STAT,1827,103,na,1930,0.08289882869498408
STAT,1859,25,20-24,1884,9.103275928270435
SIM,1927,28,50-100,1955,1
STAT,1867,78,na,1945,693.1030963156823
STAT,1932,18,15-19,1950,56.6214494915168
STAT,1827,72,na,1899,729.4881603275019
STAT,1910,33,20-24,1943,2.212492546991031
SIM,1859,21,15-19,1880,2
SIM,1872,37,50-100,1909,1
SIM,1872,41,35-39,1913,4
STAT,1850,13,na,1863,2047.0425740940893
SIM,1940,18,15-19,1958,36
SIM,1943,16,40-44,1959,2
STAT,1946,19,20-24,1965,141.9625032601795
SIM,1843,20,40-44,1863,2
STAT,1816,45,20-24,1861,0.02925505834708062
STAT,1915,37,20-24,1952,0.2515764464838111
SIM,1958,0,na,1958,4792
STAT,1853,17,35-39,1870,0.49953190166610273
STAT,1844,13,na,1857,2098.0248337776347
STAT,1847,53,35-39,1900,0.006246452498102228
STAT,1845,38,40-44,1883,3.221048862372692
STAT,1892,38,20-24,1930,0.9075831356378674
STAT,1897,41,30-34,1938,0.10131891660641003
SIM,1925,18,na,1943,4179
STAT,1882,55,na,1937,1899.6402205247446
STAT,1835,53,50-100,1888,0.009603961977572193
STAT,1846,46,45-49,1892,0.17553907552081585
STAT,1904,22,40-44,1926,2.8236785012595496
SIM,1901,45,50-100,1946,2
STAT,1847,103,na,1950,0.10582901552445251
STAT,1931,32,45-49,1963,1.947831297259915
SIM,1822,72,na,1894,652
STAT,1840,20,na,1860,1810.308199498565
STAT,1846,23,20-24,1869,62.61314685202914
SIM,1875,22,45-49,1897,3
STAT,1899,42,50-100,1941,0.09484329957132466
SIM,1900,57,na,1957,2715
SIM,1913,26,40-44,1939,6
STAT,1908,45,50-100,1953,0.19608283991198994
SIM,1946,17,na,1963,3740
STAT,1812,73,na,1885,545.1708813911681
STAT,1888,77,na,1965,1275.5130478116746
SIM,1820,43,na,1863,1500
STAT,1964,7,na,1971,4675.628655500536
STAT,1878,47,35-39,1925,0.13719030020027725
STAT,1915,25,20-24,1940,17.70857495491993
STAT,1935,16,40-44,1951,1.8108032808552845
SIM,1819,44,35-39,1863,3
SIM,1918,36,35-39,1954,4
STAT,1836,36,40-44,1872,3.515814116459958
STAT,1883,36,20-24,1919,0.7174069230523492
SIM,1853,38,40-44,1891,11
STAT,1831,25,35-39,1856,8.912087273316287
STAT,1807,58,na,1865,1085.6870942528026
STAT,1911,41,25-29,1952,0.06476009015293276
STAT,1929,30,30-34,1959,18.92642410907291
STAT,1832,52,45-49,1884,0.009123301877374469
STAT,1865,12,na,1877,2314.7458876836913
STAT,1905,26,40-44,1931,4.104462977574876
STAT,1924,39,20-24,1963,0.29301938454068954
SIM,1854,23,20-24,1877,51
STAT,1837,34,na,1871,1727.2127890204747
STAT,1880,4,na,1884,2844.766192092209
SIM,1912,15,35-39,1927,3
STAT,1884,42,50-100,1926,0.9847944942883091
SIM,1892,42,50-100,1934,2
STAT,1806,52,35-39,1858,0.03030574276209928
SIM,1854,49,na,1903,1787
SIM,1877,77,na,1954,799
SIM,1876,7,na,1883,2631
STAT,1862,29,45-49,1891,0.8904027244090813
STAT,1887,44,40-44,1931,2.3446924713997213
SIM,1881,36,50-100,1917,3
STAT,1933,39,30-34,1972,2.3401785194077616
SIM,1813,95,na,1908,7
STAT,1920,9,na,1929,4219.254766491182
SIM,1928,29,20-24,1957,24
STAT,1899,23,35-39,1922,7.530120881341809
STAT,1847,50,30-34,1897,0.004452531389596151
SIM,1836,44,35-39,1880,2
STAT,1842,45,50-100,1887,0.18250591405513866
SIM,1940,25,20-24,1965,14
STAT,1827,106,na,1933,0.0070134252432913855
STAT,1897,48,15-19,1945,2.814791103760566E-4
SIM,1886,37,25-29,1923,4
SIM,1904,24,40-44,1928,2
STAT,1913,27,45-49,1940,1.6262628787903903
SIM,1903,15,25-29,1918,5
STAT,1887,49,35-39,1936,0.08170577942089137
STAT,1836,26,30-34,1862,21.25340616238965
STAT,1815,52,45-49,1867,0.03136000716190277
STAT,1910,26,15-19,1936,0.6462310719233215
STAT,1932,25,20-24,1957,22.60600324759967
STAT,1844,17,25-29,1861,5.002920573275392
STAT,1853,27,na,1880,1896.5706214378224
SIM,1817,54,na,1871,1241
STAT,1926,43,50-100,1969,0.13659858178663598
SIM,1795,68,na,1863,716
SIM,1852,17,25-29,1869,5
STAT,1861,53,na,1914,1664.1301357470252
SIM,1889,62,na,1951,2162
STAT,1859,18,15-19,1877,5.149093009829966
SIM,1930,26,40-44,1956,9
STAT,1882,43,45-49,1925,1.365053731082886
STAT,1868,26,na,1894,2158.455822141902
STAT,1891,42,40-44,1933,2.625674777689119
SIM,1894,23,25-29,1917,77
SIM,1899,32,40-44,1931,9
SIM,1869,34,20-24,1903,1
SIM,1926,16,40-44,1942,1
STAT,1863,23,20-24,1886,57.84981580790364
STAT,1876,16,25-29,1892,5.544337786191357
STAT,1891,66,na,1957,1965.264373608208
STAT,1803,100,na,1903,0.35686433036464005
STAT,1848,71,na,1919,991.8343081640585
SIM,1805,69,na,1874,690
STAT,1904,15,35-39,1919,0.7469863932190182
SIM,1921,27,45-49,1948,2
STAT,1909,29,45-49,1938,1.5486671717827363
SIM,1890,30,30-34,1920,30
SIM,1847,61,na,1908,1415
STAT,1922,26,40-44,1948,4.9996555288581455
STAT,1935,19,45-49,1954,0.6416711432134617
STAT,1964,4,na,1968,4678.0140431821665
STAT,1810,46,30-34,1856,0.3283981286103392
STAT,1873,43,35-39,1916,1.7224338736032305
SIM,1890,43,45-49,1933,4
SIM,1960,9,na,1969,4855
STAT,1909,16,30-34,1925,2.2637093236206964
SIM,1859,27,20-24,1886,8
SIM,1917,16,30-34,1933,2
STAT,1872,23,30-34,1895,16.826359779687337
STAT,1884,81,na,1965,774.422438437418
SIM,1874,63,na,1937,1673
STAT,1895,35,35-39,1930,8.793730310767403
STAT,1834,20,na,1854,1717.4103728831865
STAT,1932,22,na,1954,4526.439379908251
STAT,1938,20,50-100,1958,0.6156376626686488
SIM,1827,32,25-29,1859,10
STAT,1789,90,na,1879,27.216169649746043
STAT,1873,36,50-100,1909,1.1819797916778558
SIM,1881,43,35-39,1924,1
STAT,1896,49,45-49,1945,0.16262847769387043
SIM,1903,31,50-100,1934,1
SIM,1869,48,na,1917,2041
SIM,1872,31,25-29,1903,10
STAT,1866,17,45-49,1883,0.05842056589870805
SIM,1850,45,50-100,1895,2
STAT,1828,44,35-39,1872,1.4850285140663728
SIM,1835,27,35-39,1862,9
SIM,1822,34,30-34,1856,16
STAT,1831,46,na,1877,1426.789648637852
STAT,1935,19,50-100,1954,0.4812533574100964
SIM,1876,21,15-19,1897,3
SIM,1905,41,40-44,1946,1
STAT,1941,3,na,1944,3924.0197016987086
STAT,1882,30,30-34,1912,16.16944652121967
STAT,1910,41,na,1951,3335.0522351214054
SIM,1858,31,40-44,1889,3
STAT,1857,46,20-24,1903,0.00896611664400916
STAT,1769,110,na,1879,0.0015103189374650447
STAT,1919,40,na,1959,3812.6790596813516
SIM,1931,21,30-34,1952,45
STAT,1936,26,35-39,1962,13.57933164908438
SIM,1871,89,na,1960,157
SIM,1830,25,25-29,1855,36
SIM,1926,20,45-49,1946,1
STAT,1878,37,25-29,1915,2.834628932449971
STAT,1800,88,na,1888,47.85241766701778
STAT,1803,99,na,1902,0.6366097550076527
SIM,1863,38,35-39,1901,9
STAT,1894,18,35-39,1912,0.6644147021126079
STAT,1929,40,40-44,1969,0.3068434954773761
STAT,1896,30,25-29,1926,12.882272117356843
STAT,1850,16,na,1866,1989.0211232441866
STAT,1868,21,15-19,1889,2.995053779950643
SIM,1832,47,50-100,1879,2
SIM,1866,22,35-39,1888,8
STAT,1881,25,30-34,1906,23.13707716875869
STAT,1832,42,35-39,1874,1.3391565786509791
STAT,1865,37,15-19,1902,0.048083252087963976
SIM,1828,94,na,1922,9
STAT,1928,35,40-44,1963,1.7902993470575241
SIM,1861,90,na,1951,56
STAT,1889,25,na,1914,2802.177117661605
SIM,1900,22,15-19,1922,4
STAT,1836,86,na,1922,143.67959915885166
SIM,1868,33,25-29,1901,11
SIM,1798,79,na,1877,275
STAT,1824,47,50-100,1871,0.2994020484000613
STAT,1827,27,35-39,1854,27.153577099092768
STAT,1923,21,30-34,1944,31.687163028524033
STAT,1790,87,na,1877,53.764108646160395
SIM,1928,33,25-29,1961,13
STAT,1947,21,na,1968,3900.359679727484
SIM,1851,38,na,1889,1721
STAT,1868,25,30-34,1893,22.851494100095685
SIM,1927,33,40-44,1960,9
STAT,1892,48,30-34,1940,0.06379750781594315
SIM,1862,34,35-39,1896,11
SIM,1835,76,na,1911,562
STAT,1846,33,30-34,1879,15.145512042867194
SIM,1867,18,15-19,1885,4
SIM,1840,42,35-39,1882,4
SIM,1888,15,na,1903,2855
STAT,1856,53,45-49,1909,0.010525029948314375
SIM,1924,30,na,1954,4198
SIM,1870,29,45-49,1899,1
SIM,1849,32,45-49,1881,1
SIM,1895,44,40-44,1939,2
STAT,1770,111,na,1881,8.997218823985759E-4
STAT,1906,28,15-19,1934,0.6220536882454937
STAT,1818,98,na,1916,1.5953544009799605
SIM,1868,100,na,1968,2
SIM,1844,26,30-34,1870,25
SIM,1893,30,na,1923,2984
STAT,1925,40,na,1965,4259.417297581342
SIM,1868,30,20-24,1898,2
STAT,1807,48,15-19,1855,0.0015149195237551683
STAT,1840,37,45-49,1877,1.5473289280085731
STAT,1871,28,40-44,1899,2.8001641217197997
STAT,1846,48,35-39,1894,0.10253379837755076
STAT,1876,52,na,1928,2090.314626307774
STAT,1865,52,40-44,1917,0.008966481565791103
SIM,1866,34,na,1900,2083
SIM,1858,26,25-29,1884,37
SIM,1904,16,na,1920,3492
STAT,1883,50,35-39,1933,0.008088412931258457
STAT,1838,31,50-100,1869,0.7723492068394855
STAT,1925,44,20-24,1969,0.020131000331109875
STAT,1857,1,na,1858,2779.9300885711377
SIM,1931,31,40-44,1962,3
SIM,1853,22,25-29,1875,55
SIM,1865,89,na,1954,83
STAT,1850,41,40-44,1891,1.5927414532078596
SIM,1853,6,na,1859,2281
SIM,1905,31,30-34,1936,10
STAT,1795,90,na,1885,32.20681035839536
SIM,1918,29,50-100,1947,4
STAT,1829,45,30-34,1874,0.08122118350810617
SIM,1836,24,15-19,1860,2
STAT,1881,38,45-49,1919,1.810245352344014
STAT,1898,16,45-49,1914,0.0837146720448942
STAT,1904,41,na,1945,3156.896129785797
SIM,1865,45,50-100,1910,4
STAT,1895,49,50-100,1944,0.16706176669084827
SIM,1859,37,30-34,1896,7
SIM,1862,75,na,1937,871
STAT,1922,20,35-39,1942,10.26157766269057
STAT,1774,91,na,1865,13.57664192654181
SIM,1903,19,40-44,1922,1
SIM,1918,26,25-29,1944,58
STAT,1837,31,30-34,1868,14.355589074743337
STAT,1910,46,35-39,1956,0.11392483762659632
SIM,1854,33,30-34,1887,23
SIM,1913,22,25-29,1935,89
STAT,1905,18,20-24,1923,24.1447847434688
STAT,1900,19,15-19,1919,7.73554748702912
STAT,1822,32,na,1854,1436.5615251766149
STAT,1871,18,30-34,1889,1.4959577040249568
SIM,1848,27,45-49,1875,3
STAT,1814,47,45-49,1861,0.7218541516354787
STAT,1854,34,35-39,1888,7.267592378305539
STAT,1825,46,na,1871,1387.6898848362052
STAT,1791,104,na,1895,0.012349960298241099
STAT,1828,34,25-29,1862,9.894863990635162
STAT,1904,30,50-100,1934,1.2515442711671352
SIM,1914,38,25-29,1952,1
STAT,1857,45,50-100,1902,0.18481128102592742
STAT,1845,22,25-29,1867,50.288869761410886
STAT,1824,61,na,1885,1088.942246427058
STAT,1839,97,na,1936,3.5768294615295084
STAT,1916,42,20-24,1958,0.01709699972095828
SIM,1899,17,15-19,1916,4
STAT,1946,20,20-24,1966,116.9768809208496
SIM,1877,74,na,1951,1010
STAT,1896,36,30-34,1932,6.6816416673738015
STAT,1880,1,na,1881,3388.121393421544
SIM,1856,75,na,1931,769
STAT,1833,72,na,1905,774.8189988093674
STAT,1823,49,45-49,1872,0.2824740353616616
STAT,1837,31,na,1868,1781.8643056673418
SIM,1818,39,35-39,1857,11
SIM,1897,1,na,1898,3469
STAT,1846,43,40-44,1889,1.6669984745509485
SIM,1898,73,na,1971,1865
SIM,1862,24,25-29,1886,51
STAT,1931,22,35-39,1953,11.536632352273763
SIM,1810,84,na,1894,111
STAT,1847,30,50-100,1877,0.8099415805167187
STAT,1846,45,na,1891,1685.3518450948204
SIM,1845,31,30-34,1876,21
STAT,1833,48,25-29,1881,0.037192122367743566
STAT,1876,24,45-49,1900,0.6763285946651464
SIM,1854,43,40-44,1897,5
STAT,1879,66,na,1945,1620.7731988547566
SIM,1904,20,25-29,1924,88
STAT,1840,19,15-19,1859,4.983214259949754
SIM,1839,25,45-49,1864,5
SIM,1900,28,20-24,1928,17
SIM,1841,76,na,1917,601
SIM,1894,15,na,1909,3196
SIM,1927,44,na,1971,4331
SIM,1801,70,na,1871,623
STAT,1879,52,35-39,1931,0.008467947371913826
STAT,1839,60,na,1899,1269.7968712212214
STAT,1854,24,25-29,1878,47.436065255177056
STAT,1863,36,35-39,1899,5.891795907382643
SIM,1876,28,35-39,1904,8
SIM,1912,25,45-49,1937,1
STAT,1886,23,25-29,1909,56.949471327127206
SIM,1842,24,na,1866,1802
STAT,1907,49,30-34,1956,0.07459114734171242
STAT,1843,52,20-24,1895,4.957718400391029E-4
SIM,1917,29,45-49,1946,4
STAT,1802,54,25-29,1856,0.009961126191445365
STAT,1887,34,30-34,1921,18.2914527631641
SIM,1831,30,25-29,1861,18
SIM,1863,23,na,1886,1987
STAT,1810,47,na,1857,1238.631389064631
STAT,1920,37,na,1957,3891.3272577663834
STAT,1937,31,35-39,1968,8.546037347926609
SIM,1870,16,30-34,1886,2
STAT,1940,24,35-39,1964,9.055264748495542
SIM,1836,34,25-29,1870,17
STAT,1824,51,40-44,1875,0.01260289222453137
SIM,1936,25,30-34,1961,43
SIM,1885,17,20-24,1902,17
STAT,1890,21,25-29,1911,66.31633676437623
SIM,1895,34,30-34,1929,30
STAT,1830,61,na,1891,1127.8071785800182
SIM,1912,45,na,1957,3309
STAT,1780,91,na,1871,14.665552330148646
STAT,1895,25,25-29,1920,52.45182738961637
STAT,1901,34,25-29,1935,13.428264004700178
STAT,1906,38,25-29,1944,0.8508135465943613
SIM,1844,16,20-24,1860,11
STAT,1838,51,35-39,1889,0.005864062117156871
STAT,1945,23,40-44,1968,3.480136571615055
SIM,1789,68,na,1857,616
SIM,1913,18,20-24,1931,27
STAT,1819,46,na,1865,1441.3615643536084
STAT,1835,23,45-49,1858,0.5857203994164389
STAT,1891,34,50-100,1925,1.0617220727194456
SIM,1904,39,45-49,1943,3
SIM,1859,89,na,1948,63
STAT,1874,49,25-29,1923,0.054436047286513405
STAT,1919,23,30-34,1942,29.639655373252943
STAT,1836,39,45-49,1875,1.551972539070085
STAT,1923,31,40-44,1954,4.255401995171981
SIM,1874,44,50-100,1918,3
STAT,1840,24,30-34,1864,14.652796613264028
STAT,1868,28,50-100,1896,0.5745521226613005
SIM,1937,9,na,1946,3557
STAT,1904,25,45-49,1929,1.514730531448424
STAT,1864,67,na,1931,1334.7086837640657
STAT,1878,32,30-34,1910,17.189451448020478
SIM,1927,23,30-34,1950,35
STAT,1876,21,40-44,1897,2.039947668446594
SIM,1881,29,20-24,1910,8
SIM,1845,36,25-29,1881,3
STAT,1905,22,25-29,1927,78.16856177920128
STAT,1870,67,na,1937,1469.118515841821
STAT,1866,44,50-100,1910,0.9080839080828632
SIM,1844,39,45-49,1883,1
SIM,1864,40,30-34,1904,4
SIM,1867,28,25-29,1895,47
STAT,1872,36,45-49,1908,1.8980744410747363
SIM,1899,8,na,1907,3436
SIM,1928,29,na,1957,4329
SIM,1802,55,na,1857,1036
STAT,1890,81,na,1971,1061.8265160461708
STAT,1936,16,25-29,1952,39.28950664647846
SIM,1886,32,30-34,1918,23
STAT,1920,40,20-24,1960,0.01847701457986961
SIM,1857,23,na,1880,2088
SIM,1804,84,na,1888,105
STAT,1885,66,na,1951,1543.363364896291
SIM,1897,29,na,1926,3034
STAT,1837,36,25-29,1873,2.298821880623515
STAT,1862,16,30-34,1878,1.483193676323078
STAT,1935,36,na,1971,4974.302294901737
STAT,1781,107,na,1888,0.008012533024102538
SIM,1918,21,30-34,1939,42
SIM,1944,16,25-29,1960,54
SIM,1828,43,30-34,1871,3
SIM,1880,36,45-49,1916,3
STAT,1859,28,25-29,1887,32.122731820810216
STAT,1880,35,30-34,1915,5.358322198627808
STAT,1958,12,na,1970,4872.927397204649
STAT,1843,36,na,1879,1706.493614038011
STAT,1914,48,30-34,1962,0.083291318655669
STAT,1866,27,20-24,1893,10.221863614700014
STAT,1885,44,20-24,1929,0.14752668997031834
STAT,1879,33,40-44,1912,4.270365388386352
SIM,1926,15,15-19,1941,38
SIM,1926,11,na,1937,4528
SIM,1934,30,na,1964,4785
SIM,1888,20,na,1908,2661
STAT,1882,43,40-44,1925,2.0515167389716993
STAT,1827,73,na,1900,686.0836147880151
SIM,1925,22,45-49,1947,1
STAT,1877,25,30-34,1902,24.844030389923844
STAT,1926,20,45-49,1946,1.2990191506358653
SIM,1785,77,na,1862,305
SIM,1841,43,45-49,1884,4
SIM,1899,35,50-100,1934,1
STAT,1843,34,15-19,1877,0.11326067046670686
STAT,1845,42,25-29,1887,0.4627329392939899
STAT,1866,39,15-19,1905,0.04843622156432928
STAT,1865,46,45-49,1911,0.2026525577406982
SIM,1830,81,na,1911,315
SIM,1945,20,20-24,1965,113
SIM,1836,25,35-39,1861,7
STAT,1769,94,na,1863,3.071883912653554
SIM,1865,29,20-24,1894,9
SIM,1885,25,30-34,1910,30
STAT,1929,21,25-29,1950,110.677681121546
SIM,1928,23,25-29,1951,111
STAT,1861,18,30-34,1879,1.4305121446152722
SIM,1800,83,na,1883,106
STAT,1856,48,45-49,1904,0.17176466819587397
SIM,1834,95,na,1929,8
STAT,1824,50,40-44,1874,0.012856114647890911
STAT,1870,16,30-34,1886,1.500042959092604
SIM,1853,22,30-34,1875,18
SIM,1890,43,40-44,1933,7
SIM,1915,49,50-100,1964,2
SIM,1878,35,40-44,1913,7
STAT,1836,44,25-29,1880,0.4821827432399903
STAT,1820,34,20-24,1854,8.07238846767416
SIM,1887,33,40-44,1920,5
STAT,1815,52,40-44,1867,0.022749293310259554
STAT,1818,37,na,1855,1480.5850116874553
SIM,1909,31,na,1940,3462
STAT,1896,45,35-39,1941,0.0995141090532044
STAT,1873,45,40-44,1918,0.16566449800750632
SIM,1870,31,20-24,1901,2
SIM,1826,76,na,1902,480
SIM,1871,26,40-44,1897,3
SIM,1917,30,50-100,1947,1
STAT,1863,38,35-39,1901,5.834490876929549
STAT,1852,72,na,1924,915.5814523399476
STAT,1863,26,40-44,1889,2.5013338507941367
STAT,1854,28,40-44,1882,2.230724888352363
SIM,1862,28,40-44,1890,2
STAT,1847,50,35-39,1897,0.006439611516797007
STAT,1838,52,35-39,1890,0.005749067859039426
STAT,1813,44,30-34,1857,3.31334462499151
SIM,1951,10,na,1961,4294
SIM,1821,44,30-34,1865,1
SIM,1900,18,na,1918,3355
STAT,1872,36,35-39,1908,6.734397287423236
STAT,1881,53,na,1934,1933.4447324343248
SIM,1793,96,na,1889,6
STAT,1885,67,na,1952,1492.710179260395
STAT,1845,22,30-34,1867,15.64765509620273
SIM,1917,50,na,1967,3560
STAT,1822,42,30-34,1864,1.6732814601589818
STAT,1846,29,45-49,1875,0.9819960431720864
STAT,1856,86,na,1942,163.5400091355941
STAT,1872,24,40-44,1896,1.962208712289099
SIM,1871,38,35-39,1909,12
STAT,1895,16,35-39,1911,0.6774492174532839
SIM,1894,23,30-34,1917,25
STAT,1835,28,30-34,1863,20.73842806590893
SIM,1892,15,20-24,1907,23
SIM,1936,22,20-24,1958,83
SIM,1938,30,30-34,1968,18
STAT,1886,18,35-39,1904,0.5461279412819373
STAT,1837,36,40-44,1873,3.495105971314007
STAT,1892,37,na,1929,2787.7107227601687
STAT,1875,37,15-19,1912,0.05452690340896729
STAT,1879,53,35-39,1932,0.008376578219770874
STAT,1889,19,15-19,1908,6.884081733638386
STAT,1880,22,25-29,1902,57.0129002967307
STAT,1858,28,25-29,1886,31.844010096368276
STAT,1825,38,15-19,1863,0.06761084257630806
STAT,1853,19,35-39,1872,0.4936647456751618
STAT,1859,37,30-34,1896,4.007259018676448
STAT,1861,38,25-29,1899,2.250354966639404
SIM,1919,30,20-24,1949,2
STAT,1899,46,15-19,1945,2.9288933182974885E-4
SIM,1842,16,20-24,1858,13
SIM,1877,26,35-39,1903,11
STAT,1877,48,na,1925,2176.9948396993896
STAT,1894,37,25-29,1931,3.4954877914370655
STAT,1843,47,20-24,1890,0.008067573086091183
STAT,1857,29,20-24,1886,8.874183298550022
SIM,1870,53,50-100,1923,1
STAT,1871,37,30-34,1908,4.999529287582215
SIM,1919,25,25-29,1944,80
STAT,1792,70,na,1862,642.644844501256
STAT,1881,85,na,1966,482.9444344438517
SIM,1910,28,na,1938,3396
STAT,1844,43,20-24,1887,0.11152695675830882
SIM,1897,19,15-19,1916,6
STAT,1856,53,40-44,1909,0.007635106464017203
STAT,1816,51,45-49,1867,0.03348160345518312
SIM,1827,32,30-34,1859,19
STAT,1827,46,25-29,1873,0.05338920811074723
STAT,1848,67,na,1915,1177.9088314518208
SIM,1937,21,25-29,1958,95
STAT,1873,34,na,1907,2266.7842563962
SIM,1843,28,30-34,1871,24
SIM,1929,15,40-44,1944,3
STAT,1833,43,45-49,1876,1.098521435285682
STAT,1886,23,30-34,1909,17.7201374671136
STAT,1827,51,20-24,1878,6.64719622053767E-4
STAT,1859,49,25-29,1908,0.042404637002777364
STAT,1878,54,30-34,1932,0.005699250254594604
STAT,1917,22,45-49,1939,1.1297245824010982
STAT,1831,35,35-39,1866,5.553556600433541
STAT,1881,17,45-49,1898,0.059613742630977025
STAT,1871,43,na,1914,2152.448055167841
SIM,1876,27,30-34,1903,32
SIM,1806,88,na,1894,45
STAT,1876,46,20-24,1922,0.01174531073973988
STAT,1823,100,na,1923,0.5681724099143998
STAT,1882,38,45-49,1920,1.8223628872469382
STAT,1808,46,15-19,1854,0.0015446795476167937
SIM,1821,39,35-39,1860,10
SIM,1890,30,35-39,1920,14
STAT,1867,38,na,1905,2079.5695637824615
SIM,1890,38,45-49,1928,2
SIM,1902,31,50-100,1933,1
STAT,1833,26,na,1859,1761.6577442224564
SIM,1840,44,40-44,1884,5
SIM,1939,32,50-100,1971,1
STAT,1892,29,15-19,1921,0.5330067500795168
STAT,1894,42,20-24,1936,0.013372421103142594
STAT,1895,49,35-39,1944,0.09523064905430234
SIM,1820,52,50-100,1872,1
STAT,1928,22,20-24,1950,131.1506359305462
STAT,1818,108,na,1926,8.99557105931734E-4
STAT,1850,40,40-44,1890,1.6015660823214508
STAT,1859,41,15-19,1900,0.010430462769145325
STAT,1902,64,na,1966,2555.8460589060955
SIM,1866,28,25-29,1894,44
STAT,1877,45,25-29,1922,0.05700696018904648
STAT,1882,30,35-39,1912,9.378677130388652
STAT,1830,39,35-39,1869,5.591544998602875
STAT,1837,53,30-34,1890,0.0038012428153662765
SIM,1856,18,15-19,1874,7
SIM,1872,34,35-39,1906,11
SIM,1901,67,na,1968,2396
STAT,1873,22,50-100,1895,0.390709891951038
STAT,1894,17,30-34,1911,1.9350363456912674
SIM,1872,25,45-49,1897,3
STAT,1899,26,20-24,1925,15.237333747308016
STAT,1818,48,25-29,1866,0.12097244248401365
SIM,1830,38,na,1868,1620
SIM,1863,76,na,1939,760
STAT,1847,18,na,1865,2100.182717779822
SIM,1938,12,na,1950,3530
STAT,1865,51,40-44,1916,0.00905760103217478
SIM,1874,42,45-49,1916,1
STAT,1835,48,25-29,1883,0.038150582315644326
SIM,1873,18,15-19,1891,4
STAT,1832,44,40-44,1876,1.6208330895891796
SIM,1855,57,na,1912,1580
SIM,1861,36,25-29,1897,2
STAT,1855,37,na,1892,1674.2202296097
SIM,1852,26,30-34,1878,25
SIM,1877,39,40-44,1916,6
STAT,1771,105,na,1876,0.014459147326088675
SIM,1815,92,na,1907,25
STAT,1896,28,45-49,1924,1.3804327521882227
SIM,1822,43,35-39,1865,1
SIM,1881,49,50-100,1930,2
SIM,1831,55,na,1886,1258
SIM,1837,60,na,1897,1216
STAT,1805,50,30-34,1855,0.02274317231240322
STAT,1861,30,15-19,1891,0.11275853864372531
STAT,1876,33,15-19,1909,0.13840403287700057
STAT,1850,35,45-49,1885,1.4574640780501535
SIM,1895,37,50-100,1932,1
STAT,1854,15,35-39,1869,0.47521666689536685
STAT,1829,37,45-49,1866,1.8087608557612826
STAT,1869,39,40-44,1908,3.9659233219501133
STAT,1895,46,30-34,1941,0.06744023907198932
STAT,1865,18,15-19,1883,5.2056072579518435
STAT,1872,92,na,1964,103.72557696651839
SIM,1896,71,na,1967,2002
STAT,1838,32,40-44,1870,3.6178725457713496
STAT,1864,25,45-49,1889,0.9448359591104047
STAT,1805,62,na,1867,958.3454238830199
STAT,1813,81,na,1894,222.54982658473907
STAT,1855,32,40-44,1887,3.1378943911794184
STAT,1876,29,30-34,1905,24.40199389226294
STAT,1844,108,na,1952,0.0012721754274632989
SIM,1826,28,30-34,1854,22
STAT,1849,53,50-100,1902,0.011143232479205139
STAT,1948,21,35-39,1969,10.217075334589289
SIM,1828,39,45-49,1867,1
STAT,1860,26,15-19,1886,0.3540355794047134
SIM,1880,36,35-39,1916,16
SIM,1887,28,45-49,1915,1
SIM,1837,37,45-49,1874,1
STAT,1814,43,35-39,1857,6.121107751333263
STAT,1844,30,15-19,1874,0.12075639998885598
STAT,1884,18,na,1902,2351.024656796966
SIM,1883,30,50-100,1913,3
STAT,1859,54,20-24,1913,5.395770066013154E-4
SIM,1852,38,25-29,1890,2
SIM,1879,16,na,1895,2540
SIM,1893,19,30-34,1912,4
STAT,1809,76,na,1885,391.7551940489944
STAT,1937,15,25-29,1952,40.01160770718395
STAT,1869,43,25-29,1912,0.5834499622699094
SIM,1843,88,na,1931,66
STAT,1857,52,45-49,1909,0.010755072403781912
STAT,1871,15,35-39,1886,0.5242101661420805
SIM,1888,52,na,1940,2444
STAT,1849,35,20-24,1884,0.6038946059531293
STAT,1830,31,25-29,1861,8.931569056836912
SIM,1910,45,50-100,1955,2
STAT,1839,28,15-19,1867,0.37781353245880805
STAT,1853,36,25-29,1889,2.2017089308202094
STAT,1862,16,50-100,1878,0.045589960290203096
SIM,1867,101,na,1968,1
SIM,1841,38,50-100,1879,1
STAT,1840,46,40-44,1886,0.11475820229730006
SIM,1850,26,na,1876,1941
STAT,1881,34,35-39,1915,9.162899731423982
STAT,1879,28,45-49,1907,1.0940842154855108
STAT,1829,54,35-39,1883,0.005944988853743639
STAT,1821,33,25-29,1854,32.11269553448905
SIM,1835,26,30-34,1861,28
SIM,1945,15,25-29,1960,43
STAT,1864,47,40-44,1911,0.1434735549987525
SIM,1906,22,35-39,1928,8
STAT,1844,38,25-29,1882,2.0912737682245908
STAT,1932,29,50-100,1961,1.2303686325192849
SIM,1886,29,40-44,1915,4
SIM,1827,27,35-39,1854,9
STAT,1823,46,40-44,1869,0.21391222215702518
STAT,1930,28,na,1958,4497.701786802573
SIM,1776,84,na,1860,87
STAT,1867,104,na,1971,0.6887209767941205
STAT,1854,40,25-29,1894,0.4640897942880935
SIM,1874,46,50-100,1920,2
STAT,1855,27,45-49,1882,0.8224124006188712
STAT,1841,45,45-49,1886,0.16768078262976518
STAT,1891,41,40-44,1932,2.6408065995042778
SIM,1877,23,30-34,1900,18
STAT,1891,36,45-49,1927,2.3411640332313106
SIM,1836,38,40-44,1874,7
STAT,1818,40,15-19,1858,0.03479227713710726
STAT,1777,81,na,1858,169.9112468692387
SIM,1846,32,40-44,1878,3
SIM,1863,27,45-49,1890,1
STAT,1801,80,na,1881,249.35583123952568
STAT,1892,69,na,1961,1888.7382050769243
SIM,1864,40,35-39,1904,3
SIM,1913,27,50-100,1940,1
STAT,1881,51,25-29,1932,0.0032479300974610223
STAT,1885,31,15-19,1916,0.13464527675532154
SIM,1883,40,45-49,1923,4
STAT,1853,41,20-24,1894,0.12073291484541118
STAT,1860,91,na,1951,44.41756223003022
STAT,1890,37,40-44,1927,5.055866111091747
SIM,1861,16,30-34,1877,2
SIM,1884,29,30-34,1913,27
SIM,1893,39,25-29,1932,3
STAT,1845,25,35-39,1870,8.431363656291325
STAT,1819,52,25-29,1871,0.0064418297890514835
STAT,1848,18,15-19,1866,5.434297827208371
STAT,1890,24,35-39,1914,6.697587809977561
STAT,1851,36,15-19,1887,0.041253110242179196
STAT,1918,15,15-19,1933,9.405983787964558
SIM,1817,38,30-34,1855,4
SIM,1827,27,50-100,1854,1
STAT,1856,54,na,1910,1543.409216582164
STAT,1892,40,45-49,1932,1.7887689792824546
STAT,1895,29,40-44,1924,3.662964252086753
STAT,1797,58,na,1855,1010.7820899999999
STAT,1834,36,15-19,1870,0.043800490741233454
STAT,1875,40,45-49,1915,1.4679234861840027
SIM,1851,75,na,1926,715
STAT,1880,36,na,1916,2357.6931459988014
STAT,1929,31,na,1960,4540.82606918885
STAT,1885,39,25-29,1924,2.6838907144380193
SIM,1916,33,na,1949,3574
SIM,1862,15,35-39,1877,1
STAT,1881,47,40-44,1928,0.1555098420631916
STAT,1947,1,na,1948,4379.213207678253
STAT,1828,38,40-44,1866,3.9077542527495965
STAT,1838,27,45-49,1865,0.9482101262206266
STAT,1851,23,na,1874,1823.5405928901225
STAT,1840,33,35-39,1873,8.011120081926492
SIM,1901,7,na,1908,3436
STAT,1844,26,30-34,1870,21.564845270760028
STAT,1939,31,35-39,1970,8.813545143024879
SIM,1882,41,40-44,1923,5
STAT,1805,94,na,1899,6.9766699189339505
STAT,1854,4,na,1858,2281.3019858738508
STAT,1829,42,40-44,1871,1.918694133117267
SIM,1908,14,na,1922,3580
STAT,1874,41,40-44,1915,2.1808771816424524
STAT,1942,29,na,1971,3710.69997164545
STAT,1871,2,na,1873,3107.1585878437304
STAT,1937,20,20-24,1957,102.36423687495551
SIM,1855,89,na,1944,49
SIM,1873,0,na,1873,3354
STAT,1891,26,50-100,1917,0.7502262348307219
STAT,1824,45,45-49,1869,0.2959896098940473
STAT,1835,40,15-19,1875,0.010804912050009892
SIM,1856,2,na,1858,2661
STAT,1807,50,40-44,1857,0.04016410943566136
SIM,1878,44,50-100,1922,2
SIM,1883,17,20-24,1900,20
STAT,1818,53,20-24,1871,0.0014805805700784263
STAT,1946,17,50-100,1963,0.3925690054073481
STAT,1868,87,na,1955,158.7991601501255
SIM,1829,41,na,1870,1475
SIM,1842,39,na,1881,1641
STAT,1954,15,25-29,1969,50.632421570664775
SIM,1831,48,50-100,1879,4
STAT,1864,73,na,1937,1000.0542229198398
STAT,1886,43,25-29,1929,0.6361860702545402
STAT,1940,3,na,1943,3874.5679107515357
SIM,1868,33,30-34,1901,24
SIM,1942,1,na,1943,3943
STAT,1854,45,30-34,1899,0.06994943233764549
SIM,1928,19,40-44,1947,2
STAT,1840,30,30-34,1870,14.248711521430312
STAT,1813,47,35-39,1860,0.3827410362420882
SIM,1830,25,40-44,1855,2
STAT,1888,43,35-39,1931,2.007075650389417
STAT,1909,20,45-49,1929,0.9938463267308413
SIM,1871,20,na,1891,2266
SIM,1943,15,15-19,1958,39
STAT,1896,33,40-44,1929,5.388024214684019
SIM,1875,18,25-29,1893,9
STAT,1886,35,25-29,1921,2.900467724887887
STAT,1849,27,20-24,1876,10.428065502145209
SIM,1905,49,na,1954,2971
STAT,1825,41,45-49,1866,1.667393369553473
STAT,1834,109,na,1943,4.4108365093742754E-4
STAT,1834,75,na,1909,638.2355185836376
SIM,1894,35,25-29,1929,6
SIM,1901,35,na,1936,3162
SIM,1945,23,25-29,1968,83
STAT,1830,44,30-34,1874,0.869755349100353
STAT,1870,28,25-29,1898,39.065323499061954
STAT,1882,46,45-49,1928,0.21743240904288397
STAT,1869,51,25-29,1920,0.0032571227108163917
SIM,1893,27,30-34,1920,35
STAT,1876,41,15-19,1917,0.01353944680327581
STAT,1937,23,25-29,1960,84.94727074738246
SIM,1810,93,na,1903,9
STAT,1867,43,15-19,1910,0.01216190265186934
STAT,1868,55,na,1923,1863.7173178687285
SIM,1792,79,na,1871,240
SIM,1857,27,20-24,1884,9
STAT,1873,15,45-49,1888,0.06333027079667744
STAT,1864,17,45-49,1881,0.05689597604819271
SIM,1880,20,25-29,1900,63
STAT,1864,41,na,1905,1954.803844522668
SIM,1871,35,30-34,1906,4
STAT,1873,48,45-49,1921,0.22327387215955272
SIM,1844,73,na,1917,745
SIM,1848,87,na,1935,114
SIM,1867,90,na,1957,99
STAT,1761,98,na,1859,0.6878372194672131
SIM,1870,22,30-34,1892,22
STAT,1833,58,na,1891,1213.3076903644378
STAT,1910,27,50-100,1937,0.9080295372191913
SIM,1870,34,25-29,1904,9
SIM,1771,85,na,1856,64
STAT,1892,32,45-49,1924,2.063378155010174
SIM,1873,30,35-39,1903,12
STAT,1928,30,20-24,1958,2.884418453491981
SIM,1886,29,na,1915,2327
STAT,1819,44,25-29,1863,1.2597913679065458
STAT,1893,25,15-19,1918,0.5472357998147408
SIM,1882,36,45-49,1918,2
STAT,1844,51,20-24,1895,5.149546217450364E-4
SIM,1917,20,45-49,1937,1
STAT,1862,47,30-34,1909,0.07782264167690475
SIM,1868,28,35-39,1896,9
STAT,1793,76,na,1869,335.2022160087742
SIM,1859,35,30-34,1894,5
SIM,1880,24,na,1904,2353
SIM,1884,38,na,1922,2295
STAT,1863,24,na,1887,1971.126975562777
SIM,1922,29,na,1951,3936
STAT,1841,50,40-44,1891,0.007362185985646389
SIM,1891,19,20-24,1910,16
STAT,1935,15,15-19,1950,58.8824606751597
STAT,1909,0,na,1909,4160.1444546250095
STAT,1873,40,35-39,1913,1.7524733293641206
STAT,1853,16,30-34,1869,1.4596184168158084
STAT,1878,29,40-44,1907,2.928115924296211
STAT,1861,35,20-24,1896,0.611242320204421
SIM,1841,40,40-44,1881,2
STAT,1836,41,20-24,1877,0.12392209168510357
SIM,1867,37,30-34,1904,9
STAT,1835,53,20-24,1888,4.692489751376961E-4
STAT,1917,30,na,1947,3771.4876045013893
STAT,1838,89,na,1927,70.52769803250192
STAT,1883,19,20-24,1902,16.332343522376032
STAT,1943,20,45-49,1963,1.1316770724970595
SIM,1846,21,na,1867,1899
SIM,1817,40,na,1857,1504
STAT,1826,34,15-19,1860,0.17174230556290976
SIM,1935,9,na,1944,5069
STAT,1876,49,25-29,1925,0.0550440895690355
SIM,1833,41,45-49,1874,2
SIM,1819,38,40-44,1857,3
STAT,1910,51,na,1961,3196.930381301728
SIM,1935,29,50-100,1964,1
STAT,1867,18,25-29,1885,5.108660505323496
STAT,1919,32,20-24,1951,2.4860330386627223
SIM,1928,20,20-24,1948,115
SIM,1881,40,35-39,1921,3
SIM,1919,22,20-24,1941,110
SIM,1927,32,20-24,1959,2
SIM,1868,49,50-100,1917,3
SIM,1936,30,20-24,1966,2
STAT,1894,45,25-29,1939,0.039839178728597456
STAT,1852,24,15-19,1876,2.8006292723373543
SIM,1814,75,na,1889,386
STAT,1821,46,30-34,1867,0.15494488587049238
SIM,1810,61,na,1871,962
SIM,1867,38,50-100,1905,1
SIM,1842,19,25-29,1861,8
STAT,1804,54,30-34,1858,0.02020415509014645
STAT,1815,40,na,1855,1460.7613898843053
STAT,1814,40,30-34,1854,4.3472020387671835
STAT,1923,38,30-34,1961,1.9929573069836561
STAT,1878,65,na,1943,1663.802908932454
SIM,1835,69,na,1904,917
SIM,1863,32,40-44,1895,5
STAT,1875,17,20-24,1892,17.21466411651335
SIM,1931,38,30-34,1969,1
STAT,1812,64,na,1876,906.11728737852
STAT,1885,27,30-34,1912,23.712373983299976
SIM,1849,28,25-29,1877,41
SIM,1863,44,35-39,1907,1
SIM,1919,33,25-29,1952,10
STAT,1840,16,45-49,1856,0.05583174652448304
STAT,1877,42,20-24,1919,0.15543479129961732
STAT,1872,27,45-49,1899,1.0520979868976448
SIM,1861,10,na,1871,2385
STAT,1833,40,40-44,1873,1.7156425551490428
SIM,1843,56,na,1899,1418
SIM,1850,58,na,1908,1467
STAT,1945,22,20-24,1967,115.1276711323293
SIM,1924,33,50-100,1957,4
STAT,1877,50,20-24,1927,7.335042102683632E-4
STAT,1890,45,40-44,1935,0.19970143238692706
STAT,1818,36,30-34,1854,18.625198327650644
SIM,1824,45,50-100,1869,4
STAT,1832,31,35-39,1863,8.082082475644986
STAT,1800,63,na,1863,871.0032795590265
STAT,1871,45,30-34,1916,0.09171068956119886
STAT,1816,45,50-100,1861,0.5987535037973654
STAT,1920,22,50-100,1942,0.6910448152237434
STAT,1823,54,40-44,1877,0.011990984091475974
STAT,1804,77,na,1881,351.5170993201118
STAT,1827,54,25-29,1881,0.002735778355023886
SIM,1860,24,15-19,1884,2
STAT,1871,75,na,1946,965.7098578565639
SIM,1890,35,40-44,1925,4
SIM,1918,21,15-19,1939,4
STAT,1845,17,35-39,1862,0.49075507636540333
STAT,1847,25,45-49,1872,0.9983755814187923
STAT,1881,31,30-34,1912,15.998967390425898
SIM,1876,51,na,1927,2093
SIM,1938,33,35-39,1971,10
STAT,1817,95,na,1912,6.153732738451734
STAT,1875,89,na,1964,228.0584994265466
STAT,1895,41,25-29,1936,0.055168814958679695
SIM,1838,34,na,1872,1739
STAT,1870,20,15-19,1890,3.0756499855212938
STAT,1934,10,na,1944,5078.277712352401
STAT,1840,49,45-49,1889,0.15222984336727768
SIM,1826,36,30-34,1862,7
STAT,1893,33,15-19,1926,0.16988836459076215
STAT,1854,48,35-39,1902,0.09890929022231114
SIM,1836,22,30-34,1858,18
STAT,1836,32,30-34,1868,14.291472613293548
STAT,1860,34,15-19,1894,0.10822230241683993
SIM,1844,32,30-34,1876,12
STAT,1871,41,15-19,1912,0.01301323519501409
SIM,1839,44,50-100,1883,3
SIM,1865,35,na,1900,2103
SIM,1873,86,na,1959,232
STAT,1769,111,na,1880,9.464715685412197E-4
STAT,1819,54,na,1873,1266.580353939143
STAT,1849,52,na,1901,1605.9962567573345
STAT,1938,24,na,1962,3412.0374011428835
STAT,1870,33,20-24,1903,2.494518715751074
SIM,1869,49,na,1918,2014
STAT,1820,37,25-29,1857,6.623141786448909
SIM,1878,38,45-49,1916,1
STAT,1866,42,45-49,1908,1.3024489894887028
SIM,1822,40,30-34,1862,1
SIM,1855,25,45-49,1880,5
STAT,1835,45,20-24,1880,0.009076334438821387
STAT,1846,76,na,1922,702.6928975692963
STAT,1880,27,30-34,1907,25.07953183565674
STAT,1880,18,40-44,1898,0.18168227410135812
STAT,1865,90,na,1955,67.50851115702105
STAT,1842,62,na,1904,1323.6105222454996
STAT,1826,42,15-19,1868,0.013492975402515386
STAT,1832,47,45-49,1879,0.1686364411487529
SIM,1856,74,na,1930,853
SIM,1850,18,20-24,1868,17
STAT,1773,99,na,1872,0.2895502690988201
STAT,1828,50,25-29,1878,0.002881525278138303
SIM,1799,105,na,1904,1
SIM,1925,30,45-49,1955,1
SIM,1861,33,20-24,1894,2
SIM,1852,60,na,1912,1437
STAT,1924,20,35-39,1944,10.558545159116052
STAT,1872,53,25-29,1925,0.003302441364236165
STAT,1913,16,na,1929,3739.823141083297
STAT,1827,29,35-39,1856,14.242929188521213
STAT,1863,43,30-34,1906,0.9462099011155033
STAT,1882,35,40-44,1917,4.059873461247218
STAT,1891,20,35-39,1911,6.861094000351161
STAT,1813,101,na,1914,0.23483823404975793
SIM,1822,94,na,1916,3
STAT,1840,41,35-39,1881,1.2556171650335495
SIM,1844,25,50-100,1869,1
SIM,1899,9,na,1908,3433
SIM,1930,16,na,1946,4540
SIM,1898,28,20-24,1926,15
STAT,1815,44,40-44,1859,5.25044198782339
SIM,1797,78,na,1875,259
SIM,1837,34,40-44,1871,3
STAT,1867,35,15-19,1902,0.05028656408492928
STAT,1799,92,na,1891,13.29666135643681
STAT,1839,74,na,1913,738.8952800662667
SIM,1835,29,35-39,1864,12
SIM,1899,68,na,1967,2275
SIM,1909,19,30-34,1928,5
SIM,1871,43,30-34,1914,4
STAT,1830,40,15-19,1870,0.011047252327305147
STAT,1819,86,na,1905,117.12731252946912
SIM,1823,44,40-44,1867,5
STAT,1849,38,25-29,1887,2.186424702333197
SIM,1877,33,50-100,1910,4
STAT,1890,15,50-100,1905,0.05684684246637611
SIM,1857,38,25-29,1895,1
STAT,1831,27,35-39,1858,8.299624156793591
STAT,1887,47,35-39,1934,0.14724611776107152
STAT,1836,24,30-34,1860,15.0051761377489
SIM,1848,102,na,1950,1
SIM,1845,36,40-44,1881,9
SIM,1891,40,na,1931,2741
STAT,1851,28,15-19,1879,0.3793875588857815
STAT,1818,69,na,1887,778.1388720665454
STAT,1918,23,15-19,1941,5.406971668625468
STAT,1834,44,15-19,1878,0.010070550270800218
SIM,1879,91,na,1970,153
SIM,1895,54,na,1949,2670
SIM,1840,31,35-39,1871,13
STAT,1869,40,20-24,1909,0.14681058477272527
STAT,1814,55,na,1869,1232.713400989231
SIM,1839,19,na,1858,2013
STAT,1884,18,50-100,1902,0.04560533546333331
STAT,1876,38,20-24,1914,0.7486205462994595
STAT,1884,48,20-24,1932,0.011059122527565685
SIM,1820,35,25-29,1855,3
STAT,1856,24,50-100,1880,0.3440928201919314
STAT,1829,34,40-44,1863,4.098613315542972
STAT,1946,11,na,1957,4116.579809001348
SIM,1832,37,45-49,1869,1
STAT,1848,54,45-49,1902,0.010487024769937084
SIM,1926,23,15-19,1949,5
STAT,1896,25,40-44,1921,3.7628780374829933
SIM,1926,43,na,1969,4271
STAT,1833,51,45-49,1884,0.009360220202545923
SIM,1844,24,30-34,1868,21
STAT,1868,27,30-34,1895,22.697506761445737
STAT,1888,32,na,1920,2664.192715785293
SIM,1823,34,50-100,1857,1
STAT,1838,57,na,1895,1349.1660807705762
SIM,1858,22,na,1880,2015
SIM,1873,35,50-100,1908,1
STAT,1875,45,15-19,1920,3.9227777869011164E-4
STAT,1880,30,25-29,1910,10.282963544526952
SIM,1858,39,30-34,1897,5
STAT,1851,31,45-49,1882,1.3192397913026077
STAT,1872,28,35-39,1900,9.110921416158869
SIM,1863,24,40-44,1887,2
SIM,1886,37,40-44,1923,7
STAT,1846,46,35-39,1892,0.10413335003040118
STAT,1962,7,na,1969,4756.4903719312015
SIM,1964,5,na,1969,4608
STAT,1872,19,45-49,1891,0.06156617312003935
SIM,1821,77,na,1898,504
STAT,1896,42,30-34,1938,0.09948673179481317
SIM,1872,37,na,1909,2215
STAT,1775,102,na,1877,0.07606740700259007
STAT,1857,37,20-24,1894,0.5743294367512197
STAT,1874,44,45-49,1918,1.425092842614634
STAT,1863,88,na,1951,113.8104703062644
STAT,1891,28,45-49,1919,1.293133547179776
STAT,1888,26,45-49,1914,1.2438499064656847
STAT,1834,43,na,1877,1551.3435582542102
SIM,1830,42,30-34,1872,1
SIM,1851,43,na,1894,1701
STAT,1882,47,50-100,1929,0.2245845640017863
STAT,1914,25,50-100,1939,0.9543733364430323
STAT,1807,53,45-49,1860,0.05211637024197502
STAT,1931,18,50-100,1949,0.4620443629693112
STAT,1862,22,30-34,1884,14.728130182110835
SIM,1951,20,45-49,1971,1
SIM,1951,6,na,1957,4296
STAT,1851,87,na,1938,126.73440638896423
SIM,1888,41,35-39,1929,1
STAT,1917,30,45-49,1947,1.569178857221987
SIM,1829,35,45-49,1864,2
SIM,1896,26,45-49,1922,1
SIM,1818,48,50-100,1866,1
STAT,1829,51,30-34,1880,0.004793829335694346
STAT,1791,103,na,1894,0.026572769382565413
SIM,1880,88,na,1968,375
STAT,1852,32,15-19,1884,0.10689642678574382
STAT,1901,15,na,1916,3355.2314569144287
STAT,1905,29,na,1934,3235.4929657165794
STAT,1869,33,50-100,1902,0.8349996319674711
STAT,1877,15,50-100,1892,0.04823189560865647
STAT,1878,37,40-44,1915,4.30974169498428
SIM,1814,41,35-39,1855,1
SIM,1949,16,20-24,1965,136
STAT,1841,42,40-44,1883,1.611348078387859
STAT,1855,24,40-44,1879,1.7052007521860097
SIM,1880,28,35-39,1908,14
STAT,1822,42,na,1864,1400.80617713376
STAT,1826,56,na,1882,1192.8225397208705
STAT,1859,16,25-29,1875,4.97515256740606
STAT,1856,45,40-44,1901,0.1274457564464195
STAT,1845,34,25-29,1879,8.440733347911
STAT,1848,51,40-44,1899,0.00786008287246005
SIM,1793,64,na,1857,802
SIM,1878,27,40-44,1905,2
STAT,1897,68,na,1965,2166.487175554927
STAT,1863,34,40-44,1897,3.564432191533414
SIM,1906,30,35-39,1936,9
STAT,1842,18,20-24,1860,16.38945732212933
STAT,1893,54,na,1947,2508.6871478025655
STAT,1895,30,20-24,1925,3.3558432797878774
SIM,1867,16,25-29,1883,6
SIM,1881,32,35-39,1913,9
STAT,1868,47,25-29,1915,0.05167526420292791
STAT,1873,32,35-39,1905,9.702888493424037
STAT,1880,38,35-39,1918,7.009229986369548
STAT,1814,51,35-39,1865,0.025661393823946083
SIM,1930,3,na,1933,4975
STAT,1881,42,35-39,1923,1.6505258542925787
STAT,1853,44,25-29,1897,0.47942211307564186
STAT,1850,110,na,1960,4.6148084152559997E-4
SIM,1898,39,25-29,1937,1
STAT,1831,52,25-29,1883,0.002219691343550124
STAT,1889,17,na,1906,2945.500432590176
STAT,1900,45,25-29,1945,0.04300436127156775
STAT,1842,19,na,1861,2109.56366125595
SIM,1853,34,25-29,1887,10
SIM,1891,31,40-44,1922,5
SIM,1894,32,20-24,1926,2
STAT,1877,16,na,1893,2481.0074288718115
STAT,1924,32,na,1956,4168.304202733709
STAT,1835,37,20-24,1872,0.6065482938670947
STAT,1830,47,35-39,1877,0.10490470022732074
SIM,1850,26,20-24,1876,14
SIM,1837,71,na,1908,810
STAT,1809,46,30-34,1855,0.27805127434490723
SIM,1848,9,na,1857,2240
STAT,1896,17,40-44,1913,0.22820548286535736
SIM,1861,28,25-29,1889,46
STAT,1833,48,15-19,1881,2.5827841241126375E-4
STAT,1847,106,na,1953,0.008953370037142406
STAT,1899,18,20-24,1917,22.887735282397525
STAT,1916,13,na,1929,3952.2183447185926
STAT,1901,49,35-39,1950,0.1022471619393203
SIM,1852,34,30-34,1886,19
STAT,1919,35,25-29,1954,1.004844980003526
STAT,1853,28,25-29,1881,33.506190983295845
SIM,1866,73,na,1939,1023
STAT,1839,53,40-44,1892,0.0068967488379216586
SIM,1858,18,25-29,1876,6
STAT,1863,51,30-34,1914,0.004958377445491201
STAT,1846,30,25-29,1876,9.166128260615624
STAT,1896,36,45-49,1932,2.4992155812258727
SIM,1837,26,40-44,1863,3
STAT,1893,49,25-29,1942,0.03811262045524755
STAT,1844,22,15-19,1866,2.8607753612690936
SIM,1879,43,35-39,1922,4
STAT,1814,52,25-29,1866,0.010348220807184913
SIM,1923,46,na,1969,4144
SIM,1857,3,na,1860,2508
SIM,1835,37,35-39,1872,20
STAT,1883,50,45-49,1933,0.013634753207970442
SIM,1858,54,na,1912,1730
STAT,1895,38,30-34,1933,6.531344114965817
STAT,1952,15,15-19,1967,51.40466458854391
STAT,1869,72,na,1941,1155.7880932209077
SIM,1824,40,40-44,1864,3
STAT,1850,27,45-49,1877,0.9210563156720712
SIM,1852,22,15-19,1874,4
SIM,1895,38,45-49,1933,1
STAT,1869,47,40-44,1916,0.15594998141599334
SIM,1874,17,na,1891,2364
SIM,1963,4,na,1967,4694
STAT,1829,45,45-49,1874,0.19801858770534495
SIM,1854,38,35-39,1892,11
SIM,1865,7,na,1872,2485
STAT,1907,49,50-100,1956,0.18925191879959186
STAT,1946,17,40-44,1963,1.465591309915919
STAT,1842,26,20-24,1868,10.582195030808276
STAT,1922,20,na,1942,3979.7724503240142
STAT,1864,34,35-39,1898,8.453701586490643
SIM,1847,40,35-39,1887,8
STAT,1841,77,na,1918,595.9222528536948
STAT,1883,31,40-44,1914,4.033139671868547
STAT,1836,35,35-39,1871,5.739947263516408
STAT,1875,32,45-49,1907,1.6932769349753893
STAT,1893,41,15-19,1934,0.01661941799713545
SIM,1845,32,25-29,1877,16
STAT,1894,71,na,1965,1878.6870567679348
SIM,1927,15,30-34,1942,18
STAT,1887,38,45-49,1925,2.0960379312620248
STAT,1851,24,20-24,1875,58.35126342073093
STAT,1859,51,na,1910,1626.692421895747
SIM,1831,30,30-34,1861,18
STAT,1827,41,na,1868,1568.4694916794392
STAT,1890,21,30-34,1911,20.63468854750167
SIM,1882,33,40-44,1915,4
SIM,1854,30,25-29,1884,8
SIM,1919,16,35-39,1935,4
STAT,1870,40,50-100,1910,0.9889579669424362
STAT,1910,27,40-44,1937,4.252138294522937
SIM,1798,63,na,1861,847
STAT,1827,37,35-39,1864,7.341507828250079
STAT,1816,89,na,1905,48.9551184557573
STAT,1844,34,30-34,1878,14.202853166959754
STAT,1834,27,25-29,1861,34.42389322708799
SIM,1877,36,na,1913,2299
STAT,1849,39,15-19,1888,0.042202537604167235
SIM,1842,27,25-29,1869,42
SIM,1843,36,30-34,1879,6
STAT,1870,41,20-24,1911,0.14784773220742597
STAT,1894,28,35-39,1922,11.673042155881914
SIM,1941,26,50-100,1967,4
STAT,1847,17,45-49,1864,0.06012001601954155
STAT,1839,40,35-39,1879,1.432602358576471
STAT,1880,26,40-44,1906,2.9936247154333895
STAT,1837,32,25-29,1869,8.334597091793599
STAT,1844,10,na,1854,2134.0
SIM,1861,20,15-19,1881,3
SIM,1895,39,35-39,1934,17
STAT,1821,42,15-19,1863,0.023765457550347414
STAT,1841,88,na,1929,94.64494413504828
SIM,1954,17,40-44,1971,1
SIM,1844,35,35-39,1879,13
STAT,1809,47,20-24,1856,0.03386889623452238
SIM,1821,35,40-44,1856,6
SIM,1863,35,45-49,1898,1
STAT,1874,52,45-49,1926,0.013933151356609127
SIM,1838,42,35-39,1880,3
STAT,1899,16,na,1915,3277.180451206607
SIM,1861,27,35-39,1888,11
STAT,1857,40,50-100,1897,0.7950634273159765
SIM,1815,42,40-44,1857,3
STAT,1853,27,35-39,1880,8.459355653190649
STAT,1812,52,50-100,1864,0.04831519172862596
STAT,1855,52,35-39,1907,0.006085258799970529
STAT,1847,22,40-44,1869,1.8837410605741167
STAT,1835,28,50-100,1863,0.526815479437095
STAT,1884,50,na,1934,2038.4747518089348
SIM,1884,37,30-34,1921,6
STAT,1885,23,15-19,1908,3.0969056654765876
SIM,1927,35,25-29,1962,4
STAT,1826,40,50-100,1866,1.0746185231555048
STAT,1939,20,30-34,1959,27.286995712926185
SIM,1794,81,na,1875,157
STAT,1888,64,na,1952,1940.7871486839467
STAT,1860,59,na,1919,1489.6840738886106
STAT,1871,51,50-100,1922,0.014235256922022415
STAT,1870,36,25-29,1906,2.6811712879118845
STAT,1853,42,50-100,1895,0.7985343600922498
STAT,1862,39,na,1901,1883.8139153633026
SIM,1798,95,na,1893,5
SIM,1819,74,na,1893,554
STAT,1853,20,15-19,1873,2.9927645268889447
STAT,1887,39,35-39,1926,7.398624138314543
SIM,1862,37,30-34,1899,6
STAT,1783,77,na,1860,276.9017022694747
STAT,1937,31,25-29,1968,8.6435379247557
STAT,1886,32,20-24,1918,2.69741040596739
STAT,1870,24,30-34,1894,16.4043931260362
STAT,1825,34,20-24,1859,3.9198742068012393
SIM,1850,30,40-44,1880,8
STAT,1926,42,50-100,1968,0.1368147490901985
STAT,1898,38,20-24,1936,0.21164966647964897
STAT,1781,86,na,1867,66.56837695313342
STAT,1844,21,na,1865,1867.5034662497737
STAT,1853,33,20-24,1886,2.0848493489392914
SIM,1815,60,na,1875,1088
SIM,1816,41,45-49,1857,4
SIM,1893,23,15-19,1916,4
SIM,1898,8,na,1906,3273
STAT,1870,69,na,1939,1360.0623949539872
SIM,1859,27,30-34,1886,26
SIM,1895,31,25-29,1926,14
STAT,1890,40,35-39,1930,2.112531280407734
STAT,1890,48,45-49,1938,0.15182135448960485
STAT,1831,26,45-49,1857,0.9861130268074594
SIM,1896,28,na,1924,2991
STAT,1920,41,35-39,1961,0.21039792837922897
STAT,1834,54,50-100,1888,0.009237139636419622
STAT,1876,37,30-34,1913,5.2016934925278235
STAT,1799,81,na,1880,202.91109395287717
STAT,1829,26,40-44,1855,5.336195426467692
SIM,1894,16,na,1910,3200
STAT,1855,53,25-29,1908,0.002476634933530239
STAT,1841,21,35-39,1862,5.133259544009429
STAT,1906,38,30-34,1944,1.5749101906390688
SIM,1882,20,35-39,1902,8
STAT,1855,35,45-49,1890,1.4300786936416605
STAT,1885,29,50-100,1914,0.5980570292156242
STAT,1838,44,35-39,1882,1.2610668250673311
SIM,1847,70,na,1917,1015
SIM,1892,19,15-19,1911,6
STAT,1862,53,50-100,1915,0.012002906345635677
STAT,1876,41,50-100,1917,1.0357676047634046
STAT,1909,43,na,1952,3262.0921770037507
STAT,1819,41,20-24,1860,0.34695722152511255
STAT,1848,35,na,1883,1841.9137078238293
SIM,1927,28,na,1955,4228
SIM,1914,38,30-34,1952,2
SIM,1815,81,na,1896,287
STAT,1887,31,25-29,1918,10.86742961264172
STAT,1903,19,50-100,1922,0.06549939034901286
STAT,1822,50,30-34,1872,0.008015792965538887
STAT,1892,25,20-24,1917,13.975418328650672
STAT,1855,41,30-34,1896,0.8206815807177403
SIM,1923,14,na,1937,4450
SIM,1928,27,40-44,1955,7
STAT,1821,45,50-100,1866,0.39891491369092014
STAT,1863,18,40-44,1881,0.15652432298650962
STAT,1866,19,20-24,1885,15.669118866613355
STAT,1882,51,40-44,1933,0.009718189765435968
STAT,1846,37,45-49,1883,1.5440493940138824
STAT,1875,28,25-29,1903,40.93071527251089
STAT,1911,43,35-39,1954,0.18048067714265545
STAT,1906,14,na,1920,3541.7808041113813
STAT,1911,38,50-100,1949,0.3812108997524665
STAT,1845,31,20-24,1876,2.2980213094112227
STAT,1920,49,45-49,1969,0.22562915656746824
SIM,1947,20,30-34,1967,37
SIM,1880,24,40-44,1904,3
STAT,1879,71,na,1950,1319.948548190928
SIM,1945,24,50-100,1969,1
SIM,1904,32,na,1936,3314
STAT,1846,18,40-44,1864,0.16941247429717352
STAT,1863,46,35-39,1909,0.11639194385684397
STAT,1832,51,50-100,1883,0.009684338148509676
STAT,1862,31,20-24,1893,2.1922330355121256
SIM,1864,18,na,1882,2266
SIM,1908,46,na,1954,3104
STAT,1875,7,na,1882,2622.188282950103
STAT,1894,21,15-19,1915,4.017270338942373
SIM,1862,91,na,1953,42
STAT,1861,26,30-34,1887,20.067852030392118
STAT,1845,50,25-29,1895,0.002542448931251741
STAT,1887,44,30-34,1931,1.1984383606671662
STAT,1941,20,35-39,1961,9.198778995777046
STAT,1795,100,na,1895,0.22111428909543748
STAT,1919,40,20-24,1959,0.01812995202388771
SIM,1939,20,45-49,1959,1
SIM,1905,17,na,1922,3414
SIM,1846,44,35-39,1890,8
STAT,1898,53,na,1951,2708.5292445797563
STAT,1831,78,na,1909,456.2089181245079
STAT,1892,42,50-100,1934,1.2485080139560027
SIM,1885,21,15-19,1906,5
SIM,1841,22,na,1863,1791
STAT,1892,5,na,1897,3100.8713454500885
SIM,1876,38,35-39,1914,14
SIM,1855,22,40-44,1877,6
STAT,1884,1,na,1885,3102.4973000671134
SIM,1864,32,35-39,1896,11
STAT,1811,44,20-24,1855,0.5555254731568571
SIM,1845,36,na,1881,1742
SIM,1804,97,na,1901,4
STAT,1880,68,na,1948,1521.9852121564409
SIM,1872,31,30-34,1903,24
STAT,1865,30,35-39,1895,8.741166586268186
STAT,1867,3,na,1870,2815.5767057129488
SIM,1885,17,30-34,1902,4
SIM,1874,19,20-24,1893,17
STAT,1830,93,na,1923,17.638864040678513
STAT,1838,20,50-100,1858,0.36035363334568893
SIM,1853,31,20-24,1884,5
STAT,1828,49,45-49,1877,0.18611127295939234
SIM,1780,78,na,1858,256
SIM,1860,16,15-19,1876,5
SIM,1933,38,40-44,1971,3
STAT,1855,50,50-100,1905,0.010886646051795349
STAT,1827,43,20-24,1870,0.14975470147842238
STAT,1872,20,25-29,1892,54.56829405107152
STAT,1867,30,50-100,1897,0.819314574825843
STAT,1873,41,25-29,1914,0.6180438521340599
STAT,1842,33,45-49,1875,1.509789308258545
STAT,1899,27,na,1926,3089.122091900467
STAT,1897,33,35-39,1930,12.740364582237946
STAT,1901,29,40-44,1930,3.9328483296117467
STAT,1868,39,25-29,1907,2.5690227254698783
STAT,1771,97,na,1868,0.6520948174451995
STAT,1855,16,40-44,1871,0.15550918980352219
SIM,1861,21,na,1882,2100
STAT,1894,34,20-24,1928,3.253550868810421
SIM,1876,39,25-29,1915,2
STAT,1900,37,25-29,1937,0.814412237014708
STAT,1886,20,na,1906,2374.1883174122004
STAT,1807,96,na,1903,3.1937917982981285
STAT,1947,16,45-49,1963,0.5317587330935185
SIM,1839,18,15-19,1857,6
STAT,1936,27,50-100,1963,0.8998601432457869
SIM,1881,73,na,1954,876
STAT,1766,97,na,1863,0.759758453186824
STAT,1871,21,20-24,1892,64.84007024623222
STAT,1806,50,25-29,1856,0.012981755189711055
STAT,1888,18,45-49,1906,0.07273811960587254
STAT,1835,36,30-34,1871,4.23739095189075
STAT,1892,37,15-19,1929,0.06644490279792785
STAT,1895,34,na,1929,2913.815233588989
STAT,1945,25,25-29,1970,68.27684503204331
STAT,1852,40,15-19,1892,0.010112960752360591
STAT,1936,15,30-34,1951,11.075024979178737
SIM,1896,23,40-44,1919,2
STAT,1899,48,na,1947,2876.1427011642527
SIM,1829,27,45-49,1856,5
SIM,1939,21,35-39,1960,8
STAT,1827,38,25-29,1865,2.9185109427930196
SIM,1829,32,40-44,1861,3
STAT,1924,20,50-100,1944,0.7378439129925396
STAT,1941,12,na,1953,3833.279341442803
SIM,1844,20,15-19,1864,2
STAT,1852,36,30-34,1888,3.9253854486097683
SIM,1940,29,50-100,1969,5
SIM,1830,29,35-39,1859,11
STAT,1837,47,45-49,1884,0.1589948065084993
STAT,1955,15,40-44,1970,1.7548511433791085
SIM,1844,16,30-34,1860,2
SIM,1865,41,40-44,1906,6
STAT,1816,40,40-44,1856,6.65055102642974
STAT,1945,26,na,1971,3884.335153473761
STAT,1842,46,15-19,1888,2.934567791669132E-4
STAT,1894,29,25-29,1923,50.98896628144958
SIM,1899,16,20-24,1915,23
STAT,1909,25,15-19,1934,0.6471578815180069
SIM,1818,38,25-29,1856,1
STAT,1802,97,na,1899,1.8834794760998237
STAT,1968,4,na,1972,4639.395684132116
STAT,1868,38,35-39,1906,6.343501387931115
SIM,1914,6,na,1920,3927
STAT,1774,103,na,1877,0.040347934872354795
STAT,1856,32,35-39,1888,7.5558250777749185
SIM,1855,42,35-39,1897,1
STAT,1900,42,20-24,1942,0.014434846463897628
STAT,1817,48,30-34,1865,0.2148262761204448
SIM,1860,36,30-34,1896,6
STAT,1879,45,35-39,1924,0.13982245731379173
SIM,1779,81,na,1860,156
STAT,1846,38,35-39,1884,5.421720027210303
STAT,1919,15,30-34,1934,2.564803311384622
STAT,1837,28,40-44,1865,2.4773884966970368
STAT,1888,21,50-100,1909,0.45665139519617415
STAT,1970,0,na,1970,4683.468182204456
SIM,1849,18,na,1867,2137
SIM,1891,27,20-24,1918,19
SIM,1827,93,na,1920,7
STAT,1901,48,50-100,1949,0.18089386128377086
STAT,1915,36,50-100,1951,0.40261817912129605
SIM,1828,28,40-44,1856,2
SIM,1854,37,45-49,1891,2
STAT,1864,50,35-39,1914,0.007352750124034498
SIM,1826,44,na,1870,1407
STAT,1874,49,15-19,1923,3.7802779126417887E-4
STAT,1836,48,40-44,1884,0.11454501498707324
STAT,1827,30,15-19,1857,0.1863300076193247
SIM,1835,38,25-29,1873,5
SIM,1885,29,25-29,1914,34
STAT,1866,21,na,1887,2092.567878765187
SIM,1845,28,40-44,1873,2
STAT,1898,45,45-49,1943,0.1718845895349454
SIM,1875,30,45-49,1905,1
SIM,1938,16,45-49,1954,1
STAT,1826,88,na,1914,74.96822025719752
STAT,1862,25,35-39,1887,7.935899676223226
SIM,1908,15,20-24,1923,18
STAT,1888,23,40-44,1911,2.3192758836210623
STAT,1861,27,20-24,1888,9.281852415514901
SIM,1912,51,na,1963,3256
STAT,1846,43,30-34,1889,0.852049871547919
STAT,1847,42,35-39,1889,1.3427544985096802
SIM,1934,25,15-19,1959,4
STAT,1877,29,25-29,1906,41.15635838218512
SIM,1886,33,25-29,1919,11
SIM,1870,25,35-39,1895,13
SIM,1932,28,na,1960,4565
STAT,1926,25,15-19,1951,0.8048708992043179
STAT,1893,17,15-19,1910,7.109755955315621
SIM,1854,43,30-34,1897,2
STAT,1878,33,25-29,1911,10.041500245873637
STAT,1883,27,20-24,1910,10.865827009480457
STAT,1887,19,40-44,1906,0.19223431832920215
SIM,1944,15,30-34,1959,19
SIM,1886,38,30-34,1924,3
STAT,1893,20,45-49,1913,0.8403950643786773
STAT,1936,12,na,1948,3583.561300254844
SIM,1835,34,30-34,1869,24
STAT,1847,38,15-19,1885,0.04251963963774217
STAT,1821,37,40-44,1858,9.247019946198613
STAT,1860,109,na,1969,0.007024088342454945
STAT,1896,21,25-29,1917,71.64015301702814
STAT,1880,51,30-34,1931,0.005956716465544496
STAT,1850,48,15-19,1898,2.7842616468736554E-4
STAT,1928,16,35-39,1944,5.006986517903187
SIM,1880,38,50-100,1918,2
SIM,1908,22,45-49,1930,5
STAT,1849,73,na,1922,890.6577134245324
STAT,1922,20,25-29,1942,100.66528933731121
SIM,1879,40,30-34,1919,1
SIM,1841,27,45-49,1868,1
STAT,1829,29,45-49,1858,1.2438587964550694
SIM,1886,72,na,1958,1306
STAT,1776,96,na,1872,1.4328645189672131
STAT,1772,82,na,1854,135.0
SIM,1900,39,40-44,1939,1
SIM,1949,20,40-44,1969,7
STAT,1861,22,15-19,1883,2.66218543035212
SIM,1891,34,45-49,1925,2
STAT,1844,18,30-34,1862,1.3988733421862272
STAT,1865,43,40-44,1908,1.9120659897507484
STAT,1794,101,na,1895,0.10747980662159994
STAT,1834,24,20-24,1858,56.378554571194755
SIM,1933,13,na,1946,5063
STAT,1772,104,na,1876,0.028324162703512033
SIM,1852,37,35-39,1889,12
STAT,1825,43,50-100,1868,1.124410879388385
SIM,1853,25,35-39,1878,14
STAT,1833,27,45-49,1860,0.897922987410168
SIM,1923,30,35-39,1953,12
STAT,1863,27,50-100,1890,0.5303160519110318
STAT,1878,30,20-24,1908,2.6826082567940355
STAT,1902,32,na,1934,3181.504910795616
STAT,1879,50,na,1929,2159.807455362112
SIM,1897,31,35-39,1928,15
STAT,1889,48,20-24,1937,0.007795185570666266
SIM,1860,36,na,1896,1979
SIM,1858,15,20-24,1873,19
STAT,1823,33,35-39,1856,23.022975263959417
SIM,1837,30,25-29,1867,15
STAT,1820,50,20-24,1870,0.0012378313735398384
STAT,1868,44,20-24,1912,0.1412126869057169
STAT,1894,25,30-34,1919,30.779482870755352
STAT,1905,16,40-44,1921,0.25036649875696826
SIM,1852,18,30-34,1870,1
STAT,1828,42,25-29,1870,0.5444311382041718
STAT,1906,46,na,1952,3104.9305524993943
STAT,1844,37,35-39,1881,5.190962751413511
STAT,1883,34,45-49,1917,1.6013231435787358
STAT,1934,2,na,1936,5225.968251003926
SIM,1833,78,na,1911,401
STAT,1857,17,na,1874,2010.126754293708
STAT,1895,33,25-29,1928,12.561543801171792
STAT,1895,42,15-19,1937,0.0011796279852139433
STAT,1878,86,na,1964,411.79303776738675
STAT,1857,41,40-44,1898,1.6834305026905778
STAT,1922,38,15-19,1960,0.020621602220228862
SIM,1930,20,25-29,1950,114
SIM,1939,17,15-19,1956,37
SIM,1831,33,35-39,1864,10
STAT,1876,8,na,1884,2608.0047213113526
STAT,1816,43,45-49,1859,3.858302683547006
STAT,1810,103,na,1913,0.06071244572442607
STAT,1829,30,25-29,1859,10.806264679916753
SIM,1837,38,35-39,1875,13
STAT,1851,20,50-100,1871,0.355391662280469
STAT,1885,47,25-29,1932,0.05398580572501662
STAT,1904,16,50-100,1920,0.06654980578434953
STAT,1874,72,na,1946,1218.9757164840282
STAT,1831,23,40-44,1854,3.8126347817483355
SIM,1937,27,na,1964,3361
STAT,1836,77,na,1913,559.7514568737921
STAT,1864,31,30-34,1895,14.760665288829541
SIM,1871,8,na,1879,2558
STAT,1833,110,na,1943,1.6954063156194275E-4
STAT,1915,30,35-39,1945,8.863192298670532
SIM,1824,43,45-49,1867,2
STAT,1858,49,30-34,1907,0.07020096787622188
STAT,1825,46,15-19,1871,4.13725066437491E-4
STAT,1917,15,20-24,1932,27.689553464928505
SIM,1801,57,na,1858,1044
STAT,1893,46,20-24,1939,0.008132472965897992
STAT,1872,38,50-100,1910,1.1576107497991401
STAT,1897,32,50-100,1929,1.157568488284134
SIM,1846,35,45-49,1881,1
STAT,1896,29,35-39,1925,11.952783779716675
SIM,1852,92,na,1944,17
STAT,1866,50,45-49,1916,0.012826689362012164
STAT,1877,49,40-44,1926,0.16426201073896526
SIM,1836,22,na,1858,1793
STAT,1844,46,25-29,1890,0.0401181443658368
STAT,1829,38,35-39,1867,6.297914743435846
STAT,1835,32,15-19,1867,0.11539298879853238
SIM,1830,26,30-34,1856,29
SIM,1827,35,35-39,1862,7
STAT,1852,16,15-19,1868,5.234502920404107
STAT,1925,38,40-44,1963,1.6955865821644236
STAT,1938,15,40-44,1953,1.3095199140126916
STAT,1886,26,35-39,1912,9.661809335499177
STAT,1858,45,15-19,1903,2.992260482186003E-4
STAT,1854,36,40-44,1890,3.147112369851018
STAT,1875,29,15-19,1904,0.4374031167793319
SIM,1868,32,na,1900,2140
STAT,1831,32,30-34,1863,13.93477390899792
STAT,1885,19,30-34,1904,1.4928081266639601
SIM,1850,33,45-49,1883,1
STAT,1812,51,25-29,1863,0.01156068337433495
SIM,1842,24,20-24,1866,61
SIM,1897,13,na,1910,3340
SIM,1806,56,na,1862,1117
STAT,1902,45,50-100,1947,0.18654577733750446
STAT,1838,41,30-34,1879,0.9142976195810455
STAT,1859,83,na,1942,298.4907587431817
STAT,1948,20,45-49,1968,1.221348155030575
STAT,1931,13,na,1944,4891.716048069592
STAT,1935,27,na,1962,4824.050145135319
STAT,1874,28,45-49,1902,1.067918205895929
SIM,1861,24,30-34,1885,22
STAT,1822,45,35-39,1867,0.1937452745992495
SIM,1878,39,35-39,1917,15
SIM,1869,17,na,1886,2377
SIM,1873,54,na,1927,2021
SIM,1916,40,45-49,1956,1
STAT,1838,16,40-44,1854,0.1631595076554713
STAT,1928,25,25-29,1953,77.12292625500757
STAT,1915,50,na,1965,3465.7477619234555
SIM,1833,89,na,1922,41
SIM,1837,29,45-49,1866,2
SIM,1877,68,na,1945,1455
SIM,1862,32,25-29,1894,13
STAT,1804,56,na,1860,1072.5848309991015
SIM,1946,15,40-44,1961,1
SIM,1862,36,40-44,1898,5
STAT,1819,35,35-39,1854,22.918103593337364
SIM,1835,37,na,1872,1627
STAT,1903,41,35-39,1944,0.1697873947433043
SIM,1936,16,35-39,1952,4
STAT,1888,39,15-19,1927,0.062062676496956765
SIM,1831,23,na,1854,1715
STAT,1850,92,na,1942,29.35964575317336
SIM,1828,44,40-44,1872,7
STAT,1853,24,30-34,1877,15.69960506904109
SIM,1860,25,na,1885,2023
SIM,1882,28,45-49,1910,1
SIM,1848,29,20-24,1877,10
STAT,1843,33,50-100,1876,0.7363210389281819
SIM,1857,91,na,1948,34
SIM,1901,27,40-44,1928,3
SIM,1936,25,25-29,1961,51
STAT,1849,42,45-49,1891,1.1209008673418661
STAT,1864,22,40-44,1886,1.7827221863381022
STAT,1885,28,20-24,1913,11.007960785249116
STAT,1887,35,40-44,1922,4.669568739820983
STAT,1840,17,35-39,1857,0.46622442569489925
STAT,1931,31,30-34,1962,19.513641107517326
SIM,1893,28,20-24,1921,14
SIM,1895,35,40-44,1930,6
STAT,1861,51,20-24,1912,5.823994814627538E-4
STAT,1808,59,na,1867,1052.4624533891092
STAT,1818,37,20-24,1855,2.4484417881097733
STAT,1860,47,20-24,1907,0.009155234363090558
STAT,1854,32,25-29,1886,7.504754759706545
STAT,1854,53,50-100,1907,0.010632292513293168
SIM,1873,43,40-44,1916,6
STAT,1832,40,25-29,1872,0.4873716200673249
SIM,1872,22,40-44,1894,1
SIM,1894,26,35-39,1920,10
SIM,1848,55,na,1903,1472
STAT,1921,35,na,1956,3975.33494718024
SIM,1818,89,na,1907,56
STAT,1859,38,50-100,1897,0.918549431139038
STAT,1852,45,20-24,1897,0.00878656906053116
STAT,1837,37,30-34,1874,4.211309159328268
STAT,1903,49,45-49,1952,0.17520236053578933
STAT,1842,30,40-44,1872,3.8735035705108047
STAT,1860,21,45-49,1881,0.5549817557842844
SIM,1805,82,na,1887,146
SIM,1909,23,15-19,1932,4
STAT,1875,25,20-24,1900,11.468694410220607
SIM,1870,38,40-44,1908,7
STAT,1922,44,50-100,1966,0.12696171142580276
STAT,1848,105,na,1953,0.021786959902578482
SIM,1947,23,35-39,1970,10
STAT,1909,16,25-29,1925,8.048228833322305
STAT,1866,47,15-19,1913,3.4690337773432344E-4
STAT,1871,40,25-29,1911,0.6084680551377385
STAT,1860,38,30-34,1898,4.064910479034698
STAT,1825,37,25-29,1862,3.6140554119896953
STAT,1920,50,na,1970,3801.837012265959
SIM,1867,38,20-24,1905,4
SIM,1861,40,45-49,1901,2
SIM,1877,18,35-39,1895,1
STAT,1855,44,35-39,1899,1.2694430276688147
SIM,1856,30,35-39,1886,8
STAT,1791,96,na,1887,1.5284510414197037
STAT,1869,18,35-39,1887,0.5061279106774338
STAT,1884,35,15-19,1919,0.05290796197782635
STAT,1847,31,50-100,1878,0.8015748839899811
SIM,1854,34,40-44,1888,3
STAT,1834,28,15-19,1862,0.3665614236670537
STAT,1932,28,30-34,1960,48.458961688461635
STAT,1892,28,25-29,1920,49.87698232803708
STAT,1916,42,45-49,1958,0.16112063606500693
STAT,1846,34,40-44,1880,3.723044169206509
SIM,1940,28,30-34,1968,40
STAT,1919,29,50-100,1948,1.0087262563465154
SIM,1917,16,25-29,1933,7
SIM,1904,30,25-29,1934,16
STAT,1924,6,na,1930,4508.863732945819
SIM,1774,82,na,1856,127
STAT,1822,74,na,1896,563.9252835762925
SIM,1849,40,45-49,1889,3
SIM,1878,31,25-29,1909,13
SIM,1845,37,30-34,1882,6
STAT,1872,17,na,1889,2401.0790827036576
STAT,1889,39,45-49,1928,2.3015143450084508
SIM,1868,36,35-39,1904,11
STAT,1850,32,40-44,1882,3.197983702710156
STAT,1890,15,45-49,1905,0.07579578995516816
STAT,1852,40,na,1892,1692.524648355609
SIM,1890,22,35-39,1912,8
STAT,1944,17,30-34,1961,12.391529130311842
STAT,1862,34,25-29,1896,8.202310022581496
STAT,1908,40,45-49,1948,0.14711599057092065
STAT,1832,27,15-19,1859,0.37167865716108706
SIM,1876,35,30-34,1911,9
SIM,1952,17,30-34,1969,12
STAT,1838,35,45-49,1873,1.6488261598181106
SIM,1837,92,na,1929,16
STAT,1897,30,30-34,1927,22.235607082150114
STAT,1838,47,50-100,1885,0.16963572298817958
STAT,1859,29,30-34,1888,18.985258928473026
STAT,1870,27,35-39,1897,8.942253327538053
SIM,1867,29,30-34,1896,29
STAT,1842,36,50-100,1878,1.053879175509333
STAT,1828,46,40-44,1874,0.1404664800082299
SIM,1846,41,30-34,1887,5
STAT,1870,58,na,1928,1832.760784027493
STAT,1811,47,25-29,1858,0.1918576026379997
STAT,1907,22,50-100,1929,0.5659020359288188
STAT,1791,85,na,1876,83.64288576397612
SIM,1883,25,20-24,1908,9
SIM,1877,27,25-29,1904,36
STAT,1848,47,20-24,1895,0.008875126540856787
STAT,1875,44,50-100,1919,1.011983500649038
STAT,1901,47,na,1948,2961.7392761599144
STAT,1939,23,35-39,1962,8.930374407946434
SIM,1853,55,na,1908,1572
SIM,1857,69,na,1926,1090
STAT,1895,37,40-44,1932,5.391326768679608
SIM,1885,26,20-24,1911,11
STAT,1871,48,35-39,1919,0.12967995460650847
STAT,1880,31,15-19,1911,0.142408369034839
STAT,1882,22,35-39,1904,5.3611451930207155
SIM,1947,7,na,1954,4129
STAT,1821,89,na,1910,55.96895568001532
SIM,1899,19,25-29,1918,6
STAT,1868,35,30-34,1903,4.8493949221351045
SIM,1840,59,na,1899,1268
SIM,1825,59,na,1884,1141
STAT,1885,35,na,1920,2239.560028747883
STAT,1851,55,na,1906,1487.3951961309497
SIM,1855,25,na,1880,2014
SIM,1821,45,na,1866,1381
STAT,1881,21,na,1902,2164.8750055050564
STAT,1857,44,45-49,1901,1.1000366185759896
SIM,1832,42,40-44,1874,6
STAT,1855,69,na,1924,1042.875481564493
STAT,1837,40,na,1877,1651.8466015413692
SIM,1851,11,na,1862,2179
SIM,1897,39,45-49,1936,3
STAT,1898,42,40-44,1940,0.19943605132397205
STAT,1766,113,na,1879,4.006994182479864E-4
STAT,1855,19,45-49,1874,0.05456337796890004
STAT,1900,18,50-100,1918,0.06403586131837025
STAT,1911,48,40-44,1959,0.14061772568413783
SIM,1854,40,na,1894,1864
SIM,1872,69,na,1941,1318
STAT,1877,17,30-34,1894,1.5618878972017387
STAT,1877,26,20-24,1903,11.535507057400977
STAT,1806,54,40-44,1860,0.03559482373310984
STAT,1872,52,35-39,1924,0.008114320807249258
SIM,1880,33,30-34,1913,26
STAT,1840,42,25-29,1882,0.4396029898869975
STAT,1881,22,50-100,1903,0.37215217800085426
STAT,1936,18,35-39,1954,3.7851378370120816
SIM,1846,47,50-100,1893,1
STAT,1940,27,na,1967,3608.771621645664
SIM,1823,31,35-39,1854,11
SIM,1850,36,50-100,1886,4
STAT,1890,57,na,1947,2321.055108693895
STAT,1888,48,50-100,1936,0.15272800321971858
SIM,1886,30,20-24,1916,2
STAT,1847,51,25-29,1898,0.0026244029308505282
SIM,1900,29,na,1929,3161
STAT,1836,19,35-39,1855,0.6775399619782098
SIM,1866,17,20-24,1883,16
STAT,1889,49,na,1938,2569.580635996211
STAT,1867,27,15-19,1894,0.4024695665701338
STAT,1891,33,40-44,1924,5.047283074079701
STAT,1858,17,20-24,1875,15.338980180399206
SIM,1883,21,na,1904,2225
STAT,1905,41,30-34,1946,0.10950794847090067
STAT,1831,51,35-39,1882,0.0055030174426496286
STAT,1889,31,35-39,1920,11.859006141985923
STAT,1872,33,30-34,1905,16.474613620471537
STAT,1896,35,50-100,1931,1.54638481014605
STAT,1881,43,25-29,1924,0.5818032850054813
SIM,1928,26,50-100,1954,2
STAT,1824,42,40-44,1866,2.9565141231882213
SIM,1871,27,50-100,1898,1
STAT,1878,38,30-34,1916,5.221053604111672
STAT,1934,30,45-49,1964,2.0319311608900485
SIM,1896,27,35-39,1923,13
STAT,1862,43,15-19,1905,0.011073878032001406
STAT,1851,27,25-29,1878,35.62839943199274
STAT,1860,18,15-19,1878,5.215427989638983
STAT,1817,44,15-19,1861,0.032410355974226646
STAT,1862,38,40-44,1900,3.518252636740467
SIM,1887,35,na,1922,2465
SIM,1880,27,45-49,1907,1
STAT,1852,48,25-29,1900,0.04123450223798438
SIM,1887,36,45-49,1923,5
SIM,1905,1,na,1906,3608
SIM,1860,39,35-39,1899,10
STAT,1823,59,na,1882,1123.4257875094308
SIM,1842,31,45-49,1873,1
STAT,1827,34,30-34,1861,19.30759625400636
SIM,1891,72,na,1963,1661
SIM,1907,4,na,1911,3649
STAT,1852,39,35-39,1891,5.076162140696789
SIM,1887,42,30-34,1929,4
STAT,1803,82,na,1885,170.58256563919562
STAT,1883,0,na,1883,3280.663038984324
STAT,1846,34,50-100,1880,0.7865911143167329
STAT,1911,40,30-34,1951,0.11658382814411204
STAT,1879,42,50-100,1921,1.043410760361877
SIM,1790,67,na,1857,651
SIM,1865,44,45-49,1909,2
SIM,1820,60,na,1880,1113
SIM,1813,42,30-34,1855,2
SIM,1824,74,na,1898,531
STAT,1835,92,na,1927,26.50885152213439
STAT,1853,52,25-29,1905,0.0026663115290138937
SIM,1913,5,na,1918,3739
SIM,1829,36,35-39,1865,12
STAT,1868,31,15-19,1899,0.1288825860161865
SIM,1903,47,na,1950,3008
STAT,1879,42,30-34,1921,1.1354764181796144
STAT,1834,31,45-49,1865,1.4007029015648447
STAT,1879,36,45-49,1915,1.9807935693935517
STAT,1923,41,50-100,1964,0.12990140229860495
STAT,1918,5,na,1923,4134.37982995161
STAT,1913,43,45-49,1956,0.15308699993091546
SIM,1845,58,na,1903,1379
STAT,1888,27,35-39,1915,10.772528944546059
STAT,1820,40,na,1860,1470.2664584469126
STAT,1883,18,45-49,1901,0.06034406053104305
STAT,1903,17,na,1920,3394.7991651600664
STAT,1886,19,25-29,1905,5.624561195385643
STAT,1841,38,20-24,1879,0.6196639199500515
STAT,1911,35,35-39,1946,2.228031404930376
STAT,1882,9,na,1891,2383.7292869999314
STAT,1892,23,50-100,1915,0.48102714803083313
STAT,1858,88,na,1946,101.68341197592986
SIM,1830,41,40-44,1871,6
STAT,1858,51,50-100,1909,0.011239849080472337
STAT,1914,36,15-19,1950,0.01820062415841373
STAT,1788,76,na,1864,330.24176982520896
STAT,1916,44,25-29,1960,0.06890132958112176
SIM,1827,28,25-29,1855,38
STAT,1796,95,na,1891,2.86344868243875
SIM,1940,30,35-39,1970,8
SIM,1813,44,45-49,1857,4
STAT,1861,37,35-39,1898,5.555688878828214
STAT,1873,28,15-19,1901,0.4331688285842613
STAT,1859,53,30-34,1912,0.004403803931892003
STAT,1859,38,20-24,1897,0.5767191857871565
STAT,1931,9,na,1940,4922.310512443734
SIM,1921,18,40-44,1939,3
SIM,1944,18,35-39,1962,5
SIM,1880,35,45-49,1915,5
STAT,1887,40,15-19,1927,0.014739875019431919
STAT,1845,54,40-44,1899,0.0072448074361709
STAT,1857,45,20-24,1902,0.009029867508620015
SIM,1832,93,na,1925,15
SIM,1928,13,na,1941,4725
STAT,1828,26,25-29,1854,102.09113340761093
SIM,1924,19,20-24,1943,128
STAT,1872,35,45-49,1907,1.9069225617613097
SIM,1879,70,na,1949,1362
SIM,1894,19,25-29,1913,6
STAT,1798,96,na,1894,2.4390271317632823
SIM,1844,25,20-24,1869,10
STAT,1845,38,na,1883,1733.5722911479063
STAT,1770,106,na,1876,0.009309229994268305
STAT,1804,52,50-100,1856,0.05336905181444185
SIM,1910,49,na,1959,3209
SIM,1871,37,45-49,1908,2
STAT,1862,18,na,1880,2110.961855404194
STAT,1901,31,45-49,1932,2.315352529945087
STAT,1834,48,30-34,1882,0.06289878456412093
STAT,1836,25,20-24,1861,9.972895673350036
STAT,1843,25,na,1868,1824.338852483776
SIM,1859,19,30-34,1878,2
SIM,1870,57,na,1927,1823
SIM,1795,98,na,1893,1
STAT,1818,40,50-100,1858,2.661609006495541
SIM,1876,28,20-24,1904,11
STAT,1826,49,35-39,1875,0.12580201053961731
STAT,1933,26,50-100,1959,1.2490876619892972
SIM,1851,47,50-100,1898,1
STAT,1853,18,50-100,1871,0.04433835417491498
STAT,1920,33,35-39,1953,9.416078062191698
STAT,1866,38,25-29,1904,2.496262701171904
STAT,1922,41,45-49,1963,0.18072310868043268
SIM,1828,88,na,1916,62
STAT,1881,74,na,1955,1012.8002664997802
STAT,1848,56,na,1904,1515.5664235047147
SIM,1874,38,25-29,1912,2
STAT,1850,60,na,1910,1344.4155497133474
STAT,1904,45,45-49,1949,0.18218847061422877
STAT,1843,46,30-34,1889,0.06591755090902969
SIM,1869,38,30-34,1907,6
STAT,1894,49,40-44,1943,0.11479411605963565
STAT,1938,31,40-44,1969,3.7194614803648176
SIM,1839,40,na,1879,1681
SIM,1891,35,20-24,1926,1
STAT,1935,31,15-19,1966,0.16804914783368696
STAT,1864,24,50-100,1888,0.3438775591376763
SIM,1853,18,25-29,1871,7
STAT,1863,27,30-34,1890,20.876230338761296
SIM,1868,21,na,1889,2126
SIM,1855,26,35-39,1881,7
STAT,1883,35,20-24,1918,0.7207512086605341
STAT,1865,36,na,1901,2027.0531547939097
STAT,1900,34,20-24,1934,3.5120422017462674
SIM,1802,95,na,1897,10
STAT,1879,17,40-44,1896,0.1808679316645141
STAT,1850,36,20-24,1886,0.5577558978021866
STAT,1921,42,40-44,1963,0.26613921230809073
SIM,1836,26,25-29,1862,49
STAT,1803,60,na,1863,975.6361058073255
STAT,1940,26,15-19,1966,0.6803704426780592
STAT,1883,87,na,1970,407.61008741819893
STAT,1838,48,15-19,1886,2.727624096867466E-4
STAT,1894,18,20-24,1912,21.466922976196972
STAT,1929,20,35-39,1949,11.315370854653786
STAT,1871,54,na,1925,1964.2830589356963
STAT,1923,34,15-19,1957,0.13898929335344334
STAT,1895,48,45-49,1943,0.16189481970681655
SIM,1802,63,na,1865,837
STAT,1913,30,25-29,1943,8.757309317516585
STAT,1827,27,20-24,1854,33.01411851719581
STAT,1879,29,35-39,1908,9.473371335017527
SIM,1871,27,30-34,1898,34
STAT,1873,55,na,1928,1981.1062895393923
STAT,1909,41,15-19,1950,0.0013648159757495876
STAT,1875,36,na,1911,2298.699168144602
STAT,1924,43,20-24,1967,0.01981281954836066
STAT,1907,46,25-29,1953,0.045216948558379585
STAT,1923,47,na,1970,4059.9625578837213
STAT,1812,43,na,1855,1370.936106243899
STAT,1822,41,40-44,1863,3.364327585584297
SIM,1804,76,na,1880,369
SIM,1815,47,50-100,1862,1
SIM,1862,38,na,1900,2003
SIM,1835,27,20-24,1862,9
STAT,1895,17,25-29,1912,6.9791353834973355
STAT,1932,30,35-39,1962,11.489164556380999
STAT,1917,18,25-29,1935,8.786645912847312
SIM,1787,79,na,1866,236
STAT,1845,18,25-29,1863,5.038362927177002
STAT,1847,26,35-39,1873,8.613942972334817
STAT,1934,37,50-100,1971,0.5473422284132534
SIM,1807,94,na,1901,8
STAT,1920,49,50-100,1969,0.23480729136424164
STAT,1870,32,30-34,1902,16.1809901413552
SIM,1862,44,40-44,1906,6
SIM,1856,38,45-49,1894,1
STAT,1843,109,na,1952,4.805531488657601E-4
STAT,1777,101,na,1878,0.11722986514978051
STAT,1916,19,20-24,1935,27.027769406269233
SIM,1887,29,35-39,1916,12
SIM,1936,32,na,1968,2869
STAT,1860,42,15-19,1902,0.010572335685308803
SIM,1921,30,25-29,1951,14
STAT,1939,19,15-19,1958,42.8867168481113
SIM,1947,19,15-19,1966,48
STAT,1862,15,20-24,1877,16.595236222062624
SIM,1833,37,25-29,1870,6
STAT,1911,24,50-100,1935,0.585858470457235
STAT,1839,105,na,1944,0.01952165118626103
STAT,1905,19,45-49,1924,0.0887191663380771
STAT,1871,36,40-44,1907,4.126178525258504
SIM,1777,79,na,1856,247
SIM,1910,17,na,1927,3634
STAT,1815,48,20-24,1863,0.026610668217585377
STAT,1881,18,35-39,1899,0.4994435513873844
SIM,1870,15,20-24,1885,18
STAT,1848,38,45-49,1886,1.510715771528576
STAT,1880,54,35-39,1934,0.00833828111717122
STAT,1920,46,40-44,1966,0.1650511035982624
STAT,1882,39,20-24,1921,0.7010630912274954
STAT,1894,36,35-39,1930,8.628205627053944
STAT,1895,9,na,1904,3195.5467440983016
STAT,1902,42,30-34,1944,0.106307915468983
STAT,1837,19,na,1856,1960.5752464477337
STAT,1845,49,45-49,1894,0.16351356521056623
SIM,1937,20,35-39,1957,9
SIM,1890,39,20-24,1929,1
STAT,1926,18,50-100,1944,0.4327928901769396
STAT,1920,20,15-19,1940,5.623908328092406
STAT,1861,54,25-29,1915,0.002705696765590093
SIM,1869,70,na,1939,1242
SIM,1900,32,20-24,1932,4
STAT,1854,29,50-100,1883,0.47294335193005965
STAT,1851,40,35-39,1891,1.3157398092203532
STAT,1868,17,50-100,1885,0.044957969196902765
SIM,1852,42,30-34,1894,1
STAT,1855,28,35-39,1883,7.095739970527475
STAT,1929,42,na,1971,4543.495510921523
SIM,1920,31,35-39,1951,12
STAT,1835,38,na,1873,1667.8498865101233
STAT,1900,52,na,1952,2806.791254506447
SIM,1916,12,na,1928,3883
STAT,1824,46,20-24,1870,0.014838017705331375
SIM,1907,61,na,1968,2863
STAT,1937,24,50-100,1961,0.6049120107778555
SIM,1850,34,20-24,1884,2
SIM,1846,28,35-39,1874,11
STAT,1896,21,50-100,1917,0.5103302500389248
STAT,1838,28,35-39,1866,8.181117512356993
STAT,1844,45,35-39,1889,0.09876667948072429
STAT,1851,47,50-100,1898,0.17584698302984222
STAT,1923,47,20-24,1970,0.012212764833610381
STAT,1842,22,50-100,1864,0.3724787050232853
STAT,1848,88,na,1936,102.00967347277177
STAT,1885,15,50-100,1900,0.04634722771028673
STAT,1828,36,na,1864,1579.7639379276275
STAT,1878,53,40-44,1931,0.010198271619792127
SIM,1864,6,na,1870,2464
STAT,1903,46,40-44,1949,0.13017474799494572
STAT,1786,95,na,1881,2.36349620014342
STAT,1842,34,20-24,1876,2.3161145504477587
SIM,1936,0,na,1936,3145
SIM,1820,92,na,1912,19
STAT,1818,91,na,1909,28.45809833260583
STAT,1883,55,na,1938,1915.1439453058185
STAT,1859,48,35-39,1907,0.10394201888750057
STAT,1840,60,na,1900,1251.6012635708637
SIM,1948,8,na,1956,4240
STAT,1832,41,na,1873,1559.998165766782
STAT,1891,74,na,1965,1583.6036434453354
STAT,1939,30,45-49,1969,1.518476658509119
STAT,1870,17,20-24,1887,16.586629939184995
STAT,1912,44,40-44,1956,0.226139569497379
STAT,1874,37,20-24,1911,0.7440413853464085
STAT,1825,93,na,1918,15.53287806340132
SIM,1810,82,na,1892,168
STAT,1915,48,25-29,1963,0.050356229161876105
SIM,1863,87,na,1950,116
STAT,1838,68,na,1906,1025.9556581139393
STAT,1928,41,25-29,1969,0.08612096238888504
STAT,1852,18,na,1870,2000.888380282812
SIM,1924,31,na,1955,4175
SIM,1908,32,50-100,1940,3
SIM,1902,18,30-34,1920,1
STAT,1903,49,na,1952,2961.537571468122
STAT,1873,16,35-39,1889,0.5288410441958092
SIM,1920,44,40-44,1964,2
SIM,1882,37,20-24,1919,4
STAT,1844,50,45-49,1894,0.01022405785672587
STAT,1778,76,na,1854,322.0
STAT,1891,49,15-19,1940,2.5820957526264836E-4
STAT,1915,28,na,1943,3597.0349671975973
SIM,1856,42,na,1898,1823
STAT,1885,43,30-34,1928,1.0747574000605422
SIM,1882,36,na,1918,2240
STAT,1820,62,na,1882,996.0464791517807
STAT,1818,47,35-39,1865,0.29849958208390726
SIM,1821,43,40-44,1864,2
SIM,1884,17,15-19,1901,9
SIM,1911,33,35-39,1944,8
SIM,1826,53,50-100,1879,1
STAT,1835,47,35-39,1882,0.09392274730385923
STAT,1844,27,20-24,1871,9.974246913096152
STAT,1875,49,30-34,1924,0.09203169277649936
SIM,1861,35,35-39,1896,14
STAT,1825,50,35-39,1875,0.008806513836073263
STAT,1830,38,45-49,1868,1.597809429017096
STAT,1940,32,35-39,1972,8.9347454546326
STAT,1880,34,40-44,1914,4.2821088469033555
SIM,1852,27,20-24,1879,11
SIM,1944,3,na,1947,3986
SIM,1795,66,na,1861,778
SIM,1811,46,na,1857,1259
STAT,1870,44,25-29,1914,0.5870931906107283
STAT,1856,49,20-24,1905,0.0086602584484727
STAT,1828,58,na,1886,1153.8482340666176
STAT,1911,46,na,1957,3293.919748586713
SIM,1869,92,na,1961,103
SIM,1850,90,na,1940,52
STAT,1833,36,20-24,1869,0.59748787828246
STAT,1922,30,50-100,1952,0.8896038368628838
STAT,1813,43,40-44,1856,6.870030342535924
STAT,1876,85,na,1961,414.179922653604
STAT,1903,33,35-39,1936,7.783209447443974
STAT,1876,48,35-39,1924,0.13492377725707758
STAT,1898,46,20-24,1944,0.00867819105812769
SIM,1843,16,15-19,1859,6
STAT,1818,52,30-34,1870,0.012184007994697214
STAT,1853,35,35-39,1888,5.465085070638519
STAT,1892,41,35-39,1933,2.152340937816432
SIM,1896,50,na,1946,2726
STAT,1820,53,25-29,1873,0.0055967881693783335
SIM,1919,30,na,1949,3945
STAT,1833,80,na,1913,379.52497592036093
STAT,1913,18,40-44,1931,0.2694646110650713
SIM,1856,20,na,1876,2013
SIM,1820,82,na,1902,210
STAT,1833,90,na,1923,48.370746429368594
STAT,1938,7,na,1945,3725.1112576048336
SIM,1862,16,25-29,1878,3
STAT,1885,38,35-39,1923,6.6271365773843245
STAT,1940,29,50-100,1969,0.9578993455617232
STAT,1798,109,na,1907,2.0208907379329108E-4
STAT,1854,16,25-29,1870,4.878837025171178
STAT,1883,33,na,1916,2200.9060110941355
STAT,1891,52,na,1943,2503.2535415664943
SIM,1855,68,na,1923,1170
STAT,1830,43,40-44,1873,1.7255174988532735
STAT,1868,66,na,1934,1477.3088698235078
STAT,1778,98,na,1876,0.5239970993460421
SIM,1900,23,50-100,1923,1
STAT,1891,42,na,1933,2698.007882226732
STAT,1828,68,na,1896,860.6506604389448
STAT,1837,52,40-44,1889,0.006857331451424253
STAT,1929,10,na,1939,4791.303370055601
SIM,1893,38,35-39,1931,13
SIM,1863,28,35-39,1891,7
STAT,1853,17,20-24,1870,16.139638125289363
STAT,1882,33,50-100,1915,0.8382166017256677
STAT,1903,27,na,1930,3207.8505846681232
SIM,1795,76,na,1871,355
SIM,1861,17,20-24,1878,20
SIM,1882,58,na,1940,1863
STAT,1891,37,20-24,1928,0.9009537159022067
SIM,1870,35,na,1905,2209
STAT,1832,63,na,1895,1074.8674004334937
STAT,1933,36,25-29,1969,1.2680854543119413
STAT,1861,46,25-29,1907,0.045372515342681205
SIM,1914,31,na,1945,3604
SIM,1920,7,na,1927,4294
STAT,1793,65,na,1858,713.274839469031
STAT,1863,35,na,1898,1971.6950757672357
STAT,1857,28,45-49,1885,0.8459558477573497
STAT,1883,44,50-100,1927,0.9652919494182586
SIM,1871,50,50-100,1921,1
SIM,1830,44,45-49,1874,3
STAT,1813,92,na,1905,17.14067720055712
STAT,1807,54,20-24,1861,0.0025970851382170253
STAT,1863,54,35-39,1917,0.00694079452407976
STAT,1924,47,50-100,1971,0.2543722243498277
SIM,1876,40,na,1916,2263
SIM,1880,32,40-44,1912,6
STAT,1897,0,na,1897,3709.7157980869742
SIM,1880,17,30-34,1897,3
SIM,1931,20,40-44,1951,3
SIM,1940,24,15-19,1964,5
STAT,1846,20,50-100,1866,0.3786108186624294
STAT,1826,46,30-34,1872,0.09059473509661502
STAT,1912,40,50-100,1952,0.1082562817860435
SIM,1875,88,na,1963,239
STAT,1931,34,na,1965,4675.533311753541
STAT,1861,76,na,1937,744.1733901506335
SIM,1909,27,30-34,1936,46
SIM,1873,75,na,1948,914
STAT,1913,40,40-44,1953,0.23304811927369828
SIM,1813,41,40-44,1854,3
SIM,1891,38,25-29,1929,2
STAT,1872,17,30-34,1889,1.5152824259174797
SIM,1879,27,35-39,1906,12
STAT,1840,82,na,1922,306.1982925177056
STAT,1874,45,20-24,1919,0.011698155624083788
STAT,1931,36,15-19,1967,0.02404724033998207
STAT,1803,53,25-29,1856,0.010115397212852668
STAT,1932,24,15-19,1956,6.575449019470677
STAT,1821,79,na,1900,372.45958201467005
SIM,1869,29,40-44,1898,2
STAT,1820,49,40-44,1869,0.2788103578153986
STAT,1901,46,30-34,1947,0.07240917828553471
SIM,1819,45,50-100,1864,1
STAT,1898,2,na,1900,3407.831931589581
STAT,1915,22,50-100,1937,0.6425586416295396
SIM,1812,63,na,1875,901
STAT,1843,49,35-39,1892,0.09258814432318885
STAT,1920,30,30-34,1950,16.433769276716415
STAT,1843,18,15-19,1861,5.092380510035329
STAT,1881,40,20-24,1921,0.1463962396398845
STAT,1885,46,35-39,1931,0.13220439018879404
STAT,1908,58,na,1966,2977.543585185058
SIM,1916,17,20-24,1933,22
STAT,1883,23,na,1906,2183.7708666705757
STAT,1802,65,na,1867,813.1171466996943
STAT,1925,28,na,1953,4165.1029670796015
STAT,1927,29,50-100,1956,1.138509569459118
STAT,1866,53,na,1919,1845.9781009415692
STAT,1830,35,40-44,1865,3.65607297085476
STAT,1901,68,na,1969,2338.760706513665
STAT,1840,100,na,1940,0.6967126857197693
STAT,1946,20,35-39,1966,9.905551496919594
SIM,1844,28,25-29,1872,40
SIM,1848,33,na,1881,1803
STAT,1891,20,na,1911,2780.7173720918727
STAT,1836,28,25-29,1864,35.19135921136553
SIM,1939,29,na,1968,3506
STAT,1914,42,35-39,1956,0.18850060140352778
STAT,1925,7,na,1932,4561.572055226356
STAT,1919,32,na,1951,3854.728981138549
SIM,1850,80,na,1930,408
SIM,1851,6,na,1857,2259
STAT,1872,32,40-44,1904,4.109373924680678
STAT,1795,78,na,1873,322.9832919079135
STAT,1870,16,50-100,1886,0.04610786846675722
STAT,1908,17,20-24,1925,24.84462648483968
SIM,1845,16,25-29,1861,9
STAT,1811,43,30-34,1854,4.19025547977148
SIM,1854,19,na,1873,2154
SIM,1880,2,na,1882,3100
SIM,1933,34,25-29,1967,14
STAT,1879,26,30-34,1905,24.987161749476215
STAT,1922,41,30-34,1963,0.13882536366825607
STAT,1816,47,25-29,1863,0.13602831744663973
SIM,1890,55,na,1945,2625
SIM,1837,39,na,1876,1646
SIM,1838,23,na,1861,1800
STAT,1871,86,na,1957,250.0126201475248
SIM,1869,16,20-24,1885,18
STAT,1850,39,25-29,1889,2.0193776543209925
STAT,1849,20,na,1869,1966.5932072413764
SIM,1920,27,na,1947,3932
STAT,1846,27,30-34,1873,22.59517101743565
SIM,1886,17,25-29,1903,4
SIM,1928,30,35-39,1958,11
SIM,1799,80,na,1879,232
STAT,1821,101,na,1922,0.30400890880115833
STAT,1920,29,na,1949,3854.3787458427673
STAT,1925,34,25-29,1959,10.35491879730295
SIM,1875,66,na,1941,1511
STAT,1928,29,40-44,1957,5.419267988438924
SIM,1878,21,na,1899,2401
STAT,1859,40,na,1899,1755.334291199165
STAT,1833,44,20-24,1877,0.11508347071259072
SIM,1897,34,na,1931,3055
STAT,1765,114,na,1879,2.0685061529178756E-4
STAT,1842,41,na,1883,1754.0137679932998
STAT,1883,38,25-29,1921,2.65352382926979
SIM,1817,94,na,1911,6
STAT,1881,25,45-49,1906,1.0201442020605374
SIM,1876,15,15-19,1891,4
STAT,1898,29,45-49,1927,1.409288325795568
STAT,1862,18,25-29,1880,5.211303979387563
SIM,1789,80,na,1869,200
STAT,1910,29,na,1939,3393.081651691657
STAT,1912,31,35-39,1943,8.529796175575862
SIM,1889,26,50-100,1915,4
SIM,1870,18,25-29,1888,8
STAT,1832,48,20-24,1880,0.008465439812936942
SIM,1936,29,40-44,1965,4
STAT,1864,38,15-19,1902,0.04704604491424941
SIM,1903,44,40-44,1947,3
STAT,1923,20,40-44,1943,3.717885365113062
STAT,1836,87,na,1923,114.08878571208618
STAT,1861,54,na,1915,1644.7763022682868
STAT,1866,51,35-39,1917,0.007537147470913242
STAT,1811,52,20-24,1863,0.002349255051449662
STAT,1817,42,na,1859,1410.745066932029
STAT,1871,39,45-49,1910,1.851213591550483
STAT,1844,42,30-34,1886,0.8177683646307801
STAT,1860,37,na,1897,1805.8792950986642
STAT,1893,37,30-34,1930,6.384981580221081
STAT,1931,31,45-49,1962,1.94896169504304
SIM,1887,26,30-34,1913,35
STAT,1926,46,35-39,1972,0.15065518047496526
SIM,1854,27,30-34,1881,28
STAT,1878,54,na,1932,2061.5438023524125
STAT,1907,31,na,1938,3353.366993978249
SIM,1863,22,na,1885,1988
STAT,1883,47,15-19,1930,3.6875781496877616E-4
STAT,1926,41,15-19,1967,0.0017910072738434207
SIM,1876,19,30-34,1895,1
STAT,1851,48,30-34,1899,0.0687574650510211
STAT,1846,87,na,1933,130.67395803953136
SIM,1935,17,30-34,1952,21
SIM,1921,40,40-44,1961,1
STAT,1927,17,30-34,1944,14.31686756272269
STAT,1859,45,30-34,1904,0.07350861785447764
SIM,1867,37,na,1904,2256
STAT,1869,27,25-29,1896,38.71381408404969
SIM,1835,58,na,1893,1258
STAT,1812,75,na,1887,451.02945695034526
SIM,1849,72,na,1921,933
STAT,1903,41,20-24,1944,0.014890791767490462
STAT,1906,34,15-19,1940,0.11154507868884772
STAT,1907,43,20-24,1950,0.015193726209448121
STAT,1821,50,50-100,1871,0.02383552605354823
STAT,1884,19,15-19,1903,5.509135519932546
STAT,1822,44,45-49,1866,2.0637853207204904
STAT,1868,19,30-34,1887,1.4454538215415513
SIM,1873,22,na,1895,2433
STAT,1878,48,45-49,1926,0.2294274152168582
SIM,1822,34,45-49,1856,2
SIM,1860,89,na,1949,73
STAT,1812,96,na,1908,3.7299364157882855
STAT,1914,44,15-19,1958,0.0014327811533389884
STAT,1933,33,20-24,1966,3.103360219753032
SIM,1925,30,50-100,1955,5
STAT,1861,108,na,1969,0.018714355967865966
SIM,1833,34,20-24,1867,4
SIM,1846,25,30-34,1871,27
STAT,1919,10,na,1929,4148.992249963802
SIM,1883,75,na,1958,986
STAT,1858,29,15-19,1887,0.3390896433238853
SIM,1844,19,na,1863,1952
SIM,1830,36,45-49,1866,2
SIM,1811,44,35-39,1855,2
SIM,1842,35,50-100,1877,4
STAT,1866,75,na,1941,896.992254644801
SIM,1901,34,50-100,1935,1
STAT,1826,54,30-34,1880,0.005094882250527476
SIM,1920,49,na,1969,3879
SIM,1842,93,na,1935,13
SIM,1943,19,30-34,1962,19
STAT,1845,15,20-24,1860,16.04451079417008
STAT,1887,28,30-34,1915,26.51565327645421
STAT,1893,45,30-34,1938,0.0660683889899598
STAT,1842,17,45-49,1859,0.060746351748043464
STAT,1932,30,na,1962,4754.964140380811
STAT,1901,30,20-24,1931,3.6030989463885112
STAT,1930,35,45-49,1965,0.8414706763975973
SIM,1824,64,na,1888,904
SIM,1935,20,25-29,1955,123
STAT,1845,46,40-44,1891,0.12149001349038636
SIM,1907,29,na,1936,3279
STAT,1877,36,35-39,1913,6.964360113168449
STAT,1910,40,15-19,1950,0.00138666262074023
STAT,1855,50,20-24,1905,5.31920837923102E-4
SIM,1926,32,na,1958,4268
SIM,1839,38,45-49,1877,1
STAT,1915,45,20-24,1960,0.010569641206433524
STAT,1908,16,na,1924,3548.057594261367
STAT,1862,42,25-29,1904,0.5180435554293312
STAT,1838,25,30-34,1863,21.817776264364007
SIM,1908,18,25-29,1926,8
SIM,1865,88,na,1953,112
STAT,1879,49,15-19,1928,3.872901849163674E-4
SIM,1898,27,45-49,1925,3
SIM,1853,15,20-24,1868,14
SIM,1859,39,25-29,1898,1
SIM,1899,15,na,1914,3371
STAT,1823,69,na,1892,785.4015529446555
STAT,1811,79,na,1890,303.1968372290942
STAT,1910,23,25-29,1933,81.69545042259723
STAT,1938,18,45-49,1956,0.4653737163079977
STAT,1925,40,45-49,1965,0.1908744765349371
SIM,1885,36,35-39,1921,12
SIM,1826,44,30-34,1870,1
STAT,1870,40,45-49,1910,1.4010237905165985
STAT,1842,37,25-29,1879,2.445936925488897
SIM,1936,10,na,1946,2977
STAT,1830,52,30-34,1882,0.003922880816605346
STAT,1853,48,40-44,1901,0.1279355272796106
STAT,1838,19,45-49,1857,0.057247638526527
SIM,1868,17,30-34,1885,2
SIM,1892,36,na,1928,3129
STAT,1870,37,na,1907,2183.4284297751697
STAT,1897,17,35-39,1914,0.6932294637217093
STAT,1899,41,45-49,1940,0.13513566882678374
STAT,1841,100,na,1941,0.7319107490045239
STAT,1916,3,na,1919,4052.0548822209325
SIM,1850,37,25-29,1887,2
STAT,1918,44,35-39,1962,0.20158501403896817
SIM,1886,40,na,1926,2288
STAT,1832,110,na,1942,1.6646645409465046E-4
STAT,1867,47,30-34,1914,0.08546882938846742
STAT,1870,35,35-39,1905,6.617162565816902
STAT,1935,19,30-34,1954,15.65677907759207
STAT,1820,45,25-29,1865,0.09950695447526337
STAT,1822,36,45-49,1858,3.6991796083234463
STAT,1858,66,na,1924,1213.9844495657815
STAT,1852,53,20-24,1905,5.263917144138053E-4
STAT,1866,35,20-24,1901,0.6780358778609379
SIM,1824,42,na,1866,1487
STAT,1818,58,na,1876,1132.399288267762
STAT,1830,46,45-49,1876,0.17914066722863414
SIM,1857,26,45-49,1883,5
STAT,1852,44,30-34,1896,0.8222430712317881
SIM,1825,81,na,1906,265
SIM,1905,30,40-44,1935,3
STAT,1927,20,25-29,1947,108.14950759579598
SIM,1866,20,na,1886,2114
STAT,1819,51,50-100,1870,0.028020846810119685
STAT,1913,27,na,1940,3526.385892449027
SIM,1838,26,35-39,1864,10
SIM,1849,17,20-24,1866,15
SIM,1880,35,na,1915,2405
SIM,1883,53,na,1936,1930
STAT,1858,40,45-49,1898,1.1197191574929823
SIM,1790,77,na,1867,284
STAT,1871,27,50-100,1898,0.6000777100960365
SIM,1855,1,na,1856,2904
STAT,1863,37,45-49,1900,1.6526349511060752
SIM,1851,18,15-19,1869,4
SIM,1872,15,30-34,1887,3
STAT,1885,35,30-34,1920,5.066224550341714
STAT,1909,29,30-34,1938,35.12408519294228
SIM,1917,29,30-34,1946,51
STAT,1840,24,45-49,1864,0.5736328748028542
STAT,1865,35,50-100,1900,1.0612586882797876
SIM,1895,28,30-34,1923,37
SIM,1914,53,na,1967,3372
SIM,1853,87,na,1940,111
STAT,1812,47,40-44,1859,0.5731913660522628
STAT,1803,92,na,1895,14.000150362423966
STAT,1818,44,30-34,1862,2.53435873949934
STAT,1871,53,30-34,1924,0.005494265938800169
SIM,1893,35,30-34,1928,13
STAT,1876,17,15-19,1893,5.792150035450171
SIM,1906,44,na,1950,3146
STAT,1912,47,45-49,1959,0.19732754166379177
STAT,1906,40,35-39,1946,0.17476104490789646
STAT,1851,76,na,1927,681.5081488558343
STAT,1941,4,na,1945,3904.7920051603846
STAT,1849,26,45-49,1875,0.9940839281264133
STAT,1869,40,na,1909,2136.5656010755397
SIM,1927,18,35-39,1945,5
STAT,1877,91,na,1968,181.00489248789754
STAT,1916,45,na,1961,3576.487866095865
STAT,1845,107,na,1952,0.0033371448915008313
STAT,1824,49,25-29,1873,0.0682522975212715
SIM,1942,28,na,1970,3621
STAT,1905,41,45-49,1946,0.1425576447267261
SIM,1869,46,50-100,1915,3
SIM,1828,37,30-34,1865,5
STAT,1823,37,15-19,1860,0.09137736447657754
STAT,1886,16,20-24,1902,17.734936286871935
SIM,1900,35,25-29,1935,1
STAT,1853,35,na,1888,1820.4098135258732
SIM,1894,16,20-24,1910,20
STAT,1898,49,25-29,1947,0.04067011392764245
STAT,1886,47,40-44,1933,0.170045783270464
STAT,1940,17,na,1957,3530.518962963854
STAT,1928,32,35-39,1960,10.794326011954844
SIM,1929,30,na,1959,4503
STAT,1919,18,35-39,1937,4.369149688734735
SIM,1868,86,na,1954,143
STAT,1890,28,15-19,1918,0.522166406043887
SIM,1851,21,na,1872,1931
STAT,1821,41,25-29,1862,1.1382787037758766
SIM,1839,72,na,1911,842
STAT,1907,63,na,1970,2778.0015405130202
SIM,1917,29,na,1946,3632
STAT,1879,17,na,1896,2497.5042035903034
SIM,1877,5,na,1882,2657
SIM,1922,31,45-49,1953,5
SIM,1921,33,na,1954,3968
STAT,1836,107,na,1943,0.0030538939995188425
STAT,1862,49,45-49,1911,0.18664154108458053
STAT,1858,34,na,1892,1752.363787770733
STAT,1918,26,na,1944,3779.208103173544
SIM,1863,17,30-34,1880,1
STAT,1864,15,30-34,1879,1.5436939137263497
SIM,1889,69,na,1958,1765
STAT,1855,17,30-34,1872,1.3471696150397496
SIM,1881,41,na,1922,1804
STAT,1884,43,15-19,1927,0.012795892795466854
STAT,1929,24,50-100,1953,0.7811210767148483
SIM,1915,16,na,1931,3664
STAT,1846,54,35-39,1900,0.006209778458155627
STAT,1896,73,na,1969,1847.1546176345837
STAT,1937,19,40-44,1956,1.2816518568581867
SIM,1854,42,40-44,1896,8
SIM,1870,49,45-49,1919,3
SIM,1926,4,na,1930,4586
STAT,1840,37,15-19,1877,0.04358673554996685
SIM,1807,62,na,1869,904
SIM,1868,26,20-24,1894,10
STAT,1820,34,50-100,1854,2.7362668504293093
SIM,1869,33,50-100,1902,1
STAT,1820,94,na,1914,10.528819298771905
STAT,1875,16,45-49,1891,0.06358489373128912
SIM,1838,47,50-100,1885,2
SIM,1864,61,na,1925,1681
STAT,1910,47,35-39,1957,0.11364230402928233
SIM,1840,69,na,1909,926
SIM,1864,71,na,1935,1135
STAT,1932,21,45-49,1953,1.3988730783774697
SIM,1940,15,na,1955,3449
STAT,1882,47,20-24,1929,0.010973187600668254
SIM,1911,13,na,1924,3727
STAT,1839,52,na,1891,1425.9436044295887
STAT,1949,18,20-24,1967,148.91559947353744
STAT,1831,40,50-100,1871,0.8012495177107316
STAT,1940,20,40-44,1960,3.238005062348274
STAT,1843,47,50-100,1890,0.16511632262461223
SIM,1828,35,na,1863,1644
STAT,1874,48,25-29,1922,0.05489829089585654
STAT,1851,34,50-100,1885,0.6718999961120995
STAT,1853,32,30-34,1885,13.607113227012896
STAT,1878,45,40-44,1923,0.1702302970044781
STAT,1922,30,na,1952,4069.3702393774847
SIM,1876,19,na,1895,2460
STAT,1846,42,40-44,1888,1.6884929903176926
STAT,1913,48,15-19,1961,3.3872924706036074E-4
STAT,1917,31,20-24,1948,2.4228133151927245
STAT,1882,20,50-100,1902,0.37687864917223574
STAT,1909,30,50-100,1939,0.7513713760082573
STAT,1921,21,35-39,1942,10.077250856342976
STAT,1830,39,na,1869,1592.8804047669098
SIM,1836,54,na,1890,1310
STAT,1883,51,35-39,1934,0.008011977429058067
STAT,1920,36,50-100,1956,0.4346606979289013
STAT,1918,18,50-100,1936,0.384232305045907
STAT,1865,22,50-100,1887,0.3534216791675444
STAT,1861,43,20-24,1904,0.12384446036453364
SIM,1900,50,na,1950,2919
SIM,1832,61,na,1893,1086
SIM,1930,30,40-44,1960,7
STAT,1840,28,50-100,1868,0.5196748423051929
STAT,1856,22,na,1878,1830.3376993953243
STAT,1814,47,15-19,1861,0.0012234805831577542
STAT,1878,17,25-29,1895,5.579010890591051
STAT,1866,46,50-100,1912,0.21460409146070986
STAT,1914,31,45-49,1945,1.5025128450796734
STAT,1837,44,40-44,1881,1.5278791756762853
STAT,1821,54,30-34,1875,0.008674967250099079
STAT,1899,17,50-100,1916,0.06341521939431342
STAT,1854,53,30-34,1907,0.004190577841797537
STAT,1833,47,25-29,1880,0.04139743251985569
STAT,1849,16,50-100,1865,0.045488801365652906
STAT,1873,49,20-24,1922,0.011257317689386299
SIM,1861,32,30-34,1893,21
STAT,1823,50,25-29,1873,0.004368632669028337
STAT,1910,20,20-24,1930,99.23873844715932
STAT,1807,47,50-100,1854,0.9476011146485968
STAT,1829,27,30-34,1856,36.18912939187703
SIM,1817,72,na,1889,594
STAT,1877,52,50-100,1929,0.01472092111565561
STAT,1811,46,35-39,1857,0.47407478156877036
STAT,1894,27,50-100,1921,0.7766182018427187
STAT,1936,31,30-34,1967,14.464812185820104
SIM,1845,44,40-44,1889,4
SIM,1918,17,30-34,1935,13
STAT,1896,18,30-34,1914,1.983437443004363
SIM,1922,30,40-44,1952,8
STAT,1880,39,50-100,1919,1.2104453662132002
STAT,1920,41,20-24,1961,0.018452440150478384
STAT,1827,42,30-34,1869,1.1028610201518212
STAT,1896,49,15-19,1945,2.7564125561396166E-4
STAT,1805,53,35-39,1858,0.030974026419716347
STAT,1897,14,na,1911,3252.133936401371
STAT,1937,30,35-39,1967,8.550740255066898
STAT,1799,60,na,1859,939.2226441530347
STAT,1904,40,25-29,1944,0.0610353423509928
SIM,1872,90,na,1962,121
SIM,1859,28,20-24,1887,10
STAT,1940,21,45-49,1961,1.0831693801354014
STAT,1856,16,35-39,1872,0.481058897979481
SIM,1925,26,na,1951,4153
STAT,1914,30,40-44,1944,3.751308709627756
STAT,1875,14,na,1889,2506.1648909860983
STAT,1881,22,40-44,1903,1.9016974912286573
STAT,1920,42,25-29,1962,0.07450459831805216
SIM,1919,29,40-44,1948,4
STAT,1841,53,45-49,1894,0.00984438977837181
STAT,1912,17,50-100,1929,0.0715722561356719
SIM,1880,44,35-39,1924,1
SIM,1864,16,35-39,1880,2
STAT,1872,44,35-39,1916,1.6927247158461747
STAT,1840,54,40-44,1894,0.006718861757459497
STAT,1810,47,30-34,1857,0.32303260957563923
STAT,1888,54,na,1942,2337.8586259866283
STAT,1872,50,20-24,1922,7.092839376017641E-4
STAT,1949,18,50-100,1967,0.41152054955453854
SIM,1848,28,45-49,1876,3
SIM,1885,8,na,1893,2499
SIM,1909,30,25-29,1939,11
STAT,1888,40,30-34,1928,1.2964964804086996
STAT,1873,23,na,1896,2258.985393488596
STAT,1801,59,na,1860,952.7807162834878
SIM,1818,42,30-34,1860,1
SIM,1914,31,45-49,1945,5
STAT,1888,19,35-39,1907,0.6093200670189364
STAT,1933,15,na,1948,4676.340046493275
STAT,1840,39,na,1879,1628.2839991905191
STAT,1916,48,40-44,1964,0.15234315954705813
STAT,1877,33,30-34,1910,17.037180475310866
STAT,1886,73,na,1959,1305.229799891366
STAT,1849,19,20-24,1868,16.17173023053712
SIM,1830,33,40-44,1863,9
SIM,1885,33,30-34,1918,30
STAT,1872,49,na,1921,2087.385546929505
STAT,1831,31,40-44,1862,3.505758912949271
STAT,1953,2,na,1955,4496.982979666544
SIM,1844,17,20-24,1861,13
SIM,1874,71,na,1945,1261
STAT,1912,42,25-29,1954,0.06506529200577375
STAT,1894,33,30-34,1927,21.107509384567546
STAT,1936,32,35-39,1968,8.385081072423155
STAT,1821,57,na,1878,1160.5694666698985
SIM,1857,19,20-24,1876,21
STAT,1820,42,20-24,1862,0.2918434476690012
SIM,1928,15,25-29,1943,60
STAT,1853,67,na,1920,1199.6867183738818
STAT,1918,41,30-34,1959,0.1285968195031273
STAT,1890,29,50-100,1919,0.7335423369493946
STAT,1841,46,20-24,1887,0.008417604027936279
STAT,1914,33,na,1947,3581.3819813411856
SIM,1949,19,25-29,1968,56
STAT,1904,40,50-100,1944,0.10041298194625431
SIM,1931,33,na,1964,4633
STAT,1912,8,na,1920,3797.678187579354
STAT,1937,28,na,1965,3448.1132856354216
SIM,1859,15,15-19,1874,6
STAT,1890,41,25-29,1931,0.745025301338332
STAT,1831,43,35-39,1874,1.3192369007368225
STAT,1901,42,15-19,1943,0.0012665419676342643
SIM,1896,34,50-100,1930,1
SIM,1826,54,na,1880,1204
STAT,1822,53,35-39,1875,0.01092119682766473
STAT,1876,54,20-24,1930,7.004074832384382E-4
STAT,1925,31,20-24,1956,2.737815451085285
STAT,1854,41,na,1895,1661.1398424436243
STAT,1868,34,na,1902,2132.4676504358677
STAT,1904,5,na,1909,3551.1129927948914
SIM,1866,52,na,1918,1888
STAT,1824,32,50-100,1856,2.231324476491135
STAT,1953,13,na,1966,4488.131698052914
SIM,1882,46,50-100,1928,4
STAT,1887,43,40-44,1930,2.3596051761127534
SIM,1930,30,50-100,1960,1
STAT,1793,97,na,1890,0.8910472931730342
SIM,1901,13,na,1914,3406
SIM,1866,40,45-49,1906,3
SIM,1834,42,na,1876,1541
STAT,1926,43,30-34,1969,0.1486513981528339
STAT,1880,46,35-39,1926,0.1398267509988058
STAT,1927,42,35-39,1969,0.23857176799346155
STAT,1861,86,na,1947,174.2808897400702
SIM,1829,28,35-39,1857,9
STAT,1839,20,na,1859,1855.6595786520359
SIM,1836,18,25-29,1854,9
SIM,1837,17,na,1854,1990
STAT,1930,30,25-29,1960,11.280792231442785
SIM,1958,10,na,1968,4785
STAT,1821,48,45-49,1869,0.3668766086978473
STAT,1840,21,40-44,1861,1.7516496859458586
STAT,1836,39,50-100,1875,0.9558243094990689
SIM,1897,66,na,1963,2315
STAT,1877,53,25-29,1930,0.003415211477961992
STAT,1900,49,40-44,1949,0.12391439272655518
STAT,1897,46,50-100,1943,0.17552448185431044
STAT,1789,82,na,1871,147.8940425922459
STAT,1892,49,30-34,1941,0.06326033280013292
SIM,1933,31,20-24,1964,2
STAT,1910,6,na,1916,3739.6615196988255
SIM,1855,18,35-39,1873,2
STAT,1922,33,45-49,1955,1.6725280186882805
STAT,1929,42,45-49,1971,0.20360468737787982
SIM,1940,21,45-49,1961,1
STAT,1802,54,20-24,1856,0.002075234720021716
STAT,1911,30,15-19,1941,0.11916715810085872
SIM,1818,57,na,1875,1105
STAT,1902,20,20-24,1922,92.42448958181653
STAT,1866,18,45-49,1884,0.05807646876556469
STAT,1922,46,15-19,1968,4.0077711837240487E-4
STAT,1853,89,na,1942,79.50409860543999
STAT,1898,32,na,1930,3050.706836698113
SIM,1930,33,45-49,1963,3
STAT,1810,44,50-100,1854,3.6937095201052097
SIM,1931,11,na,1942,4895
STAT,1842,50,35-39,1892,0.006324120990998222
STAT,1914,11,na,1925,3865.191716325637
STAT,1771,87,na,1858,38.17931816903989
STAT,1847,45,50-100,1892,0.1829127795206632
SIM,1839,94,na,1933,7
STAT,1884,30,45-49,1914,1.6406278183785832
SIM,1889,47,na,1936,2702
SIM,1857,37,na,1894,1870
SIM,1885,34,na,1919,2276
STAT,1836,52,25-29,1888,0.0023208091013965522
SIM,1841,43,na,1884,1561
STAT,1847,18,35-39,1865,0.5020337296664645
STAT,1790,79,na,1869,259.9498310736594
STAT,1859,19,na,1878,1979.9020710553777
STAT,1869,20,50-100,1889,0.3770393625487261
STAT,1906,31,45-49,1937,1.3833264207367544
SIM,1889,26,40-44,1915,3
STAT,1839,42,na,1881,1621.8481254381466
STAT,1864,51,25-29,1915,0.0029965439568822973
STAT,1822,33,40-44,1855,10.974756556442015
SIM,1892,30,45-49,1922,4
SIM,1890,33,50-100,1923,1
STAT,1808,91,na,1899,22.405826023129546
STAT,1874,33,50-100,1907,0.8806495590423996
SIM,1858,86,na,1944,151
STAT,1837,107,na,1944,0.003060578189590961
STAT,1857,48,25-29,1905,0.04237627786543408
SIM,1923,0,na,1923,4690
STAT,1812,43,25-29,1855,2.3665505316241497
STAT,1821,47,na,1868,1383.8736095522943
STAT,1929,41,40-44,1970,0.3064353936283911
STAT,1905,46,15-19,1951,3.0897551826049053E-4
STAT,1916,41,20-24,1957,0.017121654904020074
SIM,1916,44,na,1960,3493
SIM,1876,43,30-34,1919,2
SIM,1835,91,na,1926,24
STAT,1863,30,25-29,1893,8.559550350753529
STAT,1921,20,30-34,1941,30.85030201988669
STAT,1853,57,na,1910,1520.8809604315657
STAT,1867,16,45-49,1883,0.05958934155316681
SIM,1878,15,25-29,1893,7
STAT,1868,43,30-34,1911,1.0287587979157333
STAT,1893,48,35-39,1941,0.093421450935944
STAT,1860,45,50-100,1905,0.19013159532040394
SIM,1872,42,35-39,1914,4
STAT,1912,52,na,1964,3279.405918401078
SIM,1837,42,40-44,1879,5
STAT,1846,45,45-49,1891,0.17678719310413094
SIM,1867,15,na,1882,2493
STAT,1927,41,30-34,1968,0.15168534522235635
SIM,1825,91,na,1916,29
SIM,1837,49,na,1886,1487
SIM,1946,10,na,1956,4001
SIM,1859,17,15-19,1876,4
STAT,1872,60,na,1932,1807.20008316603
STAT,1842,94,na,1936,14.473563538756995
SIM,1854,93,na,1947,19
SIM,1909,15,15-19,1924,9
STAT,1911,32,30-34,1943,14.493839058810972
STAT,1822,49,15-19,1871,5.227255715111195E-4
STAT,1900,20,na,1920,3117.899594124788
STAT,1871,32,25-29,1903,9.60830339688713
SIM,1895,22,na,1917,2988
SIM,1786,94,na,1880,3
SIM,1842,61,na,1903,1218
STAT,1832,52,40-44,1884,0.00661825966094073
STAT,1861,34,30-34,1895,13.596966463260836
STAT,1954,4,na,1958,4592.410483414834
STAT,1918,41,50-100,1959,0.11817005009491272
STAT,1763,99,na,1862,0.17753157488710222
STAT,1850,43,45-49,1893,1.0473954546750386
SIM,1848,25,40-44,1873,2
STAT,1820,36,35-39,1856,17.21674980132203
STAT,1824,45,50-100,1869,0.3080298647058831
STAT,1840,51,50-100,1891,0.009958716781157381
STAT,1844,53,na,1897,1471.4152945943679
STAT,1924,46,25-29,1970,0.059805647073092764
STAT,1858,16,45-49,1874,0.056852833329428316
STAT,1848,16,35-39,1864,0.5084273425503497
STAT,1831,57,na,1888,1180.6102660551207
STAT,1864,42,35-39,1906,1.522777007493085
STAT,1923,40,35-39,1963,0.22295432573670187
STAT,1810,62,na,1872,909.8572676548482
STAT,1824,53,45-49,1877,0.016695501003694303
STAT,1854,47,45-49,1901,0.16806725730819644
STAT,1901,34,50-100,1935,1.201216681346048
STAT,1929,17,40-44,1946,1.6862660078709426
STAT,1910,44,30-34,1954,0.1127438106366254
STAT,1879,50,30-34,1929,0.0059709054815142975
STAT,1864,18,35-39,1882,0.47511130152067166
SIM,1871,34,40-44,1905,4
STAT,1862,46,40-44,1908,0.13867401958383158
STAT,1858,27,50-100,1885,0.4850354304897496
SIM,1907,19,20-24,1926,26
STAT,1888,6,na,1894,2916.5616456715943
SIM,1812,95,na,1907,5
STAT,1912,40,25-29,1952,0.06580283836200912
SIM,1833,24,na,1857,1719
STAT,1842,109,na,1951,5.152265611613173E-4
SIM,1903,30,30-34,1933,24
STAT,1891,44,45-49,1935,1.7256334356475613
STAT,1933,25,na,1958,4703.106625616521
SIM,1859,49,na,1908,1758
SIM,1889,15,na,1904,3073
SIM,1880,41,30-34,1921,5
STAT,1776,101,na,1877,0.1261132103971856
STAT,1856,40,35-39,1896,1.34817834719703
SIM,1844,39,50-100,1883,3
SIM,1846,42,na,1888,1665
STAT,1806,58,na,1864,1048.0922715133818
STAT,1839,16,35-39,1855,0.48073569429991386
SIM,1848,23,na,1871,1893
SIM,1827,39,na,1866,1521
STAT,1867,19,15-19,1886,5.318595155151414
SIM,1875,19,15-19,1894,6
SIM,1860,57,na,1917,1660
SIM,1926,30,25-29,1956,16
STAT,1881,49,20-24,1930,0.010722624082109635
SIM,1894,48,na,1942,2812
STAT,1852,47,35-39,1899,0.10102488711010611
STAT,1872,41,30-34,1913,1.0943287451597652
STAT,1902,45,35-39,1947,0.10633716981494777
SIM,1791,100,na,1891,1
STAT,1837,40,25-29,1877,0.5045478319956747
STAT,1868,28,20-24,1896,10.536830455225058
STAT,1901,37,40-44,1938,1.2494087681843504
STAT,1877,29,50-100,1906,0.622376474844664
STAT,1861,50,45-49,1911,0.011563127589814166
STAT,1825,61,na,1886,1042.6584483371482
STAT,1864,106,na,1970,0.12908340794464937
STAT,1809,54,na,1863,1131.0448914168903
STAT,1865,47,20-24,1912,0.010227291063152186
SIM,1862,16,na,1878,2266
SIM,1878,43,40-44,1921,5
STAT,1938,14,na,1952,3680.4909237009706
STAT,1931,40,35-39,1971,0.2548335868475167
STAT,1948,24,na,1972,3958.51221349952
STAT,1855,48,15-19,1903,2.8067881552238234E-4
STAT,1908,48,na,1956,3130.068025976314
SIM,1870,89,na,1959,121
STAT,1921,45,45-49,1966,0.2325475902006459
STAT,1815,61,na,1876,1032.4154659168344
STAT,1873,53,40-44,1926,0.009924740649384037
STAT,1840,50,25-29,1890,0.0023578767337824012
STAT,1882,70,na,1952,1289.0258283546416
STAT,1828,54,40-44,1882,0.007199431585406104
SIM,1865,56,na,1921,1787
SIM,1890,23,na,1913,2982
STAT,1827,45,35-39,1872,0.13149780208919812
STAT,1847,71,na,1918,984.2916391269792
STAT,1895,45,40-44,1940,0.1201225373006459
STAT,1923,15,na,1938,4101.976940191758
SIM,1885,18,20-24,1903,15
STAT,1890,49,20-24,1939,0.0076547300541331695
STAT,1901,33,25-29,1934,13.487067619521289
STAT,1834,53,na,1887,1341.8820098186586
STAT,1924,34,50-100,1958,0.9100566511858587
SIM,1852,38,na,1890,1788
STAT,1845,41,50-100,1886,0.7710862425662642
STAT,1809,54,30-34,1863,0.015369114527913279
STAT,1880,43,30-34,1923,1.1367234866238762
SIM,1915,48,na,1963,3339
STAT,1858,56,na,1914,1510.7191286054922
STAT,1868,52,20-24,1920,6.615770561787281E-4
STAT,1930,32,40-44,1962,4.770889359041726
SIM,1866,19,na,1885,2264
STAT,1794,61,na,1855,920.047
SIM,1926,19,30-34,1945,20
STAT,1823,41,35-39,1864,2.4832804427865725
STAT,1821,45,40-44,1866,0.27807098238502237
SIM,1875,56,na,1931,1940
STAT,1928,14,na,1942,4701.069066727824
SIM,1840,80,na,1920,376
STAT,1797,109,na,1906,1.7458453467722422E-4
SIM,1891,42,45-49,1933,5
SIM,1945,14,na,1959,3886
STAT,1857,71,na,1928,994.5078698539882
SIM,1829,25,30-34,1854,25
SIM,1878,17,25-29,1895,7
STAT,1810,48,35-39,1858,0.4595632997917942
STAT,1916,47,50-100,1963,0.21915762242768846
STAT,1843,42,15-19,1885,0.009604028558806935
STAT,1820,47,50-100,1867,0.41194614706224686
STAT,1888,22,na,1910,2640.454296699459
STAT,1823,80,na,1903,331.06107242379346
STAT,1884,47,30-34,1931,0.08992425030147538
STAT,1888,16,30-34,1904,1.7838431133160126
STAT,1908,41,20-24,1949,0.015524908088348404
SIM,1896,16,30-34,1912,4
SIM,1903,31,35-39,1934,16
STAT,1926,32,25-29,1958,10.55756308527557
STAT,1849,50,45-49,1899,0.011038779519993493
SIM,1934,32,25-29,1966,13
SIM,1867,17,15-19,1884,3
STAT,1844,75,na,1919,714.9857963882872
SIM,1924,47,50-100,1971,1
STAT,1883,42,45-49,1925,1.3845014903255686
STAT,1851,44,15-19,1895,0.009799913298891695
STAT,1908,26,na,1934,3355.9324573892036
STAT,1886,40,20-24,1926,0.16008030686121444
STAT,1870,49,45-49,1919,0.21414904719963393
STAT,1866,15,40-44,1881,0.16552172795332154
SIM,1871,30,25-29,1901,11
STAT,1798,64,na,1862,845.1748706518049
STAT,1831,34,45-49,1865,1.3562097428770563
STAT,1841,49,25-29,1890,0.03888100933791252
SIM,1906,34,na,1940,3266
STAT,1924,11,na,1935,4463.997882816782
STAT,1846,51,30-34,1897,0.004436152855641315
STAT,1922,30,40-44,1952,4.210617584477896
SIM,1884,48,na,1932,2171
STAT,1876,45,30-34,1921,0.09541916241407408
STAT,1899,40,50-100,1939,0.0959183939550702
STAT,1890,32,35-39,1922,11.696415066187658
STAT,1784,83,na,1867,120.3891961572175
STAT,1878,41,25-29,1919,0.6350774594192518
STAT,1827,51,50-100,1878,0.013604594392725601
SIM,1837,27,30-34,1864,26
STAT,1942,24,50-100,1966,0.6513104846897585
SIM,1889,29,45-49,1918,1
STAT,1831,40,30-34,1871,0.8719480064809639
STAT,1816,44,20-24,1860,0.39186897148888444
STAT,1918,30,25-29,1948,9.353062332388447
STAT,1847,93,na,1940,21.551016944409692
STAT,1862,60,na,1922,1540.4643704178118
STAT,1869,29,na,1898,2168.5105694724966
STAT,1904,42,40-44,1946,0.21139154635307286
STAT,1854,44,40-44,1898,1.5876003354021346
SIM,1883,85,na,1968,451
SIM,1777,80,na,1857,199
STAT,1879,23,50-100,1902,0.40200695283582205
SIM,1855,15,30-34,1870,2
STAT,1843,57,na,1900,1357.398624470542
STAT,1813,46,45-49,1859,0.6558606994770693
STAT,1866,85,na,1951,238.85917332147693
STAT,1892,45,15-19,1937,2.696421426290457E-4
STAT,1844,54,25-29,1898,0.0023923631439055817
STAT,1870,1,na,1871,3263.7795372142045
SIM,1888,17,35-39,1905,1
SIM,1911,30,30-34,1941,19
SIM,1875,34,na,1909,2301
STAT,1835,44,30-34,1879,0.8545730822661846
STAT,1944,20,25-29,1964,94.28107227160959
SIM,1843,24,na,1867,1921
STAT,1881,38,15-19,1919,0.05099283289088612
STAT,1919,42,35-39,1961,0.20614864185528775
STAT,1868,46,35-39,1914,0.12654616709049404
SIM,1850,41,45-49,1891,1
STAT,1896,51,na,1947,2699.403723549085
SIM,1820,34,35-39,1854,7
SIM,1899,47,na,1946,2971
STAT,1878,16,20-24,1894,17.496971956481474
STAT,1880,37,45-49,1917,1.9853829066077993
STAT,1899,17,45-49,1916,0.08455362585908456
STAT,1897,36,na,1933,2990.826102136527
STAT,1845,18,50-100,1863,0.043559324872850747
SIM,1816,76,na,1892,380
STAT,1873,47,20-24,1920,0.01144377274027947
STAT,1851,49,35-39,1900,0.09860530797176001
STAT,1845,16,na,1861,2065.1639812569842
STAT,1897,41,35-39,1938,0.15958490034154219
SIM,1912,42,40-44,1954,2
STAT,1768,98,na,1866,0.3807884540823261
STAT,1887,46,45-49,1933,0.25008552359627206
SIM,1831,41,35-39,1872,4
SIM,1941,11,na,1952,3772
STAT,1903,3,na,1906,3553.4567910418596
SIM,1868,29,25-29,1897,41
STAT,1918,19,30-34,1937,12.465984208397714
STAT,1813,52,30-34,1865,0.015562509099001365
STAT,1859,17,15-19,1876,5.17960085888882
SIM,1878,28,30-34,1906,30
SIM,1893,2,na,1895,3323
STAT,1934,31,20-24,1965,3.147917534001273
SIM,1843,44,30-34,1887,1
STAT,1849,19,na,1868,2093.871895036015
STAT,1842,41,45-49,1883,1.1358092407630889
STAT,1870,48,40-44,1918,0.15666794429067518
SIM,1906,12,na,1918,3536
STAT,1847,15,30-34,1862,1.4843629894650774
STAT,1893,33,na,1926,2846.8022187286983
SIM,1864,93,na,1957,29
STAT,1865,54,45-49,1919,0.012084769069476168
STAT,1903,30,30-34,1933,23.65716172980096
SIM,1845,68,na,1913,1048
SIM,1813,58,na,1871,1085
SIM,1787,78,na,1865,264
STAT,1891,3,na,1894,3089.8386844633906
SIM,1924,38,25-29,1962,1
STAT,1918,33,30-34,1951,15.749511086500906
STAT,1896,29,na,1925,2956.34861821626
STAT,1930,18,na,1948,4483.596330373688
SIM,1910,23,25-29,1933,94
SIM,1872,59,na,1931,1805
STAT,1832,46,20-24,1878,0.008685440659585163
STAT,1812,48,45-49,1860,0.7771463067579336
SIM,1912,31,35-39,1943,9
SIM,1843,20,35-39,1863,8
STAT,1892,15,na,1907,3002.308899212124
SIM,1846,21,15-19,1867,2
SIM,1857,33,40-44,1890,7
STAT,1770,105,na,1875,0.014855075229815221
SIM,1918,27,45-49,1945,1
STAT,1854,15,20-24,1869,15.354024456127865
STAT,1900,28,20-24,1928,15.320002449614597
STAT,1873,56,na,1929,1954.2028661274471
STAT,1921,43,30-34,1964,0.13581631788171689
SIM,1944,24,35-39,1968,13
STAT,1925,36,25-29,1961,1.117375622640761
STAT,1911,16,30-34,1927,2.309942040057238
STAT,1845,9,na,1854,2179.0
STAT,1844,30,50-100,1874,0.7769420810219566
STAT,1936,24,35-39,1960,8.498186034949864
STAT,1903,16,na,1919,3403.136850443653
STAT,1792,103,na,1895,0.026161930406264987
STAT,1845,37,na,1882,1751.6670113754124
STAT,1916,38,25-29,1954,0.9478051570430517
STAT,1904,46,35-39,1950,0.10731487642772936
SIM,1832,94,na,1926,11
STAT,1892,47,30-34,1939,0.06430811424303284
STAT,1838,21,15-19,1859,2.894328987345173
SIM,1845,57,na,1902,1401
STAT,1928,26,50-100,1954,1.1623879889904603
SIM,1910,18,30-34,1928,2
STAT,1902,23,25-29,1925,76.08581512234332
STAT,1913,37,45-49,1950,0.6355765051811413
STAT,1907,45,20-24,1952,0.009487177529110656
STAT,1881,49,50-100,1930,0.21945636419165876
STAT,1867,24,45-49,1891,0.6147062544671998
STAT,1927,31,30-34,1958,18.31911656350391
STAT,1930,34,40-44,1964,4.764736893596001
STAT,1933,35,20-24,1968,0.33978376988346914
STAT,1805,72,na,1877,588.3658599360002
STAT,1809,86,na,1895,89.03716524738324
STAT,1861,48,40-44,1909,0.13278571074518797
SIM,1837,23,15-19,1860,2
STAT,1822,64,na,1886,901.4346499251644
STAT,1812,101,na,1913,0.24787173681973954
SIM,1866,26,45-49,1892,2
SIM,1917,35,30-34,1952,1
SIM,1840,38,na,1878,1653
STAT,1792,80,na,1872,249.0762424247712
STAT,1796,94,na,1890,4.30438440628758
STAT,1803,81,na,1884,210.77791380105725
STAT,1922,35,45-49,1957,0.7340763310384387
STAT,1828,69,na,1897,826.491435726123
SIM,1905,18,20-24,1923,20
SIM,1867,19,15-19,1886,6
SIM,1930,35,45-49,1965,4
STAT,1815,49,25-29,1864,0.12581178722803338
STAT,1876,22,45-49,1898,0.6805892013520134
SIM,1926,33,30-34,1959,25
SIM,1909,36,35-39,1945,6
SIM,1921,37,45-49,1958,2
STAT,1865,37,na,1902,2017.3435701824467
SIM,1875,24,45-49,1899,3
STAT,1904,31,35-39,1935,13.778825424228675
STAT,1837,18,na,1855,1970.0853918240186
SIM,1909,29,45-49,1938,1
SIM,1830,28,na,1858,1746
SIM,1863,86,na,1949,158
STAT,1894,18,na,1912,3058.1772977633295
SIM,1838,20,25-29,1858,46
STAT,1843,26,na,1869,1811.2400995229434
STAT,1852,44,50-100,1896,0.7555747124468531
SIM,1920,30,30-34,1950,31
STAT,1927,26,35-39,1953,17.301564677276254
STAT,1921,45,na,1966,3930.8741242267756
STAT,1938,6,na,1944,3735.121382911035
SIM,1939,19,30-34,1958,12
STAT,1898,19,50-100,1917,0.06229629479103423
STAT,1913,26,na,1939,3538.4875197666274
SIM,1926,26,40-44,1952,4
STAT,1851,45,na,1896,1634.5419458406693
STAT,1903,17,35-39,1920,0.7375486299311712
STAT,1944,23,30-34,1967,29.30615533555036
STAT,1869,5,na,1874,2563.9087028887475
SIM,1908,37,30-34,1945,2
SIM,1899,32,35-39,1931,17
STAT,1904,39,45-49,1943,0.5771809201327426
SIM,1855,67,na,1922,1221
SIM,1911,17,35-39,1928,1
STAT,1863,51,50-100,1914,0.012580346048210901
STAT,1823,81,na,1904,289.4069682914316
STAT,1938,21,50-100,1959,0.6154160331100879
STAT,1934,29,30-34,1963,49.74558460690105
SIM,1942,29,30-34,1971,47
STAT,1883,30,50-100,1913,0.8554603591612454
SIM,1804,75,na,1879,395
SIM,1808,89,na,1897,29
SIM,1900,28,na,1928,3127
SIM,1793,86,na,1879,63
SIM,1912,44,40-44,1956,2
STAT,1902,18,30-34,1920,2.119429357311712
SIM,1887,22,15-19,1909,3
SIM,1912,29,na,1941,3414
STAT,1930,41,30-34,1971,0.15913532112092155
STAT,1879,22,15-19,1901,3.2623164318085207
STAT,1841,39,25-29,1880,2.2905974539784024
STAT,1842,49,50-100,1891,0.17414560639675558
STAT,1913,44,35-39,1957,0.1848987699212337
STAT,1835,20,35-39,1855,6.753309132438697
STAT,1924,39,15-19,1963,0.021345785665421554
SIM,1800,93,na,1893,7
STAT,1945,22,35-39,1967,9.748961214766405
STAT,1914,40,35-39,1954,0.18981833272136214
STAT,1942,28,25-29,1970,65.23064835756885
STAT,1818,59,na,1877,1110.1929382248309
SIM,1935,26,35-39,1961,26
STAT,1853,49,45-49,1902,0.17487477348320618
STAT,1835,52,50-100,1887,0.009796062768461731
STAT,1930,21,35-39,1951,11.429470637795896
STAT,1939,32,50-100,1971,0.796942354277969
STAT,1788,75,na,1863,363.0746064901096
STAT,1904,44,40-44,1948,0.20879521846944069
SIM,1933,36,25-29,1969,1
SIM,1953,11,na,1964,4442
STAT,1846,16,25-29,1862,5.31114226463667
STAT,1910,24,15-19,1934,4.693079308991743
STAT,1814,45,na,1859,1448.0341248208165
STAT,1910,42,15-19,1952,0.0013711203130113698
STAT,1817,108,na,1925,8.477985018652088E-4
STAT,1849,33,40-44,1882,3.3913611179303254
STAT,1929,29,20-24,1958,21.559682346177112
SIM,1909,34,40-44,1943,7
SIM,1929,29,15-19,1958,3
STAT,1881,75,na,1956,972.9161920050188
SIM,1837,21,20-24,1858,52
SIM,1854,16,25-29,1870,7
STAT,1952,18,40-44,1970,1.582947254810903
STAT,1833,24,50-100,1857,0.33160586531628583
SIM,1907,30,na,1937,3371
STAT,1939,25,15-19,1964,0.6710337526385936
STAT,1820,47,40-44,1867,0.28715464343877045
STAT,1907,47,15-19,1954,3.116575583319957E-4
SIM,1887,15,25-29,1902,8
STAT,1884,41,50-100,1925,0.9904698867393253
STAT,1918,26,40-44,1944,4.702174563233049
STAT,1918,42,50-100,1960,0.11799988522277602
STAT,1852,94,na,1946,14.489631715308432
STAT,1930,36,35-39,1966,2.9831027402396537
STAT,1864,49,20-24,1913,0.009892705024742857
STAT,1902,31,50-100,1933,1.2265594718011021
STAT,1877,38,na,1915,2297.252493572457
STAT,1899,27,45-49,1926,1.4371793437536156
SIM,1906,16,15-19,1922,7
STAT,1859,30,45-49,1889,1.330263239810771
STAT,1899,32,40-44,1931,5.613457485766828
SIM,1923,16,15-19,1939,54
SIM,1927,32,35-39,1959,15
STAT,1860,38,na,1898,1796.9221337949743
STAT,1892,47,na,1939,2650.2064910116173
STAT,1920,32,30-34,1952,16.302725651124003
SIM,1836,25,20-24,1861,6
STAT,1935,34,50-100,1969,1.079201193535734
STAT,1912,38,40-44,1950,1.3734788091147425
SIM,1864,5,na,1869,2490
STAT,1929,37,50-100,1966,0.5091942882944421
SIM,1858,32,45-49,1890,1
SIM,1934,27,30-34,1961,53
STAT,1895,16,20-24,1911,21.88806196659054
SIM,1776,94,na,1870,4
STAT,1925,43,15-19,1968,0.0017535906461004758
STAT,1852,19,na,1871,1989.1031477229462
STAT,1908,39,30-34,1947,1.5958562421671914
STAT,1825,92,na,1917,22.13606678552277
STAT,1810,45,30-34,1855,0.3338529804156773
SIM,1920,38,40-44,1958,4
SIM,1898,34,40-44,1932,8
SIM,1860,58,na,1918,1642
STAT,1834,22,40-44,1856,1.7295487640649527
SIM,1886,16,20-24,1902,15
STAT,1915,16,15-19,1931,8.995380307002936
STAT,1877,28,50-100,1905,0.6246502015784093
SIM,1869,71,na,1940,1163
STAT,1823,35,50-100,1858,2.214752087846603
STAT,1869,29,25-29,1898,38.43711920756497
STAT,1943,27,30-34,1970,39.42185084466916
SIM,1836,76,na,1912,593
SIM,1867,30,45-49,1897,1
STAT,1917,41,15-19,1958,0.0015161851194346182
SIM,1887,20,20-24,1907,62
STAT,1903,22,30-34,1925,23.942420465879945
STAT,1888,34,50-100,1922,1.0141827029077748
STAT,1874,18,na,1892,2431.387172503396
STAT,1927,19,45-49,1946,0.5836100918764605
STAT,1912,30,30-34,1942,14.763794876942397
STAT,1926,27,30-34,1953,44.37180122228409
STAT,1776,102,na,1878,0.07903136555960431
STAT,1929,41,na,1970,4550.047579435911
STAT,1935,28,35-39,1963,19.324209635995988
STAT,1947,17,20-24,1964,144.27893976107725
STAT,1874,46,50-100,1920,0.2377319212629692
SIM,1907,50,na,1957,3074
STAT,1938,29,15-19,1967,0.6600676212385364
STAT,1880,43,50-100,1923,1.0445567151459814
STAT,1875,67,na,1942,1539.2697739963508
SIM,1920,48,na,1968,3896
STAT,1918,28,35-39,1946,15.041113863815674
STAT,1884,28,na,1912,2219.5511607397716
STAT,1928,40,35-39,1968,0.24317527598682745
STAT,1868,65,na,1933,1523.23438657886
STAT,1887,17,25-29,1904,5.987942976923447
SIM,1824,95,na,1919,2
STAT,1908,44,25-29,1952,0.0616483437888604
SIM,1902,24,30-34,1926,32
SIM,1910,18,na,1928,3624
STAT,1859,19,15-19,1878,5.118764852002068
STAT,1919,32,35-39,1951,9.313974675107596
SIM,1919,31,na,1950,3933
SIM,1943,28,35-39,1971,16
SIM,1935,31,30-34,1966,16
STAT,1908,43,15-19,1951,0.0013342030862190425
STAT,1883,86,na,1969,462.8408909332655
STAT,1841,38,50-100,1879,0.9869481633260102
STAT,1849,18,45-49,1867,0.0599393618501485
SIM,1957,2,na,1959,4917
STAT,1834,41,50-100,1875,0.8005837745547756
SIM,1795,77,na,1872,326
SIM,1877,16,20-24,1893,13
SIM,1888,30,na,1918,2713
SIM,1882,89,na,1971,260
STAT,1934,34,25-29,1968,11.905999884786947
SIM,1948,9,na,1957,4239
STAT,1917,34,25-29,1951,9.065033514289118
SIM,1901,25,25-29,1926,54
STAT,1883,22,na,1905,2190.539634140072
STAT,1895,67,na,1962,2119.415281211713
SIM,1828,26,25-29,1854,37
SIM,1929,27,20-24,1956,21
STAT,1903,15,40-44,1918,0.2469918104438822
SIM,1866,31,40-44,1897,2
SIM,1878,22,20-24,1900,69
SIM,1925,29,30-34,1954,54
SIM,1901,45,na,1946,3033
STAT,1828,39,50-100,1867,1.0721204397766315
STAT,1944,26,35-39,1970,15.336136985281417
SIM,1870,88,na,1958,153
STAT,1927,24,40-44,1951,3.88892322409115
STAT,1839,45,50-100,1884,0.1709299584321205
SIM,1823,58,na,1881,1088
SIM,1878,24,15-19,1902,3
STAT,1858,26,45-49,1884,0.8479560131169507
SIM,1862,15,20-24,1877,14
STAT,1823,48,20-24,1871,0.014570273799234774
STAT,1907,36,50-100,1943,0.3695143232975374
SIM,1919,1,na,1920,4343
STAT,1933,37,15-19,1970,0.024709659880986577
STAT,1947,19,15-19,1966,48.264410373521194
SIM,1845,15,20-24,1860,11
STAT,1868,20,45-49,1888,0.6376490691643263
SIM,1882,69,na,1951,1329
SIM,1842,22,40-44,1864,2
STAT,1944,24,40-44,1968,3.4272446211093093
SIM,1925,34,25-29,1959,11
STAT,1869,16,20-24,1885,16.54710285675877
STAT,1861,55,na,1916,1624.1624219121152
SIM,1926,28,35-39,1954,20
STAT,1950,22,15-19,1972,5.965865097365663
STAT,1930,37,45-49,1967,0.8400155600328479
SIM,1935,24,40-44,1959,4
STAT,1890,39,20-24,1929,0.8813435998847914
STAT,1909,38,35-39,1947,2.1521688411693796
SIM,1920,8,na,1928,4290
STAT,1944,19,45-49,1963,0.5075092490167471
SIM,1879,21,25-29,1900,60
SIM,1909,33,30-34,1942,21
SIM,1900,26,20-24,1926,11
SIM,1877,90,na,1967,215
STAT,1845,92,na,1937,29.47232640319981
SIM,1902,19,35-39,1921,2
SIM,1930,32,40-44,1962,6
STAT,1840,48,20-24,1888,0.007840307923825033
SIM,1828,89,na,1917,48
SIM,1899,33,45-49,1932,3
STAT,1927,15,50-100,1942,0.44211217909130723
STAT,1910,25,25-29,1935,60.966480017363956
STAT,1953,16,35-39,1969,4.796492484248168
STAT,1837,73,na,1910,770.8323837318285
STAT,1858,31,40-44,1889,3.2456531649268765
SIM,1795,97,na,1892,1
SIM,1811,77,na,1888,311
SIM,1851,7,na,1858,2243
STAT,1911,15,na,1926,3668.2739047891264
STAT,1938,27,20-24,1965,17.084371986904888
SIM,1884,21,35-39,1905,7
STAT,1851,110,na,1961,5.833507201971484E-4
STAT,1757,102,na,1859,0.09009801446874469
SIM,1906,24,15-19,1930,4
STAT,1922,32,40-44,1954,4.177041927855108
SIM,1951,19,30-34,1970,19
STAT,1925,33,20-24,1958,2.7345310570624193
SIM,1831,77,na,1908,480
SIM,1860,20,35-39,1880,6
SIM,1863,21,15-19,1884,1
SIM,1861,43,na,1904,1997
SIM,1869,17,25-29,1886,4
STAT,1878,39,50-100,1917,1.196572631415658
STAT,1863,50,50-100,1913,0.012700364492666599
STAT,1870,54,50-100,1924,0.013611745077462642
STAT,1896,49,50-100,1945,0.16924387311871683
STAT,1835,21,45-49,1856,0.5942228052886366
STAT,1838,35,na,1873,1771.4571516875985
STAT,1882,37,20-24,1919,0.7081907157785763
STAT,1798,108,na,1906,5.202983285530524E-4
STAT,1898,30,50-100,1928,1.1807617277268838
STAT,1904,33,na,1937,3247.329977420724
STAT,1922,34,35-39,1956,9.706524780286076
STAT,1874,73,na,1947,1146.4466613532281
STAT,1761,116,na,1877,1.4583656284579064E-4
STAT,1878,24,20-24,1902,67.42104353007818
STAT,1915,49,15-19,1964,3.4861518470374555E-4
STAT,1940,23,45-49,1963,1.082454606301658
SIM,1920,20,30-34,1940,47
STAT,1862,29,50-100,1891,0.5129985084536994
STAT,1879,19,40-44,1898,0.1798979740249233
SIM,1784,81,na,1865,146
SIM,1886,24,20-24,1910,73
SIM,1842,60,na,1902,1253
SIM,1846,74,na,1920,755
STAT,1912,46,40-44,1958,0.14350196581603206
STAT,1859,22,45-49,1881,0.5439888612575962
STAT,1863,66,na,1929,1358.7677524263147
SIM,1935,26,na,1961,4717
STAT,1804,55,na,1859,1094.0389345047392
STAT,1904,21,35-39,1925,7.9312777572871225
STAT,1808,69,na,1877,737.6753338767301
STAT,1901,34,15-19,1935,0.18669937642598897
SIM,1829,51,na,1880,1302
STAT,1830,36,45-49,1866,1.6425116931567378
STAT,1855,21,15-19,1876,2.7586180070935216
SIM,1875,21,40-44,1896,1
STAT,1911,17,40-44,1928,0.26442589208903794
SIM,1837,24,25-29,1861,47
STAT,1934,23,50-100,1957,0.8350855219503391
SIM,1903,23,35-39,1926,10
SIM,1910,20,20-24,1930,86
STAT,1815,46,20-24,1861,0.02742663345620735
STAT,1841,54,20-24,1895,4.947406726017856E-4
STAT,1857,18,na,1875,1998.2871077109191
SIM,1869,16,na,1885,2381
STAT,1849,36,45-49,1885,1.5455948074065085
STAT,1814,101,na,1915,0.26227345359013265
SIM,1799,59,na,1858,977
SIM,1921,36,35-39,1957,8
STAT,1880,58,na,1938,1969.5582739522993
STAT,1924,47,15-19,1971,4.14286662323782E-4
SIM,1825,92,na,1917,18
STAT,1896,15,25-29,1911,7.103144198329107
SIM,1900,34,20-24,1934,2
SIM,1910,22,15-19,1932,4
SIM,1942,26,25-29,1968,61
STAT,1917,3,na,1920,4109.913143790072
STAT,1847,20,25-29,1867,52.50062746717265
STAT,1910,32,15-19,1942,0.1170567132236749
STAT,1826,30,35-39,1856,16.018127719423365
STAT,1921,46,35-39,1967,0.13764708664817382
SIM,1851,20,40-44,1871,3
STAT,1912,20,30-34,1932,26.17723379571274
SIM,1895,17,25-29,1912,9
STAT,1774,83,na,1857,97.53184598568801
STAT,1852,39,na,1891,1690.8602988852103
STAT,1815,62,na,1877,994.6290598642784
STAT,1859,25,50-100,1884,0.4963832843268033
SIM,1908,38,40-44,1946,2
STAT,1854,18,25-29,1872,4.821533582116621
STAT,1893,32,na,1925,2858.866635932334
STAT,1917,29,30-34,1946,38.54184521782801
STAT,1853,56,na,1909,1543.5871270707764
STAT,1887,24,50-100,1911,0.4282081776965319
STAT,1923,16,na,1939,4093.0346304621416
STAT,1924,32,15-19,1956,0.14162840419909936
SIM,1906,13,na,1919,3526
STAT,1901,19,25-29,1920,7.453166806345257
SIM,1930,34,35-39,1964,14
STAT,1938,19,20-24,1957,126.25824614252714
SIM,1865,57,na,1922,1760
STAT,1840,93,na,1933,19.179388381733343
STAT,1948,19,30-34,1967,13.16915600371043
STAT,1902,40,15-19,1942,0.0012914471399930255
STAT,1897,46,na,1943,2851.00930250431
STAT,1930,33,30-34,1963,19.195798241634154
STAT,1824,39,25-29,1863,4.080056767157517
STAT,1871,37,45-49,1908,1.8700346585978531
STAT,1896,22,15-19,1918,4.116144248065826
STAT,1798,65,na,1863,814.2414703859488
STAT,1913,36,35-39,1949,2.265888815644719
STAT,1768,99,na,1867,0.23311107582011842
STAT,1850,47,25-29,1897,0.0404142905794278
SIM,1855,20,25-29,1875,60
STAT,1830,54,45-49,1884,0.009192498456009265
SIM,1847,60,na,1907,1445
SIM,1878,25,25-29,1903,49
STAT,1921,39,45-49,1960,0.7175624752125721
SIM,1867,68,na,1935,1455
SIM,1926,29,45-49,1955,2
STAT,1810,63,na,1873,876.5564916586808
STAT,1914,33,45-49,1947,1.490082819853083
STAT,1768,111,na,1879,8.353529227561915E-4
STAT,1846,23,15-19,1869,2.9974575620065793
SIM,1946,19,20-24,1965,131
STAT,1887,48,na,1935,2347.4996672799757
SIM,1805,92,na,1897,6
STAT,1916,37,15-19,1953,0.018577709280894094
SIM,1844,95,na,1939,5
STAT,1904,47,45-49,1951,0.17954907140600482
SIM,1899,46,na,1945,2997
SIM,1916,36,25-29,1952,3
STAT,1831,54,50-100,1885,0.009096890812859207
SIM,1926,36,35-39,1962,10
STAT,1772,105,na,1877,0.017749903041409887
STAT,1764,115,na,1879,1.201288846085241E-4
SIM,1936,22,35-39,1958,8
STAT,1817,73,na,1890,549.7417425413096
STAT,1860,15,45-49,1875,0.05843346048242243
STAT,1908,46,50-100,1954,0.19469849506221135
STAT,1876,84,na,1960,460.2510530654562
STAT,1934,33,15-19,1967,0.16564561559018284
STAT,1918,29,45-49,1947,1.7244823682246886
SIM,1956,15,15-19,1971,44
STAT,1843,20,40-44,1863,1.7923485441744
STAT,1917,31,50-100,1948,0.8212518247465715
SIM,1854,23,15-19,1877,2
SIM,1901,24,15-19,1925,3
STAT,1784,93,na,1877,6.280463681392053
SIM,1884,16,na,1900,2473
STAT,1928,22,35-39,1950,11.105778918338624
SIM,1832,39,25-29,1871,5
STAT,1943,19,30-34,1962,12.202279793973258
SIM,1883,86,na,1969,400
STAT,1921,31,35-39,1952,9.646392136591611
STAT,1852,20,35-39,1872,5.098761125386828
SIM,1912,21,35-39,1933,9
STAT,1891,48,25-29,1939,0.037497942485816484
STAT,1916,46,25-29,1962,0.05152631524054734
SIM,1902,21,25-29,1923,90
SIM,1925,16,na,1941,4168
SIM,1833,56,na,1889,1226
STAT,1867,32,45-49,1899,1.5469063985709692
SIM,1835,27,na,1862,1747
SIM,1857,36,45-49,1893,2
SIM,1918,26,35-39,1944,18
SIM,1846,43,na,1889,1625
SIM,1901,28,30-34,1929,36
SIM,1933,33,20-24,1966,3
SIM,1838,46,50-100,1884,3
SIM,1788,95,na,1883,1
STAT,1832,49,25-29,1881,0.03650574641748514
STAT,1907,35,50-100,1942,0.3712368623387894
STAT,1918,36,35-39,1954,2.420035488365831
STAT,1908,36,25-29,1944,0.8750860564563756
STAT,1841,36,20-24,1877,0.6326673154540335
STAT,1831,88,na,1919,80.15791198612922
SIM,1922,33,45-49,1955,2
STAT,1828,80,na,1908,348.3812070840811
STAT,1834,21,na,1855,1785.4977864058858
SIM,1888,74,na,1962,1432
STAT,1829,31,15-19,1860,0.1460908439551482
STAT,1851,33,50-100,1884,0.678913169149413
SIM,1917,32,25-29,1949,15
STAT,1901,27,25-29,1928,55.93693867314836
STAT,1932,39,20-24,1971,0.3338822258327108
STAT,1872,24,50-100,1896,0.38399390509730486
STAT,1871,54,35-39,1925,0.007853837479080547
STAT,1818,90,na,1908,38.71850113279708
STAT,1918,25,30-34,1943,39.660415883542065
STAT,1877,18,20-24,1895,17.32728548553759
SIM,1817,62,na,1879,1003
SIM,1921,28,50-100,1949,5
SIM,1896,20,15-19,1916,7
STAT,1895,19,25-29,1914,6.941707711158391
SIM,1810,83,na,1893,136
SIM,1893,1,na,1894,3352
STAT,1913,28,50-100,1941,0.9336604397825466
STAT,1855,27,50-100,1882,0.47382641953538523
SIM,1847,48,na,1895,1667
SIM,1876,29,na,1905,2299
STAT,1828,28,25-29,1856,59.85031887750562
STAT,1926,28,40-44,1954,5.259757760565409
SIM,1836,28,25-29,1864,46
SIM,1934,28,40-44,1962,9
STAT,1850,29,25-29,1879,34.589207649784015
STAT,1886,74,na,1960,1257.71943517532
STAT,1922,42,35-39,1964,0.21834549938967798
STAT,1833,36,na,1869,1659.7953707880495
STAT,1879,15,25-29,1894,5.629711360723872
STAT,1882,60,na,1942,1752.155266733935
STAT,1924,28,50-100,1952,1.0909463085418327
STAT,1901,26,15-19,1927,0.6020087208308549
SIM,1870,24,na,1894,2161
STAT,1849,15,40-44,1864,0.17083109487776915
STAT,1888,20,15-19,1908,3.7051654967420515
SIM,1876,40,50-100,1916,1
STAT,1869,51,na,1920,1979.9847183401105
STAT,1828,89,na,1917,59.1640675801703
STAT,1870,0,na,1870,3459.5924710771724
SIM,1896,35,50-100,1931,1
STAT,1875,23,40-44,1898,2.0171566227951634
STAT,1927,30,na,1957,4399.9595187775185
SIM,1871,41,na,1912,2209
STAT,1904,36,40-44,1940,1.286481218974844
SIM,1918,34,35-39,1952,9
STAT,1944,16,40-44,1960,1.4223770749265487
STAT,1948,15,15-19,1963,49.09240180654557
STAT,1924,37,20-24,1961,0.2936445151873631
SIM,1952,16,40-44,1968,1
SIM,1914,16,20-24,1930,18
STAT,1856,47,20-24,1903,0.008803698384549169
STAT,1898,1,na,1899,3479.687478010498
STAT,1826,34,na,1860,1567.6109713932467
STAT,1869,19,25-29,1888,5.196188943072756
STAT,1936,17,45-49,1953,0.4517952673762579
STAT,1909,32,25-29,1941,8.332516790920485
SIM,1932,28,50-100,1960,1
SIM,1845,23,20-24,1868,57
SIM,1868,101,na,1969,2
STAT,1920,44,25-29,1964,0.0742567040108674
SIM,1925,31,20-24,1956,2
STAT,1967,2,na,1969,4642.845028753409
SIM,1824,75,na,1899,484
STAT,1869,26,20-24,1895,10.773345293760343
STAT,1820,39,40-44,1859,8.88555324415715
STAT,1940,30,35-39,1970,8.944850282044069
STAT,1837,22,50-100,1859,0.3464590602669166
STAT,1837,23,20-24,1860,58.1277349567578
SIM,1876,73,na,1949,1122
STAT,1906,16,20-24,1922,24.452662882867497
STAT,1867,31,35-39,1898,9.020210274722148
STAT,1896,0,na,1896,3663.6242988066642
SIM,1922,32,35-39,1954,13
STAT,1846,47,50-100,1893,0.18131320401892642
SIM,1926,18,40-44,1944,1
STAT,1902,30,15-19,1932,0.19138852843894594
SIM,1969,0,na,1969,4496
STAT,1843,108,na,1951,0.0012372316594983655
STAT,1923,18,15-19,1941,50.211077402916956
SIM,1899,30,40-44,1929,10
STAT,1869,82,na,1951,427.0113176951212
SIM,1941,10,na,1951,3777
SIM,1945,24,na,1969,3628
STAT,1934,26,25-29,1960,83.68479147331264
SIM,1911,25,35-39,1936,18
SIM,1907,3,na,1910,3661
STAT,1916,45,15-19,1961,3.586138722120476E-4
STAT,1780,79,na,1859,218.518270822696
STAT,1845,47,45-49,1892,0.16622184181466398
SIM,1869,27,25-29,1896,43
STAT,1940,28,na,1968,3607.039411267275
SIM,1931,18,15-19,1949,55
STAT,1939,31,na,1970,3647.618667054021
STAT,1779,82,na,1861,131.29723828774536
STAT,1869,19,na,1888,2315.891218490256
STAT,1791,95,na,1886,2.496734688195798
SIM,1890,37,20-24,1927,1
STAT,1846,54,na,1900,1553.0958792550578
STAT,1886,48,45-49,1934,0.23254770033653957
SIM,1912,36,40-44,1948,1
STAT,1863,21,20-24,1884,58.68957248040592
STAT,1910,22,20-24,1932,98.65013555698917
STAT,1903,25,35-39,1928,13.057619107063722
SIM,1849,34,45-49,1883,1
STAT,1914,32,35-39,1946,8.690173527900155
SIM,1825,30,40-44,1855,4
STAT,1862,92,na,1954,33.64100349813377
SIM,1852,39,na,1891,1778
STAT,1858,55,na,1913,1531.517131247838
SIM,1926,25,30-34,1951,47
STAT,1830,53,35-39,1883,0.0055622908657545255
STAT,1888,35,50-100,1923,1.383729028427186
SIM,1918,14,na,1932,4063
STAT,1834,25,45-49,1859,0.9166542520388844
STAT,1884,21,40-44,1905,1.9507336653785203
SIM,1782,79,na,1861,278
SIM,1839,41,na,1880,1672
SIM,1934,35,30-34,1969,1
SIM,1837,93,na,1930,12
STAT,1803,61,na,1864,939.9278243347775
STAT,1933,0,na,1933,5697.231337127211
STAT,1903,18,45-49,1921,0.08757334717006816
SIM,1841,75,na,1916,655
STAT,1926,35,30-34,1961,2.1078195276023304
SIM,1892,21,40-44,1913,1
SIM,1853,56,na,1909,1549
STAT,1906,49,20-24,1955,0.009119033717188156
SIM,1827,60,na,1887,1070
STAT,1904,43,30-34,1947,0.10739988416916886
SIM,1840,58,na,1898,1288
SIM,1842,25,45-49,1867,1
SIM,1906,33,na,1939,3297
STAT,1903,43,35-39,1946,0.1678016258935966
SIM,1872,91,na,1963,106
STAT,1908,33,20-24,1941,2.165916989878443
SIM,1902,51,na,1953,2845
STAT,1808,60,na,1868,1031.8236646781486
STAT,1852,21,45-49,1873,0.6049112954854562
STAT,1838,18,40-44,1856,0.1612431490012454
STAT,1824,54,20-24,1878,8.322028918692324E-4
SIM,1920,23,35-39,1943,18
STAT,1841,78,na,1919,538.6600835769833
SIM,1828,34,na,1862,1642
SIM,1821,36,45-49,1857,3
SIM,1923,24,15-19,1947,6
STAT,1905,32,40-44,1937,3.4002759806871308
STAT,1837,31,20-24,1868,2.2224873224837496
SIM,1879,24,30-34,1903,17
SIM,1934,24,25-29,1958,134
STAT,1837,33,15-19,1870,0.11468272721748445
STAT,1870,68,na,1938,1416.2743228269903
SIM,1807,63,na,1870,865
STAT,1834,30,40-44,1864,3.5197713721022685
STAT,1909,39,45-49,1948,0.6034720802071055
STAT,1878,27,25-29,1905,41.6466202502642
STAT,1877,90,na,1967,217.63504729875015
SIM,1887,68,na,1955,1554
STAT,1935,17,30-34,1952,15.74119588417374
SIM,1858,40,45-49,1898,2
STAT,1926,24,25-29,1950,105.34496897224821
SIM,1914,7,na,1921,3921
SIM,1858,55,na,1913,1709
SIM,1913,32,40-44,1945,2
SIM,1898,42,40-44,1940,1
STAT,1935,36,35-39,1971,3.198017650559428
SIM,1904,36,35-39,1940,5
STAT,1821,53,40-44,1874,0.015651184416182632
STAT,1943,21,20-24,1964,111.79722125450328
SIM,1930,31,30-34,1961,18
STAT,1871,47,45-49,1918,0.22035295420258674
STAT,1931,18,20-24,1949,167.19848709724022
STAT,1847,49,20-24,1896,0.008664129221714167
SIM,1900,18,20-24,1918,21
SIM,1850,49,50-100,1899,1
STAT,1844,48,40-44,1892,0.11740844150168953
SIM,1871,21,20-24,1892,57
STAT,1950,19,20-24,1969,151.341921494848
SIM,1891,50,na,1941,2582
STAT,1917,45,30-34,1962,0.08837860143760057
STAT,1915,24,15-19,1939,5.16575655830898
SIM,1895,64,na,1959,2273
STAT,1912,23,35-39,1935,8.498712857883698
STAT,1836,49,45-49,1885,0.15589076088589046
STAT,1918,18,40-44,1936,1.4344676209980356
SIM,1847,17,na,1864,2155
STAT,1836,108,na,1944,0.0011861629683531138
STAT,1922,31,30-34,1953,16.88558835516725
SIM,1839,20,40-44,1859,1
STAT,1864,20,25-29,1884,49.685190465549006
STAT,1929,37,20-24,1966,0.3197020273459737
STAT,1945,27,na,1972,3882.587202654696
STAT,1910,16,15-19,1926,8.516338131116008
SIM,1877,19,25-29,1896,7
STAT,1891,45,20-24,1936,0.00799035379105276
SIM,1845,26,na,1871,1873
SIM,1809,75,na,1884,410
STAT,1912,41,35-39,1953,0.18453450936157653
STAT,1854,16,50-100,1870,0.042180138678536684
STAT,1923,23,45-49,1946,1.2329447742591995
SIM,1805,61,na,1866,943
SIM,1916,33,20-24,1949,1
SIM,1923,36,na,1959,4193
STAT,1805,49,15-19,1854,0.001486277302448389
STAT,1920,40,30-34,1960,0.13375751633279961
SIM,1918,1,na,1919,4219
STAT,1891,45,50-100,1936,0.16353590111539892
STAT,1783,99,na,1882,0.30327851583070964
STAT,1912,49,45-49,1961,0.19617092407727366
SIM,1916,32,50-100,1948,4
SIM,1815,82,na,1897,235
STAT,1944,27,45-49,1971,1.763936626288488
STAT,1826,31,45-49,1857,2.5615811639352337
STAT,1903,44,25-29,1947,0.05913031142899625
SIM,1939,15,15-19,1954,39
SIM,1845,26,25-29,1871,38
SIM,1866,83,na,1949,299
STAT,1839,21,30-34,1860,15.3481049013697
SIM,1849,23,40-44,1872,1
SIM,1929,19,20-24,1948,162
STAT,1860,20,40-44,1880,1.8356571638852255
STAT,1940,16,20-24,1956,130.0780063522256
STAT,1863,23,15-19,1886,2.7694242594751324
STAT,1891,27,20-24,1918,13.711500151240863
STAT,1911,42,30-34,1953,0.11527710673536955
STAT,1829,54,na,1883,1319.8288070985293
STAT,1869,102,na,1971,2.6023255918073263
SIM,1892,41,50-100,1933,1
STAT,1850,44,20-24,1894,0.1104398913123708
STAT,1944,15,30-34,1959,12.398099255050067
SIM,1943,22,25-29,1965,99
SIM,1823,89,na,1912,42
SIM,1838,55,na,1893,1373
STAT,1813,54,45-49,1867,0.036452183451995065
STAT,1934,23,20-24,1957,141.12108739783469
STAT,1924,42,na,1966,4173.175089430076
STAT,1931,22,40-44,1953,4.119650169887031
SIM,1832,36,20-24,1868,3
STAT,1915,42,15-19,1957,0.001460607784035135
STAT,1847,16,40-44,1863,0.1693334598684676
SIM,1796,62,na,1858,911
STAT,1819,35,20-24,1854,2.4977507147492295
STAT,1824,36,20-24,1860,1.269428912523168
STAT,1858,35,na,1893,1761.6013899304382
STAT,1876,18,50-100,1894,0.047691029994655625
SIM,1841,23,na,1864,1780
SIM,1932,29,20-24,1961,28
STAT,1923,30,35-39,1953,9.976288073492126
STAT,1860,48,25-29,1908,0.043596198617147024
STAT,1924,29,20-24,1953,19.934264645157718
STAT,1854,21,na,1875,1810.4584491667113
STAT,1921,47,50-100,1968,0.24087346564059925
SIM,1899,22,40-44,1921,3
STAT,1880,45,45-49,1925,0.23738388155890844
STAT,1886,26,20-24,1912,11.747112261808637
SIM,1952,15,30-34,1967,23
STAT,1831,39,15-19,1870,0.04202309293122272
SIM,1845,37,na,1882,1724
STAT,1870,17,50-100,1887,0.04583629312148803
STAT,1934,25,15-19,1959,0.8979356938776119
SIM,1905,33,45-49,1938,2
STAT,1927,18,35-39,1945,4.915844251738792
SIM,1870,36,40-44,1906,1
SIM,1942,23,20-24,1965,103
SIM,1832,31,50-100,1863,3
SIM,1904,65,na,1969,2653
STAT,1889,15,35-39,1904,0.6429079368105973
STAT,1837,26,25-29,1863,35.491916330651264
SIM,1834,31,45-49,1865,2
STAT,1872,50,35-39,1922,0.008274978969518875
STAT,1844,11,na,1855,2117.20542
STAT,1935,22,25-29,1957,118.82683979940417
STAT,1848,25,na,1873,1946.8302972661454
STAT,1959,9,na,1968,4854.867689124467
SIM,1837,70,na,1907,861
SIM,1848,8,na,1856,2258
SIM,1871,23,15-19,1894,3
STAT,1871,18,25-29,1889,5.318620107862251
SIM,1879,49,na,1928,2231
STAT,1902,27,40-44,1929,3.993779961997619
STAT,1933,29,15-19,1962,0.8846417081391397
SIM,1917,28,na,1945,3666
SIM,1877,29,25-29,1906,48
STAT,1862,54,40-44,1916,0.008269540346739308
SIM,1894,26,20-24,1920,14
SIM,1904,34,40-44,1938,7
STAT,1923,19,25-29,1942,47.81323590818078
STAT,1909,27,30-34,1936,35.37693073949891
STAT,1847,105,na,1952,0.021621275144028996
SIM,1809,74,na,1883,461
SIM,1917,27,30-34,1944,44
SIM,1820,37,40-44,1857,2
SIM,1834,41,na,1875,1563
STAT,1838,30,25-29,1868,8.724123716523927
SIM,1920,16,45-49,1936,1
SIM,1878,30,20-24,1908,2
SIM,1847,21,30-34,1868,16
SIM,1931,30,35-39,1961,14
SIM,1902,32,30-34,1934,28
SIM,1794,71,na,1865,501
STAT,1860,69,na,1929,1124.8862044645177
SIM,1845,31,20-24,1876,2
SIM,1924,46,50-100,1970,1
SIM,1837,18,na,1855,1994
SIM,1931,19,25-29,1950,51
STAT,1880,27,45-49,1907,1.1057895863823373
SIM,1930,26,35-39,1956,23
SIM,1913,28,20-24,1941,19
STAT,1942,27,15-19,1969,0.6999652210053058
SIM,1904,29,45-49,1933,1
SIM,1928,43,40-44,1971,2
SIM,1886,32,20-24,1918,2
SIM,1853,25,20-24,1878,11
SIM,1857,41,40-44,1898,5
STAT,1827,63,na,1890,1030.670737214464
STAT,1888,21,25-29,1909,64.10471616134457
STAT,1936,16,35-39,1952,3.8044017333454145
STAT,1868,15,15-19,1883,5.510633862165211
STAT,1899,26,na,1925,3099.72314505656
SIM,1925,27,na,1952,4115
STAT,1919,16,35-39,1935,0.8810401946601553
SIM,1927,16,35-39,1943,7
STAT,1878,32,20-24,1910,2.661217016227421
STAT,1911,24,30-34,1935,25.590295214233493
STAT,1900,36,20-24,1936,0.2190924446782538
STAT,1799,91,na,1890,18.499960147531528
SIM,1846,30,25-29,1876,12
STAT,1942,25,20-24,1967,18.114857071391018
STAT,1888,17,40-44,1905,0.20420179312108866
SIM,1910,27,40-44,1937,3
STAT,1769,101,na,1870,0.1013254465500619
STAT,1914,32,na,1946,3596.5594622719696
STAT,1926,13,na,1939,4582.027389672046
STAT,1918,46,na,1964,3702.490874265453
STAT,1878,34,15-19,1912,0.13900292392487945
SIM,1914,30,35-39,1944,8
STAT,1867,91,na,1958,73.61460327166762
STAT,1925,27,15-19,1952,0.7876761914519551
STAT,1884,72,na,1956,1209.3575009920503
SIM,1902,25,40-44,1927,3
SIM,1933,27,15-19,1960,4
STAT,1905,28,20-24,1933,15.962843285423041
STAT,1907,39,15-19,1946,0.01665062509909611
STAT,1850,26,20-24,1876,9.802251661928697
SIM,1913,46,na,1959,3269
SIM,1896,21,25-29,1917,70
STAT,1785,78,na,1863,304.19744392176364
SIM,1908,34,25-29,1942,13
STAT,1893,22,45-49,1915,0.8354105293924593
STAT,1909,32,na,1941,3409.637731334251
STAT,1810,94,na,1904,8.454889624638
SIM,1935,18,35-39,1953,4
STAT,1887,30,20-24,1917,2.8792389163816314
SIM,1864,17,na,1881,2274
STAT,1858,24,na,1882,1802.8238400417945
SIM,1874,61,na,1935,1706
SIM,1878,75,na,1953,962
STAT,1935,29,45-49,1964,2.222504602175802
STAT,1878,32,na,1910,2349.3723879818244
STAT,1849,41,40-44,1890,1.6942917183505446
SIM,1858,17,20-24,1875,17
STAT,1897,48,20-24,1945,0.008444380739240183
STAT,1797,80,na,1877,259.34804639202264
STAT,1859,72,na,1931,949.5587087843533
SIM,1855,23,30-34,1878,22
SIM,1944,16,35-39,1960,5
STAT,1877,47,40-44,1924,0.16698268385286574
STAT,1907,53,na,1960,3026.335066057327
STAT,1890,2,na,1892,3078.746108544634
SIM,1890,24,na,1914,2946
STAT,1847,23,30-34,1870,15.986501608061742
SIM,1836,39,50-100,1875,3
SIM,1829,30,25-29,1859,13
STAT,1876,53,na,1929,2067.760131489914
STAT,1790,78,na,1868,285.7942006372895
STAT,1902,34,30-34,1936,13.251703327581737
SIM,1879,20,15-19,1899,3
STAT,1863,45,45-49,1908,0.19759860840333873
STAT,1898,31,na,1929,3063.1739546937147
SIM,1869,24,20-24,1893,54
STAT,1920,48,40-44,1968,0.1641840727216642
SIM,1912,28,40-44,1940,3
STAT,1839,21,na,1860,1842.3359428773135
STAT,1920,15,40-44,1935,0.29880914596553904
STAT,1943,22,50-100,1965,0.6613429197957084
SIM,1878,31,50-100,1909,1
STAT,1880,52,35-39,1932,0.008528418038019384
STAT,1909,43,30-34,1952,0.11229205480088388
SIM,1943,17,30-34,1960,14
SIM,1814,42,na,1856,1346
SIM,1854,62,na,1916,1466
SIM,1881,40,na,1921,1805
STAT,1847,40,na,1887,1758.312018756875
STAT,1818,53,50-100,1871,0.030302547801181294
SIM,1908,24,na,1932,3285
STAT,1898,52,na,1950,2738.073052819681
SIM,1905,29,25-29,1934,53
STAT,1879,31,25-29,1910,10.170028885397599
STAT,1885,13,na,1898,2428.0338178962547
SIM,1885,54,na,1939,2001
STAT,1790,103,na,1893,0.028479375696314983
SIM,1849,42,45-49,1891,2
STAT,1904,28,40-44,1932,4.044869797125269
SIM,1869,2,na,1871,2930
STAT,1920,22,30-34,1942,30.184834255344057
STAT,1896,20,20-24,1916,86.49412760784945
STAT,1936,21,30-34,1957,25.966172928363406
STAT,1947,20,50-100,1967,0.703035644237136
STAT,1898,44,40-44,1942,0.19698656178672688
SIM,1889,16,na,1905,3073
STAT,1811,45,25-29,1856,0.19829203441212212
SIM,1839,22,35-39,1861,6
STAT,1821,78,na,1899,416.2675823848516
STAT,1879,72,na,1951,1248.8429198998838
STAT,1887,24,15-19,1911,3.4642037587549686
STAT,1915,21,45-49,1936,1.1020925338469094
SIM,1860,21,45-49,1881,1
STAT,1845,25,20-24,1870,10.251100177135752
STAT,1826,78,na,1904,426.6724245907772
SIM,1895,24,15-19,1919,3
STAT,1827,40,na,1867,1588.6559276204105
STAT,1925,8,na,1933,4551.399749543201
SIM,1906,2,na,1908,3627
SIM,1829,26,40-44,1855,5
STAT,1926,31,15-19,1957,0.1468718770964114
SIM,1901,14,na,1915,3400
SIM,1923,21,45-49,1944,1
STAT,1891,21,na,1912,2772.5698701916413
SIM,1838,23,30-34,1861,16
SIM,1909,28,35-39,1937,15
STAT,1922,31,na,1953,4053.418308039122
SIM,1881,51,na,1932,1693
STAT,1906,13,na,1919,3547.7765464749236
SIM,1819,36,25-29,1855,5
SIM,1877,35,na,1912,2312
STAT,1832,38,20-24,1870,0.5828090343595924
STAT,1863,52,35-39,1915,0.0070990647095656645
STAT,1813,59,na,1872,1022.849431726175
STAT,1916,35,20-24,1951,0.2574432175728586
SIM,1886,27,25-29,1913,47
SIM,1958,11,na,1969,4784
STAT,1914,43,na,1957,3471.1385797921835
STAT,1862,108,na,1970,0.022083378198644157
SIM,1812,94,na,1906,6
STAT,1821,35,40-44,1856,10.268608858254451
SIM,1860,44,50-100,1904,1
STAT,1899,24,40-44,1923,2.680402267236375
STAT,1935,33,30-34,1968,20.578741980704244
SIM,1941,19,20-24,1960,128
SIM,1920,17,na,1937,3971
STAT,1789,92,na,1881,10.199650193595607
SIM,1935,27,45-49,1962,5
STAT,1896,20,na,1916,2968.4430841548115
STAT,1890,48,50-100,1938,0.15799713814156227
STAT,1901,69,na,1970,2285.1329235133067
STAT,1876,21,35-39,1897,5.712651632600096
STAT,1889,45,50-100,1934,0.2892878000706843
SIM,1850,32,40-44,1882,5
SIM,1902,16,30-34,1918,2
SIM,1934,21,20-24,1955,133
STAT,1836,46,40-44,1882,0.11751797859281317
STAT,1839,47,20-24,1886,0.00814034794701588
STAT,1849,104,na,1953,0.0500162265181754
SIM,1944,21,30-34,1965,35
SIM,1847,24,35-39,1871,5
STAT,1931,35,na,1966,4715.053482478092
SIM,1862,37,45-49,1899,2
STAT,1905,35,45-49,1940,0.5931202155382409
SIM,1820,38,na,1858,1565
SIM,1887,31,25-29,1918,12
SIM,1921,34,40-44,1955,3
SIM,1893,21,na,1914,2956
STAT,1903,40,30-34,1943,0.10839363097035982
SIM,1873,76,na,1949,820
STAT,1833,30,50-100,1863,0.7389879200895559
STAT,1842,40,na,1882,1776.6302713475538
SIM,1843,55,na,1898,1434
STAT,1900,46,15-19,1946,2.965327424434592E-4
STAT,1911,20,15-19,1931,4.797909346626395
STAT,1830,50,30-34,1880,0.004485095306015826
STAT,1876,20,na,1896,2322.071414397809
STAT,1902,3,na,1905,3524.586071372684
STAT,1920,43,35-39,1963,0.20976300533289033
SIM,1897,35,na,1932,3075
STAT,1952,17,30-34,1969,13.798669673457397
STAT,1836,88,na,1924,88.9002636025718
STAT,1925,45,50-100,1970,0.2601289462813056
SIM,1897,45,50-100,1942,2
SIM,1902,35,35-39,1937,5
STAT,1832,74,na,1906,668.5382053420016
STAT,1855,18,40-44,1873,0.15368268648800035
STAT,1815,93,na,1908,13.0450255986825
STAT,1889,27,na,1916,2783.2943349917123
STAT,1854,37,45-49,1891,1.4263098821577829
SIM,1863,4,na,1867,2373
STAT,1793,66,na,1859,687.1689803444647
STAT,1842,32,40-44,1874,3.793890324049208
STAT,1873,39,20-24,1912,0.7311281812147907
SIM,1916,43,na,1959,3503
SIM,1910,34,30-34,1944,15
SIM,1862,69,na,1931,1250
STAT,1919,42,na,1961,3802.125240728969
STAT,1834,22,na,1856,1772.6779122994883
SIM,1863,55,na,1918,1715
SIM,1867,69,na,1936,1396
STAT,1909,36,40-44,1945,1.345081707107665
STAT,1862,39,45-49,1901,1.5939704535603532
STAT,1920,28,na,1948,3868.4599400244583
STAT,1922,19,45-49,1941,0.5432228039215077
SIM,1827,38,25-29,1865,2
STAT,1881,15,30-34,1896,1.461333786373119
STAT,1855,50,35-39,1905,0.006205742882244536
STAT,1871,15,20-24,1886,16.93698111154112
STAT,1854,31,20-24,1885,2.001203192919793
STAT,1908,9,na,1917,3636.0987062378977
STAT,1914,39,50-100,1953,0.39203986231549
STAT,1812,74,na,1886,495.87107858696476
STAT,1943,24,25-29,1967,92.77618937560912
STAT,1839,24,35-39,1863,4.92065946934941
SIM,1894,29,25-29,1923,51
STAT,1804,53,40-44,1857,0.0364600245649899
STAT,1889,71,na,1960,1702.3142396639478
STAT,1911,19,35-39,1930,0.7890234450276984
SIM,1907,39,na,1946,3272
STAT,1868,4,na,1872,2687.8537120695014
STAT,1933,38,25-29,1971,1.265651895737004
SIM,1870,39,45-49,1909,1
STAT,1768,112,na,1880,5.234906161036226E-4
SIM,1859,21,20-24,1880,58
STAT,1930,18,40-44,1948,1.7037992213392983
STAT,1931,32,35-39,1963,11.31182766860274
STAT,1921,32,25-29,1953,9.716737774124487
STAT,1907,29,20-24,1936,16.027653130863275
STAT,1927,15,30-34,1942,14.383385817393565
SIM,1917,36,40-44,1953,4
SIM,1920,48,50-100,1968,2
STAT,1871,44,40-44,1915,2.0815025460751486
SIM,1918,24,40-44,1942,4
STAT,1889,16,na,1905,2952.7346324396535
SIM,1873,21,na,1894,2284
STAT,1886,29,25-29,1915,41.91132299577358
STAT,1931,25,45-49,1956,2.108865232046786
SIM,1824,42,40-44,1866,6
SIM,1908,31,20-24,1939,2
STAT,1819,38,25-29,1857,7.403618722753867
STAT,1815,47,50-100,1862,0.5529301626801078
SIM,1823,47,50-100,1870,3
SIM,1918,31,30-34,1949,23
STAT,1903,48,40-44,1951,0.12817518461535685
SIM,1888,25,35-39,1913,12
STAT,1926,19,50-100,1945,0.43160270972895304
SIM,1882,80,na,1962,725
STAT,1817,74,na,1891,513.6566945608979
SIM,1901,22,20-24,1923,79
STAT,1806,48,20-24,1854,0.04365685132248191
STAT,1847,19,45-49,1866,0.059413887920439105
STAT,1883,33,40-44,1916,3.999774214775879
SIM,1911,22,30-34,1933,37
STAT,1831,89,na,1920,61.33923898914564
STAT,1925,27,na,1952,4179.815919114885
STAT,1872,39,na,1911,2210.0015617956315
STAT,1923,16,20-24,1939,150.76103949165454
SIM,1875,87,na,1962,268
STAT,1938,34,45-49,1972,1.4928248251569098
SIM,1784,82,na,1866,118
SIM,1862,31,20-24,1893,2
SIM,1878,20,na,1898,2404
SIM,1926,22,25-29,1948,120
STAT,1828,41,20-24,1869,0.1369155449262115
STAT,1838,99,na,1937,1.2714479196052284
STAT,1913,34,40-44,1947,3.646784464539503
SIM,1866,23,40-44,1889,5
STAT,1813,60,na,1873,1002.7913543700246
SIM,1816,56,na,1872,1168
SIM,1868,39,25-29,1907,2
STAT,1902,54,na,1956,2810.731007643434
SIM,1931,16,20-24,1947,162
SIM,1841,44,na,1885,1545
SIM,1943,26,40-44,1969,5
STAT,1870,38,40-44,1908,4.036777909072978
STAT,1918,22,25-29,1940,94.11413665460915
STAT,1895,38,50-100,1933,1.5045864418831816
STAT,1789,81,na,1870,182.74316395928076
STAT,1933,19,20-24,1952,170.53022528571793
STAT,1816,42,40-44,1858,6.067467317705466
SIM,1877,26,20-24,1903,10
SIM,1938,32,45-49,1970,2
SIM,1899,18,20-24,1917,27
STAT,1893,47,25-29,1940,0.038743880119648355
SIM,1933,35,na,1968,4903
STAT,1802,75,na,1877,420.11381977112364
SIM,1856,20,40-44,1876,1
STAT,1953,17,45-49,1970,0.5708510211816118
SIM,1927,39,40-44,1966,3
SIM,1846,22,na,1868,1898
STAT,1871,51,30-34,1922,0.005610638736202845
SIM,1892,35,na,1927,3139
SIM,1952,18,35-39,1970,5
STAT,1912,16,45-49,1928,0.09566405177440984
STAT,1913,41,30-34,1954,0.1184611203967232
SIM,1896,49,na,1945,2751
STAT,1944,18,35-39,1962,4.264571081466143
SIM,1891,33,40-44,1924,3
STAT,1873,87,na,1960,262.8898429445883
STAT,1915,47,20-24,1962,0.010520127519264877
SIM,1825,37,na,1862,1581
SIM,1871,10,na,1881,2526
STAT,1925,47,30-34,1972,0.10204610591766598
SIM,1886,28,na,1914,2322
STAT,1919,39,40-44,1958,1.5160493818277443
STAT,1836,33,na,1869,1755.6046573082479
STAT,1848,20,40-44,1868,1.9126920661196725
STAT,1872,22,25-29,1894,54.24463963856389
SIM,1863,25,30-34,1888,26
SIM,1883,31,40-44,1914,4
STAT,1941,5,na,1946,3889.8756997006717
STAT,1849,10,na,1859,2231.094936336408
STAT,1885,20,45-49,1905,0.6605461943194194
SIM,1868,54,na,1922,1895
STAT,1922,26,35-39,1948,16.104252834285855
STAT,1819,44,na,1863,1463.8378502455996
STAT,1939,17,15-19,1956,42.91546540339945
STAT,1845,28,25-29,1873,36.17305950660726
STAT,1943,28,40-44,1971,4.68725517022562
SIM,1927,29,50-100,1956,1
SIM,1838,88,na,1926,77
STAT,1861,18,50-100,1879,0.043970651243160755
SIM,1868,18,20-24,1886,19
SIM,1856,73,na,1929,924
SIM,1817,93,na,1910,8
STAT,1901,24,20-24,1925,90.55541012833388
SIM,1894,39,50-100,1933,1
SIM,1832,30,na,1862,1683
STAT,1871,21,na,1892,2225.284691825403
STAT,1910,36,30-34,1946,1.654672957967817
STAT,1870,80,na,1950,573.2910933885919
STAT,1857,43,40-44,1900,1.6637417392346998
STAT,1903,42,50-100,1945,0.09848854300043335
SIM,1869,39,na,1908,2144
STAT,1890,35,na,1925,2746.915456174455
SIM,1947,17,15-19,1964,40
STAT,1839,17,45-49,1856,0.05689334196621709
SIM,1921,9,na,1930,4314
STAT,1866,33,50-100,1899,0.7949752709250802
STAT,1885,57,na,1942,1892.3561095656028
STAT,1869,48,45-49,1917,0.2132708547564114
STAT,1882,34,50-100,1916,0.8345619773421435
STAT,1935,26,40-44,1961,6.004892413119313
SIM,1865,43,40-44,1908,8
STAT,1896,19,40-44,1915,0.2269816636428744
SIM,1918,20,25-29,1938,100
STAT,1858,23,40-44,1881,1.599928519915435
STAT,1875,31,40-44,1906,4.228224223980921
STAT,1921,36,40-44,1957,1.5804972287094148
STAT,1862,40,50-100,1902,0.8619260343752089
SIM,1935,15,30-34,1950,18
SIM,1837,28,40-44,1865,1
SIM,1925,18,25-29,1943,58
SIM,1909,25,30-34,1934,38
SIM,1802,64,na,1866,801
STAT,1899,41,50-100,1940,0.09538988360437774
STAT,1917,25,15-19,1942,0.7041526192440408
STAT,1853,36,na,1889,1801.6049801521515
STAT,1940,19,25-29,1959,41.538505476778816
STAT,1887,33,25-29,1920,10.77752527360349
STAT,1893,53,na,1946,2538.2064892728094
SIM,1816,40,40-44,1856,2
STAT,1841,55,na,1896,1425.5063880343935
STAT,1863,16,25-29,1879,5.392411091270451
STAT,1932,20,na,1952,4553.446695064498
STAT,1936,34,na,1970,3465.817109704184
STAT,1920,18,45-49,1938,0.5280671548751485
STAT,1818,107,na,1925,0.0023159988309562926
STAT,1820,48,50-100,1868,0.4059154678829592
SIM,1871,16,25-29,1887,6
STAT,1829,28,40-44,1857,3.725722036253729
STAT,1861,109,na,1970,0.00830056544598727
STAT,1843,15,45-49,1858,0.05705484111481429
SIM,1872,20,25-29,1892,57
STAT,1909,46,35-39,1955,0.11220317487299512
SIM,1875,32,45-49,1907,2
SIM,1899,25,45-49,1924,3
STAT,1849,51,na,1900,1622.3167633971093
SIM,1884,17,na,1901,2464
SIM,1914,25,50-100,1939,2
STAT,1862,36,40-44,1898,3.5528081067451076
SIM,1856,84,na,1940,229
STAT,1828,47,45-49,1875,0.19109286457856425
STAT,1917,38,40-44,1955,1.4616097055093444
SIM,1895,33,25-29,1928,15
STAT,1927,34,35-39,1961,10.605681291247475
STAT,1906,18,15-19,1924,8.143977733630967
SIM,1915,29,20-24,1944,14
STAT,1863,42,40-44,1905,1.8623928295521768
SIM,1819,41,na,1860,1485
STAT,1906,25,50-100,1931,0.8861264548392572
STAT,1885,49,40-44,1934,0.15784345026866467
SIM,1886,50,na,1936,2109
STAT,1852,46,25-29,1898,0.0418777702847446
STAT,1820,93,na,1913,15.396161931933301
STAT,1884,16,45-49,1900,0.061116582718147634
SIM,1789,81,na,1870,158
STAT,1840,27,50-100,1867,0.5234330919050713
STAT,1923,49,20-24,1972,0.012141180814129562
SIM,1933,17,20-24,1950,148
STAT,1821,38,45-49,1859,3.986332175362328
STAT,1910,29,40-44,1939,4.221747466131695
STAT,1857,39,na,1896,1737.6799031948988
SIM,1829,74,na,1903,649
STAT,1873,35,50-100,1908,1.1874897440904353
STAT,1846,32,25-29,1878,8.977734158215258
STAT,1912,21,na,1933,3465.531750620386
SIM,1842,30,40-44,1872,3
SIM,1914,18,15-19,1932,9
SIM,1935,34,35-39,1969,15
SIM,1915,17,na,1932,3654
STAT,1853,25,na,1878,1924.1015273185399
STAT,1900,39,25-29,1939,0.8062155400997183
STAT,1811,49,40-44,1860,0.5517484698545565
SIM,1893,20,45-49,1913,4
SIM,1855,36,na,1891,1878
STAT,1926,21,20-24,1947,127.9988503840608
SIM,1832,46,50-100,1878,3
SIM,1914,32,na,1946,3602
SIM,1854,32,25-29,1886,18
STAT,1927,27,45-49,1954,1.9840838552599722
SIM,1858,31,35-39,1889,10
SIM,1925,38,40-44,1963,2
STAT,1898,40,25-29,1938,0.05758341750032738
STAT,1895,38,45-49,1933,2.442997962338538
STAT,1905,42,35-39,1947,0.17149491136621403
STAT,1855,25,30-34,1880,20.794771686552018
STAT,1891,4,na,1895,3074.6984749095204
STAT,1854,73,na,1927,849.8192383603536
SIM,1898,20,na,1918,2980
STAT,1907,48,25-29,1955,0.044522388700444594
SIM,1841,30,50-100,1871,1
STAT,1862,40,na,1902,1885.6681931498433
STAT,1890,68,na,1958,1841.8610907092175
STAT,1866,54,na,1920,1824.5093756276199
STAT,1900,31,15-19,1931,0.18738856450912403
STAT,1920,25,35-39,1945,15.664062310269175
STAT,1824,46,50-100,1870,0.3036847503454414
SIM,1881,35,50-100,1916,3
SIM,1840,37,na,1877,1664
SIM,1853,28,25-29,1881,35
SIM,1903,20,30-34,1923,38
STAT,1919,31,na,1950,3870.4818422364538
SIM,1871,42,40-44,1913,9
SIM,1905,26,20-24,1931,18
SIM,1964,6,na,1970,4607
STAT,1795,77,na,1872,355.09448630442233
STAT,1865,37,20-24,1902,0.6600518319807553
STAT,1850,23,50-100,1873,0.3425484865243765
SIM,1880,3,na,1883,2915
STAT,1867,39,na,1906,2068.90137192026
STAT,1915,20,35-39,1935,8.876187970483473
STAT,1918,21,15-19,1939,5.440105715611445
STAT,1840,47,45-49,1887,0.15618089950088143
SIM,1928,35,40-44,1963,4
STAT,1947,24,45-49,1971,1.2005447498459816
SIM,1867,23,20-24,1890,60
STAT,1865,22,35-39,1887,5.057463636945221
STAT,1922,16,40-44,1938,1.53298094511512
STAT,1819,46,40-44,1865,0.32937342454391505
SIM,1854,47,50-100,1901,1
STAT,1827,45,20-24,1872,0.011271240591107729
SIM,1847,25,45-49,1872,1
STAT,1920,1,na,1921,4426.154954034963
STAT,1880,23,15-19,1903,3.2754604951847517
SIM,1885,39,40-44,1924,5
STAT,1929,35,35-39,1964,2.9385063396997713
SIM,1850,35,45-49,1885,1
STAT,1843,48,25-29,1891,0.03841687767573993
STAT,1868,23,15-19,1891,2.964361026492722
STAT,1871,44,na,1915,2138.844583459181
STAT,1847,31,30-34,1878,15.27458540146372
SIM,1853,36,25-29,1889,1
SIM,1806,87,na,1893,67
STAT,1812,102,na,1914,0.1273515409432458
SIM,1953,12,na,1965,4440
SIM,1917,23,15-19,1940,3
STAT,1880,49,40-44,1929,0.16694405371857102
SIM,1864,22,40-44,1886,1
SIM,1887,27,40-44,1914,3
SIM,1903,34,25-29,1937,16
SIM,1914,20,40-44,1934,4
STAT,1925,17,20-24,1942,154.7127370940364
STAT,1852,61,na,1913,1354.7351120766882
STAT,1845,36,25-29,1881,2.1630246854610093
STAT,1888,25,40-44,1913,3.367081425485922
SIM,1920,31,20-24,1951,2
STAT,1848,23,45-49,1871,0.6263712757773138
STAT,1875,19,20-24,1894,17.12234540186263
SIM,1914,22,35-39,1936,10
SIM,1955,13,na,1968,4600
STAT,1841,24,na,1865,1840.610270187673
STAT,1862,33,20-24,1895,2.174097076127007
STAT,1941,18,30-34,1959,11.856518606967573
SIM,1868,31,na,1899,2160
STAT,1794,82,na,1876,166.9744992172353
STAT,1862,8,na,1870,2271.6719062640636
STAT,1908,32,50-100,1940,0.7372839917955922
SIM,1844,38,25-29,1882,1
STAT,1909,21,20-24,1930,97.92864656206176
STAT,1829,75,na,1904,622.0375913378008
STAT,1878,42,15-19,1920,0.013579322747291619
SIM,1825,42,50-100,1867,1
STAT,1839,25,45-49,1864,0.944792219381935
STAT,1887,79,na,1966,1064.4629323706145
SIM,1876,23,15-19,1899,2
STAT,1854,34,25-29,1888,7.350507350496181
STAT,1912,31,20-24,1943,2.276724582708355
SIM,1845,37,45-49,1882,1
SIM,1864,24,35-39,1888,9
STAT,1875,41,35-39,1916,1.7662827617702943
SIM,1872,36,na,1908,2238
SIM,1878,36,30-34,1914,4
SIM,1910,37,35-39,1947,5
STAT,1905,38,15-19,1943,0.01646834208799713
SIM,1836,39,45-49,1875,1
STAT,1856,22,40-44,1878,1.7838381377780201
STAT,1889,38,20-24,1927,0.8945471927874644
SIM,1879,28,45-49,1907,1
STAT,1892,16,na,1908,2995.76386581184
STAT,1811,89,na,1900,45.56094450142941
SIM,1896,25,40-44,1921,3
SIM,1899,26,20-24,1925,15
STAT,1874,20,35-39,1894,5.666148876361724
SIM,1829,34,40-44,1863,5
STAT,1929,33,40-44,1962,4.692801153140406
STAT,1881,16,40-44,1897,0.16732847472020962
SIM,1908,23,20-24,1931,92
STAT,1822,41,na,1863,1418.683745576841
STAT,1854,3,na,1857,2418.1704323445524
STAT,1897,18,45-49,1915,0.08231108028861332
SIM,1917,21,20-24,1938,98
STAT,1859,25,15-19,1884,0.35206039783880944
SIM,1883,41,35-39,1924,2
STAT,1837,37,45-49,1874,1.575207111112446
STAT,1807,74,na,1881,491.94137613746426
STAT,1828,39,45-49,1867,1.7408026397456837
STAT,1872,18,40-44,1890,0.17286069356320907
SIM,1919,37,40-44,1956,5
SIM,1853,36,40-44,1889,6
SIM,1791,84,na,1875,92
STAT,1794,92,na,1886,11.515551630177002
SIM,1813,59,na,1872,1069
STAT,1930,40,40-44,1970,0.31175596228647223
SIM,1855,24,40-44,1879,2
SIM,1937,28,45-49,1965,1
STAT,1867,49,na,1916,1954.1139230056028
SIM,1878,29,40-44,1907,5
STAT,1864,19,45-49,1883,0.056227715291235644
STAT,1832,50,50-100,1882,0.009878056060686154
STAT,1879,34,30-34,1913,17.11762666867135
STAT,1826,57,na,1883,1169.4312897169443
SIM,1838,34,35-39,1872,9
SIM,1871,27,45-49,1898,1
STAT,1883,36,45-49,1919,1.8552808303478623
STAT,1825,42,50-100,1867,1.1503051188911417
STAT,1875,68,na,1943,1483.9022402257021
SIM,1851,74,na,1925,783
STAT,1893,29,50-100,1922,0.760891789086202
STAT,1863,27,45-49,1890,0.9204604879705384
SIM,1806,77,na,1883,353
STAT,1869,44,15-19,1913,0.012468012843641567
STAT,1809,75,na,1884,430.7037325868205
STAT,1818,38,na,1856,1471.6348219298202
SIM,1937,33,40-44,1970,5
STAT,1877,49,na,1926,2158.6645431491206
STAT,1889,31,50-100,1920,1.0729427091545352
STAT,1829,35,30-34,1864,5.018670575552452
SIM,1838,27,45-49,1865,4
STAT,1887,38,50-100,1925,1.2909017124315936
SIM,1847,39,20-24,1886,4
SIM,1942,15,20-24,1957,124
SIM,1922,21,30-34,1943,36
STAT,1934,15,20-24,1949,174.04188523483063
STAT,1889,7,na,1896,3038.509317723132
SIM,1856,23,45-49,1879,1
STAT,1877,69,na,1946,1438.0966150902884
SIM,1800,62,na,1862,853
SIM,1894,37,40-44,1931,8
STAT,1896,26,30-34,1922,31.52691170843288
STAT,1850,51,45-49,1901,0.010279087352726486
STAT,1902,37,35-39,1939,2.0353483892877473
STAT,1907,21,50-100,1928,0.5676105436652513
SIM,1861,74,na,1935,939
STAT,1892,48,20-24,1940,0.007908782253353118
STAT,1816,45,45-49,1861,0.5753494589912448
STAT,1816,57,na,1873,1164.1801484831803
STAT,1927,45,25-29,1972,0.06319772279363628
STAT,1792,102,na,1894,0.05344404805986475
SIM,1872,23,30-34,1895,25
SIM,1891,19,na,1910,2980
STAT,1872,91,na,1963,126.95442880496236
STAT,1894,17,na,1911,3066.210769980679
STAT,1929,28,45-49,1957,2.0415203986483523
STAT,1842,49,20-24,1891,0.00850874332043823
STAT,1824,31,50-100,1855,2.6117235268775776
SIM,1923,20,35-39,1943,10
STAT,1859,23,20-24,1882,53.37346407186676
STAT,1930,22,25-29,1952,111.78474188046025
SIM,1865,98,na,1963,11
SIM,1930,16,40-44,1946,2
STAT,1862,50,25-29,1912,0.002902062505007419
STAT,1892,36,na,1928,2801.128126486038
SIM,1849,27,20-24,1876,12
STAT,1849,51,35-39,1900,0.006486545888255292
STAT,1854,96,na,1950,6.14362486281964
STAT,1831,49,45-49,1880,0.16385617651541198
STAT,1850,18,20-24,1868,15.181499188612179
STAT,1886,37,40-44,1923,4.368355539662867
SIM,1823,35,na,1858,1517
STAT,1864,23,30-34,1887,15.129197794274074
STAT,1833,26,20-24,1859,9.556298535772317
STAT,1877,39,25-29,1916,2.793028691446106
STAT,1894,36,20-24,1930,0.9403529696166719
SIM,1857,44,45-49,1901,3
SIM,1881,19,na,1900,1948
SIM,1837,35,30-34,1872,5
SIM,1888,30,30-34,1918,25
SIM,1907,27,20-24,1934,19
STAT,1884,17,na,1901,2357.2005221650384
STAT,1792,81,na,1873,201.57740299436733
STAT,1848,30,35-39,1878,8.959635520042543
STAT,1828,44,25-29,1872,0.5266259379742801
STAT,1897,25,35-39,1922,12.272989093501348
STAT,1906,20,40-44,1926,2.8842273878646045
SIM,1855,31,30-34,1886,21
STAT,1909,23,15-19,1932,4.65955045435851
SIM,1841,26,20-24,1867,13
STAT,1923,15,45-49,1938,0.5567073921192536
SIM,1885,39,25-29,1924,3
SIM,1821,44,na,1865,1387
STAT,1865,15,45-49,1880,0.06409168098673426
STAT,1881,54,na,1935,1910.958770196113
SIM,1877,15,30-34,1892,1
STAT,1855,26,40-44,1881,2.234890040219407
STAT,1906,39,50-100,1945,0.36094140645716677
STAT,1834,40,35-39,1874,1.3899363442356953
SIM,1860,30,50-100,1890,5
STAT,1854,29,45-49,1883,0.8208796753016195
STAT,1782,81,na,1863,169.47517284011724
STAT,1908,25,20-24,1933,16.551901736925107
SIM,1897,23,35-39,1920,13
STAT,1854,41,15-19,1895,0.009925434200994421
SIM,1850,37,na,1887,1806
STAT,1831,24,na,1855,1627.0752446504132
STAT,1917,45,50-100,1962,0.22423331050623163
SIM,1816,43,45-49,1859,5
STAT,1904,66,na,1970,2543.7147130146614
STAT,1784,82,na,1866,148.75719282987458
STAT,1876,47,25-29,1923,0.055955785303769844
STAT,1777,80,na,1857,209.94840833960052
STAT,1840,29,15-19,1869,0.3659335571811598
SIM,1867,18,25-29,1885,9
SIM,1849,40,na,1889,1772
STAT,1859,18,25-29,1877,4.916717868652402
STAT,1829,36,50-100,1865,1.1350574710996204
STAT,1937,27,40-44,1964,4.29227934003774
SIM,1938,11,na,1949,3538
STAT,1946,25,40-44,1971,4.909278617883682
SIM,1879,35,35-39,1914,7
SIM,1863,26,40-44,1889,2
SIM,1943,12,na,1955,3821
STAT,1862,54,50-100,1916,0.011863312544835932
SIM,1866,27,20-24,1893,10
STAT,1865,105,na,1970,0.2860415558775356
STAT,1846,77,na,1923,641.1229458842744
SIM,1830,27,na,1857,1742
STAT,1868,16,25-29,1884,5.230949780852653
STAT,1869,15,30-34,1884,1.4964682533263143
STAT,1759,95,na,1854,1.0
STAT,1914,24,35-39,1938,9.031092467328712
STAT,1889,23,35-39,1912,6.784627530842427
SIM,1887,34,30-34,1921,27
SIM,1888,26,45-49,1914,1
STAT,1887,69,na,1956,1577.794476693891
SIM,1877,37,25-29,1914,5
SIM,1925,15,20-24,1940,157
SIM,1846,26,40-44,1872,1
STAT,1847,24,40-44,1871,1.8567876503169225
STAT,1830,25,40-44,1855,3.6626163144431416
STAT,1845,43,15-19,1888,0.009824567300821443
STAT,1851,24,na,1875,1810.4475714331709
SIM,1881,29,na,1910,1835
SIM,1886,35,40-44,1921,9
STAT,1857,46,45-49,1903,0.17633362064026936
SIM,1873,29,20-24,1902,12
STAT,1830,25,25-29,1855,51.72110471840028
STAT,1849,29,20-24,1878,10.278856073338401
SIM,1857,29,20-24,1886,9
SIM,1856,1,na,1857,2838
STAT,1869,47,50-100,1916,0.22372263672778078
STAT,1912,41,50-100,1953,0.10765978967340242
STAT,1838,26,40-44,1864,2.576742964394742
STAT,1881,48,45-49,1929,0.21266893807048656
SIM,1811,78,na,1889,286
STAT,1868,86,na,1954,199.98634865578427
STAT,1940,16,50-100,1956,0.35946383621508354
STAT,1857,34,50-100,1891,0.6768141684178199
STAT,1888,49,50-100,1937,0.1514420334326085
STAT,1908,20,50-100,1928,0.5748840592500939
STAT,1911,14,na,1925,3721.4879597841136
STAT,1861,44,na,1905,1790.9439625339203
SIM,1942,0,na,1942,4037
STAT,1878,35,40-44,1913,4.350671834087813
STAT,1858,27,20-24,1885,8.89516528487421
STAT,1848,37,20-24,1885,0.5902666735049912
STAT,1947,0,na,1947,4724.27419487168
SIM,1922,24,35-39,1946,9
SIM,1905,22,40-44,1927,1
SIM,1927,5,na,1932,4693
STAT,1808,50,35-39,1858,0.03237788775753203
SIM,1847,69,na,1916,1068
SIM,1850,27,na,1877,1940
SIM,1862,34,25-29,1896,11
STAT,1809,55,na,1864,1109.014470827774
STAT,1955,5,na,1960,4930.290470970686
STAT,1829,36,40-44,1865,4.047034459713286
STAT,1886,44,15-19,1930,0.013594955193792719
SIM,1957,3,na,1960,4914
STAT,1767,112,na,1879,6.612180166884036E-4
STAT,1826,53,50-100,1879,0.013185877114440397
SIM,1872,24,40-44,1896,5
SIM,1901,39,35-39,1940,6
STAT,1867,17,20-24,1884,16.077294226494363
SIM,1876,16,25-29,1892,5
SIM,1912,32,25-29,1944,14
STAT,1878,25,50-100,1903,0.6340630386346146
STAT,1938,26,45-49,1964,1.617649078571876
STAT,1853,35,20-24,1888,0.5956173505263798
STAT,1902,31,na,1933,3194.506552464148
STAT,1914,22,40-44,1936,3.2452553841812137
STAT,1845,39,45-49,1884,1.4516924851187225
STAT,1879,27,40-44,1906,2.962232845476863
STAT,1891,19,20-24,1910,20.60965359394988
SIM,1924,21,na,1945,4106
STAT,1820,35,25-29,1855,7.491035368283135
SIM,1858,28,25-29,1886,39
STAT,1872,71,na,1943,1264.8267045929256
STAT,1863,31,15-19,1894,0.11854088559627092
STAT,1864,24,40-44,1888,1.7572141993495258
SIM,1922,22,40-44,1944,3
STAT,1860,90,na,1950,60.43205745582343
STAT,1938,33,35-39,1971,8.675237315224823
STAT,1873,21,30-34,1894,17.11773059864583
SIM,1912,20,na,1932,3418
STAT,1833,59,na,1892,1192.3659996287472
SIM,1875,17,20-24,1892,20
SIM,1896,70,na,1966,2051
STAT,1869,37,25-29,1906,2.6350108803232404
SIM,1906,21,45-49,1927,1
SIM,1862,29,45-49,1891,1
STAT,1904,32,25-29,1936,7.969498285247069
SIM,1847,32,35-39,1879,8
STAT,1847,49,na,1896,1624.4092048471284
STAT,1910,39,35-39,1949,2.163414849086359
SIM,1882,19,20-24,1901,12
STAT,1838,33,30-34,1871,14.415172584897048
STAT,1895,34,15-19,1929,0.17388749436030201
SIM,1824,96,na,1920,2
STAT,1956,10,na,1966,4910.997314938498
SIM,1842,40,35-39,1882,5
STAT,1954,17,50-100,1971,0.4375122165809617
SIM,1837,36,40-44,1873,4
SIM,1929,31,40-44,1960,8
STAT,1837,94,na,1931,12.970643195156418
STAT,1910,50,na,1960,3208.9962070401994
SIM,1916,25,20-24,1941,19
STAT,1884,46,20-24,1930,0.011231647470540165
STAT,1829,85,na,1914,165.64177011836688
SIM,1926,21,15-19,1947,6
STAT,1896,27,40-44,1923,3.7375214646427994
SIM,1883,34,45-49,1917,3
SIM,1950,5,na,1955,4260
STAT,1937,34,30-34,1971,14.706386340950566
STAT,1810,46,20-24,1856,0.040710513317869304
STAT,1886,37,25-29,1923,2.8731807788776607
STAT,1875,34,45-49,1909,1.678779773814283
STAT,1917,48,35-39,1965,0.12686783897301646
STAT,1909,24,25-29,1933,80.59674131932135
STAT,1839,32,35-39,1871,8.297526062584108
STAT,1852,71,na,1923,967.7121033472647
STAT,1928,37,40-44,1965,1.7872034651084872
SIM,1846,33,30-34,1879,29
STAT,1890,38,45-49,1928,2.2909890528261587
STAT,1882,16,na,1898,2326.0118832566104
SIM,1894,37,25-29,1931,7
SIM,1816,87,na,1903,70
SIM,1867,102,na,1969,1
SIM,1865,102,na,1967,1
STAT,1914,17,45-49,1931,0.09762126353096577
SIM,1832,28,20-24,1860,10
SIM,1888,51,na,1939,2467
STAT,1819,46,25-29,1865,0.11081722608665172
STAT,1828,43,15-19,1871,0.011514734372917146
STAT,1848,22,35-39,1870,5.279646015585286
SIM,1845,34,40-44,1879,6
SIM,1864,25,45-49,1889,4
SIM,1868,39,40-44,1907,5
SIM,1859,40,na,1899,1889
STAT,1823,47,45-49,1870,0.290683392813751
SIM,1903,31,20-24,1934,2
STAT,1929,32,30-34,1961,18.90504328735896
STAT,1797,79,na,1876,285.1325861583195
STAT,1895,27,25-29,1922,52.09837490761785
STAT,1932,20,35-39,1952,11.740758417110472
STAT,1830,32,15-19,1862,0.12215084822839732
SIM,1847,31,50-100,1878,1
SIM,1948,11,na,1959,4238
SIM,1829,33,30-34,1862,22
STAT,1880,35,na,1915,2368.683839011814
SIM,1853,33,20-24,1886,2
STAT,1900,17,30-34,1917,2.0887730304537606
SIM,1914,23,45-49,1937,2
STAT,1912,34,25-29,1946,8.518437848941504
SIM,1895,23,na,1918,2980
STAT,1884,39,30-34,1923,4.924142188953099
SIM,1896,24,30-34,1920,27
SIM,1871,74,na,1945,988
STAT,1794,102,na,1896,0.055220975046045624
STAT,1894,39,40-44,1933,5.261016816731921
STAT,1879,19,50-100,1898,0.048186945610241595
SIM,1846,36,35-39,1882,14
STAT,1888,24,30-34,1912,19.761998826820346
SIM,1892,39,30-34,1931,9
SIM,1866,41,35-39,1907,1
SIM,1917,24,25-29,1941,90
STAT,1947,21,40-44,1968,3.59121857640585
SIM,1853,39,45-49,1892,1
SIM,1856,22,35-39,1878,9
STAT,1864,42,na,1906,1943.602818493552
SIM,1843,39,35-39,1882,12
STAT,1887,36,30-34,1923,5.65878675234531
STAT,1839,31,50-100,1870,0.7585539227326461
SIM,1894,47,na,1941,2833
SIM,1867,26,25-29,1893,41
SIM,1929,26,45-49,1955,2
STAT,1942,17,20-24,1959,133.8470342538115
SIM,1786,93,na,1879,6
STAT,1854,33,15-19,1887,0.10326422902781596
STAT,1861,36,25-29,1897,2.27245743669441
STAT,1906,23,45-49,1929,0.9564827143439324
SIM,1836,36,25-29,1872,2
SIM,1918,45,na,1963,3717
SIM,1934,23,15-19,1957,4
STAT,1906,47,na,1953,3081.705671966701
STAT,1929,36,45-49,1965,0.8275321439128147
SIM,1842,18,20-24,1860,8
STAT,1844,52,na,1896,1487.465042401885
SIM,1833,79,na,1912,360
STAT,1837,34,25-29,1871,8.163293691564753
SIM,1867,14,na,1881,2549
STAT,1845,33,20-24,1878,2.250789408484891
STAT,1787,80,na,1867,241.20729759776694
STAT,1880,90,na,1970,252.55342824918083
STAT,1802,98,na,1900,1.1389212044028019
SIM,1940,20,35-39,1960,11
STAT,1850,37,50-100,1887,0.8791696961191259
STAT,1867,105,na,1972,0.37503612070347037
STAT,1832,27,50-100,1859,0.5240438109152714
STAT,1872,47,40-44,1919,0.1614689239086151
STAT,1857,20,35-39,1877,5.092132436052228
STAT,1813,51,40-44,1864,0.028080476998394107
STAT,1834,33,45-49,1867,1.371913847084368
STAT,1885,15,15-19,1900,5.6141953193713965
STAT,1842,95,na,1937,9.628393408522705
STAT,1859,26,25-29,1885,32.589030252513105
STAT,1840,15,40-44,1855,0.15725516118320718
SIM,1901,34,na,1935,3143
STAT,1921,14,na,1935,4252.8540618669185
STAT,1856,25,45-49,1881,0.8603389385823398
STAT,1828,36,25-29,1864,2.6889321717072585
SIM,1863,45,na,1908,1894
SIM,1882,27,20-24,1909,15
STAT,1776,97,na,1873,0.8771710012213484
STAT,1926,23,15-19,1949,6.090323132225065
SIM,1937,32,30-34,1969,19
STAT,1838,36,35-39,1874,5.789629429428558
STAT,1843,45,20-24,1888,0.008276963264915662
SIM,1869,39,40-44,1908,4
STAT,1826,41,50-100,1867,1.0531899926335884
SIM,1842,33,45-49,1875,3
STAT,1835,46,25-29,1881,0.03914076327441408
STAT,1819,107,na,1926,0.0024895280819794627
SIM,1893,15,15-19,1908,9
STAT,1868,49,40-44,1917,0.15108789960238095
SIM,1854,35,30-34,1889,4
SIM,1869,47,50-100,1916,1
STAT,1836,20,15-19,1856,3.48531485128559
STAT,1813,50,na,1863,1222.2633799231824
STAT,1864,105,na,1969,0.24856715246124553
SIM,1841,54,na,1895,1396
SIM,1920,34,25-29,1954,18
SIM,1909,21,15-19,1930,3
STAT,1791,64,na,1855,777.4638
STAT,1831,46,40-44,1877,0.12354636257667842
SIM,1833,25,na,1858,1726
SIM,1878,37,40-44,1915,8
STAT,1927,42,20-24,1969,0.020923358439910198
SIM,1862,26,25-29,1888,37
SIM,1878,33,25-29,1911,15
SIM,1871,24,40-44,1895,2
SIM,1872,26,35-39,1898,10
SIM,1888,33,35-39,1921,17
STAT,1867,69,na,1936,1301.8255324078998
STAT,1900,24,50-100,1924,0.5310656467115604
SIM,1878,31,na,1909,2408
SIM,1895,29,40-44,1924,4
STAT,1864,16,40-44,1880,0.17610182498782145
SIM,1803,59,na,1862,991
STAT,1906,30,35-39,1936,8.065139658736923
SIM,1831,44,na,1875,1482
STAT,1961,11,na,1972,4793.8706214596195
STAT,1814,49,45-49,1863,0.6981470788992449
STAT,1836,23,na,1859,1814.1409026797248
STAT,1868,36,50-100,1904,1.111942463033147
SIM,1830,26,45-49,1856,1
STAT,1846,28,50-100,1874,0.5698608779090467
SIM,1929,33,35-39,1962,11
STAT,1865,68,na,1933,1308.5438752227526
STAT,1860,23,45-49,1883,0.5470408284126891
SIM,1895,36,30-34,1931,6
SIM,1945,25,50-100,1970,1
STAT,1887,29,40-44,1916,3.142741881733395
SIM,1937,25,40-44,1962,4
STAT,1923,26,15-19,1949,0.7683043250984969
STAT,1927,39,na,1966,4409.360823233054
SIM,1859,16,25-29,1875,10
SIM,1865,20,35-39,1885,6
SIM,1845,34,25-29,1879,13
SIM,1907,21,50-100,1928,1
SIM,1911,44,na,1955,3274
SIM,1886,18,na,1904,2488
SIM,1888,23,40-44,1911,3
STAT,1875,30,50-100,1905,0.8968393131758836
SIM,1816,77,na,1893,342
SIM,1819,39,45-49,1858,1
STAT,1864,48,45-49,1912,0.19620860119183647
STAT,1901,38,30-34,1939,1.5136011886117027
SIM,1901,68,na,1969,2344
STAT,1863,24,40-44,1887,1.7367304003730561
STAT,1823,60,na,1883,1101.3954078163713
SIM,1859,23,15-19,1882,2
STAT,1888,20,50-100,1908,0.45799331561091416
SIM,1851,38,30-34,1889,9
SIM,1854,41,na,1895,1849
SIM,1776,83,na,1859,105
STAT,1854,26,25-29,1880,35.11882334922178
STAT,1864,26,35-39,1890,8.152005338934968
STAT,1937,35,40-44,1972,1.4165859996481935
STAT,1871,23,20-24,1894,64.44514888873957
SIM,1906,20,35-39,1926,8
STAT,1853,38,40-44,1891,3.296445310788916
SIM,1818,58,na,1876,1079
STAT,1806,57,na,1863,1069.0564688678814
STAT,1843,38,30-34,1881,3.7847712439786974
SIM,1908,26,25-29,1934,73
STAT,1819,49,45-49,1868,0.4338469280282209
STAT,1866,29,20-24,1895,10.148806041912882
SIM,1881,21,30-34,1902,13
SIM,1861,38,40-44,1899,3
STAT,1796,63,na,1859,851.7091756074603
STAT,1809,49,35-39,1858,0.38145638855278835
SIM,1843,89,na,1932,44
SIM,1937,28,na,1965,3345
SIM,1828,38,40-44,1866,4
SIM,1876,36,50-100,1912,2
STAT,1859,33,15-19,1892,0.1066231237508052
STAT,1934,18,25-29,1952,55.228208049645936
STAT,1929,25,40-44,1954,5.531505553358786
STAT,1862,36,25-29,1898,2.336774072224116
STAT,1901,48,na,1949,2938.2230663072028
SIM,1925,23,20-24,1948,121
SIM,1942,18,25-29,1960,39
SIM,1844,41,na,1885,1590
STAT,1917,23,20-24,1940,111.29954719006993
STAT,1860,30,35-39,1890,7.824890111168501
STAT,1888,5,na,1893,2925.8071964122573
STAT,1837,41,15-19,1878,0.01071236497554744
STAT,1880,19,45-49,1899,0.0647080727816039
SIM,1952,6,na,1958,4391
SIM,1867,15,20-24,1882,16
STAT,1840,39,45-49,1879,1.5155262261237614
STAT,1922,24,40-44,1946,3.619799944229635
STAT,1854,52,40-44,1906,0.007492276844699662
STAT,1872,26,40-44,1898,2.848269304957539
STAT,1862,28,25-29,1890,34.04737156750261
SIM,1896,32,30-34,1928,34
STAT,1878,35,25-29,1913,2.8615497469032127
STAT,1836,25,50-100,1861,0.5438018958881099
STAT,1931,28,15-19,1959,0.8605815804086847
STAT,1898,21,35-39,1919,7.482715109264822
SIM,1924,27,20-24,1951,24
STAT,1862,61,na,1923,1509.331585491668
STAT,1926,16,25-29,1942,50.31449257589682
SIM,1796,93,na,1889,4
STAT,1854,37,30-34,1891,3.813233084333574
STAT,1876,18,25-29,1894,5.516263582719617
SIM,1823,79,na,1902,307
STAT,1899,20,25-29,1919,74.5409895377957
SIM,1923,28,30-34,1951,51
STAT,1919,43,25-29,1962,0.07298963687356601
STAT,1888,32,30-34,1920,19.49287033866146
STAT,1906,15,45-49,1921,0.0902950671459518
STAT,1871,26,40-44,1897,2.819698887334818
STAT,1908,28,25-29,1936,58.57500386437447
SIM,1854,28,40-44,1882,2
STAT,1839,39,20-24,1878,0.6007104009194582
SIM,1904,26,40-44,1930,5
STAT,1929,40,30-34,1969,0.1568363528210429
STAT,1922,23,30-34,1945,31.040559452539114
STAT,1959,0,na,1959,4893.558399408005
SIM,1886,38,45-49,1924,1
SIM,1930,23,30-34,1953,42
SIM,1829,41,30-34,1870,1
SIM,1929,34,45-49,1963,3
STAT,1830,28,45-49,1858,1.047501777005573
STAT,1872,25,30-34,1897,24.023681737853984
SIM,1903,15,na,1918,3427
STAT,1856,46,45-49,1902,0.17444423789154007
STAT,1819,38,40-44,1857,11.256388424583244
STAT,1838,29,45-49,1867,0.9346427113158098
STAT,1844,15,25-29,1859,5.0623797825279135
SIM,1891,36,45-49,1927,2
STAT,1832,95,na,1927,8.009251090625272
STAT,1849,44,45-49,1893,1.1071338732171039
SIM,1873,55,na,1928,1994
STAT,1793,102,na,1895,0.04862639595539986
STAT,1855,68,na,1923,1085.9779462512033
STAT,1859,15,20-24,1874,15.657135870456715
STAT,1878,16,35-39,1894,0.5415422332873993
STAT,1890,16,35-39,1906,0.6352967808231227
STAT,1886,29,40-44,1915,2.9679392232626727
STAT,1904,24,25-29,1928,77.08542423109557
STAT,1825,30,50-100,1855,2.018248803952693
SIM,1930,24,40-44,1954,5
STAT,1811,48,na,1859,1288.8856479543942
STAT,1864,38,50-100,1902,1.0285974883467497
STAT,1868,46,20-24,1914,0.010846814718560553
SIM,1872,38,50-100,1910,1
SIM,1886,35,25-29,1921,5
STAT,1916,27,20-24,1943,17.830090963971013
SIM,1890,36,45-49,1926,1
STAT,1825,49,20-24,1874,0.01190676734045377
SIM,1887,37,35-39,1924,11
SIM,1846,29,45-49,1875,2
STAT,1914,21,30-34,1935,26.699945911595318
STAT,1857,70,na,1927,1045.3758591607502
STAT,1766,112,na,1878,6.394105641693178E-4
STAT,1882,15,45-49,1897,0.060291617043507446
SIM,1887,0,na,1887,3268
SIM,1883,19,20-24,1902,12
SIM,1877,14,na,1891,2510
SIM,1781,94,na,1875,4
SIM,1801,78,na,1879,302
STAT,1870,90,na,1960,126.07289176531278
STAT,1867,25,20-24,1892,10.47731555304225
STAT,1871,33,15-19,1904,0.1330249498325964
STAT,1937,25,50-100,1962,0.9173994838661464
SIM,1934,16,25-29,1950,68
SIM,1870,28,25-29,1898,40
SIM,1864,92,na,1956,39
STAT,1861,29,35-39,1890,7.524939924761651
STAT,1846,35,30-34,1881,4.214633736219316
STAT,1898,47,45-49,1945,0.1693944646220191
SIM,1839,30,35-39,1869,9
STAT,1915,28,30-34,1943,37.62292030204825
SIM,1912,24,25-29,1936,95
STAT,1845,36,40-44,1881,3.2886412635866593
STAT,1854,52,na,1906,1532.3580486149806
STAT,1864,27,45-49,1891,0.9348438989577121
SIM,1887,14,na,1901,2681
STAT,1874,27,20-24,1901,11.32347132559481
SIM,1947,22,45-49,1969,1
SIM,1879,42,50-100,1921,1
STAT,1872,16,na,1888,2415.3052305113697
STAT,1897,15,na,1912,3205.6312374774793
STAT,1896,30,15-19,1926,0.17910819823162447
SIM,1909,22,25-29,1931,95
SIM,1948,21,35-39,1969,11
STAT,1933,27,50-100,1960,1.2485255725414024
SIM,1859,24,25-29,1883,54
SIM,1829,95,na,1924,8
SIM,1888,22,30-34,1910,23
STAT,1880,42,40-44,1922,2.23737425298135
STAT,1810,49,25-29,1859,0.18598888181721626
SIM,1838,78,na,1916,471
SIM,1916,28,25-29,1944,64
SIM,1884,39,25-29,1923,2
STAT,1870,52,25-29,1922,0.003265125450072755
STAT,1877,21,15-19,1898,3.2425881488753743
SIM,1933,12,na,1945,5071
SIM,1901,29,40-44,1930,9
STAT,1906,22,35-39,1928,8.029059244400067
STAT,1896,50,na,1946,2725.15645202068
STAT,1828,47,30-34,1875,0.07838046317207581
STAT,1846,28,40-44,1874,2.6685555504375547
STAT,1878,38,45-49,1916,1.9528940891168851
STAT,1835,39,35-39,1874,5.450994991463785
SIM,1840,27,na,1867,1778
STAT,1856,24,35-39,1880,4.923967680629012
STAT,1954,3,na,1957,4593.696718496012
SIM,1941,27,50-100,1968,5
SIM,1956,1,na,1957,4797
STAT,1819,43,20-24,1862,0.32273247551518774
STAT,1939,22,45-49,1961,1.0675040193790417
SIM,1894,34,20-24,1928,4
SIM,1850,19,25-29,1869,6
STAT,1827,48,40-44,1875,0.15453140039187324
STAT,1886,34,20-24,1920,2.6743162548777324
SIM,1894,29,40-44,1923,3
SIM,1922,25,50-100,1947,1
STAT,1885,34,na,1919,2227.8160753900997
SIM,1840,20,30-34,1860,20
STAT,1836,38,25-29,1874,2.2649138680065706
STAT,1842,19,25-29,1861,5.2078522757435355
STAT,1879,37,35-39,1916,6.994222451900024
SIM,1858,26,50-100,1884,1
SIM,1837,32,25-29,1869,11
SIM,1852,91,na,1943,31
SIM,1936,26,50-100,1962,4
SIM,1878,28,45-49,1906,1
SIM,1902,30,na,1932,3183
SIM,1827,38,40-44,1865,10
STAT,1912,31,na,1943,3530.184874677812
STAT,1884,49,25-29,1933,0.05263682018087972
SIM,1943,2,na,1945,3933
SIM,1950,17,20-24,1967,155
STAT,1928,15,na,1943,4401.605112430158
STAT,1880,16,25-29,1896,5.657553418076107
STAT,1910,21,45-49,1931,1.0012488216990894
SIM,1852,15,25-29,1867,8
STAT,1811,102,na,1913,0.12714784975873097
STAT,1893,40,50-100,1933,1.2784295305897941
STAT,1851,48,50-100,1899,0.17445075798458531
STAT,1871,29,45-49,1900,1.0341004889381158
SIM,1826,77,na,1903,423
STAT,1847,94,na,1941,14.73787844760401
SIM,1872,27,45-49,1899,1
STAT,1829,32,25-29,1861,10.219747592301351
STAT,1856,17,45-49,1873,0.0569315919603082
STAT,1896,23,25-29,1919,71.20381440152347
STAT,1816,88,na,1904,63.97438476766111
SIM,1890,18,15-19,1908,11
STAT,1851,47,20-24,1898,0.00859187247518328
STAT,1908,35,15-19,1943,0.01714684469755526
SIM,1866,102,na,1968,1
STAT,1842,35,45-49,1877,1.7290453255697662
SIM,1847,22,40-44,1869,4
STAT,1865,29,20-24,1894,9.973449736029522
SIM,1864,72,na,1936,1053
STAT,1882,18,15-19,1900,5.437878305503251
SIM,1904,33,30-34,1937,19
STAT,1839,22,40-44,1861,1.7826396503322972
STAT,1919,47,40-44,1966,0.1615492320320917
STAT,1893,36,20-24,1929,0.9279431334105276
STAT,1875,26,45-49,1901,1.0818204484897507
SIM,1828,34,40-44,1862,9
STAT,1855,22,25-29,1877,47.52463665041925
SIM,1852,36,25-29,1888,2
SIM,1938,21,40-44,1959,6
STAT,1837,45,30-34,1882,0.06690743987673403
SIM,1876,18,na,1894,2479
SIM,1874,92,na,1966,118
STAT,1936,32,20-24,1968,2.238098052126022
SIM,1863,36,35-39,1899,14
STAT,1857,53,50-100,1910,0.011071799059685378
SIM,1875,39,30-34,1914,2
STAT,1822,95,na,1917,6.755962720491098
STAT,1932,28,50-100,1960,1.2309964407040441
STAT,1887,25,40-44,1912,3.1868402182018154
STAT,1916,20,35-39,1936,9.376533109252533
SIM,1913,15,na,1928,3624
STAT,1905,34,35-39,1939,7.872315872560891
STAT,1897,29,15-19,1926,0.5691030287688363
STAT,1908,47,30-34,1955,0.07616384445934529
STAT,1899,42,35-39,1941,0.16256637511294797
SIM,1902,20,15-19,1922,4
SIM,1913,34,35-39,1947,9
STAT,1895,24,20-24,1919,84.34122100149416
STAT,1901,16,20-24,1917,23.500755677510043
SIM,1813,80,na,1893,263
STAT,1867,70,na,1937,1244.6363367692206
SIM,1886,39,40-44,1925,3
STAT,1774,102,na,1876,0.06438465998428965
STAT,1910,28,30-34,1938,35.6193401320489
STAT,1914,12,na,1926,3859.432580668312
SIM,1894,3,na,1897,3322
STAT,1855,36,35-39,1891,5.050398096064711
STAT,1878,39,40-44,1917,4.266366061797372
SIM,1833,32,40-44,1865,2
SIM,1951,7,na,1958,4295
STAT,1919,21,15-19,1940,5.523219258558206
SIM,1856,53,na,1909,1671
STAT,1818,80,na,1898,303.79184310406526
SIM,1895,25,40-44,1920,6
SIM,1904,22,25-29,1926,79
STAT,1826,45,20-24,1871,0.011384125662854369
STAT,1926,38,35-39,1964,2.7896450012770466
SIM,1837,39,45-49,1876,1
STAT,1851,18,20-24,1869,15.413859439303247
STAT,1905,20,25-29,1925,78.63495993591846
STAT,1877,15,na,1892,2486.427841566427
STAT,1919,21,30-34,1940,29.821287864409545
STAT,1858,48,20-24,1906,0.00877649775668758
STAT,1943,23,15-19,1966,5.348498018218477
SIM,1929,23,40-44,1952,4
STAT,1860,16,20-24,1876,15.76543577025329
STAT,1811,58,na,1869,1074.8190410114994
STAT,1817,42,50-100,1859,2.6847097209700155
STAT,1880,16,40-44,1896,0.18260691902701184
SIM,1854,24,25-29,1878,58
STAT,1825,32,40-44,1857,7.586141500168988
STAT,1884,38,20-24,1922,0.7158807673593262
SIM,1863,22,25-29,1885,56
SIM,1887,45,na,1932,2357
STAT,1884,24,45-49,1908,0.6467503940805067
SIM,1826,39,35-39,1865,13
STAT,1830,51,40-44,1881,0.007076811263607684
STAT,1859,41,na,1900,1745.662399254657
SIM,1883,26,45-49,1909,1
SIM,1934,8,na,1942,4968
STAT,1829,39,45-49,1868,1.7422244729033824
STAT,1881,23,30-34,1904,16.205375551511967
SIM,1921,34,na,1955,3965
STAT,1907,18,30-34,1925,2.206061673325951
SIM,1915,18,30-34,1933,3
STAT,1846,31,15-19,1877,0.12612446353137868
STAT,1873,38,45-49,1911,1.9005149178989234
STAT,1815,45,45-49,1860,0.5475466013403607
STAT,1843,19,25-29,1862,4.833924259762226
SIM,1880,25,30-34,1905,27
SIM,1891,30,50-100,1921,1
SIM,1832,40,na,1872,1533
SIM,1881,24,35-39,1905,4
SIM,1927,21,30-34,1948,43
STAT,1858,37,15-19,1895,0.041592643567892974
STAT,1867,60,na,1927,1691.8172348976645
SIM,1918,23,30-34,1941,30
STAT,1859,0,na,1859,2936.901514451355
SIM,1884,18,25-29,1902,5
SIM,1822,32,30-34,1854,21
SIM,1922,25,45-49,1947,6
STAT,1882,36,45-49,1918,1.8402617173167914
SIM,1815,39,25-29,1854,1
STAT,1926,44,na,1970,4310.776602922604
SIM,1885,9,na,1894,2494
SIM,1915,27,na,1942,3448
STAT,1869,48,30-34,1917,0.08747719813493847
SIM,1901,21,45-49,1922,5
STAT,1818,39,35-39,1857,18.713552360358943
STAT,1892,23,40-44,1915,2.4580485476051988
SIM,1881,38,45-49,1919,1
STAT,1799,61,na,1860,904.8470953770336
SIM,1868,85,na,1953,185
STAT,1867,28,25-29,1895,37.392575334438035
STAT,1846,23,na,1869,1942.6797812533937
SIM,1849,19,na,1868,2134
STAT,1951,11,na,1962,4419.645052043218
SIM,1848,20,35-39,1868,5
STAT,1917,26,25-29,1943,65.43376800732918
STAT,1835,24,15-19,1859,2.751143506828083
STAT,1885,37,25-29,1922,2.711177510145882
STAT,1889,20,30-34,1909,20.897609327622007
STAT,1940,18,15-19,1958,43.516939569269645
STAT,1817,47,20-24,1864,0.027052379388187876
STAT,1869,34,20-24,1903,2.452631063396161
STAT,1814,46,40-44,1860,0.5324691731574016
SIM,1828,34,25-29,1862,8
STAT,1879,30,15-19,1909,0.14195508780753055
SIM,1807,73,na,1880,463
STAT,1854,42,na,1896,1651.621511146422
SIM,1845,38,40-44,1883,4
SIM,1897,31,50-100,1928,1
SIM,1796,83,na,1879,130
STAT,1925,31,50-100,1956,0.9280269020002043
STAT,1849,37,20-24,1886,0.5914825843232548
SIM,1891,71,na,1962,1721
SIM,1901,17,25-29,1918,9
SIM,1929,30,30-34,1959,25
STAT,1914,25,45-49,1939,1.6564894534171084
SIM,1862,23,20-24,1885,57
SIM,1819,36,40-44,1855,3
SIM,1874,33,40-44,1907,4
STAT,1881,37,40-44,1918,3.994937522022252
STAT,1927,16,40-44,1943,1.646954332117419
STAT,1843,30,35-39,1873,8.39590960047237
STAT,1899,38,15-19,1937,0.015610951112413719
STAT,1877,18,40-44,1895,0.17876345395222146
SIM,1912,21,20-24,1933,106
STAT,1841,17,15-19,1858,5.276767133915306
SIM,1927,21,15-19,1948,6
SIM,1833,42,50-100,1875,3
SIM,1836,43,na,1879,1538
SIM,1833,28,20-24,1861,7
STAT,1869,23,30-34,1892,16.251241609971814
SIM,1877,4,na,1881,2678
SIM,1925,26,25-29,1951,69
SIM,1869,35,40-44,1904,6
SIM,1893,37,25-29,1930,2
STAT,1940,22,35-39,1962,9.061425471221328
STAT,1852,30,na,1882,1828.8413688626304
STAT,1841,35,45-49,1876,1.6532140480524453
SIM,1843,24,15-19,1867,7
SIM,1831,25,35-39,1856,8
SIM,1851,23,45-49,1874,1
SIM,1886,27,40-44,1913,3
STAT,1930,26,40-44,1956,5.601348388207607
SIM,1915,21,50-100,1936,3
SIM,1950,14,na,1964,4257
STAT,1821,49,35-39,1870,0.2144825770929989
STAT,1917,33,15-19,1950,0.12658728176915088
SIM,1913,20,25-29,1933,80
STAT,1818,46,25-29,1864,0.12467880016404409
SIM,1939,31,35-39,1970,12
SIM,1896,18,na,1914,3166
STAT,1887,25,25-29,1912,45.00250162607757
STAT,1925,32,45-49,1957,1.7652203379103828
STAT,1939,29,30-34,1968,37.1752304130136
STAT,1848,42,50-100,1890,0.7840385832105645
SIM,1895,25,25-29,1920,55
STAT,1855,29,45-49,1884,0.8106449558790262
SIM,1798,64,na,1862,819
SIM,1861,20,na,1881,2102
SIM,1836,53,na,1889,1333
SIM,1878,44,30-34,1922,4
SIM,1864,39,20-24,1903,2
STAT,1843,23,45-49,1866,0.5869609981337621
STAT,1878,27,40-44,1905,2.949194368537332
STAT,1892,19,20-24,1911,20.864793428049474
SIM,1940,14,na,1954,3686
STAT,1856,23,na,1879,1817.1958747136655
STAT,1929,39,15-19,1968,0.02323997418502293
STAT,1852,35,20-24,1887,0.5736782008689301
STAT,1913,29,45-49,1942,1.6146396735592639
SIM,1933,32,45-49,1965,2
STAT,1911,27,35-39,1938,13.832197133885867
SIM,1815,61,na,1876,1059
STAT,1912,9,na,1921,3790.500575804829
SIM,1885,23,na,1908,2270
SIM,1843,17,25-29,1860,9
SIM,1910,15,25-29,1925,10
STAT,1888,35,35-39,1923,7.971545052465517
SIM,1869,32,20-24,1901,4
STAT,1937,29,na,1966,3446.354747859744
STAT,1925,39,30-34,1964,2.062052223154466
STAT,1801,58,na,1859,971.8384686537886
SIM,1928,31,25-29,1959,17
SIM,1842,41,50-100,1883,4
STAT,1835,108,na,1943,0.0011658480757001494
SIM,1821,36,30-34,1857,5
SIM,1848,42,50-100,1890,1
SIM,1857,90,na,1947,46
STAT,1857,27,20-24,1884,9.00300228498745
SIM,1921,29,45-49,1950,4
STAT,1904,4,na,1908,3564.730262397249
STAT,1925,25,20-24,1950,20.50523243730169
STAT,1929,43,35-39,1972,0.2459560076709068
SIM,1870,25,20-24,1895,9
STAT,1843,26,15-19,1869,0.3798712402395526
SIM,1903,38,40-44,1941,2
SIM,1914,19,25-29,1933,11
STAT,1840,36,40-44,1876,3.433249213844876
STAT,1940,15,45-49,1955,0.4794049661949935
SIM,1885,35,25-29,1920,2
STAT,1877,35,25-29,1912,2.8482204957711503
SIM,1868,48,50-100,1916,2
STAT,1804,76,na,1880,386.46514212222456
STAT,1848,15,45-49,1863,0.06088566997123378
STAT,1862,25,20-24,1887,9.648700482271382
STAT,1931,14,na,1945,4883.449047948355
STAT,1882,29,20-24,1911,10.70083312418764
STAT,1900,38,15-19,1938,0.015805144272737316
SIM,1825,29,25-29,1854,44
STAT,1840,22,30-34,1862,14.865498824238507
STAT,1873,49,50-100,1922,0.23039975958731027
STAT,1868,49,25-29,1917,0.050833311620021235
STAT,1888,49,45-49,1937,0.14552247536153562
STAT,1961,6,na,1967,4796.843928470719
STAT,1897,47,45-49,1944,0.16740198667676026
SIM,1933,25,20-24,1958,28
STAT,1846,24,40-44,1870,1.8797320973679708
STAT,1921,21,20-24,1942,119.00451719407486
SIM,1822,40,na,1862,1505
SIM,1803,80,na,1883,222
SIM,1848,43,40-44,1891,5
STAT,1878,46,30-34,1924,0.09557217309308381
SIM,1896,35,35-39,1931,17
STAT,1852,17,25-29,1869,4.968833457137335
STAT,1904,21,20-24,1925,93.66223920524529
SIM,1877,47,50-100,1924,4
STAT,1893,29,30-34,1922,29.952991606787332
SIM,1875,31,35-39,1906,8
STAT,1872,17,45-49,1889,0.06210172614119006
STAT,1934,37,30-34,1971,2.3759887387691476
SIM,1878,85,na,1963,397
STAT,1905,27,45-49,1932,1.51611268937465
SIM,1913,27,45-49,1940,1
SIM,1851,30,35-39,1881,15
SIM,1905,27,na,1932,3218
STAT,1867,46,20-24,1913,0.010675160017378078
STAT,1934,32,na,1966,4878.185778690313
SIM,1851,19,25-29,1870,7
SIM,1865,27,20-24,1892,8
STAT,1826,38,30-34,1864,5.62952800120299
STAT,1941,11,na,1952,3838.999450624233
SIM,1909,26,40-44,1935,4
STAT,1833,38,50-100,1871,0.9320658364775327
STAT,1906,26,15-19,1932,0.6263933170928095
STAT,1951,18,25-29,1969,48.73446146132333
SIM,1932,29,na,1961,4552
SIM,1860,17,25-29,1877,7
STAT,1836,35,20-24,1871,0.6255734608093386
STAT,1909,31,15-19,1940,0.11632428163121225
SIM,1834,38,30-34,1872,7
SIM,1849,71,na,1920,981
SIM,1866,34,45-49,1900,4
STAT,1895,24,50-100,1919,0.4990900641475807
SIM,1893,52,na,1945,2679
STAT,1857,39,20-24,1896,0.5685490664320524
SIM,1829,44,35-39,1873,2
STAT,1859,47,25-29,1906,0.043106985374620335
SIM,1854,24,40-44,1878,7
STAT,1797,89,na,1886,38.62503130627792
STAT,1893,21,35-39,1914,7.012173151064684
STAT,1931,17,45-49,1948,0.6176774655855826
SIM,1892,24,45-49,1916,5
STAT,1832,23,35-39,1855,5.5104951731466265
SIM,1830,34,30-34,1864,26
SIM,1848,39,20-24,1887,2
STAT,1919,15,50-100,1934,0.07883615132993337
SIM,1820,37,25-29,1857,5
STAT,1932,16,50-100,1948,0.4698096127588432
SIM,1840,37,45-49,1877,1
SIM,1919,22,35-39,1941,12
STAT,1808,90,na,1898,30.4841170382715
STAT,1856,28,15-19,1884,0.34404145888319787
SIM,1858,85,na,1943,180
SIM,1881,20,na,1901,1848
STAT,1831,24,30-34,1855,18.087015959197462
STAT,1918,25,na,1943,3791.834913435288
STAT,1821,58,na,1879,1137.8106994285013
STAT,1867,21,40-44,1888,1.8695394296070929
SIM,1830,27,40-44,1857,3
STAT,1846,24,25-29,1870,51.639292262687235
STAT,1896,48,40-44,1944,0.11897633735287588
SIM,1899,29,25-29,1928,54
STAT,1866,52,50-100,1918,0.013089293654988168
SIM,1889,44,40-44,1933,8
STAT,1829,43,30-34,1872,0.9655028635579338
STAT,1859,82,na,1941,350.8189068957521
STAT,1887,15,na,1902,2681.167830236489
SIM,1840,19,15-19,1859,5
STAT,1902,22,15-19,1924,4.398362544303985
STAT,1880,89,na,1969,298.6218157676573
SIM,1857,38,na,1895,1864
SIM,1885,33,na,1918,2259
SIM,1922,18,20-24,1940,145
STAT,1832,37,45-49,1869,1.523606302333407
SIM,1825,33,45-49,1858,1
SIM,1890,29,20-24,1919,17
STAT,1896,34,30-34,1930,21.59772726698061
SIM,1834,30,35-39,1864,9
STAT,1840,38,na,1878,1645.2797388932865
STAT,1902,15,25-29,1917,7.590162420425761
STAT,1830,83,na,1913,239.5998393539109
STAT,1921,28,40-44,1949,4.890160583284586
SIM,1885,28,35-39,1913,9
STAT,1822,34,30-34,1856,37.94400559720132
SIM,1840,23,35-39,1863,2
SIM,1943,21,15-19,1964,4
STAT,1902,29,35-39,1931,12.7723114906806
SIM,1854,72,na,1926,983
SIM,1872,15,na,1887,2459
SIM,1910,29,35-39,1939,18
SIM,1930,27,45-49,1957,3
STAT,1927,23,15-19,1950,6.176468478941006
SIM,1908,45,na,1953,3134
STAT,1851,22,40-44,1873,1.7900663878054965
STAT,1837,36,50-100,1873,0.9802600359636953
STAT,1857,49,15-19,1906,2.9180162919564096E-4
STAT,1914,18,20-24,1932,26.425000878774895
SIM,1859,28,40-44,1887,3
STAT,1898,28,20-24,1926,14.944925387334273
SIM,1818,37,35-39,1855,13
STAT,1863,24,25-29,1887,47.710803497974126
SIM,1938,17,20-24,1955,119
STAT,1872,21,15-19,1893,3.1355180489198338
SIM,1871,24,25-29,1895,63
STAT,1884,31,35-39,1915,9.490426537016583
SIM,1892,31,35-39,1923,14
STAT,1889,16,45-49,1905,0.07636979507767695
STAT,1771,98,na,1869,0.39919940534360215
STAT,1918,15,na,1933,4002.9668997393183
SIM,1862,60,na,1922,1644
STAT,1822,48,40-44,1870,0.22695370279419808
STAT,1867,39,30-34,1906,4.680168777846147
STAT,1916,49,30-34,1965,0.08587178857626934
STAT,1931,24,35-39,1955,11.464411028681837
STAT,1817,40,35-39,1857,4.979121456770082
STAT,1876,36,20-24,1912,0.7559733255064908
SIM,1868,25,30-34,1893,27
STAT,1922,27,45-49,1949,1.8467802563254283
SIM,1924,20,35-39,1944,11
SIM,1913,31,30-34,1944,15
STAT,1898,21,na,1919,3032.6527946828983
STAT,1925,35,15-19,1960,0.021810674394729564
SIM,1771,84,na,1855,74
SIM,1942,22,45-49,1964,1
STAT,1816,48,15-19,1864,9.297423910619758E-4
SIM,1814,44,40-44,1858,2
STAT,1826,48,25-29,1874,0.05246511557967787
SIM,1886,16,35-39,1902,1
SIM,1835,22,15-19,1857,3
STAT,1873,35,40-44,1908,4.233981130694932
SIM,1883,23,40-44,1906,1
STAT,1877,28,35-39,1905,9.422036597604327
STAT,1838,22,25-29,1860,49.86262437084567
STAT,1834,76,na,1910,587.3617653973358
STAT,1884,27,15-19,1911,0.42344997938935713
SIM,1859,71,na,1930,1023
SIM,1814,65,na,1879,814
SIM,1907,38,25-29,1945,1
STAT,1909,11,na,1920,3664.308529602145
SIM,1917,38,35-39,1955,5
SIM,1863,33,30-34,1896,19
STAT,1865,49,50-100,1914,0.2059080912963117
SIM,1833,35,45-49,1868,1
STAT,1827,48,25-29,1875,0.05199187262428903
SIM,1927,24,35-39,1951,13
STAT,1850,38,na,1888,1669.6552608211161
STAT,1825,35,45-49,1860,2.7192369535405176
STAT,1936,35,25-29,1971,0.9147077586752592
SIM,1846,22,25-29,1868,44
STAT,1863,49,40-44,1912,0.13896441695775238
STAT,1828,90,na,1918,44.40144943756621
STAT,1848,19,50-100,1867,0.04459787055438447
STAT,1830,29,40-44,1859,2.699812630220857
STAT,1866,33,40-44,1899,3.7627275381211662
STAT,1877,36,20-24,1913,0.7590172275639145
STAT,1882,0,na,1882,3272.6037218783576
STAT,1887,28,45-49,1915,1.1691100719647851
SIM,1881,35,40-44,1916,3
STAT,1935,21,15-19,1956,6.850167121080674
STAT,1892,26,45-49,1918,1.3182750174823028
SIM,1822,35,35-39,1857,13
SIM,1873,49,50-100,1922,2
SIM,1832,35,45-49,1867,1
SIM,1837,38,na,1875,1664
SIM,1828,31,20-24,1859,2
SIM,1838,31,30-34,1869,19
SIM,1879,25,40-44,1904,3
STAT,1855,33,30-34,1888,12.502731544509903
SIM,1907,20,35-39,1927,8
STAT,1813,91,na,1904,23.84823051528666
STAT,1928,44,30-34,1972,0.1534500089258224
SIM,1838,24,na,1862,1793
STAT,1916,20,50-100,1936,0.6552434805529773
STAT,1938,30,30-34,1968,14.982875499766328
STAT,1894,39,25-29,1933,3.4603072616092225
STAT,1847,34,35-39,1881,7.814990709393039
SIM,1855,27,45-49,1882,4
STAT,1883,39,15-19,1922,0.05148763712264757
STAT,1893,39,25-29,1932,3.4146415937940757
SIM,1844,34,25-29,1878,16
SIM,1938,24,45-49,1962,2
STAT,1843,16,20-24,1859,15.393482185573992
STAT,1913,22,25-29,1935,84.5594820966378
SIM,1864,21,30-34,1885,17
STAT,1869,26,35-39,1895,8.860901795602967
STAT,1923,22,35-39,1945,10.349781014485691
SIM,1854,21,20-24,1875,63
STAT,1814,76,na,1890,435.45137625740574
STAT,1923,17,50-100,1940,0.4155996077009422
STAT,1841,28,20-24,1869,9.973314280810545
STAT,1837,48,35-39,1885,0.09311827287146986
STAT,1842,16,20-24,1858,16.58424437864536
SIM,1878,25,40-44,1903,3
SIM,1921,22,25-29,1943,101
STAT,1910,17,25-29,1927,8.112078054704739
SIM,1850,16,20-24,1866,18
SIM,1877,37,40-44,1914,5
SIM,1931,22,35-39,1953,12
STAT,1920,17,35-39,1937,4.447417155740929
STAT,1869,37,40-44,1906,4.006244389755498
STAT,1836,34,25-29,1870,8.211660371150833
STAT,1764,105,na,1869,0.012860516132862002
STAT,1897,69,na,1966,2116.8096246194523
STAT,1845,47,30-34,1892,0.06817912840169095
STAT,1876,74,na,1950,1083.1589737731188
STAT,1938,25,na,1963,3509.1815977476276
STAT,1857,49,na,1906,1641.26938995092
STAT,1934,22,45-49,1956,1.4284675824265374
STAT,1945,9,na,1954,4061.5292326301897
SIM,1823,80,na,1903,275
STAT,1856,21,30-34,1877,15.358423594234242
STAT,1849,47,15-19,1896,2.9854858050054855E-4
STAT,1846,21,20-24,1867,63.52204875812945
STAT,1852,38,25-29,1890,2.0770249927803555
SIM,1838,24,40-44,1862,1
SIM,1901,20,50-100,1921,2
STAT,1842,38,15-19,1880,0.047211662475827455
SIM,1849,31,40-44,1880,3
SIM,1916,32,45-49,1948,1
SIM,1925,37,30-34,1962,1
STAT,1886,84,na,1970,666.442797533688
STAT,1897,15,40-44,1912,0.23215011641150365
STAT,1951,15,20-24,1966,152.59690805200898
STAT,1765,115,na,1880,1.2962707508490452E-4
SIM,1943,18,40-44,1961,1
STAT,1941,29,20-24,1970,17.821094871252747
STAT,1895,27,40-44,1922,3.6893326028423283
SIM,1885,36,20-24,1921,4
SIM,1793,65,na,1858,773
STAT,1908,32,45-49,1940,1.403217928531054
STAT,1913,26,40-44,1939,4.402664673001781
STAT,1849,41,na,1890,1740.9667220570288
STAT,1846,27,45-49,1873,0.9962508462014146
STAT,1836,27,35-39,1863,8.085179278700197
STAT,1861,75,na,1936,808.6292257338812
STAT,1906,19,25-29,1925,7.75506021279774
SIM,1860,38,25-29,1898,1
STAT,1909,1,na,1910,3856.287503659199
SIM,1890,34,na,1924,2960
STAT,1852,28,30-34,1880,21.111457312021837
STAT,1923,26,na,1949,4077.0188100415553
STAT,1862,28,40-44,1890,2.4110555883520903
SIM,1844,27,35-39,1871,10
SIM,1854,27,45-49,1881,1
SIM,1895,22,20-24,1917,82
SIM,1855,34,35-39,1889,9
STAT,1828,36,40-44,1864,4.088225786002741
STAT,1862,24,25-29,1886,46.656403574005
SIM,1860,28,30-34,1888,27
STAT,1935,18,40-44,1953,1.8016341317676074
SIM,1870,28,40-44,1898,4
SIM,1865,67,na,1932,1369
STAT,1921,33,50-100,1954,0.8655364571931781
STAT,1899,47,na,1946,2899.1620478239747
STAT,1905,31,30-34,1936,13.745531286378109
STAT,1907,37,20-24,1944,0.23089146293133067
STAT,1932,16,15-19,1948,56.90961594151556
SIM,1810,62,na,1872,929
STAT,1917,37,30-34,1954,1.7883694810379698
STAT,1871,85,na,1956,280.8247069995112
STAT,1876,15,20-24,1891,17.3835246026042
SIM,1836,36,40-44,1872,4
STAT,1830,43,50-100,1873,0.8104502729289416
SIM,1874,36,45-49,1910,1
STAT,1887,22,20-24,1909,72.8187503124956
SIM,1846,53,na,1899,1528
STAT,1946,21,25-29,1967,97.13771780264412
STAT,1897,22,30-34,1919,22.503724671430177
STAT,1834,42,na,1876,1571.3468030571269
STAT,1899,28,20-24,1927,15.131770084220284
SIM,1870,24,25-29,1894,54
SIM,1829,37,45-49,1866,1
STAT,1824,35,45-49,1859,3.4353367682784324
STAT,1860,19,25-29,1879,4.950726646305521
STAT,1819,75,na,1894,543.4478110838961
STAT,1870,19,35-39,1889,0.507336929550208
STAT,1870,38,na,1908,2172.598624763483
SIM,1937,29,20-24,1966,14
STAT,1881,26,35-39,1907,8.835893574722496
STAT,1927,29,na,1956,4284.953857865489
SIM,1850,68,na,1918,1124
STAT,1855,46,50-100,1901,0.17502543473378285
STAT,1888,28,45-49,1916,1.235232562077527
SIM,1935,23,30-34,1958,45
SIM,1896,28,45-49,1924,2
STAT,1891,26,45-49,1917,1.3021548258102438
SIM,1786,83,na,1869,125
STAT,1881,23,50-100,1904,0.3710022277708316
STAT,1927,23,30-34,1950,33.34834919156059
STAT,1875,48,20-24,1923,0.011505766510531151
STAT,1844,42,na,1886,1644.0036398878071
SIM,1808,58,na,1866,1079
STAT,1866,36,45-49,1902,1.7453275851195436
SIM,1894,37,na,1931,2958
STAT,1844,29,35-39,1873,8.086274749459514
SIM,1881,74,na,1955,804
STAT,1884,17,20-24,1901,16.546405627226726
STAT,1877,70,na,1947,1374.9210307893716
SIM,1940,16,15-19,1956,39
STAT,1848,89,na,1937,78.06086243156912
SIM,1920,15,35-39,1935,6
SIM,1906,28,30-34,1934,40
STAT,1907,30,na,1937,3366.563924562533
STAT,1855,5,na,1860,2125.346931516364
STAT,1915,39,20-24,1954,0.2490444414511549
SIM,1887,23,25-29,1910,68
SIM,1917,28,40-44,1945,6
SIM,1862,26,40-44,1888,2
SIM,1938,31,35-39,1969,11
SIM,1832,39,na,1871,1524
STAT,1878,55,na,1933,2035.7066005201082
STAT,1905,24,40-44,1929,2.8276164054597857
STAT,1873,17,45-49,1890,0.06258643726678004
STAT,1935,25,30-34,1960,50.500720580686334
STAT,1858,41,35-39,1899,1.3473049954702505
STAT,1860,37,20-24,1897,0.590863130447426
STAT,1827,94,na,1921,11.54459251747578
SIM,1841,29,25-29,1870,39
SIM,1801,88,na,1889,49
SIM,1855,2,na,1857,2726
STAT,1854,23,20-24,1877,57.51669300183156
SIM,1831,54,na,1885,1282
STAT,1833,29,25-29,1862,33.7192852687798
STAT,1881,19,45-49,1900,0.05929404635006435
SIM,1941,27,20-24,1968,22
SIM,1884,7,na,1891,2531
STAT,1830,36,30-34,1866,4.391247658099844
STAT,1883,17,20-24,1900,16.42040277628266
SIM,1921,26,40-44,1947,3
STAT,1914,28,15-19,1942,0.6699624536153113
SIM,1908,30,45-49,1938,2
SIM,1913,24,40-44,1937,4
SIM,1891,17,20-24,1908,24
SIM,1902,27,35-39,1929,20
STAT,1798,75,na,1873,420.6947248970438
SIM,1884,15,20-24,1899,13
STAT,1919,17,45-49,1936,0.5215031094843863
STAT,1878,49,35-39,1927,0.13495503871908263
STAT,1887,32,15-19,1919,0.15047995303301137
SIM,1790,98,na,1888,1
SIM,1935,16,40-44,1951,4
STAT,1863,45,25-29,1908,0.04822745654680733
STAT,1850,49,50-100,1899,0.1695143776567278
SIM,1869,35,25-29,1904,4
STAT,1888,46,40-44,1934,0.19167860480053772
STAT,1904,12,na,1916,3499.4455158187357
SIM,1943,25,30-34,1968,37
STAT,1933,27,20-24,1960,22.896969235699324
STAT,1851,25,45-49,1876,0.9487283619325416
SIM,1897,20,30-34,1917,29
STAT,1931,21,30-34,1952,35.32085844473392
SIM,1839,31,50-100,1870,3
STAT,1879,23,25-29,1902,56.43373014409947
SIM,1877,34,20-24,1911,2
STAT,1837,38,40-44,1875,3.423270040860242
STAT,1838,90,na,1928,52.929626819432045
STAT,1925,28,25-29,1953,73.1812881630094
STAT,1870,26,25-29,1896,39.33785464547215
STAT,1863,56,na,1919,1690.8918690490154
SIM,1902,20,na,1922,3175
STAT,1928,25,na,1953,4389.440757848825
STAT,1862,17,35-39,1879,0.5076001707960781
STAT,1870,89,na,1959,149.0699061938358
SIM,1781,84,na,1865,77
STAT,1930,29,45-49,1959,2.0731466468879876
SIM,1869,38,45-49,1907,1
STAT,1856,39,20-24,1895,0.5624571663507043
SIM,1880,34,na,1914,2398
SIM,1892,17,20-24,1909,26
STAT,1799,108,na,1907,5.847815414671819E-4
SIM,1883,52,na,1935,1953
STAT,1869,41,na,1910,2124.793124613615
SIM,1847,38,na,1885,1789
SIM,1871,19,na,1890,2387
STAT,1844,44,50-100,1888,0.7324523532380603
SIM,1876,34,20-24,1910,2
STAT,1836,38,40-44,1874,3.4435525654708674
SIM,1933,31,50-100,1964,4
SIM,1878,6,na,1884,2723
STAT,1823,91,na,1914,31.01257906357586
SIM,1880,21,15-19,1901,3
STAT,1840,25,35-39,1865,8.009917508326325
STAT,1783,76,na,1859,304.43143712905515
STAT,1876,30,na,1906,2347.772281088324
SIM,1933,28,25-29,1961,86
STAT,1871,26,25-29,1897,39.8179686065134
STAT,1899,35,45-49,1934,2.604880676544537
STAT,1928,40,15-19,1968,0.0018545303563567586
STAT,1861,6,na,1867,2252.336330636501
STAT,1866,3,na,1869,2776.707247781978
SIM,1923,15,na,1938,4174
SIM,1844,38,40-44,1882,6
SIM,1870,17,35-39,1887,1
SIM,1911,34,na,1945,3416
STAT,1919,11,na,1930,4142.644291821358
STAT,1902,26,30-34,1928,33.68851508571629
STAT,1865,36,45-49,1901,1.7151709148059173
SIM,1840,34,40-44,1874,7
SIM,1868,21,15-19,1889,2
STAT,1847,27,45-49,1874,0.9840903767269419
STAT,1866,105,na,1971,0.3280131798072586
SIM,1905,32,35-39,1937,12
STAT,1820,102,na,1922,0.1544468367153804
SIM,1830,37,35-39,1867,12
STAT,1834,47,20-24,1881,0.007897910678804625
STAT,1862,71,na,1933,1078.143195835263
STAT,1913,33,30-34,1946,14.746329627948104
STAT,1916,44,na,1960,3583.489116790884
STAT,1938,23,40-44,1961,3.1427004909019964
STAT,1863,35,30-34,1898,4.460273388708682
STAT,1911,30,50-100,1941,0.7667169592079426
SIM,1895,33,na,1928,3006
SIM,1928,7,na,1935,4766
SIM,1948,21,na,1969,3972
SIM,1805,51,na,1856,1186
SIM,1850,5,na,1855,2321
STAT,1858,34,45-49,1892,1.2805584839017703
STAT,1909,35,30-34,1944,1.6452611912091069
STAT,1886,15,30-34,1901,1.5979287550329728
STAT,1886,48,30-34,1934,0.09538397209219335
SIM,1834,20,40-44,1854,1
SIM,1921,33,30-34,1954,28
STAT,1839,75,na,1914,685.4140396950702
SIM,1844,72,na,1916,788
STAT,1821,44,50-100,1865,1.7140663487312477
STAT,1928,33,25-29,1961,10.910708172373226
SIM,1874,29,20-24,1903,11
STAT,1893,22,na,1915,2833.3936384602744
STAT,1840,83,na,1923,260.5257552057646
SIM,1932,18,30-34,1950,21
SIM,1936,33,25-29,1969,8
SIM,1894,15,30-34,1909,2
SIM,1851,16,20-24,1867,22
SIM,1926,33,na,1959,4257
STAT,1822,37,35-39,1859,12.44965717504188
STAT,1939,8,na,1947,3763.344206635325
STAT,1832,34,40-44,1866,3.3481869091799923
STAT,1855,47,40-44,1902,0.12109210536251465
STAT,1828,33,20-24,1861,2.7045583398469923
SIM,1861,38,25-29,1899,5
SIM,1852,29,35-39,1881,8
STAT,1912,15,35-39,1927,0.8053338114980156
STAT,1812,95,na,1907,5.775415226589482
STAT,1902,19,40-44,1921,0.2425443782928032
SIM,1859,38,35-39,1897,6
STAT,1876,25,15-19,1901,0.4458200643197525
STAT,1941,27,50-100,1968,0.9727111222115545
SIM,1889,21,35-39,1910,6
SIM,1910,26,30-34,1936,43
SIM,1946,23,40-44,1969,3
SIM,1898,51,na,1949,2714
STAT,1844,36,25-29,1880,2.346327788790777
STAT,1863,28,40-44,1891,2.474632796301853
SIM,1900,6,na,1906,3477
SIM,1900,29,25-29,1929,52
STAT,1867,49,25-29,1916,0.05002885638199465
SIM,1871,28,40-44,1899,4
STAT,1924,18,30-34,1942,13.675833600592764
SIM,1873,36,45-49,1909,2
SIM,1898,30,25-29,1928,15
SIM,1905,25,45-49,1930,1
STAT,1822,44,25-29,1866,0.8854995870056026
SIM,1828,37,45-49,1865,1
STAT,1873,24,35-39,1897,5.556056905247119
STAT,1911,7,na,1918,3766.6053201654286
STAT,1946,10,na,1956,4117.073857864291
STAT,1919,24,35-39,1943,9.67936557989306
STAT,1943,16,25-29,1959,43.42434547037918
STAT,1854,26,40-44,1880,2.486930162130629
SIM,1836,33,20-24,1869,2
STAT,1824,76,na,1900,522.3859296849588
STAT,1896,37,35-39,1933,8.824781138450554
SIM,1951,16,25-29,1967,57
STAT,1853,38,25-29,1891,2.168157609788115
STAT,1840,18,45-49,1858,0.05517598547095825
STAT,1871,52,40-44,1923,0.009823122973951756
STAT,1921,24,25-29,1945,97.94249818456434
SIM,1879,32,30-34,1911,21
STAT,1909,28,40-44,1937,4.193521130005775
STAT,1877,39,40-44,1916,4.2464931014476335
SIM,1864,102,na,1966,3
SIM,1934,20,45-49,1954,1
STAT,1879,20,20-24,1899,68.552314191278
STAT,1962,8,na,1970,4755.872028182851
SIM,1858,25,20-24,1883,14
STAT,1829,46,35-39,1875,0.11593939562860069
STAT,1843,29,20-24,1872,9.61232614464338
STAT,1881,27,45-49,1908,1.0132698467108883
STAT,1820,47,25-29,1867,0.09661277647961344
STAT,1894,16,na,1910,3073.741436500104
SIM,1807,93,na,1900,10
STAT,1883,64,na,1947,1610.0907998809353
SIM,1823,56,na,1879,1131
SIM,1870,58,na,1928,1794
SIM,1856,11,na,1867,2261
SIM,1948,20,45-49,1968,2
STAT,1911,49,45-49,1960,0.1932432197508837
SIM,1862,33,35-39,1895,13
SIM,1871,28,35-39,1899,11
SIM,1822,36,45-49,1858,1
SIM,1862,38,40-44,1900,9
STAT,1853,51,20-24,1904,5.611265273210836E-4
STAT,1863,28,35-39,1891,7.970971598669825
STAT,1871,31,15-19,1902,0.13413462203346657
SIM,1844,39,30-34,1883,8
SIM,1920,34,50-100,1954,2
STAT,1854,22,25-29,1876,48.12465435021522
STAT,1856,30,35-39,1886,7.714380996042895
SIM,1811,47,na,1858,1248
STAT,1963,7,na,1970,4716.24577164005
STAT,1879,59,na,1938,1921.8396023508876
STAT,1946,9,na,1955,4117.526785810731
STAT,1824,52,35-39,1876,0.01010310788952003
STAT,1827,50,50-100,1877,0.013877114728569274
STAT,1831,33,40-44,1864,3.4168028009673974
STAT,1950,20,35-39,1970,10.560008189363083
STAT,1844,19,40-44,1863,0.1595809546797741
STAT,1903,18,na,1921,3385.904791347347
SIM,1862,22,25-29,1884,57
SIM,1885,38,35-39,1923,14
STAT,1845,40,30-34,1885,0.8499430407188933
STAT,1883,49,15-19,1932,3.627495903458553E-4
STAT,1794,81,na,1875,206.31965799732527
STAT,1862,19,na,1881,2101.1422734434973
SIM,1845,59,na,1904,1348
STAT,1858,65,na,1923,1251.723925932651
STAT,1927,20,na,1947,4275.658806320308
SIM,1824,33,45-49,1857,1
STAT,1884,17,15-19,1901,5.5388391789874225
STAT,1849,17,20-24,1866,16.3639296224062
STAT,1852,38,30-34,1890,3.8447058588047884
SIM,1851,29,20-24,1880,7
STAT,1875,69,na,1944,1425.006160311144
STAT,1868,45,30-34,1913,0.08811976100417927
STAT,1790,91,na,1881,17.446174347212036
SIM,1851,32,50-100,1883,1
SIM,1857,40,45-49,1897,4
STAT,1843,32,20-24,1875,2.1949286553929164
STAT,1826,35,25-29,1861,3.350175638834719
STAT,1862,70,na,1932,1133.2890405483454
SIM,1872,41,25-29,1913,4
SIM,1830,24,30-34,1854,23
STAT,1923,48,25-29,1971,0.05845830134047274
STAT,1796,96,na,1892,1.8493010625794177
STAT,1840,20,30-34,1860,15.081288652665643
SIM,1816,39,25-29,1855,1
STAT,1812,103,na,1915,0.062341126322537674
SIM,1841,30,40-44,1871,6
STAT,1845,48,40-44,1893,0.11962385292005384
STAT,1877,38,35-39,1915,6.896623064118368
STAT,1850,42,35-39,1892,1.274913416283508
STAT,1803,83,na,1886,138.05247037180106
STAT,1874,26,45-49,1900,1.0753683162970924
SIM,1864,30,35-39,1894,8
SIM,1909,16,25-29,1925,9
STAT,1879,48,40-44,1927,0.1671678921627054
STAT,1828,67,na,1895,892.7633584421076
STAT,1864,18,na,1882,2186.8489538256035
STAT,1960,6,na,1966,4835.756897107306
STAT,1894,35,30-34,1929,6.53182095164449
SIM,1840,36,na,1876,1675
SIM,1860,38,30-34,1898,5
STAT,1816,44,50-100,1860,2.6067804997773663
SIM,1891,24,45-49,1915,3
STAT,1883,24,45-49,1907,0.6418253127462714
STAT,1944,23,15-19,1967,5.427811242746106
SIM,1870,34,na,1904,2182
STAT,1833,30,40-44,1863,3.4977316892186754
STAT,1885,46,15-19,1931,3.7772651065798535E-4
SIM,1874,48,na,1922,2085
STAT,1893,26,25-29,1919,50.85218657402022
SIM,1882,26,45-49,1908,1
STAT,1859,39,25-29,1898,2.1430529047517215
SIM,1869,61,na,1930,1693
STAT,1938,25,40-44,1963,4.366201594677483
SIM,1857,17,20-24,1874,18
STAT,1827,44,30-34,1871,1.065715465979925
STAT,1922,49,20-24,1971,0.011923207428186542
STAT,1837,95,na,1932,8.628590679145859
STAT,1849,40,45-49,1889,1.1418969925461298
STAT,1872,34,40-44,1906,4.074191105599632
SIM,1865,87,na,1952,146
SIM,1891,43,50-100,1934,1
STAT,1811,54,20-24,1865,0.002256959890557043
STAT,1923,46,na,1969,4070.0562975015237
SIM,1834,35,25-29,1869,7
STAT,1845,24,25-29,1869,49.56931410356655
STAT,1828,32,25-29,1860,10.627385424523677
STAT,1867,26,50-100,1893,0.5694044430658151
SIM,1881,30,40-44,1911,5
SIM,1853,40,30-34,1893,2
STAT,1891,32,50-100,1923,1.0708906106281117
STAT,1843,16,15-19,1859,5.152902941663987
SIM,1836,43,35-39,1879,1
STAT,1864,52,35-39,1916,0.007209996973010626
STAT,1880,53,30-34,1933,0.005833165513322763
STAT,1889,6,na,1895,3046.674405128877
STAT,1911,45,na,1956,3301.2154346973957
STAT,1813,51,20-24,1864,0.0019682578100233303
SIM,1840,28,na,1868,1782
SIM,1851,32,20-24,1883,1
STAT,1895,34,35-39,1929,12.365696917269117
STAT,1841,19,15-19,1860,5.214789879210871
STAT,1846,47,45-49,1893,0.17422604323592006
SIM,1832,92,na,1924,25
STAT,1886,49,40-44,1935,0.1672752026329906
STAT,1845,39,na,1884,1715.664489380348
STAT,1895,23,25-29,1918,70.28576461791125
STAT,1812,44,na,1856,1354.501484567012
SIM,1922,20,25-29,1942,112
STAT,1864,41,25-29,1905,0.5431245426503871
STAT,1877,16,50-100,1893,0.0481267500762296
STAT,1817,42,20-24,1859,0.40358382195684694
SIM,1910,48,na,1958,3224
STAT,1817,39,20-24,1856,2.273053705352161
STAT,1792,101,na,1893,0.10402126992071462
STAT,1847,43,45-49,1890,1.095660904925087
SIM,1880,34,40-44,1914,2
STAT,1866,106,na,1972,0.17034052440570743
SIM,1870,29,30-34,1899,29
STAT,1896,32,30-34,1928,21.784235192431524
STAT,1947,18,45-49,1965,0.5314397254992449
SIM,1853,24,25-29,1877,62
STAT,1854,75,na,1929,736.5646979991138
STAT,1858,89,na,1947,77.8111973463408
SIM,1881,10,na,1891,2007
SIM,1886,36,30-34,1922,4
STAT,1838,17,45-49,1855,0.05792802096884373
STAT,1874,31,40-44,1905,4.203006488753775
STAT,1828,43,35-39,1871,1.50986943915545
SIM,1841,25,45-49,1866,4
STAT,1845,90,na,1935,55.789859016695345
STAT,1880,40,25-29,1920,0.6459998323202972
STAT,1840,15,50-100,1855,0.042121907931076306
SIM,1838,40,35-39,1878,2
STAT,1767,111,na,1878,0.0010551295206223427
SIM,1869,39,35-39,1908,16
SIM,1844,18,na,1862,1979
STAT,1866,37,20-24,1903,0.671657069286916
SIM,1886,41,na,1927,2270
SIM,1863,37,45-49,1900,1
STAT,1865,53,35-39,1918,0.007253286536338305
SIM,1887,35,35-39,1922,18
STAT,1837,18,40-44,1855,0.17832080437559186
SIM,1836,32,25-29,1868,10
STAT,1823,36,40-44,1859,7.522254242881543
STAT,1879,35,35-39,1914,7.060647430039776
STAT,1889,37,15-19,1926,0.06549053077231104
STAT,1949,15,45-49,1964,0.5491607211190616
STAT,1862,29,30-34,1891,20.194514171932095
STAT,1848,44,45-49,1892,1.0970793611725103
STAT,1882,50,30-34,1932,0.005547286171123775
STAT,1862,44,25-29,1906,0.511680903038064
SIM,1853,54,na,1907,1591
SIM,1860,42,45-49,1902,1
STAT,1807,73,na,1880,540.8504855453281
STAT,1821,80,na,1901,329.5671365498607
SIM,1841,77,na,1918,554
STAT,1829,41,30-34,1870,0.9961683994495376
SIM,1813,43,40-44,1856,5
SIM,1791,85,na,1876,74
STAT,1911,13,na,1924,3727.787921371231
STAT,1897,31,35-39,1928,12.846642603193049
SIM,1828,87,na,1915,86
SIM,1837,41,30-34,1878,2
STAT,1812,50,20-24,1862,0.0024572423243829776
SIM,1851,16,15-19,1867,5
SIM,1849,41,na,1890,1749
STAT,1938,8,na,1946,3716.804259500375
STAT,1834,29,25-29,1863,33.93134075466022
STAT,1914,26,50-100,1940,0.9511952732326769
SIM,1843,22,15-19,1865,6
SIM,1932,30,35-39,1962,15
SIM,1774,81,na,1855,161
STAT,1900,38,50-100,1938,0.34555788337845195
STAT,1890,27,40-44,1917,3.4597739071610185
STAT,1867,36,25-29,1903,2.566365522870553
STAT,1911,44,50-100,1955,0.10462926947314272
STAT,1894,19,25-29,1913,6.8427942770594266
STAT,1925,32,50-100,1957,0.9274886463970442
SIM,1870,66,na,1936,1476
STAT,1853,43,50-100,1896,0.7937431539316961
SIM,1906,20,40-44,1926,2
STAT,1914,20,25-29,1934,86.06118909265304
SIM,1915,30,35-39,1945,10
SIM,1868,35,25-29,1903,4
STAT,1883,32,na,1915,2210.233195177788
SIM,1856,41,40-44,1897,6
STAT,1884,20,45-49,1904,0.654707860250547
STAT,1939,24,45-49,1963,1.0667782399425778
STAT,1800,54,45-49,1854,0.040624180128739536
STAT,1899,28,15-19,1927,0.5852065825349688
STAT,1850,93,na,1943,20.601663425001746
STAT,1886,41,30-34,1927,1.1524569813284529
STAT,1887,46,na,1933,2384.12122068266
STAT,1879,18,45-49,1897,0.06442643350579638
STAT,1828,59,na,1887,1131.2212701965716
STAT,1870,23,20-24,1893,63.66808725587151
STAT,1866,45,50-100,1911,0.2161299690421473
SIM,1831,40,25-29,1871,6
STAT,1844,28,25-29,1872,35.70703963695886
STAT,1861,40,15-19,1901,0.01095689822491733
SIM,1852,28,25-29,1880,47
SIM,1877,41,30-34,1918,1
SIM,1919,18,35-39,1937,4
STAT,1767,103,na,1870,0.04436030638690804
STAT,1894,48,na,1942,2697.5990884484086
STAT,1870,41,50-100,1911,0.9835088085445836
STAT,1880,42,20-24,1922,0.1579727048982406
STAT,1830,37,40-44,1867,3.5574542464410572
STAT,1838,34,35-39,1872,8.274784319311497
STAT,1890,34,na,1924,2732.5109987895285
SIM,1804,77,na,1881,335
STAT,1840,40,25-29,1880,0.49561829076531294
STAT,1869,41,30-34,1910,1.056925031390187
SIM,1936,9,na,1945,2989
STAT,1835,22,15-19,1857,2.7910795219148326
STAT,1833,25,45-49,1858,0.911010484094606
STAT,1824,45,na,1869,1467.8234665932225
STAT,1878,36,30-34,1914,5.272333594447058
STAT,1865,50,30-34,1915,0.005170212371036732
STAT,1904,48,15-19,1952,3.0190390145008663E-4
STAT,1830,30,15-19,1860,0.12622837268903073
STAT,1843,52,45-49,1895,0.009750179150746972
STAT,1819,50,30-34,1869,0.011266639381453074
SIM,1875,36,25-29,1911,2
STAT,1903,26,na,1929,3218.859082731064
SIM,1933,8,na,1941,5110
SIM,1894,30,20-24,1924,2
STAT,1835,35,20-24,1870,0.6192764632884408
SIM,1890,78,na,1968,1361
SIM,1872,24,35-39,1896,6
SIM,1897,37,45-49,1934,6
STAT,1900,53,na,1953,2776.505976870322
STAT,1946,23,50-100,1969,0.6915061093273562
SIM,1888,31,35-39,1919,12
SIM,1907,60,na,1967,2906
STAT,1928,18,35-39,1946,4.981633236103878
STAT,1835,37,na,1872,1685.2586079300404
STAT,1823,40,25-29,1863,0.9054051491007011
STAT,1879,51,40-44,1930,0.010460320731764719
STAT,1895,36,30-34,1931,6.5954934780041095
STAT,1930,38,15-19,1968,0.023638513918724253
STAT,1815,60,na,1875,1071.6373945576443
SIM,1950,6,na,1956,4260
STAT,1869,29,40-44,1898,2.7219144033429616
SIM,1815,69,na,1884,786
STAT,1887,48,45-49,1935,0.24624405770176658
STAT,1850,25,45-49,1875,0.9344265084036155
STAT,1890,42,35-39,1932,2.0888531262872956
STAT,1841,57,na,1898,1385.4635740388853
STAT,1830,30,50-100,1860,0.8121485450881382
STAT,1864,24,35-39,1888,4.920887295303158
STAT,1861,48,25-29,1909,0.04467556588423029
STAT,1886,30,20-24,1916,2.7190925741442395
SIM,1882,59,na,1941,1833
STAT,1890,31,25-29,1921,11.878202156356213
STAT,1840,26,45-49,1866,0.9150841564236671
STAT,1823,51,35-39,1874,0.01040897771715901
SIM,1867,39,50-100,1906,1
SIM,1795,75,na,1870,388
SIM,1936,18,35-39,1954,3
SIM,1873,23,na,1896,2265
STAT,1851,29,25-29,1880,35.1186123456482
STAT,1828,45,30-34,1873,0.08047873700075957
SIM,1824,97,na,1921,2
STAT,1870,30,15-19,1900,0.13303877617097665
STAT,1928,23,30-34,1951,33.794651781962834
STAT,1844,44,30-34,1888,0.7970805038022968
STAT,1869,49,40-44,1918,0.15340906572484525
STAT,1860,28,na,1888,1835.6183955856884
SIM,1787,88,na,1875,25
SIM,1861,41,na,1902,2016
SIM,1862,35,30-34,1897,4
SIM,1837,24,40-44,1861,2
SIM,1894,25,25-29,1919,54
STAT,1885,26,20-24,1911,11.084755546017313
SIM,1946,25,40-44,1971,5
SIM,1846,34,35-39,1880,10
SIM,1879,41,35-39,1920,2
SIM,1880,37,50-100,1917,1
STAT,1937,30,na,1967,3538.8528980527462
SIM,1802,62,na,1864,867
SIM,1878,42,30-34,1920,1
SIM,1861,18,25-29,1879,6
STAT,1838,47,40-44,1885,0.11824770275564242
STAT,1880,20,30-34,1900,17.845719925277436
STAT,1896,15,40-44,1911,0.22926575882027733
STAT,1868,17,30-34,1885,1.462632895240823
STAT,1948,22,na,1970,3961.2053756357304
SIM,1876,17,30-34,1893,4
SIM,1893,26,20-24,1919,12
STAT,1848,36,15-19,1884,0.04344838623690235
SIM,1941,20,35-39,1961,9
STAT,1825,39,25-29,1864,3.328108335728772
SIM,1936,23,30-34,1959,25
STAT,1862,9,na,1871,2253.7938483617654
STAT,1918,33,15-19,1951,0.12845862204854613
SIM,1947,24,45-49,1971,2
STAT,1854,35,30-34,1889,3.8715798024681622
SIM,1877,25,25-29,1902,49
STAT,1848,87,na,1935,130.91254520260227
STAT,1907,30,35-39,1937,8.134447658689819
SIM,1791,93,na,1884,7
SIM,1845,35,30-34,1880,6
STAT,1889,37,45-49,1926,2.3249135659279623
SIM,1869,18,na,1887,2365
SIM,1828,79,na,1907,389
STAT,1839,51,40-44,1890,0.007042827306672999
STAT,1837,63,na,1900,1157.9847763237162
SIM,1894,25,50-100,1919,1
STAT,1891,43,35-39,1934,2.101156442055747
STAT,1924,30,35-39,1954,10.117153836968063
SIM,1821,37,40-44,1858,4
STAT,1858,27,15-19,1885,0.3440119198528757
STAT,1870,14,na,1884,2432.132527593516
SIM,1842,29,25-29,1871,37
SIM,1877,30,20-24,1907,2
SIM,1935,28,50-100,1963,1
STAT,1870,18,25-29,1888,5.270505104465397
STAT,1886,25,25-29,1911,42.49941444357804
STAT,1844,45,15-19,1889,2.821902748936989E-4
STAT,1840,51,35-39,1891,0.0056767929706656355
STAT,1854,33,35-39,1887,7.3434502190685205
STAT,1817,75,na,1892,476.47822300857985
STAT,1899,44,20-24,1943,0.014082378120121374
STAT,1821,40,15-19,1861,0.02520384321491456
STAT,1855,34,35-39,1889,7.176980110627694
STAT,1849,37,15-19,1886,0.04308814070299364
STAT,1837,35,30-34,1872,4.299681770392506
STAT,1913,38,15-19,1951,0.017814763969750094
STAT,1838,50,40-44,1888,0.007314344525736003
SIM,1773,88,na,1861,38
SIM,1897,42,40-44,1939,1
SIM,1861,34,30-34,1895,12
SIM,1846,84,na,1930,198
STAT,1809,45,20-24,1854,0.03507876772318098
STAT,1853,34,30-34,1887,13.327442267827443
STAT,1879,52,25-29,1931,0.003483955455002126
SIM,1924,32,na,1956,4165
STAT,1870,38,25-29,1908,2.65509356819467
STAT,1877,51,50-100,1928,0.014870518532088416
SIM,1929,25,40-44,1954,8
STAT,1831,36,45-49,1867,1.546796113923256
SIM,1842,70,na,1912,899
STAT,1851,21,50-100,1872,0.35283995014529523
STAT,1880,28,40-44,1908,2.972884998360057
SIM,1832,84,na,1916,172
STAT,1910,45,35-39,1955,0.11417716917046304
SIM,1827,34,25-29,1861,12
STAT,1881,21,30-34,1902,16.30468246633546
STAT,1786,86,na,1872,64.07978732021962
STAT,1839,46,45-49,1885,0.1621577719864393
STAT,1865,59,na,1924,1664.1226222698283
STAT,1865,104,na,1969,0.5252902557709913
STAT,1889,42,40-44,1931,2.6199992633672067
SIM,1898,18,20-24,1916,26
SIM,1863,34,35-39,1897,4
STAT,1852,92,na,1944,30.195252708218185
STAT,1853,54,25-29,1907,0.002606867413834661
SIM,1837,44,35-39,1881,2
STAT,1810,85,na,1895,115.96954548123128
STAT,1850,30,40-44,1880,3.5880133281408804
STAT,1868,46,15-19,1914,3.6156017257803804E-4
STAT,1832,29,15-19,1861,0.3629673087724807
STAT,1870,51,20-24,1921,6.871472013417034E-4
STAT,1822,41,20-24,1863,0.23754270352862084
SIM,1937,31,25-29,1968,13
STAT,1918,16,25-29,1934,8.961918332991544
STAT,1832,32,na,1864,1686.4236266054395
SIM,1863,56,na,1919,1692
STAT,1859,27,30-34,1886,19.260851817434144
SIM,1872,40,40-44,1912,8
SIM,1830,58,na,1888,1182
STAT,1871,22,25-29,1893,53.700522547679846
STAT,1896,35,35-39,1931,8.908591154251587
STAT,1862,52,50-100,1914,0.012133830375386094
SIM,1822,33,40-44,1855,7
STAT,1850,69,na,1919,1034.5056503038309
STAT,1807,52,35-39,1859,0.03154623357958983
STAT,1895,39,40-44,1934,5.337065462814995
STAT,1816,46,20-24,1862,0.02879347800060297
STAT,1895,57,na,1952,2475.0589244500043
SIM,1890,20,35-39,1910,9
STAT,1820,44,20-24,1864,0.2743986701568454
SIM,1867,46,na,1913,2169
STAT,1834,26,15-19,1860,0.37188248471292634
STAT,1822,52,30-34,1874,0.007703011162066111
STAT,1872,46,35-39,1918,0.13303746485944612
SIM,1899,48,na,1947,2940
STAT,1887,14,na,1901,2720.0623664876466
SIM,1867,27,30-34,1894,28
STAT,1779,84,na,1863,85.9952913080182
STAT,1814,75,na,1889,478.74421568148205
STAT,1861,77,na,1938,678.9689177056349
STAT,1882,20,35-39,1902,5.393132838424517
SIM,1882,23,40-44,1905,2
SIM,1847,30,35-39,1877,13
STAT,1833,33,45-49,1866,1.3633133115826903
STAT,1864,40,40-44,1904,1.9129361845209019
SIM,1872,37,40-44,1909,6
SIM,1811,87,na,1898,70
STAT,1832,47,50-100,1879,0.1754962282970888
STAT,1845,41,15-19,1886,0.010079559462905324
STAT,1867,53,45-49,1920,0.012666943857095377
STAT,1883,21,40-44,1904,1.935878596017365
SIM,1883,30,45-49,1913,1
STAT,1911,46,40-44,1957,0.14136030630078422
SIM,1833,34,na,1867,1638
SIM,1897,8,na,1905,3371
STAT,1901,39,35-39,1940,1.9984064664267716
SIM,1836,23,na,1859,1771
STAT,1829,44,35-39,1873,1.4972425762749015
STAT,1894,38,35-39,1932,8.544285614550736
STAT,1874,43,35-39,1917,1.7352138321680222
STAT,1849,72,na,1921,947.0044799835538
SIM,1825,90,na,1915,35
STAT,1848,41,50-100,1889,0.7941480883755859
STAT,1853,18,25-29,1871,5.128470667968719
SIM,1841,33,45-49,1874,2
STAT,1842,108,na,1950,0.0013265017923362358
SIM,1856,41,50-100,1897,1
STAT,1882,53,40-44,1935,0.009516620393058367
STAT,1855,51,25-29,1906,0.0025290919748475814
STAT,1839,30,35-39,1869,8.471646274561394
STAT,1871,30,30-34,1901,16.51012978017225
SIM,1852,44,30-34,1896,3
STAT,1871,38,40-44,1909,4.086046316037108
STAT,1936,13,na,1949,3578.0067802394487
STAT,1903,22,15-19,1925,4.434390574106232
STAT,1835,29,50-100,1864,0.5230329442947369
STAT,1844,33,20-24,1877,2.2217923426835733
STAT,1845,54,50-100,1899,0.010393251781682898
SIM,1911,22,15-19,1933,4
SIM,1969,2,na,1971,4489
STAT,1846,28,35-39,1874,8.595610845293217
STAT,1861,19,40-44,1880,0.1631902523511852
SIM,1854,28,35-39,1882,11
STAT,1933,20,35-39,1953,11.869367553029921
SIM,1808,59,na,1867,1065
SIM,1929,22,30-34,1951,46
STAT,1866,49,15-19,1915,3.412512306305278E-4
STAT,1881,24,40-44,1905,1.8897925344185418
SIM,1862,30,30-34,1892,20
SIM,1884,23,15-19,1907,5
SIM,1852,33,20-24,1885,2
STAT,1862,17,50-100,1879,0.04532143542409381
STAT,1878,85,na,1963,462.5432872437736
STAT,1875,30,45-49,1905,1.7068877356132501
STAT,1860,16,15-19,1876,5.277412828221858
STAT,1915,51,na,1966,3452.7165503386236
STAT,1895,20,20-24,1915,85.37893573503291
SIM,1939,30,45-49,1969,1
SIM,1882,43,35-39,1925,4
STAT,1881,52,35-39,1933,0.00781485821940302
SIM,1906,35,na,1941,3294
STAT,1905,49,20-24,1954,0.009050043583430069
STAT,1824,40,40-44,1864,3.113402146952881
STAT,1840,23,35-39,1863,4.835117188449005
SIM,1891,37,20-24,1928,5
SIM,1893,34,20-24,1927,3
SIM,1857,92,na,1949,26
SIM,1881,33,45-49,1914,1
STAT,1822,43,40-44,1865,3.1861584665756375
STAT,1838,51,25-29,1889,0.002412642675284203
SIM,1896,25,35-39,1921,15
SIM,1830,43,40-44,1873,4
SIM,1927,25,30-34,1952,53
SIM,1836,40,30-34,1876,1
STAT,1900,21,na,1921,3108.7641483140037
STAT,1853,26,na,1879,1910.2864783523933
SIM,1842,62,na,1904,1182
STAT,1938,28,45-49,1966,1.6161450143410048
SIM,1829,34,35-39,1863,11
SIM,1814,42,45-49,1856,1
STAT,1862,41,20-24,1903,0.1288566488896408
STAT,1848,41,40-44,1889,1.6908087626655601
STAT,1861,45,20-24,1906,0.009519817717079042
STAT,1872,18,35-39,1890,0.5185820506643432
STAT,1857,16,na,1873,2022.0365495706799
STAT,1847,40,35-39,1887,1.3776050789209129
SIM,1795,67,na,1862,743
STAT,1875,27,20-24,1902,11.391411335324776
SIM,1931,34,na,1965,4642
STAT,1858,57,na,1915,1488.4964502237049
STAT,1818,43,20-24,1861,0.3620914066330351
STAT,1821,88,na,1909,73.14004375157184
STAT,1855,17,45-49,1872,0.05521185824370345
STAT,1845,24,50-100,1869,0.353108129943809
STAT,1883,37,20-24,1920,0.7139705438909286
STAT,1891,31,40-44,1922,5.089386677383268
STAT,1874,34,45-49,1908,1.6687672906539455
STAT,1823,36,na,1859,1550.1270599072043
STAT,1882,48,50-100,1930,0.2228013625636121
STAT,1885,41,15-19,1926,0.013062776990399974
SIM,1881,31,25-29,1912,9
STAT,1828,48,40-44,1876,0.1368044233868176
STAT,1863,42,20-24,1905,0.13149665616979717
SIM,1818,44,30-34,1862,3
SIM,1811,79,na,1890,265
SIM,1926,16,25-29,1942,57
STAT,1836,50,30-34,1886,0.0040578365669067295
STAT,1886,42,15-19,1928,0.013764005814324716
SIM,1918,12,na,1930,4088
SIM,1855,40,35-39,1895,5
SIM,1841,22,40-44,1863,4
SIM,1883,27,20-24,1910,16
STAT,1864,39,50-100,1903,1.0233207832315312
STAT,1923,45,20-24,1968,0.01227024503205173
SIM,1891,21,40-44,1912,3
STAT,1942,4,na,1946,3955.876706849147
STAT,1877,35,30-34,1912,5.27223796792186
SIM,1881,18,na,1899,1954
SIM,1885,35,30-34,1920,10
STAT,1881,41,25-29,1922,0.5886883603667539
STAT,1919,25,30-34,1944,40.26634485829779
STAT,1863,53,30-34,1916,0.004855533494732639
STAT,1893,43,45-49,1936,0.12361129428555313
SIM,1868,38,35-39,1906,11
STAT,1818,54,30-34,1872,0.011707444742171948
STAT,1868,3,na,1871,2849.113538339518
SIM,1824,30,40-44,1854,2
SIM,1831,36,40-44,1867,8
SIM,1849,40,50-100,1889,1
STAT,1771,96,na,1867,1.0652011131451526
STAT,1828,40,30-34,1868,1.0079195449272187
STAT,1861,85,na,1946,215.32907043758752
STAT,1906,37,50-100,1943,0.3646110545421363
STAT,1861,28,30-34,1889,19.78071222117071
STAT,1868,48,35-39,1916,0.12460234092267752
SIM,1827,62,na,1889,996
STAT,1826,52,45-49,1878,0.012924523395898963
STAT,1814,50,25-29,1864,0.010771686245784234
SIM,1815,43,45-49,1858,3
STAT,1885,34,20-24,1919,2.5235258910768295
STAT,1885,45,30-34,1930,0.09205983503877228
STAT,1873,33,45-49,1906,1.6637305803598723
STAT,1890,30,40-44,1920,5.0490204330607025
SIM,1832,40,40-44,1872,4
SIM,1778,95,na,1873,4
SIM,1911,33,na,1944,3443
STAT,1827,28,25-29,1855,77.89486082827878
STAT,1895,31,30-34,1926,21.591241587070506
SIM,1812,72,na,1884,541
STAT,1836,54,na,1890,1355.9765501479174
STAT,1859,23,15-19,1882,2.5551294182799698
STAT,1859,44,20-24,1903,0.11779820235172937
SIM,1882,34,45-49,1916,1
STAT,1920,23,50-100,1943,0.6889094867447019
STAT,1787,71,na,1858,566.0636837631077
STAT,1883,56,na,1939,1889.1362905285655
STAT,1828,48,35-39,1876,0.11187277639207131
STAT,1886,21,na,1907,2367.2319456421824
STAT,1832,40,na,1872,1580.1120094723346
STAT,1855,31,30-34,1886,12.76509628436192
SIM,1819,51,na,1870,1290
STAT,1853,37,35-39,1890,5.352759586295424
SIM,1906,23,45-49,1929,5
STAT,1825,48,15-19,1873,4.024245456063388E-4
SIM,1781,83,na,1864,97
STAT,1898,48,20-24,1946,0.00854488876019213
SIM,1835,28,25-29,1863,34
SIM,1842,26,20-24,1868,12
STAT,1824,33,50-100,1857,1.9467622382615637
SIM,1850,4,na,1854,2340
STAT,1886,28,35-39,1914,9.594872691436313
STAT,1900,27,25-29,1927,55.43620109967585
SIM,1852,69,na,1921,1076
SIM,1878,45,50-100,1923,2
STAT,1848,53,35-39,1901,0.006294319331443223
SIM,1907,20,na,1927,3315
SIM,1863,39,50-100,1902,1
STAT,1884,33,20-24,1917,2.512174419175109
SIM,1892,33,20-24,1925,2
STAT,1764,113,na,1877,3.058930680926797E-4
STAT,1829,52,na,1881,1373.1559313517173
SIM,1938,15,35-39,1953,4
STAT,1819,37,35-39,1856,19.62735441058964
STAT,1881,24,35-39,1905,5.292158506812299
STAT,1855,4,na,1859,2252.8587359724015
SIM,1855,26,na,1881,2026
STAT,1813,54,25-29,1867,0.00889680401938315
SIM,1914,22,na,1936,3525
SIM,1953,15,30-34,1968,14
SIM,1897,34,40-44,1931,8
STAT,1844,16,30-34,1860,1.4154988115600844
STAT,1865,41,40-44,1906,1.9346934289117979
SIM,1867,23,15-19,1890,2
SIM,1861,37,35-39,1898,15
SIM,1877,44,35-39,1921,5
SIM,1863,31,30-34,1894,23
STAT,1812,53,25-29,1865,0.011106370556111432
STAT,1869,33,25-29,1902,9.334365461293944
STAT,1869,49,na,1918,2016.0395534431452
SIM,1788,73,na,1861,461
STAT,1891,46,45-49,1937,0.15603418464645452
SIM,1908,17,20-24,1925,22
SIM,1827,37,35-39,1864,18
STAT,1896,35,40-44,1931,5.513617392937262
STAT,1797,108,na,1905,4.4948516947870604E-4
STAT,1861,25,20-24,1886,9.41658918848912
STAT,1900,38,35-39,1938,1.9907295279604007
STAT,1810,96,na,1906,3.6324907097040815
SIM,1872,0,na,1872,3391
STAT,1832,32,45-49,1864,1.3764249910476885
STAT,1935,17,50-100,1952,0.4838481357733813
SIM,1884,39,30-34,1923,8
STAT,1833,25,15-19,1858,0.37226570131590786
STAT,1820,44,15-19,1864,0.02386075521542226
STAT,1876,39,30-34,1915,5.149340761238797
STAT,1934,30,na,1964,4883.702804958716
STAT,1824,77,na,1901,476.6144745259629
STAT,1880,45,25-29,1925,0.05793776041897102
SIM,1770,91,na,1861,13
STAT,1874,95,na,1969,58.93582386410408
STAT,1837,54,40-44,1891,0.006644672329379094
STAT,1871,34,25-29,1905,9.526040938837697
STAT,1869,44,35-39,1913,1.6348680698956402
STAT,1829,27,45-49,1856,1.5956263730922498
STAT,1809,48,30-34,1857,0.2684420096028992
SIM,1837,44,40-44,1881,3
SIM,1840,32,45-49,1872,3
SIM,1845,67,na,1912,1086
SIM,1869,34,35-39,1903,12
STAT,1854,38,35-39,1892,5.0354689579537455
SIM,1873,41,40-44,1914,6
SIM,1837,27,45-49,1864,3
SIM,1872,81,na,1953,453
STAT,1844,40,15-19,1884,0.010077996743734068
STAT,1850,45,45-49,1895,0.1680204756537835
STAT,1904,11,na,1915,3504.6674703495564
SIM,1811,43,30-34,1854,4
SIM,1873,20,35-39,1893,8
SIM,1832,49,na,1881,1374
SIM,1877,33,25-29,1910,18
STAT,1832,29,45-49,1861,0.8882554114076902
STAT,1838,37,na,1875,1735.0478771777857
STAT,1845,27,35-39,1872,8.310723931218735
STAT,1866,52,45-49,1918,0.012577660047436887
SIM,1840,29,45-49,1869,4
STAT,1831,45,35-39,1876,0.10234016017691204
STAT,1842,36,20-24,1878,0.6616871334448443
SIM,1831,99,na,1930,1
STAT,1870,34,30-34,1904,16.042454963216173
STAT,1945,15,30-34,1960,12.585030228898521
STAT,1854,30,30-34,1884,13.061182790101093
SIM,1893,3,na,1896,3314
STAT,1827,47,35-39,1874,0.12805598266175108
STAT,1836,39,30-34,1875,4.149191634994615
SIM,1828,38,35-39,1866,13
STAT,1866,44,na,1910,1986.6495196705634
SIM,1894,28,35-39,1922,15
STAT,1860,44,15-19,1904,0.010442485412634987
STAT,1874,26,15-19,1900,0.4394271497732527
SIM,1860,56,na,1916,1683
STAT,1864,37,40-44,1901,3.685733846025848
STAT,1849,29,na,1878,1895.4130373044056
STAT,1919,41,na,1960,3807.608196531975
STAT,1889,45,45-49,1934,0.2779801340749463
STAT,1910,42,30-34,1952,0.1141457579676446
SIM,1874,16,na,1890,2370
STAT,1854,38,40-44,1892,3.116502794599498
SIM,1876,29,25-29,1905,49
STAT,1831,47,na,1878,1408.626660118446
STAT,1811,70,na,1881,711.5403235992865
STAT,1892,39,15-19,1931,0.06577616440595946
STAT,1920,39,45-49,1959,0.7036155102864913
STAT,1854,50,25-29,1904,0.002570675514461418
SIM,1838,89,na,1927,59
SIM,1884,18,na,1902,2467
STAT,1865,20,35-39,1885,5.130878543730147
SIM,1883,84,na,1967,517
SIM,1895,29,35-39,1924,18
STAT,1858,97,na,1955,3.9791203316568344
STAT,1835,38,30-34,1873,4.150298622152034
STAT,1840,23,40-44,1863,1.7265862982009463
SIM,1879,71,na,1950,1285
SIM,1892,69,na,1961,2177
STAT,1843,48,30-34,1891,0.06456169782729929
STAT,1880,23,35-39,1903,5.793799702854248
SIM,1822,33,35-39,1855,10
STAT,1895,39,35-39,1934,8.62332853066657
SIM,1834,75,na,1909,584
STAT,1852,25,25-29,1877,36.23874310106416
STAT,1768,113,na,1881,3.280558643936572E-4
STAT,1888,44,45-49,1932,1.6483669568161368
SIM,1948,22,40-44,1970,5
STAT,1830,33,25-29,1863,8.64192177004313
STAT,1834,26,20-24,1860,9.615818456191597
STAT,1929,31,25-29,1960,11.096929482698853
STAT,1857,20,50-100,1877,0.35584437680309705
SIM,1843,38,30-34,1881,5
STAT,1887,29,35-39,1916,10.12299938749838
SIM,1860,25,25-29,1885,38
STAT,1826,29,50-100,1855,1.2738634929057338
STAT,1861,45,15-19,1906,3.1732697810434593E-4
STAT,1939,21,40-44,1960,3.1910795767328204
STAT,1858,43,20-24,1901,0.11678013854989325
STAT,1849,54,50-100,1903,0.011013636685471982
SIM,1947,21,40-44,1968,5
STAT,1875,27,15-19,1902,0.44055182313054736
SIM,1893,16,25-29,1909,9
STAT,1898,27,45-49,1925,1.4194332811740291
SIM,1963,5,na,1968,4692
STAT,1870,35,20-24,1905,0.7211775817780126
SIM,1895,24,35-39,1919,7
STAT,1759,100,na,1859,0.08597965243340167
STAT,1838,37,45-49,1875,1.6149373557820736
STAT,1872,69,na,1941,1390.610736139904
STAT,1921,35,45-49,1956,0.720338979485871
STAT,1843,67,na,1910,1070.7301515920062
STAT,1885,17,30-34,1902,1.5008569146214066
SIM,1916,27,20-24,1943,19
STAT,1864,43,45-49,1907,1.2510259094937928
SIM,1828,33,35-39,1861,12
SIM,1854,44,35-39,1898,1
STAT,1849,53,20-24,1902,5.444576345469809E-4
STAT,1855,34,40-44,1889,3.0734003343164527
STAT,1890,35,40-44,1925,5.103882284185521
STAT,1894,72,na,1966,1823.7354603574724
STAT,1943,15,na,1958,3689.2537189865916
STAT,1855,46,35-39,1901,0.09977019925542693
STAT,1876,39,25-29,1915,2.7818277522953285
STAT,1763,114,na,1877,1.5656670340556664E-4
SIM,1796,60,na,1856,977
STAT,1887,24,35-39,1911,6.127658305635896
SIM,1886,15,25-29,1901,5
STAT,1797,70,na,1867,669.1472591796668
STAT,1844,48,25-29,1892,0.03950190524445126
STAT,1835,54,30-34,1889,0.0037110456847208673
SIM,1923,47,na,1970,4128
STAT,1906,45,20-24,1951,0.009406343853939323
STAT,1809,48,25-29,1857,0.15973408681925566
STAT,1939,21,35-39,1960,8.936271373893248
STAT,1893,35,15-19,1928,0.06791363417491952
STAT,1871,18,40-44,1889,0.17166728435453438
SIM,1863,34,40-44,1897,2
SIM,1889,46,na,1935,2728
SIM,1857,36,na,1893,1877
STAT,1901,36,30-34,1937,1.5284674321343734
SIM,1854,25,30-34,1879,24
SIM,1792,70,na,1862,587
STAT,1824,85,na,1909,151.1541236726675
SIM,1824,44,50-100,1868,1
SIM,1843,22,20-24,1865,51
STAT,1846,25,30-34,1871,22.923165936057845
STAT,1908,27,20-24,1935,16.440364903188986
STAT,1927,28,50-100,1955,1.1390905056169836
STAT,1916,21,40-44,1937,3.3384834407744934
STAT,1826,44,15-19,1870,0.012964935141521488
STAT,1816,49,25-29,1865,0.13177253889085352
STAT,1859,113,na,1972,1.2608764215732036E-4
SIM,1847,15,na,1862,2173
STAT,1846,44,35-39,1890,1.324958315513221
SIM,1868,35,30-34,1903,8
SIM,1889,28,20-24,1917,13
SIM,1838,54,na,1892,1391
SIM,1861,15,20-24,1876,21
SIM,1921,32,na,1953,3997
SIM,1894,17,na,1911,3193
STAT,1919,33,30-34,1952,15.990130981500728
STAT,1886,45,25-29,1931,0.05805268530571774
SIM,1880,31,30-34,1911,27
SIM,1812,42,35-39,1854,7
SIM,1843,19,20-24,1862,12
STAT,1840,50,50-100,1890,0.010053724477469463
STAT,1842,100,na,1942,0.7688245356541656
STAT,1872,31,30-34,1903,16.61204213127136
STAT,1837,50,25-29,1887,0.0024003585346011494
STAT,1869,25,25-29,1894,38.97646131056874
STAT,1823,44,40-44,1867,2.8413020488279126
SIM,1831,44,40-44,1875,10
STAT,1926,46,na,1972,4292.846209257187
SIM,1872,43,45-49,1915,4
SIM,1809,52,na,1861,1196
SIM,1938,15,40-44,1953,1
STAT,1853,15,20-24,1868,16.33145610570622
STAT,1885,16,25-29,1901,5.349143810140217
STAT,1835,22,20-24,1857,58.302167208785036
STAT,1862,24,30-34,1886,14.517393503154121
SIM,1868,87,na,1955,115
STAT,1932,35,20-24,1967,0.33517413484248504
STAT,1862,109,na,1971,0.00979486156622663
SIM,1884,23,20-24,1907,56
SIM,1927,28,35-39,1955,22
STAT,1816,100,na,1916,0.4947283798444658
STAT,1815,49,na,1864,1321.097000936648
SIM,1946,22,30-34,1968,48
STAT,1883,43,50-100,1926,0.971431395839967
STAT,1896,18,45-49,1914,0.0812884032684922
SIM,1817,39,40-44,1856,8
SIM,1865,26,45-49,1891,1
SIM,1879,25,35-39,1904,15
SIM,1943,1,na,1944,3960
STAT,1864,45,40-44,1909,0.14558263851836853
SIM,1924,21,40-44,1945,4
SIM,1908,17,15-19,1925,8
STAT,1836,109,na,1945,4.6071755853803296E-4
STAT,1835,38,25-29,1873,2.242115335291592
STAT,1815,49,50-100,1864,0.5364474854372897
STAT,1896,20,50-100,1916,0.511829911680148
STAT,1829,44,40-44,1873,1.8597779575005868
STAT,1871,52,20-24,1923,6.885366838108148E-4
SIM,1917,27,na,1944,3678
STAT,1926,23,20-24,1949,127.21924790122553
SIM,1831,42,45-49,1873,3
SIM,1858,77,na,1935,631
STAT,1919,17,25-29,1936,45.240403878561686
SIM,1927,33,30-34,1960,18
SIM,1921,43,na,1964,3973
STAT,1904,6,na,1910,3539.891475737659
STAT,1890,33,45-49,1923,2.005555710486296
STAT,1774,104,na,1878,0.02528484034645858
STAT,1914,10,na,1924,3871.114521543599
SIM,1843,38,25-29,1881,3
SIM,1894,33,25-29,1927,17
STAT,1875,80,na,1955,600.666074410427
SIM,1852,16,30-34,1868,1
SIM,1856,51,na,1907,1701
STAT,1910,45,40-44,1955,0.13962236654932383
SIM,1900,41,na,1941,3108
STAT,1917,46,35-39,1963,0.1275378085493186
SIM,1820,38,30-34,1858,6
SIM,1894,27,50-100,1921,1
SIM,1794,82,na,1876,135
SIM,1947,21,35-39,1968,13
STAT,1869,48,50-100,1917,0.22194627899216215
STAT,1924,31,na,1955,4170.723222202585
STAT,1896,74,na,1970,1779.9181895526847
STAT,1835,43,20-24,1878,0.11957127885837118
STAT,1919,28,35-39,1947,15.270910917115547
SIM,1846,37,45-49,1883,1
STAT,1857,26,45-49,1883,0.858235870742306
STAT,1874,46,45-49,1920,0.2284394686897534
STAT,1920,22,15-19,1942,5.590551911558256
SIM,1883,76,na,1959,933
STAT,1892,60,na,1952,2256.6709453024528
SIM,1917,38,na,1955,3636
STAT,1883,16,15-19,1899,5.510160150859352
STAT,1838,80,na,1918,415.294714822139
STAT,1874,40,30-34,1914,1.120883822055159
SIM,1858,36,25-29,1894,5
STAT,1867,33,15-19,1900,0.12579362357893314
SIM,1879,39,na,1918,2352
SIM,1866,72,na,1938,1093
STAT,1874,23,40-44,1897,2.0051260116140384
STAT,1901,28,50-100,1929,0.8429144698538502
SIM,1831,39,45-49,1870,3
SIM,1919,15,30-34,1934,4
SIM,1843,25,na,1868,1940
SIM,1850,89,na,1939,69
SIM,1853,28,40-44,1881,2
STAT,1811,59,na,1870,1053.7418396172636
STAT,1938,34,50-100,1972,0.7843655812575275
SIM,1880,15,30-34,1895,2
STAT,1878,32,50-100,1910,0.902062621547689
STAT,1841,101,na,1942,0.3933947084824416
STAT,1885,49,25-29,1934,0.053106207153599955
STAT,1910,26,50-100,1936,0.9111456553605248
STAT,1872,15,30-34,1887,1.5332914055763986
SIM,1946,19,na,1965,3755
STAT,1858,30,45-49,1888,1.318720844654903
STAT,1938,22,30-34,1960,26.872498558983935
SIM,1832,60,na,1892,1116
SIM,1935,0,na,1935,5335
STAT,1870,54,25-29,1924,0.0031923310705650643
STAT,1919,40,50-100,1959,0.12060359159901039
SIM,1882,40,30-34,1922,1
STAT,1825,30,na,1855,1558.7233643359243
SIM,1850,19,30-34,1869,3
STAT,1867,45,15-19,1912,3.583684353922649E-4
SIM,1927,17,25-29,1944,51
STAT,1813,53,40-44,1866,0.02697811666781041
STAT,1887,45,35-39,1932,0.14941065853863875
SIM,1868,84,na,1952,228
STAT,1845,28,40-44,1873,2.561585616037479
STAT,1842,19,30-34,1861,1.4648022560975542
SIM,1893,54,na,1947,2609
STAT,1872,40,na,1912,2212.1769129653185
STAT,1876,54,na,1930,2043.7120811606849
STAT,1897,13,na,1910,3257.639346897628
SIM,1887,38,45-49,1925,2
STAT,1825,62,na,1887,1004.4971491280083
STAT,1846,21,na,1867,1970.8800146691744
SIM,1923,20,40-44,1943,6
STAT,1886,25,30-34,1911,25.29976468082328
STAT,1867,2,na,1869,2984.4993700582454
STAT,1847,37,40-44,1884,3.349195977108608
STAT,1836,42,25-29,1878,0.4946975763571722
STAT,1899,44,15-19,1943,0.0012245546852802487
SIM,1844,34,30-34,1878,24
SIM,1933,32,50-100,1965,4
STAT,1882,53,35-39,1935,0.00778228304965345
SIM,1892,13,na,1905,3388
SIM,1863,21,na,1884,2010
SIM,1919,23,25-29,1942,102
STAT,1902,35,35-39,1937,2.0546783395709975
STAT,1909,43,15-19,1952,0.0013488536067272907
STAT,1931,17,50-100,1948,0.46325809918918687
SIM,1878,86,na,1964,345
SIM,1860,29,40-44,1889,2
STAT,1836,53,35-39,1889,0.005530238335120797
SIM,1827,34,30-34,1861,20
STAT,1836,34,30-34,1870,13.99773581642485
SIM,1866,30,45-49,1896,2
STAT,1878,51,25-29,1929,0.0035038695064088065
STAT,1831,30,30-34,1861,14.294058590901408
STAT,1910,28,na,1938,3405.4775901196926
SIM,1953,18,35-39,1971,8
STAT,1845,44,25-29,1889,0.451026745874303
SIM,1843,29,40-44,1872,3
SIM,1889,49,na,1938,2639
SIM,1848,27,20-24,1875,9
SIM,1907,16,15-19,1923,10
STAT,1894,16,20-24,1910,21.576175689470837
STAT,1926,43,15-19,1969,0.0017856025067761632
STAT,1863,44,40-44,1907,1.8395187718281905
STAT,1846,32,na,1878,1899.6162428996843
STAT,1927,22,25-29,1949,107.50805332362927
STAT,1915,20,40-44,1935,3.1696242164936868
STAT,1847,40,40-44,1887,1.7111719907753733
SIM,1908,20,15-19,1928,3
STAT,1893,40,40-44,1933,2.7218851048210824
STAT,1879,38,45-49,1917,1.9615278925779034
SIM,1838,24,35-39,1862,5
SIM,1855,37,40-44,1892,4
STAT,1861,28,25-29,1889,33.22832039279374
SIM,1894,25,30-34,1919,36
STAT,1857,72,na,1929,940.9337309049538
STAT,1851,42,20-24,1893,0.1141003869305963
STAT,1852,34,15-19,1886,0.1046993534084666
SIM,1853,32,25-29,1885,11
STAT,1934,17,20-24,1951,173.2370008639024
SIM,1871,44,40-44,1915,3
STAT,1904,3,na,1907,3582.283451308662
SIM,1942,17,20-24,1959,117
STAT,1851,39,20-24,1890,0.5489238766425178
STAT,1853,35,15-19,1888,0.04338934887489284
SIM,1958,12,na,1970,4784
SIM,1889,78,na,1967,1203
SIM,1835,25,20-24,1860,10
STAT,1835,19,20-24,1854,29.597658543955127
STAT,1769,112,na,1881,5.931253378577262E-4
STAT,1852,22,15-19,1874,2.8412836302779243
STAT,1877,36,15-19,1913,0.05529265267326361
STAT,1830,51,20-24,1881,4.960381919599685E-4
STAT,1888,25,35-39,1913,10.845613318091342
STAT,1904,41,50-100,1945,0.0998597064157304
SIM,1860,22,15-19,1882,5
SIM,1873,36,50-100,1909,1
STAT,1848,36,na,1884,1822.8867392220077
SIM,1828,35,30-34,1863,5
SIM,1858,33,20-24,1891,2
SIM,1895,26,30-34,1921,46
STAT,1823,39,15-19,1862,0.08147667063347772
SIM,1934,23,20-24,1957,143
SIM,1889,38,na,1927,2849
STAT,1826,39,40-44,1865,4.478212305218226
STAT,1862,41,15-19,1903,0.01120492659559134
SIM,1918,22,25-29,1940,99
SIM,1937,22,35-39,1959,12
STAT,1842,15,45-49,1857,0.061468316046099404
STAT,1945,23,30-34,1968,29.74801565977684
SIM,1853,24,30-34,1877,14
SIM,1855,40,40-44,1895,2
STAT,1879,19,na,1898,2484.110600534809
SIM,1831,26,45-49,1857,4
SIM,1835,89,na,1924,47
STAT,1893,23,15-19,1916,3.9401093496488135
STAT,1894,36,15-19,1930,0.06850254282918543
SIM,1939,30,na,1969,3599
STAT,1843,32,15-19,1875,0.11563739960279006
SIM,1925,17,na,1942,4155
SIM,1932,27,na,1959,4558
STAT,1887,26,30-34,1913,26.700634245200604
STAT,1935,33,15-19,1968,0.16784754928676004
STAT,1810,93,na,1903,12.363480280522326
SIM,1935,22,25-29,1957,120
SIM,1870,24,30-34,1894,17
STAT,1847,24,35-39,1871,5.199731917658436
STAT,1826,32,15-19,1858,0.19518773291379093
SIM,1856,44,45-49,1900,4
SIM,1907,21,40-44,1928,2
STAT,1786,110,na,1896,1.298436925871505E-4
STAT,1797,100,na,1897,0.2605162154355427
SIM,1935,24,na,1959,4598
STAT,1836,35,15-19,1871,0.045571582348873034
STAT,1916,48,50-100,1964,0.21854836423733953
STAT,1929,22,35-39,1951,11.248257345427318
SIM,1931,10,na,1941,4901
STAT,1890,17,45-49,1907,0.07544526027298985
STAT,1926,35,na,1961,4351.016926690772
STAT,1899,31,45-49,1930,2.26643251017467
SIM,1908,33,20-24,1941,4
SIM,1893,43,na,1936,2890
STAT,1862,32,25-29,1894,8.273141356235556
SIM,1908,45,50-100,1953,1
STAT,1814,86,na,1900,101.98006848554091
STAT,1888,38,40-44,1926,4.86301441877908
SIM,1855,24,35-39,1879,9
STAT,1845,24,30-34,1869,15.423761443195849
STAT,1852,29,40-44,1881,2.268925400689407
STAT,1872,61,na,1933,1770.6765694852447
STAT,1827,45,15-19,1872,3.7570768921830626E-4
STAT,1857,26,15-19,1883,0.3507004407681162
STAT,1861,33,20-24,1894,2.114257911137312
STAT,1835,29,40-44,1864,2.449268796413475
SIM,1850,39,25-29,1889,2
SIM,1854,23,35-39,1877,6
STAT,1945,18,35-39,1963,4.328869681509994
STAT,1920,36,40-44,1956,1.549777758034686
SIM,1899,34,20-24,1933,7
STAT,1842,39,25-29,1881,2.180055044075069
STAT,1897,15,35-39,1912,0.6964503089108666
SIM,1908,20,45-49,1928,1
SIM,1876,26,20-24,1902,13
STAT,1900,35,30-34,1935,7.050767534122915
SIM,1921,35,na,1956,3994
SIM,1900,70,na,1970,2178
STAT,1797,81,na,1878,209.89037394506394
STAT,1801,57,na,1858,991.277418837186
STAT,1946,22,35-39,1968,9.898717843166237
SIM,1839,36,45-49,1875,1
STAT,1846,23,35-39,1869,5.302054095173075
STAT,1859,50,na,1909,1642.2113188589638
STAT,1843,53,50-100,1896,0.01003731265584452
STAT,1793,96,na,1889,1.4555315318583333
STAT,1867,50,40-44,1917,0.00947304999549715
STAT,1841,52,35-39,1893,0.005903592007307198
STAT,1900,24,20-24,1924,89.74477412629186
SIM,1833,23,na,1856,1730
SIM,1910,35,35-39,1945,7
SIM,1861,39,30-34,1900,3
SIM,1846,44,na,1890,1599
SIM,1812,64,na,1876,863
SIM,1896,38,40-44,1934,11
SIM,1880,34,35-39,1914,8
STAT,1844,45,20-24,1889,0.008465715693536388
STAT,1838,53,45-49,1891,0.009586716832166182
STAT,1825,70,na,1895,745.7138396680364
STAT,1860,29,20-24,1889,8.958576210980969
SIM,1871,25,30-34,1896,33
SIM,1839,33,40-44,1872,7
STAT,1842,15,15-19,1857,5.584397642823725
STAT,1876,35,15-19,1911,0.05532763164672468
STAT,1904,35,45-49,1939,0.5885863369484293
SIM,1880,25,na,1905,2437
STAT,1888,41,40-44,1929,2.522562583710789
STAT,1883,24,na,1907,2176.826475314565
STAT,1855,37,45-49,1892,1.4166248359176328
STAT,1921,48,20-24,1969,0.011736344311877043
SIM,1822,71,na,1893,682
SIM,1878,24,35-39,1902,6
STAT,1840,44,40-44,1884,1.500838607410936
STAT,1854,18,40-44,1872,0.1556229923702586
SIM,1955,15,40-44,1970,2
STAT,1836,22,na,1858,1827.2606340320747
SIM,1843,25,25-29,1868,43
SIM,1826,29,35-39,1855,8
STAT,1870,15,20-24,1885,16.78376037247958
STAT,1884,50,40-44,1934,0.009966872425989015
STAT,1903,58,na,1961,2777.699278319967
SIM,1856,36,45-49,1892,1
STAT,1898,24,40-44,1922,2.6473050851904616
SIM,1913,30,25-29,1943,9
SIM,1833,39,25-29,1872,3
SIM,1854,41,30-34,1895,1
STAT,1917,43,50-100,1960,0.11563813283478419
STAT,1910,46,25-29,1956,0.04687193272195631
SIM,1912,35,45-49,1947,1
STAT,1931,24,40-44,1955,4.09386044382834
SIM,1844,74,na,1918,692
SIM,1881,23,25-29,1904,45
SIM,1836,24,25-29,1860,44
STAT,1832,26,40-44,1858,2.4887143560481064
STAT,1860,32,20-24,1892,2.071920680478984
STAT,1863,25,30-34,1888,21.17927285460754
STAT,1932,38,25-29,1970,1.2484815837757288
STAT,1848,98,na,1946,2.4138545981731654
SIM,1893,29,25-29,1922,55
STAT,1876,23,20-24,1899,67.05109467648668
SIM,1821,33,25-29,1854,15
STAT,1868,24,na,1892,2118.372987045137
STAT,1891,40,30-34,1931,1.3572691848385479
STAT,1900,41,50-100,1941,0.0965764905463022
STAT,1854,54,40-44,1908,0.007325240186430498
STAT,1895,15,25-29,1910,7.011561464327388
STAT,1853,39,30-34,1892,3.9928094182741773
SIM,1879,40,50-100,1919,1
STAT,1833,29,30-34,1862,20.072982032216864
SIM,1938,31,40-44,1969,5
STAT,1848,36,45-49,1884,1.5424175279788677
STAT,1863,40,25-29,1903,0.5377309826472108
STAT,1846,41,30-34,1887,0.874164437237864
STAT,1910,48,45-49,1958,0.19103589479141478
STAT,1905,30,25-29,1935,14.09864200768826
SIM,1878,54,na,1932,2127
SIM,1829,29,na,1858,1630
STAT,1845,43,35-39,1888,1.2882462973115238
STAT,1861,44,30-34,1905,0.8908601415789338
SIM,1826,38,25-29,1864,1
SIM,1841,29,30-34,1870,26
STAT,1912,48,50-100,1960,0.20478353907749286
STAT,1874,28,na,1902,2295.4196610979006
STAT,1859,28,na,1887,1812.2711823847505
STAT,1867,49,30-34,1916,0.0840762733411671
SIM,1854,95,na,1949,13
SIM,1840,22,25-29,1862,53
STAT,1845,32,25-29,1877,8.617858706565714
STAT,1898,27,15-19,1925,0.5800222226998173
STAT,1860,36,na,1896,1814.5710906227469
STAT,1928,15,30-34,1943,14.575879374186545
STAT,1943,23,20-24,1966,111.72344726319272
SIM,1840,26,40-44,1866,2
SIM,1853,43,35-39,1896,3
STAT,1828,28,40-44,1856,4.238284459291347
STAT,1876,26,25-29,1902,41.4280737789901
SIM,1874,17,20-24,1891,18
STAT,1814,54,40-44,1868,0.029548062293450205
STAT,1885,29,25-29,1914,39.54816806584223
SIM,1924,24,45-49,1948,2
STAT,1912,54,na,1966,3248.488609441911
STAT,1882,90,na,1972,248.80974524771773
STAT,1837,108,na,1945,0.0011887591746190251
SIM,1870,27,35-39,1897,10
STAT,1865,44,45-49,1909,1.2642242219799549
SIM,1879,22,30-34,1901,27
STAT,1862,27,35-39,1889,7.82234927154713
STAT,1774,93,na,1867,5.08804141936713
STAT,1887,42,30-34,1929,1.2133407083139343
SIM,1873,44,45-49,1917,2
SIM,1792,78,na,1870,268
SIM,1910,40,na,1950,3365
SIM,1907,28,na,1935,3437
STAT,1896,47,35-39,1943,0.09807242912825298
STAT,1906,17,45-49,1923,0.08987748325101963
STAT,1832,22,25-29,1854,82.53000122091342
STAT,1791,102,na,1893,0.05428331709136584
STAT,1912,7,na,1919,3806.165937620247
STAT,1881,45,40-44,1926,0.1577958608701866
STAT,1895,19,40-44,1914,0.2240551284713706
STAT,1929,3,na,1932,4889.9207395211115
SIM,1890,34,50-100,1924,2
SIM,1850,15,15-19,1865,7
SIM,1869,36,30-34,1905,6
STAT,1837,35,50-100,1872,0.9904918164273904
STAT,1861,21,na,1882,1922.3053603768087
SIM,1890,54,na,1944,2625
STAT,1906,48,25-29,1954,0.044143044233133776
STAT,1834,42,20-24,1876,0.1188171518820163
SIM,1825,82,na,1907,234
SIM,1936,15,30-34,1951,9
SIM,1894,68,na,1962,2101
STAT,1859,9,na,1868,2126.3907325938467
STAT,1874,32,50-100,1906,0.8843816496037271
SIM,1859,62,na,1921,1444
STAT,1863,87,na,1950,146.05691628328893
STAT,1842,51,45-49,1893,0.01055991783700319
SIM,1948,17,15-19,1965,46
SIM,1846,34,40-44,1880,2
STAT,1917,17,20-24,1934,27.561498722290946
SIM,1925,17,20-24,1942,155
STAT,1916,24,45-49,1940,1.1068479102364726
STAT,1947,15,40-44,1962,1.4892971390158827
STAT,1896,42,na,1938,2890.0966330965725
SIM,1852,25,20-24,1877,8
STAT,1829,47,45-49,1876,0.19289647986784217
STAT,1838,88,na,1926,92.16535947689181
STAT,1834,39,20-24,1873,0.582819938554347
STAT,1880,44,40-44,1924,2.2098946434162934
STAT,1844,25,20-24,1869,10.119034589279442
SIM,1830,27,35-39,1857,13
SIM,1944,20,na,1964,3643
STAT,1896,38,45-49,1934,2.4749076066723847
STAT,1838,34,40-44,1872,3.5435133581754132
STAT,1866,17,20-24,1883,15.855344772830907
STAT,1844,19,35-39,1863,0.47874283632068165
STAT,1893,31,na,1924,2870.5497735105205
SIM,1856,43,na,1899,1800
SIM,1884,26,25-29,1910,46
SIM,1905,21,30-34,1926,25
STAT,1836,37,35-39,1873,5.621972456510706
SIM,1949,21,15-19,1970,9
STAT,1895,35,25-29,1930,3.5796924368674765
SIM,1891,16,15-19,1907,8
SIM,1866,10,na,1876,2416
STAT,1851,45,25-29,1896,0.04184723484955918
STAT,1893,39,30-34,1932,6.320719580655964
STAT,1942,23,50-100,1965,0.6515385231728693
SIM,1896,34,25-29,1930,18
STAT,1899,18,50-100,1917,0.06324907151950035
STAT,1931,20,25-29,1951,113.84873540912163
SIM,1876,28,na,1904,2329
SIM,1930,17,na,1947,4497
SIM,1879,6,na,1885,2692
STAT,1800,86,na,1886,73.06086402529965
STAT,1851,26,20-24,1877,9.95227990520069
SIM,1923,23,45-49,1946,2
STAT,1886,44,35-39,1930,1.782638375234622
SIM,1832,43,45-49,1875,1
STAT,1915,23,45-49,1938,1.0953800198428914
STAT,1819,42,25-29,1861,1.3526227335721188
STAT,1886,33,25-29,1919,10.178067812425617
SIM,1808,67,na,1875,785
STAT,1873,27,40-44,1900,2.8700931220101733
STAT,1888,34,25-29,1922,11.337432534141364
STAT,1830,54,25-29,1884,0.002243592823988175
STAT,1819,53,35-39,1872,0.015347890332110406
STAT,1895,23,50-100,1918,0.5006822336505896
STAT,1821,44,30-34,1865,1.8653075012419413
STAT,1823,42,45-49,1865,1.9964674505203732
STAT,1823,39,45-49,1862,2.892421463508806
STAT,1885,46,20-24,1931,0.011331805287572822
SIM,1882,31,40-44,1913,5
SIM,1887,35,40-44,1922,7
STAT,1840,35,35-39,1875,5.605151119258046
SIM,1833,26,na,1859,1718
SIM,1939,32,40-44,1971,8
STAT,1879,15,40-44,1894,0.18170827045283827
STAT,1879,54,45-49,1933,0.013956295931669967
SIM,1881,27,40-44,1908,2
SIM,1949,18,15-19,1967,47
SIM,1836,28,40-44,1864,5
SIM,1836,74,na,1910,688
STAT,1873,30,40-44,1903,4.188469884642644
SIM,1815,40,40-44,1855,11
STAT,1948,1,na,1949,4439.65308927157
SIM,1866,21,na,1887,2127
STAT,1859,105,na,1964,0.11147540770135214
STAT,1862,62,na,1924,1476.2923170852553
STAT,1824,43,45-49,1867,1.9170423687666465
STAT,1879,35,40-44,1914,4.369906285023085
SIM,1858,21,na,1879,2036
SIM,1822,93,na,1915,8
STAT,1880,13,na,1893,2568.0242508348742
SIM,1843,33,na,1876,1850
STAT,1808,49,20-24,1857,0.04394365263056142
STAT,1905,34,40-44,1939,3.3711641751306587
SIM,1897,24,45-49,1921,4
STAT,1818,38,25-29,1856,8.280212966821319
STAT,1889,24,45-49,1913,0.8081635599640431
SIM,1777,78,na,1855,273
SIM,1913,34,40-44,1947,6
STAT,1842,48,15-19,1890,2.860329250914123E-4
STAT,1793,99,na,1892,0.31411931896035455
SIM,1886,39,35-39,1925,8
STAT,1809,53,20-24,1862,0.0019439793702135627
STAT,1850,29,na,1879,1768.872290377544
SIM,1865,23,40-44,1888,3
STAT,1854,52,20-24,1906,5.25159612327113E-4
STAT,1878,39,35-39,1917,6.893352993193396
STAT,1882,79,na,1961,826.0048830135173
STAT,1873,65,na,1938,1619.1775409078477
SIM,1865,36,na,1901,2095
STAT,1857,23,40-44,1880,1.7794776090943272
STAT,1938,23,na,1961,3413.2320323542076
STAT,1839,54,45-49,1893,0.0093966317676181
STAT,1852,95,na,1947,9.639082602291783
STAT,1891,34,45-49,1925,2.020696860552647
STAT,1831,33,35-39,1864,7.9788908300271775
STAT,1861,15,25-29,1876,5.176877377792598
SIM,1838,21,30-34,1859,19
STAT,1825,36,20-24,1861,1.0088144847334515
STAT,1876,44,20-24,1920,0.15291004143946024
STAT,1882,39,na,1921,2142.687969118848
STAT,1815,101,na,1916,0.2547031340233081
STAT,1901,14,na,1915,3403.9043411927955
STAT,1905,28,na,1933,3247.313185712575
STAT,1862,45,30-34,1907,0.07896664658439573
STAT,1883,52,45-49,1935,0.013370035387966163
STAT,1875,43,20-24,1918,0.15309580706024897
SIM,1876,5,na,1881,2682
SIM,1949,21,45-49,1970,1
STAT,1837,38,35-39,1875,5.531126124871655
STAT,1904,43,na,1947,3119.97427227235
STAT,1833,45,45-49,1878,0.17401677095528692
STAT,1892,27,20-24,1919,13.881243415381457
STAT,1873,23,50-100,1896,0.3895025983849092
STAT,1918,17,50-100,1935,0.07729071898045226
SIM,1892,17,15-19,1909,9
SIM,1929,28,45-49,1957,2
STAT,1881,36,35-39,1917,6.4858613856291205
SIM,1906,43,na,1949,3164
SIM,1899,37,25-29,1936,1
STAT,1780,78,na,1858,240.2434895859538
SIM,1834,96,na,1930,5
STAT,1873,54,na,1927,2006.250503858392
STAT,1830,32,35-39,1862,8.686538229425073
SIM,1830,82,na,1912,262
STAT,1904,22,30-34,1926,24.136648245003297
STAT,1869,45,25-29,1914,0.05324045689610287
STAT,1847,62,na,1909,1347.782177940343
STAT,1859,36,20-24,1895,0.5823835892803727
SIM,1880,87,na,1967,375
SIM,1912,22,30-34,1934,30
STAT,1871,33,35-39,1904,9.459830438734258
STAT,1835,25,25-29,1860,35.5984220270959
STAT,1808,52,20-24,1860,0.0026658192866340883
SIM,1868,76,na,1944,780
STAT,1849,21,na,1870,1952.4730680133823
STAT,1921,32,50-100,1953,0.8692045001839543
SIM,1831,23,40-44,1854,1
SIM,1844,37,35-39,1881,9
STAT,1872,34,35-39,1906,9.5140187906201
SIM,1879,79,na,1958,738
STAT,1826,48,30-34,1874,0.0881705423100669
STAT,1880,24,25-29,1904,56.65598963203109
STAT,1827,49,30-34,1876,0.08622432375709668
STAT,1897,16,na,1913,3198.6429613797786
STAT,1911,22,30-34,1933,25.751504105545624
SIM,1919,20,20-24,1939,106
SIM,1845,38,35-39,1883,14
SIM,1871,51,na,1922,2072
SIM,1867,39,25-29,1906,5
SIM,1891,28,na,1919,2800
STAT,1847,73,na,1920,875.8574115398403
STAT,1856,30,50-100,1886,0.6979580536719776
SIM,1849,22,45-49,1871,3
STAT,1908,34,50-100,1942,0.730971660581608
STAT,1813,102,na,1915,0.12065518789008459
STAT,1834,44,na,1878,1531.5949547576338
STAT,1850,33,45-49,1883,1.2726465949030539
STAT,1886,39,50-100,1925,1.2128463961394385
SIM,1848,101,na,1949,1
STAT,1820,43,30-34,1863,2.0483146160043906
STAT,1875,19,50-100,1894,0.04731671506778078
STAT,1913,17,na,1930,3730.6605743876403
STAT,1814,45,35-39,1859,0.44276425245408757
SIM,1877,13,na,1890,2515
STAT,1832,45,15-19,1877,2.9325228035048835E-4
SIM,1877,29,40-44,1906,4
STAT,1845,47,na,1892,1584.6299886236345
SIM,1808,56,na,1864,1135
STAT,1822,65,na,1887,868.4421417379036
STAT,1834,42,15-19,1876,0.010331926808646424
STAT,1873,57,na,1930,1925.4565419667128
STAT,1910,43,20-24,1953,0.01567327545150575
STAT,1865,20,40-44,1885,1.8322005953653906
SIM,1891,17,na,1908,2985
SIM,1887,16,30-34,1903,1
STAT,1826,55,na,1881,1216.6816672149564
STAT,1845,25,15-19,1870,0.39645139124477724
STAT,1847,33,25-29,1880,8.77654185967423
STAT,1829,53,30-34,1882,0.004192825932784367
STAT,1875,58,na,1933,1920.2761706415804
SIM,1768,96,na,1864,1
STAT,1873,51,40-44,1924,0.010134954324100534
SIM,1866,42,45-49,1908,5
SIM,1802,73,na,1875,454
STAT,1830,60,na,1890,1151.0703095357358
STAT,1836,30,15-19,1866,0.11901243822746368
STAT,1766,104,na,1870,0.026882432894917555
STAT,1865,17,40-44,1882,0.16138756690481726
STAT,1858,42,45-49,1900,1.107168866271917
SIM,1830,80,na,1910,358
SIM,1903,32,30-34,1935,13
SIM,1813,49,na,1862,1293
STAT,1860,92,na,1952,31.924678677211915
STAT,1856,54,45-49,1910,0.010402623850015476
STAT,1894,43,25-29,1937,0.05374666677488748
STAT,1861,47,35-39,1908,0.10945552280431971
SIM,1817,39,na,1856,1511
STAT,1864,82,na,1946,392.84924062285023
SIM,1910,35,40-44,1945,2
SIM,1858,23,na,1881,1976
STAT,1922,21,35-39,1943,10.231511240138888
SIM,1901,46,50-100,1947,1
SIM,1926,12,na,1938,4522
STAT,1934,19,na,1953,4678.015458899483
SIM,1926,10,na,1936,4530
SIM,1896,40,na,1936,2934
SIM,1914,33,45-49,1947,1
SIM,1900,28,35-39,1928,17
STAT,1833,42,40-44,1875,1.6722383357891544
STAT,1827,74,na,1901,641.0490863133297
STAT,1896,28,na,1924,2967.149040724497
SIM,1821,78,na,1899,454
STAT,1896,31,25-29,1927,12.831773610656805
STAT,1902,35,40-44,1937,1.2716612575203345
SIM,1822,85,na,1907,130
SIM,1855,33,25-29,1888,16
SIM,1905,40,40-44,1945,1
STAT,1813,50,30-34,1863,0.016198418198725483
SIM,1887,12,na,1899,2689
STAT,1880,21,20-24,1901,68.83956216439405
STAT,1911,8,na,1919,3758.2057903014597
SIM,1889,24,40-44,1913,2
STAT,1863,44,35-39,1907,1.4809326102238258
STAT,1848,58,na,1906,1469.4696786988056
STAT,1940,2,na,1942,3906.8383959016837
STAT,1880,41,30-34,1921,1.150175502231282
STAT,1918,4,na,1922,4150.233722772602
STAT,1856,42,35-39,1898,1.3330673876657668
STAT,1866,103,na,1969,1.0576199908071964
STAT,1805,61,na,1866,994.7533982593106
STAT,1831,54,40-44,1885,0.006341155164083369
STAT,1829,40,25-29,1869,0.565204321080039
STAT,1873,23,25-29,1896,54.678369049643024
SIM,1850,35,na,1885,1854
SIM,1910,22,20-24,1932,92
SIM,1892,32,45-49,1924,5
SIM,1905,24,35-39,1929,6
STAT,1865,48,50-100,1913,0.2076565595275335
STAT,1859,39,50-100,1898,0.9138372725572949
STAT,1886,27,50-100,1913,0.6383556811519203
STAT,1882,44,45-49,1926,1.3564265915024425
STAT,1805,93,na,1898,10.201897930766455
STAT,1839,30,40-44,1869,3.6278156120138054
STAT,1839,27,40-44,1866,2.512548014834744
STAT,1871,15,15-19,1886,5.669582667549846
STAT,1921,22,30-34,1943,30.667323303957172
SIM,1950,3,na,1953,4289
SIM,1868,19,25-29,1887,8
SIM,1871,44,35-39,1915,4
STAT,1836,26,50-100,1862,0.5398973982756335
STAT,1827,96,na,1923,4.959925786002856
STAT,1844,50,50-100,1894,0.01063995171816918
STAT,1930,40,25-29,1970,0.08900477229188167
STAT,1852,63,na,1915,1293.5960606124831
STAT,1827,52,25-29,1879,0.0031279956250051862
SIM,1928,17,40-44,1945,1
STAT,1879,36,50-100,1915,1.2199253518108082
SIM,1841,42,40-44,1883,5
SIM,1873,32,35-39,1905,8
STAT,1871,15,50-100,1886,0.04680447044807288
STAT,1917,49,45-49,1966,0.21320209180805666
SIM,1842,48,na,1890,1488
STAT,1944,22,25-29,1966,94.21602953233352
SIM,1869,72,na,1941,1091
SIM,1825,41,45-49,1866,4
STAT,1894,27,na,1921,2897.3572611133964
STAT,1877,16,20-24,1893,17.415470129189817
SIM,1825,68,na,1893,822
SIM,1909,17,30-34,1926,2
STAT,1815,53,45-49,1868,0.03074044665555322
STAT,1875,43,15-19,1918,0.01331267959383361
SIM,1873,20,40-44,1893,1
SIM,1935,27,25-29,1962,78
STAT,1938,5,na,1943,3746.961782142606
STAT,1809,110,na,1919,1.1089229806704093E-4
STAT,1869,20,na,1889,2186.7027750252423
STAT,1896,44,30-34,1940,0.09826482779597072
STAT,1884,32,45-49,1916,1.6275453773422033
SIM,1872,40,35-39,1912,1
STAT,1913,25,na,1938,3550.31005224059
SIM,1863,30,25-29,1893,10
STAT,1850,82,na,1932,328.9048659011458
STAT,1866,16,45-49,1882,0.05876670177214599
STAT,1922,34,40-44,1956,4.156628002996245
SIM,1870,32,25-29,1902,13
STAT,1811,104,na,1915,0.028927320227761365
SIM,1855,66,na,1921,1267
STAT,1850,29,30-34,1879,20.59084402674404
STAT,1946,12,na,1958,4115.962322029997
STAT,1955,3,na,1958,4932.707207459157
STAT,1817,49,40-44,1866,0.37403101186550347
STAT,1847,44,50-100,1891,0.7685197587430914
SIM,1827,49,na,1876,1353
STAT,1904,32,40-44,1936,3.37428388319253
STAT,1904,17,50-100,1921,0.06638675876017787
SIM,1880,79,na,1959,900
SIM,1890,44,45-49,1934,2
SIM,1923,48,50-100,1971,3
STAT,1885,68,na,1953,1439.0173941123985
STAT,1927,27,25-29,1954,75.59157902095384
STAT,1902,22,20-24,1924,91.87630323300154
STAT,1930,29,na,1959,4495.407958891305
SIM,1912,32,40-44,1944,6
STAT,1864,40,35-39,1904,1.5400384167423649
STAT,1845,41,20-24,1886,0.11591492756274528
STAT,1832,50,40-44,1882,0.006885680776972788
SIM,1940,23,45-49,1963,1
STAT,1877,31,15-19,1908,0.14012050458025435
STAT,1856,87,na,1943,129.8589442541185
STAT,1822,38,50-100,1860,2.046542024072771
STAT,1788,96,na,1884,1.433992038718239
STAT,1928,22,40-44,1950,3.965795442778777
STAT,1908,27,15-19,1935,0.635815222348379
STAT,1940,17,50-100,1957,0.35936318634094333
STAT,1850,21,35-39,1871,4.973024529324238
SIM,1880,33,na,1913,2380
STAT,1937,32,35-39,1969,8.54108064626481
STAT,1797,59,na,1856,990.9606532150999
STAT,1880,27,na,1907,2376.821692528283
SIM,1851,84,na,1935,193
STAT,1924,39,35-39,1963,2.6885984138067602
SIM,1886,32,50-100,1918,4
SIM,1928,5,na,1933,4793
STAT,1778,101,na,1879,0.12306259297154132
STAT,1853,42,25-29,1895,0.4853836336953792
STAT,1881,20,25-29,1901,52.554427094235244
STAT,1932,23,45-49,1955,1.3903529633779825
STAT,1872,18,na,1890,2386.9367269065337
STAT,1843,53,20-24,1896,4.904224618850812E-4
STAT,1881,40,35-39,1921,1.6692353581183312
STAT,1815,71,na,1886,671.3521859637609
STAT,1834,41,45-49,1875,1.1341603505360143
STAT,1917,33,20-24,1950,2.402769805597589
SIM,1815,91,na,1906,29
STAT,1920,19,na,1939,3880.2474957155355
STAT,1855,15,30-34,1870,1.3631805908020236
STAT,1869,15,15-19,1884,5.571891011677997
SIM,1858,28,50-100,1886,1
SIM,1900,27,na,1927,3161
STAT,1922,28,20-24,1950,19.44437509226029
SIM,1932,39,35-39,1971,3
STAT,1889,21,40-44,1910,2.437589335829255
STAT,1897,43,35-39,1940,0.1577184559894097
STAT,1923,49,na,1972,4036.165453559309
SIM,1930,28,20-24,1958,25
SIM,1897,21,40-44,1918,3
STAT,1814,42,30-34,1856,4.073767436416577
STAT,1895,32,20-24,1927,3.329083632448394
SIM,1809,97,na,1906,3
STAT,1880,47,45-49,1927,0.23394485587896646
SIM,1870,55,na,1925,1879
SIM,1925,20,15-19,1945,6
STAT,1840,32,30-34,1872,13.955853605730427
STAT,1831,49,15-19,1880,2.7772209932278925E-4
SIM,1799,104,na,1903,1
STAT,1814,78,na,1892,359.1208457680376
SIM,1863,15,30-34,1878,1
SIM,1919,22,40-44,1941,7
STAT,1926,41,50-100,1967,0.13701204643706785
STAT,1921,12,na,1933,4266.666886043793
SIM,1883,45,50-100,1928,2
SIM,1888,43,35-39,1931,5
STAT,1855,38,na,1893,1665.9160972708357
STAT,1927,43,30-34,1970,0.1512276005942822
STAT,1907,39,35-39,1946,2.097221668576925
SIM,1915,39,35-39,1954,6
STAT,1879,19,35-39,1898,0.5396938908271358
SIM,1847,27,40-44,1874,2
STAT,1767,114,na,1881,2.5967042444967147E-4
SIM,1873,85,na,1958,266
STAT,1923,30,40-44,1953,4.2721488185406615
STAT,1908,30,15-19,1938,0.11551364349439015
SIM,1877,15,15-19,1892,4
STAT,1817,107,na,1924,0.00218274118036407
SIM,1825,36,na,1861,1603
SIM,1842,22,35-39,1864,4
SIM,1804,66,na,1870,785
STAT,1934,33,20-24,1967,3.144141164951618
SIM,1851,31,45-49,1882,3
STAT,1871,50,50-100,1921,0.014371063471831222
STAT,1877,39,na,1916,2285.467588280432
SIM,1847,30,40-44,1877,5
STAT,1953,17,25-29,1970,49.52133608230902
SIM,1832,39,30-34,1871,5
STAT,1860,32,15-19,1892,0.10915685987567708
STAT,1841,31,35-39,1872,8.559328285241339
STAT,1917,20,15-19,1937,5.3766096243467105
STAT,1833,44,50-100,1877,0.76555524710328
STAT,1843,31,45-49,1874,1.4307927108621972
SIM,1829,40,na,1869,1494
STAT,1845,93,na,1938,20.680731437125306
STAT,1886,42,20-24,1928,0.15828605831556675
SIM,1920,47,na,1967,3904
STAT,1929,32,na,1961,4538.1923900687125
STAT,1934,17,15-19,1951,57.990352059082426
STAT,1820,46,35-39,1866,0.23831310843747963
SIM,1888,31,40-44,1919,5
STAT,1889,18,40-44,1907,0.21275270495231052
SIM,1822,42,30-34,1864,1
STAT,1934,20,15-19,1954,6.780168050439878
SIM,1838,86,na,1924,121
SIM,1843,87,na,1930,93
SIM,1942,17,15-19,1959,36
STAT,1860,31,45-49,1891,1.3421190070050624
STAT,1793,100,na,1893,0.17608586662960593
STAT,1771,106,na,1877,0.009061113854839991
SIM,1925,17,15-19,1942,53
SIM,1781,86,na,1867,58
STAT,1917,17,15-19,1934,9.226094923204379
STAT,1897,33,50-100,1930,1.152683549263575
STAT,1933,29,35-39,1962,18.81374643036286
SIM,1941,29,35-39,1970,15
SIM,1876,20,na,1896,2333
SIM,1931,30,40-44,1961,6
STAT,1843,39,40-44,1882,3.07654781941686
SIM,1851,39,40-44,1890,4
STAT,1881,33,30-34,1914,15.866610739423782
SIM,1916,34,na,1950,3562
STAT,1915,23,50-100,1938,0.6405731354269043
STAT,1908,43,20-24,1951,0.015343334662812153
SIM,1815,39,30-34,1854,5
SIM,1818,80,na,1898,277
SIM,1878,41,25-29,1919,4
STAT,1819,51,20-24,1870,0.0013690968038862373
STAT,1890,30,35-39,1920,11.790432512687556
SIM,1832,95,na,1927,6
SIM,1846,15,30-34,1861,1
STAT,1856,53,na,1909,1561.570278926075
STAT,1843,35,na,1878,1724.3056918346617
SIM,1925,33,20-24,1958,3
STAT,1860,108,na,1968,0.015836425897224473
STAT,1860,39,na,1899,1787.7039232486081
STAT,1824,39,30-34,1863,7.552445546622022
SIM,1883,23,35-39,1906,11
SIM,1810,60,na,1870,995
SIM,1900,25,30-34,1925,41
SIM,1909,34,20-24,1943,3
STAT,1886,26,15-19,1912,0.454308212662874
SIM,1951,19,na,1970,4015
STAT,1796,93,na,1889,7.031239841692933
STAT,1860,39,40-44,1899,3.321627668856088
SIM,1830,37,na,1867,1649
SIM,1889,60,na,1949,2253
STAT,1817,41,50-100,1858,2.793977750646838
STAT,1879,48,na,1927,2196.8524550576894
STAT,1839,107,na,1946,0.0031398737188775643
STAT,1850,49,25-29,1899,0.03975581467486219
SIM,1888,28,40-44,1916,3
STAT,1814,49,15-19,1863,0.0011832991377638694
SIM,1855,58,na,1913,1557
SIM,1832,31,35-39,1863,10
SIM,1889,30,50-100,1919,1
STAT,1819,35,15-19,1854,0.18195537297392295
STAT,1896,16,30-34,1912,1.9935318530181998
STAT,1860,48,30-34,1908,0.07326583449327541
STAT,1891,22,35-39,1913,6.820399612035396
SIM,1936,22,40-44,1958,3
STAT,1899,43,45-49,1942,0.13355517339573986
STAT,1849,15,50-100,1864,0.04575831785783555
STAT,1885,50,20-24,1935,7.048424332229735E-4
SIM,1926,32,25-29,1958,10
STAT,1829,25,30-34,1854,71.63961157633219
STAT,1869,42,20-24,1911,0.1451650689477053
SIM,1942,20,15-19,1962,5
STAT,1824,31,35-39,1855,28.86682120317141
STAT,1856,85,na,1941,202.0584023815981
STAT,1860,100,na,1960,1.8003052954293408
STAT,1847,32,50-100,1879,0.7932946154383648
STAT,1918,32,25-29,1950,9.278480586850339
STAT,1914,40,40-44,1954,0.23578006444553956
STAT,1846,53,30-34,1899,0.0043441406014596735
SIM,1884,71,na,1955,1260
STAT,1858,19,20-24,1877,15.158819135308422
STAT,1882,36,15-19,1918,0.051838364399124356
STAT,1884,49,na,1933,2055.980300505493
STAT,1871,84,na,1955,312.06212579121143
STAT,1942,30,na,1972,3810.2929933770583
STAT,1950,17,na,1967,4111.559369521051
STAT,1926,39,45-49,1965,0.785374444440863
SIM,1837,25,30-34,1862,23
STAT,1857,47,50-100,1904,0.18213388466178787
STAT,1834,49,40-44,1883,0.10982636153068528
STAT,1882,46,50-100,1928,0.22627711683571752
SIM,1892,58,na,1950,2610
STAT,1921,32,40-44,1953,4.114064712094967
SIM,1900,59,na,1959,2666
SIM,1933,14,na,1947,5055
STAT,1815,45,15-19,1860,9.280443058977421E-4
STAT,1831,29,50-100,1860,0.5238925562646528
STAT,1902,33,na,1935,3168.078960072058
STAT,1868,56,na,1924,1838.408036692071
STAT,1877,43,25-29,1920,0.624726208423204
SIM,1858,17,15-19,1875,3
STAT,1936,33,30-34,1969,14.447459612743582
SIM,1935,24,20-24,1959,135
STAT,1768,102,na,1870,0.056042803824758
SIM,1919,27,40-44,1946,5
STAT,1850,46,20-24,1896,0.008483097835274985
SIM,1865,47,50-100,1912,2
STAT,1927,24,20-24,1951,128.6084371430036
STAT,1850,15,na,1865,2000.8058698174118
SIM,1890,46,50-100,1936,1
STAT,1889,26,na,1915,2792.8458678597913
STAT,1885,36,na,1921,2229.168470214494
STAT,1868,50,20-24,1918,6.746758424567444E-4
STAT,1922,19,50-100,1941,0.40741710294113065
STAT,1772,83,na,1855,109.2555
SIM,1926,17,30-34,1943,16
SIM,1905,48,na,1953,2993
STAT,1895,16,15-19,1911,7.3269360067643765
SIM,1818,66,na,1884,809
STAT,1883,40,45-49,1923,1.4001954801304781
STAT,1865,23,45-49,1888,0.6000118078218498
SIM,1910,25,50-100,1935,4
SIM,1830,69,na,1899,850
STAT,1875,46,25-29,1921,0.05608924157200809
SIM,1896,48,na,1944,2769
STAT,1933,24,15-19,1957,6.665880878792399
SIM,1868,34,50-100,1902,4
SIM,1909,32,25-29,1941,7
STAT,1884,33,15-19,1917,0.13235114338149462
STAT,1951,17,15-19,1968,51.05409899579707
SIM,1941,24,15-19,1965,7
STAT,1834,22,35-39,1856,4.843413251978627
STAT,1817,64,na,1881,913.7144215023773
SIM,1860,67,na,1927,1287
STAT,1832,43,na,1875,1520.535346742894
STAT,1911,32,15-19,1943,0.11821691374814003
SIM,1899,70,na,1969,2154
STAT,1918,17,30-34,1935,2.514525235392789
STAT,1817,42,15-19,1859,0.0350942472830226
STAT,1852,43,20-24,1895,0.11430553988496638
STAT,1876,51,na,1927,2111.556888607161
SIM,1891,40,45-49,1931,2
STAT,1849,83,na,1932,297.6878450468497
STAT,1954,15,45-49,1969,0.5836589204796786
SIM,1948,13,na,1961,4236
STAT,1840,39,15-19,1879,0.042690884686109654
SIM,1846,18,35-39,1864,1
SIM,1871,47,45-49,1918,3
SIM,1868,16,20-24,1884,15
STAT,1854,19,30-34,1873,1.3481554819214079
SIM,1922,1,na,1923,4460
STAT,1863,33,na,1896,1969.9447294291965
STAT,1863,55,na,1918,1714.170301746736
SIM,1879,15,25-29,1894,8
STAT,1860,50,na,1910,1674.1411536025728
SIM,1834,39,40-44,1873,2
STAT,1921,1,na,1922,4496.904764178726
STAT,1856,23,25-29,1879,48.65307412501525
SIM,1937,23,50-100,1960,1
SIM,1829,48,50-100,1877,1
STAT,1850,37,na,1887,1687.0828264180147
STAT,1877,19,25-29,1896,5.52324383372882
STAT,1928,42,35-39,1970,0.2425021462016324
STAT,1886,83,na,1969,733.4185824863408
STAT,1915,46,30-34,1961,0.08507334073305252
SIM,1878,26,30-34,1904,26
STAT,1938,25,35-39,1963,14.063851799447304
STAT,1949,16,20-24,1965,149.0049891161601
STAT,1940,30,40-44,1970,3.83045590533767
SIM,1864,23,25-29,1887,59
STAT,1837,54,35-39,1891,0.0054337273846866005
SIM,1866,19,20-24,1885,13
SIM,1828,30,30-34,1858,20
STAT,1839,33,45-49,1872,1.414026636002192
STAT,1789,91,na,1880,16.66119473618153
STAT,1910,42,na,1952,3315.942385814159
SIM,1928,32,35-39,1960,14
STAT,1826,53,20-24,1879,6.442611223047448E-4
SIM,1878,22,15-19,1900,2
STAT,1891,47,20-24,1938,0.007874596007926137
SIM,1936,25,50-100,1961,4
STAT,1887,21,30-34,1908,18.87878505660564
SIM,1814,44,na,1858,1318
STAT,1937,17,40-44,1954,1.285468519586727
SIM,1908,47,na,1955,3090
SIM,1946,25,35-39,1971,17
STAT,1849,16,45-49,1865,0.06065173515420387
STAT,1909,12,na,1921,3658.8487098930377
SIM,1862,15,15-19,1877,3
STAT,1882,21,50-100,1903,0.3757743947301611
STAT,1865,14,na,1879,2293.7757056398623
STAT,1929,23,50-100,1952,0.7836129659465587
STAT,1856,46,15-19,1902,2.956679509572576E-4
STAT,1917,43,30-34,1960,0.1258414977728235
STAT,1854,15,15-19,1869,5.139694633908587
STAT,1892,78,na,1970,1350.3331585687445
SIM,1898,34,35-39,1932,14
SIM,1862,19,30-34,1881,3
STAT,1844,52,25-29,1896,0.0024469159414595167
STAT,1862,25,15-19,1887,0.3731541652897443
SIM,1895,21,30-34,1916,24
STAT,1863,47,45-49,1910,0.19473595958254566
SIM,1863,43,30-34,1906,1
SIM,1945,17,40-44,1962,1
STAT,1893,44,20-24,1937,0.013033871633626164
SIM,1879,34,25-29,1913,12
STAT,1860,32,50-100,1892,0.702311081461995
STAT,1874,43,40-44,1917,2.1553704708592916
SIM,1915,36,30-34,1951,2
SIM,1835,60,na,1895,1218
SIM,1910,32,30-34,1942,12
STAT,1828,29,30-34,1857,30.838179992157052
STAT,1878,15,25-29,1893,5.6049317888326575
SIM,1888,40,30-34,1928,1
SIM,1846,52,na,1898,1528
STAT,1817,41,45-49,1858,3.9581351580922313
STAT,1780,92,na,1872,8.977957825470398
STAT,1807,52,40-44,1859,0.038576536974079374
STAT,1834,45,25-29,1879,0.042740530785155315
STAT,1834,84,na,1918,206.2411717808606
SIM,1837,21,15-19,1858,2
STAT,1854,51,30-34,1905,0.00427933751808837
STAT,1818,60,na,1878,1088.4220547062432
STAT,1822,33,na,1855,1438.6486097691031
SIM,1883,22,na,1905,2220
STAT,1819,45,na,1864,1459.9422478839988
STAT,1849,33,35-39,1882,7.919479613369468
STAT,1860,44,50-100,1904,0.7988500756917816
SIM,1839,50,na,1889,1481
SIM,1956,3,na,1959,4792
STAT,1902,32,30-34,1934,23.277844106586603
STAT,1855,30,25-29,1885,7.566706270521539
STAT,1846,20,30-34,1866,16.53771876561342
SIM,1930,34,40-44,1964,4
STAT,1893,23,na,1916,2824.6384521174305
STAT,1858,43,15-19,1901,0.01015479520498174
SIM,1820,59,na,1879,1156
STAT,1901,39,40-44,1940,1.2368340246695941
STAT,1939,7,na,1946,3771.755220777659
STAT,1897,45,50-100,1942,0.1767724956737673
SIM,1872,39,50-100,1911,1
STAT,1869,21,50-100,1890,0.3743322199256262
SIM,1818,88,na,1906,75
STAT,1787,82,na,1869,157.98269706999486
STAT,1841,35,15-19,1876,0.046569415342535954
STAT,1881,20,na,1901,2171.236729121383
SIM,1812,61,na,1873,970
SIM,1836,29,30-34,1865,28
SIM,1882,43,40-44,1925,4
STAT,1841,43,45-49,1884,1.0585222405212342
STAT,1852,48,40-44,1900,0.12255810482811379
STAT,1884,17,50-100,1901,0.04572513531786613
STAT,1838,18,35-39,1856,0.48372941899637817
STAT,1907,36,30-34,1943,1.6040455594191307
STAT,1911,42,25-29,1953,0.06438901483635646
STAT,1869,101,na,1970,4.208227157307405
SIM,1854,20,30-34,1874,19
STAT,1862,20,15-19,1882,2.7674033905988815
STAT,1902,33,50-100,1935,1.2164123604294226
STAT,1868,26,20-24,1894,10.610338472727111
SIM,1832,38,na,1870,1548
SIM,1892,40,50-100,1932,2
STAT,1928,25,45-49,1953,2.024277767905199
SIM,1832,33,50-100,1865,5
SIM,1849,94,na,1943,10
STAT,1913,29,50-100,1942,0.930261915781738
STAT,1850,46,15-19,1896,2.827696791086552E-4
SIM,1857,33,35-39,1890,8
STAT,1890,80,na,1970,1138.944444374788
SIM,1898,21,na,1919,2966
STAT,1883,16,45-49,1899,0.06065117265653438
STAT,1819,54,25-29,1873,0.006189805885287341
SIM,1913,4,na,1917,3749
STAT,1951,13,na,1964,4418.230878327513
SIM,1907,24,45-49,1931,5
STAT,1788,98,na,1886,0.5374090977369964
STAT,1875,23,35-39,1898,5.6488277874284
STAT,1907,34,15-19,1941,0.11250364439702333
SIM,1920,16,25-29,1936,54
STAT,1842,23,50-100,1865,0.369804307921218
SIM,1876,42,na,1918,2236
STAT,1906,33,45-49,1939,1.371882403893453
SIM,1840,90,na,1930,43
STAT,1901,46,na,1947,2984.0600452987474
STAT,1799,109,na,1908,2.2713499852126815E-4
STAT,1917,24,30-34,1941,28.676871028308582
STAT,1812,54,30-34,1866,0.01829445125500064
STAT,1935,20,50-100,1955,0.8470500442821154
STAT,1854,72,na,1926,903.58239060112
SIM,1936,25,45-49,1961,1
STAT,1830,62,na,1892,1103.1194794409023
SIM,1901,16,15-19,1917,6
STAT,1909,34,na,1943,3380.445774205949
SIM,1870,20,15-19,1890,3
STAT,1798,74,na,1872,462.52044911006715
STAT,1879,16,30-34,1895,1.5800057844160746
STAT,1856,31,na,1887,1799.0154838411768
STAT,1943,13,na,1956,3934.4578805019214
SIM,1821,46,na,1867,1357
SIM,1925,24,30-34,1949,46
STAT,1912,16,25-29,1928,8.298858166374007
SIM,1888,34,45-49,1922,1
STAT,1908,46,25-29,1954,0.04566218744490457
SIM,1807,96,na,1903,3
STAT,1913,31,35-39,1944,8.624583960551039
STAT,1857,50,45-49,1907,0.010968015693616417
STAT,1835,69,na,1904,934.0561161147266
STAT,1897,24,25-29,1921,71.87034195752858
STAT,1905,21,35-39,1926,7.992372363390365
STAT,1868,40,50-100,1908,0.9618328678963064
SIM,1847,37,na,1884,1791
SIM,1912,29,50-100,1941,5
STAT,1822,43,35-39,1865,2.565065410995057
SIM,1863,24,na,1887,1949
SIM,1899,37,na,1936,3147
SIM,1909,40,na,1949,3363
STAT,1853,41,50-100,1894,0.8031363312704292
STAT,1867,54,20-24,1921,6.36591242804784E-4
SIM,1830,43,35-39,1873,6
SIM,1941,26,30-34,1967,40
SIM,1859,70,na,1929,1084
SIM,1878,7,na,1885,2710
STAT,1763,106,na,1869,0.006582459117400625
STAT,1841,54,na,1895,1443.5989246757126
STAT,1860,35,25-29,1895,2.227891999290259
STAT,1933,26,30-34,1959,49.17113417748864
STAT,1848,53,40-44,1901,0.007697053336128853
STAT,1889,72,na,1961,1652.5215481537773
SIM,1913,21,35-39,1934,9
STAT,1843,80,na,1923,417.82882232518654
STAT,1911,28,45-49,1939,1.5860695657264023
STAT,1783,75,na,1858,334.6981948932519
SIM,1848,23,40-44,1871,1
SIM,1921,31,35-39,1952,13
SIM,1838,33,25-29,1871,12
STAT,1904,29,50-100,1933,0.8606239453122324
STAT,1865,36,15-19,1901,0.048314679402301
STAT,1904,48,20-24,1952,0.009057125010451347
STAT,1872,43,30-34,1915,1.0815298920012992
STAT,1896,19,35-39,1915,0.6809449515027206
STAT,1877,52,20-24,1929,7.192632751707852E-4
STAT,1844,12,na,1856,2107.5933073931997
STAT,1901,35,25-29,1936,0.8295729993603762
SIM,1853,46,na,1899,1711
SIM,1898,7,na,1905,3273
SIM,1900,23,15-19,1923,4
STAT,1891,47,15-19,1938,2.6248630270564254E-4
SIM,1895,63,na,1958,2310
STAT,1774,101,na,1875,0.1027409322040143
SIM,1837,28,35-39,1865,10
STAT,1892,42,45-49,1934,1.7687196915061636
SIM,1891,73,na,1964,1596
SIM,1834,64,na,1898,1045
SIM,1930,30,25-29,1960,14
SIM,1902,31,25-29,1933,22
STAT,1916,14,na,1930,3945.5390957160184
STAT,1914,43,45-49,1957,0.15554985884437286
STAT,1899,40,40-44,1939,0.20421841136931437
SIM,1887,69,na,1956,1518
SIM,1918,24,20-24,1942,101
STAT,1866,40,45-49,1906,1.3172128747609706
STAT,1869,71,na,1940,1221.5954395494357
SIM,1884,19,15-19,1903,6
SIM,1885,56,na,1941,1952
SIM,1845,30,30-34,1875,18
STAT,1829,28,35-39,1857,12.000820719703375
STAT,1867,71,na,1938,1184.0723326220302
SIM,1934,36,40-44,1970,1
SIM,1880,43,30-34,1923,6
SIM,1902,50,na,1952,2869
STAT,1865,81,na,1946,463.03835705540394
SIM,1927,32,40-44,1959,5
SIM,1849,19,20-24,1868,13
STAT,1872,51,25-29,1923,0.003372389623766242
STAT,1878,31,30-34,1909,17.259698420592287
STAT,1849,28,50-100,1877,0.5645386874647675
SIM,1920,35,35-39,1955,10
STAT,1836,18,25-29,1854,8.658218744741207
STAT,1867,17,15-19,1884,5.3818061251494
SIM,1949,8,na,1957,4245
STAT,1805,52,30-34,1857,0.021849776203147438
SIM,1879,41,40-44,1920,9
SIM,1847,23,25-29,1870,49
STAT,1820,84,na,1904,175.24952553355837
STAT,1799,82,na,1881,164.2159483360635
STAT,1909,63,na,1972,2865.274313275121
STAT,1921,47,45-49,1968,0.23145821654943727
STAT,1831,110,na,1941,1.613498306564361E-4
STAT,1878,34,na,1912,2329.25799946538
SIM,1887,36,50-100,1923,1
STAT,1853,46,40-44,1899,0.12993135194773486
SIM,1819,40,30-34,1859,3
STAT,1846,24,na,1870,1928.7313404239926
STAT,1912,35,35-39,1947,2.2514323961666705
SIM,1875,17,15-19,1892,6
STAT,1915,49,35-39,1964,0.12201541751472024
STAT,1833,46,20-24,1879,0.00873567116238381
SIM,1879,38,40-44,1917,10
STAT,1852,41,na,1893,1683.1988375431702
SIM,1886,31,30-34,1917,21
SIM,1849,27,na,1876,1936
STAT,1808,50,na,1858,1257.5930340235739
SIM,1843,18,15-19,1861,8
SIM,1830,38,50-100,1868,1
STAT,1926,43,na,1969,4318.333686874632
STAT,1831,50,25-29,1881,0.0023093942343529934
STAT,1873,30,35-39,1903,9.78088169002853
STAT,1884,49,30-34,1933,0.08845910143431229
STAT,1867,93,na,1960,48.19927201708974
STAT,1871,19,30-34,1890,1.4871465131482495
STAT,1879,81,na,1960,699.6744728214701
STAT,1837,30,30-34,1867,14.505430168382732
SIM,1887,34,na,1921,2441
STAT,1915,48,50-100,1963,0.21471336752438425
STAT,1916,36,na,1952,3657.148058179412
STAT,1831,52,50-100,1883,0.009464517323294659
STAT,1859,42,na,1901,1735.659753706928
STAT,1821,40,20-24,1861,0.2898441813167815
STAT,1851,46,50-100,1897,0.17717223132011678
STAT,1862,48,40-44,1910,0.1365439022182808
SIM,1883,44,na,1927,2082
STAT,1885,48,35-39,1933,0.1301736502694614
SIM,1874,19,na,1893,2350
SIM,1929,41,40-44,1970,3
STAT,1907,19,20-24,1926,24.470436174956216
STAT,1796,101,na,1897,0.12289471325673362
SIM,1761,95,na,1856,2
SIM,1929,25,35-39,1954,21
SIM,1829,75,na,1904,592
STAT,1806,51,35-39,1857,0.03092302157256323
SIM,1844,18,25-29,1862,3
SIM,1870,26,na,1896,2191
STAT,1918,48,na,1966,3683.0412987198993
STAT,1922,30,25-29,1952,9.944779627604637
SIM,1902,53,na,1955,2777
STAT,1825,51,45-49,1876,0.014553190292558613
SIM,1892,36,25-29,1928,2
STAT,1951,10,na,1961,4420.17547309999
STAT,1855,18,35-39,1873,0.4610480327698682
STAT,1837,51,30-34,1888,0.003954830426341808
STAT,1856,33,45-49,1889,1.2876293290749479
STAT,1908,0,na,1908,4114.959208912809
STAT,1862,106,na,1968,0.09538492074190112
STAT,1897,47,15-19,1944,2.837319419955009E-4
STAT,1920,21,25-29,1941,97.30173926287229
STAT,1932,20,40-44,1952,4.192542150146518
STAT,1871,28,50-100,1899,0.5979654365564985
STAT,1920,52,na,1972,3771.8616807847247
SIM,1920,42,40-44,1962,2
SIM,1779,90,na,1869,15
SIM,1862,93,na,1955,13
STAT,1859,1,na,1860,2770.6728887334084
STAT,1926,36,40-44,1962,1.7298593165288647
SIM,1880,30,25-29,1910,12
SIM,1890,20,40-44,1910,3
STAT,1949,19,25-29,1968,47.58256011173159
STAT,1827,42,na,1869,1548.5391414483684
STAT,1860,52,45-49,1912,0.011064687515642662
STAT,1882,20,40-44,1902,1.925849757157248
SIM,1890,17,40-44,1907,1
STAT,1892,36,50-100,1928,1.4597190636941983
STAT,1892,30,45-49,1922,2.0799638818504023
SIM,1915,26,na,1941,3451
STAT,1891,43,40-44,1934,2.609920729022984
SIM,1893,51,na,1944,2710
STAT,1884,36,25-29,1920,2.7001480808256866
STAT,1912,42,40-44,1954,0.22790342807899652
STAT,1872,30,25-29,1902,9.783674378714947
STAT,1830,94,na,1924,12.062513562858404
SIM,1803,81,na,1884,176
STAT,1945,22,40-44,1967,3.481285395795669
SIM,1873,31,na,1904,2298
SIM,1885,16,20-24,1901,20
SIM,1865,34,na,1899,2091
SIM,1836,20,na,1856,1820
STAT,1841,86,na,1927,152.96408677175452
STAT,1878,52,30-34,1930,0.005829209640626838
STAT,1831,79,na,1910,408.1974915810844
SIM,1849,49,na,1898,1678
SIM,1881,42,35-39,1923,4
STAT,1865,99,na,1964,5.879516316183911
STAT,1868,29,25-29,1897,37.85554380634494
SIM,1864,33,45-49,1897,1
SIM,1820,36,35-39,1856,9
SIM,1838,57,na,1895,1338
STAT,1838,50,35-39,1888,0.00598135651848435
SIM,1864,30,40-44,1894,6
STAT,1863,23,35-39,1886,4.898697290110142
STAT,1894,47,40-44,1941,0.1166954520033051
STAT,1874,47,20-24,1921,0.011528682206870328
SIM,1904,31,na,1935,3344
SIM,1880,37,45-49,1917,3
STAT,1898,54,na,1952,2677.0290494652936
STAT,1815,49,30-34,1864,0.21143370001821238
STAT,1897,28,40-44,1925,3.7712210627726406
SIM,1841,21,na,1862,1798
SIM,1940,20,40-44,1960,3
STAT,1891,11,na,1902,3022.892318057794
SIM,1886,19,na,1905,2465
STAT,1873,42,35-39,1915,1.7328308587557648
SIM,1798,94,na,1892,7
STAT,1841,52,40-44,1893,0.007219249638001526
STAT,1911,25,40-44,1936,4.323416932357962
STAT,1910,20,na,1930,3405.832915724842
SIM,1940,25,na,1965,3506
STAT,1790,69,na,1859,633.224555558969
SIM,1881,30,35-39,1911,11
STAT,1892,43,15-19,1935,0.01622244518376153
STAT,1836,51,20-24,1887,4.931730420325609E-4
STAT,1875,45,50-100,1920,0.2408587584468926
STAT,1888,41,35-39,1929,2.030827436370784
STAT,1852,49,na,1901,1597.0474459312975
STAT,1941,30,35-39,1971,9.0741723316523
STAT,1915,40,35-39,1955,0.19205380351440338
STAT,1945,25,na,1970,3885.9672597228455
STAT,1868,41,15-19,1909,0.012503702466554936
SIM,1913,48,na,1961,3250
SIM,1938,19,15-19,1957,34
SIM,1859,29,25-29,1888,38
STAT,1858,15,50-100,1873,0.042892260410891385
STAT,1841,40,40-44,1881,1.653169882625841
SIM,1784,72,na,1856,446
SIM,1903,42,40-44,1945,1
STAT,1872,37,45-49,1909,1.8889826645019896
STAT,1766,95,na,1861,2.0272964819661015
SIM,1865,5,na,1870,2524
STAT,1857,47,20-24,1904,0.008899050091511972
STAT,1851,41,45-49,1892,1.0814689241805016
SIM,1876,71,na,1947,1281
STAT,1935,18,na,1953,4741.051692416874
STAT,1930,40,na,1970,4629.04902981433
SIM,1819,65,na,1884,887
STAT,1845,61,na,1906,1322.3004224810718
SIM,1890,32,35-39,1922,11
STAT,1822,40,30-34,1862,1.7663991157515777
SIM,1869,31,30-34,1900,18
STAT,1822,46,45-49,1868,0.3219511149382562
SIM,1860,19,20-24,1879,10
SIM,1899,18,15-19,1917,7
STAT,1881,53,50-100,1934,0.013561568650588201
STAT,1870,37,35-39,1907,6.5549097932295775
SIM,1859,17,30-34,1876,1
STAT,1852,19,20-24,1871,15.362563288588593
SIM,1838,40,40-44,1878,6
STAT,1894,70,na,1964,1930.2835356765693
STAT,1847,104,na,1951,0.049185093255144544
STAT,1909,42,25-29,1951,0.0631002902653781
STAT,1858,46,25-29,1904,0.04278438141261324
STAT,1850,42,40-44,1892,1.583615044680978
STAT,1830,103,na,1933,0.0866178900610486
SIM,1840,41,35-39,1881,5
STAT,1930,38,20-24,1968,0.32449228660351176
SIM,1871,23,35-39,1894,5
STAT,1897,31,40-44,1928,5.501321595280881
STAT,1852,22,20-24,1874,59.35086836451019
STAT,1853,17,50-100,1870,0.04460105438524405
STAT,1917,19,50-100,1936,0.3775936971120618
STAT,1919,32,40-44,1951,3.9885261543224586
STAT,1925,38,50-100,1963,0.47555518420723997
STAT,1841,16,40-44,1857,0.16359371090952465
SIM,1798,72,na,1870,495
SIM,1847,45,50-100,1892,1
STAT,1867,4,na,1871,2656.2150641695957
STAT,1906,23,na,1929,3244.0242764119716
STAT,1887,41,25-29,1928,0.681627565801188
SIM,1904,63,na,1967,2731
STAT,1831,42,30-34,1873,0.8488801801466553
STAT,1902,47,35-39,1949,0.10479664290417173
SIM,1874,93,na,1967,93
STAT,1821,47,40-44,1868,0.27005841879256404
STAT,1925,43,20-24,1968,0.020166291340956558
STAT,1899,29,50-100,1928,0.8221015354151114
STAT,1921,48,15-19,1969,3.912111329399261E-4
STAT,1899,17,na,1916,3269.1513591011526
SIM,1838,37,40-44,1875,6
SIM,1868,19,30-34,1887,2
STAT,1906,30,40-44,1936,3.453737162621597
STAT,1877,40,20-24,1917,0.15719671936327786
STAT,1832,41,35-39,1873,1.3566329212747352
STAT,1934,33,na,1967,4875.161303507522
STAT,1852,46,50-100,1898,0.1785621606682494
STAT,1932,40,35-39,1972,0.25853624994764207
STAT,1843,44,15-19,1887,0.00936106635237935
SIM,1914,30,40-44,1944,2
SIM,1927,26,na,1953,4244
SIM,1952,18,na,1970,4107
STAT,1912,32,30-34,1944,14.646067703364608
STAT,1830,30,20-24,1860,2.395957305253043
STAT,1839,46,15-19,1885,2.7484345000168005E-4
STAT,1880,59,na,1939,1935.5636981438824
STAT,1931,0,na,1931,5570.560264923526
SIM,1810,51,na,1861,1198
STAT,1873,54,45-49,1927,0.013522187839955683
STAT,1851,42,15-19,1893,0.009921773312457163
STAT,1815,41,35-39,1856,4.7974902448336865
STAT,1826,29,20-24,1855,23.36164660862468
STAT,1921,15,na,1936,3981.9419615892634
STAT,1812,45,40-44,1857,0.5925450326210339
STAT,1935,32,25-29,1967,12.079844792317292
STAT,1802,53,25-29,1855,0.01016358808499907
STAT,1901,32,20-24,1933,3.574367671088697
STAT,1868,53,50-100,1921,0.013394176963087208
STAT,1879,51,35-39,1930,0.008554000618132234
STAT,1870,60,na,1930,1767.5002855900252
SIM,1896,47,50-100,1943,1
SIM,1861,12,na,1873,2360
SIM,1816,54,na,1870,1225
STAT,1899,47,25-29,1946,0.04186062169570011
SIM,1830,41,50-100,1871,3
SIM,1860,22,20-24,1882,64
STAT,1882,17,40-44,1899,0.16803584970965954
SIM,1827,91,na,1918,26
STAT,1813,53,35-39,1866,0.022061544054927034
STAT,1865,67,na,1932,1357.3684171890422
STAT,1833,57,na,1890,1232.961090141291
SIM,1869,15,na,1884,2392
SIM,1799,57,na,1856,1032
STAT,1917,5,na,1922,4074.1516305304485
SIM,1848,64,na,1912,1261
SIM,1830,40,30-34,1870,3
STAT,1833,49,25-29,1882,0.036718664491782516
STAT,1914,46,15-19,1960,3.4599626762695033E-4
STAT,1882,32,35-39,1914,9.303891131283258
STAT,1878,88,na,1966,315.8061599715738
STAT,1894,40,20-24,1934,0.19475236727062226
STAT,1933,25,50-100,1958,1.2496124992389777
STAT,1837,33,35-39,1870,8.155456213997972
SIM,1944,17,25-29,1961,44
STAT,1890,4,na,1894,3038.3544189261834
STAT,1913,40,25-29,1953,0.06653407568175593
SIM,1948,10,na,1958,4239
STAT,1838,34,na,1872,1770.8082523406656
STAT,1822,41,50-100,1863,1.5801753455245686
STAT,1925,46,25-29,1971,0.060872613298000026
SIM,1918,27,25-29,1945,65
STAT,1932,8,na,1940,4989.122306146915
SIM,1760,99,na,1859,1
SIM,1931,33,45-49,1964,3
STAT,1875,42,45-49,1917,1.4514703719199777
SIM,1845,33,35-39,1878,10
STAT,1888,22,50-100,1910,0.4552768744966338
STAT,1882,37,na,1919,2164.4724212817146
STAT,1902,38,45-49,1940,0.5708129336974218
SIM,1883,42,45-49,1925,2
STAT,1834,48,50-100,1882,0.15958617199423758
STAT,1791,87,na,1878,54.783287302302426
STAT,1868,6,na,1874,2515.7650661855923
STAT,1908,34,30-34,1942,13.929190246114397
STAT,1808,51,45-49,1859,0.05349299866542943
SIM,1823,41,35-39,1864,1
SIM,1878,52,na,1930,2186
STAT,1841,39,30-34,1880,4.240042118937275
STAT,1828,27,na,1855,1579.7300379605035
STAT,1922,40,35-39,1962,0.21895157591891526
SIM,1885,85,na,1970,500
STAT,1883,9,na,1892,2403.1838565647035
SIM,1774,84,na,1858,90
STAT,1917,46,40-44,1963,0.15596051980921818
STAT,1897,34,45-49,1931,2.184252048655529
SIM,1827,94,na,1921,5
STAT,1884,45,15-19,1929,3.7704989193066557E-4
STAT,1923,33,45-49,1956,1.7031042371692415
STAT,1836,54,25-29,1890,0.0022306794404534213
SIM,1949,18,20-24,1967,149
SIM,1871,41,30-34,1912,1
STAT,1915,24,20-24,1939,107.9062062752643
STAT,1856,27,40-44,1883,2.2879558572510197
STAT,1936,17,25-29,1953,39.193247355194586
SIM,1913,45,na,1958,3282
SIM,1904,34,na,1938,3300
STAT,1846,40,25-29,1886,0.4945678791055104
STAT,1878,34,35-39,1912,9.884943331851748
SIM,1890,41,40-44,1931,5
STAT,1846,44,40-44,1890,1.6457775839699151
STAT,1913,38,20-24,1951,0.2445480928167436
STAT,1876,19,15-19,1895,5.761087922200809
SIM,1916,34,30-34,1950,21
SIM,1797,79,na,1876,233
SIM,1911,21,25-29,1932,70
SIM,1862,90,na,1952,52
SIM,1912,5,na,1917,3813
STAT,1832,72,na,1904,760.7696757330909
STAT,1912,45,45-49,1957,0.19825627699991843
SIM,1956,0,na,1956,4797
STAT,1864,23,50-100,1887,0.3463644559312628
STAT,1858,50,50-100,1908,0.01134707897680313
STAT,1894,31,15-19,1925,0.1735964979465941
SIM,1850,57,na,1907,1488
SIM,1886,34,35-39,1920,12
STAT,1857,19,na,1876,1986.5171966465016
STAT,1802,52,20-24,1854,0.0021604512882744823
STAT,1882,41,40-44,1923,2.0757944419630117
STAT,1820,39,na,1859,1454.4241462762627
STAT,1915,35,50-100,1950,0.4044950360887478
SIM,1903,38,na,1941,3183
SIM,1819,43,35-39,1862,1
STAT,1827,40,15-19,1867,0.013711907956129477
STAT,1917,2,na,1919,4144.1437713413525
STAT,1921,44,40-44,1965,0.2652537046060268
SIM,1941,25,50-100,1966,5
SIM,1852,83,na,1935,242
SIM,1844,15,20-24,1859,13
STAT,1863,41,30-34,1904,0.957407373946378
STAT,1893,23,20-24,1916,82.30396601760889
SIM,1864,27,40-44,1891,6
SIM,1903,18,40-44,1921,1
STAT,1842,35,50-100,1877,1.0648793794995637
SIM,1887,37,na,1924,2459
SIM,1814,76,na,1890,351
STAT,1850,25,15-19,1875,0.3818341781486272
STAT,1871,31,20-24,1902,2.5460268614899766
STAT,1847,52,35-39,1899,0.006314586890652366
STAT,1826,32,20-24,1858,3.7048839702836247
STAT,1903,21,25-29,1924,77.17912690147226
SIM,1854,44,40-44,1898,8
STAT,1873,34,50-100,1907,0.8703521669309787
STAT,1890,66,na,1956,1918.0429126604954
SIM,1834,32,20-24,1866,4
SIM,1852,16,na,1868,2141
STAT,1856,30,40-44,1886,3.3035316758330975
STAT,1888,47,50-100,1935,0.2729213483653802
STAT,1817,45,25-29,1862,0.1339932517073685
SIM,1825,50,na,1875,1377
STAT,1824,52,40-44,1876,0.01235465761926467
SIM,1842,41,45-49,1883,4
STAT,1819,108,na,1927,9.669576023216431E-4
SIM,1834,29,20-24,1863,9
SIM,1850,35,50-100,1885,4
SIM,1897,44,na,1941,2966
SIM,1915,6,na,1921,3778
STAT,1766,98,na,1864,0.4651089298719099
STAT,1878,19,40-44,1897,0.17910614039531056
STAT,1893,77,na,1970,1456.704993939649
STAT,1791,65,na,1856,749.0086249200001
STAT,1863,20,30-34,1883,15.279602329117623
SIM,1932,34,50-100,1966,1
SIM,1864,42,35-39,1906,1
SIM,1904,31,35-39,1935,9
SIM,1859,26,20-24,1885,10
STAT,1818,68,na,1886,807.7007183584653
SIM,1932,36,30-34,1968,1
STAT,1874,41,na,1915,2240.956829930915
STAT,1854,54,35-39,1908,0.005990266521409275
STAT,1833,101,na,1934,0.350092472812073
STAT,1867,33,20-24,1900,2.387705275348034
SIM,1875,33,20-24,1908,2
SIM,1915,19,20-24,1934,27
STAT,1947,15,35-39,1962,4.467891158362062
SIM,1885,19,25-29,1904,9
STAT,1902,42,15-19,1944,0.0012769720480960416
SIM,1829,72,na,1901,742
STAT,1815,50,40-44,1865,0.023675542164726292
STAT,1945,25,45-49,1970,1.7920909666222598
STAT,1832,94,na,1926,12.039641468680886
STAT,1835,83,na,1918,252.67268709573221
SIM,1823,32,45-49,1855,1
SIM,1903,16,na,1919,3416
STAT,1838,21,50-100,1859,0.357766294258267
SIM,1861,75,na,1936,863
STAT,1845,29,30-34,1874,21.379093932574502
STAT,1851,46,30-34,1897,0.06983009786681901
STAT,1885,33,na,1918,2237.57188882538
STAT,1793,103,na,1896,0.02380359334808734
STAT,1910,35,25-29,1945,0.8980708256145503
SIM,1869,15,25-29,1884,8
SIM,1863,6,na,1869,2340
SIM,1872,38,na,1910,2209
SIM,1878,29,35-39,1907,9
SIM,1898,29,na,1927,2979
SIM,1923,24,20-24,1947,118
SIM,1852,61,na,1913,1395
STAT,1821,43,25-29,1864,1.0729269302414035
STAT,1899,24,35-39,1923,7.506175096939141
STAT,1832,53,45-49,1885,0.008944385401373364
STAT,1895,39,50-100,1934,1.4968679134363208
STAT,1924,36,30-34,1960,2.032080162978808
STAT,1902,44,30-34,1946,0.1050022331465597
SIM,1853,29,30-34,1882,27
SIM,1863,53,na,1916,1753
STAT,1882,23,45-49,1905,0.6386604644608695
STAT,1842,31,na,1873,1915.7677732453612
SIM,1955,15,35-39,1970,7
SIM,1901,32,20-24,1933,4
STAT,1916,43,20-24,1959,0.017069986461399168
STAT,1889,58,na,1947,2306.3826805183257
STAT,1897,40,30-34,1937,0.10188027693230706
SIM,1903,16,25-29,1919,11
STAT,1839,23,25-29,1862,48.62038612642405
STAT,1935,36,40-44,1971,1.9792855498402475
SIM,1928,22,na,1950,4297
SIM,1927,29,na,1956,4217
STAT,1807,76,na,1883,406.99175121842944
SIM,1947,9,na,1956,4119
STAT,1816,87,na,1903,82.1005425523743
STAT,1913,44,40-44,1957,0.22966930149957668
SIM,1800,92,na,1892,13
SIM,1918,29,40-44,1947,6
STAT,1849,52,45-49,1901,0.01082446235521105
SIM,1921,44,40-44,1965,2
SIM,1877,59,na,1936,1852
SIM,1918,15,na,1933,3998
STAT,1803,69,na,1872,697.505508674396
STAT,1858,23,35-39,1881,4.4804258524427185
STAT,1924,34,15-19,1958,0.1414457623901217
STAT,1889,40,na,1929,2722.693125689239
SIM,1930,21,35-39,1951,12
STAT,1880,26,50-100,1906,0.6392782822854753
STAT,1912,33,35-39,1945,8.459230667941574
SIM,1851,35,25-29,1886,1
SIM,1887,66,na,1953,1678
STAT,1891,26,15-19,1917,0.5320987934995097
SIM,1920,33,35-39,1953,12
STAT,1771,103,na,1874,0.036818396774388154
SIM,1930,15,na,1945,4578
SIM,1874,40,45-49,1914,2
SIM,1838,43,45-49,1881,3
SIM,1861,97,na,1958,8
STAT,1880,44,35-39,1924,1.7791093478984135
STAT,1865,53,40-44,1918,0.008869733229696216
STAT,1857,30,na,1887,1826.4637675241204
STAT,1876,22,na,1898,2308.2987892407104
SIM,1879,44,45-49,1923,3
STAT,1887,45,40-44,1932,0.1827078905916186
STAT,1934,24,30-34,1958,36.46376485673474
STAT,1890,37,na,1927,2721.0730952668946
STAT,1844,97,na,1941,3.731149513999599
STAT,1843,35,25-29,1878,2.317958343641228
STAT,1909,46,40-44,1955,0.1372084535282727
SIM,1888,24,25-29,1912,71
STAT,1861,23,na,1884,1894.8001548566588
SIM,1871,20,30-34,1891,18
SIM,1900,21,15-19,1921,3
STAT,1863,89,na,1952,87.09118619246271
SIM,1905,43,45-49,1948,1
SIM,1929,19,15-19,1948,51
STAT,1804,51,50-100,1855,0.05445496487115322
STAT,1805,95,na,1900,4.6411598968716214
STAT,1939,10,na,1949,3749.9961418178837
SIM,1827,39,30-34,1866,3
SIM,1886,81,na,1967,801
STAT,1824,35,15-19,1859,0.09677006131898563
SIM,1942,24,30-34,1966,33
SIM,1920,32,30-34,1952,21
SIM,1785,76,na,1861,330
STAT,1856,51,40-44,1907,0.007796823917737504
SIM,1801,77,na,1878,335
STAT,1841,19,45-49,1860,0.05739998705522922
STAT,1844,47,35-39,1891,0.09678000949114565
SIM,1805,62,na,1867,898
STAT,1853,30,15-19,1883,0.11331342585911262
SIM,1876,74,na,1950,1037
STAT,1868,53,25-29,1921,0.003141305324231119
SIM,1866,23,35-39,1889,6
STAT,1819,39,30-34,1858,12.691770046097883
STAT,1881,52,na,1933,1954.534155977319
STAT,1932,29,na,1961,4630.679407477309
STAT,1841,22,45-49,1863,0.60900414913912
STAT,1902,46,50-100,1948,0.18522876414950162
STAT,1953,19,50-100,1972,0.42785146119955075
SIM,1825,39,na,1864,1549
STAT,1919,35,45-49,1954,0.6957304365199173
STAT,1854,109,na,1963,0.0024811457918471626
STAT,1956,11,na,1967,4910.407995260705
SIM,1821,55,na,1876,1147
SIM,1889,23,35-39,1912,8
STAT,1916,25,20-24,1941,17.951056155623323
SIM,1944,19,40-44,1963,1
SIM,1898,52,na,1950,2676
SIM,1901,38,30-34,1939,2
STAT,1941,17,25-29,1958,42.16730450588931
SIM,1889,21,40-44,1910,3
STAT,1829,74,na,1903,670.573716972252
STAT,1916,27,15-19,1943,0.6895615345222692
STAT,1825,84,na,1909,176.805720985287
SIM,1919,43,40-44,1962,1
SIM,1936,31,na,1967,2868
SIM,1928,36,na,1964,4501
STAT,1848,17,45-49,1865,0.06017054903072385
SIM,1829,28,40-44,1857,1
SIM,1857,78,na,1935,518
SIM,1910,26,na,1936,3432
STAT,1911,47,na,1958,3285.750827610219
STAT,1861,38,40-44,1899,3.4214173563304553
SIM,1843,31,45-49,1874,2
SIM,1903,35,30-34,1938,1
STAT,1920,27,35-39,1947,15.558508281414886
STAT,1841,23,na,1864,1853.9214260265435
STAT,1856,76,na,1932,698.3102003048774
SIM,1853,88,na,1941,83
STAT,1931,15,45-49,1946,0.6205472851728828
SIM,1924,25,20-24,1949,24
STAT,1865,16,35-39,1881,0.4870312869622164
STAT,1922,24,35-39,1946,10.136856146332335
SIM,1933,18,25-29,1951,69
STAT,1830,42,50-100,1872,0.8218373281038797
STAT,1850,21,50-100,1871,0.3475209721442029
STAT,1876,16,50-100,1892,0.0479337464021966
STAT,1920,2,na,1922,4334.754854234141
STAT,1860,81,na,1941,414.5012253749287
STAT,1872,15,na,1887,2429.6156667887553
SIM,1802,96,na,1898,6
SIM,1893,29,na,1922,2956
SIM,1907,28,25-29,1935,2
SIM,1912,28,35-39,1940,17
STAT,1844,106,na,1950,0.00843269120585246
STAT,1883,78,na,1961,907.6107563216266
SIM,1855,30,25-29,1885,14
SIM,1848,40,50-100,1888,2
STAT,1926,8,na,1934,4619.415650891181
SIM,1950,15,20-24,1965,149
STAT,1900,33,15-19,1933,0.18583833178289416
STAT,1911,21,25-29,1932,83.01076351482601
STAT,1877,15,15-19,1892,5.842491470324313
SIM,1837,30,na,1867,1781
SIM,1793,94,na,1887,8
STAT,1807,54,50-100,1861,0.053153673724348705
SIM,1823,46,50-100,1869,1
STAT,1862,51,30-34,1913,0.004830988931762417
SIM,1866,101,na,1967,1
STAT,1816,48,na,1864,1369.7761417801203
SIM,1903,33,35-39,1936,4
STAT,1904,28,35-39,1932,13.02881878935145
SIM,1861,83,na,1944,287
STAT,1908,47,50-100,1955,0.193242150319146
STAT,1847,30,25-29,1877,9.054244367781488
STAT,1911,36,25-29,1947,0.9027636501367755
SIM,1868,16,25-29,1884,5
STAT,1903,4,na,1907,3536.0448527657545
STAT,1931,33,45-49,1964,1.946623641855614
STAT,1925,18,25-29,1943,49.32264579477632
STAT,1870,53,50-100,1923,0.013771912418894385
SIM,1906,29,20-24,1935,18
SIM,1930,22,40-44,1952,5
STAT,1859,17,20-24,1876,15.473237988826067
STAT,1813,50,50-100,1863,0.04109846590216894
STAT,1921,25,30-34,1946,41.53372500442092
STAT,1835,31,45-49,1866,1.4277685923815935
SIM,1831,36,50-100,1867,1
SIM,1950,17,15-19,1967,45
STAT,1902,29,40-44,1931,3.9652356689736137
SIM,1826,78,na,1904,369
SIM,1826,86,na,1912,98
STAT,1928,42,30-34,1970,0.15396227760454798
SIM,1822,96,na,1918,1
STAT,1777,100,na,1877,0.18706793870742255
SIM,1920,32,25-29,1952,13
STAT,1896,25,25-29,1921,53.13693608903616
SIM,1888,22,na,1910,2671
SIM,1910,29,40-44,1939,4
STAT,1848,18,50-100,1866,0.044862108372699674
STAT,1904,26,40-44,1930,4.073087994343501
STAT,1923,16,50-100,1939,0.4166203275033253
STAT,1850,51,na,1901,1525.0804399918418
SIM,1907,26,30-34,1933,50
STAT,1926,45,30-34,1971,0.10439801578179049
STAT,1929,41,35-39,1970,0.24670048183310658
SIM,1851,53,na,1904,1592
STAT,1798,97,na,1895,1.5259773249876982
STAT,1839,24,40-44,1863,1.7571328443058352
STAT,1889,18,45-49,1907,0.07598309043434774
STAT,1909,48,35-39,1957,0.11161375974673199
STAT,1862,17,na,1879,2123.4690883344833
SIM,1800,61,na,1861,888
STAT,1873,20,25-29,1893,55.17510240525914
SIM,1852,47,na,1899,1719
STAT,1843,54,25-29,1897,0.002326650365004339
SIM,1911,28,45-49,1939,1
STAT,1870,46,40-44,1916,0.15911200150111887
STAT,1811,43,25-29,1854,2.340503070349416
STAT,1903,28,45-49,1931,1.4871631351032972
SIM,1905,30,35-39,1935,10
STAT,1867,48,na,1915,1970.7072782887947
STAT,1856,37,50-100,1893,0.9049419336031582
STAT,1892,49,25-29,1941,0.03764251171662483
STAT,1907,32,15-19,1939,0.11347517353352815
STAT,1912,32,25-29,1944,8.591999115441869
SIM,1912,26,40-44,1938,3
SIM,1806,49,50-100,1855,3
SIM,1867,60,na,1927,1841
STAT,1936,19,40-44,1955,1.2582429755042
STAT,1871,0,na,1871,3491.175459841678
SIM,1842,37,na,1879,1685
STAT,1915,27,25-29,1942,63.42352570102535
SIM,1851,73,na,1924,847
SIM,1797,76,na,1873,318
SIM,1834,73,na,1907,671
STAT,1888,19,40-44,1907,0.20310670076594783
STAT,1900,15,15-19,1915,7.813389575355225
STAT,1826,58,na,1884,1146.4987421255955
STAT,1855,35,na,1890,1690.1205020013442
STAT,1898,20,30-34,1918,22.907440167998583
STAT,1911,5,na,1916,3788.69923797912
SIM,1830,91,na,1921,33
SIM,1922,28,20-24,1950,22
STAT,1854,2,na,1856,2563.2504052836043
SIM,1913,25,45-49,1938,1
STAT,1835,48,40-44,1883,0.11339200943202359
STAT,1914,28,20-24,1942,17.323314733154426
SIM,1865,21,25-29,1886,48
STAT,1927,44,35-39,1971,0.2377779836569817
SIM,1867,17,20-24,1884,16
STAT,1922,22,40-44,1944,3.6426032738081218
STAT,1942,17,15-19,1959,44.80472762594412
STAT,1905,25,45-49,1930,1.526398495678572
SIM,1909,23,30-34,1932,38
STAT,1925,44,50-100,1969,0.13391491269330433
STAT,1940,5,na,1945,3840.8542027319354
STAT,1864,71,na,1935,1123.8644525060938
SIM,1888,24,30-34,1912,23
STAT,1835,94,na,1929,12.720658424792061
STAT,1918,39,45-49,1957,0.6773691792529304
STAT,1912,21,50-100,1933,0.5975397740697503
STAT,1940,20,35-39,1960,9.067681093935631
SIM,1893,39,40-44,1932,7
STAT,1937,35,35-39,1972,2.2888395415082687
SIM,1820,81,na,1901,266
STAT,1930,26,na,1956,4501.8875698348065
STAT,1906,24,50-100,1930,0.5575679155796223
SIM,1904,31,30-34,1935,17
SIM,1814,73,na,1887,468
SIM,1854,42,na,1896,1834
SIM,1942,21,20-24,1963,98
SIM,1921,31,30-34,1952,23
STAT,1796,62,na,1858,884.0659908734281
STAT,1874,81,na,1955,521.9585553124758
STAT,1874,21,25-29,1895,55.421623080718454
STAT,1913,19,45-49,1932,0.09597268501349561
SIM,1925,21,20-24,1946,124
SIM,1923,27,25-29,1950,69
STAT,1874,10,na,1884,2554.9913316160046
SIM,1858,42,45-49,1900,4
STAT,1930,19,45-49,1949,0.6068262001066569
SIM,1916,11,na,1927,3888
STAT,1937,33,40-44,1970,3.6552818330284036
SIM,1925,23,15-19,1948,6
STAT,1864,18,40-44,1882,0.1583704430096836
STAT,1816,56,na,1872,1187.4663638788443
STAT,1810,47,25-29,1857,0.1922177492998794
STAT,1782,82,na,1864,137.15625737950688
STAT,1905,43,45-49,1948,0.14089034468590736
SIM,1865,65,na,1930,1469
SIM,1943,13,na,1956,3821
STAT,1837,23,50-100,1860,0.3439714842142001
SIM,1888,27,35-39,1915,11
STAT,1799,106,na,1905,0.0038762595595074993
STAT,1908,33,15-19,1941,0.11410895194687336
STAT,1934,21,20-24,1955,141.21427344007077
STAT,1829,34,25-29,1863,9.68024414093044
STAT,1920,45,35-39,1965,0.1352706453051225
SIM,1842,17,na,1859,2031
SIM,1881,3,na,1884,2216
STAT,1885,39,40-44,1924,4.08056080440745
SIM,1879,14,na,1893,2584
STAT,1917,21,20-24,1938,111.98159338008657
STAT,1805,64,na,1869,889.4783000507997
STAT,1871,53,na,1924,1987.3964799980738
SIM,1843,78,na,1921,540
SIM,1847,24,40-44,1871,2
STAT,1864,51,na,1915,1821.5805080841508
STAT,1942,15,20-24,1957,133.91800142030414
STAT,1821,53,35-39,1874,0.012798865790412667
STAT,1807,51,na,1858,1246.911779131829
STAT,1873,88,na,1961,228.92973303300636
STAT,1841,15,na,1856,2065.2735103934733
SIM,1865,103,na,1968,1
SIM,1906,27,25-29,1933,57
SIM,1929,30,50-100,1959,1
STAT,1847,18,40-44,1865,0.1673445862445401
STAT,1890,12,na,1902,2982.7097603814145
SIM,1837,34,25-29,1871,11
SIM,1916,31,20-24,1947,3
STAT,1889,15,40-44,1904,0.21430265801140064
STAT,1869,21,15-19,1890,3.028347310565499
STAT,1887,68,na,1955,1614.8223532540055
SIM,1892,1,na,1893,3496
SIM,1847,26,35-39,1873,12
STAT,1847,48,na,1895,1638.202873038109
SIM,1905,59,na,1964,2750
STAT,1842,96,na,1938,6.2183053150262175
STAT,1859,24,50-100,1883,0.31357031904810684
SIM,1884,32,45-49,1916,3
STAT,1914,30,35-39,1944,8.760026377693078
STAT,1891,73,na,1964,1643.4242875107257
STAT,1891,53,na,1944,2476.2434358529927
SIM,1863,78,na,1941,614
STAT,1824,43,na,1867,1496.1678528759496
SIM,1811,45,na,1856,1274
SIM,1848,22,na,1870,1901
SIM,1897,17,35-39,1914,1
STAT,1876,49,40-44,1925,0.16360326749271556
STAT,1903,41,15-19,1944,0.0012948515279787005
STAT,1875,35,na,1910,2309.414853062815
STAT,1889,17,35-39,1906,0.6399347068344545
STAT,1860,54,30-34,1914,0.004437215902992914
STAT,1902,30,na,1932,3207.0782993977846
SIM,1941,22,15-19,1963,5
SIM,1786,92,na,1878,12
SIM,1874,30,na,1904,2226
SIM,1812,86,na,1898,79
STAT,1876,32,45-49,1908,1.7019788281328627
STAT,1928,43,40-44,1971,0.3007445640784297
STAT,1891,39,50-100,1930,1.420520444267024
STAT,1917,23,15-19,1940,5.328204796369721
SIM,1866,20,30-34,1886,23
STAT,1913,31,30-34,1944,14.869341078609011
SIM,1901,23,30-34,1924,31
STAT,1908,31,20-24,1939,2.1839847123326526
SIM,1882,37,na,1919,2215
STAT,1820,61,na,1881,1033.886733601599
SIM,1878,35,25-29,1913,2
STAT,1839,26,35-39,1865,8.15162795437782
SIM,1927,6,na,1933,4681
STAT,1831,33,na,1864,1620.2026575047244
STAT,1897,1,na,1898,3438.7581561947018
STAT,1903,45,35-39,1948,0.1072082027697325
STAT,1933,22,15-19,1955,6.670415991233392
STAT,1904,57,na,1961,2839.1523925874576
SIM,1939,18,20-24,1957,103
SIM,1888,25,40-44,1913,4
STAT,1834,49,35-39,1883,0.08981127715977832
STAT,1858,20,30-34,1878,15.357104936472112
SIM,1806,86,na,1892,67
STAT,1922,21,30-34,1943,31.230776716176635
SIM,1803,58,na,1861,1006
SIM,1931,20,35-39,1951,14
SIM,1916,19,35-39,1935,3
SIM,1942,23,15-19,1965,8
STAT,1908,19,35-39,1927,0.7648329824271303
STAT,1934,23,15-19,1957,6.755841094824682
SIM,1817,41,45-49,1858,1
STAT,1915,29,na,1944,3583.9417599169988
SIM,1868,22,na,1890,2107
SIM,1930,21,30-34,1951,49
SIM,1902,37,35-39,1939,2
STAT,1909,49,45-49,1958,0.18756752889616393
STAT,1934,22,50-100,1956,0.8353611911434164
STAT,1938,32,45-49,1970,1.4947524348777406
STAT,1920,41,15-19,1961,0.0016045600997487573
STAT,1778,77,na,1855,292.88154
STAT,1859,49,40-44,1908,0.1260360054061015
STAT,1852,43,50-100,1895,0.7603803160442529
STAT,1923,20,35-39,1943,10.411533702237803
STAT,1836,56,na,1892,1320.7988024070987
STAT,1912,35,30-34,1947,1.6964961552724216
STAT,1933,25,20-24,1958,22.916902609675148
STAT,1927,43,25-29,1970,0.0844694709478181
SIM,1862,37,na,1899,2020
STAT,1907,22,na,1929,3282.0434025587
SIM,1912,29,45-49,1941,1
STAT,1818,82,na,1900,229.13803181265334
STAT,1878,63,na,1941,1756.68428809924
SIM,1900,5,na,1905,3494
SIM,1905,31,45-49,1936,2
STAT,1908,47,na,1955,3138.793872943094
SIM,1905,28,20-24,1933,17
STAT,1779,100,na,1879,0.17861720313582097
STAT,1937,6,na,1943,3683.555186217494
STAT,1841,37,50-100,1878,0.9972497532773652
STAT,1941,16,15-19,1957,44.172594451879384
SIM,1895,49,50-100,1944,1
STAT,1823,38,na,1861,1521.7584979688029
SIM,1902,18,25-29,1920,10
SIM,1907,48,50-100,1955,1
STAT,1920,26,25-29,1946,68.44341295832845
STAT,1862,54,35-39,1916,0.006762474598208962
SIM,1794,100,na,1894,1
STAT,1838,33,50-100,1871,0.7564748887604595
STAT,1856,43,50-100,1899,0.7730621689279149
SIM,1839,30,40-44,1869,4
SIM,1849,63,na,1912,1338
STAT,1887,35,25-29,1922,3.0712965158364987
SIM,1924,45,50-100,1969,1
STAT,1902,25,50-100,1927,0.8586440708545627
STAT,1837,41,20-24,1878,0.1231921905650783
SIM,1879,34,30-34,1913,21
SIM,1920,16,na,1936,3965
SIM,1858,27,20-24,1885,11
STAT,1936,11,na,1947,3588.9087743285936
SIM,1881,20,25-29,1901,48
STAT,1913,31,50-100,1944,0.7803085999932492
SIM,1923,44,45-49,1967,1
STAT,1904,29,45-49,1933,1.4937702409847575
SIM,1826,31,45-49,1857,3
STAT,1849,74,na,1923,832.1949411153462
STAT,1914,15,45-49,1929,0.09807482615843281
STAT,1826,54,25-29,1880,0.003031665442169501
SIM,1907,25,20-24,1932,18
STAT,1903,42,25-29,1945,0.059865585337356496
STAT,1916,40,15-19,1956,0.001490822431118216
STAT,1885,22,45-49,1907,0.6566283754802137
STAT,1919,37,40-44,1956,1.5192837375750143
SIM,1923,9,na,1932,4472
STAT,1919,19,40-44,1938,1.4523782597878736
SIM,1867,103,na,1970,1
SIM,1877,21,15-19,1898,2
SIM,1878,32,20-24,1910,1
STAT,1879,29,40-44,1908,2.9410612128002507
STAT,1778,97,na,1875,0.8559526599138196
SIM,1856,31,25-29,1887,14
STAT,1893,45,25-29,1938,0.0393134211688476
SIM,1790,66,na,1856,680
STAT,1855,15,na,1870,1963.2112294438227
STAT,1882,17,na,1899,2320.3131541426324
SIM,1908,27,30-34,1935,51
STAT,1876,76,na,1952,924.6705134502096
STAT,1931,28,20-24,1959,22.25218068643479
SIM,1893,22,45-49,1915,5
STAT,1826,41,45-49,1867,1.4920191605064903
STAT,1830,31,na,1861,1709.6476704689132
STAT,1915,44,45-49,1959,0.15776667828208393
SIM,1864,101,na,1965,6
STAT,1910,38,30-34,1948,1.6385792090096356
SIM,1886,27,na,1913,2339
STAT,1893,32,45-49,1925,2.0891472139150578
STAT,1835,51,50-100,1886,0.009992006006244178
SIM,1926,41,na,1967,4286
SIM,1927,19,40-44,1946,5
STAT,1819,76,na,1895,500.12958606239846
SIM,1913,22,40-44,1935,4
SIM,1833,88,na,1921,62
SIM,1854,34,25-29,1888,12
STAT,1888,30,15-19,1918,0.16026878400272332
STAT,1921,28,35-39,1949,15.751561678382227
STAT,1876,17,20-24,1893,17.303131729099047
STAT,1908,18,25-29,1926,7.920503088704649
SIM,1879,16,30-34,1895,2
SIM,1933,15,20-24,1948,163
STAT,1905,38,20-24,1943,0.22606539476536783
STAT,1910,23,30-34,1933,25.419983332428462
STAT,1922,25,45-49,1947,1.8593094199790272
SIM,1808,81,na,1889,182
STAT,1868,33,na,1901,2141.805924265666
STAT,1860,53,20-24,1913,5.565406755623433E-4
STAT,1936,34,35-39,1970,8.374267801002407
STAT,1822,100,na,1922,0.539461744145264
STAT,1911,33,20-24,1944,2.234421532887715
SIM,1793,66,na,1859,745
STAT,1909,2,na,1911,3776.6551667086364
STAT,1852,31,45-49,1883,1.32263981019655
STAT,1868,10,na,1878,2437.4987985166226
STAT,1931,30,40-44,1961,4.849545777590722
SIM,1931,21,45-49,1952,1
STAT,1839,76,na,1915,630.7796865909763
STAT,1925,15,20-24,1940,155.43155503390804
SIM,1810,91,na,1901,24
STAT,1848,31,25-29,1879,8.968245822219675
SIM,1892,67,na,1959,2218
STAT,1902,31,25-29,1933,13.711568163001505
STAT,1913,47,45-49,1960,0.20040755698474483
SIM,1930,25,45-49,1955,7
STAT,1795,69,na,1864,715.623168753257
STAT,1858,21,40-44,1879,1.783684979350508
STAT,1905,22,40-44,1927,2.845429287334108
STAT,1884,71,na,1955,1245.7970651476182
STAT,1815,94,na,1909,8.920971205915011
STAT,1860,61,na,1921,1432.3272457333603
SIM,1901,35,25-29,1936,3
SIM,1823,81,na,1904,243
STAT,1790,77,na,1867,314.2080330675918
STAT,1895,43,na,1938,2835.7168427547413
SIM,1884,60,na,1944,1837
STAT,1875,47,30-34,1922,0.0935560145051653
SIM,1941,25,20-24,1966,16
STAT,1921,40,25-29,1961,0.07619232451044142
SIM,1840,81,na,1921,324
SIM,1916,18,25-29,1934,9
STAT,1852,44,25-29,1896,0.45927090653109426
SIM,1858,25,50-100,1883,1
SIM,1911,25,40-44,1936,5
STAT,1867,43,50-100,1910,0.930385484881453
STAT,1923,21,45-49,1944,1.2405002882483833
STAT,1899,21,30-34,1920,23.125876017274823
STAT,1838,28,40-44,1866,2.5398737727100316
STAT,1846,34,25-29,1880,8.793212174643045
SIM,1860,31,45-49,1891,2
SIM,1895,32,na,1927,2996
STAT,1916,28,25-29,1944,64.06566798849241
SIM,1924,28,25-29,1952,91
SIM,1868,2,na,1870,2878
STAT,1901,16,15-19,1917,7.866778393744747
STAT,1842,17,na,1859,2134.6356137942694
SIM,1864,24,40-44,1888,1
SIM,1908,16,na,1924,3523
STAT,1902,22,na,1924,3153.1571503469695
STAT,1880,47,40-44,1927,0.16970914953369196
SIM,1902,36,25-29,1938,1
SIM,1903,24,na,1927,3170
STAT,1818,54,50-100,1872,0.02970401261621577
STAT,1863,31,20-24,1894,2.2500401040203846
STAT,1856,24,40-44,1880,1.7583141832567415
STAT,1801,54,20-24,1855,0.0019802646507251533
STAT,1928,25,50-100,1953,1.1662716736637606
STAT,1945,27,40-44,1972,4.83080113226004
STAT,1903,25,40-44,1928,4.053811017134959
STAT,1951,21,20-24,1972,125.54358187584573
SIM,1943,21,na,1964,3596
SIM,1846,28,40-44,1874,4
SIM,1899,40,40-44,1939,1
STAT,1917,52,na,1969,3564.1173888512585
STAT,1887,22,50-100,1909,0.43090572241023456
SIM,1859,23,20-24,1882,44
STAT,1930,16,40-44,1946,1.7124704541942166
STAT,1918,43,50-100,1961,0.11781344540412403
STAT,1938,22,50-100,1960,0.6152129458191616
STAT,1844,21,45-49,1865,0.6090610988065592
STAT,1908,27,na,1935,3344.455168384931
STAT,1924,47,20-24,1971,0.012428610802333376
SIM,1848,21,25-29,1869,53
SIM,1904,2,na,1906,3651
SIM,1925,24,25-29,1949,100
STAT,1897,24,30-34,1921,22.36284744383969
STAT,1895,0,na,1895,3616.3882128887176
STAT,1917,30,50-100,1947,0.8244838012474617
STAT,1919,19,na,1938,3821.9748866774758
SIM,1910,31,25-29,1941,7
STAT,1834,46,30-34,1880,0.07091346878372451
STAT,1857,20,40-44,1877,1.8183646331709
SIM,1841,20,25-29,1861,55
STAT,1823,58,na,1881,1145.8968242326325
STAT,1913,32,40-44,1945,3.67827639869721
SIM,1950,15,na,1965,3984
STAT,1851,48,25-29,1899,0.0409135325286029
SIM,1904,34,35-39,1938,7
STAT,1884,40,50-100,1924,0.995957613187991
SIM,1860,46,50-100,1906,2
STAT,1812,66,na,1878,841.0033004158935
STAT,1937,32,30-34,1969,14.725375959016523
STAT,1821,50,30-34,1871,0.00939445817566673
STAT,1918,36,40-44,1954,1.4977845014036035
STAT,1773,103,na,1876,0.04362343137688181
STAT,1799,59,na,1858,958.0092046563458
SIM,1836,45,na,1881,1518
STAT,1900,33,45-49,1933,2.2756428663170962
STAT,1924,7,na,1931,4496.779978141524
STAT,1915,44,15-19,1959,0.0014557479986948207
STAT,1921,23,35-39,1944,10.015873353621773
STAT,1829,31,20-24,1860,2.772969478638753
STAT,1968,2,na,1970,4642.459213255204
STAT,1874,22,35-39,1896,5.632541923502921
SIM,1838,33,30-34,1871,19
STAT,1843,20,50-100,1863,0.3507531652787782
STAT,1926,17,30-34,1943,14.117185248422528
STAT,1909,47,25-29,1956,0.04604910577503314
SIM,1896,31,25-29,1927,13
SIM,1881,75,na,1956,772
SIM,1827,40,na,1867,1509
SIM,1866,21,40-44,1887,1
STAT,1923,18,20-24,1941,149.9976487565444
SIM,1848,22,35-39,1870,5
STAT,1896,22,20-24,1918,85.98111530751844
SIM,1891,42,na,1933,2716
SIM,1901,20,20-24,1921,97
STAT,1831,25,na,1856,1686.0779653044315
STAT,1843,58,na,1901,1335.7616903964813
STAT,1924,19,20-24,1943,151.6973062489632
SIM,1917,29,25-29,1946,80
STAT,1901,37,na,1938,3139.9900349655877
SIM,1921,8,na,1929,4322
SIM,1884,40,na,1924,2299
STAT,1872,24,25-29,1896,53.9050587667081
SIM,1875,55,na,1930,1971
SIM,1796,82,na,1878,155
STAT,1866,86,na,1952,193.32544911120374
SIM,1913,40,40-44,1953,1
SIM,1839,17,na,1856,2038
STAT,1917,24,25-29,1941,92.16252680935904
SIM,1903,32,25-29,1935,10
STAT,1917,42,25-29,1959,0.07040107959619085
SIM,1921,32,40-44,1953,3
SIM,1931,18,20-24,1949,161
STAT,1932,29,20-24,1961,22.563985349550638
SIM,1786,84,na,1870,102
SIM,1820,61,na,1881,1066
SIM,1932,19,20-24,1951,163
SIM,1937,26,45-49,1963,2
STAT,1881,12,na,1893,2356.8146143958443
STAT,1905,40,40-44,1945,0.21543457761666077
STAT,1917,32,na,1949,3741.413590363258
STAT,1909,29,25-29,1938,59.00264577155825
SIM,1865,20,40-44,1885,2
SIM,1882,14,na,1896,2445
SIM,1964,7,na,1971,4607
STAT,1843,89,na,1932,70.95805450557525
SIM,1819,73,na,1892,603
SIM,1940,29,20-24,1969,20
SIM,1930,24,35-39,1954,17
STAT,1854,15,50-100,1869,0.042430051682949256
STAT,1938,19,15-19,1957,42.26441295828896
STAT,1878,42,20-24,1920,0.15616220315939736
STAT,1901,44,15-19,1945,0.0012509861978644231
STAT,1903,42,30-34,1945,0.10717870879448807
STAT,1850,91,na,1941,40.84877111775239
SIM,1887,29,40-44,1916,3
STAT,1907,35,20-24,1942,0.23308426713270458
STAT,1896,48,50-100,1944,0.17068100719933524
SIM,1836,20,15-19,1856,1
STAT,1855,53,40-44,1908,0.00736110944307606
STAT,1925,19,na,1944,4177.794421545899
SIM,1866,44,50-100,1910,1
STAT,1806,66,na,1872,805.4472740276699
STAT,1905,5,na,1910,3578.4672043308033
STAT,1904,25,30-34,1929,34.35439531510207
STAT,1949,17,50-100,1966,0.41165227828358925
SIM,1892,27,na,1919,3118
SIM,1916,31,50-100,1947,1
SIM,1912,25,30-34,1937,48
STAT,1819,84,na,1903,175.61121262636038
SIM,1844,32,na,1876,1729
SIM,1844,71,na,1915,842
SIM,1927,37,40-44,1964,2
SIM,1789,89,na,1878,24
STAT,1942,18,25-29,1960,42.7690296121261
SIM,1915,18,na,1933,3658
SIM,1933,34,30-34,1967,30
SIM,1837,31,20-24,1868,2
SIM,1950,18,25-29,1968,49
SIM,1906,24,20-24,1930,89
STAT,1864,20,na,1884,2052.6969162608348
STAT,1883,15,40-44,1898,0.1701943484146255
SIM,1920,35,30-34,1955,7
SIM,1933,16,30-34,1949,16
STAT,1868,25,15-19,1893,0.41171559804983077
SIM,1946,19,15-19,1965,41
SIM,1888,21,25-29,1909,75
SIM,1915,49,na,1964,3328
STAT,1889,32,25-29,1921,11.945487111839908
STAT,1898,21,40-44,1919,2.672024870847472
SIM,1838,32,na,1870,1759
STAT,1848,33,na,1881,1862.285915832795
SIM,1889,22,25-29,1911,67
STAT,1788,67,na,1855,652.2218
STAT,1888,31,25-29,1919,11.48206934960438
STAT,1931,41,50-100,1972,0.14847543403741378
STAT,1878,15,30-34,1893,1.5764880213279098
SIM,1934,17,30-34,1951,20
SIM,1831,53,na,1884,1302
STAT,1856,23,30-34,1879,15.138668395017532
STAT,1925,34,30-34,1959,17.651170551865487
STAT,1958,9,na,1967,4874.779580928069
SIM,1897,32,25-29,1929,20
SIM,1926,36,40-44,1962,1
STAT,1929,38,50-100,1967,0.5086800020632646
STAT,1943,24,na,1967,3667.879215902077
STAT,1818,106,na,1924,0.005962768288551513
STAT,1925,16,30-34,1941,13.943486499839912
STAT,1877,78,na,1955,765.6549913232687
STAT,1899,22,40-44,1921,2.6972877573862255
STAT,1923,36,15-19,1959,0.021038970263512455
STAT,1911,34,30-34,1945,14.369748594729977
SIM,1864,23,30-34,1887,18
SIM,1911,24,30-34,1935,40
SIM,1946,22,50-100,1968,4
SIM,1868,15,15-19,1883,4
STAT,1858,44,50-100,1902,0.7719321363875925
STAT,1861,7,na,1868,2234.6104437143913
STAT,1901,21,50-100,1922,0.5408663270403583
STAT,1921,41,35-39,1962,0.21456840569919372
STAT,1862,48,na,1910,1794.404433355107
STAT,1808,92,na,1900,16.103963395864128
STAT,1915,26,15-19,1941,0.682581429794719
STAT,1781,97,na,1878,0.9201530904401114
SIM,1940,16,na,1956,3432
STAT,1867,29,15-19,1896,0.3995930412355543
STAT,1898,24,45-49,1922,0.8858888165433849
SIM,1900,24,20-24,1924,93
STAT,1820,100,na,1920,0.559282763134926
SIM,1911,26,25-29,1937,67
STAT,1944,16,35-39,1960,4.267130977717838
STAT,1814,109,na,1923,3.270054235066071E-4
SIM,1936,27,40-44,1963,4
SIM,1952,16,35-39,1968,5
STAT,1779,109,na,1888,0.002662400745698034
STAT,1857,25,40-44,1882,2.3322396382127213
SIM,1898,31,30-34,1929,25
SIM,1850,7,na,1857,2286
SIM,1879,25,na,1904,2402
SIM,1950,19,35-39,1969,7
STAT,1905,21,30-34,1926,24.396004740175325
STAT,1905,40,35-39,1945,0.17343888860956258
SIM,1839,96,na,1935,2
STAT,1901,33,30-34,1934,22.99028466150007
STAT,1935,19,25-29,1954,55.664982908533474
STAT,1955,16,45-49,1971,0.6265757157014422
SIM,1925,27,30-34,1952,62
STAT,1848,50,35-39,1898,0.006488958535980923
SIM,1839,73,na,1912,788
STAT,1814,52,40-44,1866,0.030757212083019722
STAT,1928,27,40-44,1955,5.424637051168432
STAT,1811,56,na,1867,1118.2466505482137
STAT,1949,18,na,1967,4042.9324957988133
STAT,1888,53,na,1941,2365.3678541301615
SIM,1877,22,25-29,1899,58
SIM,1920,15,40-44,1935,1
STAT,1907,34,50-100,1941,0.7238441656793682
STAT,1918,40,50-100,1958,0.11832742557092203
STAT,1912,38,35-39,1950,2.2191893810232726
STAT,1942,19,35-39,1961,4.139874372915195
SIM,1828,33,na,1861,1648
SIM,1928,39,50-100,1967,3
SIM,1955,1,na,1956,4605
SIM,1821,86,na,1907,134
STAT,1762,107,na,1869,0.003743479273617282
SIM,1906,3,na,1909,3610
STAT,1869,22,25-29,1891,52.39057980183854
SIM,1920,38,35-39,1958,8
STAT,1822,96,na,1918,4.363203403774767
STAT,1829,43,na,1872,1555.5263783195242
STAT,1881,43,40-44,1924,2.0378754791203333
STAT,1953,19,45-49,1972,0.5704686149327344
SIM,1856,32,35-39,1888,7
STAT,1925,45,15-19,1970,4.2366242306579664E-4
STAT,1903,26,25-29,1929,57.054677075142735
SIM,1879,35,40-44,1914,5
STAT,1864,46,45-49,1910,0.19926950205873134
STAT,1837,44,25-29,1881,0.43620188407372257
STAT,1848,32,35-39,1880,8.775485523049205
STAT,1912,15,40-44,1927,0.2684446193752951
STAT,1893,16,50-100,1909,0.05883777817525389
STAT,1811,47,40-44,1858,0.5702434345022409
STAT,1803,51,25-29,1854,0.010530613923265205
STAT,1857,61,na,1918,1392.2474730527495
SIM,1896,17,na,1913,3188
STAT,1929,26,45-49,1955,2.043420338184071
STAT,1893,49,40-44,1942,0.113279178346077
STAT,1928,24,na,1952,4280.21736031343
STAT,1919,34,35-39,1953,9.234232142078014
SIM,1934,7,na,1941,4978
SIM,1904,54,na,1958,2960
STAT,1892,30,50-100,1922,1.0928623718531556
STAT,1889,33,35-39,1922,11.760898664242951
STAT,1860,36,30-34,1896,4.104835096915457
STAT,1924,34,na,1958,4162.928821825747
SIM,1897,33,35-39,1930,17
SIM,1935,29,45-49,1964,2
STAT,1927,29,45-49,1956,1.9760915591506116
STAT,1873,24,40-44,1897,1.9840287940780295
SIM,1889,5,na,1894,3175
STAT,1802,96,na,1898,3.0104363079993974
SIM,1894,2,na,1896,3341
SIM,1951,5,na,1956,4296
STAT,1841,15,35-39,1856,0.493688932123137
STAT,1863,34,25-29,1897,8.418597018407468
SIM,1907,22,15-19,1929,7
STAT,1924,35,20-24,1959,0.2941531806928582
STAT,1890,36,45-49,1926,2.3134906215506947
SIM,1790,97,na,1887,2
STAT,1961,8,na,1969,4795.548867912592
STAT,1942,30,45-49,1972,1.5853243685309204
SIM,1916,15,20-24,1931,20
STAT,1823,45,45-49,1868,0.299136442899319
SIM,1862,104,na,1966,1
STAT,1857,23,45-49,1880,0.5954807861038838
STAT,1934,36,25-29,1970,1.2847492380036505
STAT,1812,97,na,1909,2.3336347185379402
STAT,1869,24,20-24,1893,62.673170809329
SIM,1857,39,na,1896,1845
STAT,1858,47,30-34,1905,0.07136370711831078
SIM,1875,35,na,1910,2310
STAT,1912,36,40-44,1948,1.386968802782265
SIM,1943,4,na,1947,3891
STAT,1905,15,50-100,1920,0.06720895423651169
STAT,1858,106,na,1964,0.048943216227937805
SIM,1943,19,25-29,1962,40
STAT,1944,26,40-44,1970,4.761189659575306
STAT,1835,44,25-29,1879,0.477329110966534
STAT,1870,42,25-29,1912,0.5943935801131646
STAT,1908,15,20-24,1923,24.96005824283292
SIM,1915,17,25-29,1932,8
SIM,1913,14,na,1927,3672
STAT,1896,40,15-19,1936,0.001208582208360122
SIM,1901,23,25-29,1924,88
STAT,1875,91,na,1966,160.4129695134878
SIM,1847,91,na,1938,32
SIM,1865,25,40-44,1890,2
STAT,1918,17,na,1935,3984.454542839737
STAT,1859,73,na,1932,893.0599656116843
STAT,1902,46,25-29,1948,0.043441273370295026
SIM,1879,37,35-39,1916,12
STAT,1905,50,na,1955,2982.471172939684
STAT,1868,26,25-29,1894,38.25889756216995
SIM,1860,81,na,1941,390
STAT,1922,43,45-49,1965,0.1801777360734346
STAT,1858,24,45-49,1882,0.531552692914602
STAT,1935,37,25-29,1972,1.3006427972710006
SIM,1927,34,35-39,1961,11
STAT,1823,36,50-100,1859,2.109740098061435
STAT,1900,30,40-44,1930,5.728969417457804
SIM,1920,36,40-44,1956,4
STAT,1907,17,25-29,1924,7.8638758907931585
SIM,1880,24,25-29,1904,74
SIM,1843,47,na,1890,1575
STAT,1866,30,30-34,1896,15.335308442294698
STAT,1913,35,45-49,1948,0.6416126522658439
STAT,1785,70,na,1855,649.3315999999999
STAT,1847,34,40-44,1881,3.346615803402008
SIM,1866,24,45-49,1890,1
STAT,1930,31,50-100,1961,1.0085609674320968
STAT,1844,27,50-100,1871,0.5438755762673907
SIM,1854,73,na,1927,915
STAT,1826,89,na,1915,57.367931187415266
STAT,1775,100,na,1875,0.19369606723398963
STAT,1895,12,na,1907,3180.6148780458575
SIM,1896,15,25-29,1911,8
STAT,1945,24,35-39,1969,9.742333047145387
STAT,1833,21,35-39,1854,5.243166059761692
SIM,1910,16,30-34,1926,2
STAT,1867,17,na,1884,2290.3709240231724
SIM,1928,32,30-34,1960,22
STAT,1802,53,30-34,1855,0.01708047458524257
SIM,1899,45,na,1944,3016
STAT,1822,33,25-29,1855,25.92055280032235
STAT,1851,45,20-24,1896,0.008718174333670095
SIM,1841,21,35-39,1862,11
STAT,1817,49,35-39,1866,0.30586648237107855
SIM,1908,23,15-19,1931,3
STAT,1887,17,na,1904,2668.7683432998765
STAT,1897,25,40-44,1922,3.8102182329318084
STAT,1916,47,35-39,1963,0.1249269838478836
STAT,1800,61,na,1861,938.4399901659466
STAT,1840,42,40-44,1882,1.5397921887468473
STAT,1925,30,15-19,1955,0.14431816771016076
STAT,1888,15,25-29,1903,6.356003212036103
STAT,1897,27,35-39,1924,12.190286189283803
SIM,1879,43,50-100,1922,1
STAT,1926,12,na,1938,4589.140557536228
STAT,1902,16,30-34,1918,2.1302158779572338
SIM,1885,15,15-19,1900,6
STAT,1793,74,na,1867,405.16752227536784
STAT,1789,69,na,1858,604.7330160715698
STAT,1884,2,na,1886,2926.8959528833147
SIM,1835,22,20-24,1857,65
STAT,1935,35,30-34,1970,2.411743367099861
SIM,1851,39,35-39,1890,13
STAT,1846,106,na,1952,0.009005537602442343
STAT,1954,17,40-44,1971,1.6333793390992613
STAT,1808,81,na,1889,222.9167598009871
STAT,1911,37,35-39,1948,2.2070705881166743
SIM,1857,30,30-34,1887,6
STAT,1936,15,50-100,1951,0.34042078055879166
STAT,1904,41,30-34,1945,0.10867085722029163
STAT,1916,22,15-19,1938,5.2694784380757795
STAT,1854,10,na,1864,2068.8145432363144
SIM,1924,22,15-19,1946,4
SIM,1838,36,35-39,1874,14
SIM,1919,39,na,1958,3868
SIM,1912,20,30-34,1932,31
STAT,1951,20,15-19,1971,6.012268967945596
STAT,1901,15,30-34,1916,2.1174326569132083
STAT,1877,19,30-34,1896,1.5535118125960645
STAT,1861,34,25-29,1895,7.976552218053171
STAT,1849,30,30-34,1879,15.478811451966243
STAT,1941,26,50-100,1967,0.9731490392792299
SIM,1844,40,na,1884,1606
STAT,1843,39,35-39,1882,4.970911968755269
STAT,1800,72,na,1872,555.0582212420716
SIM,1855,34,40-44,1889,8
STAT,1844,43,na,1887,1623.0754735520354
STAT,1947,22,45-49,1969,1.2013615369338386
SIM,1923,13,na,1936,4452
STAT,1854,36,50-100,1890,0.8826594987882806
STAT,1898,26,40-44,1924,3.8427297604899557
SIM,1830,60,na,1890,1113
STAT,1820,46,50-100,1866,0.41806928038945634
STAT,1900,18,20-24,1918,23.17244834152717
SIM,1870,80,na,1950,565
STAT,1921,21,15-19,1942,5.697062165224194
STAT,1881,24,50-100,1905,0.36982244068652037
STAT,1813,90,na,1903,32.44657212964171
STAT,1901,48,30-34,1949,0.07129692922436114
SIM,1826,55,na,1881,1178
STAT,1899,25,45-49,1924,1.446929640322893
SIM,1924,29,35-39,1953,29
STAT,1878,45,25-29,1923,0.05727374434068204
STAT,1921,41,30-34,1962,0.13622741472958624
STAT,1853,88,na,1941,103.89568966904069
STAT,1875,20,30-34,1895,17.399185986859404
STAT,1904,20,30-34,1924,24.280661234299412
SIM,1905,18,15-19,1923,10
SIM,1834,33,na,1867,1704
SIM,1839,35,40-44,1874,8
SIM,1865,25,na,1890,2138
STAT,1939,25,20-24,1964,17.351015464820062
SIM,1913,21,30-34,1934,29
STAT,1915,41,40-44,1956,0.23823954120729712
SIM,1779,82,na,1861,123
SIM,1864,26,35-39,1890,13
STAT,1831,23,25-29,1854,104.73926686747849
STAT,1876,42,20-24,1918,0.1548114480290691
SIM,1860,44,30-34,1904,4
STAT,1942,30,15-19,1972,0.1294640913753572
SIM,1897,67,na,1964,2272
STAT,1836,25,na,1861,1838.938051266961
STAT,1888,35,40-44,1923,4.933670059477467
STAT,1896,8,na,1904,3243.4159919344775
STAT,1930,31,30-34,1961,19.218853955280604
STAT,1916,40,45-49,1956,0.16156786962909572
STAT,1922,39,na,1961,4035.5323642673834
STAT,1892,19,50-100,1911,0.057658776435833656
STAT,1840,30,na,1870,1768.6744954246792
SIM,1923,41,40-44,1964,3
SIM,1838,34,40-44,1872,4
STAT,1898,63,na,1961,2414.167766427302
SIM,1792,92,na,1884,4
SIM,1895,35,25-29,1930,7
SIM,1871,65,na,1936,1572
SIM,1905,28,na,1933,3217
STAT,1931,30,35-39,1961,11.324620877640411
SIM,1903,38,35-39,1941,10
STAT,1833,88,na,1921,84.22706715913651
STAT,1895,35,na,1930,2929.175437949877
SIM,1885,65,na,1950,1578
SIM,1894,39,na,1933,2937
SIM,1909,39,45-49,1948,3
STAT,1946,25,35-39,1971,15.813142253504127
SIM,1839,33,45-49,1872,1
STAT,1827,27,50-100,1854,1.8001933268690389
STAT,1916,29,35-39,1945,14.560147452754483
SIM,1881,72,na,1953,934
STAT,1933,27,15-19,1960,0.8855181543370894
STAT,1886,21,15-19,1907,3.302069585160606
STAT,1870,54,20-24,1924,6.65069004058009E-4
STAT,1938,16,45-49,1954,0.4666660153042344
SIM,1869,15,30-34,1884,1
STAT,1920,24,30-34,1944,29.99587194678141
SIM,1860,0,na,1860,3098
STAT,1918,19,25-29,1937,44.32066100310766
STAT,1878,18,35-39,1896,0.5388000903242276
STAT,1881,46,45-49,1927,0.21598662410946468
STAT,1893,19,15-19,1912,7.071627791627234
STAT,1853,15,25-29,1868,5.220168821865591
STAT,1849,43,na,1892,1720.6050368432038
STAT,1929,29,15-19,1958,0.833799876427077
STAT,1864,43,40-44,1907,1.8801462065363732
SIM,1872,43,40-44,1915,7
STAT,1944,27,25-29,1971,67.20419327063664
STAT,1833,99,na,1932,1.1619368700100852
STAT,1807,48,50-100,1855,0.9301613689590964
STAT,1820,37,40-44,1857,10.069759036919486
STAT,1916,43,15-19,1959,0.0014843467289881714
STAT,1899,48,30-34,1947,0.0697905291655725
STAT,1916,26,30-34,1942,38.404148494990594
STAT,1924,17,25-29,1941,48.74979672533862
SIM,1853,37,50-100,1890,3
SIM,1890,32,na,1922,2993
SIM,1908,39,30-34,1947,1
STAT,1839,19,50-100,1858,0.042168834110522906
SIM,1918,46,na,1964,3705
STAT,1877,29,40-44,1906,2.914476604364423
STAT,1855,91,na,1946,41.179264548465454
STAT,1897,21,25-29,1918,72.54144687030372
SIM,1932,17,25-29,1949,65
STAT,1936,36,30-34,1972,1.691794046589926
SIM,1859,29,30-34,1888,26
STAT,1847,38,50-100,1885,0.9296338218548902
SIM,1889,24,45-49,1913,4
STAT,1839,23,30-34,1862,15.128497346629155
STAT,1874,40,35-39,1914,1.7654761719570413
STAT,1908,24,na,1932,3293.6123089268035
SIM,1894,21,15-19,1915,6
SIM,1902,22,na,1924,3148
STAT,1761,97,na,1858,1.1235865586383307
STAT,1927,26,40-44,1953,5.3713676993743595
SIM,1903,17,35-39,1920,2
STAT,1912,18,45-49,1930,0.09517964909946194
SIM,1950,16,30-34,1966,13
STAT,1889,30,30-34,1919,20.526156841357352
SIM,1878,4,na,1882,2776
STAT,1845,37,50-100,1882,0.9128256953231794
SIM,1818,38,40-44,1856,3
SIM,1831,45,na,1876,1482
STAT,1856,26,35-39,1882,7.42296856188699
SIM,1882,22,35-39,1904,9
SIM,1929,32,45-49,1961,1
SIM,1833,43,50-100,1876,4
STAT,1821,43,50-100,1864,1.7651378418823223
STAT,1826,28,15-19,1854,1.4477655366872255
STAT,1901,36,35-39,1937,2.0284402546379003
SIM,1924,26,30-34,1950,56
STAT,1942,16,30-34,1958,12.036780921843622
SIM,1888,50,na,1938,2492
SIM,1922,30,35-39,1952,12
SIM,1897,30,30-34,1927,32
STAT,1798,66,na,1864,784.4402325698233
STAT,1874,25,40-44,1899,2.9110045066839407
STAT,1874,47,15-19,1921,3.8428906886191905E-4
SIM,1841,52,na,1893,1429
STAT,1901,18,35-39,1919,0.7236800352211519
SIM,1900,39,25-29,1939,3
SIM,1882,40,35-39,1922,2
SIM,1859,73,na,1932,897
STAT,1817,41,na,1858,1428.329302309427
STAT,1851,49,40-44,1900,0.12058020489882328
STAT,1860,39,35-39,1899,5.366898128693819
STAT,1835,41,20-24,1876,0.12267469684978559
SIM,1869,34,50-100,1903,7
STAT,1865,21,50-100,1886,0.3559775983235072
STAT,1836,28,40-44,1864,2.4920667699721726
STAT,1777,109,na,1886,0.0027883642267767317
SIM,1847,42,35-39,1889,2
STAT,1851,25,na,1876,1848.4646227832068
SIM,1901,69,na,1970,2284
SIM,1788,96,na,1884,1
SIM,1923,29,20-24,1952,28
STAT,1820,51,25-29,1871,0.005824358279562526
SIM,1871,73,na,1944,1059
SIM,1831,42,40-44,1873,4
SIM,1909,26,35-39,1935,17
STAT,1872,21,20-24,1893,65.497058087715
SIM,1885,29,40-44,1914,2
SIM,1910,25,25-29,1935,72
STAT,1918,37,25-29,1955,0.9804129468012638
SIM,1864,20,25-29,1884,50
SIM,1875,24,na,1899,2295
STAT,1902,25,25-29,1927,56.7802038334575
STAT,1864,43,na,1907,1931.9412015825908
SIM,1880,21,20-24,1901,71
STAT,1953,16,40-44,1969,1.598830920653126
STAT,1864,40,na,1904,1965.6344905656842
STAT,1892,46,20-24,1938,0.008032161138418932
SIM,1878,21,30-34,1899,21
SIM,1912,21,na,1933,3413
STAT,1919,31,30-34,1950,16.12351801799857
SIM,1844,28,40-44,1872,2
STAT,1852,18,15-19,1870,5.173022071900513
SIM,1927,31,30-34,1958,30
STAT,1915,29,20-24,1944,17.463530132064346
SIM,1867,91,na,1958,82
SIM,1860,18,15-19,1878,6
STAT,1961,5,na,1966,4797.61154631813
SIM,1940,27,50-100,1967,5
STAT,1861,52,25-29,1913,0.0027673944757690794
STAT,1848,35,40-44,1883,3.4223516858625347
SIM,1836,23,20-24,1859,57
STAT,1877,61,na,1938,1831.1407461622166
SIM,1928,35,35-39,1963,4
STAT,1922,37,45-49,1959,0.7328069267535007
SIM,1938,21,35-39,1959,6
STAT,1874,50,na,1924,2108.1537144628564
SIM,1926,19,25-29,1945,57
STAT,1806,89,na,1895,36.4308235104546
STAT,1909,45,30-34,1954,0.07813209345683281
SIM,1900,8,na,1908,3462
STAT,1909,18,40-44,1927,0.25845456664258165
STAT,1882,16,35-39,1898,0.5053456167026741
STAT,1920,35,50-100,1955,0.43501741220691104
STAT,1839,42,35-39,1881,1.2706881321448136
STAT,1798,107,na,1905,0.0013395595596226984
STAT,1856,20,25-29,1876,49.71629248484713
STAT,1816,49,20-24,1865,0.027452613549515916
STAT,1823,42,40-44,1865,3.0004580041736117
STAT,1911,18,30-34,1929,2.2982454614321024
SIM,1863,33,50-100,1896,1
SIM,1854,70,na,1924,1095
STAT,1857,21,25-29,1878,49.59476278165493
STAT,1894,16,25-29,1910,6.896585270796308
SIM,1899,49,50-100,1948,3
STAT,1883,46,50-100,1929,0.22812385502633495
STAT,1933,37,20-24,1970,0.33919619750821983
SIM,1817,41,na,1858,1475
STAT,1934,24,25-29,1958,117.18826307310675
SIM,1844,63,na,1907,1173
STAT,1848,17,40-44,1865,0.16847757825556017
STAT,1890,33,40-44,1923,4.9876223495875225
SIM,1819,96,na,1915,2
STAT,1840,92,na,1932,27.332746731841734
STAT,1898,23,na,1921,3014.181819035711
SIM,1857,47,na,1904,1780
STAT,1861,31,20-24,1892,2.131894702073234
SIM,1858,32,na,1890,1930
STAT,1902,43,20-24,1945,0.0145970666933856
STAT,1817,46,30-34,1863,0.2216744814248995
SIM,1835,25,25-29,1860,38
STAT,1902,19,35-39,1921,0.7276330927493191
SIM,1876,23,20-24,1899,62
STAT,1912,32,na,1944,3515.817022237873
SIM,1765,90,na,1855,18
SIM,1868,37,50-100,1905,1
STAT,1871,76,na,1947,888.733125086817
STAT,1836,18,30-34,1854,2.435279973311519
SIM,1854,21,15-19,1875,2
SIM,1942,24,25-29,1966,92
SIM,1864,40,na,1904,2054
STAT,1913,16,40-44,1929,0.270836011145222
STAT,1863,58,na,1921,1639.4625091917992
SIM,1875,32,na,1907,2332
STAT,1862,18,40-44,1880,0.1682034783354772
STAT,1906,36,15-19,1942,0.01675686457835126
SIM,1879,31,25-29,1910,12
STAT,1945,26,50-100,1971,1.0320654293858107
SIM,1793,63,na,1856,832
SIM,1898,60,na,1958,2449
STAT,1847,37,45-49,1884,1.5252023680920712
STAT,1839,73,na,1912,790.8036303633147
STAT,1881,83,na,1964,590.5979624895541
STAT,1874,47,50-100,1921,0.23595368649192217
STAT,1846,31,20-24,1877,2.3939849918970553
STAT,1910,34,15-19,1944,0.1160545203740937
STAT,1891,50,na,1941,2552.816298972351
SIM,1848,25,na,1873,1889
STAT,1863,52,50-100,1915,0.012453787766965903
STAT,1855,33,50-100,1888,0.6561144099130857
STAT,1952,19,30-34,1971,13.789426110227192
SIM,1837,20,30-34,1857,16
STAT,1904,65,na,1969,2588.548370796863
STAT,1889,9,na,1898,3026.0034657393344
SIM,1909,36,40-44,1945,1
STAT,1882,68,na,1950,1403.978564593536
STAT,1881,43,na,1924,2094.01566118644
STAT,1874,20,50-100,1894,0.39595734028976964
STAT,1923,24,na,1947,3988.8523532999525
SIM,1849,21,40-44,1870,2
STAT,1901,15,50-100,1916,0.06508500695955291
SIM,1904,32,40-44,1936,8
STAT,1922,40,40-44,1962,0.2719674961869712
SIM,1758,97,na,1855,1
STAT,1907,47,20-24,1954,0.009349734974298092
STAT,1927,16,50-100,1943,0.44114837454088823
SIM,1902,34,30-34,1936,21
STAT,1916,21,50-100,1937,0.653323617154957
SIM,1951,17,30-34,1968,19
STAT,1823,89,na,1912,56.22266432218231
STAT,1921,46,na,1967,3922.186892412237
SIM,1889,24,na,1913,2822
SIM,1882,47,50-100,1929,2
STAT,1884,37,30-34,1921,4.974205353307599
STAT,1868,23,20-24,1891,61.92180153835761
STAT,1810,44,20-24,1854,0.5552635332149944
STAT,1936,32,15-19,1968,0.11791173174036193
SIM,1930,40,40-44,1970,2
STAT,1916,44,30-34,1960,0.12335560568084784
SIM,1806,78,na,1884,317
SIM,1859,17,na,1876,2160
STAT,1930,31,35-39,1961,11.147408529174172
STAT,1897,67,na,1964,2213.004530792178
SIM,1854,31,20-24,1885,2
SIM,1892,37,30-34,1929,6
STAT,1906,21,45-49,1927,0.9623440624590422
STAT,1839,84,na,1923,221.48656818014447
STAT,1879,40,15-19,1919,0.013793966012017558
SIM,1816,45,na,1861,1396
STAT,1933,1,na,1934,5281.105560263441
STAT,1945,21,30-34,1966,29.767659073067
STAT,1828,81,na,1909,304.547883608762
STAT,1943,17,30-34,1960,12.21045943422273
STAT,1840,45,45-49,1885,0.16023450349386395
SIM,1921,16,40-44,1937,1
STAT,1861,21,45-49,1882,0.5667811619846224
SIM,1914,21,45-49,1935,5
STAT,1917,36,25-29,1953,0.9707806733031131
SIM,1807,71,na,1878,570
SIM,1911,36,na,1947,3426
STAT,1939,28,25-29,1967,62.48009487305913
STAT,1907,37,50-100,1944,0.36774434968894204
STAT,1894,26,50-100,1920,0.779283350902806
STAT,1950,7,na,1957,4390.668092569849
SIM,1883,20,30-34,1903,22
SIM,1853,20,15-19,1873,2
STAT,1885,27,50-100,1912,0.6023622247984675
STAT,1921,44,35-39,1965,0.21354653572974377
SIM,1935,26,40-44,1961,5
STAT,1907,37,15-19,1944,0.016819910011869586
SIM,1873,48,50-100,1921,4
STAT,1834,42,50-100,1876,0.7903923431046931
SIM,1847,23,30-34,1870,15
SIM,1925,36,25-29,1961,1
STAT,1876,45,25-29,1921,0.0567783440297482
STAT,1971,1,na,1972,4710.77578404591
SIM,1922,28,na,1950,3931
STAT,1887,22,15-19,1909,3.486026892976475
STAT,1928,16,na,1944,4392.009613285062
STAT,1810,71,na,1881,614.1331378739811
STAT,1855,43,30-34,1898,0.8110832008086661
STAT,1932,26,15-19,1958,0.8738981345409051
STAT,1898,22,25-29,1920,73.18391232295012
SIM,1851,36,30-34,1887,3
STAT,1917,27,30-34,1944,38.81929397886681
SIM,1895,24,na,1919,2988
STAT,1920,42,30-34,1962,0.13338726418495303
SIM,1878,83,na,1961,503
STAT,1904,41,35-39,1945,0.17116475876759452
STAT,1775,103,na,1878,0.04766916194631313
STAT,1843,36,30-34,1879,4.2463660563688395
SIM,1884,9,na,1893,2531
STAT,1939,19,na,1958,3478.2757388788805
SIM,1876,26,25-29,1902,48
STAT,1842,39,20-24,1881,0.583667217464713
STAT,1908,34,25-29,1942,8.171448657576715
STAT,1800,64,na,1864,839.1245595271661
STAT,1929,39,20-24,1968,0.31902142367465997
SIM,1862,14,na,1876,2331
STAT,1844,51,na,1895,1502.581007335681
STAT,1939,31,50-100,1970,0.7974048490904414
STAT,1833,46,15-19,1879,2.9118878260655243E-4
STAT,1946,22,30-34,1968,30.21495451459444
STAT,1845,36,na,1881,1769.9506010846176
STAT,1904,23,35-39,1927,7.882970730988965
SIM,1848,20,40-44,1868,2
STAT,1874,50,45-49,1924,0.014209018498758282
SIM,1851,22,na,1873,1905
STAT,1845,20,15-19,1865,2.9401813558621805
STAT,1809,54,25-29,1863,0.009145258143344912
STAT,1846,21,15-19,1867,3.0409691091581865
STAT,1940,18,20-24,1958,129.9999712034036
STAT,1843,107,na,1950,0.0031853754009895873
SIM,1929,38,na,1967,4524
STAT,1854,53,25-29,1907,0.002493566956210523
STAT,1941,19,20-24,1960,131.833315245877
SIM,1839,31,25-29,1870,10
STAT,1905,24,35-39,1929,7.918432283764029
STAT,1886,75,na,1961,1208.1904438181161
STAT,1870,91,na,1961,104.85356335229295
STAT,1810,48,40-44,1858,0.561980262449403
STAT,1865,32,35-39,1897,8.671464125312086
SIM,1805,93,na,1898,5
SIM,1916,34,25-29,1950,10
STAT,1927,40,20-24,1967,0.020981436836298918
SIM,1934,29,30-34,1963,60
STAT,1901,32,15-19,1933,0.18831162538856505
STAT,1815,63,na,1878,958.2256362732455
SIM,1885,19,30-34,1904,4
STAT,1887,32,20-24,1919,2.856279733969111
STAT,1926,29,30-34,1955,44.05466765254724
STAT,1927,16,35-39,1943,4.940862710282184
SIM,1895,32,20-24,1927,4
STAT,1866,33,35-39,1899,8.786691535521303
SIM,1838,30,25-29,1868,11
STAT,1883,31,50-100,1914,0.8521069545533335
SIM,1813,71,na,1884,603
STAT,1843,54,30-34,1897,0.003910065234428047
SIM,1919,25,45-49,1944,3
SIM,1913,24,35-39,1937,9
STAT,1967,3,na,1970,4641.0807476424825
SIM,1935,16,35-39,1951,5
SIM,1853,77,na,1930,643
STAT,1867,30,45-49,1897,1.55934065203624
STAT,1862,93,na,1955,23.605892154640465
STAT,1826,29,25-29,1855,84.23773160303926
SIM,1848,43,35-39,1891,1
SIM,1944,16,40-44,1960,1
SIM,1848,41,40-44,1889,4
STAT,1853,54,20-24,1907,5.430974032162054E-4
STAT,1813,52,25-29,1865,0.009260335903544423
SIM,1851,76,na,1927,646
SIM,1877,81,na,1958,673
STAT,1834,100,na,1934,0.658187986955189
STAT,1948,15,20-24,1963,146.65578242233812
SIM,1860,26,30-34,1886,23
SIM,1839,42,na,1881,1647
STAT,1944,24,20-24,1968,113.34051844920218
STAT,1835,29,35-39,1864,7.889272316642586
SIM,1845,17,35-39,1862,2
SIM,1876,35,25-29,1911,4
SIM,1896,38,45-49,1934,2
STAT,1843,28,15-19,1871,0.3744358725038381
SIM,1860,9,na,1869,2357
STAT,1831,52,45-49,1883,0.009094568778362786
STAT,1927,25,30-34,1952,45.30471464975544
SIM,1804,74,na,1878,421
SIM,1815,41,45-49,1856,1
STAT,1836,38,50-100,1874,0.9658010341821704
SIM,1893,32,20-24,1925,3
STAT,1878,19,45-49,1897,0.0639664631575631
STAT,1815,40,25-29,1855,1.8077619767010715
STAT,1845,23,20-24,1868,60.10327809166335
STAT,1846,55,na,1901,1533.6310240084954
STAT,1911,15,25-29,1926,8.230543883945293
STAT,1852,26,30-34,1878,21.417914418175588
STAT,1857,47,15-19,1904,2.9663474212037274E-4
STAT,1816,59,na,1875,1118.968690980547
STAT,1792,104,na,1896,0.012159018775615715
STAT,1868,35,25-29,1903,2.619788047002367
STAT,1888,38,45-49,1926,2.2145855776379433
STAT,1820,48,30-34,1868,0.15998622716845728
STAT,1831,36,40-44,1867,3.3966137415846624
STAT,1877,47,na,1924,2194.4185227701846
SIM,1884,20,45-49,1904,1
SIM,1800,84,na,1884,81
STAT,1882,31,25-29,1913,9.44849332660807
SIM,1904,28,50-100,1932,4
STAT,1942,27,20-24,1969,18.09910056944689
STAT,1871,54,40-44,1925,0.009604121237984578
SIM,1834,29,25-29,1863,35
STAT,1865,107,na,1972,0.07337788386427727
STAT,1843,35,20-24,1878,0.6205881362074468
STAT,1859,42,20-24,1901,0.11926300005950016
STAT,1902,24,15-19,1926,4.370828030341231
SIM,1830,29,na,1859,1739
SIM,1890,31,25-29,1921,18
STAT,1931,27,45-49,1958,2.1070309178704347
STAT,1939,30,na,1969,3649.625961332756
SIM,1882,32,45-49,1914,1
STAT,1833,24,40-44,1857,1.6945058484844908
STAT,1850,36,50-100,1886,0.888346313537973
STAT,1916,37,20-24,1953,0.2550212498611229
SIM,1939,18,25-29,1957,43
SIM,1851,26,20-24,1877,11
SIM,1884,69,na,1953,1405
SIM,1797,87,na,1884,43
SIM,1935,25,30-34,1960,54
SIM,1864,36,45-49,1900,2
STAT,1942,28,na,1970,3712.5933942765305
STAT,1801,71,na,1872,585.1866083862816
STAT,1843,26,20-24,1869,9.822384847438109
STAT,1900,36,15-19,1936,0.015960378772708173
STAT,1850,48,50-100,1898,0.17095380872620247
STAT,1835,91,na,1926,36.88239352496645
SIM,1837,49,50-100,1886,2
SIM,1895,22,15-19,1917,4
SIM,1956,15,20-24,1971,167
STAT,1820,64,na,1884,924.4701408994835
STAT,1851,20,40-44,1871,1.8160512621285774
SIM,1857,67,na,1924,1198
SIM,1857,34,45-49,1891,2
SIM,1918,28,35-39,1946,19
SIM,1841,24,40-44,1865,2
STAT,1874,32,45-49,1906,1.6831779886682696
SIM,1843,29,35-39,1872,12
SIM,1909,19,25-29,1928,6
STAT,1837,17,35-39,1854,0.67271671749183
SIM,1791,82,na,1873,146
SIM,1922,18,15-19,1940,38
STAT,1915,26,na,1941,3622.1289373860577
STAT,1834,23,45-49,1857,0.5746171104659347
SIM,1881,33,40-44,1914,5
SIM,1837,37,50-100,1874,1
STAT,1839,30,50-100,1869,0.7664715740930272
SIM,1836,85,na,1921,159
STAT,1816,47,50-100,1863,0.580009635426717
STAT,1937,15,45-49,1952,0.46122881419840356
STAT,1927,31,na,1958,4397.539541042195
SIM,1905,50,na,1955,2928
SIM,1799,88,na,1887,42
SIM,1860,43,50-100,1903,1
SIM,1886,38,50-100,1924,3
SIM,1880,28,40-44,1908,3
STAT,1876,54,50-100,1930,0.014335005922719638
SIM,1907,51,na,1958,3074
STAT,1914,18,15-19,1932,8.845657085264312
SIM,1872,33,30-34,1905,21
SIM,1909,32,na,1941,3452
STAT,1893,29,25-29,1922,50.31606499829489
SIM,1879,17,na,1896,2534
SIM,1938,19,20-24,1957,111
STAT,1857,40,30-34,1897,0.8652160845660164
STAT,1872,37,40-44,1909,4.148022107185746
SIM,1882,25,40-44,1907,2
STAT,1770,104,na,1874,0.02370478119235837
STAT,1833,31,45-49,1864,1.3919288551935713
STAT,1851,22,35-39,1873,5.0128862769046805
STAT,1861,19,35-39,1880,0.48957072870799273
STAT,1796,85,na,1881,88.27684421247221
STAT,1841,46,na,1887,1578.1890038607564
SIM,1941,24,45-49,1965,1
STAT,1826,38,25-29,1864,3.041239248323243
STAT,1864,29,na,1893,1995.0237738385567
STAT,1801,53,45-49,1854,0.039735410463206534
STAT,1861,24,15-19,1885,2.624093689620443
STAT,1933,24,45-49,1957,1.4089811100942529
SIM,1839,18,20-24,1857,11
STAT,1950,21,40-44,1971,3.769547033239361
SIM,1942,20,45-49,1962,2
STAT,1847,46,45-49,1893,0.17452220716834355
SIM,1834,38,25-29,1872,2
STAT,1914,49,20-24,1963,0.010293465068684728
STAT,1943,26,25-29,1969,66.25199365522589
SIM,1783,87,na,1870,34
STAT,1898,41,30-34,1939,0.10252485036372923
SIM,1862,39,45-49,1901,1
STAT,1945,23,25-29,1968,95.60500125913228
SIM,1820,84,na,1904,143
SIM,1889,42,40-44,1931,7
SIM,1835,34,25-29,1869,8
SIM,1917,36,35-39,1953,7
STAT,1872,28,40-44,1900,2.828536604586334
STAT,1862,6,na,1868,2307.8545962496914
STAT,1879,47,35-39,1926,0.13779682264063298
STAT,1833,82,na,1915,286.2605036315815
STAT,1905,37,45-49,1942,0.5875402743583777
STAT,1919,19,45-49,1938,0.518706395216359
STAT,1936,16,40-44,1952,1.268133984538583
STAT,1884,27,20-24,1911,10.949206522133895
SIM,1853,23,20-24,1876,59
SIM,1852,31,20-24,1883,2
SIM,1872,9,na,1881,2559
STAT,1920,15,35-39,1935,0.8964273859945374
SIM,1893,0,na,1893,3423
SIM,1874,30,30-34,1904,25
STAT,1880,43,25-29,1923,0.6349266347660902
SIM,1793,97,na,1890,1
STAT,1845,16,50-100,1861,0.04407702308024358
STAT,1813,110,na,1923,1.1372601700311184E-4
STAT,1910,41,25-29,1951,0.06412452381832248
SIM,1826,75,na,1901,528
STAT,1898,0,na,1898,3753.87015406328
SIM,1841,31,45-49,1872,2
SIM,1942,28,40-44,1970,5
STAT,1865,50,35-39,1915,0.007477579878855007
STAT,1934,28,40-44,1962,5.920606307242755
SIM,1844,49,na,1893,1470
SIM,1888,53,na,1941,2417
STAT,1866,83,na,1949,345.9032321777004
SIM,1919,24,35-39,1943,12
STAT,1842,52,20-24,1894,5.315433284889782E-4
SIM,1900,20,40-44,1920,3
STAT,1862,47,25-29,1909,0.046307687163091055
SIM,1880,37,40-44,1917,6
STAT,1812,53,20-24,1865,0.002313827307123494
STAT,1892,46,25-29,1938,0.03855437166595651
STAT,1894,25,25-29,1919,51.70443343588743
STAT,1899,70,na,1969,2149.441437531225
SIM,1932,38,25-29,1970,1
STAT,1934,35,15-19,1969,0.025077732806404195
STAT,1874,19,na,1893,2424.7008577790093
STAT,1825,30,40-44,1855,9.552649788182638
STAT,1902,17,40-44,1919,0.243852107153787
SIM,1894,24,20-24,1918,84
STAT,1813,82,na,1895,192.02044137384456
STAT,1833,37,na,1870,1642.6497145019189
SIM,1799,82,na,1881,153
STAT,1871,38,35-39,1909,6.602002546193843
STAT,1943,21,50-100,1964,0.6615612350032595
SIM,1915,31,40-44,1946,12
STAT,1868,23,50-100,1891,0.36642291319644466
STAT,1917,35,15-19,1952,0.019021929692175858
SIM,1802,93,na,1895,13
STAT,1839,45,40-44,1884,0.11914987339149136
STAT,1825,32,35-39,1857,17.715097527387123
STAT,1926,33,30-34,1959,17.985443555952862
STAT,1861,30,50-100,1891,0.7254841455602805
STAT,1934,20,45-49,1954,1.4331382273463347
SIM,1837,61,na,1898,1188
STAT,1809,77,na,1886,356.3287718511437
STAT,1837,72,na,1909,819.598494132726
SIM,1877,24,20-24,1901,53
SIM,1827,33,20-24,1860,1
STAT,1875,66,na,1941,1591.5028991463334
STAT,1889,43,45-49,1932,1.7328550451196174
STAT,1947,2,na,1949,4288.782454939696
STAT,1876,42,50-100,1918,1.0298326563881102
SIM,1891,46,50-100,1937,2
SIM,1919,2,na,1921,4311
SIM,1934,33,30-34,1967,26
SIM,1806,55,na,1861,1137
STAT,1892,21,40-44,1913,2.4731115257492804
STAT,1850,24,50-100,1874,0.3400889883911315
STAT,1910,19,25-29,1929,8.068574643073358
SIM,1860,59,na,1919,1610
STAT,1867,39,25-29,1906,2.5283670270262686
SIM,1837,22,25-29,1859,63
STAT,1844,74,na,1918,770.7744511635017
STAT,1890,23,30-34,1913,20.50900886853663
SIM,1965,6,na,1971,4597
SIM,1926,34,20-24,1960,1
STAT,1892,23,35-39,1915,6.883497682653795
SIM,1864,37,50-100,1901,2
SIM,1874,39,na,1913,2174
STAT,1810,44,25-29,1854,2.2451959969221154
STAT,1844,34,25-29,1878,8.331990833227886
STAT,1902,53,na,1955,2824.65656450645
SIM,1942,2,na,1944,3912
SIM,1877,48,50-100,1925,1
SIM,1833,30,40-44,1863,3
SIM,1861,52,na,1913,1857
STAT,1865,39,20-24,1904,0.6534087038829236
STAT,1928,23,25-29,1951,108.61019313416385
STAT,1907,31,40-44,1938,3.4697619536856332
STAT,1920,48,35-39,1968,0.13426267660070568
STAT,1849,49,15-19,1898,2.9368428512919933E-4
SIM,1936,24,35-39,1960,12
STAT,1835,110,na,1945,1.7588255491102954E-4
STAT,1851,49,50-100,1900,0.17298188260235514
SIM,1875,39,25-29,1914,2
STAT,1849,34,45-49,1883,1.3496016803222013
STAT,1879,54,40-44,1933,0.010124228225944007
SIM,1852,24,15-19,1876,2
STAT,1924,31,40-44,1955,4.315488516985609
SIM,1856,35,40-44,1891,8
SIM,1944,27,50-100,1971,5
SIM,1949,15,na,1964,3994
STAT,1879,28,na,1907,2351.6617707770897
STAT,1903,22,50-100,1925,0.5481323961195487
STAT,1768,110,na,1878,0.0013330028926806633
SIM,1863,37,40-44,1900,7
SIM,1897,43,45-49,1940,1
STAT,1818,109,na,1927,3.4939697551494495E-4
SIM,1898,17,15-19,1915,6
STAT,1816,109,na,1925,3.3154145066310994E-4
SIM,1883,21,40-44,1904,4
STAT,1851,22,na,1873,1836.728302099194
STAT,1821,47,35-39,1868,0.22084216540974877
STAT,1854,5,na,1859,2152.180293473391
SIM,1889,44,35-39,1933,1
STAT,1886,24,20-24,1910,68.33799096062585
SIM,1886,15,30-34,1901,2
STAT,1948,13,na,1961,4246.213862752806
STAT,1824,74,na,1898,611.9228409261311
SIM,1836,99,na,1935,1
SIM,1861,24,25-29,1885,55
SIM,1936,23,25-29,1959,77
STAT,1928,24,35-39,1952,11.036254812125451
SIM,1837,23,35-39,1860,8
STAT,1915,20,na,1935,3597.4102797910964
STAT,1864,74,na,1938,934.4106637273817
STAT,1844,24,15-19,1868,2.819842106917003
STAT,1865,36,50-100,1901,1.0563344479661696
STAT,1872,53,45-49,1925,0.013530836262811154
STAT,1911,16,na,1927,3660.2770676766863
SIM,1932,31,40-44,1963,3
STAT,1861,46,na,1907,1772.2384712521343
SIM,1836,24,30-34,1860,18
STAT,1953,15,30-34,1968,13.936152934216949
STAT,1870,24,25-29,1894,52.72089551810317
SIM,1902,25,35-39,1927,19
SIM,1837,47,na,1884,1525
STAT,1834,21,50-100,1855,0.34091132253182294
STAT,1838,46,35-39,1884,0.09794472433119716
STAT,1855,53,45-49,1908,0.010147323774242618
STAT,1895,15,30-34,1910,1.9721279536960532
STAT,1827,53,50-100,1880,0.013075504101115448
STAT,1853,24,25-29,1877,50.45582803101202
SIM,1919,28,50-100,1947,2
STAT,1918,34,20-24,1952,2.427659016761548
STAT,1808,51,50-100,1859,0.05566898496039269
STAT,1904,68,na,1972,2442.682134398923
STAT,1880,29,45-49,1909,1.0978863012046518
STAT,1908,38,40-44,1946,1.3175316613180816
STAT,1871,16,25-29,1887,5.3818313744207
STAT,1908,30,45-49,1938,1.4144971936543254
SIM,1906,41,40-44,1947,3
SIM,1916,38,40-44,1954,3
SIM,1955,15,na,1970,4320
SIM,1892,44,na,1936,3028
STAT,1840,50,30-34,1890,0.003962542882463619
STAT,1943,25,15-19,1968,0.7108822146321772
STAT,1885,32,20-24,1917,2.545317886732129
STAT,1923,32,35-39,1955,9.89673669747536
SIM,1861,15,25-29,1876,6
SIM,1901,19,25-29,1920,7
STAT,1919,33,25-29,1952,9.380483146154804
SIM,1871,96,na,1967,33
STAT,1891,40,35-39,1931,2.1378008653657736
SIM,1882,68,na,1950,1411
SIM,1931,32,35-39,1963,9
STAT,1885,25,15-19,1910,0.4301245215310931
SIM,1901,26,30-34,1927,50
STAT,1794,84,na,1878,109.36270167182039
SIM,1847,8,na,1855,2288
STAT,1818,41,20-24,1859,0.3873520861179749
SIM,1868,34,20-24,1902,1
SIM,1828,32,25-29,1860,9
SIM,1780,90,na,1870,14
SIM,1912,38,na,1950,3416
STAT,1899,47,20-24,1946,0.008720963260079552
SIM,1787,77,na,1864,290
SIM,1898,35,45-49,1933,3
SIM,1939,15,20-24,1954,111
STAT,1850,24,40-44,1874,1.737854604243166
SIM,1776,85,na,1861,75
SIM,1901,66,na,1967,2438
STAT,1903,48,35-39,1951,0.10481615588511733
SIM,1817,39,35-39,1856,10
STAT,1889,36,40-44,1925,5.129855954652159
SIM,1911,20,15-19,1931,3
STAT,1810,54,na,1864,1103.8132599025373
STAT,1870,20,50-100,1890,0.3801792755994736
STAT,1868,29,30-34,1897,22.535283431648427
STAT,1849,16,15-19,1865,5.510211253782965
STAT,1823,32,30-34,1855,45.765772842472394
STAT,1925,36,na,1961,4269.509050653928
STAT,1862,48,35-39,1910,0.11165973337992606
STAT,1892,38,na,1930,2773.883677575278
STAT,1895,66,na,1961,2160.6843523414345
STAT,1847,17,na,1864,2112.626085422962
STAT,1861,49,30-34,1910,0.07444759949470542
SIM,1878,23,25-29,1901,54
STAT,1774,84,na,1858,78.93252295621731
STAT,1835,34,15-19,1869,0.11302128310885712
SIM,1916,30,45-49,1946,2
STAT,1858,39,15-19,1897,0.04117403211079
SIM,1857,16,15-19,1873,6
SIM,1831,32,30-34,1863,22
STAT,1911,36,na,1947,3449.4734776396003
SIM,1811,56,na,1867,1045
SIM,1833,32,35-39,1865,10
SIM,1815,48,50-100,1863,1
STAT,1899,38,20-24,1937,0.21429575649043808
SIM,1927,33,25-29,1960,10
STAT,1838,53,40-44,1891,0.006954431865127105
SIM,1874,31,40-44,1905,5
STAT,1856,22,50-100,1878,0.34908772359276175
STAT,1903,20,15-19,1923,4.460848673665094
SIM,1862,68,na,1930,1303
STAT,1869,28,35-39,1897,8.799513808221663
STAT,1824,54,na,1878,1272.8647596915102
STAT,1888,7,na,1895,2908.745260461194
STAT,1948,17,15-19,1965,49.066386270056256
SIM,1897,36,40-44,1933,8
SIM,1893,35,25-29,1928,7
STAT,1831,56,na,1887,1204.2251206714882
STAT,1895,32,na,1927,2938.97758644427
STAT,1905,28,15-19,1933,0.6173475353253792
STAT,1831,39,45-49,1870,1.4918196216445683
SIM,1911,23,20-24,1934,88
STAT,1881,43,45-49,1924,1.355977006383037
STAT,1916,45,50-100,1961,0.22018910250600876
SIM,1879,38,45-49,1917,2
STAT,1837,18,45-49,1855,0.06368598607586859
STAT,1856,41,25-29,1897,0.47546135230926373
SIM,1933,30,45-49,1963,1
STAT,1952,16,25-29,1968,49.072535080249516
STAT,1839,15,45-49,1854,0.05756951362944819
STAT,1849,97,na,1946,4.028472590662953
SIM,1820,39,na,1859,1551
SIM,1859,38,50-100,1897,3
SIM,1860,25,20-24,1885,12
STAT,1824,38,20-24,1862,1.1491353747287698
STAT,1888,44,40-44,1932,2.477303513315559
STAT,1929,16,35-39,1945,5.071222225166111
SIM,1909,16,20-24,1925,24
STAT,1848,42,45-49,1890,1.110721329397881
STAT,1843,29,25-29,1872,34.66025162603101
STAT,1893,17,20-24,1910,21.23927092765845
STAT,1891,29,20-24,1920,13.613501492867112
STAT,1851,56,na,1907,1467.196369367491
STAT,1860,35,20-24,1895,0.596474629194209
STAT,1889,19,20-24,1908,20.565104899215847
SIM,1855,80,na,1935,456
SIM,1872,36,35-39,1908,13
SIM,1937,16,35-39,1953,4
STAT,1894,19,30-34,1913,1.924659142451776
SIM,1851,29,25-29,1880,30
SIM,1819,42,na,1861,1461
STAT,1953,18,35-39,1971,4.793615018523346
STAT,1863,43,25-29,1906,0.5285136406233226
STAT,1879,44,30-34,1923,1.1215304059734192
STAT,1842,93,na,1935,21.16451252998712
STAT,1887,37,na,1924,2489.524083225186
SIM,1820,39,40-44,1859,3
STAT,1839,22,na,1861,1829.1079708074553
SIM,1874,33,35-39,1907,12
SIM,1887,44,30-34,1931,3
SIM,1853,26,25-29,1879,40
SIM,1908,13,na,1921,3583
STAT,1866,55,na,1921,1801.6429117042076
STAT,1885,35,25-29,1920,2.7369258914824663
SIM,1901,29,35-39,1930,13
SIM,1935,15,na,1950,4705
STAT,1903,15,35-39,1918,0.7409753884300528
SIM,1900,27,25-29,1927,59
STAT,1847,31,na,1878,1896.0149194629169
STAT,1911,25,35-39,1936,13.926039301076951
STAT,1897,37,45-49,1934,2.5185359807723313
STAT,1925,30,45-49,1955,1.7672167290720981
SIM,1811,76,na,1887,343
SIM,1897,19,20-24,1916,18
STAT,1881,51,30-34,1932,0.005458327021950786
STAT,1908,37,30-34,1945,1.6120811216024364
STAT,1818,44,25-29,1862,1.4155877701969055
STAT,1901,26,20-24,1927,15.566225370959003
SIM,1876,29,30-34,1905,32
STAT,1845,26,25-29,1871,36.69815310736069
STAT,1870,39,30-34,1909,4.889535040085433
SIM,1880,4,na,1884,2763
STAT,1848,18,20-24,1866,16.23410488054374
STAT,1883,22,45-49,1905,0.6458685621975843
SIM,1941,21,40-44,1962,2
STAT,1898,44,35-39,1942,0.15858703243126304
STAT,1935,34,20-24,1969,3.183801780016893
SIM,1914,32,35-39,1946,10
SIM,1918,43,na,1961,3726
SIM,1854,38,40-44,1892,2
SIM,1918,23,na,1941,3707
STAT,1876,7,na,1883,2628.6925315345293
SIM,1920,39,45-49,1959,1
SIM,1835,38,na,1873,1610
STAT,1803,52,na,1855,1142.9613711883956
STAT,1868,103,na,1971,1.373117134613964
SIM,1916,37,30-34,1953,2
SIM,1916,42,na,1958,3506
STAT,1926,26,25-29,1952,74.79306936460198
SIM,1849,9,na,1858,2271
STAT,1825,52,20-24,1877,7.254336411535958E-4
STAT,1921,20,50-100,1941,0.7062798847455942
STAT,1934,0,na,1934,5756.623752972259
STAT,1908,45,15-19,1953,3.1935289119612483E-4
STAT,1912,39,45-49,1951,0.6222647621884403
SIM,1893,20,na,1913,2991
STAT,1916,33,50-100,1949,0.8029920333368074
SIM,1839,20,35-39,1859,5
STAT,1893,26,20-24,1919,14.102834791615503
STAT,1918,31,15-19,1949,0.12953020269585128
STAT,1910,47,50-100,1957,0.1993610698917387
SIM,1875,37,30-34,1912,5
STAT,1858,37,20-24,1895,0.5709534898697571
SIM,1824,31,45-49,1855,1
STAT,1838,43,30-34,1881,0.8109627402849716
STAT,1832,32,40-44,1864,3.4230353273086833
SIM,1900,23,45-49,1923,4
STAT,1805,49,45-49,1854,0.8769043465200743
STAT,1892,43,20-24,1935,0.186558109537092
SIM,1918,25,30-34,1943,57
STAT,1763,98,na,1861,0.28999897887402765
STAT,1822,42,25-29,1864,0.934625684273177
SIM,1943,10,na,1953,3834
SIM,1846,43,30-34,1889,4
SIM,1914,33,na,1947,3583
STAT,1918,35,30-34,1953,1.8320423955900131
SIM,1875,43,50-100,1918,1
STAT,1903,23,20-24,1926,92.34266055212733
STAT,1842,73,na,1915,860.1494402251645
SIM,1883,28,25-29,1911,47
SIM,1848,40,30-34,1888,5
SIM,1856,18,20-24,1874,13
SIM,1891,22,45-49,1913,4
STAT,1826,35,20-24,1861,0.896944184253998
STAT,1807,110,na,1917,1.027834535564931E-4
STAT,1819,36,25-29,1855,8.854959076795062
SIM,1877,25,30-34,1902,28
SIM,1840,32,40-44,1872,1
SIM,1917,33,30-34,1950,23
STAT,1814,52,45-49,1866,0.04239896062040162
STAT,1948,18,25-29,1966,46.837060250956796
SIM,1929,32,na,1961,4513
SIM,1830,42,25-29,1872,1
STAT,1855,46,na,1901,1603.3361574625221
SIM,1852,34,25-29,1886,9
STAT,1857,92,na,1949,31.03135358820332
STAT,1898,48,15-19,1946,2.848293747941148E-4
SIM,1840,47,50-100,1887,1
STAT,1909,44,50-100,1953,0.10253514968025194
SIM,1871,7,na,1878,2582
STAT,1846,47,40-44,1893,0.12638770582536513
STAT,1878,32,15-19,1910,0.1402032885119661
STAT,1817,39,25-29,1856,8.490081415453313
SIM,1825,39,25-29,1864,1
STAT,1868,64,na,1932,1566.855647814002
STAT,1876,20,45-49,1896,0.6846499841241054
STAT,1887,49,50-100,1936,0.14333528117742247
SIM,1834,26,20-24,1860,10
STAT,1941,31,40-44,1972,3.8836983156909906
STAT,1842,54,45-49,1896,0.010220625253333006
SIM,1861,18,30-34,1879,1
SIM,1901,12,na,1913,3406
SIM,1888,20,15-19,1908,4
STAT,1863,8,na,1871,2323.0099971104446
SIM,1867,100,na,1967,4
STAT,1834,45,20-24,1879,0.008904277662267162
STAT,1817,48,25-29,1865,0.1278305101785005
STAT,1844,31,20-24,1875,2.2684157519696297
STAT,1848,50,30-34,1898,0.004486651328559281
STAT,1882,14,na,1896,2364.9098299951042
SIM,1948,23,15-19,1971,4
STAT,1846,38,40-44,1884,3.35555749770788
STAT,1846,22,50-100,1868,0.3731934856028049
STAT,1931,18,15-19,1949,55.96898516000143
STAT,1933,21,40-44,1954,4.226048856922907
SIM,1834,35,20-24,1869,3
STAT,1878,16,40-44,1894,0.1805140882140168
STAT,1924,38,25-29,1962,1.0956836782070738
SIM,1909,38,35-39,1947,7
SIM,1936,21,30-34,1957,25
STAT,1822,73,na,1895,603.5417650330623
STAT,1887,39,40-44,1926,4.579083496647855
STAT,1932,15,50-100,1947,0.4708360353158317
STAT,1853,18,30-34,1871,1.442474749093796
STAT,1892,20,30-34,1912,21.202143334437277
SIM,1831,35,35-39,1866,12
SIM,1909,18,na,1927,3587
SIM,1871,21,15-19,1892,6
STAT,1907,34,45-49,1941,1.3776389044745356
SIM,1922,42,na,1964,4019
STAT,1830,53,40-44,1883,0.006801887100151032
SIM,1827,36,25-29,1863,2
STAT,1811,81,na,1892,234.52561310671555
STAT,1779,93,na,1872,5.543312029800947
STAT,1863,22,25-29,1885,48.40338073488203
STAT,1876,19,50-100,1895,0.04755987966217034
SIM,1899,31,45-49,1930,4
STAT,1867,36,20-24,1903,0.6870943134221381
STAT,1886,27,25-29,1913,42.21302740491524
STAT,1930,34,35-39,1964,11.126575843663407
SIM,1817,92,na,1909,11
SIM,1878,30,50-100,1908,5
SIM,1802,65,na,1867,777
STAT,1926,36,35-39,1962,2.795008849375214
SIM,1820,50,na,1870,1367
STAT,1867,37,30-34,1904,4.727751493726643
STAT,1951,20,45-49,1971,1.2708258006218476
SIM,1885,16,25-29,1901,5
STAT,1839,48,45-49,1887,0.1580555132488725
STAT,1866,31,40-44,1897,3.794115590916948
STAT,1917,21,na,1938,3677.641323783724
SIM,1823,35,45-49,1858,3
SIM,1871,22,25-29,1893,58
SIM,1934,26,25-29,1960,82
SIM,1890,26,45-49,1916,2
STAT,1928,21,30-34,1949,34.00174618686158
SIM,1936,20,20-24,1956,89
SIM,1894,27,25-29,1921,59
STAT,1823,35,35-39,1858,12.758998102669558
STAT,1837,41,na,1878,1630.818594303748
STAT,1936,30,20-24,1966,2.240629248416003
STAT,1873,33,40-44,1906,4.1375364358654725
SIM,1864,63,na,1927,1594
STAT,1840,42,45-49,1882,1.0245585777646256
SIM,1895,39,40-44,1934,8
SIM,1899,30,35-39,1929,15
STAT,1821,46,25-29,1867,0.0921986088855804
SIM,1871,11,na,1882,2520
STAT,1891,76,na,1967,1456.786336731039
STAT,1839,20,25-29,1859,49.68289015358784
SIM,1926,26,35-39,1952,19
SIM,1949,15,15-19,1964,43
SIM,1859,48,na,1907,1775
SIM,1899,17,na,1916,3360
STAT,1854,39,45-49,1893,1.411954707616501
SIM,1902,28,na,1930,3155
STAT,1882,26,45-49,1908,1.023553088098013
STAT,1841,30,25-29,1871,8.747340524179894
STAT,1842,36,15-19,1878,0.048202380024177184
STAT,1875,24,45-49,1899,0.6728706555457878
STAT,1877,25,25-29,1902,41.733856314898446
STAT,1897,28,45-49,1925,1.397799766383626
STAT,1958,0,na,1958,4913.628978386273
STAT,1874,64,na,1938,1677.904221017737
STAT,1899,40,35-39,1939,0.16440914310667812
SIM,1875,27,20-24,1902,10
STAT,1916,47,30-34,1963,0.0863780859356779
STAT,1947,21,35-39,1968,10.056817133525294
SIM,1857,61,na,1918,1438
SIM,1897,32,50-100,1929,1
SIM,1813,57,na,1870,1107
SIM,1838,37,45-49,1875,2
SIM,1885,25,25-29,1910,47
STAT,1890,35,50-100,1925,1.4314678503350808
SIM,1864,94,na,1958,22
STAT,1889,32,50-100,1921,1.0685758323282761
SIM,1901,16,20-24,1917,29
SIM,1934,36,35-39,1970,4
STAT,1839,49,20-24,1888,0.007934413855276677
STAT,1857,17,50-100,1874,0.04290235746281579
STAT,1863,107,na,1970,0.055230586226380704
STAT,1863,21,15-19,1884,2.8096256407311495
SIM,1814,42,40-44,1856,4
STAT,1890,26,35-39,1916,11.182426418283281
STAT,1852,111,na,1963,2.8404510889419035E-4
STAT,1910,22,15-19,1932,4.722643880479046
SIM,1915,34,45-49,1949,2
SIM,1828,56,na,1884,1260
STAT,1831,27,40-44,1858,2.576664824499933
STAT,1883,37,15-19,1920,0.052011105767659195
STAT,1887,20,20-24,1907,73.25322844727476
SIM,1829,41,50-100,1870,1
SIM,1890,16,35-39,1906,3
STAT,1853,28,40-44,1881,2.3727320287999967
SIM,1935,28,35-39,1963,19
STAT,1872,50,40-44,1922,0.010119117116532952
STAT,1898,31,50-100,1929,1.176133141754194
SIM,1929,21,25-29,1950,103
STAT,1904,44,35-39,1948,0.16809377138505383
STAT,1817,38,15-19,1855,0.18368532714916946
SIM,1851,38,25-29,1889,5
STAT,1850,28,20-24,1878,9.661996657661977
SIM,1839,28,na,1867,1820
SIM,1925,25,na,1950,4171
SIM,1884,49,na,1933,2161
STAT,1924,37,15-19,1961,0.02139132498978296
STAT,1943,29,30-34,1972,39.38283286280201
STAT,1847,21,30-34,1868,16.218564082381743
STAT,1870,21,20-24,1891,64.058246761771
STAT,1928,20,20-24,1948,131.93315531504092
STAT,1843,38,25-29,1881,2.0446465228796296
STAT,1835,19,25-29,1854,9.460563303806959
SIM,1918,26,40-44,1944,8
STAT,1814,44,na,1858,1442.1543935409538
STAT,1884,29,15-19,1913,0.420423503116825
SIM,1809,66,na,1875,806
SIM,1855,21,30-34,1876,21
SIM,1902,22,30-34,1924,33
STAT,1933,17,na,1950,4654.713568410197
STAT,1859,45,25-29,1904,0.0437406647480403
SIM,1875,86,na,1961,314
SIM,1834,36,30-34,1870,4
STAT,1796,65,na,1861,790.5049794962712
STAT,1875,46,20-24,1921,0.011685259205919885
STAT,1874,6,na,1880,2637.0301968551785
SIM,1861,28,40-44,1889,6
SIM,1827,71,na,1898,744
SIM,1889,41,30-34,1930,1
STAT,1864,36,35-39,1900,5.983863001077542
STAT,1918,26,35-39,1944,15.14604508253937
SIM,1791,101,na,1892,1
STAT,1827,28,30-34,1855,46.370560032474046
STAT,1844,49,30-34,1893,0.06582618401605447
SIM,1873,77,na,1950,740
SIM,1843,19,25-29,1862,5
STAT,1887,48,40-44,1935,0.17863128237328096
STAT,1935,26,na,1961,4826.221945010575
SIM,1872,92,na,1964,81
STAT,1897,42,25-29,1939,0.05626827294449008
STAT,1927,28,35-39,1955,17.181700101572172
SIM,1868,37,25-29,1905,5
SIM,1886,10,na,1896,2556
SIM,1895,20,20-24,1915,82
STAT,1837,31,15-19,1868,0.11708929763650192
SIM,1867,77,na,1944,728
STAT,1816,46,15-19,1862,9.597817557633649E-4
STAT,1934,27,30-34,1961,49.79486933776143
SIM,1858,30,45-49,1888,1
STAT,1838,26,na,1864,1860.7672975095527
STAT,1764,94,na,1858,2.528069756936244
STAT,1853,3,na,1856,2572.1102884
SIM,1835,28,30-34,1863,23
SIM,1942,27,30-34,1969,42
STAT,1853,19,40-44,1872,0.16455492475258784
STAT,1841,16,45-49,1857,0.05842631111700917
STAT,1875,12,na,1887,2529.076779827981
STAT,1920,45,30-34,1965,0.09352998899715632
STAT,1944,21,15-19,1965,5.43139537221281
STAT,1893,46,50-100,1939,0.1664446067787347
SIM,1873,20,na,1893,2280
STAT,1907,16,15-19,1923,8.255766975551278
STAT,1920,27,na,1947,3882.1250200951927
SIM,1900,19,na,1919,3337
STAT,1826,36,30-34,1862,6.007639621310718
STAT,1841,25,45-49,1866,0.9645345129817937
STAT,1864,33,30-34,1897,14.638552893915746
STAT,1871,35,30-34,1906,5.047010423036596
SIM,1915,16,15-19,1931,9
SIM,1893,17,30-34,1910,2
STAT,1893,27,30-34,1920,30.168612326650113
SIM,1844,43,na,1887,1547
SIM,1860,87,na,1947,121
SIM,1865,11,na,1876,2422
STAT,1866,53,20-24,1919,6.326414017474803E-4
STAT,1894,19,na,1913,3049.76731019448
STAT,1828,98,na,1926,1.8295142037434862
SIM,1908,28,40-44,1936,5
STAT,1917,39,30-34,1956,1.7775061293433996
SIM,1855,35,na,1890,1903
SIM,1893,74,na,1967,1782
SIM,1874,34,45-49,1908,2
SIM,1929,31,35-39,1960,18
STAT,1884,40,na,1924,2178.8941487019624
STAT,1841,22,40-44,1863,1.8198895288110088
SIM,1867,32,45-49,1899,1
SIM,1782,88,na,1870,27
SIM,1830,28,45-49,1858,2
SIM,1851,45,na,1896,1713
SIM,1932,16,15-19,1948,48
STAT,1892,45,45-49,1937,0.15908899805364995
STAT,1897,20,15-19,1917,4.192797068956845
STAT,1938,29,20-24,1967,17.067462640892106
SIM,1875,15,20-24,1890,17
STAT,1924,16,15-19,1940,51.179210793635136
STAT,1903,24,30-34,1927,23.792536752570854
STAT,1818,38,30-34,1856,15.327202809954754
STAT,1906,39,20-24,1945,0.2266201763259701
STAT,1878,23,na,1901,2321.2441958742315
SIM,1869,1,na,1870,3112
STAT,1866,34,45-49,1900,1.5064207043277027
SIM,1857,4,na,1861,2367
STAT,1839,41,25-29,1880,0.5015671159071431
SIM,1845,90,na,1935,44
SIM,1863,28,40-44,1891,2
SIM,1891,33,35-39,1924,10
SIM,1927,37,na,1964,4380
SIM,1943,16,25-29,1959,58
STAT,1825,54,45-49,1879,0.013710992496691199
STAT,1921,29,45-49,1950,1.8059360917225966
STAT,1820,95,na,1915,7.004191750315021
STAT,1935,16,25-29,1951,56.10256361398228
SIM,1824,42,35-39,1866,1
STAT,1837,53,25-29,1890,0.0022618965294924974
STAT,1927,42,15-19,1969,0.001819422571304258
STAT,1829,38,40-44,1867,3.8978432916490817
SIM,1925,39,30-34,1964,1
STAT,1901,29,25-29,1930,55.53714690105646
STAT,1830,34,30-34,1864,14.491127152454203
SIM,1840,22,30-34,1862,16
STAT,1949,17,30-34,1966,13.392423509643017
SIM,1780,76,na,1856,302
STAT,1863,26,50-100,1889,0.5341512579430631
STAT,1803,54,50-100,1857,0.04227206864824879
STAT,1860,17,25-29,1877,5.009565535970726
STAT,1829,49,50-100,1878,0.19555101160345859
SIM,1941,28,25-29,1969,71
STAT,1855,28,40-44,1883,2.2029122331871673
STAT,1833,49,20-24,1882,0.007649722125959629
STAT,1859,32,45-49,1891,1.3111633775479137
STAT,1933,28,25-29,1961,82.52256198793086
STAT,1785,76,na,1861,367.69125844041224
SIM,1865,32,45-49,1897,1
STAT,1827,110,na,1937,1.596216453248243E-4
SIM,1844,15,25-29,1859,5
SIM,1879,44,40-44,1923,2
STAT,1800,95,na,1895,5.285415734133619
SIM,1862,82,na,1944,350
STAT,1881,40,40-44,1921,2.0734162747580647
STAT,1888,30,na,1918,2685.6078754478335
STAT,1923,17,45-49,1940,0.554132810267923
STAT,1828,41,15-19,1869,0.01190570020183817
STAT,1856,15,45-49,1871,0.057608218220882836
SIM,1852,28,30-34,1880,23
STAT,1920,41,na,1961,3880.497425975318
STAT,1844,28,30-34,1872,21.256285812201256
SIM,1847,20,25-29,1867,50
STAT,1920,23,20-24,1943,116.41880182647688
STAT,1824,37,45-49,1861,3.1270680123699037
STAT,1832,22,30-34,1854,25.679658348277254
STAT,1841,34,40-44,1875,3.552943424820074
STAT,1922,28,15-19,1950,0.7519924129124819
SIM,1845,28,na,1873,1839
SIM,1798,86,na,1884,58
SIM,1867,20,45-49,1887,2
STAT,1895,32,15-19,1927,0.17538910586942488
STAT,1857,32,45-49,1889,1.3072751939495868
STAT,1887,25,50-100,1912,0.6805387896843935
STAT,1852,4,na,1856,2337.14934856
SIM,1848,7,na,1855,2278
STAT,1909,26,25-29,1935,60.137500771956795
SIM,1821,37,35-39,1858,12
STAT,1946,23,40-44,1969,3.533595961580277
SIM,1903,39,45-49,1942,4
SIM,1866,75,na,1941,862
STAT,1869,50,50-100,1919,0.014020503189513003
STAT,1877,92,na,1969,147.88642730938693
SIM,1919,49,50-100,1968,2
STAT,1851,38,15-19,1889,0.04040522305859128
SIM,1837,38,40-44,1875,8
SIM,1906,0,na,1906,3713
SIM,1829,43,30-34,1872,2
SIM,1874,70,na,1944,1321
SIM,1884,15,na,1899,2490
STAT,1820,92,na,1912,21.941231198422827
STAT,1921,22,25-29,1943,98.55949777024676
SIM,1896,22,30-34,1918,36
STAT,1801,54,25-29,1855,0.009505269880086296
SIM,1905,27,45-49,1932,2
STAT,1853,21,20-24,1874,62.06625667938528
SIM,1920,17,35-39,1937,4
STAT,1912,17,35-39,1929,0.8016094172386669
STAT,1880,28,35-39,1908,9.57587805489874
STAT,1869,42,15-19,1911,0.012623050155495377
SIM,1902,33,20-24,1935,2
STAT,1813,68,na,1881,744.1555357925271
SIM,1882,21,25-29,1903,65
STAT,1896,29,40-44,1925,3.7108086990709803
SIM,1876,82,na,1958,464
SIM,1861,21,20-24,1882,57
STAT,1856,27,45-49,1883,0.8480288239613947
STAT,1867,15,20-24,1882,16.26837125592673
STAT,1873,26,35-39,1899,9.27650361316111
SIM,1857,1,na,1858,2837
STAT,1878,38,50-100,1916,1.2027427014742205
SIM,1848,56,na,1904,1445
SIM,1864,27,45-49,1891,1
STAT,1869,49,35-39,1918,0.12545133908298703
SIM,1835,38,40-44,1873,7
STAT,1888,33,na,1921,2652.949822524681
STAT,1886,46,30-34,1932,0.09687198475367416
STAT,1894,29,40-44,1923,3.610770125190101
STAT,1869,27,50-100,1896,0.5854397251009478
STAT,1906,15,na,1921,3491.1364058150857
STAT,1871,17,35-39,1888,0.5180531563364317
STAT,1888,22,30-34,1910,19.886491721267742
SIM,1868,53,na,1921,1916
STAT,1808,61,na,1869,994.0589185509289
STAT,1874,29,20-24,1903,11.242540356276962
SIM,1863,21,20-24,1884,57
SIM,1884,17,20-24,1901,19
STAT,1916,22,na,1938,3614.9546055628434
STAT,1906,18,20-24,1924,24.3288448436944
SIM,1880,33,25-29,1913,15
SIM,1921,12,na,1933,4293
SIM,1896,34,30-34,1930,31
STAT,1926,18,40-44,1944,1.6157605162397888
STAT,1826,86,na,1912,121.16278849700774
SIM,1892,39,25-29,1931,8
STAT,1836,36,25-29,1872,2.3124421649752205
STAT,1970,2,na,1972,4653.041969805332
SIM,1823,32,40-44,1855,5
SIM,1922,24,40-44,1946,4
STAT,1886,52,na,1938,2137.2885189827653
STAT,1892,24,45-49,1916,0.8199406624650761
STAT,1907,62,na,1969,2814.6482608695414
STAT,1851,26,15-19,1877,0.3848948060496552
STAT,1825,33,45-49,1858,2.7675103519063606
STAT,1910,29,35-39,1939,13.59855458134294
SIM,1869,100,na,1969,10
SIM,1922,26,50-100,1948,2
STAT,1867,27,20-24,1894,10.406712995015122
SIM,1858,63,na,1921,1451
STAT,1882,23,40-44,1905,1.9085116142162764
SIM,1883,30,na,1913,2236
SIM,1890,23,40-44,1913,3
STAT,1875,21,40-44,1896,2.0295178050639002
SIM,1858,46,na,1904,1849
SIM,1897,21,35-39,1918,10
STAT,1832,26,50-100,1858,0.5314564081567947
STAT,1857,43,35-39,1900,1.339420632372485
STAT,1888,34,30-34,1922,19.32598016437569
SIM,1934,18,40-44,1952,5
STAT,1855,21,20-24,1876,57.62408668470735
SIM,1882,29,20-24,1911,14
STAT,1909,33,30-34,1942,14.143809899547929
SIM,1833,33,45-49,1866,3
STAT,1872,33,25-29,1905,9.664701032470315
SIM,1914,18,20-24,1932,28
STAT,1783,98,na,1881,0.49540742237693114
STAT,1901,36,50-100,1937,0.3521038449007545
STAT,1838,24,25-29,1862,49.14916762283697
SIM,1865,43,35-39,1908,2
STAT,1889,21,35-39,1910,6.826203884699382
STAT,1914,24,40-44,1938,3.224939521450854
STAT,1827,38,40-44,1865,4.437275070974377
STAT,1865,31,25-29,1896,8.806237064022042
STAT,1900,19,30-34,1919,2.0775713688899073
SIM,1829,31,30-34,1860,19
STAT,1884,39,25-29,1923,2.66016875414215
STAT,1845,45,30-34,1890,0.06918137216776371
SIM,1876,39,40-44,1915,7
SIM,1899,28,20-24,1927,13
SIM,1881,23,30-34,1904,18
STAT,1842,32,35-39,1874,8.859462626322609
STAT,1880,67,na,1947,1578.7737022254923
STAT,1870,18,30-34,1888,1.4824244926748338
STAT,1878,54,25-29,1932,0.0033912893750078998
STAT,1917,20,45-49,1937,1.1364651626399702
SIM,1824,40,na,1864,1526
STAT,1912,31,15-19,1943,0.11994672797645549
SIM,1846,24,25-29,1870,42
STAT,1953,14,na,1967,4487.234071713303
SIM,1940,22,35-39,1962,9
SIM,1926,35,30-34,1961,1
STAT,1851,53,na,1904,1523.9973147099477
STAT,1882,50,35-39,1932,0.008022934548649526
SIM,1871,29,45-49,1900,1
STAT,1827,31,20-24,1858,3.384879696337442
SIM,1844,33,20-24,1877,1
STAT,1826,106,na,1932,0.0066303691399213745
SIM,1809,83,na,1892,168
STAT,1871,22,na,1893,2218.5865849030065
SIM,1838,22,40-44,1860,5
SIM,1866,41,na,1907,2073
STAT,1951,17,20-24,1968,152.5160423725249
SIM,1864,33,40-44,1897,4
SIM,1928,26,35-39,1954,20
STAT,1911,19,40-44,1930,0.2630078302370723
STAT,1881,18,40-44,1899,0.1664811934348573
STAT,1906,20,35-39,1926,8.076965184416448
SIM,1878,20,20-24,1898,73
SIM,1923,22,35-39,1945,9
SIM,1865,40,50-100,1905,3
STAT,1865,38,45-49,1903,1.698488748103223
STAT,1898,43,50-100,1941,0.09311015641440386
STAT,1894,22,20-24,1916,83.66317632074048
STAT,1926,44,20-24,1970,0.020498492470335618
SIM,1888,33,50-100,1921,1
STAT,1935,29,na,1964,4819.27551641911
SIM,1857,16,na,1873,2157
SIM,1902,32,50-100,1934,1
SIM,1919,21,30-34,1940,36
STAT,1879,70,na,1949,1387.4624720824609
SIM,1885,22,20-24,1907,57
STAT,1868,39,40-44,1907,3.905916654054015
SIM,1905,20,25-29,1925,88
STAT,1933,14,na,1947,4994.495638872218
STAT,1925,33,15-19,1958,0.14406575803492846
STAT,1851,44,45-49,1895,1.0620655292019965
SIM,1858,37,30-34,1895,6
SIM,1925,20,45-49,1945,1
STAT,1907,38,25-29,1945,0.8581250362575817
STAT,1922,22,na,1944,3956.167700776259
SIM,1830,49,45-49,1879,3
SIM,1817,61,na,1878,1041
STAT,1881,36,50-100,1917,1.1258387946856305
STAT,1840,16,na,1856,1961.9356732041858
STAT,1863,47,40-44,1910,0.14126608580561892
SIM,1850,32,35-39,1882,8
SIM,1918,3,na,1921,4172
STAT,1799,90,na,1889,30.219804873618102
STAT,1821,43,20-24,1864,0.2653475237725655
STAT,1861,42,50-100,1903,0.8288077191221467
SIM,1835,31,20-24,1866,2
SIM,1912,52,na,1964,3247
STAT,1831,32,25-29,1863,8.174724268991861
STAT,1939,27,15-19,1966,0.6704500800991774
STAT,1822,49,45-49,1871,0.3084083467736384
STAT,1936,33,25-29,1969,8.475487258915122
SIM,1914,20,35-39,1934,10
STAT,1847,43,40-44,1890,1.646650703564291
SIM,1918,29,45-49,1947,1
SIM,1928,27,50-100,1955,1
STAT,1891,22,na,1913,2764.224434882365
STAT,1906,12,na,1918,3553.2841368870986
STAT,1842,21,45-49,1863,0.641544853367816
SIM,1910,28,30-34,1938,43
SIM,1909,25,50-100,1934,4
STAT,1833,68,na,1901,937.5890964752862
STAT,1906,32,35-39,1938,8.000827867327782
STAT,1932,36,50-100,1968,0.5333992032591802
STAT,1836,54,20-24,1890,4.647249051059213E-4
SIM,1827,34,50-100,1861,3
SIM,1859,26,25-29,1885,37
STAT,1902,28,30-34,1930,33.45512234684142
SIM,1855,43,40-44,1898,3
SIM,1849,25,20-24,1874,13
STAT,1880,81,na,1961,733.2623714093407
STAT,1816,42,35-39,1858,4.88470699504041
SIM,1843,16,20-24,1859,13
SIM,1877,67,na,1944,1501
SIM,1907,29,35-39,1936,16
STAT,1897,34,40-44,1931,5.432022794502713
SIM,1860,16,20-24,1876,12
SIM,1835,80,na,1915,367
STAT,1839,53,na,1892,1410.5576729377947
SIM,1913,37,na,1950,3377
SIM,1943,23,30-34,1966,31
STAT,1833,42,35-39,1875,1.3462609468645745
SIM,1879,23,40-44,1902,2
SIM,1874,16,15-19,1890,8
STAT,1802,76,na,1878,382.1229270492209
STAT,1877,34,20-24,1911,2.62614277826902
STAT,1841,25,50-100,1866,0.555708953878319
SIM,1869,33,25-29,1902,20
SIM,1889,33,45-49,1922,3
SIM,1885,34,20-24,1919,1
STAT,1834,98,na,1932,2.013997810617096
STAT,1931,36,na,1967,4711.1871386224575
SIM,1784,83,na,1867,94
STAT,1884,74,na,1958,1127.2187183509009
SIM,1839,42,45-49,1881,2
STAT,1866,52,40-44,1918,0.009124133043039578
SIM,1887,25,25-29,1912,50
STAT,1880,21,15-19,1901,3.2955325925804013
STAT,1858,49,25-29,1907,0.041772476350196076
STAT,1835,60,na,1895,1213.8740532163183
STAT,1879,25,25-29,1904,42.1145346936465
SIM,1923,44,na,1967,4159
STAT,1872,37,50-100,1909,1.1633811201551096
STAT,1851,23,45-49,1874,0.594723199874091
STAT,1872,25,50-100,1897,0.6102703335252541
STAT,1935,23,30-34,1958,36.961415615575326
SIM,1870,26,25-29,1896,50
STAT,1859,39,30-34,1898,3.96692773908228
STAT,1790,104,na,1894,0.013236074648619346
STAT,1929,23,40-44,1952,4.004261964661664
SIM,1928,33,40-44,1961,11
SIM,1853,23,na,1876,1888
STAT,1826,39,35-39,1865,7.235642172093975
STAT,1894,15,15-19,1909,7.238312919079177
STAT,1909,23,20-24,1932,97.33219264258199
SIM,1819,76,na,1895,497
SIM,1869,30,20-24,1899,4
STAT,1932,22,35-39,1954,11.671121857383541
STAT,1789,83,na,1872,119.69064866990462
SIM,1835,24,15-19,1859,2
STAT,1852,16,20-24,1868,15.637249210355877
SIM,1855,36,35-39,1891,13
SIM,1917,23,20-24,1940,115
STAT,1868,32,20-24,1900,2.4363806839761764
STAT,1915,22,35-39,1937,9.195013085503843
STAT,1883,33,35-39,1916,9.340241056761808
STAT,1929,35,40-44,1964,1.8186713682659945
SIM,1937,23,40-44,1960,2
STAT,1887,37,50-100,1924,1.297336501478929
SIM,1870,8,na,1878,2485
SIM,1862,38,35-39,1900,9
SIM,1876,32,20-24,1908,2
SIM,1933,37,na,1970,4888
STAT,1862,26,25-29,1888,34.54160836075217
SIM,1822,62,na,1884,1006
STAT,1872,38,na,1910,2221.3973300990388
SIM,1834,39,35-39,1873,10
STAT,1875,8,na,1883,2601.551661163285
SIM,1848,44,45-49,1892,4
STAT,1887,44,25-29,1931,0.6693980059943726
STAT,1823,48,50-100,1871,0.29820492528429154
STAT,1905,27,50-100,1932,0.8734963707720999
STAT,1909,44,20-24,1953,0.015413780964715204
STAT,1946,16,35-39,1962,4.398005116612444
STAT,1826,80,na,1906,337.80485237777634
STAT,1882,17,45-49,1899,0.06001278887412267
STAT,1872,16,40-44,1888,0.1749151255693888
STAT,1901,17,25-29,1918,7.493352117614841
STAT,1897,46,40-44,1943,0.1223525705024579
STAT,1898,33,45-49,1931,2.21992868194248
SIM,1841,42,35-39,1883,1
STAT,1847,36,35-39,1883,5.4679251083789975
STAT,1860,67,na,1927,1215.0848059068353
SIM,1838,43,40-44,1881,5
SIM,1938,22,45-49,1960,3
STAT,1944,25,30-34,1969,40.04126836719866
SIM,1908,21,20-24,1929,103
SIM,1954,16,35-39,1970,6
SIM,1815,83,na,1898,197
STAT,1814,100,na,1914,0.4879596896502868
SIM,1933,27,20-24,1960,29
STAT,1852,37,20-24,1889,0.5618872258087467
SIM,1843,26,30-34,1869,25
STAT,1946,0,na,1946,4659.789553058538
SIM,1902,15,25-29,1917,9
STAT,1852,29,35-39,1881,7.308373167697146
STAT,1897,49,45-49,1946,0.16467448180106734
SIM,1925,28,40-44,1953,5
STAT,1865,17,45-49,1882,0.05763840273549904
STAT,1873,85,na,1958,335.3003350994091
STAT,1923,39,20-24,1962,0.2879305573244631
STAT,1860,28,15-19,1888,0.34896987986826555
SIM,1828,38,50-100,1866,3
STAT,1850,49,20-24,1899,0.00828246177695011
SIM,1896,37,35-39,1933,17
STAT,1903,27,35-39,1930,12.969628886092005
SIM,1784,80,na,1864,183
STAT,1832,25,35-39,1857,8.147823713246824
SIM,1846,75,na,1921,706
STAT,1844,38,40-44,1882,3.179551881153842
STAT,1863,29,45-49,1892,0.9138817845528094
SIM,1875,89,na,1964,207
STAT,1861,54,50-100,1915,0.01153679045688971
STAT,1846,26,40-44,1872,2.707292706262981
SIM,1933,19,35-39,1952,7
STAT,1804,54,na,1858,1115.7218799263558
STAT,1854,17,35-39,1871,0.4696351008234689
STAT,1905,15,35-39,1920,0.7527404269138116
STAT,1879,32,30-34,1911,17.26544652949059
STAT,1917,28,40-44,1945,4.601573006742693
SIM,1897,36,na,1933,3049
SIM,1887,32,30-34,1919,27
SIM,1929,29,20-24,1958,20
STAT,1882,48,na,1930,2040.9918196946826
STAT,1898,23,35-39,1921,7.437140143083268
STAT,1936,19,45-49,1955,0.44937238197534884
SIM,1919,22,na,1941,3851
STAT,1838,48,50-100,1886,0.16747626023454004
SIM,1873,31,25-29,1904,8
SIM,1916,16,30-34,1932,7
SIM,1880,30,20-24,1910,2
STAT,1809,46,na,1855,1286.0838569515915
STAT,1866,16,15-19,1882,5.338955936368491
STAT,1873,23,30-34,1896,17.013471652294616
SIM,1905,24,40-44,1929,3
SIM,1911,27,35-39,1938,13
STAT,1837,51,35-39,1888,0.005719796073747581
STAT,1887,23,25-29,1910,60.30362322769763
STAT,1925,19,35-39,1944,4.762776538552579
STAT,1835,26,30-34,1861,21.03947022312833
SIM,1891,30,30-34,1921,27
SIM,1831,76,na,1907,538
SIM,1895,23,25-29,1918,72
STAT,1838,106,na,1944,0.008151325363585303
STAT,1875,49,25-29,1924,0.05476265963673393
SIM,1885,37,25-29,1922,2
SIM,1889,20,30-34,1909,26
STAT,1884,15,20-24,1899,16.62328264090151
STAT,1919,16,40-44,1935,0.293680081890445
SIM,1870,97,na,1967,17
SIM,1927,16,40-44,1943,1
STAT,1862,23,20-24,1885,56.57134558905534
SIM,1789,72,na,1861,444
STAT,1925,9,na,1934,4542.797604016565
SIM,1898,32,40-44,1930,8
SIM,1870,23,20-24,1893,53
STAT,1892,42,40-44,1934,2.6581796533351474
STAT,1918,23,30-34,1941,29.193637090351196
STAT,1831,87,na,1918,102.86942325162242
STAT,1880,25,30-34,1905,25.249679614553717
STAT,1819,53,na,1872,1291.9147874931004
STAT,1825,39,na,1864,1487.8901569898103
STAT,1812,53,50-100,1865,0.047356330344166433
STAT,1825,51,40-44,1876,0.010557229558532725
STAT,1877,37,25-29,1914,2.8214250799054783
STAT,1886,49,35-39,1935,0.13679046975832063
STAT,1883,30,30-34,1913,16.30141185129573
STAT,1921,26,40-44,1947,4.924275776773886
STAT,1838,21,20-24,1859,60.45891965903679
STAT,1846,86,na,1932,164.5664102254661
STAT,1885,1,na,1886,3115.3739025852838
SIM,1832,34,40-44,1866,4
SIM,1859,93,na,1952,17
STAT,1814,49,50-100,1863,0.7265462809154739
STAT,1910,26,30-34,1936,35.86783108850534
SIM,1899,38,30-34,1937,3
STAT,1856,45,na,1901,1674.840301650121
SIM,1920,9,na,1929,4282
STAT,1839,27,45-49,1866,0.9312737094180212
SIM,1868,56,na,1924,1839
STAT,1872,30,20-24,1902,2.581945541434879
SIM,1848,53,na,1901,1513
STAT,1879,73,na,1952,1174.53676616584
SIM,1899,14,na,1913,3417
STAT,1875,5,na,1880,2663.9539206129657
STAT,1891,21,25-29,1912,67.10959664247368
STAT,1822,46,40-44,1868,0.2335509780811888
STAT,1866,52,na,1918,1866.1134652314163
STAT,1889,80,na,1969,1135.0613364913852
SIM,1926,23,30-34,1949,34
STAT,1826,47,20-24,1873,0.011079464544998762
STAT,1946,26,45-49,1972,1.8188555568192353
STAT,1818,48,40-44,1866,0.35955698462660596
SIM,1903,36,40-44,1939,1
SIM,1922,27,45-49,1949,2
SIM,1881,36,45-49,1917,1
SIM,1840,25,35-39,1865,6
SIM,1865,40,30-34,1905,1
STAT,1834,20,40-44,1854,2.8345988334122385
STAT,1945,20,20-24,1965,115.20715037948169
STAT,1861,19,50-100,1880,0.04371166410733856
SIM,1897,33,na,1930,3065
STAT,1888,37,35-39,1925,7.896550554992485
STAT,1908,49,30-34,1957,0.07571741695502562
SIM,1817,95,na,1912,6
SIM,1892,18,25-29,1910,8
STAT,1877,16,25-29,1893,5.566661882326805
SIM,1866,25,20-24,1891,15
STAT,1938,31,35-39,1969,8.685656980238857
SIM,1907,2,na,1909,3676
STAT,1891,25,40-44,1916,3.5249118919425544
STAT,1884,18,25-29,1902,5.275018199906538
STAT,1923,37,50-100,1960,0.45956974778147947
SIM,1852,38,40-44,1890,4
SIM,1883,24,45-49,1907,2
SIM,1833,57,na,1890,1204
STAT,1929,40,na,1969,4556.107202014588
STAT,1862,44,20-24,1906,0.12654474107785885
STAT,1815,110,na,1925,1.2334606870081967E-4
SIM,1914,30,na,1944,3635
STAT,1824,34,40-44,1858,8.1585743247543
STAT,1893,38,20-24,1931,0.9189177343039158
STAT,1854,19,na,1873,1941.5725245817728
STAT,1914,27,45-49,1941,1.6453270147023316
SIM,1964,4,na,1968,4611
STAT,1848,39,20-24,1887,0.5781347507378144
STAT,1824,30,25-29,1854,35.364924309625685
STAT,1861,16,30-34,1877,1.447513637982829
STAT,1896,11,na,1907,3226.9672156336273
SIM,1847,27,45-49,1874,1
STAT,1858,25,20-24,1883,9.024288848997356
STAT,1836,33,20-24,1869,2.1897052575456257
STAT,1869,46,30-34,1915,0.08884186324125039
STAT,1904,34,na,1938,3233.171618719169
SIM,1790,69,na,1859,592
SIM,1856,82,na,1938,322
SIM,1854,22,25-29,1876,53
STAT,1837,39,45-49,1876,1.5428314208149616
SIM,1842,20,40-44,1862,3
SIM,1936,11,na,1947,2970
SIM,1839,32,35-39,1871,9
SIM,1858,3,na,1861,2541
SIM,1860,29,35-39,1889,9
STAT,1873,36,45-49,1909,1.9191813392789614
STAT,1852,31,50-100,1883,0.694946336660846
SIM,1904,23,na,1927,3234
SIM,1854,26,40-44,1880,2
STAT,1904,22,25-29,1926,77.57103237561235
STAT,1925,6,na,1931,4573.829919410376
STAT,1947,19,20-24,1966,144.1822890306786
STAT,1830,37,35-39,1867,5.747933375300161
SIM,1912,22,25-29,1934,85
STAT,1896,36,50-100,1932,1.5392095846269724
STAT,1919,33,na,1952,3838.462024838145
SIM,1832,30,25-29,1862,10
STAT,1914,41,na,1955,3481.6452269383153
SIM,1880,1,na,1881,3276
STAT,1925,27,20-24,1952,20.36705564424004
SIM,1844,36,25-29,1880,2
SIM,1928,23,30-34,1951,37
STAT,1905,39,50-100,1944,0.35821070091504575
STAT,1838,31,30-34,1869,14.717669122689161
STAT,1857,22,35-39,1879,5.019271925918716
SIM,1855,33,30-34,1888,19
SIM,1882,34,na,1916,2245
SIM,1895,55,na,1950,2634
STAT,1844,20,na,1864,1881.009111671576
STAT,1808,48,15-19,1856,0.001490915270580535
STAT,1840,61,na,1901,1226.306402034097
SIM,1908,24,25-29,1932,69
STAT,1857,41,na,1898,1729.8062974263185
STAT,1959,8,na,1967,4855.450343165647
STAT,1884,36,20-24,1920,0.7229119839709629
STAT,1909,36,35-39,1945,2.1733069496324635
SIM,1926,38,35-39,1964,7
STAT,1815,47,45-49,1862,0.5313172581710754
SIM,1871,42,na,1913,2194
SIM,1838,25,45-49,1863,5
STAT,1876,23,15-19,1899,3.2099139060016872
STAT,1924,34,45-49,1958,1.7320433145617131
STAT,1929,38,45-49,1967,0.8259440427812955
STAT,1785,79,na,1864,276.6888690679186
STAT,1845,48,35-39,1893,0.09782324443591602
STAT,1846,22,25-29,1868,52.38889603644657
STAT,1878,52,35-39,1930,0.008430675103900718
STAT,1910,16,20-24,1926,25.441212611958285
SIM,1867,39,30-34,1906,7
STAT,1827,34,25-29,1861,11.326647759358758
STAT,1792,72,na,1864,531.6713807012151
STAT,1816,79,na,1895,325.7842269160066
STAT,1851,41,40-44,1892,1.6253218097678666
SIM,1844,94,na,1938,9
STAT,1897,16,45-49,1913,0.08272999029560431
SIM,1864,49,na,1913,1968
SIM,1949,22,20-24,1971,106
STAT,1840,17,40-44,1857,0.15540815089624632
STAT,1847,33,30-34,1880,14.960642401275628
STAT,1869,18,na,1887,2329.612636921726
STAT,1878,26,50-100,1904,0.6319516087159612
STAT,1806,80,na,1886,268.92115100255995
SIM,1932,34,45-49,1966,2
STAT,1807,65,na,1872,866.0353725344884
STAT,1849,31,40-44,1880,3.8049752665595773
STAT,1868,22,45-49,1890,0.6285253008709996
STAT,1915,47,15-19,1962,3.5067060884701347E-4
STAT,1795,86,na,1881,75.07745709879107
SIM,1813,88,na,1901,59
STAT,1837,27,na,1864,1801.9250740050718
STAT,1848,20,35-39,1868,5.356286155370001
STAT,1912,42,50-100,1954,0.10704289907857384
SIM,1863,24,25-29,1887,54
STAT,1834,48,25-29,1882,0.037427375578261375
SIM,1859,103,na,1962,1
SIM,1877,27,50-100,1904,1
STAT,1877,22,50-100,1899,0.3996079518814004
SIM,1846,31,30-34,1877,19
STAT,1870,35,15-19,1905,0.052536121838733865
STAT,1943,18,40-44,1961,1.4007519347000792
STAT,1861,107,na,1968,0.03992992226650586
SIM,1884,27,30-34,1911,28
SIM,1917,26,25-29,1943,78
STAT,1938,21,25-29,1959,86.39209370358964
SIM,1877,28,35-39,1905,8
STAT,1892,27,15-19,1919,0.536843672302599
STAT,1843,27,na,1870,1798.2353956083682
STAT,1832,35,45-49,1867,1.5568772533361819
STAT,1855,24,25-29,1879,46.8446328771977
STAT,1859,20,45-49,1879,0.6064675694451946
STAT,1817,72,na,1889,604.3973993659744
STAT,1899,25,na,1924,3110.0797104924986
STAT,1817,45,20-24,1862,0.027915262074537817
SIM,1846,21,20-24,1867,61
SIM,1851,42,na,1893,1718
SIM,1828,36,40-44,1864,8
STAT,1859,35,15-19,1894,0.042623070970412416
STAT,1954,16,50-100,1970,0.4376347543121692
SIM,1831,23,35-39,1854,8
STAT,1903,43,50-100,1946,0.09789761174243072
STAT,1858,26,na,1884,1822.6254534371333
STAT,1853,34,na,1887,1821.5313595746757
SIM,1894,70,na,1964,2003
STAT,1855,60,na,1915,1355.292755934507
STAT,1887,27,40-44,1914,3.165365340377463
SIM,1853,57,na,1910,1526
STAT,1927,21,15-19,1948,6.214318020113225
STAT,1836,19,40-44,1855,0.22584666706898926
SIM,1895,27,40-44,1922,9
SIM,1930,2,na,1932,5001
SIM,1951,18,40-44,1969,2
STAT,1865,35,40-44,1900,3.7839057417749618
SIM,1935,21,15-19,1956,9
STAT,1918,38,35-39,1956,2.4060109904229985
SIM,1873,35,40-44,1908,5
STAT,1850,111,na,1961,1.819342069630526E-4
STAT,1871,50,25-29,1921,0.003370412256261663
STAT,1889,18,na,1907,2937.7832214567916
STAT,1899,29,25-29,1928,54.36372804183132
STAT,1836,79,na,1915,452.71718916214456
STAT,1889,44,50-100,1933,1.2154612209177362
STAT,1834,38,15-19,1872,0.04290024650470602
STAT,1935,26,35-39,1961,19.342193698221504
SIM,1933,37,30-34,1970,5
STAT,1829,37,50-100,1866,1.1139743471510617
SIM,1910,24,15-19,1934,4
STAT,1864,21,30-34,1885,15.348815516818533
STAT,1833,28,20-24,1861,9.419141019345242
STAT,1852,19,25-29,1871,4.9104729782794365
STAT,1876,27,30-34,1903,24.577654993438045
SIM,1893,29,30-34,1922,27
SIM,1920,19,na,1939,3949
STAT,1866,37,15-19,1903,0.04892866683252767
STAT,1841,37,45-49,1878,1.619235058472214
SIM,1927,30,20-24,1957,3
STAT,1855,50,40-44,1905,0.007588736992787105
STAT,1895,18,35-39,1913,0.6740188984673229
SIM,1879,48,na,1927,2259
STAT,1870,28,40-44,1898,2.766400523648536
SIM,1856,20,35-39,1876,5
STAT,1848,103,na,1951,0.10663998780836713
STAT,1822,40,35-39,1862,2.782211222664907
SIM,1841,28,20-24,1869,11
SIM,1860,19,25-29,1879,3
SIM,1834,50,na,1884,1393
STAT,1842,42,na,1884,1731.6851727267453
STAT,1903,45,30-34,1948,0.07412681445290828
SIM,1946,21,25-29,1967,110
STAT,1867,48,20-24,1915,0.010511183060473737
STAT,1869,25,30-34,1894,23.20256201547755
SIM,1888,28,45-49,1916,1
SIM,1857,31,40-44,1888,4
STAT,1815,91,na,1906,25.86554560730851
STAT,1908,16,30-34,1924,2.239122133650626
STAT,1952,20,50-100,1972,0.7478795128595465
STAT,1888,84,na,1972,770.3842870768391
SIM,1821,34,30-34,1855,22
SIM,1869,37,40-44,1906,3
STAT,1786,72,na,1858,486.82715763140703
SIM,1826,38,30-34,1864,6
STAT,1770,107,na,1877,0.00583381516050812
STAT,1825,36,15-19,1861,0.07348980614728803
STAT,1944,28,35-39,1972,15.321877690490695
SIM,1824,43,na,1867,1455
STAT,1850,20,25-29,1870,49.13779836585422
STAT,1925,37,30-34,1962,2.0664514271243872
STAT,1843,32,50-100,1875,0.7440066273891117
STAT,1843,17,25-29,1860,4.8913749647778895
STAT,1887,41,20-24,1928,0.16857456143800223
STAT,1914,38,50-100,1952,0.39406139728355444
STAT,1885,29,30-34,1914,23.542897207484934
SIM,1901,22,15-19,1923,7
STAT,1913,48,na,1961,3378.1767407113443
SIM,1835,35,na,1870,1681
SIM,1945,25,na,1970,3712
STAT,1875,39,15-19,1914,0.053978114379722705
STAT,1888,47,45-49,1935,0.262253413355096
SIM,1872,21,30-34,1893,19
STAT,1802,73,na,1875,507.80235720712244
SIM,1865,22,35-39,1887,9
STAT,1854,31,15-19,1885,0.1054311869032571
STAT,1860,38,25-29,1898,2.1959861088032624
SIM,1880,56,na,1936,2043
SIM,1881,26,35-39,1907,10
STAT,1828,27,35-39,1855,16.65978025677479
SIM,1851,17,25-29,1868,6
STAT,1870,18,50-100,1888,0.04556631735500246
STAT,1913,34,35-39,1947,8.515942188692168
SIM,1840,50,na,1890,1432
SIM,1921,34,35-39,1955,12
SIM,1930,26,na,1956,4497
STAT,1919,30,20-24,1949,2.50601612552197
SIM,1878,39,40-44,1917,4
STAT,1890,26,na,1916,2765.8118392551055
STAT,1879,22,20-24,1901,68.14571802840629
SIM,1830,40,35-39,1870,4
STAT,1940,17,45-49,1957,0.47915091512125774
SIM,1879,26,45-49,1905,1
SIM,1836,27,35-39,1863,7
SIM,1943,26,35-39,1969,19
SIM,1887,22,20-24,1909,72
STAT,1897,47,na,1944,2829.6837529215777
STAT,1858,46,20-24,1904,0.008913413210080375
STAT,1815,41,30-34,1856,3.045880362089852
STAT,1925,16,15-19,1941,51.91662898776537
STAT,1857,44,15-19,1901,0.010150280930170714
STAT,1921,43,na,1964,3945.4736923018318
SIM,1867,98,na,1965,9
SIM,1878,24,30-34,1902,20
STAT,1843,45,25-29,1888,0.03972942181832798
SIM,1883,28,30-34,1911,25
STAT,1927,24,25-29,1951,106.8350342249237
SIM,1863,84,na,1947,236
STAT,1924,23,45-49,1947,1.2503540256431047
STAT,1847,26,na,1873,1931.2287892647148
STAT,1856,51,45-49,1907,0.010747958214160157
STAT,1922,15,35-39,1937,4.608990167637506
SIM,1871,28,na,1899,2263
STAT,1833,32,35-39,1865,7.999959954386325
STAT,1944,21,20-24,1965,113.45506951035384
SIM,1822,86,na,1908,100
STAT,1863,49,45-49,1912,0.19156309831740598
STAT,1878,43,20-24,1921,0.155225229940441
SIM,1781,87,na,1868,45
STAT,1870,27,40-44,1897,2.7761726513813985
STAT,1904,42,50-100,1946,0.0992875102979683
STAT,1814,47,na,1861,1411.424759392032
SIM,1928,34,35-39,1962,8
STAT,1851,31,na,1882,1805.2967253952013
STAT,1889,29,50-100,1918,0.7407122406421849
SIM,1841,32,35-39,1873,11
SIM,1789,67,na,1856,645
SIM,1933,16,15-19,1949,50
STAT,1880,46,40-44,1926,0.17098814082707853
SIM,1888,44,na,1932,2574
STAT,1799,100,na,1899,0.3389323705969575
STAT,1823,83,na,1906,212.45995546515132
SIM,1926,35,na,1961,4306
STAT,1861,29,40-44,1890,2.3361597639017915
SIM,1932,23,45-49,1955,2
STAT,1868,95,na,1963,32.94944453422279
SIM,1804,73,na,1877,471
STAT,1888,28,40-44,1916,3.332619712465242
STAT,1864,81,na,1945,455.30845439703563
STAT,1845,53,35-39,1898,0.005994204676337655
STAT,1911,36,40-44,1947,1.3725528936685014
SIM,1827,29,30-34,1856,30
STAT,1820,45,30-34,1865,0.1672269667715271
STAT,1843,54,50-100,1897,0.009920578709657046
SIM,1883,13,na,1896,2403
SIM,1887,22,30-34,1909,22
STAT,1820,41,50-100,1861,2.0029391485134
STAT,1887,35,50-100,1922,1.309657463436213
STAT,1894,26,15-19,1920,0.5527075854701342
SIM,1851,99,na,1950,1
SIM,1922,21,na,1943,3938
STAT,1882,32,30-34,1914,16.040510617332703
STAT,1906,36,50-100,1942,0.36636594743032763
SIM,1884,30,na,1914,2354
STAT,1877,17,25-29,1894,5.553023560715103
SIM,1896,28,40-44,1924,4
STAT,1879,22,30-34,1901,17.61408933150902
SIM,1895,36,25-29,1931,3
STAT,1871,40,30-34,1911,1.089354094257252
STAT,1847,53,45-49,1900,0.010529734196407197
STAT,1941,20,40-44,1961,3.284819199880045
SIM,1842,90,na,1932,41
SIM,1829,37,40-44,1866,8
SIM,1853,19,30-34,1872,1
STAT,1918,31,20-24,1949,2.45862977386701
STAT,1829,43,25-29,1872,0.5392898899595814
STAT,1909,33,20-24,1942,2.189700334113766
STAT,1860,101,na,1961,1.1558140027185915
STAT,1832,48,50-100,1880,0.1732593279783192
SIM,1949,19,30-34,1968,15
STAT,1896,34,25-29,1930,12.67013490118048
SIM,1930,15,35-39,1945,6
SIM,1938,20,na,1958,3267
STAT,1876,29,50-100,1905,0.6198805459467758
STAT,1917,42,50-100,1959,0.11582113022053259
STAT,1864,50,40-44,1914,0.00899136298808421
SIM,1889,25,45-49,1914,2
STAT,1802,100,na,1902,0.37220708526826635
SIM,1875,43,45-49,1918,1
SIM,1919,36,35-39,1955,4
STAT,1877,22,20-24,1899,67.52974063137742
STAT,1934,18,na,1952,4690.915476459751
STAT,1874,49,20-24,1923,0.011340843713709131
SIM,1872,45,na,1917,2141
SIM,1927,18,40-44,1945,1
SIM,1821,42,35-39,1863,5
STAT,1871,53,50-100,1924,0.013939997015325462
STAT,1909,20,15-19,1929,4.701880797656693
STAT,1805,86,na,1891,77.45176008953082
STAT,1847,47,50-100,1894,0.18026288711082386
STAT,1826,32,na,1858,1593.8646201368174
STAT,1889,44,35-39,1933,2.0833640928567565
STAT,1860,47,50-100,1907,0.18737712254583616
SIM,1939,6,na,1945,3740
STAT,1852,48,30-34,1900,0.06929687248448588
STAT,1827,35,15-19,1862,0.06115490741114603
STAT,1847,27,40-44,1874,2.6550457695283103
STAT,1915,38,50-100,1953,0.3987022174386103
SIM,1880,64,na,1944,1703
STAT,1766,105,na,1871,0.016846414222257987
STAT,1861,27,15-19,1888,0.35896667088153905
STAT,1880,33,35-39,1913,10.043335596011556
STAT,1893,62,na,1955,2189.6724529416356
SIM,1968,2,na,1970,4587
STAT,1901,29,35-39,1930,12.667989523156486
SIM,1917,33,20-24,1950,2
STAT,1933,21,45-49,1954,1.4141964375234102
SIM,1818,81,na,1899,235
SIM,1941,21,45-49,1962,3
STAT,1792,105,na,1897,0.005344983063572912
STAT,1836,18,50-100,1854,0.07485490199367269
STAT,1871,48,40-44,1919,0.15858005841025516
STAT,1919,18,40-44,1937,1.4563833139011022
SIM,1873,35,35-39,1908,13
SIM,1890,32,30-34,1922,24
SIM,1855,27,40-44,1882,2
STAT,1865,35,35-39,1900,6.1138208942242755
SIM,1884,44,25-29,1928,2
SIM,1837,23,30-34,1860,21
SIM,1952,16,25-29,1968,54
STAT,1847,52,30-34,1899,0.004366085790986745
SIM,1823,41,30-34,1864,3
STAT,1815,50,45-49,1865,0.03263684553721538
SIM,1869,41,na,1910,2140
STAT,1909,18,50-100,1927,0.06922888494452543
STAT,1870,39,35-39,1909,6.488937541784596
SIM,1918,16,na,1934,3995
STAT,1898,22,40-44,1920,2.663982075986221
STAT,1922,20,30-34,1942,31.32255179292991
STAT,1834,101,na,1935,0.35376946110854446
STAT,1884,40,40-44,1924,2.1204783896996684
SIM,1842,47,na,1889,1513
STAT,1826,64,na,1890,949.2877925792319
SIM,1851,67,na,1918,1171
STAT,1822,40,50-100,1862,1.6231775622638727
STAT,1880,28,na,1908,2368.455280170586
SIM,1839,43,na,1882,1632
SIM,1956,4,na,1960,4792
STAT,1843,50,20-24,1893,5.055877931690985E-4
SIM,1863,33,25-29,1896,12
SIM,1793,72,na,1865,482
STAT,1845,53,50-100,1898,0.010515547600274086
STAT,1831,24,25-29,1855,58.12855564316288
STAT,1910,44,25-29,1954,0.06297402061325044
SIM,1890,41,45-49,1931,3
SIM,1797,86,na,1883,56
STAT,1882,41,45-49,1923,1.381207812802455
SIM,1843,39,40-44,1882,7
STAT,1868,38,40-44,1906,3.926057328147412
STAT,1913,44,50-100,1957,0.10787230393631551
STAT,1920,29,45-49,1949,1.7775232961840015
STAT,1835,39,40-44,1874,3.373676069914281
STAT,1801,72,na,1873,532.2681833899103
STAT,1858,30,50-100,1888,0.692887219185573
STAT,1889,57,na,1946,2343.7419268320277
SIM,1876,38,40-44,1914,5
STAT,1858,17,15-19,1875,5.134658626348836
SIM,1866,17,15-19,1883,3
STAT,1867,43,45-49,1910,1.3180461073590892
SIM,1917,20,15-19,1937,5
SIM,1876,59,na,1935,1839
SIM,1834,28,na,1862,1709
SIM,1840,19,20-24,1859,14
SIM,1935,24,25-29,1959,130
STAT,1928,33,30-34,1961,18.598578565614016
SIM,1892,40,40-44,1932,6
STAT,1885,43,na,1928,2160.642492564063
SIM,1839,31,40-44,1870,3
STAT,1866,102,na,1968,1.779905740166941
STAT,1874,36,15-19,1910,0.05446257286670747
SIM,1936,33,30-34,1969,12
STAT,1856,62,na,1918,1347.1800448169552
STAT,1916,49,50-100,1965,0.21787304979184619
SIM,1821,69,na,1890,771
STAT,1903,15,25-29,1918,7.652335239317454
STAT,1838,22,50-100,1860,0.3551975322654926
STAT,1903,6,na,1909,3511.405943998076
STAT,1848,31,40-44,1879,3.797153378455923
STAT,1818,100,na,1918,0.5213725139747618
STAT,1850,24,35-39,1874,4.8666728542655395
SIM,1912,59,na,1971,3091
STAT,1870,25,15-19,1895,0.42332658239928866
STAT,1890,40,40-44,1930,2.624049818037932
SIM,1822,32,25-29,1854,13
STAT,1838,29,40-44,1867,2.521637479021973
STAT,1776,88,na,1864,41.563415203231024
STAT,1921,11,na,1932,4273.033706266129
SIM,1835,37,40-44,1872,5
STAT,1814,79,na,1893,321.3269679594091
SIM,1945,26,35-39,1971,18
SIM,1859,63,na,1922,1405
STAT,1891,36,15-19,1927,0.06594829046909774
STAT,1837,42,20-24,1879,0.12162395397918489
STAT,1853,25,15-19,1878,0.4035416584039983
STAT,1809,49,40-44,1858,0.4664666683545408
STAT,1881,23,25-29,1904,52.08128729412655
STAT,1880,12,na,1892,2572.010867679778
STAT,1829,26,35-39,1855,17.188272236951917
STAT,1831,70,na,1901,819.2348290957839
STAT,1824,45,15-19,1869,5.016768826518807E-4
STAT,1913,56,na,1969,3261.361132175155
SIM,1877,60,na,1937,1820
STAT,1798,99,na,1897,0.5379500748688043
STAT,1794,85,na,1879,88.50723446300422
STAT,1862,15,na,1877,2148.7063054790065
STAT,1876,44,25-29,1920,0.6182884205293961
STAT,1866,29,na,1895,2064.5665117340527
SIM,1880,25,25-29,1905,40
SIM,1913,23,35-39,1936,9
STAT,1944,16,25-29,1960,44.068287910018476
STAT,1905,23,35-39,1928,7.943693228229798
SIM,1892,65,na,1957,2320
STAT,1834,27,30-34,1861,20.49243288279502
STAT,1858,53,20-24,1911,5.377875595760593E-4
STAT,1897,46,35-39,1943,0.10005467237059797
STAT,1818,37,15-19,1855,0.17836333150851733
STAT,1835,84,na,1919,211.7321316056107
STAT,1813,42,35-39,1855,5.922982031394561
SIM,1842,27,30-34,1869,22
STAT,1809,53,25-29,1862,0.009331100541755172
STAT,1839,98,na,1937,2.1628730070922777
SIM,1868,25,25-29,1893,40
STAT,1894,28,40-44,1922,3.6239613444840235
STAT,1849,22,45-49,1871,0.6322007611848691
STAT,1855,29,40-44,1884,2.1870953233528847
STAT,1896,37,50-100,1933,1.5318367707166094
STAT,1933,37,30-34,1970,2.345171080952663
STAT,1855,109,na,1964,0.002943504123101571
STAT,1830,42,35-39,1872,1.4086721567703913
SIM,1863,16,35-39,1879,2
SIM,1856,31,40-44,1887,4
STAT,1869,54,35-39,1923,0.00766225503360986
STAT,1818,47,40-44,1865,0.36502234524939453
SIM,1846,29,40-44,1875,2
STAT,1896,17,35-39,1913,0.6846164089575962
SIM,1867,41,45-49,1908,3
STAT,1871,51,na,1922,2029.4910728885143
STAT,1822,34,na,1856,1439.580376608902
STAT,1826,48,na,1874,1377.321102858697
STAT,1928,36,35-39,1964,2.8902924476102685
SIM,1906,33,45-49,1939,3
STAT,1875,53,20-24,1928,7.050258843894295E-4
SIM,1863,29,40-44,1892,3
STAT,1839,53,35-39,1892,0.005639864716914074
STAT,1844,27,15-19,1871,0.3857443588480043
STAT,1847,10,na,1857,2224.638586378527
STAT,1875,65,na,1940,1640.9783978412474
STAT,1823,51,50-100,1874,0.018260320854084258
SIM,1873,40,30-34,1913,1
STAT,1865,40,30-34,1905,0.9943551995305281
STAT,1900,42,15-19,1942,0.001255204108133585
SIM,1864,42,30-34,1906,1
SIM,1867,82,na,1949,370
STAT,1850,48,20-24,1898,0.008352792288015201
SIM,1904,22,30-34,1926,24
STAT,1893,78,na,1971,1382.2382346494542
STAT,1926,44,50-100,1970,0.1363595342685093
SIM,1837,26,35-39,1863,11
STAT,1874,30,30-34,1904,16.98799083620646
STAT,1937,31,30-34,1968,14.733921633563991
STAT,1824,34,35-39,1858,19.051838124063384
STAT,1874,21,40-44,1895,2.0174134700202186
STAT,1796,92,na,1888,11.485575879141647
STAT,1862,51,50-100,1913,0.012257137175370317
STAT,1867,30,na,1897,2133.859660279851
STAT,1929,15,45-49,1944,0.605035797752119
SIM,1878,44,25-29,1922,3
SIM,1854,32,na,1886,1932
STAT,1864,27,40-44,1891,2.522180277132947
STAT,1900,39,50-100,1939,0.3437851714367206
STAT,1857,21,40-44,1878,1.8053087751047334
STAT,1858,1,na,1859,2746.632382785156
STAT,1913,22,30-34,1935,26.311142350966904
SIM,1872,27,40-44,1899,3
STAT,1821,52,50-100,1873,0.022904603612833644
STAT,1885,28,15-19,1913,0.42572224372694945
STAT,1918,26,25-29,1944,66.40107565461729
STAT,1770,103,na,1873,0.03782657729324584
SIM,1779,89,na,1868,38
SIM,1921,22,30-34,1943,39
STAT,1859,41,45-49,1900,1.1304013232430206
SIM,1846,13,na,1859,2134
SIM,1865,21,40-44,1886,2
SIM,1926,31,20-24,1957,1
STAT,1838,21,30-34,1859,15.627230038384642
STAT,1855,16,35-39,1871,0.46652754239917676
STAT,1841,34,35-39,1875,8.296805336227173
SIM,1846,21,30-34,1867,19
SIM,1902,22,20-24,1924,93
STAT,1827,37,40-44,1864,4.543733633225112
STAT,1891,30,30-34,1921,20.570621165739336
STAT,1834,52,20-24,1886,4.695616975787419E-4
STAT,1863,32,20-24,1895,2.2408824407970216
STAT,1869,26,50-100,1895,0.5874487999969369
STAT,1881,50,40-44,1931,0.00974566663676773
STAT,1937,26,35-39,1963,13.831967244615894
STAT,1833,35,15-19,1868,0.043979992441333805
STAT,1891,49,20-24,1940,0.007746294071777654
STAT,1850,7,na,1857,2132.086987863272
SIM,1852,5,na,1857,2313
STAT,1834,47,50-100,1881,0.1616438988262964
SIM,1882,30,30-34,1912,5
SIM,1900,28,30-34,1928,53
STAT,1835,37,15-19,1872,0.044185642860826636
SIM,1832,34,35-39,1866,8
STAT,1873,58,na,1931,1894.7647646877638
SIM,1840,83,na,1923,237
STAT,1875,28,30-34,1903,24.36592311141317
SIM,1909,55,na,1964,3153
SIM,1833,54,na,1887,1272
SIM,1909,31,20-24,1940,2
STAT,1907,47,30-34,1954,0.07542119266804735
STAT,1849,19,15-19,1868,5.413418177391022
STAT,1794,109,na,1903,1.3400700376496965E-4
STAT,1833,48,20-24,1881,0.007748359188052666
STAT,1788,73,na,1861,438.8575960633006
STAT,1859,11,na,1870,2093.053044512985
SIM,1834,71,na,1905,753
STAT,1897,30,50-100,1927,1.166873188297032
STAT,1924,47,30-34,1971,0.10025745676169094
SIM,1909,23,na,1932,3347
STAT,1784,91,na,1875,16.7584340430775
STAT,1867,46,na,1913,2001.4507807645741
SIM,1838,85,na,1923,157
STAT,1861,46,30-34,1907,0.07625103346356904
SIM,1926,26,25-29,1952,78
SIM,1915,23,45-49,1938,1
STAT,1854,42,20-24,1896,0.1134884506951515
SIM,1852,37,40-44,1889,2
STAT,1868,24,20-24,1892,61.72489020946565
SIM,1829,49,na,1878,1345
STAT,1817,52,20-24,1869,0.0015940227911735343
STAT,1838,33,na,1871,1789.2916349294871
STAT,1849,18,50-100,1867,0.04495452138761137
STAT,1829,39,40-44,1868,3.82575540003091
SIM,1837,39,40-44,1876,8
STAT,1873,17,40-44,1890,0.175242066961472
STAT,1881,77,na,1958,888.5469961768625
STAT,1848,43,35-39,1891,1.3358198326222155
SIM,1857,19,15-19,1876,5
STAT,1939,20,25-29,1959,87.69570681044257
STAT,1884,43,20-24,1927,0.14715275920002044
STAT,1902,38,50-100,1940,0.3515506005869073
SIM,1825,35,na,1860,1623
STAT,1850,35,15-19,1885,0.041055331024740155
STAT,1891,25,35-39,1916,11.353996690125655
SIM,1856,43,35-39,1899,2
STAT,1838,16,35-39,1854,0.48947849462619125
STAT,1867,27,50-100,1894,0.5674570798705301
STAT,1840,22,25-29,1862,47.77515415021846
SIM,1898,23,45-49,1921,4
STAT,1844,37,40-44,1881,3.2127394799820572
STAT,1859,48,40-44,1907,0.12710623994645062
SIM,1848,63,na,1911,1285
STAT,1941,23,45-49,1964,1.0981044208743855
STAT,1861,9,na,1870,2199.576080173918
STAT,1873,51,45-49,1924,0.013971081908114177
SIM,1857,38,30-34,1895,7
STAT,1826,45,25-29,1871,0.05464380063271947
SIM,1818,97,na,1915,5
STAT,1947,20,na,1967,3901.7643148808415
STAT,1885,31,45-49,1916,1.6487694470347274
STAT,1855,20,50-100,1875,0.3434571626844721
STAT,1870,17,15-19,1887,5.55230409699086
SIM,1887,34,25-29,1921,20
STAT,1944,24,25-29,1968,94.151973514203
STAT,1908,16,15-19,1924,8.337059247869442
SIM,1862,40,30-34,1902,4
SIM,1805,90,na,1895,14
STAT,1869,40,15-19,1909,0.012766138495834125
STAT,1836,29,30-34,1865,20.798886919071098
SIM,1904,24,na,1928,3273
STAT,1876,38,15-19,1914,0.05453527844612628
SIM,1908,38,na,1946,3271
STAT,1928,41,30-34,1969,0.15418430300086924
STAT,1855,29,na,1884,1742.4277998271068
SIM,1901,59,na,1960,2667
STAT,1942,16,15-19,1958,44.81727646335385
SIM,1878,27,35-39,1905,10
STAT,1874,44,15-19,1918,0.0131496465298031
STAT,1827,105,na,1932,0.01693654973023759
STAT,1865,33,50-100,1898,0.7812392781193909
STAT,1851,15,na,1866,2031.4291796578307
SIM,1868,17,25-29,1885,4
STAT,1926,33,20-24,1959,2.7844500204229297
SIM,1826,40,45-49,1866,1
STAT,1856,42,30-34,1898,0.8463516485116567
STAT,1893,36,25-29,1929,3.4659597936537336
STAT,1840,39,50-100,1879,0.9333778608482566
SIM,1880,31,35-39,1911,12
SIM,1848,32,45-49,1880,2
SIM,1881,81,na,1962,561
STAT,1906,22,na,1928,3254.0793817014305
SIM,1889,61,na,1950,2202
SIM,1888,60,na,1948,2155
STAT,1926,21,50-100,1947,0.7574345461262146
SIM,1836,78,na,1914,491
SIM,1893,31,45-49,1924,4
SIM,1931,27,20-24,1958,23
SIM,1913,44,na,1957,3285
STAT,1856,46,na,1902,1663.0159291204732
SIM,1838,26,na,1864,1807
SIM,1879,28,40-44,1907,5
STAT,1809,47,15-19,1856,0.0011289622147437834
STAT,1866,19,15-19,1885,5.245171152809175
STAT,1867,54,25-29,1921,0.003055637822925945
SIM,1861,27,40-44,1888,2
SIM,1928,31,30-34,1959,26
STAT,1921,40,50-100,1961,0.12534866211634607
SIM,1943,26,25-29,1969,72
STAT,1863,46,40-44,1909,0.14233071958813817
STAT,1853,27,40-44,1880,2.6262543625748758
STAT,1882,35,35-39,1917,6.559713927661591
SIM,1918,24,25-29,1942,97
SIM,1934,21,50-100,1955,4
STAT,1919,43,30-34,1962,0.13067499451317988
STAT,1811,50,na,1861,1259.148432108109
SIM,1862,67,na,1929,1358
STAT,1812,72,na,1884,599.3721004333563
SIM,1831,29,20-24,1860,10
SIM,1882,25,35-39,1907,9
SIM,1863,21,30-34,1884,19
STAT,1896,43,na,1939,2872.7560532979915
STAT,1818,40,45-49,1858,3.7706127700071934
SIM,1831,47,na,1878,1453
STAT,1844,49,35-39,1893,0.09520315874404905
STAT,1815,44,35-39,1859,4.226948306772863
STAT,1935,26,25-29,1961,84.79721670460896
STAT,1935,35,na,1970,4978.384570249341
SIM,1876,75,na,1951,949
STAT,1884,51,20-24,1935,6.920106914886967E-4
SIM,1823,44,35-39,1867,2
SIM,1859,24,20-24,1883,58
STAT,1928,15,50-100,1943,0.4480289880356842
STAT,1815,64,na,1879,923.154577985645
SIM,1950,16,15-19,1966,43
STAT,1819,78,na,1897,412.4615737445208
STAT,1885,27,na,1912,2247.254264320873
STAT,1897,18,40-44,1915,0.23047108085292006
STAT,1757,100,na,1857,0.22942324125223196
SIM,1924,21,45-49,1945,1
SIM,1840,42,45-49,1882,2
SIM,1844,21,20-24,1865,64
STAT,1878,89,na,1967,271.40065581797086
STAT,1871,52,25-29,1923,0.003304975928123964
STAT,1837,32,na,1869,1763.4576473897955
STAT,1966,4,na,1970,4639.243529059799
STAT,1859,106,na,1965,0.05789029397338917
STAT,1916,26,15-19,1942,0.6919279280361526
SIM,1772,94,na,1866,2
STAT,1885,38,40-44,1923,4.1016020227843315
SIM,1836,19,30-34,1855,1
STAT,1798,106,na,1904,0.0034488287109567164
STAT,1857,49,20-24,1906,0.00875405657622889
SIM,1824,39,30-34,1863,6
STAT,1855,21,30-34,1876,14.89449139105053
STAT,1904,2,na,1906,3612.119558864886
SIM,1843,32,na,1875,1857
STAT,1875,17,15-19,1892,5.762535876961581
STAT,1761,114,na,1875,3.7135443148719895E-4
STAT,1800,87,na,1887,59.128157255675
SIM,1813,66,na,1879,821
SIM,1906,30,40-44,1936,6
STAT,1895,30,15-19,1925,0.1767989084272541
STAT,1918,34,25-29,1952,9.199041940035173
STAT,1865,41,45-49,1906,1.2873209530629248
SIM,1860,35,25-29,1895,4
STAT,1884,30,50-100,1914,0.8620247806064762
STAT,1773,101,na,1874,0.11108157133141296
STAT,1846,43,25-29,1889,0.47591975001903386
SIM,1828,45,50-100,1873,2
STAT,1852,35,25-29,1887,2.14274507468947
STAT,1825,45,50-100,1870,0.2575702025745223
STAT,1923,27,20-24,1950,19.7982122840441
SIM,1897,37,na,1934,3047
STAT,1872,16,35-39,1888,0.524745346326035
SIM,1928,22,40-44,1950,6
SIM,1769,90,na,1859,12
SIM,1898,39,30-34,1937,1
SIM,1893,38,40-44,1931,11
SIM,1820,38,35-39,1858,15
STAT,1910,41,20-24,1951,0.01585875340500439
SIM,1847,78,na,1925,523
STAT,1832,42,45-49,1874,1.106814826784657
SIM,1873,30,na,1903,2309
SIM,1890,58,na,1948,2509
SIM,1916,16,15-19,1932,10
STAT,1889,41,30-34,1930,1.3468729983700614
STAT,1839,45,35-39,1884,0.09743564435325382
STAT,1765,111,na,1876,8.405046166340051E-4
STAT,1844,30,45-49,1874,1.478696227847157
SIM,1843,64,na,1907,1233
SIM,1822,70,na,1892,724
SIM,1846,37,40-44,1883,5
STAT,1830,53,na,1883,1322.2002038254964
SIM,1892,30,50-100,1922,1
STAT,1924,31,45-49,1955,1.735286281146426
STAT,1820,48,35-39,1868,0.23138503939808153
STAT,1881,20,20-24,1901,63.26522739072344
SIM,1838,27,40-44,1865,3
SIM,1844,29,30-34,1873,26
STAT,1842,43,50-100,1885,0.7814651262367803
STAT,1872,25,25-29,1897,40.35580644793766
SIM,1852,30,45-49,1882,1
SIM,1859,49,50-100,1908,1
STAT,1836,21,20-24,1857,59.32092620096678
STAT,1838,37,40-44,1875,3.546245277624187
STAT,1880,30,30-34,1910,17.52851440518643
SIM,1840,99,na,1939,1
STAT,1916,21,45-49,1937,1.1171833427670927
STAT,1821,49,na,1870,1348.8697447305171
STAT,1873,43,45-49,1916,1.423594059016343
STAT,1852,32,45-49,1884,1.3089769409572194
SIM,1913,20,30-34,1933,31
STAT,1888,40,25-29,1928,0.7241692082362624
STAT,1831,30,35-39,1861,8.290905952222435
STAT,1897,43,30-34,1940,0.1001339290589698
STAT,1876,82,na,1958,552.2056372122928
SIM,1895,20,15-19,1915,6
STAT,1906,40,40-44,1946,0.2170768747159923
SIM,1911,15,25-29,1926,6
STAT,1929,24,35-39,1953,11.17784129949782
STAT,1861,49,35-39,1910,0.10767214807832703
SIM,1863,52,na,1915,1769
STAT,1866,22,45-49,1888,0.6125521973266059
STAT,1922,23,35-39,1945,10.169194183836932
STAT,1876,41,20-24,1917,0.15570362982798344
STAT,1856,45,35-39,1901,0.10421966088577901
SIM,1901,43,na,1944,3068
STAT,1817,71,na,1888,664.4869546774572
STAT,1851,22,50-100,1873,0.3503065593032521
SIM,1863,30,20-24,1893,2
STAT,1826,53,25-29,1879,0.0030924532428084207
STAT,1898,49,30-34,1947,0.06834838656490878
STAT,1845,25,50-100,1870,0.5589718266242314
SIM,1850,29,30-34,1879,30
STAT,1780,77,na,1857,264.12864274982
STAT,1862,31,na,1893,1935.344517282171
SIM,1932,31,45-49,1963,2
STAT,1831,103,na,1934,0.08379635446266384
STAT,1918,23,na,1941,3709.2773725786246
STAT,1939,33,na,1972,3643.242836337229
SIM,1854,35,25-29,1889,2
STAT,1880,38,40-44,1918,4.3380835077947
STAT,1820,37,30-34,1857,12.259858267746774
STAT,1848,34,45-49,1882,1.3468273039889933
STAT,1893,44,25-29,1937,0.05270217593216859
STAT,1876,23,na,1899,2301.166145981955
SIM,1887,38,40-44,1925,5
STAT,1825,47,na,1872,1370.0256076249668
STAT,1840,52,45-49,1892,0.009473182317349615
STAT,1821,33,na,1854,1480.1611529586257
STAT,1905,20,30-34,1925,24.46769508677959
STAT,1809,50,20-24,1859,0.0020649146725501446
STAT,1832,50,45-49,1882,0.009491943135792252
STAT,1884,58,na,1942,1845.7326974654104
STAT,1819,48,50-100,1867,0.458391228214268
STAT,1858,50,40-44,1908,0.007909690237163737
STAT,1866,16,50-100,1882,0.04407502632910949
STAT,1823,99,na,1922,1.013561927884831
SIM,1900,36,30-34,1936,1
STAT,1931,29,20-24,1960,22.240832074284715
STAT,1794,69,na,1863,682.7522647215325
STAT,1908,40,50-100,1948,0.10384658128188767
SIM,1856,40,30-34,1896,1
STAT,1879,38,40-44,1917,4.307324368389427
STAT,1849,27,15-19,1876,0.40329535414532164
SIM,1909,22,30-34,1931,33
STAT,1892,24,15-19,1916,3.8791341803757073
SIM,1860,32,45-49,1892,1
SIM,1849,17,15-19,1866,5
SIM,1871,32,20-24,1903,2
SIM,1945,23,30-34,1968,31
SIM,1872,23,25-29,1895,59
STAT,1824,40,45-49,1864,2.071619078862474
STAT,1859,38,15-19,1897,0.04201266120412451
SIM,1825,29,20-24,1854,13
STAT,1848,11,na,1859,2208.9858525209233
STAT,1924,39,30-34,1963,2.0259088746616043
STAT,1937,23,30-34,1960,26.43180489689135
SIM,1932,39,30-34,1971,2
STAT,1869,51,30-34,1920,0.0054737757195441215
SIM,1782,72,na,1854,499
SIM,1786,86,na,1872,82
SIM,1825,51,na,1876,1350
SIM,1829,65,na,1894,1009
SIM,1833,86,na,1919,114
SIM,1926,34,25-29,1960,20
STAT,1913,30,30-34,1943,14.92785828307868
SIM,1950,17,na,1967,3969
STAT,1887,36,25-29,1923,3.0570457000030187
STAT,1925,41,na,1966,4253.752272575558
STAT,1864,97,na,1961,10.494578260652034
STAT,1874,24,45-49,1898,0.6688575585256649
STAT,1891,31,45-49,1922,2.046475815183364
STAT,1905,53,na,1958,2945.5815955446287
STAT,1816,39,30-34,1855,17.504764338706703
SIM,1865,59,na,1924,1692
STAT,1848,40,30-34,1888,0.8753633559439843
SIM,1908,18,30-34,1926,3
SIM,1861,45,na,1906,1976
STAT,1826,42,45-49,1868,1.4623011065825136
SIM,1861,39,35-39,1900,3
SIM,1883,29,na,1912,2203
STAT,1918,23,20-24,1941,112.94488882964356
STAT,1862,5,na,1867,2326.1614871535903
STAT,1847,24,50-100,1871,0.36336355878772386
SIM,1831,79,na,1910,370
SIM,1872,61,na,1933,1714
STAT,1860,17,30-34,1877,1.4090305390067561
SIM,1851,19,20-24,1870,15
STAT,1862,19,30-34,1881,1.3259971253075884
SIM,1810,85,na,1895,88
SIM,1960,8,na,1968,4855
SIM,1856,34,45-49,1890,1
STAT,1866,34,15-19,1900,0.12302049447176457
STAT,1795,103,na,1898,0.029890613720580557
STAT,1888,15,35-39,1903,0.6154515976643478
SIM,1830,31,20-24,1861,1
STAT,1825,33,15-19,1858,0.22600624843322972
STAT,1833,34,na,1867,1676.5024195404812
STAT,1852,43,25-29,1895,0.4621919597165027
SIM,1921,30,30-34,1951,15
STAT,1837,48,na,1885,1496.3746582275012
SIM,1867,50,50-100,1917,1
STAT,1878,33,50-100,1911,0.8982559172847578
STAT,1943,20,15-19,1963,5.353957199625822
SIM,1926,23,20-24,1949,118
SIM,1898,20,40-44,1918,2
STAT,1829,40,20-24,1869,0.13978171560145158
SIM,1934,33,20-24,1967,3
STAT,1843,19,20-24,1862,15.123078306575103
STAT,1846,35,25-29,1881,2.2768710863785326
SIM,1937,24,35-39,1961,7
SIM,1904,25,35-39,1929,17
STAT,1896,31,20-24,1927,3.386349481828189
SIM,1831,26,40-44,1857,2
STAT,1833,43,15-19,1876,0.010136299999174774
STAT,1874,33,35-39,1907,9.733631106781514
SIM,1948,15,20-24,1963,133
STAT,1868,27,25-29,1895,38.12805213250732
STAT,1937,34,35-39,1971,8.530066200196028
SIM,1881,43,45-49,1924,2
STAT,1854,45,25-29,1899,0.04162280231215514
STAT,1870,20,45-49,1890,0.6501065365041796
SIM,1949,20,na,1969,3945
STAT,1830,51,25-29,1881,0.0023809832103415945
STAT,1901,27,50-100,1928,0.8458920097280933
STAT,1842,29,30-34,1871,22.22921170104763
STAT,1879,17,35-39,1896,0.5426037635774301
STAT,1830,69,na,1899,885.7296684537715
STAT,1867,46,25-29,1913,0.05124076569317538
STAT,1900,34,15-19,1934,0.1850280766563208
SIM,1815,42,35-39,1857,4
STAT,1898,41,50-100,1939,0.09421202445182311
SIM,1842,19,30-34,1861,2
STAT,1924,20,40-44,1944,3.7703821210822714
STAT,1893,33,45-49,1926,2.0803310126723358
SIM,1871,23,30-34,1894,23
SIM,1940,30,40-44,1970,4
STAT,1872,31,35-39,1903,9.635393482463835
SIM,1882,33,35-39,1915,4
STAT,1806,52,45-49,1858,0.05108682344203334
STAT,1862,18,50-100,1880,0.04505449216944589
STAT,1867,14,na,1881,2357.44755790155
STAT,1872,39,45-49,1911,1.8699708942032656
STAT,1948,24,45-49,1972,1.2196757670806249
STAT,1890,17,40-44,1907,0.21124678013430528
STAT,1881,53,45-49,1934,0.013031474783367901
SIM,1859,32,20-24,1891,4
STAT,1868,36,15-19,1904,0.05085808166030004
SIM,1932,20,40-44,1952,3
STAT,1880,49,45-49,1929,0.23013315837333737
STAT,1895,26,50-100,1921,0.7905479877241066
STAT,1852,96,na,1948,6.225208717038104
STAT,1841,31,30-34,1872,14.756836069911419
SIM,1873,46,na,1919,2153
STAT,1883,8,na,1891,2407.7344747219277
SIM,1880,39,45-49,1919,2
SIM,1813,50,na,1863,1276
STAT,1849,38,30-34,1887,4.047211705258911
STAT,1906,38,na,1944,3250.9713510829506
STAT,1863,23,30-34,1886,14.952837139774536
STAT,1932,30,40-44,1962,4.920008366236064
SIM,1888,76,na,1964,1308
STAT,1905,39,20-24,1944,0.2249056792902215
SIM,1792,71,na,1863,541
SIM,1796,85,na,1881,86
SIM,1885,31,na,1916,2293
SIM,1918,21,20-24,1939,108
STAT,1901,38,25-29,1939,0.817692591657942
STAT,1855,37,40-44,1892,3.110770282544608
STAT,1844,23,20-24,1867,59.328963665298566
STAT,1893,38,15-19,1931,0.06694103542450916
STAT,1872,22,20-24,1894,65.29991194287098
SIM,1915,20,40-44,1935,1
STAT,1886,40,15-19,1926,0.013920027435416602
STAT,1895,41,30-34,1936,0.09876997476384193
SIM,1852,33,25-29,1885,15
SIM,1939,25,20-24,1964,18
SIM,1788,66,na,1854,731
STAT,1762,108,na,1870,0.0023459261563977423
SIM,1852,52,na,1904,1641
SIM,1951,20,15-19,1971,3
SIM,1948,19,na,1967,3970
SIM,1904,40,na,1944,3258
STAT,1883,20,30-34,1903,16.59641105687461
STAT,1850,30,45-49,1880,1.442763728923661
SIM,1828,36,35-39,1864,13
SIM,1908,54,na,1962,2990
STAT,1910,11,na,1921,3702.4496846969905
SIM,1854,41,35-39,1895,3
STAT,1854,44,na,1898,1631.3361636168008
STAT,1808,52,50-100,1860,0.05456043257292068
STAT,1893,33,20-24,1926,3.2246733404501966
SIM,1895,27,35-39,1922,13
STAT,1918,17,35-39,1935,0.8656562129665532
STAT,1887,27,35-39,1914,10.195871187542828
STAT,1830,104,na,1934,0.04025653058477297
STAT,1829,34,35-39,1863,9.57104934178645
STAT,1949,17,15-19,1966,49.86482273319126
SIM,1812,49,na,1861,1266
STAT,1860,24,50-100,1884,0.31760999763675385
STAT,1791,93,na,1884,6.662145618190869
STAT,1834,52,45-49,1886,0.009234713035255287
SIM,1850,37,30-34,1887,8
STAT,1853,17,15-19,1870,5.402675481128945
STAT,1867,6,na,1873,2486.152068733196
STAT,1835,40,20-24,1875,0.1242564818639132
STAT,1839,42,30-34,1881,0.8067476598224328
STAT,1901,15,15-19,1916,7.883965438400459
SIM,1833,70,na,1903,806
SIM,1891,20,30-34,1911,27
SIM,1861,17,15-19,1878,3
SIM,1828,59,na,1887,1193
STAT,1850,30,na,1880,1793.0918834854267
STAT,1899,29,30-34,1928,32.36255239367038
SIM,1881,65,na,1946,1268
SIM,1889,45,na,1934,2759
SIM,1865,33,35-39,1898,13
SIM,1954,15,45-49,1969,1
STAT,1894,17,25-29,1911,6.879688636882858
STAT,1835,45,15-19,1880,3.025442151658463E-4
STAT,1842,38,20-24,1880,0.6480872851740278
SIM,1840,67,na,1907,1024
SIM,1882,22,30-34,1904,23
SIM,1918,38,50-100,1956,1
SIM,1803,72,na,1875,514
SIM,1840,48,50-100,1888,4
STAT,1826,42,20-24,1868,0.1551692087481031
SIM,1852,23,20-24,1875,62
STAT,1774,100,na,1874,0.16394742400946954
STAT,1863,80,na,1943,512.8270217560874
STAT,1826,47,15-19,1873,3.6931515997109393E-4
STAT,1835,48,30-34,1883,0.06411417367615876
STAT,1891,28,na,1919,2779.5051645659373
STAT,1806,71,na,1877,631.1023708419231
SIM,1928,25,45-49,1953,2
STAT,1870,52,30-34,1922,0.005487224767590683
STAT,1864,23,25-29,1887,48.622637244573916
STAT,1795,70,na,1865,689.4313607768877
STAT,1857,33,35-39,1890,7.51344075907721
SIM,1873,33,50-100,1906,1
STAT,1865,32,30-34,1897,14.950165517543331
STAT,1799,84,na,1883,107.55594328369281
SIM,1847,42,50-100,1889,3
STAT,1882,33,45-49,1915,1.5953154776483005
STAT,1910,16,30-34,1926,2.287271883297198
STAT,1862,105,na,1967,0.1836762641618708
SIM,1893,50,na,1943,2735
STAT,1945,1,na,1946,4260.6950110561675
SIM,1897,64,na,1961,2401
STAT,1815,42,45-49,1857,3.7882737402084667
SIM,1902,25,25-29,1927,50
SIM,1835,30,45-49,1865,4
SIM,1860,32,20-24,1892,5
STAT,1927,15,35-39,1942,4.951657323246862
SIM,1824,34,na,1858,1568
SIM,1871,30,30-34,1901,24
STAT,1843,17,30-34,1860,1.3757873120167954
STAT,1874,43,na,1917,2214.7474504116367
STAT,1855,24,35-39,1879,4.7752292921828685
STAT,1940,19,20-24,1959,129.9544712134825
STAT,1829,47,40-44,1876,0.13993168357311883
STAT,1894,21,45-49,1915,0.8491387897014383
STAT,1887,42,35-39,1929,1.9111027091693675
SIM,1907,21,45-49,1928,4
STAT,1797,107,na,1904,0.0011572440706436656
STAT,1853,16,25-29,1869,5.189422027504803
STAT,1878,57,na,1935,1978.5231172061854
STAT,1862,17,40-44,1879,0.16920006672850807
STAT,1920,49,15-19,1969,3.824219773885282E-4
STAT,1861,22,45-49,1883,0.5627116732415727
STAT,1854,52,25-29,1906,0.002520766021583408
SIM,1851,17,30-34,1868,1
STAT,1939,31,40-44,1970,3.7742270664752797
STAT,1842,37,30-34,1879,4.527585397567044
SIM,1844,24,25-29,1868,49
SIM,1879,24,na,1903,2365
STAT,1847,19,40-44,1866,0.16635892663155974
STAT,1879,50,25-29,1929,0.003552935458889795
SIM,1761,94,na,1855,3
SIM,1894,16,15-19,1910,6
STAT,1909,24,30-34,1933,25.078114024554058
SIM,1893,34,25-29,1927,19
STAT,1946,20,40-44,1966,3.537202682814691
SIM,1855,33,na,1888,1903
STAT,1870,66,na,1936,1518.9711489503718
SIM,1824,66,na,1890,839
STAT,1885,34,25-29,1919,9.562306876089814
SIM,1795,100,na,1895,1
STAT,1823,51,30-34,1874,0.007197064589745549
STAT,1861,35,15-19,1896,0.044527591842329906
SIM,1845,43,35-39,1888,4
STAT,1933,26,15-19,1959,0.8859168169046961
STAT,1924,9,na,1933,4478.272197210156
STAT,1876,49,30-34,1925,0.09250465141728671
SIM,1862,6,na,1868,2437
STAT,1910,48,40-44,1958,0.138581971010433
STAT,1837,43,35-39,1880,1.3691237762906043
STAT,1831,38,45-49,1869,1.5099839176797665
STAT,1868,31,na,1899,2159.672516185508
SIM,1847,42,30-34,1889,1
STAT,1836,24,25-29,1860,48.2240529906238
STAT,1876,30,40-44,1906,4.266678806240479
STAT,1853,39,35-39,1892,5.298886441966825
SIM,1914,27,20-24,1941,16
SIM,1914,40,40-44,1954,3
STAT,1887,20,15-19,1907,3.506826514718823
STAT,1827,30,45-49,1857,2.281663575817551
STAT,1842,51,40-44,1893,0.007660414966297198
STAT,1858,10,na,1868,2091.3510262347945
STAT,1815,48,na,1863,1338.1264629125792
SIM,1870,81,na,1951,491
STAT,1854,40,30-34,1894,0.8308704347614397
SIM,1863,24,35-39,1887,4
STAT,1816,70,na,1886,755.5848259446141
STAT,1841,32,45-49,1873,1.4586417795292743
STAT,1853,65,na,1918,1278.9570888002524
SIM,1846,49,50-100,1895,1
SIM,1903,27,45-49,1930,2
STAT,1856,50,30-34,1906,0.004450542183419904
SIM,1874,95,na,1969,47
SIM,1866,76,na,1942,788
STAT,1827,29,40-44,1856,4.4217971735341886
STAT,1818,43,25-29,1861,1.4641087124617875
SIM,1884,30,40-44,1914,3
STAT,1924,35,na,1959,4198.116178386575
SIM,1891,64,na,1955,2059
STAT,1899,19,na,1918,3251.619570538322
STAT,1821,53,25-29,1874,0.005265819014917954
SIM,1933,21,na,1954,4597
SIM,1917,24,30-34,1941,26
STAT,1855,30,20-24,1885,1.9968799821286087
STAT,1949,16,25-29,1965,47.62779224657291
STAT,1920,42,na,1962,3874.909509681914
STAT,1875,53,45-49,1928,0.013865508533458814
STAT,1919,46,35-39,1965,0.13243645957307063
STAT,1867,48,15-19,1915,3.5037246048290365E-4
SIM,1835,29,40-44,1864,1
STAT,1876,48,40-44,1924,0.16499250437959173
STAT,1816,86,na,1902,103.39467609391635
STAT,1852,32,20-24,1884,2.02901510339289
SIM,1861,16,25-29,1877,7
STAT,1882,46,15-19,1928,3.6852919666730644E-4
STAT,1906,27,20-24,1933,16.141348499528657
STAT,1917,30,15-19,1947,0.1281455826884955
STAT,1843,49,40-44,1892,0.11322207336839642
STAT,1838,33,25-29,1871,8.456546330857421
STAT,1853,16,50-100,1869,0.044865311067431225
STAT,1936,20,na,1956,3300.3912308025597
STAT,1912,19,45-49,1931,0.09491790506443841
SIM,1872,49,50-100,1921,1
STAT,1836,26,na,1862,1825.7344760588658
STAT,1862,51,20-24,1913,5.988829475893706E-4
STAT,1841,45,15-19,1886,2.842044771113436E-4
STAT,1864,22,50-100,1886,0.34886933777649815
STAT,1883,39,20-24,1922,0.7067847479407642
STAT,1916,21,na,1937,3625.8684696565083
SIM,1873,8,na,1881,2567
STAT,1926,41,20-24,1967,0.020596582536760017
STAT,1946,21,30-34,1967,30.224928741078998
SIM,1885,28,40-44,1913,3
SIM,1876,27,25-29,1903,48
STAT,1857,48,30-34,1905,0.07121568987688773
STAT,1806,48,50-100,1854,0.8935101883570569
SIM,1818,37,40-44,1855,3
SIM,1838,58,na,1896,1314
STAT,1836,85,na,1921,177.52029252239598
STAT,1863,38,40-44,1901,3.6110255618386913
SIM,1918,38,45-49,1956,2
STAT,1937,20,15-19,1957,4.900447770577506
SIM,1846,33,25-29,1879,21
STAT,1920,15,25-29,1935,9.257747264547346
STAT,1863,26,35-39,1889,8.056977630486182
STAT,1880,27,50-100,1907,0.6370919505600592
STAT,1898,34,35-39,1932,12.83579578832049
SIM,1923,43,na,1966,4168
STAT,1916,49,25-29,1965,0.051097262131427755
SIM,1891,39,20-24,1930,1
STAT,1935,18,50-100,1953,0.482580453657655
SIM,1903,39,na,1942,3168
STAT,1920,38,35-39,1958,2.4992377903117613
STAT,1856,17,40-44,1873,0.1594084962530224
SIM,1852,84,na,1936,208
SIM,1924,26,15-19,1950,3
STAT,1941,31,45-49,1972,1.5616606047737815
SIM,1856,98,na,1954,1
SIM,1885,18,15-19,1903,4
SIM,1871,38,40-44,1909,10
STAT,1897,12,na,1909,3262.6965265137246
STAT,1845,62,na,1907,1293.3552662329614
STAT,1859,34,20-24,1893,2.0150036147134145
STAT,1849,76,na,1925,710.4276861698944
SIM,1868,83,na,1951,276
SIM,1935,15,35-39,1950,5
STAT,1885,0,na,1885,3302.283127607891
SIM,1905,34,50-100,1939,1
SIM,1948,22,45-49,1970,1
SIM,1830,34,25-29,1864,12
SIM,1938,30,25-29,1968,11
STAT,1839,17,40-44,1856,0.1593013962435233
STAT,1853,81,na,1934,409.2484840684679
STAT,1897,44,45-49,1941,0.12953068873241605
STAT,1921,42,35-39,1963,0.2142594271949868
STAT,1953,18,50-100,1971,0.4280012616411252
SIM,1904,27,50-100,1931,4
SIM,1918,15,35-39,1933,5
STAT,1845,99,na,1944,1.3401549272930895
STAT,1861,37,40-44,1898,3.438472178334996
STAT,1852,37,15-19,1889,0.04093218716247189
STAT,1835,47,40-44,1882,0.11485410215242395
SIM,1891,80,na,1971,1110
SIM,1839,43,35-39,1882,3
STAT,1891,33,50-100,1924,1.066371452251261
STAT,1822,32,35-39,1854,29.529015878335144
SIM,1919,33,30-34,1952,24
STAT,1866,39,20-24,1905,0.6648971396376077
SIM,1921,36,na,1957,3982
STAT,1867,43,20-24,1910,0.13986187294243607
STAT,1925,27,30-34,1952,43.71847442022747
SIM,1864,40,40-44,1904,3
STAT,1801,56,na,1857,1011.105191645351
SIM,1892,18,30-34,1910,4
STAT,1864,52,30-34,1916,0.00498519790479389
SIM,1945,20,15-19,1965,9
STAT,1817,54,50-100,1871,0.0313458986044374
STAT,1877,28,40-44,1905,2.925124055928001
STAT,1884,18,30-34,1902,1.4836938820572787
STAT,1865,50,na,1915,1870.1791980030712
STAT,1907,36,15-19,1943,0.01690086515596667
SIM,1935,1,na,1936,5220
STAT,1901,18,30-34,1919,2.1021182354568726
SIM,1933,27,30-34,1960,57
SIM,1848,21,40-44,1869,3
STAT,1859,44,25-29,1903,0.47631446429297397
SIM,1830,32,35-39,1862,10
STAT,1937,17,50-100,1954,0.34432184115882114
STAT,1804,85,na,1889,91.83379696376295
STAT,1846,32,20-24,1878,2.369255126930759
STAT,1873,52,35-39,1925,0.008204553381677717
SIM,1815,45,50-100,1860,5
SIM,1890,35,35-39,1925,19
SIM,1958,1,na,1959,4786
STAT,1862,50,30-34,1912,0.004877077312364258
SIM,1934,36,25-29,1970,4
SIM,1865,46,50-100,1911,3
SIM,1869,34,30-34,1903,28
SIM,1859,35,25-29,1894,3
SIM,1890,30,40-44,1920,9
STAT,1883,38,30-34,1921,4.9118420088027
STAT,1883,52,40-44,1935,0.009698940916662003
SIM,1871,44,na,1915,2179
STAT,1856,43,45-49,1899,1.0951714091195677
STAT,1930,20,na,1950,4445.745237286172
STAT,1946,15,45-49,1961,0.5237028664031239
SIM,1917,36,25-29,1953,1
STAT,1846,49,45-49,1895,0.1713873530158558
SIM,1871,26,35-39,1897,10
STAT,1757,116,na,1873,1.2979557447049677E-4
SIM,1907,37,30-34,1944,1
STAT,1892,29,20-24,1921,13.782031570122962
STAT,1900,22,na,1922,3099.4067682275795
SIM,1830,101,na,1931,1
SIM,1854,26,35-39,1880,7
STAT,1920,47,50-100,1967,0.23619170775475412
STAT,1904,36,na,1940,3233.1598037539634
STAT,1882,30,40-44,1912,4.016233706054061
STAT,1893,32,50-100,1925,1.097687512399715
SIM,1835,26,25-29,1861,35
STAT,1808,67,na,1875,794.7892382442253
STAT,1827,49,35-39,1876,0.12470460053165297
STAT,1846,41,35-39,1887,1.3768746180009885
STAT,1902,42,25-29,1944,0.059379196270669884
SIM,1890,40,30-34,1930,3
STAT,1867,20,35-39,1887,5.273304213252146
SIM,1899,41,40-44,1940,1
SIM,1771,93,na,1864,4
SIM,1819,66,na,1885,864
STAT,1825,63,na,1888,967.732553469923
SIM,1854,48,na,1902,1804
STAT,1816,47,30-34,1863,0.22860314680106936
SIM,1843,48,na,1891,1559
SIM,1902,44,na,1946,3040
STAT,1816,48,20-24,1864,0.027892296266851843
SIM,1842,47,50-100,1889,1
SIM,1876,31,45-49,1907,1
STAT,1886,18,40-44,1904,0.18204265763403177
STAT,1926,36,25-29,1962,1.1377733550499334
STAT,1879,34,25-29,1913,10.041919522323473
SIM,1815,52,na,1867,1296
SIM,1823,71,na,1894,704
SIM,1899,23,na,1922,3093
SIM,1928,30,40-44,1958,5
STAT,1825,38,20-24,1863,0.9281123585945086
SIM,1918,16,25-29,1934,10
STAT,1894,18,15-19,1912,7.185961514035099
STAT,1882,40,30-34,1922,1.0668754882180311
STAT,1861,38,30-34,1899,4.165550705794473
STAT,1924,48,20-24,1972,0.012394059264302888
SIM,1854,32,20-24,1886,2
SIM,1919,38,na,1957,3874
STAT,1878,44,35-39,1922,1.75871923955636
STAT,1911,32,25-29,1943,8.502695392023377
SIM,1867,39,na,1906,2231
STAT,1817,44,na,1861,1376.1717022846037
SIM,1915,24,na,1939,3374
STAT,1902,49,45-49,1951,0.17377889641793143
STAT,1827,27,15-19,1854,1.2767891241620153
STAT,1861,30,20-24,1891,2.140284617774912
STAT,1836,27,40-44,1863,2.510089210503587
SIM,1891,38,30-34,1929,4
STAT,1843,47,15-19,1890,2.689188663195086E-4
SIM,1860,42,50-100,1902,1
STAT,1846,26,35-39,1872,8.720386031882173
SIM,1871,35,25-29,1906,4
STAT,1852,47,40-44,1899,0.12353900452403462
STAT,1884,42,na,1926,2154.472171170285
STAT,1935,19,na,1954,4728.013800262728
SIM,1829,29,40-44,1858,4
SIM,1909,25,35-39,1934,13
SIM,1919,17,na,1936,3935
SIM,1844,27,40-44,1871,2
SIM,1939,32,45-49,1971,2
STAT,1800,71,na,1871,610.242445597449
STAT,1863,104,na,1967,0.3953791965287422
STAT,1921,17,45-49,1938,0.5379173802464315
STAT,1929,21,30-34,1950,34.43796190397562
SIM,1832,38,50-100,1870,1
STAT,1907,23,45-49,1930,0.9647022749127175
SIM,1836,51,na,1887,1381
SIM,1886,44,35-39,1930,2
SIM,1937,21,30-34,1958,40
SIM,1852,29,40-44,1881,2
STAT,1828,53,35-39,1881,0.006005284681821585
SIM,1873,51,na,1924,2094
SIM,1901,16,30-34,1917,3
STAT,1846,84,na,1930,246.73755619544352
STAT,1883,23,35-39,1906,5.388198506554348
STAT,1904,40,30-34,1944,0.10927295118130062
SIM,1822,36,40-44,1858,9
STAT,1851,45,50-100,1896,0.17843196096452626
STAT,1878,46,25-29,1924,0.05686939170563681
STAT,1948,21,40-44,1969,3.648445651437755
STAT,1833,30,45-49,1863,1.4064608888524868
STAT,1950,17,50-100,1967,0.4185059169376775
STAT,1878,41,30-34,1919,1.136993511405044
SIM,1939,28,25-29,1967,61
STAT,1885,39,30-34,1924,4.968053051869475
STAT,1951,17,30-34,1968,13.711832874918485
SIM,1863,25,na,1888,1984
STAT,1840,28,45-49,1868,0.9019907227218893
STAT,1844,26,25-29,1870,36.2253684228276
STAT,1905,21,na,1926,3239.210638124047
SIM,1912,43,na,1955,3325
STAT,1927,21,20-24,1948,129.80934633085764
SIM,1837,41,35-39,1878,2
SIM,1864,49,50-100,1913,4
SIM,1828,33,30-34,1861,25
SIM,1847,62,na,1909,1380
STAT,1857,30,30-34,1887,13.36353079402385
SIM,1886,41,30-34,1927,3
STAT,1818,45,15-19,1863,8.789963160093676E-4
STAT,1866,24,na,1890,2047.8168227894103
SIM,1935,21,20-24,1956,138
STAT,1836,47,na,1883,1524.6689931109076
STAT,1864,65,na,1929,1422.9007510369975
STAT,1909,36,25-29,1945,0.8846951379740388
STAT,1850,14,na,1864,2037.7490008077023
STAT,1910,19,35-39,1929,0.7812798372332441
STAT,1827,70,na,1897,810.4601708948494
SIM,1846,24,35-39,1870,5
STAT,1829,41,35-39,1870,1.5690400181350779
SIM,1891,23,35-39,1914,9
STAT,1844,29,40-44,1873,2.5104293055390334
SIM,1827,27,40-44,1854,3
STAT,1832,33,na,1865,1669.027605063091
STAT,1934,30,15-19,1964,0.1659358341445782
SIM,1877,76,na,1953,881
SIM,1909,39,na,1948,3372
STAT,1821,50,20-24,1871,0.0011646022962830175
STAT,1864,20,20-24,1884,59.81122897825594
STAT,1930,32,35-39,1962,11.140943032227248
SIM,1875,10,na,1885,2562
STAT,1833,47,30-34,1880,0.06957068587749196
STAT,1912,33,50-100,1945,0.7653482729965461
SIM,1830,37,40-44,1867,8
SIM,1832,48,na,1880,1395
STAT,1795,108,na,1903,3.8150252391032824E-4
STAT,1923,42,45-49,1965,0.18376198825559478
SIM,1875,20,35-39,1895,8
STAT,1843,42,20-24,1885,0.11044632246097798
STAT,1865,46,15-19,1911,3.4347862232453455E-4
STAT,1941,28,15-19,1969,0.6895652976332736
SIM,1817,42,45-49,1859,2
SIM,1852,26,25-29,1878,40
SIM,1900,58,na,1958,2690
STAT,1856,49,50-100,1905,0.17724661589441731
SIM,1884,33,45-49,1917,1
STAT,1851,19,30-34,1870,1.377608522240479
STAT,1903,29,45-49,1932,1.4817498612915219
SIM,1911,29,45-49,1940,1
SIM,1829,81,na,1910,299
STAT,1876,33,45-49,1909,1.694796477478142
SIM,1905,25,na,1930,3238
STAT,1856,41,40-44,1897,1.6653928503193545
SIM,1832,31,30-34,1863,19
SIM,1920,33,50-100,1953,1
STAT,1881,27,40-44,1908,2.7337710880256085
SIM,1782,93,na,1875,4
STAT,1835,43,25-29,1878,0.483483860510837
SIM,1824,32,35-39,1856,6
STAT,1822,37,40-44,1859,7.705219057410404
STAT,1882,26,50-100,1908,0.5897120405442727
STAT,1895,44,35-39,1939,0.15277893247869453
SIM,1861,66,na,1927,1404
SIM,1852,30,20-24,1882,1
SIM,1952,19,na,1971,4119
STAT,1857,47,na,1904,1668.4537491452272
STAT,1934,34,na,1968,4871.894945434169
STAT,1896,32,35-39,1928,12.63539281534135
SIM,1858,43,45-49,1901,5
STAT,1838,24,35-39,1862,5.0101480255856545
STAT,1939,21,50-100,1960,0.6244774577095826
STAT,1861,31,50-100,1892,0.7226402477096844
STAT,1915,41,45-49,1956,0.15852162862658567
SIM,1872,29,na,1901,2236
STAT,1948,17,45-49,1965,0.5400811925281829
SIM,1891,43,na,1934,2693
STAT,1870,16,25-29,1886,5.333144529034104
SIM,1850,22,35-39,1872,7
SIM,1906,10,na,1916,3549
STAT,1848,32,na,1880,1878.0062907122367
STAT,1822,34,25-29,1856,22.259549056473386
SIM,1872,20,20-24,1892,58
STAT,1860,50,20-24,1910,5.737505800302014E-4
SIM,1871,33,35-39,1904,7
SIM,1890,79,na,1969,1259
STAT,1864,19,40-44,1883,0.1574376411003566
STAT,1818,51,50-100,1869,0.031536044788228794
SIM,1826,39,40-44,1865,6
SIM,1895,57,na,1952,2561
SIM,1893,31,20-24,1924,3
STAT,1854,43,35-39,1897,1.2862509412385472
SIM,1839,34,45-49,1873,2
STAT,1911,30,20-24,1941,2.2619274646072376
STAT,1897,42,40-44,1939,0.19709021355035164
SIM,1882,28,na,1910,2255
SIM,1889,22,40-44,1911,3
STAT,1908,15,25-29,1923,7.978205800379322
STAT,1868,31,45-49,1899,1.5782036711504261
SIM,1895,33,20-24,1928,2
STAT,1930,30,30-34,1960,19.22943014185863
STAT,1818,39,40-44,1857,11.58200729960262
STAT,1842,22,35-39,1864,5.330169645022457
SIM,1811,86,na,1897,87
STAT,1785,92,na,1877,11.367932703826188
STAT,1887,33,20-24,1920,2.8442262334917605
SIM,1808,82,na,1890,145
STAT,1834,99,na,1933,1.174140583611661
STAT,1904,42,35-39,1946,0.17018398469985627
STAT,1874,31,45-49,1905,1.6900565186993766
SIM,1894,15,25-29,1909,9
STAT,1860,51,na,1911,1658.320519701029
SIM,1858,40,40-44,1898,4
STAT,1866,27,15-19,1893,0.3953206954509037
SIM,1819,82,na,1901,230
SIM,1911,38,35-39,1949,7
SIM,1849,30,35-39,1879,10
STAT,1818,48,30-34,1866,0.20330091224501884
STAT,1910,34,50-100,1944,0.7466903665542743
STAT,1898,45,15-19,1943,2.9132956756372866E-4
STAT,1832,51,35-39,1883,0.005520388212166788
SIM,1843,44,50-100,1887,1
SIM,1877,26,50-100,1903,1
SIM,1893,4,na,1897,3299
STAT,1936,28,45-49,1964,1.5611221392125576
SIM,1868,24,na,1892,2107
SIM,1879,30,50-100,1909,1
SIM,1873,32,30-34,1905,22
STAT,1886,24,50-100,1910,0.4043907817228696
SIM,1864,10,na,1874,2385
SIM,1950,7,na,1957,4260
SIM,1887,75,na,1962,1254
STAT,1840,20,35-39,1860,4.940779275771339
SIM,1911,58,na,1969,3083
SIM,1916,15,25-29,1931,9
STAT,1818,40,20-24,1858,0.4001111654663817
STAT,1844,35,15-19,1879,0.046239370507877714
SIM,1815,40,45-49,1855,2
STAT,1885,31,20-24,1916,2.55571966577182
SIM,1895,24,30-34,1919,27
STAT,1886,15,25-29,1901,5.68116062678994
STAT,1887,24,30-34,1911,18.704131173269584
SIM,1893,39,30-34,1932,6
STAT,1846,23,30-34,1869,16.1840478593065
STAT,1942,3,na,1945,3975.3559510090918
STAT,1855,33,25-29,1888,7.334628007103784
SIM,1856,41,45-49,1897,2
STAT,1861,14,na,1875,2135.736123710855
SIM,1799,66,na,1865,760
STAT,1897,41,40-44,1938,0.1982260488100332
SIM,1899,60,na,1959,2602
SIM,1859,38,40-44,1897,6
SIM,1882,31,45-49,1913,3
STAT,1840,15,na,1855,1973.5599412581964
STAT,1810,49,na,1859,1207.3193174378116
STAT,1835,32,45-49,1867,1.413019742822292
SIM,1915,39,30-34,1954,1
SIM,1859,47,na,1906,1797
SIM,1917,27,35-39,1944,16
STAT,1954,15,50-100,1969,0.4377441903597589
STAT,1820,41,15-19,1861,0.026182213004905017
STAT,1946,24,35-39,1970,9.891987858334792
SIM,1878,61,na,1939,1844
STAT,1923,40,40-44,1963,0.2769394533023173
SIM,1861,20,45-49,1881,1
STAT,1763,107,na,1870,0.00412502965510145
STAT,1881,21,35-39,1902,5.341575185185773
STAT,1850,21,30-34,1871,15.179714416976623
SIM,1940,17,20-24,1957,125
STAT,1837,48,40-44,1885,0.11387034484879936
STAT,1903,38,35-39,1941,2.0418423889900486
STAT,1909,3,na,1912,3745.459995031623
STAT,1932,17,20-24,1949,169.5919519612335
STAT,1780,93,na,1873,5.496126221596468
STAT,1915,38,15-19,1953,0.018235862561920255
SIM,1915,47,50-100,1962,2
STAT,1892,17,15-19,1909,7.022059062156741
STAT,1957,15,20-24,1972,168.92445703181434
STAT,1859,41,20-24,1900,0.11995031536655053
SIM,1876,24,20-24,1900,57
STAT,1910,43,na,1953,3296.0467314992725
STAT,1914,57,na,1971,3290.964383375776
SIM,1844,70,na,1914,896
STAT,1841,30,40-44,1871,3.7036221221323795
STAT,1907,39,30-34,1946,1.5802955058977388
STAT,1912,16,40-44,1928,0.26785941010505687
STAT,1875,50,40-44,1925,0.01036940378297112
SIM,1822,38,45-49,1860,1
SIM,1833,29,30-34,1862,23
SIM,1909,34,25-29,1943,9
STAT,1870,19,40-44,1889,0.16911231964147092
SIM,1837,63,na,1900,1120
SIM,1848,84,na,1932,230
SIM,1864,43,45-49,1907,4
STAT,1862,54,25-29,1916,0.002782275235187087
STAT,1896,38,40-44,1934,5.434656261615685
SIM,1827,85,na,1912,143
STAT,1946,19,na,1965,3854.1618181345457
STAT,1968,1,na,1969,4645.199881185104
SIM,1854,23,30-34,1877,19
STAT,1909,27,35-39,1936,13.555350340028888
SIM,1868,22,20-24,1890,66
SIM,1839,40,30-34,1879,1
SIM,1929,16,na,1945,4428
STAT,1900,30,45-49,1930,2.3036562363896813
SIM,1878,42,35-39,1920,3
STAT,1852,19,50-100,1871,0.04245364830438594
STAT,1914,29,20-24,1943,17.26025786752575
SIM,1908,2,na,1910,3677
STAT,1829,77,na,1906,522.2964700287
STAT,1838,30,20-24,1868,2.3023264533221157
STAT,1842,33,15-19,1875,0.12329558848770658
STAT,1881,29,45-49,1910,1.0060278174323307
STAT,1915,4,na,1919,3977.7332324056392
STAT,1858,28,30-34,1886,18.95663675558279
SIM,1768,89,na,1857,29
SIM,1908,17,na,1925,3511
STAT,1898,31,30-34,1929,22.41206214919382
STAT,1830,37,na,1867,1626.1754556115286
STAT,1832,52,35-39,1884,0.0054121282398857905
STAT,1859,46,15-19,1905,3.016098574776828E-4
STAT,1863,35,25-29,1898,2.409572966879972
STAT,1883,57,na,1940,1861.3470956948902
SIM,1890,33,45-49,1923,4
STAT,1916,17,25-29,1933,8.685706404914864
SIM,1924,17,25-29,1941,71
STAT,1845,19,30-34,1864,1.4087834263722796
SIM,1858,62,na,1920,1492
STAT,1880,42,25-29,1922,0.6387591899055233
STAT,1898,25,45-49,1923,1.429063182627805
SIM,1846,30,20-24,1876,2
SIM,1931,40,40-44,1971,1
SIM,1807,97,na,1904,2
STAT,1820,36,40-44,1856,10.65562101916811
STAT,1860,41,45-49,1901,1.1523799364888383
SIM,1829,44,na,1873,1419
STAT,1926,42,na,1968,4325.167451447917
SIM,1957,0,na,1957,4920
STAT,1944,28,40-44,1972,4.756762781608867
STAT,1837,40,30-34,1877,0.9033033729415567
STAT,1853,20,45-49,1873,0.6325868646651542
SIM,1869,37,35-39,1906,19
SIM,1894,13,na,1907,3264
STAT,1840,51,30-34,1891,0.003925096852224338
STAT,1813,51,25-29,1864,0.00944763704740596
STAT,1935,23,20-24,1958,142.99701557457388
SIM,1941,29,30-34,1970,47
STAT,1815,40,40-44,1855,6.332026475874075
STAT,1859,49,30-34,1908,0.07126334898316007
STAT,1895,42,na,1937,2852.8338458297176
STAT,1903,49,15-19,1952,2.969529035100546E-4
SIM,1865,32,na,1897,2113
SIM,1902,33,50-100,1935,3
STAT,1811,71,na,1882,647.1957321362028
STAT,1899,56,na,1955,2640.107748759732
SIM,1887,25,35-39,1912,18
STAT,1889,42,45-49,1931,1.7433149347279853
STAT,1913,25,35-39,1938,14.228683533747006
STAT,1922,30,35-39,1952,9.832600823211056
SIM,1898,38,na,1936,2965
STAT,1851,16,15-19,1867,5.22104694494309
SIM,1863,39,45-49,1902,1
SIM,1956,9,na,1965,4787
STAT,1896,27,na,1923,2977.630299378311
SIM,1845,40,30-34,1885,3
STAT,1857,24,45-49,1881,0.5379967606716671
SIM,1823,42,45-49,1865,6
SIM,1885,37,30-34,1922,4
STAT,1827,33,na,1860,1662.721502152415
STAT,1892,13,na,1905,3051.0183103002755
SIM,1880,80,na,1960,827
STAT,1885,36,15-19,1921,0.05313208472970755
SIM,1839,70,na,1909,945
SIM,1846,77,na,1923,581
SIM,1809,45,na,1854,1339
STAT,1824,31,30-34,1855,49.76826850877502
SIM,1842,63,na,1905,1145
STAT,1922,49,25-29,1971,0.05723139298560987
STAT,1877,37,30-34,1914,5.222637942536539
STAT,1844,77,na,1921,600.3408198709095
SIM,1866,28,30-34,1894,32
SIM,1922,29,20-24,1951,19
SIM,1844,33,na,1877,1710
STAT,1891,22,30-34,1913,20.818662306985235
SIM,1848,47,na,1895,1592
SIM,1921,25,35-39,1946,21
STAT,1861,33,25-29,1894,8.011482280797447
STAT,1884,46,25-29,1930,0.05391190534375215
SIM,1880,22,20-24,1902,56
STAT,1840,26,40-44,1866,2.468869095494858
SIM,1885,79,na,1964,888
SIM,1943,23,20-24,1966,93
STAT,1933,29,30-34,1962,49.10036168169029
STAT,1879,25,35-39,1904,9.606299819870216
STAT,1907,20,40-44,1927,2.9090130754187826
SIM,1844,51,50-100,1895,1
SIM,1904,3,na,1907,3634
SIM,1930,30,35-39,1960,15
STAT,1816,43,15-19,1859,0.03560141134422458
STAT,1836,51,50-100,1887,0.010093607860634065
STAT,1809,52,na,1861,1176.7441835712782
STAT,1837,45,25-29,1882,0.03981269111319059
STAT,1856,40,40-44,1896,1.674620006555475
STAT,1920,20,50-100,1940,0.6951679821426858
STAT,1935,17,35-39,1952,5.419100124692114
SIM,1887,31,20-24,1918,2
STAT,1765,106,na,1871,0.00869652160357709
STAT,1859,37,25-29,1896,2.164841067171496
STAT,1825,29,30-34,1854,83.3019615874108
SIM,1829,25,25-29,1854,34
STAT,1902,46,40-44,1948,0.1291171190779874
SIM,1817,39,50-100,1856,3
STAT,1879,31,20-24,1910,2.683905833379261
STAT,1883,34,15-19,1917,0.13077061697718315
STAT,1876,50,na,1926,2131.701467474799
STAT,1821,51,20-24,1872,0.001141633378496839
STAT,1888,16,25-29,1904,6.342147125033867
SIM,1865,30,30-34,1895,19
SIM,1888,43,30-34,1931,2
STAT,1846,25,na,1871,1969.2321975414839
STAT,1907,47,50-100,1954,0.1913579015642741
SIM,1843,32,45-49,1875,1
SIM,1896,16,25-29,1912,7
STAT,1924,43,15-19,1967,0.0017228539668233264
SIM,1943,17,35-39,1960,8
STAT,1881,13,na,1894,2353.1615517435307
STAT,1861,42,15-19,1903,0.010834088623347088
STAT,1911,37,30-34,1948,1.6630687084053115
SIM,1835,23,20-24,1858,64
STAT,1878,49,40-44,1927,0.16503073268161267
STAT,1868,28,15-19,1896,0.40750173357992653
SIM,1885,24,25-29,1909,62
SIM,1889,26,35-39,1915,17
STAT,1934,17,30-34,1951,15.574734084667384
STAT,1790,92,na,1882,10.680199011876262
SIM,1887,32,35-39,1919,10
SIM,1875,80,na,1955,531
SIM,1946,15,35-39,1961,4
STAT,1929,34,na,1963,4532.340007050647
STAT,1810,51,45-49,1861,0.04722767745448173
STAT,1882,42,35-39,1924,1.6615742487114182
STAT,1866,53,50-100,1919,0.01294806017645085
STAT,1858,30,35-39,1888,7.658334147682601
STAT,1913,21,40-44,1934,3.087359394386222
STAT,1912,39,15-19,1951,0.017528586934956007
STAT,1916,22,20-24,1938,110.07282687130693
STAT,1918,16,20-24,1934,28.037632665272415
STAT,1927,18,50-100,1945,0.4389145840133822
SIM,1935,27,40-44,1962,5
STAT,1828,36,50-100,1864,1.1466102570011922
SIM,1928,37,na,1965,4501
SIM,1924,22,20-24,1946,115
STAT,1866,26,15-19,1892,0.3966773319260909
STAT,1873,53,35-39,1926,0.008116026250689416
STAT,1784,86,na,1870,63.81402466275283
STAT,1904,43,35-39,1947,0.16916288079165706
STAT,1877,24,25-29,1901,55.74578171590276
SIM,1914,39,na,1953,3514
SIM,1928,24,30-34,1952,40
STAT,1840,25,40-44,1865,2.4867237721791056
SIM,1926,38,40-44,1964,2
STAT,1900,27,15-19,1927,0.5945792061379499
STAT,1865,33,45-49,1898,1.4868747643088884
STAT,1919,28,45-49,1947,1.7572251852029055
STAT,1915,40,45-49,1955,0.15873274317500852
SIM,1841,68,na,1909,981
STAT,1825,85,na,1910,145.6985224351357
SIM,1902,16,35-39,1918,4
STAT,1889,5,na,1894,3056.332415562053
SIM,1890,42,35-39,1932,5
STAT,1804,50,20-24,1854,0.0027148037806089954
SIM,1848,30,30-34,1878,23
SIM,1839,32,30-34,1871,18
STAT,1933,38,20-24,1971,0.3388536093487367
STAT,1963,6,na,1969,4716.90613849944
SIM,1854,11,na,1865,2287
SIM,1917,32,30-34,1949,16
SIM,1823,40,40-44,1863,5
SIM,1907,25,25-29,1932,65
STAT,1836,63,na,1899,1155.4557802105337
STAT,1883,33,50-100,1916,0.8450576231778737
STAT,1922,38,45-49,1960,0.7320667917574799
SIM,1822,39,45-49,1861,5
SIM,1823,55,na,1878,1155
STAT,1907,48,20-24,1955,0.009275498078602158
SIM,1927,28,45-49,1955,5
SIM,1867,33,20-24,1900,5
SIM,1910,35,25-29,1945,1
STAT,1875,24,15-19,1899,3.1833468912887946
SIM,1824,30,45-49,1854,1
STAT,1891,20,40-44,1911,2.4500483504258255
STAT,1894,21,20-24,1915,83.91576276666817
STAT,1929,22,30-34,1951,34.33430363864465
SIM,1869,41,30-34,1910,4
STAT,1796,71,na,1867,596.7246076543177
SIM,1926,16,20-24,1942,129
SIM,1938,28,20-24,1966,19
STAT,1878,53,25-29,1931,0.003431194163125043
SIM,1849,58,na,1907,1506
SIM,1933,15,25-29,1948,68
SIM,1890,31,40-44,1921,8
STAT,1912,42,30-34,1954,0.1164878610175984
STAT,1952,17,35-39,1969,4.750361605194099
STAT,1882,31,40-44,1913,4.000490069926328
STAT,1883,21,45-49,1904,0.6478184958701534
SIM,1891,21,45-49,1912,3
SIM,1930,0,na,1930,5143
STAT,1885,43,15-19,1928,0.012909999714575508
STAT,1876,45,15-19,1921,3.942937273206657E-4
SIM,1878,39,na,1917,2358
STAT,1935,0,na,1935,5818.150193410438
STAT,1890,27,na,1917,2756.352762764855
STAT,1902,35,25-29,1937,0.8364046033287853
STAT,1865,20,25-29,1885,50.33352474026605
STAT,1911,12,na,1923,3733.574962563204
SIM,1874,20,30-34,1894,25
STAT,1918,2,na,1920,4205.406664852711
STAT,1945,18,45-49,1963,0.5153415332706541
STAT,1853,53,50-100,1906,0.011246186224866029
SIM,1859,39,40-44,1898,5
STAT,1825,39,20-24,1864,0.891036094256087
STAT,1905,49,25-29,1954,0.04344020717409932
SIM,1853,53,na,1906,1616
SIM,1876,31,20-24,1907,2
STAT,1902,48,45-49,1950,0.1752545396417146
STAT,1883,15,35-39,1898,0.510583015681727
STAT,1859,36,25-29,1895,2.1752605652791837
STAT,1862,95,na,1957,14.211237758610244
STAT,1911,33,25-29,1944,8.466814017469035
STAT,1827,30,20-24,1857,3.536754324189842
SIM,1918,17,25-29,1935,53
STAT,1868,52,50-100,1920,0.013540276547029655
STAT,1886,19,40-44,1905,0.18154204032553817
SIM,1893,28,na,1921,2946
SIM,1835,50,na,1885,1413
SIM,1937,22,30-34,1959,34
STAT,1822,109,na,1931,3.615194448464853E-4
STAT,1908,44,50-100,1952,0.10142146817640692
SIM,1908,34,30-34,1942,21
SIM,1855,20,20-24,1875,53
STAT,1929,17,35-39,1946,5.058797730714456
STAT,1881,52,30-34,1933,0.0054034162521099625
STAT,1760,115,na,1875,1.4255407820009018E-4
STAT,1817,40,50-100,1857,2.9048830522200855
STAT,1879,23,20-24,1902,67.93514775969854
SIM,1838,23,25-29,1861,55
SIM,1939,25,45-49,1964,1
SIM,1919,4,na,1923,4269
STAT,1836,20,45-49,1856,0.7366982515118086
STAT,1896,37,40-44,1933,5.461746524376591
STAT,1907,16,45-49,1923,0.09087248546998836
STAT,1918,38,40-44,1956,1.4891045974271018
SIM,1864,41,40-44,1905,3
STAT,1791,106,na,1897,0.002248115377571326
STAT,1863,30,30-34,1893,14.590754987647282
STAT,1828,34,na,1862,1589.466871369515
SIM,1789,88,na,1877,30
SIM,1830,38,40-44,1868,4
STAT,1862,52,20-24,1914,5.928581851366217E-4
SIM,1862,30,na,1892,2034
STAT,1877,45,na,1922,2226.6768155374834
STAT,1840,68,na,1908,1002.8913412149743
SIM,1791,92,na,1883,8
STAT,1822,38,40-44,1860,7.296922231303447
SIM,1907,29,30-34,1936,48
STAT,1813,42,50-100,1855,3.4555433666330493
SIM,1866,30,35-39,1896,13
STAT,1847,51,40-44,1898,0.007800308771863825
STAT,1848,41,45-49,1889,1.125043128422702
STAT,1900,49,35-39,1949,0.10133186344465092
STAT,1924,36,15-19,1960,0.021410808825814455
STAT,1843,33,na,1876,1741.665941893106
STAT,1846,33,35-39,1879,8.78476992011165
SIM,1898,43,na,1941,2887
STAT,1813,43,25-29,1856,1.9613593972385759
STAT,1815,51,35-39,1866,0.01897833845734047
SIM,1835,30,20-24,1865,2
SIM,1888,41,40-44,1929,5
STAT,1885,64,na,1949,1636.9140227296405
STAT,1925,39,25-29,1964,1.1139822293821893
STAT,1898,23,30-34,1921,22.701207843504708
SIM,1826,79,na,1905,327
SIM,1827,28,40-44,1855,2
SIM,1880,20,30-34,1900,18
STAT,1948,22,40-44,1970,3.647241664372781
STAT,1879,32,35-39,1911,10.014384122522662
SIM,1878,20,15-19,1898,3
SIM,1906,17,20-24,1923,19
STAT,1920,43,50-100,1963,0.12237841644649022
STAT,1880,34,25-29,1914,10.113630119452043
SIM,1793,93,na,1886,10
SIM,1942,17,30-34,1959,12
SIM,1889,31,30-34,1920,30
STAT,1905,22,45-49,1927,0.9521886986187479
SIM,1913,22,45-49,1935,1
STAT,1830,40,20-24,1870,0.12704339490228506
STAT,1916,22,50-100,1938,0.6513571130673207
STAT,1930,33,35-39,1963,11.134035647547268
SIM,1937,17,35-39,1954,3
STAT,1847,20,20-24,1867,63.20046318668125
SIM,1837,33,35-39,1870,7
STAT,1839,30,25-29,1869,8.568298133760466
STAT,1853,20,20-24,1873,62.51511520656843
STAT,1874,22,30-34,1896,17.192832517968863
SIM,1919,35,45-49,1954,2
STAT,1861,30,na,1891,1889.483477958077
SIM,1936,35,45-49,1971,1
SIM,1906,23,40-44,1929,2
SIM,1902,21,30-34,1923,25
SIM,1911,27,40-44,1938,5
STAT,1870,20,20-24,1890,64.24648897446622
STAT,1896,24,35-39,1920,7.235264174144222
STAT,1899,25,15-19,1924,0.5912580444613624
STAT,1838,31,35-39,1869,8.536610491425794
STAT,1913,48,20-24,1961,0.01016188635054443
STAT,1815,85,na,1900,122.36244610294497
STAT,1857,22,30-34,1879,15.320880475718802
SIM,1883,9,na,1892,2413
STAT,1918,25,35-39,1943,15.196649926795601
STAT,1885,20,40-44,1905,1.9739128280770755
STAT,1855,31,35-39,1886,7.404070166053143
SIM,1869,78,na,1947,744
SIM,1887,23,20-24,1910,78
STAT,1859,33,45-49,1892,1.3056302680946617
STAT,1957,15,45-49,1972,0.6224186553698369
SIM,1855,3,na,1858,2576
STAT,1917,46,25-29,1963,0.05247269784507313
SIM,1838,64,na,1902,1141
STAT,1939,27,45-49,1966,1.6407287855780732
STAT,1854,66,na,1920,1172.6872117438213
STAT,1935,25,35-39,1960,19.350320832971345
SIM,1878,45,na,1923,2299
SIM,1941,2,na,1943,3858
STAT,1844,42,15-19,1886,0.009823044115237116
SIM,1852,25,25-29,1877,35
STAT,1833,22,45-49,1855,0.5760467937019585
STAT,1906,43,na,1949,3167.974766015884
SIM,1783,73,na,1856,413
STAT,1828,50,na,1878,1351.8928962626567
SIM,1847,30,25-29,1877,15
SIM,1872,21,35-39,1893,6
STAT,1851,52,45-49,1903,0.010383828566466361
SIM,1846,83,na,1929,242
STAT,1839,28,na,1867,1801.4288728472034
STAT,1835,32,20-24,1867,2.1902894618465774
STAT,1928,35,45-49,1963,0.8152908406641374
SIM,1873,20,25-29,1893,65
STAT,1842,97,na,1939,3.890482720346154
SIM,1897,34,45-49,1931,2
STAT,1821,109,na,1930,3.790416476067038E-4
SIM,1767,101,na,1868,1
SIM,1943,25,35-39,1968,27
STAT,1844,25,25-29,1869,36.487347578440804
STAT,1866,51,na,1917,1885.077343305065
SIM,1823,49,na,1872,1298
STAT,1834,51,45-49,1885,0.009419428018702032
STAT,1818,49,30-34,1867,0.20025816354647347
STAT,1892,35,50-100,1927,1.4665237338191188
STAT,1850,22,45-49,1872,0.5899940468943323
STAT,1903,27,40-44,1930,4.026493960001449
STAT,1904,17,45-49,1921,0.08851567834690383
STAT,1886,28,na,1914,2373.1533294715937
STAT,1953,17,40-44,1970,1.5983832479953433
SIM,1841,78,na,1919,492
STAT,1828,51,30-34,1879,0.004747480664812
STAT,1840,29,45-49,1869,0.8955144293327456
SIM,1865,22,30-34,1887,21
SIM,1934,24,30-34,1958,44
SIM,1832,85,na,1917,139
SIM,1893,20,40-44,1913,3
STAT,1885,23,20-24,1908,64.69049359603278
STAT,1926,24,30-34,1950,32.77865954074032
SIM,1814,48,50-100,1862,3
STAT,1848,44,50-100,1892,0.7744089586084858
STAT,1851,15,15-19,1866,5.251981113702798
STAT,1864,21,35-39,1885,5.028423721584998
STAT,1865,103,na,1968,0.9222899758949896
STAT,1883,3,na,1886,2754.541002890191
STAT,1895,42,30-34,1937,0.09820402280844515
SIM,1778,94,na,1872,4
STAT,1849,23,35-39,1872,5.252535795647189
STAT,1929,28,15-19,1957,0.8342253313460637
SIM,1873,30,40-44,1903,7
SIM,1833,33,na,1866,1674
STAT,1845,54,25-29,1899,0.0024375052866518173
STAT,1828,54,25-29,1882,0.0024222386453918547
SIM,1886,74,na,1960,1197
STAT,1868,23,45-49,1891,0.6265831576913085
STAT,1861,20,na,1881,1936.2073289990212
STAT,1899,72,na,1971,2030.7962520197646
STAT,1949,18,15-19,1967,49.848865989916646
SIM,1945,25,45-49,1970,1
STAT,1856,52,35-39,1908,0.006311765795382227
SIM,1893,23,20-24,1916,83
STAT,1848,39,15-19,1887,0.04211578184264333
SIM,1901,28,25-29,1929,56
SIM,1866,24,15-19,1890,2
STAT,1844,30,20-24,1874,2.2920930734180387
STAT,1907,24,20-24,1931,95.03310338441166
STAT,1854,41,30-34,1895,0.8262923386659041
SIM,1826,32,20-24,1858,2
STAT,1871,41,20-24,1912,0.14965219665981688
STAT,1943,24,30-34,1967,28.86781547044239
SIM,1828,43,35-39,1871,4
STAT,1886,12,na,1898,2577.1126882462263
STAT,1833,98,na,1931,1.9930648381791882
SIM,1928,15,na,1943,4422
SIM,1931,19,na,1950,4534
SIM,1896,58,na,1954,2469
STAT,1879,58,na,1937,1955.593139946362
STAT,1881,26,40-44,1907,2.7431526701575466
STAT,1873,79,na,1952,669.8228579504275
STAT,1889,34,45-49,1923,2.0163290332536388
STAT,1924,24,20-24,1948,123.17274093378431
SIM,1930,27,50-100,1957,1
STAT,1944,17,na,1961,3741.9778642927854
SIM,1853,63,na,1916,1355
STAT,1908,27,30-34,1935,35.28971909508878
STAT,1894,47,na,1941,2719.1894527028685
SIM,1846,31,35-39,1877,14
SIM,1926,25,35-39,1951,19
SIM,1936,8,na,1944,2993
STAT,1875,52,45-49,1927,0.014016749257952113
SIM,1878,23,na,1901,2407
SIM,1898,24,35-39,1922,12
STAT,1859,27,50-100,1886,0.48928081011349744
SIM,1861,20,20-24,1881,61
SIM,1915,24,20-24,1939,106
STAT,1824,38,50-100,1862,1.8302454136637873
STAT,1837,49,40-44,1886,0.11242077535887414
STAT,1890,36,50-100,1926,1.424825839509526
SIM,1916,27,30-34,1943,43
SIM,1878,34,35-39,1912,10
STAT,1938,15,35-39,1953,3.9285595145791516
SIM,1879,24,25-29,1903,60
STAT,1849,34,15-19,1883,0.1102140096562587
STAT,1923,43,45-49,1966,0.18347164431415097
SIM,1932,24,20-24,1956,118
SIM,1847,43,45-49,1890,1
STAT,1870,15,25-29,1885,5.364742864506043
STAT,1895,45,25-29,1940,0.0404150589640941
STAT,1806,49,na,1855,1240.4359521907334
SIM,1910,32,20-24,1942,4
SIM,1850,47,50-100,1897,2
STAT,1874,80,na,1954,597.0836158599783
STAT,1892,16,15-19,1908,7.039305360289451
STAT,1927,27,40-44,1954,5.3529976218424995
SIM,1863,31,35-39,1894,13
SIM,1921,21,40-44,1942,4
SIM,1894,28,50-100,1922,4
STAT,1910,28,25-29,1938,59.83459204370185
SIM,1878,55,na,1933,2098
STAT,1876,33,20-24,1909,2.627065108928153
STAT,1918,49,35-39,1967,0.12885500169450648
STAT,1945,27,50-100,1972,1.0316009999425866
STAT,1839,43,45-49,1882,1.036856186509599
STAT,1825,79,na,1904,371.56442570412435
STAT,1894,57,na,1951,2439.7914386955754
STAT,1820,48,na,1868,1340.5784108613243
SIM,1846,22,20-24,1868,46
STAT,1937,25,45-49,1962,1.5923145707930004
SIM,1861,82,na,1943,351
STAT,1841,16,na,1857,2053.1090494172554
SIM,1822,35,40-44,1857,4
STAT,1838,22,20-24,1860,60.02482461588489
STAT,1909,35,35-39,1944,2.1834381024277274
SIM,1873,24,na,1897,2267
STAT,1913,24,45-49,1937,1.0666828687992167
SIM,1856,33,45-49,1889,1
STAT,1848,31,50-100,1879,0.802248636181979
STAT,1887,47,40-44,1934,0.1800609664468691
SIM,1900,38,35-39,1938,3
STAT,1868,25,na,1893,2165.667494899921
STAT,1870,29,30-34,1899,23.17081151092173
STAT,1920,27,30-34,1947,40.604798553687665
SIM,1878,37,50-100,1915,1
STAT,1931,10,na,1941,4914.139476993078
STAT,1838,25,25-29,1863,36.65025060091953
STAT,1792,89,na,1881,37.095238599810706
SIM,1871,50,na,1921,2091
STAT,1935,16,20-24,1951,175.51856776001677
STAT,1901,44,na,1945,3025.407849480776
STAT,1845,83,na,1928,280.9194468889387
STAT,1824,49,30-34,1873,0.11470177888428278
STAT,1872,20,30-34,1892,16.979221218341067
SIM,1943,16,20-24,1959,141
SIM,1871,34,25-29,1905,10
STAT,1764,106,na,1870,0.008059299644980634
SIM,1929,15,35-39,1944,4
STAT,1806,50,40-44,1856,0.038584661558686235
STAT,1911,16,35-39,1927,0.7952259338752773
STAT,1904,58,na,1962,2816.9786124013503
SIM,1917,35,35-39,1952,8
STAT,1854,44,25-29,1898,0.45325197730504924
STAT,1842,18,15-19,1860,5.48630139882333
SIM,1945,24,30-34,1969,34
SIM,1832,32,45-49,1864,1
STAT,1859,81,na,1940,406.5957058201619
SIM,1817,96,na,1913,5
STAT,1822,39,50-100,1861,1.9383706772240188
STAT,1882,1,na,1883,3087.3743512200426
SIM,1830,39,50-100,1869,1
STAT,1914,17,15-19,1931,8.86889358646084
SIM,1904,21,40-44,1925,3
SIM,1841,84,na,1925,191
SIM,1889,43,50-100,1932,2
STAT,1830,43,25-29,1873,0.49262663958281877
SIM,1922,17,15-19,1939,45
STAT,1869,52,30-34,1921,0.0054187095358055075
STAT,1861,52,na,1913,1682.2819580746504
STAT,1898,26,35-39,1924,12.377711080206865
STAT,1937,24,30-34,1961,26.422553765177447
STAT,1873,50,30-34,1923,0.005785181533191831
SIM,1921,24,45-49,1945,2
SIM,1942,4,na,1946,3881
STAT,1912,45,35-39,1957,0.11760965601136787
SIM,1840,40,40-44,1880,5
STAT,1916,29,30-34,1945,37.99926339579128
STAT,1916,35,50-100,1951,0.4100337337128678
SIM,1954,17,35-39,1971,5
SIM,1869,44,35-39,1913,6
STAT,1835,31,50-100,1866,0.7501834930611628
SIM,1916,19,30-34,1935,13
STAT,1804,53,25-29,1857,0.012266924057209893
SIM,1861,36,30-34,1897,3
STAT,1819,51,na,1870,1344.114026239
SIM,1892,20,35-39,1912,12
SIM,1893,26,25-29,1919,53
SIM,1950,19,30-34,1969,17
STAT,1877,36,50-100,1913,1.2088982988349366
STAT,1942,19,30-34,1961,12.02534958580996
SIM,1928,27,35-39,1955,19
STAT,1944,16,50-100,1960,0.38099376670714746
SIM,1863,23,35-39,1886,7
STAT,1855,23,35-39,1878,4.809763393347101
SIM,1858,2,na,1860,2704
STAT,1868,101,na,1969,3.7369086467948867
STAT,1900,46,30-34,1946,0.0717609841388421
STAT,1845,15,15-19,1860,5.370832010077502
STAT,1857,31,45-49,1888,1.3209203006553574
STAT,1848,33,45-49,1881,1.360885248607105
STAT,1909,48,40-44,1957,0.13648768303267594
STAT,1844,22,45-49,1866,0.6046880401171281
SIM,1918,27,40-44,1945,5
STAT,1889,33,30-34,1922,20.276550663716012
SIM,1869,46,na,1915,2074
STAT,1844,82,na,1926,324.052549468141
SIM,1880,29,40-44,1909,3
SIM,1833,49,na,1882,1416
STAT,1865,30,40-44,1895,3.7432323755182932
SIM,1880,0,na,1880,3467
SIM,1889,23,30-34,1912,33
STAT,1932,40,45-49,1972,0.21368058019892922
STAT,1831,39,20-24,1870,0.5768623849320332
STAT,1884,20,35-39,1904,5.4788706085395145
SIM,1826,35,25-29,1861,4
STAT,1760,109,na,1869,0.0023536735044543283
STAT,1872,29,40-44,1901,2.818240731345641
SIM,1881,41,40-44,1922,3
SIM,1901,25,20-24,1926,16
STAT,1871,44,25-29,1915,0.5942585950229617
STAT,1911,25,25-29,1936,61.05250474039584
STAT,1933,20,50-100,1953,0.8294457681523489
STAT,1944,15,35-39,1959,4.268198027224643
STAT,1946,23,45-49,1969,1.1824754018940806
STAT,1953,16,na,1969,4207.369248058124
STAT,1931,28,45-49,1959,2.1060195430298556
SIM,1805,68,na,1873,716
STAT,1832,97,na,1929,3.236246344422283
STAT,1885,26,25-29,1911,39.96955686445413
STAT,1861,106,na,1967,0.08083307475303832
STAT,1946,17,35-39,1963,4.39677367517979
SIM,1835,34,na,1869,1668
STAT,1858,52,45-49,1910,0.010691853368123843
SIM,1803,67,na,1870,724
SIM,1906,34,20-24,1940,2
SIM,1853,15,15-19,1868,5
STAT,1767,104,na,1871,0.027799273203483667
STAT,1774,92,na,1866,8.311348654590365
STAT,1845,30,na,1875,1861.7342619361098
STAT,1916,43,na,1959,3589.7712164196187
SIM,1888,44,45-49,1932,6
STAT,1864,44,na,1908,1919.7313331885887
STAT,1820,39,45-49,1859,4.046423960384805
STAT,1872,95,na,1967,50.04213676785463
SIM,1883,17,15-19,1900,5
SIM,1787,71,na,1858,518
SIM,1865,31,45-49,1896,1
STAT,1879,74,na,1953,1097.440172834714
STAT,1848,32,30-34,1880,15.129505141286533
STAT,1894,41,na,1935,2818.6556958372776
STAT,1928,32,40-44,1960,4.622457449023264
STAT,1941,2,na,1943,3956.702060720258
SIM,1845,34,na,1879,1759
STAT,1807,66,na,1873,834.3384778997267
SIM,1920,28,35-39,1948,20
STAT,1923,19,20-24,1942,149.58515522246392
STAT,1822,54,50-100,1876,0.018781384135110428
STAT,1853,36,30-34,1889,4.0755037879327265
SIM,1830,33,25-29,1863,7
STAT,1857,36,15-19,1893,0.04203994483989004
STAT,1912,28,35-39,1940,13.928275842524997
STAT,1873,41,40-44,1914,2.16481488459318
SIM,1830,35,na,1865,1676
STAT,1829,33,35-39,1862,9.831551294988795
SIM,1821,48,na,1869,1319
STAT,1903,45,50-100,1948,0.18807381800211567
SIM,1833,45,50-100,1878,1
SIM,1856,32,30-34,1888,17
SIM,1850,18,15-19,1868,4
SIM,1952,15,35-39,1967,5
STAT,1774,86,na,1860,51.69815750747808
STAT,1917,34,30-34,1951,15.45241017831735
SIM,1876,6,na,1882,2662
STAT,1874,23,45-49,1897,0.6709913108943086
SIM,1868,29,40-44,1897,7
STAT,1837,52,25-29,1889,0.0023071395357893263
SIM,1848,22,30-34,1870,20
SIM,1941,17,25-29,1958,59
STAT,1909,48,30-34,1957,0.07717294241848179
STAT,1824,32,45-49,1856,4.246714352439906
STAT,1933,17,25-29,1950,54.80198708710933
STAT,1940,19,na,1959,3528.1539106767896
STAT,1847,96,na,1943,6.331863444516781
SIM,1872,15,25-29,1887,6
STAT,1844,22,20-24,1866,59.75802629409013
STAT,1846,30,30-34,1876,15.62473800089492
SIM,1852,39,30-34,1891,5
STAT,1864,15,25-29,1879,5.488337984315478
STAT,1877,21,45-49,1898,0.6853926034166655
STAT,1844,39,30-34,1883,3.8310929824621316
SIM,1839,35,35-39,1874,9
SIM,1908,60,na,1968,2855
SIM,1908,37,35-39,1945,4
STAT,1891,23,45-49,1914,0.8124979695946136
SIM,1888,31,25-29,1919,18
STAT,1811,54,30-34,1865,0.018206142443362345
SIM,1925,34,30-34,1959,26
SIM,1859,34,25-29,1893,13
STAT,1897,34,50-100,1931,1.1476578489887859
SIM,1852,22,20-24,1874,62
STAT,1874,27,na,1901,2303.528079939288
STAT,1830,40,50-100,1870,0.8451147412833266
STAT,1879,30,50-100,1909,0.9133336315343583
SIM,1887,30,50-100,1917,4
SIM,1934,27,35-39,1961,19
STAT,1935,22,30-34,1957,36.973616909155325
SIM,1921,1,na,1922,4436
SIM,1887,26,25-29,1913,39
STAT,1931,39,25-29,1970,1.2292230065458043
STAT,1898,32,45-49,1930,2.2293364818960812
SIM,1841,21,30-34,1862,16
STAT,1885,23,45-49,1908,0.65459939379998
STAT,1797,87,na,1884,58.97253049736623
SIM,1829,30,20-24,1859,1
STAT,1851,29,20-24,1880,9.739443303987516
STAT,1888,21,20-24,1909,77.16951109548127
SIM,1891,19,15-19,1910,4
STAT,1915,17,20-24,1932,26.80643823824128
STAT,1875,38,na,1913,2276.3414646695114
STAT,1932,38,15-19,1970,0.02434982111252004
STAT,1857,25,35-39,1882,7.51231291578582
SIM,1845,38,50-100,1883,1
SIM,1921,42,na,1963,3980
STAT,1886,16,15-19,1902,5.936694781671204
STAT,1899,31,35-39,1930,13.162071075498062
SIM,1854,30,30-34,1884,22
STAT,1905,16,50-100,1921,0.0670624387162761
STAT,1868,47,30-34,1915,0.08684315317801339
STAT,1883,19,15-19,1902,5.467182796338819
STAT,1845,18,40-44,1863,0.16262151907079572
STAT,1927,37,na,1964,4418.76780013722
STAT,1919,4,na,1923,4213.640694399434
STAT,1901,27,20-24,1928,15.512988880190322
STAT,1904,35,35-39,1939,2.0883133691613764
STAT,1805,49,20-24,1854,0.04458835829485637
SIM,1896,21,20-24,1917,81
STAT,1835,44,15-19,1879,0.010265142856907874
SIM,1878,29,na,1907,2385
SIM,1912,22,na,1934,3424
SIM,1923,17,20-24,1940,145
SIM,1936,32,40-44,1968,3
STAT,1837,38,50-100,1875,0.9601124660908369
SIM,1791,103,na,1894,1
STAT,1926,27,35-39,1953,17.001907689934956
SIM,1826,32,45-49,1858,1
STAT,1863,42,25-29,1905,0.5317038638061595
SIM,1902,24,35-39,1926,10
STAT,1786,71,na,1857,535.2278083395529
SIM,1845,12,na,1857,2111
STAT,1843,98,na,1941,2.1942164204995436
STAT,1926,44,25-29,1970,0.08288520762539577
SIM,1791,86,na,1877,54
STAT,1879,26,25-29,1905,41.974293293116666
STAT,1846,46,40-44,1892,0.12734021060065803
STAT,1795,91,na,1886,19.71636516520247
STAT,1866,20,30-34,1886,15.87407969299682
SIM,1867,30,40-44,1897,4
SIM,1931,19,20-24,1950,152
SIM,1838,80,na,1918,375
STAT,1907,24,45-49,1931,0.961634521678495
SIM,1943,22,30-34,1965,34
STAT,1879,35,50-100,1914,1.2256121923834677
STAT,1870,32,15-19,1902,0.131977918903221
STAT,1870,23,25-29,1893,52.88908280141166
STAT,1904,42,na,1946,3138.807114962122
SIM,1888,23,na,1911,2655
SIM,1842,16,15-19,1858,5
SIM,1798,65,na,1863,787
STAT,1925,5,na,1930,4588.329039174167
STAT,1924,19,na,1943,4118.453480543941
STAT,1887,23,na,1910,2491.3874794277167
SIM,1903,61,na,1964,2685
STAT,1906,48,15-19,1954,3.065486629346582E-4
STAT,1841,41,35-39,1882,1.3139671189748159
STAT,1859,30,40-44,1889,3.3082355334353304
SIM,1862,41,30-34,1903,6
SIM,1925,46,50-100,1971,2
SIM,1828,86,na,1914,111
STAT,1855,83,na,1938,282.1095496159574
STAT,1841,32,na,1873,1812.8254012442465
STAT,1863,33,35-39,1896,8.360083778506759
STAT,1870,50,na,1920,2024.14823634862
STAT,1925,15,25-29,1940,49.68197276901699
STAT,1930,25,35-39,1955,18.04993011569391
SIM,1886,58,na,1944,1899
SIM,1891,27,na,1918,2818
STAT,1832,40,40-44,1872,1.7071108042042002
SIM,1924,29,30-34,1953,55
STAT,1902,23,30-34,1925,23.67451482597154
SIM,1847,40,40-44,1887,5
SIM,1897,33,30-34,1930,32
STAT,1859,50,50-100,1909,0.011518799149452974
SIM,1895,31,30-34,1926,33
SIM,1916,17,15-19,1933,6
SIM,1873,33,45-49,1906,3
STAT,1917,46,50-100,1963,0.22373775489001288
STAT,1940,18,50-100,1958,0.35924819012131415
STAT,1907,60,na,1967,2879.4131336774503
STAT,1880,31,30-34,1911,17.459802628718105
STAT,1927,17,25-29,1944,50.90115816498202
SIM,1935,17,25-29,1952,70
STAT,1895,49,40-44,1944,0.11645347914642035
SIM,1912,35,35-39,1947,5
SIM,1894,45,na,1939,2875
STAT,1845,51,20-24,1896,5.246714388185084E-4
SIM,1896,74,na,1970,1753
SIM,1805,52,na,1857,1166
STAT,1909,32,30-34,1941,14.2037497233806
STAT,1786,93,na,1879,6.306619573093155
STAT,1908,19,30-34,1927,2.221657750925259
STAT,1842,20,45-49,1862,0.6461844577746382
STAT,1840,84,na,1924,218.31276708977455
STAT,1859,33,20-24,1892,2.0238275026248593
STAT,1887,31,30-34,1918,18.524805197226158
SIM,1865,25,35-39,1890,15
STAT,1911,22,na,1933,3419.188794836206
STAT,1908,17,15-19,1925,8.31663345271216
SIM,1808,66,na,1874,822
STAT,1839,40,40-44,1879,1.7794860569438484
SIM,1910,23,30-34,1933,30
SIM,1827,48,50-100,1875,1
SIM,1846,25,25-29,1871,41
SIM,1859,31,45-49,1890,1
SIM,1919,34,30-34,1953,20
STAT,1844,33,25-29,1877,8.418958676354634
STAT,1850,39,30-34,1889,3.737996955113396
SIM,1938,15,na,1953,3296
SIM,1821,40,30-34,1861,3
STAT,1907,27,25-29,1934,58.702852412674616
STAT,1841,36,50-100,1877,1.007658869398249
SIM,1844,23,25-29,1867,55
STAT,1894,63,na,1957,2212.5231623003056
STAT,1905,38,45-49,1943,0.58462607459756
SIM,1867,36,25-29,1903,1
STAT,1854,110,na,1964,0.0010388309315884888
SIM,1928,33,45-49,1961,4
STAT,1822,41,25-29,1863,0.9604987454740962
STAT,1950,6,na,1956,4391.282872171953
SIM,1913,38,45-49,1951,3
SIM,1905,29,20-24,1934,19
STAT,1894,37,30-34,1931,6.47037105371022
STAT,1855,61,na,1916,1327.9022893370718
STAT,1913,40,35-39,1953,0.18761893864271267
SIM,1833,27,na,1860,1741
SIM,1915,27,25-29,1942,63
SIM,1941,19,na,1960,3497
STAT,1833,21,30-34,1854,16.00429737650664
STAT,1827,46,30-34,1873,0.08972353116197042
STAT,1836,23,25-29,1859,48.57280573580689
SIM,1829,47,50-100,1876,2
SIM,1869,25,na,1894,2215
STAT,1861,34,15-19,1895,0.11090170141267766
SIM,1923,16,na,1939,4135
STAT,1873,38,50-100,1911,1.1704835706576795
STAT,1816,49,na,1865,1352.345657777398
SIM,1798,87,na,1885,45
STAT,1884,80,na,1964,830.6668938178229
SIM,1842,69,na,1911,934
STAT,1933,39,35-39,1972,3.105667946864246
SIM,1859,31,20-24,1890,4
STAT,1824,84,na,1908,183.4261142060863
STAT,1853,29,30-34,1882,19.802914492865035
SIM,1925,23,na,1948,4062
STAT,1855,20,30-34,1875,15.002207239026736
STAT,1931,17,15-19,1948,56.11600910385351
SIM,1871,31,20-24,1902,2
STAT,1908,36,20-24,1944,0.23428722361951226
SIM,1911,23,25-29,1934,78
STAT,1901,60,na,1961,2647.6266180447346
STAT,1855,25,25-29,1880,34.93177234317257
SIM,1870,9,na,1879,2466
STAT,1869,96,na,1965,27.775098378645087
SIM,1823,87,na,1910,84
SIM,1856,35,35-39,1891,10
SIM,1854,39,40-44,1893,4
STAT,1826,52,50-100,1878,0.013450266698388065
STAT,1876,36,25-29,1912,2.8236354760772002
STAT,1921,18,35-39,1939,4.506668343343918
STAT,1952,16,20-24,1968,153.5249107848602
STAT,1879,4,na,1883,2842.6453930309067
STAT,1839,52,35-39,1891,0.005701382635551675
STAT,1900,22,45-49,1922,0.9138430375154788
STAT,1809,45,25-29,1854,0.1683780772168989
SIM,1927,36,na,1963,4376
SIM,1876,81,na,1957,510
SIM,1891,30,35-39,1921,12
SIM,1908,17,30-34,1925,2
STAT,1843,41,45-49,1884,1.0542572163498884
STAT,1937,22,40-44,1959,3.0932031710769436
SIM,1861,29,30-34,1890,27
SIM,1945,22,40-44,1967,3
STAT,1924,27,25-29,1951,72.39666530719636
STAT,1920,20,20-24,1940,117.47642485169123
STAT,1830,91,na,1921,34.97416228538201
STAT,1844,46,30-34,1890,0.06742077104237852
STAT,1854,41,20-24,1895,0.11414248714650094
SIM,1863,25,25-29,1888,39
STAT,1897,31,25-29,1928,12.993208199987738
STAT,1887,7,na,1894,2753.038970301674
SIM,1913,38,na,1951,3356
STAT,1940,29,25-29,1969,63.343732215840014
SIM,1922,28,45-49,1950,5
SIM,1851,46,na,1897,1703
STAT,1860,19,20-24,1879,15.488498106962295
STAT,1829,34,50-100,1863,0.8659399858029242
STAT,1894,73,na,1967,1764.0810734491795
SIM,1932,27,25-29,1959,85
SIM,1946,18,na,1964,3729
STAT,1823,50,40-44,1873,0.012984547200695612
STAT,1889,31,40-44,1920,5.078385738796861
STAT,1903,23,25-29,1926,76.70905206271469
SIM,1864,96,na,1960,17
STAT,1914,28,45-49,1942,1.6395354636105803
STAT,1837,30,15-19,1867,0.11831145496630388
STAT,1815,46,50-100,1861,0.5613317425124511
STAT,1926,21,na,1947,4203.671758549394
STAT,1883,26,15-19,1909,0.42166746004051986
SIM,1939,21,na,1960,3415
STAT,1846,42,25-29,1888,0.4820563270625399
STAT,1848,35,35-39,1883,5.529642298805028
STAT,1941,16,45-49,1957,0.48621448005829376
STAT,1890,41,40-44,1931,2.6095913035405425
SIM,1940,18,na,1958,3444
STAT,1830,40,30-34,1870,0.9196836910617744
STAT,1934,26,20-24,1960,23.208299745401092
SIM,1848,57,na,1905,1422
STAT,1922,38,20-24,1960,0.2830783221346962
STAT,1926,26,20-24,1952,20.742358822102297
STAT,1929,23,45-49,1952,1.3399781207116124
STAT,1906,16,na,1922,3483.5257284504096
SIM,1882,32,35-39,1914,16
STAT,1869,74,na,1943,1015.6667940963647
STAT,1875,9,na,1884,2581.07744958993
SIM,1807,65,na,1872,811
STAT,1863,53,40-44,1916,0.008587472445846487
STAT,1829,30,30-34,1859,18.42054241347523
STAT,1889,36,35-39,1925,8.288531126359763
SIM,1843,35,25-29,1878,2
SIM,1908,44,na,1952,3154
SIM,1851,41,45-49,1892,5
SIM,1878,33,20-24,1911,2
SIM,1821,42,50-100,1863,1
SIM,1833,22,35-39,1855,5
SIM,1884,40,45-49,1924,2
STAT,1881,15,25-29,1896,5.195520728688255
STAT,1945,18,na,1963,3797.181635674164
SIM,1936,15,40-44,1951,2
SIM,1820,35,30-34,1855,12
STAT,1860,8,na,1868,2170.8694425576277
STAT,1933,33,50-100,1966,1.0519342234650737
SIM,1866,30,50-100,1896,1
SIM,1902,37,40-44,1939,1
STAT,1863,20,15-19,1883,2.829944643269827
STAT,1874,59,na,1933,1875.877077023314
STAT,1895,26,na,1921,2949.3256107779184
SIM,1884,14,na,1898,2519
STAT,1875,18,50-100,1893,0.047447194853628256
STAT,1917,29,25-29,1946,64.74391655406528
STAT,1910,17,20-24,1927,25.37888164105898
SIM,1902,30,20-24,1932,3
STAT,1827,39,30-34,1866,5.277892015229289
STAT,1907,49,35-39,1956,0.10787975860095193
STAT,1947,21,50-100,1968,0.7027825514052107
STAT,1926,36,na,1962,4347.449092810888
SIM,1897,36,35-39,1933,20
STAT,1876,40,45-49,1916,1.4754672689381836
SIM,1942,26,20-24,1968,18
SIM,1925,37,35-39,1962,7
SIM,1815,41,35-39,1856,2
SIM,1868,77,na,1945,714
SIM,1914,4,na,1918,3952
STAT,1787,72,na,1859,514.87454484041
STAT,1813,47,40-44,1860,0.46803760895383395
SIM,1903,28,35-39,1931,18
SIM,1943,0,na,1943,4030
SIM,1830,30,20-24,1860,2
SIM,1895,35,50-100,1930,1
STAT,1874,32,35-39,1906,9.7748811050448
SIM,1863,20,30-34,1883,22
SIM,1891,70,na,1961,1781
SIM,1924,22,50-100,1946,1
SIM,1925,29,25-29,1954,73
STAT,1905,27,15-19,1932,0.6195282748528612
SIM,1877,8,na,1885,2593
STAT,1875,30,35-39,1905,9.912572994422016
SIM,1862,83,na,1945,286
SIM,1899,20,45-49,1919,1
STAT,1874,20,40-44,1894,2.023341861674925
STAT,1928,15,40-44,1943,1.6726419620779138
STAT,1840,29,20-24,1869,9.461996188389266
STAT,1845,67,na,1912,1121.7458559048043
SIM,1926,24,20-24,1950,115
SIM,1958,13,na,1971,4783
STAT,1807,49,30-34,1856,0.35988146431908946
SIM,1909,27,25-29,1936,66
STAT,1935,34,25-29,1969,12.064266810502735
STAT,1941,10,na,1951,3844.8821202682434
SIM,1871,20,15-19,1891,5
STAT,1949,20,50-100,1969,0.7258612175974322
STAT,1835,35,25-29,1870,2.313059114975144
STAT,1882,78,na,1960,875.3297123017193
SIM,1900,16,25-29,1916,8
SIM,1865,40,35-39,1905,4
STAT,1894,19,50-100,1913,0.059159592760722926
STAT,1937,27,35-39,1964,13.825742859355824
STAT,1851,23,15-19,1874,2.8136317639842163
STAT,1910,26,35-39,1936,13.74344823528793
SIM,1832,64,na,1896,1011
STAT,1870,34,na,1904,2192.6063690858705
SIM,1883,30,35-39,1913,11
SIM,1902,15,20-24,1917,25
SIM,1930,23,35-39,1953,11
STAT,1816,102,na,1918,0.1366200396951432
SIM,1910,18,25-29,1928,10
STAT,1855,67,na,1922,1126.4980822704722
SIM,1889,34,35-39,1923,14
STAT,1836,25,15-19,1861,0.38569210095685147
STAT,1919,17,40-44,1936,1.4602090616426056
STAT,1826,49,40-44,1875,0.1538378868193928
STAT,1840,31,na,1871,1750.4040878869416
STAT,1948,0,na,1948,4789.476449114924
STAT,1856,30,25-29,1886,7.802393318757127
STAT,1848,46,15-19,1894,2.9806683102943205E-4
STAT,1761,109,na,1870,0.003842324922551597
STAT,1869,19,40-44,1888,0.16771561547171532
STAT,1833,24,35-39,1857,4.745279377272794
SIM,1926,38,30-34,1964,2
SIM,1899,44,na,1943,3033
STAT,1884,42,45-49,1926,1.395125537573016
SIM,1919,32,40-44,1951,9
STAT,1950,17,25-29,1967,48.407194162396955
SIM,1921,26,na,1947,3980
SIM,1875,42,45-49,1917,3
SIM,1888,81,na,1969,966
STAT,1863,86,na,1949,183.9391931028134
STAT,1820,91,na,1911,30.527355091441727
STAT,1918,24,20-24,1942,112.58572408316529
STAT,1925,28,20-24,1953,20.295363608372305
STAT,1864,51,40-44,1915,0.008906394607846818
SIM,1951,3,na,1954,4314
STAT,1886,28,50-100,1914,0.6361086691542654
STAT,1900,49,25-29,1949,0.041690823396524385
STAT,1867,42,45-49,1909,1.326002120079567
STAT,1921,32,30-34,1953,16.563316334600056
STAT,1940,18,45-49,1958,0.47899758682841903
STAT,1872,36,40-44,1908,4.167986763784272
STAT,1836,20,20-24,1856,72.80387665038903
SIM,1877,44,na,1921,2204
STAT,1831,28,40-44,1859,2.5090438268837736
STAT,1845,51,30-34,1896,0.004232349449832731
STAT,1911,38,45-49,1949,0.6189723803112833
SIM,1928,20,15-19,1948,9
SIM,1919,37,35-39,1956,3
STAT,1842,47,50-100,1889,0.17788888909593453
STAT,1936,17,40-44,1953,1.265027056276464
STAT,1900,35,15-19,1935,0.07428970495291394
SIM,1880,23,35-39,1903,10
SIM,1841,24,35-39,1865,4
SIM,1912,32,30-34,1944,20
SIM,1818,39,30-34,1857,3
STAT,1927,39,35-39,1966,2.8348123826003078
SIM,1847,94,na,1941,9
SIM,1934,26,20-24,1960,20
STAT,1861,25,25-29,1886,33.954460743498295
STAT,1857,107,na,1964,0.020756255946448674
SIM,1767,88,na,1855,36
STAT,1811,43,15-19,1854,0.05033340272400167
STAT,1864,59,na,1923,1636.3419736783453
SIM,1910,39,40-44,1949,1
SIM,1844,20,20-24,1864,51
STAT,1898,37,15-19,1935,0.07178909279609448
STAT,1942,28,20-24,1970,18.09041300117355
SIM,1829,33,25-29,1862,10
SIM,1831,84,na,1915,166
SIM,1835,39,30-34,1874,7
STAT,1914,36,20-24,1950,0.24984490019470423
SIM,1856,45,na,1901,1796
SIM,1867,12,na,1879,2578
STAT,1806,50,na,1856,1227.8124827773627
STAT,1922,27,50-100,1949,1.0640078820125218
STAT,1906,43,45-49,1949,0.14196437749420235
STAT,1863,96,na,1959,12.469334748377229
SIM,1937,25,35-39,1962,18
STAT,1888,24,25-29,1912,63.51166223418959
STAT,1911,22,20-24,1933,99.6279004015656
STAT,1850,46,na,1896,1590.468223246688
STAT,1853,32,15-19,1885,0.11098446203189195
SIM,1887,59,na,1946,2005
SIM,1896,24,25-29,1920,77
STAT,1902,39,40-44,1941,1.2470194577028673
STAT,1887,40,20-24,1927,0.16950855356816283
STAT,1840,16,50-100,1856,0.04187380989336229
SIM,1837,32,20-24,1869,2
SIM,1890,26,na,1916,2999
SIM,1942,25,na,1967,3660
SIM,1896,22,35-39,1918,6
STAT,1905,16,35-39,1921,0.7510994527831397
STAT,1913,7,na,1920,3848.462146234004
STAT,1888,22,35-39,1910,6.515011311508271
STAT,1904,32,30-34,1936,13.584942209526051
SIM,1828,64,na,1892,1012
SIM,1930,16,35-39,1946,6
STAT,1846,31,na,1877,1919.4441004574087
STAT,1831,54,na,1885,1252.845785154783
STAT,1854,48,40-44,1902,0.1209519317643543
STAT,1874,21,50-100,1895,0.3947971852827206
STAT,1829,32,20-24,1861,2.6970267722665304
STAT,1847,21,35-39,1868,5.31336195112462
STAT,1876,44,na,1920,2225.3322885699845
STAT,1923,18,na,1941,4072.309218074993
SIM,1870,51,50-100,1921,3
STAT,1930,22,30-34,1952,34.782429874884826
SIM,1874,19,15-19,1893,5
STAT,1831,35,40-44,1866,3.4371524896165577
SIM,1880,36,40-44,1916,7
STAT,1855,45,na,1900,1614.736194999217
SIM,1863,31,na,1894,1986
STAT,1911,37,40-44,1948,1.3659783653078295
SIM,1834,41,45-49,1875,4
STAT,1824,107,na,1931,0.0026003149540115332
SIM,1850,98,na,1948,1
SIM,1863,46,na,1909,1876
STAT,1950,21,45-49,1971,1.2614335910365198
STAT,1862,15,15-19,1877,5.555185013720573
STAT,1866,38,30-34,1904,4.620741621151211
STAT,1846,39,40-44,1885,3.320894588756557
SIM,1933,28,20-24,1961,26
SIM,1874,38,30-34,1912,3
STAT,1929,25,35-39,1954,17.817380311777406
STAT,1890,49,50-100,1939,0.1566668022384102
SIM,1763,95,na,1858,2
SIM,1870,15,15-19,1885,8
STAT,1763,113,na,1876,2.4983915522614234E-4
STAT,1847,40,25-29,1887,0.4885310685774707
STAT,1932,33,45-49,1965,1.9749075569301338
SIM,1904,33,35-39,1937,12
STAT,1866,21,45-49,1887,0.6169821290129188
STAT,1956,3,na,1959,4916.648729516081
SIM,1822,39,50-100,1861,3
SIM,1948,23,20-24,1971,112
SIM,1821,91,na,1912,29
STAT,1909,26,20-24,1935,16.677930592680646
STAT,1794,103,na,1897,0.02703177170454025
STAT,1902,26,35-39,1928,12.908401460400425
STAT,1896,23,20-24,1919,85.71543366121817
STAT,1929,39,45-49,1968,0.8250189854533804
SIM,1868,93,na,1961,37
SIM,1937,20,40-44,1957,3
STAT,1892,48,50-100,1940,0.16186640370991268
SIM,1816,79,na,1895,257
STAT,1922,16,35-39,1938,4.598942569072055
SIM,1923,33,45-49,1956,2
SIM,1927,17,40-44,1944,2
STAT,1916,38,20-24,1954,0.2537563444618118
STAT,1944,28,30-34,1972,39.987236940303795
STAT,1817,51,45-49,1868,0.031982009075568515
STAT,1842,25,15-19,1867,0.41221587467405657
SIM,1881,49,na,1930,1728
SIM,1910,26,35-39,1936,10
SIM,1933,15,15-19,1948,54
STAT,1878,31,15-19,1909,0.14077624784067766
SIM,1947,20,25-29,1967,118
SIM,1917,26,20-24,1943,19
SIM,1944,17,40-44,1961,1
STAT,1883,30,35-39,1913,9.455220271278744
STAT,1925,37,35-39,1962,2.7424027302824063
SIM,1855,21,35-39,1876,6
SIM,1788,87,na,1875,53
SIM,1928,15,40-44,1943,2
STAT,1827,42,15-19,1869,0.013247580760620416
STAT,1909,41,20-24,1950,0.015695382873398996
STAT,1902,18,25-29,1920,7.5352662489470905
STAT,1925,15,15-19,1940,52.03005450658973
SIM,1831,29,45-49,1860,4
SIM,1884,33,20-24,1917,2
STAT,1901,28,35-39,1929,12.71426946400546
STAT,1857,29,15-19,1886,0.3432004618117324
SIM,1881,59,na,1940,1501
SIM,1892,42,45-49,1934,1
STAT,1962,4,na,1966,4758.917013218817
SIM,1848,79,na,1927,497
SIM,1885,17,25-29,1902,8
SIM,1918,39,35-39,1957,11
STAT,1813,51,na,1864,1198.2948296215811
STAT,1822,45,40-44,1867,0.23692279239213965
SIM,1864,30,25-29,1894,9
SIM,1895,1,na,1896,3402
STAT,1894,33,15-19,1927,0.17216036456790776
SIM,1848,33,35-39,1881,8
STAT,1812,99,na,1911,0.8226721006906484
STAT,1915,33,45-49,1948,1.5076313704869337
STAT,1872,50,50-100,1922,0.014516677348162865
SIM,1933,37,35-39,1970,6
STAT,1920,27,40-44,1947,4.830226074466039
STAT,1862,100,na,1962,2.5104668799641088
STAT,1869,15,25-29,1884,5.3204352780191
STAT,1790,76,na,1866,345.44678591817217
STAT,1902,32,20-24,1934,3.6038028918410485
STAT,1854,30,15-19,1884,0.1065316589401084
STAT,1917,17,30-34,1934,2.4778945111836514
STAT,1868,43,15-19,1911,0.012357463913913043
STAT,1801,66,na,1867,746.8470731514456
STAT,1831,32,na,1863,1637.0183032301481
STAT,1916,25,25-29,1941,64.7281536169724
SIM,1911,20,20-24,1931,96
STAT,1855,22,20-24,1877,57.21034574231114
STAT,1920,23,25-29,1943,96.70910364711548
SIM,1863,22,20-24,1885,56
STAT,1906,26,45-49,1932,1.5329128550419078
STAT,1872,0,na,1872,3515.445669267662
SIM,1934,20,15-19,1954,5
SIM,1833,37,30-34,1870,4
STAT,1894,24,25-29,1918,69.06392829632804
STAT,1837,64,na,1901,1128.1666683333801
STAT,1861,44,50-100,1905,0.8186282364112709
STAT,1880,31,20-24,1911,2.7030719389749733
STAT,1889,47,15-19,1936,2.619189267370074E-4
SIM,1882,20,40-44,1902,2
STAT,1834,23,15-19,1857,2.7185099799000056
STAT,1823,53,45-49,1876,0.016861882327192705
STAT,1912,5,na,1917,3828.4919076285305
STAT,1840,18,40-44,1858,0.1544927968874674
STAT,1920,28,45-49,1948,1.7840171184953235
STAT,1921,15,30-34,1936,13.186168278301631
STAT,1872,32,25-29,1904,9.705658913083528
STAT,1905,29,50-100,1934,0.8672533286916709
SIM,1913,29,50-100,1942,4
SIM,1918,22,na,1940,3717
STAT,1827,33,25-29,1860,11.788516792607664
SIM,1901,26,35-39,1927,13
SIM,1925,17,30-34,1942,19
STAT,1872,27,50-100,1899,0.6061579588986791
STAT,1903,16,25-29,1919,7.6356531484957415
SIM,1839,27,na,1866,1818
STAT,1929,20,40-44,1949,4.040639247251539
STAT,1955,15,35-39,1970,5.264553125325961
SIM,1844,16,25-29,1860,5
STAT,1888,42,50-100,1930,1.1780216994074078
STAT,1940,26,20-24,1966,17.592435591047668
SIM,1921,33,35-39,1954,12
STAT,1877,26,15-19,1903,0.4461245859074585
SIM,1842,23,15-19,1865,5
STAT,1915,46,15-19,1961,3.5154243408354064E-4
STAT,1818,50,na,1868,1326.6839014227583
STAT,1926,20,15-19,1946,6.145651531715364
SIM,1835,33,25-29,1868,11
STAT,1865,42,35-39,1907,1.5486296309720635
SIM,1874,30,35-39,1904,12
STAT,1920,26,na,1946,3895.4474503754755
STAT,1825,37,30-34,1862,6.689847288703915
STAT,1952,19,25-29,1971,49.02593087251588
SIM,1873,42,35-39,1915,4
SIM,1933,17,15-19,1950,51
SIM,1942,29,25-29,1971,67
SIM,1838,20,20-24,1858,54
STAT,1934,29,25-29,1963,83.56434313198393
SIM,1868,3,na,1871,2694
SIM,1895,34,35-39,1929,17
SIM,1939,22,40-44,1961,2
SIM,1903,23,na,1926,3171
SIM,1909,15,30-34,1924,3
STAT,1905,59,na,1964,2830.0599492173956
SIM,1907,22,20-24,1929,81
SIM,1828,80,na,1908,346
STAT,1800,55,na,1855,1075.4878299999996
STAT,1892,28,30-34,1920,29.691607105885605
SIM,1898,21,30-34,1919,28
STAT,1887,34,35-39,1921,10.609493001899702
STAT,1870,36,30-34,1906,4.96301921976155
SIM,1952,5,na,1957,4391
STAT,1816,65,na,1881,910.437248736879
STAT,1913,33,35-39,1946,8.553234290197421
STAT,1880,53,40-44,1933,0.01031650758295911
STAT,1871,30,50-100,1901,0.8664133929247544
STAT,1928,18,45-49,1946,0.5930514658483135
SIM,1860,39,40-44,1899,4
SIM,1913,7,na,1920,3722
STAT,1809,79,na,1888,294.7970589582716
STAT,1868,34,25-29,1902,9.153049168671327
SIM,1843,32,20-24,1875,2
SIM,1878,36,25-29,1914,2
STAT,1852,39,40-44,1891,3.1416882180027192
SIM,1903,25,30-34,1928,38
STAT,1866,23,35-39,1889,5.089288942218603
STAT,1911,45,50-100,1956,0.20324175307170417
SIM,1856,44,50-100,1900,3
SIM,1933,11,na,1944,5081
STAT,1926,29,25-29,1955,74.00454519479626
SIM,1829,31,35-39,1860,8
STAT,1797,101,na,1898,0.14002486063444985
SIM,1832,32,na,1864,1639
SIM,1900,20,45-49,1920,1
SIM,1855,23,25-29,1878,57
SIM,1876,34,25-29,1910,14
STAT,1891,32,35-39,1923,11.836324736146473
STAT,1847,23,25-29,1870,51.37786411866264
STAT,1868,31,20-24,1899,2.4463372766923133
STAT,1903,20,20-24,1923,93.18156047617096
SIM,1874,23,35-39,1897,3
STAT,1812,52,30-34,1864,0.01904279548620775
SIM,1893,44,na,1937,2869
STAT,1935,31,20-24,1966,3.189762925848605
STAT,1905,37,na,1942,3242.4586924336204
SIM,1877,15,25-29,1892,6
STAT,1897,8,na,1905,3284.2209145098327
STAT,1918,38,30-34,1956,1.8129739990174847
SIM,1936,18,45-49,1954,1
STAT,1831,52,40-44,1883,0.006597415989134317
SIM,1924,25,25-29,1949,77
STAT,1860,20,50-100,1880,0.3592284339405574
STAT,1880,34,na,1914,2356.2627776570803
SIM,1925,26,20-24,1951,20
SIM,1776,87,na,1863,53
SIM,1947,18,20-24,1965,139
STAT,1813,104,na,1917,0.027450179172200478
STAT,1856,31,50-100,1887,0.6907481469775464
STAT,1895,58,na,1953,2435.6064851942715
STAT,1908,39,25-29,1947,0.8621292295416907
STAT,1893,49,30-34,1942,0.06405037666015487
STAT,1924,16,45-49,1940,0.5633373741026072
SIM,1814,51,na,1865,1186
SIM,1832,69,na,1901,844
SIM,1914,26,45-49,1940,1
SIM,1902,33,25-29,1935,8
SIM,1885,21,20-24,1906,62
SIM,1832,41,35-39,1873,2
SIM,1903,45,na,1948,3056
STAT,1834,46,na,1880,1498.2425952438173
STAT,1898,41,35-39,1939,0.16148433654680566
STAT,1872,63,na,1935,1690.7661243043628
STAT,1888,9,na,1897,2896.773489476744
STAT,1893,45,15-19,1938,2.730096418146773E-4
STAT,1917,26,20-24,1943,18.146744165209757
STAT,1849,40,35-39,1889,1.3816031667666082
SIM,1864,31,50-100,1895,4
SIM,1918,37,na,1955,3738
STAT,1921,29,15-19,1950,0.737958648615296
STAT,1939,18,20-24,1957,128.16213729321493
STAT,1918,22,30-34,1940,29.28412503671465
SIM,1872,67,na,1939,1452
STAT,1939,24,40-44,1963,3.1878576708866406
SIM,1855,27,na,1882,1987
STAT,1918,27,25-29,1945,66.17398397587849
SIM,1771,88,na,1859,35
SIM,1868,21,45-49,1889,3
SIM,1920,41,na,1961,3954
SIM,1930,20,30-34,1950,33
SIM,1934,22,na,1956,4553
STAT,1851,27,30-34,1878,21.209471551201577
SIM,1899,1,na,1900,3545
STAT,1854,82,na,1936,333.8327410705949
STAT,1766,111,na,1877,0.001020330579362851
STAT,1804,50,30-34,1854,0.02189941635309569
STAT,1881,19,40-44,1900,0.16602337015291152
STAT,1914,39,25-29,1953,0.919378308309262
STAT,1838,27,na,1865,1847.406988313434
SIM,1854,33,35-39,1887,10
STAT,1884,44,50-100,1928,0.9726991695259005
STAT,1885,47,30-34,1932,0.09072614660672511
SIM,1857,40,35-39,1897,5
SIM,1792,87,na,1879,52
SIM,1913,23,na,1936,3378
STAT,1834,29,20-24,1863,9.410177322944408
SIM,1934,29,25-29,1963,79
SIM,1834,98,na,1932,1
SIM,1837,35,25-29,1872,2
STAT,1796,86,na,1882,71.44245002115376
STAT,1831,37,50-100,1868,0.9412665572475998
STAT,1875,81,na,1956,559.9949745120971
STAT,1869,52,20-24,1921,6.717408764068405E-4
SIM,1828,31,50-100,1859,3
SIM,1889,32,45-49,1921,4
SIM,1910,15,20-24,1925,23
SIM,1906,26,45-49,1932,1
STAT,1917,22,na,1939,3666.5716233991343
STAT,1824,41,35-39,1865,2.4426448525157913
SIM,1790,91,na,1881,15
STAT,1853,23,25-29,1876,50.820720806401994
SIM,1855,97,na,1952,3
STAT,1928,29,50-100,1957,1.1572660771516756
STAT,1901,25,30-34,1926,33.52499151083189
SIM,1909,24,20-24,1933,94
STAT,1930,40,35-39,1970,0.25098388668407
STAT,1882,20,25-29,1902,52.906219244284365
STAT,1909,44,25-29,1953,0.062325287452315505
SIM,1922,39,25-29,1961,3
SIM,1929,37,45-49,1966,3
STAT,1887,43,25-29,1930,0.6736555088100521
SIM,1841,46,na,1887,1517
SIM,1842,29,20-24,1871,8
STAT,1874,25,35-39,1899,9.376556506102018
SIM,1828,102,na,1930,1
STAT,1896,21,30-34,1917,22.29122290415526
STAT,1830,47,40-44,1877,0.1282834616964301
SIM,1922,37,na,1959,4031
STAT,1822,48,45-49,1870,0.3128567401184562
STAT,1849,20,30-34,1869,16.38326547324585
SIM,1902,60,na,1962,2638
STAT,1917,43,20-24,1960,0.01738351049608206
SIM,1937,23,45-49,1960,4
SIM,1944,26,30-34,1970,45
STAT,1895,1,na,1896,3352.2472178193257
STAT,1886,22,na,1908,2360.1065774857993
SIM,1901,38,na,1939,3126
STAT,1861,22,20-24,1883,55.60973052989093
STAT,1899,18,15-19,1917,7.661572413759558
STAT,1930,42,50-100,1972,0.14602188218738713
SIM,1926,27,25-29,1953,85
SIM,1923,30,40-44,1953,3
STAT,1793,68,na,1861,637.7887150625598
SIM,1802,66,na,1868,742
STAT,1806,65,na,1871,836.0465788121957
SIM,1914,19,20-24,1933,28
STAT,1907,31,45-49,1938,1.395214074461313
SIM,1878,20,25-29,1898,56
STAT,1917,37,35-39,1954,2.3733581555203145
STAT,1867,101,na,1968,3.2909126049457855
SIM,1879,41,25-29,1920,3
STAT,1852,44,15-19,1896,0.009876794348488423
STAT,1925,17,15-19,1942,51.78943324674532
STAT,1930,19,50-100,1949,0.4551196500799928
SIM,1897,31,40-44,1928,6
STAT,1836,53,na,1889,1383.0991239689495
SIM,1837,30,30-34,1867,29
STAT,1841,23,50-100,1864,0.35358568560613574
SIM,1819,50,na,1869,1310
STAT,1906,19,20-24,1925,24.261940520374242
STAT,1938,21,na,1959,3415.485881089312
SIM,1853,31,na,1884,1875
SIM,1857,20,30-34,1877,26
STAT,1923,48,15-19,1971,4.059600878161062E-4
SIM,1880,32,25-29,1912,14
STAT,1831,31,25-29,1862,8.280020476168303
SIM,1867,40,45-49,1907,1
STAT,1858,107,na,1965,0.024176969952276715
SIM,1906,37,25-29,1943,1
SIM,1773,95,na,1868,1
SIM,1788,72,na,1860,509
STAT,1872,53,40-44,1925,0.009815589686782152
STAT,1895,42,20-24,1937,0.013565721097263967
SIM,1841,39,30-34,1880,7
SIM,1859,27,25-29,1886,43
SIM,1929,5,na,1934,4803
STAT,1954,17,na,1971,4298.2843982854765
STAT,1944,17,25-29,1961,44.055948789403665
SIM,1878,31,30-34,1909,28
STAT,1850,31,35-39,1881,7.5458548864229655
STAT,1942,15,25-29,1957,42.80540395026787
SIM,1952,17,25-29,1969,52
STAT,1821,54,na,1875,1231.5277343327111
STAT,1811,47,30-34,1858,0.32242736309636894
STAT,1857,40,35-39,1897,1.3627802907303455
SIM,1861,23,25-29,1884,49
SIM,1884,36,25-29,1920,2
STAT,1902,15,20-24,1917,23.746052787630685
SIM,1855,37,50-100,1892,5
STAT,1848,30,40-44,1878,3.8367873922175293
SIM,1918,36,30-34,1954,1
STAT,1856,21,35-39,1877,5.031571422744284
STAT,1915,30,40-44,1945,3.7954874827516565
SIM,1950,15,25-29,1965,55
STAT,1833,39,30-34,1872,4.004254477830631
STAT,1865,45,na,1910,1945.6685703062708
STAT,1824,68,na,1892,842.6280521392795
SIM,1791,76,na,1867,342
STAT,1912,26,45-49,1938,1.6139091388196907
SIM,1876,20,40-44,1896,8
STAT,1800,101,na,1901,0.22684172937081223
SIM,1947,24,40-44,1971,2
STAT,1871,41,30-34,1912,1.083351753197894
STAT,1932,16,45-49,1948,0.626412817011791
SIM,1823,65,na,1888,852
STAT,1806,87,na,1893,61.09658132154647
STAT,1862,32,15-19,1894,0.11502531762501837
SIM,1920,26,45-49,1946,5
SIM,1935,6,na,1941,5099
STAT,1872,23,35-39,1895,5.512481831017624
STAT,1868,20,40-44,1888,1.9054892576161295
STAT,1921,35,35-39,1956,2.555773769720057
SIM,1838,79,na,1917,414
SIM,1879,21,20-24,1900,68
SIM,1885,49,50-100,1934,3
STAT,1915,15,50-100,1930,0.07442238240124349
STAT,1928,44,35-39,1972,0.24169528457321518
SIM,1890,20,25-29,1910,81
STAT,1871,45,na,1916,2131.5542214004595
SIM,1837,47,50-100,1884,1
STAT,1828,51,20-24,1879,5.885306827082541E-4
SIM,1871,82,na,1953,378
STAT,1936,14,na,1950,3571.959948780844
STAT,1886,44,na,1930,2275.277964805043
STAT,1829,35,25-29,1864,2.71123581328906
SIM,1856,30,40-44,1886,1
SIM,1926,22,30-34,1948,40
SIM,1933,19,30-34,1952,17
SIM,1936,29,50-100,1965,3
STAT,1943,27,35-39,1970,15.105239151094978
STAT,1925,19,30-34,1944,13.83473209957762
SIM,1911,27,30-34,1938,40
STAT,1811,48,50-100,1859,0.8046821861433644
STAT,1896,26,25-29,1922,52.959990091859666
STAT,1775,87,na,1862,49.431161056578134
STAT,1877,49,50-100,1926,0.23564690308427047
STAT,1861,100,na,1961,2.1274720930183904
STAT,1903,27,30-34,1930,33.848307222674364
SIM,1883,24,15-19,1907,2
SIM,1854,16,na,1870,2203
SIM,1904,30,30-34,1934,33
STAT,1829,47,50-100,1876,0.20074311600735512
SIM,1854,10,na,1864,2299
STAT,1900,39,30-34,1939,1.492356433483052
SIM,1820,85,na,1905,116
STAT,1925,47,35-39,1972,0.1475873433362346
SIM,1865,97,na,1962,14
STAT,1842,21,35-39,1863,5.368717033321706
STAT,1875,39,25-29,1914,2.767604797530653
STAT,1880,20,15-19,1900,3.305216878033038
STAT,1845,22,15-19,1867,2.898111924997328
STAT,1872,38,45-49,1910,1.879613310486059
SIM,1937,23,35-39,1960,8
STAT,1921,17,50-100,1938,0.4034380351848236
SIM,1872,35,na,1907,2254
STAT,1874,25,45-49,1899,1.0789612572838476
STAT,1932,23,50-100,1955,0.813071939388544
SIM,1830,44,40-44,1874,5
STAT,1856,34,40-44,1890,3.1691303160210786
STAT,1859,35,20-24,1894,0.5850984460701378
STAT,1796,70,na,1866,656.0513293691719
SIM,1860,8,na,1868,2368
STAT,1831,42,40-44,1873,1.6607971113360174
STAT,1915,34,45-49,1949,1.5010580977116106
SIM,1912,20,25-29,1932,95
STAT,1889,40,30-34,1929,1.3543353863488437
SIM,1924,22,na,1946,4092
STAT,1849,27,na,1876,1922.9271395188296
SIM,1923,34,45-49,1957,2
STAT,1839,37,45-49,1876,1.586092217546059
STAT,1941,31,35-39,1972,9.069181536869891
STAT,1871,51,25-29,1922,0.003338561860439991
STAT,1911,18,25-29,1929,8.17101612638376
STAT,1841,47,na,1888,1558.0986578416098
STAT,1920,25,40-44,1945,4.862995914171429
STAT,1857,48,20-24,1905,0.008828391633785366
STAT,1918,44,40-44,1962,0.25039587546653197
SIM,1940,31,40-44,1971,8
SIM,1848,40,35-39,1888,3
STAT,1869,21,45-49,1890,0.6401080716828706
SIM,1924,36,30-34,1960,4
SIM,1907,39,35-39,1946,5
SIM,1783,88,na,1871,26
STAT,1784,85,na,1869,78.85088924101422
STAT,1934,27,35-39,1961,19.07986037510271
STAT,1822,44,40-44,1866,3.1016289210414105
STAT,1858,63,na,1921,1321.6010994563378
SIM,1853,38,50-100,1891,1
STAT,1935,34,15-19,1969,0.16773509142873794
SIM,1864,21,35-39,1885,6
SIM,1883,39,25-29,1922,1
SIM,1885,18,25-29,1903,7
SIM,1877,82,na,1959,618
STAT,1825,45,20-24,1870,0.012584863816241075
SIM,1799,87,na,1886,56
SIM,1853,22,15-19,1875,3
STAT,1930,29,15-19,1959,0.8471487473620929
STAT,1932,31,40-44,1963,4.917302361634632
SIM,1888,46,50-100,1934,2
SIM,1910,34,35-39,1944,12
SIM,1880,38,45-49,1918,1
SIM,1844,24,15-19,1868,2
SIM,1876,25,20-24,1901,10
SIM,1838,95,na,1933,4
SIM,1905,43,40-44,1948,1
STAT,1814,45,45-49,1859,0.7463740245249485
STAT,1833,21,40-44,1854,1.8722976765906894
STAT,1920,16,25-29,1936,46.04297727605608
STAT,1808,48,25-29,1856,0.214691977799034
SIM,1928,23,40-44,1951,3
STAT,1861,16,20-24,1877,16.10062296990397
STAT,1902,41,25-29,1943,0.059721399892051365
SIM,1841,21,40-44,1862,1
SIM,1912,37,na,1949,3422
STAT,1948,18,20-24,1966,146.53116014271956
SIM,1781,77,na,1858,278
SIM,1908,26,20-24,1934,18
STAT,1904,20,25-29,1924,78.03386533161361
SIM,1942,27,35-39,1969,20
STAT,1936,19,na,1955,3311.102339426206
SIM,1933,29,35-39,1962,19
STAT,1862,28,50-100,1890,0.5148726448810667
STAT,1868,28,25-29,1896,37.993841389000906
SIM,1926,44,40-44,1970,3
SIM,1795,73,na,1868,469
STAT,1892,36,20-24,1928,0.9164972089175248
STAT,1836,42,15-19,1878,0.010638658266598986
STAT,1853,32,na,1885,1859.755454812245
STAT,1883,38,20-24,1921,0.7104292499932297
STAT,1885,65,na,1950,1591.3423363368472
STAT,1844,19,25-29,1863,4.944159730743026
SIM,1881,37,50-100,1918,1
SIM,1832,23,40-44,1855,1
SIM,1835,24,20-24,1859,51
SIM,1901,65,na,1966,2485
STAT,1848,35,45-49,1883,1.5585170086785172
SIM,1907,15,20-24,1922,24
STAT,1926,34,20-24,1960,2.7825844389092462
STAT,1909,37,25-29,1946,0.8804574482631431
STAT,1946,20,30-34,1966,30.235813633987235
STAT,1853,53,30-34,1906,0.004432535950241195
STAT,1954,15,40-44,1969,1.6342453747507024
SIM,1910,25,20-24,1935,18
SIM,1882,22,40-44,1904,4
SIM,1874,40,35-39,1914,3
STAT,1912,21,15-19,1933,4.834096215708001
STAT,1909,44,15-19,1953,0.0013403288519327743
STAT,1906,41,40-44,1947,0.2158807811363072
SIM,1920,21,15-19,1941,4
STAT,1865,27,45-49,1892,0.9507150128584679
STAT,1883,22,35-39,1905,5.4048996464619155
STAT,1902,34,35-39,1936,7.686314233080584
SIM,1896,73,na,1969,1851
STAT,1937,18,45-49,1955,0.45789295724664686
STAT,1944,18,na,1962,3740.780431376212
SIM,1845,16,30-34,1861,1
STAT,1866,46,20-24,1912,0.010485542343197754
STAT,1850,54,45-49,1904,0.009948817916968474
STAT,1866,40,35-39,1906,1.5937212296335799
STAT,1934,18,20-24,1952,172.783119921639
SIM,1868,30,na,1898,2168
STAT,1907,29,15-19,1936,0.619853993456424
SIM,1843,30,50-100,1873,3
STAT,1923,7,na,1930,4434.169252337435
SIM,1824,31,35-39,1855,8
STAT,1897,22,35-39,1919,7.372442703337166
STAT,1841,46,15-19,1887,2.8058655411771605E-4
SIM,1922,43,na,1965,4008
SIM,1856,35,45-49,1891,1
SIM,1886,59,na,1945,1863
SIM,1924,38,na,1962,4187
SIM,1851,77,na,1928,591
STAT,1822,108,na,1930,9.307676034254662E-4
STAT,1854,6,na,1860,2135.2426345637555
STAT,1943,29,25-29,1972,66.15663651081529
STAT,1805,92,na,1897,14.53883131076878
SIM,1847,68,na,1915,1124
STAT,1826,54,na,1880,1240.9675240944314
SIM,1793,62,na,1855,866
SIM,1924,29,40-44,1953,5
SIM,1839,33,na,1872,1757
STAT,1905,27,na,1932,3258.784105764866
SIM,1768,95,na,1863,1
STAT,1916,36,30-34,1952,1.7716796377132003
STAT,1851,21,na,1872,1850.0113838351303
STAT,1877,25,15-19,1902,0.4476151443381044
SIM,1921,19,15-19,1940,43
SIM,1859,41,na,1900,1885
SIM,1882,48,50-100,1930,3
STAT,1913,19,15-19,1932,8.719120197841148
STAT,1805,52,40-44,1857,0.03864340577528497
STAT,1822,40,na,1862,1436.7927391758483
STAT,1915,41,35-39,1956,0.19179837195572905
STAT,1900,46,20-24,1946,0.008895990098512892
SIM,1829,43,na,1872,1441
SIM,1934,34,20-24,1968,2
STAT,1876,13,na,1889,2523.8395791942385
STAT,1835,90,na,1925,50.180127244852315
STAT,1902,25,20-24,1927,15.746851572093536
SIM,1838,31,35-39,1869,7
STAT,1929,23,35-39,1952,11.213500230229949
STAT,1883,2,na,1885,2919.801783856467
SIM,1940,26,45-49,1966,1
STAT,1872,43,40-44,1915,2.11596614277058
STAT,1891,38,50-100,1929,1.4278452906078423
SIM,1783,72,na,1855,447
SIM,1809,98,na,1907,2
STAT,1881,54,45-49,1935,0.012879918731637328
STAT,1903,23,15-19,1926,4.420688307232245
SIM,1902,26,25-29,1928,55
STAT,1933,19,15-19,1952,57.08427040250171
SIM,1931,15,40-44,1946,1
STAT,1882,47,15-19,1929,3.6577259827623486E-4
SIM,1833,35,50-100,1868,1
SIM,1861,51,na,1912,1881
SIM,1863,43,40-44,1906,5
SIM,1898,44,na,1942,2868
STAT,1865,47,15-19,1912,3.4090940222954695E-4
STAT,1928,25,40-44,1953,5.461439570116028
STAT,1919,35,na,1954,3839.527773561006
STAT,1932,26,45-49,1958,2.1386078808315476
SIM,1888,38,45-49,1926,3
SIM,1872,39,na,1911,2193
STAT,1904,39,15-19,1943,0.016258619402075195
SIM,1880,43,40-44,1923,5
SIM,1951,16,20-24,1967,145
STAT,1941,25,50-100,1966,0.9735579336113466
SIM,1879,32,35-39,1911,9
STAT,1917,36,20-24,1953,0.2599075908176187
STAT,1869,27,30-34,1896,23.04620896657085
STAT,1926,16,20-24,1942,157.4104123878655
STAT,1804,53,35-39,1857,0.029815440717698153
SIM,1843,26,20-24,1869,8
SIM,1897,20,35-39,1917,8
STAT,1760,110,na,1870,0.0014749765750363942
STAT,1858,43,50-100,1901,0.7768417764145323
STAT,1896,47,45-49,1943,0.16532209458572372
SIM,1836,29,na,1865,1729
STAT,1850,16,45-49,1866,0.056602530195828
STAT,1892,20,35-39,1912,6.9460317882189395
STAT,1842,37,20-24,1879,0.6548519053563587
STAT,1923,40,na,1963,4112.082727221122
SIM,1934,16,20-24,1950,157
STAT,1877,43,15-19,1920,0.013434973121444935
STAT,1943,16,20-24,1959,135.85437869326827
STAT,1920,23,15-19,1943,5.573277106151542
STAT,1835,26,20-24,1861,9.801624289101998
STAT,1916,29,40-44,1945,4.520279361124543
SIM,1852,19,25-29,1871,4
STAT,1839,20,20-24,1859,59.808459853610486
SIM,1919,25,40-44,1944,8
STAT,1942,26,30-34,1968,38.867733691347325
STAT,1923,15,40-44,1938,1.558781076990483
STAT,1851,38,25-29,1889,2.0716857279523926
SIM,1925,18,20-24,1943,137
STAT,1815,86,na,1901,99.0364930023406
SIM,1945,15,40-44,1960,1
SIM,1893,17,20-24,1910,25
SIM,1942,18,20-24,1960,126
STAT,1869,41,15-19,1910,0.012695797072722077
STAT,1918,42,15-19,1960,0.001542482272489466
STAT,1946,13,na,1959,4115.262608435252
SIM,1852,15,na,1867,2151
STAT,1845,40,15-19,1885,0.010209526738283679
SIM,1840,34,na,1874,1682
STAT,1903,33,40-44,1936,3.3330061041143346
STAT,1937,20,na,1957,3361.7930969346826
SIM,1832,48,50-100,1880,1
SIM,1844,48,na,1892,1482
STAT,1910,18,35-39,1928,0.7834342815073894
SIM,1889,41,35-39,1930,4
STAT,1878,20,50-100,1898,0.4038735047961298
SIM,1877,23,15-19,1900,5
SIM,1911,33,40-44,1944,5
STAT,1934,36,20-24,1970,0.3439665502591226
STAT,1830,50,25-29,1880,0.002668817015874521
SIM,1918,38,na,1956,3732
STAT,1794,75,na,1869,409.4967224681376
SIM,1917,52,na,1969,3536
STAT,1894,15,20-24,1909,21.62331451511378
STAT,1885,17,20-24,1902,16.693957611181602
STAT,1846,78,na,1924,579.5174420142547
SIM,1897,28,45-49,1925,1
STAT,1917,16,na,1933,3936.0537342157763
STAT,1942,19,40-44,1961,1.3799582042029992
SIM,1904,18,na,1922,3486
SIM,1847,20,20-24,1867,63
SIM,1916,37,35-39,1953,7
STAT,1917,18,20-24,1935,27.489287595638544
STAT,1912,23,40-44,1935,3.0348305120342305
STAT,1828,40,15-19,1868,0.012107142538951092
STAT,1923,33,40-44,1956,4.2354548978960205
STAT,1921,21,na,1942,3908.284539802659
STAT,1810,55,na,1865,1082.3447640331428
STAT,1850,83,na,1933,279.84541610333093
SIM,1823,50,na,1873,1279
SIM,1852,24,20-24,1876,55
STAT,1925,35,na,1960,4273.012921249351
STAT,1814,69,na,1883,798.2083360979734
STAT,1840,35,45-49,1875,1.579798996666548
SIM,1892,43,na,1935,3047
STAT,1889,20,35-39,1909,6.846263436568527
STAT,1881,36,45-49,1917,1.828025166766869
SIM,1905,25,40-44,1930,7
SIM,1931,33,40-44,1964,10
STAT,1887,60,na,1947,2015.2868159442555
STAT,1914,48,15-19,1962,3.441787126959002E-4
STAT,1898,49,20-24,1947,0.00847294079683131
SIM,1871,97,na,1968,24
STAT,1870,47,25-29,1917,0.0531325825235267
STAT,1886,41,15-19,1927,0.013843328084247455
SIM,1911,16,25-29,1927,14
STAT,1871,44,35-39,1915,1.67574533402724
STAT,1906,44,na,1950,3147.953165494667
SIM,1901,36,35-39,1937,6
STAT,1908,46,20-24,1954,0.009512956161441417
SIM,1890,39,50-100,1929,4
SIM,1868,38,50-100,1906,1
SIM,1878,24,na,1902,2367
STAT,1844,24,20-24,1868,58.90298170618171
SIM,1883,20,35-39,1903,8
SIM,1941,19,15-19,1960,39
SIM,1901,18,35-39,1919,1
SIM,1946,21,35-39,1967,10
STAT,1889,28,45-49,1917,1.2903383807602615
STAT,1895,31,15-19,1926,0.17610585670621925
STAT,1910,36,35-39,1946,2.1959285265998476
SIM,1911,23,15-19,1934,4
SIM,1920,23,40-44,1943,3
SIM,1873,46,50-100,1919,2
SIM,1936,25,40-44,1961,6
STAT,1840,53,45-49,1893,0.009370966680145414
STAT,1908,37,35-39,1945,2.139404590540677
SIM,1836,18,30-34,1854,1
STAT,1821,86,na,1907,118.20811033436247
STAT,1835,47,na,1882,1509.3328056561106
SIM,1916,28,20-24,1944,18
STAT,1900,43,na,1943,3017.394869522185
SIM,1884,24,na,1908,2329
STAT,1876,27,20-24,1903,11.449952760123828
STAT,1899,41,na,1940,3015.590223324962
STAT,1858,59,na,1917,1439.4878897690485
STAT,1938,29,45-49,1967,1.6153207803836904
STAT,1889,33,40-44,1922,5.036373144328651
STAT,1900,23,45-49,1923,0.9110192625295556
SIM,1928,37,50-100,1965,1
STAT,1770,113,na,1883,3.5333453897580866E-4
SIM,1897,33,40-44,1930,7
SIM,1886,43,na,1929,2233
SIM,1847,37,45-49,1884,6
STAT,1917,45,35-39,1962,0.12782029139329779
STAT,1927,32,15-19,1959,0.14933057755660234
SIM,1950,19,40-44,1969,2
SIM,1918,25,50-100,1943,2
STAT,1886,23,15-19,1909,3.2819576729101314
SIM,1894,23,15-19,1917,3
SIM,1881,12,na,1893,2004
STAT,1834,38,25-29,1872,2.1996123689395537
STAT,1882,36,50-100,1918,1.1333750056594656
STAT,1908,28,20-24,1936,16.244603390162652
STAT,1810,52,20-24,1862,0.0023537641914621473
STAT,1844,83,na,1927,275.7168711894731
STAT,1915,21,na,1936,3576.8905748467137
STAT,1937,27,50-100,1964,0.9166015197036854
STAT,1820,69,na,1889,767.2309228028998
STAT,1938,21,35-39,1959,8.806602403051365
SIM,1884,27,20-24,1911,15
SIM,1902,23,na,1925,3127
STAT,1846,48,45-49,1894,0.17284268845262699
SIM,1906,37,na,1943,3259
SIM,1964,3,na,1967,4610
STAT,1916,39,35-39,1955,2.3163961298793554
STAT,1875,36,20-24,1911,0.7521081780676865
STAT,1814,42,40-44,1856,7.970148613301959
STAT,1907,17,20-24,1924,24.602373661415786
SIM,1894,15,15-19,1909,12
STAT,1910,41,30-34,1951,0.11480358249534298
STAT,1882,24,40-44,1906,1.9024425472830673
SIM,1814,41,na,1855,1361
STAT,1869,19,30-34,1888,1.4615217337046003
STAT,1839,46,50-100,1885,0.16875402006127957
STAT,1827,71,na,1898,771.0231789791064
STAT,1840,50,40-44,1890,0.00700813367996654
STAT,1892,49,50-100,1941,0.16050348859067523
SIM,1825,29,na,1854,1649
SIM,1883,42,50-100,1925,1
STAT,1921,20,25-29,1941,99.14755986376285
STAT,1820,53,20-24,1873,0.0011659975896776997
SIM,1823,33,40-44,1856,7
STAT,1902,4,na,1906,3507.315599622958
STAT,1853,28,na,1881,1890.3219280736516
STAT,1804,79,na,1883,290.8162776605684
SIM,1873,52,na,1925,2069
STAT,1842,45,20-24,1887,0.008917227424154333
SIM,1795,69,na,1864,683
SIM,1890,24,40-44,1914,2
STAT,1827,34,15-19,1861,0.15747963198585627
STAT,1881,33,40-44,1914,3.941014107618721
SIM,1817,54,50-100,1871,1
STAT,1922,45,45-49,1967,0.23698243003337147
STAT,1911,15,20-24,1926,25.749505572255284
STAT,1809,54,50-100,1863,0.03899436485851886
STAT,1950,18,na,1968,4110.243670522807
STAT,1886,15,15-19,1901,5.949665051483436
STAT,1829,33,50-100,1862,0.8895088808741063
STAT,1850,36,15-19,1886,0.04063122945525459
SIM,1910,31,30-34,1941,22
STAT,1824,46,15-19,1870,4.946001551105639E-4
STAT,1900,15,45-49,1915,0.08600316999746885
STAT,1875,75,na,1950,999.6227813649218
SIM,1931,36,45-49,1967,1
SIM,1802,56,na,1858,1016
SIM,1806,48,50-100,1854,2
SIM,1847,46,50-100,1893,3
SIM,1833,21,35-39,1854,5
STAT,1969,3,na,1972,4641.497864243757
STAT,1847,31,35-39,1878,8.8596356463332
SIM,1935,7,na,1942,5085
SIM,1835,27,25-29,1862,39
STAT,1894,25,15-19,1919,0.554554251126385
SIM,1915,17,20-24,1932,28
STAT,1874,22,40-44,1896,2.011341055475458
SIM,1903,21,15-19,1924,2
STAT,1854,51,25-29,1905,0.0025463826308497577
STAT,1937,15,40-44,1952,1.2914409938016806
SIM,1895,2,na,1897,3379
SIM,1888,21,20-24,1909,89
STAT,1903,31,15-19,1934,0.1921998487754065
STAT,1951,18,20-24,1969,152.46723723896574
STAT,1868,25,20-24,1893,10.645788949930381
STAT,1883,46,20-24,1929,0.011146117136401726
STAT,1943,26,20-24,1969,18.373662650175064
SIM,1901,17,20-24,1918,22
SIM,1859,20,40-44,1879,5
SIM,1863,15,na,1878,2203
STAT,1931,29,50-100,1960,1.2127477358902692
SIM,1830,99,na,1929,1
SIM,1916,29,35-39,1945,15
STAT,1835,78,na,1913,497.2994998909494
SIM,1901,37,na,1938,3145
SIM,1870,96,na,1966,21
SIM,1855,31,35-39,1886,14
STAT,1830,43,35-39,1873,1.3891541487364267
STAT,1891,37,15-19,1928,0.06563239815775075
STAT,1922,27,15-19,1949,0.754648776606135
SIM,1834,34,na,1868,1665
SIM,1882,29,na,1911,2235
STAT,1848,42,35-39,1890,1.3438831314106792
STAT,1876,52,50-100,1928,0.01466188550955358
SIM,1849,16,15-19,1865,10
STAT,1851,53,20-24,1904,5.222942769178682E-4
STAT,1863,15,50-100,1878,0.04689647965649897
STAT,1848,32,40-44,1880,3.7579287840564723
STAT,1908,29,35-39,1937,13.312289094748037
SIM,1910,28,25-29,1938,70
STAT,1923,36,45-49,1959,0.7468833555319951
SIM,1822,42,40-44,1864,6
STAT,1822,52,40-44,1874,0.01362350731923703
SIM,1856,32,40-44,1888,4
SIM,1933,26,30-34,1959,62
SIM,1846,35,50-100,1881,3
STAT,1902,28,25-29,1930,56.19906460856279
STAT,1876,29,na,1905,2312.610490663669
STAT,1899,57,na,1956,2621.8910052932897
SIM,1907,29,40-44,1936,2
SIM,1882,25,45-49,1907,4
SIM,1924,39,35-39,1963,9
STAT,1911,35,40-44,1946,1.378951227363468
SIM,1883,82,na,1965,618
SIM,1948,16,20-24,1964,138
SIM,1846,20,30-34,1866,17
SIM,1826,34,20-24,1860,2
STAT,1866,23,na,1889,2062.6264809224335
SIM,1838,48,na,1886,1513
SIM,1856,4,na,1860,2392
STAT,1867,102,na,1969,2.0350674457724245
SIM,1876,28,25-29,1904,41
SIM,1912,53,na,1965,3228
SIM,1931,18,45-49,1949,1
STAT,1893,56,na,1949,2443.5379594806327
SIM,1789,73,na,1862,399
STAT,1885,25,20-24,1910,11.121791110414996
STAT,1867,40,na,1907,2070.9378351957494
STAT,1902,16,35-39,1918,0.7333529939402763
STAT,1861,54,20-24,1915,5.636868524590275E-4
STAT,1925,44,30-34,1969,0.14573093472132903
SIM,1835,19,25-29,1854,4
SIM,1885,15,20-24,1900,17
STAT,1841,23,40-44,1864,1.8068227219941448
STAT,1868,89,na,1957,118.84116264643016
STAT,1816,64,na,1880,945.0251699573168
SIM,1907,38,na,1945,3278
STAT,1864,75,na,1939,866.7780198867938
SIM,1861,67,na,1928,1357
STAT,1918,47,45-49,1965,0.21849339617291685
SIM,1782,94,na,1876,4
STAT,1908,47,35-39,1955,0.11015432054897238
SIM,1927,27,50-100,1954,1
STAT,1838,20,30-34,1858,15.740244997466442
SIM,1828,65,na,1893,980
SIM,1893,25,20-24,1918,12
STAT,1943,19,25-29,1962,43.38310535075444
SIM,1942,19,35-39,1961,4
STAT,1894,43,15-19,1937,0.0011558423734301115
STAT,1855,46,45-49,1901,0.1681840499389699
STAT,1923,18,45-49,1941,0.5526809823050208
SIM,1848,32,35-39,1880,10
STAT,1866,30,35-39,1896,8.894856505227896
STAT,1819,38,50-100,1857,3.1570395325538367
SIM,1861,17,25-29,1878,5
STAT,1829,78,na,1907,472.109002223642
STAT,1922,28,50-100,1950,1.0602625742678382
STAT,1882,84,na,1966,557.1637955334418
STAT,1909,19,25-29,1928,7.985455415787767
STAT,1881,51,40-44,1932,0.00965357008705028
STAT,1853,17,25-29,1870,5.1588563317628005
STAT,1929,16,45-49,1945,0.6037168197130192
SIM,1870,43,30-34,1913,6
SIM,1838,44,40-44,1882,9
STAT,1910,33,30-34,1943,14.291030375840421
SIM,1923,26,45-49,1949,1
STAT,1834,35,20-24,1869,0.6075370642185285
STAT,1765,105,na,1870,0.013877354275100274
STAT,1927,36,30-34,1963,2.1425907189658893
SIM,1904,19,15-19,1923,7
SIM,1865,81,na,1946,433
SIM,1887,21,30-34,1908,22
SIM,1827,38,50-100,1865,1
STAT,1791,105,na,1896,0.005428919047503804
SIM,1901,49,50-100,1950,3
STAT,1879,21,30-34,1900,17.667267807609925
SIM,1813,87,na,1900,73
SIM,1887,35,50-100,1922,4
STAT,1915,26,45-49,1941,1.6704166851610582
SIM,1917,19,25-29,1936,53
STAT,1935,27,25-29,1962,84.75905795709187
STAT,1837,26,na,1863,1814.9564613979073
STAT,1889,36,45-49,1925,2.3361035017011096
SIM,1890,64,na,1954,2189
STAT,1904,29,15-19,1933,0.6103984927436643
SIM,1771,87,na,1858,42
SIM,1943,27,25-29,1970,62
STAT,1900,59,na,1959,2630.6584958948097
STAT,1831,37,45-49,1868,1.5283351074832
SIM,1841,47,na,1888,1499
SIM,1841,31,35-39,1872,8
STAT,1917,39,25-29,1956,0.9602619266729104
STAT,1892,30,35-39,1922,12.079173910752791
STAT,1873,49,15-19,1922,3.752435929024936E-4
STAT,1920,36,na,1956,3894.871590914115
STAT,1812,105,na,1917,0.012736532021284983
SIM,1889,26,45-49,1915,1
SIM,1871,81,na,1952,441
STAT,1828,65,na,1893,951.753493985762
STAT,1829,53,40-44,1882,0.007415411140109732
STAT,1860,25,20-24,1885,9.220552043451283
SIM,1914,41,40-44,1955,1
SIM,1804,83,na,1887,124
SIM,1895,48,50-100,1943,1
STAT,1816,47,20-24,1863,0.028339234123329782
SIM,1888,54,na,1942,2383
STAT,1897,35,40-44,1932,5.58298337355412
STAT,1915,16,45-49,1931,0.09901352214347835
STAT,1896,44,40-44,1940,0.19225085703059377
STAT,1824,90,na,1914,43.47165298479581
STAT,1886,43,na,1929,2289.749179620244
SIM,1925,39,25-29,1964,3
SIM,1859,57,na,1916,1605
STAT,1926,46,40-44,1972,0.18422976312738826
STAT,1805,96,na,1901,2.9974002961966004
SIM,1897,36,45-49,1933,4
STAT,1833,31,35-39,1864,8.083482054659767
STAT,1795,109,na,1904,1.4817939531201058E-4
STAT,1827,27,25-29,1854,119.0427413509355
STAT,1863,45,40-44,1908,0.1433427191855885
STAT,1938,26,40-44,1964,4.364367790007721
STAT,1910,15,30-34,1925,2.2922690297821218
STAT,1833,23,50-100,1856,0.3340998393410738
STAT,1802,72,na,1874,558.2883749542337
SIM,1899,7,na,1906,3442
STAT,1942,29,35-39,1971,14.871482999606245
SIM,1877,19,30-34,1896,2
STAT,1768,90,na,1858,19.3041496360314
STAT,1894,18,25-29,1912,6.861663852654226
SIM,1928,30,30-34,1958,22
STAT,1820,54,50-100,1874,0.02339322834413696
STAT,1887,48,50-100,1935,0.25626076471283693
SIM,1777,88,na,1865,35
SIM,1921,29,50-100,1950,1
SIM,1907,22,na,1929,3310
STAT,1934,37,35-39,1971,3.1531919496351875
STAT,1871,36,35-39,1907,6.66684590012846
SIM,1881,44,na,1925,1778
SIM,1919,23,na,1942,3830
STAT,1912,20,50-100,1932,0.59929571050152
STAT,1876,60,na,1936,1861.4165133237084
SIM,1848,85,na,1933,197
SIM,1832,70,na,1902,819
STAT,1887,49,45-49,1936,0.137732599403205
STAT,1920,37,35-39,1957,2.501764572530015
SIM,1836,84,na,1920,203
SIM,1864,34,40-44,1898,3
SIM,1905,28,45-49,1933,1
SIM,1936,21,25-29,1957,69
STAT,1870,99,na,1969,10.980061794557193
STAT,1934,19,35-39,1953,5.333039404650358
SIM,1951,19,25-29,1970,50
STAT,1852,5,na,1857,2204.866695431504
STAT,1853,42,15-19,1895,0.010438358411032337
STAT,1833,24,45-49,1857,0.5670460080847722
STAT,1911,23,20-24,1934,99.32005018932477
STAT,1903,36,45-49,1939,0.5811409146320969
SIM,1886,17,30-34,1903,3
STAT,1847,63,na,1910,1315.7588733924804
SIM,1842,84,na,1926,189
SIM,1913,22,na,1935,3347
SIM,1935,36,30-34,1971,5
STAT,1853,24,15-19,1877,2.9077336117523394
STAT,1873,21,35-39,1894,5.607937792177826
SIM,1861,24,15-19,1885,3
SIM,1889,33,35-39,1922,14
STAT,1846,46,na,1892,1673.4532610684505
STAT,1932,21,na,1953,4540.1050962479585
STAT,1936,31,25-29,1967,8.48566700787872
SIM,1919,28,45-49,1947,6
STAT,1845,54,35-39,1899,0.005924492075951847
STAT,1889,43,35-39,1932,2.096614697746515
STAT,1849,11,na,1860,2213.53621918744
STAT,1941,24,45-49,1965,1.0977200843270791
STAT,1832,48,15-19,1880,2.821810788818064E-4
STAT,1840,32,40-44,1872,3.4664123830419644
SIM,1894,14,na,1908,3256
SIM,1905,20,35-39,1925,8
STAT,1857,46,na,1903,1681.0278373687445
STAT,1928,21,25-29,1949,109.27575890055125
STAT,1924,17,20-24,1941,152.51521407643625
SIM,1824,44,na,1868,1437
SIM,1818,36,50-100,1854,1
STAT,1818,37,25-29,1855,9.14517332921067
SIM,1869,29,45-49,1898,1
STAT,1907,31,35-39,1938,8.102560623867758
SIM,1868,62,na,1930,1630
STAT,1897,21,20-24,1918,87.32568092261175
SIM,1881,26,45-49,1907,3
STAT,1859,112,na,1971,3.633649629893959E-4
STAT,1883,23,50-100,1906,0.37653383208993674
STAT,1900,28,na,1928,3116.540397612752
SIM,1879,40,35-39,1919,4
STAT,1826,85,na,1911,149.70012293142534
SIM,1856,21,25-29,1877,57
SIM,1906,31,40-44,1937,6
STAT,1821,42,30-34,1863,1.9784742008338931
SIM,1865,22,40-44,1887,2
SIM,1908,27,35-39,1935,17
STAT,1835,62,na,1897,1163.3069696940443
SIM,1898,17,20-24,1915,18
STAT,1896,39,45-49,1935,2.4622113306501556
STAT,1874,58,na,1932,1908.8233683612293
STAT,1908,44,30-34,1952,0.11037042149299264
STAT,1882,27,45-49,1909,1.020052536536718
SIM,1823,86,na,1909,104
STAT,1864,31,35-39,1895,8.561549326502552
STAT,1838,23,35-39,1861,5.046381041463359
STAT,1853,87,na,1940,133.33293507487062
SIM,1838,30,20-24,1868,1
SIM,1934,35,35-39,1969,9
STAT,1829,48,45-49,1877,0.1903855011468528
STAT,1906,38,15-19,1944,0.016593883265003738
SIM,1828,58,na,1886,1214
STAT,1896,23,50-100,1919,0.5072219820443102
STAT,1848,21,25-29,1869,52.16748476247074
SIM,1891,33,50-100,1924,4
STAT,1926,35,35-39,1961,2.797302637537995
STAT,1893,27,20-24,1920,14.054603096628176
STAT,1923,38,50-100,1961,0.45910558233622034
SIM,1929,26,40-44,1955,8
SIM,1856,77,na,1933,623
STAT,1903,37,35-39,1940,2.052020410224762
STAT,1844,34,15-19,1878,0.11584352917147134
STAT,1867,32,15-19,1899,0.12632672234723846
STAT,1863,39,50-100,1902,1.007576076106259
STAT,1914,36,na,1950,3565.7541255348838
STAT,1885,28,25-29,1913,39.69264930932817
STAT,1889,25,40-44,1914,3.5172926360864256
STAT,1851,27,20-24,1878,9.880822535481347
SIM,1941,21,35-39,1962,11
STAT,1779,108,na,1887,0.004248489229894576
STAT,1870,24,15-19,1894,3.038267845796705
SIM,1913,22,35-39,1935,11
SIM,1850,88,na,1938,90
STAT,1800,93,na,1893,11.618059502247258
STAT,1888,78,na,1966,1210.308820807542
STAT,1871,14,na,1885,2454.3357249165983
STAT,1922,42,40-44,1964,0.2712146670946819
STAT,1904,47,15-19,1951,3.043202038688049E-4
SIM,1881,21,35-39,1902,9
SIM,1890,27,45-49,1917,1
STAT,1843,66,na,1909,1107.0639918029794
SIM,1919,16,na,1935,3913
SIM,1823,36,45-49,1859,1
STAT,1861,46,20-24,1907,0.009452607803996465
SIM,1864,20,20-24,1884,60
STAT,1847,34,50-100,1881,0.7070607100933265
STAT,1875,20,35-39,1895,5.7001453601891985
SIM,1832,63,na,1895,1031
SIM,1897,25,40-44,1922,1
SIM,1911,37,35-39,1948,4
SIM,1892,26,20-24,1918,15
STAT,1848,45,50-100,1893,0.18431444799343452
STAT,1868,24,50-100,1892,0.36525768833248007
STAT,1961,9,na,1970,4794.973402048442
STAT,1905,22,35-39,1927,7.9683153225765615
STAT,1880,65,na,1945,1683.0925833784509
STAT,1884,79,na,1963,885.4968593486938
SIM,1856,76,na,1932,702
SIM,1892,28,na,1920,3147
SIM,1915,24,45-49,1939,2
STAT,1855,38,45-49,1893,1.4095983767314808
STAT,1913,17,45-49,1930,0.09649014186383227
SIM,1879,22,35-39,1901,5
SIM,1920,25,30-34,1945,58
SIM,1916,26,30-34,1942,50
STAT,1795,92,na,1887,12.069964426833646
SIM,1942,19,na,1961,3551
STAT,1764,93,na,1857,4.129618342540175
STAT,1858,31,na,1889,1785.9452001628897
STAT,1939,17,45-49,1956,0.4723770690060924
STAT,1853,47,25-29,1900,0.043388231023590434
SIM,1788,88,na,1876,43
SIM,1877,7,na,1884,2609
STAT,1830,54,40-44,1884,0.006668456500989345
SIM,1958,2,na,1960,4786
SIM,1872,28,45-49,1900,3
STAT,1858,32,na,1890,1767.4963862452075
STAT,1821,55,na,1876,1207.4617859493753
STAT,1826,105,na,1931,0.016011516879790813
STAT,1852,42,50-100,1894,0.7649701368654455
STAT,1841,26,45-49,1867,0.9576091551785844
STAT,1873,37,50-100,1910,1.1763181084757186
STAT,1759,114,na,1873,1.2386264498912328E-4
STAT,1806,81,na,1887,217.6378875063717
STAT,1895,27,na,1922,2939.2389171890577
SIM,1822,34,40-44,1856,5
SIM,1846,23,35-39,1869,6
SIM,1932,21,40-44,1953,8
STAT,1874,45,50-100,1919,0.23942224229356174
STAT,1880,48,45-49,1928,0.2320873337232875
SIM,1893,28,25-29,1921,63
STAT,1870,39,25-29,1909,2.6414729381898323
SIM,1881,43,na,1924,1788
STAT,1855,98,na,1953,2.3085000325282414
STAT,1889,22,25-29,1911,66.76297297191951
STAT,1857,18,20-24,1875,15.433494334430337
STAT,1791,71,na,1862,565.400458476423
STAT,1795,85,na,1880,92.76838885307185
STAT,1913,30,50-100,1943,0.7833794474271637
SIM,1897,22,25-29,1919,73
STAT,1845,40,50-100,1885,0.7810287384061749
STAT,1914,35,na,1949,3582.3763518072687
STAT,1923,44,45-49,1967,0.18315056893660123
STAT,1845,20,45-49,1865,0.621472250402952
STAT,1838,41,35-39,1879,1.4400873932570202
STAT,1857,22,40-44,1879,1.7923466580994816
STAT,1881,25,40-44,1906,2.752317888727009
SIM,1826,37,25-29,1863,1
STAT,1932,28,15-19,1960,0.8730855980377794
STAT,1820,45,20-24,1865,0.020730616482705518
STAT,1930,37,15-19,1967,0.02366241295580962
STAT,1785,71,na,1856,590.6125434119999
STAT,1789,85,na,1874,78.39336404515059
SIM,1915,31,35-39,1946,8
STAT,1861,39,30-34,1900,4.144181430673745
STAT,1825,37,20-24,1862,0.9675928467091839
STAT,1818,44,15-19,1862,0.03044274977936913
STAT,1928,28,50-100,1956,1.15785658400952
SIM,1822,64,na,1886,944
SIM,1879,31,20-24,1910,3
STAT,1866,39,na,1905,2032.1524833215497
SIM,1902,43,40-44,1945,1
SIM,1932,17,20-24,1949,166
STAT,1909,16,20-24,1925,25.17912742007996
SIM,1860,26,20-24,1886,9
STAT,1908,26,30-34,1934,35.41082411355714
SIM,1801,71,na,1872,569
STAT,1849,46,20-24,1895,0.009023964548242424
STAT,1852,112,na,1964,1.0518474427460767E-4
STAT,1912,25,30-34,1937,36.726084082385825
SIM,1939,29,25-29,1968,61
STAT,1824,99,na,1923,1.0442533996674064
STAT,1862,43,30-34,1905,0.921900280820628
SIM,1853,32,na,1885,1844
SIM,1829,41,35-39,1870,6
STAT,1832,25,45-49,1857,0.9375708568546317
STAT,1885,35,15-19,1920,0.0533797668478817
STAT,1878,79,na,1957,762.0050634521237
SIM,1846,41,35-39,1887,5
SIM,1867,38,25-29,1905,3
SIM,1831,85,na,1916,136
STAT,1911,24,35-39,1935,8.383633730994699
STAT,1866,16,20-24,1882,15.949286067770075
STAT,1921,39,15-19,1960,0.020213029874599973
SIM,1936,19,na,1955,2726
STAT,1888,32,35-39,1920,11.306344778772651
STAT,1896,47,50-100,1943,0.1720470608625842
STAT,1916,19,15-19,1935,9.047431296000003
STAT,1868,35,15-19,1903,0.051095163217629844
STAT,1849,16,20-24,1865,16.460884230523998
STAT,1876,5,na,1881,2670.561767436852
SIM,1869,22,25-29,1891,52
SIM,1923,23,40-44,1946,6
STAT,1874,65,na,1939,1631.1913675046032
STAT,1836,84,na,1920,215.4215621707109
STAT,1825,35,50-100,1860,1.6747157040804084
SIM,1878,18,30-34,1896,1
STAT,1911,21,30-34,1932,25.82925014849258
STAT,1920,33,40-44,1953,4.03224991824016
SIM,1907,19,15-19,1926,7
STAT,1860,7,na,1867,2188.0897085640268
SIM,1896,32,35-39,1928,15
SIM,1857,16,20-24,1873,22
STAT,1932,23,40-44,1955,4.154797307998191
SIM,1794,88,na,1882,38
STAT,1846,15,40-44,1861,0.17244160562031413
SIM,1940,23,40-44,1963,3
SIM,1871,34,35-39,1905,9
STAT,1897,38,45-49,1935,2.506044042307701
SIM,1950,15,15-19,1965,48
STAT,1872,46,45-49,1918,0.22426315473613725
SIM,1853,25,na,1878,1888
STAT,1866,40,50-100,1906,0.929797320696231
STAT,1911,26,25-29,1937,60.849199899610326
SIM,1840,89,na,1929,60
STAT,1897,30,35-39,1927,12.897199625725898
STAT,1916,25,15-19,1941,0.6942397463916369
STAT,1934,34,30-34,1968,20.295169732436946
STAT,1925,26,30-34,1951,43.86850470632309
STAT,1886,19,30-34,1905,1.5820091454847127
SIM,1869,17,30-34,1886,3
STAT,1843,28,25-29,1871,34.91091197400433
STAT,1887,21,50-100,1908,0.43220666447029
STAT,1822,40,25-29,1862,0.9866373479701354
SIM,1821,43,35-39,1864,3
STAT,1906,15,40-44,1921,0.2528262494896856
STAT,1852,10,na,1862,2119.4601117940615
STAT,1856,20,20-24,1876,59.84866971221499
SIM,1865,18,20-24,1883,11
STAT,1924,21,40-44,1945,3.759334901467502
SIM,1860,29,25-29,1889,39
SIM,1827,28,30-34,1855,25
SIM,1874,16,20-24,1890,16
STAT,1934,16,30-34,1950,15.612985900122682
SIM,1857,105,na,1962,1
STAT,1851,52,na,1903,1540.6206111037566
STAT,1852,29,25-29,1881,32.04030075018574
STAT,1880,34,35-39,1914,9.999546652812947
SIM,1843,70,na,1913,973
SIM,1862,77,na,1939,716
SIM,1942,16,30-34,1958,15
STAT,1838,35,50-100,1873,1.0154742342518839
STAT,1930,19,15-19,1949,55.13017143560312
STAT,1879,24,35-39,1903,5.7344251759100935
SIM,1851,28,25-29,1879,38
STAT,1838,32,50-100,1870,0.7643708395328338
SIM,1887,24,35-39,1911,5
SIM,1934,17,35-39,1951,6
STAT,1935,24,20-24,1959,142.94696661912266
STAT,1877,33,15-19,1910,0.13896131222299837
STAT,1902,45,40-44,1947,0.13003516735954584
STAT,1873,80,na,1953,592.6860576288561
STAT,1926,17,35-39,1943,4.860014506073459
STAT,1877,94,na,1971,93.00443854297112
SIM,1943,24,20-24,1967,93
STAT,1818,99,na,1917,0.9300756622273076
SIM,1933,19,40-44,1952,1
STAT,1863,105,na,1968,0.21529978767776128
STAT,1824,48,50-100,1872,0.29518083853878274
SIM,1868,18,25-29,1886,5
STAT,1813,43,35-39,1856,5.530822584309486
STAT,1898,23,40-44,1921,2.6557503713714232
STAT,1947,19,45-49,1966,0.5312537215953205
SIM,1924,19,15-19,1943,42
SIM,1894,19,30-34,1913,2
SIM,1924,25,15-19,1949,3
STAT,1840,24,40-44,1864,1.714189408579863
STAT,1804,86,na,1890,74.32109188277333
SIM,1928,33,35-39,1961,13
STAT,1915,23,40-44,1938,3.273328483884414
SIM,1825,38,25-29,1863,1
SIM,1889,30,30-34,1919,32
STAT,1820,38,na,1858,1466.9248178840244
STAT,1879,42,35-39,1921,1.7884606064165212
STAT,1863,41,25-29,1904,0.5347680849328246
STAT,1884,29,25-29,1913,39.198615802933205
STAT,1912,30,25-29,1942,8.661062825355724
SIM,1792,93,na,1885,3
STAT,1878,50,20-24,1928,7.369369016065542E-4
STAT,1916,18,25-29,1934,8.662949854133988
STAT,1925,19,40-44,1944,1.587592271437225
STAT,1796,108,na,1904,3.9449673983570874E-4
STAT,1826,36,20-24,1862,0.8689210489157694
STAT,1813,50,25-29,1863,0.009638728091468906
STAT,1882,39,50-100,1921,1.1165938631999164
STAT,1942,15,15-19,1957,44.82848358424991
SIM,1809,82,na,1891,168
SIM,1839,32,40-44,1871,5
SIM,1849,24,15-19,1873,5
SIM,1838,21,35-39,1859,6
SIM,1900,20,35-39,1920,13
STAT,1912,49,15-19,1961,3.324928118025968E-4
SIM,1887,42,35-39,1929,7
STAT,1836,32,15-19,1868,0.11656634094005386
STAT,1859,45,15-19,1904,3.0375436328245706E-4
STAT,1883,15,45-49,1898,0.06078368108129161
SIM,1892,29,25-29,1921,58
SIM,1924,18,25-29,1942,55
STAT,1867,37,20-24,1904,0.6838031316608463
SIM,1939,31,na,1970,3585
SIM,1888,82,na,1970,900
SIM,1902,54,na,1956,2760
STAT,1898,30,30-34,1928,22.500263180862806
SIM,1857,0,na,1857,3022
STAT,1880,41,25-29,1921,0.6424403732442123
STAT,1817,38,25-29,1855,9.41804652674198
STAT,1886,50,na,1936,2179.6054120236417
SIM,1853,18,30-34,1871,1
SIM,1889,23,40-44,1912,2
STAT,1905,15,45-49,1920,0.08961193898201557
STAT,1869,75,na,1944,942.15283153967
SIM,1920,30,25-29,1950,15
STAT,1927,41,50-100,1968,0.13938653314170085
STAT,1831,45,45-49,1876,0.17251626977200535
STAT,1907,54,na,1961,3011.415234181664
STAT,1917,27,35-39,1944,14.874357917336019
STAT,1939,28,20-24,1967,17.327602117494443
STAT,1898,19,20-24,1917,22.542957074267832
SIM,1840,20,35-39,1860,6
STAT,1867,42,50-100,1909,0.9360014938445205
STAT,1812,46,25-29,1858,0.19607729140615557
STAT,1881,1,na,1882,3085.330521581266
SIM,1903,30,25-29,1933,12
STAT,1911,33,15-19,1944,0.11771803837212283
SIM,1903,35,35-39,1938,5
SIM,1868,61,na,1929,1665
SIM,1874,62,na,1936,1673
STAT,1877,54,30-34,1931,0.00567270284335698
STAT,1865,46,50-100,1911,0.2108960512685343
STAT,1906,33,40-44,1939,3.411738354057352
SIM,1839,28,20-24,1867,8
STAT,1951,16,30-34,1967,13.715673263432247
STAT,1887,16,40-44,1903,0.19374546634777204
STAT,1894,78,na,1972,1415.0872593025408
STAT,1871,13,na,1884,2465.5292276099476
STAT,1834,34,50-100,1868,0.7133898479414108
SIM,1817,86,na,1903,72
STAT,1880,50,50-100,1930,0.015257505327811782
SIM,1869,47,na,1916,2061
STAT,1896,36,40-44,1932,5.488034208234033
SIM,1822,49,na,1871,1365
STAT,1931,36,20-24,1967,0.3301029849530456
STAT,1833,67,na,1900,972.5725303935416
STAT,1926,42,25-29,1968,0.08316190683247549
SIM,1914,33,40-44,1947,3
SIM,1890,57,na,1947,2550
SIM,1872,36,50-100,1908,1
STAT,1845,18,30-34,1863,1.4171303239805246
STAT,1770,93,na,1863,4.770087803249554
STAT,1826,31,15-19,1857,0.20918922616475058
STAT,1939,32,40-44,1971,3.772038014776725
SIM,1873,21,25-29,1894,58
SIM,1925,27,35-39,1952,23
STAT,1767,89,na,1856,30.12845854
SIM,1887,28,na,1915,2458
STAT,1839,34,40-44,1873,3.4802210377075173
STAT,1924,31,35-39,1955,10.077494593927147
STAT,1867,50,45-49,1917,0.013058643697291365
SIM,1869,26,40-44,1895,1
STAT,1833,45,50-100,1878,0.18109541896791334
STAT,1861,49,25-29,1910,0.044299397619485065
SIM,1906,34,45-49,1940,1
SIM,1929,29,45-49,1958,3
STAT,1857,50,35-39,1907,0.006506449996809144
STAT,1847,30,20-24,1877,2.3894464361277974
SIM,1890,36,50-100,1926,2
STAT,1941,1,na,1942,4040.130760933536
STAT,1790,106,na,1896,0.0024094185112871224
STAT,1865,21,25-29,1886,49.97213003263094
STAT,1867,79,na,1946,620.1609264594197
STAT,1899,37,20-24,1936,0.21536396174067182
SIM,1863,38,45-49,1901,1
STAT,1849,49,25-29,1898,0.042290572286064296
STAT,1858,24,15-19,1882,2.514772487995265
STAT,1893,42,50-100,1935,1.2641003456266333
SIM,1870,37,25-29,1907,2
SIM,1934,37,25-29,1971,1
SIM,1937,20,30-34,1957,30
STAT,1887,19,45-49,1906,0.06865509699379418
SIM,1908,24,30-34,1932,34
STAT,1847,36,45-49,1883,1.541122160004923
STAT,1826,39,25-29,1865,2.945436423904139
STAT,1879,64,na,1943,1719.016038098069
STAT,1946,23,35-39,1969,9.895451266277991
SIM,1917,34,20-24,1951,2
STAT,1893,22,15-19,1915,3.9523220247051523
SIM,1865,25,45-49,1890,1
STAT,1916,15,20-24,1931,27.299747313057107
STAT,1921,43,35-39,1964,0.2139208973000188
STAT,1871,33,30-34,1904,16.309360078437926
SIM,1815,67,na,1882,849
STAT,1964,6,na,1970,4676.28333516746
STAT,1835,99,na,1934,1.2054008732887904
STAT,1863,7,na,1870,2341.4371071436653
STAT,1923,38,15-19,1961,0.020998594777524082
STAT,1831,85,na,1916,160.06314725202333
STAT,1857,25,45-49,1882,0.8644425683832985
SIM,1834,39,25-29,1873,4
SIM,1841,74,na,1915,703
STAT,1856,37,45-49,1893,1.4693547929756374
STAT,1860,66,na,1926,1256.3171342530193
SIM,1929,21,35-39,1950,15
SIM,1873,24,40-44,1897,2
STAT,1865,13,na,1878,2304.2369413536076
SIM,1919,21,25-29,1940,106
STAT,1837,33,na,1870,1745.2411298922614
STAT,1879,17,45-49,1896,0.0645956741721274
STAT,1852,21,15-19,1873,2.861831581029717
STAT,1921,25,35-39,1946,15.914444288767548
STAT,1784,92,na,1876,10.259178152491184
STAT,1888,37,45-49,1925,2.225624676031057
STAT,1929,20,30-34,1949,34.539161647603095
SIM,1863,35,40-44,1898,3
STAT,1818,66,na,1884,870.236280369802
STAT,1946,2,na,1948,4230.242118580412
STAT,1935,34,na,1969,4936.657236958244
STAT,1891,17,45-49,1908,0.07634771811199603
STAT,1840,47,15-19,1887,2.647131661797724E-4
STAT,1924,35,50-100,1959,0.4685022510988237
SIM,1767,89,na,1856,28
SIM,1891,40,35-39,1931,5
STAT,1837,19,35-39,1856,0.4956508216784436
STAT,1865,24,40-44,1889,1.7801438124350935
STAT,1926,37,25-29,1963,1.1367379812968381
STAT,1894,48,25-29,1942,0.03895028048292818
STAT,1872,94,na,1966,65.23207858781271
STAT,1881,28,45-49,1909,1.0097031368504659
STAT,1908,19,40-44,1927,0.2549443422366834
SIM,1916,19,40-44,1935,2
STAT,1898,26,45-49,1924,1.4243044022296545
STAT,1905,46,20-24,1951,0.009269273701376517
SIM,1888,30,35-39,1918,13
SIM,1812,42,30-34,1854,2
SIM,1845,33,na,1878,1767
STAT,1825,48,na,1873,1352.5861806083358
SIM,1871,29,na,1900,2253
STAT,1909,34,20-24,1943,2.180153240657029
SIM,1932,31,35-39,1963,9
STAT,1918,48,35-39,1966,0.12925439778365794
STAT,1878,17,30-34,1895,1.5691973018116847
SIM,1860,11,na,1871,2330
SIM,1870,22,15-19,1892,3
STAT,1850,51,40-44,1901,0.007456693869414472
SIM,1908,29,25-29,1937,67
STAT,1911,31,25-29,1942,8.537442784154889
SIM,1896,37,45-49,1933,2
SIM,1901,38,25-29,1939,1
STAT,1859,38,25-29,1897,2.1541034554783263
STAT,1881,48,15-19,1929,3.60455523848553E-4
STAT,1913,37,15-19,1950,0.017903565655400876
STAT,1849,98,na,1947,2.435977090847981
SIM,1951,17,35-39,1968,4
STAT,1836,53,30-34,1889,0.003823764789979257
STAT,1857,32,35-39,1889,7.591864721651873
STAT,1860,28,25-29,1888,32.53656407489379
STAT,1846,53,40-44,1899,0.007683025512312337
STAT,1943,17,35-39,1960,4.203600713022808
SIM,1864,47,na,1911,2004
SIM,1899,6,na,1905,3451
SIM,1928,26,45-49,1954,3
STAT,1873,20,20-24,1893,66.42000670497397
SIM,1860,21,15-19,1881,2
STAT,1761,108,na,1869,0.006131336943768805
STAT,1907,21,40-44,1928,2.900489667107806
STAT,1874,18,20-24,1892,17.067159969965548
STAT,1847,32,na,1879,1876.4290853448647
SIM,1813,56,na,1869,1128
SIM,1865,32,35-39,1897,11
STAT,1893,40,45-49,1933,1.8111085068588388
STAT,1864,36,50-100,1900,1.0387001368274875
STAT,1923,41,40-44,1964,0.276571123829425
STAT,1954,18,45-49,1972,0.5831629502288744
SIM,1880,58,na,1938,1982
STAT,1870,36,20-24,1906,0.7178313177985627
SIM,1897,27,na,1924,3078
STAT,1839,31,25-29,1870,8.479787614038719
STAT,1883,40,35-39,1923,1.6941234823003626
SIM,1845,19,35-39,1864,3
SIM,1898,31,35-39,1929,13
SIM,1866,39,25-29,1905,2
STAT,1911,29,40-44,1940,4.263591060484168
STAT,1862,22,15-19,1884,2.727806144196436
SIM,1822,37,45-49,1859,1
SIM,1847,31,25-29,1878,11
SIM,1915,21,40-44,1936,2
STAT,1926,44,15-19,1970,0.0017824777023893051
STAT,1831,48,na,1879,1390.694885839953
STAT,1892,28,20-24,1920,13.83238143855932
SIM,1940,24,na,1964,3420
STAT,1846,18,45-49,1864,0.06050444039296312
STAT,1849,30,35-39,1879,8.97809178438122
SIM,1888,35,40-44,1923,5
STAT,1947,16,40-44,1963,1.4889248147311291
SIM,1868,29,30-34,1897,26
SIM,1837,17,30-34,1854,1
SIM,1917,16,20-24,1933,27
SIM,1835,44,na,1879,1516
STAT,1946,16,45-49,1962,0.5235719406865231
STAT,1836,41,50-100,1877,0.8243512898430999
STAT,1913,57,na,1970,3238.8577403631457
STAT,1926,19,25-29,1945,49.92205683432987
STAT,1852,26,20-24,1878,9.97792948000776
STAT,1958,1,na,1959,4884.58943112401
SIM,1814,45,na,1859,1312
STAT,1906,18,45-49,1924,0.08964200424490196
STAT,1860,14,na,1874,2091.2737813631347
SIM,1879,46,na,1925,2291
STAT,1822,49,20-24,1871,0.015681780939550263
SIM,1828,96,na,1924,4
SIM,1809,67,na,1876,776
STAT,1830,63,na,1893,1076.909360609386
SIM,1844,11,na,1855,2070
STAT,1873,26,45-49,1899,1.0674481612883022
SIM,1891,22,35-39,1913,7
STAT,1864,28,na,1892,2002.3121902109249
STAT,1828,104,na,1932,0.0375641450719883
STAT,1862,46,35-39,1908,0.11340165179035148
STAT,1951,19,35-39,1970,4.717304785992929
SIM,1931,2,na,1933,4996
STAT,1852,47,na,1899,1623.4993566818212
STAT,1870,17,25-29,1887,5.301732307758095
SIM,1914,3,na,1917,3964
STAT,1927,41,25-29,1968,0.0847251481285092
SIM,1896,42,na,1938,2898
SIM,1812,71,na,1883,592
SIM,1857,30,35-39,1887,4
SIM,1797,92,na,1889,7
STAT,1827,29,50-100,1856,0.9442596084734933
SIM,1835,29,50-100,1864,1
STAT,1833,28,15-19,1861,0.3642761749396487
STAT,1854,44,35-39,1898,1.2781218352899197
STAT,1892,46,na,1938,2670.1794331717415
SIM,1859,17,20-24,1876,13
SIM,1939,26,20-24,1965,17
SIM,1901,33,30-34,1934,24
SIM,1938,22,35-39,1960,7
SIM,1839,35,45-49,1874,1
SIM,1879,61,na,1940,1893
STAT,1918,40,25-29,1958,0.0719245140344351
STAT,1928,28,45-49,1956,2.009671840927229
STAT,1846,47,na,1893,1660.9358306756587
STAT,1838,16,45-49,1854,0.05827123856398558
SIM,1827,48,na,1875,1372
STAT,1835,54,50-100,1889,0.009415628283192
SIM,1858,47,na,1905,1833
STAT,1925,29,35-39,1954,16.631846352204207
STAT,1871,30,15-19,1901,0.1346624990296628
STAT,1820,48,25-29,1868,0.09519841524884619
SIM,1934,19,25-29,1953,65
STAT,1882,13,na,1895,2368.9132934610534
STAT,1933,34,50-100,1967,1.0512294275353515
SIM,1865,10,na,1875,2432
STAT,1884,26,20-24,1910,10.986781314228558
SIM,1902,23,20-24,1925,92
SIM,1910,58,na,1968,3041
STAT,1880,45,40-44,1925,0.1722039003636458
STAT,1844,27,25-29,1871,35.96527027755168
STAT,1898,33,35-39,1931,12.892004929814476
SIM,1827,30,45-49,1857,1
STAT,1884,43,50-100,1927,0.9788857273225791
STAT,1866,38,20-24,1904,0.6683256502232533
SIM,1924,15,20-24,1939,141
STAT,1906,36,45-49,1942,0.5948686217870426
STAT,1883,79,na,1962,856.466890202903
STAT,1910,24,50-100,1934,0.5801087576358113
SIM,1867,76,na,1943,798
SIM,1859,10,na,1869,2262
SIM,1927,42,na,1969,4350
STAT,1817,81,na,1898,250.28849174119227
STAT,1836,36,30-34,1872,4.280478073557608
STAT,1908,23,15-19,1931,4.608940929981415
SIM,1863,62,na,1925,1511
STAT,1886,21,45-49,1907,0.6979653183587828
STAT,1919,43,40-44,1962,0.25565993704063755
STAT,1836,28,50-100,1864,0.5321723046430303
STAT,1878,24,na,1902,2313.86263933135
SIM,1901,15,30-34,1916,2
STAT,1890,49,15-19,1939,2.551574440259241E-4
STAT,1828,54,35-39,1882,0.005887385655848334
STAT,1919,3,na,1922,4234.38920148672
STAT,1840,27,45-49,1867,0.9085138521805455
STAT,1813,54,40-44,1867,0.026443278819025303
STAT,1894,42,na,1936,2812.183388572462
SIM,1873,27,45-49,1900,1
STAT,1874,29,15-19,1903,0.43479438190573916
SIM,1871,39,50-100,1910,2
STAT,1843,25,20-24,1868,9.893419600167306
STAT,1930,22,40-44,1952,4.06909851203604
STAT,1861,51,na,1912,1699.3776977136502
SIM,1839,42,35-39,1881,4
SIM,1847,34,40-44,1881,5
STAT,1924,24,45-49,1948,1.2463778998415602
STAT,1895,45,35-39,1940,0.0982310470845369
STAT,1918,46,30-34,1964,0.08984213378602184
SIM,1936,28,45-49,1964,1
STAT,1874,47,45-49,1921,0.226730741463954
SIM,1916,23,15-19,1939,4
STAT,1920,36,45-49,1956,0.7057588515950477
SIM,1906,27,20-24,1933,15
STAT,1821,45,35-39,1866,0.22739449546542087
STAT,1936,36,35-39,1972,2.245192193508288
SIM,1909,61,na,1970,2983
SIM,1871,31,30-34,1902,20
SIM,1874,19,25-29,1893,7
STAT,1870,28,na,1898,2203.952030070591
SIM,1849,95,na,1944,3
SIM,1850,21,35-39,1871,7
STAT,1855,51,na,1906,1537.4193440257814
SIM,1909,17,na,1926,3605
SIM,1955,16,40-44,1971,1
STAT,1885,17,50-100,1902,0.04613288758653131
SIM,1851,25,20-24,1876,10
SIM,1868,102,na,1970,1
STAT,1829,99,na,1928,1.144341797433274
STAT,1925,42,na,1967,4247.626869303051
SIM,1826,30,na,1856,1610
SIM,1927,43,40-44,1970,1
SIM,1942,20,na,1962,3529
STAT,1819,35,50-100,1854,3.978205606301376
STAT,1926,32,30-34,1958,17.99660144885115
SIM,1852,27,25-29,1879,40
SIM,1857,62,na,1919,1406
STAT,1908,49,25-29,1957,0.04505499147288916
SIM,1934,32,30-34,1966,28
STAT,1950,21,35-39,1971,10.556206586414914
STAT,1866,19,25-29,1885,5.008460068972147
STAT,1926,20,na,1946,4216.0247109524835
SIM,1833,48,na,1881,1428
SIM,1894,21,45-49,1915,1
STAT,1896,40,25-29,1936,0.05619906893534282
SIM,1816,52,50-100,1868,3
SIM,1802,97,na,1899,4
SIM,1909,54,na,1963,3165
SIM,1862,36,35-39,1898,15
SIM,1844,27,na,1871,1774
STAT,1921,40,30-34,1961,0.13640883848477103
SIM,1882,66,na,1948,1516
STAT,1843,31,15-19,1874,0.11684440227832514
SIM,1859,41,45-49,1900,3
STAT,1884,50,45-49,1934,0.013739380225926703
STAT,1809,85,na,1894,110.0079879997816
STAT,1840,30,35-39,1870,8.264603535326435
SIM,1895,45,50-100,1940,1
STAT,1936,30,50-100,1966,0.7594975837813603
STAT,1927,38,35-39,1965,2.837990932444647
SIM,1884,39,50-100,1923,1
STAT,1914,18,50-100,1932,0.07302412186538598
STAT,1938,24,50-100,1962,0.6147946720731001
SIM,1881,20,20-24,1901,50
STAT,1863,34,35-39,1897,8.323633813232469
SIM,1876,39,30-34,1915,6
STAT,1823,84,na,1907,178.03506888113284
STAT,1946,8,na,1954,4125.323647504514
SIM,1880,65,na,1945,1643
STAT,1868,39,30-34,1907,4.755425071122961
STAT,1940,25,na,1965,3611.9133035681534
SIM,1926,36,na,1962,4296
SIM,1869,20,20-24,1889,73
STAT,1811,53,30-34,1864,0.018574669544772545
STAT,1868,96,na,1964,24.664306706092475
STAT,1911,46,45-49,1957,0.19486584297553206
SIM,1852,46,na,1898,1734
SIM,1855,33,40-44,1888,9
STAT,1877,7,na,1884,2631.742203994029
SIM,1827,39,35-39,1866,9
SIM,1844,36,30-34,1880,4
STAT,1921,42,na,1963,3951.7174058030005
STAT,1824,53,40-44,1877,0.012111312581464645
STAT,1883,63,na,1946,1652.6464458618784
SIM,1863,83,na,1946,300
STAT,1853,44,20-24,1897,0.11856676066263896
STAT,1884,11,na,1895,2413.905985450579
STAT,1875,44,na,1919,2213.9545889800006
SIM,1880,24,35-39,1904,5
STAT,1857,37,15-19,1894,0.04183857350410697
STAT,1927,45,40-44,1972,0.18783767754338637
STAT,1820,51,30-34,1871,0.00978815775860165
STAT,1913,32,35-39,1945,8.589481903831594
STAT,1819,39,35-39,1858,16.843340409394578
STAT,1847,25,na,1872,1945.1952914573799
STAT,1888,34,40-44,1922,4.80026652964514
STAT,1856,31,25-29,1887,7.721794595774363
STAT,1887,42,25-29,1929,0.677721839849147
STAT,1854,76,na,1930,677.8531259216045
STAT,1859,10,na,1869,2109.656037528333
STAT,1920,19,40-44,1939,1.474522275124817
SIM,1855,15,25-29,1870,6
SIM,1870,34,20-24,1904,3
SIM,1874,43,50-100,1917,1
STAT,1910,48,50-100,1958,0.19880684611743962
STAT,1900,16,20-24,1916,23.290381072609183
STAT,1901,45,20-24,1946,0.009040168336224718
STAT,1899,15,50-100,1914,0.06370985575210611
SIM,1830,30,30-34,1860,25
STAT,1786,87,na,1873,51.85977187825373
STAT,1864,30,20-24,1894,2.2941931900933183
STAT,1855,34,50-100,1889,0.6493367480586835
SIM,1912,25,35-39,1937,15
STAT,1856,61,na,1917,1377.3297940077862
SIM,1852,6,na,1858,2294
SIM,1858,20,45-49,1878,3
SIM,1800,86,na,1886,54
SIM,1851,98,na,1949,1
SIM,1922,36,na,1958,4036
SIM,1886,42,30-34,1928,4
STAT,1950,18,25-29,1968,48.39170386026497
STAT,1871,78,na,1949,732.946567505126
SIM,1909,26,50-100,1935,5
STAT,1895,37,35-39,1932,8.711000879869266
SIM,1846,32,50-100,1878,3
STAT,1896,42,35-39,1938,0.1566990717089503
STAT,1901,38,na,1939,3124.415684392161
STAT,1904,25,35-39,1929,13.163546256886262
STAT,1941,18,15-19,1959,44.146094853072725
STAT,1879,50,35-39,1929,0.008635607105277105
STAT,1894,45,20-24,1939,0.008299829288955105
SIM,1835,38,30-34,1873,9
STAT,1837,70,na,1907,910.5726065817933
SIM,1929,34,50-100,1963,4
STAT,1803,54,35-39,1857,0.02409645614301576
SIM,1843,79,na,1922,458
SIM,1844,17,na,1861,1973
STAT,1831,23,35-39,1854,10.676869140985403
STAT,1942,23,15-19,1965,5.270946045660709
SIM,1864,31,25-29,1895,15
SIM,1921,32,35-39,1953,12
STAT,1828,46,35-39,1874,0.11486744886975843
STAT,1917,16,30-34,1933,2.4839802628275787
SIM,1861,98,na,1959,4
STAT,1833,51,40-44,1884,0.006790125835654122
STAT,1899,43,15-19,1942,0.0012323430936320022
STAT,1853,30,45-49,1883,1.3875549072162743
STAT,1843,17,50-100,1860,0.04228853582905141
STAT,1867,18,30-34,1885,1.436902784030283
SIM,1899,0,na,1899,3631
STAT,1847,15,25-29,1862,5.277397096117215
SIM,1823,49,50-100,1872,5
STAT,1870,45,35-39,1915,0.13104009788974014
STAT,1860,53,25-29,1913,0.002671395118086085
STAT,1856,77,na,1933,637.124260554164
STAT,1847,33,40-44,1880,3.715985961385429
SIM,1821,54,na,1875,1162
STAT,1900,40,50-100,1940,0.09711157532635038
STAT,1845,43,30-34,1888,0.8178951698216874
STAT,1850,43,40-44,1893,1.5741133544128925
SIM,1939,21,40-44,1960,4
STAT,1798,72,na,1870,559.0603385590713
SIM,1785,74,na,1859,403
SIM,1856,12,na,1868,2253
STAT,1838,49,50-100,1887,0.16534428744175433
SIM,1814,72,na,1886,518
SIM,1940,27,20-24,1967,17
SIM,1814,82,na,1896,161
SIM,1776,93,na,1869,5
STAT,1816,54,45-49,1870,0.03153169659402619
STAT,1907,35,15-19,1942,0.016979650735378833
STAT,1863,59,na,1922,1611.165386283149
STAT,1868,29,50-100,1897,0.5724607529348134
STAT,1834,52,na,1886,1368.7226612048862
STAT,1878,42,30-34,1920,1.130478538584693
STAT,1925,40,15-19,1965,0.001761240968266052
STAT,1863,49,na,1912,1826.2138536876673
SIM,1853,29,35-39,1882,10
SIM,1864,31,na,1895,2077
STAT,1827,54,20-24,1881,5.699538505500726E-4
STAT,1859,51,50-100,1910,0.011409946497490647
STAT,1960,7,na,1967,4835.0798911417105
STAT,1852,54,30-34,1906,0.004196842726797235
STAT,1845,29,35-39,1874,8.191810373330824
STAT,1831,30,25-29,1861,8.385495769686033
STAT,1864,96,na,1960,14.396052429597157
STAT,1895,64,na,1959,2233.792868909202
STAT,1932,27,20-24,1959,22.586340297308883
SIM,1870,26,30-34,1896,27
STAT,1881,16,50-100,1897,0.04482011625806502
STAT,1811,44,15-19,1855,0.0483065654922844
STAT,1912,24,30-34,1936,26.94773749834443
SIM,1869,35,50-100,1904,1
SIM,1882,50,na,1932,2057
STAT,1869,44,30-34,1913,1.037961995663318
SIM,1861,29,na,1890,2018
SIM,1872,31,35-39,1903,10
STAT,1920,35,30-34,1955,1.8883916111653143
STAT,1918,16,50-100,1934,0.07748054631893363
STAT,1903,35,30-34,1938,1.5609203036996433
SIM,1917,53,na,1970,3518
STAT,1866,45,45-49,1911,0.2076818924174136
STAT,1862,26,30-34,1888,20.562508323129126
STAT,1865,54,40-44,1919,0.008766578232234847
SIM,1773,89,na,1862,30
SIM,1898,20,30-34,1918,26
SIM,1857,99,na,1956,7
SIM,1872,1,na,1873,3178
SIM,1880,31,25-29,1911,12
STAT,1897,32,25-29,1929,12.940325842613783
STAT,1850,52,na,1902,1509.7381307655248
SIM,1846,12,na,1858,2141
STAT,1788,72,na,1860,482.48908392240355
SIM,1822,40,35-39,1862,7
STAT,1872,31,25-29,1903,9.745322375150385
SIM,1855,98,na,1953,1
STAT,1924,28,25-29,1952,72.14182904531503
SIM,1874,31,na,1905,2228
SIM,1912,27,45-49,1939,2
STAT,1840,54,35-39,1894,0.005494396309658614
SIM,1845,41,30-34,1886,1
STAT,1881,44,na,1925,2080.7814822077416
STAT,1909,17,35-39,1926,0.7774004441989127
STAT,1904,27,45-49,1931,1.504523351021278
SIM,1925,16,30-34,1941,23
STAT,1848,54,40-44,1902,0.007607536605829672
STAT,1823,54,35-39,1877,0.009805711312371476
STAT,1890,11,na,1901,2987.1606297196963
STAT,1907,33,50-100,1940,0.7270139464860472
SIM,1869,19,na,1888,2355
SIM,1806,53,na,1859,1181
SIM,1920,24,30-34,1944,42
SIM,1870,65,na,1935,1522
STAT,1818,101,na,1919,0.28023251253629455
STAT,1849,15,45-49,1864,0.06101109047711408
STAT,1889,21,25-29,1910,66.96453622595963
STAT,1827,38,30-34,1865,5.402350072697856
SIM,1902,29,40-44,1931,4
SIM,1879,47,50-100,1926,1
STAT,1761,95,na,1856,2.9981148191999996
STAT,1835,49,30-34,1884,0.06329800024526129
SIM,1823,59,na,1882,1069
SIM,1895,21,50-100,1916,1
STAT,1908,40,15-19,1948,0.0013574717499388747
SIM,1901,44,na,1945,3046
STAT,1915,28,15-19,1943,0.6778525318602275
SIM,1915,28,25-29,1943,67
STAT,1855,35,40-44,1890,3.1403136448606994
STAT,1866,61,na,1927,1628.1820112901244
STAT,1814,40,35-39,1854,6.847169584493164
STAT,1870,42,15-19,1912,0.012782658490565708
STAT,1888,31,20-24,1919,3.0301578544104215
SIM,1897,21,25-29,1918,79
STAT,1870,28,30-34,1898,23.255461390382727
STAT,1922,46,20-24,1968,0.012023324127288414
STAT,1819,53,30-34,1872,0.010611969881964393
STAT,1829,51,35-39,1880,0.006933224248980908
SIM,1862,46,na,1908,1915
SIM,1873,83,na,1956,332
SIM,1896,31,20-24,1927,2
STAT,1881,78,na,1959,843.1244737323013
STAT,1890,45,35-39,1935,0.16330724648741002
SIM,1851,40,50-100,1891,1
SIM,1910,48,50-100,1958,3
SIM,1869,40,na,1909,2151
SIM,1911,35,30-34,1946,1
STAT,1881,31,35-39,1912,9.279795036738397
STAT,1899,20,40-44,1919,2.7133813122572255
STAT,1928,43,35-39,1971,0.24211899281063384
SIM,1808,72,na,1880,560
STAT,1886,44,30-34,1930,1.131779939663667
STAT,1907,28,25-29,1935,58.49621837218201
STAT,1919,46,45-49,1965,0.22325003154051648
STAT,1894,29,30-34,1923,30.35356757565954
STAT,1857,25,na,1882,1858.062215253927
SIM,1852,38,30-34,1890,8
STAT,1799,105,na,1904,0.00936068476094542
STAT,1838,40,20-24,1878,0.12792789510823574
SIM,1918,28,50-100,1946,1
STAT,1933,18,25-29,1951,54.65840588094109
STAT,1822,67,na,1889,806.0355073180754
SIM,1882,60,na,1942,1792
STAT,1857,46,50-100,1903,0.18350651338188437
STAT,1891,44,40-44,1935,2.593426030015559
STAT,1869,22,20-24,1891,63.067987371490695
SIM,1921,25,45-49,1946,2
SIM,1880,31,na,1911,2423
STAT,1837,41,30-34,1878,0.8918043210040105
SIM,1842,91,na,1933,28
STAT,1875,0,na,1875,3564.8999755421737
SIM,1909,24,na,1933,3340
STAT,1870,42,30-34,1912,1.0641562439131274
STAT,1854,23,50-100,1877,0.34035563700615934
SIM,1888,32,25-29,1920,15
STAT,1880,23,30-34,1903,17.685057525835774
STAT,1772,102,na,1874,0.0721239114037254
STAT,1848,20,25-29,1868,52.544756111350225
STAT,1944,1,na,1945,4203.336454985741
SIM,1941,18,25-29,1959,47
SIM,1932,28,25-29,1960,85
STAT,1811,49,45-49,1860,0.7605878446520568
STAT,1841,20,25-29,1861,50.72105937659783
SIM,1812,87,na,1899,64
SIM,1900,25,na,1925,3187
STAT,1938,15,na,1953,3446.0390681498834
STAT,1913,25,45-49,1938,1.637295980147385
SIM,1873,14,na,1887,2505
STAT,1844,38,30-34,1882,3.8710812517931563
STAT,1851,33,15-19,1884,0.10552023402268446
STAT,1803,53,50-100,1856,0.043130930086851836
STAT,1915,42,na,1957,3532.360518746128
SIM,1870,0,na,1870,3254
STAT,1810,86,na,1896,93.86227102614417
STAT,1933,25,15-19,1958,0.8862890583091864
SIM,1842,15,15-19,1857,4
SIM,1932,20,na,1952,4521
SIM,1899,21,45-49,1920,1
STAT,1912,17,40-44,1929,0.2672031545502995
SIM,1861,28,30-34,1889,27
STAT,1913,23,na,1936,3473.01109965351
STAT,1875,34,na,1909,2297.3045903460347
SIM,1917,17,35-39,1934,2
SIM,1867,83,na,1950,319
SIM,1877,44,30-34,1921,2
STAT,1854,36,35-39,1890,5.084926178483845
SIM,1877,22,20-24,1899,70
STAT,1807,53,40-44,1860,0.03780645159868119
STAT,1853,28,30-34,1881,19.946127689676924
STAT,1890,21,35-39,1911,6.76012798942565
STAT,1912,18,50-100,1930,0.07138473682459644
SIM,1882,44,40-44,1926,3
STAT,1829,45,40-44,1874,0.14364738213659647
STAT,1874,44,40-44,1918,2.141748529483461
STAT,1930,25,45-49,1955,2.0770071911624224
SIM,1855,30,20-24,1885,2
SIM,1856,20,25-29,1876,55
STAT,1873,23,40-44,1896,1.9903581329407805
STAT,1807,50,na,1857,1271.8527317485868
SIM,1920,17,40-44,1937,1
STAT,1830,32,30-34,1862,14.976154248888019
SIM,1938,21,na,1959,3248
STAT,1861,52,30-34,1913,0.004650760205490836
SIM,1845,36,35-39,1881,10
SIM,1905,24,na,1929,3201
STAT,1858,22,45-49,1880,0.5926030708766927
STAT,1817,101,na,1918,0.2641085293369062
SIM,1897,9,na,1906,3368
SIM,1935,35,30-34,1970,3
STAT,1863,31,30-34,1894,14.5335592280957
STAT,1848,42,na,1890,1715.2708696566
STAT,1905,58,na,1963,2854.983959181046
SIM,1891,33,na,1924,2790
STAT,1822,33,35-39,1855,25.62816455933112
STAT,1875,42,50-100,1917,1.0245673184192492
SIM,1849,7,na,1856,2288
STAT,1941,17,20-24,1958,131.921688001609
SIM,1927,38,45-49,1965,4
STAT,1877,26,50-100,1903,0.6290079444637492
STAT,1893,48,40-44,1941,0.11424108830964418
STAT,1805,55,na,1860,1140.02513201707
STAT,1903,57,na,1960,2799.5638721615496
SIM,1845,98,na,1943,1
STAT,1864,33,25-29,1897,8.587590612255548
STAT,1882,50,25-29,1932,0.003300864466706676
STAT,1850,46,45-49,1896,0.16683425109566774
STAT,1883,27,15-19,1910,0.42022535732718136
STAT,1931,20,35-39,1951,11.605466471021183
SIM,1880,21,30-34,1901,23
STAT,1848,21,50-100,1869,0.37161625738579274
STAT,1900,19,25-29,1919,7.386447376397498
SIM,1848,22,40-44,1870,2
STAT,1839,49,15-19,1888,2.6448022919673477E-4
STAT,1907,23,na,1930,3271.901888444791
STAT,1919,36,35-39,1955,2.457008616097111
SIM,1880,40,50-100,1920,1
SIM,1909,38,40-44,1947,2
STAT,1837,36,35-39,1873,5.647194558531489
SIM,1879,40,na,1919,2356
SIM,1810,52,na,1862,1167
SIM,1898,37,na,1935,2988
STAT,1803,51,30-34,1854,0.01769728190271787
STAT,1840,52,na,1892,1405.5104856010767
SIM,1831,30,35-39,1861,10
STAT,1933,33,15-19,1966,0.1634971163920328
SIM,1913,8,na,1921,3714
SIM,1815,85,na,1900,120
STAT,1836,39,35-39,1875,5.506422420055864
SIM,1933,23,15-19,1956,6
STAT,1849,26,15-19,1875,0.406211955989325
SIM,1819,44,na,1863,1406
STAT,1836,30,45-49,1866,1.457340923463137
SIM,1881,23,40-44,1904,4
SIM,1908,24,15-19,1932,3
STAT,1900,17,15-19,1917,7.7772553129350515
STAT,1820,38,30-34,1858,11.533572966596815
STAT,1930,17,45-49,1947,0.6100980307756104
STAT,1845,46,35-39,1891,0.09934931032638948
SIM,1944,21,na,1965,3609
SIM,1851,4,na,1855,2296
SIM,1844,39,35-39,1883,12
STAT,1925,23,15-19,1948,6.00064970843199
STAT,1945,26,35-39,1971,15.567365898904148
STAT,1798,68,na,1866,728.0700123036534
STAT,1856,53,35-39,1909,0.006243661842450052
STAT,1825,43,15-19,1868,0.014698182503961524
SIM,1915,5,na,1920,3789
STAT,1836,57,na,1893,1301.3698520236903
SIM,1854,17,na,1871,2183
STAT,1813,84,na,1897,136.9064260595112
SIM,1933,9,na,1942,5096
SIM,1799,56,na,1855,1062
STAT,1917,6,na,1923,4061.277311377972
STAT,1878,37,35-39,1915,6.963436888135754
STAT,1860,49,40-44,1909,0.12848654802394038
SIM,1771,94,na,1865,3
STAT,1820,70,na,1890,739.1502710283139
STAT,1878,45,35-39,1923,0.13920701889945578
SIM,1924,25,50-100,1949,1
SIM,1846,46,na,1892,1590
SIM,1868,37,30-34,1905,6
STAT,1846,105,na,1951,0.021747253326351954
STAT,1893,45,50-100,1938,0.1676280608886083
STAT,1820,34,15-19,1854,0.425284898755987
STAT,1840,20,25-29,1860,48.468665510923444
STAT,1850,25,50-100,1875,0.538362464455375
SIM,1887,38,na,1925,2432
SIM,1921,22,40-44,1943,2
STAT,1891,47,45-49,1938,0.15486704894529915
SIM,1836,37,50-100,1873,4
STAT,1915,35,20-24,1950,0.25396569848045353
STAT,1822,71,na,1893,678.2623579579782
SIM,1829,71,na,1900,788
STAT,1868,58,na,1926,1782.4918955040416
SIM,1874,8,na,1882,2515
STAT,1884,48,15-19,1932,3.6863709331977536E-4
STAT,1869,10,na,1879,2464.5944524963083
SIM,1869,42,30-34,1911,7
STAT,1881,21,25-29,1902,52.40044262284914
STAT,1808,66,na,1874,824.9836394480226
STAT,1863,25,50-100,1888,0.5380141998983332
STAT,1810,50,45-49,1860,0.04818362741253568
STAT,1903,35,50-100,1938,0.35957981764048474
STAT,1868,17,20-24,1885,16.268793724436666
SIM,1778,88,na,1866,39
STAT,1938,9,na,1947,3709.7794994499195
STAT,1923,19,na,1942,4061.1103677252863
SIM,1872,66,na,1938,1498
SIM,1935,28,40-44,1963,6
STAT,1878,52,25-29,1930,0.0034686205791743334
SIM,1886,37,35-39,1923,14
STAT,1927,35,30-34,1962,2.1443490852157665
SIM,1828,27,na,1855,1736
SIM,1780,92,na,1872,3
STAT,1862,20,45-49,1882,0.5849518124108751
STAT,1930,25,na,1955,4503.779157080776
STAT,1850,28,15-19,1878,0.3736683820216802
SIM,1830,33,35-39,1863,8
SIM,1915,25,20-24,1940,25
SIM,1932,36,na,1968,4732
STAT,1919,27,50-100,1946,1.0159877107078434
STAT,1924,18,15-19,1942,50.920060714265496
SIM,1849,27,50-100,1876,3
SIM,1932,18,15-19,1950,54
SIM,1893,38,na,1931,2914
STAT,1853,59,na,1912,1470.8061440069473
STAT,1828,37,50-100,1865,1.1208700661884745
STAT,1800,56,na,1856,1054.3975136537001
STAT,1828,28,na,1856,1596.5446891317256
STAT,1866,17,50-100,1883,0.043815424424031045
SIM,1889,39,na,1928,2832
STAT,1923,24,50-100,1947,0.7187275185417475
STAT,1845,26,30-34,1871,21.846292472327118
STAT,1896,32,25-29,1928,12.779548292061426
STAT,1834,20,50-100,1854,0.5547160547240816
STAT,1849,19,25-29,1868,5.16911421729107
STAT,1844,40,45-49,1884,1.0922028204209127
STAT,1842,26,15-19,1868,0.409256164693897
STAT,1927,28,40-44,1955,5.334155070213612
STAT,1816,71,na,1887,687.257290134443
SIM,1886,80,na,1966,863
STAT,1876,46,15-19,1922,3.9151001360578184E-4
STAT,1929,22,50-100,1951,0.7860418352173802
STAT,1911,23,50-100,1934,0.5877274437282911
SIM,1878,35,35-39,1913,13
STAT,1921,24,40-44,1945,3.565224259801837
STAT,1793,69,na,1862,614.4456480912702
STAT,1815,52,35-39,1867,0.01860339410502972
STAT,1941,25,20-24,1966,17.854280717450674
STAT,1859,44,na,1903,1714.34224175912
SIM,1916,40,na,1956,3511
STAT,1883,45,45-49,1928,0.22076556693281352
STAT,1893,63,na,1956,2161.162917604336
SIM,1887,65,na,1952,1741
STAT,1893,17,50-100,1910,0.058693625618724515
SIM,1879,5,na,1884,2714
SIM,1901,38,40-44,1939,1
STAT,1847,50,40-44,1897,0.00787472492238032
SIM,1912,6,na,1918,3807
SIM,1875,18,30-34,1893,1
SIM,1916,36,na,1952,3561
STAT,1833,102,na,1935,0.17987051068138687
STAT,1866,44,15-19,1910,0.011870378750846528
STAT,1886,47,35-39,1933,0.13905613149979715
STAT,1930,15,35-39,1945,5.148635089628049
SIM,1873,79,na,1952,587
STAT,1877,31,45-49,1908,1.7158151583351566
STAT,1907,25,20-24,1932,16.390508892832578
STAT,1884,32,15-19,1916,0.13291203215719793
STAT,1829,41,25-29,1870,0.5564183875547033
SIM,1868,15,20-24,1883,16
SIM,1853,26,30-34,1879,26
STAT,1910,38,25-29,1948,0.8852094528816022
STAT,1941,15,50-100,1956,0.364752048055734
STAT,1890,42,30-34,1932,1.3261927366084794
SIM,1857,19,25-29,1876,7
STAT,1913,22,40-44,1935,3.0780664426091198
SIM,1904,55,na,1959,2948
SIM,1871,13,na,1884,2497
SIM,1934,21,na,1955,4552
STAT,1899,21,35-39,1920,7.5762656356301
STAT,1940,28,50-100,1968,0.9583881235047105
SIM,1830,25,35-39,1855,8
STAT,1844,76,na,1920,657.994278558177
STAT,1855,41,35-39,1896,1.2926351036672463
STAT,1901,48,40-44,1949,0.12609539525406604
STAT,1928,40,30-34,1968,0.15438964122369678
STAT,1899,23,45-49,1922,0.8998258367275882
SIM,1866,66,na,1932,1421
SIM,1870,29,35-39,1899,12
SIM,1828,101,na,1929,2
STAT,1810,70,na,1880,675.1906262013713
STAT,1907,43,15-19,1950,0.0013211936547890845
STAT,1862,29,35-39,1891,7.737915891091672
STAT,1866,42,40-44,1908,1.9574291053533668
STAT,1933,39,na,1972,4830.658515154591
SIM,1885,31,45-49,1916,2
SIM,1876,17,20-24,1893,20
STAT,1902,47,30-34,1949,0.07245939306090475
SIM,1858,31,na,1889,1968
STAT,1911,41,15-19,1952,0.0013926902038302355
SIM,1896,34,40-44,1930,10
STAT,1830,50,50-100,1880,0.011379539300743122
STAT,1915,27,20-24,1942,17.589243749850958
STAT,1858,42,15-19,1900,0.010216091755514826
STAT,1839,51,45-49,1890,0.009708570361511144
SIM,1850,82,na,1932,299
SIM,1818,40,45-49,1858,4
STAT,1874,52,40-44,1926,0.01010743860201688
STAT,1902,24,50-100,1926,0.5402754676791877
SIM,1834,27,na,1861,1727
STAT,1940,6,na,1946,3828.717103451302
SIM,1874,42,40-44,1916,8
SIM,1923,27,20-24,1950,17
STAT,1856,4,na,1860,2323.030565906075
STAT,1870,35,na,1905,2204.164714146297
STAT,1923,37,20-24,1960,0.2885448314134604
SIM,1890,43,35-39,1933,4
SIM,1827,86,na,1913,110
STAT,1861,24,na,1885,1881.1954897447872
STAT,1891,29,15-19,1920,0.5264890122328326
STAT,1905,30,35-39,1935,13.939606929665464
STAT,1844,28,50-100,1872,0.539970549629791
STAT,1837,51,25-29,1888,0.0023532875037376197
STAT,1818,50,45-49,1868,0.030913979841888126
SIM,1863,31,25-29,1894,9
SIM,1889,23,na,1912,2831
SIM,1829,43,40-44,1872,7
SIM,1802,87,na,1889,50
STAT,1898,38,15-19,1936,0.015418189564196504
STAT,1819,36,30-34,1855,16.39109455127814
STAT,1900,50,na,1950,2862.3638570119547
STAT,1953,18,40-44,1971,1.5978717653559846
SIM,1878,51,na,1929,2215
SIM,1927,36,35-39,1963,8
SIM,1883,14,na,1897,2403
SIM,1941,15,20-24,1956,122
STAT,1851,51,45-49,1902,0.010489351441972609
STAT,1817,41,15-19,1858,0.03652258764460979
STAT,1830,35,35-39,1865,5.907275932707371
SIM,1850,44,45-49,1894,1
STAT,1771,102,na,1873,0.058752448297171
STAT,1858,20,35-39,1878,5.031139417423453
SIM,1837,69,na,1906,908
SIM,1872,7,na,1879,2606
STAT,1812,43,20-24,1855,0.5852759454064861
SIM,1836,21,20-24,1857,54
STAT,1848,24,40-44,1872,1.8583483463597532
STAT,1865,44,na,1909,1952.3231644898958
STAT,1844,52,30-34,1896,0.004112178219029823
SIM,1804,52,na,1856,1139
SIM,1900,17,25-29,1917,7
SIM,1844,30,45-49,1874,3
STAT,1939,29,15-19,1968,0.6697864986460591
STAT,1837,44,35-39,1881,1.2300424058690942
SIM,1917,3,na,1920,4107
STAT,1882,43,35-39,1925,1.6516048032191497
STAT,1919,38,45-49,1957,0.6911732794584748
SIM,1888,32,50-100,1920,1
SIM,1913,30,35-39,1943,13
SIM,1827,36,30-34,1863,4
SIM,1864,41,na,1905,2048
STAT,1896,25,35-39,1921,12.120502892735757
SIM,1852,40,45-49,1892,6
STAT,1862,40,15-19,1902,0.011267007808616818
STAT,1817,40,na,1857,1446.1384172491414
STAT,1860,35,na,1895,1823.0299495888405
SIM,1856,24,40-44,1880,1
STAT,1859,3,na,1862,2465.9087345682174
SIM,1792,86,na,1878,63
SIM,1854,3,na,1857,2583
SIM,1907,17,25-29,1924,11
STAT,1886,27,30-34,1913,25.12927939812776
STAT,1842,44,45-49,1886,1.092982526303445
SIM,1900,24,15-19,1924,3
SIM,1920,27,35-39,1947,20
SIM,1928,21,na,1949,4309
SIM,1849,28,30-34,1877,28
STAT,1832,22,40-44,1854,3.0041909076058992
SIM,1821,85,na,1906,165
STAT,1811,46,40-44,1857,0.5797257315528965
STAT,1830,38,na,1868,1609.4424405305817
STAT,1915,5,na,1920,3962.5382914578495
STAT,1925,24,50-100,1949,0.7393780384395497
SIM,1837,34,35-39,1871,11
STAT,1844,51,50-100,1895,0.010539404174432485
SIM,1845,44,35-39,1889,4
STAT,1868,62,na,1930,1647.4110498642535
STAT,1859,75,na,1934,774.0427777735717
SIM,1866,20,35-39,1886,7
STAT,1933,15,20-24,1948,172.24625493729982
STAT,1824,38,15-19,1862,0.08371185902244634
SIM,1903,34,40-44,1937,2
STAT,1838,43,25-29,1881,0.4529701811115977
SIM,1907,53,na,1960,3045
SIM,1857,83,na,1940,244
STAT,1875,16,15-19,1891,5.776688764434446
STAT,1904,17,35-39,1921,0.7435318358727406
SIM,1894,27,30-34,1921,37
STAT,1851,52,20-24,1903,5.279913030780805E-4
STAT,1912,27,35-39,1939,13.977476560016253
SIM,1840,22,40-44,1862,1
SIM,1883,16,15-19,1899,9
SIM,1803,73,na,1876,460
STAT,1875,22,45-49,1897,0.6771094785632207
SIM,1918,35,30-34,1953,1
STAT,1865,82,na,1947,399.5187552345437
STAT,1865,39,15-19,1904,0.04759931554312917
STAT,1920,31,15-19,1951,0.13351424003733992
STAT,1830,90,na,1920,47.58389426582586
SIM,1840,68,na,1908,982
STAT,1949,17,na,1966,4044.226648326278
SIM,1929,37,na,1966,4526
STAT,1812,53,30-34,1865,0.018664872920021062
STAT,1928,22,na,1950,4307.181062351821
SIM,1942,29,na,1971,3622
STAT,1899,17,15-19,1916,7.6816984637345405
STAT,1874,50,35-39,1924,0.00842907878220074
STAT,1928,33,40-44,1961,4.61959152540487
STAT,1827,43,na,1870,1528.8615121121916
STAT,1823,32,25-29,1855,26.848126592348255
SIM,1817,39,25-29,1856,2
SIM,1831,32,25-29,1863,18
SIM,1866,97,na,1963,9
SIM,1922,20,35-39,1942,11
SIM,1878,82,na,1960,553
SIM,1850,8,na,1858,2274
STAT,1869,23,15-19,1892,3.0099025583265515
SIM,1877,27,30-34,1904,26
SIM,1923,38,25-29,1961,3
STAT,1917,42,30-34,1959,0.12604064198716325
STAT,1923,40,50-100,1963,0.13007440125227054
STAT,1929,39,50-100,1968,0.508110280460954
STAT,1804,70,na,1874,682.4857086427558
STAT,1901,46,35-39,1947,0.10472401822901688
SIM,1845,33,30-34,1878,21
STAT,1846,45,40-44,1891,0.12824562471111856
STAT,1846,31,30-34,1877,15.463334457345677
SIM,1911,27,na,1938,3428
STAT,1887,45,50-100,1932,0.26210898304048014
SIM,1923,22,na,1945,4059
STAT,1914,46,45-49,1960,0.20413796971936962
SIM,1796,86,na,1882,67
SIM,1839,71,na,1910,895
STAT,1888,42,25-29,1930,0.7160524100231802
STAT,1910,44,35-39,1954,0.17757996618208285
SIM,1936,33,40-44,1969,2
STAT,1915,38,25-29,1953,0.9350022929374395
STAT,1916,37,na,1953,3639.6303189807345
SIM,1909,23,20-24,1932,97
SIM,1834,65,na,1899,1015
STAT,1854,45,na,1899,1625.7756701783198
SIM,1831,32,40-44,1863,4
SIM,1858,78,na,1936,566
STAT,1810,51,20-24,1861,0.002401407419328072
SIM,1878,92,na,1970,122
STAT,1858,40,50-100,1898,0.790389991259494
SIM,1833,80,na,1913,310
SIM,1847,90,na,1937,40
STAT,1845,68,na,1913,1081.3966574679084
STAT,1803,53,20-24,1856,0.0021073745176474696
STAT,1871,16,30-34,1887,1.5137370113023283
STAT,1878,34,30-34,1912,17.042282226751542
STAT,1914,20,35-39,1934,8.772870782286935
SIM,1762,105,na,1867,1
SIM,1896,30,25-29,1926,12
STAT,1898,62,na,1960,2446.0148801670775
STAT,1911,45,30-34,1956,0.0801050559778637
STAT,1866,22,35-39,1888,5.126094299287487
STAT,1817,49,na,1866,1307.565554469946
SIM,1860,82,na,1942,329
SIM,1927,35,40-44,1962,2
SIM,1874,22,35-39,1896,11
STAT,1862,18,30-34,1880,1.4657731099193312
STAT,1870,44,20-24,1914,0.14519509200616382
SIM,1877,38,na,1915,2274
STAT,1853,50,na,1903,1652.9257027135689
STAT,1865,50,25-29,1915,0.003076489976255388
SIM,1870,18,30-34,1888,4
STAT,1891,48,20-24,1939,0.007812071715623201
STAT,1854,19,35-39,1873,0.4641190919636498
STAT,1915,45,15-19,1960,3.5232106363417205E-4
STAT,1811,55,na,1866,1140.6140929101828
STAT,1937,26,45-49,1963,1.5916457986732662
STAT,1841,42,35-39,1883,1.2972403175502674
SIM,1822,33,na,1855,1577
SIM,1910,33,20-24,1943,1
STAT,1860,45,25-29,1905,0.0445911230178998
SIM,1859,39,30-34,1898,11
STAT,1872,21,30-34,1893,16.92947210017133
STAT,1916,4,na,1920,4032.19981329805
STAT,1866,30,na,1896,2095.956949205652
STAT,1822,98,na,1920,1.6507058669459005
STAT,1850,47,20-24,1897,0.008419644263467127
SIM,1883,45,na,1928,2074
STAT,1879,44,25-29,1923,0.6264404095031858
SIM,1846,50,na,1896,1558
STAT,1795,102,na,1897,0.06106106741416195
SIM,1859,26,na,1885,1985
STAT,1796,102,na,1898,0.0631408457770446
STAT,1830,27,50-100,1857,0.6411004971250966
STAT,1838,46,45-49,1884,0.16510682078527258
STAT,1897,31,50-100,1928,1.1622990453989077
SIM,1963,7,na,1970,4692
SIM,1944,25,30-34,1969,34
SIM,1798,71,na,1869,560
SIM,1954,14,na,1968,4484
STAT,1893,25,na,1918,2878.518057897103
STAT,1909,18,30-34,1927,2.2522468481000875
STAT,1856,30,na,1886,1817.793288511501
STAT,1837,33,30-34,1870,14.060534473578171
STAT,1851,41,15-19,1892,0.009978952711494021
STAT,1869,30,20-24,1899,2.493695687423808
SIM,1849,26,na,1875,1950
STAT,1855,43,40-44,1898,1.58684896698081
STAT,1793,90,na,1883,27.653289227755717
SIM,1945,26,45-49,1971,5
SIM,1807,66,na,1873,784
SIM,1859,25,20-24,1884,11
STAT,1886,77,na,1963,1103.4187718181588
SIM,1891,74,na,1965,1534
STAT,1878,58,na,1936,1946.9854587179195
STAT,1806,54,35-39,1860,0.02910791667130482
SIM,1900,39,35-39,1939,7
SIM,1848,25,45-49,1873,1
SIM,1898,30,40-44,1928,6
STAT,1833,36,15-19,1869,0.043525612503407016
SIM,1955,2,na,1957,4605
STAT,1783,73,na,1856,404.5582990161
STAT,1853,97,na,1950,4.065692162566797
STAT,1876,39,50-100,1915,1.18622264538834
STAT,1872,41,35-39,1913,1.7236499321801608
SIM,1880,41,35-39,1921,3
STAT,1835,29,25-29,1864,34.58699383914899
STAT,1937,33,35-39,1970,8.53578517626413
SIM,1841,13,na,1854,2016
SIM,1904,22,40-44,1926,1
SIM,1843,29,25-29,1872,47
SIM,1816,46,na,1862,1383
STAT,1766,94,na,1860,3.3116019503513696
SIM,1942,26,na,1968,3642
STAT,1890,23,25-29,1913,65.91242391173019
STAT,1855,39,50-100,1894,0.8636857719445311
STAT,1942,27,30-34,1969,38.85024321118622
SIM,1872,33,40-44,1905,3
SIM,1911,37,na,1948,3399
STAT,1805,50,35-39,1855,0.03289301782210108
STAT,1913,15,35-39,1928,0.8142831236018724
STAT,1874,48,50-100,1922,0.23408021422117628
SIM,1897,65,na,1962,2357
STAT,1917,47,25-29,1964,0.052342565554417346
SIM,1890,27,na,1917,2980
STAT,1811,48,30-34,1859,0.31715486897351536
SIM,1881,42,30-34,1923,1
STAT,1873,31,25-29,1904,9.853691953755103
SIM,1839,64,na,1903,1172
STAT,1877,18,25-29,1895,5.538474638986033
SIM,1949,17,30-34,1966,17
STAT,1946,24,50-100,1970,0.6912640821890915
STAT,1900,17,50-100,1917,0.06420407599748364
STAT,1857,17,45-49,1874,0.05720314328375438
STAT,1811,65,na,1876,857.3660988667986
SIM,1878,32,30-34,1910,21
SIM,1921,15,35-39,1936,5
STAT,1785,105,na,1890,0.021672505076055573
STAT,1829,50,20-24,1879,6.061745090431218E-4
STAT,1873,40,40-44,1913,2.176809102749328
SIM,1849,50,50-100,1899,1
SIM,1859,16,na,1875,2171
STAT,1945,25,40-44,1970,4.835006674250374
SIM,1844,28,30-34,1872,27
STAT,1862,30,na,1892,1942.9609241046624
SIM,1860,43,25-29,1903,3
STAT,1945,24,na,1969,3778.3925569145254
STAT,1941,28,25-29,1969,64.29232660061587
STAT,1883,44,15-19,1927,0.012618196339288216
STAT,1916,37,30-34,1953,1.7631932922485543
SIM,1918,28,40-44,1946,4
SIM,1903,24,30-34,1927,24
SIM,1877,45,na,1922,2201
STAT,1828,29,35-39,1857,11.81624083560842
SIM,1881,40,40-44,1921,3
STAT,1873,45,35-39,1918,0.13547330475780767
SIM,1828,41,30-34,1869,1
STAT,1860,45,na,1905,1741.7174933283898
STAT,1941,21,40-44,1962,3.2836366649680877
STAT,1896,41,20-24,1937,0.013822112837964338
SIM,1935,16,25-29,1951,60
SIM,1948,14,na,1962,4235
STAT,1802,52,25-29,1854,0.010370165699978092
SIM,1765,91,na,1856,11
SIM,1827,79,na,1906,378
STAT,1883,49,25-29,1932,0.05223598452165309
STAT,1887,32,30-34,1919,18.449409240073447
STAT,1843,40,50-100,1883,0.7537771454108056
SIM,1836,29,35-39,1865,9
SIM,1848,18,20-24,1866,18
STAT,1924,25,na,1949,4148.400725399605
SIM,1889,30,na,1919,2897
SIM,1886,34,30-34,1920,27
STAT,1817,43,na,1860,1393.3624249118811
STAT,1887,46,40-44,1933,0.18141797288404174
STAT,1888,30,25-29,1918,11.527256193884401
SIM,1873,9,na,1882,2561
SIM,1890,21,25-29,1911,67
STAT,1842,16,na,1858,2147.2831113199422
SIM,1848,78,na,1926,550
STAT,1929,31,35-39,1960,10.9717542321228
SIM,1895,32,30-34,1927,31
STAT,1962,5,na,1967,4757.917640646041
STAT,1936,28,35-39,1964,13.566705803786366
STAT,1902,31,30-34,1933,23.372972103046006
STAT,1916,32,50-100,1948,0.8063950203225687
SIM,1849,30,45-49,1879,1
SIM,1937,31,35-39,1968,12
STAT,1902,48,50-100,1950,0.1823835375648937
STAT,1927,16,25-29,1943,51.02617228708541
SIM,1886,20,20-24,1906,62
STAT,1879,47,45-49,1926,0.23228607212752456
STAT,1844,45,na,1889,1587.2093024345
SIM,1836,50,na,1886,1405
STAT,1936,10,na,1946,3594.408218903516
SIM,1923,12,na,1935,4452
SIM,1899,15,15-19,1914,5
STAT,1827,49,na,1876,1422.3760974581512
SIM,1847,93,na,1940,13
STAT,1857,18,50-100,1875,0.04264966257735979
SIM,1948,18,25-29,1966,48
SIM,1815,51,na,1866,1325
SIM,1840,30,25-29,1870,14
STAT,1857,108,na,1965,0.009728042036981565
SIM,1924,37,30-34,1961,2
SIM,1819,43,30-34,1862,3
STAT,1874,37,15-19,1911,0.05420169714267594
STAT,1902,36,25-29,1938,0.8325236859693399
STAT,1855,40,20-24,1895,0.11399554291840436
STAT,1872,30,na,1902,2279.3900404706797
SIM,1830,68,na,1898,888
STAT,1855,2,na,1857,2531.291825363487
STAT,1863,48,45-49,1911,0.19318975606346023
SIM,1840,44,35-39,1884,2
STAT,1836,28,30-34,1864,20.949302913993577
STAT,1873,70,na,1943,1344.3056997533408
STAT,1842,43,15-19,1885,0.010215231154786873
STAT,1849,41,50-100,1890,0.7957839816002974
SIM,1860,72,na,1932,1009
STAT,1771,88,na,1859,30.898522194203984
STAT,1919,35,40-44,1954,1.5277563344327696
STAT,1922,22,35-39,1944,10.200714391306068
STAT,1898,18,45-49,1916,0.08329077602210642
STAT,1831,40,35-39,1871,1.37338357315664
STAT,1886,25,50-100,1911,0.6426864956984599
STAT,1939,5,na,1944,3793.8793465561366
SIM,1889,19,20-24,1908,24
SIM,1828,31,na,1859,1694
SIM,1839,20,25-29,1859,45
STAT,1861,19,25-29,1880,5.055983502189088
STAT,1922,15,45-49,1937,0.5486892040120657
STAT,1890,26,45-49,1916,1.2867628814376786
SIM,1922,43,40-44,1965,3
STAT,1915,52,na,1967,3438.4223038202213
STAT,1832,30,25-29,1862,8.264694949334306
SIM,1852,53,na,1905,1618
SIM,1879,16,25-29,1895,4
STAT,1853,54,30-34,1907,0.00438098555713989
STAT,1925,46,20-24,1971,0.012681795028653828
SIM,1831,35,45-49,1866,1
SIM,1892,12,na,1904,3394
SIM,1872,33,25-29,1905,18
STAT,1832,44,35-39,1876,1.3048763703111816
STAT,1866,15,45-49,1881,0.05911488846520605
STAT,1867,18,na,1885,2276.8806392806764
SIM,1839,27,45-49,1866,1
SIM,1854,31,30-34,1885,22
STAT,1900,12,na,1912,3384.389749442824
SIM,1895,30,na,1925,3032
STAT,1912,34,50-100,1946,0.7620113545262807
STAT,1850,45,na,1895,1601.7767672232835
STAT,1900,38,30-34,1938,1.5000516986973689
STAT,1936,35,40-44,1971,1.390712597744206
SIM,1809,51,na,1860,1215
STAT,1823,35,45-49,1858,3.5960943732300104
STAT,1840,90,na,1930,51.73972579724597
SIM,1908,18,20-24,1926,25
STAT,1914,43,40-44,1957,0.2337733174142282
STAT,1842,48,25-29,1890,0.04118877552284156
STAT,1896,22,30-34,1918,22.22412632321375
STAT,1897,22,na,1919,2987.96073904138
STAT,1829,31,30-34,1860,17.91128792926299
SIM,1923,31,40-44,1954,6
STAT,1885,37,na,1922,2218.490753242167
STAT,1850,32,35-39,1882,7.467906205446216
SIM,1845,22,25-29,1867,49
STAT,1840,32,25-29,1872,8.187090505400686
SIM,1878,3,na,1881,2926
STAT,1765,112,na,1877,5.26719028106032E-4
STAT,1842,41,40-44,1883,1.7069889753392635
STAT,1879,40,25-29,1919,0.6414193767199337
STAT,1886,81,na,1967,864.079114374144
STAT,1832,41,30-34,1873,0.8613131788908004
STAT,1932,34,45-49,1966,1.9735843688669907
SIM,1880,35,40-44,1915,4
STAT,1928,18,na,1946,4369.770316855413
SIM,1896,32,50-100,1928,1
STAT,1890,20,20-24,1910,80.06646347083729
STAT,1857,41,50-100,1898,0.7906826278314655
STAT,1921,47,15-19,1968,3.923017317542029E-4
STAT,1878,20,20-24,1898,68.2505763420406
SIM,1865,26,na,1891,2116
SIM,1876,41,45-49,1917,1
STAT,1860,31,15-19,1891,0.10960294385717577
SIM,1836,22,15-19,1858,2
SIM,1867,45,na,1912,2186
SIM,1849,64,na,1913,1286
STAT,1842,20,50-100,1862,0.3778856622199508
SIM,1837,31,30-34,1868,31
STAT,1815,48,15-19,1863,8.870214936651837E-4
STAT,1888,40,35-39,1928,2.0420792932767386
SIM,1813,44,40-44,1857,7
STAT,1825,48,25-29,1873,0.057949182838177585
STAT,1849,22,35-39,1871,5.2905217417529755
STAT,1937,30,30-34,1967,14.742029749926452
SIM,1910,42,na,1952,3318
STAT,1917,44,20-24,1961,0.01735308935271391
STAT,1832,102,na,1934,0.176609027779779
SIM,1827,31,20-24,1858,1
SIM,1822,39,na,1861,1501
SIM,1909,26,25-29,1935,68
STAT,1834,21,45-49,1855,0.5829583393170356
STAT,1945,21,25-29,1966,95.66813180786589
SIM,1918,38,35-39,1956,3
STAT,1931,11,na,1942,4906.620843593278
STAT,1882,39,15-19,1921,0.05107082764076293
STAT,1846,35,50-100,1881,0.9708998125651855
STAT,1892,39,25-29,1931,3.3725229246148705
SIM,1866,40,50-100,1906,1
STAT,1901,49,50-100,1950,0.17937073497176165
STAT,1900,30,35-39,1930,13.378243993922665
SIM,1854,35,50-100,1889,1
STAT,1852,40,20-24,1892,0.11629904237073446
SIM,1879,30,na,1909,2416
STAT,1902,43,15-19,1945,0.0012693102158074655
STAT,1911,43,40-44,1954,0.22418143220304948
STAT,1901,43,30-34,1944,0.10480697366409215
SIM,1856,27,45-49,1883,4
STAT,1852,49,30-34,1901,0.06871339281816652
SIM,1930,22,35-39,1952,22
STAT,1852,16,na,1868,2024.668738006199
SIM,1854,34,35-39,1888,7
STAT,1841,53,40-44,1894,0.007141353934407493
STAT,1867,20,45-49,1887,0.6301433205097763
SIM,1842,53,na,1895,1410
STAT,1862,64,na,1926,1404.104309631803
SIM,1892,59,na,1951,2577
STAT,1854,33,30-34,1887,12.660583571400405
SIM,1933,15,na,1948,4730
STAT,1864,33,40-44,1897,3.6359840433155997
SIM,1859,19,na,1878,2130
SIM,1862,33,30-34,1895,23
STAT,1872,35,40-44,1907,4.187416375767834
STAT,1936,18,40-44,1954,1.2617126853890201
STAT,1846,34,35-39,1880,8.694023246836894
SIM,1837,79,na,1916,400
STAT,1882,21,25-29,1903,52.75120402189863
STAT,1837,22,25-29,1859,48.63591779982575
STAT,1914,41,50-100,1955,0.11013224886476704
STAT,1924,35,15-19,1959,0.021428380097494388
SIM,1850,41,40-44,1891,5
STAT,1848,27,45-49,1875,0.9849175396803812
SIM,1840,41,30-34,1881,1
SIM,1881,71,na,1952,991
STAT,1814,42,25-29,1856,2.2754376764975768
SIM,1853,21,20-24,1874,55
SIM,1939,24,45-49,1963,1
STAT,1824,42,35-39,1866,2.3801867339822262
STAT,1843,97,na,1940,3.628663315913184
STAT,1871,82,na,1953,437.68805347706086
SIM,1897,58,na,1955,2580
STAT,1915,49,30-34,1964,0.08436494578623152
STAT,1820,54,35-39,1874,0.013334902191057115
SIM,1898,33,45-49,1931,2
SIM,1838,27,na,1865,1801
SIM,1908,48,na,1956,3084
STAT,1810,54,25-29,1864,0.010854214409009083
STAT,1878,46,50-100,1924,0.24248476912216915
SIM,1862,16,30-34,1878,2
SIM,1885,29,30-34,1914,22
STAT,1901,22,15-19,1923,4.362437501695918
SIM,1852,16,20-24,1868,16
SIM,1863,41,35-39,1904,3
STAT,1776,94,na,1870,3.8233746347301025
STAT,1835,31,na,1866,1774.4159191210688
STAT,1806,51,30-34,1857,0.021381060620482905
STAT,1854,16,30-34,1870,1.3722607906697386
STAT,1913,19,na,1932,3710.653806512618
STAT,1816,51,40-44,1867,0.02428834960296436
STAT,1874,96,na,1970,44.11641095347512
SIM,1904,25,45-49,1929,2
STAT,1844,16,20-24,1860,15.744523630903718
STAT,1906,44,45-49,1950,0.14106716262843902
SIM,1818,65,na,1883,842
SIM,1880,27,na,1907,2413
STAT,1823,108,na,1931,9.803039382271644E-4
STAT,1864,36,45-49,1900,1.6865380725977137
STAT,1845,31,na,1876,1842.5025470103108
STAT,1868,41,45-49,1909,1.3550886596749607
SIM,1894,44,na,1938,2895
STAT,1877,29,30-34,1906,24.50024772861904
STAT,1878,23,25-29,1901,56.18533309785814
SIM,1846,43,40-44,1889,7
SIM,1787,72,na,1859,459
STAT,1844,54,20-24,1898,4.984090115630578E-4
SIM,1836,43,30-34,1879,1
STAT,1832,98,na,1930,1.9569258020087104
SIM,1872,36,45-49,1908,1
STAT,1872,24,35-39,1896,5.494952138794986
STAT,1857,15,na,1872,2034.0169091656655
STAT,1955,17,na,1972,4615.493736398357
STAT,1966,3,na,1969,4640.542881066497
SIM,1840,34,50-100,1874,4
STAT,1833,47,20-24,1880,0.008624465510610618
SIM,1803,66,na,1869,756
STAT,1921,0,na,1921,4851.239281283686
SIM,1857,22,35-39,1879,6
SIM,1877,11,na,1888,2539
SIM,1886,23,25-29,1909,59
STAT,1838,43,40-44,1881,1.5866132912111774
STAT,1915,31,40-44,1946,3.7806091718192674
STAT,1828,43,30-34,1871,0.9586015686005078
STAT,1852,45,15-19,1897,2.92885377719081E-4
SIM,1879,77,na,1956,827
STAT,1883,42,40-44,1925,2.0807444555907413
SIM,1908,16,30-34,1924,2
STAT,1879,41,20-24,1920,0.15775654596128236
STAT,1873,42,30-34,1915,1.1001576270407725
STAT,1911,48,35-39,1959,0.1149911310816506
STAT,1884,48,na,1932,2073.4386539719353
SIM,1932,26,na,1958,4580
SIM,1859,28,25-29,1887,52
STAT,1826,50,20-24,1876,6.837975645186421E-4
STAT,1901,48,25-29,1949,0.04242461863371271
STAT,1832,34,50-100,1866,0.7073926475585967
SIM,1907,59,na,1966,2928
STAT,1856,49,15-19,1905,2.886750276873666E-4
STAT,1805,65,na,1870,856.9233942689403
STAT,1903,19,40-44,1922,0.2445311167668332
STAT,1843,105,na,1948,0.019804550451043113
SIM,1818,38,30-34,1856,7
STAT,1831,34,40-44,1865,3.3727619676352885
STAT,1866,49,25-29,1915,0.04914021814391549
STAT,1928,36,45-49,1964,0.8146223021747928
STAT,1901,26,30-34,1927,33.413353289100804
SIM,1945,23,40-44,1968,3
STAT,1846,51,35-39,1897,0.0064159235544548965
STAT,1937,23,40-44,1960,3.0921824140304883
SIM,1962,5,na,1967,4634
SIM,1824,72,na,1896,624
STAT,1830,32,na,1862,1692.2367765597176
STAT,1841,31,na,1872,1831.7473513840434
STAT,1822,47,45-49,1869,0.31737065381915636
SIM,1904,32,35-39,1936,10
STAT,1895,34,30-34,1929,21.31926200482265
STAT,1967,5,na,1972,4638.806890971686
STAT,1847,41,25-29,1888,0.48231206807447924
STAT,1874,17,45-49,1891,0.06305081043503072
SIM,1891,42,40-44,1933,5
STAT,1879,44,40-44,1923,2.194225406693287
STAT,1837,97,na,1934,3.486498890712384
STAT,1921,27,45-49,1948,1.8189363704672137
STAT,1910,35,20-24,1945,0.24044094725831716
SIM,1828,44,35-39,1872,1
STAT,1858,96,na,1954,6.3599781533714275
STAT,1900,20,40-44,1920,2.7471345466627315
STAT,1853,50,50-100,1903,0.011593951984057166
SIM,1898,23,35-39,1921,6
SIM,1868,32,20-24,1900,2
STAT,1893,41,20-24,1934,0.19112329664432237
STAT,1835,68,na,1903,972.6610324944306
STAT,1834,83,na,1917,246.11999448770317
STAT,1812,45,50-100,1857,0.8500529200084364
STAT,1887,35,35-39,1922,7.5448250767320335
STAT,1803,91,na,1894,19.478741078030957
STAT,1846,41,25-29,1887,0.4882720300044973
SIM,1895,35,35-39,1930,17
STAT,1859,27,20-24,1886,8.973022181662436
SIM,1909,16,30-34,1925,2
SIM,1894,0,na,1894,3436
STAT,1875,37,na,1912,2287.688399129193
STAT,1877,15,20-24,1892,17.453518800174198
STAT,1954,16,35-39,1970,4.90151015642944
STAT,1918,22,na,1940,3720.7745659875263
STAT,1906,37,20-24,1943,0.22892419653864898
STAT,1899,0,na,1899,3800.801852476431
STAT,1876,81,na,1957,596.7403711080897
STAT,1893,46,15-19,1939,2.7108219374346573E-4
SIM,1824,65,na,1889,868
STAT,1936,25,30-34,1961,35.454408325253
STAT,1858,16,15-19,1874,5.165080953162964
STAT,1823,50,na,1873,1342.5516135729802
STAT,1841,38,15-19,1879,0.04514108594072199
STAT,1849,82,na,1931,349.8752351168841
SIM,1836,26,30-34,1862,29
STAT,1764,112,na,1876,4.881246399104467E-4
STAT,1776,87,na,1863,51.35724107652418
STAT,1909,17,50-100,1926,0.06941074108617121
STAT,1917,19,35-39,1936,4.229050191197412
SIM,1826,29,25-29,1855,33
STAT,1855,43,25-29,1898,0.453037465368351
SIM,1832,42,35-39,1874,1
STAT,1876,15,50-100,1891,0.04803847026737948
SIM,1842,94,na,1936,8
SIM,1858,18,30-34,1876,1
SIM,1939,5,na,1944,3747
STAT,1829,53,25-29,1882,0.0024949046632311155
SIM,1944,18,40-44,1962,1
STAT,1845,21,20-24,1866,60.97574636337456
STAT,1895,17,30-34,1912,1.9630075344058417
STAT,1940,18,na,1958,3529.389196895705
STAT,1889,48,15-19,1937,2.5983929045871555E-4
STAT,1867,15,na,1882,2317.5917527456704
STAT,1823,52,45-49,1875,0.017200815839037046
SIM,1932,25,20-24,1957,23
STAT,1839,50,30-34,1889,0.004061811495799327
STAT,1924,25,20-24,1949,20.21397832914881
STAT,1904,24,40-44,1928,2.8060017830863435
SIM,1861,30,45-49,1891,1
SIM,1912,24,40-44,1936,3
STAT,1891,33,35-39,1924,11.786375445759937
STAT,1828,83,na,1911,223.5752309991609
SIM,1820,45,50-100,1865,3
STAT,1890,43,45-49,1933,1.7160814546409444
STAT,1834,41,15-19,1875,0.010465148144526246
STAT,1843,53,25-29,1896,0.002354027707239536
STAT,1902,33,20-24,1935,3.588594843637478
STAT,1828,26,30-34,1854,60.77452324996405
SIM,1925,19,35-39,1944,7
STAT,1878,30,15-19,1908,0.1413302624695584
STAT,1919,31,25-29,1950,9.458733590083693
SIM,1838,44,50-100,1882,1
STAT,1906,37,na,1943,3267.176546754859
STAT,1892,77,na,1969,1423.0810624828687
STAT,1869,47,35-39,1916,0.12752919070437185
STAT,1874,31,50-100,1905,0.8879957924791172
SIM,1873,45,na,1918,2169
SIM,1903,27,35-39,1930,13
STAT,1833,54,45-49,1887,0.008820286239170397
SIM,1927,31,25-29,1958,14
STAT,1867,51,20-24,1918,6.577240680634551E-4
STAT,1921,17,35-39,1938,4.518506831241771
SIM,1811,92,na,1903,18
STAT,1823,32,40-44,1855,11.36749110319496
STAT,1905,19,50-100,1924,0.0665393747535578
STAT,1896,44,25-29,1940,0.054886660795290865
STAT,1891,40,25-29,1931,0.75811432256119
SIM,1938,14,na,1952,3515
SIM,1866,16,15-19,1882,4
STAT,1872,17,50-100,1889,0.04657629460589254
STAT,1860,42,20-24,1902,0.12158185381430968
STAT,1930,32,50-100,1962,1.007976002070986
STAT,1928,26,35-39,1954,17.533112364663268
STAT,1950,15,20-24,1965,151.5236685298212
STAT,1864,53,45-49,1917,0.012022853275657277
STAT,1890,23,40-44,1913,2.399291187259891
STAT,1875,42,15-19,1917,0.013393037820758163
SIM,1839,24,40-44,1863,2
STAT,1836,24,15-19,1860,2.7791179978173526
STAT,1848,47,15-19,1895,2.958372911333317E-4
STAT,1841,40,45-49,1881,1.0999986856180324
STAT,1857,52,40-44,1909,0.007801984719695693
STAT,1871,19,35-39,1890,0.5119684625066935
SIM,1857,93,na,1950,20
SIM,1832,91,na,1923,36
SIM,1849,20,35-39,1869,4
STAT,1839,43,50-100,1882,0.7318984824976617
SIM,1867,27,20-24,1894,13
STAT,1860,47,15-19,1907,3.051742103280519E-4
SIM,1899,19,30-34,1918,4
SIM,1873,43,35-39,1916,2
SIM,1872,30,20-24,1902,1
STAT,1910,12,na,1922,3696.933034666792
STAT,1880,26,35-39,1906,9.642682186809957
STAT,1934,30,50-100,1964,1.067624840656897
SIM,1885,30,na,1915,2314
SIM,1857,32,45-49,1889,1
SIM,1919,33,40-44,1952,7
STAT,1817,50,na,1867,1292.8573853416208
STAT,1883,47,50-100,1930,0.2264174885907379
STAT,1816,43,50-100,1859,2.723507768816854
SIM,1855,64,na,1919,1351
STAT,1856,108,na,1964,0.008165124614823948
SIM,1891,47,50-100,1938,3
STAT,1851,35,20-24,1886,0.5722034859034796
STAT,1874,48,20-24,1922,0.011437144470147776
STAT,1887,22,na,1909,2499.109728488748
SIM,1872,60,na,1932,1767
SIM,1949,19,20-24,1968,134
STAT,1890,22,50-100,1912,0.470983982741
SIM,1821,35,35-39,1856,13
SIM,1824,43,50-100,1867,3
STAT,1916,33,15-19,1949,0.12480521976353597
SIM,1887,44,40-44,1931,5
SIM,1894,22,20-24,1916,88
SIM,1835,40,45-49,1875,2
STAT,1865,43,35-39,1908,1.539337853186231
SIM,1936,26,35-39,1962,12
STAT,1888,32,50-100,1920,1.022940712933982
STAT,1894,31,45-49,1925,2.125738153048573
STAT,1855,82,na,1937,331.56592263640334
STAT,1870,33,50-100,1903,0.8455575319520995
SIM,1844,17,25-29,1861,6
STAT,1910,38,40-44,1948,1.3458636663885097
SIM,1903,60,na,1963,2715
STAT,1849,32,45-49,1881,1.3779225230517296
STAT,1827,40,45-49,1867,1.48602792041463
STAT,1898,15,40-44,1913,0.23491324961034887
STAT,1905,52,na,1957,2958.9560770127255
STAT,1841,33,50-100,1874,0.7584880344424325
STAT,1886,22,20-24,1908,68.76849368304593
STAT,1818,38,50-100,1856,3.5308354810168208
STAT,1842,66,na,1908,1186.942120405302
STAT,1845,37,30-34,1882,3.96253652643344
STAT,1887,78,na,1965,1128.0272689774963
STAT,1847,45,40-44,1892,0.12750271936810667
STAT,1829,44,50-100,1873,0.8735104420820177
SIM,1933,34,50-100,1967,1
STAT,1846,56,na,1902,1512.80431470246
SIM,1864,27,35-39,1891,11
STAT,1920,46,50-100,1966,0.23677891947505222
STAT,1884,39,35-39,1923,6.534864940946378
SIM,1945,18,na,1963,3634
STAT,1947,21,45-49,1968,1.2017581171124854
SIM,1901,23,15-19,1924,4
STAT,1913,15,50-100,1928,0.07270383685130312
SIM,1842,34,20-24,1876,1
STAT,1850,50,40-44,1900,0.007527831880686964
SIM,1901,3,na,1904,3464
STAT,1924,21,50-100,1945,0.7356820303274714
STAT,1886,36,35-39,1922,7.0921130448759575
SIM,1889,43,45-49,1932,2
SIM,1848,19,20-24,1867,18
SIM,1825,37,25-29,1862,2
STAT,1840,31,40-44,1871,3.502594180930981
SIM,1903,31,25-29,1934,20
STAT,1819,45,35-39,1864,0.2734678770674225
STAT,1863,17,25-29,1880,5.360649789942871
SIM,1844,42,30-34,1886,3
STAT,1895,73,na,1968,1806.8414560239721
STAT,1936,28,50-100,1964,0.8994282103770291
STAT,1836,31,20-24,1867,2.2356553323915356
SIM,1862,39,na,1901,1986
SIM,1871,17,25-29,1888,9
SIM,1875,25,45-49,1900,1
STAT,1892,47,15-19,1939,2.6573578535320105E-4
STAT,1852,32,50-100,1884,0.6877675410031397
STAT,1920,47,45-49,1967,0.22695945896444508
STAT,1854,51,na,1905,1547.9302266955372
STAT,1899,63,na,1962,2463.7256023007103
STAT,1817,48,35-39,1865,0.3106991598191303
SIM,1919,23,30-34,1942,39
STAT,1823,34,45-49,1857,3.4736830158661363
SIM,1875,81,na,1956,495
SIM,1892,22,40-44,1914,3
STAT,1856,27,35-39,1883,7.36967164761264
STAT,1836,42,30-34,1878,0.8856682379189721
SIM,1917,15,20-24,1932,24
STAT,1883,88,na,1971,354.95501632551606
SIM,1855,32,35-39,1887,9
SIM,1892,28,25-29,1920,58
STAT,1834,45,30-34,1879,0.07182783715065236
STAT,1841,26,50-100,1867,0.5517189635894727
SIM,1890,25,40-44,1915,8
STAT,1844,104,na,1948,0.04632475834586055
SIM,1808,51,na,1859,1237
SIM,1922,28,50-100,1950,1
STAT,1825,31,45-49,1856,3.394667804769002
STAT,1911,37,na,1948,3432.9504996817045
STAT,1817,37,25-29,1854,10.28160601225871
STAT,1852,27,20-24,1879,9.906287946341303
STAT,1939,29,20-24,1968,17.31876504041454
STAT,1877,49,45-49,1926,0.2264359495896678
SIM,1892,39,35-39,1931,18
STAT,1884,28,25-29,1912,39.341820027834515
SIM,1873,28,45-49,1901,1
STAT,1892,43,50-100,1935,1.2410169658722665
STAT,1894,44,15-19,1938,0.001148537449630034
STAT,1824,53,na,1877,1298.324905203053
STAT,1834,34,20-24,1868,2.1046046662351463
SIM,1901,34,25-29,1935,11
SIM,1853,78,na,1931,562
STAT,1858,35,45-49,1893,1.4905615377400172
STAT,1847,32,35-39,1879,8.768115610106586
STAT,1812,68,na,1880,780.5684332065553
STAT,1894,46,40-44,1940,0.11757491234766562
SIM,1908,20,20-24,1928,98
SIM,1831,34,45-49,1865,2
STAT,1884,22,40-44,1906,1.944861957045731
STAT,1831,42,25-29,1873,0.4741492917516248
SIM,1886,25,20-24,1911,15
STAT,1919,23,35-39,1942,9.710244156310125
SIM,1906,19,na,1925,3436
SIM,1848,42,45-49,1890,1
STAT,1763,93,na,1856,3.3728791715999997
STAT,1893,15,15-19,1908,7.142788918372067
SIM,1898,50,na,1948,2741
STAT,1833,50,35-39,1883,0.0056637389510298805
STAT,1862,21,20-24,1883,57.39254379457065
STAT,1899,36,45-49,1935,2.5927940302053694
STAT,1819,47,30-34,1866,0.18342986490466257
STAT,1851,46,15-19,1897,2.8855388027398797E-4
SIM,1851,27,25-29,1878,40
SIM,1853,35,35-39,1888,12
STAT,1927,42,25-29,1969,0.08460314391520415
STAT,1829,52,40-44,1881,0.007563863845990524
SIM,1838,37,35-39,1875,17
STAT,1825,94,na,1919,10.622313992437629
STAT,1843,27,25-29,1870,35.16338507887064
STAT,1832,37,20-24,1869,0.589153777380017
SIM,1834,24,15-19,1858,2
SIM,1865,63,na,1928,1562
SIM,1857,42,40-44,1899,6
STAT,1896,43,40-44,1939,0.1934736102473571
STAT,1936,20,30-34,1956,25.975524117045534
SIM,1910,24,na,1934,3369
SIM,1894,60,na,1954,2376
STAT,1874,12,na,1886,2523.37517851993
STAT,1881,37,50-100,1918,1.1204460268590866
SIM,1914,38,na,1952,3534
SIM,1851,38,35-39,1889,14
SIM,1870,21,20-24,1891,63
SIM,1907,44,na,1951,3189
STAT,1873,30,na,1903,2304.7372305022227
STAT,1949,20,40-44,1969,3.7091505520681016
SIM,1825,31,40-44,1856,2
STAT,1769,90,na,1859,21.871987620616302
STAT,1890,25,45-49,1915,1.2910621182915896
STAT,1923,22,na,1945,4013.9805692935533
STAT,1770,87,na,1857,39.224764146417996
SIM,1861,73,na,1934,995
STAT,1841,25,na,1866,1879.2606990988716
STAT,1923,37,15-19,1960,0.02101982480057266
STAT,1816,58,na,1874,1141.350575771424
STAT,1927,31,15-19,1958,0.14941723955554456
STAT,1897,20,25-29,1917,72.75461790075292
STAT,1860,24,20-24,1884,53.6729078121748
STAT,1897,39,45-49,1936,0.5381327341073076
STAT,1821,39,40-44,1860,8.258377108191585
SIM,1853,37,30-34,1890,7
STAT,1878,25,20-24,1903,11.628213477084689
STAT,1843,38,35-39,1881,5.022797466585091
SIM,1836,21,15-19,1857,2
SIM,1880,9,na,1889,2658
STAT,1849,42,40-44,1891,1.6845834268043958
STAT,1879,46,45-49,1925,0.23403666639213785
STAT,1760,100,na,1860,0.15790507088003947
STAT,1817,99,na,1916,0.8765610852919459
STAT,1855,40,15-19,1895,0.009912656441339363
STAT,1865,32,50-100,1897,0.7845500794546898
SIM,1869,27,40-44,1896,1
SIM,1903,20,15-19,1923,5
STAT,1853,43,15-19,1896,0.010375728260566146
STAT,1831,53,35-39,1884,0.005289265905780734
STAT,1851,21,45-49,1872,0.6033562917588529
SIM,1902,29,na,1931,3116
STAT,1850,61,na,1911,1317.244911453641
SIM,1818,49,50-100,1867,1
STAT,1863,28,50-100,1891,0.5284493394083053
STAT,1885,9,na,1894,2443.2195714050163
SIM,1815,44,50-100,1859,1
SIM,1855,34,30-34,1889,20
STAT,1939,16,15-19,1955,42.927485099227226
STAT,1948,14,na,1962,4245.364619980255
STAT,1772,111,na,1883,0.001075051854652113
STAT,1897,28,35-39,1925,12.147376381897525
STAT,1845,35,35-39,1880,5.900069181212792
STAT,1821,37,45-49,1858,4.211033578247786
SIM,1857,68,na,1925,1150
STAT,1847,34,30-34,1881,13.473549902887287
STAT,1925,34,15-19,1959,0.14396923397704509
SIM,1947,16,15-19,1963,45
STAT,1820,63,na,1883,959.5911780148257
SIM,1852,37,na,1889,1813
STAT,1898,40,40-44,1938,0.20169675481767058
STAT,1915,27,na,1942,3609.7412564201936
STAT,1862,32,30-34,1894,14.102537348399178
STAT,1902,60,na,1962,2687.52568120758
STAT,1919,36,40-44,1955,1.5206675450410017
SIM,1869,16,30-34,1885,2
STAT,1880,51,35-39,1931,0.008615085801179244
SIM,1841,37,50-100,1878,4
SIM,1870,38,45-49,1908,1
SIM,1920,34,35-39,1954,17
STAT,1917,28,30-34,1945,38.68265006406121
STAT,1838,45,45-49,1883,0.16723573164916644
STAT,1855,54,35-39,1909,0.005949590922805905
STAT,1873,22,35-39,1895,5.59105789942337
SIM,1819,35,na,1854,1553
STAT,1851,49,25-29,1900,0.040569040584712064
SIM,1925,39,40-44,1964,1
STAT,1805,52,25-29,1857,0.013001519598880133
SIM,1860,32,na,1892,1980
STAT,1861,51,25-29,1912,0.002795517380618096
STAT,1936,29,na,1965,3383.408395490574
SIM,1877,22,15-19,1899,3
SIM,1872,32,40-44,1904,4
SIM,1822,41,40-44,1863,6
STAT,1870,43,20-24,1913,0.14611856131366618
STAT,1879,27,na,1906,2359.9688611684023
SIM,1823,40,na,1863,1444
STAT,1860,21,40-44,1881,1.6584541951983378
STAT,1888,49,20-24,1937,0.007399448180550241
STAT,1933,23,50-100,1956,0.8242540817826983
SIM,1843,19,15-19,1862,4
STAT,1843,30,50-100,1873,0.7596193040708592
SIM,1922,31,35-39,1953,13
SIM,1887,40,30-34,1927,1
STAT,1899,39,25-29,1938,0.7963098068186869
SIM,1879,38,35-39,1917,16
STAT,1917,39,40-44,1956,1.459972702639174
SIM,1832,27,45-49,1859,4
SIM,1877,38,30-34,1915,3
STAT,1872,54,35-39,1926,0.007933415982205894
SIM,1891,12,na,1903,3059
SIM,1786,90,na,1876,33
STAT,1862,38,45-49,1900,1.602189686652882
STAT,1839,38,15-19,1877,0.04421712877790039
STAT,1841,27,45-49,1868,0.950733521444402
SIM,1799,81,na,1880,195
SIM,1927,23,35-39,1950,17
SIM,1890,70,na,1960,1931
STAT,1895,25,20-24,1920,14.54646311260107
SIM,1895,26,na,1921,3022
STAT,1938,27,50-100,1965,0.9315763626569433
SIM,1886,65,na,1951,1574
STAT,1869,38,30-34,1907,4.853380594579088
SIM,1802,94,na,1896,10
STAT,1878,16,30-34,1894,1.5730512774414154
STAT,1831,23,na,1854,1512.7318041153753
STAT,1860,38,35-39,1898,5.39457228451337
STAT,1879,40,30-34,1919,1.1483475891065846
SIM,1822,42,25-29,1864,3
STAT,1820,52,20-24,1872,0.0011894666067872534
STAT,1886,38,30-34,1924,5.292061577829938
STAT,1912,47,40-44,1959,0.1431460809408083
STAT,1890,20,15-19,1910,3.8329941627268176
STAT,1904,67,na,1971,2495.129761996081
STAT,1947,23,40-44,1970,3.5888487632291253
SIM,1934,18,30-34,1952,19
SIM,1811,55,na,1866,1075
STAT,1828,34,20-24,1862,2.611288864979645
STAT,1891,18,45-49,1909,0.0761476870905426
STAT,1841,16,35-39,1857,0.49078110431293187
STAT,1840,99,na,1939,1.2428647371778176
STAT,1881,33,25-29,1914,9.308020978687114
SIM,1856,27,na,1883,1938
SIM,1888,20,25-29,1908,79
STAT,1883,36,50-100,1919,1.1426249330781644
SIM,1865,101,na,1966,2
STAT,1892,22,45-49,1914,0.8251059692359104
STAT,1810,45,15-19,1855,0.0013795566078642785
STAT,1832,64,na,1896,1047.1895648723316
SIM,1894,38,30-34,1932,7
STAT,1860,27,25-29,1887,32.77186607330008
STAT,1903,41,30-34,1944,0.10779638206371313
SIM,1880,43,25-29,1923,2
STAT,1837,24,20-24,1861,57.71037781976828
STAT,1896,41,15-19,1937,0.001201922920392057
STAT,1928,29,45-49,1957,2.0086469082883553
STAT,1829,84,na,1913,201.00692925074256
STAT,1854,24,20-24,1878,57.10372314607842
STAT,1882,28,45-49,1910,1.0164619516081086
SIM,1934,29,40-44,1963,5
STAT,1879,41,15-19,1920,0.013717961259291341
STAT,1875,46,30-34,1921,0.09426108743921059
STAT,1943,18,30-34,1961,12.206552087203782
SIM,1902,13,na,1915,3453
SIM,1879,30,25-29,1909,13
SIM,1915,18,20-24,1933,26
SIM,1951,18,30-34,1969,15
STAT,1880,19,50-100,1899,0.0485310545862029
SIM,1903,54,na,1957,2851
SIM,1898,30,35-39,1928,15
SIM,1874,32,45-49,1906,2
STAT,1820,79,na,1899,368.2940175630153
SIM,1831,31,40-44,1862,3
SIM,1896,30,30-34,1926,22
STAT,1875,35,20-24,1910,0.7556142280860052
STAT,1835,19,15-19,1854,9.907690796591892
STAT,1924,18,20-24,1942,152.11562421555598
STAT,1834,31,40-44,1865,3.4834121338284527
STAT,1830,24,35-39,1854,12.914681170359135
SIM,1833,31,45-49,1864,1
STAT,1870,41,25-29,1911,0.5978190834613983
STAT,1891,18,15-19,1909,6.918018772077443
SIM,1932,18,20-24,1950,165
STAT,1850,17,15-19,1867,5.112052520920529
SIM,1894,36,35-39,1930,23
STAT,1844,73,na,1917,824.9223545137866
SIM,1847,9,na,1856,2267
STAT,1873,24,30-34,1897,16.95936881244033
STAT,1913,15,40-44,1928,0.2714277235826324
STAT,1927,31,50-100,1958,0.9613448318395896
SIM,1845,24,20-24,1869,67
SIM,1823,37,45-49,1860,2
SIM,1864,7,na,1871,2441
STAT,1861,53,20-24,1914,5.703196702237295E-4
SIM,1883,35,20-24,1918,3
STAT,1872,43,25-29,1915,0.6040977799859024
STAT,1820,50,25-29,1870,0.005941590315832538
SIM,1888,40,50-100,1928,1
STAT,1807,81,na,1888,225.44450723305818
STAT,1862,86,na,1948,179.21350598370395
STAT,1853,10,na,1863,2200.514529610905
SIM,1862,24,20-24,1886,55
SIM,1920,26,na,1946,3932
STAT,1782,72,na,1854,447.0
STAT,1853,45,40-44,1898,0.13085518958621356
STAT,1803,52,20-24,1855,0.0021501912069520823
SIM,1890,28,45-49,1918,2
STAT,1922,41,40-44,1963,0.2716057794170425
SIM,1921,15,40-44,1936,1
SIM,1892,25,20-24,1917,19
STAT,1830,26,30-34,1856,27.405686071017485
SIM,1877,36,35-39,1913,13
STAT,1959,3,na,1962,4859.919861574035
SIM,1945,19,45-49,1964,1
SIM,1849,57,na,1906,1524
STAT,1922,17,50-100,1939,0.40961377765989637
STAT,1854,26,50-100,1880,0.5310753996700098
STAT,1819,106,na,1925,0.006409536525783225
STAT,1847,48,20-24,1895,0.008737700661282162
STAT,1861,40,45-49,1901,1.1874537617567797
STAT,1843,21,40-44,1864,1.7794794816272275
STAT,1881,32,40-44,1913,3.9577156677365704
STAT,1869,36,35-39,1905,6.504218312719769
STAT,1849,48,25-29,1897,0.042649682613671414
STAT,1909,18,25-29,1927,8.007475974718242
SIM,1851,21,40-44,1872,2
SIM,1930,41,40-44,1971,3
STAT,1861,45,na,1906,1784.839437682171
SIM,1841,53,na,1894,1414
STAT,1943,29,40-44,1972,4.684864670088805
STAT,1814,41,40-44,1855,8.328909552498146
STAT,1907,18,20-24,1925,24.537915442422875
SIM,1849,33,na,1882,1877
STAT,1936,32,25-29,1968,8.480745321014151
STAT,1862,37,30-34,1899,4.304798756064223
STAT,1821,34,40-44,1855,11.625898584970319
STAT,1835,41,50-100,1876,0.8160534026185123
SIM,1890,28,20-24,1918,15
STAT,1880,17,25-29,1897,5.64369241220182
STAT,1934,24,15-19,1958,6.753476550441489
SIM,1826,29,na,1855,1603
SIM,1843,41,50-100,1884,1
SIM,1870,32,30-34,1902,21
STAT,1892,1,na,1893,3220.6493666145407
STAT,1919,37,50-100,1956,0.4261081476377758
STAT,1891,43,na,1934,2681.819834933369
STAT,1857,19,20-24,1876,15.342591052800547
SIM,1919,15,25-29,1934,13
SIM,1875,39,35-39,1914,14
SIM,1847,27,35-39,1874,14
STAT,1910,23,15-19,1933,4.708050910888365
SIM,1842,37,25-29,1879,1
STAT,1867,39,35-39,1906,6.211086051225714
STAT,1897,36,40-44,1933,5.557078330700828
STAT,1858,38,25-29,1896,2.1219904710881132
STAT,1859,16,20-24,1875,15.56491534017973
STAT,1847,48,50-100,1895,0.1788315997871639
SIM,1890,17,35-39,1907,2
STAT,1819,82,na,1901,246.30649947761972
STAT,1915,15,45-49,1930,0.099229843201658
SIM,1919,26,35-39,1945,17
STAT,1811,86,na,1897,96.2260790670029
STAT,1815,92,na,1907,18.59060224979692
STAT,1834,37,25-29,1871,2.222571532874143
SIM,1938,21,45-49,1959,1
SIM,1864,24,30-34,1888,20
SIM,1837,48,na,1885,1507
STAT,1838,40,15-19,1878,0.011124165392846304
STAT,1863,50,20-24,1913,6.205390062951434E-4
SIM,1942,24,15-19,1966,5
STAT,1926,29,40-44,1955,5.240612242316954
STAT,1927,6,na,1933,4707.842933337532
STAT,1832,88,na,1920,82.699828823339
STAT,1847,37,35-39,1884,5.411441442009439
STAT,1823,47,20-24,1870,0.014780512059928884
STAT,1872,40,50-100,1912,1.011170937100847
SIM,1902,30,50-100,1932,2
STAT,1882,47,na,1929,2057.3269960432654
STAT,1919,20,30-34,1939,29.908921002948173
STAT,1873,86,na,1959,298.5111823323019
SIM,1847,38,45-49,1885,2
STAT,1956,16,15-19,1972,56.739097283756315
STAT,1814,51,na,1865,1334.164480925684
STAT,1863,16,40-44,1879,0.17404901071863596
STAT,1839,27,35-39,1866,8.093099265665384
SIM,1854,17,25-29,1871,7
STAT,1864,34,30-34,1898,14.574728803298276
STAT,1870,2,na,1872,3079.0496154078805
SIM,1838,34,30-34,1872,17
STAT,1940,21,35-39,1961,9.064416728741811
STAT,1874,54,45-49,1928,0.01362251854231145
STAT,1926,18,30-34,1944,14.080198223071658
STAT,1858,46,30-34,1904,0.0719015305669516
STAT,1916,52,na,1968,3499.835984695981
STAT,1847,48,45-49,1895,0.17184143981711805
STAT,1833,89,na,1922,64.45307860218604
STAT,1890,38,20-24,1928,0.885888206383539
STAT,1906,22,40-44,1928,2.8671205140472913
STAT,1930,15,40-44,1945,1.7162117959092988
SIM,1864,35,40-44,1899,5
STAT,1874,34,50-100,1908,0.8768099269649745
STAT,1899,49,20-24,1948,0.008578871339399208
SIM,1845,43,na,1888,1606
STAT,1890,42,na,1932,2666.1164462647
STAT,1882,28,20-24,1910,10.739926456489263
STAT,1934,35,25-29,1969,1.2858035969531518
STAT,1869,25,na,1894,2198.938683624583
STAT,1898,22,na,1920,3023.5245097709017
STAT,1791,89,na,1880,35.881217395050584
STAT,1896,46,45-49,1942,0.1665680234007614
STAT,1846,17,25-29,1863,5.279859636697962
SIM,1820,91,na,1911,25
STAT,1936,23,35-39,1959,8.501161441454375
STAT,1874,71,na,1945,1288.3807896209062
STAT,1938,31,45-49,1969,1.4956198944165022
STAT,1839,38,45-49,1877,1.5697078849388082
SIM,1855,37,35-39,1892,10
STAT,1877,46,40-44,1923,0.16824112748646447
STAT,1865,28,15-19,1893,0.38712265526060485
STAT,1916,25,50-100,1941,0.9788349031573457
STAT,1830,27,45-49,1857,1.1127471519962981
STAT,1864,35,45-49,1899,1.6944000890107234
SIM,1888,28,35-39,1916,16
SIM,1900,7,na,1907,3467
STAT,1856,24,30-34,1880,15.029972755941312
SIM,1929,33,40-44,1962,5
STAT,1836,47,30-34,1883,0.0656012101298005
STAT,1818,84,na,1902,163.37046610941684
STAT,1893,18,25-29,1911,6.771110488902129
STAT,1848,63,na,1911,1325.8415900590583
SIM,1869,93,na,1962,78
STAT,1867,25,15-19,1892,0.40520005226158434
STAT,1908,34,15-19,1942,0.11361143691638498
SIM,1828,71,na,1899,737
SIM,1882,18,15-19,1900,6
SIM,1834,38,35-39,1872,16
SIM,1836,47,na,1883,1478
STAT,1938,20,35-39,1958,8.80977392166317
STAT,1871,17,50-100,1888,0.046254737531563825
STAT,1903,44,35-39,1947,0.1667411196179491
STAT,1858,81,na,1939,400.5342506375319
STAT,1812,45,25-29,1857,0.19936094400273185
STAT,1897,25,30-34,1922,32.0302075738529
SIM,1888,39,45-49,1927,2
STAT,1841,84,na,1925,229.34197145104912
SIM,1834,27,25-29,1861,35
STAT,1832,49,15-19,1881,2.535119167271194E-4
SIM,1908,25,20-24,1933,15
STAT,1812,42,15-19,1854,0.05276317086362706
STAT,1918,19,50-100,1937,0.38317566620703075
SIM,1872,97,na,1969,14
SIM,1919,29,45-49,1948,1
STAT,1908,45,25-29,1953,0.045986854638653436
SIM,1881,22,35-39,1903,8
SIM,1944,23,35-39,1967,15
SIM,1882,35,na,1917,2240
STAT,1903,42,na,1945,3113.54911191019
SIM,1889,14,na,1903,3120
SIM,1886,49,na,1935,2129
STAT,1834,48,35-39,1882,0.09096931655958182
STAT,1849,45,45-49,1894,0.1787331521008471
SIM,1836,37,30-34,1873,5
STAT,1826,38,35-39,1864,7.470987586765592
STAT,1901,47,35-39,1948,0.1039406825726638
STAT,1971,0,na,1971,4738.781985580692
STAT,1861,17,20-24,1878,16.00579030061124
STAT,1936,21,15-19,1957,4.809211025394765
SIM,1858,29,30-34,1887,20
SIM,1927,36,40-44,1963,2
STAT,1931,19,50-100,1950,0.46077374097114554
STAT,1788,69,na,1857,605.352854474408
SIM,1944,2,na,1946,4005
SIM,1864,38,45-49,1902,3
SIM,1812,96,na,1908,4
SIM,1881,20,15-19,1901,2
STAT,1832,24,45-49,1856,0.6033323866042489
STAT,1895,28,30-34,1923,30.904825699146667
SIM,1944,21,15-19,1965,8
STAT,1893,29,35-39,1922,11.477063907882085
STAT,1850,17,45-49,1867,0.056269141292974556
STAT,1877,76,na,1953,928.3936692592391
SIM,1849,35,45-49,1884,1
STAT,1914,31,35-39,1945,8.725687074292521
STAT,1810,48,25-29,1858,0.1890774700063515
SIM,1795,91,na,1886,17
SIM,1906,15,15-19,1921,7
STAT,1951,18,na,1969,4139.356455316285
SIM,1878,14,na,1892,2610
STAT,1828,37,30-34,1865,4.865648065576436
SIM,1870,50,na,1920,1991
STAT,1881,30,15-19,1911,0.1310068232613536
STAT,1840,34,45-49,1874,1.3652186319892377
SIM,1908,39,40-44,1947,2
STAT,1881,35,45-49,1916,1.8365467436574396
SIM,1837,91,na,1928,25
STAT,1888,45,50-100,1933,0.2769333345324047
STAT,1927,30,30-34,1957,18.32919762219613
STAT,1876,19,30-34,1895,1.547281732920837
SIM,1840,21,35-39,1861,7
SIM,1824,46,50-100,1870,1
SIM,1919,48,50-100,1967,1
STAT,1860,24,45-49,1884,0.5431130752646859
STAT,1864,48,20-24,1912,0.009976708913797032
STAT,1900,16,15-19,1916,7.796356386080949
STAT,1821,51,50-100,1872,0.02336542888813684
STAT,1876,28,20-24,1904,11.409648926408194
STAT,1855,51,30-34,1906,0.004250279609804654
STAT,1865,28,45-49,1893,0.9473684960132059
STAT,1886,39,45-49,1925,1.9692994645689745
STAT,1879,43,na,1922,2269.0129388226637
STAT,1893,15,45-49,1908,0.07862176635098365
STAT,1905,26,50-100,1931,0.8764939801843302
SIM,1879,33,50-100,1912,5
STAT,1890,58,na,1948,2284.0574902613134
SIM,1939,19,15-19,1958,39
SIM,1938,26,45-49,1964,2
STAT,1860,35,30-34,1895,4.123970319196529
STAT,1814,44,45-49,1858,4.820033853026975
STAT,1932,39,na,1971,4765.123976026601
STAT,1888,63,na,1951,1992.0832934913497
SIM,1822,44,45-49,1866,4
STAT,1864,30,15-19,1894,0.12086704232367408
SIM,1903,34,35-39,1937,11
STAT,1828,37,25-29,1865,2.628568480767301
SIM,1965,5,na,1970,4597
SIM,1908,28,30-34,1936,42
SIM,1877,29,na,1906,2290
SIM,1895,18,25-29,1913,8
STAT,1894,42,50-100,1936,0.08895566912082561
SIM,1869,5,na,1874,2588
STAT,1908,41,50-100,1949,0.10327438661902442
SIM,1894,39,45-49,1933,5
SIM,1845,15,30-34,1860,1
STAT,1889,17,45-49,1906,0.07618268907973666
SIM,1769,99,na,1868,1
SIM,1945,16,35-39,1961,7
STAT,1789,67,na,1856,651.5539711200001
STAT,1865,35,na,1900,2036.5025265169481
STAT,1871,25,35-39,1896,9.112800112707882
SIM,1884,28,20-24,1912,13
SIM,1828,27,25-29,1855,34
SIM,1839,29,20-24,1868,7
SIM,1885,43,30-34,1928,1
STAT,1804,92,na,1896,13.951158972587967
STAT,1857,40,na,1897,1739.3903381897437
SIM,1881,48,50-100,1929,1
STAT,1880,17,30-34,1897,1.5873901448046728
SIM,1851,12,na,1863,2171
STAT,1854,27,25-29,1881,31.728669607147406
STAT,1877,32,20-24,1909,2.648820925624907
STAT,1918,41,15-19,1959,0.0015447066500655603
STAT,1838,44,30-34,1882,0.800639184601144
STAT,1944,24,na,1968,3722.270435044378
STAT,1837,26,40-44,1863,2.513350642668078
SIM,1862,27,25-29,1889,34
SIM,1922,6,na,1928,4349
STAT,1877,43,30-34,1920,1.1184614330847185
STAT,1873,48,50-100,1921,0.23235619878104655
SIM,1946,20,35-39,1966,14
SIM,1837,32,na,1869,1749
STAT,1858,54,50-100,1912,0.010878710149901017
STAT,1911,18,40-44,1929,0.26373309625176466
STAT,1919,17,na,1936,3842.5818654928294
SIM,1885,32,20-24,1917,1
SIM,1823,34,40-44,1857,4
STAT,1937,16,35-39,1953,3.865876733475915
SIM,1845,26,40-44,1871,2
SIM,1924,16,na,1940,4170
STAT,1861,61,na,1922,1467.7892170481712
SIM,1846,44,30-34,1890,4
STAT,1865,75,na,1940,881.4935597706533
SIM,1914,22,40-44,1936,5
STAT,1876,78,na,1954,762.5844697083031
SIM,1886,25,na,1911,2343
SIM,1853,38,45-49,1891,1
STAT,1879,45,30-34,1924,0.09667724187029564
STAT,1877,60,na,1937,1868.9114464958989
STAT,1834,34,45-49,1868,1.3577419770439865
STAT,1808,47,25-29,1855,0.21852632140405542
STAT,1926,15,20-24,1941,157.75431679848614
SIM,1862,15,na,1877,2288
STAT,1845,15,na,1860,2077.399866470496
SIM,1866,29,na,1895,2103
STAT,1875,49,35-39,1924,0.13310368796021518
STAT,1922,44,45-49,1966,0.17986242503530614
STAT,1854,27,30-34,1881,18.887974933445626
SIM,1836,37,25-29,1873,2
STAT,1849,45,20-24,1894,0.009088126722906136
SIM,1862,27,30-34,1889,23
STAT,1891,5,na,1896,3062.953126735366
STAT,1894,49,45-49,1943,0.15824422555363316
STAT,1895,28,25-29,1923,51.91498862794305
STAT,1844,51,25-29,1895,0.0024717820690744055
STAT,1882,25,40-44,1907,2.770741528394087
SIM,1829,42,35-39,1871,1
STAT,1841,24,40-44,1865,1.7938497348502283
STAT,1881,41,30-34,1922,1.0539420602153768
SIM,1881,25,45-49,1906,4
STAT,1870,81,na,1951,501.15960801843926
STAT,1866,32,45-49,1898,1.5194294527458756
SIM,1798,56,na,1854,1049
SIM,1850,73,na,1923,864
STAT,1945,26,40-44,1971,4.832975971447192
STAT,1837,28,50-100,1865,0.5290378097686829
SIM,1824,81,na,1905,245
STAT,1855,92,na,1947,29.597184601564056
SIM,1927,20,30-34,1947,41
SIM,1833,58,na,1891,1187
STAT,1881,30,20-24,1911,2.48665770257776
STAT,1846,53,25-29,1899,0.0025849431428974054
SIM,1842,34,45-49,1876,2
STAT,1887,18,25-29,1905,5.972254566323909
STAT,1874,51,35-39,1925,0.008349423987708942
SIM,1935,30,30-34,1965,23
SIM,1875,28,25-29,1903,46
STAT,1819,48,45-49,1867,0.4404736564993305
STAT,1929,42,35-39,1971,0.24634523313926693
SIM,1883,31,50-100,1914,3
STAT,1910,39,30-34,1949,1.6301732976674161
STAT,1875,38,25-29,1913,2.781875820489766
STAT,1900,37,na,1937,3111.881399989625
SIM,1882,75,na,1957,986
SIM,1953,13,na,1966,4439
STAT,1803,54,40-44,1857,0.029466523444077526
STAT,1788,103,na,1891,0.03871787717445446
SIM,1844,31,20-24,1875,2
STAT,1956,16,45-49,1972,0.6245358921548423
STAT,1855,42,40-44,1897,1.5964275321738528
STAT,1903,44,40-44,1947,0.20711504186980487
STAT,1894,32,na,1926,2897.099654109577
STAT,1810,61,na,1871,944.4231551327047
SIM,1834,24,45-49,1858,1
STAT,1835,27,20-24,1862,9.73124862670624
STAT,1865,17,35-39,1882,0.48416267268200897
SIM,1874,41,35-39,1915,1
STAT,1821,64,na,1885,942.094192995801
STAT,1947,20,30-34,1967,30.70859360984591
SIM,1879,35,30-34,1914,10
STAT,1866,41,35-39,1907,1.5849398256582987
SIM,1896,33,35-39,1929,16
SIM,1883,38,25-29,1921,2
STAT,1870,45,40-44,1915,0.1602433193356285
SIM,1843,27,20-24,1870,11
SIM,1911,44,40-44,1955,2
STAT,1921,21,25-29,1942,98.85705751336202
STAT,1828,43,na,1871,1471.6366159273014
STAT,1848,16,45-49,1864,0.06052705337510322
STAT,1888,33,35-39,1921,11.258632003806232
STAT,1836,78,na,1914,505.9649393827894
STAT,1906,3,na,1909,3637.3965257722166
SIM,1934,15,20-24,1949,159
STAT,1843,37,20-24,1880,0.6078330075907685
STAT,1907,16,na,1923,3513.4615028125836
SIM,1865,19,20-24,1884,20
SIM,1849,17,na,1866,2162
STAT,1917,24,15-19,1941,5.311261105117264
SIM,1899,26,45-49,1925,1
STAT,1823,33,30-34,1856,39.693099795890745
STAT,1825,41,40-44,1866,2.505897995220875
STAT,1858,35,20-24,1893,0.5763759043474538
STAT,1853,45,35-39,1898,0.10700774874017108
SIM,1945,16,40-44,1961,1
STAT,1874,19,20-24,1893,17.020225280048145
STAT,1876,15,15-19,1891,5.819061209243044
SIM,1805,86,na,1891,66
SIM,1826,45,na,1871,1401
STAT,1915,28,20-24,1943,17.52732961185148
SIM,1820,41,30-34,1861,1
STAT,1901,47,40-44,1948,0.1271046058243111
STAT,1891,27,na,1918,2789.323583580141
SIM,1875,36,30-34,1911,5
STAT,1886,53,na,1939,2114.2271758629413
STAT,1891,25,50-100,1916,0.752732835171844
STAT,1853,34,25-29,1887,7.8184379927432675
SIM,1934,18,25-29,1952,65
STAT,1855,42,35-39,1897,1.2852283045232327
STAT,1946,16,50-100,1962,0.3926789555148925
SIM,1775,90,na,1865,21
STAT,1908,30,20-24,1938,2.1925796244605373
SIM,1923,28,20-24,1951,27
SIM,1853,22,na,1875,1888
SIM,1875,25,20-24,1900,15
SIM,1865,42,45-49,1907,3
STAT,1791,92,na,1883,10.882658071467329
STAT,1937,16,40-44,1953,1.2886256524351933
STAT,1863,53,25-29,1916,0.0028892430433997587
STAT,1874,51,40-44,1925,0.010210152738566866
SIM,1938,23,35-39,1961,9
STAT,1810,45,20-24,1855,0.04138673464107827
SIM,1780,74,na,1854,359
SIM,1784,88,na,1872,35
SIM,1869,101,na,1970,5
SIM,1880,42,40-44,1922,5
SIM,1893,75,na,1968,1715
SIM,1916,38,30-34,1954,2
STAT,1828,99,na,1927,1.0665884856404155
STAT,1820,101,na,1921,0.30060889235739113
STAT,1817,59,na,1876,1081.8948136637903
STAT,1885,41,45-49,1926,1.415678356942791
SIM,1920,37,45-49,1957,2
STAT,1892,32,40-44,1924,5.13142115562774
STAT,1919,22,20-24,1941,115.0258826764742
SIM,1831,33,30-34,1864,19
SIM,1872,32,35-39,1904,15
SIM,1817,71,na,1888,649
STAT,1842,47,na,1889,1629.5670873903064
STAT,1862,47,35-39,1909,0.11255340743495966
STAT,1855,45,45-49,1900,0.16937987183411882
STAT,1862,35,40-44,1897,3.569369983468401
STAT,1901,5,na,1906,3465.37995634926
STAT,1921,24,35-39,1945,9.984022876357256
STAT,1819,43,15-19,1862,0.028063695038804282
STAT,1918,16,na,1934,3994.2404318978865
STAT,1861,0,na,1861,3037.982729135437
SIM,1834,40,na,1874,1586
SIM,1888,36,40-44,1924,6
STAT,1868,37,50-100,1905,1.1066162586352184
SIM,1916,30,20-24,1946,1
STAT,1910,36,na,1946,3415.6197691388693
SIM,1884,15,15-19,1899,6
SIM,1893,41,45-49,1934,1
STAT,1890,24,30-34,1914,20.443790220334673
STAT,1909,17,40-44,1926,0.2591334964031579
SIM,1852,77,na,1929,605
SIM,1908,28,25-29,1936,62
STAT,1886,34,15-19,1920,0.1408934074780548
SIM,1841,37,na,1878,1663
SIM,1849,39,30-34,1888,12
STAT,1877,17,na,1894,2474.928960671076
STAT,1917,23,25-29,1940,92.45653860211378
SIM,1862,98,na,1960,5
STAT,1908,17,na,1925,3539.364853155425
STAT,1910,34,30-34,1944,14.228721483401754
STAT,1839,24,30-34,1863,15.019874735680355
STAT,1853,46,25-29,1899,0.043715220875740965
STAT,1890,22,35-39,1912,6.739780004177478
STAT,1901,33,15-19,1934,0.18751695032942536
SIM,1927,22,20-24,1949,124
SIM,1894,22,15-19,1916,4
STAT,1810,110,na,1920,1.1690177811659908E-4
SIM,1854,63,na,1917,1434
STAT,1919,20,25-29,1939,96.12212333249788
SIM,1913,13,na,1926,3676
STAT,1908,49,40-44,1957,0.13391344792025897
STAT,1863,19,45-49,1882,0.055572270316252954
STAT,1920,44,35-39,1964,0.20939592007355787
SIM,1918,2,na,1920,4188
STAT,1823,31,35-39,1854,30.693071586192055
SIM,1900,65,na,1965,2458
STAT,1839,35,40-44,1874,3.5559914893166438
SIM,1861,34,25-29,1895,10
STAT,1812,49,40-44,1861,0.5544894576879411
STAT,1864,6,na,1870,2387.8454393982556
SIM,1927,39,45-49,1966,3
STAT,1941,18,20-24,1959,131.8794730614485
STAT,1867,29,30-34,1896,22.17865455543994
STAT,1821,46,35-39,1867,0.2240938433026794
STAT,1875,35,45-49,1910,1.9540884642449543
STAT,1908,38,30-34,1946,1.604085199239289
STAT,1817,46,15-19,1863,9.160094819697074E-4
STAT,1886,22,15-19,1908,3.2921303557092734
STAT,1808,82,na,1890,180.4065337069388
STAT,1828,26,50-100,1854,1.5438469830855737
STAT,1949,23,15-19,1972,5.866228947922291
SIM,1883,35,45-49,1918,3
SIM,1798,96,na,1894,2
STAT,1907,18,15-19,1925,8.213963230753452
STAT,1884,37,15-19,1921,0.05241021580757519
STAT,1912,37,45-49,1949,0.6285912535581127
SIM,1925,23,25-29,1948,111
SIM,1942,20,20-24,1962,112
SIM,1875,25,na,1900,2339
SIM,1901,37,35-39,1938,5
SIM,1828,55,na,1883,1278
STAT,1855,44,30-34,1899,0.8059571549795559
SIM,1833,41,40-44,1874,8
SIM,1824,41,na,1865,1498
STAT,1865,91,na,1956,56.14615364418283
STAT,1933,39,50-100,1972,0.5390928436643249
SIM,1847,24,30-34,1871,18
STAT,1821,35,25-29,1856,6.753930473256887
SIM,1884,19,30-34,1903,1
STAT,1848,101,na,1949,0.4240064392763415
SIM,1838,30,na,1868,1806
SIM,1879,36,45-49,1915,1
STAT,1870,43,15-19,1913,0.012705962539622315
STAT,1917,35,25-29,1952,0.9753060935773117
STAT,1859,51,45-49,1910,0.010963955121458403
STAT,1868,42,20-24,1910,0.1429686391694877
STAT,1930,18,45-49,1948,0.6084995739349786
SIM,1816,44,45-49,1860,2
SIM,1847,35,40-44,1882,4
STAT,1854,11,na,1865,2052.5329727810445
STAT,1858,25,na,1883,1835.8065444261129
SIM,1831,31,35-39,1862,8
SIM,1811,71,na,1882,543
SIM,1895,38,50-100,1933,4
STAT,1867,61,na,1928,1657.625608580383
STAT,1829,44,na,1873,1535.7441283421454
STAT,1830,24,40-44,1854,4.61174169834933
SIM,1860,29,na,1889,1970
SIM,1828,37,50-100,1865,4
STAT,1873,25,45-49,1898,1.0710146400396339
SIM,1903,22,35-39,1925,10
SIM,1927,20,25-29,1947,122
SIM,1919,26,40-44,1945,7
STAT,1873,21,50-100,1894,0.39188947928368184
STAT,1938,33,40-44,1971,3.7149994641067288
SIM,1925,35,25-29,1960,2
SIM,1849,20,40-44,1869,4
SIM,1925,24,15-19,1949,5
SIM,1892,33,50-100,1925,1
STAT,1945,0,na,1945,4596.417333063096
STAT,1816,41,45-49,1857,4.230817768896688
STAT,1856,23,40-44,1879,1.771030179948774
SIM,1812,56,na,1868,1109
SIM,1873,25,40-44,1898,4
SIM,1897,68,na,1965,2222
SIM,1845,25,35-39,1870,6
STAT,1845,33,15-19,1878,0.11858036187700258
STAT,1839,43,na,1882,1601.201998801319
SIM,1860,18,30-34,1878,1
STAT,1853,66,na,1919,1240.3965325729248
STAT,1870,30,45-49,1900,1.6290973935922244
STAT,1866,20,na,1886,2107.701173188683
STAT,1816,54,20-24,1870,0.0016033066673218463
STAT,1844,43,50-100,1887,0.7418966982062255
STAT,1826,35,30-34,1861,6.201388982522952
STAT,1837,29,45-49,1866,0.9116488883874408
SIM,1865,3,na,1868,2691
SIM,1891,36,50-100,1927,3
SIM,1896,27,na,1923,2985
STAT,1903,32,50-100,1935,1.231573522570581
STAT,1883,45,20-24,1928,0.01122536823614894
STAT,1846,50,20-24,1896,5.551828022524241E-4
STAT,1894,35,25-29,1929,3.528684862552656
SIM,1843,18,30-34,1861,1
STAT,1931,38,na,1969,4702.145989368406
STAT,1837,18,35-39,1855,0.5349623821530899
SIM,1873,39,na,1912,2238
STAT,1919,39,45-49,1958,0.6903991653854818
STAT,1936,35,35-39,1971,2.2470347620131386
SIM,1845,29,45-49,1874,5
STAT,1882,28,15-19,1910,0.41535627512826045
SIM,1872,34,30-34,1906,21
STAT,1901,45,15-19,1946,3.013386794730544E-4
STAT,1833,37,50-100,1870,0.9417961781732131
SIM,1864,65,na,1929,1497
SIM,1853,21,15-19,1874,6
STAT,1893,26,30-34,1919,30.2721430559013
STAT,1916,44,15-19,1960,0.0014817491222124416
STAT,1831,63,na,1894,1041.829562486256
SIM,1864,23,40-44,1887,4
STAT,1877,47,25-29,1924,0.056181089457056965
STAT,1831,41,40-44,1872,1.6832176406547443
STAT,1822,50,35-39,1872,0.011593089005000038
SIM,1834,35,30-34,1869,6
SIM,1874,24,na,1898,2191
STAT,1827,58,na,1885,1199.2294198909499
STAT,1861,41,50-100,1902,0.833584156337963
SIM,1860,19,15-19,1879,2
STAT,1925,45,30-34,1970,0.10252639277311835
STAT,1805,51,40-44,1856,0.03942551852790819
SIM,1850,31,45-49,1881,2
STAT,1941,19,na,1960,3579.162936057341
STAT,1862,21,15-19,1883,2.747533434254381
STAT,1893,15,20-24,1908,21.337951677927336
STAT,1828,35,35-39,1863,6.757026806891548
SIM,1942,28,30-34,1970,44
SIM,1860,51,na,1911,1808
SIM,1915,18,15-19,1933,6
STAT,1934,20,20-24,1954,141.6292471341739
STAT,1886,36,40-44,1922,4.3893806730869525
STAT,1887,15,20-24,1902,18.820499171202115
SIM,1834,24,20-24,1858,59
SIM,1912,50,na,1962,3269
STAT,1822,52,25-29,1874,0.004583609903499533
SIM,1870,10,na,1880,2449
SIM,1896,36,45-49,1932,2
STAT,1852,19,15-19,1871,5.142552971897019
SIM,1885,64,na,1949,1630
SIM,1801,93,na,1894,13
SIM,1870,21,15-19,1891,3
STAT,1909,42,na,1951,3281.782874249244
STAT,1888,36,45-49,1924,2.23633672896279
SIM,1881,50,na,1931,1711
SIM,1894,36,40-44,1930,7
STAT,1949,23,45-49,1972,1.2399570177449617
SIM,1895,15,20-24,1910,19
STAT,1856,35,40-44,1891,3.25720316948555
STAT,1948,20,50-100,1968,0.7142387143669214
SIM,1935,33,35-39,1968,16
SIM,1823,96,na,1919,2
SIM,1885,24,na,1909,2227
SIM,1801,53,na,1854,1115
SIM,1828,29,45-49,1857,5
STAT,1927,33,35-39,1960,10.612791861794877
STAT,1819,45,40-44,1864,0.3344121460426837
STAT,1934,28,30-34,1962,49.77096780047931
SIM,1839,74,na,1913,749
STAT,1836,46,25-29,1882,0.03953875884491625
STAT,1872,42,40-44,1914,2.1287385742158746
SIM,1851,15,na,1866,2103
STAT,1876,15,45-49,1891,0.06405129368983933
SIM,1819,35,35-39,1854,13
SIM,1876,50,na,1926,2117
STAT,1922,21,na,1943,3968.1117170445623
STAT,1871,23,15-19,1894,3.085160363009803
STAT,1907,32,na,1939,3339.7187903127565
SIM,1910,8,na,1918,3728
SIM,1870,33,20-24,1903,2
STAT,1785,77,na,1862,334.4409379396458
STAT,1842,44,20-24,1886,0.11597969325097997
SIM,1831,75,na,1906,583
STAT,1863,25,na,1888,2007.188789753917
SIM,1794,66,na,1860,662
SIM,1872,14,na,1886,2493
STAT,1878,26,35-39,1904,9.53216883656013
SIM,1935,31,50-100,1966,1
SIM,1838,35,45-49,1873,2
STAT,1926,18,25-29,1944,50.059721067264874
SIM,1905,18,na,1923,3404
STAT,1842,26,na,1868,1951.3485043066207
STAT,1846,19,45-49,1865,0.060148069239048585
STAT,1885,12,na,1897,2431.8031127209724
SIM,1886,26,35-39,1912,15
SIM,1867,16,20-24,1883,16
SIM,1839,95,na,1934,2
STAT,1817,45,30-34,1862,0.2251831057340544
STAT,1847,35,45-49,1882,1.5572081198833165
STAT,1855,76,na,1931,673.2503120796018
STAT,1836,45,40-44,1881,0.11903327214724767
SIM,1842,78,na,1920,460
STAT,1843,29,15-19,1872,0.3717474229392605
STAT,1894,46,35-39,1940,0.09614770891724861
SIM,1824,41,45-49,1865,4
STAT,1933,24,na,1957,4572.911164946939
STAT,1894,47,25-29,1941,0.039262020929105274
STAT,1899,20,35-39,1919,7.598529326556911
STAT,1841,27,15-19,1868,0.3884977037084117
STAT,1869,65,na,1934,1546.6358638911013
SIM,1835,81,na,1916,329
STAT,1827,44,25-29,1871,0.5952644969468308
SIM,1853,35,40-44,1888,3
STAT,1826,29,15-19,1855,0.9034891026053663
SIM,1855,35,45-49,1890,2
SIM,1910,24,25-29,1934,81
SIM,1954,3,na,1957,4488
STAT,1883,32,45-49,1915,1.6151514253138242
STAT,1865,25,40-44,1890,2.582401860141695
STAT,1867,25,45-49,1892,0.9916075922684293
STAT,1921,37,40-44,1958,1.5790589762312894
STAT,1852,18,30-34,1870,1.3893421978518063
STAT,1862,34,20-24,1896,2.164618012875094
SIM,1848,32,na,1880,1828
SIM,1918,33,35-39,1951,12
STAT,1858,47,15-19,1905,2.9489110324603697E-4
SIM,1905,5,na,1910,3534
STAT,1902,24,25-29,1926,75.84386223025427
STAT,1892,47,20-24,1939,0.007972080573103562
SIM,1891,32,45-49,1923,2
STAT,1807,97,na,1904,1.9981958386052245
STAT,1867,36,30-34,1903,4.75050641947593
STAT,1876,75,na,1951,1004.7599272514204
STAT,1897,26,45-49,1923,1.4075512272359492
STAT,1865,51,na,1916,1852.5060045819432
STAT,1851,31,40-44,1882,3.2808212871686377
STAT,1839,32,50-100,1871,0.750718060710818
SIM,1862,26,50-100,1888,1
SIM,1892,36,30-34,1928,5
STAT,1825,48,50-100,1873,0.24708887856701064
SIM,1833,48,50-100,1881,1
SIM,1838,22,30-34,1860,20
SIM,1914,20,45-49,1934,1
STAT,1853,31,20-24,1884,2.1285990651607283
SIM,1825,34,20-24,1859,1
SIM,1889,40,40-44,1929,6
STAT,1898,43,45-49,1941,0.13190605529839922
SIM,1820,44,35-39,1864,5
STAT,1912,20,15-19,1932,4.848301739805632
STAT,1863,51,35-39,1914,0.007171207052513954
STAT,1809,45,na,1854,1302.6535989015804
STAT,1850,53,45-49,1903,0.010065884149628654
SIM,1884,39,na,1923,2295
SIM,1893,40,50-100,1933,1
STAT,1908,33,25-29,1941,8.207232189924786
SIM,1881,34,35-39,1915,10
SIM,1899,29,50-100,1928,1
STAT,1853,4,na,1857,2426.52884607656
STAT,1897,47,50-100,1944,0.17421155873004024
STAT,1806,56,na,1862,1090.4399972132328
STAT,1887,38,na,1925,2477.1760437723888
STAT,1833,33,na,1866,1694.0013581753262
STAT,1912,31,25-29,1943,8.627111459080327
STAT,1921,39,na,1960,3960.012252194999
STAT,1901,49,30-34,1950,0.07069660908029204
STAT,1947,23,35-39,1970,10.050180729404554
STAT,1904,24,35-39,1928,7.85790288406442
STAT,1892,68,na,1960,1933.0633476382695
STAT,1888,30,30-34,1918,19.64955680060931
SIM,1838,33,40-44,1871,5
SIM,1907,0,na,1907,3777
STAT,1862,44,30-34,1906,0.9160738710458417
STAT,1939,16,45-49,1955,0.4725093716301488
STAT,1932,27,15-19,1959,0.8735048803803621
STAT,1942,25,50-100,1967,0.987766636874435
STAT,1885,40,50-100,1925,1.0048390297972296
STAT,1840,33,30-34,1873,13.811689637983234
SIM,1848,88,na,1936,86
STAT,1884,36,30-34,1920,4.998146474922479
STAT,1838,42,35-39,1880,1.4217550807408583
STAT,1873,34,35-39,1907,9.61981623553643
STAT,1884,25,20-24,1909,11.023489534378033
SIM,1800,68,na,1868,689
STAT,1843,51,na,1894,1461.3085216899344
STAT,1906,20,45-49,1926,0.9651720164672911
SIM,1818,96,na,1914,5
STAT,1836,44,20-24,1880,0.11924949716362036
STAT,1880,80,na,1960,786.5174692524223
SIM,1872,76,na,1948,820
SIM,1861,31,20-24,1892,3
STAT,1929,25,50-100,1954,1.1812340238819274
SIM,1937,25,50-100,1962,4
STAT,1864,10,na,1874,2313.558792833347
SIM,1862,36,na,1898,2026
SIM,1920,34,40-44,1954,9
STAT,1757,101,na,1858,0.14377266259553623
STAT,1875,52,50-100,1927,0.01458692208516644
STAT,1831,50,30-34,1881,0.0038810653479150387
STAT,1897,39,15-19,1936,0.015158670369139433
SIM,1831,78,na,1909,431
STAT,1910,35,15-19,1945,0.017515567898048957
STAT,1930,35,na,1965,4643.824480105588
STAT,1845,17,50-100,1862,0.04381740941430097
STAT,1903,47,45-49,1950,0.17810423875861894
SIM,1942,23,25-29,1965,81
STAT,1917,53,na,1970,3548.0075782536514
SIM,1920,20,15-19,1940,4
STAT,1937,7,na,1944,3673.683258318431
STAT,1864,46,50-100,1910,0.20737537976799836
STAT,1899,23,na,1922,3051.865773538044
STAT,1910,7,na,1917,3729.6392268260324
STAT,1849,52,50-100,1901,0.011264779449464864
STAT,1892,35,45-49,1927,2.3811955190537213
SIM,1872,46,50-100,1918,2
STAT,1853,42,30-34,1895,0.8689932761249552
STAT,1875,47,15-19,1922,3.865947755067167E-4
SIM,1906,28,20-24,1934,15
STAT,1825,44,45-49,1869,1.557347853000363
SIM,1938,20,30-34,1958,34
STAT,1928,26,40-44,1954,5.443252976347542
SIM,1920,31,25-29,1951,18
STAT,1878,61,na,1939,1839.7102143266347
STAT,1799,69,na,1868,671.4726569353197
STAT,1821,48,na,1869,1366.259586603872
SIM,1814,43,35-39,1857,2
SIM,1842,31,40-44,1873,9
STAT,1929,19,na,1948,4413.660005020599
SIM,1816,86,na,1902,88
SIM,1874,40,na,1914,2186
SIM,1899,23,40-44,1922,5
SIM,1833,44,45-49,1877,4
STAT,1913,18,45-49,1931,0.09623733769214904
SIM,1836,35,35-39,1871,13
SIM,1841,18,20-24,1859,16
STAT,1855,14,na,1869,1999.4602082703248
STAT,1942,20,na,1962,3619.652201277418
SIM,1887,50,na,1937,2272
STAT,1905,41,35-39,1946,0.17248324033332385
STAT,1920,30,50-100,1950,0.8624061704640278
STAT,1877,45,20-24,1922,0.011876450593388096
SIM,1884,61,na,1945,1796
STAT,1821,43,30-34,1864,1.9208853027341886
STAT,1868,45,25-29,1913,0.052434898604564864
STAT,1895,26,35-39,1921,11.924389127991027
SIM,1886,28,25-29,1914,47
STAT,1954,2,na,1956,4595.442986831008
STAT,1845,106,na,1951,0.008591809921219409
STAT,1929,16,na,1945,4448.35564952985
SIM,1906,19,30-34,1925,2
SIM,1840,33,35-39,1873,10
STAT,1845,21,15-19,1866,2.9190708537270886
SIM,1861,14,na,1875,2333
SIM,1819,37,25-29,1856,2
SIM,1936,26,40-44,1962,3
STAT,1761,115,na,1876,2.32716681580083E-4
STAT,1840,46,45-49,1886,0.15819471826438705
SIM,1916,22,15-19,1938,4
STAT,1789,102,na,1891,0.06477903480159175
STAT,1792,74,na,1866,439.8610826421777
SIM,1831,49,50-100,1880,1
STAT,1897,2,na,1899,3367.747800269281
SIM,1912,24,35-39,1936,13
STAT,1810,107,na,1917,0.001995032196262177
STAT,1823,49,50-100,1872,0.2939645041139241
SIM,1851,24,20-24,1875,66
SIM,1914,54,na,1968,3351
STAT,1888,60,na,1948,2129.267343318948
STAT,1842,31,45-49,1873,1.5414716232536667
STAT,1877,23,50-100,1900,0.39837316331008654
SIM,1849,23,45-49,1872,1
SIM,1901,34,30-34,1935,14
STAT,1876,51,45-49,1927,0.014231955993324845
STAT,1892,22,50-100,1914,0.4825181290495964
SIM,1863,42,40-44,1905,3
SIM,1903,14,na,1917,3467
SIM,1869,23,25-29,1892,53
STAT,1881,34,30-34,1915,15.797432316599899
SIM,1925,28,30-34,1953,56
SIM,1927,4,na,1931,4710
SIM,1887,49,50-100,1936,2
STAT,1920,41,30-34,1961,0.13357961883607689
STAT,1908,22,15-19,1930,4.623226700485915
STAT,1917,20,20-24,1937,112.31066362450635
SIM,1816,41,40-44,1857,7
STAT,1778,109,na,1887,0.0029270982394956216
SIM,1850,40,35-39,1890,4
SIM,1896,24,na,1920,2934
SIM,1858,22,40-44,1880,1
STAT,1821,100,na,1921,0.5656084928113237
STAT,1843,24,20-24,1867,57.58967504050515
SIM,1829,96,na,1925,4
SIM,1905,32,40-44,1937,5
SIM,1851,35,30-34,1886,6
SIM,1879,33,40-44,1912,4
STAT,1834,74,na,1908,688.035530264157
SIM,1916,33,25-29,1949,12
STAT,1875,32,40-44,1907,4.211015351389318
SIM,1883,32,40-44,1915,3
STAT,1816,108,na,1924,8.535862893929351E-4
SIM,1887,22,50-100,1909,2
SIM,1774,89,na,1863,31
STAT,1894,16,50-100,1910,0.0596246444859132
STAT,1895,24,15-19,1919,4.037638154128391
STAT,1814,43,30-34,1857,3.886232372040666
STAT,1867,38,20-24,1905,0.6804114681278082
SIM,1840,52,na,1892,1405
STAT,1832,48,na,1880,1431.3824041321743
STAT,1906,37,15-19,1943,0.016676599197020962
STAT,1856,38,15-19,1894,0.041184984988111996
SIM,1935,16,na,1951,4698
STAT,1812,44,35-39,1856,6.3736842950313966
STAT,1864,32,35-39,1896,8.526703820743686
SIM,1925,20,20-24,1945,116
SIM,1822,43,30-34,1865,8
SIM,1926,42,na,1968,4275
STAT,1834,46,15-19,1880,2.930306158278361E-4
STAT,1843,35,30-34,1878,4.290688872420948
STAT,1879,22,50-100,1901,0.4032530046200983
STAT,1897,24,40-44,1921,2.616166541151357
STAT,1842,40,35-39,1882,1.3919570924069595
STAT,1828,33,15-19,1861,0.1424866784282609
STAT,1872,51,30-34,1923,0.0056674881723407025
STAT,1880,83,na,1963,622.383112938835
SIM,1862,25,35-39,1887,8
SIM,1838,33,na,1871,1753
SIM,1828,26,40-44,1854,3
STAT,1821,33,20-24,1854,8.474651531648794
STAT,1877,79,na,1956,722.5103325622024
SIM,1899,16,na,1915,3359
STAT,1880,43,na,1923,2285.216242620681
STAT,1827,52,50-100,1879,0.013337425884042948
SIM,1900,19,20-24,1919,23
SIM,1815,45,na,1860,1447
STAT,1887,17,40-44,1904,0.19327078995521998
SIM,1859,32,na,1891,1921
STAT,1879,43,35-39,1922,1.7777298427780228
STAT,1877,44,20-24,1921,0.15352572875809214
SIM,1866,38,25-29,1904,3
SIM,1764,90,na,1854,13
STAT,1860,36,15-19,1896,0.043250183296271345
STAT,1826,37,20-24,1863,0.8411572829639975
STAT,1922,24,na,1946,3931.401403387453
SIM,1827,70,na,1897,794
STAT,1868,53,30-34,1921,0.0052791381652124245
SIM,1929,31,45-49,1960,1
STAT,1931,31,35-39,1962,11.31839233615771
SIM,1929,20,35-39,1949,16
STAT,1893,28,20-24,1921,14.00513089372805
SIM,1891,41,35-39,1932,4
SIM,1856,29,20-24,1885,8
SIM,1827,30,na,1857,1621
STAT,1809,48,na,1857,1253.5741034929092
STAT,1854,25,35-39,1879,8.068514237544933
STAT,1908,22,45-49,1930,0.9772210465675363
STAT,1857,51,35-39,1908,0.006444964044339299
SIM,1906,48,50-100,1954,4
SIM,1845,22,30-34,1867,20
STAT,1866,76,na,1942,825.493002027064
STAT,1948,19,15-19,1967,49.03351728669057
STAT,1863,28,na,1891,1971.5048231322698
STAT,1843,29,na,1872,1772.5054386778406
STAT,1899,36,20-24,1935,1.0025912826196617
STAT,1832,33,35-39,1865,7.905618242046343
STAT,1883,41,35-39,1924,1.6847888619128875
STAT,1943,23,na,1966,3669.1634231001613
SIM,1916,22,45-49,1938,4
SIM,1858,39,50-100,1897,4
STAT,1831,44,45-49,1875,1.075825627011192
SIM,1855,48,50-100,1903,3
SIM,1887,43,35-39,1930,1
SIM,1944,20,30-34,1964,33
SIM,1885,7,na,1892,2505
SIM,1849,73,na,1922,876
STAT,1851,34,15-19,1885,0.10443021000523013
STAT,1830,29,35-39,1859,8.69629216479338
STAT,1779,92,na,1871,9.05503614917336
STAT,1899,47,30-34,1946,0.07034910102773269
STAT,1910,37,35-39,1947,2.185410028957435
STAT,1810,45,50-100,1855,0.8470484687838692
STAT,1878,28,25-29,1906,41.500024146983264
STAT,1882,17,35-39,1899,0.5041075199417528
STAT,1934,36,50-100,1970,0.547840763508046
SIM,1866,103,na,1969,1
STAT,1869,23,20-24,1892,62.873107290512806
SIM,1888,75,na,1963,1364
SIM,1838,32,40-44,1870,2
SIM,1860,88,na,1948,95
STAT,1816,50,35-39,1866,0.020263227889807715
STAT,1852,25,na,1877,1853.2285896402418
STAT,1912,34,40-44,1946,3.606704777999643
STAT,1846,52,40-44,1898,0.007766829603736662
SIM,1888,25,30-34,1913,36
SIM,1864,62,na,1926,1642
STAT,1848,29,20-24,1877,10.257725827697694
STAT,1934,23,25-29,1957,117.22929332577078
SIM,1886,23,30-34,1909,27
STAT,1932,37,50-100,1969,0.5329138099842141
STAT,1827,41,20-24,1868,0.15499167941338707
STAT,1908,57,na,1965,3000.9812487376994
SIM,1760,94,na,1854,1
STAT,1805,54,45-49,1859,0.05117756698888702
STAT,1897,23,40-44,1920,2.6245124908723287
STAT,1923,22,40-44,1945,3.6958339151906903
SIM,1860,27,20-24,1887,13
STAT,1788,66,na,1854,677.0
SIM,1843,63,na,1906,1276
STAT,1835,50,45-49,1885,0.009793489337913372
STAT,1875,13,na,1888,2517.594771247562
SIM,1929,31,na,1960,4501
STAT,1858,49,35-39,1907,0.10153032548682785
STAT,1831,26,na,1857,1676.6861731913436
STAT,1829,54,30-34,1883,0.00411053514843995
STAT,1881,47,45-49,1928,0.2143710441611259
SIM,1847,47,na,1894,1681
SIM,1931,22,40-44,1953,6
SIM,1827,35,50-100,1862,4
SIM,1879,34,40-44,1913,3
STAT,1818,81,na,1899,265.5687534047115
STAT,1819,85,na,1904,144.71417587687847
STAT,1896,45,30-34,1941,0.06880689822846256
STAT,1851,34,45-49,1885,1.278777419849142
STAT,1856,38,45-49,1894,1.4620667932024782
STAT,1909,15,20-24,1924,25.234137840572412
STAT,1847,21,50-100,1868,0.37130416303411223
STAT,1878,19,35-39,1897,0.537318390075836
STAT,1862,15,50-100,1877,0.04586007613865981
SIM,1806,71,na,1877,600
STAT,1836,54,30-34,1890,0.003748780762447763
SIM,1910,28,40-44,1938,6
STAT,1943,25,25-29,1968,66.2798311843233
STAT,1891,15,40-44,1906,0.21476688631168034
STAT,1894,32,20-24,1926,3.2816470205670245
STAT,1843,88,na,1931,92.72774787394019
SIM,1879,23,30-34,1902,25
STAT,1838,58,na,1896,1327.660373443093
STAT,1869,34,15-19,1903,0.12921416723924783
STAT,1820,54,40-44,1874,0.01630668035603049
SIM,1826,48,na,1874,1353
STAT,1822,89,na,1911,53.381642660733334
STAT,1880,15,35-39,1895,0.5490175836953229
SIM,1875,65,na,1940,1571
STAT,1859,19,25-29,1878,4.887758400406038
SIM,1796,92,na,1888,9
STAT,1932,3,na,1935,5073.75134398917
SIM,1918,30,30-34,1948,28
SIM,1928,16,35-39,1944,5
STAT,1888,45,35-39,1933,0.15786102179259334
SIM,1953,16,50-100,1969,1
STAT,1836,48,45-49,1884,0.15790083856076906
STAT,1872,40,20-24,1912,0.15200609148142782
STAT,1914,47,20-24,1961,0.010354155014356598
SIM,1896,64,na,1960,2310
STAT,1878,23,30-34,1901,17.482371704746022
STAT,1837,27,25-29,1864,35.23708437139719
SIM,1938,22,50-100,1960,1
STAT,1954,16,40-44,1970,1.633836813407016
STAT,1827,52,30-34,1879,0.0052567704760199336
STAT,1871,27,30-34,1898,23.622442601874933
SIM,1910,17,30-34,1927,4
STAT,1902,28,40-44,1930,3.979721856531388
STAT,1836,43,20-24,1879,0.12078711716513249
STAT,1857,42,45-49,1899,1.1137153597213152
STAT,1873,38,20-24,1911,0.7348982090270999
SIM,1832,24,40-44,1856,1
STAT,1902,17,30-34,1919,2.124996849056239
SIM,1867,19,25-29,1886,9
SIM,1902,69,na,1971,2219
STAT,1872,45,45-49,1917,0.225857710169937
SIM,1845,27,25-29,1872,35
STAT,1863,108,na,1971,0.0258854711525801
STAT,1898,44,50-100,1942,0.09252170022586483
STAT,1894,43,30-34,1937,0.09622387076779261
STAT,1846,16,40-44,1862,0.17142592456321054
SIM,1846,28,na,1874,1832
SIM,1857,30,40-44,1887,5
SIM,1905,40,na,1945,3164
SIM,1851,39,25-29,1890,2
SIM,1953,4,na,1957,4446
STAT,1831,41,35-39,1872,1.3551000035037637
STAT,1844,18,35-39,1862,0.481579338625184
STAT,1939,28,15-19,1967,0.6701282640607297
SIM,1836,28,35-39,1864,9
SIM,1881,31,30-34,1912,24
STAT,1809,61,na,1870,967.6943802306984
SIM,1908,32,20-24,1940,2
STAT,1871,1,na,1872,3293.574928814639
SIM,1951,17,40-44,1968,1
STAT,1850,29,15-19,1879,0.3709854430387647
STAT,1948,17,na,1965,3979.4704164935965
SIM,1827,33,na,1860,1591
STAT,1805,71,na,1876,646.8615498928069
STAT,1828,35,40-44,1863,4.181992402832457
STAT,1943,17,40-44,1960,1.4012003188020963
STAT,1852,15,20-24,1867,15.729898311410084
SIM,1855,22,30-34,1877,23
STAT,1876,52,20-24,1928,7.163787991884037E-4
STAT,1926,7,na,1933,4629.73997102657
SIM,1838,36,45-49,1874,2
SIM,1897,29,20-24,1926,19
STAT,1861,15,30-34,1876,1.4560900081307193
SIM,1884,79,na,1963,898
SIM,1909,30,na,1939,3465
STAT,1897,27,45-49,1924,1.4027374020388022
SIM,1808,88,na,1896,35
STAT,1834,39,15-19,1873,0.042457086958312434
SIM,1814,40,30-34,1854,4
STAT,1819,35,30-34,1854,17.269217009771435
STAT,1863,49,50-100,1912,0.19935549520968873
STAT,1916,48,30-34,1964,0.08613795485677676
STAT,1827,98,na,1925,1.8764604436015915
SIM,1829,34,na,1863,1575
STAT,1873,33,na,1906,2276.7107151141
STAT,1889,29,20-24,1918,13.584075296084984
SIM,1880,89,na,1969,308
STAT,1873,31,30-34,1904,16.796770756577807
STAT,1864,48,15-19,1912,3.3255667126505533E-4
STAT,1879,24,na,1903,2324.092295601555
SIM,1934,31,na,1965,4806
STAT,1834,46,20-24,1880,0.008790926207626499
STAT,1841,22,na,1863,1867.3288471490741
SIM,1862,25,40-44,1887,1
STAT,1828,28,35-39,1856,13.651821434914098
STAT,1877,23,na,1900,2310.431716776448
SIM,1853,25,30-34,1878,28
SIM,1838,70,na,1908,874
SIM,1843,18,25-29,1861,6
STAT,1874,15,40-44,1889,0.17802446722332935
STAT,1843,11,na,1854,2070.0
SIM,1965,2,na,1967,4601
STAT,1836,47,25-29,1883,0.039035430444820454
SIM,1880,55,na,1935,2078
STAT,1834,44,50-100,1878,0.7703970394205857
STAT,1895,19,35-39,1914,0.6721653464965378
STAT,1861,48,na,1909,1745.0158093949206
SIM,1812,43,30-34,1855,4
SIM,1899,37,30-34,1936,2
STAT,1780,86,na,1866,55.84459238156454
STAT,1837,28,45-49,1865,0.9182418649779827
SIM,1845,28,45-49,1873,4
STAT,1771,112,na,1883,5.488011530053935E-4
STAT,1854,23,15-19,1877,2.753476786390968
STAT,1766,114,na,1880,2.5110630443346565E-4
STAT,1896,48,35-39,1944,0.09729373404097462
STAT,1845,25,30-34,1870,22.004283225888997
STAT,1900,27,30-34,1927,33.00099215443488
STAT,1911,6,na,1917,3776.726948387106
SIM,1816,83,na,1899,141
SIM,1855,88,na,1943,69
STAT,1823,38,50-100,1861,1.8855549975731407
STAT,1918,45,30-34,1963,0.09004112467154596
SIM,1860,15,20-24,1875,18
STAT,1923,25,15-19,1948,0.7708713266161284
SIM,1892,74,na,1966,1823
SIM,1842,38,na,1880,1685
STAT,1835,93,na,1928,18.601261113081698
STAT,1820,40,20-24,1860,0.3102757749780601
STAT,1855,30,na,1885,1762.88317094004
SIM,1842,16,na,1858,2040
STAT,1932,38,30-34,1970,2.3110191145687518
STAT,1854,25,40-44,1879,2.504915455098235
STAT,1910,30,15-19,1940,0.11799763171969983
SIM,1797,71,na,1868,536
SIM,1881,2,na,1883,2347
STAT,1840,52,50-100,1892,0.009858532090338937
STAT,1917,27,40-44,1944,4.617827760459509
STAT,1856,20,15-19,1876,2.8651147023302697
STAT,1823,47,15-19,1870,4.926833019499434E-4
SIM,1827,35,30-34,1862,5
STAT,1822,43,na,1865,1383.148838641632
STAT,1947,22,35-39,1969,10.053498383871228
SIM,1917,25,25-29,1942,7
SIM,1921,7,na,1928,4338
STAT,1913,47,na,1960,3387.5942527339434
SIM,1834,80,na,1914,349
SIM,1933,22,15-19,1955,4
SIM,1922,12,na,1934,4302
STAT,1916,46,50-100,1962,0.2197024845894704
SIM,1935,30,25-29,1965,11
STAT,1886,26,30-34,1912,25.21551646443613
STAT,1792,71,na,1863,584.5304712130073
STAT,1866,41,40-44,1907,1.9687098125794478
STAT,1919,24,40-44,1943,3.4564332846877965
SIM,1874,41,40-44,1915,4
SIM,1914,17,na,1931,3810
STAT,1825,44,15-19,1869,0.014369992732073702
STAT,1890,38,15-19,1928,0.06453491057128974
SIM,1826,85,na,1911,121
SIM,1841,17,20-24,1858,11
SIM,1877,29,35-39,1906,9
STAT,1812,42,50-100,1854,4.036382276114771
STAT,1841,15,45-49,1856,0.05877248103027748
SIM,1894,26,30-34,1920,46
STAT,1865,52,45-49,1917,0.012360336749162513
STAT,1859,20,na,1879,1859.5511851376518
SIM,1910,27,na,1937,3438
SIM,1916,18,na,1934,3790
SIM,1934,22,20-24,1956,130
SIM,1915,17,15-19,1932,7
SIM,1810,49,50-100,1859,2
STAT,1871,34,30-34,1905,16.238251268495933
STAT,1852,87,na,1939,127.72864724457504
SIM,1943,14,na,1957,3821
STAT,1847,22,30-34,1869,16.102114792270253
STAT,1849,30,40-44,1879,3.844690923802455
STAT,1943,15,15-19,1958,45.488049684645475
STAT,1956,12,na,1968,4909.671434061416
STAT,1858,28,50-100,1886,0.48155287609883335
SIM,1869,28,30-34,1897,35
STAT,1843,39,25-29,1882,2.023525324298283
STAT,1845,47,35-39,1892,0.0986061774851481
STAT,1885,74,na,1959,1163.486667955239
STAT,1925,22,15-19,1947,6.019249188424222
SIM,1898,53,na,1951,2652
STAT,1851,33,45-49,1884,1.2921250718412618
STAT,1930,19,na,1949,4471.266440465161
SIM,1840,30,30-34,1870,23
SIM,1864,20,15-19,1884,4
STAT,1885,19,35-39,1904,0.5139175425343292
STAT,1892,35,15-19,1927,0.06707593809115782
STAT,1945,25,35-39,1970,15.573906939818864
SIM,1826,28,35-39,1854,11
SIM,1859,39,50-100,1898,1
STAT,1826,33,na,1859,1580.8863726613383
STAT,1808,49,15-19,1857,0.0014647871325420437
SIM,1927,24,40-44,1951,4
STAT,1860,36,20-24,1896,0.5937069869147475
SIM,1930,41,na,1971,4638
SIM,1843,25,30-34,1868,28
SIM,1882,45,50-100,1927,2
STAT,1784,76,na,1860,331.8290338035013
STAT,1839,83,na,1922,264.3132429324969
SIM,1893,19,35-39,1912,3
SIM,1817,49,na,1866,1350
STAT,1877,48,25-29,1925,0.05573501160676794
STAT,1899,24,45-49,1923,0.8969643905667941
SIM,1872,37,35-39,1909,14
STAT,1860,82,na,1942,357.6399472779959
SIM,1865,104,na,1969,1
STAT,1927,30,25-29,1957,10.752677984718712
STAT,1835,25,30-34,1860,21.191626098515673
SIM,1919,27,50-100,1946,2
SIM,1833,43,45-49,1876,1
SIM,1936,19,40-44,1955,1
STAT,1860,60,na,1920,1461.8716722291108
SIM,1856,25,40-44,1881,2
SIM,1884,19,25-29,1903,3
SIM,1951,15,15-19,1966,48
SIM,1880,42,35-39,1922,2
STAT,1820,60,na,1880,1073.1645563645409
STAT,1925,46,15-19,1971,4.2272612911082116E-4
STAT,1832,30,30-34,1862,14.088139459658295
SIM,1833,55,na,1888,1248
SIM,1879,15,na,1894,2542
STAT,1892,34,45-49,1926,2.045712334947536
SIM,1877,36,40-44,1913,4
STAT,1896,12,na,1908,3222.159034482334
STAT,1880,18,45-49,1898,0.06488651068599037
STAT,1880,27,35-39,1907,9.60970421373107
STAT,1830,36,35-39,1866,5.827656730203099
SIM,1839,25,40-44,1864,3
STAT,1850,41,45-49,1891,1.0597903600053242
STAT,1875,47,20-24,1922,0.011597853467059603
STAT,1777,107,na,1884,0.007100218162086257
SIM,1927,35,35-39,1962,5
STAT,1849,31,50-100,1880,0.8039012160064151
STAT,1879,52,30-34,1931,0.005854980751641364
STAT,1912,35,40-44,1947,1.3934343381111005
STAT,1858,47,20-24,1905,0.00884674087926897
STAT,1926,22,20-24,1948,127.6135738444048
SIM,1920,35,40-44,1955,4
STAT,1898,16,40-44,1914,0.23440113872619836
STAT,1914,35,45-49,1949,0.649134062835527
SIM,1867,29,35-39,1896,10
SIM,1919,19,40-44,1938,3
STAT,1885,58,na,1943,1862.1919531791268
STAT,1920,40,25-29,1960,0.07471140582490272
STAT,1816,55,na,1871,1211.218355836804
SIM,1875,42,50-100,1917,2
STAT,1863,18,45-49,1881,0.05590153032989605
SIM,1821,36,35-39,1857,8
SIM,1929,22,25-29,1951,128
STAT,1825,43,45-49,1868,1.5929154170315825
STAT,1869,36,40-44,1905,4.025526662468722
SIM,1946,22,25-29,1968,115
STAT,1827,80,na,1907,357.32084126476144
STAT,1842,63,na,1905,1292.1615362369466
STAT,1872,42,35-39,1914,1.7137734180687687
SIM,1893,16,30-34,1909,2
STAT,1924,17,15-19,1941,51.05382172719074
SIM,1898,31,40-44,1929,3
STAT,1844,44,25-29,1888,0.44521613908054
STAT,1860,29,15-19,1889,0.34646427613081127
STAT,1860,37,50-100,1897,0.9410767072240533
STAT,1865,28,20-24,1893,10.009885720050502
STAT,1814,46,35-39,1860,0.4354303996141771
STAT,1868,80,na,1948,557.566888508068
STAT,1897,21,15-19,1918,4.180512173544802
SIM,1892,2,na,1894,3468
STAT,1848,25,40-44,1873,2.6958508708270497
STAT,1907,17,15-19,1924,8.235540346461178
SIM,1905,58,na,1963,2782
SIM,1925,27,40-44,1952,7
STAT,1876,26,30-34,1902,24.66199903012107
STAT,1848,28,20-24,1876,10.331908933842682
STAT,1864,44,40-44,1908,1.8682636825110621
SIM,1889,70,na,1959,1712
STAT,1824,39,15-19,1863,0.07957558501484387
STAT,1870,53,25-29,1923,0.0032298947464664686
STAT,1858,36,20-24,1894,0.5737015201512817
SIM,1868,20,15-19,1888,3
STAT,1787,104,na,1891,0.024582309040696138
STAT,1855,36,na,1891,1682.2783428720568
SIM,1862,23,15-19,1885,4
STAT,1919,35,35-39,1954,2.4684622810813286
SIM,1836,22,20-24,1858,53
STAT,1881,37,35-39,1918,6.454794109591955
SIM,1830,90,na,1920,38
STAT,1821,36,25-29,1857,6.4026309744895125
SIM,1872,44,40-44,1916,2
STAT,1843,46,50-100,1889,0.16724535600657595
STAT,1906,38,20-24,1944,0.2277887325238173
STAT,1871,18,35-39,1889,0.5150018232456103
STAT,1940,25,45-49,1965,1.6657055427710703
SIM,1879,37,45-49,1916,5
STAT,1864,72,na,1936,1063.3218744495907
STAT,1908,46,15-19,1954,3.1709825978428017E-4
STAT,1823,43,40-44,1866,2.9193868994345866
STAT,1901,22,na,1923,3127.4027238222984
SIM,1901,37,40-44,1938,2
STAT,1885,45,25-29,1930,0.05477940544552832
SIM,1928,3,na,1931,4823
STAT,1919,22,15-19,1941,5.50659436858995
STAT,1844,107,na,1951,0.0032753415912651538
STAT,1880,37,na,1917,2346.3997958294653
SIM,1884,45,na,1929,2234
STAT,1888,42,30-34,1930,1.2819647933447347
STAT,1805,51,35-39,1856,0.032240494197639684
STAT,1866,45,15-19,1911,3.5200291121200865E-4
STAT,1869,48,35-39,1917,0.1265166089301791
STAT,1790,70,na,1860,610.0485368255106
SIM,1858,39,35-39,1897,8
SIM,1917,43,na,1960,3627
STAT,1886,48,35-39,1934,0.13795202581568872
SIM,1866,23,45-49,1889,1
SIM,1877,26,30-34,1903,29
STAT,1873,27,50-100,1900,0.6128985345353806
STAT,1814,48,na,1862,1393.4685635754397
STAT,1870,31,20-24,1901,2.5153275796288863
STAT,1901,35,50-100,1936,0.3537452227342414
STAT,1858,23,45-49,1881,0.5353968422418988
STAT,1815,95,na,1910,5.934586885022904
STAT,1818,54,25-29,1872,0.006966413333159379
STAT,1890,34,40-44,1924,4.965876316143317
STAT,1923,38,20-24,1961,0.2882534011337329
STAT,1938,22,25-29,1960,86.36358431266746
SIM,1932,17,15-19,1949,53
STAT,1918,19,40-44,1937,1.430522835040291
SIM,1856,28,20-24,1884,9
SIM,1836,35,40-44,1871,3
STAT,1848,66,na,1914,1217.8796412785837
SIM,1888,21,15-19,1909,3
STAT,1841,51,45-49,1892,0.010052901559561931
SIM,1884,26,30-34,1910,24
STAT,1867,26,20-24,1893,10.442426092250619
STAT,1928,19,40-44,1947,1.6559780107806825
STAT,1890,27,35-39,1917,11.144182519932752
STAT,1895,26,40-44,1921,3.7019934203398916
STAT,1798,90,na,1888,31.5677122419981
STAT,1917,37,na,1954,3691.599675055975
STAT,1932,26,50-100,1958,1.232142066683372
SIM,1904,39,na,1943,3261
STAT,1811,106,na,1917,0.005265762145423439
STAT,1861,41,20-24,1902,0.12531003896242332
STAT,1838,51,30-34,1889,0.004054580090596742
SIM,1835,68,na,1903,959
STAT,1796,61,na,1857,917.6520561277017
SIM,1831,43,40-44,1874,9
STAT,1854,18,35-39,1872,0.46686895007961887
SIM,1873,43,50-100,1916,1
STAT,1903,40,25-29,1943,0.060544190519448766
STAT,1884,37,20-24,1921,0.7194492355677419
SIM,1847,32,50-100,1879,3
STAT,1853,7,na,1860,2253.2972902416004
SIM,1876,18,20-24,1894,12
STAT,1840,36,35-39,1876,5.5472499081961075
STAT,1868,18,20-24,1886,16.17297052939974
STAT,1824,51,45-49,1875,0.017373145839380943
SIM,1927,22,15-19,1949,5
STAT,1879,40,na,1919,2308.5847998045115
STAT,1835,54,25-29,1889,0.0022082255101215924
STAT,1857,15,40-44,1872,0.16207243074476702
STAT,1873,89,na,1962,196.73992327123528
STAT,1875,23,45-49,1898,0.6750172102744604
STAT,1897,43,na,1940,2908.8977596422324
STAT,1865,38,na,1903,2007.337546074342
STAT,1817,46,20-24,1863,0.027480308631685737
STAT,1913,27,40-44,1940,4.387607559820117
SIM,1766,91,na,1857,5
SIM,1868,36,30-34,1904,6
SIM,1863,42,35-39,1905,5
STAT,1839,38,20-24,1877,0.6069805095834551
SIM,1921,27,40-44,1948,5
STAT,1891,42,45-49,1933,1.7470913513926745
SIM,1853,28,35-39,1881,10
STAT,1867,55,na,1922,1834.2233283807411
SIM,1953,15,25-29,1968,53
SIM,1883,20,40-44,1903,2
STAT,1932,28,20-24,1960,22.575498853966153
STAT,1899,21,40-44,1920,2.7054311050123125
STAT,1861,18,35-39,1879,0.4924713851666242
STAT,1810,104,na,1914,0.02821671627488426
STAT,1908,48,40-44,1956,0.1343285230565036
SIM,1872,20,na,1892,2257
STAT,1846,53,na,1899,1571.3709230906009
STAT,1906,25,15-19,1931,0.6284861760590861
SIM,1852,15,30-34,1867,1
STAT,1836,54,50-100,1890,0.009511369347921185
SIM,1949,0,na,1949,4423
STAT,1851,30,40-44,1881,3.3150659181026376
STAT,1849,42,na,1891,1730.9909827396418
STAT,1869,29,35-39,1898,8.767483577959734
STAT,1850,39,na,1889,1652.4077219768337
STAT,1845,35,40-44,1880,3.6516126392827903
SIM,1911,34,30-34,1945,23
STAT,1881,32,35-39,1913,9.242026270938872
STAT,1803,54,na,1857,1098.5740565206304
STAT,1841,47,50-100,1888,0.17008716087239217
SIM,1825,60,na,1885,1097
SIM,1940,28,20-24,1968,15
SIM,1890,33,na,1923,2969
STAT,1859,52,20-24,1911,5.51880922618775E-4
SIM,1908,35,25-29,1943,1
STAT,1902,57,na,1959,2759.328591353708
STAT,1819,54,30-34,1873,0.010402312768586101
SIM,1894,23,na,1917,2983
SIM,1897,12,na,1909,3344
STAT,1814,41,35-39,1855,6.705315516644954
STAT,1823,36,35-39,1859,12.15403297552107
STAT,1925,41,15-19,1966,0.0017588985177782583
SIM,1844,98,na,1942,1
STAT,1859,15,15-19,1874,5.241159895615962
STAT,1856,23,50-100,1879,0.34658127373736564
STAT,1876,19,25-29,1895,5.501093857867137
STAT,1810,49,30-34,1859,0.3125646516219413
STAT,1845,28,35-39,1873,8.251052933392588
SIM,1859,94,na,1953,10
SIM,1787,93,na,1880,2
SIM,1785,92,na,1877,6
SIM,1814,66,na,1880,787
SIM,1949,17,25-29,1966,60
SIM,1874,77,na,1951,774
STAT,1873,22,40-44,1895,1.9965274026148603
SIM,1899,13,na,1912,3421
SIM,1926,19,40-44,1945,1
STAT,1845,52,na,1897,1515.532419817055
SIM,1860,35,na,1895,1978
STAT,1929,43,40-44,1972,0.305510655941441
SIM,1831,36,35-39,1867,15
STAT,1851,46,20-24,1897,0.008656624022874381
STAT,1866,30,40-44,1896,3.809047055374014
STAT,1945,15,25-29,1960,44.74390863684292
SIM,1904,27,40-44,1931,4
STAT,1909,19,30-34,1928,2.246053169267812
SIM,1822,41,35-39,1863,3
SIM,1877,51,na,1928,2084
SIM,1934,37,na,1971,4821
SIM,1882,38,na,1920,2206
SIM,1930,25,na,1955,4505
SIM,1856,83,na,1939,268
STAT,1895,38,35-39,1933,8.667794315505107
STAT,1883,45,15-19,1928,3.741786120647084E-4
STAT,1904,33,25-29,1937,7.9358670024833255
STAT,1845,44,30-34,1889,0.8074833643098575
STAT,1828,47,50-100,1875,0.19886613331956224
STAT,1829,28,na,1857,1710.8194235676892
STAT,1773,110,na,1883,0.0016557400583704094
SIM,1915,42,na,1957,3391
STAT,1822,49,na,1871,1290.8069617542485
STAT,1866,44,45-49,1910,1.2864522068038835
SIM,1853,44,30-34,1897,4
STAT,1941,28,30-34,1969,38.27301517148325
STAT,1873,8,na,1881,2585.485189148289
STAT,1923,44,15-19,1967,0.0016899707662765232
SIM,1912,33,25-29,1945,7
STAT,1828,47,35-39,1875,0.11336017406057262
STAT,1844,15,30-34,1859,1.4238854971382287
SIM,1874,44,45-49,1918,4
SIM,1917,19,30-34,1936,13
STAT,1935,10,na,1945,5132.55403205043
STAT,1817,39,15-19,1856,0.16558671460079422
SIM,1849,37,50-100,1886,2
SIM,1819,97,na,1916,2
STAT,1914,42,na,1956,3476.6316578115247
SIM,1914,21,35-39,1935,10
STAT,1887,18,30-34,1905,1.6798041686947032
STAT,1889,26,40-44,1915,3.505580051608258
SIM,1842,32,na,1874,1774
STAT,1901,22,50-100,1923,0.539238319395967
SIM,1859,104,na,1963,1
STAT,1886,29,35-39,1915,9.559947354839492
SIM,1836,69,na,1905,935
SIM,1875,26,20-24,1901,13
SIM,1827,38,35-39,1865,14
SIM,1828,27,30-34,1855,17
SIM,1845,23,15-19,1868,6
SIM,1932,27,50-100,1959,1
SIM,1933,36,na,1969,4896
STAT,1915,38,30-34,1953,1.730748934725329
STAT,1825,49,15-19,1874,3.9689189556215803E-4
STAT,1884,27,na,1911,2227.3915790981987
STAT,1921,30,50-100,1951,0.8761912894805952
STAT,1806,96,na,1902,2.9777107863347587
STAT,1852,25,30-34,1877,21.572807173682627
STAT,1777,82,na,1859,137.50917209127488
STAT,1822,51,35-39,1873,0.011364653118611536
STAT,1903,34,30-34,1937,13.36025116955874
SIM,1832,79,na,1911,390
SIM,1866,20,40-44,1886,2
STAT,1837,23,15-19,1860,2.7827289869364114
STAT,1843,36,20-24,1879,0.6141774607604236
STAT,1882,16,45-49,1898,0.06016018131835262
SIM,1860,25,30-34,1885,22
SIM,1943,9,na,1952,3842
STAT,1842,47,25-29,1889,0.04171986946108112
STAT,1910,37,50-100,1947,0.37935121437330416
STAT,1923,25,na,1948,4090.6406433840266
STAT,1924,0,na,1924,5068.043776235829
SIM,1936,22,25-29,1958,77
SIM,1865,66,na,1931,1421
SIM,1804,98,na,1902,2
SIM,1918,47,na,1965,3698
STAT,1804,52,na,1856,1160.802010509262
STAT,1885,16,30-34,1901,1.5045430450818573
STAT,1927,15,na,1942,4343.476158290327
STAT,1928,22,25-29,1950,108.94683886626059
STAT,1928,38,40-44,1966,1.785398389608728
SIM,1917,22,20-24,1939,106
STAT,1841,109,na,1950,4.904888447215644E-4
STAT,1926,15,15-19,1941,52.80758916607669
STAT,1911,40,15-19,1951,0.0014004064433330004
STAT,1840,29,50-100,1869,0.5159435769374416
SIM,1864,36,50-100,1900,1
SIM,1877,23,20-24,1900,62
SIM,1897,26,40-44,1923,4
STAT,1842,44,15-19,1886,0.01008519126218643
STAT,1850,35,50-100,1885,0.8976187148625027
SIM,1862,37,35-39,1899,13
SIM,1859,72,na,1931,960
STAT,1875,6,na,1881,2642.9886032577415
SIM,1867,15,15-19,1882,7
SIM,1810,76,na,1886,371
STAT,1854,22,30-34,1876,14.974247710653124
SIM,1885,80,na,1965,826
STAT,1838,25,50-100,1863,0.554234015540292
STAT,1864,50,na,1914,1838.9586674919485
STAT,1909,22,20-24,1931,97.63388133590993
STAT,1864,37,35-39,1901,5.95520029730238
STAT,1889,42,50-100,1931,1.2305752445169125
STAT,1837,57,na,1894,1304.218216585925
STAT,1862,24,na,1886,1927.565434343812
STAT,1759,108,na,1867,0.002045064086439778
STAT,1825,38,na,1863,1502.5662472260522
STAT,1871,37,35-39,1908,6.634911708266846
STAT,1819,38,35-39,1857,18.18743579786936
STAT,1871,25,40-44,1896,2.8291198564568187
SIM,1852,93,na,1945,13
SIM,1894,29,35-39,1923,14
STAT,1906,21,35-39,1927,8.053299676426109
SIM,1862,22,30-34,1884,19
SIM,1895,18,30-34,1913,1
STAT,1827,53,20-24,1880,6.388683038505964E-4
STAT,1867,19,50-100,1886,0.04390694066237625
STAT,1813,66,na,1879,801.7711644491554
STAT,1877,20,15-19,1897,3.252116851249536
STAT,1816,46,50-100,1862,0.589306493080155
STAT,1948,9,na,1957,4248.55008823202
STAT,1871,15,30-34,1886,1.5227057481589843
STAT,1912,16,na,1928,3698.720920574616
SIM,1877,69,na,1946,1398
STAT,1890,25,50-100,1915,0.7438352588646957
SIM,1901,27,30-34,1928,38
STAT,1867,22,40-44,1889,1.8561161365025132
STAT,1910,49,35-39,1959,0.11297619991475052
STAT,1923,48,30-34,1971,0.09824242403291858
SIM,1858,29,25-29,1887,36
STAT,1814,104,na,1918,0.030657074740374334
SIM,1854,17,30-34,1871,4
STAT,1898,19,45-49,1917,0.08306172638804564
STAT,1881,84,na,1965,536.664556555008
STAT,1812,81,na,1893,234.9013237461278
SIM,1820,35,na,1855,1602
STAT,1852,65,na,1917,1225.1996008681922
STAT,1830,33,30-34,1863,14.731166708776236
STAT,1900,17,20-24,1917,23.233319638981303
SIM,1833,40,40-44,1873,5
STAT,1854,37,35-39,1891,5.0605693820889055
STAT,1909,43,50-100,1952,0.10318729337437803
STAT,1939,18,na,1957,3479.4935616254493
SIM,1900,43,na,1943,3074
SIM,1862,52,na,1914,1840
STAT,1899,48,20-24,1947,0.008651718811794516
STAT,1930,23,25-29,1953,111.43932702804959
STAT,1888,33,40-44,1921,4.821287342458257
SIM,1758,96,na,1854,1
STAT,1894,44,20-24,1938,0.01320817995736011
SIM,1934,15,15-19,1949,58
STAT,1915,28,50-100,1943,0.9557299489506159
SIM,1896,33,40-44,1929,8
STAT,1846,17,30-34,1863,1.485055623358556
SIM,1868,39,35-39,1907,12
SIM,1922,32,40-44,1954,3
STAT,1828,32,30-34,1860,18.115621794884152
STAT,1862,37,25-29,1899,2.3255809244181633
STAT,1890,37,45-49,1927,2.302409001473467
STAT,1926,25,25-29,1951,75.04296242949225
STAT,1840,62,na,1902,1199.4625548935703
STAT,1838,54,40-44,1892,0.0068735518225356744
STAT,1870,34,25-29,1904,9.411178593814943
STAT,1848,104,na,1952,0.0495620007338167
SIM,1887,10,na,1897,2697
SIM,1927,25,25-29,1952,80
STAT,1878,24,15-19,1902,3.227624339744525
SIM,1927,21,na,1948,4226
SIM,1886,24,15-19,1910,2
STAT,1818,51,20-24,1869,0.00154084915489365
STAT,1823,46,45-49,1869,0.29487899810221874
STAT,1874,49,na,1923,2126.257636267927
STAT,1858,20,40-44,1878,1.7965844557427402
SIM,1875,22,40-44,1897,2
SIM,1889,76,na,1965,1348
SIM,1923,38,30-34,1961,4
STAT,1840,31,35-39,1871,8.179230180806512
SIM,1882,18,20-24,1900,20
SIM,1944,24,40-44,1968,5
SIM,1923,19,30-34,1942,12
SIM,1935,19,na,1954,4660
SIM,1896,23,30-34,1919,25
STAT,1895,23,30-34,1918,21.86979759401752
STAT,1936,24,40-44,1960,3.034642387274544
STAT,1850,21,na,1871,1822.12290394974
SIM,1867,26,30-34,1893,30
STAT,1888,23,30-34,1911,19.82504246184902
STAT,1914,32,40-44,1946,3.7213956029175073
STAT,1885,42,20-24,1927,0.14936115563269148
SIM,1926,15,25-29,1941,57
SIM,1934,25,25-29,1959,81
STAT,1907,44,50-100,1951,0.10043253654418764
STAT,1940,22,40-44,1962,3.2357712235302554
STAT,1797,65,na,1862,806.2848388805731
SIM,1826,51,na,1877,1280
SIM,1886,29,45-49,1915,3
SIM,1921,11,na,1932,4298
STAT,1858,39,25-29,1897,2.1111046599714323
STAT,1915,19,30-34,1934,2.3970870048309476
STAT,1901,37,30-34,1938,1.5211460731344493
STAT,1838,54,35-39,1892,0.005620895194942537
STAT,1838,107,na,1945,0.0031660562844701688
SIM,1855,32,40-44,1887,7
STAT,1918,15,25-29,1933,8.981497998628555
SIM,1871,72,na,1943,1129
STAT,1853,43,20-24,1896,0.1193208685518869
STAT,1886,45,30-34,1931,0.09756076374571887
STAT,1844,41,20-24,1885,0.11442158803963343
SIM,1942,10,na,1952,3823
STAT,1902,29,30-34,1931,33.333345701498914
SIM,1819,38,45-49,1857,4
SIM,1829,32,30-34,1861,24
STAT,1794,100,na,1894,0.19996615122439476
STAT,1919,25,25-29,1944,67.64079033343597
STAT,1846,21,50-100,1867,0.3758923929844331
STAT,1871,20,na,1891,2231.82393595776
STAT,1889,48,na,1937,2591.400225898277
SIM,1836,32,30-34,1868,15
SIM,1864,26,45-49,1890,1
SIM,1884,22,15-19,1906,5
STAT,1864,47,45-49,1911,0.19777896618333207
STAT,1904,64,na,1968,2629.783374102794
STAT,1952,15,25-29,1967,49.084806281819965
STAT,1902,16,40-44,1918,0.24445101213351417
SIM,1835,84,na,1919,190
STAT,1817,49,25-29,1866,0.12584220861993756
STAT,1934,38,40-44,1972,1.9495714111397968
STAT,1857,18,45-49,1875,0.056866216769813065
STAT,1847,32,40-44,1879,3.754772764037942
SIM,1868,55,na,1923,1862
SIM,1910,29,30-34,1939,44
STAT,1857,77,na,1934,644.02487017726
SIM,1834,25,20-24,1859,13
SIM,1848,54,na,1902,1493
STAT,1833,50,40-44,1883,0.006925943615573086
SIM,1901,28,na,1929,3127
STAT,1829,52,35-39,1881,0.006185402692060237
SIM,1937,26,na,1963,3335
SIM,1811,52,na,1863,1137
SIM,1885,27,na,1912,2275
STAT,1904,28,45-49,1932,1.4992274288256824
SIM,1912,28,45-49,1940,2
STAT,1918,19,na,1937,3764.4617120206667
STAT,1955,1,na,1956,4937.495471079619
SIM,1904,19,20-24,1923,22
SIM,1902,46,50-100,1948,3
STAT,1800,96,na,1896,3.413480043575515
STAT,1825,40,40-44,1865,2.5640105047584827
STAT,1878,29,45-49,1907,1.085303589155355
SIM,1891,49,na,1940,2606
SIM,1901,10,na,1911,3417
STAT,1823,90,na,1913,42.19398512051139
STAT,1856,26,45-49,1882,0.8541617050033184
SIM,1929,32,35-39,1961,9
STAT,1883,48,25-29,1931,0.05267954630151181
SIM,1889,54,na,1943,2502
STAT,1892,31,40-44,1923,5.15239138857926
STAT,1893,16,20-24,1909,21.291434943269458
STAT,1896,43,35-39,1939,0.15575887727869656
STAT,1912,38,45-49,1950,0.6254734409404645
SIM,1893,78,na,1971,1523
SIM,1807,87,na,1894,49
SIM,1873,28,20-24,1901,16
STAT,1825,54,na,1879,1218.7715906290937
SIM,1936,15,25-29,1951,46
STAT,1784,106,na,1890,0.012256856328912501
SIM,1934,19,30-34,1953,19
SIM,1767,95,na,1862,1
SIM,1888,24,40-44,1912,2
STAT,1852,31,na,1883,1809.9494375222785
STAT,1869,33,30-34,1902,15.911517992169689
SIM,1945,15,35-39,1960,9
SIM,1943,3,na,1946,3912
STAT,1906,44,15-19,1950,0.001301657878038924
SIM,1947,23,45-49,1970,1
STAT,1866,33,45-49,1899,1.5130174604552886
SIM,1887,44,na,1931,2364
SIM,1831,43,35-39,1874,7
STAT,1919,32,25-29,1951,9.420236544372052
STAT,1851,37,25-29,1888,2.093309616288657
STAT,1832,33,40-44,1865,3.3854252587525226
SIM,1872,25,35-39,1897,9
STAT,1888,31,15-19,1919,0.15964053036943265
STAT,1936,8,na,1944,3607.2024704365354
SIM,1870,35,35-39,1905,4
STAT,1864,25,35-39,1889,8.210960031964474
SIM,1820,54,na,1874,1269
SIM,1813,81,na,1894,220
STAT,1915,27,15-19,1942,0.6802470013048207
STAT,1856,38,20-24,1894,0.5653574500695611
STAT,1914,28,50-100,1942,0.9446054289056197
STAT,1851,86,na,1937,159.60507069953303
SIM,1849,32,40-44,1881,5
SIM,1857,12,na,1869,2236
STAT,1880,50,20-24,1930,7.454807458581276E-4
STAT,1878,28,30-34,1906,24.704830852694574
SIM,1782,87,na,1869,39
STAT,1895,35,30-34,1930,6.626239228022134
STAT,1879,43,50-100,1922,1.0371502957997059
STAT,1954,18,50-100,1972,0.43737221267165566
STAT,1840,46,na,1886,1508.1056247897973
STAT,1943,26,15-19,1969,0.7105836441020315
STAT,1845,38,50-100,1883,0.9033962058904913
STAT,1814,50,30-34,1864,0.018102417337522554
STAT,1844,17,20-24,1861,15.6517883867177
SIM,1840,21,40-44,1861,1
SIM,1868,33,20-24,1901,2
STAT,1873,27,35-39,1900,9.244777970804096
STAT,1874,34,na,1908,2283.6031365378626
SIM,1877,33,30-34,1910,18
SIM,1886,28,30-34,1914,29
SIM,1779,80,na,1859,198
STAT,1905,45,45-49,1950,0.18359186779553432
STAT,1920,34,30-34,1954,16.16314822214716
SIM,1944,22,15-19,1966,5
STAT,1870,43,50-100,1913,0.9720060632531933
SIM,1875,59,na,1934,1839
STAT,1909,29,40-44,1938,4.178256713092553
SIM,1875,29,25-29,1904,48
SIM,1889,27,50-100,1916,1
SIM,1906,1,na,1907,3649
SIM,1840,33,40-44,1873,3
SIM,1923,15,15-19,1938,43
STAT,1901,21,15-19,1922,4.375608082022806
STAT,1910,33,25-29,1943,8.383719291408564
STAT,1902,19,45-49,1921,0.08662297118288446
SIM,1819,37,30-34,1856,4
SIM,1837,94,na,1931,10
SIM,1852,17,20-24,1869,15
STAT,1847,37,50-100,1884,0.9393371748713103
STAT,1833,31,50-100,1864,0.7313524448243774
STAT,1925,34,50-100,1959,0.926292571321976
STAT,1928,22,30-34,1950,33.89940093083913
SIM,1862,61,na,1923,1604
STAT,1862,49,na,1911,1779.2955480262567
SIM,1831,38,50-100,1869,1
SIM,1794,72,na,1866,464
STAT,1812,42,20-24,1854,0.606776432159189
STAT,1869,45,30-34,1914,0.08947354647939491
STAT,1783,97,na,1880,0.8092512371801286
SIM,1936,22,30-34,1958,25
STAT,1836,94,na,1930,12.94231578801194
SIM,1862,103,na,1965,2
STAT,1845,38,45-49,1883,1.4668449939057688
STAT,1849,67,na,1916,1188.704129360451
SIM,1827,32,20-24,1859,3
STAT,1929,36,50-100,1965,0.509658077144644
SIM,1884,29,35-39,1913,13
STAT,1838,35,35-39,1873,5.850060554961308
STAT,1835,21,15-19,1856,2.8112644003090512
SIM,1868,52,na,1920,1927
SIM,1881,27,35-39,1908,10
STAT,1932,34,15-19,1966,0.1611709957532198
SIM,1918,34,40-44,1952,5
STAT,1888,45,40-44,1933,0.19304147763262408
STAT,1855,32,30-34,1887,12.633232839744455
STAT,1824,39,20-24,1863,1.0923556204954694
SIM,1904,38,50-100,1942,1
STAT,1837,27,30-34,1864,20.976522954644494
STAT,1919,44,25-29,1963,0.07286190500903726
STAT,1871,27,25-29,1898,39.68179115387914
STAT,1871,28,45-49,1899,1.0378783661910516
STAT,1889,29,45-49,1918,1.2856415490542938
STAT,1903,30,15-19,1933,0.19295623722532976
STAT,1926,11,na,1937,4595.988580521204
STAT,1870,50,20-24,1920,6.937026917790149E-4
STAT,1916,45,20-24,1961,0.010758425629830851
STAT,1847,48,15-19,1895,2.9125643251032366E-4
SIM,1894,23,20-24,1917,69
SIM,1843,21,15-19,1864,2
STAT,1889,19,50-100,1908,0.05683060270173994
STAT,1923,21,35-39,1944,10.381027908490251
STAT,1886,23,20-24,1909,68.5559990375653
SIM,1931,21,35-39,1952,10
STAT,1937,15,35-39,1952,3.874322757086362
SIM,1917,29,40-44,1946,6
SIM,1845,27,30-34,1872,35
SIM,1937,32,25-29,1969,12
STAT,1815,49,15-19,1864,8.736922390872308E-4
SIM,1847,23,40-44,1870,2
STAT,1823,43,35-39,1866,2.3502968969085947
STAT,1869,26,30-34,1895,23.125297483966005
STAT,1805,50,50-100,1855,0.05770375108984415
STAT,1868,54,20-24,1922,6.468275183623538E-4
SIM,1862,34,30-34,1896,26
STAT,1926,19,30-34,1945,14.041477677958211
SIM,1869,45,50-100,1914,2
SIM,1846,35,35-39,1881,11
SIM,1906,4,na,1910,3596
SIM,1922,9,na,1931,4323
SIM,1927,32,25-29,1959,11
STAT,1862,46,na,1908,1822.3975694982396
STAT,1882,63,na,1945,1639.2677253119873
STAT,1870,59,na,1929,1801.1273328951784
STAT,1857,54,45-49,1911,0.010515293309788405
SIM,1897,29,45-49,1926,1
SIM,1914,29,30-34,1943,49
STAT,1886,35,20-24,1921,0.7765436615614305
STAT,1899,25,50-100,1924,0.8336371025995047
STAT,1825,32,50-100,1857,1.602772146873057
STAT,1917,36,15-19,1953,0.01893366793840416
SIM,1829,42,40-44,1871,7
SIM,1845,27,na,1872,1857
SIM,1863,32,30-34,1895,21
STAT,1838,47,35-39,1885,0.09669788799046103
STAT,1933,2,na,1935,5172.050730444
SIM,1877,38,25-29,1915,2
STAT,1890,34,35-39,1924,11.596275029599855
STAT,1847,30,15-19,1877,0.12588535471760476
STAT,1903,21,50-100,1924,0.5497872557593845
STAT,1863,15,40-44,1878,0.17508023329273015
STAT,1869,38,25-29,1907,2.6219412263568387
STAT,1871,43,50-100,1914,0.9838692847071964
STAT,1787,87,na,1874,54.84754912042068
STAT,1891,18,20-24,1909,20.666486431636883
SIM,1846,46,50-100,1892,3
STAT,1840,40,30-34,1880,0.8873166137074476
STAT,1819,44,20-24,1863,0.31156131002214926
STAT,1910,46,30-34,1956,0.07877088769469238
STAT,1939,23,45-49,1962,1.067151743052646
SIM,1807,72,na,1879,513
SIM,1834,21,40-44,1855,2
SIM,1966,4,na,1970,4458
STAT,1970,1,na,1971,4655.788885247628
SIM,1870,22,20-24,1892,59
SIM,1819,75,na,1894,554
STAT,1888,38,35-39,1926,7.857383664239722
SIM,1854,57,na,1911,1623
SIM,1906,37,50-100,1943,1
STAT,1841,27,20-24,1868,10.045440543915857
STAT,1857,96,na,1953,6.397583577970798
STAT,1839,23,40-44,1862,1.7698402976429117
SIM,1821,33,30-34,1854,17
SIM,1858,26,20-24,1884,11
STAT,1833,41,45-49,1874,1.12703441054153
SIM,1853,22,20-24,1875,62
SIM,1903,35,40-44,1938,1
STAT,1884,73,na,1957,1169.7994171346004
SIM,1857,15,na,1872,2181
STAT,1893,19,25-29,1912,6.752489935057649
STAT,1799,75,na,1874,402.731512511545
STAT,1925,44,25-29,1969,0.0813992611683816
SIM,1843,28,35-39,1871,13
STAT,1882,44,na,1926,2094.7099489779275
STAT,1800,62,na,1862,904.0930865258729
STAT,1916,32,15-19,1948,0.12533412979125508
SIM,1857,31,na,1888,1902
STAT,1935,28,na,1963,4821.734601065657
STAT,1845,34,20-24,1879,2.2275387538952423
SIM,1779,83,na,1862,102
SIM,1832,54,na,1886,1233
STAT,1929,32,25-29,1961,11.090493263598889
STAT,1815,79,na,1894,312.0521145589086
STAT,1920,11,na,1931,4205.80605984933
SIM,1914,33,35-39,1947,12
STAT,1862,22,20-24,1884,56.98046533012565
SIM,1792,62,na,1854,833
STAT,1861,20,50-100,1881,0.3338480132854521
STAT,1865,29,na,1894,2028.8938665723367
STAT,1896,40,30-34,1936,0.1006144617145147
STAT,1879,36,35-39,1915,7.027886025964392
SIM,1896,38,35-39,1934,13
SIM,1860,28,35-39,1888,10
SIM,1869,24,15-19,1893,2
STAT,1902,38,na,1940,3150.1455123939263
SIM,1867,28,20-24,1895,13
STAT,1841,39,15-19,1880,0.044674778522954345
STAT,1866,45,20-24,1911,0.010560096625372882
STAT,1900,23,15-19,1923,4.310026471469929
SIM,1853,34,20-24,1887,4
STAT,1821,34,35-39,1855,27.148706265454376
STAT,1850,29,20-24,1879,9.592623521659963
STAT,1871,22,30-34,1893,16.709209399586577
STAT,1886,59,na,1945,1939.403067101048
SIM,1882,1,na,1883,3012
STAT,1870,75,na,1945,954.0655977072333
SIM,1912,37,40-44,1949,2
STAT,1850,50,35-39,1900,0.006155937299804796
SIM,1907,18,25-29,1925,6
STAT,1895,36,na,1931,2915.5840639177923
STAT,1852,28,35-39,1880,8.089260262861174
STAT,1832,37,15-19,1869,0.0429184924937312
STAT,1842,43,45-49,1885,1.107075598674573
SIM,1844,64,na,1908,1139
STAT,1836,32,20-24,1868,2.2125610128079316
SIM,1850,43,45-49,1893,2
SIM,1903,23,40-44,1926,2
SIM,1906,59,na,1965,2845
SIM,1905,31,35-39,1936,6
STAT,1871,24,20-24,1895,64.24021331527338
STAT,1915,15,15-19,1930,9.01503307911541
STAT,1945,19,40-44,1964,1.4424516092233823
SIM,1864,16,na,1880,2289
SIM,1908,29,30-34,1937,39
STAT,1832,26,35-39,1858,8.01632932324621
STAT,1936,22,15-19,1958,4.807623985756385
STAT,1793,75,na,1868,368.52822323600617
SIM,1891,3,na,1894,3110
STAT,1830,84,na,1914,200.7774773833967
STAT,1877,14,na,1891,2522.4973694524015
SIM,1881,22,40-44,1903,2
STAT,1837,25,40-44,1862,2.531527006575288
STAT,1883,44,45-49,1927,1.3674969322612711
STAT,1907,23,50-100,1930,0.5641533986377989
STAT,1897,39,20-24,1936,0.20808717615935574
STAT,1851,83,na,1934,285.5697999447679
SIM,1780,77,na,1857,287
STAT,1859,28,20-24,1887,8.908595882398105
STAT,1922,43,50-100,1965,0.12718428392266737
SIM,1887,36,35-39,1923,16
STAT,1850,17,20-24,1867,15.271448017434867
STAT,1892,35,20-24,1927,0.9207695797676465
SIM,1822,61,na,1883,1034
STAT,1856,15,na,1871,2024.3611463545906
STAT,1864,44,35-39,1908,1.504074138464894
STAT,1807,51,45-49,1858,0.0542611369431014
STAT,1945,22,25-29,1967,95.63656132436934
SIM,1919,25,35-39,1944,24
STAT,1825,44,20-24,1869,0.16525490749328647
STAT,1932,15,15-19,1947,57.03394995241182
SIM,1883,60,na,1943,1701
STAT,1904,37,40-44,1941,1.2803189739359546
STAT,1871,23,na,1894,2211.7311523556573
STAT,1769,102,na,1871,0.0634976175895273
STAT,1919,29,40-44,1948,4.723682840139141
SIM,1866,42,na,1908,2065
STAT,1833,53,45-49,1886,0.00899671179065729
STAT,1813,69,na,1882,716.9194431825205
SIM,1814,43,40-44,1857,8
STAT,1883,20,50-100,1903,0.3799545067949049
SIM,1927,29,40-44,1956,6
SIM,1872,44,35-39,1916,2
SIM,1940,15,15-19,1955,39
SIM,1912,25,40-44,1937,6
STAT,1879,48,35-39,1927,0.13670271586886637
STAT,1902,25,15-19,1927,0.6089942645771507
STAT,1934,1,na,1935,5336.159954055165
SIM,1845,25,40-44,1870,3
STAT,1921,25,40-44,1946,4.940728402353726
STAT,1926,14,na,1940,4574.283763383501
SIM,1877,66,na,1943,1558
SIM,1934,15,na,1949,4612
STAT,1845,22,20-24,1867,60.53794050448555
SIM,1856,67,na,1923,1224
SIM,1840,26,35-39,1866,11
STAT,1847,47,45-49,1894,0.17321678105872423
SIM,1913,16,na,1929,3619
SIM,1882,81,na,1963,664
SIM,1945,21,na,1966,3610
STAT,1826,28,25-29,1854,134.9839022428783
STAT,1877,46,35-39,1923,0.13758036157957185
STAT,1896,3,na,1899,3298.433118770877
STAT,1941,17,15-19,1958,44.16022612543284
STAT,1876,16,20-24,1892,17.345628518970518
STAT,1816,53,45-49,1869,0.03216870811604794
STAT,1931,35,45-49,1966,0.8543775201127919
SIM,1881,34,40-44,1915,4
STAT,1904,25,40-44,1929,4.0866966943356395
STAT,1888,49,15-19,1937,2.4664805572497425E-4
STAT,1935,19,40-44,1954,1.7966796379052465
SIM,1943,19,40-44,1962,1
STAT,1880,53,25-29,1933,0.0034709744868715374
SIM,1786,68,na,1854,696
STAT,1825,32,na,1857,1546.1451770892113
STAT,1901,34,20-24,1935,3.543765361976409
SIM,1843,17,na,1860,2135
STAT,1947,13,na,1960,4179.610595898739
SIM,1834,28,25-29,1862,40
SIM,1860,45,50-100,1905,2
STAT,1890,15,35-39,1905,0.6366847535859401
STAT,1873,34,40-44,1907,4.119496777005099
STAT,1832,36,45-49,1868,1.5401735087958996
SIM,1882,42,45-49,1924,1
STAT,1836,45,35-39,1881,0.09734029286825518
STAT,1930,27,40-44,1957,5.598827781432913
SIM,1866,45,na,1911,2025
SIM,1827,42,30-34,1869,4
SIM,1831,24,35-39,1855,9
STAT,1857,51,40-44,1908,0.007881270298902657
SIM,1872,22,30-34,1894,19
STAT,1829,90,na,1919,47.63827393797419
STAT,1842,30,50-100,1872,0.8183796246734603
STAT,1886,33,30-34,1919,17.349707357663682
STAT,1885,28,50-100,1913,0.6002419097671768
SIM,1829,50,na,1879,1330
SIM,1788,94,na,1882,2
STAT,1901,40,15-19,1941,0.0012808988295563617
SIM,1888,27,45-49,1915,2
STAT,1851,39,15-19,1890,0.03998783710439607
STAT,1830,53,50-100,1883,0.0097578473748661
STAT,1886,38,25-29,1924,2.8589298022144276
SIM,1887,43,40-44,1930,4
SIM,1944,20,25-29,1964,93
SIM,1843,15,20-24,1858,11
STAT,1854,37,50-100,1891,0.8784315597890846
SIM,1871,75,na,1946,885
STAT,1883,48,na,1931,2057.6491714979798
STAT,1886,37,na,1923,2351.0540960448725
STAT,1926,17,40-44,1943,1.6200049291541727
SIM,1934,17,40-44,1951,1
STAT,1852,18,25-29,1870,4.939567028074798
SIM,1888,29,na,1917,2673
SIM,1893,22,na,1915,2926
STAT,1851,34,20-24,1885,1.9822035190736789
STAT,1850,22,50-100,1872,0.3450257715642073
STAT,1869,35,20-24,1904,0.7121727293678046
STAT,1849,33,45-49,1882,1.3636885833886048
STAT,1890,31,30-34,1921,20.247785252163368
SIM,1866,26,na,1892,2115
STAT,1840,43,35-39,1883,1.223852628414679
SIM,1862,28,45-49,1890,6
SIM,1862,37,50-100,1899,1
SIM,1894,38,25-29,1932,2
STAT,1935,25,na,1960,4828.249809930745
SIM,1868,24,30-34,1892,18
SIM,1949,21,20-24,1970,117
SIM,1816,41,50-100,1857,6
SIM,1855,82,na,1937,339
STAT,1819,47,25-29,1866,0.10914834831280182
STAT,1874,42,45-49,1916,1.442813594608706
STAT,1857,93,na,1950,21.77470081284227
STAT,1913,41,na,1954,3441.3039712423915
STAT,1814,53,35-39,1867,0.02465257320418993
STAT,1954,15,35-39,1969,4.902735840389533
STAT,1852,50,45-49,1902,0.01067249627494015
STAT,1860,39,25-29,1899,2.1847207000651023
STAT,1932,36,na,1968,4779.6394136610725
STAT,1878,26,40-44,1904,2.9593152266123455
STAT,1920,44,40-44,1964,0.2600980781031814
STAT,1952,19,40-44,1971,1.5823932232717193
SIM,1892,25,45-49,1917,2
STAT,1823,31,40-44,1854,13.14370320387459
SIM,1835,65,na,1900,1070
STAT,1872,85,na,1957,307.6069401224502
STAT,1936,20,25-29,1956,83.48086286893489
SIM,1937,29,na,1966,3330
STAT,1830,110,na,1940,1.6678269577222502E-4
STAT,1932,23,35-39,1955,11.63505809084423
STAT,1834,49,25-29,1883,0.03695092508715012
STAT,1899,33,40-44,1932,5.5897686951768915
STAT,1783,91,na,1874,15.374767244712189
STAT,1896,34,50-100,1930,1.1333987321723475
SIM,1831,40,30-34,1871,2
SIM,1940,23,35-39,1963,11
STAT,1874,18,45-49,1892,0.06288561731169096
SIM,1817,65,na,1882,904
STAT,1890,22,40-44,1912,2.4067279767079186
SIM,1819,35,40-44,1854,8
STAT,1864,22,30-34,1886,15.238611021407783
SIM,1844,42,na,1886,1566
SIM,1886,26,40-44,1912,3
STAT,1921,28,45-49,1949,1.8125337144431692
STAT,1921,43,50-100,1964,0.12480418372554519
SIM,1891,41,40-44,1932,7
SIM,1931,26,na,1957,4528
STAT,1942,22,15-19,1964,5.272686032051289
STAT,1881,44,35-39,1925,1.630253963708089
STAT,1837,79,na,1916,453.708070882909
STAT,1888,48,45-49,1936,0.1467581792306579
STAT,1911,37,50-100,1948,0.38311113096203814
SIM,1852,90,na,1942,39
SIM,1866,35,45-49,1901,7
STAT,1842,72,na,1914,914.5661246413234
SIM,1936,25,35-39,1961,12
STAT,1875,96,na,1971,47.33128363547294
STAT,1934,20,50-100,1954,0.8380925625456164
SIM,1853,32,30-34,1885,25
SIM,1918,30,25-29,1948,12
STAT,1830,26,25-29,1856,46.03701359031238
STAT,1905,42,40-44,1947,0.21301989472936447
STAT,1855,35,35-39,1890,5.073941183154549
STAT,1900,29,20-24,1929,15.264237640697997
SIM,1849,39,25-29,1888,1
STAT,1862,35,35-39,1897,5.76718614928012
STAT,1906,33,35-39,1939,7.96706437372766
STAT,1928,40,na,1968,4485.030056127118
SIM,1900,49,na,1949,2940
STAT,1814,91,na,1905,26.634324706821587
STAT,1823,40,30-34,1863,1.6209672764352054
STAT,1876,22,15-19,1898,3.2198632835478493
SIM,1847,53,na,1900,1582
STAT,1820,43,25-29,1863,1.1441036640709334
STAT,1881,81,na,1962,695.8146092359912
SIM,1836,34,20-24,1870,1
SIM,1890,30,na,1920,2996
STAT,1796,64,na,1860,820.5366197802274
SIM,1899,27,20-24,1926,19
STAT,1835,28,35-39,1863,7.946326944101233
STAT,1858,32,40-44,1890,3.2121255677331826
STAT,1934,36,15-19,1970,0.025057169065502958
STAT,1873,38,15-19,1911,0.05353563785680634
STAT,1849,45,na,1894,1703.9031073667584
SIM,1828,48,50-100,1876,4
SIM,1846,32,30-34,1878,23
SIM,1869,56,na,1925,1856
SIM,1943,11,na,1954,3825
STAT,1910,37,40-44,1947,1.3525724256195835
STAT,1838,32,30-34,1870,14.565635600651785
SIM,1890,48,na,1938,2789
STAT,1895,33,na,1928,2926.5751010294775
SIM,1918,44,na,1962,3725
SIM,1866,32,40-44,1898,6
STAT,1895,16,30-34,1911,1.9678287147569953
STAT,1774,109,na,1883,0.0024437385440761418
STAT,1927,34,40-44,1961,4.541674063984961
SIM,1840,36,45-49,1876,6
SIM,1860,18,25-29,1878,9
STAT,1928,25,35-39,1953,17.591692701358788
SIM,1857,33,45-49,1890,1
STAT,1869,22,15-19,1891,3.019231985160697
STAT,1847,19,na,1866,2087.812641572099
STAT,1928,34,25-29,1962,10.903397997897738
STAT,1905,12,na,1917,3526.4017329518783
STAT,1919,48,40-44,1967,0.1611001251670425
SIM,1881,24,30-34,1905,22
STAT,1854,28,45-49,1882,0.8268162157305645
STAT,1879,43,40-44,1922,2.2081811113168097
STAT,1892,22,na,1914,2798.444503672699
SIM,1908,23,25-29,1931,78
SIM,1880,71,na,1951,1333
SIM,1893,59,na,1952,2416
STAT,1925,38,30-34,1963,2.0643643111829912
SIM,1908,27,40-44,1935,7
STAT,1848,52,45-49,1900,0.01072615925947931
STAT,1935,9,na,1944,5141.088238526383
STAT,1910,52,na,1962,3183.69508952314
SIM,1935,34,40-44,1969,8
SIM,1836,25,30-34,1861,19
SIM,1936,34,25-29,1970,14
SIM,1839,21,25-29,1860,40
SIM,1933,38,30-34,1971,3
SIM,1930,9,na,1939,4897
STAT,1837,42,na,1879,1610.0582735982612
STAT,1913,23,25-29,1936,87.84714995196529
STAT,1833,83,na,1916,243.56188690989487
SIM,1900,18,15-19,1918,8
STAT,1854,15,30-34,1869,1.380391295399643
SIM,1871,17,30-34,1888,1
STAT,1859,26,na,1885,1838.5783848630567
STAT,1880,24,30-34,1904,17.62881904290362
SIM,1829,44,30-34,1873,4
STAT,1906,48,30-34,1954,0.0741848389401104
SIM,1881,37,45-49,1918,6
STAT,1854,34,30-34,1888,12.529799743107837
STAT,1936,36,40-44,1972,1.3895722134140553
SIM,1841,29,20-24,1870,10
STAT,1834,68,na,1902,947.4365065236861
STAT,1880,15,40-44,1895,0.18300587182759603
STAT,1838,46,50-100,1884,0.17182303016214368
STAT,1832,24,50-100,1856,0.35282597052218717
SIM,1850,40,40-44,1890,7
STAT,1859,19,30-34,1878,1.3747700881458564
SIM,1917,15,15-19,1932,6
STAT,1858,41,na,1899,1719.6383801968543
STAT,1888,35,30-34,1923,6.006707354888527
STAT,1843,24,45-49,1867,0.5827466181671614
STAT,1848,28,45-49,1876,0.977845831745476
STAT,1839,26,45-49,1865,0.938008611246773
STAT,1812,65,na,1877,872.9533946604664
SIM,1820,51,na,1871,1334
STAT,1931,32,40-44,1963,4.844067337867147
STAT,1901,44,30-34,1945,0.1041445935905351
SIM,1899,69,na,1968,2212
STAT,1873,37,45-49,1910,1.9099884606638153
STAT,1909,25,25-29,1934,60.338427736318714
SIM,1867,19,30-34,1886,1
STAT,1851,103,na,1954,0.10323651970331674
SIM,1855,44,40-44,1899,2
STAT,1906,29,30-34,1935,34.40023690491854
STAT,1875,20,40-44,1895,2.035481766640157
STAT,1904,45,50-100,1949,0.1895995267346082
SIM,1832,27,20-24,1859,11
SIM,1896,35,30-34,1931,6
SIM,1856,28,45-49,1884,1
STAT,1835,51,20-24,1886,4.882087818495363E-4
STAT,1892,38,25-29,1930,3.3899131792242896
STAT,1904,21,25-29,1925,77.80522610619197
STAT,1929,30,35-39,1959,10.977792017732549
SIM,1863,35,35-39,1898,11
STAT,1854,52,50-100,1906,0.010748266306742924
SIM,1912,45,50-100,1957,1
STAT,1793,72,na,1865,489.73638379068353
STAT,1811,80,na,1891,268.28068945379175
STAT,1845,32,30-34,1877,14.690148401848438
STAT,1866,48,25-29,1914,0.04955749222847929
STAT,1869,81,na,1950,494.9019699301374
STAT,1816,50,40-44,1866,0.02477903290525012
STAT,1827,64,na,1891,1004.1309657311915
STAT,1876,29,35-39,1905,9.350092540265251
STAT,1856,36,50-100,1892,0.9092974684771639
STAT,1895,11,na,1906,3185.3610660342483
SIM,1822,95,na,1917,3
SIM,1864,19,na,1883,2253
SIM,1948,19,25-29,1967,56
STAT,1862,25,25-29,1887,34.791410689502776
SIM,1847,26,45-49,1873,1
STAT,1769,87,na,1856,41.26288887
STAT,1902,23,na,1925,3143.4138947523957
SIM,1877,39,45-49,1916,2
STAT,1869,39,45-49,1908,1.8060560455861716
SIM,1870,25,25-29,1895,48
STAT,1870,46,25-29,1916,0.053533009434093705
STAT,1938,32,35-39,1970,8.68061929919032
STAT,1920,30,15-19,1950,0.13403967556555688
SIM,1841,50,na,1891,1447
SIM,1884,16,20-24,1900,20
SIM,1886,22,25-29,1908,50
STAT,1838,42,40-44,1880,1.7660122695047094
STAT,1909,15,15-19,1924,8.447020728740434
STAT,1841,106,na,1947,0.00837062577569139
SIM,1820,69,na,1889,776
SIM,1898,34,45-49,1932,4
SIM,1817,38,35-39,1855,23
STAT,1878,22,25-29,1900,56.35948390311878
SIM,1846,42,40-44,1888,7
SIM,1770,99,na,1869,1
SIM,1853,37,25-29,1890,1
SIM,1937,30,35-39,1967,7
STAT,1836,35,25-29,1871,2.336579026317076
SIM,1909,48,na,1957,3236
STAT,1837,21,25-29,1858,48.987649120511
SIM,1879,92,na,1971,126
STAT,1885,18,20-24,1903,16.650219442240303
STAT,1887,84,na,1971,718.0105345631033
SIM,1901,33,25-29,1934,20
STAT,1781,87,na,1868,53.87378746817088
STAT,1891,77,na,1968,1389.3225614770245
STAT,1932,19,30-34,1951,15.165262186538754
SIM,1836,38,45-49,1874,3
SIM,1831,91,na,1922,27
STAT,1911,0,na,1911,4245.108887513459
STAT,1844,27,na,1871,1839.2433459023578
STAT,1863,71,na,1934,1106.5727909438901
SIM,1858,36,30-34,1894,3
STAT,1825,47,25-29,1872,0.05875712411852013
SIM,1912,21,25-29,1933,92
STAT,1883,26,na,1909,2218.015339210536
STAT,1913,19,20-24,1932,26.04699194974635
STAT,1832,23,30-34,1855,16.820295683492333
STAT,1888,19,50-100,1907,0.054403567332717305
STAT,1873,20,15-19,1893,3.1797020494251016
SIM,1858,93,na,1951,15
STAT,1883,41,40-44,1924,2.09273583190757
STAT,1884,25,45-49,1909,1.0432992936255363
STAT,1933,18,na,1951,4642.518218860964
SIM,1810,92,na,1902,16
STAT,1828,44,30-34,1872,0.942830304451207
STAT,1865,16,45-49,1881,0.05797990437225161
STAT,1874,7,na,1881,2616.2767692059283
STAT,1847,44,40-44,1891,1.636243871117765
STAT,1861,44,25-29,1905,0.49759755859352056
STAT,1864,32,40-44,1896,3.651392921444094
STAT,1839,53,50-100,1892,0.009893934073344202
SIM,1844,79,na,1923,421
SIM,1893,18,20-24,1911,25
STAT,1842,40,40-44,1882,1.728999134319146
SIM,1905,21,25-29,1926,71
SIM,1921,19,20-24,1940,139
STAT,1848,82,na,1930,346.69781922284596
STAT,1884,70,na,1954,1309.5182218214507
STAT,1846,52,35-39,1898,0.006351379363497082
STAT,1895,29,45-49,1924,1.3576744748222456
SIM,1840,23,30-34,1863,14
SIM,1844,35,25-29,1879,5
STAT,1845,37,25-29,1882,2.140680640460198
STAT,1914,26,na,1940,3579.9680257040927
SIM,1859,78,na,1937,586
SIM,1921,23,25-29,1944,98
STAT,1949,8,na,1957,4318.203123647848
STAT,1868,104,na,1972,0.7820588640193831
SIM,1839,49,na,1888,1513
STAT,1928,15,25-29,1943,51.8220300752767
SIM,1819,72,na,1891,603
STAT,1828,38,45-49,1866,1.7795662245363646
STAT,1803,51,na,1854,1165.8231091939786
STAT,1925,21,50-100,1946,0.7462821413070176
SIM,1943,15,25-29,1958,53
STAT,1865,5,na,1870,2438.1926368946065
SIM,1845,21,25-29,1866,53
STAT,1834,22,45-49,1856,0.5787726984407392
STAT,1878,36,50-100,1914,1.2145557642742248
STAT,1879,33,30-34,1912,17.192586345136135
STAT,1830,87,na,1917,106.3331746469063
SIM,1919,22,30-34,1941,38
SIM,1887,33,30-34,1920,19
STAT,1824,50,na,1874,1377.8018503706337
SIM,1842,22,45-49,1864,1
STAT,1898,25,na,1923,3071.676939530214
SIM,1940,19,30-34,1959,15
SIM,1836,44,30-34,1880,3
STAT,1864,41,30-34,1905,0.9723681288311249
STAT,1867,29,25-29,1896,37.25646636022069
SIM,1872,41,30-34,1913,3
STAT,1935,15,25-29,1950,56.2251344069895
SIM,1878,30,na,1908,2431
SIM,1881,34,na,1915,1832
STAT,1863,17,30-34,1880,1.50777930914642
STAT,1819,42,30-34,1861,2.4216310131000567
STAT,1852,53,50-100,1905,0.010773483328452153
SIM,1872,35,45-49,1907,1
SIM,1894,33,30-34,1927,30
STAT,1910,27,30-34,1937,35.74516310618266
STAT,1949,20,35-39,1969,10.387072808081756
SIM,1886,36,50-100,1922,1
STAT,1844,53,20-24,1897,5.042737148669608E-4
SIM,1876,17,15-19,1893,4
SIM,1947,19,na,1966,3845
SIM,1846,90,na,1936,43
SIM,1806,62,na,1868,942
STAT,1927,39,40-44,1966,1.7544941268249346
STAT,1862,40,20-24,1902,0.1295705828008737
SIM,1919,34,25-29,1953,16
SIM,1939,31,45-49,1970,1
SIM,1825,69,na,1894,822
STAT,1844,67,na,1911,1100.9713321203624
SIM,1942,16,25-29,1958,56
STAT,1836,53,25-29,1889,0.0022752980349181667
STAT,1901,38,50-100,1939,0.34867919783696083
SIM,1836,29,40-44,1865,2
SIM,1862,37,40-44,1899,6
STAT,1912,44,50-100,1956,0.10621444056115519
STAT,1934,16,25-29,1950,55.5092838044417
STAT,1889,79,na,1968,1209.983515789043
STAT,1860,34,50-100,1894,0.6962981743451007
SIM,1881,30,25-29,1911,10
STAT,1871,69,na,1940,1376.6617990035868
STAT,1897,74,na,1971,1817.9547932862674
SIM,1940,19,25-29,1959,53
SIM,1829,59,na,1888,1124
STAT,1897,17,40-44,1914,0.23107650128629018
STAT,1829,103,na,1932,0.08671687843802732
STAT,1852,62,na,1914,1325.0799604733297
SIM,1873,92,na,1965,74
STAT,1860,43,20-24,1903,0.12085236269142384
SIM,1928,12,na,1940,4726
SIM,1955,14,na,1969,4595
STAT,1840,24,35-39,1864,4.800401047035938
STAT,1932,20,30-34,1952,35.83761929174904
STAT,1945,19,35-39,1964,4.327354577121463
STAT,1859,40,15-19,1899,0.01048825304341454
SIM,1811,49,na,1860,1198
SIM,1937,18,40-44,1955,1
STAT,1838,50,25-29,1888,0.0024609009427719606
STAT,1868,17,15-19,1885,5.445909770729917
STAT,1911,29,35-39,1940,13.733335831582679
SIM,1891,18,na,1909,2977
STAT,1831,31,30-34,1862,14.1142636131393
SIM,1867,22,15-19,1889,3
STAT,1932,19,25-29,1951,53.91747921034973
SIM,1859,16,30-34,1875,1
SIM,1833,64,na,1897,1031
SIM,1838,26,40-44,1864,4
SIM,1879,18,na,1897,2523
STAT,1857,30,50-100,1887,0.7012871619343409
STAT,1859,22,15-19,1881,2.5736079231683178
STAT,1837,51,50-100,1888,0.010034156510334924
STAT,1913,26,35-39,1939,14.181302017579625
STAT,1839,106,na,1945,0.008083915756230693
SIM,1921,26,35-39,1947,20
STAT,1866,82,na,1948,406.54321867530945
STAT,1854,37,40-44,1891,3.13203770159943
STAT,1929,36,40-44,1965,1.817180057744016
STAT,1930,23,30-34,1953,34.67495216657143
STAT,1932,37,25-29,1969,1.2497438250390178
STAT,1798,81,na,1879,211.96162752875398
SIM,1890,20,50-100,1910,1
SIM,1846,32,25-29,1878,15
STAT,1911,47,35-39,1958,0.11531169760098132
SIM,1869,35,30-34,1904,5
STAT,1839,80,na,1919,411.8603219579221
STAT,1846,24,50-100,1870,0.3678536661693958
STAT,1955,4,na,1959,4931.326049441069
SIM,1874,46,na,1920,2130
STAT,1927,20,20-24,1947,130.19080539065226
STAT,1838,32,25-29,1870,8.544814262185799
STAT,1865,106,na,1971,0.14854424038276298
STAT,1906,30,30-34,1936,13.904822885475568
STAT,1936,26,30-34,1962,35.43951747375641
SIM,1822,34,35-39,1856,10
STAT,1887,44,na,1931,2409.2849666635793
STAT,1855,26,50-100,1881,0.47725309677019523
STAT,1911,9,na,1920,3751.1027813577903
STAT,1929,34,45-49,1963,1.8857418765785605
STAT,1883,49,30-34,1932,0.08778547483384185
STAT,1847,16,na,1863,2125.1431787457755
STAT,1932,0,na,1932,5635.499657142787
SIM,1871,24,30-34,1895,20
STAT,1793,101,na,1894,0.09464439245474689
STAT,1827,95,na,1922,7.679924726325588
STAT,1879,33,25-29,1912,10.085894020251768
STAT,1869,1,na,1870,3236.823875447786
STAT,1894,20,15-19,1914,4.029075530245991
STAT,1809,70,na,1879,691.8277797495383
STAT,1863,24,30-34,1887,14.845475769110951
STAT,1898,16,na,1914,3236.7143468025392
SIM,1899,18,25-29,1917,12
STAT,1926,4,na,1930,4674.754371769833
STAT,1904,33,30-34,1937,13.527613753401846
STAT,1772,88,na,1860,37.93071338863879
SIM,1810,46,50-100,1856,1
STAT,1856,52,na,1908,1578.603409716921
SIM,1859,1,na,1860,2878
STAT,1896,36,35-39,1932,8.867255291295862
STAT,1924,42,15-19,1966,0.0017255803838297774
SIM,1912,33,30-34,1945,21
STAT,1886,35,50-100,1921,1.2368129172056452
SIM,1926,15,30-34,1941,14
STAT,1846,27,35-39,1873,8.65777366017326
SIM,1887,33,25-29,1920,11
STAT,1896,30,20-24,1926,3.3996762125815074
SIM,1854,27,35-39,1881,15
STAT,1901,13,na,1914,3409.6666778784097
SIM,1905,43,na,1948,3108
SIM,1873,21,30-34,1894,21
STAT,1819,100,na,1919,0.5604370336303051
SIM,1830,26,40-44,1856,4
STAT,1885,30,45-49,1915,1.6552580586245358
STAT,1902,36,30-34,1938,1.5410544909983963
STAT,1904,15,30-34,1919,2.169817657528712
SIM,1849,24,20-24,1873,62
STAT,1914,39,30-34,1953,1.7018279417442
STAT,1916,18,30-34,1934,2.4366106830447176
SIM,1940,20,30-34,1960,24
STAT,1918,15,30-34,1933,2.526208086355225
STAT,1894,39,35-39,1933,8.500453429348093
SIM,1879,20,50-100,1899,1
SIM,1811,44,30-34,1855,4
STAT,1848,57,na,1905,1493.2724414149604
STAT,1815,39,50-100,1854,3.7640894482841487
SIM,1924,18,30-34,1942,19
STAT,1865,21,30-34,1886,15.549099808427771
STAT,1848,24,35-39,1872,5.204102477224731
SIM,1893,30,45-49,1923,4
SIM,1879,27,40-44,1906,3
SIM,1922,39,30-34,1961,1
STAT,1900,26,25-29,1926,55.62644353657093
STAT,1899,30,45-49,1929,2.275351889581831
SIM,1937,34,45-49,1971,4
STAT,1922,45,15-19,1967,4.0166479757504587E-4
STAT,1940,15,40-44,1955,1.342334231768095
SIM,1910,36,30-34,1946,2
SIM,1912,15,30-34,1927,2
STAT,1844,48,35-39,1892,0.09601157621578597
SIM,1857,46,na,1903,1800
SIM,1922,23,45-49,1945,1
STAT,1950,19,15-19,1969,50.66106700657501
SIM,1858,21,35-39,1879,7
SIM,1816,44,50-100,1860,1
STAT,1872,32,30-34,1904,16.544431119797085
SIM,1859,36,50-100,1895,1
SIM,1936,35,na,1971,2899
STAT,1864,54,45-49,1918,0.011883027492061384
STAT,1840,26,50-100,1866,0.527218520885026
STAT,1846,48,50-100,1894,0.17987357717901623
SIM,1932,24,15-19,1956,6
STAT,1890,46,40-44,1936,0.1118529422763651
STAT,1877,54,25-29,1931,0.003375492568473294
STAT,1829,45,35-39,1874,0.11746865388727178
STAT,1866,51,45-49,1917,0.012705477147541146
STAT,1912,41,40-44,1953,0.22921684057549407
STAT,1920,34,25-29,1954,9.481982334107402
STAT,1860,97,na,1957,5.561167213915218
STAT,1815,70,na,1885,738.0984266892718
SIM,1853,84,na,1937,198
SIM,1884,76,na,1960,1070
STAT,1870,35,30-34,1905,4.986154978863476
SIM,1813,41,30-34,1854,3
STAT,1864,22,25-29,1886,48.97427252127668
STAT,1923,44,20-24,1967,0.019434662762496998
STAT,1839,31,30-34,1870,14.454790071166876
STAT,1917,47,30-34,1964,0.08796459018229698
STAT,1786,96,na,1882,1.4468851038037989
STAT,1830,32,25-29,1862,8.785641761686424
SIM,1904,20,20-24,1924,100
STAT,1933,18,30-34,1951,15.37366115817244
SIM,1856,21,30-34,1877,18
STAT,1860,49,35-39,1909,0.10507077549552755
STAT,1919,47,35-39,1966,0.13210801715332934
STAT,1854,19,40-44,1873,0.15470637294519776
STAT,1801,100,na,1901,0.3752961512808692
SIM,1850,36,na,1886,1835
SIM,1889,30,25-29,1919,15
SIM,1828,37,35-39,1865,11
SIM,1916,26,25-29,1942,75
SIM,1826,82,na,1908,213
STAT,1792,96,na,1888,1.5801653395799764
STAT,1906,44,20-24,1950,0.014969064788955433
SIM,1849,79,na,1928,487
SIM,1909,33,na,1942,3425
SIM,1935,20,20-24,1955,134
STAT,1821,42,25-29,1863,1.1050937022845615
STAT,1887,28,35-39,1915,10.15998172096268
SIM,1886,38,40-44,1924,4
SIM,1950,4,na,1954,4269
STAT,1921,46,50-100,1967,0.24147231698672633
STAT,1940,31,45-49,1971,1.5394043435060394
STAT,1927,37,45-49,1964,0.8006899368300077
STAT,1915,49,50-100,1964,0.21404990321873385
SIM,1770,93,na,1863,6
SIM,1941,18,30-34,1959,13
SIM,1945,24,25-29,1969,92
STAT,1919,29,35-39,1948,15.21532480137725
SIM,1927,29,35-39,1956,23
STAT,1937,24,25-29,1961,84.91753920262087
SIM,1895,28,35-39,1923,19
STAT,1878,38,40-44,1916,4.288365376177161
STAT,1803,85,na,1888,90.41974195524756
STAT,1877,54,na,1931,2051.9410215197386
STAT,1881,25,35-39,1906,8.865415408031245
STAT,1894,26,na,1920,2907.3002278927897
STAT,1883,54,na,1937,1939.504117015534
STAT,1927,44,50-100,1971,0.13872271261370134
SIM,1870,56,na,1926,1857
STAT,1832,42,na,1874,1540.1403668373594
STAT,1860,107,na,1967,0.033789421134301605
SIM,1856,21,na,1877,1981
SIM,1799,103,na,1902,1
STAT,1839,19,45-49,1858,0.056225112147363886
SIM,1785,83,na,1868,108
STAT,1879,49,na,1928,2178.354957386101
SIM,1861,38,35-39,1899,12
STAT,1853,38,35-39,1891,5.326209898747399
STAT,1854,97,na,1951,3.843758895423108
SIM,1815,39,na,1854,1546
SIM,1949,14,na,1963,4243
SIM,1901,30,20-24,1931,7
STAT,1871,33,25-29,1904,9.567756356552263
STAT,1914,25,40-44,1939,4.469157934651459
STAT,1895,38,40-44,1933,5.3645857879069565
STAT,1865,69,na,1934,1256.6077688151618
STAT,1890,44,45-49,1934,1.7052358198476134
SIM,1926,17,na,1943,4175
SIM,1878,28,35-39,1906,9
SIM,1899,23,50-100,1922,1
SIM,1922,25,40-44,1947,4
STAT,1885,46,30-34,1931,0.09140989260339855
STAT,1914,41,45-49,1955,0.1560206863388507
SIM,1881,28,na,1909,1838
STAT,1895,37,50-100,1932,1.5120863903794632
STAT,1908,26,25-29,1934,59.48431966766182
SIM,1766,88,na,1854,27
STAT,1828,37,na,1865,1563.7132993723587
STAT,1828,47,40-44,1875,0.13862329824581898
SIM,1870,41,50-100,1911,3
SIM,1847,31,30-34,1878,23
STAT,1914,23,45-49,1937,1.0826299987715522
SIM,1872,22,25-29,1894,45
STAT,1932,34,20-24,1966,3.059207818682364
STAT,1824,75,na,1899,567.6318656998977
STAT,1923,31,45-49,1954,1.7111250960164914
SIM,1948,1,na,1949,4345
STAT,1900,41,45-49,1941,0.1368166953326606
STAT,1884,49,20-24,1933,0.010966004715883583
SIM,1895,48,na,1943,2824
STAT,1855,32,25-29,1887,7.4111855538753115
SIM,1802,72,na,1874,497
STAT,1875,29,50-100,1904,0.6167112149350952
SIM,1931,26,20-24,1957,23
STAT,1767,113,na,1880,4.143654945181219E-4
SIM,1827,64,na,1891,938
STAT,1903,34,25-29,1937,7.837685073964197
STAT,1851,49,na,1900,1584.6160152902653
STAT,1923,26,20-24,1949,19.86615453254542
SIM,1888,38,na,1926,2638
SIM,1911,34,25-29,1945,14
STAT,1872,53,50-100,1925,0.014081243138511258
SIM,1804,67,na,1871,752
SIM,1899,22,35-39,1921,10
STAT,1828,29,40-44,1857,3.668418176985781
SIM,1862,21,na,1883,2086
STAT,1889,22,30-34,1911,20.773661830501872
SIM,1931,31,45-49,1962,4
SIM,1925,16,25-29,1941,54
STAT,1903,48,na,1951,2986.6854630671496
STAT,1840,77,na,1917,567.2639646713362
SIM,1791,83,na,1874,113
SIM,1845,37,40-44,1882,2
SIM,1897,22,30-34,1919,23
STAT,1880,54,30-34,1934,0.005765325798402822
STAT,1921,16,45-49,1937,0.5392385146072192
STAT,1831,24,50-100,1855,0.4140800806040417
STAT,1888,26,na,1914,2673.5732334114336
STAT,1898,18,50-100,1916,0.06246808201657983
STAT,1848,97,na,1945,3.9918877411122486
STAT,1908,23,na,1931,3304.1194086462983
SIM,1902,29,35-39,1931,17
STAT,1811,45,50-100,1856,0.8454952082496557
SIM,1868,46,na,1914,2043
SIM,1886,35,30-34,1921,6
STAT,1928,19,35-39,1947,4.967933744704592
STAT,1945,16,30-34,1961,12.581883971341298
STAT,1948,20,na,1968,3963.940023335759
SIM,1844,23,30-34,1867,18
SIM,1847,44,na,1891,1686
SIM,1915,28,30-34,1943,41
SIM,1878,43,30-34,1921,4
STAT,1778,106,na,1884,0.011893798721202137
STAT,1930,10,na,1940,4853.838750662276
SIM,1919,31,20-24,1950,2
SIM,1863,32,25-29,1895,10
STAT,1904,18,35-39,1922,0.741583782462754
STAT,1887,46,35-39,1933,0.14835581928935596
SIM,1912,18,35-39,1930,2
STAT,1851,40,45-49,1891,1.0874608333723832
STAT,1854,101,na,1955,0.4082726339972214
SIM,1821,39,na,1860,1474
SIM,1843,54,na,1897,1456
STAT,1819,53,25-29,1872,0.006314560530062136
STAT,1852,54,25-29,1906,0.002497294821628961
STAT,1930,26,35-39,1956,18.042349145045325
STAT,1906,26,20-24,1932,16.196741354962633
STAT,1836,23,30-34,1859,15.113692449536574
STAT,1862,43,25-29,1905,0.5149352940967552
STAT,1850,104,na,1954,0.04701841863813573
SIM,1896,23,25-29,1919,71
STAT,1871,29,na,1900,2222.7307117290816
STAT,1836,50,20-24,1886,5.030376095559531E-4
STAT,1800,65,na,1865,808.412600648472
STAT,1907,28,30-34,1935,34.82261059147099
SIM,1923,19,25-29,1942,56
STAT,1766,88,na,1854,36.0
STAT,1933,36,30-34,1969,2.3473071304413646
SIM,1819,44,30-34,1863,2
SIM,1939,29,30-34,1968,37
STAT,1888,23,25-29,1911,63.71427362431489
STAT,1813,75,na,1888,429.98929103027206
STAT,1910,30,20-24,1940,2.2397285309053268
STAT,1931,39,30-34,1970,2.2753702586495854
STAT,1902,32,50-100,1934,1.221567374750871
STAT,1918,41,na,1959,3735.7467510284873
STAT,1834,53,20-24,1887,4.603535926892227E-4
STAT,1859,29,na,1888,1799.2590752952294
STAT,1910,49,40-44,1959,0.13815375272001082
SIM,1827,35,25-29,1862,2
SIM,1891,58,na,1949,2293
SIM,1886,71,na,1957,1306
STAT,1915,19,25-29,1934,8.522430219709262
SIM,1855,40,25-29,1895,3
STAT,1906,47,50-100,1953,0.18972747329316267
STAT,1886,26,25-29,1912,42.357891393480905
SIM,1888,32,30-34,1920,31
STAT,1825,50,45-49,1875,0.014845266160113548
SIM,1894,26,25-29,1920,62
STAT,1849,21,45-49,1870,0.6367727898157461
SIM,1914,26,20-24,1940,16
STAT,1788,91,na,1879,16.67827210430961
STAT,1924,29,15-19,1953,0.7709384178725788
STAT,1907,46,30-34,1953,0.07598959483743135
STAT,1904,19,50-100,1923,0.06603074018223258
STAT,1894,20,45-49,1914,0.8516340775486556
SIM,1885,36,50-100,1921,1
STAT,1836,32,na,1868,1773.929347467587
SIM,1903,48,na,1951,2983
STAT,1879,89,na,1968,284.94311131586346
STAT,1911,26,30-34,1937,36.223332924276114
STAT,1875,54,20-24,1929,6.968264333539804E-4
SIM,1913,30,40-44,1943,5
STAT,1854,26,na,1880,1795.9565342483388
STAT,1870,53,30-34,1923,0.005428017612348379
STAT,1904,36,35-39,1940,2.078623595128467
STAT,1918,18,35-39,1936,4.303402613832215
SIM,1898,22,45-49,1920,4
SIM,1910,39,35-39,1949,7
STAT,1926,31,50-100,1957,0.9449680666649356
SIM,1796,67,na,1863,759
SIM,1792,77,na,1869,301
SIM,1860,26,na,1886,2014
SIM,1822,92,na,1914,12
SIM,1905,2,na,1907,3581
STAT,1861,47,50-100,1908,0.19201625942224915
STAT,1924,27,50-100,1951,1.094800004557877
STAT,1915,34,15-19,1949,0.12258256201659183
STAT,1838,67,na,1905,1064.2362355050564
SIM,1915,33,na,1948,3466
SIM,1921,21,35-39,1942,12
SIM,1907,18,30-34,1925,4
SIM,1885,18,na,1903,2421
STAT,1817,43,50-100,1860,2.5795735513397227
SIM,1868,36,25-29,1904,1
STAT,1902,39,35-39,1941,2.0148635130725294
STAT,1936,29,35-39,1965,13.559786783826437
STAT,1928,37,35-39,1965,2.887662281482944
SIM,1928,28,40-44,1956,6
STAT,1762,114,na,1876,1.4208484741739586E-4
STAT,1881,22,30-34,1903,16.25560537211179
STAT,1832,48,45-49,1880,0.16648697666953205
STAT,1872,70,na,1942,1329.5212065012777
SIM,1867,92,na,1959,64
STAT,1842,48,30-34,1890,0.06922002619857466
STAT,1905,49,30-34,1954,0.07300368220451588
STAT,1861,79,na,1940,549.1381865602972
STAT,1848,21,30-34,1869,16.232196362184688
STAT,1886,44,25-29,1930,0.6321653742905314
STAT,1896,33,25-29,1929,12.725618598268932
SIM,1945,21,20-24,1966,106
SIM,1864,44,50-100,1908,1
SIM,1869,31,na,1900,2213
STAT,1829,42,25-29,1871,0.5477776051607587
STAT,1911,44,30-34,1955,0.11386126408827717
SIM,1886,9,na,1895,2560
SIM,1936,19,35-39,1955,6
SIM,1926,18,35-39,1944,8
SIM,1827,95,na,1922,2
STAT,1896,21,na,1917,2959.7455459182393
SIM,1907,33,20-24,1940,2
SIM,1875,31,na,1906,2333
STAT,1941,27,25-29,1968,64.32320173744985
SIM,1899,15,20-24,1914,23
STAT,1856,44,50-100,1900,0.7681764160202907
SIM,1911,45,50-100,1956,1
STAT,1829,50,na,1879,1428.6333527549361
STAT,1902,20,15-19,1922,4.424605680119016
STAT,1913,21,35-39,1934,8.645814281203679
SIM,1904,26,35-39,1930,13
SIM,1953,16,30-34,1969,16
SIM,1829,32,25-29,1861,17
STAT,1867,21,35-39,1888,5.235441889000997
STAT,1888,41,25-29,1929,0.7201790358988804
STAT,1859,40,45-49,1899,1.136664343777233
STAT,1908,30,50-100,1938,0.7432103852983547
SIM,1912,36,35-39,1948,8
STAT,1812,50,na,1862,1282.0429109227312
STAT,1827,48,35-39,1875,0.12636913612589748
STAT,1846,45,35-39,1891,0.10487375876729832
SIM,1890,4,na,1894,3271
STAT,1943,21,15-19,1964,5.352029775033957
SIM,1780,83,na,1863,103
STAT,1909,21,15-19,1930,4.688104286919558
STAT,1847,54,45-49,1901,0.010407273387702979
SIM,1898,28,na,1926,2976
STAT,1837,34,30-34,1871,13.9152891524661
STAT,1866,4,na,1870,2619.545617557518
STAT,1828,31,25-29,1859,11.031330170820446
STAT,1922,31,25-29,1953,9.905796091464433
SIM,1856,24,35-39,1880,5
STAT,1840,21,25-29,1861,48.12066049255503
SIM,1853,25,25-29,1878,52
SIM,1911,31,20-24,1942,2
STAT,1829,42,30-34,1871,0.980698611678512
STAT,1852,45,50-100,1897,0.17983177298552722
SIM,1876,30,45-49,1906,1
STAT,1822,41,30-34,1863,1.7196025856678792
STAT,1830,47,na,1877,1457.4413640016778
SIM,1859,34,30-34,1893,22
SIM,1884,8,na,1892,2531
STAT,1920,19,35-39,1939,4.4235665692552075
SIM,1917,21,15-19,1938,5
STAT,1851,32,50-100,1883,0.6859995444435146
STAT,1920,51,na,1971,3787.542105099838
STAT,1845,25,25-29,1870,36.963551406459075
SIM,1918,23,25-29,1941,96
STAT,1941,24,15-19,1965,5.193306899545854
STAT,1889,8,na,1897,3031.7334419446097
STAT,1916,20,45-49,1936,1.1204663090526172
SIM,1880,86,na,1966,448
STAT,1882,69,na,1951,1348.2546553648185
SIM,1816,92,na,1908,15
SIM,1854,26,na,1880,2015
STAT,1819,60,na,1879,1124.763828546551
STAT,1937,21,20-24,1958,102.32738574968053
SIM,1905,20,40-44,1925,3
STAT,1905,30,40-44,1935,5.969362034936285
STAT,1867,64,na,1931,1542.059599849675
SIM,1849,27,25-29,1876,48
SIM,1900,17,30-34,1917,1
SIM,1862,21,25-29,1883,50
SIM,1922,27,na,1949,3976
SIM,1909,30,20-24,1939,1
STAT,1824,47,na,1871,1430.693809812046
SIM,1866,11,na,1877,2405
SIM,1914,30,30-34,1944,17
STAT,1907,38,na,1945,3278.908662993437
SIM,1948,20,na,1968,3973
STAT,1877,51,20-24,1928,7.265725954813272E-4
SIM,1837,42,30-34,1879,3
SIM,1928,6,na,1934,4778
STAT,1841,20,50-100,1861,0.36131261344103865
STAT,1921,34,45-49,1955,1.6401290545163758
SIM,1878,43,25-29,1921,3
STAT,1829,59,na,1888,1195.4333717459428
STAT,1877,21,20-24,1898,67.73361882403773
STAT,1765,94,na,1859,2.7279558057180022
SIM,1837,24,30-34,1861,13
STAT,1904,18,40-44,1922,0.24719460846652433
SIM,1813,72,na,1885,547
SIM,1924,20,45-49,1944,2
STAT,1923,29,30-34,1952,42.19369855528945
SIM,1931,29,30-34,1960,59
STAT,1910,21,50-100,1931,0.5855256490348166
STAT,1952,15,30-34,1967,13.805985879554557
STAT,1920,33,50-100,1953,0.8519189706707326
SIM,1920,28,40-44,1948,8
STAT,1819,35,25-29,1854,9.329347069009183
STAT,1811,53,25-29,1864,0.011052695820943674
SIM,1839,89,na,1928,46
SIM,1904,23,25-29,1927,86
STAT,1860,85,na,1945,210.12669312726825
SIM,1897,43,na,1940,2983
STAT,1892,41,45-49,1933,1.7789128622066086
SIM,1845,34,30-34,1879,15
STAT,1912,28,40-44,1940,4.324111279182452
STAT,1854,21,25-29,1875,48.47268825186361
STAT,1896,33,30-34,1929,21.692305719919453
SIM,1808,57,na,1865,1111
STAT,1925,41,20-24,1966,0.020227331861954204
SIM,1774,83,na,1857,108
SIM,1863,5,na,1868,2361
SIM,1897,74,na,1971,1931
STAT,1867,17,25-29,1884,5.138928795931533
STAT,1845,43,25-29,1888,0.4568423489767773
STAT,1945,19,50-100,1964,0.3863708728005072
STAT,1825,60,na,1885,1082.2695124944448
SIM,1874,86,na,1960,292
STAT,1856,16,40-44,1872,0.16035297527740636
SIM,1931,29,25-29,1960,81
STAT,1861,39,na,1900,1831.9644129058859
STAT,1917,31,15-19,1948,0.12764325200435658
SIM,1933,23,20-24,1956,127
STAT,1914,21,25-29,1935,85.80902980861156
STAT,1850,67,na,1917,1117.457119057953
STAT,1837,52,30-34,1889,0.003877276201681247
STAT,1878,53,30-34,1931,0.005766312468604473
SIM,1801,87,na,1888,57
SIM,1820,37,35-39,1857,12
SIM,1897,25,35-39,1922,16
STAT,1911,41,20-24,1952,0.01601593647901306
STAT,1825,106,na,1931,0.006453134225738662
STAT,1873,30,25-29,1903,9.892470437871557
STAT,1889,25,35-39,1914,11.329454514768178
STAT,1901,37,25-29,1938,0.8217685637340625
SIM,1848,26,na,1874,1893
STAT,1798,100,na,1898,0.3015586734692056
STAT,1868,49,35-39,1917,0.12355318921210856
STAT,1849,29,50-100,1878,0.5604852996887705
SIM,1885,58,na,1943,1875
SIM,1836,31,25-29,1867,16
STAT,1923,29,25-29,1952,70.87842533048784
SIM,1856,52,na,1908,1684
STAT,1925,23,20-24,1948,125.34608201429253
STAT,1890,36,na,1926,2734.1697684578066
STAT,1903,31,20-24,1934,3.6481705493933143
STAT,1919,26,30-34,1945,40.13225792991964
SIM,1837,54,na,1891,1343
SIM,1908,20,na,1928,3302
SIM,1903,26,45-49,1929,1
SIM,1875,17,25-29,1892,9
STAT,1878,35,30-34,1913,5.296911262706014
STAT,1880,42,50-100,1922,1.0508618864647699
SIM,1949,18,30-34,1967,14
STAT,1840,21,30-34,1861,14.973005000139507
SIM,1878,25,30-34,1903,29
STAT,1858,29,20-24,1887,8.767889278502246
STAT,1915,37,25-29,1952,0.9396630215241992
SIM,1923,28,50-100,1951,1
SIM,1905,48,50-100,1953,1
SIM,1872,11,na,1883,2524
STAT,1895,22,25-29,1917,70.5036208062024
SIM,1858,19,20-24,1877,13
SIM,1927,26,30-34,1953,55
STAT,1771,94,na,1865,2.8423223989250292
STAT,1868,49,na,1917,1985.5357322322564
STAT,1881,22,25-29,1903,52.24271729055437
STAT,1919,44,30-34,1963,0.13044631327278183
STAT,1872,17,35-39,1889,0.5216545962361746
STAT,1865,97,na,1962,12.076758591115528
STAT,1873,49,45-49,1922,0.22139390615596932
STAT,1936,35,na,1971,3495.112095910625
STAT,1831,53,50-100,1884,0.009278883589394979
SIM,1922,21,25-29,1943,97
STAT,1873,64,na,1937,1665.5463513288432
STAT,1868,5,na,1873,2535.7211919663678
SIM,1916,27,na,1943,3561
STAT,1842,32,na,1874,1895.9778921477362
SIM,1866,29,20-24,1895,9
SIM,1845,89,na,1934,59
STAT,1946,18,40-44,1964,1.4651223206967465
SIM,1923,37,25-29,1960,3
SIM,1930,31,25-29,1961,15
STAT,1807,75,na,1882,447.45511749335327
STAT,1931,20,40-44,1951,4.144230348949069
STAT,1794,91,na,1885,18.810728266485352
SIM,1839,80,na,1919,374
SIM,1936,32,35-39,1968,8
STAT,1860,46,25-29,1906,0.04427630968939345
STAT,1923,47,25-29,1970,0.05862126846681046
STAT,1908,1,na,1909,3814.4025882938176
STAT,1793,81,na,1874,185.67820646313217
SIM,1908,16,25-29,1924,11
SIM,1949,20,45-49,1969,2
SIM,1877,32,25-29,1909,19
SIM,1886,38,35-39,1924,9
SIM,1838,41,30-34,1879,3
STAT,1816,54,50-100,1870,0.03281434182531479
STAT,1905,35,40-44,1940,1.3024342745464121
STAT,1868,30,45-49,1898,1.5844145762894812
SIM,1855,45,50-100,1900,2
STAT,1928,16,30-34,1944,14.544103957150815
STAT,1907,42,45-49,1949,0.14404864414999424
STAT,1870,44,na,1914,2113.0549919517857
SIM,1821,39,45-49,1860,1
SIM,1786,77,na,1863,306
STAT,1868,19,35-39,1887,0.4976152410648738
STAT,1884,44,20-24,1928,0.14622275376187627
SIM,1870,28,na,1898,2188
SIM,1904,23,30-34,1927,30
STAT,1808,85,na,1893,105.99550926822438
STAT,1909,28,35-39,1937,13.507635506831987
STAT,1851,38,30-34,1889,3.83482253874984
STAT,1878,38,35-39,1916,6.928898241170602
STAT,1910,27,25-29,1937,60.04595380108165
SIM,1906,65,na,1971,2603
SIM,1900,35,30-34,1935,2
STAT,1904,16,45-49,1920,0.0887330743791327
SIM,1926,5,na,1931,4576
STAT,1930,24,45-49,1954,1.3531505702385596
SIM,1854,66,na,1920,1301
STAT,1832,45,40-44,1877,0.12551208151693075
STAT,1872,9,na,1881,2545.2712851572683
STAT,1912,25,na,1937,3511.2906598425025
SIM,1917,28,35-39,1945,20
STAT,1941,13,na,1954,3827.3377584635664
STAT,1857,62,na,1919,1361.7711758676248
STAT,1937,28,40-44,1965,4.29021904595452
SIM,1883,54,na,1937,1916
SIM,1943,18,35-39,1961,7
SIM,1936,16,30-34,1952,14
STAT,1853,23,30-34,1876,15.813143438932627
SIM,1843,26,na,1869,1938
SIM,1861,23,30-34,1884,18
STAT,1875,90,na,1965,192.87591472001327
STAT,1911,31,50-100,1942,0.7637114287278475
STAT,1806,53,45-49,1859,0.050067045698295634
STAT,1941,24,20-24,1965,108.48169851360417
STAT,1841,20,30-34,1861,15.782133243488417
STAT,1852,51,20-24,1903,5.375410976104445E-4
SIM,1913,33,45-49,1946,1
STAT,1920,20,na,1940,3858.0997248229946
STAT,1935,18,35-39,1953,5.40490208236542
STAT,1853,111,na,1964,3.5991392469673727E-4
SIM,1882,10,na,1892,2474
STAT,1873,44,45-49,1917,1.4145969445633597
STAT,1884,64,na,1948,1622.4459189256902
STAT,1910,21,na,1931,3395.8538252817666
STAT,1924,46,30-34,1970,0.10050671341095006
SIM,1868,24,25-29,1892,57
STAT,1840,37,na,1877,1662.4528771138719
SIM,1852,62,na,1914,1370
STAT,1924,10,na,1934,4470.838265362788
STAT,1827,33,30-34,1860,20.094906057017596
STAT,1872,47,35-39,1919,0.13204234462229753
STAT,1909,21,45-49,1930,0.9909343569935197
STAT,1909,28,50-100,1937,0.8955120429415053
SIM,1948,19,30-34,1967,14
STAT,1931,25,40-44,1956,5.689653963972011
SIM,1866,51,na,1917,1903
SIM,1909,33,25-29,1942,13
STAT,1838,95,na,1933,8.92596171492731
SIM,1782,78,na,1860,305
SIM,1858,19,15-19,1877,5
SIM,1881,44,45-49,1925,5
SIM,1893,17,15-19,1910,8
SIM,1900,29,30-34,1929,31
STAT,1859,26,30-34,1885,19.40014485751108
STAT,1934,31,15-19,1965,0.1658445694357986
SIM,1946,9,na,1955,4001
STAT,1825,69,na,1894,779.9782857615412
STAT,1906,23,50-100,1929,0.5593466378881066
SIM,1835,33,30-34,1868,19
STAT,1845,77,na,1922,611.6688120513782
STAT,1940,30,30-34,1970,15.421500949978286
STAT,1836,38,35-39,1874,5.563897481034951
STAT,1773,104,na,1877,0.027337495740950533
SIM,1837,85,na,1922,146
STAT,1861,45,30-34,1906,0.07679319340903686
STAT,1871,21,25-29,1892,53.86264912153566
SIM,1903,17,na,1920,3407
STAT,1919,45,45-49,1964,0.22374450690076728
STAT,1848,29,na,1877,1891.5166365003593
SIM,1900,40,na,1940,3125
SIM,1870,25,na,1895,2201
SIM,1844,38,35-39,1882,12
STAT,1938,30,na,1968,3596.6683884745307
STAT,1860,46,30-34,1906,0.07440879894514972
STAT,1885,17,15-19,1902,5.588231580459908
SIM,1845,37,35-39,1882,10
STAT,1861,70,na,1931,1102.0967489883037
STAT,1781,96,na,1877,1.5030760404458028
SIM,1937,20,na,1957,3254
STAT,1830,36,40-44,1866,3.6067958391356973
STAT,1869,44,25-29,1913,0.5797625585083632
STAT,1871,15,25-29,1886,5.41371817446832
STAT,1902,32,15-19,1934,0.18986238758585688
STAT,1817,53,20-24,1870,0.0015624785635909447
STAT,1844,36,na,1880,1745.4094342206097
STAT,1915,39,15-19,1954,0.018142312586977585
STAT,1835,109,na,1944,4.5282705108269503E-4
SIM,1880,35,35-39,1915,10
STAT,1923,33,35-39,1956,9.890600720722924
SIM,1928,21,20-24,1949,122
SIM,1904,61,na,1965,2788
SIM,1877,26,25-29,1903,44
SIM,1883,51,na,1934,1975
STAT,1933,32,15-19,1965,0.16359854749147748
STAT,1811,49,na,1860,1272.4895096514172
STAT,1820,85,na,1905,144.41612401118397
STAT,1869,32,25-29,1901,9.373923418118407
STAT,1934,31,na,1965,4881.016768415988
STAT,1870,31,15-19,1901,0.1325172641683864
SIM,1808,97,na,1905,1
SIM,1917,21,45-49,1938,1
STAT,1888,20,20-24,1908,77.39628220233408
SIM,1824,59,na,1883,1120
SIM,1896,20,20-24,1916,98
SIM,1813,44,35-39,1857,3
SIM,1825,97,na,1922,3
SIM,1901,33,50-100,1934,1
STAT,1924,28,30-34,1952,42.94579872185624
SIM,1932,28,30-34,1960,55
SIM,1844,67,na,1911,1027
SIM,1931,33,35-39,1964,15
STAT,1825,48,30-34,1873,0.0973868220972042
STAT,1894,24,30-34,1918,21.489616583092957
SIM,1834,20,35-39,1854,5
SIM,1882,13,na,1895,2455
STAT,1926,34,50-100,1960,0.9432020757174416
SIM,1875,21,35-39,1896,13
STAT,1857,65,na,1922,1259.1251478520899
SIM,1898,24,40-44,1922,1
SIM,1910,20,15-19,1930,3
STAT,1850,38,50-100,1888,0.8700878731582152
STAT,1892,39,30-34,1931,6.242755235151585
SIM,1876,72,na,1948,1202
STAT,1912,43,30-34,1955,0.11578893385149279
SIM,1884,26,50-100,1910,1
STAT,1881,52,50-100,1933,0.013709494091839145
SIM,1915,24,15-19,1939,5
SIM,1944,27,45-49,1971,1
STAT,1777,88,na,1865,38.63571107335672
SIM,1835,99,na,1934,1
STAT,1873,46,40-44,1919,0.16449490665157335
STAT,1822,44,35-39,1866,2.4970136126518305
STAT,1781,93,na,1874,6.551542172631477
STAT,1896,9,na,1905,3237.2859357097213
SIM,1875,28,na,1903,2315
SIM,1919,38,40-44,1957,4
SIM,1858,87,na,1945,125
STAT,1878,39,na,1917,2296.1632389449856
STAT,1760,94,na,1854,3.0
STAT,1858,113,na,1971,1.0660050779174319E-4
SIM,1927,27,45-49,1954,6
STAT,1811,50,20-24,1861,0.002445324684608705
STAT,1877,36,30-34,1913,5.247774783750706
SIM,1810,67,na,1877,790
STAT,1916,36,25-29,1952,0.9571142817865177
STAT,1819,50,50-100,1869,0.028585605629512376
SIM,1913,47,na,1960,3256
STAT,1837,37,35-39,1874,5.588859038741859
SIM,1862,92,na,1954,25
STAT,1832,70,na,1902,845.2138841149269
STAT,1925,38,25-29,1963,1.115231288425225
STAT,1856,31,30-34,1887,13.162702291010431
STAT,1872,35,35-39,1907,6.765790555601225
STAT,1833,52,na,1885,1361.2663317336219
STAT,1834,37,na,1871,1651.632091949986
SIM,1889,6,na,1895,3162
STAT,1931,23,45-49,1954,1.3743315487909753
SIM,1885,36,30-34,1921,5
SIM,1880,29,35-39,1909,10
SIM,1931,32,na,1963,4647
STAT,1936,27,45-49,1963,1.5618718376946514
SIM,1933,38,25-29,1971,5
STAT,1819,69,na,1888,804.1204724785539
SIM,1839,21,30-34,1860,18
SIM,1848,33,40-44,1881,7
STAT,1872,29,35-39,1901,9.077757662204048
SIM,1803,82,na,1885,139
SIM,1885,24,30-34,1909,27
STAT,1846,22,na,1868,1956.7290961638494
STAT,1886,48,40-44,1934,0.16869561975129646
SIM,1949,6,na,1955,4247
STAT,1919,27,45-49,1946,1.7634324674884645
SIM,1925,32,na,1957,4193
STAT,1820,44,30-34,1864,1.9864077308890533
STAT,1831,46,35-39,1877,0.10103090420924457
STAT,1856,24,na,1880,1804.1484083332225
STAT,1905,1,na,1906,3716.693422959819
STAT,1911,34,50-100,1945,0.7540911429047426
SIM,1847,84,na,1931,204
SIM,1830,44,35-39,1874,5
STAT,1853,53,25-29,1906,0.002637542027615834
STAT,1804,50,50-100,1854,0.055562981843246914
SIM,1912,31,40-44,1943,11
STAT,1907,24,15-19,1931,4.549486948064586
SIM,1967,3,na,1970,4497
STAT,1805,49,na,1854,1271.357902715338
SIM,1871,66,na,1937,1516
SIM,1883,0,na,1883,3145
STAT,1880,23,25-29,1903,56.83673043481379
STAT,1889,40,25-29,1929,0.7564756242989746
STAT,1897,20,50-100,1917,0.5182691658398961
STAT,1928,31,na,1959,4469.987315257269
STAT,1907,42,15-19,1949,0.0013291686667898238
SIM,1898,29,50-100,1927,1
STAT,1905,33,45-49,1938,1.3615034149040186
SIM,1850,67,na,1917,1168
STAT,1877,24,30-34,1901,17.345602903726462
SIM,1864,31,30-34,1895,21
STAT,1846,9,na,1855,2269.9934399999997
SIM,1849,11,na,1860,2249
STAT,1888,57,na,1945,2243.648943793711
STAT,1916,48,25-29,1964,0.05125564206540985
STAT,1858,54,20-24,1912,5.3153309025819E-4
SIM,1904,21,35-39,1925,6
STAT,1888,0,na,1888,3343.8869421397053
SIM,1918,53,na,1971,3612
SIM,1927,27,na,1954,4247
SIM,1827,39,40-44,1866,4
SIM,1894,38,na,1932,2960
STAT,1922,17,40-44,1939,1.5292251417995881
STAT,1911,44,25-29,1955,0.0635981838050151
STAT,1842,49,15-19,1891,2.8362452786214257E-4
STAT,1845,47,40-44,1892,0.1205812681894783
SIM,1885,86,na,1971,438
STAT,1872,79,na,1951,662.4562362621743
STAT,1890,3,na,1893,3053.315665688055
SIM,1923,8,na,1931,4477
STAT,1942,26,25-29,1968,65.29135521498605
SIM,1930,17,40-44,1947,4
STAT,1882,52,45-49,1934,0.013261800521612478
STAT,1936,29,40-44,1965,4.209711786166315
STAT,1905,17,40-44,1922,0.24975310083501362
SIM,1829,99,na,1928,1
SIM,1830,26,35-39,1856,10
STAT,1819,39,40-44,1858,10.424514160365336
STAT,1821,70,na,1891,747.5103799266336
STAT,1910,42,20-24,1952,0.01576788274799371
STAT,1831,34,35-39,1865,7.876047024958643
STAT,1939,15,na,1954,3489.188630208937
STAT,1887,16,na,1903,2675.3228843665743
SIM,1861,11,na,1872,2369
SIM,1900,31,45-49,1931,4
SIM,1821,79,na,1900,404
SIM,1864,87,na,1951,141
STAT,1952,18,35-39,1970,4.748841489480434
SIM,1923,34,20-24,1957,2
STAT,1843,46,25-29,1889,0.03922366627858068
STAT,1904,31,40-44,1935,5.90051052288742
SIM,1923,16,20-24,1939,153
SIM,1849,70,na,1919,1039
STAT,1823,34,na,1857,1529.2877195901624
STAT,1950,18,30-34,1968,13.611038339370058
STAT,1901,22,20-24,1923,91.12587393685547
SIM,1913,35,40-44,1948,1
SIM,1849,31,35-39,1880,10
STAT,1945,17,45-49,1962,0.5155064953491661
SIM,1838,29,45-49,1867,2
STAT,1866,23,40-44,1889,1.8173492415473242
STAT,1868,34,30-34,1902,15.60244315850249
STAT,1915,34,20-24,1949,2.326755694489043
STAT,1941,29,15-19,1970,0.6892136193314808
SIM,1855,11,na,1866,2316
SIM,1818,56,na,1874,1125
SIM,1895,21,15-19,1916,4
STAT,1832,43,45-49,1875,1.092556389344982
STAT,1865,43,50-100,1908,0.898069364281429
SIM,1840,43,45-49,1883,2
SIM,1878,76,na,1954,877
STAT,1799,66,na,1865,750.9454781375442
STAT,1910,58,na,1968,3071.8260680261305
SIM,1798,62,na,1860,882
STAT,1901,40,20-24,1941,0.01473033574429993
STAT,1881,90,na,1971,239.65550646033753
STAT,1893,3,na,1896,3167.155735239567
SIM,1889,79,na,1968,1133
STAT,1897,32,30-34,1929,22.05829933733335
STAT,1917,16,25-29,1933,8.831364241022234
SIM,1876,10,na,1886,2570
STAT,1890,64,na,1954,2007.7445443508325
STAT,1915,16,20-24,1931,26.87227531275753
SIM,1876,34,30-34,1910,22
STAT,1862,28,35-39,1890,7.7661848037774215
STAT,1893,16,na,1909,3033.1772770839257
STAT,1926,45,na,1971,4302.354412508835
STAT,1812,52,25-29,1864,0.011331250097460126
SIM,1903,24,25-29,1927,82
STAT,1831,28,35-39,1859,8.0818120222912
SIM,1874,23,40-44,1897,7
STAT,1931,41,45-49,1972,0.21034019882242644
SIM,1870,28,35-39,1898,7
SIM,1893,53,na,1946,2645
SIM,1890,34,45-49,1924,1
STAT,1868,16,30-34,1884,1.4712988454404672
SIM,1921,23,30-34,1944,37
SIM,1855,41,30-34,1896,4
STAT,1922,35,40-44,1957,1.611960187211151
STAT,1917,43,15-19,1960,0.0015116096899983101
STAT,1910,24,20-24,1934,98.03256856300888
SIM,1843,85,na,1928,156
STAT,1930,21,40-44,1951,4.0813834762997
SIM,1869,38,35-39,1907,9
STAT,1863,65,na,1928,1401.0081480912665
SIM,1859,18,20-24,1877,18
STAT,1870,84,na,1954,308.2993677061576
SIM,1872,51,na,1923,2024
STAT,1853,26,35-39,1879,8.520533080710146
STAT,1837,25,50-100,1862,0.540598902721329
STAT,1892,31,na,1923,2835.1423279699216
SIM,1803,57,na,1860,1031
SIM,1894,32,25-29,1926,15
STAT,1866,79,na,1945,609.1453096160828
STAT,1823,37,na,1860,1535.8541594821133
SIM,1849,29,20-24,1878,12
STAT,1887,13,na,1900,2724.667053808583
SIM,1870,25,30-34,1895,27
STAT,1839,77,na,1916,575.5107704518749
STAT,1880,27,40-44,1907,2.9833865189066073
SIM,1844,17,30-34,1861,1
SIM,1853,29,40-44,1882,2
STAT,1826,70,na,1896,766.1948220488575
STAT,1845,29,40-44,1874,2.5431934313143287
STAT,1787,110,na,1897,1.0184443891605576E-4
STAT,1833,29,15-19,1862,0.3616551182971912
SIM,1918,39,40-44,1957,2
STAT,1830,39,45-49,1869,1.5759641427433941
SIM,1861,26,35-39,1887,8
SIM,1864,25,na,1889,2097
SIM,1823,43,45-49,1866,1
SIM,1911,43,na,1954,3296
STAT,1849,23,40-44,1872,1.8756435432919798
STAT,1815,49,20-24,1864,0.0262107902285008
STAT,1887,21,15-19,1908,3.4965515130306972
STAT,1847,41,30-34,1888,0.8634941828584245
STAT,1851,35,50-100,1886,0.9113572071562609
STAT,1864,40,25-29,1904,0.5461337395553372
STAT,1819,41,25-29,1860,1.402913964763797
STAT,1820,40,15-19,1860,0.026980503629245603
STAT,1890,6,na,1896,3017.18338166594
SIM,1830,59,na,1889,1159
STAT,1838,36,na,1874,1753.1579993106654
STAT,1834,77,na,1911,535.897127513221
STAT,1879,30,20-24,1909,2.694468148521466
SIM,1875,50,50-100,1925,1
STAT,1875,50,na,1925,2120.802484416388
SIM,1940,16,20-24,1956,126
STAT,1854,15,25-29,1869,4.907743635182401
SIM,1803,51,50-100,1854,1
SIM,1878,79,na,1957,708
SIM,1917,25,30-34,1942,3
STAT,1866,26,45-49,1892,0.9707507484840165
SIM,1885,20,15-19,1905,3
SIM,1899,38,na,1937,3141
SIM,1835,59,na,1894,1242
SIM,1919,32,35-39,1951,14
STAT,1884,47,25-29,1931,0.05350864429178085
SIM,1866,31,35-39,1897,8
SIM,1887,30,20-24,1917,2
STAT,1924,42,45-49,1966,0.18700976096798935
STAT,1901,25,25-29,1926,56.316433232133754
STAT,1932,16,20-24,1948,170.00847271939597
STAT,1812,90,na,1902,34.24735422732384
SIM,1862,15,25-29,1877,5
SIM,1821,36,40-44,1857,4
SIM,1943,20,na,1963,3559
STAT,1909,25,30-34,1934,35.919271898824846
STAT,1886,32,25-29,1918,10.221201281834958
SIM,1911,40,na,1951,3364
STAT,1855,47,35-39,1902,0.09902391816499631
STAT,1817,96,na,1913,3.974265214474284
STAT,1841,39,20-24,1880,0.6132627916569674
SIM,1864,44,45-49,1908,1
SIM,1885,18,30-34,1903,1
SIM,1840,74,na,1914,701
SIM,1927,42,40-44,1969,2
SIM,1854,24,30-34,1878,22
SIM,1930,10,na,1940,4885
STAT,1923,30,30-34,1953,17.19976647473391
SIM,1943,15,30-34,1958,11
STAT,1861,41,15-19,1902,0.010896525715698036
STAT,1900,23,20-24,1923,90.03107293823547
STAT,1855,39,na,1894,1657.369947691835
STAT,1827,36,35-39,1863,7.519641758638049
STAT,1868,30,15-19,1898,0.12938979400870065
SIM,1854,20,15-19,1874,3
STAT,1850,36,na,1886,1704.6922978548541
STAT,1905,4,na,1909,3592.1893677154767
STAT,1905,43,na,1948,3144.0074236824853
SIM,1890,21,30-34,1911,28
STAT,1935,15,30-34,1950,15.814331775950373
STAT,1858,31,35-39,1889,7.5792235559370384
STAT,1855,23,50-100,1878,0.3361120863939747
STAT,1916,38,50-100,1954,0.4041615947546127
SIM,1868,21,20-24,1889,65
STAT,1929,31,40-44,1960,4.698437588688675
SIM,1816,52,na,1868,1272
SIM,1937,31,40-44,1968,3
STAT,1856,19,45-49,1875,0.05626291288349721
STAT,1836,35,30-34,1871,4.325156944797362
SIM,1880,32,30-34,1912,26
STAT,1894,27,35-39,1921,11.71427640884104
STAT,1913,23,30-34,1936,27.33411806935367
SIM,1948,21,45-49,1969,1
SIM,1909,15,25-29,1924,9
STAT,1879,49,50-100,1928,0.23779637329728542
SIM,1900,4,na,1904,3509
SIM,1918,20,20-24,1938,103
STAT,1869,48,40-44,1917,0.15471173856355036
STAT,1878,64,na,1942,1711.4496676806846
STAT,1899,28,50-100,1927,0.8251049173141349
STAT,1859,29,35-39,1888,7.2745665237791775
STAT,1863,62,na,1925,1515.220720101513
SIM,1858,84,na,1942,231
STAT,1846,62,na,1908,1355.6351444195689
STAT,1919,42,40-44,1961,0.2560645189806271
STAT,1945,22,30-34,1967,29.757835745572887
STAT,1883,51,45-49,1934,0.013505904790155126
SIM,1876,16,30-34,1892,2
STAT,1846,20,15-19,1866,3.062961170361381
STAT,1911,42,35-39,1953,0.1815700977290297
SIM,1854,39,35-39,1893,8
STAT,1856,44,45-49,1900,1.0882499258139315
STAT,1921,18,40-44,1939,1.5022228680915506
STAT,1882,32,na,1914,2192.340625147204
STAT,1840,101,na,1941,0.37447610144751875
STAT,1859,27,15-19,1886,0.347022960084298
STAT,1824,78,na,1902,430.8165896687629
SIM,1919,35,50-100,1954,1
STAT,1917,31,na,1948,3756.7033730917424
STAT,1846,24,30-34,1870,16.067846395676682
SIM,1893,13,na,1906,3221
SIM,1898,20,25-29,1918,74
SIM,1928,24,25-29,1952,119
STAT,1835,44,50-100,1879,0.7852833711700246
STAT,1853,50,20-24,1903,5.664797610631301E-4
STAT,1871,19,40-44,1890,0.17065616404968617
STAT,1931,20,na,1951,4500.976092833954
STAT,1870,47,30-34,1917,0.08929225760151267
SIM,1844,35,30-34,1879,3
SIM,1835,36,35-39,1871,11
STAT,1924,24,15-19,1948,5.896606101232621
STAT,1830,78,na,1908,471.570084025375
STAT,1905,31,25-29,1936,8.06370658977003
SIM,1839,58,na,1897,1359
STAT,1879,51,25-29,1930,0.003519360218803285
STAT,1895,16,25-29,1911,6.996276260335152
STAT,1901,43,25-29,1944,0.05854083237621963
STAT,1851,77,na,1928,621.7944048530865
STAT,1940,29,30-34,1969,37.708319986229775
SIM,1927,32,30-34,1959,18
SIM,1918,13,na,1931,4075
STAT,1811,103,na,1914,0.062241415413893955
SIM,1776,78,na,1854,259
SIM,1834,74,na,1908,629
SIM,1818,59,na,1877,1055
SIM,1839,18,na,1857,2026
STAT,1916,33,20-24,1949,2.368944252833111
STAT,1916,46,na,1962,3568.583827911796
STAT,1845,31,25-29,1876,8.707810387872435
STAT,1856,20,50-100,1876,0.35415513376653124
SIM,1775,93,na,1868,3
STAT,1854,33,25-29,1887,7.427230643038774
SIM,1907,20,45-49,1927,5
STAT,1911,43,na,1954,3328.7152990784775
SIM,1797,77,na,1874,289
SIM,1924,33,20-24,1957,2
STAT,1807,49,25-29,1856,0.2141443403408552
STAT,1882,21,30-34,1903,16.413823781688695
SIM,1836,44,na,1880,1523
SIM,1935,23,25-29,1958,142
STAT,1893,40,15-19,1933,0.016711498353060815
STAT,1887,25,30-34,1912,26.78984442714299
STAT,1903,19,35-39,1922,0.7335933078263196
STAT,1898,15,35-39,1913,0.7047397080274557
SIM,1931,30,30-34,1961,20
STAT,1841,39,50-100,1880,0.9767529887988524
STAT,1877,39,35-39,1916,6.861243387799442
STAT,1881,28,na,1909,2170.290214552864
STAT,1906,47,25-29,1953,0.04449634521413398
STAT,1829,46,40-44,1875,0.14177731775601976
SIM,1936,34,30-34,1970,14
SIM,1836,25,25-29,1861,34
STAT,1846,42,30-34,1888,0.8630363239518258
SIM,1862,33,25-29,1895,11
STAT,1887,75,na,1962,1301.6773076852517
STAT,1937,22,35-39,1959,8.662179142405346
STAT,1925,35,20-24,1960,0.29940103811282326
SIM,1871,27,35-39,1898,8
SIM,1887,13,na,1900,2685
SIM,1913,31,25-29,1944,8
STAT,1900,28,50-100,1928,0.8353688487259983
STAT,1910,45,25-29,1955,0.04697574912752815
SIM,1922,0,na,1922,4558
SIM,1841,39,25-29,1880,2
STAT,1925,37,50-100,1962,0.476035980547593
SIM,1885,39,35-39,1924,11
SIM,1854,42,30-34,1896,1
SIM,1839,24,35-39,1863,4
STAT,1890,49,45-49,1939,0.1505430186848023
SIM,1867,36,na,1903,2281
SIM,1875,19,20-24,1894,17
STAT,1867,19,20-24,1886,15.888461455605295
SIM,1848,36,45-49,1884,1
SIM,1922,20,40-44,1942,3
STAT,1863,27,35-39,1890,7.999128531099293
STAT,1833,39,25-29,1872,2.163217924424621
STAT,1873,24,na,1897,2251.801819937303
SIM,1876,13,na,1889,2529
STAT,1868,37,35-39,1905,6.375121993016478
SIM,1806,93,na,1899,8
STAT,1828,43,25-29,1871,0.5354351125802024
SIM,1931,35,na,1966,4688
STAT,1860,48,20-24,1908,0.009082541802247624
STAT,1928,5,na,1933,4785.971897066717
STAT,1787,81,na,1868,195.2090659458728
SIM,1903,28,40-44,1931,4
STAT,1931,21,25-29,1952,113.51515861437295
STAT,1834,110,na,1944,1.7132130086060623E-4
SIM,1859,28,30-34,1887,32
STAT,1928,34,30-34,1962,18.586117517975055
STAT,1898,56,na,1954,2607.508117036686
SIM,1892,68,na,1960,2177
SIM,1865,54,50-100,1919,1
SIM,1823,34,na,1857,1504
SIM,1876,37,35-39,1913,16
SIM,1914,29,25-29,1943,65
SIM,1945,22,35-39,1967,13
STAT,1839,16,40-44,1855,0.1602452407113129
SIM,1906,38,30-34,1944,4
STAT,1922,46,na,1968,3996.985649289725
SIM,1895,25,30-34,1920,41
STAT,1866,49,30-34,1915,0.0825828673988909
STAT,1914,20,40-44,1934,3.1327303761675505
SIM,1911,19,35-39,1930,2
STAT,1862,25,30-34,1887,20.711214845721393
SIM,1834,45,50-100,1879,3
STAT,1867,50,50-100,1917,0.013589842740624828
SIM,1858,17,25-29,1875,6
STAT,1927,23,25-29,1950,107.17585343885928
STAT,1895,34,25-29,1929,12.50677547019868
STAT,1842,50,45-49,1892,0.010660661084249347
STAT,1826,45,50-100,1871,0.23299509600820056
STAT,1935,33,50-100,1968,1.0799247431136199
SIM,1866,5,na,1871,2517
STAT,1951,12,na,1963,4418.982105285411
STAT,1920,31,20-24,1951,2.5342513094171553
STAT,1933,8,na,1941,5043.773520829513
STAT,1829,81,na,1910,326.7491419843099
STAT,1843,43,20-24,1886,0.10904034077604971
SIM,1828,34,30-34,1862,21
STAT,1869,50,na,1919,1998.8740783808078
SIM,1852,16,15-19,1868,9
STAT,1890,30,25-29,1920,11.924947952329342
STAT,1858,87,na,1945,130.4938425296192
STAT,1835,22,na,1857,1808.8817318918395
STAT,1919,32,30-34,1951,16.05789529966532
STAT,1863,39,40-44,1902,3.59250100070646
STAT,1844,16,15-19,1860,5.270412578176299
STAT,1867,24,na,1891,2084.8489810102574
STAT,1891,46,na,1937,2637.527821261712
STAT,1857,54,50-100,1911,0.010943034036621236
STAT,1942,23,20-24,1965,110.10348336179447
STAT,1890,28,50-100,1918,0.7362221857053622
SIM,1770,90,na,1860,19
SIM,1781,93,na,1874,7
STAT,1941,30,45-49,1971,1.5625199907687044
STAT,1900,28,15-19,1928,0.5924862873323443
STAT,1904,34,45-49,1938,1.3452051492384636
SIM,1944,25,25-29,1969,65
STAT,1814,85,na,1899,125.99931858796455
STAT,1875,28,na,1903,2309.1920131995776
SIM,1863,36,40-44,1899,9
SIM,1912,34,45-49,1946,1
SIM,1860,66,na,1926,1332
STAT,1908,41,15-19,1949,0.0013499920805967109
STAT,1936,25,25-29,1961,59.557533924767654
STAT,1855,36,40-44,1891,3.1257425895485453
STAT,1864,104,na,1968,0.4564717972256318
STAT,1856,21,na,1877,1843.5745647703754
STAT,1887,43,30-34,1930,1.2060606640640508
SIM,1852,99,na,1951,1
SIM,1871,39,40-44,1910,4
SIM,1853,31,25-29,1884,12
STAT,1906,29,25-29,1935,57.78670053352555
STAT,1870,13,na,1883,2443.2247680404193
SIM,1848,18,15-19,1866,9
STAT,1904,21,30-34,1925,24.20951889688291
SIM,1867,61,na,1928,1798
STAT,1841,49,30-34,1890,0.0653416968781902
STAT,1870,26,35-39,1896,8.97294078502283
STAT,1927,21,na,1948,4263.131126017791
STAT,1873,42,25-29,1915,0.6145024608613316
STAT,1925,20,na,1945,4153.948305083823
SIM,1868,35,50-100,1903,2
STAT,1872,14,na,1886,2471.397955884531
SIM,1843,57,na,1900,1397
SIM,1910,24,30-34,1934,29
SIM,1926,27,30-34,1953,50
STAT,1767,110,na,1877,0.0016837083642464814
SIM,1879,41,50-100,1920,4
STAT,1894,32,15-19,1926,0.1728899601999515
STAT,1919,16,50-100,1935,0.07866428852003406
STAT,1890,19,45-49,1909,0.07504066280842417
STAT,1901,16,na,1917,3347.917052338356
STAT,1845,12,na,1857,2135.0999382528066
STAT,1928,17,45-49,1945,0.5946093423252055
SIM,1851,52,na,1903,1609
SIM,1894,63,na,1957,2260
STAT,1849,41,35-39,1890,1.36401535845367
STAT,1900,38,25-29,1938,0.8103727523191151
STAT,1769,93,na,1862,5.017942292550483
SIM,1875,31,45-49,1906,2
STAT,1801,81,na,1882,201.80367422214806
STAT,1902,24,30-34,1926,23.59922986882495
STAT,1859,44,30-34,1903,0.8527565374225657
SIM,1831,28,45-49,1859,4
SIM,1850,33,na,1883,1870
STAT,1855,47,50-100,1902,0.17371624448197415
STAT,1889,42,na,1931,2692.176016640664
SIM,1888,69,na,1957,1695
STAT,1918,27,30-34,1945,39.39315975294051
SIM,1878,15,20-24,1893,23
STAT,1860,29,na,1889,1822.438655505382
STAT,1812,59,na,1871,1072.8993334416487
STAT,1919,17,35-39,1936,4.380626931294728
SIM,1858,25,na,1883,2022
SIM,1870,59,na,1929,1763
SIM,1850,22,40-44,1872,1
STAT,1871,52,30-34,1923,0.005554195710516643
STAT,1958,13,na,1971,4872.098999547125
SIM,1854,15,35-39,1869,1
STAT,1827,41,15-19,1868,0.013477538068228023
STAT,1939,17,20-24,1956,128.2031623051526
STAT,1943,28,35-39,1971,15.097988636302446
STAT,1892,16,45-49,1908,0.0774827070538773
STAT,1881,19,35-39,1900,0.4980700816210692
STAT,1806,51,25-29,1857,0.012722614461470287
SIM,1839,30,50-100,1869,3
STAT,1880,52,40-44,1932,0.010429036891013146
SIM,1833,25,45-49,1858,2
STAT,1846,15,35-39,1861,0.5173247869084526
STAT,1834,28,20-24,1862,9.478231021680067
SIM,1842,28,20-24,1870,9
SIM,1947,17,20-24,1964,117
STAT,1842,22,40-44,1864,1.9033660441918863
STAT,1832,49,20-24,1881,0.00760536419174517
STAT,1858,41,45-49,1899,1.1135495049351962
STAT,1782,75,na,1857,336.3689552967794
SIM,1873,34,45-49,1907,3
SIM,1837,20,15-19,1857,2
SIM,1855,44,35-39,1899,4
STAT,1807,72,na,1879,594.6221682172109
SIM,1830,28,50-100,1858,2
STAT,1847,44,35-39,1891,1.3172830547463916
SIM,1890,24,35-39,1914,10
STAT,1821,49,45-49,1870,0.36155634373844103
SIM,1825,30,35-39,1855,5
SIM,1884,34,20-24,1918,2
SIM,1920,23,na,1943,3872
SIM,1927,17,35-39,1944,3
STAT,1833,27,na,1860,1749.010960524067
STAT,1808,110,na,1918,1.0684756462924381E-4
STAT,1830,51,30-34,1881,0.004001374600388741
SIM,1877,91,na,1968,167
STAT,1860,31,50-100,1891,0.7051811688190887
STAT,1877,42,25-29,1919,0.6284971915726397
SIM,1953,10,na,1963,4442
STAT,1884,21,35-39,1905,5.462817517656496
SIM,1907,32,45-49,1939,2
SIM,1818,51,50-100,1869,1
STAT,1911,22,15-19,1933,4.769452079309334
SIM,1839,43,40-44,1882,4
SIM,1919,22,25-29,1941,102
SIM,1867,37,25-29,1904,2
STAT,1820,44,50-100,1864,1.8253476405952085
SIM,1910,17,25-29,1927,6
SIM,1841,34,50-100,1875,1
STAT,1902,17,25-29,1919,7.55506050747668
STAT,1876,34,20-24,1910,2.6156111050532256
STAT,1837,22,30-34,1859,15.13333011120727
STAT,1851,15,45-49,1866,0.057809356642087376
STAT,1900,45,30-34,1945,0.07227121894459095
SIM,1892,21,35-39,1913,13
STAT,1934,35,30-34,1969,2.3801045435955563
STAT,1881,29,50-100,1910,0.5796149940446573
STAT,1899,42,45-49,1941,0.13436134144440634
STAT,1914,43,35-39,1957,0.18820277045331016
SIM,1886,34,na,1920,2306
SIM,1905,17,15-19,1922,6
STAT,1891,2,na,1893,3115.573320087312
SIM,1793,87,na,1880,48
SIM,1825,38,30-34,1863,7
STAT,1926,40,20-24,1966,0.02062401247334957
STAT,1877,18,30-34,1895,1.5577957509110703
SIM,1879,20,20-24,1899,68
STAT,1884,29,30-34,1913,23.334809870023175
STAT,1906,53,na,1959,2984.507257455404
STAT,1847,47,na,1894,1651.3143086487803
STAT,1919,26,na,1945,3836.9465721313245
SIM,1864,4,na,1868,2515
STAT,1909,9,na,1918,3676.025715263725
STAT,1851,46,na,1897,1623.0020797030352
STAT,1826,36,15-19,1862,0.06329889232210055
SIM,1901,50,na,1951,2916
STAT,1869,4,na,1873,2717.732354132656
STAT,1839,109,na,1948,4.736886591698743E-4
STAT,1884,33,50-100,1917,0.851542218664546
STAT,1941,28,50-100,1969,0.9722442208728928
SIM,1912,21,30-34,1933,34
STAT,1880,45,35-39,1925,0.14082094688380545
STAT,1882,24,35-39,1906,5.327583492345372
STAT,1864,19,na,1883,2173.968413487569
STAT,1861,26,25-29,1887,33.71066771535997
STAT,1923,49,15-19,1972,4.0470567114475435E-4
STAT,1957,15,15-19,1972,56.54674628291524
STAT,1912,46,35-39,1958,0.11734973867158277
SIM,1889,37,45-49,1926,4
STAT,1841,56,na,1897,1406.1480112848863
STAT,1909,43,25-29,1952,0.06272168852378583
STAT,1813,54,35-39,1867,0.02162417665421095
SIM,1848,94,na,1942,12
SIM,1866,100,na,1966,1
SIM,1892,29,30-34,1921,40
STAT,1879,15,30-34,1894,1.5834577222505808
SIM,1887,21,25-29,1908,52
STAT,1897,45,45-49,1942,0.16986282185474139
SIM,1823,33,35-39,1856,8
SIM,1869,62,na,1931,1646
STAT,1910,19,40-44,1929,0.2604266274894724
STAT,1898,34,40-44,1932,5.496676660511418
STAT,1881,50,na,1931,1993.2326340202358
STAT,1879,21,25-29,1900,56.7795573429063
STAT,1817,38,30-34,1855,17.43340536860364
SIM,1818,50,na,1868,1280
STAT,1856,83,na,1939,292.6103004567871
SIM,1865,33,40-44,1898,5
STAT,1876,26,50-100,1902,0.6264854212498371
SIM,1879,86,na,1965,386
STAT,1869,26,25-29,1895,38.846669694404525
STAT,1824,33,45-49,1857,3.7051281537565592
SIM,1846,39,45-49,1885,3
STAT,1832,79,na,1911,421.14199139460646
STAT,1952,4,na,1956,4452.040253109639
SIM,1916,38,25-29,1954,1
SIM,1927,7,na,1934,4673
STAT,1856,55,na,1911,1524.0657636838218
STAT,1864,49,50-100,1913,0.20247068815672617
SIM,1862,30,20-24,1892,2
SIM,1837,39,35-39,1876,11
STAT,1903,16,30-34,1919,2.1476649809730044
STAT,1876,27,15-19,1903,0.4428158561519785
STAT,1818,43,30-34,1861,2.6212268777149137
STAT,1814,53,40-44,1867,0.0301465751630308
SIM,1893,27,25-29,1920,56
STAT,1818,44,na,1862,1413.9156301363869
SIM,1851,20,35-39,1871,8
STAT,1887,16,35-39,1903,0.5812363653904222
SIM,1843,36,25-29,1879,1
SIM,1874,26,45-49,1900,4
SIM,1895,16,35-39,1911,1
SIM,1925,35,30-34,1960,2
STAT,1927,32,20-24,1959,2.8344632872343882
STAT,1855,100,na,1955,0.7544332875069972
STAT,1857,33,40-44,1890,3.2174829781986336
STAT,1913,18,50-100,1931,0.07217800326911177
STAT,1805,53,30-34,1858,0.021416326829069937
STAT,1835,43,30-34,1878,0.8655920693084813
STAT,1829,39,35-39,1868,6.181439205176532
STAT,1891,24,45-49,1915,0.809914226051303
STAT,1855,39,45-49,1894,1.4023671370588489
STAT,1838,20,25-29,1858,50.58643776487504
SIM,1935,32,20-24,1967,2
SIM,1849,42,na,1891,1740
SIM,1787,87,na,1874,31
SIM,1774,80,na,1854,200
STAT,1853,31,15-19,1884,0.11214289816998797
STAT,1912,47,50-100,1959,0.2053544243772616
SIM,1906,28,na,1934,3248
STAT,1880,16,50-100,1896,0.04891255570220789
SIM,1843,43,30-34,1886,8
STAT,1809,46,25-29,1855,0.1654519963626978
STAT,1810,64,na,1874,844.4745240639726
STAT,1828,40,20-24,1868,0.13923213167788923
SIM,1819,46,50-100,1865,2
STAT,1835,100,na,1935,0.6757115675394971
STAT,1825,91,na,1916,30.798434462424197
STAT,1886,38,50-100,1924,1.2191003810944527
STAT,1908,54,na,1962,3056.885314642948
STAT,1801,87,na,1888,56.700424649589145
SIM,1852,36,35-39,1888,17
STAT,1925,26,na,1951,4194.159946130652
STAT,1830,44,25-29,1874,0.48580929607977535
SIM,1863,8,na,1871,2316
STAT,1928,18,50-100,1946,0.4447885993862351
SIM,1901,6,na,1907,3443
STAT,1844,36,35-39,1880,5.7638956863402635
STAT,1917,35,30-34,1952,1.8053538427022857
SIM,1910,33,na,1943,3439
STAT,1885,34,30-34,1919,16.300070801433943
SIM,1893,34,30-34,1927,26
STAT,1829,49,45-49,1878,0.1879073241620929
STAT,1908,38,25-29,1946,0.8665747580504896
STAT,1840,43,40-44,1883,1.5201906341840996
STAT,1841,33,45-49,1874,1.4435740099467373
SIM,1911,16,30-34,1927,3
STAT,1881,50,35-39,1931,0.007969587221343052
STAT,1849,49,30-34,1898,0.07107165688794753
STAT,1843,20,35-39,1863,5.019277207666445
STAT,1920,22,25-29,1942,97.00886102769101
SIM,1889,19,15-19,1908,7
STAT,1902,63,na,1965,2592.8722749929952
STAT,1852,93,na,1945,21.188008825356704
STAT,1837,49,50-100,1886,0.16127653275686443
SIM,1762,95,na,1857,4
STAT,1845,17,40-44,1862,0.16358503492651283
STAT,1840,18,35-39,1858,0.4634783638275563
SIM,1799,72,na,1871,528
STAT,1924,48,50-100,1972,0.2536650695661352
STAT,1775,93,na,1868,6.0112784254428755
STAT,1843,28,30-34,1871,20.78235357590225
STAT,1928,30,15-19,1958,0.15196241049047005
SIM,1883,29,20-24,1912,13
SIM,1895,17,na,1912,3219
SIM,1863,44,30-34,1907,1
STAT,1903,22,25-29,1925,76.94681772949883
STAT,1923,25,45-49,1948,1.8864801617575204
SIM,1925,28,25-29,1953,82
SIM,1863,20,25-29,1883,52
STAT,1864,13,na,1877,2274.5566081391607
STAT,1873,27,na,1900,2286.562451341409
STAT,1878,16,25-29,1894,5.592713037533005
STAT,1860,28,30-34,1888,19.368911910778753
STAT,1876,37,25-29,1913,2.8101102621467913
SIM,1942,28,25-29,1970,73
SIM,1846,20,25-29,1866,52
SIM,1944,22,20-24,1966,101
STAT,1913,45,40-44,1958,0.1460646397470353
STAT,1815,43,45-49,1858,3.6322975595605795
SIM,1840,43,na,1883,1554
STAT,1948,23,na,1971,3959.8981778617726
SIM,1851,28,30-34,1879,27
SIM,1914,57,na,1971,3265
SIM,1888,20,30-34,1908,30
SIM,1857,77,na,1934,584
SIM,1902,32,25-29,1934,19
STAT,1902,35,50-100,1937,0.35665834462863794
STAT,1853,41,na,1894,1757.0517355790223
SIM,1912,28,na,1940,3432
STAT,1835,36,25-29,1871,2.289165214317452
STAT,1890,33,na,1923,2744.4769181526735
STAT,1934,28,25-29,1962,83.60698269315745
STAT,1824,44,na,1868,1477.2609416970793
SIM,1930,35,40-44,1965,1
STAT,1882,34,45-49,1916,1.588359902165753
STAT,1918,43,35-39,1961,0.20193840624990544
SIM,1825,66,na,1891,888
STAT,1860,20,35-39,1880,5.140558288021363
STAT,1899,32,35-39,1931,13.108501446220787
SIM,1874,49,na,1923,2067
SIM,1931,25,45-49,1956,2
STAT,1881,44,40-44,1925,2.0249961060922934
STAT,1821,54,25-29,1875,0.005161963933779764
STAT,1854,30,20-24,1884,2.0220913970513323
STAT,1855,20,25-29,1875,48.21451146122173
STAT,1931,1,na,1932,5163.686543173511
STAT,1838,39,45-49,1877,1.5817450782004203
SIM,1857,41,35-39,1898,1
STAT,1917,28,25-29,1945,64.9804453752311
SIM,1863,77,na,1940,688
STAT,1944,27,40-44,1971,4.759047124228497
STAT,1875,29,20-24,1904,11.309994786039011
STAT,1860,42,45-49,1902,1.1457767994527572
STAT,1804,54,25-29,1858,0.012022307045209615
SIM,1911,22,25-29,1933,81
STAT,1887,47,na,1934,2366.287993951954
SIM,1870,87,na,1957,183
SIM,1832,33,45-49,1865,2
STAT,1806,59,na,1865,1027.5391820690047
STAT,1850,47,15-19,1897,2.806545619089224E-4
SIM,1941,25,na,1966,3620
STAT,1844,17,50-100,1861,0.043252906889435686
STAT,1854,52,30-34,1906,0.0042362873826564005
SIM,1852,40,50-100,1892,1
SIM,1945,1,na,1946,4014
STAT,1845,103,na,1948,0.10155536761731762
STAT,1876,44,30-34,1920,1.1069357160961877
STAT,1818,36,25-29,1854,10.061888696485966
STAT,1809,53,30-34,1862,0.01568143300602951
SIM,1829,28,na,1857,1641
STAT,1833,54,20-24,1887,4.484891478255639E-4
STAT,1907,20,50-100,1927,0.5692785297574405
STAT,1871,45,25-29,1916,0.05457164946087539
STAT,1883,85,na,1968,519.882386365262
STAT,1859,15,45-49,1874,0.05769024584520128
STAT,1885,27,25-29,1912,39.832860979977696
STAT,1908,45,30-34,1953,0.0772834647903617
SIM,1901,24,20-24,1925,83
SIM,1885,1,na,1886,3047
STAT,1821,39,35-39,1860,13.343418668975913
STAT,1891,46,50-100,1937,0.1623813376535242
STAT,1928,40,25-29,1968,0.08623565581111382
STAT,1890,16,40-44,1906,0.21176560586868354
SIM,1943,27,30-34,1970,36
STAT,1900,68,na,1968,2301.208219133088
SIM,1889,17,na,1906,3056
STAT,1842,29,25-29,1871,37.34139399142093
SIM,1861,25,20-24,1886,12
SIM,1868,18,30-34,1886,5
SIM,1865,18,15-19,1883,6
STAT,1889,70,na,1959,1749.0667950968875
STAT,1867,44,20-24,1911,0.13897794590543996
STAT,1884,31,45-49,1915,1.6341965573305388
SIM,1861,42,50-100,1903,1
STAT,1877,32,15-19,1909,0.13955021412661273
SIM,1831,25,40-44,1856,2
STAT,1827,27,na,1854,1545.9496578364824
STAT,1870,23,30-34,1893,16.456725513168074
STAT,1813,48,40-44,1861,0.4604448049486931
STAT,1863,15,35-39,1878,0.5252406694673806
STAT,1869,41,20-24,1910,0.1460016584506275
SIM,1914,47,50-100,1961,1
STAT,1940,25,15-19,1965,0.6806563183317583
SIM,1789,82,na,1871,132
SIM,1873,31,40-44,1904,5
STAT,1954,5,na,1959,4591.446077213316
STAT,1926,43,25-29,1969,0.08303051101968019
STAT,1834,38,30-34,1872,4.071622918047232
STAT,1909,36,na,1945,3380.4334210574298
SIM,1892,19,20-24,1911,20
STAT,1869,56,na,1925,1866.6515324668196
SIM,1919,16,30-34,1935,18
STAT,1921,21,30-34,1942,30.75991063496843
STAT,1855,54,40-44,1909,0.007275499740253083
SIM,1827,92,na,1919,18
STAT,1865,66,na,1931,1403.4289555088426
SIM,1813,41,na,1854,1424
STAT,1897,35,35-39,1932,9.020668782655932
SIM,1812,65,na,1877,830
STAT,1879,18,35-39,1897,0.5411821417168571
SIM,1821,70,na,1891,737
SIM,1889,34,40-44,1923,6
SIM,1901,27,25-29,1928,60
STAT,1881,22,na,1903,2158.358731738488
STAT,1932,39,15-19,1971,0.024322549312874035
STAT,1817,40,45-49,1857,4.115251002437901
STAT,1936,22,20-24,1958,100.42526387862883
SIM,1906,16,20-24,1922,30
STAT,1871,42,20-24,1913,0.1487946895729562
SIM,1854,94,na,1948,13
STAT,1853,25,20-24,1878,10.434434226497066
SIM,1880,18,na,1898,2571
STAT,1895,16,50-100,1911,0.060486526065899264
STAT,1885,80,na,1965,857.3933707229008
STAT,1884,19,20-24,1903,16.45767064586106
STAT,1909,37,30-34,1946,1.6297829450931371
STAT,1898,37,45-49,1935,2.548512491180893
SIM,1951,18,25-29,1969,59
STAT,1889,44,40-44,1933,2.5878202228145892
STAT,1943,18,25-29,1961,43.39829475391832
STAT,1912,53,na,1965,3264.583003649905
SIM,1878,21,15-19,1899,3
SIM,1892,34,na,1926,3120
STAT,1893,19,30-34,1912,1.899259419707005
SIM,1897,44,40-44,1941,1
STAT,1890,67,na,1957,1881.4082930286804
STAT,1900,48,35-39,1948,0.10219232280264925
STAT,1888,15,40-44,1903,0.20515054443275443
STAT,1819,109,na,1928,3.7557600231774964E-4
SIM,1932,30,45-49,1962,3
STAT,1847,72,na,1919,931.267848527209
STAT,1875,35,15-19,1910,0.05504475201785525
STAT,1857,18,15-19,1875,5.1662968389679635
SIM,1812,93,na,1905,10
STAT,1855,29,35-39,1884,7.044792557539089
STAT,1866,14,na,1880,2324.902641440779
STAT,1918,37,40-44,1955,1.4906101136418803
SIM,1892,31,45-49,1923,3
STAT,1835,26,15-19,1861,0.37906834571182885
STAT,1880,39,40-44,1919,4.315829139399713
STAT,1900,35,20-24,1935,1.0197949124109864
STAT,1920,38,40-44,1958,1.5468036091399977
STAT,1933,21,na,1954,4589.837743208907
SIM,1864,34,35-39,1898,6
STAT,1895,31,20-24,1926,3.3426883741311095
STAT,1861,48,35-39,1909,0.10858644595325347
STAT,1864,107,na,1971,0.06376462185649791
SIM,1875,62,na,1937,1717
SIM,1938,27,20-24,1965,22
SIM,1894,69,na,1963,2052
STAT,1844,33,30-34,1877,14.351100030272468
STAT,1851,28,20-24,1879,9.809878229676588
SIM,1887,37,40-44,1924,4
STAT,1826,28,30-34,1854,80.35548270854149
SIM,1880,44,30-34,1924,7
SIM,1926,37,40-44,1963,3
SIM,1867,34,20-24,1901,2
STAT,1812,46,30-34,1858,0.3295187845667548
STAT,1898,19,15-19,1917,7.546159369363524
STAT,1814,110,na,1924,1.2701217654420126E-4
STAT,1828,110,na,1938,1.5562814997909698E-4
SIM,1863,29,35-39,1892,9
STAT,1808,48,30-34,1856,0.36080179950073227
STAT,1932,9,na,1941,4979.692864988298
STAT,1830,54,35-39,1884,0.005453177057777217
STAT,1912,22,35-39,1934,8.525055278694868
STAT,1885,37,35-39,1922,6.660171025671655
STAT,1832,73,na,1905,715.503880026972
SIM,1875,29,30-34,1904,29
SIM,1893,37,35-39,1930,9
STAT,1864,52,25-29,1916,0.002966398724676063
SIM,1926,33,25-29,1959,11
SIM,1853,47,na,1900,1699
SIM,1886,6,na,1892,2577
STAT,1929,4,na,1933,4865.960127897458
SIM,1834,28,30-34,1862,29
SIM,1946,18,15-19,1964,48
STAT,1909,40,20-24,1949,0.01578234358656094
STAT,1848,43,40-44,1891,1.659269058514127
SIM,1939,15,na,1954,3451
STAT,1891,48,15-19,1939,2.604021614621597E-4
STAT,1903,11,na,1914,3476.465386430438
SIM,1850,25,45-49,1875,1
STAT,1908,35,20-24,1943,0.23537938396109181
SIM,1856,43,40-44,1899,7
SIM,1920,22,35-39,1942,12
STAT,1872,44,30-34,1916,1.0746946230838517
SIM,1834,49,na,1883,1412
STAT,1837,25,35-39,1862,8.154231973662037
SIM,1877,16,15-19,1893,4
STAT,1888,23,na,1911,2632.295292922657
SIM,1866,41,45-49,1907,1
SIM,1859,30,45-49,1889,1
STAT,1854,29,na,1883,1764.4266533523478
STAT,1853,19,50-100,1872,0.044077201268824716
STAT,1863,45,35-39,1908,0.1172195136230225
STAT,1869,34,50-100,1903,0.8313590335720928
SIM,1852,33,30-34,1885,28
STAT,1858,39,30-34,1897,3.9077894984196657
STAT,1938,18,15-19,1956,42.27921068202768
SIM,1904,33,na,1937,3303
STAT,1842,25,45-49,1867,1.0087767479271839
STAT,1856,34,35-39,1890,7.400528005450732
STAT,1844,41,15-19,1885,0.009949703845186333
SIM,1850,29,25-29,1879,45
SIM,1934,28,35-39,1962,26
STAT,1914,35,15-19,1949,0.018285468733336408
SIM,1851,18,20-24,1869,15
STAT,1926,28,35-39,1954,16.94206097486639
STAT,1791,86,na,1877,67.69218744878589
STAT,1869,28,na,1897,2176.4327848092016
STAT,1843,82,na,1925,315.15156234591785
STAT,1874,40,na,1914,2253.37291469086
SIM,1919,32,na,1951,3915
STAT,1836,31,15-19,1867,0.11778303974057396
STAT,1879,37,40-44,1916,4.328795192544448
SIM,1828,40,na,1868,1587
STAT,1935,27,30-34,1962,50.45679449841734
STAT,1869,16,15-19,1885,5.5390725736192135
STAT,1934,38,35-39,1972,3.1500072257660565
SIM,1873,61,na,1934,1808
STAT,1913,41,50-100,1954,0.10885616445000677
SIM,1854,48,50-100,1902,2
STAT,1876,38,na,1914,2288.039775681918
SIM,1836,75,na,1911,639
SIM,1883,39,30-34,1922,6
STAT,1887,32,50-100,1919,0.9681822899021801
STAT,1904,46,45-49,1950,0.1809022200116923
STAT,1927,35,25-29,1962,1.1584414534701026
STAT,1830,41,20-24,1871,0.1252816055698257
STAT,1950,20,45-49,1970,1.2618878706699603
STAT,1870,46,50-100,1916,0.228258805725092
STAT,1783,107,na,1890,0.0070468189805244635
SIM,1896,45,50-100,1941,3
STAT,1863,31,na,1894,1986.3776835949327
STAT,1846,27,50-100,1873,0.5739820691656559
SIM,1895,32,50-100,1927,2
SIM,1832,30,40-44,1862,2
STAT,1896,52,na,1948,2672.2477220901815
SIM,1876,44,na,1920,2214
SIM,1831,38,na,1869,1577
SIM,1869,25,20-24,1894,14
SIM,1908,38,35-39,1946,5
SIM,1918,32,20-24,1950,4
STAT,1901,19,30-34,1920,2.0963374103093657
SIM,1893,24,20-24,1917,77
STAT,1894,23,na,1917,2862.4137200948176
STAT,1838,98,na,1936,2.180908625542854
SIM,1845,52,na,1897,1505
SIM,1933,22,45-49,1955,2
STAT,1868,36,20-24,1904,0.6981426694994852
STAT,1897,37,na,1934,2976.5000451072938
STAT,1820,47,35-39,1867,0.23482272297977508
STAT,1854,49,40-44,1903,0.1199335164988985
SIM,1847,22,35-39,1869,5
STAT,1939,24,50-100,1963,0.6238469477133817
SIM,1861,76,na,1937,787
STAT,1818,46,35-39,1864,0.3030387534566919
STAT,1877,50,45-49,1927,0.014425582254489555
STAT,1906,49,15-19,1955,3.0396752319274833E-4
STAT,1843,30,45-49,1873,1.4457270715109054
SIM,1860,33,20-24,1893,2
STAT,1839,22,35-39,1861,4.99208850615428
STAT,1834,34,15-19,1868,0.11087877968031906
STAT,1918,33,25-29,1951,9.23932539877383
STAT,1842,33,50-100,1875,0.7932791231711601
SIM,1945,15,na,1960,3657
STAT,1875,39,30-34,1914,5.123013163976687
SIM,1830,53,na,1883,1303
STAT,1908,48,35-39,1956,0.10984809153784626
STAT,1849,100,na,1949,0.7960936448103303
STAT,1935,30,50-100,1965,1.0818168197417004
STAT,1826,43,20-24,1869,0.15209306645397005
STAT,1853,47,30-34,1900,0.0729163333951799
STAT,1831,43,30-34,1874,0.8375708055322723
SIM,1826,33,20-24,1859,4
STAT,1874,33,40-44,1907,4.168235753279652
SIM,1846,36,40-44,1882,5
SIM,1928,43,na,1971,4461
STAT,1815,109,na,1924,3.175666658963972E-4
SIM,1845,80,na,1925,391
STAT,1862,31,25-29,1893,8.306950645362184
STAT,1897,44,50-100,1941,0.09143342707851473
STAT,1926,33,15-19,1959,0.1466956836590227
STAT,1843,36,15-19,1879,0.044741410055430475
STAT,1868,40,na,1908,2104.238152445262
STAT,1914,40,30-34,1954,0.12051383171091325
SIM,1948,15,15-19,1963,42
STAT,1795,76,na,1871,390.39819508605433
STAT,1845,46,na,1891,1596.5723498001394
SIM,1825,38,na,1863,1563
SIM,1886,16,25-29,1902,6
STAT,1859,97,na,1956,4.706524489161259
STAT,1936,32,30-34,1968,14.45642259475233
STAT,1862,53,35-39,1915,0.006842047611935777
STAT,1860,24,15-19,1884,2.569464585076536
STAT,1877,20,45-49,1897,0.6874067050624988
STAT,1882,38,na,1920,2153.7366380721587
SIM,1845,15,25-29,1860,3
STAT,1816,39,25-29,1855,9.456596774746972
STAT,1822,54,45-49,1876,0.018047258400511204
SIM,1882,44,na,1926,2143
SIM,1868,28,40-44,1896,4
STAT,1857,31,na,1888,1807.596396805597
STAT,1894,26,20-24,1920,14.291438881138765
STAT,1773,92,na,1865,8.986074475184195
STAT,1804,51,20-24,1855,0.002660666141392563
STAT,1903,26,40-44,1929,4.0403118264479
STAT,1924,30,45-49,1954,1.742115373410194
STAT,1913,49,20-24,1962,0.010130486121721254
STAT,1873,95,na,1968,54.54735585833266
SIM,1851,30,45-49,1881,2
STAT,1838,36,40-44,1874,3.5832603571131667
STAT,1861,16,15-19,1877,5.389615323165253
SIM,1888,42,40-44,1930,5
STAT,1852,33,20-24,1885,2.0080553773748417
SIM,1886,33,50-100,1919,1
STAT,1933,32,45-49,1965,2.003310425610954
SIM,1795,82,na,1877,142
SIM,1837,23,na,1860,1803
STAT,1871,37,40-44,1908,4.106414130122514
SIM,1816,55,na,1871,1193
STAT,1893,34,20-24,1927,3.2106137646858333
STAT,1885,24,20-24,1909,64.48477782639738
SIM,1903,21,20-24,1924,89
STAT,1793,104,na,1897,0.011062958044457068
STAT,1836,41,25-29,1877,0.5010762773680676
STAT,1915,36,na,1951,3607.7476415905767
STAT,1841,23,35-39,1864,5.059810568806772
SIM,1911,26,40-44,1937,6
STAT,1881,40,25-29,1921,0.5919500048937182
STAT,1844,98,na,1942,2.2561887996204177
STAT,1846,50,50-100,1896,0.011362740902885636
STAT,1885,42,15-19,1927,0.012987927278244975
SIM,1824,39,25-29,1863,4
STAT,1921,36,na,1957,3972.075172523552
STAT,1850,98,na,1948,2.289972647352299
STAT,1794,60,na,1854,955.0
STAT,1880,20,20-24,1900,69.04185479895501
STAT,1839,46,na,1885,1545.8863021420116
STAT,1875,31,50-100,1906,0.8933237030682342
STAT,1913,48,45-49,1961,0.19985042397632716
STAT,1925,22,45-49,1947,1.2723012243471594
STAT,1891,80,na,1971,1166.9848079384246
SIM,1942,25,20-24,1967,15
STAT,1826,42,50-100,1868,1.0322125428650133
STAT,1833,32,40-44,1865,3.42582523837854
SIM,1843,23,na,1866,1942
STAT,1827,35,20-24,1862,0.8394899870228306
STAT,1944,23,25-29,1967,94.18493824258788
SIM,1898,59,na,1957,2470
STAT,1955,15,50-100,1970,0.4700492991008569
STAT,1828,50,30-34,1878,0.0048425633613210185
SIM,1805,83,na,1888,113
SIM,1833,22,40-44,1855,1
SIM,1888,23,35-39,1911,7
SIM,1838,44,35-39,1882,1
STAT,1824,30,40-44,1854,14.97350144979599
SIM,1841,32,40-44,1873,7
STAT,1859,47,35-39,1906,0.10477392384281253
STAT,1823,51,25-29,1874,0.004282550788987209
STAT,1899,48,15-19,1947,2.883903733818187E-4
STAT,1890,42,25-29,1932,0.740756306361663
STAT,1891,21,40-44,1912,2.4428697087590767
STAT,1876,40,15-19,1916,0.013614462491604553
STAT,1911,17,35-39,1928,0.7932776303372828
SIM,1801,56,na,1857,1059
STAT,1857,36,45-49,1893,1.492417864331114
SIM,1872,29,45-49,1901,2
SIM,1928,22,35-39,1950,15
STAT,1930,41,25-29,1971,0.08888639594473349
STAT,1934,25,20-24,1959,23.218051326958406
SIM,1947,8,na,1955,4119
STAT,1837,17,na,1854,1973.9656498888644
SIM,1830,50,na,1880,1377
SIM,1904,64,na,1968,2692
STAT,1926,25,30-34,1951,44.672834091362446
SIM,1879,23,25-29,1902,66
STAT,1848,26,na,1874,1932.8520557317747
STAT,1789,76,na,1865,329.9036256673909
STAT,1863,54,30-34,1917,0.0047990636401888985
STAT,1953,6,na,1959,4492.352814661602
SIM,1847,16,na,1863,2164
STAT,1932,15,45-49,1947,0.6277813804211091
STAT,1864,26,40-44,1890,2.5308357353478357
SIM,1809,76,na,1885,369
SIM,1949,9,na,1958,4245
STAT,1889,35,45-49,1924,2.3469935517813756
SIM,1822,55,na,1877,1215
STAT,1815,103,na,1918,0.06405926087668737
STAT,1876,47,35-39,1923,0.13600364620796876
STAT,1917,25,20-24,1942,18.207374723037468
STAT,1825,29,25-29,1854,139.93349875502417
SIM,1874,18,na,1892,2365
SIM,1869,48,50-100,1917,3
STAT,1874,18,15-19,1892,5.713159488858433
STAT,1943,14,na,1957,3933.670988925821
STAT,1906,26,50-100,1932,0.8831756537446421
SIM,1796,61,na,1857,943
STAT,1900,25,50-100,1925,0.8440071705313729
STAT,1838,17,35-39,1855,0.48659546629284306
STAT,1847,29,45-49,1876,0.9700095711378803
STAT,1825,40,35-39,1865,2.064195716621878
STAT,1940,15,50-100,1955,0.359553724646245
STAT,1797,71,na,1868,608.6362725320495
STAT,1854,20,na,1874,1823.5515492906172
STAT,1840,51,25-29,1891,0.0023355947986481575
STAT,1867,95,na,1962,29.016963643635872
STAT,1867,47,25-29,1914,0.050857484765790446
STAT,1823,65,na,1888,914.063719016004
SIM,1885,55,na,1940,1980
SIM,1842,40,45-49,1882,8
SIM,1934,25,30-34,1959,54
STAT,1892,31,35-39,1923,12.031823549022645
STAT,1821,36,30-34,1857,11.851678677411085
STAT,1830,48,40-44,1878,0.12663550952734207
STAT,1840,47,20-24,1887,0.007941401970914778
STAT,1853,35,30-34,1888,4.118043173919312
SIM,1951,15,20-24,1966,136
SIM,1865,36,45-49,1901,1
SIM,1886,0,na,1886,3190
STAT,1872,45,na,1917,2153.152057454662
STAT,1816,80,na,1896,288.26691534435923
STAT,1912,24,25-29,1936,86.60538931151389
SIM,1872,26,40-44,1898,4
STAT,1785,86,na,1871,70.7106872640013
SIM,1871,35,na,1906,2264
SIM,1871,42,30-34,1913,1
STAT,1916,12,na,1928,3958.3537930978946
STAT,1869,103,na,1972,1.5463018666519133
STAT,1850,20,40-44,1870,1.7886747229692774
STAT,1849,45,15-19,1894,3.0293729095624177E-4
SIM,1879,30,30-34,1909,29
SIM,1833,40,35-39,1873,3
STAT,1872,40,15-19,1912,0.013217921712296422
SIM,1929,18,15-19,1947,41
STAT,1833,34,50-100,1867,0.7089157695484175
STAT,1842,35,na,1877,1857.6892890209224
SIM,1919,19,35-39,1938,7
SIM,1784,76,na,1860,302
STAT,1931,29,na,1960,4564.36048402248
SIM,1833,29,25-29,1862,43
SIM,1925,25,20-24,1950,19
SIM,1939,19,20-24,1958,117
STAT,1895,46,25-29,1941,0.04012972864780761
STAT,1863,42,30-34,1905,0.9519214296936652
STAT,1872,54,40-44,1926,0.00970143437872487
STAT,1845,52,20-24,1897,5.193932441439943E-4
SIM,1929,36,45-49,1965,1
STAT,1875,41,45-49,1916,1.459835227775129
SIM,1846,29,35-39,1875,12
SIM,1865,6,na,1871,2499
STAT,1896,15,30-34,1911,1.9978872472171327
STAT,1907,30,45-49,1937,1.4007048374240147
SIM,1911,12,na,1923,3731
SIM,1874,15,na,1889,2388
STAT,1912,22,na,1934,3455.100500051017
STAT,1921,36,35-39,1957,2.5536780352288857
SIM,1861,35,30-34,1896,3
STAT,1922,41,35-39,1963,0.21866037032294308
SIM,1803,51,na,1854,1161
STAT,1823,68,na,1891,817.862516213156
STAT,1833,23,45-49,1856,0.5713107035046626
STAT,1848,28,15-19,1876,0.39957659180546207
STAT,1918,42,20-24,1960,0.017738545175554617
STAT,1879,46,50-100,1925,0.24355680157418916
STAT,1851,19,25-29,1870,4.897849964231595
STAT,1926,37,30-34,1963,2.1041745726745096
SIM,1858,56,na,1914,1687
STAT,1891,22,50-100,1913,0.4766177784987851
STAT,1808,50,45-49,1858,0.05457986785803603
STAT,1897,23,50-100,1920,0.5136032645431645
SIM,1858,53,na,1911,1748
STAT,1891,12,na,1903,3018.3882085038877
SIM,1904,30,na,1934,3307
STAT,1916,15,na,1931,3889.1213035067744
STAT,1859,66,na,1925,1232.356192610827
SIM,1932,20,35-39,1952,15
SIM,1883,20,na,1903,2214
STAT,1865,60,na,1925,1633.0534529120507
STAT,1867,92,na,1959,60.1453393110506
STAT,1868,16,50-100,1884,0.04522434056281775
SIM,1841,28,na,1869,1750
STAT,1935,23,15-19,1958,6.845646756763963
SIM,1866,82,na,1948,350
SIM,1883,41,45-49,1924,6
SIM,1902,26,30-34,1928,35
STAT,1835,46,35-39,1881,0.09513380058531024
STAT,1815,100,na,1915,0.4738751121384735
STAT,1870,25,20-24,1895,10.946015828559137
STAT,1808,51,na,1859,1232.9317019528141
STAT,1889,47,45-49,1936,0.15453229684204925
SIM,1915,30,45-49,1945,1
STAT,1838,29,35-39,1867,8.122377088618272
SIM,1833,95,na,1928,5
STAT,1879,18,na,1897,2490.9607425768977
STAT,1909,47,40-44,1956,0.1368681765635226
STAT,1900,41,15-19,1941,0.0012624378771697677
STAT,1821,52,35-39,1873,0.013056370177253463
STAT,1924,41,na,1965,4179.193127533724
SIM,1929,22,na,1951,4290
STAT,1910,15,25-29,1925,8.149767952413779
STAT,1912,31,30-34,1943,14.70592080102478
SIM,1830,41,30-34,1871,1
STAT,1878,33,na,1911,2339.458036504541
STAT,1873,19,45-49,1892,0.06225079903393795
STAT,1873,24,50-100,1897,0.3882639801220453
SIM,1929,24,45-49,1953,1
STAT,1922,49,30-34,1971,0.09618053636112406
STAT,1855,50,25-29,1905,0.0025532199029302716
SIM,1841,90,na,1931,52
SIM,1897,40,na,1937,3032
STAT,1839,41,40-44,1880,1.7568331994389534
STAT,1853,72,na,1925,955.7539751191794
STAT,1819,50,20-24,1869,0.0013966908841021807
STAT,1930,2,na,1932,4995.001975719711
STAT,1886,41,20-24,1927,0.15919826437040913
STAT,1908,4,na,1912,3686.625412042649
STAT,1879,80,na,1959,750.4901616680111
STAT,1884,25,15-19,1909,0.42632280309034165
SIM,1847,41,40-44,1888,6
STAT,1822,53,30-34,1875,0.007551227517420439
STAT,1951,21,50-100,1972,0.7429054688528027
SIM,1897,35,45-49,1932,2
SIM,1870,37,30-34,1907,3
SIM,1823,36,50-100,1859,4
SIM,1926,30,20-24,1956,3
SIM,1869,23,30-34,1892,18
STAT,1920,16,30-34,1936,12.950416682429086
STAT,1847,22,25-29,1869,51.74942499009151
SIM,1841,35,45-49,1876,2
SIM,1946,21,40-44,1967,4
SIM,1869,28,25-29,1897,49
STAT,1894,36,30-34,1930,6.501513302428856
STAT,1843,18,20-24,1861,15.212680997651262
STAT,1882,23,50-100,1905,0.3734856659623752
STAT,1865,31,40-44,1896,3.7285589046062615
SIM,1835,28,na,1863,1739
STAT,1878,30,na,1908,2368.256977109815
STAT,1912,56,na,1968,3211.2380609427455
STAT,1921,43,40-44,1964,0.265718712352644
STAT,1859,17,50-100,1876,0.04275949210869202
STAT,1918,30,20-24,1948,2.4683055315506897
SIM,1814,91,na,1905,11
STAT,1856,22,35-39,1878,4.99544473992898
STAT,1868,52,25-29,1920,0.003175569721526387
STAT,1810,95,na,1905,5.624530773894184
SIM,1920,31,30-34,1951,21
STAT,1883,26,45-49,1909,1.0319067148559826
STAT,1768,106,na,1874,0.008643218128240045
STAT,1831,53,40-44,1884,0.006468016578438737
STAT,1922,40,50-100,1962,0.1277391458846483
STAT,1858,53,45-49,1911,0.010576488270281785
SIM,1926,8,na,1934,4547
SIM,1902,5,na,1907,3502
STAT,1813,44,25-29,1857,1.850697005315123
STAT,1910,27,na,1937,3417.507215518318
SIM,1772,88,na,1860,31
SIM,1798,93,na,1891,7
STAT,1920,32,35-39,1952,9.455982307529469
STAT,1918,47,na,1965,3693.308696897274
STAT,1938,21,40-44,1959,3.1447757003981858
STAT,1898,40,35-39,1938,0.16237904508522524
SIM,1873,24,35-39,1897,9
STAT,1833,35,45-49,1868,1.56128954599184
STAT,1880,35,25-29,1915,2.8947257695754005
SIM,1838,22,25-29,1860,58
SIM,1847,13,na,1860,2221
STAT,1893,47,na,1940,2683.3043150877106
STAT,1841,87,na,1928,121.46113310111167
SIM,1874,27,20-24,1901,11
SIM,1889,40,35-39,1929,5
STAT,1930,41,na,1971,4622.892394604674
STAT,1884,33,na,1917,2217.794782693474
SIM,1849,48,na,1897,1690
STAT,1931,35,15-19,1966,0.024066975259695027
STAT,1852,46,35-39,1898,0.10178624824699362
STAT,1837,19,40-44,1856,0.16521695012534554
STAT,1827,45,30-34,1872,0.09092133740332792
SIM,1845,49,50-100,1894,2
STAT,1852,36,25-29,1888,2.1206105180679273
STAT,1865,24,35-39,1889,4.985099183507085
STAT,1953,3,na,1956,4495.274126134271
SIM,1809,73,na,1882,501
SIM,1934,37,30-34,1971,2
STAT,1851,30,35-39,1881,7.741315667206736
STAT,1894,48,30-34,1942,0.06545811088690792
STAT,1935,30,20-24,1965,3.191518260892096
SIM,1900,71,na,1971,2115
STAT,1904,43,40-44,1947,0.21012319707495447
STAT,1812,47,45-49,1859,0.7901469772880038
STAT,1847,78,na,1925,576.1603949024275
SIM,1863,26,50-100,1889,1
SIM,1803,88,na,1891,39
STAT,1904,27,na,1931,3233.873588303343
STAT,1804,53,50-100,1857,0.05230480155737084
STAT,1849,51,45-49,1900,0.010934463053529558
SIM,1835,90,na,1925,35
SIM,1894,38,50-100,1932,1
SIM,1903,31,30-34,1934,26
SIM,1829,39,45-49,1868,1
SIM,1860,36,25-29,1896,5
STAT,1868,2,na,1870,3020.0482704468072
STAT,1862,33,15-19,1895,0.11453991078464076
STAT,1820,88,na,1908,72.32205011962915
SIM,1912,43,40-44,1955,1
SIM,1828,49,na,1877,1433
STAT,1889,29,15-19,1918,0.5253509825139018
SIM,1872,85,na,1957,277
STAT,1925,26,25-29,1951,73.69182227798532
STAT,1893,37,25-29,1930,3.449357846242133
STAT,1942,22,50-100,1964,0.6517536018614836
SIM,1824,50,na,1874,1333
STAT,1842,19,15-19,1861,5.453987083584257
STAT,1927,45,35-39,1972,0.15360557778457143
STAT,1943,17,na,1960,3687.29867276329
SIM,1920,24,25-29,1944,109
STAT,1921,31,40-44,1952,4.130877383043954
STAT,1944,20,20-24,1964,113.49592804444987
STAT,1906,25,45-49,1931,1.538034509960075
STAT,1897,20,30-34,1917,22.63799470873332
STAT,1848,110,na,1958,3.0499594761359086E-4
STAT,1948,23,50-100,1971,0.7135104383339804
STAT,1853,48,45-49,1901,0.17635972234535402
STAT,1860,20,na,1880,1883.5074994020176
SIM,1855,29,45-49,1884,3
STAT,1845,40,20-24,1885,0.11740955114887044
SIM,1850,19,15-19,1869,5
STAT,1861,36,35-39,1897,5.582428712360421
SIM,1790,73,na,1863,411
STAT,1901,21,45-49,1922,0.9248813839983843
STAT,1877,85,na,1962,438.56966353598295
SIM,1930,19,na,1949,4535
SIM,1917,37,30-34,1954,6
STAT,1813,52,50-100,1865,0.0394850436450533
STAT,1930,33,40-44,1963,4.76793140763912
STAT,1874,36,45-49,1910,1.9334211068370624
SIM,1914,25,45-49,1939,1
SIM,1935,25,na,1960,4748
SIM,1889,48,na,1937,2663
SIM,1869,16,25-29,1885,7
STAT,1877,48,30-34,1925,0.09366578429744457
STAT,1870,48,45-49,1918,0.21596749349486066
SIM,1878,47,50-100,1925,2
SIM,1920,47,50-100,1967,4
STAT,1864,25,50-100,1889,0.5443597873970238
STAT,1935,37,40-44,1972,1.977484399989893
STAT,1892,62,na,1954,2162.6634427357412
STAT,1859,40,50-100,1899,0.8023512991905707
STAT,1779,86,na,1865,56.32403410454018
STAT,1872,48,na,1920,2105.1105779962327
SIM,1855,22,25-29,1877,55
STAT,1826,46,25-29,1872,0.05390761044702706
STAT,1862,41,50-100,1903,0.8571768219258014
SIM,1878,18,25-29,1896,10
STAT,1822,51,40-44,1873,0.013897347210138942
SIM,1777,94,na,1871,1
SIM,1834,43,na,1877,1507
SIM,1841,17,15-19,1858,2
SIM,1784,73,na,1857,408
SIM,1891,26,45-49,1917,1
STAT,1937,19,45-49,1956,0.45773269471161054
STAT,1917,32,50-100,1949,0.8179093298198529
SIM,1855,42,na,1897,1855
STAT,1819,91,na,1910,30.590358687487676
STAT,1817,65,na,1882,880.27247367539
STAT,1868,46,30-34,1914,0.08749763549148974
SIM,1824,35,45-49,1859,1
SIM,1908,35,30-34,1943,2
STAT,1840,107,na,1947,0.0030948807664178367
SIM,1933,26,25-29,1959,94
SIM,1884,44,30-34,1928,2
STAT,1943,25,30-34,1968,39.45617025557532
STAT,1861,23,20-24,1884,55.21045266468631
STAT,1846,54,30-34,1900,0.004293618246264698
SIM,1833,26,20-24,1859,8
STAT,1847,26,40-44,1873,2.6742468619974518
STAT,1875,31,35-39,1906,9.873715708283886
STAT,1822,51,50-100,1873,0.019936848553256042
STAT,1871,60,na,1931,1789.0724219178478
STAT,1855,17,35-39,1872,0.4637796951744456
SIM,1807,47,na,1854,1273
STAT,1802,66,na,1868,783.3570591304858
STAT,1925,29,na,1954,4149.941992279432
STAT,1919,40,15-19,1959,0.0015765176524436672
STAT,1871,43,35-39,1914,1.686403403537598
SIM,1928,16,40-44,1944,7
STAT,1899,36,15-19,1935,0.07303646024090112
SIM,1868,15,na,1883,2345
STAT,1951,16,25-29,1967,48.76371532128721
STAT,1849,103,na,1952,0.10761732188263924
STAT,1867,40,40-44,1907,2.0154163654806645
STAT,1847,41,na,1888,1735.9287067581004
SIM,1880,49,na,1929,2234
STAT,1922,39,20-24,1961,0.28276127441390514
STAT,1907,2,na,1909,3699.2100682358705
STAT,1889,32,40-44,1921,5.057716708839956
SIM,1870,31,25-29,1901,10
SIM,1816,40,35-39,1856,5
STAT,1863,52,40-44,1915,0.00868114196767773
SIM,1847,44,45-49,1891,2
SIM,1897,32,40-44,1929,8
STAT,1895,43,20-24,1938,0.013484326770680382
STAT,1824,35,50-100,1859,2.1157451641534566
SIM,1830,51,50-100,1881,2
SIM,1883,31,35-39,1914,14
SIM,1884,70,na,1954,1338
STAT,1896,58,na,1954,2467.419584459141
STAT,1810,92,na,1902,17.619324897423862
STAT,1838,64,na,1902,1167.0471881275605
STAT,1884,43,45-49,1927,1.3867547843475778
SIM,1872,25,50-100,1897,2
STAT,1864,29,45-49,1893,0.9281623946090839
SIM,1879,55,na,1934,2096
STAT,1827,51,25-29,1878,0.003190654037022933
STAT,1863,34,na,1897,1961.3557704088864
STAT,1897,23,35-39,1920,7.349661855383854
STAT,1900,47,20-24,1947,0.008829448092576015
SIM,1820,34,30-34,1854,17
STAT,1885,30,15-19,1915,0.13517516339583321
STAT,1885,49,35-39,1934,0.1290775881341926
STAT,1839,44,45-49,1883,1.0236570072553317
STAT,1908,23,20-24,1931,96.27502285239049
STAT,1874,74,na,1948,1071.1939025020024
STAT,1937,14,na,1951,3629.6789421228927
STAT,1845,50,30-34,1895,0.0042727267173113224
SIM,1925,6,na,1931,4539
STAT,1817,52,45-49,1869,0.031349113703371775
SIM,1864,56,na,1920,1840
SIM,1901,15,25-29,1916,8
STAT,1792,65,na,1857,774.3509187220641
SIM,1910,27,35-39,1937,13
STAT,1892,17,20-24,1909,20.977290335775717
STAT,1893,30,40-44,1923,5.237268521434205
STAT,1902,27,35-39,1929,12.864254727405855
STAT,1922,15,na,1937,4042.8966707658424
SIM,1884,37,25-29,1921,4
STAT,1821,46,40-44,1867,0.2740347563210351
STAT,1867,37,15-19,1904,0.04981347943466712
STAT,1881,59,na,1940,1773.6180154614813
SIM,1827,61,na,1888,1032
STAT,1841,53,na,1894,1460.585534441265
STAT,1869,53,20-24,1922,6.644927923504109E-4
SIM,1848,27,50-100,1875,1
SIM,1951,18,na,1969,4000
STAT,1911,39,45-49,1950,0.6157970520002861
SIM,1853,16,na,1869,2101
SIM,1916,23,20-24,1939,109
SIM,1818,87,na,1905,101
SIM,1932,11,na,1943,4930
STAT,1920,26,40-44,1946,4.846802137777237
SIM,1889,38,20-24,1927,3
STAT,1894,42,25-29,1936,0.05407109333489686
STAT,1898,30,25-29,1928,13.199600415801097
SIM,1892,43,45-49,1935,1
STAT,1903,48,50-100,1951,0.18387748433727547
SIM,1924,32,45-49,1956,2
STAT,1829,27,35-39,1856,13.866559849970697
STAT,1931,16,50-100,1947,0.46439586906840463
STAT,1850,23,45-49,1873,0.5857578896376314
STAT,1899,32,na,1931,3088.8474348889868
STAT,1921,33,30-34,1954,16.493419139668042
STAT,1826,79,na,1905,381.76941862684373
SIM,1875,40,40-44,1915,5
STAT,1918,45,25-29,1963,0.053578189370822024
STAT,1866,45,na,1911,1979.877922335163
STAT,1802,69,na,1871,700.4541090359194
STAT,1858,19,na,1877,1962.7229057667887
STAT,1909,33,na,1942,3395.249060108023
STAT,1918,49,40-44,1967,0.15757125885161907
SIM,1908,23,na,1931,3275
STAT,1880,42,30-34,1922,1.1435849966034968
SIM,1790,76,na,1866,313
STAT,1836,43,15-19,1879,0.010503228146865185
STAT,1873,16,40-44,1889,0.17628035827169225
SIM,1946,0,na,1946,4191
SIM,1916,33,50-100,1949,3
STAT,1813,51,30-34,1864,0.01587727907991349
SIM,1903,41,40-44,1944,1
STAT,1912,34,35-39,1946,8.422348422229346
STAT,1858,35,15-19,1893,0.04198765394378132
SIM,1887,25,40-44,1912,3
SIM,1861,42,na,1903,1999
SIM,1876,41,na,1917,2253
STAT,1848,34,50-100,1882,0.7076550197614758
SIM,1902,22,15-19,1924,4
STAT,1908,33,50-100,1941,0.7341726533502149
STAT,1834,30,35-39,1864,8.219342221537515
SIM,1845,83,na,1928,251
STAT,1804,52,35-39,1856,0.03042209803220287
STAT,1892,4,na,1896,3112.7620966593277
SIM,1837,27,35-39,1864,10
STAT,1773,98,na,1871,0.47298224231242464
STAT,1851,16,20-24,1867,15.597051612828102
STAT,1859,46,20-24,1905,0.009048303683519702
SIM,1911,32,35-39,1943,10
STAT,1828,52,20-24,1880,5.769750106634943E-4
SIM,1911,48,50-100,1959,2
SIM,1864,22,35-39,1886,5
STAT,1846,93,na,1939,21.67658576140973
STAT,1871,40,50-100,1911,1.0010280844181156
SIM,1842,30,35-39,1872,9
SIM,1947,10,na,1957,4119
STAT,1795,79,na,1874,293.7759128206808
STAT,1844,45,30-34,1889,0.06829010406715338
SIM,1898,22,na,1920,2951
STAT,1896,18,35-39,1914,0.6828227139661273
SIM,1938,23,40-44,1961,1
STAT,1921,46,45-49,1967,0.23203366002630246
SIM,1891,23,40-44,1914,2
STAT,1879,25,40-44,1904,2.982329605756772
STAT,1889,16,50-100,1905,0.057277346308257704
SIM,1896,27,40-44,1923,4
SIM,1914,23,na,1937,3523
STAT,1893,27,15-19,1920,0.5435481904156213
STAT,1903,32,35-39,1935,13.612318573822547
STAT,1907,20,35-39,1927,8.146374807350213
STAT,1926,21,15-19,1947,6.1276447727274395
SIM,1943,23,15-19,1966,4
SIM,1948,7,na,1955,4240
STAT,1860,18,20-24,1878,15.580265872953992
STAT,1881,48,20-24,1929,0.0108136752275254
SIM,1865,33,50-100,1898,4
SIM,1885,39,50-100,1924,1
SIM,1925,38,35-39,1963,10
SIM,1831,69,na,1900,878
SIM,1854,97,na,1951,6
STAT,1914,47,15-19,1961,3.451381968832356E-4
SIM,1917,37,na,1954,3658
STAT,1817,68,na,1885,787.1129315430514
STAT,1815,39,na,1854,1427.7241249627111
STAT,1862,47,40-44,1909,0.13763673791734454
STAT,1814,54,na,1868,1257.2048141926953
STAT,1872,50,25-29,1922,0.003404562741675073
SIM,1830,84,na,1914,173
STAT,1928,39,50-100,1967,0.5001835511435921
SIM,1852,68,na,1920,1129
STAT,1857,33,50-100,1890,0.6797780004999998
SIM,1883,23,na,1906,2211
STAT,1870,8,na,1878,2524.7015629688144
SIM,1829,36,40-44,1865,7
SIM,1887,81,na,1968,867
SIM,1935,22,na,1957,4625
SIM,1929,21,40-44,1950,3
STAT,1931,40,30-34,1971,0.16179139053292194
SIM,1824,32,40-44,1856,6
SIM,1866,39,30-34,1905,6
SIM,1882,21,40-44,1903,5
STAT,1888,27,40-44,1915,3.344391972207413
SIM,1800,77,na,1877,300
SIM,1915,20,35-39,1935,15
SIM,1872,82,na,1954,389
STAT,1788,97,na,1885,0.8778612462625315
STAT,1935,33,25-29,1968,12.072355288546056
SIM,1832,23,35-39,1855,5
STAT,1822,80,na,1902,314.33202392782187
STAT,1869,59,na,1928,1778.6378847834847
SIM,1887,15,30-34,1902,5
STAT,1839,34,35-39,1873,8.126984594009976
STAT,1860,30,45-49,1890,1.347400818212455
STAT,1924,24,50-100,1948,0.7288759925918867
STAT,1917,38,35-39,1955,2.361586299068935
SIM,1932,24,50-100,1956,1
STAT,1767,98,na,1865,0.48097172831904156
STAT,1905,45,15-19,1950,3.1117239537181555E-4
SIM,1821,76,na,1897,551
SIM,1851,83,na,1934,234
SIM,1867,67,na,1934,1522
STAT,1778,100,na,1878,0.19637543359589787
STAT,1881,52,25-29,1933,0.0032152559206805632
SIM,1934,21,15-19,1955,4
STAT,1847,8,na,1855,2260.0721399999998
SIM,1946,24,45-49,1970,1
STAT,1885,36,20-24,1921,0.7293585258884503
SIM,1846,68,na,1914,1073
STAT,1812,49,35-39,1861,0.4534376416783414
STAT,1866,32,50-100,1898,0.7983442838027279
STAT,1889,73,na,1962,1598.4675683136677
STAT,1818,45,20-24,1863,0.026369912676134297
STAT,1916,32,45-49,1948,1.5347518223459637
SIM,1851,24,15-19,1875,3
SIM,1869,26,35-39,1895,11
STAT,1861,33,30-34,1894,13.656508841811132
STAT,1877,39,50-100,1916,1.1909989323670382
STAT,1870,38,35-39,1908,6.5223974406551575
STAT,1938,24,45-49,1962,1.051298849187505
STAT,1915,25,50-100,1940,0.9656128921207617
SIM,1812,62,na,1874,939
SIM,1847,34,35-39,1881,17
SIM,1887,8,na,1895,2707
STAT,1943,15,20-24,1958,135.88835078096358
STAT,1929,18,40-44,1947,1.6818479909303203
STAT,1820,54,na,1874,1208.4821449176288
SIM,1841,20,40-44,1861,2
SIM,1846,24,40-44,1870,1
STAT,1820,35,35-39,1855,18.40218005844864
STAT,1843,24,15-19,1867,2.7569706303312786
STAT,1843,42,45-49,1885,1.0408365219857547
STAT,1848,46,45-49,1894,0.1758595783253911
STAT,1948,19,20-24,1967,146.4798742366696
SIM,1879,33,35-39,1912,12
STAT,1868,42,15-19,1910,0.012432056251421575
STAT,1918,40,30-34,1958,0.12876808105092502
STAT,1871,30,20-24,1901,2.5560465640209387
STAT,1850,54,20-24,1904,5.058721166709623E-4
SIM,1869,96,na,1965,43
SIM,1902,38,na,1940,3142
STAT,1913,41,25-29,1954,0.06616747292474943
SIM,1923,25,50-100,1948,1
STAT,1805,106,na,1911,0.004238378517864019
SIM,1815,76,na,1891,420
STAT,1779,83,na,1862,106.25885494627232
STAT,1768,103,na,1871,0.0351203438728611
STAT,1909,33,15-19,1942,0.11536195125255624
STAT,1829,53,na,1882,1346.2283442404346
STAT,1831,27,50-100,1858,0.550237928802393
STAT,1844,35,20-24,1879,0.6347403698386972
STAT,1812,44,40-44,1856,7.916978683212841
STAT,1849,39,20-24,1888,0.5793256705870788
SIM,1860,97,na,1957,8
STAT,1942,22,45-49,1964,1.1144986167175486
SIM,1838,32,35-39,1870,10
STAT,1853,41,25-29,1894,0.48818091031146393
SIM,1888,35,35-39,1923,16
SIM,1902,36,40-44,1938,3
STAT,1880,74,na,1954,1105.277129696588
STAT,1912,44,45-49,1956,0.15047045789282898
STAT,1883,23,40-44,1906,1.9240877419948939
SIM,1855,26,40-44,1881,1
SIM,1820,44,40-44,1864,4
SIM,1843,33,20-24,1876,2
SIM,1837,17,25-29,1854,7
STAT,1838,24,40-44,1862,1.7890885775427476
STAT,1834,40,45-49,1874,1.1487843756378846
STAT,1864,19,35-39,1883,0.4723128959547149
SIM,1867,30,na,1897,2334
SIM,1941,20,45-49,1961,1
STAT,1875,59,na,1934,1887.1322039363067
STAT,1927,42,30-34,1969,0.15146691832523618
STAT,1912,21,20-24,1933,100.97823571798715
STAT,1852,26,15-19,1878,0.3858867785639598
STAT,1865,34,45-49,1899,1.4803919903365015
SIM,1920,21,20-24,1941,112
STAT,1903,38,40-44,1941,1.2637169575572333
SIM,1906,19,25-29,1925,14
SIM,1875,96,na,1971,74
STAT,1869,18,40-44,1887,0.16870931332721262
SIM,1852,31,na,1883,1899
SIM,1969,1,na,1970,4492
STAT,1871,49,40-44,1920,0.15724481431844084
STAT,1877,44,15-19,1921,0.013350064091317405
STAT,1835,53,na,1888,1369.1869412998713
SIM,1892,37,na,1929,3113
STAT,1869,100,na,1969,6.5547688623345515
STAT,1898,15,50-100,1913,0.06292317655856834
STAT,1880,32,20-24,1912,2.6920704361833434
SIM,1851,42,45-49,1893,1
SIM,1923,37,na,1960,4191
STAT,1835,33,20-24,1868,2.1676637717057012
STAT,1813,41,20-24,1854,0.5621785183583506
STAT,1831,50,50-100,1881,0.00984700048538849
STAT,1933,20,45-49,1953,1.4183522094972372
STAT,1850,97,na,1947,3.78701921207941
STAT,1861,32,40-44,1893,3.4064350539289627
STAT,1864,33,20-24,1897,2.266294894402807
STAT,1882,29,30-34,1911,22.969648013272085
STAT,1910,46,20-24,1956,0.009764986439250372
STAT,1887,38,20-24,1925,0.8105037783340632
SIM,1816,40,30-34,1856,2
STAT,1879,23,na,1902,2331.50648622776
SIM,1924,21,15-19,1945,7
STAT,1842,27,35-39,1869,8.64119135444471
STAT,1861,49,na,1910,1730.3227762798153
STAT,1884,37,40-44,1921,4.085614059645104
SIM,1841,29,35-39,1870,9
STAT,1940,25,50-100,1965,0.9596831136514259
SIM,1821,35,50-100,1856,1
SIM,1834,31,35-39,1865,14
SIM,1859,44,45-49,1903,1
SIM,1965,1,na,1966,4603
SIM,1832,41,50-100,1873,3
SIM,1887,19,30-34,1906,4
STAT,1875,31,30-34,1906,17.022925076876678
SIM,1846,38,25-29,1884,5
SIM,1949,22,30-34,1971,40
STAT,1840,19,25-29,1859,4.758325116373744
SIM,1936,5,na,1941,3018
SIM,1883,39,40-44,1922,3
STAT,1849,44,35-39,1893,1.3395425990751422
STAT,1861,44,35-39,1905,1.4031716057959893
STAT,1883,50,20-24,1933,6.932925623091448E-4
SIM,1919,7,na,1926,4231
STAT,1880,16,15-19,1896,5.924942113007546
SIM,1860,34,40-44,1894,4
STAT,1866,53,25-29,1919,0.0030366785867352837
STAT,1887,42,na,1929,2439.2439560715657
SIM,1890,29,30-34,1919,29
SIM,1879,2,na,1881,3091
SIM,1844,14,na,1858,2036
SIM,1904,30,50-100,1934,1
SIM,1823,38,30-34,1861,5
SIM,1848,28,na,1876,1872
SIM,1881,23,20-24,1904,48
STAT,1833,21,25-29,1854,51.43505665493261
SIM,1916,17,na,1933,3797
SIM,1948,3,na,1951,4286
STAT,1811,50,30-34,1861,0.019725618392477568
STAT,1916,21,15-19,1937,5.2853874543132635
SIM,1878,26,na,1904,2421
SIM,1832,23,25-29,1855,37
STAT,1889,46,30-34,1935,0.11321399642426606
STAT,1824,36,30-34,1860,8.776713880769202
SIM,1808,63,na,1871,937
STAT,1828,31,na,1859,1635.9276990789522
STAT,1893,22,35-39,1915,6.99106650987998
STAT,1844,35,45-49,1879,1.6414974578154669
STAT,1888,17,30-34,1905,1.7794726976883877
STAT,1838,38,25-29,1876,2.3083632429565095
SIM,1855,6,na,1861,2394
SIM,1894,32,45-49,1926,1
STAT,1871,51,40-44,1922,0.009922947829112632
STAT,1874,52,20-24,1926,7.084653501038726E-4
SIM,1835,53,na,1888,1339
SIM,1841,21,25-29,1862,48
STAT,1854,54,45-49,1908,0.010097877836298267
STAT,1895,61,na,1956,2323.606055398905
SIM,1799,85,na,1884,87
SIM,1852,35,45-49,1887,1
STAT,1863,52,45-49,1915,0.011966994779441888
SIM,1830,28,20-24,1858,10
SIM,1827,34,na,1861,1569
STAT,1891,27,30-34,1918,29.432131924012136
SIM,1910,12,na,1922,3705
STAT,1847,36,25-29,1883,2.2258460817084074
STAT,1895,30,45-49,1925,2.16495257396711
SIM,1836,70,na,1906,888
STAT,1856,111,na,1967,5.977903277344424E-4
SIM,1889,27,40-44,1916,6
STAT,1845,28,15-19,1873,0.3879729955944821
STAT,1864,45,15-19,1909,3.4014606569323356E-4
STAT,1901,48,20-24,1949,0.00883846262764653
STAT,1871,23,50-100,1894,0.38135484773586104
STAT,1842,78,na,1920,565.8273077622864
STAT,1900,39,15-19,1939,0.015724063882618166
STAT,1855,35,20-24,1890,0.5529881722196326
STAT,1908,15,30-34,1923,2.2440140843545193
STAT,1887,25,15-19,1912,0.48267289533321694
SIM,1827,41,45-49,1868,1
SIM,1844,48,50-100,1892,4
SIM,1795,71,na,1866,562
SIM,1829,26,30-34,1855,32
SIM,1939,15,25-29,1954,50
STAT,1882,11,na,1893,2376.1312447700448
SIM,1820,87,na,1907,73
STAT,1855,47,15-19,1902,2.8292524194341306E-4
STAT,1853,30,na,1883,1898.7816671525754
STAT,1831,26,20-24,1857,10.419260031271055
STAT,1871,18,15-19,1889,5.569990052498321
STAT,1873,26,25-29,1899,40.668690398785515
SIM,1842,30,30-34,1872,20
STAT,1886,32,45-49,1918,1.7401782844322515
STAT,1919,37,na,1956,3818.2346064398134
SIM,1938,16,20-24,1954,116
SIM,1896,17,30-34,1913,1
STAT,1819,70,na,1889,774.689663185839
SIM,1825,33,35-39,1858,12
STAT,1870,42,35-39,1912,1.6761259774659127
STAT,1873,43,15-19,1916,0.013135816922388868
STAT,1884,24,35-39,1908,5.412279186373302
STAT,1802,52,30-34,1854,0.017427639747094933
STAT,1835,42,40-44,1877,1.7153293372919192
STAT,1812,48,na,1860,1312.359391338748
STAT,1856,34,25-29,1890,7.48495962211648
STAT,1915,23,na,1938,3555.1048106416956
STAT,1793,107,na,1900,7.821944009918295E-4
STAT,1853,33,45-49,1886,1.3449972445093077
STAT,1851,25,35-39,1876,8.244786394829578
STAT,1879,39,25-29,1918,2.818505503989715
STAT,1898,44,30-34,1942,0.10068537987850278
STAT,1866,80,na,1946,538.9961357606948
STAT,1949,19,35-39,1968,4.607417848101417
STAT,1823,44,15-19,1867,0.01744467994825856
SIM,1840,22,20-24,1862,56
SIM,1869,97,na,1966,28
SIM,1912,9,na,1921,3778
SIM,1890,21,20-24,1911,77
STAT,1869,40,45-49,1909,1.3835301623512748
SIM,1894,64,na,1958,2229
STAT,1803,51,35-39,1854,0.025595242432885336
STAT,1890,35,15-19,1925,0.06547255028632315
SIM,1872,4,na,1876,2671
STAT,1919,21,40-44,1940,3.488708480475851
SIM,1865,83,na,1948,312
STAT,1896,36,20-24,1932,0.966406018346864
STAT,1847,49,30-34,1896,0.069890639801886
STAT,1852,34,40-44,1886,3.1883914754696714
SIM,1887,39,25-29,1926,2
STAT,1889,2,na,1891,3108.838867995464
STAT,1923,42,na,1965,4100.70013352756
STAT,1889,33,25-29,1922,11.895077156227943
SIM,1864,34,25-29,1898,6
STAT,1847,16,30-34,1863,1.4756200914571282
SIM,1892,24,35-39,1916,9
SIM,1877,40,45-49,1917,2
STAT,1833,34,30-34,1867,13.508899393792662
STAT,1835,37,45-49,1872,1.5685901350156175
STAT,1875,51,25-29,1926,0.0034558024499192347
STAT,1882,21,20-24,1903,63.50210823525341
SIM,1890,50,na,1940,2742
STAT,1883,16,40-44,1899,0.1698233247350816
SIM,1822,46,50-100,1868,2
SIM,1927,21,40-44,1948,6
STAT,1834,30,30-34,1864,14.170678086371678
STAT,1832,22,20-24,1854,99.34994219298592
SIM,1886,45,na,1931,2225
STAT,1829,45,20-24,1874,0.01006874212984099
STAT,1821,84,na,1905,177.23167337989696
STAT,1833,29,35-39,1862,7.691348518033101
STAT,1912,49,35-39,1961,0.1163725822419727
SIM,1855,16,30-34,1871,1
STAT,1866,19,45-49,1885,0.0577343983645355
STAT,1919,16,45-49,1935,0.10488571802671211
STAT,1825,98,na,1923,1.7265531023422476
SIM,1843,42,40-44,1885,6
SIM,1897,33,25-29,1930,15
SIM,1874,33,30-34,1907,27
STAT,1948,18,na,1966,3978.1969859603196
SIM,1854,43,50-100,1897,1
SIM,1876,41,40-44,1917,6
SIM,1892,37,40-44,1929,7
SIM,1890,16,25-29,1906,9
STAT,1950,20,50-100,1970,0.7379461513166673
SIM,1841,34,30-34,1875,19
STAT,1817,46,40-44,1863,0.3920523879093237
STAT,1865,31,na,1896,2051.6677355314937
SIM,1778,91,na,1869,14
SIM,1824,37,35-39,1861,10
STAT,1852,51,30-34,1903,0.0043361646935788775
STAT,1892,43,25-29,1935,0.754343650664083
SIM,1881,14,na,1895,1998
STAT,1878,81,na,1959,666.4211319442705
SIM,1875,32,35-39,1907,9
SIM,1852,33,na,1885,1850
SIM,1827,66,na,1893,912
STAT,1791,69,na,1860,645.2282689622373
STAT,1818,45,45-49,1863,0.518608262949311
STAT,1868,41,40-44,1909,2.036540397504035
STAT,1825,52,25-29,1877,0.0034820813151078367
SIM,1857,64,na,1921,1324
SIM,1853,50,na,1903,1651
STAT,1850,26,30-34,1876,21.04081689705877
STAT,1885,36,45-49,1921,1.886188783590643
STAT,1877,19,20-24,1896,17.279635450452353
STAT,1836,50,na,1886,1467.765542380108
STAT,1820,67,na,1887,826.633144268627
SIM,1882,31,na,1913,2263
STAT,1841,40,15-19,1881,0.010149930914386448
STAT,1803,87,na,1890,59.22190101513422
SIM,1851,23,35-39,1874,4
SIM,1874,28,35-39,1902,8
STAT,1833,51,20-24,1884,4.759434181916402E-4
STAT,1890,15,20-24,1905,20.57098152989376
STAT,1963,3,na,1966,4719.973473721405
SIM,1856,32,25-29,1888,18
SIM,1896,34,20-24,1930,2
STAT,1798,91,na,1889,19.325122080306397
SIM,1953,17,na,1970,4153
STAT,1825,35,35-39,1860,9.64789450165892
STAT,1898,19,40-44,1917,0.2325728904424381
SIM,1876,45,50-100,1921,5
STAT,1854,39,20-24,1893,0.5459799215898262
STAT,1813,53,45-49,1866,0.03718945992646005
SIM,1823,52,na,1875,1222
STAT,1874,47,25-29,1921,0.05533767201162885
SIM,1949,17,35-39,1966,4
STAT,1865,37,30-34,1902,4.563537208442857
SIM,1865,39,50-100,1904,1
STAT,1834,38,40-44,1872,3.344268814411832
STAT,1837,39,20-24,1876,0.596587818022038
STAT,1882,41,15-19,1923,0.012744709663429351
SIM,1839,28,40-44,1867,3
STAT,1830,53,45-49,1883,0.009376433160628882
STAT,1827,40,40-44,1867,2.2333268529228367
STAT,1862,98,na,1960,5.494400022815923
STAT,1814,46,15-19,1860,0.0012440858071793176
STAT,1892,26,35-39,1918,11.456278071672784
SIM,1842,38,40-44,1880,1
STAT,1840,24,20-24,1864,56.68901341092112
STAT,1940,22,na,1962,3514.314527107074
STAT,1875,26,35-39,1901,9.401403893089194
STAT,1865,32,25-29,1897,8.770395679171472
SIM,1893,33,40-44,1926,6
STAT,1899,40,30-34,1939,0.10438178188604356
STAT,1860,23,35-39,1883,4.577867623758817
STAT,1894,31,40-44,1925,5.286504416745997
STAT,1946,5,na,1951,4158.795827533406
STAT,1857,12,na,1869,2090.512013242423
STAT,1809,52,40-44,1861,0.028297691604482568
SIM,1843,37,50-100,1880,2
SIM,1917,48,50-100,1965,2
SIM,1816,50,na,1866,1327
STAT,1876,43,40-44,1919,2.179445627783969
STAT,1888,34,20-24,1922,2.9919876980503006
SIM,1867,42,na,1909,2209
STAT,1843,23,35-39,1866,4.911936386105727
STAT,1848,51,na,1899,1607.5835826749583
STAT,1881,37,15-19,1918,0.05124701810066542
STAT,1864,14,na,1878,2264.230121138209
STAT,1897,35,25-29,1932,3.6720730197082894
SIM,1864,39,30-34,1903,11
STAT,1792,86,na,1878,69.982515283949
STAT,1848,45,30-34,1893,0.0726451083544539
STAT,1870,6,na,1876,2564.9144536187514
SIM,1915,26,50-100,1941,6
STAT,1872,27,20-24,1899,11.11645643639158
SIM,1840,32,na,1872,1737
STAT,1855,18,30-34,1873,1.3392347860071663
SIM,1826,42,40-44,1868,7
STAT,1853,8,na,1861,2235.563840567399
STAT,1838,18,30-34,1856,1.4051188138532795
STAT,1899,48,40-44,1947,0.12343118358478145
STAT,1777,106,na,1883,0.011330075098674352
STAT,1880,44,45-49,1924,1.4704364195475903
STAT,1923,10,na,1933,4408.588737899192
SIM,1879,27,50-100,1906,2
SIM,1897,36,50-100,1933,2
SIM,1903,42,na,1945,3130
STAT,1831,46,15-19,1877,2.886594829497108E-4
STAT,1845,102,na,1947,0.2074590774990146
STAT,1871,59,na,1930,1823.1098834417041
SIM,1844,46,na,1890,1494
SIM,1835,40,40-44,1875,7
STAT,1848,28,40-44,1876,2.6381981779576935
STAT,1936,17,na,1953,3328.9548418070767
SIM,1842,25,35-39,1867,8
SIM,1856,28,40-44,1884,3
SIM,1907,56,na,1963,3009
STAT,1839,42,25-29,1881,0.45061581183460064
SIM,1863,18,30-34,1881,4
SIM,1889,10,na,1899,3142
STAT,1872,50,45-49,1922,0.013949250243456711
SIM,1873,37,30-34,1910,7
SIM,1926,32,50-100,1958,3
STAT,1868,28,na,1896,2143.5021230908055
STAT,1819,41,45-49,1860,3.2696946325001384
STAT,1865,54,20-24,1919,6.144798065133849E-4
STAT,1891,47,25-29,1938,0.03779805907487099
SIM,1766,90,na,1856,10
SIM,1838,44,25-29,1882,3
STAT,1854,26,15-19,1880,0.3766658193250779
SIM,1848,29,45-49,1877,4
SIM,1882,27,30-34,1909,32
SIM,1884,43,40-44,1927,5
SIM,1867,43,40-44,1910,3
STAT,1855,50,45-49,1905,0.010461109415485613
STAT,1870,25,45-49,1895,1.0359669273813148
SIM,1916,15,30-34,1931,2
STAT,1820,43,35-39,1863,3.2262493008388957
STAT,1875,21,50-100,1896,0.39716593986673604
STAT,1876,38,45-49,1914,1.9360021545994799
STAT,1908,53,na,1961,3072.0304246364058
STAT,1840,87,na,1927,115.6199883230829
STAT,1875,39,40-44,1914,4.207838865472703
STAT,1877,64,na,1941,1703.477643973918
SIM,1832,36,30-34,1868,6
STAT,1838,43,20-24,1881,0.11202488493203329
STAT,1863,29,20-24,1892,9.65606547347329
SIM,1836,27,na,1863,1775
STAT,1860,17,50-100,1877,0.04331035612304543
STAT,1881,25,20-24,1906,10.778833076644487
STAT,1849,25,na,1874,1950.8406406008169
STAT,1858,61,na,1919,1384.0637491930368
SIM,1871,41,50-100,1912,1
SIM,1867,38,45-49,1905,3
SIM,1847,35,50-100,1882,1
SIM,1862,11,na,1873,2354
STAT,1808,48,40-44,1856,0.6381122723147798
SIM,1883,26,35-39,1909,11
SIM,1851,36,40-44,1887,4
SIM,1866,25,na,1891,2112
SIM,1868,42,45-49,1910,2
SIM,1888,35,25-29,1923,3
SIM,1846,18,30-34,1864,1
SIM,1861,30,40-44,1891,6
STAT,1873,50,na,1923,2092.627030304634
STAT,1874,18,40-44,1892,0.17607977129093133
STAT,1845,11,na,1856,2144.8375005051
STAT,1832,68,na,1900,920.5883619173864
SIM,1895,38,na,1933,2974
STAT,1899,35,35-39,1934,9.242156673396774
STAT,1829,28,30-34,1857,31.31989898958119
STAT,1809,47,45-49,1856,0.6660882673340361
STAT,1860,36,40-44,1896,3.3715479746590535
STAT,1857,18,40-44,1875,0.15922544567512276
SIM,1891,24,na,1915,2791
SIM,1879,75,na,1954,962
STAT,1841,23,25-29,1864,49.63635336044115
STAT,1864,28,25-29,1892,35.49123229065913
STAT,1872,47,15-19,1919,3.7726352371547205E-4
SIM,1875,61,na,1936,1761
SIM,1883,80,na,1963,735
STAT,1843,36,40-44,1879,3.4877958648739797
SIM,1852,40,40-44,1892,4
STAT,1819,38,15-19,1857,0.1443968367872576
STAT,1834,50,25-29,1884,0.0023449637612160644
STAT,1858,93,na,1951,21.646707663614684
STAT,1850,46,25-29,1896,0.04071886770989785
STAT,1908,21,na,1929,3324.3671285240694
STAT,1902,44,20-24,1946,0.014504813231883405
SIM,1816,82,na,1898,166
SIM,1831,24,20-24,1855,50
STAT,1886,29,15-19,1915,0.449518557561549
SIM,1855,33,20-24,1888,2
STAT,1848,32,25-29,1880,8.875603842876144
STAT,1865,41,15-19,1906,0.011878394864526198
SIM,1884,38,45-49,1922,1
STAT,1849,53,25-29,1902,0.0026133965239178185
SIM,1833,35,35-39,1868,10
SIM,1883,31,30-34,1914,23
STAT,1896,19,30-34,1915,1.9779829900361
STAT,1844,40,40-44,1884,1.6414536053962474
STAT,1859,43,40-44,1902,1.6789922666912196
STAT,1874,27,30-34,1901,24.306158933493105
STAT,1939,17,25-29,1956,40.978719006941326
SIM,1893,38,50-100,1931,1
STAT,1812,91,na,1903,25.171805357083024
SIM,1820,41,35-39,1861,7
SIM,1922,34,50-100,1956,3
STAT,1890,23,20-24,1913,79.34563684182517
STAT,1948,16,50-100,1964,0.4051743432122363
SIM,1839,36,40-44,1875,6
STAT,1922,21,50-100,1943,0.7149903869789618
SIM,1876,44,45-49,1920,4
SIM,1785,93,na,1878,3
SIM,1826,44,50-100,1870,1
STAT,1818,44,50-100,1862,2.328870187942972
STAT,1847,33,20-24,1880,2.316159782780798
STAT,1856,39,30-34,1895,3.8887767330242187
STAT,1811,53,35-39,1864,0.026864191502547735
SIM,1896,23,na,1919,2963
STAT,1843,52,na,1895,1446.607757961732
SIM,1866,57,na,1923,1788
STAT,1893,47,35-39,1940,0.09416915401885366
STAT,1898,27,40-44,1925,3.8295876247090805
STAT,1827,35,45-49,1862,2.1709989549108153
STAT,1849,41,30-34,1890,0.8660002171712624
SIM,1893,28,45-49,1921,3
SIM,1896,29,25-29,1925,64
SIM,1947,17,25-29,1964,50
STAT,1842,24,30-34,1866,16.037071516153304
SIM,1816,43,35-39,1859,3
STAT,1833,46,25-29,1879,0.041931219623467374
STAT,1837,47,20-24,1884,0.008084481993681206
STAT,1888,29,25-29,1917,46.88980317254973
SIM,1893,41,40-44,1934,7
SIM,1834,79,na,1913,410
SIM,1893,47,na,1940,2814
STAT,1824,40,15-19,1864,0.019115286960152255
STAT,1865,24,25-29,1889,48.903440404441334
STAT,1803,55,na,1858,1077.1929444009245
SIM,1873,24,25-29,1897,64
SIM,1826,37,45-49,1863,3
STAT,1840,16,20-24,1856,15.152739053398301
STAT,1855,38,25-29,1893,2.035885995968208
STAT,1807,69,na,1876,746.040146520579
SIM,1800,67,na,1867,723
STAT,1936,16,45-49,1952,0.452904884342898
SIM,1929,26,20-24,1955,25
STAT,1910,49,25-29,1959,0.046481636067306834
STAT,1925,15,30-34,1940,13.97394971020817
STAT,1868,44,45-49,1912,1.330776060480776
STAT,1911,15,50-100,1926,0.07115742555725438
STAT,1857,43,30-34,1900,0.8503852624014576
STAT,1894,26,45-49,1920,1.3525887644819972
STAT,1900,57,na,1957,2674.7159317973783
STAT,1892,18,35-39,1910,0.6475592035384343
SIM,1841,26,30-34,1867,24
STAT,1824,49,na,1873,1394.503348829194
SIM,1931,38,na,1969,4673
STAT,1860,28,40-44,1888,2.30406815642194
SIM,1833,27,35-39,1860,8
STAT,1843,44,40-44,1887,1.5246835760311337
STAT,1859,51,40-44,1910,0.007953513199499088
STAT,1927,23,40-44,1950,3.9013294517477064
STAT,1820,35,na,1855,1504.5868049033227
STAT,1841,36,30-34,1877,4.374203198521411
SIM,1858,81,na,1939,396
SIM,1883,34,35-39,1917,14
STAT,1826,47,45-49,1873,0.21789612778242276
SIM,1843,34,40-44,1877,6
STAT,1890,43,50-100,1933,1.2113516115693825
STAT,1853,30,40-44,1883,3.450714348310802
STAT,1916,40,na,1956,3605.432172622478
STAT,1862,66,na,1928,1323.858872175257
STAT,1854,51,40-44,1905,0.007568415100611818
STAT,1883,33,30-34,1916,16.103180242046758
STAT,1850,30,15-19,1880,0.11782200472166707
STAT,1847,19,35-39,1866,0.4990767509987291
STAT,1867,32,35-39,1899,8.983498018904026
SIM,1859,41,40-44,1900,3
SIM,1891,33,30-34,1924,22
STAT,1823,32,20-24,1855,7.085313560905516
SIM,1908,21,30-34,1929,33
STAT,1818,37,45-49,1855,6.331897515534903
SIM,1831,32,20-24,1863,1
STAT,1875,34,35-39,1909,9.749338929730243
STAT,1882,24,25-29,1906,52.26318518988941
STAT,1861,103,na,1964,0.5018810178933637
STAT,1907,36,na,1943,3311.1133514142775
STAT,1835,34,40-44,1869,3.4418177751781966
STAT,1903,22,na,1925,3178.985407713109
STAT,1851,38,50-100,1889,0.8834049924900104
STAT,1869,45,na,1914,2079.558191246157
SIM,1935,23,40-44,1958,3
SIM,1850,24,30-34,1874,20
STAT,1861,41,30-34,1902,0.9071357015348727
SIM,1881,26,25-29,1907,35
STAT,1885,28,45-49,1913,1.0418296017510573
SIM,1878,38,20-24,1916,2
SIM,1823,33,25-29,1856,11
STAT,1896,39,25-29,1935,3.5561771706976066
STAT,1840,44,15-19,1884,0.009214665920884501
STAT,1856,27,na,1883,1822.781955539031
STAT,1844,52,35-39,1896,0.005947365195506934
STAT,1852,13,na,1865,2083.7300603303947
STAT,1833,26,30-34,1859,20.512871393188956
STAT,1853,50,35-39,1903,0.006608930304139203
STAT,1858,34,35-39,1892,7.4367102068034505
STAT,1873,35,15-19,1908,0.054313467093413656
SIM,1840,25,25-29,1865,31
STAT,1774,108,na,1882,0.0038995620407489447
STAT,1842,15,40-44,1857,0.17211132678224847
SIM,1919,19,15-19,1938,51
STAT,1873,23,20-24,1896,65.82203712499432
SIM,1840,17,25-29,1857,5
SIM,1828,51,na,1879,1389
SIM,1868,34,45-49,1902,1
STAT,1885,41,40-44,1926,2.1275996542378883
SIM,1933,15,30-34,1948,21
SIM,1865,43,30-34,1908,1
SIM,1857,96,na,1953,7
STAT,1848,48,35-39,1896,0.10272100666633918
SIM,1853,82,na,1935,296
STAT,1899,11,na,1910,3347.7949622334468
SIM,1902,57,na,1959,2733
SIM,1835,35,45-49,1870,1
SIM,1910,44,na,1954,3275
SIM,1829,29,35-39,1858,10
STAT,1835,45,45-49,1880,0.178501237189315
SIM,1907,24,na,1931,3269
STAT,1818,50,40-44,1868,0.022425734508916922
STAT,1832,25,25-29,1857,35.720497057511714
STAT,1891,31,15-19,1922,0.16712361028038417
STAT,1937,20,50-100,1957,0.6057414505231623
SIM,1867,20,50-100,1887,1
SIM,1903,10,na,1913,3487
SIM,1915,2,na,1917,3838
STAT,1790,109,na,1899,1.4118333965949627E-4
SIM,1824,34,30-34,1858,27
SIM,1900,32,50-100,1932,1
STAT,1881,45,15-19,1926,3.686816079439219E-4
STAT,1897,48,30-34,1945,0.06811800210886672
SIM,1852,27,45-49,1879,4
STAT,1829,48,25-29,1877,0.046466969367314814
SIM,1847,34,25-29,1881,15
STAT,1882,19,50-100,1901,0.04476821444250934
SIM,1881,31,50-100,1912,4
STAT,1856,31,20-24,1887,2.037808328107324
STAT,1895,27,15-19,1922,0.5587794578122678
STAT,1857,52,20-24,1909,5.468681090816922E-4
SIM,1838,16,30-34,1854,1
STAT,1844,27,45-49,1871,0.94399552214634
STAT,1852,37,45-49,1889,1.4530924714595204
STAT,1880,41,40-44,1921,2.2502682902846813
SIM,1897,30,20-24,1927,4
STAT,1836,18,20-24,1854,27.08749931440142
STAT,1889,30,20-24,1919,3.177795290859243
SIM,1938,19,25-29,1957,48
STAT,1857,44,na,1901,1698.7706254113302
SIM,1944,24,na,1968,3615
STAT,1771,92,na,1863,7.584292317886499
SIM,1844,18,20-24,1862,8
STAT,1847,54,50-100,1901,0.010830620083991533
STAT,1820,51,35-39,1871,0.014156426516789642
STAT,1834,33,35-39,1867,7.967246976788552
STAT,1947,16,20-24,1963,144.3193491788473
SIM,1829,38,25-29,1867,1
STAT,1879,44,20-24,1923,0.15492612475981235
SIM,1940,10,na,1950,3719
SIM,1860,37,45-49,1897,1
SIM,1864,31,20-24,1895,2
SIM,1955,16,20-24,1971,142
SIM,1842,33,35-39,1875,9
STAT,1897,40,20-24,1937,0.014073552005823126
STAT,1839,34,25-29,1873,8.219704255010454
STAT,1883,25,30-34,1908,23.482048563586094
STAT,1886,25,na,1911,2397.6934618750643
STAT,1840,27,25-29,1867,34.61345470186205
STAT,1887,74,na,1961,1355.0387329904147
SIM,1853,31,45-49,1884,1
SIM,1871,79,na,1950,580
STAT,1883,60,na,1943,1766.455307728881
SIM,1848,38,35-39,1886,12
SIM,1854,24,15-19,1878,2
STAT,1910,38,20-24,1948,0.23699756556196142
SIM,1882,22,25-29,1904,60
STAT,1889,38,30-34,1927,6.1848164056193795
STAT,1828,36,15-19,1864,0.05244371900685829
SIM,1819,47,na,1866,1358
STAT,1880,48,50-100,1928,0.24152817402044616
STAT,1763,110,na,1873,0.001015181719847896
STAT,1854,79,na,1933,500.19933694145124
SIM,1822,35,na,1857,1569
STAT,1827,43,45-49,1870,1.4112752617262283
STAT,1850,65,na,1915,1191.2940953340399
STAT,1891,47,na,1938,2617.7991131586755
SIM,1856,15,na,1871,2183
SIM,1859,29,20-24,1888,11
SIM,1863,27,20-24,1890,13
SIM,1896,37,25-29,1933,2
SIM,1826,49,na,1875,1327
STAT,1842,32,30-34,1874,15.274287103764639
SIM,1876,36,45-49,1912,2
STAT,1870,30,40-44,1900,4.0514070626166605
SIM,1891,25,30-34,1916,41
STAT,1861,52,35-39,1913,0.006726306085369659
SIM,1812,68,na,1880,738
STAT,1833,54,25-29,1887,0.002152747809143
STAT,1824,44,30-34,1868,1.4351893871993109
STAT,1906,15,20-24,1921,24.50608615067597
STAT,1851,42,25-29,1893,0.46136242821595286
SIM,1871,29,20-24,1900,15
STAT,1884,45,40-44,1929,0.16137748942784247
STAT,1812,107,na,1919,0.0020485512102285807
SIM,1825,33,50-100,1858,4
SIM,1811,83,na,1894,160
STAT,1832,36,na,1868,1635.5935727371484
STAT,1891,9,na,1900,3032.5584775090265
STAT,1868,36,45-49,1904,1.805461684227103
SIM,1868,31,50-100,1899,4
STAT,1888,37,25-29,1925,3.2144745517652202
SIM,1881,46,na,1927,1764
STAT,1829,37,20-24,1866,0.6994184054744619
SIM,1909,33,40-44,1942,7
STAT,1876,52,30-34,1928,0.005778788766250478
STAT,1933,17,50-100,1950,0.4737922999411003
STAT,1845,31,45-49,1876,1.48252070613845
STAT,1866,45,25-29,1911,0.05068846143731389
SIM,1849,42,35-39,1891,3
SIM,1861,42,35-39,1903,7
SIM,1833,44,25-29,1877,3
STAT,1917,16,35-39,1933,0.8551407307976748
STAT,1817,54,40-44,1871,0.021850235525239577
STAT,1929,15,na,1944,4458.074251397896
STAT,1831,51,na,1882,1329.5387444876171
STAT,1852,21,35-39,1873,5.06215202050655
STAT,1831,41,45-49,1872,1.1199920902190537
STAT,1894,12,na,1906,3135.2938197091507
SIM,1957,8,na,1965,4912
STAT,1860,39,45-49,1899,1.5126479373216941
STAT,1898,26,na,1924,3061.4482553215767
SIM,1878,58,na,1936,1988
STAT,1878,48,20-24,1926,0.011665801216458988
STAT,1937,20,45-49,1957,1.0358178409269823
SIM,1841,37,35-39,1878,12
SIM,1857,44,35-39,1901,3
SIM,1861,33,45-49,1894,1
SIM,1874,44,na,1918,2136
SIM,1925,16,35-39,1941,5
STAT,1841,53,20-24,1894,5.005622111170771E-4
STAT,1849,16,40-44,1865,0.16982489972893913
STAT,1886,17,50-100,1903,0.048889504796981564
SIM,1870,30,na,1900,2215
STAT,1852,29,45-49,1881,0.8409752019930133
STAT,1858,47,40-44,1905,0.1262134983059565
STAT,1833,37,35-39,1870,5.425607550548449
STAT,1897,32,20-24,1929,3.414996791669558
STAT,1816,42,30-34,1858,3.1012534369983498
STAT,1860,20,30-34,1880,15.69109629278061
STAT,1857,26,40-44,1883,2.315494157610353
SIM,1849,13,na,1862,2227
SIM,1883,23,30-34,1906,22
SIM,1860,29,45-49,1889,5
STAT,1828,63,na,1891,1004.8848935485407
STAT,1892,35,25-29,1927,3.439165858111086
STAT,1811,45,35-39,1856,0.4819598107262685
SIM,1842,22,30-34,1864,17
SIM,1865,35,30-34,1900,4
SIM,1815,39,35-39,1854,10
SIM,1846,80,na,1926,406
SIM,1884,35,40-44,1919,1
STAT,1870,17,45-49,1887,0.06111505749531738
STAT,1921,47,35-39,1968,0.13730572187328632
STAT,1837,67,na,1904,1028.7808927895437
SIM,1806,72,na,1878,556
SIM,1932,23,na,1955,4447
STAT,1825,44,25-29,1869,0.6682046174136219
STAT,1838,51,20-24,1889,5.026339141306836E-4
SIM,1851,44,40-44,1895,2
STAT,1851,17,35-39,1868,0.4798951796832834
STAT,1854,34,15-19,1888,0.10219750954195858
SIM,1865,26,40-44,1891,4
STAT,1829,80,na,1909,373.77787410408604
SIM,1817,44,40-44,1861,6
STAT,1902,47,25-29,1949,0.04311633264548525
SIM,1860,21,35-39,1881,9
SIM,1855,36,25-29,1891,2
STAT,1826,39,45-49,1865,2.039349163029405
SIM,1834,39,45-49,1873,4
STAT,1876,35,40-44,1911,4.313039857966998
STAT,1896,28,20-24,1924,14.585638166952815
SIM,1805,98,na,1903,1
STAT,1850,51,20-24,1901,5.226654784485131E-4
STAT,1826,31,35-39,1857,14.876116184361557
SIM,1888,27,25-29,1915,52
SIM,1856,37,30-34,1893,4
STAT,1922,25,na,1947,4031.7236492469397
STAT,1903,48,30-34,1951,0.07247288489343819
SIM,1892,27,50-100,1919,1
STAT,1790,95,na,1885,2.450285874523537
STAT,1834,22,30-34,1856,14.784087537655102
STAT,1926,39,na,1965,4334.246187588504
STAT,1848,83,na,1931,294.9843725075662
SIM,1920,22,na,1942,3901
STAT,1914,49,45-49,1963,0.20243813866821506
SIM,1924,36,na,1960,4194
STAT,1869,37,15-19,1906,0.05139206248551331
STAT,1871,21,45-49,1892,0.6561129513430501
SIM,1822,37,25-29,1859,3
SIM,1893,7,na,1900,3268
STAT,1808,49,50-100,1857,0.8993800548966806
SIM,1872,33,20-24,1905,1
SIM,1860,35,50-100,1895,1
SIM,1816,49,50-100,1865,3
STAT,1912,26,50-100,1938,0.9298410239521185
STAT,1832,42,15-19,1874,0.01021282495494166
STAT,1848,37,30-34,1885,4.081049088766649
STAT,1841,28,30-34,1869,21.408007759521908
STAT,1880,52,45-49,1932,0.014376476101190548
SIM,1835,43,45-49,1878,3
SIM,1827,33,45-49,1860,1
STAT,1820,40,30-34,1860,2.2461267679311887
SIM,1857,41,30-34,1898,4
STAT,1846,24,15-19,1870,2.9759358167113708
SIM,1880,42,45-49,1922,3
STAT,1796,105,na,1901,0.006314767753369671
STAT,1930,35,50-100,1965,0.5182424997760395
STAT,1841,20,20-24,1861,61.058212074218055
STAT,1849,49,40-44,1898,0.12569697971767613
STAT,1894,34,45-49,1928,2.0989607501603245
STAT,1889,49,35-39,1938,0.09017808129864756
SIM,1850,32,30-34,1882,24
STAT,1860,40,25-29,1900,0.49718625269997313
STAT,1805,51,45-49,1856,0.0543482615716833
STAT,1819,102,na,1921,0.1547655903735943
STAT,1872,42,45-49,1914,1.416436180135662
STAT,1867,34,50-100,1901,0.8058226138198261
STAT,1876,58,na,1934,1930.1446320400723
SIM,1906,16,25-29,1922,8
STAT,1886,24,45-49,1910,0.6915082103976645
SIM,1861,26,na,1887,2071
SIM,1889,39,35-39,1928,11
STAT,1881,28,25-29,1909,38.468663637674815
SIM,1919,22,45-49,1941,1
SIM,1842,26,50-100,1868,4
STAT,1833,29,50-100,1862,0.5099112439682902
STAT,1855,41,50-100,1896,0.7541398292749311
STAT,1834,49,45-49,1883,0.15139615271542328
STAT,1908,37,50-100,1945,0.3713654274043029
SIM,1891,36,35-39,1927,9
SIM,1876,28,45-49,1904,1
STAT,1835,51,30-34,1886,0.0039382173611686635
SIM,1879,29,25-29,1908,40
STAT,1872,44,na,1916,2160.516288638054
SIM,1867,31,na,1898,2300
STAT,1839,39,30-34,1878,4.153256052434533
STAT,1856,43,15-19,1899,0.010105388567559426
STAT,1820,34,45-49,1854,5.207733715222324
SIM,1886,13,na,1899,2542
STAT,1836,48,50-100,1884,0.16432392324929834
STAT,1917,41,25-29,1958,0.07050260334500766
SIM,1870,20,40-44,1890,2
STAT,1830,47,50-100,1877,0.18403281641141198
STAT,1827,32,40-44,1859,5.203272184935549
SIM,1873,21,20-24,1894,67
STAT,1768,93,na,1861,4.428820579116417
STAT,1810,53,50-100,1863,0.04721795359690746
STAT,1823,35,25-29,1858,5.193846910930215
STAT,1865,45,30-34,1910,0.08371290978612957
SIM,1870,32,35-39,1902,14
SIM,1822,67,na,1889,837
STAT,1821,52,na,1873,1281.287071919171
STAT,1859,38,45-49,1897,1.4914492953766247
STAT,1867,41,25-29,1908,0.5722209139067237
SIM,1891,17,30-34,1908,2
SIM,1908,24,35-39,1932,7
STAT,1868,39,na,1907,2102.168943197397
STAT,1825,66,na,1891,871.1104117540366
STAT,1938,26,20-24,1964,17.09206341544184
SIM,1763,93,na,1856,4
SIM,1880,19,20-24,1899,21
STAT,1842,40,30-34,1882,0.8837401550112017
STAT,1851,46,40-44,1897,0.12350116459346787
STAT,1863,37,20-24,1900,0.639047057355451
STAT,1894,23,40-44,1917,2.522029776754619
STAT,1857,76,na,1933,705.8735068472128
SIM,1847,39,30-34,1886,7
STAT,1853,62,na,1915,1383.2198504420196
STAT,1881,17,20-24,1898,16.179173003078546
SIM,1831,35,25-29,1866,1
STAT,1864,52,50-100,1916,0.012648394651389868
SIM,1879,17,30-34,1896,5
STAT,1844,35,50-100,1879,1.010960654691128
STAT,1818,54,35-39,1872,0.016932254800070733
STAT,1887,28,50-100,1915,0.6735735490186863
SIM,1863,42,45-49,1905,1
STAT,1797,104,na,1901,0.016367468987880565
STAT,1865,21,20-24,1886,60.15664796505763
STAT,1953,16,45-49,1969,0.5710109042347976
STAT,1872,33,na,1905,2251.671756928713
STAT,1872,19,20-24,1891,16.709062744351225
STAT,1914,38,na,1952,3531.0727394237365
STAT,1898,34,50-100,1932,1.1613176806204664
STAT,1910,24,na,1934,3364.4376586138
STAT,1866,28,35-39,1894,8.377723301766101
STAT,1874,31,15-19,1905,0.13801694839849843
STAT,1872,35,20-24,1907,0.7373759406956086
SIM,1845,18,15-19,1863,7
SIM,1948,22,15-19,1970,4
SIM,1835,96,na,1931,5
STAT,1854,21,45-49,1875,0.5904566349252576
SIM,1919,30,45-49,1949,2
STAT,1844,26,na,1870,1852.5446162470112
STAT,1857,22,25-29,1879,49.238672384882676
STAT,1879,52,20-24,1931,7.25824086983119E-4
STAT,1899,32,30-34,1931,22.599905099751968
SIM,1847,26,25-29,1873,45
STAT,1834,41,35-39,1875,1.3722424545735745
SIM,1871,47,na,1918,2137
STAT,1882,75,na,1957,1010.0791484221986
STAT,1883,17,30-34,1900,1.4762631858574624
STAT,1819,59,na,1878,1147.2616290930657
SIM,1850,40,30-34,1890,4
STAT,1819,46,15-19,1865,7.695634290100056E-4
STAT,1846,48,25-29,1894,0.04218533376392734
STAT,1846,16,15-19,1862,5.562158789588782
STAT,1826,53,30-34,1879,0.005197039527585805
STAT,1815,105,na,1920,0.013087553522766788
STAT,1894,42,45-49,1936,0.12602053161563098
STAT,1842,41,20-24,1883,0.12052416590853986
STAT,1886,37,15-19,1923,0.056037220651682096
SIM,1860,84,na,1944,225
STAT,1893,44,30-34,1937,0.09435389523444691
SIM,1854,16,15-19,1870,4
STAT,1833,43,20-24,1876,0.11656744369460102
SIM,1864,98,na,1962,17
STAT,1824,41,50-100,1865,1.425070204908921
STAT,1827,51,45-49,1878,0.013072818737606911
SIM,1843,29,na,1872,1885
STAT,1880,49,15-19,1929,3.9005587232908277E-4
STAT,1889,37,40-44,1926,5.105283944629377
STAT,1837,18,15-19,1855,5.785873005797974
STAT,1856,47,30-34,1903,0.07101649767375438
SIM,1847,31,20-24,1878,1
STAT,1842,48,40-44,1890,0.12242219486815901
STAT,1890,39,30-34,1929,6.0935279876845945
STAT,1833,30,15-19,1863,0.11485736587711644
STAT,1876,46,45-49,1922,0.23099110244870671
STAT,1879,47,25-29,1926,0.05669354931433544
SIM,1882,19,30-34,1901,1
STAT,1847,7,na,1854,2278.0
STAT,1873,45,50-100,1918,0.23765888248206324
STAT,1815,45,na,1860,1390.543704536084
SIM,1854,99,na,1953,2
SIM,1863,38,25-29,1901,1
STAT,1921,39,35-39,1960,2.545922689887784
SIM,1945,20,45-49,1965,1
STAT,1876,27,40-44,1903,2.9236847423727297
STAT,1901,30,50-100,1931,1.2213287610352406
STAT,1839,31,20-24,1870,2.237845309939447
SIM,1884,27,40-44,1911,3
SIM,1899,63,na,1962,2518
STAT,1843,47,45-49,1890,0.15866226467184882
SIM,1842,66,na,1908,1061
SIM,1882,38,35-39,1920,13
STAT,1843,20,30-34,1863,15.320896597783278
STAT,1885,45,35-39,1930,0.13314438957922337
STAT,1924,43,50-100,1967,0.13179831883101614
SIM,1851,48,na,1899,1664
STAT,1863,83,na,1946,329.10908372866714
STAT,1892,47,40-44,1939,0.11373501175627272
STAT,1836,21,50-100,1857,0.35103220597683665
STAT,1853,41,45-49,1894,1.13777647256022
STAT,1874,38,35-39,1912,6.793087652772077
SIM,1883,18,35-39,1901,1
STAT,1900,25,na,1925,3148.76769327393
STAT,1843,28,40-44,1871,2.4722069732317102
SIM,1937,15,15-19,1952,37
STAT,1928,36,50-100,1964,0.5017072015625406
STAT,1850,33,na,1883,1741.5368650268636
SIM,1835,27,45-49,1862,5
STAT,1905,23,50-100,1928,0.5551148957362706
STAT,1938,31,50-100,1969,0.785834176961129
SIM,1825,86,na,1911,106
SIM,1851,28,40-44,1879,2
STAT,1823,48,30-34,1871,0.11753353763065214
STAT,1824,81,na,1905,298.17044446060237
STAT,1867,97,na,1964,15.834135284257059
SIM,1832,44,30-34,1876,4
STAT,1807,53,20-24,1860,0.002649985028125729
STAT,1870,50,35-39,1920,0.008093197774898692
SIM,1935,26,45-49,1961,3
STAT,1862,20,40-44,1882,1.7480138349966965
STAT,1837,54,45-49,1891,0.009159711864273645
SIM,1889,42,na,1931,2802
STAT,1807,47,35-39,1854,0.5401635034756856
STAT,1897,44,15-19,1941,0.0011952082844428496
STAT,1942,0,na,1942,4415.493700824156
STAT,1920,27,25-29,1947,68.20933648601095
STAT,1855,27,20-24,1882,8.689600909879251
STAT,1876,51,40-44,1927,0.010324198575572287
SIM,1814,48,na,1862,1256
STAT,1949,20,15-19,1969,5.872216574335281
SIM,1914,15,20-24,1929,29
STAT,1823,40,20-24,1863,0.22391740532670473
STAT,1838,84,na,1922,223.33348532346523
STAT,1834,70,na,1904,869.8637988028622
SIM,1895,17,15-19,1912,4
STAT,1859,5,na,1864,2194.6675524008087
STAT,1861,19,45-49,1880,0.05828221880978474
STAT,1891,35,30-34,1926,6.288269130174
STAT,1942,15,30-34,1957,12.039790869561012
STAT,1828,29,50-100,1857,0.7833781097537396
STAT,1878,40,50-100,1918,1.0505936168542964
STAT,1874,44,20-24,1918,0.151220926925162
STAT,1927,26,45-49,1953,1.990892708322435
STAT,1894,18,45-49,1912,0.07909697369195012
SIM,1835,32,40-44,1867,5
SIM,1858,32,35-39,1890,10
STAT,1808,51,35-39,1859,0.031733134845764815
STAT,1895,22,45-49,1917,0.8588203417761985
STAT,1852,43,30-34,1895,0.8274726986874933
STAT,1861,81,na,1942,424.7635663364549
STAT,1912,58,na,1970,3164.1737994741434
SIM,1850,85,na,1935,161
SIM,1946,15,na,1961,3749
STAT,1822,36,20-24,1858,1.4304125915685393
STAT,1861,1,na,1862,2866.032906666371
STAT,1857,46,35-39,1903,0.10460469035615784
SIM,1851,20,30-34,1871,19
SIM,1916,23,30-34,1939,37
STAT,1865,95,na,1960,22.13135473964146
STAT,1890,26,25-29,1916,49.024358408824185
SIM,1897,61,na,1958,2517
STAT,1853,42,35-39,1895,1.368729651014623
STAT,1945,4,na,1949,4117.967659976082
SIM,1850,16,30-34,1866,2
STAT,1887,17,15-19,1904,6.270946625250979
SIM,1950,15,30-34,1965,14
STAT,1908,23,30-34,1931,24.88486293750975
STAT,1888,1,na,1889,3154.6229412145985
STAT,1962,2,na,1964,4762.059465783107
STAT,1828,31,45-49,1859,1.8781042151845602
SIM,1892,33,25-29,1925,17
STAT,1800,90,na,1890,31.34173003738063
STAT,1841,105,na,1946,0.02021402022625305
STAT,1887,46,20-24,1933,0.012716213546801101
SIM,1924,25,30-34,1949,54
STAT,1877,31,40-44,1908,4.267065724840135
STAT,1943,19,na,1962,3684.8285956299887
STAT,1842,35,35-39,1877,6.1346793878936
SIM,1945,17,15-19,1962,39
SIM,1825,42,25-29,1867,2
STAT,1873,50,50-100,1923,0.014678105174395936
STAT,1833,25,40-44,1858,2.4578784520138304
SIM,1907,25,30-34,1932,39
STAT,1898,23,25-29,1921,72.9577740338722
STAT,1865,16,25-29,1881,5.029757719439988
SIM,1927,24,45-49,1951,2
STAT,1929,15,15-19,1944,54.96751334877849
STAT,1860,54,50-100,1914,0.011258060154544265
STAT,1878,22,45-49,1900,0.6865274531226417
STAT,1911,29,25-29,1940,60.2076823734304
SIM,1873,16,25-29,1889,7
STAT,1845,36,15-19,1881,0.04218665684571424
STAT,1884,29,40-44,1913,2.775839582798695
SIM,1813,85,na,1898,125
SIM,1836,31,45-49,1867,2
SIM,1872,36,25-29,1908,1
STAT,1842,19,35-39,1861,0.5042761774312429
STAT,1883,42,20-24,1925,0.14691365533222053
STAT,1946,15,15-19,1961,47.57841504049496
STAT,1869,19,50-100,1888,0.04492381464843005
STAT,1909,48,50-100,1957,0.19580242364687026
SIM,1880,29,na,1909,2411
STAT,1827,27,45-49,1854,3.124564723470162
STAT,1886,57,na,1943,2005.4316548616705
STAT,1838,19,50-100,1857,0.042935728894895255
STAT,1882,43,na,1925,2108.032715741414
STAT,1928,41,na,1969,4479.064966152463
STAT,1863,41,40-44,1904,1.873125840618923
SIM,1845,95,na,1940,4
STAT,1867,48,45-49,1915,0.20671992567757058
STAT,1832,46,30-34,1878,0.07006255206101636
STAT,1866,33,30-34,1899,15.148825032233267
SIM,1875,29,40-44,1904,3
STAT,1780,110,na,1890,0.0016542445152266233
STAT,1816,51,20-24,1867,0.0017024544775840382
SIM,1818,40,40-44,1858,6
SIM,1834,20,30-34,1854,17
STAT,1928,41,50-100,1969,0.14168287271691687
SIM,1850,35,35-39,1885,7
SIM,1925,42,na,1967,4205
STAT,1840,42,50-100,1882,0.7232178175260856
STAT,1918,32,50-100,1950,0.8300004866279771
SIM,1892,29,40-44,1921,7
STAT,1937,17,15-19,1954,41.708860799071005
SIM,1881,18,25-29,1899,5
STAT,1887,20,45-49,1907,0.7412452165679287
STAT,1828,95,na,1923,7.487784471238593
STAT,1868,53,35-39,1921,0.007635117184552401
STAT,1906,20,50-100,1926,0.5644281013117594
SIM,1885,31,40-44,1916,4
SIM,1871,41,40-44,1912,8
STAT,1864,49,30-34,1913,0.07980115091286903
STAT,1868,33,40-44,1901,3.8923698085013845
SIM,1847,11,na,1858,2237
SIM,1856,47,na,1903,1765
STAT,1878,38,na,1916,2308.0032958527104
SIM,1830,43,45-49,1873,3
SIM,1954,15,15-19,1969,47
SIM,1876,33,40-44,1909,5
STAT,1857,51,30-34,1908,0.004456232280066572
STAT,1916,25,30-34,1941,38.53246159209227
STAT,1897,19,25-29,1916,7.1208513151347566
STAT,1799,65,na,1864,779.4742351438074
STAT,1846,28,na,1874,1927.118763040384
STAT,1842,14,na,1856,2199.888157752
STAT,1817,38,40-44,1855,14.319104464414124
STAT,1849,25,50-100,1874,0.5768755830904294
STAT,1884,21,30-34,1905,16.674763886867645
STAT,1806,52,na,1858,1180.1299842524356
SIM,1864,77,na,1941,715
SIM,1860,63,na,1923,1466
STAT,1783,93,na,1876,5.761914689765294
STAT,1884,51,50-100,1935,0.014163151591712423
SIM,1838,28,25-29,1866,42
SIM,1860,30,25-29,1890,11
STAT,1873,18,25-29,1891,5.415149567429106
SIM,1890,24,25-29,1914,74
STAT,1919,24,45-49,1943,1.1566538398474528
STAT,1850,34,30-34,1884,12.610526965879034
SIM,1825,38,40-44,1863,12
SIM,1839,32,25-29,1871,12
SIM,1938,27,25-29,1965,68
STAT,1853,38,15-19,1891,0.042286767084241846
STAT,1866,42,20-24,1908,0.1382068154253459
STAT,1862,36,15-19,1898,0.04557538643617948
STAT,1864,101,na,1965,2.1811573073969894
STAT,1831,34,20-24,1865,2.102229585231532
STAT,1864,41,20-24,1905,0.13432112516736042
SIM,1876,9,na,1885,2595
STAT,1893,38,45-49,1931,2.3764064749572285
STAT,1892,32,20-24,1924,3.1983951050085206
SIM,1929,35,na,1964,4537
STAT,1822,43,45-49,1865,2.120030229341647
STAT,1835,50,40-44,1885,0.007104429547125552
SIM,1844,30,40-44,1874,4
STAT,1870,34,35-39,1904,9.305018899772241
SIM,1918,26,45-49,1944,2
STAT,1867,54,30-34,1921,0.0051351691685759
STAT,1846,52,45-49,1898,0.01070661091211194
STAT,1847,66,na,1913,1208.61795010139
SIM,1825,30,30-34,1855,25
SIM,1925,21,na,1946,4102
STAT,1909,48,25-29,1957,0.04592108926097856
SIM,1854,29,20-24,1883,7
STAT,1921,44,30-34,1965,0.13557863932542388
SIM,1827,30,40-44,1857,5
STAT,1865,29,30-34,1894,21.4082985180699
STAT,1871,26,15-19,1897,0.4270663518504514
STAT,1894,39,15-19,1933,0.0674882704795062
SIM,1864,66,na,1930,1442
SIM,1943,25,50-100,1968,7
SIM,1860,52,na,1912,1782
STAT,1834,50,50-100,1884,0.009998664996832917
STAT,1826,29,na,1855,1518.9593568063217
STAT,1819,81,na,1900,285.4668406824362
STAT,1858,43,25-29,1901,0.4721979454946671
SIM,1865,22,25-29,1887,50
STAT,1873,27,15-19,1900,0.4346989689549826
SIM,1894,21,40-44,1915,1
STAT,1849,52,35-39,1901,0.006421291236619442
STAT,1816,45,35-39,1861,0.34130900157231686
STAT,1886,21,40-44,1907,2.0857325457469478
STAT,1894,43,35-39,1937,0.15155982062666587
SIM,1910,39,25-29,1949,3
STAT,1913,37,50-100,1950,0.39143699962796946
STAT,1912,15,45-49,1927,0.0958730550343848
SIM,1877,32,45-49,1909,3
SIM,1910,30,25-29,1940,7
SIM,1899,30,30-34,1929,32
STAT,1902,39,25-29,1941,0.8201970522378401
STAT,1856,18,25-29,1874,4.909726969579239
STAT,1869,32,45-49,1901,1.5959276725261915
SIM,1855,28,25-29,1883,35
STAT,1827,52,35-39,1879,0.007602767220829591
STAT,1848,28,50-100,1876,0.5633781652184492
STAT,1864,36,25-29,1900,2.4358705999864916
STAT,1868,52,45-49,1920,0.01301101494440996
STAT,1897,6,na,1903,3300.40618432736
STAT,1836,30,40-44,1866,3.6242653957843887
STAT,1883,36,35-39,1919,6.582564898892189
STAT,1883,49,40-44,1932,0.15525695520357582
STAT,1827,48,15-19,1875,3.610543702484788E-4
STAT,1813,106,na,1919,0.004996871927021578
STAT,1877,43,35-39,1920,1.7616607274637102
STAT,1893,27,na,1920,2859.120843297052
STAT,1843,63,na,1906,1205.2024136377213
SIM,1866,39,40-44,1905,10
STAT,1815,46,30-34,1861,0.22124150169206486
STAT,1814,71,na,1885,699.4537916253483
STAT,1879,12,na,1891,2553.7740493500523
STAT,1917,35,50-100,1952,0.41588850115973053
SIM,1864,18,25-29,1882,5
SIM,1885,43,35-39,1928,2
SIM,1879,43,na,1922,2327
STAT,1847,28,25-29,1875,37.22364488365802
SIM,1890,37,30-34,1927,9
STAT,1825,41,20-24,1866,0.17693217126130023
STAT,1902,30,25-29,1932,13.765529036825864
SIM,1843,26,40-44,1869,2
STAT,1764,90,na,1854,18.0
STAT,1843,84,na,1927,224.6962550401047
STAT,1847,98,na,1945,2.3954977958446046
STAT,1834,48,na,1882,1460.4018007021266
STAT,1893,31,25-29,1924,12.321070011397278
STAT,1848,54,20-24,1902,5.332385678604732E-4
STAT,1835,26,40-44,1861,2.502792804903025
SIM,1886,19,15-19,1905,10
STAT,1861,35,45-49,1896,1.580729322415337
STAT,1883,41,30-34,1924,1.0696562258348223
STAT,1830,34,na,1864,1657.9396132714726
SIM,1891,41,30-34,1932,1
STAT,1847,77,na,1924,637.4090284457827
STAT,1846,29,20-24,1875,10.375760024805954
STAT,1816,50,30-34,1866,0.014010574706032074
STAT,1826,40,25-29,1866,0.6531994985730151
STAT,1811,74,na,1885,487.01689550601515
STAT,1924,16,na,1940,4150.828515713461
STAT,1882,37,30-34,1919,4.896364990656586
STAT,1884,48,45-49,1932,0.21749606812142136
SIM,1811,43,35-39,1854,1
SIM,1911,18,na,1929,3627
SIM,1836,59,na,1895,1223
STAT,1876,22,35-39,1898,5.695456551185968
SIM,1874,36,35-39,1910,11
STAT,1928,30,45-49,1958,1.8608226411813893
STAT,1799,103,na,1902,0.045817466652015464
STAT,1818,51,30-34,1869,0.01242951605613358
STAT,1847,52,25-29,1899,0.0025980014373661736
STAT,1868,49,15-19,1917,3.5300881442068327E-4
SIM,1870,62,na,1932,1662
SIM,1905,25,20-24,1930,21
STAT,1861,16,40-44,1877,0.1661081290133317
SIM,1882,26,40-44,1908,5
STAT,1844,51,45-49,1895,0.010127440509979817
STAT,1865,48,35-39,1913,0.11837100334743254
STAT,1930,29,35-39,1959,18.016380614922532
SIM,1874,76,na,1950,856
STAT,1844,32,40-44,1876,3.601791827004473
STAT,1882,33,15-19,1915,0.13028000633218864
STAT,1835,33,na,1868,1737.9458322028981
SIM,1942,28,50-100,1970,5
SIM,1884,22,35-39,1906,5
STAT,1794,66,na,1860,763.5600952403181
STAT,1900,46,50-100,1946,0.18207125680755307
SIM,1865,27,30-34,1892,34
STAT,1932,35,na,1967,4783.561934447322
SIM,1848,43,30-34,1891,3
STAT,1788,92,na,1880,10.210104616816256
SIM,1907,21,15-19,1928,2
STAT,1891,79,na,1970,1244.0141650375501
STAT,1852,49,50-100,1901,0.1743389383527556
STAT,1880,37,20-24,1917,0.7677152799790272
STAT,1864,17,20-24,1881,15.441571004206489
STAT,1854,47,na,1901,1602.2227471961382
STAT,1855,0,na,1855,2844.136741838973
STAT,1934,28,50-100,1962,1.2643251542753098
STAT,1850,43,20-24,1893,0.1111423107160965
STAT,1874,26,40-44,1900,2.901310861676683
STAT,1925,40,50-100,1965,0.13473492422679653
SIM,1885,39,na,1924,2225
STAT,1828,28,15-19,1856,0.6419226855264892
STAT,1869,13,na,1882,2423.046094905271
STAT,1908,49,20-24,1957,0.009386456994704038
SIM,1829,26,50-100,1855,2
STAT,1874,22,25-29,1896,55.2548039952455
STAT,1895,19,15-19,1914,7.2697884252620755
STAT,1848,41,15-19,1889,0.010381021521657381
SIM,1872,17,20-24,1889,13
SIM,1948,17,40-44,1965,1
STAT,1866,36,35-39,1902,6.192449095009542
SIM,1852,32,40-44,1884,3
SIM,1852,41,30-34,1893,3
SIM,1923,16,25-29,1939,66
STAT,1813,46,20-24,1859,0.03334885039155093
STAT,1896,43,45-49,1939,0.1287349347520357
STAT,1923,39,45-49,1962,0.7446151219208024
SIM,1802,90,na,1892,31
STAT,1915,16,25-29,1931,8.58942477953525
STAT,1835,54,35-39,1889,0.005367214835706274
STAT,1839,100,na,1939,0.7068413992672578
STAT,1873,61,na,1934,1790.3667825221848
SIM,1892,21,30-34,1913,27
STAT,1822,40,40-44,1862,3.455882959123738
STAT,1872,38,25-29,1910,2.7147295852646742
SIM,1849,77,na,1926,634
STAT,1829,52,45-49,1881,0.010426821666365597
SIM,1845,63,na,1908,1237
STAT,1877,75,na,1952,1008.8055604855416
SIM,1885,28,na,1913,2272
STAT,1834,46,40-44,1880,0.1254172090214695
SIM,1817,67,na,1884,838
SIM,1860,43,30-34,1903,1
SIM,1879,26,20-24,1905,13
STAT,1839,47,na,1886,1526.2071695157438
SIM,1939,31,25-29,1970,12
SIM,1813,53,na,1866,1197
STAT,1851,22,30-34,1873,15.301388850887967
SIM,1822,34,20-24,1856,4
SIM,1861,41,45-49,1902,1
STAT,1902,69,na,1971,2319.5692984271095
SIM,1906,39,na,1945,3231
SIM,1938,24,20-24,1962,91
STAT,1941,31,15-19,1972,0.12753161135161414
SIM,1902,25,na,1927,3209
STAT,1873,39,na,1912,2234.57714059621
STAT,1854,18,15-19,1872,5.049410099900997
SIM,1839,37,30-34,1876,5
SIM,1916,26,35-39,1942,18
SIM,1885,3,na,1888,2702
STAT,1833,85,na,1918,168.1886306573433
STAT,1856,38,40-44,1894,3.2105563986130816
STAT,1867,65,na,1932,1499.12866058986
STAT,1808,52,25-29,1860,0.012795931978948936
STAT,1886,40,45-49,1926,1.5085828673988377
STAT,1898,47,35-39,1945,0.10048824186501647
SIM,1820,40,45-49,1860,3
SIM,1868,19,20-24,1887,24
STAT,1818,42,40-44,1860,5.304929488308626
SIM,1950,18,35-39,1968,4
STAT,1939,30,20-24,1969,2.353755805668746
STAT,1860,32,na,1892,1829.1305095089062
SIM,1927,0,na,1927,4890
SIM,1817,39,45-49,1856,1
STAT,1837,99,na,1936,1.2290892587829576
STAT,1942,18,35-39,1960,4.141323836257887
STAT,1863,51,na,1914,1793.5538598670428
SIM,1881,30,45-49,1911,1
STAT,1823,44,50-100,1867,1.3345179185238452
STAT,1824,53,20-24,1877,8.489238120657597E-4
STAT,1895,33,50-100,1928,1.1236847854752545
SIM,1851,70,na,1921,1016
STAT,1912,3,na,1915,3862.097103638674
STAT,1891,38,35-39,1929,8.225695080610274
STAT,1875,47,40-44,1922,0.16546270303312163
SIM,1830,40,40-44,1870,5
SIM,1853,32,50-100,1885,3
STAT,1885,33,40-44,1918,4.0664082425682055
STAT,1841,29,na,1870,1825.866836805686
SIM,1956,15,25-29,1971,56
STAT,1852,30,25-29,1882,7.849814259774749
SIM,1911,27,25-29,1938,62
STAT,1875,43,25-29,1918,0.6190395597690751
STAT,1843,53,30-34,1896,0.003956074379461181
STAT,1903,27,25-29,1930,56.85955007954576
STAT,1839,58,na,1897,1316.6809240306218
STAT,1842,44,25-29,1886,0.46896136237084896
STAT,1918,20,na,1938,3742.974826036299
STAT,1905,48,40-44,1953,0.13021032100883095
STAT,1840,31,45-49,1871,1.4084161287117385
SIM,1841,25,40-44,1866,2
SIM,1936,30,45-49,1966,1
STAT,1846,45,20-24,1891,0.008989179651521436
STAT,1888,27,na,1915,2664.429612953168
SIM,1815,97,na,1912,1
STAT,1824,47,35-39,1871,0.17066892061597852
STAT,1891,44,20-24,1935,0.18311220144289317
SIM,1894,40,45-49,1934,6
SIM,1912,39,35-39,1951,2
STAT,1897,39,40-44,1936,1.1816871163642535
STAT,1849,28,35-39,1877,8.515332518289226
STAT,1778,105,na,1883,0.018979365090401865
STAT,1779,88,na,1867,36.89035492009098
SIM,1838,25,20-24,1863,13
STAT,1838,101,na,1939,0.38308823630193994
STAT,1849,19,45-49,1868,0.059586319008851134
STAT,1845,32,50-100,1877,0.7709049831152132
STAT,1878,35,15-19,1913,0.05581037425553801
STAT,1885,42,30-34,1927,1.0812448692761993
STAT,1948,15,25-29,1963,46.87689438052637
SIM,1868,80,na,1948,461
STAT,1862,23,45-49,1885,0.5724422008632782
SIM,1915,43,na,1958,3380
STAT,1816,104,na,1920,0.03108233167363884
SIM,1871,44,45-49,1915,4
STAT,1863,44,45-49,1907,1.2239929195701869
SIM,1873,29,30-34,1902,33
STAT,1904,39,35-39,1943,2.0478467750155738
SIM,1878,1,na,1879,3273
SIM,1857,28,35-39,1885,9
SIM,1791,89,na,1880,30
SIM,1935,4,na,1939,5127
STAT,1954,17,15-19,1971,52.99732389282627
STAT,1832,26,15-19,1858,0.3769360500191258
STAT,1873,30,45-49,1903,1.684211254695264
SIM,1858,37,40-44,1895,8
SIM,1893,36,45-49,1929,2
STAT,1869,41,35-39,1910,1.6647362748469554
SIM,1843,29,45-49,1872,1
STAT,1892,23,30-34,1915,21.01126354725695
STAT,1832,49,35-39,1881,0.08872924566009048
STAT,1902,48,15-19,1950,2.9704134259820214E-4
STAT,1810,89,na,1899,44.44173307760524
STAT,1915,41,15-19,1956,0.0014627140923280874
STAT,1916,28,35-39,1944,14.613340010392308
STAT,1837,51,40-44,1888,0.0069944934683383655
STAT,1889,42,15-19,1931,0.01608595208417502
SIM,1871,24,15-19,1895,2
SIM,1838,29,na,1867,1765
STAT,1842,16,30-34,1858,1.490993234150145
STAT,1867,45,40-44,1912,0.15338181930687914
STAT,1881,32,45-49,1913,1.5914234682516795
STAT,1848,16,25-29,1864,5.250722940034383
SIM,1856,16,25-29,1872,5
STAT,1825,32,30-34,1857,30.54197496138847
STAT,1931,38,40-44,1969,1.8709939722672213
STAT,1892,42,35-39,1934,2.140008024242744
SIM,1917,30,35-39,1947,14
STAT,1841,29,50-100,1870,0.5399200602071554
SIM,1892,30,20-24,1922,3
STAT,1883,28,na,1911,2202.6490141122767
SIM,1857,32,na,1889,1881
STAT,1884,30,20-24,1914,2.5430995141154797
STAT,1897,16,20-24,1913,22.452923880676916
STAT,1892,64,na,1956,2081.1295015090177
STAT,1825,51,35-39,1876,0.008633248490672006
SIM,1833,32,30-34,1865,17
SIM,1833,30,na,1863,1713
SIM,1837,44,na,1881,1571
STAT,1887,49,25-29,1936,0.03361609176537426
SIM,1849,26,35-39,1875,14
STAT,1868,28,45-49,1896,0.9972402782898446
STAT,1866,23,50-100,1889,0.3556456700129895
SIM,1897,37,40-44,1934,4
STAT,1874,35,30-34,1909,5.19308860429137
SIM,1885,40,30-34,1925,1
STAT,1908,26,35-39,1934,13.568337237138419
SIM,1818,43,45-49,1861,4
STAT,1841,32,15-19,1873,0.11911867147029757
STAT,1859,52,30-34,1911,0.0044518392776983695
STAT,1916,20,25-29,1936,91.9830701915964
SIM,1792,74,na,1866,410
STAT,1827,42,50-100,1869,1.0134398541318348
SIM,1815,44,30-34,1859,3
STAT,1814,41,45-49,1855,5.541952860783519
SIM,1904,16,15-19,1920,9
SIM,1950,20,na,1970,3949
STAT,1841,27,40-44,1868,2.565049993126922
STAT,1839,49,50-100,1888,0.16239099714184482
STAT,1832,41,25-29,1873,0.4810938496371283
STAT,1877,34,45-49,1911,1.6942014550149167
STAT,1904,39,na,1943,3185.28852108904
SIM,1796,88,na,1884,37
STAT,1838,27,20-24,1865,10.018778376108074
SIM,1885,34,45-49,1919,1
STAT,1818,85,na,1903,134.62706630212605
STAT,1834,42,25-29,1876,0.48043456451497074
SIM,1867,10,na,1877,2602
STAT,1858,31,30-34,1889,13.067072067445586
SIM,1898,29,35-39,1927,13
STAT,1842,104,na,1946,0.048302988447007866
STAT,1923,15,20-24,1938,151.09041659984217
SIM,1846,27,20-24,1873,10
STAT,1850,18,30-34,1868,1.364880549132718
STAT,1840,40,20-24,1880,0.12257226702416515
STAT,1909,30,35-39,1939,8.304747016749586
SIM,1904,37,35-39,1941,6
SIM,1931,15,20-24,1946,157
STAT,1863,24,15-19,1887,2.7495397932920995
SIM,1924,28,35-39,1952,23
STAT,1853,17,45-49,1870,0.05946807251365875
SIM,1899,33,35-39,1932,16
STAT,1898,20,20-24,1918,88.62473268195262
SIM,1855,84,na,1939,215
SIM,1865,51,na,1916,1904
SIM,1882,35,30-34,1917,6
SIM,1877,41,35-39,1918,1
SIM,1880,38,25-29,1918,3
STAT,1888,38,15-19,1926,0.06238269974665711
SIM,1859,98,na,1957,1
STAT,1858,39,40-44,1897,3.209702572142597
STAT,1877,40,30-34,1917,1.1379675361951533
STAT,1774,89,na,1863,27.403351824799955
STAT,1854,9,na,1863,2085.225266080367
SIM,1832,28,30-34,1860,26
SIM,1930,27,35-39,1957,25
STAT,1789,66,na,1855,676.3068000000002
SIM,1924,20,25-29,1944,106
SIM,1918,23,40-44,1941,6
STAT,1840,48,30-34,1888,0.06324514824485908
SIM,1835,85,na,1920,160
STAT,1865,26,50-100,1891,0.5496266811044397
STAT,1898,28,30-34,1926,32.0797148920816
STAT,1851,50,25-29,1901,0.0025845367442802586
STAT,1870,22,40-44,1892,1.931193357583771
SIM,1887,28,20-24,1915,17
SIM,1831,71,na,1902,786
STAT,1882,28,40-44,1910,2.7423832895100335
SIM,1872,10,na,1882,2538
STAT,1870,31,30-34,1901,16.247115903080736
STAT,1836,33,45-49,1869,1.4126428555544368
STAT,1848,62,na,1910,1358.1102905628318
STAT,1859,46,45-49,1905,0.17794996568930263
STAT,1899,31,50-100,1930,1.190837413249246
STAT,1847,37,15-19,1884,0.04296345209791359
STAT,1760,112,na,1872,5.792458517861501E-4
STAT,1895,48,20-24,1943,0.008231940297496815
STAT,1893,35,40-44,1928,5.294175846277301
SIM,1935,20,na,1955,4613
STAT,1837,34,15-19,1871,0.11349805464532778
STAT,1879,19,30-34,1898,1.567682282579063
STAT,1909,21,50-100,1930,0.5794937980999741
SIM,1839,99,na,1938,1
STAT,1938,19,na,1957,3427.804528181057
STAT,1831,37,25-29,1868,2.2073777139886266
STAT,1891,19,30-34,1910,1.8528944319178862
SIM,1866,31,30-34,1897,20
STAT,1861,40,40-44,1901,1.7846046741811563
STAT,1889,17,25-29,1906,6.608849611519652
STAT,1870,39,50-100,1909,1.126372764768004
SIM,1844,33,45-49,1877,2
STAT,1835,29,45-49,1864,0.9078193228270747
STAT,1903,54,na,1957,2851.7158152238735
STAT,1857,27,30-34,1884,19.32520497692978
STAT,1934,16,35-39,1950,5.37496226212626
STAT,1815,42,15-19,1857,0.034955238811305314
STAT,1937,34,na,1971,3530.2966284419454
SIM,1921,39,na,1960,3976
STAT,1826,44,40-44,1870,2.1116636642108952
STAT,1793,92,na,1885,10.363467029169769
STAT,1911,26,20-24,1937,16.87530608220902
STAT,1869,29,15-19,1898,0.4122560956796398
STAT,1848,36,40-44,1884,3.3869987929475758
SIM,1901,62,na,1963,2576
STAT,1880,20,35-39,1900,5.846434293427961
SIM,1861,46,50-100,1907,2
STAT,1861,28,50-100,1889,0.5024867535420179
SIM,1920,38,30-34,1958,3
STAT,1850,37,35-39,1887,5.064821722604211
SIM,1898,47,50-100,1945,1
STAT,1883,45,25-29,1928,0.053881765020080234
STAT,1877,43,50-100,1920,1.0277753686873639
SIM,1776,89,na,1865,35
SIM,1897,17,25-29,1914,7
STAT,1912,38,30-34,1950,1.6722004440983718
SIM,1848,46,50-100,1894,1
STAT,1933,20,na,1953,4603.325486885482
STAT,1935,20,35-39,1955,12.121284714961657
STAT,1818,96,na,1914,4.216896475603884
SIM,1834,44,40-44,1878,7
STAT,1865,100,na,1965,3.909584374446491
STAT,1878,52,40-44,1930,0.010309511246137961
STAT,1821,48,20-24,1869,0.01865474352309754
STAT,1844,103,na,1947,0.09967458117277853
STAT,1851,41,35-39,1892,1.3084900828715493
STAT,1816,54,25-29,1870,0.007695871644153826
STAT,1801,53,na,1854,1072.8384317804394
STAT,1874,24,na,1898,2268.509534756405
STAT,1902,17,50-100,1919,0.06531751281831788
STAT,1835,21,35-39,1856,4.97270624118353
SIM,1864,15,20-24,1879,20
SIM,1866,34,35-39,1900,13
SIM,1942,16,35-39,1958,4
STAT,1805,67,na,1872,795.3445021104808
SIM,1888,32,20-24,1920,3
STAT,1857,39,50-100,1896,0.905536757604125
STAT,1939,18,50-100,1957,0.3541694312580078
STAT,1860,32,25-29,1892,7.851055318953999
STAT,1856,15,20-24,1871,15.634873568740566
STAT,1830,25,15-19,1855,0.5547330584350599
STAT,1894,36,50-100,1930,1.4977144971037568
SIM,1843,21,35-39,1864,4
SIM,1856,36,40-44,1892,6
STAT,1838,46,25-29,1884,0.04029725760390878
STAT,1876,79,na,1955,682.3300801162012
SIM,1943,20,35-39,1963,9
STAT,1872,65,na,1937,1601.370044122083
SIM,1837,33,na,1870,1743
STAT,1820,38,50-100,1858,2.6569198018902362
STAT,1879,28,20-24,1907,11.560082492935676
STAT,1871,34,15-19,1905,0.13244496105132614
STAT,1867,16,35-39,1883,0.5005505617867038
STAT,1855,32,na,1887,1726.6501199524182
SIM,1884,43,na,1927,2254
STAT,1847,48,40-44,1895,0.12465785792313377
STAT,1912,42,15-19,1954,0.001399253684974854
SIM,1852,35,50-100,1887,4
STAT,1950,21,na,1971,4094.039097446903
SIM,1831,50,na,1881,1392
SIM,1797,73,na,1870,436
STAT,1932,34,40-44,1966,4.90811272680667
STAT,1847,13,na,1860,2187.135426617677
STAT,1862,49,20-24,1911,0.009490248211915915
SIM,1848,27,30-34,1875,23
SIM,1892,62,na,1954,2425
STAT,1771,100,na,1871,0.14960570662206016
STAT,1844,16,40-44,1860,0.16243429632656026
STAT,1882,48,35-39,1930,0.1270040344202707
STAT,1810,48,45-49,1858,0.7746924185690324
STAT,1921,48,25-29,1969,0.056334450069164176
SIM,1846,16,na,1862,2067
STAT,1832,54,30-34,1886,0.0035967671053365527
STAT,1915,37,45-49,1952,0.6506000200591754
SIM,1871,15,na,1886,2453
STAT,1791,108,na,1899,3.3915591969782067E-4
SIM,1945,19,na,1964,3634
STAT,1903,44,15-19,1947,0.00127161968555204
SIM,1866,18,35-39,1884,2
STAT,1875,27,25-29,1902,41.07530032967133
SIM,1939,9,na,1948,3713
STAT,1900,30,15-19,1930,0.18812601850165045
SIM,1867,47,50-100,1914,2
SIM,1875,16,35-39,1891,1
SIM,1890,17,15-19,1907,8
SIM,1806,51,na,1857,1227
SIM,1892,6,na,1898,3423
SIM,1895,28,50-100,1923,1
SIM,1937,19,30-34,1956,12
STAT,1810,68,na,1878,727.4667036079912
SIM,1859,44,na,1903,1834
SIM,1867,63,na,1930,1725
SIM,1900,24,45-49,1924,4
STAT,1891,26,40-44,1917,3.513173935342385
STAT,1850,45,35-39,1895,0.09967316366238442
STAT,1868,82,na,1950,420.5503944122659
SIM,1890,28,40-44,1918,3
SIM,1832,35,40-44,1867,5
STAT,1925,22,na,1947,4129.310487067912
SIM,1829,46,na,1875,1391
STAT,1952,20,35-39,1972,10.702154576404398
STAT,1824,35,40-44,1859,7.543665237501689
SIM,1905,54,na,1959,2869
STAT,1924,19,50-100,1943,0.4192076522151716
STAT,1858,18,35-39,1876,0.4719547535366693
SIM,1883,27,25-29,1910,42
STAT,1885,49,15-19,1934,3.6879279803379633E-4
STAT,1929,19,30-34,1948,14.615799052526333
STAT,1930,26,30-34,1956,47.08715894987081
STAT,1809,71,na,1880,629.2657936267876
STAT,1909,45,20-24,1954,0.009685797067989926
SIM,1846,26,na,1872,1867
SIM,1880,8,na,1888,2680
STAT,1906,44,40-44,1950,0.2120075121306072
SIM,1823,37,40-44,1860,8
STAT,1855,42,na,1897,1640.4065354200527
STAT,1867,29,40-44,1896,2.6383067850617805
SIM,1884,33,na,1917,2331
STAT,1794,106,na,1900,0.002286947994658261
STAT,1869,0,na,1869,3431.0195838963173
SIM,1839,29,30-34,1868,26
STAT,1833,53,35-39,1886,0.00533703242562684
STAT,1855,10,na,1865,2043.0205846033093
SIM,1797,83,na,1880,108
STAT,1919,40,45-49,1959,0.1708550885882053
SIM,1912,36,30-34,1948,1
STAT,1864,44,25-29,1908,0.5333799630439493
SIM,1889,28,30-34,1917,29
STAT,1856,52,50-100,1908,0.011072640533134993
STAT,1927,35,na,1962,4426.4222075600455
SIM,1914,37,na,1951,3552
STAT,1862,25,50-100,1887,0.5261241856903096
SIM,1869,76,na,1945,804
STAT,1823,86,na,1909,118.74395058368779
STAT,1896,40,40-44,1936,0.19684781348673439
STAT,1831,45,25-29,1876,0.042105665476468476
SIM,1852,2,na,1854,2616
STAT,1904,36,30-34,1940,1.5662815118935198
SIM,1855,62,na,1917,1430
STAT,1830,46,20-24,1876,0.009108847831885071
STAT,1881,49,30-34,1930,0.08649583106119514
SIM,1857,43,na,1900,1825
STAT,1868,60,na,1928,1719.021359373455
STAT,1917,25,na,1942,3736.596788557639
SIM,1864,0,na,1864,3173
STAT,1918,41,40-44,1959,0.2515940781193589
STAT,1917,35,na,1952,3726.6592444938483
SIM,1878,17,15-19,1895,5
SIM,1859,66,na,1925,1286
SIM,1906,18,na,1924,3453
SIM,1864,38,40-44,1902,7
STAT,1900,43,35-39,1943,0.1636010954162709
STAT,1813,54,20-24,1867,0.0018535009238321554
SIM,1855,17,20-24,1872,16
STAT,1899,19,35-39,1918,0.7064416605024251
SIM,1888,16,20-24,1904,21
STAT,1909,5,na,1914,3712.869691395134
STAT,1853,46,15-19,1899,3.035776698720061E-4
SIM,1878,53,50-100,1931,1
SIM,1854,45,na,1899,1833
STAT,1938,1,na,1939,3891.69647689297
SIM,1856,26,na,1882,1952
SIM,1905,28,25-29,1933,53
STAT,1806,51,50-100,1857,0.054247814822577144
STAT,1948,19,40-44,1967,1.5112146836208062
SIM,1821,40,na,1861,1477
STAT,1891,40,50-100,1931,1.2472203292769006
SIM,1914,29,50-100,1943,6
STAT,1847,17,20-24,1864,16.316575628361527
SIM,1891,40,50-100,1931,4
STAT,1840,23,50-100,1863,0.33788384027723106
SIM,1865,19,30-34,1884,2
STAT,1871,48,na,1919,2083.994636378398
STAT,1840,43,25-29,1883,0.4340068438257358
SIM,1904,34,30-34,1938,17
STAT,1903,30,40-44,1933,5.876063240885255
SIM,1895,27,na,1922,3013
STAT,1942,28,50-100,1970,0.9864337510042861
SIM,1839,46,na,1885,1576
SIM,1760,96,na,1856,1
STAT,1907,18,40-44,1925,0.2531546283424656
STAT,1954,9,na,1963,4588.921300657057
STAT,1823,43,25-29,1866,0.8334703988028674
STAT,1929,31,15-19,1960,0.15428575234578928
SIM,1921,34,30-34,1955,21
SIM,1880,61,na,1941,1854
STAT,1834,104,na,1938,0.04135201890091187
SIM,1884,32,50-100,1916,4
STAT,1820,42,45-49,1862,2.750307228594755
STAT,1845,32,na,1877,1823.469495699693
SIM,1842,26,25-29,1868,50
SIM,1894,43,na,1937,2907
SIM,1789,86,na,1875,51
SIM,1804,70,na,1874,637
STAT,1865,53,30-34,1918,0.0050151295457097475
STAT,1877,43,na,1920,2248.503056113696
STAT,1834,26,25-29,1860,34.67284424879435
STAT,1913,34,30-34,1947,14.682035630770253
STAT,1880,45,20-24,1925,0.012070367317001382
STAT,1922,44,25-29,1966,0.07717280546941162
STAT,1857,19,30-34,1876,1.3793633844128572
SIM,1871,25,na,1896,2288
STAT,1761,93,na,1854,8.0
SIM,1853,46,50-100,1899,2
SIM,1837,26,50-100,1863,1
STAT,1885,17,40-44,1902,0.17222948887162118
SIM,1854,13,na,1867,2268
SIM,1911,30,40-44,1941,8
SIM,1830,33,50-100,1863,1
SIM,1862,32,na,1894,2026
SIM,1867,95,na,1962,28
STAT,1884,13,na,1897,2406.5732861706824
STAT,1831,83,na,1914,231.79499123734018
STAT,1910,41,50-100,1951,0.10549518368314083
STAT,1892,10,na,1902,3065.0040550886038
SIM,1872,32,na,1904,2246
STAT,1835,38,20-24,1873,0.6002826499914479
STAT,1895,39,30-34,1934,6.4978383196560445
STAT,1903,24,20-24,1927,92.04901089157151
SIM,1911,24,20-24,1935,107
STAT,1810,53,40-44,1863,0.0329141435736734
STAT,1850,28,45-49,1878,0.914443131325546
STAT,1881,36,25-29,1917,2.6402207172852514
STAT,1890,34,25-29,1924,11.728575352945516
STAT,1802,53,50-100,1855,0.04333641061259227
STAT,1851,49,45-49,1900,0.16622037606352613
STAT,1814,45,25-29,1859,0.18216586202858306
STAT,1830,33,15-19,1863,0.12015264259210957
STAT,1828,48,30-34,1876,0.07735203392746381
SIM,1884,65,na,1949,1626
SIM,1934,35,na,1969,4834
STAT,1839,18,25-29,1857,4.906428326047433
SIM,1875,82,na,1957,495
STAT,1854,47,20-24,1901,0.008545793068799813
STAT,1923,36,40-44,1959,1.6400831666989213
SIM,1912,18,15-19,1930,12
SIM,1818,100,na,1918,1
STAT,1935,25,50-100,1960,1.2828629653164123
SIM,1922,24,na,1946,3865
STAT,1854,38,30-34,1892,3.7943194482352802
STAT,1871,47,20-24,1918,0.011204387927036118
STAT,1888,80,na,1968,1071.3885964257254
SIM,1875,50,na,1925,2106
STAT,1775,107,na,1882,0.007351790713054378
STAT,1894,22,50-100,1916,0.4950777276033148
STAT,1890,47,30-34,1937,0.06277088868848203
STAT,1865,36,40-44,1901,3.766348419133125
STAT,1872,12,na,1884,2493.991998061462
SIM,1932,35,45-49,1967,1
STAT,1858,82,na,1940,345.5889621350752
SIM,1839,24,na,1863,1823
STAT,1885,30,na,1915,2265.1166017122146
STAT,1891,46,35-39,1937,0.09256265203795455
SIM,1816,71,na,1887,624
STAT,1880,34,50-100,1914,0.9047082485269383
STAT,1800,68,na,1868,722.8580138783335
STAT,1913,46,25-29,1959,0.04903463632999836
SIM,1830,86,na,1916,105
STAT,1875,18,35-39,1893,0.5314086808180141
STAT,1784,88,na,1872,41.796047746136644
SIM,1880,83,na,1963,651
STAT,1851,54,40-44,1905,0.007364738301665631
SIM,1935,25,50-100,1960,1
STAT,1792,108,na,1900,3.339122633498941E-4
SIM,1873,36,40-44,1909,5
STAT,1905,24,na,1929,3209.243629378752
STAT,1923,18,25-29,1941,47.94508489163276
STAT,1855,46,25-29,1901,0.04104831013658443
STAT,1935,22,na,1957,4697.783978031583
SIM,1931,18,25-29,1949,73
SIM,1921,37,50-100,1958,1
STAT,1849,50,20-24,1899,5.612938951992353E-4
STAT,1856,28,50-100,1884,0.4850770786869825
STAT,1924,35,45-49,1959,0.7607074029943368
STAT,1908,42,na,1950,3246.1379183674385
SIM,1864,45,na,1909,2005
SIM,1847,18,25-29,1865,5
STAT,1920,44,15-19,1964,0.0015969184724795055
SIM,1872,64,na,1936,1588
STAT,1860,44,40-44,1904,1.7008196932118114
STAT,1898,20,50-100,1918,0.5244377896605781
STAT,1885,62,na,1947,1721.0712757648182
STAT,1904,18,15-19,1922,8.02058187945809
STAT,1922,24,30-34,1946,30.941850473480045
STAT,1872,46,25-29,1918,0.0547354135612639
STAT,1838,19,20-24,1857,15.537012220016106
STAT,1844,48,15-19,1892,2.7431855791605966E-4
STAT,1907,35,45-49,1942,0.602777529420959
STAT,1928,19,na,1947,4357.753448484061
STAT,1900,26,45-49,1926,1.4600505767427763
STAT,1861,43,45-49,1904,1.1670994064883093
SIM,1929,17,30-34,1946,19
STAT,1809,48,20-24,1857,0.033277936306334854
STAT,1843,103,na,1946,0.09693674693913945
SIM,1898,20,50-100,1918,1
SIM,1902,34,20-24,1936,1
SIM,1930,24,30-34,1954,43
SIM,1846,19,20-24,1865,14
SIM,1866,14,na,1880,2364
STAT,1839,49,45-49,1888,0.15604346656521434
STAT,1874,19,30-34,1893,1.530189748586899
STAT,1842,43,35-39,1885,1.3394720915836367
STAT,1891,29,45-49,1920,1.2884265410680418
SIM,1802,69,na,1871,673
SIM,1832,38,45-49,1870,3
STAT,1840,35,25-29,1875,2.2817071208721544
STAT,1873,29,na,1902,2270.2199614571805
SIM,1895,59,na,1954,2462
SIM,1923,34,40-44,1957,4
STAT,1900,31,40-44,1931,5.7065118573413685
STAT,1921,45,20-24,1966,0.01182445418775725
STAT,1953,18,na,1971,4204.8452034895745
STAT,1932,37,45-49,1969,0.8652924921109885
STAT,1813,86,na,1899,91.31240262250776
STAT,1821,43,15-19,1864,0.023073698965583988
STAT,1824,52,30-34,1876,0.006985577451873874
SIM,1809,48,na,1857,1283
STAT,1907,30,25-29,1937,8.227252464779365
STAT,1872,97,na,1969,27.307266646739293
STAT,1917,47,20-24,1964,0.010904701665844304
STAT,1913,53,na,1966,3315.5387170945883
STAT,1875,62,na,1937,1774.7537535992017
SIM,1857,37,25-29,1894,1
STAT,1773,94,na,1867,3.3676603813105745
SIM,1855,94,na,1949,10
STAT,1824,38,45-49,1862,2.9717706418806387
STAT,1873,38,40-44,1911,4.173345813398137
SIM,1898,33,50-100,1931,1
STAT,1856,59,na,1915,1432.4842767164932
STAT,1830,49,25-29,1879,0.04205902093873018
STAT,1914,20,15-19,1934,4.959645336476742
SIM,1934,25,na,1959,4688
SIM,1793,69,na,1862,665
STAT,1829,29,20-24,1858,13.142599164730129
STAT,1852,18,40-44,1870,0.15943271758464161
SIM,1821,72,na,1893,737
SIM,1942,6,na,1948,3853
STAT,1891,43,30-34,1934,1.3340039933229826
STAT,1845,40,35-39,1885,1.3387241000219177
STAT,1851,28,na,1879,1808.9338889690998
STAT,1831,73,na,1904,693.5116777986622
STAT,1899,16,30-34,1915,2.0681759214203184
STAT,1844,19,45-49,1863,0.05699318424059894
SIM,1904,59,na,1963,2845
SIM,1847,43,na,1890,1698
STAT,1803,66,na,1869,780.0594742095651
STAT,1878,19,15-19,1897,5.811354353826223
STAT,1880,28,30-34,1908,24.991251883595236
STAT,1947,6,na,1953,4203.023794235974
STAT,1910,45,45-49,1955,0.1924700849047453
STAT,1829,26,na,1855,1686.7821112128718
STAT,1838,50,45-49,1888,0.010082858117102904
SIM,1864,13,na,1877,2362
STAT,1849,37,25-29,1886,2.2092462157418096
SIM,1885,60,na,1945,1800
STAT,1856,27,15-19,1883,0.34652954098748795
SIM,1800,56,na,1856,1017
SIM,1873,5,na,1878,2636
STAT,1831,42,20-24,1873,0.11726272956584442
STAT,1853,46,50-100,1899,0.18639684588235175
STAT,1873,47,30-34,1920,0.09231309668847185
SIM,1834,28,40-44,1862,3
SIM,1909,36,na,1945,3422
SIM,1914,18,25-29,1932,11
STAT,1923,40,25-29,1963,0.07906483263072626
SIM,1853,40,35-39,1893,2
SIM,1922,20,15-19,1942,6
SIM,1849,5,na,1854,2310
SIM,1844,34,50-100,1878,3
STAT,1844,21,50-100,1865,0.35617609474475487
STAT,1881,45,50-100,1926,0.22637069743817087
SIM,1905,7,na,1912,3510
STAT,1808,97,na,1905,2.077205538631859
STAT,1923,44,40-44,1967,0.2752539694005736
STAT,1876,54,45-49,1930,0.013774679980936295
STAT,1878,60,na,1938,1877.6576759577397
STAT,1906,47,45-49,1953,0.18231141600457262
STAT,1796,89,na,1885,37.86909800164881
STAT,1900,40,30-34,1940,0.10568024396940368
STAT,1921,36,30-34,1957,1.9242438617946942
SIM,1860,42,40-44,1902,7
STAT,1848,29,30-34,1877,22.018505376585164
SIM,1817,77,na,1894,385
STAT,1904,40,15-19,1944,0.0013125880952128796
SIM,1804,92,na,1896,19
SIM,1856,29,30-34,1885,24
STAT,1882,17,15-19,1899,5.452162972491178
STAT,1836,46,15-19,1882,2.745744854838821E-4
STAT,1831,44,50-100,1875,0.7594063227729007
SIM,1888,19,25-29,1907,7
SIM,1941,20,25-29,1961,86
STAT,1864,25,na,1889,2030.8624996563344
STAT,1858,15,30-34,1873,1.395428489072575
STAT,1875,84,na,1959,431.91023971104994
STAT,1769,99,na,1868,0.2641195111257105
STAT,1826,28,40-44,1854,9.558849240242134
SIM,1964,0,na,1964,4615
STAT,1892,32,na,1924,2823.603298695086
STAT,1891,58,na,1949,2311.3788299898606
SIM,1881,38,40-44,1919,4
SIM,1904,37,na,1941,3291
STAT,1888,37,na,1925,2630.326506817212
STAT,1819,50,35-39,1869,0.016294726385518994
STAT,1854,15,na,1869,1987.9975627885535
STAT,1869,49,30-34,1918,0.08674064012664229
STAT,1933,20,25-29,1953,116.43758477030981
SIM,1866,15,30-34,1881,1
STAT,1920,24,20-24,1944,116.04859003666866
SIM,1883,42,35-39,1925,6
SIM,1850,43,35-39,1893,2
STAT,1877,18,45-49,1895,0.06384407517193581
STAT,1934,32,35-39,1966,11.786898385206735
STAT,1881,58,na,1939,1804.768316606103
STAT,1911,46,15-19,1957,3.302808117970427E-4
STAT,1903,9,na,1912,3487.581914978672
SIM,1919,36,na,1955,3882
STAT,1846,101,na,1947,0.4232336906194868
STAT,1843,52,40-44,1895,0.007073011309684342
STAT,1893,19,40-44,1912,0.2179478109498951
STAT,1915,34,40-44,1949,3.7329857640107242
STAT,1875,42,35-39,1917,1.7561619615453514
STAT,1860,16,25-29,1876,5.039246699028001
STAT,1938,29,25-29,1967,61.54208053800398
STAT,1869,16,45-49,1885,0.060969416100775047
SIM,1867,27,40-44,1894,7
STAT,1890,31,20-24,1921,3.134698673597346
STAT,1805,52,20-24,1857,0.002708650042784358
STAT,1863,48,25-29,1911,0.047151397679991984
SIM,1896,18,20-24,1914,25
SIM,1923,42,40-44,1965,2
STAT,1886,41,35-39,1927,1.8152062682200083
STAT,1919,29,15-19,1948,0.7154402219676658
STAT,1781,81,na,1862,191.74333036355452
SIM,1840,64,na,1904,1157
STAT,1847,101,na,1948,0.4207819690047174
STAT,1829,48,na,1877,1464.9884847075944
SIM,1846,48,na,1894,1576
STAT,1863,61,na,1924,1549.1312021158283
SIM,1876,14,na,1890,2516
STAT,1864,46,na,1910,1899.6807238632566
STAT,1923,31,20-24,1954,2.652375725635903
STAT,1859,14,na,1873,2064.6748897021935
STAT,1880,31,na,1911,2386.3227002654885
STAT,1817,90,na,1907,36.49072086518852
SIM,1834,90,na,1924,48
STAT,1802,54,45-49,1856,0.0408129479448975
SIM,1877,0,na,1877,3404
STAT,1898,37,na,1935,3011.927406584129
STAT,1809,46,50-100,1855,0.7054689339121963
STAT,1868,50,30-34,1918,0.005442384927731855
STAT,1900,23,40-44,1923,2.7224024972019105
SIM,1826,29,45-49,1855,2
SIM,1918,19,20-24,1937,128
STAT,1913,23,50-100,1936,0.625781159199053
SIM,1909,58,na,1967,3089
SIM,1829,27,20-24,1856,10
SIM,1927,29,15-19,1956,2
SIM,1821,50,na,1871,1269
STAT,1917,20,40-44,1937,3.396103380035455
STAT,1804,50,na,1854,1207.7035788086152
STAT,1926,30,35-39,1956,10.450277459222459
SIM,1886,4,na,1890,2594
STAT,1850,25,40-44,1875,2.5210541701705136
SIM,1787,73,na,1860,415
STAT,1839,26,na,1865,1827.5786867210284
SIM,1862,38,30-34,1900,7
STAT,1870,38,15-19,1908,0.051783746162295315
STAT,1908,42,35-39,1950,0.17600338778374866
STAT,1841,16,15-19,1857,5.308031439091556
STAT,1855,17,50-100,1872,0.04140889368277758
SIM,1806,83,na,1889,126
STAT,1841,47,35-39,1888,0.09695522229006069
STAT,1915,42,40-44,1957,0.23789647626795857
STAT,1888,49,40-44,1937,0.10556545660666641
STAT,1763,94,na,1857,2.0648091712700873
STAT,1801,85,na,1886,86.56996276189511
STAT,1883,44,35-39,1927,1.6545608793863864
STAT,1888,18,20-24,1906,19.741129630242504
STAT,1866,17,30-34,1883,1.4254620977395258
SIM,1934,30,35-39,1964,13
SIM,1901,30,na,1931,3161
STAT,1922,48,50-100,1970,0.24478468705148798
STAT,1902,36,20-24,1938,0.22289197907356081
SIM,1847,15,20-24,1862,17
STAT,1821,35,15-19,1856,0.13172561050747966
SIM,1811,72,na,1883,489
STAT,1857,54,35-39,1911,0.006237885870435071
SIM,1817,46,50-100,1863,4
STAT,1848,94,na,1942,14.850815442108578
SIM,1839,16,25-29,1855,5
STAT,1940,8,na,1948,3809.9409844182537
STAT,1942,24,na,1966,3614.695823606163
STAT,1859,27,40-44,1886,2.2912136490958606
STAT,1938,29,na,1967,3502.659063313093
STAT,1922,36,na,1958,4047.825332645565
SIM,1842,41,35-39,1883,2
SIM,1869,44,na,1913,2091
SIM,1931,31,20-24,1962,3
STAT,1918,52,na,1970,3631.1633464822735
SIM,1874,17,30-34,1891,1
STAT,1888,59,na,1947,2169.777081429232
STAT,1916,41,30-34,1957,0.12394589101878514
SIM,1840,86,na,1926,129
STAT,1896,47,25-29,1943,0.040349799005595835
SIM,1840,37,40-44,1877,4
STAT,1865,39,45-49,1904,1.6897755008254531
STAT,1786,69,na,1855,610.7956
SIM,1826,71,na,1897,712
STAT,1875,40,20-24,1915,0.1557658165124803
STAT,1797,85,na,1882,90.03900412884668
STAT,1816,53,35-39,1869,0.019083131959852423
SIM,1859,28,45-49,1887,1
STAT,1850,42,30-34,1892,0.8094302520374264
SIM,1847,65,na,1912,1271
STAT,1863,29,na,1892,1964.328545576068
STAT,1882,32,25-29,1914,9.410037958768784
STAT,1849,79,na,1928,524.2366583231309
STAT,1839,15,20-24,1854,15.624369140513158
SIM,1861,15,na,1876,2279
STAT,1851,19,50-100,1870,0.042344515640119415
SIM,1912,24,na,1936,3387
STAT,1839,46,40-44,1885,0.11763309550321766
SIM,1779,86,na,1865,53
STAT,1879,51,45-49,1930,0.014419601021892088
SIM,1839,78,na,1917,497
STAT,1789,87,na,1876,51.34502648794447
SIM,1821,37,30-34,1858,7
SIM,1873,39,45-49,1912,1
STAT,1815,41,25-29,1856,1.701302551551599
STAT,1927,42,45-49,1969,0.19717990732151155
STAT,1930,23,na,1953,4405.720844876145
STAT,1897,28,15-19,1925,0.5711821317283272
STAT,1832,37,40-44,1869,3.345691172021788
STAT,1840,34,na,1874,1696.7174868120815
SIM,1849,39,40-44,1888,3
SIM,1834,47,na,1881,1452
SIM,1841,18,30-34,1859,3
STAT,1776,107,na,1883,0.007638252469172782
STAT,1872,43,20-24,1915,0.14940052814192803
STAT,1822,47,25-29,1869,0.07745995551270578
SIM,1870,83,na,1953,346
STAT,1810,45,40-44,1855,0.5904507245997734
SIM,1814,70,na,1884,631
SIM,1925,20,40-44,1945,3
STAT,1835,53,45-49,1888,0.00922856282748146
STAT,1930,30,15-19,1960,0.15684208133414146
SIM,1885,82,na,1967,701
SIM,1915,30,25-29,1945,12
STAT,1945,19,15-19,1964,46.80240119597497
STAT,1877,47,15-19,1924,3.9014612957631546E-4
SIM,1921,37,35-39,1958,7
STAT,1935,35,20-24,1970,0.34882494762541194
STAT,1913,37,35-39,1950,2.2550352082177807
SIM,1890,32,25-29,1922,16
SIM,1877,31,na,1908,2327
STAT,1913,43,20-24,1956,0.016244526207339415
STAT,1894,40,30-34,1934,1.4098377653732124
STAT,1806,84,na,1890,115.36209198327133
STAT,1839,27,15-19,1866,0.3805458516738262
SIM,1909,48,50-100,1957,1
STAT,1901,30,30-34,1931,23.2732971507748
STAT,1828,44,15-19,1872,0.011325289745083462
SIM,1881,78,na,1959,708
STAT,1807,52,30-34,1859,0.02181196720800315
STAT,1849,57,na,1906,1506.9579834818728
STAT,1858,23,50-100,1881,0.31309758049242753
STAT,1880,63,na,1943,1777.0508037724057
STAT,1825,43,35-39,1868,1.9272990461731865
SIM,1908,41,na,1949,3227
SIM,1862,96,na,1958,7
SIM,1859,12,na,1871,2242
STAT,1864,40,45-49,1904,1.2728439531585702
STAT,1890,38,40-44,1928,5.030789015180732
STAT,1840,32,20-24,1872,2.160601529598294
STAT,1878,59,na,1937,1913.380489700447
STAT,1893,39,20-24,1932,0.914203686326937
SIM,1790,94,na,1884,2
STAT,1931,18,na,1949,4539.297421650928
STAT,1787,75,na,1862,387.4447712681734
STAT,1884,6,na,1890,2438.1671851670253
SIM,1824,69,na,1893,733
STAT,1826,48,20-24,1874,0.01093023292229787
STAT,1888,45,25-29,1933,0.06494853402498355
SIM,1873,59,na,1932,1900
STAT,1895,47,50-100,1942,0.16982881218695375
STAT,1892,34,35-39,1926,11.88026161455275
SIM,1856,79,na,1935,495
STAT,1830,37,30-34,1867,4.331174628455014
STAT,1911,34,20-24,1945,2.224679455004324
STAT,1885,44,45-49,1929,1.3902786753540695
STAT,1871,30,35-39,1901,9.57628180938937
STAT,1910,42,40-44,1952,0.2233212054393508
STAT,1872,34,50-100,1906,0.8607801508774356
STAT,1859,47,50-100,1906,0.18380339726899997
STAT,1860,31,35-39,1891,7.79421654193272
SIM,1920,31,45-49,1951,2
SIM,1929,29,25-29,1958,86
STAT,1843,16,25-29,1859,4.920355860797991
STAT,1931,20,15-19,1951,6.561021937864765
STAT,1922,48,40-44,1970,0.17063167122890885
SIM,1809,46,50-100,1855,1
STAT,1900,34,45-49,1934,2.2657210634199547
SIM,1833,43,35-39,1876,2
STAT,1838,94,na,1932,13.417656356994932
STAT,1895,35,15-19,1930,0.0698167050345709
SIM,1932,30,25-29,1962,20
STAT,1913,30,15-19,1943,0.12175692912930297
STAT,1907,32,40-44,1939,3.4556400225341313
STAT,1855,64,na,1919,1235.323864650159
STAT,1927,25,50-100,1952,1.1508695303770913
SIM,1765,95,na,1860,2
SIM,1873,49,na,1922,2135
STAT,1815,48,45-49,1863,0.5233431217514928
SIM,1915,32,40-44,1947,7
STAT,1783,72,na,1855,444.77973000000003
STAT,1891,26,na,1917,2798.8958072409046
STAT,1817,47,na,1864,1341.4904432313
STAT,1870,31,na,1901,2220.5784519920758
STAT,1823,54,na,1877,1240.2992786335972
STAT,1902,41,50-100,1943,0.0982513346886805
STAT,1924,30,25-29,1954,10.232579067962678
STAT,1823,47,40-44,1870,0.2108686305268111
STAT,1847,17,50-100,1864,0.04509001201465614
SIM,1879,18,20-24,1897,16
SIM,1872,40,45-49,1912,2
STAT,1818,53,45-49,1871,0.029118083439836216
STAT,1925,2,na,1927,4667.154522690798
STAT,1851,71,na,1922,960.1794242625596
STAT,1912,26,na,1938,3499.5980619452275
SIM,1854,67,na,1921,1252
SIM,1851,16,25-29,1867,6
STAT,1773,109,na,1882,0.002642124337163753
STAT,1836,82,na,1918,302.1431837792778
STAT,1916,8,na,1924,3984.4675128925896
STAT,1912,31,45-49,1943,1.468781565347774
STAT,1865,17,15-19,1882,5.236449948146427
SIM,1823,84,na,1907,166
STAT,1910,18,50-100,1928,0.0699494764603275
STAT,1920,45,na,1965,3854.4713503453954
STAT,1852,38,20-24,1890,0.5560829307661423
SIM,1790,72,na,1862,450
STAT,1917,40,35-39,1957,0.19907452901878817
STAT,1911,29,50-100,1940,0.9104752360782926
SIM,1862,86,na,1948,156
STAT,1851,33,35-39,1884,7.503881963243206
STAT,1914,48,50-100,1962,0.21132590711764915
STAT,1896,44,20-24,1940,0.013574120585171944
STAT,1947,19,25-29,1966,46.086269649904835
STAT,1904,44,30-34,1948,0.1067211169012197
STAT,1861,71,na,1932,1048.4687211825333
STAT,1859,54,45-49,1913,0.01061168072710959
STAT,1888,69,na,1957,1692.883341636782
STAT,1923,47,45-49,1970,0.2401843659459396
STAT,1950,20,25-29,1970,103.59286990065878
SIM,1884,11,na,1895,2527
STAT,1890,30,45-49,1920,2.0302442831751923
STAT,1947,19,50-100,1966,0.39844029119649027
SIM,1849,15,30-34,1864,3
SIM,1894,35,50-100,1929,2
STAT,1804,72,na,1876,564.6324282030898
STAT,1823,64,na,1887,948.7894114760263
STAT,1893,43,40-44,1936,0.18577337549313733
SIM,1841,49,na,1890,1456
STAT,1841,31,25-29,1872,8.65698049656511
SIM,1912,25,50-100,1937,4
SIM,1841,27,na,1868,1764
STAT,1823,32,na,1855,1533.3756544015882
STAT,1886,49,30-34,1935,0.09458083904717708
SIM,1878,40,50-100,1918,3
STAT,1897,43,25-29,1940,0.05593066330682315
STAT,1841,38,45-49,1879,1.602508360318196
STAT,1772,109,na,1881,0.0027374840884431704
STAT,1899,28,25-29,1927,54.56233494101663
SIM,1873,17,15-19,1890,6
SIM,1879,51,50-100,1930,1
SIM,1901,31,35-39,1932,14
STAT,1883,40,50-100,1923,0.9883732772597914
STAT,1833,64,na,1897,1066.528275376032
STAT,1864,48,40-44,1912,0.14233437497206236
STAT,1906,29,50-100,1935,0.8738645590793491
STAT,1874,43,30-34,1917,1.101670553914901
STAT,1905,30,15-19,1935,0.1960199524203072
STAT,1866,15,15-19,1881,5.370588703834073
SIM,1902,40,40-44,1942,1
STAT,1902,26,na,1928,3192.70686428665
STAT,1876,3,na,1879,3000.6191968904614
STAT,1814,46,50-100,1860,0.7638693272894381
STAT,1925,18,35-39,1943,4.7759102918551815
STAT,1894,76,na,1970,1563.7405533169826
SIM,1940,30,25-29,1970,8
STAT,1847,44,25-29,1891,0.4671394641331707
SIM,1870,31,45-49,1901,1
STAT,1922,41,20-24,1963,0.019177077586966743
SIM,1933,18,35-39,1951,4
SIM,1820,66,na,1886,869
SIM,1841,17,na,1858,1962
STAT,1906,19,na,1925,3456.3554255709805
STAT,1892,28,50-100,1920,0.754251874010559
STAT,1959,13,na,1972,4852.198057048111
SIM,1882,43,30-34,1925,4
STAT,1813,50,40-44,1863,0.028648442050447236
STAT,1862,44,50-100,1906,0.8417976093840728
STAT,1856,46,40-44,1902,0.12654598940590772
SIM,1874,15,15-19,1889,6
STAT,1915,45,45-49,1960,0.2078696025044825
STAT,1870,33,45-49,1903,1.6092869255848512
STAT,1873,34,25-29,1907,9.729567409533137
STAT,1845,48,30-34,1893,0.06763778612218156
STAT,1868,45,50-100,1913,0.2235765831272642
STAT,1888,39,50-100,1927,1.3569156191812275
STAT,1873,31,20-24,1904,2.6004234219017843
STAT,1876,32,50-100,1908,0.8942600567190595
STAT,1858,42,35-39,1900,1.339584937846206
STAT,1899,45,50-100,1944,0.18111285758607443
STAT,1866,59,na,1925,1693.381745572371
STAT,1941,18,na,1959,3580.4160816859303
STAT,1969,0,na,1969,4673.62456714418
STAT,1911,41,45-49,1952,0.15093279024342737
STAT,1920,30,40-44,1950,4.081887280436459
STAT,1836,50,35-39,1886,0.005868771896946178
SIM,1906,60,na,1966,2807
SIM,1857,8,na,1865,2291
STAT,1826,52,40-44,1878,0.009375755946440207
STAT,1874,78,na,1952,754.1606115755288
STAT,1870,63,na,1933,1653.6240980791001
STAT,1820,99,na,1919,0.997703700046249
STAT,1846,53,20-24,1899,5.3852984655788E-4
SIM,1928,17,15-19,1945,52
SIM,1869,12,na,1881,2466
SIM,1872,96,na,1968,23
STAT,1912,46,30-34,1958,0.08113896213043842
SIM,1881,31,20-24,1912,2
STAT,1822,33,50-100,1855,2.318706305041359
STAT,1869,45,15-19,1914,3.6972508713570436E-4
STAT,1852,54,35-39,1906,0.006069813863821077
STAT,1906,18,25-29,1924,7.776445437751557
STAT,1843,40,25-29,1883,0.4581782677376091
SIM,1815,87,na,1902,87
STAT,1807,47,na,1854,1318.2196913371406
SIM,1866,42,35-39,1908,1
STAT,1842,27,50-100,1869,0.5728827165460105
STAT,1829,53,20-24,1882,5.197718290857273E-4
STAT,1855,96,na,1951,6.101907917839543
STAT,1902,42,40-44,1944,0.20798680785848728
SIM,1773,92,na,1865,8
SIM,1939,19,40-44,1958,1
STAT,1802,91,na,1893,20.316195328182705
STAT,1852,45,45-49,1897,0.17280251829920842
STAT,1848,53,30-34,1901,0.004352072221482774
SIM,1874,41,30-34,1915,1
STAT,1859,34,50-100,1893,0.6830181199176275
STAT,1898,40,15-19,1938,0.0012383531472298407
SIM,1917,23,na,1940,3615
STAT,1867,49,20-24,1916,0.010422678899104549
STAT,1795,72,na,1867,570.3786883522554
SIM,1833,84,na,1917,162
STAT,1886,47,na,1933,2234.6725296167097
STAT,1906,40,25-29,1946,0.0619743650200867
STAT,1840,106,na,1946,0.00796807694554166
STAT,1845,46,50-100,1891,0.17428707530051346
SIM,1837,29,20-24,1866,12
STAT,1920,31,45-49,1951,1.6349195829398186
STAT,1905,56,na,1961,2897.4492977050836
STAT,1925,40,35-39,1965,0.23094270582811294
SIM,1851,40,25-29,1891,3
SIM,1910,42,40-44,1952,1
SIM,1840,33,25-29,1873,16
STAT,1842,50,50-100,1892,0.011094315076235525
STAT,1842,46,na,1888,1650.57895751953
STAT,1916,19,50-100,1935,0.07468984148485895
SIM,1824,47,na,1871,1403
STAT,1882,36,40-44,1918,4.04103564838703
STAT,1837,45,na,1882,1555.007626889218
STAT,1932,32,25-29,1964,11.607115703330756
SIM,1900,21,40-44,1921,1
SIM,1899,26,25-29,1925,53
SIM,1837,65,na,1902,1060
STAT,1832,33,25-29,1865,7.995812364469309
STAT,1839,79,na,1918,465.46304637891836
STAT,1867,21,50-100,1888,0.3658590147990567
STAT,1791,91,na,1882,17.776892534005245
STAT,1880,24,15-19,1904,3.265044530810064
STAT,1866,41,30-34,1907,1.0062630341490324
STAT,1880,21,50-100,1901,0.40735883460722183
STAT,1902,43,45-49,1945,0.137561484980231
SIM,1884,45,50-100,1929,2
SIM,1892,17,25-29,1909,9
SIM,1805,87,na,1892,49
SIM,1885,42,45-49,1927,4
SIM,1899,4,na,1903,3475
STAT,1815,45,40-44,1860,0.39720329688125766
STAT,1853,33,50-100,1886,0.7066934630916452
STAT,1850,54,25-29,1904,0.0024281860467524822
SIM,1774,87,na,1861,35
SIM,1890,36,40-44,1926,7
SIM,1938,31,30-34,1969,11
STAT,1920,23,na,1943,3823.365818784422
SIM,1837,97,na,1934,1
STAT,1855,43,20-24,1898,0.11204152512477626
STAT,1930,34,30-34,1964,19.18293705681225
STAT,1833,45,35-39,1878,0.10323028799874377
STAT,1856,42,25-29,1898,0.4727369587605315
STAT,1901,63,na,1964,2554.3784383027914
STAT,1914,46,40-44,1960,0.14808652705119627
STAT,1867,53,40-44,1920,0.009188901637105649
STAT,1901,31,35-39,1932,13.446169002236402
STAT,1834,27,na,1861,1758.5321533131746
STAT,1884,17,25-29,1901,5.288875052544204
STAT,1816,84,na,1900,155.02160901535277
STAT,1845,44,15-19,1889,0.009699500559081987
STAT,1843,48,20-24,1891,0.008003516555787621
STAT,1814,50,na,1864,1360.8507198436484
STAT,1910,40,25-29,1950,0.06447980755796687
SIM,1865,15,15-19,1880,8
SIM,1863,19,20-24,1882,14
STAT,1892,31,30-34,1923,20.74364270396958
SIM,1898,18,30-34,1916,2
STAT,1959,4,na,1963,4858.559084012794
STAT,1881,40,45-49,1921,1.3796254099126406
STAT,1884,41,25-29,1925,0.6020503270965641
STAT,1829,50,50-100,1879,0.012406371127215191
STAT,1894,44,na,1938,2777.643927219343
STAT,1767,107,na,1874,0.006841481477916791
SIM,1851,31,35-39,1882,7
STAT,1862,34,na,1896,1910.965456393366
STAT,1876,45,50-100,1921,0.24209655194584973
STAT,1906,42,25-29,1948,0.06127972983050567
SIM,1810,88,na,1898,53
SIM,1951,0,na,1951,4474
SIM,1877,41,na,1918,2244
SIM,1873,39,50-100,1912,1
SIM,1832,35,na,1867,1603
STAT,1878,30,45-49,1908,1.7306289854092267
SIM,1833,40,30-34,1873,2
SIM,1916,30,40-44,1946,8
STAT,1786,90,na,1876,27.489017846101937
STAT,1876,19,40-44,1895,0.17755692724950656
SIM,1845,31,na,1876,1825
STAT,1881,48,na,1929,2027.4205437513428
STAT,1911,37,25-29,1948,0.8984394122526198
STAT,1877,42,45-49,1919,1.4648039334133098
SIM,1894,11,na,1905,3270
SIM,1838,17,20-24,1855,18
STAT,1867,11,na,1878,2389.849759376525
STAT,1855,19,20-24,1874,14.80850375820012
SIM,1826,28,na,1854,1608
STAT,1817,41,35-39,1858,4.789023970294378
STAT,1817,50,25-29,1867,0.00796336661850285
STAT,1857,15,15-19,1872,5.258671332903454
STAT,1815,54,30-34,1869,0.01235968977446838
STAT,1870,85,na,1955,254.0571769519363
STAT,1899,21,na,1920,3070.5676773268256
STAT,1875,1,na,1876,3363.1266369264868
STAT,1825,40,30-34,1865,1.3105379846346168
SIM,1912,56,na,1968,3181
STAT,1795,106,na,1901,0.0025288123862005295
STAT,1950,22,40-44,1972,3.7683030827183908
SIM,1815,65,na,1880,912
STAT,1882,45,30-34,1927,0.08981825764112879
STAT,1830,33,50-100,1863,0.7730575289128855
SIM,1849,17,30-34,1866,2
STAT,1903,41,45-49,1944,0.14032952449245034
SIM,1923,19,na,1942,4128
STAT,1865,39,50-100,1904,1.040693994658365
STAT,1822,44,20-24,1866,0.21899452431555613
STAT,1838,54,25-29,1892,0.0023125968568684404
STAT,1860,53,30-34,1913,0.00448942795005202
STAT,1877,51,35-39,1928,0.008476679970740355
STAT,1864,78,na,1942,657.860090477896
STAT,1832,30,20-24,1862,2.181081611033327
SIM,1903,46,50-100,1949,2
STAT,1842,52,25-29,1894,0.0025514078577310063
STAT,1858,51,25-29,1909,0.0026360557918076026
STAT,1812,45,15-19,1857,0.0013844498467905082
STAT,1892,40,20-24,1932,0.18981170560493488
STAT,1864,15,50-100,1879,0.047449598356892254
STAT,1921,32,15-19,1953,0.13509630751144874
STAT,1898,16,15-19,1914,7.605479494291992
STAT,1928,41,15-19,1969,0.0018520638309828042
SIM,1825,41,35-39,1866,2
SIM,1916,18,35-39,1934,1
STAT,1852,42,40-44,1894,1.6286864245121206
STAT,1874,46,35-39,1920,0.13551493924216385
SIM,1840,30,20-24,1870,2
STAT,1884,32,35-39,1916,9.45180050101092
SIM,1851,27,na,1878,1871
STAT,1831,49,40-44,1880,0.11886515844853518
STAT,1846,82,na,1928,346.065964964698
STAT,1911,41,na,1952,3368.1074033876853
SIM,1844,41,45-49,1885,1
STAT,1879,77,na,1956,893.4759961561756
STAT,1770,100,na,1870,0.15370228800909158
SIM,1888,43,25-29,1931,2
SIM,1830,46,50-100,1876,2
SIM,1947,21,na,1968,3852
STAT,1767,87,na,1854,46.0
SIM,1900,24,na,1924,3122
STAT,1881,26,na,1907,2185.430795181337
STAT,1812,49,30-34,1861,0.3135197406755165
SIM,1914,1,na,1915,4010
STAT,1908,18,35-39,1926,0.7669420731282329
SIM,1892,32,35-39,1924,18
SIM,1955,6,na,1961,4605
STAT,1869,77,na,1946,791.0825728110786
SIM,1904,27,na,1931,3301
SIM,1881,34,25-29,1915,8
STAT,1863,45,20-24,1908,0.010047387249267547
STAT,1849,15,15-19,1864,5.542858691475758
STAT,1851,30,30-34,1881,13.346529360648978
STAT,1932,5,na,1937,5029.603202747241
SIM,1923,20,30-34,1943,38
STAT,1841,44,30-34,1885,0.8027698611658867
SIM,1865,2,na,1867,2851
SIM,1810,66,na,1876,817
STAT,1892,0,na,1892,3474.4210824787915
STAT,1841,35,40-44,1876,3.6302971689999644
STAT,1899,43,na,1942,2980.3210259972366
STAT,1822,46,50-100,1868,0.33504743092785744
STAT,1836,41,45-49,1877,1.1678309972909615
STAT,1850,21,25-29,1871,48.7849889735874
SIM,1942,22,na,1964,3554
STAT,1940,31,20-24,1971,2.386195329704018
SIM,1828,61,na,1889,1113
SIM,1798,68,na,1866,710
STAT,1915,20,30-34,1935,27.093773157328755
SIM,1828,83,na,1911,207
STAT,1871,54,45-49,1925,0.013239326017707517
STAT,1856,49,na,1905,1623.683486252401
STAT,1893,46,45-49,1939,0.15993862892627772
SIM,1903,20,na,1923,3180
STAT,1886,45,15-19,1931,4.0314331214331127E-4
STAT,1949,13,na,1962,4315.310697388868
SIM,1883,59,na,1942,1745
STAT,1796,90,na,1886,30.64746101273438
STAT,1934,20,40-44,1954,4.282652683028868
SIM,1800,88,na,1888,32
SIM,1830,54,na,1884,1278
STAT,1813,54,na,1867,1129.172626322864
STAT,1830,50,40-44,1880,0.007932317303379477
STAT,1879,51,50-100,1930,0.015006161038815448
STAT,1930,37,35-39,1967,2.9803881167460364
STAT,1879,55,na,1934,2044.7065205829174
SIM,1873,27,na,1900,2299
SIM,1871,3,na,1874,2815
SIM,1884,15,25-29,1899,2
SIM,1906,42,40-44,1948,2
SIM,1860,20,na,1880,2083
STAT,1914,42,25-29,1956,0.0668467339734946
STAT,1876,15,25-29,1891,5.5564508490422675
STAT,1862,40,35-39,1902,1.4773862956811388
SIM,1870,40,35-39,1910,1
STAT,1882,4,na,1886,2592.250145976588
STAT,1932,30,25-29,1962,11.620242870917421
SIM,1910,40,40-44,1950,2
SIM,1832,31,25-29,1863,7
STAT,1858,27,25-29,1885,32.074303596188905
STAT,1849,17,30-34,1866,1.4711860121003422
SIM,1857,15,15-19,1872,5
STAT,1847,41,20-24,1888,0.11928148072524672
STAT,1897,18,50-100,1915,0.06173331021645999
STAT,1808,65,na,1873,856.3251395557637
STAT,1844,43,45-49,1887,1.0510203254706532
STAT,1925,42,35-39,1967,0.23030343683443927
STAT,1856,49,45-49,1905,0.1703184096896647
STAT,1868,92,na,1960,68.29644707006132
SIM,1908,16,35-39,1924,2
SIM,1927,33,na,1960,4355
STAT,1903,12,na,1915,3471.2854530046566
STAT,1944,23,50-100,1967,0.6709285374057748
STAT,1899,43,35-39,1942,0.16159097686227034
SIM,1942,20,40-44,1962,3
STAT,1845,64,na,1909,1230.1125476207537
SIM,1890,39,45-49,1929,3
SIM,1886,77,na,1963,1038
STAT,1936,36,50-100,1972,0.38972841426702376
STAT,1897,47,40-44,1944,0.12143737327509951
STAT,1862,31,45-49,1893,1.4142735989946786
SIM,1892,30,na,1922,3184
STAT,1885,50,30-34,1935,0.0056857287509067675
SIM,1914,44,40-44,1958,1
STAT,1860,40,50-100,1900,0.817951571880979
SIM,1858,29,40-44,1887,2
STAT,1877,11,na,1888,2549.8678499289163
STAT,1820,47,15-19,1867,6.709215000174438E-4
STAT,1824,31,25-29,1855,29.19615883697127
STAT,1940,32,25-29,1972,9.036680749340753
STAT,1882,39,45-49,1921,1.8130141656353613
STAT,1880,48,25-29,1928,0.056645043670333316
STAT,1891,22,25-29,1913,66.9075967565799
STAT,1825,29,50-100,1854,2.1161084481548857
SIM,1922,48,50-100,1970,1
STAT,1860,47,45-49,1907,0.18005293564105457
STAT,1833,42,30-34,1875,0.8547281122080642
STAT,1910,31,35-39,1941,8.358296231600738
SIM,1784,87,na,1871,44
SIM,1932,32,40-44,1964,8
STAT,1908,30,40-44,1938,3.5177171990841813
STAT,1904,47,35-39,1951,0.10651216115204996
STAT,1820,49,30-34,1869,0.15764510915034619
STAT,1781,91,na,1872,17.481764555980963
STAT,1926,45,20-24,1971,0.01294190326183821
STAT,1847,40,50-100,1887,0.8037123980915291
STAT,1894,47,15-19,1941,2.72652696002687E-4
STAT,1897,41,50-100,1938,0.09310386910969128
STAT,1949,16,30-34,1965,13.396174438485794
SIM,1873,32,25-29,1905,16
SIM,1928,18,na,1946,4394
STAT,1928,19,15-19,1947,53.73057004941619
SIM,1897,18,na,1915,3260
SIM,1936,19,15-19,1955,33
STAT,1918,46,50-100,1964,0.22794657025668336
SIM,1857,17,30-34,1874,1
STAT,1814,42,20-24,1856,0.5627426583668511
SIM,1855,40,50-100,1895,1
STAT,1841,83,na,1924,273.6875681122822
SIM,1866,27,25-29,1893,41
STAT,1822,51,45-49,1873,0.019157558087523473
STAT,1862,12,na,1874,2208.3869235758425
STAT,1914,41,20-24,1955,0.01655582857631474
STAT,1922,35,50-100,1957,0.4521007843700899
STAT,1828,53,na,1881,1273.9145365533197
STAT,1881,33,20-24,1914,2.456418962367403
SIM,1877,63,na,1940,1689
STAT,1890,43,15-19,1933,0.015834662746236874
STAT,1811,44,45-49,1855,5.235223667672259
SIM,1852,43,45-49,1895,1
STAT,1866,44,35-39,1910,1.5565033049531707
STAT,1847,45,na,1892,1675.5888852012865
SIM,1898,16,15-19,1914,8
STAT,1924,32,40-44,1956,4.312985533645757
STAT,1883,81,na,1964,749.0339130504595
STAT,1825,52,50-100,1877,0.01484720793443712
STAT,1868,17,40-44,1885,0.1678431258170207
SIM,1869,19,15-19,1888,6
STAT,1875,30,na,1905,2335.7685691675824
STAT,1920,48,30-34,1968,0.09283305063613248
STAT,1817,79,na,1896,323.5752295261636
STAT,1861,48,15-19,1909,3.102467268757231E-4
STAT,1902,40,40-44,1942,0.21034443828712562
SIM,1862,64,na,1926,1485
SIM,1868,26,na,1894,2147
SIM,1874,44,35-39,1918,5
STAT,1782,76,na,1858,305.95111066929167
STAT,1834,54,40-44,1888,0.006438918187744105
SIM,1867,34,50-100,1901,3
STAT,1866,50,20-24,1916,6.522045685824737E-4
STAT,1871,38,30-34,1909,4.97473162231581
STAT,1888,42,20-24,1930,0.17708823269845492
STAT,1832,46,na,1878,1468.5332586716106
STAT,1843,31,35-39,1874,8.309179854299488
SIM,1871,22,35-39,1893,7
STAT,1831,30,50-100,1861,0.7501191067123708
STAT,1914,31,20-24,1945,2.329010664984751
STAT,1846,19,50-100,1865,0.045111051929286425
STAT,1911,30,40-44,1941,3.6289770535870303
STAT,1830,52,20-24,1882,4.8630755724653034E-4
STAT,1811,51,50-100,1862,0.049054679839411655
SIM,1776,90,na,1866,19
STAT,1848,20,45-49,1868,0.6400594024261361
STAT,1894,49,50-100,1943,0.16468127852603112
STAT,1932,22,25-29,1954,114.49280971055678
STAT,1925,45,40-44,1970,0.18132766952721205
STAT,1915,18,40-44,1933,0.27583411270718444
STAT,1918,19,20-24,1937,138.658528957203
SIM,1806,50,na,1856,1253
SIM,1874,23,15-19,1897,3
STAT,1857,25,50-100,1882,0.4980417692666198
SIM,1848,15,15-19,1863,7
SIM,1910,32,40-44,1942,4
STAT,1874,14,na,1888,2500.5149426987987
STAT,1833,105,na,1938,0.017988997243459485
SIM,1914,25,35-39,1939,18
STAT,1929,38,35-39,1967,2.930462157279911
SIM,1865,61,na,1926,1631
SIM,1847,22,45-49,1869,1
SIM,1896,22,40-44,1918,4
STAT,1920,41,45-49,1961,0.17389418860152556
STAT,1840,65,na,1905,1109.05084021269
STAT,1921,29,20-24,1950,19.081502046914004
STAT,1844,79,na,1923,485.54515611119734
STAT,1911,43,45-49,1954,0.14916753768320057
SIM,1931,22,30-34,1953,43
STAT,1868,31,50-100,1899,0.8292256526043194
STAT,1888,22,40-44,1910,2.3264646594186673
SIM,1795,61,na,1856,929
SIM,1923,18,40-44,1941,1
STAT,1866,23,15-19,1889,2.877173139175913
STAT,1915,23,35-39,1938,9.166600495069638
STAT,1923,20,na,1943,4037.9302633394177
STAT,1839,22,45-49,1861,0.5965389251849582
STAT,1946,17,na,1963,3856.7454056008132
STAT,1931,41,20-24,1972,0.022319836914759878
STAT,1885,24,50-100,1909,0.3815893523921
STAT,1912,39,50-100,1951,0.3832386022762666
SIM,1842,13,na,1855,2113
STAT,1896,30,50-100,1926,1.1523753297962973
SIM,1884,44,na,1928,2231
STAT,1912,36,15-19,1948,0.017792021764901366
SIM,1847,53,50-100,1900,1
SIM,1922,23,na,1945,3872
SIM,1879,25,45-49,1904,1
STAT,1847,12,na,1859,2197.1103074133334
STAT,1941,20,25-29,1961,90.23931598029556
STAT,1875,21,15-19,1896,3.213072083622984
SIM,1876,25,na,1901,2354
SIM,1899,23,20-24,1922,100
SIM,1907,22,40-44,1929,3
SIM,1931,24,25-29,1955,122
STAT,1921,34,15-19,1955,0.1339396668569817
SIM,1894,74,na,1968,1723
STAT,1902,32,40-44,1934,5.781846767757706
SIM,1905,32,30-34,1937,19
SIM,1940,22,25-29,1962,78
STAT,1934,38,45-49,1972,0.8878223171646292
SIM,1829,31,40-44,1860,5
STAT,1862,48,30-34,1910,0.07720472990199014
STAT,1927,17,20-24,1944,159.24581343404262
STAT,1923,42,25-29,1965,0.07884597446930663
STAT,1910,29,45-49,1939,1.5647869811033979
SIM,1888,58,na,1946,2226
SIM,1926,19,20-24,1945,152
SIM,1859,77,na,1936,652
STAT,1921,41,na,1962,3957.4160849653526
SIM,1867,96,na,1963,22
STAT,1917,36,na,1953,3709.367545599397
STAT,1897,15,45-49,1912,0.0829107356994291
STAT,1867,15,30-34,1882,1.4625949135471406
STAT,1917,46,45-49,1963,0.21499230554056092
SIM,1901,61,na,1962,2609
STAT,1927,40,45-49,1967,0.19772723306991843
SIM,1935,17,20-24,1952,179
STAT,1931,19,35-39,1950,5.160666855025543
SIM,1855,21,40-44,1876,1
SIM,1901,1,na,1902,3498
SIM,1922,26,25-29,1948,76
STAT,1859,20,20-24,1879,59.93388748750337
STAT,1904,25,50-100,1929,0.8727000513818239
STAT,1930,27,20-24,1957,21.926547920980695
SIM,1808,48,50-100,1856,2
SIM,1916,39,na,1955,3520
STAT,1814,49,na,1863,1375.7407530379771
SIM,1852,43,na,1895,1761
STAT,1914,20,50-100,1934,0.6130588266312275
STAT,1907,19,45-49,1926,0.09016371132962207
SIM,1892,63,na,1955,2352
STAT,1924,16,40-44,1940,1.577345031058162
SIM,1922,24,30-34,1946,40
SIM,1818,43,50-100,1861,2
SIM,1808,85,na,1893,72
SIM,1905,27,35-39,1932,14
STAT,1846,30,35-39,1876,9.062732775979658
STAT,1923,45,50-100,1968,0.2511310050463918
STAT,1903,31,45-49,1934,2.353541438824074
SIM,1932,16,40-44,1948,2
STAT,1857,25,15-19,1882,0.35323668013146026
SIM,1922,31,20-24,1953,3
SIM,1884,64,na,1948,1675
STAT,1855,31,na,1886,1744.672587784229
STAT,1897,62,na,1959,2397.437097759529
SIM,1833,52,na,1885,1328
SIM,1869,33,35-39,1902,13
STAT,1829,27,50-100,1856,0.9193075526458511
STAT,1942,23,na,1965,3615.9614100996987
SIM,1797,72,na,1869,482
SIM,1939,28,45-49,1967,2
SIM,1905,34,25-29,1939,8
SIM,1911,31,45-49,1942,2
STAT,1950,22,na,1972,4092.6880645447427
STAT,1944,14,na,1958,3992.0036515349802
SIM,1923,23,35-39,1946,12
STAT,1880,46,25-29,1926,0.057528719830413105
STAT,1915,30,25-29,1945,8.96431125316202
SIM,1867,20,20-24,1887,64
STAT,1932,15,35-39,1947,5.273364572566229
SIM,1940,15,35-39,1955,6
STAT,1929,37,na,1966,4562.746015877793
STAT,1867,20,50-100,1887,0.3685048798362812
STAT,1900,37,35-39,1937,2.0006527656781645
STAT,1943,18,15-19,1961,45.44939574033133
SIM,1829,47,na,1876,1375
SIM,1825,33,na,1858,1617
STAT,1916,47,40-44,1963,0.15276785418168323
STAT,1852,98,na,1950,2.355147720889525
STAT,1920,23,45-49,1943,1.178035177446927
STAT,1909,26,15-19,1935,0.645002845772552
SIM,1860,100,na,1960,5
STAT,1811,47,15-19,1858,0.0013323433529394456
STAT,1928,39,30-34,1967,2.1712749777776144
STAT,1863,22,35-39,1885,4.93412430260283
STAT,1905,29,35-39,1934,13.081389522775005
STAT,1859,16,35-39,1875,0.4817438717519246
SIM,1910,27,45-49,1937,1
SIM,1951,18,15-19,1969,46
SIM,1927,18,25-29,1945,43
SIM,1906,30,25-29,1936,15
STAT,1890,48,35-39,1938,0.09006351550074611
STAT,1895,30,30-34,1925,21.67621233944112
STAT,1877,42,na,1919,2262.0755091687097
SIM,1862,33,na,1895,2015
STAT,1826,50,na,1876,1343.2749679287826
STAT,1889,75,na,1964,1479.6269905502409
STAT,1849,47,na,1896,1679.218337264062
STAT,1908,15,45-49,1923,0.09196777164440427
STAT,1899,22,15-19,1921,4.270265564131306
STAT,1878,30,30-34,1908,17.3276227015825
STAT,1908,43,na,1951,3226.6610908572347
STAT,1800,69,na,1869,696.4014105703867
STAT,1852,48,15-19,1900,2.863504714598366E-4
SIM,1910,22,na,1932,3399
STAT,1925,15,45-49,1940,0.5727027405393861
STAT,1847,41,50-100,1888,0.7934811392638236
SIM,1876,45,na,1921,2211
STAT,1761,112,na,1873,9.456072681238534E-4
SIM,1837,30,35-39,1867,12
SIM,1849,67,na,1916,1185
SIM,1930,25,20-24,1955,22
STAT,1889,23,na,1912,2749.7264484673597
STAT,1914,26,25-29,1940,62.900406970516144
SIM,1923,30,25-29,1953,10
SIM,1902,15,15-19,1917,11
SIM,1821,51,na,1872,1248
SIM,1886,30,30-34,1916,19
STAT,1899,18,30-34,1917,2.0577035451199577
SIM,1898,24,15-19,1922,3
STAT,1918,42,45-49,1960,0.16716650454463652
STAT,1919,18,25-29,1937,45.12187402039988
SIM,1904,28,30-34,1932,36
STAT,1807,91,na,1898,21.553586049755324
STAT,1847,21,40-44,1868,1.8973641350638746
SIM,1913,29,35-39,1942,16
STAT,1874,1,na,1875,3355.544736928358
STAT,1940,17,35-39,1957,4.024868432730867
SIM,1934,28,50-100,1962,1
STAT,1897,42,na,1939,2926.456498634037
STAT,1825,88,na,1913,72.96426153283106
STAT,1832,78,na,1910,470.6759258288328
STAT,1775,108,na,1883,0.0046071466861497875
SIM,1929,36,35-39,1965,8
STAT,1832,41,50-100,1873,0.7914769734601346
SIM,1866,24,20-24,1890,63
STAT,1840,97,na,1937,3.525575133385165
STAT,1822,68,na,1890,776.534607750234
SIM,1793,90,na,1883,24
STAT,1903,8,na,1911,3494.1859263795295
SIM,1889,16,15-19,1905,8
STAT,1885,61,na,1946,1759.5886717903074
SIM,1807,99,na,1906,1
SIM,1925,43,40-44,1968,1
SIM,1853,72,na,1925,953
SIM,1817,46,na,1863,1397
STAT,1883,15,15-19,1898,5.522198543684584
STAT,1933,32,40-44,1965,4.9820385440782085
STAT,1858,24,20-24,1882,52.53045817432146
STAT,1904,37,20-24,1941,0.22545558479919453
STAT,1913,35,20-24,1948,0.24810117752749652
STAT,1926,41,40-44,1967,0.29171028942522964
STAT,1839,22,50-100,1861,0.34885318591508707
SIM,1915,16,40-44,1931,1
SIM,1901,34,40-44,1935,2
STAT,1903,38,15-19,1941,0.01621094834175799
SIM,1828,40,35-39,1868,4
SIM,1872,21,40-44,1893,2
SIM,1899,19,35-39,1918,3
STAT,1886,41,50-100,1927,1.0590145210590014
SIM,1922,27,35-39,1949,15
SIM,1785,71,na,1856,529
STAT,1920,38,15-19,1958,0.01984238104320735
STAT,1844,49,50-100,1893,0.16701354083243605
SIM,1890,43,50-100,1933,1
STAT,1795,105,na,1900,0.00610676741415245
STAT,1908,23,50-100,1931,0.5697084623704715
STAT,1914,27,35-39,1941,14.298476076156248
STAT,1784,89,na,1873,33.82554144094839
STAT,1780,75,na,1855,319.25907
SIM,1858,25,25-29,1883,44
STAT,1909,17,na,1926,3578.229654101339
SIM,1878,31,35-39,1909,14
STAT,1923,22,30-34,1945,31.59178466780817
STAT,1870,36,15-19,1906,0.052292354233402144
STAT,1913,28,30-34,1941,36.754139967763145
STAT,1935,21,na,1956,4699.334758501885
STAT,1864,21,40-44,1885,1.7956146998832634
SIM,1866,21,15-19,1887,5
SIM,1921,28,30-34,1949,42
SIM,1866,17,30-34,1883,2
STAT,1813,87,na,1900,72.5066133024023
STAT,1923,24,25-29,1947,100.89495851353584
SIM,1836,80,na,1916,400
STAT,1913,32,15-19,1945,0.12078603382430993
SIM,1918,18,na,1936,3775
STAT,1808,96,na,1904,3.3200759827888735
STAT,1835,24,50-100,1859,0.34006722169942266
SIM,1902,33,45-49,1935,2
STAT,1871,53,20-24,1924,6.811073729924964E-4
SIM,1835,31,na,1866,1726
STAT,1860,45,45-49,1905,0.18269974173171255
STAT,1849,31,15-19,1880,0.12494652968714011
STAT,1858,17,30-34,1875,1.3790387518159861
SIM,1883,70,na,1953,1274
STAT,1792,76,na,1868,363.9048085830257
STAT,1854,53,20-24,1907,5.194931401101034E-4
STAT,1922,25,20-24,1947,19.64544408065688
STAT,1858,83,na,1941,294.0409125430074
STAT,1911,28,50-100,1939,0.9138014734416204
STAT,1859,21,30-34,1880,15.380292262275336
SIM,1840,54,na,1894,1375
STAT,1908,48,45-49,1956,0.18517249690565052
STAT,1893,38,50-100,1931,1.4635742713438147
SIM,1930,22,na,1952,4424
STAT,1860,50,40-44,1910,0.00818550795698983
STAT,1810,54,45-49,1864,0.04447212886812808
SIM,1816,40,na,1856,1473
STAT,1923,17,35-39,1940,4.654716468658703
SIM,1901,29,45-49,1930,1
STAT,1940,24,25-29,1964,88.83145222858947
SIM,1906,26,40-44,1932,7
SIM,1931,17,35-39,1948,5
STAT,1892,43,na,1935,2715.019765473239
STAT,1904,29,20-24,1933,15.783160900107966
SIM,1898,24,na,1922,2956
STAT,1939,2,na,1941,3859.05653226858
STAT,1813,52,20-24,1865,0.001929236736565285
STAT,1896,57,na,1953,2507.387338637015
SIM,1936,15,na,1951,2759
SIM,1867,21,30-34,1888,22
STAT,1922,18,30-34,1940,13.291189882666052
STAT,1926,17,na,1943,4263.089256393362
STAT,1867,12,na,1879,2378.9998414689558
SIM,1783,92,na,1875,2
SIM,1872,63,na,1935,1627
STAT,1852,16,50-100,1868,0.043212728628275396
SIM,1847,32,na,1879,1886
STAT,1932,18,40-44,1950,1.7450750142841578
SIM,1948,23,40-44,1971,5
STAT,1910,17,50-100,1927,0.07013322551116674
SIM,1854,22,35-39,1876,6
STAT,1927,39,50-100,1966,0.4920767753467888
SIM,1839,34,50-100,1873,3
SIM,1907,25,45-49,1932,3
STAT,1931,31,20-24,1962,3.0210407772995125
SIM,1913,34,30-34,1947,18
STAT,1848,35,15-19,1883,0.043901892789417016
STAT,1947,18,50-100,1965,0.39857979412443373
SIM,1870,20,na,1890,2176
SIM,1930,18,30-34,1948,15
STAT,1837,46,na,1883,1535.212379798917
STAT,1833,32,na,1865,1711.6829483830045
STAT,1868,21,25-29,1889,51.97103264688378
STAT,1858,21,15-19,1879,2.8238768828876113
SIM,1940,18,40-44,1958,1
STAT,1915,22,25-29,1937,90.20237268953353
STAT,1915,48,35-39,1963,0.12239361378130449
STAT,1845,96,na,1941,6.076166509004134
STAT,1841,82,na,1923,321.66749108208614
STAT,1896,4,na,1900,3282.2707964889
SIM,1883,27,na,1910,2215
SIM,1915,42,40-44,1957,2
SIM,1923,22,25-29,1945,103
STAT,1881,47,na,1928,2043.6471017391502
SIM,1906,49,na,1955,3016
STAT,1941,30,25-29,1971,9.177698328621803
STAT,1834,20,15-19,1854,4.487652366085241
STAT,1846,22,35-39,1868,5.340398153918205
STAT,1799,102,na,1901,0.09359672056711772
STAT,1902,35,45-49,1937,0.5791063809456081
SIM,1879,10,na,1889,2601
SIM,1875,51,na,1926,2090
SIM,1913,42,na,1955,3291
STAT,1830,99,na,1929,1.1430355172802384
SIM,1879,22,40-44,1901,4
SIM,1842,20,15-19,1862,2
STAT,1933,10,na,1943,5025.883949165613
SIM,1905,31,20-24,1936,1
STAT,1779,98,na,1877,0.47661204165217974
STAT,1923,25,35-39,1948,16.394182566748466
STAT,1919,49,30-34,1968,0.09080785726832422
STAT,1854,32,35-39,1886,7.420099850524437
STAT,1938,33,30-34,1971,14.95667074121829
STAT,1901,33,35-39,1934,13.334931204538943
STAT,1805,68,na,1873,766.234893333237
STAT,1878,15,35-39,1893,0.5427253746040361
STAT,1883,38,na,1921,2171.314145500573
STAT,1880,43,20-24,1923,0.15702486866885126
STAT,1854,44,50-100,1898,0.7456726031372163
STAT,1876,20,20-24,1896,67.66022980314241
SIM,1931,25,35-39,1956,22
STAT,1911,40,40-44,1951,0.2280911835835126
SIM,1876,77,na,1953,770
STAT,1819,42,50-100,1861,2.225282547695272
SIM,1895,31,35-39,1926,19
SIM,1939,25,40-44,1964,4
STAT,1917,43,40-44,1960,0.24620341112357705
SIM,1856,17,15-19,1873,7
STAT,1881,16,na,1897,2310.5454081778976
STAT,1826,39,50-100,1865,1.2559883996066372
SIM,1928,37,30-34,1965,2
STAT,1838,63,na,1901,1197.8929311034747
STAT,1863,3,na,1866,2672.720771913778
SIM,1929,39,40-44,1968,2
STAT,1884,15,30-34,1899,1.494502937912823
SIM,1919,39,30-34,1958,4
STAT,1874,25,15-19,1899,0.4408953312262361
STAT,1932,4,na,1936,5048.889962403623
STAT,1923,21,20-24,1944,122.59188858541728
SIM,1912,57,na,1969,3156
SIM,1865,1,na,1866,3005
STAT,1887,31,35-39,1918,10.744843159605233
STAT,1914,19,35-39,1933,0.8156211730540553
STAT,1898,68,na,1966,2210.385362790455
SIM,1818,83,na,1901,199
STAT,1924,19,45-49,1943,0.5589435362868955
STAT,1801,53,40-44,1854,0.02882500959786752
SIM,1866,79,na,1945,550
SIM,1899,10,na,1909,3429
SIM,1901,42,40-44,1943,1
STAT,1848,17,15-19,1865,5.466495485618663
STAT,1905,41,20-24,1946,0.015127224368267335
STAT,1930,19,20-24,1949,164.69266382253073
SIM,1857,9,na,1866,2269
SIM,1934,2,na,1936,5070
STAT,1848,52,50-100,1900,0.011162477583905265
SIM,1904,38,25-29,1942,1
STAT,1961,0,na,1961,4833.1867867574665
SIM,1931,21,20-24,1952,135
STAT,1885,47,15-19,1932,3.7490111635826343E-4
SIM,1854,30,50-100,1884,5
STAT,1862,13,na,1875,2198.360846942808
SIM,1933,37,40-44,1970,3
STAT,1902,17,15-19,1919,7.91212965379138
STAT,1910,34,40-44,1944,3.534188430055376
STAT,1875,95,na,1970,63.23062405380127
STAT,1902,27,45-49,1929,1.4802910264198523
SIM,1788,91,na,1879,11
STAT,1907,24,40-44,1931,2.8736562780725703
STAT,1781,92,na,1873,10.701986625880423
STAT,1931,16,30-34,1947,15.108348678707511
STAT,1860,65,na,1925,1295.3726187070365
SIM,1858,23,30-34,1881,26
SIM,1918,40,45-49,1958,1
STAT,1916,19,na,1935,3850.3753378667907
STAT,1846,30,50-100,1876,0.8199500818687371
STAT,1911,1,na,1912,3935.046134369476
STAT,1921,26,15-19,1947,0.7458216552619636
SIM,1829,34,45-49,1863,1
STAT,1907,42,40-44,1949,0.2164883315365607
STAT,1838,31,40-44,1869,3.655635257986348
STAT,1953,15,20-24,1968,155.01114335436034
STAT,1867,18,35-39,1885,0.4946714413190012
STAT,1846,50,na,1896,1619.962418119485
SIM,1910,17,15-19,1927,10
STAT,1899,25,20-24,1924,15.28824359849099
STAT,1836,34,50-100,1870,0.7345687734410091
SIM,1896,25,45-49,1921,1
SIM,1879,30,40-44,1909,8
STAT,1769,88,na,1857,33.394055962490995
SIM,1896,45,na,1941,2824
SIM,1857,42,na,1899,1845
STAT,1835,98,na,1933,2.0676184382044123
SIM,1838,21,40-44,1859,4
SIM,1817,66,na,1883,869
STAT,1888,25,45-49,1913,1.2480057656653503
SIM,1813,52,na,1865,1228
SIM,1846,31,40-44,1877,3
SIM,1909,47,50-100,1956,1
STAT,1905,34,30-34,1939,13.572382195253917
STAT,1864,79,na,1943,588.6268945560022
SIM,1922,19,35-39,1941,4
SIM,1859,97,na,1956,2
SIM,1905,24,30-34,1929,27
SIM,1915,24,40-44,1939,2
SIM,1924,17,45-49,1941,1
SIM,1824,79,na,1903,331
STAT,1828,42,35-39,1870,1.535237264022287
SIM,1930,28,25-29,1958,85
SIM,1897,21,45-49,1918,3
STAT,1893,49,15-19,1942,2.646707549164154E-4
SIM,1854,30,35-39,1884,11
STAT,1951,20,40-44,1971,3.797613810618296
SIM,1913,26,30-34,1939,41
STAT,1915,15,35-39,1930,0.8335308373273478
STAT,1818,86,na,1904,108.9631086529518
STAT,1931,23,20-24,1954,135.8177033128366
SIM,1836,42,35-39,1878,4
SIM,1838,19,20-24,1857,14
SIM,1906,29,45-49,1935,1
STAT,1881,27,na,1908,2177.9566218618183
STAT,1836,35,50-100,1871,0.9963603790600541
SIM,1893,25,na,1918,2986
STAT,1901,40,25-29,1941,0.05956179159637967
SIM,1931,16,na,1947,4557
SIM,1909,27,20-24,1936,16
STAT,1821,47,30-34,1868,0.15269658287125645
STAT,1938,18,na,1956,3429.0046798189937
STAT,1916,17,45-49,1933,0.10012339656361971
SIM,1847,96,na,1943,4
STAT,1809,82,na,1891,187.23585491621057
STAT,1909,18,15-19,1927,8.385927293221723
SIM,1858,15,30-34,1873,1
SIM,1818,51,na,1869,1254
STAT,1857,97,na,1954,4.00264816555743
STAT,1931,24,30-34,1955,34.99409350347104
SIM,1887,32,40-44,1919,8
SIM,1800,89,na,1889,27
STAT,1853,83,na,1936,300.4382210030622
STAT,1889,36,15-19,1925,0.06580574026819569
STAT,1935,16,15-19,1951,58.75409691088786
STAT,1937,29,30-34,1966,36.04689172992129
STAT,1957,15,40-44,1972,1.7427726588342678
SIM,1871,2,na,1873,2971
SIM,1902,25,45-49,1927,1
SIM,1760,95,na,1855,1
SIM,1860,43,45-49,1903,1
SIM,1943,16,15-19,1959,49
SIM,1923,15,35-39,1938,8
STAT,1928,43,15-19,1971,0.0018464748120288633
STAT,1860,53,45-49,1913,0.010945299537348876
STAT,1863,50,na,1913,1810.664640721864
SIM,1914,28,40-44,1942,9
STAT,1855,11,na,1866,2026.942012602481
STAT,1779,104,na,1883,0.027547291405806616
STAT,1889,21,45-49,1910,0.8157099625641344
STAT,1905,26,30-34,1931,34.50374574732933
STAT,1844,46,15-19,1890,2.7859799269430214E-4
STAT,1858,25,30-34,1883,19.370897202670072
STAT,1844,102,na,1946,0.2036169741231789
STAT,1909,44,45-49,1953,0.1452581291299461
STAT,1869,23,na,1892,2157.7793276558673
STAT,1860,103,na,1963,0.424700778522071
SIM,1841,16,na,1857,1965
SIM,1878,0,na,1878,3457
STAT,1857,66,na,1923,1221.1625246443496
STAT,1920,15,45-49,1935,0.10671752617950998
SIM,1900,31,40-44,1931,13
STAT,1906,28,40-44,1934,4.10709971649218
SIM,1862,32,35-39,1894,9
STAT,1778,93,na,1871,6.094431467397721
STAT,1911,31,na,1942,3493.4927557159062
STAT,1940,16,25-29,1956,41.57799211382441
SIM,1889,43,na,1932,2773
SIM,1870,52,na,1922,1958
STAT,1887,23,35-39,1910,6.147206422058041
STAT,1881,47,30-34,1928,0.08792846226407648
SIM,1922,18,25-29,1940,58
SIM,1935,25,20-24,1960,23
SIM,1824,40,50-100,1864,1
SIM,1948,21,50-100,1969,3
STAT,1915,40,25-29,1955,0.06810678277170129
SIM,1855,24,45-49,1879,3
SIM,1892,5,na,1897,3430
SIM,1905,55,na,1960,2854
STAT,1913,36,30-34,1949,1.707389336033821
STAT,1915,31,50-100,1946,0.7987532368951675
STAT,1917,28,15-19,1945,0.6969456935951774
STAT,1875,31,na,1906,2326.6123563764445
STAT,1843,30,na,1873,1796.7747772501166
STAT,1879,32,40-44,1911,4.288462700984506
STAT,1903,46,15-19,1949,3.041463517471708E-4
STAT,1781,110,na,1891,0.00122218808202668
STAT,1925,30,40-44,1955,4.394896441120416
STAT,1933,22,40-44,1955,4.213328449863569
STAT,1919,15,20-24,1934,28.528181030550584
STAT,1936,23,50-100,1959,0.5940714490886471
SIM,1877,62,na,1939,1733
STAT,1791,109,na,1900,1.3173155076983052E-4
STAT,1847,24,45-49,1871,0.6213516618517305
SIM,1828,32,35-39,1860,5
SIM,1866,25,30-34,1891,31
SIM,1905,35,35-39,1940,4
STAT,1910,26,40-44,1936,4.26673051287698
STAT,1850,51,50-100,1901,0.010697219702048648
STAT,1919,48,20-24,1967,0.011292065286992857
SIM,1921,36,30-34,1957,6
SIM,1923,40,na,1963,4182
STAT,1839,57,na,1896,1338.0087840483527
STAT,1833,52,50-100,1885,0.00954995435270407
STAT,1897,20,40-44,1917,2.6483552447639784
SIM,1899,16,30-34,1915,3
STAT,1923,32,25-29,1955,10.009647219328347
SIM,1876,21,25-29,1897,60
STAT,1949,16,45-49,1965,0.5490234309387819
SIM,1925,28,15-19,1953,4
SIM,1931,32,25-29,1963,14
STAT,1935,34,45-49,1969,2.053963574569648
SIM,1898,2,na,1900,3324
SIM,1912,29,20-24,1941,15
STAT,1914,18,25-29,1932,8.44645846716351
STAT,1927,25,20-24,1952,21.1060348389253
STAT,1903,44,na,1947,3075.3082526337826
STAT,1887,32,na,1919,2521.5774205637485
STAT,1821,54,20-24,1875,0.0010754092030356337
STAT,1817,69,na,1886,758.3045982485755
SIM,1897,18,15-19,1915,6
STAT,1912,39,20-24,1951,0.24061966310610142
STAT,1922,28,25-29,1950,70.11278261550031
STAT,1889,18,15-19,1907,6.903065162836187
STAT,1905,33,20-24,1938,2.1104351847031775
SIM,1927,15,20-24,1942,170
SIM,1933,30,40-44,1963,7
STAT,1898,47,50-100,1945,0.17628508662220937
STAT,1872,20,35-39,1892,5.562560749706805
SIM,1895,23,35-39,1918,8
STAT,1929,37,25-29,1966,1.194118834263212
SIM,1858,22,20-24,1880,60
STAT,1895,33,35-39,1928,12.419847452160539
STAT,1939,27,40-44,1966,4.426636134356907
STAT,1889,22,50-100,1911,0.47558754769833217
SIM,1913,33,20-24,1946,2
SIM,1935,10,na,1945,5064
SIM,1883,21,15-19,1904,2
STAT,1878,41,35-39,1919,1.7908501421448748
STAT,1908,38,15-19,1946,0.01690128281695602
SIM,1765,94,na,1859,3
SIM,1784,77,na,1861,271
STAT,1858,32,20-24,1890,2.002105533911048
STAT,1864,29,50-100,1893,0.5347534446879305
STAT,1911,48,15-19,1959,3.28545811815019E-4
STAT,1851,20,15-19,1871,2.875118216856391
STAT,1838,34,45-49,1872,1.4248699986800122
SIM,1877,43,35-39,1920,1
STAT,1882,64,na,1946,1597.0565813852033
STAT,1893,28,na,1921,2849.0567379286454
SIM,1883,79,na,1962,796
SIM,1902,18,20-24,1920,22
STAT,1842,36,na,1878,1838.4993586653356
STAT,1922,22,15-19,1944,5.766860907346442
STAT,1915,45,30-34,1960,0.0852617692430797
STAT,1901,44,40-44,1945,0.20375436279657577
STAT,1823,49,35-39,1872,0.1675693432447622
STAT,1905,18,30-34,1923,2.17071757208779
STAT,1924,42,40-44,1966,0.28105388545590615
STAT,1933,19,na,1952,4629.751293759096
SIM,1924,25,45-49,1949,2
STAT,1953,7,na,1960,4491.723885267549
STAT,1931,15,20-24,1946,168.41656705824315
SIM,1837,22,35-39,1859,8
SIM,1868,45,50-100,1913,2
STAT,1819,48,na,1867,1404.9065446147074
SIM,1917,36,45-49,1953,3
STAT,1876,21,30-34,1897,17.437360269431093
SIM,1871,49,50-100,1920,6
SIM,1904,39,35-39,1943,6
STAT,1872,49,30-34,1921,0.08981032054779711
STAT,1785,74,na,1859,444.4378617733068
SIM,1903,47,50-100,1950,4
STAT,1927,43,20-24,1970,0.020890299533575126
SIM,1858,26,35-39,1884,6
STAT,1789,88,na,1877,41.55352993669346
STAT,1922,36,25-29,1958,1.0593586517197195
SIM,1941,22,40-44,1963,3
SIM,1913,18,30-34,1931,4
STAT,1876,23,25-29,1899,55.699347210135585
SIM,1857,11,na,1868,2244
SIM,1850,52,na,1902,1597
SIM,1842,16,30-34,1858,1
SIM,1900,32,30-34,1932,26
SIM,1930,17,20-24,1947,178
STAT,1905,37,35-39,1942,2.084601923015497
SIM,1889,20,na,1909,2881
SIM,1906,40,na,1946,3222
SIM,1921,24,15-19,1945,9
STAT,1835,48,15-19,1883,2.649343787273535E-4
STAT,1773,108,na,1881,0.004216133430934547
STAT,1872,43,na,1915,2174.257596648877
STAT,1876,57,na,1933,1961.4094994614884
SIM,1829,78,na,1907,446
STAT,1931,34,25-29,1965,11.426128784493791
SIM,1859,13,na,1872,2232
STAT,1837,102,na,1939,0.1902658555351453
STAT,1922,17,20-24,1939,148.22560214519672
STAT,1793,70,na,1863,591.9569373711297
STAT,1910,30,25-29,1940,8.486923636242771
STAT,1860,42,40-44,1902,1.7219690549016382
STAT,1925,17,50-100,1942,0.42754063924201935
SIM,1906,20,30-34,1926,31
SIM,1923,31,50-100,1954,4
SIM,1930,22,15-19,1952,5
STAT,1911,17,45-49,1928,0.09443779563831224
STAT,1933,36,35-39,1969,3.115128378454877
STAT,1814,49,40-44,1863,0.5064524567734883
SIM,1906,34,40-44,1940,3
SIM,1816,49,na,1865,1348
STAT,1872,21,50-100,1893,0.38757953150685803
SIM,1803,86,na,1889,64
SIM,1812,46,na,1858,1310
SIM,1838,51,na,1889,1445
SIM,1876,22,35-39,1898,5
SIM,1852,66,na,1918,1210
SIM,1947,24,35-39,1971,14
STAT,1825,44,na,1869,1415.7994694462966
SIM,1932,24,40-44,1956,4
STAT,1907,46,35-39,1953,0.10990230663286694
STAT,1923,16,25-29,1939,48.18909427380481
STAT,1910,25,na,1935,3439.5516372404727
SIM,1915,20,25-29,1935,105
STAT,1877,15,40-44,1892,0.18006578739314688
STAT,1905,0,na,1905,4009.5510302060707
STAT,1934,28,15-19,1962,0.8967240252972084
STAT,1833,63,na,1896,1094.7172444198438
SIM,1884,46,50-100,1930,2
SIM,1899,27,35-39,1926,18
STAT,1829,58,na,1887,1219.3447217392488
STAT,1843,53,45-49,1896,0.009644974717710416
STAT,1857,29,30-34,1886,19.048691294158118
STAT,1924,43,30-34,1967,0.14342758257201974
STAT,1849,34,20-24,1883,2.0919865791796752
STAT,1880,22,35-39,1902,5.8117580351829625
SIM,1858,33,25-29,1891,10
STAT,1953,8,na,1961,4491.139961162465
SIM,1905,19,35-39,1924,4
STAT,1861,38,15-19,1899,0.04388990721963564
STAT,1941,18,50-100,1959,0.36444209620130713
STAT,1927,32,45-49,1959,1.8285951034940011
STAT,1932,30,50-100,1962,1.0394813188773135
STAT,1868,22,35-39,1890,5.259763944712314
STAT,1844,15,na,1859,2050.636589374642
STAT,1850,32,na,1882,1759.7147180644697
SIM,1827,99,na,1926,1
STAT,1886,40,30-34,1926,1.1588422018607054
STAT,1914,39,na,1953,3512.958336270492
SIM,1845,40,35-39,1885,1
STAT,1867,25,25-29,1892,37.77924177449406
SIM,1865,29,30-34,1894,23
STAT,1910,46,na,1956,3246.2329261013597
SIM,1898,28,30-34,1926,44
SIM,1846,34,45-49,1880,2
STAT,1840,46,30-34,1886,0.06488664721356421
STAT,1884,76,na,1960,1036.949387050176
STAT,1939,24,35-39,1963,8.92724877690365
STAT,1806,85,na,1891,95.06528551973454
SIM,1853,45,50-100,1898,2
SIM,1931,16,25-29,1947,63
STAT,1905,44,25-29,1949,0.0600691690488057
SIM,1900,0,na,1900,3628
STAT,1880,62,na,1942,1820.3011593177962
STAT,1869,43,35-39,1912,1.6452661519761296
SIM,1867,32,na,1899,2292
SIM,1916,37,40-44,1953,3
SIM,1894,40,30-34,1934,4
STAT,1837,40,35-39,1877,1.4227706293884437
SIM,1875,39,na,1914,2271
STAT,1815,104,na,1919,0.029772182085049226
STAT,1870,46,15-19,1916,3.717567002905559E-4
STAT,1909,41,40-44,1950,0.22229438657930103
SIM,1913,37,35-39,1950,6
STAT,1802,71,na,1873,613.7937431470186
STAT,1909,36,45-49,1945,0.6125415828096852
SIM,1888,39,50-100,1927,4
STAT,1904,45,20-24,1949,0.009263820891271151
STAT,1779,105,na,1884,0.017263061105276832
STAT,1942,15,45-49,1957,0.49343395171099075
STAT,1826,82,na,1908,254.79268376568157
STAT,1922,29,35-39,1951,15.934469822245086
SIM,1929,33,30-34,1962,20
STAT,1907,20,25-29,1927,79.91531165950117
SIM,1860,85,na,1945,186
STAT,1778,92,na,1870,9.955293324508677
STAT,1840,105,na,1945,0.019241914864867572
SIM,1930,29,35-39,1959,24
STAT,1910,23,35-39,1933,8.327837874591467
SIM,1864,99,na,1963,15
SIM,1832,67,na,1899,914
STAT,1943,28,45-49,1971,1.7373270017496218
SIM,1857,27,30-34,1884,28
SIM,1861,47,na,1908,1941
STAT,1823,33,na,1856,1532.825765340734
SIM,1948,15,40-44,1963,2
STAT,1868,0,na,1868,3393.2990902270176
STAT,1873,48,35-39,1921,0.13245060231319652
STAT,1911,15,15-19,1926,8.61953789338276
STAT,1855,95,na,1950,9.448164250405748
STAT,1908,37,40-44,1945,1.3240991933169335
STAT,1925,41,25-29,1966,0.08178877561421018
SIM,1887,35,45-49,1922,3
STAT,1926,28,45-49,1954,1.9495245827746477
STAT,1840,39,40-44,1879,3.327948110968239
STAT,1875,24,20-24,1899,66.49614290178174
SIM,1917,41,40-44,1958,1
STAT,1831,52,na,1883,1303.4664898459155
STAT,1925,37,40-44,1962,1.6973008560290124
STAT,1848,43,15-19,1891,0.010187377890980566
STAT,1879,13,na,1892,2549.8156995735594
SIM,1820,34,na,1854,1621
STAT,1838,16,15-19,1854,5.293943094798505
STAT,1932,26,40-44,1958,5.7698987216671265
SIM,1868,20,35-39,1888,9
STAT,1921,38,30-34,1959,1.9205510821525833
SIM,1906,61,na,1967,2774
SIM,1927,30,45-49,1957,3
STAT,1878,27,na,1905,2349.5812916627406
SIM,1940,26,40-44,1966,4
SIM,1824,48,na,1872,1389
SIM,1924,44,35-39,1968,3
SIM,1935,32,45-49,1967,1
STAT,1866,27,30-34,1893,21.941526098432348
SIM,1848,19,30-34,1867,1
SIM,1914,16,25-29,1930,8
SIM,1840,41,50-100,1881,1
SIM,1880,20,35-39,1900,10
SIM,1926,9,na,1935,4537
STAT,1920,27,50-100,1947,1.0314781983245793
STAT,1891,17,50-100,1908,0.05726078858399701
SIM,1943,8,na,1951,3848
STAT,1916,44,35-39,1960,0.19429434007492394
STAT,1936,30,45-49,1966,1.4454954103133324
SIM,1846,16,15-19,1862,9
STAT,1858,28,35-39,1886,7.263599388617655
STAT,1811,52,na,1863,1210.2489270860915
STAT,1937,34,50-100,1971,0.7717571125714255
STAT,1838,62,na,1900,1227.0475816433202
STAT,1866,31,15-19,1897,0.12458992322060153
SIM,1883,58,na,1941,1784
STAT,1941,24,40-44,1965,3.280321307919417
STAT,1924,24,40-44,1948,3.7245560511689573
STAT,1879,35,45-49,1914,1.9900272960472103
STAT,1932,19,50-100,1951,0.46614525932230255
STAT,1943,25,50-100,1968,1.0022997492327799
STAT,1829,47,na,1876,1483.8780266988754
SIM,1895,60,na,1955,2415
STAT,1912,57,na,1969,3189.0805183222406
STAT,1935,26,45-49,1961,2.225708085658042
STAT,1912,32,20-24,1944,2.2674583136567312
STAT,1904,38,30-34,1942,1.5510474794952311
SIM,1858,31,30-34,1889,16
STAT,1924,38,na,1962,4186.623804896524
SIM,1913,25,20-24,1938,18
SIM,1873,28,na,1901,2285
SIM,1920,32,20-24,1952,1
STAT,1847,76,na,1923,698.6223157519704
SIM,1942,23,na,1965,3553
STAT,1919,30,45-49,1949,1.6167042406386778
SIM,1934,28,45-49,1962,2
SIM,1890,38,35-39,1928,14
SIM,1904,27,20-24,1931,15
SIM,1863,0,na,1863,3085
STAT,1862,44,15-19,1906,0.011003891122839159
STAT,1900,33,50-100,1933,1.195676752887427
SIM,1821,82,na,1903,262
STAT,1868,47,15-19,1915,3.5885570248715443E-4
SIM,1834,21,20-24,1855,49
STAT,1849,27,30-34,1876,22.38414441789596
STAT,1905,25,20-24,1930,16.12791070137773
STAT,1906,36,40-44,1942,1.306273604524744
STAT,1909,29,20-24,1938,16.363201302529824
SIM,1889,36,50-100,1925,2
SIM,1933,34,35-39,1967,15
STAT,1930,28,30-34,1958,47.043378062873764
SIM,1943,26,45-49,1969,1
SIM,1899,3,na,1902,3492
SIM,1845,84,na,1929,198
STAT,1848,51,50-100,1899,0.011275913271415706
SIM,1945,20,na,1965,3598
STAT,1846,81,na,1927,401.08709228425175
SIM,1849,21,15-19,1870,3
STAT,1945,20,45-49,1965,1.1657745459598217
SIM,1905,26,25-29,1931,61
STAT,1930,35,20-24,1965,0.32538302499465327
SIM,1838,32,45-49,1870,2
STAT,1877,20,35-39,1897,5.752508288259502
STAT,1878,28,na,1906,2341.3107655160857
SIM,1825,85,na,1910,138
SIM,1849,28,35-39,1877,10
SIM,1837,66,na,1903,1031
SIM,1942,27,40-44,1969,4
STAT,1917,38,45-49,1955,0.6656076859359362
STAT,1853,29,na,1882,1876.749416630082
STAT,1916,25,45-49,1941,1.6989469757818247
STAT,1947,23,na,1970,3897.7858670880346
STAT,1934,27,40-44,1961,5.923449563033014
SIM,1849,35,25-29,1884,1
SIM,1886,41,35-39,1927,5
SIM,1832,66,na,1898,940
SIM,1917,29,20-24,1946,16
STAT,1889,44,15-19,1933,0.015888383133801014
STAT,1829,26,50-100,1855,1.139526216691466
SIM,1914,36,40-44,1950,3
SIM,1914,22,30-34,1936,35
STAT,1875,17,30-34,1892,1.5476706167534908
SIM,1839,39,30-34,1878,2
STAT,1925,34,35-39,1959,10.238113553368763
STAT,1931,33,50-100,1964,1.0228022461866788
SIM,1925,20,na,1945,4110
SIM,1929,34,na,1963,4489
STAT,1799,87,na,1886,57.01157443038329
SIM,1922,15,20-24,1937,153
SIM,1908,38,45-49,1946,1
SIM,1851,26,na,1877,1870
SIM,1887,17,15-19,1904,6
STAT,1832,47,35-39,1879,0.10003856692262145
STAT,1857,41,15-19,1898,0.010335721380515502
STAT,1931,27,35-39,1958,18.31084696335732
STAT,1935,31,40-44,1966,5.1175719139593205
SIM,1860,62,na,1922,1504
STAT,1831,48,30-34,1879,0.06807974798043902
STAT,1921,24,50-100,1945,0.6976956006233717
STAT,1862,44,na,1906,1841.6324763130733
SIM,1786,89,na,1875,48
SIM,1860,40,40-44,1900,2
STAT,1916,43,45-49,1959,0.16086606546002433
STAT,1876,16,35-39,1892,0.5368580591716198
STAT,1876,39,20-24,1915,0.7447801228969435
STAT,1906,22,30-34,1928,24.507988176672182
STAT,1914,15,20-24,1929,26.617513171192947
SIM,1845,85,na,1930,151
SIM,1841,71,na,1912,874
SIM,1859,25,40-44,1884,4
STAT,1897,23,45-49,1920,0.8782615489045319
STAT,1809,47,50-100,1856,0.6931833821549479
STAT,1811,50,50-100,1861,0.050047643230141
STAT,1870,32,na,1902,2211.5406976924664
STAT,1943,20,na,1963,3672.908517268969
SIM,1868,58,na,1926,1774
STAT,1929,35,30-34,1964,2.214219141570554
SIM,1864,44,na,1908,2003
SIM,1894,10,na,1904,3276
STAT,1853,36,15-19,1889,0.04294113690101521
STAT,1901,47,45-49,1948,0.1752142932353684
SIM,1821,71,na,1892,737
STAT,1810,51,40-44,1861,0.03426007785098823
STAT,1863,22,50-100,1885,0.3448025772263538
STAT,1899,29,35-39,1928,12.400333393081581
STAT,1935,19,20-24,1954,174.14958328315316
SIM,1900,35,35-39,1935,8
STAT,1837,77,na,1914,560.9766091323446
STAT,1858,35,25-29,1893,2.1528212651963146
STAT,1803,97,na,1900,1.8058405350060978
SIM,1881,8,na,1889,2020
STAT,1867,43,na,1910,2035.4395229295712
STAT,1822,37,na,1859,1454.1214934397701
STAT,1883,16,50-100,1899,0.045488379492400796
STAT,1901,32,na,1933,3155.518944807862
SIM,1921,17,na,1938,3984
STAT,1890,37,30-34,1927,6.155480157512381
STAT,1914,34,25-29,1948,8.71406789818808
SIM,1850,18,30-34,1868,1
STAT,1918,42,na,1960,3730.367275707005
STAT,1904,34,15-19,1938,0.10985497089216845
SIM,1834,78,na,1912,461
SIM,1843,20,30-34,1863,24
SIM,1938,25,25-29,1963,52
SIM,1930,33,20-24,1963,5
STAT,1918,35,20-24,1953,0.2649793097421046
STAT,1892,27,50-100,1919,0.7569162191017972
STAT,1811,85,na,1896,118.89009855443481
STAT,1933,33,30-34,1966,20.045362515675475
STAT,1946,19,30-34,1965,12.763025377055788
STAT,1864,24,na,1888,1994.375355804093
STAT,1844,70,na,1914,974.4682688870182
SIM,1867,23,25-29,1890,55
STAT,1840,49,35-39,1889,0.09030583941156785
STAT,1899,30,15-19,1929,0.18581456942902497
STAT,1916,40,40-44,1956,0.24281768656911643
STAT,1810,90,na,1900,33.35263184008118
STAT,1818,63,na,1881,973.2339699990016
STAT,1833,32,15-19,1865,0.11249612543133623
STAT,1872,98,na,1970,19.347471491881254
STAT,1896,56,na,1952,2544.8216653340796
STAT,1924,20,25-29,1944,103.57851768621691
SIM,1936,16,na,1952,2733
STAT,1926,26,15-19,1952,0.802190679109967
SIM,1834,37,na,1871,1631
SIM,1869,41,35-39,1910,4
STAT,1842,18,30-34,1860,1.4734810595382355
STAT,1856,22,45-49,1878,0.5969399845985004
STAT,1931,18,25-29,1949,53.443142103119094
STAT,1921,18,15-19,1939,48.74176499830221
SIM,1947,21,30-34,1968,26
STAT,1922,33,20-24,1955,2.5925472822192495
STAT,1932,24,na,1956,4510.873323785555
STAT,1859,23,25-29,1882,44.337338882986536
SIM,1891,46,na,1937,2671
STAT,1849,23,15-19,1872,2.969462939788994
STAT,1886,43,35-39,1929,1.7939763054852889
STAT,1823,46,30-34,1869,0.12095036882691765
SIM,1874,65,na,1939,1571
STAT,1953,19,na,1972,4203.373507668354
SIM,1893,30,50-100,1923,1
STAT,1933,25,45-49,1958,2.1689310113821687
STAT,1913,39,35-39,1952,2.23233928188673
SIM,1849,32,20-24,1881,2
SIM,1908,35,40-44,1943,3
STAT,1911,33,45-49,1944,1.4414906316061833
STAT,1912,21,45-49,1933,1.0217929747260357
STAT,1902,21,35-39,1923,7.803534112106618
STAT,1939,21,30-34,1960,27.277172394469524
STAT,1854,14,na,1868,2024.7041995884435
STAT,1882,38,35-39,1920,6.46577153087186
STAT,1819,52,35-39,1871,0.01565722533971991
STAT,1843,38,50-100,1881,0.8718749768935568
STAT,1942,30,40-44,1972,3.942547798840899
STAT,1835,20,30-34,1855,20.61387459392034
STAT,1846,102,na,1948,0.21744900556647995
STAT,1841,51,na,1892,1491.5218644955628
STAT,1888,38,na,1926,2617.280087343398
SIM,1851,38,50-100,1889,1
SIM,1941,25,45-49,1966,1
SIM,1910,21,35-39,1931,7
SIM,1915,21,na,1936,3412
STAT,1815,47,35-39,1862,0.3151882044391917
STAT,1824,70,na,1894,773.6366852710095
SIM,1791,67,na,1858,673
SIM,1870,51,na,1921,1970
SIM,1921,39,35-39,1960,7
SIM,1920,21,45-49,1941,1
STAT,1907,16,40-44,1923,0.25444302119014656
STAT,1907,43,30-34,1950,0.10998936396524096
SIM,1918,17,20-24,1935,131
SIM,1866,28,35-39,1894,8
STAT,1839,20,15-19,1859,2.8631897496517835
STAT,1869,40,30-34,1909,1.0627809544492022
STAT,1820,37,15-19,1857,0.12917476701190767
SIM,1932,20,25-29,1952,112
SIM,1888,20,40-44,1908,3
SIM,1926,26,45-49,1952,7
SIM,1834,24,25-29,1858,53
SIM,1942,7,na,1949,3843
STAT,1929,15,50-100,1944,0.4537768483140891
STAT,1873,83,na,1956,410.0423995150085
STAT,1924,46,35-39,1970,0.14536094921394238
SIM,1845,45,50-100,1890,3
SIM,1915,54,na,1969,3243
SIM,1921,27,20-24,1948,20
SIM,1904,58,na,1962,2883
STAT,1913,27,20-24,1940,17.183076739365454
STAT,1920,7,na,1927,4236.692081480766
SIM,1879,15,15-19,1894,6
SIM,1891,15,15-19,1906,7
SIM,1922,34,25-29,1956,13
STAT,1827,46,15-19,1873,3.707580808213755E-4
STAT,1901,32,45-49,1933,2.3059290451482095
SIM,1899,32,30-34,1931,23
STAT,1910,20,30-34,1930,25.650914756314915
STAT,1850,55,na,1905,1457.5796448079102
STAT,1920,20,40-44,1940,3.5523081303052297
SIM,1831,44,50-100,1875,2
STAT,1773,93,na,1866,5.50109507221826
SIM,1886,5,na,1891,2582
STAT,1802,52,45-49,1854,0.04248887372360007
STAT,1837,45,50-100,1882,0.1697568924718667
SIM,1812,67,na,1879,770
SIM,1881,47,na,1928,1755
SIM,1883,24,20-24,1907,62
SIM,1835,21,35-39,1856,5
SIM,1844,99,na,1943,1
STAT,1900,34,30-34,1934,22.68513937127078
STAT,1830,31,35-39,1861,8.830819439884763
STAT,1863,4,na,1867,2521.4447762234586
SIM,1847,20,15-19,1867,3
STAT,1902,58,na,1960,2737.7782350552357
SIM,1840,85,na,1925,165
SIM,1826,70,na,1896,743
SIM,1906,23,35-39,1929,10
SIM,1860,49,50-100,1909,2
SIM,1943,19,20-24,1962,120
STAT,1873,28,na,1901,2278.5137515126876
SIM,1831,39,40-44,1870,8
STAT,1894,37,15-19,1931,0.06817441564903362
SIM,1796,66,na,1862,794
STAT,1867,76,na,1943,840.4209912500578
SIM,1842,33,na,1875,1742
STAT,1854,25,na,1879,1808.9447576079642
STAT,1851,52,40-44,1903,0.007532675631176811
SIM,1880,33,50-100,1913,1
SIM,1928,39,25-29,1967,1
SIM,1938,29,40-44,1967,6
STAT,1922,34,50-100,1956,0.878197116144822
SIM,1900,55,na,1955,2732
STAT,1893,15,25-29,1908,6.820439607505168
STAT,1947,7,na,1954,4191.759690467421
SIM,1928,29,30-34,1957,50
STAT,1817,104,na,1921,0.03087157625988764
SIM,1891,19,30-34,1910,1
STAT,1820,89,na,1909,55.343002413043806
STAT,1869,24,na,1893,2150.9175893939228
STAT,1861,102,na,1963,0.8446331502749304
STAT,1883,19,30-34,1902,1.4683462890256618
SIM,1817,45,na,1862,1413
STAT,1865,10,na,1875,2343.7480594520766
SIM,1883,17,30-34,1900,3
SIM,1934,25,40-44,1959,6
STAT,1936,29,15-19,1965,0.6375951215695956
STAT,1876,49,15-19,1925,3.822503035977297E-4
STAT,1823,39,40-44,1862,6.351476061373065
SIM,1803,53,na,1856,1120
SIM,1820,39,30-34,1859,3
SIM,1854,14,na,1868,2258
STAT,1901,29,15-19,1930,0.5956618971098641
SIM,1773,93,na,1866,5
STAT,1856,48,35-39,1904,0.10189429483451762
STAT,1867,47,50-100,1914,0.2168506657394857
STAT,1939,31,25-29,1970,8.914097679875498
STAT,1922,40,45-49,1962,0.1809637905218267
STAT,1801,86,na,1887,70.06107086320173
SIM,1842,23,20-24,1865,54
SIM,1846,70,na,1916,977
SIM,1882,36,35-39,1918,9
STAT,1922,26,30-34,1948,42.029089830864194
STAT,1956,15,25-29,1971,54.19204759108167
SIM,1938,18,35-39,1956,3
SIM,1930,26,30-34,1956,57
STAT,1905,28,25-29,1933,57.5590295849443
STAT,1858,36,50-100,1894,0.9137431491191026
SIM,1913,28,25-29,1941,61
SIM,1925,32,35-39,1957,16
STAT,1879,17,15-19,1896,5.868518186066825
STAT,1845,42,35-39,1887,1.304857128558068
STAT,1926,44,45-49,1970,0.19317600743395894
STAT,1830,34,50-100,1864,0.7604608086448903
STAT,1850,11,na,1861,2065.757069728809
SIM,1875,47,50-100,1922,4
STAT,1892,21,15-19,1913,3.9153564374967695
STAT,1887,19,15-19,1906,6.237316824043819
STAT,1863,30,35-39,1893,8.462997168033535
SIM,1839,77,na,1916,567
STAT,1884,51,40-44,1935,0.009872685481563422
STAT,1944,25,20-24,1969,18.653961550940146
SIM,1875,15,30-34,1890,1
SIM,1878,23,35-39,1901,6
SIM,1931,31,50-100,1962,1
STAT,1801,75,na,1876,400.53354090509754
STAT,1814,105,na,1919,0.013476543485121152
STAT,1914,24,30-34,1938,27.566605336247374
STAT,1880,47,15-19,1927,3.965163711382148E-4
STAT,1926,25,40-44,1951,5.3141474834086475
STAT,1821,35,50-100,1856,2.8800004839067244
STAT,1861,28,20-24,1889,9.215208715171501
STAT,1946,26,20-24,1972,19.218008981360068
STAT,1919,45,15-19,1964,3.7922765860814967E-4
STAT,1908,5,na,1913,3672.5425029686457
STAT,1876,46,50-100,1922,0.240387350289112
STAT,1824,59,na,1883,1152.920422407491
STAT,1867,22,20-24,1889,61.38259402827005
SIM,1884,31,50-100,1915,4
SIM,1895,19,15-19,1914,6
STAT,1824,48,na,1872,1412.4826788549362
STAT,1843,50,40-44,1893,0.007213052235563304
STAT,1864,47,30-34,1911,0.08112289807017112
STAT,1853,84,na,1937,251.7582160539361
STAT,1940,21,20-24,1961,107.04373165135995
SIM,1875,22,20-24,1897,69
STAT,1907,57,na,1964,2956.3427213486366
STAT,1794,88,na,1882,46.914532392744064
STAT,1903,15,45-49,1918,0.08821133942201827
STAT,1906,32,25-29,1938,8.092108223405793
SIM,1901,26,40-44,1927,6
STAT,1903,43,na,1946,3094.867817238728
STAT,1891,57,na,1948,2348.819004928419
STAT,1948,17,40-44,1965,1.5122277068148688
SIM,1856,25,na,1881,1964
SIM,1826,59,na,1885,1088
STAT,1825,30,15-19,1855,0.3136867802636808
STAT,1932,40,25-29,1972,0.09168301742315549
SIM,1898,35,20-24,1933,1
STAT,1883,50,na,1933,2022.9515236171414
SIM,1859,21,25-29,1880,49
SIM,1818,52,na,1870,1232
SIM,1933,31,30-34,1964,21
STAT,1881,32,50-100,1913,0.8361716476485411
STAT,1938,27,25-29,1965,61.60305247953145
SIM,1839,17,15-19,1856,5
SIM,1884,21,30-34,1905,26
SIM,1869,6,na,1875,2568
SIM,1889,64,na,1953,2038
STAT,1937,33,15-19,1970,0.1200309458196044
STAT,1885,30,50-100,1915,0.8697118559424908
SIM,1885,50,na,1935,2093
STAT,1846,18,15-19,1864,5.496829522016371
STAT,1906,25,35-39,1931,13.366066106284341
SIM,1875,25,25-29,1900,41
STAT,1836,29,na,1865,1786.6898426378302
SIM,1904,36,30-34,1940,1
STAT,1874,36,35-39,1910,6.859807800771948
SIM,1924,22,40-44,1946,5
STAT,1872,48,50-100,1920,0.22980077656303208
STAT,1929,42,20-24,1971,0.02160511135197435
SIM,1853,42,35-39,1895,1
SIM,1880,48,50-100,1928,3
STAT,1947,23,30-34,1970,30.677281483687658
SIM,1914,32,25-29,1946,10
STAT,1898,26,15-19,1924,0.5820127061548671
SIM,1854,18,15-19,1872,4
SIM,1902,30,40-44,1932,7
STAT,1871,17,na,1888,2384.5023246854607
SIM,1872,24,45-49,1896,1
STAT,1941,27,45-49,1968,1.6883180340832367
STAT,1925,31,30-34,1956,17.684219469175765
STAT,1864,24,45-49,1888,0.5880306037197771
STAT,1928,38,20-24,1966,0.314396682563662
STAT,1800,54,35-39,1854,0.024099089940475764
STAT,1815,89,na,1904,46.89161405146694
STAT,1952,16,15-19,1968,51.39181342239678
STAT,1930,24,15-19,1954,6.401746941573164
STAT,1874,54,35-39,1928,0.008081155078738767
SIM,1873,80,na,1953,505
SIM,1885,61,na,1946,1759
STAT,1916,22,40-44,1938,3.3284346056177623
SIM,1869,43,na,1912,2107
SIM,1820,86,na,1906,95
STAT,1834,23,20-24,1857,56.7862800620402
STAT,1918,53,na,1971,3614.750488156174
SIM,1849,25,30-34,1874,37
SIM,1835,64,na,1899,1111
SIM,1842,31,20-24,1873,2
STAT,1877,19,50-100,1896,0.04775137797390972
STAT,1918,38,25-29,1956,0.9794227297249942
STAT,1919,22,45-49,1941,1.1639403084713096
STAT,1836,36,15-19,1872,0.04510082790320918
STAT,1869,24,45-49,1893,0.6341862202428044
STAT,1881,24,45-49,1905,0.6323963494778385
STAT,1884,25,25-29,1909,39.74864307651277
STAT,1888,41,45-49,1929,1.6784817795396005
STAT,1942,30,20-24,1972,2.4573749062178187
SIM,1822,33,45-49,1855,2
SIM,1839,21,20-24,1860,50
STAT,1884,23,30-34,1907,16.573202917469185
STAT,1946,16,na,1962,3857.825596767908
STAT,1837,31,50-100,1868,0.7533480840725496
STAT,1861,20,25-29,1881,46.865579209494996
SIM,1956,7,na,1963,4790
STAT,1833,35,35-39,1868,5.539479303802342
SIM,1825,34,25-29,1859,19
SIM,1910,20,25-29,1930,79
SIM,1887,43,45-49,1930,1
SIM,1878,20,30-34,1898,24
SIM,1883,25,30-34,1908,31
SIM,1924,33,30-34,1957,25
SIM,1843,23,35-39,1866,6
SIM,1894,75,na,1969,1649
SIM,1924,35,na,1959,4203
STAT,1841,34,15-19,1875,0.11667039074012332
STAT,1813,49,25-29,1862,0.152409405656384
STAT,1898,38,30-34,1936,1.4633261833936706
SIM,1943,18,na,1961,3554
STAT,1939,20,20-24,1959,105.5684390318744
SIM,1907,36,35-39,1943,8
SIM,1918,24,45-49,1942,2
SIM,1846,24,15-19,1870,1
STAT,1897,73,na,1970,1886.6280544689362
STAT,1849,38,35-39,1887,5.371084113009185
SIM,1914,39,45-49,1953,3
STAT,1811,108,na,1919,7.944051364794309E-4
STAT,1841,52,30-34,1893,0.004081912186059723
STAT,1873,37,30-34,1910,5.10634559853167
SIM,1927,22,45-49,1949,2
SIM,1881,37,30-34,1918,4
STAT,1925,33,25-29,1958,10.361861244336655
SIM,1841,35,35-39,1876,9
STAT,1840,66,na,1906,1075.6129573802773
SIM,1916,16,na,1932,3789
STAT,1823,31,45-49,1854,5.285169399332675
SIM,1857,38,35-39,1895,8
STAT,1911,19,30-34,1930,2.291925286413164
STAT,1835,23,35-39,1858,4.901554534501365
STAT,1946,23,15-19,1969,5.594283780426862
SIM,1868,26,45-49,1894,1
SIM,1889,15,25-29,1904,7
STAT,1858,36,35-39,1894,5.263996440013931
SIM,1948,2,na,1950,4307
SIM,1872,39,30-34,1911,12
STAT,1903,42,20-24,1945,0.01480546753066274
SIM,1808,62,na,1870,962
STAT,1834,31,20-24,1865,2.17119740899561
STAT,1919,38,na,1957,3814.3781894873096
SIM,1892,25,25-29,1917,63
STAT,1900,41,40-44,1941,0.2056195549336229
STAT,1828,32,na,1860,1620.3782569717564
STAT,1826,32,25-29,1858,14.038785014819348
STAT,1923,43,na,1966,4094.221027316586
STAT,1894,29,15-19,1923,0.5468805309892756
STAT,1847,22,15-19,1869,2.982282687741424
SIM,1858,37,na,1895,1910
SIM,1865,84,na,1949,258
STAT,1830,48,15-19,1878,2.9587710994363243E-4
SIM,1899,19,na,1918,3332
SIM,1901,2,na,1903,3474
STAT,1780,96,na,1876,1.2609390920900443
STAT,1842,67,na,1909,1147.9866800135999
STAT,1920,19,25-29,1939,45.68385788507697
SIM,1942,24,35-39,1966,8
STAT,1827,38,15-19,1865,0.05692131970182759
STAT,1893,23,25-29,1916,68.36990808434331
STAT,1838,24,15-19,1862,2.832431698449851
STAT,1866,52,35-39,1918,0.007461323767355856
STAT,1934,24,35-39,1958,11.94588989508604
SIM,1947,20,20-24,1967,114
STAT,1889,54,na,1943,2442.1544626611453
STAT,1896,17,15-19,1913,7.404452597155806
STAT,1901,17,35-39,1918,0.725581057592043
SIM,1882,29,45-49,1911,1
STAT,1951,21,30-34,1972,32.450107360186244
SIM,1881,13,na,1894,1999
SIM,1816,81,na,1897,189
STAT,1822,105,na,1927,0.014898934907396367
SIM,1938,22,20-24,1960,86
SIM,1859,33,40-44,1892,6
STAT,1836,51,na,1887,1438.982660094035
STAT,1874,29,45-49,1903,1.0640309836264685
STAT,1931,30,45-49,1961,1.9500342138606632
SIM,1778,92,na,1870,7
STAT,1921,40,15-19,1961,0.0016385447225622908
STAT,1943,22,35-39,1965,9.46381607460013
SIM,1838,18,30-34,1856,1
STAT,1897,63,na,1960,2366.222466746701
SIM,1833,33,20-24,1866,1
STAT,1819,101,na,1920,0.3012293012059526
STAT,1820,66,na,1886,858.037309807584
SIM,1851,24,25-29,1875,57
SIM,1835,54,na,1889,1312
STAT,1864,39,30-34,1903,4.442190883307456
STAT,1872,31,40-44,1903,4.1261674261049235
SIM,1823,39,35-39,1862,9
SIM,1799,84,na,1883,105
SIM,1921,3,na,1924,4390
STAT,1902,28,20-24,1930,15.58568425497753
STAT,1944,28,25-29,1972,67.17193525786674
STAT,1926,37,20-24,1963,0.3043394231412506
STAT,1913,16,15-19,1929,8.78766093148933
SIM,1831,31,45-49,1862,2
SIM,1834,32,25-29,1866,15
SIM,1905,20,15-19,1925,2
STAT,1916,40,20-24,1956,0.01714445703187246
SIM,1874,27,30-34,1901,22
STAT,1859,24,na,1883,1818.603453477441
SIM,1880,51,na,1931,2185
STAT,1777,105,na,1882,0.01807981090314576
SIM,1873,38,35-39,1911,6
STAT,1945,20,50-100,1965,0.6817395265375261
SIM,1899,35,35-39,1934,15
SIM,1827,35,na,1862,1579
STAT,1889,47,35-39,1936,0.09167170164426865
STAT,1890,22,45-49,1912,0.8053825797997279
STAT,1863,39,na,1902,1933.4882694571336
SIM,1841,28,45-49,1869,1
STAT,1849,24,na,1873,1910.7180394456002
SIM,1922,38,40-44,1960,4
STAT,1828,53,50-100,1881,0.01053498509554973
STAT,1917,32,35-39,1949,9.040176780328165
STAT,1902,20,25-29,1922,76.77702744117079
SIM,1850,31,na,1881,1896
SIM,1848,27,na,1875,1886
STAT,1833,28,30-34,1861,20.218458814454
STAT,1846,44,45-49,1890,1.0950799420027064
STAT,1937,25,15-19,1962,0.6506666067634824
STAT,1865,38,35-39,1903,6.026264181434623
SIM,1855,40,45-49,1895,2
SIM,1836,81,na,1917,348
SIM,1890,51,na,1941,2719
STAT,1879,25,15-19,1904,0.4516980981433792
SIM,1841,28,30-34,1869,30
STAT,1812,47,na,1859,1329.269023127381
STAT,1850,96,na,1946,6.052935686213395
STAT,1815,39,35-39,1854,21.684598647621787
STAT,1877,37,15-19,1914,0.05502780086695867
STAT,1843,24,25-29,1867,47.8397455146224
STAT,1860,21,20-24,1881,54.845824879343745
STAT,1916,33,30-34,1949,15.301590200587386
SIM,1880,31,40-44,1911,4
SIM,1921,16,15-19,1937,44
STAT,1879,43,45-49,1922,1.4692962565933738
SIM,1933,33,25-29,1966,17
STAT,1833,28,45-49,1861,0.8914584752310607
SIM,1892,23,30-34,1915,25
STAT,1926,3,na,1929,4697.773461732321
STAT,1838,52,na,1890,1437.8341650766554
STAT,1877,42,50-100,1919,1.033979244152277
STAT,1851,19,35-39,1870,0.4742586630381774
SIM,1874,34,20-24,1908,2
SIM,1877,42,50-100,1919,2
STAT,1847,40,45-49,1887,1.1385925672257828
SIM,1852,12,na,1864,2206
STAT,1866,34,20-24,1900,2.3350681478846305
SIM,1823,102,na,1925,1
STAT,1850,86,na,1936,156.40571037536523
STAT,1884,18,35-39,1902,0.5107798518246799
SIM,1825,54,na,1879,1279
SIM,1825,32,30-34,1857,20
STAT,1882,53,30-34,1935,0.005380892849036182
SIM,1827,45,na,1872,1428
STAT,1856,112,na,1968,2.213677362633414E-4
SIM,1910,28,20-24,1938,17
STAT,1832,36,30-34,1868,4.117646980381054
SIM,1909,31,40-44,1940,5
SIM,1840,36,30-34,1876,5
SIM,1928,1,na,1929,4887
SIM,1926,23,40-44,1949,4
STAT,1898,27,na,1925,3050.978102288378
STAT,1932,29,45-49,1961,2.135529761528581
STAT,1918,23,40-44,1941,3.4152813840945475
SIM,1888,57,na,1945,2271
SIM,1940,29,45-49,1969,1
SIM,1842,12,na,1854,2121
STAT,1852,77,na,1929,626.6724282621184
SIM,1875,26,35-39,1901,12
STAT,1855,112,na,1967,1.7992162423511899E-4
SIM,1850,21,na,1871,1964
STAT,1867,33,25-29,1900,9.047646649186408
SIM,1933,18,na,1951,4688
STAT,1908,41,25-29,1949,0.0627746275551782
SIM,1833,29,35-39,1862,7
STAT,1838,42,45-49,1880,1.1750826068491635
SIM,1891,13,na,1904,3053
STAT,1850,27,35-39,1877,8.004306485426763
STAT,1905,40,45-49,1945,0.14334748939328307
SIM,1879,74,na,1953,1047
STAT,1922,49,50-100,1971,0.24402830236849882
STAT,1851,26,25-29,1877,35.88606135250372
STAT,1834,24,30-34,1858,14.572550195808752
SIM,1886,76,na,1962,1099
STAT,1874,33,15-19,1907,0.13687515839257045
SIM,1941,25,30-34,1966,33
STAT,1766,108,na,1874,0.00414595122783458
SIM,1852,28,20-24,1880,12
STAT,1836,20,50-100,1856,0.4308177073579654
STAT,1845,15,45-49,1860,0.05911756657411301
SIM,1902,29,25-29,1931,72
STAT,1878,53,50-100,1931,0.014630230770979786
STAT,1858,40,20-24,1898,0.11881679833665279
SIM,1837,44,45-49,1881,2
SIM,1875,33,25-29,1908,11
SIM,1926,16,na,1942,4214
STAT,1810,108,na,1918,7.74890455350192E-4
STAT,1890,29,30-34,1919,28.876362942824684
SIM,1846,42,45-49,1888,1
STAT,1853,28,15-19,1881,0.35936958233725474
STAT,1899,34,30-34,1933,22.40641373417
SIM,1842,24,30-34,1866,17
STAT,1798,92,na,1890,11.830453235121965
STAT,1870,28,15-19,1898,0.4189938807645004
STAT,1933,25,30-34,1958,49.19179473127577
SIM,1955,15,30-34,1970,17
STAT,1862,2,na,1864,2770.4623041030886
SIM,1884,75,na,1959,1127
STAT,1855,42,45-49,1897,1.0622430311193403
SIM,1843,30,25-29,1873,14
STAT,1897,49,35-39,1946,0.09768825205207382
STAT,1856,45,15-19,1901,2.9777020863018674E-4
STAT,1860,46,35-39,1906,0.1076160315810103
STAT,1899,36,25-29,1935,3.7447780471803336
SIM,1858,27,na,1885,1985
SIM,1953,18,na,1971,4146
STAT,1840,38,30-34,1878,4.09404405559775
SIM,1847,16,30-34,1863,2
STAT,1947,15,30-34,1962,12.978160265481527
STAT,1826,51,na,1877,1316.9333483691007
SIM,1898,39,35-39,1937,4
STAT,1874,51,30-34,1925,0.005773030297456842
STAT,1942,23,30-34,1965,28.45919960571174
SIM,1862,30,50-100,1892,5
SIM,1830,96,na,1926,10
SIM,1930,21,na,1951,4428
STAT,1772,87,na,1859,46.86854490132065
STAT,1917,29,50-100,1946,0.979073274131034
SIM,1856,39,30-34,1895,5
STAT,1882,35,15-19,1917,0.052080015671841715
STAT,1887,45,45-49,1932,0.2518636811854413
STAT,1888,48,30-34,1936,0.060195727808875055
SIM,1876,56,na,1932,1954
STAT,1857,37,30-34,1894,3.97086051053433
STAT,1868,25,40-44,1893,2.7183457762226646
STAT,1862,38,50-100,1900,0.9867518995207968
STAT,1913,43,na,1956,3416.1791947139823
STAT,1839,16,30-34,1855,1.3964227562448202
STAT,1860,24,25-29,1884,44.58608681084352
STAT,1829,26,15-19,1855,0.808210239674439
STAT,1843,17,35-39,1860,0.47363168903805225
STAT,1840,23,45-49,1863,0.5777813448589417
STAT,1848,39,30-34,1887,3.997170098851838
SIM,1916,34,35-39,1950,8
SIM,1891,23,na,1914,2773
STAT,1833,50,30-34,1883,0.003916070930080274
STAT,1927,21,40-44,1948,3.925236888531976
STAT,1825,99,na,1924,1.0065631931345074
STAT,1860,17,35-39,1877,0.4850760784511582
STAT,1885,29,20-24,1914,10.96789180799081
SIM,1946,24,20-24,1970,107
SIM,1901,22,25-29,1923,75
STAT,1858,62,na,1920,1353.7665937232014
STAT,1910,15,35-39,1925,0.7891417829066808
SIM,1888,17,30-34,1905,4
STAT,1815,44,15-19,1859,0.03223602365762591
STAT,1813,49,50-100,1862,0.6498567759248985
STAT,1825,36,25-29,1861,3.7680223253452034
SIM,1863,28,na,1891,1973
STAT,1938,17,30-34,1955,11.358755788379863
STAT,1817,47,50-100,1864,0.5536720095569216
STAT,1835,30,25-29,1865,8.47374936829554
STAT,1924,35,30-34,1959,2.0337478362044945
STAT,1875,32,20-24,1907,2.6247097009817923
SIM,1884,31,25-29,1915,10
SIM,1911,19,25-29,1930,9
SIM,1947,16,35-39,1963,6
STAT,1830,66,na,1896,989.2177132036466
STAT,1871,49,15-19,1920,3.6739411708307647E-4
STAT,1839,23,20-24,1862,58.52941329942496
SIM,1925,31,25-29,1956,11
STAT,1889,44,na,1933,2659.110495430201
SIM,1876,46,na,1922,2197
STAT,1814,48,30-34,1862,0.29117944239197935
STAT,1909,38,na,1947,3347.5545088915114
SIM,1839,48,50-100,1887,1
STAT,1843,22,30-34,1865,15.10167835162888
STAT,1928,27,15-19,1955,0.8216054437447473
SIM,1853,83,na,1936,245
STAT,1818,38,20-24,1856,2.2168655215814885
STAT,1876,31,25-29,1907,10.03768435257503
STAT,1881,39,30-34,1920,4.814855271995589
SIM,1851,22,30-34,1873,18
STAT,1934,31,25-29,1965,11.928291913779148
STAT,1944,21,40-44,1965,3.4307084706976654
SIM,1936,20,45-49,1956,5
SIM,1946,17,30-34,1963,17
SIM,1848,82,na,1930,324
SIM,1893,29,20-24,1922,13
SIM,1883,32,20-24,1915,2
SIM,1901,20,30-34,1921,28
STAT,1841,37,35-39,1878,5.745070872616272
SIM,1932,35,30-34,1967,2
STAT,1903,19,25-29,1922,7.576097679439629
STAT,1859,35,40-44,1894,3.3226617242205334
STAT,1939,16,35-39,1955,3.9690794570691827
SIM,1808,52,na,1860,1212
STAT,1875,25,30-34,1900,24.617884487806837
STAT,1825,29,35-39,1854,31.9187461920835
STAT,1866,36,50-100,1902,1.0749072499028478
STAT,1938,24,20-24,1962,103.89414062253442
STAT,1805,99,na,1904,0.6611044595412198
SIM,1901,15,35-39,1916,3
SIM,1826,30,25-29,1856,12
SIM,1833,36,25-29,1869,1
STAT,1908,34,35-39,1942,8.07927332791672
STAT,1928,20,45-49,1948,1.3350240304340593
STAT,1878,41,50-100,1919,1.044804846025429
SIM,1915,35,30-34,1950,3
STAT,1904,60,na,1964,2765.2723172767787
SIM,1832,37,35-39,1869,14
STAT,1865,35,15-19,1900,0.04853990455945689
STAT,1917,39,20-24,1956,0.2570914015688413
SIM,1926,38,25-29,1964,1
SIM,1935,21,40-44,1956,5
STAT,1885,21,25-29,1906,54.06770591961326
SIM,1817,47,50-100,1864,2
STAT,1824,37,35-39,1861,11.094885366122815
STAT,1836,49,50-100,1885,0.16223207970633485
STAT,1839,49,30-34,1888,0.06400426939714107
SIM,1836,20,40-44,1856,3
STAT,1892,27,25-29,1919,50.05316948462293
STAT,1831,33,45-49,1864,1.3739188512643594
STAT,1917,31,25-29,1948,9.180680295482649
STAT,1849,45,25-29,1894,0.043623006235057375
STAT,1866,81,na,1947,471.17964195928414
SIM,1845,64,na,1909,1203
SIM,1903,43,na,1946,3103
STAT,1910,22,25-29,1932,81.94867181851644
STAT,1919,37,15-19,1956,0.019489356409293977
SIM,1847,23,20-24,1870,52
STAT,1899,41,20-24,1940,0.014339655978585233
STAT,1823,38,30-34,1861,8.185111997573014
STAT,1876,24,35-39,1900,5.659802003305197
STAT,1907,35,30-34,1942,1.611523026260982
STAT,1891,28,35-39,1919,11.237789766048564
STAT,1848,46,35-39,1894,0.10432347881304137
STAT,1869,44,na,1913,2086.670715987096
SIM,1831,38,30-34,1869,6
SIM,1884,24,35-39,1908,4
SIM,1893,21,25-29,1914,77
STAT,1848,47,30-34,1895,0.07159268477997817
STAT,1870,26,50-100,1896,0.5948766184521903
SIM,1843,73,na,1916,815
SIM,1917,33,40-44,1950,4
STAT,1822,46,15-19,1868,5.456793965380677E-4
STAT,1898,15,25-29,1913,7.278115557537003
STAT,1919,0,na,1919,4703.206222641892
STAT,1851,16,30-34,1867,1.4022404576576095
STAT,1926,22,35-39,1948,10.806262036316582
SIM,1938,23,30-34,1961,36
STAT,1855,34,45-49,1889,1.2358344636114258
SIM,1825,31,20-24,1856,1
STAT,1883,26,35-39,1909,8.967635821540703
STAT,1904,48,25-29,1952,0.043474198022215874
SIM,1853,20,40-44,1873,1
STAT,1908,31,30-34,1939,14.106891300838164
STAT,1918,31,40-44,1949,3.9445610755597436
STAT,1916,41,na,1957,3600.636947832892
STAT,1848,39,45-49,1887,1.4951100776086856
SIM,1892,22,20-24,1914,76
STAT,1837,21,45-49,1858,0.5967294882079106
SIM,1919,21,40-44,1940,3
STAT,1900,44,45-49,1944,0.13436197072630626
STAT,1905,22,15-19,1927,4.504798817849546
STAT,1884,22,20-24,1906,64.31745816041143
STAT,1878,29,15-19,1907,0.44348699472884817
STAT,1920,16,20-24,1936,144.04684752919658
SIM,1947,22,na,1969,3835
SIM,1876,25,40-44,1901,7
STAT,1839,36,50-100,1875,0.9870338974761327
STAT,1786,91,na,1877,16.82822694502668
STAT,1816,51,na,1867,1310.9370989421766
SIM,1843,22,25-29,1865,56
SIM,1897,15,30-34,1912,1
SIM,1913,22,15-19,1935,3
STAT,1818,48,15-19,1866,8.400857063586703E-4
SIM,1856,39,45-49,1895,5
STAT,1870,18,20-24,1888,16.488934688843194
STAT,1899,44,25-29,1943,0.05694178906252416
STAT,1867,35,50-100,1902,1.0994470121691284
STAT,1877,29,15-19,1906,0.44142120868653234
STAT,1891,78,na,1969,1318.3003921343188
STAT,1909,33,40-44,1942,3.513097741226871
STAT,1884,26,35-39,1910,9.03644946120211
SIM,1879,41,45-49,1920,2
STAT,1892,25,30-34,1917,29.998639930356536
STAT,1898,28,50-100,1926,0.8149166526685145
SIM,1901,23,35-39,1924,10
STAT,1920,42,20-24,1962,0.01842586863666169
SIM,1889,38,30-34,1927,8
STAT,1894,45,na,1939,2759.161959562824
STAT,1932,34,na,1966,4743.467546329913
SIM,1833,34,30-34,1867,22
SIM,1874,75,na,1949,930
SIM,1930,11,na,1941,4878
SIM,1807,90,na,1897,20
STAT,1943,21,25-29,1964,92.86995646868404
SIM,1824,35,35-39,1859,13
SIM,1893,58,na,1951,2460
SIM,1915,44,na,1959,3376
SIM,1868,27,na,1895,2130
SIM,1918,21,40-44,1939,4
SIM,1834,68,na,1902,903
SIM,1828,82,na,1910,251
SIM,1889,74,na,1963,1488
SIM,1916,31,30-34,1947,12
STAT,1811,75,na,1886,442.9759576454062
STAT,1845,20,40-44,1865,1.857148005565688
SIM,1832,34,30-34,1866,14
SIM,1926,31,40-44,1957,5
STAT,1912,47,20-24,1959,0.010033604194191236
SIM,1891,26,35-39,1917,17
STAT,1812,92,na,1904,18.091983382349856
STAT,1825,34,30-34,1859,25.319426017979243
STAT,1930,16,50-100,1946,0.45869733154399045
STAT,1886,16,45-49,1902,0.06534610435163694
STAT,1909,37,20-24,1946,0.2357253090101951
STAT,1869,78,na,1947,715.0674483896621
SIM,1874,37,25-29,1911,3
SIM,1834,22,30-34,1856,19
SIM,1840,29,40-44,1869,4
STAT,1955,17,30-34,1972,15.284169805253836
STAT,1777,86,na,1863,58.988836319483646
SIM,1884,23,25-29,1907,51
SIM,1840,31,na,1871,1732
SIM,1802,91,na,1893,23
SIM,1850,25,35-39,1875,10
STAT,1897,31,45-49,1928,2.2121175516726135
SIM,1909,34,45-49,1943,2
SIM,1859,36,45-49,1895,1
SIM,1826,81,na,1907,251
STAT,1888,25,50-100,1913,0.7190286808172447
STAT,1870,86,na,1956,226.18202349676983
STAT,1945,27,15-19,1972,0.7316641593667981
SIM,1892,26,35-39,1918,15
STAT,1822,47,na,1869,1324.305373406111
STAT,1832,29,40-44,1861,2.396485961139518
STAT,1854,48,na,1902,1589.5010985834012
STAT,1948,21,25-29,1969,100.22872491400743
STAT,1938,21,15-19,1959,4.978715134695349
SIM,1813,43,45-49,1856,1
SIM,1951,1,na,1952,4381
SIM,1851,21,20-24,1872,49
SIM,1900,45,na,1945,3038
SIM,1873,28,40-44,1901,5
SIM,1830,39,25-29,1869,2
SIM,1825,35,35-39,1860,11
SIM,1914,0,na,1914,4083
STAT,1822,39,25-29,1861,4.545700897804045
STAT,1842,25,35-39,1867,8.766628194595764
SIM,1845,30,na,1875,1834
SIM,1940,21,na,1961,3437
STAT,1855,18,50-100,1873,0.04116499529898605
SIM,1943,23,40-44,1966,4
STAT,1912,17,25-29,1929,8.278525963866393
SIM,1946,21,15-19,1967,9
STAT,1838,49,30-34,1887,0.06516826981151298
STAT,1852,67,na,1919,1149.261145186172
SIM,1866,33,30-34,1899,23
SIM,1875,29,na,1904,2305
STAT,1893,20,20-24,1913,83.05166800526915
SIM,1938,17,na,1955,3271
SIM,1868,23,40-44,1891,6
STAT,1817,42,25-29,1859,1.6318823896709878
STAT,1896,46,na,1942,2815.586833407809
STAT,1865,35,30-34,1900,4.60687767429098
STAT,1866,37,25-29,1903,2.508705882348352
STAT,1928,35,15-19,1963,0.022965941904849494
STAT,1848,21,20-24,1869,62.79942467990168
STAT,1844,38,15-19,1882,0.040787259351934425
STAT,1883,52,35-39,1935,0.007931376936121743
SIM,1906,37,45-49,1943,2
STAT,1851,31,20-24,1882,2.0449233120886263
STAT,1843,21,20-24,1864,58.84818544176946
STAT,1889,15,30-34,1904,1.8674945167949963
SIM,1898,57,na,1955,2500
SIM,1934,22,35-39,1956,10
SIM,1920,17,25-29,1937,58
SIM,1854,41,40-44,1895,5
SIM,1938,30,20-24,1968,2
STAT,1767,108,na,1875,0.004287351197766116
STAT,1839,19,35-39,1858,0.47229102954214075
STAT,1855,45,15-19,1900,2.870842868982234E-4
SIM,1887,40,40-44,1927,7
SIM,1860,21,na,1881,2053
STAT,1858,33,30-34,1891,12.87751579651006
SIM,1873,35,30-34,1908,6
SIM,1885,29,na,1914,2283
STAT,1829,44,45-49,1873,1.2374731298289963
SIM,1923,18,na,1941,4110
SIM,1856,21,20-24,1877,58
STAT,1839,101,na,1940,0.3799201836921584
STAT,1883,19,45-49,1902,0.060178114364582654
SIM,1941,28,35-39,1969,22
STAT,1835,34,na,1869,1719.9928517562435
SIM,1839,24,25-29,1863,57
STAT,1862,102,na,1964,0.9966868926005841
SIM,1815,64,na,1879,945
STAT,1836,28,15-19,1864,0.3774438004001592
SIM,1848,37,30-34,1885,7
STAT,1859,20,50-100,1879,0.35465941084990954
STAT,1896,35,45-49,1931,2.5108659994633813
STAT,1879,40,40-44,1919,2.2466920578454377
STAT,1844,28,20-24,1872,9.902631820260126
STAT,1842,105,na,1947,0.021233510691420193
STAT,1855,49,30-34,1904,0.06735240772750836
STAT,1914,34,50-100,1948,0.7795113141968147
STAT,1846,41,40-44,1887,1.710264659432266
STAT,1854,112,na,1966,1.516599814927005E-4
SIM,1852,49,50-100,1901,1
SIM,1938,15,30-34,1953,10
SIM,1955,5,na,1960,4605
STAT,1851,24,30-34,1875,15.082449730307813
STAT,1937,33,na,1970,3532.663512995654
STAT,1842,51,35-39,1893,0.006264358047633288
SIM,1900,27,35-39,1927,13
STAT,1933,28,35-39,1961,18.82334633699473
SIM,1889,20,20-24,1909,79
STAT,1847,25,20-24,1872,10.548826056330862
STAT,1825,34,na,1859,1526.912378282077
STAT,1859,49,15-19,1908,2.944764005576628E-4
STAT,1855,16,15-19,1871,5.045717613198864
SIM,1875,30,20-24,1905,1
STAT,1894,15,40-44,1909,0.22308505229184875
STAT,1884,33,25-29,1917,9.519293147479626
STAT,1850,24,30-34,1874,14.855085401849388
SIM,1863,16,15-19,1879,4
STAT,1874,29,30-34,1903,24.132438265482484
STAT,1899,37,35-39,1936,1.9760713334195974
STAT,1884,50,50-100,1934,0.014298270245532707
STAT,1947,18,35-39,1965,4.464094521284097
SIM,1829,28,30-34,1857,25
STAT,1877,30,50-100,1907,0.9050778982432809
STAT,1837,28,15-19,1865,0.3752206564158021
SIM,1825,64,na,1889,945
SIM,1775,94,na,1869,2
SIM,1866,35,25-29,1901,2
SIM,1928,17,na,1945,4393
STAT,1851,23,20-24,1874,58.773255394463156
SIM,1896,19,30-34,1915,3
STAT,1956,16,na,1972,4601.756441905615
SIM,1908,32,35-39,1940,15
SIM,1858,34,35-39,1892,13
STAT,1863,47,15-19,1910,3.30060670638287E-4
SIM,1844,78,na,1922,474
STAT,1888,19,30-34,1907,1.7699297504025886
SIM,1905,44,na,1949,3083
SIM,1890,20,45-49,1910,5
STAT,1901,22,30-34,1923,23.553927236727063
SIM,1879,23,15-19,1902,3
STAT,1860,96,na,1956,7.628591906494216
SIM,1865,36,35-39,1901,15
STAT,1889,1,na,1890,3174.390021948705
STAT,1943,25,40-44,1968,4.693588668222636
SIM,1871,18,15-19,1889,7
SIM,1902,26,na,1928,3195
STAT,1949,14,na,1963,4314.44763524939
SIM,1839,17,35-39,1856,2
SIM,1949,4,na,1953,4267
STAT,1830,38,20-24,1868,0.6178469196387159
SIM,1882,29,30-34,1911,28
SIM,1830,55,na,1885,1253
SIM,1855,25,20-24,1880,8
STAT,1950,17,45-49,1967,0.5580078892502367
STAT,1841,40,50-100,1881,0.7764696582111844
STAT,1887,42,40-44,1929,2.3738482657069944
STAT,1925,26,35-39,1951,16.809059965269288
STAT,1841,29,35-39,1870,8.143992516448401
STAT,1914,38,40-44,1952,1.4050214149106672
STAT,1879,54,na,1933,2070.657949461045
STAT,1899,33,20-24,1932,3.484081366655341
STAT,1835,38,50-100,1873,0.9560793194693095
STAT,1889,48,30-34,1937,0.0628811612761826
STAT,1935,23,40-44,1958,4.324011917082352
STAT,1882,20,45-49,1902,0.6444624655286582
STAT,1887,63,na,1950,1885.4462828412268
STAT,1941,17,na,1958,3581.562181584037
STAT,1951,16,35-39,1967,4.721789071110555
SIM,1818,62,na,1880,937
STAT,1825,33,20-24,1858,4.28985425725517
STAT,1903,20,40-44,1923,2.8176684410673505
SIM,1868,31,40-44,1899,5
STAT,1904,39,50-100,1943,0.35547249745312814
SIM,1768,92,na,1860,10
STAT,1934,15,na,1949,4725.089889397535
STAT,1863,18,15-19,1881,5.078655058166673
STAT,1928,35,50-100,1963,0.5021189390925965
SIM,1897,22,20-24,1919,78
STAT,1848,52,na,1900,1591.411291833248
SIM,1869,30,30-34,1899,17
SIM,1902,26,20-24,1928,12
SIM,1798,67,na,1865,739
STAT,1884,45,na,1929,2120.7573371538524
STAT,1839,26,25-29,1865,35.73717505508604
SIM,1835,24,40-44,1859,1
STAT,1782,77,na,1859,278.2839517314676
STAT,1832,47,na,1879,1449.838841514352
SIM,1851,32,25-29,1883,11
STAT,1899,44,na,1943,2961.4853971129332
STAT,1856,81,na,1937,398.58551114086936
STAT,1889,22,20-24,1911,80.36953116767059
SIM,1820,38,50-100,1858,1
STAT,1913,24,15-19,1937,5.0464700256971335
STAT,1920,39,50-100,1959,0.43334066315077346
SIM,1855,18,30-34,1873,4
STAT,1859,39,20-24,1898,0.5737606163640685
SIM,1838,40,45-49,1878,2
SIM,1901,30,25-29,1931,18
SIM,1933,26,35-39,1959,22
STAT,1940,28,40-44,1968,4.487958457222121
SIM,1838,22,15-19,1860,2
SIM,1932,27,45-49,1959,2
SIM,1838,82,na,1920,285
STAT,1849,39,50-100,1888,0.9227008191789093
STAT,1892,24,20-24,1916,81.0302708446008
STAT,1873,15,20-24,1888,17.18783895005493
STAT,1930,38,25-29,1968,1.212010928498323
STAT,1824,34,30-34,1858,32.846602286778044
STAT,1881,35,15-19,1916,0.05173371724134542
STAT,1924,27,45-49,1951,1.9002256160153908
STAT,1897,46,15-19,1943,2.858702514765455E-4
SIM,1905,16,30-34,1921,2
STAT,1843,25,35-39,1868,8.13717718214688
STAT,1815,99,na,1914,0.8453451168247915
SIM,1911,20,40-44,1931,3
STAT,1835,22,25-29,1857,48.43161278922844
STAT,1911,42,na,1953,3348.808147966276
SIM,1899,34,25-29,1933,17
STAT,1891,25,30-34,1916,29.631809171095103
STAT,1885,39,15-19,1924,0.05234539270052937
STAT,1906,39,45-49,1945,0.5860607911598658
SIM,1853,28,na,1881,1883
STAT,1853,22,40-44,1875,1.8633137082126838
STAT,1868,38,na,1906,2113.0086777140696
STAT,1862,26,15-19,1888,0.3704749183829639
STAT,1871,39,20-24,1910,0.7158341879584392
STAT,1861,15,50-100,1876,0.0447568559044888
STAT,1884,27,50-100,1911,0.597038158247049
STAT,1924,31,15-19,1955,0.14171059634497943
SIM,1878,27,na,1905,2417
SIM,1926,20,35-39,1946,11
STAT,1927,24,45-49,1951,1.3013813979699778
SIM,1841,36,30-34,1877,7
SIM,1861,22,40-44,1883,2
STAT,1934,21,30-34,1955,36.50061807582247
SIM,1881,15,20-24,1896,15
STAT,1907,38,35-39,1945,2.108035892706511
SIM,1865,29,na,1894,2110
SIM,1920,11,na,1931,4274
STAT,1843,32,25-29,1875,8.31716506187067
STAT,1833,84,na,1917,204.09755437388458
STAT,1892,17,30-34,1909,1.885946519319175
STAT,1831,30,40-44,1861,3.5504171298474074
SIM,1899,31,50-100,1930,2
SIM,1915,38,35-39,1953,13
SIM,1866,46,na,1912,2013
SIM,1905,23,20-24,1928,71
STAT,1844,48,na,1892,1542.933990616093
SIM,1902,19,30-34,1921,3
SIM,1942,21,30-34,1963,36
STAT,1847,18,30-34,1865,1.458288479139538
STAT,1918,20,35-39,1938,9.6510107917703
SIM,1925,35,40-44,1960,2
STAT,1852,35,50-100,1887,0.9137060081429278
STAT,1891,18,40-44,1909,0.21321357570172847
SIM,1896,12,na,1908,3253
STAT,1920,49,20-24,1969,0.011472669413397887
STAT,1833,36,30-34,1869,4.130975829508921
STAT,1871,27,na,1898,2238.7313437332496
SIM,1833,26,30-34,1859,34
STAT,1832,67,na,1899,954.9374624414037
SIM,1832,27,40-44,1859,2
SIM,1866,32,20-24,1898,3
SIM,1872,32,45-49,1904,2
STAT,1917,35,40-44,1952,1.4828457046860997
SIM,1851,25,35-39,1876,7
SIM,1838,37,50-100,1875,1
SIM,1857,39,50-100,1896,1
STAT,1845,65,na,1910,1195.8662142949925
STAT,1909,22,35-39,1931,8.267594688828956
SIM,1865,30,na,1895,2141
SIM,1929,27,50-100,1956,1
SIM,1827,76,na,1903,506
STAT,1874,45,na,1919,2193.2488758213963
SIM,1897,18,35-39,1915,2
SIM,1931,20,45-49,1951,2
STAT,1793,93,na,1886,6.344307245917149
STAT,1897,38,30-34,1935,6.699897527504924
SIM,1903,21,45-49,1924,7
SIM,1906,22,25-29,1928,74
SIM,1896,26,20-24,1922,14
STAT,1823,53,na,1876,1265.1080408362986
STAT,1838,20,35-39,1858,5.156659889624212
STAT,1901,32,25-29,1933,13.54422424583873
SIM,1835,95,na,1930,6
SIM,1845,31,50-100,1876,3
STAT,1919,43,50-100,1962,0.12007972442428397
SIM,1893,25,40-44,1918,4
SIM,1833,37,35-39,1870,12
STAT,1950,21,15-19,1971,5.9678344827449665
SIM,1934,33,40-44,1967,4
SIM,1856,38,35-39,1894,13
STAT,1797,105,na,1902,0.007194975692382418
STAT,1851,34,25-29,1885,7.5110932712322995
SIM,1939,22,20-24,1961,98
SIM,1856,24,25-29,1880,52
STAT,1787,76,na,1863,352.4081406023924
SIM,1863,31,40-44,1894,3
STAT,1872,37,15-19,1909,0.05321078560980912
STAT,1897,24,20-24,1921,86.51780217181454
STAT,1899,26,30-34,1925,32.70737789988549
STAT,1900,15,40-44,1915,0.2408089345516231
SIM,1917,22,35-39,1939,11
STAT,1892,28,35-39,1920,11.376909417113314
SIM,1885,42,50-100,1927,1
STAT,1840,34,15-19,1874,0.1114893539944646
SIM,1882,25,30-34,1907,25
SIM,1820,55,na,1875,1247
SIM,1936,21,40-44,1957,1
STAT,1851,48,35-39,1899,0.09944261478827732
STAT,1841,19,40-44,1860,0.16072000283772683
STAT,1952,19,20-24,1971,153.37910811086329
STAT,1850,17,40-44,1867,0.1575536339334321
STAT,1859,24,35-39,1883,4.487190740382702
SIM,1938,26,35-39,1964,14
STAT,1845,23,45-49,1868,0.6081816232517857
STAT,1848,38,35-39,1886,5.360042774765412
STAT,1828,38,15-19,1866,0.05012863200479745
STAT,1916,7,na,1923,3993.37273408961
STAT,1938,32,20-24,1970,2.3169814313018926
SIM,1937,32,na,1969,3429
SIM,1838,33,20-24,1871,1
SIM,1843,28,na,1871,1898
SIM,1881,77,na,1958,736
SIM,1875,23,30-34,1898,23
STAT,1923,20,45-49,1943,1.2441456349588123
SIM,1861,18,20-24,1879,16
SIM,1835,20,25-29,1855,63
SIM,1948,20,20-24,1968,106
STAT,1853,18,20-24,1871,16.04457565673141
STAT,1929,34,20-24,1963,2.923045188160729
STAT,1910,19,15-19,1929,8.449913622017007
STAT,1834,80,na,1914,383.5110910272312
SIM,1888,39,40-44,1927,4
SIM,1897,62,na,1959,2482
STAT,1787,86,na,1873,67.77159164762223
STAT,1855,31,40-44,1886,3.170647176512796
STAT,1902,27,na,1929,3181.787806810789
SIM,1879,27,30-34,1906,26
STAT,1861,82,na,1943,366.49450030642
STAT,1859,78,na,1937,587.4766550799134
STAT,1876,2,na,1878,3180.6436261293843
STAT,1848,24,25-29,1872,51.05184590821361
STAT,1857,36,35-39,1893,5.295121518818075
STAT,1944,24,45-49,1968,1.14688620453459
SIM,1864,23,20-24,1887,60
SIM,1900,20,15-19,1920,4
STAT,1924,38,35-39,1962,2.6916130203895965
SIM,1844,68,na,1912,989
STAT,1816,46,25-29,1862,0.13820868795584285
SIM,1928,22,45-49,1950,2
SIM,1820,65,na,1885,907
STAT,1845,49,20-24,1894,0.008314249394031468
SIM,1937,34,20-24,1971,1
STAT,1766,91,na,1857,14.434465890535197
SIM,1932,38,35-39,1970,8
SIM,1849,33,30-34,1882,20
SIM,1900,33,50-100,1933,1
STAT,1895,29,15-19,1924,0.5547857564237687
STAT,1883,37,25-29,1920,2.666750913802249
STAT,1883,23,15-19,1906,3.0461583509243093
STAT,1943,29,na,1972,3765.2958828686446
SIM,1841,24,15-19,1865,2
STAT,1829,41,40-44,1870,1.9489600993207192
STAT,1874,55,na,1929,1995.8055222244773
SIM,1891,37,25-29,1928,3
STAT,1941,19,45-49,1960,0.485752721956849
SIM,1792,73,na,1865,450
STAT,1804,73,na,1877,513.5727177206845
STAT,1841,26,30-34,1867,21.718769636806623
SIM,1803,63,na,1866,852
SIM,1865,29,45-49,1894,4
SIM,1948,17,na,1965,3973
STAT,1802,92,na,1894,14.602062230178035
STAT,1869,39,15-19,1908,0.050874824235786036
STAT,1839,38,40-44,1877,3.4469257611035617
SIM,1805,88,na,1893,34
STAT,1831,36,15-19,1867,0.04357172670070824
STAT,1867,23,30-34,1890,15.752060738063054
STAT,1889,39,35-39,1928,8.165808266831979
SIM,1867,35,40-44,1902,6
SIM,1833,25,35-39,1858,11
STAT,1882,74,na,1956,1051.486694449625
SIM,1891,23,15-19,1914,4
STAT,1805,53,50-100,1858,0.05433729189702549
STAT,1865,85,na,1950,234.73204131333407
STAT,1861,27,50-100,1888,0.5061207001692334
STAT,1902,24,40-44,1926,2.7608074389814328
STAT,1907,27,45-49,1934,1.5407983698476646
STAT,1928,21,40-44,1949,3.9777685260421634
STAT,1825,65,na,1890,898.1908663752512
STAT,1929,20,45-49,1949,1.3521513409433445
STAT,1927,39,15-19,1966,0.022506632902082165
SIM,1946,25,30-34,1971,44
SIM,1897,39,35-39,1936,9
STAT,1914,16,30-34,1930,2.387809447578866
SIM,1852,87,na,1939,89
STAT,1896,46,15-19,1942,2.823184461072535E-4
STAT,1922,20,50-100,1942,0.7170914649713275
STAT,1884,7,na,1891,2431.632897110778
STAT,1857,29,45-49,1886,0.8398818847704516
SIM,1884,20,20-24,1904,60
SIM,1915,27,45-49,1942,1
STAT,1896,32,40-44,1928,5.410858035594227
SIM,1803,76,na,1879,349
SIM,1922,16,30-34,1938,16
STAT,1825,37,35-39,1862,8.878145031090366
STAT,1856,30,45-49,1886,1.328371787769248
STAT,1889,25,25-29,1914,49.668937485728065
SIM,1905,30,45-49,1935,1
SIM,1865,20,na,1885,2149
STAT,1947,25,25-29,1972,70.40967094481573
STAT,1926,33,40-44,1959,4.467298527068079
STAT,1827,46,na,1873,1478.1083587492951
STAT,1888,26,20-24,1914,13.142505233194337
STAT,1839,45,30-34,1884,0.06736978835086226
STAT,1833,24,15-19,1857,2.682691141568955
STAT,1856,19,35-39,1875,0.47260855578449074
SIM,1769,87,na,1856,38
SIM,1846,20,35-39,1866,5
STAT,1867,30,20-24,1897,2.4170981438392287
STAT,1808,86,na,1894,85.78958533642277
SIM,1929,28,35-39,1957,23
SIM,1854,78,na,1932,576
STAT,1877,26,45-49,1903,1.091758315465019
SIM,1862,97,na,1959,7
STAT,1889,18,35-39,1907,0.6382580779025482
STAT,1912,37,na,1949,3469.006743942859
STAT,1906,21,20-24,1927,95.10322343608732
STAT,1933,6,na,1939,5068.630202964523
STAT,1842,13,na,1855,2209.9212
SIM,1926,27,20-24,1953,18
STAT,1890,62,na,1952,2110.9669881094665
STAT,1938,25,30-34,1963,36.7040245039188
STAT,1817,46,na,1863,1358.7814857555404
SIM,1847,38,40-44,1885,3
STAT,1953,18,25-29,1971,49.505489254762686
STAT,1869,42,50-100,1911,0.9656632663309731
STAT,1891,29,30-34,1920,29.221774967456124
STAT,1910,37,45-49,1947,0.6159528079787038
STAT,1892,74,na,1966,1622.082889858258
SIM,1909,16,15-19,1925,7
SIM,1879,34,20-24,1913,2
STAT,1892,16,35-39,1908,0.6508548598404802
SIM,1852,97,na,1949,3
STAT,1873,22,45-49,1895,0.668113889779223
STAT,1888,58,na,1946,2207.88517962964
STAT,1863,102,na,1965,1.1682863724242671
SIM,1914,21,20-24,1935,95
SIM,1885,26,45-49,1911,1
STAT,1810,44,30-34,1854,4.019625074817512
STAT,1910,56,na,1966,3117.5167394031823
SIM,1870,38,50-100,1908,2
STAT,1861,24,40-44,1885,1.6574931176879928
SIM,1926,0,na,1926,4759
STAT,1935,27,20-24,1962,23.506226024753015
STAT,1898,48,25-29,1946,0.041015464135664745
SIM,1835,28,20-24,1863,12
SIM,1887,21,35-39,1908,8
SIM,1923,26,40-44,1949,8
STAT,1776,91,na,1867,16.665158306810845
STAT,1937,1,na,1938,3837.9686417234957
SIM,1885,19,20-24,1904,19
SIM,1856,46,na,1902,1779
SIM,1944,18,25-29,1962,47
STAT,1887,48,15-19,1935,4.1736245837680874E-4
SIM,1889,37,35-39,1926,14
STAT,1918,27,20-24,1945,18.352028229039966
STAT,1806,51,na,1857,1203.7351561001906
SIM,1867,11,na,1878,2592
SIM,1938,33,25-29,1971,9
SIM,1864,30,45-49,1894,1
STAT,1921,37,20-24,1958,0.27806169569150757
STAT,1841,38,30-34,1879,4.284298926851654
SIM,1855,30,na,1885,1975
SIM,1910,24,40-44,1934,3
STAT,1865,28,40-44,1893,2.5559712573250657
STAT,1865,25,50-100,1890,0.5514630530711666
SIM,1918,32,45-49,1950,1
SIM,1860,26,40-44,1886,3
STAT,1833,53,na,1886,1334.571898968462
SIM,1841,27,35-39,1868,10
STAT,1936,18,25-29,1954,39.09056104712398
STAT,1907,26,50-100,1933,0.8907652480676402
SIM,1889,23,25-29,1912,74
STAT,1833,27,35-39,1860,7.803269647303412
STAT,1898,37,35-39,1935,9.042161485434098
STAT,1911,22,40-44,1933,3.0125959404068983
STAT,1915,45,50-100,1960,0.2163253147934541
SIM,1864,16,30-34,1880,1
STAT,1854,30,50-100,1884,0.6854206385689499
STAT,1894,19,20-24,1913,21.40788893801243
STAT,1902,37,na,1939,3165.8481190644857
STAT,1851,15,35-39,1866,0.4855986857634099
STAT,1893,59,na,1952,2328.323799083824
STAT,1826,36,40-44,1862,4.934435785966684
STAT,1814,52,50-100,1866,0.0441236640307996
STAT,1906,17,35-39,1923,0.7549709991867181
STAT,1851,82,na,1933,335.6327863579145
STAT,1905,55,na,1960,2915.144223139541
SIM,1854,68,na,1922,1197
STAT,1827,28,20-24,1855,21.60257851996332
STAT,1856,26,na,1882,1835.9641783395077
STAT,1856,37,30-34,1893,3.9283134606922596
SIM,1896,33,45-49,1929,2
STAT,1831,29,25-29,1860,34.643838047973446
STAT,1850,53,35-39,1903,0.005971287215731353
SIM,1934,29,20-24,1963,20
SIM,1829,42,45-49,1871,4
SIM,1943,27,20-24,1970,16
SIM,1897,25,25-29,1922,57
SIM,1880,34,45-49,1914,1
SIM,1902,22,40-44,1924,3
SIM,1816,48,50-100,1864,3
STAT,1925,23,30-34,1948,32.399058221590195
STAT,1898,34,15-19,1932,0.18049806514621308
STAT,1882,33,na,1915,2183.0889477090827
SIM,1774,88,na,1862,33
SIM,1891,77,na,1968,1334
STAT,1862,15,45-49,1877,0.06114676818487974
STAT,1879,21,35-39,1900,5.787971615271259
STAT,1888,33,45-49,1921,1.9386713114640928
STAT,1915,26,40-44,1941,4.506733180378381
STAT,1863,41,50-100,1904,0.879779747101218
STAT,1842,18,45-49,1860,0.0603885557362475
STAT,1893,27,40-44,1920,3.588768398837649
STAT,1830,35,na,1865,1660.1702875199446
STAT,1856,23,20-24,1879,58.5687632415357
STAT,1882,16,25-29,1898,5.218896782687852
SIM,1892,15,30-34,1907,2
STAT,1956,16,35-39,1972,5.24610246607857
SIM,1850,29,35-39,1879,10
STAT,1872,34,45-49,1906,1.6382590069441738
STAT,1926,29,20-24,1955,20.523677446823008
SIM,1925,29,50-100,1954,1
STAT,1874,24,50-100,1898,0.39114478597137586
STAT,1930,16,15-19,1946,55.56354800463833
STAT,1882,43,50-100,1925,0.9635673368266935
STAT,1842,29,35-39,1871,8.517549320748065
STAT,1854,19,50-100,1873,0.04143919696191348
STAT,1851,27,35-39,1878,8.126816300725968
STAT,1857,44,20-24,1901,0.11672822439237042
STAT,1842,36,25-29,1878,2.4714671814735194
SIM,1887,62,na,1949,1879
SIM,1917,22,na,1939,3644
SIM,1952,17,20-24,1969,133
SIM,1929,35,25-29,1964,1
SIM,1895,20,30-34,1915,21
SIM,1848,22,25-29,1870,51
SIM,1863,41,50-100,1904,1
STAT,1901,42,na,1943,3063.0282069609257
STAT,1833,39,35-39,1872,5.31407526381082
STAT,1853,25,45-49,1878,0.9875491625348317
STAT,1927,28,25-29,1955,75.32549666280009
STAT,1838,83,na,1921,266.517280240898
STAT,1871,37,50-100,1908,1.151711477681566
STAT,1852,26,40-44,1878,2.5478114008266237
SIM,1929,21,15-19,1950,5
STAT,1867,26,35-39,1893,8.588726118791113
SIM,1844,25,45-49,1869,2
STAT,1944,17,20-24,1961,137.83036878724013
SIM,1844,49,50-100,1893,2
SIM,1875,30,na,1905,2335
STAT,1889,36,50-100,1925,1.4387525940180212
STAT,1917,24,35-39,1941,9.394826485572992
SIM,1824,39,35-39,1863,12
STAT,1951,20,20-24,1971,125.58879384162874
STAT,1816,39,35-39,1855,23.23070016807598
STAT,1847,32,45-49,1879,1.509818793541471
SIM,1899,24,30-34,1923,27
SIM,1821,49,50-100,1870,1
SIM,1855,32,45-49,1887,1
STAT,1821,49,50-100,1870,0.3762637198149353
SIM,1825,47,50-100,1872,2
STAT,1897,17,30-34,1914,2.01366657379192
STAT,1892,46,30-34,1938,0.06479276411864024
STAT,1887,20,30-34,1907,18.93426244557116
SIM,1935,28,25-29,1963,82
STAT,1836,25,45-49,1861,0.943867636374031
SIM,1947,23,25-29,1970,88
SIM,1899,31,20-24,1930,3
SIM,1937,27,30-34,1964,38
STAT,1885,38,50-100,1923,1.1503618429205313
STAT,1887,27,15-19,1914,0.4794203502582533
SIM,1850,36,25-29,1886,6
STAT,1851,72,na,1923,908.4545586775354
STAT,1926,28,50-100,1954,1.1232032155123257
SIM,1874,36,50-100,1910,2
SIM,1937,22,na,1959,3259
SIM,1925,24,35-39,1949,14
STAT,1880,39,15-19,1919,0.055363412520713876
STAT,1842,22,15-19,1864,3.013352376731825
STAT,1866,49,40-44,1915,0.14605564950922437
STAT,1835,65,na,1900,1075.6205493042141
STAT,1912,28,15-19,1940,0.6549218561210717
STAT,1873,60,na,1933,1827.2964436483169
STAT,1843,24,50-100,1867,0.3407875089891672
SIM,1850,22,15-19,1872,2
SIM,1908,43,40-44,1951,2
SIM,1839,39,45-49,1878,3
SIM,1838,26,30-34,1864,26
SIM,1918,28,25-29,1946,74
SIM,1833,83,na,1916,196
SIM,1876,29,20-24,1905,17
STAT,1901,39,45-49,1940,0.5632462824679128
STAT,1901,25,35-39,1926,12.845744262614273
SIM,1861,25,45-49,1886,2
SIM,1848,36,35-39,1884,14
SIM,1886,41,50-100,1927,1
STAT,1813,48,15-19,1861,0.0010758047145328067
STAT,1861,27,na,1888,1888.2025712965499
STAT,1929,27,30-34,1956,46.3243319022929
SIM,1841,39,35-39,1880,15
STAT,1844,20,25-29,1864,50.36159118202187
SIM,1882,28,35-39,1910,12
SIM,1931,37,na,1968,4680
SIM,1857,35,30-34,1892,6
STAT,1888,15,15-19,1903,6.656402214618444
STAT,1930,22,na,1952,4419.3767189376595
STAT,1936,22,45-49,1958,1.0161974844041843
SIM,1793,68,na,1861,686
SIM,1907,33,30-34,1940,17
STAT,1850,32,50-100,1882,0.6756582651066594
SIM,1836,23,45-49,1859,1
STAT,1908,45,40-44,1953,0.13668315235117587
STAT,1816,43,20-24,1859,0.40941620834565745
STAT,1921,38,50-100,1959,0.44242579602100335
STAT,1901,44,50-100,1945,0.09570043714345962
SIM,1877,21,40-44,1898,1
STAT,1817,49,45-49,1866,0.5156034981353054
STAT,1939,23,25-29,1962,87.60628757262029
STAT,1903,28,50-100,1931,0.8568173133585467
STAT,1929,23,15-19,1952,6.339428164692855
STAT,1851,27,na,1878,1822.0159635876594
SIM,1864,37,30-34,1901,4
STAT,1891,25,15-19,1916,0.5338766025861214
STAT,1870,96,na,1966,30.937983146058055
STAT,1855,20,35-39,1875,4.914871422761926
STAT,1898,58,na,1956,2549.0865980717977
SIM,1811,51,na,1862,1156
SIM,1883,28,35-39,1911,12
STAT,1865,20,45-49,1885,0.6131238995378405
STAT,1867,37,40-44,1904,3.8831866803475834
STAT,1900,56,na,1956,2693.2996997254836
STAT,1834,34,25-29,1868,7.974903583336502
STAT,1843,46,35-39,1889,0.09533530094469293
STAT,1843,94,na,1937,13.499530222551206
STAT,1883,34,20-24,1917,2.482174240103764
STAT,1939,14,na,1953,3726.5761735717106
STAT,1886,27,15-19,1913,0.45275447857556705
SIM,1842,34,25-29,1876,11
SIM,1880,82,na,1962,712
STAT,1877,23,40-44,1900,2.035686716410611
SIM,1779,87,na,1866,46
STAT,1847,47,30-34,1894,0.07104823907737802
STAT,1916,36,35-39,1952,2.3512089429615055
STAT,1824,34,15-19,1858,0.2679085874832427
SIM,1809,47,na,1856,1298
SIM,1825,49,45-49,1874,3
SIM,1865,37,30-34,1902,4
SIM,1836,49,na,1885,1437
SIM,1875,37,40-44,1912,5
STAT,1865,41,na,1906,1987.9911119420124
STAT,1926,36,45-49,1962,0.7877668383901797
SIM,1833,22,15-19,1855,2
STAT,1819,36,15-19,1855,0.17270312376299946
STAT,1874,28,35-39,1902,9.280588467732157
STAT,1924,15,na,1939,4159.897091372652
SIM,1852,20,25-29,1872,44
SIM,1785,94,na,1879,2
STAT,1908,22,na,1930,3314.360783467213
STAT,1850,28,30-34,1878,20.739755471026005
STAT,1900,18,45-49,1918,0.08538114842449368
SIM,1911,23,45-49,1934,4
SIM,1864,26,25-29,1890,46
SIM,1866,56,na,1922,1804
SIM,1904,24,15-19,1928,4
SIM,1914,24,25-29,1938,98
SIM,1909,37,na,1946,3403
STAT,1843,53,na,1896,1430.9988602533253
STAT,1905,36,25-29,1941,0.8526699831152502
SIM,1851,16,na,1867,2077
STAT,1911,18,20-24,1929,25.56327118159435
SIM,1888,25,50-100,1913,3
SIM,1826,50,na,1876,1308
STAT,1866,24,50-100,1890,0.35309213410229634
STAT,1847,97,na,1944,3.9615303640619244
STAT,1864,32,45-49,1896,1.4682490797317616
STAT,1881,21,40-44,1902,1.9074388822642718
STAT,1889,36,30-34,1925,6.245562253020092
STAT,1879,36,20-24,1915,0.7659406579186538
STAT,1933,21,15-19,1954,6.690554560460376
SIM,1888,24,20-24,1912,76
STAT,1806,49,35-39,1855,0.5000055233667883
STAT,1892,39,40-44,1931,5.12755038203208
SIM,1866,15,na,1881,2321
STAT,1951,17,na,1968,4140.681473387773
SIM,1905,6,na,1911,3521
SIM,1770,95,na,1865,4
SIM,1891,27,30-34,1918,30
STAT,1883,5,na,1888,2451.551298738241
SIM,1863,20,35-39,1883,8
SIM,1929,25,30-34,1954,60
SIM,1872,28,25-29,1900,36
SIM,1873,20,45-49,1893,3
SIM,1941,21,15-19,1962,5
STAT,1909,48,na,1957,3180.3798841774374
STAT,1875,28,35-39,1903,9.336271327931783
STAT,1886,26,na,1912,2389.709142647019
SIM,1919,20,45-49,1939,1
STAT,1825,48,40-44,1873,0.17223785033210753
STAT,1828,49,20-24,1877,0.009463285424866156
SIM,1847,42,na,1889,1723
STAT,1938,28,35-39,1966,14.044874129374687
STAT,1892,33,na,1925,2811.6876927745916
SIM,1834,36,40-44,1870,4
SIM,1883,35,50-100,1918,1
SIM,1909,20,35-39,1929,8
STAT,1846,26,15-19,1872,0.41004152062063004
SIM,1844,22,40-44,1866,2
STAT,1856,26,25-29,1882,32.542693117157
SIM,1890,27,30-34,1917,39
SIM,1880,27,20-24,1907,8
STAT,1941,22,50-100,1963,0.6423783373164068
STAT,1940,9,na,1949,3802.7401959577032
SIM,1904,38,na,1942,3275
STAT,1903,23,45-49,1926,0.9344100849928729
SIM,1849,36,35-39,1885,11
STAT,1889,29,40-44,1918,3.4686216191844346
STAT,1906,24,25-29,1930,78.27137581294245
STAT,1879,29,30-34,1908,24.72372850436819
SIM,1948,23,25-29,1971,104
SIM,1824,36,30-34,1860,1
SIM,1922,5,na,1927,4359
STAT,1883,59,na,1942,1800.0624741207146
STAT,1862,67,na,1929,1280.4098239904645
STAT,1866,16,40-44,1882,0.16454680497567642
STAT,1943,29,20-24,1972,18.347217257274092
SIM,1926,16,15-19,1942,49
STAT,1810,47,35-39,1857,0.46719592315169584
STAT,1838,35,20-24,1873,0.637574259710075
STAT,1856,16,30-34,1872,1.3973615859976356
STAT,1915,55,na,1970,3387.5112218005943
SIM,1891,34,20-24,1925,3
SIM,1893,48,na,1941,2788
STAT,1914,30,45-49,1944,1.5084258745077443
STAT,1848,35,30-34,1883,4.16668824519305
STAT,1810,54,50-100,1864,0.04628116454268685
STAT,1854,49,15-19,1903,2.8021826089316026E-4
STAT,1875,35,50-100,1910,1.2034782897358236
SIM,1869,22,45-49,1891,1
SIM,1840,39,35-39,1879,12
STAT,1857,33,15-19,1890,0.10565465063242323
SIM,1859,22,35-39,1881,4
STAT,1890,52,na,1942,2473.6641728535665
SIM,1898,36,30-34,1934,5
STAT,1832,39,35-39,1871,5.2899646539330565
SIM,1849,23,na,1872,1939
SIM,1861,57,na,1918,1737
SIM,1933,23,30-34,1956,34
SIM,1885,23,40-44,1908,3
SIM,1883,48,na,1931,2033
STAT,1875,85,na,1960,388.67602471597394
SIM,1896,15,15-19,1911,8
SIM,1897,29,40-44,1926,3
SIM,1887,29,30-34,1916,31
STAT,1882,27,30-34,1909,23.134998176108397
STAT,1941,16,40-44,1957,1.3614008752218667
SIM,1898,47,na,1945,2806
STAT,1918,49,15-19,1967,3.6815683731371464E-4
STAT,1931,26,25-29,1957,80.31187753490298
SIM,1822,36,na,1858,1555
SIM,1934,36,45-49,1970,1
STAT,1896,44,50-100,1940,0.09029740912787848
SIM,1842,27,35-39,1869,8
STAT,1839,48,35-39,1887,0.09376174527834868
STAT,1851,45,30-34,1896,0.07032660368886237
SIM,1944,22,45-49,1966,2
STAT,1817,91,na,1908,26.820679835913563
STAT,1916,43,25-29,1959,0.06902211828812596
STAT,1812,108,na,1920,7.956777755648832E-4
SIM,1906,8,na,1914,3562
SIM,1933,30,20-24,1963,4
STAT,1834,27,35-39,1861,7.85206916595697
STAT,1799,64,na,1863,809.0868124805972
STAT,1839,30,45-49,1869,1.4587684887303745
STAT,1829,27,na,1856,1705.849776053836
SIM,1924,36,35-39,1960,4
STAT,1829,30,35-39,1859,10.684368177716877
SIM,1922,30,45-49,1952,2
SIM,1856,35,30-34,1891,3
STAT,1880,18,15-19,1898,5.894940688698021
STAT,1896,21,35-39,1917,7.302825023310126
STAT,1947,22,20-24,1969,118.72401891543112
STAT,1864,102,na,1966,1.3488058673212242
SIM,1905,38,40-44,1943,2
STAT,1925,30,20-24,1955,2.739322078228312
STAT,1860,86,na,1946,170.0702416164171
STAT,1888,2,na,1890,2976.0712827418524
SIM,1879,37,25-29,1916,2
STAT,1915,29,45-49,1944,1.6528059099771255
STAT,1839,27,na,1866,1814.456671750371
STAT,1864,25,20-24,1889,9.983126961356781
SIM,1810,55,na,1865,1100
SIM,1846,28,30-34,1874,30
STAT,1898,45,20-24,1943,0.008739894714814275
SIM,1867,31,25-29,1898,18
STAT,1884,47,35-39,1931,0.13005573396603062
STAT,1873,44,50-100,1917,0.9985390168303413
STAT,1844,24,40-44,1868,1.7811364371893992
STAT,1929,14,na,1943,4761.380093193217
STAT,1824,38,30-34,1862,7.945015506396725
SIM,1934,18,15-19,1952,54
STAT,1876,26,na,1902,2337.251534837845
STAT,1888,30,40-44,1918,4.880637826908014
SIM,1900,24,30-34,1924,23
STAT,1864,45,na,1909,1913.1878299426517
SIM,1903,17,25-29,1920,9
STAT,1769,98,na,1867,0.43144093424435714
STAT,1880,29,20-24,1909,11.600255291278248
STAT,1857,47,25-29,1904,0.042715438446700886
SIM,1861,16,na,1877,2275
SIM,1832,38,30-34,1870,6
STAT,1851,38,40-44,1889,3.1497704191368174
STAT,1901,36,40-44,1937,1.2554222407173867
SIM,1850,26,30-34,1876,30
SIM,1847,30,45-49,1877,1
STAT,1840,20,40-44,1860,1.7643174854916885
SIM,1854,44,45-49,1898,2
STAT,1929,41,45-49,1970,0.20389830093122074
SIM,1831,27,25-29,1858,29
SIM,1852,24,40-44,1876,2
STAT,1871,16,15-19,1887,5.636188825637976
SIM,1910,45,na,1955,3248
STAT,1848,17,35-39,1865,0.5054327055027279
STAT,1904,26,15-19,1930,0.616902336034295
STAT,1907,26,na,1933,3323.2097230177105
SIM,1881,44,50-100,1925,1
STAT,1856,71,na,1927,983.8518984858785
STAT,1917,9,na,1926,4033.7225398519126
STAT,1926,18,15-19,1944,52.42565603873872
SIM,1896,30,40-44,1926,7
STAT,1824,80,na,1904,341.0858684259561
SIM,1923,29,45-49,1952,1
STAT,1890,8,na,1898,3002.3870431567225
STAT,1903,49,20-24,1952,0.008908594941598394
STAT,1819,54,50-100,1873,0.026392644724845427
STAT,1879,46,15-19,1925,3.966719820465132E-4
STAT,1906,41,na,1947,3205.4646626334747
STAT,1841,15,25-29,1856,5.098513758400642
STAT,1887,73,na,1960,1406.2253351913803
STAT,1846,37,20-24,1883,0.5970587884491048
SIM,1886,33,35-39,1919,7
STAT,1797,86,na,1883,72.86856604147563
SIM,1882,63,na,1945,1665
STAT,1863,18,50-100,1881,0.04192614774742203
SIM,1830,65,na,1895,995
SIM,1856,17,35-39,1873,1
STAT,1905,42,50-100,1947,0.10005232165854036
STAT,1849,78,na,1927,585.8963949250424
SIM,1860,31,na,1891,1985
SIM,1922,23,20-24,1945,127
SIM,1939,21,25-29,1960,95
SIM,1823,36,30-34,1859,4
STAT,1918,16,15-19,1934,9.385478743306793
STAT,1861,27,45-49,1888,0.8784650303738463
STAT,1878,33,35-39,1911,9.928230416467544
STAT,1868,29,20-24,1897,10.498476392368037
STAT,1890,18,25-29,1908,6.527730070181011
SIM,1837,41,40-44,1878,5
SIM,1897,36,30-34,1933,13
STAT,1872,16,15-19,1888,5.67537089618588
SIM,1880,16,15-19,1896,4
SIM,1944,15,20-24,1959,134
SIM,1885,81,na,1966,754
STAT,1950,21,50-100,1971,0.7376804907021934
STAT,1883,27,30-34,1910,23.323812163440156
STAT,1838,28,30-34,1866,21.3511875640492
STAT,1850,24,15-19,1874,2.7513195993437334
STAT,1936,15,20-24,1951,123.18695789320131
STAT,1836,22,40-44,1858,1.780895141543908
STAT,1892,49,35-39,1941,0.09149221690115843
STAT,1852,15,35-39,1867,0.48685019797320994
SIM,1940,11,na,1951,3712
STAT,1914,23,20-24,1937,106.99042752826662
SIM,1838,29,35-39,1867,14
SIM,1843,83,na,1926,240
SIM,1926,34,45-49,1960,1
SIM,1918,25,20-24,1943,19
STAT,1917,21,30-34,1938,28.944647533970556
STAT,1913,38,25-29,1951,0.9134114223167102
STAT,1816,61,na,1877,1056.874573783233
SIM,1845,32,35-39,1877,12
STAT,1893,16,35-39,1909,0.6589832376567496
STAT,1854,0,na,1854,2880.0451149696573
STAT,1945,21,na,1966,3782.2113049030145
STAT,1849,42,20-24,1891,0.11894219315540504
SIM,1856,7,na,1863,2323
STAT,1842,33,20-24,1875,2.3402897434980945
SIM,1901,19,15-19,1920,5
SIM,1929,32,20-24,1961,3
STAT,1934,35,40-44,1969,1.9549230271068523
SIM,1878,42,40-44,1920,8
STAT,1843,39,45-49,1882,1.4010401456931314
SIM,1872,18,30-34,1890,1
SIM,1834,25,35-39,1859,9
SIM,1899,20,15-19,1919,5
STAT,1842,26,30-34,1868,22.714987912113223
SIM,1874,34,na,1908,2203
SIM,1850,33,20-24,1883,1
SIM,1888,31,45-49,1919,3
SIM,1921,38,25-29,1959,4
STAT,1866,26,na,1892,2086.5646280712117
STAT,1837,32,35-39,1869,8.240581420067265
STAT,1923,28,40-44,1951,5.037573661285116
STAT,1867,8,na,1875,2447.1740197234008
SIM,1906,15,35-39,1921,2
STAT,1864,18,30-34,1882,1.3800852340676277
SIM,1931,28,40-44,1959,6
STAT,1782,87,na,1869,47.61714227769266
SIM,1937,23,15-19,1960,4
STAT,1865,39,30-34,1904,4.517607236301229
SIM,1872,25,20-24,1897,9
STAT,1897,27,25-29,1924,53.4428698115534
STAT,1849,35,30-34,1884,4.175271351001107
STAT,1823,34,15-19,1857,0.2836752050886982
STAT,1948,22,20-24,1970,120.61591944835897
SIM,1896,22,na,1918,2955
STAT,1918,34,45-49,1952,1.5661537797988567
STAT,1885,25,40-44,1910,2.839890404667951
STAT,1854,28,15-19,1882,0.33786144482651176
SIM,1874,26,35-39,1900,9
SIM,1883,35,25-29,1918,2
SIM,1846,49,na,1895,1575
SIM,1925,21,30-34,1946,44
SIM,1867,24,35-39,1891,5
SIM,1873,39,30-34,1912,8
STAT,1859,31,25-29,1890,7.732789562911483
STAT,1852,22,25-29,1874,49.30276888405786
STAT,1875,35,25-29,1910,2.8222942115356617
STAT,1879,44,na,1923,2254.6727770493053
STAT,1940,20,45-49,1960,1.0835594615415567
STAT,1894,11,na,1905,3139.972378553195
STAT,1903,16,20-24,1919,23.888371906809283
SIM,1858,82,na,1940,332
STAT,1907,31,15-19,1938,0.11393890487637501
SIM,1860,22,25-29,1882,50
SIM,1911,16,20-24,1927,27
STAT,1869,21,40-44,1890,1.9128375046537642
SIM,1848,26,40-44,1874,5
STAT,1839,45,15-19,1884,2.7838732059282687E-4
STAT,1833,24,30-34,1857,14.484542626126524
STAT,1845,26,15-19,1871,0.39360487025563956
STAT,1911,25,45-49,1936,1.6024706792409291
SIM,1841,24,30-34,1865,16
SIM,1927,22,na,1949,4194
STAT,1850,50,30-34,1900,0.004256390931078994
SIM,1838,36,25-29,1874,1
STAT,1903,23,na,1926,3169.1623428032744
SIM,1826,34,40-44,1860,3
STAT,1848,93,na,1941,21.716163311362816
STAT,1890,25,15-19,1915,0.5275659866701479
STAT,1933,17,45-49,1950,0.6317230665881338
SIM,1870,31,na,1901,2202
STAT,1942,26,35-39,1968,14.892918523338803
STAT,1841,72,na,1913,870.6548064713398
STAT,1868,39,15-19,1907,0.05010505930732844
SIM,1851,39,45-49,1890,1
STAT,1860,16,45-49,1876,0.058089287400180975
STAT,1810,69,na,1879,700.8414222559384
STAT,1841,35,20-24,1876,0.6392709847262557
STAT,1925,45,na,1970,4225.222817146481
SIM,1889,29,35-39,1918,14
SIM,1901,63,na,1964,2545
SIM,1859,67,na,1926,1243
SIM,1867,86,na,1953,189
STAT,1815,43,25-29,1858,1.5584944599516148
STAT,1910,48,15-19,1958,3.2378937966057685E-4
STAT,1849,39,40-44,1888,3.289879240744617
SIM,1954,17,15-19,1971,44
STAT,1861,34,35-39,1895,7.8865753533551946
SIM,1863,72,na,1935,1006
STAT,1847,14,na,1861,2177.2058317808323
STAT,1877,41,35-39,1918,1.7825082667990508
STAT,1855,45,20-24,1900,0.008612536182820313
SIM,1892,7,na,1899,3419
STAT,1814,59,na,1873,1138.8266153761556
STAT,1865,27,50-100,1892,0.5477469578550626
STAT,1886,47,45-49,1933,0.2344089070585848
SIM,1813,41,45-49,1854,2
STAT,1864,35,15-19,1899,0.047729585648347374
STAT,1921,31,na,1952,3992.304964251702
SIM,1866,24,35-39,1890,5
STAT,1835,24,40-44,1859,1.7377433764566264
SIM,1843,24,40-44,1867,2
SIM,1907,22,25-29,1929,78
SIM,1892,61,na,1953,2479
STAT,1872,32,45-49,1904,1.652406249612784
STAT,1890,44,50-100,1934,1.2036958693842639
STAT,1832,40,20-24,1872,0.12053276779322816
STAT,1845,26,20-24,1871,10.177497277863923
SIM,1880,32,45-49,1912,4
STAT,1946,17,15-19,1963,47.553201811012556
SIM,1848,44,40-44,1892,5
SIM,1857,39,40-44,1896,4
STAT,1885,18,45-49,1903,0.06134935922807279
SIM,1862,19,25-29,1881,6
STAT,1856,50,na,1906,1609.8587086855152
STAT,1798,71,na,1869,614.6424558407502
SIM,1885,41,35-39,1926,3
STAT,1853,20,50-100,1873,0.36993385308100873
STAT,1839,70,na,1909,934.1643373986534
STAT,1882,34,25-29,1916,9.329472970252954
SIM,1839,35,30-34,1874,4
STAT,1936,31,40-44,1967,3.592829610846208
STAT,1877,52,45-49,1929,0.01414551054153265
STAT,1850,44,30-34,1894,0.7994887649274827
STAT,1945,24,45-49,1969,1.1641782547671828
STAT,1882,23,15-19,1905,3.0214986897912333
STAT,1884,31,25-29,1915,9.598701521555205
SIM,1848,33,30-34,1881,18
SIM,1892,26,50-100,1918,3
SIM,1922,33,na,1955,3983
SIM,1818,101,na,1919,1
STAT,1946,15,na,1961,3858.790294341493
SIM,1933,29,50-100,1962,2
STAT,1892,41,30-34,1933,1.3665005368331713
STAT,1872,13,na,1885,2482.6692743902627
STAT,1896,49,25-29,1945,0.039692373871606845
SIM,1909,30,35-39,1939,13
STAT,1912,27,50-100,1939,0.9266609676502022
STAT,1861,42,40-44,1903,1.7646020617175149
STAT,1824,38,25-29,1862,4.292134790239452
STAT,1875,44,35-39,1919,1.7345926398406935
SIM,1890,34,25-29,1924,19
STAT,1858,24,35-39,1882,4.448256394822181
SIM,1832,38,25-29,1870,4
STAT,1856,16,25-29,1872,4.968078582198556
STAT,1817,40,25-29,1857,1.7657132389191401
STAT,1826,46,35-39,1872,0.13102544338092828
STAT,1926,15,50-100,1941,0.43594588728798706
STAT,1836,53,40-44,1889,0.006762691434209319
STAT,1810,45,na,1855,1270.7553510118412
STAT,1852,41,30-34,1893,0.8372650323450889
STAT,1823,95,na,1918,7.115521465336089
SIM,1888,56,na,1944,2318
STAT,1833,27,40-44,1860,2.4225687858210727
SIM,1854,36,na,1890,1873
SIM,1857,37,45-49,1894,1
STAT,1866,35,25-29,1901,2.5325313661015585
SIM,1821,41,na,1862,1444
SIM,1864,16,25-29,1880,8
SIM,1883,44,35-39,1927,2
STAT,1808,53,35-39,1861,0.03048189900581552
SIM,1841,27,40-44,1868,3
SIM,1874,35,25-29,1909,4
SIM,1891,32,20-24,1923,7
STAT,1893,37,35-39,1930,8.473555530297574
SIM,1858,42,50-100,1900,1
STAT,1820,41,40-44,1861,4.2644276463846325
STAT,1851,23,40-44,1874,1.7772137111410526
STAT,1874,28,40-44,1902,2.8812106914373232
STAT,1893,40,35-39,1933,2.191295068441151
SIM,1890,23,15-19,1913,1
SIM,1836,29,25-29,1865,40
STAT,1844,57,na,1901,1395.7363296248452
SIM,1809,92,na,1901,16
STAT,1832,48,30-34,1880,0.06828787863040019
STAT,1879,37,30-34,1916,5.270276611001576
STAT,1831,28,15-19,1859,0.3800151138808152
STAT,1880,39,20-24,1919,0.759988567165795
STAT,1869,47,15-19,1916,3.6436880910693277E-4
STAT,1838,45,15-19,1883,2.8345015405031496E-4
SIM,1855,29,35-39,1884,7
STAT,1843,30,25-29,1873,8.491697390265914
STAT,1889,77,na,1966,1351.316926082001
SIM,1806,52,na,1858,1204
STAT,1883,32,20-24,1915,2.5036091421379805
SIM,1855,23,20-24,1878,71
STAT,1834,26,45-49,1860,0.9100726745092452
STAT,1841,33,25-29,1874,8.47905105637219
STAT,1871,79,na,1950,655.8112707408866
SIM,1935,20,35-39,1955,16
STAT,1833,47,35-39,1880,0.1006187606122186
SIM,1943,19,na,1962,3596
SIM,1869,77,na,1946,744
STAT,1919,34,45-49,1953,1.590081364342848
STAT,1931,39,45-49,1970,0.8510843721600089
SIM,1838,26,25-29,1864,44
STAT,1849,54,35-39,1903,0.006278131680162747
SIM,1872,38,25-29,1910,2
STAT,1927,36,na,1963,4422.7925413498415
STAT,1853,20,40-44,1873,1.8903618517129577
STAT,1864,38,25-29,1902,2.412178734024687
STAT,1847,29,35-39,1876,8.429727660593251
STAT,1889,21,na,1910,2766.5768355094788
STAT,1831,31,15-19,1862,0.11512096121687461
STAT,1813,48,20-24,1861,0.0322741698254187
STAT,1841,22,15-19,1863,2.88119484623902
STAT,1899,25,35-39,1924,12.574332434322319
STAT,1877,44,na,1921,2234.2925167990584
STAT,1904,20,40-44,1924,2.8405261752882653
SIM,1872,26,30-34,1898,26
SIM,1908,31,30-34,1939,17
STAT,1896,18,20-24,1914,22.061677082853468
STAT,1897,72,na,1969,1950.426505462619
STAT,1881,89,na,1970,283.371178106887
STAT,1864,26,30-34,1890,21.275210232811514
SIM,1882,28,40-44,1910,3
STAT,1845,46,45-49,1891,0.16747455145958168
SIM,1811,44,45-49,1855,2
STAT,1870,35,45-49,1905,1.865032103477124
STAT,1882,36,20-24,1918,0.7115992763121113
STAT,1836,23,45-49,1859,0.5916761883438586
STAT,1887,43,15-19,1930,0.014487216210793758
STAT,1898,26,30-34,1924,32.30351238543299
STAT,1828,29,25-29,1857,51.80303487825523
STAT,1866,51,30-34,1917,0.0052113991060983335
STAT,1823,104,na,1927,0.03569660446470062
SIM,1853,26,20-24,1879,11
STAT,1881,35,20-24,1916,0.7101627564178822
STAT,1821,40,45-49,1861,2.7314663166458475
SIM,1912,20,40-44,1932,5
STAT,1920,49,40-44,1969,0.16367674393695422
STAT,1847,23,20-24,1870,61.84887622290199
STAT,1880,26,15-19,1906,0.4534088344581718
SIM,1919,21,35-39,1940,12
SIM,1861,20,40-44,1881,4
STAT,1815,45,20-24,1860,0.027841353667114037
STAT,1829,27,20-24,1856,16.859371737361904
STAT,1871,33,40-44,1904,4.05098601150227
SIM,1837,27,20-24,1864,13
SIM,1851,30,25-29,1881,14
SIM,1889,34,30-34,1923,30
STAT,1909,47,50-100,1956,0.19634827184259263
SIM,1873,82,na,1955,359
SIM,1929,23,15-19,1952,10
STAT,1897,17,25-29,1914,7.159244877769032
SIM,1905,53,na,1958,2886
STAT,1868,44,50-100,1912,0.9393713341180702
STAT,1879,15,50-100,1894,0.048671846321231615
STAT,1931,41,na,1972,4693.80033153334
STAT,1889,40,15-19,1929,0.01626829408219768
STAT,1865,39,25-29,1904,2.440546424604773
STAT,1934,29,50-100,1963,1.26368034844663
STAT,1884,14,na,1898,2402.506177317054
SIM,1858,38,45-49,1896,1
SIM,1855,61,na,1916,1475
STAT,1920,38,30-34,1958,1.8832221254319939
STAT,1874,25,30-34,1899,24.47105989668298
STAT,1761,94,na,1855,4.89744
STAT,1857,25,30-34,1882,19.60573257412628
SIM,1867,94,na,1961,36
STAT,1878,17,15-19,1895,5.84268748907922
SIM,1785,73,na,1858,436
STAT,1899,42,25-29,1941,0.0576498491214214
STAT,1891,45,30-34,1936,0.06445551819570104
SIM,1873,36,20-24,1909,1
STAT,1847,53,50-100,1900,0.010958062349111706
SIM,1912,47,na,1959,3292
STAT,1772,86,na,1858,57.91244890809421
STAT,1839,48,40-44,1887,0.11465721967596797
SIM,1850,31,20-24,1881,2
STAT,1903,49,40-44,1952,0.12709594956089548
SIM,1877,27,20-24,1904,9
SIM,1834,99,na,1933,1
SIM,1812,42,40-44,1854,7
STAT,1867,47,35-39,1914,0.12361194338644602
STAT,1814,44,20-24,1858,0.5114684217542604
STAT,1839,49,25-29,1888,0.03808518472875995
SIM,1830,85,na,1915,139
SIM,1926,15,na,1941,4236
STAT,1874,45,30-34,1919,0.09436511854188266
STAT,1878,50,40-44,1928,0.010513632721002834
STAT,1917,31,30-34,1948,15.649543646824416
STAT,1809,54,35-39,1863,0.022228058211600694
STAT,1843,49,45-49,1892,0.15607715735578964
STAT,1851,52,25-29,1903,0.0025343581365540194
STAT,1827,77,na,1904,499.30032511314477
SIM,1789,87,na,1876,43
SIM,1888,48,na,1936,2518
STAT,1867,50,35-39,1917,0.0077466530515656095
STAT,1814,45,50-100,1859,0.7767350005181014
STAT,1825,33,40-44,1858,6.882529571086331
STAT,1886,18,50-100,1904,0.04876141429441348
STAT,1828,33,50-100,1861,0.9167538653535185
STAT,1862,41,45-49,1903,1.2143338345413817
STAT,1871,36,45-49,1907,1.879035237384927
STAT,1834,43,35-39,1877,1.3375275375493985
SIM,1949,15,40-44,1964,1
SIM,1848,47,50-100,1895,4
SIM,1933,17,na,1950,4731
STAT,1825,51,50-100,1876,0.015145184449077368
SIM,1887,37,30-34,1924,5
SIM,1888,17,25-29,1905,6
SIM,1909,35,na,1944,3445
SIM,1833,33,40-44,1866,8
STAT,1834,28,40-44,1862,2.4202160483385438
STAT,1876,45,35-39,1921,0.1380029209093409
STAT,1873,19,35-39,1892,0.5229068087672619
SIM,1922,25,na,1947,3977
SIM,1865,25,30-34,1890,21
SIM,1934,21,30-34,1955,41
STAT,1845,46,15-19,1891,2.8385493304930584E-4
STAT,1935,31,na,1966,4945.90031669247
STAT,1865,36,20-24,1901,0.6632286974414995
SIM,1913,40,na,1953,3332
STAT,1807,54,30-34,1861,0.02094981933961112
STAT,1876,25,40-44,1901,2.94351997966382
SIM,1843,44,35-39,1887,6
STAT,1849,37,45-49,1886,1.529628813046
STAT,1905,49,45-49,1954,0.1779841837195746
SIM,1946,23,15-19,1969,5
STAT,1890,28,25-29,1918,48.68471953630324
SIM,1811,46,50-100,1857,2
SIM,1810,97,na,1907,2
SIM,1856,38,40-44,1894,5
STAT,1868,31,40-44,1899,3.9248393157437174
SIM,1821,35,45-49,1856,6
STAT,1860,18,40-44,1878,0.16073966942299542
SIM,1883,24,40-44,1907,4
STAT,1884,19,40-44,1903,0.16979174557479357
STAT,1927,20,35-39,1947,11.024500884881146
STAT,1938,0,na,1938,4198.343485040315
STAT,1881,57,na,1938,1834.0023134830217
SIM,1821,49,na,1870,1306
STAT,1850,28,50-100,1878,0.5268491993295064
SIM,1892,53,na,1945,2808
SIM,1831,37,25-29,1868,2
SIM,1884,25,40-44,1909,3
STAT,1809,80,na,1889,268.13856091667503
STAT,1886,27,20-24,1913,11.706937137873254
STAT,1928,21,35-39,1949,11.139308236129375
SIM,1833,22,30-34,1855,22
SIM,1927,34,45-49,1961,2
STAT,1851,43,35-39,1894,1.2931864800885151
SIM,1894,27,20-24,1921,17
STAT,1938,23,15-19,1961,4.975429724888527
STAT,1926,21,30-34,1947,33.08473738666146
STAT,1823,37,25-29,1860,4.685166112547379
STAT,1903,38,30-34,1941,1.5385661894586324
SIM,1936,21,35-39,1957,7
STAT,1881,22,15-19,1903,3.0107107734244667
STAT,1897,24,50-100,1921,0.5119700061619173
SIM,1876,79,na,1955,621
STAT,1819,36,20-24,1855,2.370742582469814
SIM,1911,38,30-34,1949,3
STAT,1869,30,50-100,1899,0.8452785531668386
STAT,1800,59,na,1859,993.5757689778251
STAT,1881,19,15-19,1900,5.38686520096709
STAT,1877,24,45-49,1901,0.6790518097989828
STAT,1885,46,45-49,1931,0.22285882886471006
STAT,1886,47,15-19,1933,3.973028978992899E-4
SIM,1842,28,40-44,1870,2
STAT,1850,28,25-29,1878,34.839354213033616
STAT,1844,17,45-49,1861,0.05767054251924759
SIM,1858,26,na,1884,2025
STAT,1835,44,35-39,1879,1.3460167630669826
SIM,1862,31,na,1893,2033
SIM,1868,30,50-100,1898,3
SIM,1878,28,20-24,1906,10
STAT,1846,100,na,1946,0.7874261672207611
STAT,1855,42,50-100,1897,0.7498186080531855
STAT,1861,17,45-49,1878,0.058974897135006185
STAT,1830,35,45-49,1865,1.6649521829054401
STAT,1880,26,45-49,1906,1.1095843649103303
STAT,1826,52,na,1878,1291.108287918251
STAT,1883,15,30-34,1898,1.4831221199174378
SIM,1854,44,na,1898,1832
STAT,1882,30,50-100,1912,0.84853512411452
SIM,1872,33,na,1905,2240
STAT,1847,51,20-24,1898,5.467506360982577E-4
STAT,1858,24,50-100,1882,0.3108495398644921
STAT,1879,50,50-100,1929,0.015149322132972032
SIM,1829,69,na,1898,868
STAT,1825,53,35-39,1878,0.008296877801513489
STAT,1782,110,na,1892,6.695382020863804E-4
STAT,1851,59,na,1910,1398.017252596229
SIM,1809,49,na,1858,1258
STAT,1841,54,50-100,1895,0.010125692031680568
STAT,1943,21,30-34,1964,28.896991610983434
SIM,1879,27,25-29,1906,47
STAT,1923,33,50-100,1956,0.8948513733277437
STAT,1856,46,20-24,1902,0.008870046331105837
STAT,1891,29,25-29,1920,49.08774215043328
STAT,1848,50,25-29,1898,0.002669742913577405
STAT,1944,20,35-39,1964,9.610785918421577
SIM,1869,38,50-100,1907,4
SIM,1880,84,na,1964,575
STAT,1840,67,na,1907,1040.3113401190567
STAT,1937,21,50-100,1958,0.605523383600974
SIM,1868,37,20-24,1905,2
STAT,1885,31,na,1916,2256.2373446335027
STAT,1850,27,40-44,1877,2.4849817986798683
STAT,1856,44,25-29,1900,0.466930765614078
STAT,1872,29,15-19,1901,0.42684550225494183
SIM,1842,43,35-39,1885,3
STAT,1901,11,na,1912,3420.055748735815
SIM,1867,62,na,1929,1765
STAT,1871,19,25-29,1890,5.287293435426941
STAT,1892,44,35-39,1936,0.14678134998636394
STAT,1854,19,25-29,1873,4.793134749317956
STAT,1950,20,na,1970,4095.513482300531
STAT,1838,36,30-34,1874,4.362593380196923
STAT,1870,52,35-39,1922,0.007936068882343288
STAT,1909,21,25-29,1930,81.34933087963026
STAT,1840,37,25-29,1877,2.234810530211927
STAT,1905,25,na,1930,3280.89276716788
SIM,1870,41,45-49,1911,1
STAT,1889,39,40-44,1928,5.053901532556983
STAT,1900,20,50-100,1920,0.5375997547019947
STAT,1830,65,na,1895,1019.9698027567631
STAT,1879,49,25-29,1928,0.055769833083453624
STAT,1843,18,40-44,1861,0.1569473418836033
SIM,1884,66,na,1950,1583
STAT,1872,32,15-19,1904,0.13494227297302044
STAT,1896,23,na,1919,2941.718626385487
SIM,1813,54,na,1867,1173
SIM,1913,1,na,1914,3813
STAT,1895,37,15-19,1932,0.06915988522425433
SIM,1939,30,20-24,1969,2
SIM,1870,30,35-39,1900,13
STAT,1918,1,na,1919,4294.07940455681
SIM,1846,36,30-34,1882,8
STAT,1866,34,40-44,1900,3.746322046054958
STAT,1824,54,30-34,1878,0.006713103079297446
STAT,1897,64,na,1961,2332.4328099215572
SIM,1899,39,45-49,1938,3
SIM,1897,39,40-44,1936,2
SIM,1874,34,40-44,1908,5
STAT,1828,46,15-19,1874,3.281924343646803E-4
SIM,1937,17,15-19,1954,35
STAT,1902,42,50-100,1944,0.09768835454091433
STAT,1805,98,na,1903,1.1339893643822698
STAT,1832,43,25-29,1875,0.4687785215991181
STAT,1855,48,25-29,1903,0.04041778310267527
SIM,1863,36,30-34,1899,7
STAT,1883,80,na,1963,803.4344603615393
STAT,1916,22,25-29,1938,91.43750198094928
STAT,1940,29,45-49,1969,1.6626094870504173
SIM,1847,16,25-29,1863,5
SIM,1939,25,25-29,1964,59
STAT,1771,109,na,1880,0.0022299663071556333
STAT,1882,31,20-24,1913,2.4934901013250195
STAT,1848,109,na,1957,7.284529069564376E-4
STAT,1894,41,35-39,1935,2.2083648185832616
STAT,1813,105,na,1918,0.012066824262307606
STAT,1940,31,50-100,1971,0.8088395653237891
SIM,1912,55,na,1967,3206
SIM,1930,12,na,1942,4874
STAT,1857,33,30-34,1890,12.953658267071248
SIM,1881,16,25-29,1897,4
SIM,1945,10,na,1955,3889
STAT,1918,43,na,1961,3724.4732954113892
STAT,1939,13,na,1952,3732.8847487971775
STAT,1846,42,45-49,1888,1.123502242295017
STAT,1884,47,50-100,1931,0.2281549154647752
STAT,1961,2,na,1963,4801.78792548255
STAT,1834,40,25-29,1874,0.49290402445090703
STAT,1762,112,na,1874,3.618011608750378E-4
STAT,1897,32,na,1929,3014.823337770715
STAT,1862,11,na,1873,2218.4587261927577
STAT,1839,16,25-29,1855,4.964740734619207
STAT,1839,78,na,1917,520.2099405191543
STAT,1883,18,40-44,1901,0.16896341057459618
SIM,1856,70,na,1926,1127
STAT,1835,52,40-44,1887,0.006828525843588937
STAT,1794,65,na,1859,792.5680872330477
STAT,1918,49,30-34,1967,0.0890940297026835
SIM,1834,30,25-29,1864,20
SIM,1890,31,20-24,1921,6
STAT,1898,43,20-24,1941,0.013996951884670686
SIM,1862,16,20-24,1878,14
STAT,1849,51,30-34,1900,0.004484983154989744
STAT,1818,65,na,1883,903.2969486919269
STAT,1858,41,25-29,1899,0.47778594838835714
STAT,1890,49,30-34,1939,0.06174815348474755
SIM,1873,34,25-29,1907,12
SIM,1843,27,45-49,1870,2
SIM,1843,84,na,1927,202
STAT,1775,106,na,1881,0.011731518523392496
STAT,1878,29,50-100,1907,0.625289104798774
STAT,1833,44,30-34,1877,0.8331042413229097
STAT,1827,50,35-39,1877,0.007910407442584918
STAT,1830,97,na,1927,3.2423943457032056
STAT,1858,5,na,1863,2175.6249152990154
STAT,1888,44,15-19,1932,0.015209846113444248
STAT,1863,52,na,1915,1775.510708036781
STAT,1855,36,30-34,1891,3.805568831272455
STAT,1919,31,40-44,1950,4.004825795309367
STAT,1874,29,25-29,1903,40.538499401782865
SIM,1895,58,na,1953,2510
STAT,1788,93,na,1881,6.2504218443225765
STAT,1815,40,20-24,1855,0.44708092468133
SIM,1854,42,45-49,1896,5
SIM,1947,3,na,1950,4178
STAT,1860,30,25-29,1890,7.914163217334868
STAT,1822,38,20-24,1860,1.284939067828776
SIM,1870,26,20-24,1896,17
STAT,1778,104,na,1882,0.03028605979287641
STAT,1862,43,40-44,1905,1.8036577589339475
STAT,1830,48,50-100,1878,0.18166869811449363
STAT,1862,26,20-24,1888,9.579422812808673
STAT,1834,47,na,1881,1479.232429530045
STAT,1854,16,20-24,1870,15.263589252081273
SIM,1870,43,40-44,1913,4
STAT,1882,39,30-34,1921,4.8470852549287775
STAT,1835,27,45-49,1862,0.9209973653691975
SIM,1890,39,30-34,1929,12
STAT,1904,23,45-49,1927,0.941990287498182
SIM,1898,35,40-44,1933,8
STAT,1869,27,15-19,1896,0.415223777749104
STAT,1860,87,na,1947,135.04427535551602
SIM,1886,29,50-100,1915,1
STAT,1847,35,15-19,1882,0.043865022678125226
SIM,1817,44,na,1861,1422
SIM,1882,29,25-29,1911,48
STAT,1848,38,40-44,1886,3.3173848208007755
STAT,1868,51,35-39,1919,0.007796834865341916
SIM,1939,16,35-39,1955,4
STAT,1826,30,25-29,1856,16.20087635821147
SIM,1898,26,na,1924,3001
STAT,1876,33,50-100,1909,0.890486279279705
STAT,1891,28,40-44,1919,3.488834801224213
SIM,1830,29,30-34,1859,22
SIM,1832,42,50-100,1874,3
SIM,1872,23,20-24,1895,63
STAT,1834,23,40-44,1857,1.7171306039389667
STAT,1845,98,na,1943,2.2987614320881824
SIM,1810,65,na,1875,839
STAT,1826,60,na,1886,1101.9739499583618
SIM,1864,46,na,1910,1999
SIM,1906,9,na,1915,3556
STAT,1841,18,30-34,1859,1.4088581433601757
SIM,1832,37,40-44,1869,3
SIM,1872,41,na,1913,2191
STAT,1891,24,25-29,1915,66.4887435723434
STAT,1836,20,40-44,1856,2.2014783244333027
STAT,1931,36,40-44,1967,1.8745914649428956
SIM,1883,27,45-49,1910,2
STAT,1871,31,45-49,1902,1.6425163357212977
SIM,1814,79,na,1893,285
STAT,1824,37,40-44,1861,6.866737048327259
STAT,1875,41,30-34,1916,1.121395918161054
STAT,1881,38,25-29,1919,2.6145412927116105
SIM,1836,26,20-24,1862,11
SIM,1843,52,na,1895,1508
STAT,1838,48,25-29,1886,0.03927781971277004
STAT,1849,24,50-100,1873,0.3644181131372882
SIM,1798,91,na,1889,15
STAT,1820,44,45-49,1864,2.5859091649201336
STAT,1833,54,na,1887,1308.4009440298269
SIM,1832,33,na,1865,1600
STAT,1861,45,45-49,1906,0.1872230746640526
SIM,1876,23,na,1899,2325
STAT,1847,26,25-29,1873,37.76398894058133
STAT,1864,23,20-24,1887,58.532123204365604
STAT,1883,51,30-34,1934,0.005539710105581114
STAT,1808,50,30-34,1858,0.022386996667919754
STAT,1875,27,45-49,1902,1.0781206225559161
STAT,1815,48,25-29,1863,0.12773120148610398
STAT,1800,67,na,1867,750.3197154643283
STAT,1830,30,45-49,1860,1.5457020792254494
STAT,1842,31,20-24,1873,2.3893997725781673
STAT,1852,44,35-39,1896,1.295094568458373
SIM,1831,25,30-34,1856,24
SIM,1877,64,na,1941,1646
SIM,1840,95,na,1935,8
STAT,1892,9,na,1901,3070.100421788773
STAT,1844,45,45-49,1889,0.16649240232111528
STAT,1876,28,45-49,1904,1.0798466881393618
SIM,1842,43,na,1885,1584
STAT,1836,36,20-24,1872,0.6191112869591778
SIM,1875,35,50-100,1910,2
STAT,1841,30,20-24,1871,2.308453449243412
STAT,1814,47,25-29,1861,0.17618135073133578
STAT,1895,17,20-24,1912,21.834436214772417
SIM,1847,74,na,1921,787
STAT,1893,21,25-29,1914,68.7888804566305
SIM,1924,22,25-29,1946,109
STAT,1904,38,50-100,1942,0.3573054745375055
STAT,1861,31,30-34,1892,13.770429187143089
STAT,1888,36,15-19,1924,0.06299540830754698
STAT,1859,28,45-49,1887,0.8431388048508458
STAT,1886,80,na,1966,926.8351203747161
SIM,1855,26,25-29,1881,30
SIM,1926,30,35-39,1956,16
STAT,1832,32,15-19,1864,0.11240451124677688
STAT,1945,21,40-44,1966,3.4824345992134096
STAT,1925,39,20-24,1964,0.29824701440256424
STAT,1828,26,20-24,1854,28.312929789962624
SIM,1809,57,na,1866,1079
SIM,1824,38,na,1862,1550
STAT,1846,72,na,1918,936.6939591535131
SIM,1868,41,35-39,1909,2
STAT,1810,51,25-29,1861,0.011526755075083639
STAT,1824,33,25-29,1857,21.762632583876318
STAT,1914,39,45-49,1953,0.6365553737101828
STAT,1860,18,50-100,1878,0.04305525812548068
STAT,1905,33,na,1938,3272.34414940272
STAT,1921,46,25-29,1967,0.056631943649488196
SIM,1779,77,na,1856,291
SIM,1871,35,50-100,1906,1
STAT,1890,16,30-34,1906,1.8453859204326721
SIM,1849,24,35-39,1873,6
SIM,1918,20,35-39,1938,13
SIM,1832,33,25-29,1865,17
SIM,1842,23,40-44,1865,3
STAT,1936,34,45-49,1970,1.4420004788176999
SIM,1867,28,45-49,1895,1
STAT,1863,39,20-24,1902,0.6326153329712997
STAT,1902,68,na,1970,2374.0052385469917
STAT,1808,55,na,1863,1139.2292319250307
STAT,1826,49,45-49,1875,0.21206624604257218
STAT,1918,30,35-39,1948,9.24755819965195
STAT,1900,41,35-39,1941,0.1655371550779436
SIM,1862,16,15-19,1878,6
SIM,1896,43,na,1939,2866
STAT,1847,46,na,1893,1663.7592276717648
SIM,1884,28,45-49,1912,2
STAT,1843,51,30-34,1894,0.0040398670912445275
STAT,1892,25,25-29,1917,50.392746621483774
STAT,1860,105,na,1965,0.13171787035088153
STAT,1905,46,40-44,1951,0.13224163300042355
SIM,1917,24,35-39,1941,16
STAT,1838,85,na,1923,184.04019191565482
SIM,1858,44,30-34,1902,1
STAT,1876,53,40-44,1929,0.010110059700184066
SIM,1792,75,na,1867,366
SIM,1858,35,40-44,1893,6
STAT,1854,24,na,1878,1771.7405044717514
STAT,1937,30,45-49,1967,1.4723880146962
SIM,1930,20,na,1950,4486
SIM,1833,34,25-29,1867,16
SIM,1874,30,25-29,1904,11
STAT,1843,32,na,1875,1759.8451422121573
STAT,1809,51,30-34,1860,0.01632523443418317
STAT,1858,38,na,1896,1736.3732994095492
STAT,1913,20,na,1933,3514.3396600639107
STAT,1892,15,50-100,1907,0.05823899129142328
STAT,1909,4,na,1913,3727.1072410559677
SIM,1838,39,30-34,1877,6
STAT,1886,42,45-49,1928,1.4916740254001393
STAT,1854,16,15-19,1870,5.109421832514866
STAT,1819,40,35-39,1859,4.091220457331379
STAT,1847,22,na,1869,1932.844805842351
STAT,1819,51,45-49,1870,0.026925569454596378
SIM,1885,51,na,1936,2071
STAT,1821,42,40-44,1863,3.870798629118767
STAT,1850,23,25-29,1873,48.086951515192254
SIM,1844,20,40-44,1864,2
STAT,1855,17,20-24,1872,14.984501340168354
SIM,1817,37,45-49,1854,2
SIM,1853,30,35-39,1883,11
STAT,1825,34,25-29,1859,14.853439869050822
STAT,1913,38,50-100,1951,0.3894954721098149
STAT,1853,40,35-39,1893,1.3842448594407617
STAT,1898,34,30-34,1932,22.129742891356365
STAT,1912,27,na,1939,3487.629436573372
STAT,1816,82,na,1898,217.4281999931267
STAT,1853,23,45-49,1876,0.6190585435638686
SIM,1800,87,na,1887,42
STAT,1849,34,40-44,1883,3.3563283575821052
SIM,1890,38,na,1928,2939
STAT,1816,41,20-24,1857,0.4489449146977515
STAT,1871,49,50-100,1920,0.22558017738554278
SIM,1940,19,na,1959,3441
SIM,1920,42,na,1962,3948
SIM,1891,15,30-34,1906,2
STAT,1861,34,50-100,1895,0.7135373254949066
SIM,1884,42,30-34,1926,4
STAT,1864,51,20-24,1915,6.24280020138073E-4
STAT,1932,23,20-24,1955,137.40101247498475
STAT,1890,41,20-24,1931,0.1842535715023541
STAT,1917,34,35-39,1951,8.962778395573569
SIM,1863,17,20-24,1880,10
STAT,1832,24,15-19,1856,2.8543617729214374
STAT,1927,41,40-44,1968,0.29676577339074367
STAT,1849,88,na,1937,102.94457164595488
STAT,1828,26,15-19,1854,1.0949751940267016
SIM,1827,40,35-39,1867,6
STAT,1831,43,50-100,1874,0.7696596574488225
SIM,1937,20,45-49,1957,1
STAT,1898,45,40-44,1943,0.1246891597523088
SIM,1848,28,35-39,1876,8
STAT,1831,31,45-49,1862,1.4096886882454338
STAT,1909,24,35-39,1933,8.215838109168928
SIM,1940,23,20-24,1963,105
STAT,1838,33,20-24,1871,2.231711854842278
STAT,1872,64,na,1936,1647.228896603525
STAT,1840,34,20-24,1874,2.1161940574093525
SIM,1846,33,20-24,1879,2
SIM,1838,23,20-24,1861,57
STAT,1876,42,30-34,1918,1.120700246175738
SIM,1905,22,15-19,1927,3
STAT,1815,48,30-34,1863,0.2146593823441143
STAT,1865,38,40-44,1903,3.7297160044588598
STAT,1947,17,30-34,1964,12.971282749012042
STAT,1810,52,50-100,1862,0.04817370521126889
STAT,1823,50,20-24,1873,9.101318485026907E-4
STAT,1860,53,50-100,1913,0.011390532042194987
SIM,1783,90,na,1873,16
SIM,1857,34,40-44,1891,5
SIM,1875,31,25-29,1906,16
STAT,1897,47,20-24,1944,0.008511965747273538
STAT,1877,54,40-44,1931,0.010032714101066134
STAT,1895,17,15-19,1912,7.308985013547807
STAT,1888,28,na,1916,2655.0508207155744
SIM,1864,29,30-34,1893,22
SIM,1885,21,40-44,1906,1
SIM,1776,88,na,1864,45
STAT,1874,40,25-29,1914,0.6260792545203377
SIM,1927,31,40-44,1958,13
SIM,1865,38,50-100,1903,3
STAT,1866,38,35-39,1904,6.13221983901578
STAT,1937,27,15-19,1964,0.6501006497915871
STAT,1892,42,15-19,1934,0.016320367388090066
SIM,1871,48,na,1919,2125
SIM,1894,31,35-39,1925,17
STAT,1842,50,30-34,1892,0.00437267794036575
STAT,1845,30,35-39,1875,8.69945012654296
SIM,1899,36,40-44,1935,4
STAT,1835,41,30-34,1876,0.8880581165630183
SIM,1948,19,40-44,1967,1
STAT,1886,31,35-39,1917,10.147203512497471
STAT,1881,49,na,1930,2010.3496627729546
STAT,1866,18,35-39,1884,0.48784242801633154
SIM,1882,40,25-29,1922,3
SIM,1826,45,50-100,1871,1
STAT,1852,36,35-39,1888,5.2094076010576735
STAT,1910,28,20-24,1938,16.59392492764795
SIM,1840,24,15-19,1864,1
SIM,1879,24,20-24,1903,63
STAT,1880,64,na,1944,1731.2917455752663
STAT,1851,24,25-29,1875,48.47239701458778
STAT,1929,17,15-19,1946,54.71330734346245
SIM,1909,27,na,1936,3392
SIM,1905,13,na,1918,3484
SIM,1827,97,na,1924,2
SIM,1823,83,na,1906,194
STAT,1864,77,na,1941,727.7937963712052
STAT,1943,24,35-39,1967,9.457381772740156
STAT,1846,39,15-19,1885,0.04260040217456527
STAT,1887,29,50-100,1916,0.671121741300258
STAT,1929,32,50-100,1961,0.9920929099940204
SIM,1865,33,30-34,1898,17
STAT,1805,90,na,1895,27.521388640947023
STAT,1887,43,45-49,1930,1.5700519466147225
SIM,1874,18,35-39,1892,1
STAT,1818,40,40-44,1858,5.6667917443174245
STAT,1925,21,na,1946,4141.777236549928
STAT,1854,8,na,1862,2101.7661658052543
SIM,1842,40,30-34,1882,2
SIM,1860,36,35-39,1896,8
STAT,1856,49,30-34,1905,0.06985941556556043
SIM,1900,31,50-100,1931,1
STAT,1879,34,20-24,1913,2.650097328925666
STAT,1867,42,na,1909,2047.7258781987628
STAT,1875,41,25-29,1916,0.6263652901842599
SIM,1847,44,25-29,1891,3
SIM,1843,41,30-34,1884,1
SIM,1829,39,35-39,1868,8
STAT,1846,42,15-19,1888,0.010366803424901969
STAT,1929,35,na,1964,4570.649829463863
SIM,1825,31,na,1856,1679
SIM,1844,69,na,1913,943
SIM,1859,99,na,1958,1
STAT,1847,43,15-19,1890,0.01010990525350993
SIM,1874,38,35-39,1912,13
STAT,1834,40,30-34,1874,0.8824572014547644
STAT,1896,46,20-24,1942,0.008469560833325335
STAT,1856,29,30-34,1885,18.958264491819868
STAT,1874,48,35-39,1922,0.1334333472739092
STAT,1873,16,25-29,1889,5.4615430170647965
STAT,1808,50,25-29,1858,0.013321187971531501
STAT,1891,41,15-19,1932,0.016213702430054922
SIM,1824,32,30-34,1856,17
STAT,1884,5,na,1889,2457.5077713273718
SIM,1923,10,na,1933,4464
STAT,1844,20,50-100,1864,0.35875193362820523
STAT,1879,46,20-24,1925,0.011900169929181123
SIM,1934,21,25-29,1955,126
STAT,1855,39,35-39,1894,4.975620154514653
STAT,1863,42,15-19,1905,0.011434492458438767
SIM,1891,34,40-44,1925,6
SIM,1829,77,na,1906,488
STAT,1807,54,25-29,1861,0.012466008081937064
STAT,1859,25,40-44,1884,2.324473252831602
STAT,1883,23,30-34,1906,16.446996001966085
STAT,1894,36,45-49,1930,2.431839981230836
SIM,1914,33,20-24,1947,2
STAT,1885,31,40-44,1916,4.100329549735364
SIM,1908,22,40-44,1930,2
STAT,1892,29,40-44,1921,3.5191687044158604
STAT,1920,45,25-29,1965,0.05565420779249916
STAT,1839,44,25-29,1883,0.4392161568643853
SIM,1908,42,na,1950,3197
SIM,1850,34,30-34,1884,21
STAT,1825,38,40-44,1863,5.270571867675665
STAT,1825,67,na,1892,842.5205680402695
SIM,1841,26,na,1867,1793
SIM,1833,38,40-44,1871,4
STAT,1926,21,25-29,1947,106.32865047824697
STAT,1867,7,na,1874,2466.5860519522653
STAT,1863,39,15-19,1902,0.04608456647819314
SIM,1891,23,30-34,1914,29
STAT,1920,34,15-19,1954,0.1318323938552638
STAT,1881,44,50-100,1925,0.9511109843587253
STAT,1852,44,na,1896,1652.9993827627573
STAT,1861,18,na,1879,2060.180085539624
SIM,1887,34,20-24,1921,3
STAT,1916,18,40-44,1934,0.2796110731353644
STAT,1899,46,40-44,1945,0.12535673941944708
SIM,1824,43,40-44,1867,8
STAT,1897,26,15-19,1923,0.5751668656874018
SIM,1899,15,35-39,1914,2
STAT,1822,54,20-24,1876,9.176572416310055E-4
STAT,1936,35,50-100,1971,0.39004825383516883
SIM,1826,36,35-39,1862,10
SIM,1941,22,25-29,1963,93
STAT,1827,45,45-49,1872,0.22166772321276604
STAT,1836,81,na,1917,350.18101548327326
SIM,1817,43,30-34,1860,1
STAT,1925,29,50-100,1954,1.1026370009183628
STAT,1832,28,30-34,1860,20.37418457823905
STAT,1883,34,40-44,1917,3.982335199199455
STAT,1802,93,na,1895,10.246267066915928
STAT,1885,27,35-39,1912,9.0858514296871
STAT,1834,24,25-29,1858,46.833667689064114
SIM,1790,71,na,1861,485
SIM,1929,12,na,1941,4741
SIM,1924,18,40-44,1942,1
STAT,1861,80,na,1941,485.89943299601333
STAT,1870,54,na,1924,1940.5982816093713
STAT,1837,36,15-19,1873,0.04483518402685925
SIM,1833,82,na,1915,243
STAT,1913,22,50-100,1935,0.6023613828865226
SIM,1840,28,30-34,1868,28
STAT,1940,26,40-44,1966,4.492135172631473
STAT,1874,45,25-29,1919,0.05615114437630724
STAT,1891,42,20-24,1933,0.1853891660109733
SIM,1872,29,35-39,1901,8
SIM,1893,30,35-39,1923,11
STAT,1885,30,35-39,1915,9.612739015214714
STAT,1795,95,na,1890,2.769130360603313
SIM,1801,72,na,1873,510
STAT,1791,81,na,1872,194.98035035708122
SIM,1893,27,35-39,1920,16
SIM,1842,24,25-29,1866,58
STAT,1824,51,20-24,1875,8.833803304422074E-4
STAT,1874,47,na,1921,2161.474860008188
SIM,1848,59,na,1907,1380
SIM,1843,33,30-34,1876,24
STAT,1933,22,25-29,1955,115.7469724147655
STAT,1797,103,na,1900,0.0352170345724257
STAT,1863,26,15-19,1889,0.37884737523459144
SIM,1852,30,40-44,1882,4
SIM,1925,34,35-39,1959,12
STAT,1919,31,35-39,1950,9.352037467600729
STAT,1823,34,20-24,1857,5.3844762906500305
STAT,1865,34,25-29,1899,8.695307052508358
STAT,1894,24,45-49,1918,0.8412831259673597
STAT,1920,47,20-24,1967,0.011540311910726474
SIM,1835,33,45-49,1868,1
STAT,1826,32,50-100,1858,1.2558304438853223
STAT,1866,39,40-44,1905,3.775823181989388
STAT,1812,52,40-44,1864,0.033678993607416885
STAT,1833,44,25-29,1877,0.465337506066272
STAT,1849,45,50-100,1894,0.18600365289777424
STAT,1856,49,25-29,1905,0.04156923861357943
STAT,1823,53,25-29,1876,0.004115442430506127
STAT,1838,39,50-100,1877,0.9741605338457562
SIM,1850,22,30-34,1872,21
STAT,1829,51,50-100,1880,0.012162856216994878
SIM,1790,92,na,1882,11
STAT,1827,33,45-49,1860,2.007016627743975
STAT,1882,42,na,1924,2120.7572592971983
STAT,1891,16,na,1907,2959.130927251461
STAT,1904,46,25-29,1950,0.04415240585615104
SIM,1861,35,45-49,1896,4
STAT,1850,41,20-24,1891,0.11245757174130555
SIM,1922,36,40-44,1958,1
STAT,1811,43,35-39,1854,6.599966971050565
STAT,1870,65,na,1935,1566.1918327064723
SIM,1911,29,50-100,1940,4
SIM,1811,82,na,1893,198
STAT,1842,34,30-34,1876,14.96035023457599
STAT,1890,25,20-24,1915,13.641348974522991
STAT,1907,32,25-29,1939,8.161647978462499
SIM,1867,25,40-44,1892,4
STAT,1823,63,na,1886,984.8343486361083
SIM,1882,24,25-29,1906,63
SIM,1820,56,na,1876,1227
SIM,1867,37,35-39,1904,18
STAT,1843,34,40-44,1877,3.4491077973823034
STAT,1873,16,30-34,1889,1.5361573465576404
STAT,1884,54,na,1938,1954.387007008627
STAT,1859,87,na,1946,132.46866135433504
STAT,1914,36,40-44,1950,1.4188212128136977
SIM,1867,40,35-39,1907,1
SIM,1831,34,20-24,1865,3
SIM,1794,85,na,1879,70
STAT,1908,41,30-34,1949,0.11238683274379535
STAT,1858,27,45-49,1885,0.841867688942771
STAT,1906,33,20-24,1939,2.126523417244624
STAT,1842,22,30-34,1864,16.26986807090476
STAT,1844,30,40-44,1874,3.677373964582089
SIM,1898,4,na,1902,3295
STAT,1929,33,15-19,1962,0.15410066492413088
STAT,1785,96,na,1881,1.5966070481905248
STAT,1811,54,45-49,1865,0.04438687616312734
SIM,1908,50,na,1958,3071
STAT,1763,111,na,1874,6.36183928377081E-4
STAT,1876,34,30-34,1910,16.89487171585609
STAT,1874,79,na,1953,674.7927488133203
SIM,1831,28,35-39,1859,9
SIM,1884,34,30-34,1918,19
SIM,1851,34,40-44,1885,4
SIM,1881,16,30-34,1897,1
STAT,1871,49,20-24,1920,0.011021833207663792
STAT,1939,23,30-34,1962,27.259172431173244
STAT,1836,39,25-29,1875,2.2415173077500627
SIM,1819,70,na,1889,709
STAT,1861,29,na,1890,1861.1853237469668
STAT,1769,115,na,1884,1.4596985983533783E-4
STAT,1843,46,40-44,1889,0.11658145345780282
SIM,1903,33,45-49,1936,3
SIM,1833,85,na,1918,131
STAT,1944,22,50-100,1966,0.6711500169113555
SIM,1927,31,35-39,1958,14
STAT,1874,26,20-24,1900,11.362330495890761
STAT,1875,24,40-44,1899,2.0107420647346754
STAT,1842,33,40-44,1875,3.7546994370017805
SIM,1850,33,40-44,1883,3
SIM,1882,26,20-24,1908,13
SIM,1863,100,na,1963,1
SIM,1865,39,na,1904,2063
STAT,1867,49,50-100,1916,0.21331748635587566
STAT,1853,112,na,1965,1.332797254544488E-4
STAT,1848,39,na,1887,1766.977024516413
STAT,1938,20,na,1958,3416.7158988128876
SIM,1874,13,na,1887,2435
STAT,1897,7,na,1904,3291.5610957533627
STAT,1875,25,25-29,1900,41.353968654280294
STAT,1927,44,45-49,1971,0.19652384343257462
STAT,1859,6,na,1865,2177.395518763414
STAT,1865,62,na,1927,1565.0243603295562
STAT,1799,88,na,1887,46.139467186509194
STAT,1857,45,30-34,1902,0.07284092854040485
STAT,1795,74,na,1869,471.88431892601767
STAT,1814,70,na,1884,768.9939109967873
SIM,1866,27,45-49,1893,2
STAT,1827,101,na,1928,0.3296102887624459
STAT,1945,21,35-39,1966,9.752179433979615
SIM,1857,7,na,1864,2308
SIM,1881,25,20-24,1906,9
SIM,1833,74,na,1907,626
STAT,1843,54,35-39,1897,0.005655053027561976
STAT,1822,38,15-19,1860,0.09360484453270326
STAT,1846,80,na,1926,458.81522373453026
STAT,1863,35,50-100,1898,1.0274863411906687
SIM,1881,29,30-34,1910,18
STAT,1841,54,30-34,1895,0.003990907944620097
STAT,1861,23,30-34,1884,14.270622915198556
STAT,1826,46,40-44,1872,0.1602253989648941
STAT,1882,39,25-29,1921,2.6185402957598223
STAT,1916,17,na,1933,3871.13544366842
SIM,1820,34,45-49,1854,3
SIM,1844,77,na,1921,521
STAT,1828,46,45-49,1874,0.19363369925336388
SIM,1890,39,25-29,1929,3
SIM,1860,41,30-34,1901,1
STAT,1873,29,30-34,1902,23.954701346041862
STAT,1893,37,40-44,1930,5.244369434281597
STAT,1873,33,15-19,1906,0.13586706427737943
STAT,1912,25,50-100,1937,0.9329477399260723
STAT,1878,37,15-19,1915,0.05528532284536233
STAT,1884,35,40-44,1919,4.124415631437502
SIM,1782,97,na,1879,2
STAT,1836,73,na,1909,769.1489141886784
STAT,1890,44,25-29,1934,0.7316582781464249
SIM,1895,40,40-44,1935,1
STAT,1882,15,15-19,1897,5.477494516805773
SIM,1805,67,na,1872,745
SIM,1871,42,45-49,1913,2
SIM,1915,32,25-29,1947,11
STAT,1822,41,15-19,1863,0.020655888379000748
STAT,1930,36,25-29,1966,1.2143413477849363
SIM,1825,44,40-44,1869,10
SIM,1822,45,50-100,1867,2
STAT,1873,44,25-29,1917,0.606955092476836
STAT,1876,4,na,1880,2830.7841503464615
SIM,1875,34,35-39,1909,8
SIM,1871,4,na,1875,2652
SIM,1880,28,na,1908,2385
STAT,1898,49,35-39,1947,0.09885097234941702
STAT,1949,12,na,1961,4316.044424941108
STAT,1867,34,35-39,1901,8.906584895078582
STAT,1835,33,30-34,1868,14.001470354413163
STAT,1817,44,40-44,1861,5.278836361913586
STAT,1847,54,25-29,1901,0.0025400802623653943
STAT,1890,33,15-19,1923,0.16378190666518042
SIM,1832,44,na,1876,1458
SIM,1841,18,na,1859,1938
STAT,1878,37,45-49,1915,1.9626287276058094
STAT,1847,26,30-34,1873,22.480781114627586
STAT,1934,31,30-34,1965,20.33316910388455
STAT,1870,20,40-44,1890,1.9427159569733534
STAT,1816,85,na,1901,127.74710712519163
SIM,1908,31,25-29,1939,12
STAT,1957,15,25-29,1972,53.994829251014835
SIM,1892,35,40-44,1927,7
SIM,1911,17,na,1928,3644
STAT,1918,47,50-100,1965,0.22738126276244686
STAT,1823,42,15-19,1865,0.018421846280859633
STAT,1827,37,na,1864,1623.1019010571954
STAT,1887,40,40-44,1927,2.400756976705672
SIM,1874,35,30-34,1909,6
SIM,1870,29,25-29,1899,41
STAT,1863,42,45-49,1905,1.2392130331807554
SIM,1890,19,30-34,1909,6
SIM,1769,86,na,1855,45
STAT,1806,53,25-29,1859,0.012219753420089217
SIM,1891,35,30-34,1926,7
STAT,1830,48,20-24,1878,0.008876321106216585
SIM,1810,57,na,1867,1062
SIM,1960,4,na,1964,4857
STAT,1893,24,35-39,1917,6.947301218480775
SIM,1855,26,30-34,1881,21
STAT,1857,44,40-44,1901,1.6532268914427366
STAT,1899,28,45-49,1927,1.4321204724636025
STAT,1868,46,45-49,1914,0.21332068136944413
STAT,1877,50,25-29,1927,0.0035208200450516664
SIM,1886,37,45-49,1923,5
STAT,1864,43,15-19,1907,0.011543492478207112
SIM,1865,44,40-44,1909,5
STAT,1816,43,40-44,1859,5.798579469129692
STAT,1826,33,35-39,1859,12.996416748572619
SIM,1881,69,na,1950,1103
STAT,1837,44,na,1881,1569.9033589963624
SIM,1883,25,na,1908,2245
STAT,1921,23,45-49,1944,1.196865463781812
STAT,1933,16,50-100,1949,0.4749559419989978
SIM,1951,2,na,1953,4337
STAT,1863,84,na,1947,275.7835388921112
STAT,1866,35,30-34,1901,4.687877235325702
STAT,1894,67,na,1961,2069.2575831152217
SIM,1810,89,na,1899,43
STAT,1862,29,25-29,1891,33.92343913499689
STAT,1842,53,35-39,1895,0.006134426162118876
STAT,1882,19,30-34,1901,1.4564595393094506
SIM,1869,10,na,1879,2489
STAT,1873,25,15-19,1898,0.43764810949481286
STAT,1885,39,na,1924,2196.16263059547
SIM,1834,33,35-39,1867,4
SIM,1816,59,na,1875,1093
STAT,1902,23,35-39,1925,7.756005133913193
STAT,1853,53,40-44,1906,0.007839361087553615
SIM,1909,21,45-49,1930,6
STAT,1941,8,na,1949,3858.567930550673
STAT,1912,35,na,1947,3501.9523213415946
STAT,1816,44,30-34,1860,2.836790550100421
STAT,1902,28,na,1930,3170.587913730817
STAT,1883,35,30-34,1918,4.98320707463533
STAT,1851,28,40-44,1879,2.5049004048755283
SIM,1910,23,35-39,1933,9
STAT,1873,45,15-19,1918,3.87066258695318E-4
STAT,1856,25,15-19,1881,0.35155981619579113
STAT,1893,45,35-39,1938,0.09555345519407081
SIM,1887,31,na,1918,2495
STAT,1857,40,25-29,1897,0.4832738510141865
SIM,1824,44,30-34,1868,5
SIM,1855,21,na,1876,2024
STAT,1846,29,na,1875,1913.282050321754
SIM,1891,76,na,1967,1405
SIM,1931,33,50-100,1964,1
STAT,1841,38,25-29,1879,2.314506304099753
STAT,1826,54,35-39,1880,0.007368631357407952
STAT,1869,47,45-49,1916,0.21497777831624235
SIM,1876,34,45-49,1910,1
SIM,1874,15,30-34,1889,1
SIM,1948,15,25-29,1963,44
STAT,1833,62,na,1895,1121.3607764687413
STAT,1867,47,40-44,1914,0.1511597475639766
STAT,1868,34,45-49,1902,1.5583234260310996
SIM,1869,21,na,1890,2184
STAT,1823,55,na,1878,1216.0429029157663
STAT,1864,54,25-29,1918,0.002900264311822066
STAT,1866,15,30-34,1881,1.4424035718064525
SIM,1820,64,na,1884,945
STAT,1883,18,35-39,1901,0.5068902023754488
STAT,1859,79,na,1938,525.6506118993032
STAT,1852,52,40-44,1904,0.007591770032436674
STAT,1907,30,50-100,1937,0.7359635541034347
SIM,1831,59,na,1890,1165
SIM,1830,34,na,1864,1661
SIM,1816,38,40-44,1854,3
STAT,1903,34,15-19,1937,0.10897096716449829
SIM,1931,33,20-24,1964,3
SIM,1829,36,30-34,1865,6
STAT,1916,18,50-100,1934,0.07489580494846723
SIM,1915,30,50-100,1945,5
STAT,1875,29,40-44,1904,2.8879472155918107
SIM,1830,41,45-49,1871,1
STAT,1818,43,45-49,1861,3.4123178746310314
SIM,1834,48,na,1882,1430
STAT,1888,27,30-34,1915,28.11428703801697
SIM,1822,90,na,1912,33
STAT,1824,35,20-24,1859,1.3283888564283468
STAT,1843,16,45-49,1859,0.056718788100648045
STAT,1901,38,20-24,1939,0.21892124284274098
STAT,1838,39,35-39,1877,5.612055846448509
STAT,1811,51,40-44,1862,0.03419446740488822
STAT,1809,46,35-39,1855,0.40214027299512267
STAT,1871,24,50-100,1895,0.3801421393200609
SIM,1917,21,25-29,1938,93
SIM,1818,85,na,1903,134
STAT,1837,47,na,1884,1515.669126204079
STAT,1807,51,20-24,1858,0.0027590409662200097
STAT,1858,45,40-44,1903,0.1280688563141448
STAT,1898,29,35-39,1927,12.247216043213044
SIM,1925,22,40-44,1947,5
SIM,1826,43,45-49,1869,5
SIM,1857,95,na,1952,10
STAT,1854,36,15-19,1890,0.040371125629254545
SIM,1839,19,30-34,1858,1
STAT,1845,95,na,1940,9.408306379394162
STAT,1835,88,na,1923,87.37770779861346
STAT,1874,42,20-24,1916,0.15310132970470158
SIM,1896,27,30-34,1923,31
SIM,1897,35,50-100,1932,1
SIM,1900,22,na,1922,3128
SIM,1876,31,40-44,1907,3
STAT,1824,54,25-29,1878,0.003994573694636546
SIM,1846,39,35-39,1885,11
STAT,1923,33,20-24,1956,2.6399427764875774
STAT,1831,107,na,1938,0.0027535775093170557
SIM,1854,27,20-24,1881,12
SIM,1907,25,na,1932,3320
SIM,1849,6,na,1855,2298
SIM,1877,41,50-100,1918,3
STAT,1840,22,20-24,1862,57.5119197003287
SIM,1893,34,45-49,1927,1
STAT,1884,47,40-44,1931,0.15903958288312528
STAT,1833,43,40-44,1876,1.6509497474652544
SIM,1913,16,15-19,1929,6
STAT,1898,30,15-19,1928,0.18352016059854884
STAT,1859,47,na,1906,1683.747468784057
STAT,1816,47,35-39,1863,0.3306243860191461
STAT,1901,43,na,1944,3044.6500377191596
STAT,1822,70,na,1892,712.9547353816492
STAT,1889,35,50-100,1924,1.44545952621968
STAT,1905,16,15-19,1921,8.123498387002426
STAT,1813,85,na,1898,112.8191094586008
STAT,1771,93,na,1864,4.642952071163757
STAT,1801,54,30-34,1855,0.015974134257990318
SIM,1867,34,30-34,1901,23
STAT,1891,26,20-24,1917,13.75855440731387
STAT,1833,32,30-34,1865,13.792448855629615
STAT,1903,45,25-29,1948,0.04410851726587521
SIM,1841,43,40-44,1884,4
STAT,1837,49,15-19,1886,2.6266514214659656E-4
SIM,1938,17,30-34,1955,13
SIM,1832,89,na,1921,61
SIM,1889,26,30-34,1915,37
STAT,1861,40,na,1901,1833.7676541331018
STAT,1885,34,45-49,1919,1.6280003021192222
SIM,1841,32,30-34,1873,22
STAT,1845,29,25-29,1874,35.91333693934981
SIM,1856,34,25-29,1890,14
STAT,1898,41,25-29,1939,0.057266132869900586
STAT,1854,111,na,1965,4.0954870646944575E-4
STAT,1886,24,na,1910,2345.331900124215
STAT,1885,24,30-34,1909,16.66782110481548
STAT,1832,44,15-19,1876,0.009951393414541843
SIM,1884,37,35-39,1921,12
STAT,1850,44,25-29,1894,0.44656129394876015
STAT,1847,18,50-100,1865,0.044824431843889845
STAT,1876,40,35-39,1916,1.7851962694814811
SIM,1868,36,na,1904,2133
STAT,1843,23,50-100,1866,0.3432520587711441
STAT,1848,34,25-29,1882,7.910794594494069
STAT,1866,54,35-39,1920,0.007294977192850257
SIM,1849,44,35-39,1893,3
SIM,1895,28,20-24,1923,13
SIM,1948,20,15-19,1968,5
SIM,1853,29,25-29,1882,36
SIM,1810,86,na,1896,74
STAT,1846,27,20-24,1873,10.526376126023044
STAT,1870,62,na,1932,1693.870460213779
SIM,1836,26,na,1862,1764
SIM,1891,68,na,1959,1885
STAT,1858,24,40-44,1882,1.5884410331424428
STAT,1874,76,na,1950,914.4561784692683
STAT,1895,37,45-49,1932,2.4551756334806023
STAT,1862,30,35-39,1892,8.245569462543495
SIM,1826,33,30-34,1859,14
SIM,1869,13,na,1882,2454
SIM,1903,30,40-44,1933,8
SIM,1883,28,na,1911,2198
SIM,1840,15,30-34,1855,2
STAT,1812,60,na,1872,1051.8597775128585
STAT,1887,28,20-24,1915,12.352804915696057
SIM,1886,17,15-19,1903,5
STAT,1842,17,35-39,1859,0.5102694492243464
SIM,1893,24,30-34,1917,29
SIM,1848,25,30-34,1873,29
STAT,1864,69,na,1933,1235.6301206685566
STAT,1876,37,35-39,1913,6.903205296168745
STAT,1822,41,45-49,1863,2.2385817459080815
SIM,1783,93,na,1876,1
SIM,1821,39,30-34,1860,6
SIM,1884,40,35-39,1924,1
STAT,1935,23,na,1958,4696.2337093188335
SIM,1906,22,30-34,1928,32
STAT,1860,55,na,1915,1584.9224543830776
STAT,1864,35,20-24,1899,0.6551969569204739
STAT,1891,45,25-29,1936,0.03835369640795984
SIM,1859,46,50-100,1905,1
STAT,1917,22,40-44,1939,3.3759604772125855
SIM,1883,25,25-29,1908,41
STAT,1833,41,20-24,1874,0.11959304204065162
STAT,1867,52,30-34,1919,0.005252265874722777
STAT,1842,37,35-39,1879,6.008591536629053
STAT,1884,17,45-49,1901,0.060966847090488184
SIM,1831,48,na,1879,1429
STAT,1864,29,35-39,1893,8.066060835029134
STAT,1844,33,45-49,1877,1.433343171918702
SIM,1878,57,na,1935,2031
STAT,1837,36,na,1873,1709.9973900652205
SIM,1868,28,na,1896,2153
STAT,1889,44,30-34,1933,1.3227078021365573
STAT,1852,23,35-39,1875,4.989720483577899
SIM,1925,31,30-34,1956,19
STAT,1881,23,20-24,1904,62.695659826266784
SIM,1860,23,35-39,1883,5
STAT,1936,16,na,1952,3337.1308122972036
SIM,1839,38,35-39,1877,11
SIM,1850,37,35-39,1887,15
SIM,1883,29,40-44,1912,2
SIM,1947,23,30-34,1970,31
STAT,1883,83,na,1966,635.7697826564936
SIM,1852,33,45-49,1885,1
STAT,1872,33,50-100,1905,0.864549587077092
STAT,1946,20,45-49,1966,1.1836823477892977
STAT,1903,21,na,1924,3188.583042671553
STAT,1908,44,35-39,1952,0.1738417000947177
STAT,1812,71,na,1883,658.962037482939
STAT,1833,22,na,1855,1762.9252135408988
STAT,1885,15,40-44,1900,0.17302969219489742
STAT,1872,17,20-24,1889,16.854411863515853
SIM,1841,23,25-29,1864,46
STAT,1849,35,25-29,1884,2.2556063496532412
SIM,1845,16,15-19,1861,6
STAT,1914,47,50-100,1961,0.21191503090356106
STAT,1888,23,15-19,1911,3.6718084351313354
SIM,1939,29,40-44,1968,5
STAT,1836,51,45-49,1887,0.00969906945855794
STAT,1857,48,35-39,1905,0.10299789862895181
SIM,1900,44,40-44,1944,1
SIM,1918,41,40-44,1959,3
SIM,1827,39,25-29,1866,1
STAT,1914,22,15-19,1936,5.13779157449251
STAT,1861,26,35-39,1887,7.689382859324848
SIM,1891,30,25-29,1921,19
STAT,1855,33,20-24,1888,1.9356337249147488
STAT,1922,45,35-39,1967,0.14058279767340906
STAT,1926,2,na,1928,4736.900257862264
SIM,1873,39,25-29,1912,2
STAT,1852,29,50-100,1881,0.4845212311712963
STAT,1847,39,30-34,1886,3.993813156883438
SIM,1896,23,15-19,1919,5
STAT,1853,35,45-49,1888,1.5403217018767756
SIM,1939,18,30-34,1957,14
STAT,1917,0,na,1917,4564.948603591841
SIM,1858,58,na,1916,1628
SIM,1863,33,20-24,1896,2
SIM,1922,22,15-19,1944,3
STAT,1898,46,30-34,1944,0.07000407194475701
STAT,1893,42,30-34,1935,1.3756386144359203
SIM,1877,61,na,1938,1786
STAT,1819,39,25-29,1858,6.856473435541652
STAT,1883,30,25-29,1913,9.563093592323787
STAT,1870,23,45-49,1893,0.6442537226930919
STAT,1830,108,na,1938,0.00110552911301801
STAT,1851,40,30-34,1891,0.8353505358014658
STAT,1902,36,na,1938,3181.0855186990534
STAT,1826,51,30-34,1877,0.005407540324958371
STAT,1839,46,20-24,1885,0.008245310752900298
STAT,1833,23,25-29,1856,46.900930547490404
SIM,1809,45,50-100,1854,1
STAT,1916,49,20-24,1965,0.0106452634406194
STAT,1834,39,50-100,1873,0.9282661929911236
STAT,1894,75,na,1969,1632.9276999644771
SIM,1857,35,25-29,1892,2
SIM,1856,43,30-34,1899,4
SIM,1921,2,na,1923,4405
STAT,1878,53,45-49,1931,0.014058365096179862
STAT,1923,31,50-100,1954,0.8990657228655383
SIM,1879,20,na,1899,2378
STAT,1916,9,na,1925,3976.936869293223
STAT,1890,19,35-39,1909,0.6303416843780709
STAT,1850,66,na,1916,1155.3765783597187
STAT,1950,12,na,1962,4387.902666627214
SIM,1862,36,45-49,1898,1
STAT,1838,45,20-24,1883,0.008503512101481847
STAT,1854,49,20-24,1903,0.008406555221480708
SIM,1877,72,na,1949,1179
SIM,1891,38,35-39,1929,17
SIM,1891,79,na,1970,1182
STAT,1894,21,40-44,1915,2.5374848333453404
SIM,1866,24,40-44,1890,6
STAT,1895,38,na,1933,2887.2263889070173
STAT,1854,36,45-49,1890,1.4331747893990046
STAT,1860,34,40-44,1894,3.2956752381782124
STAT,1848,52,20-24,1900,5.453979491461057E-4
STAT,1890,18,50-100,1908,0.056435695268305996
STAT,1827,30,40-44,1857,5.674275805695777
STAT,1786,81,na,1867,184.57520510703733
SIM,1855,39,30-34,1894,2
STAT,1934,38,na,1972,4899.625294233182
STAT,1883,38,35-39,1921,6.518541282337883
STAT,1900,58,na,1958,2653.826400370041
SIM,1897,35,25-29,1932,2
SIM,1892,31,25-29,1923,20
STAT,1921,20,40-44,1941,3.6090899484750008
STAT,1825,50,30-34,1875,0.0060890752781826655
SIM,1886,34,40-44,1920,7
SIM,1835,30,40-44,1865,7
STAT,1835,36,35-39,1871,5.6234723754964255
STAT,1850,25,20-24,1875,9.873140812965783
STAT,1871,28,na,1899,2230.85100940331
SIM,1912,0,na,1912,3959
SIM,1844,40,35-39,1884,7
STAT,1829,43,20-24,1872,0.1333727701887002
STAT,1841,52,50-100,1893,0.010356587089943326
STAT,1848,43,30-34,1891,0.8480991493116028
SIM,1963,8,na,1971,4692
STAT,1923,46,35-39,1969,0.14283648566796936
SIM,1855,22,15-19,1877,2
SIM,1779,85,na,1864,64
STAT,1934,34,35-39,1968,11.771698182567409
STAT,1860,95,na,1955,10.191158782304743
SIM,1865,28,35-39,1893,10
STAT,1837,52,45-49,1889,0.009452863458014472
STAT,1888,38,50-100,1926,1.3639124902562425
SIM,1928,30,45-49,1958,2
STAT,1889,35,25-29,1924,3.3897678825219044
SIM,1908,10,na,1918,3605
STAT,1934,6,na,1940,5121.469586687184
STAT,1873,49,30-34,1922,0.09080902600026498
SIM,1880,17,20-24,1897,15
SIM,1843,36,35-39,1879,7
STAT,1896,34,20-24,1930,3.343692466774248
STAT,1878,34,40-44,1912,4.233032232571604
SIM,1822,34,na,1856,1565
SIM,1847,66,na,1913,1215
SIM,1932,24,na,1956,4457
STAT,1884,46,na,1930,2105.784790353545
STAT,1774,107,na,1881,0.006222672284853183
SIM,1910,20,30-34,1930,27
SIM,1860,44,35-39,1904,2
STAT,1931,5,na,1936,4971.6457198332855
STAT,1857,28,35-39,1885,7.351656748206554
STAT,1881,50,45-49,1931,0.013434447011535147
STAT,1915,46,na,1961,3505.96378818876
SIM,1768,93,na,1861,7
SIM,1923,23,15-19,1946,6
SIM,1919,17,20-24,1936,131
STAT,1899,25,40-44,1924,3.903771961597356
STAT,1915,23,15-19,1938,5.182236069008426
STAT,1873,41,20-24,1914,0.15284955678177634
SIM,1898,36,25-29,1934,3
STAT,1828,54,50-100,1882,0.010328156519184672
STAT,1871,16,20-24,1887,16.83722229279415
STAT,1806,50,20-24,1856,0.0027045324573487252
STAT,1836,40,35-39,1876,1.4312003997429295
STAT,1902,20,30-34,1922,23.889589295025484
STAT,1915,44,50-100,1959,0.11136471376234108
SIM,1919,13,na,1932,4207
SIM,1819,43,40-44,1862,3
SIM,1890,15,15-19,1905,6
STAT,1846,26,45-49,1872,1.0034556578245954
SIM,1920,21,na,1941,3888
SIM,1875,92,na,1967,143
SIM,1845,31,45-49,1876,1
STAT,1821,83,na,1904,211.5012152939806
STAT,1835,43,45-49,1878,1.1268293162074912
SIM,1922,22,na,1944,3925
SIM,1834,70,na,1904,809
SIM,1942,22,40-44,1964,3
STAT,1834,27,50-100,1861,0.5205664971169547
SIM,1860,20,30-34,1880,18
STAT,1831,28,na,1859,1656.2559699543394
STAT,1925,44,35-39,1969,0.22953716317878345
STAT,1850,32,30-34,1882,12.875153748836123
STAT,1875,45,40-44,1920,0.16789503044064505
STAT,1946,18,20-24,1964,142.01220753281606
STAT,1849,26,na,1875,1936.8336048013025
STAT,1760,113,na,1873,3.6299599793882675E-4
STAT,1946,21,20-24,1967,116.93476924371807
STAT,1852,40,40-44,1892,1.6471483679049563
STAT,1904,62,na,1966,2703.0747438153658
SIM,1848,29,25-29,1877,42
STAT,1845,33,50-100,1878,0.7629415346396327
SIM,1818,42,40-44,1860,4
STAT,1888,26,50-100,1914,0.7166343153101229
STAT,1921,46,30-34,1967,0.09517312843932141
STAT,1849,30,25-29,1879,9.080521611465242
SIM,1865,26,20-24,1891,15
SIM,1918,33,50-100,1951,6
STAT,1906,16,50-100,1922,0.0675736679246802
STAT,1813,88,na,1901,56.49860321749792
SIM,1884,3,na,1887,2714
STAT,1929,29,50-100,1958,1.1756060144022555
STAT,1929,24,25-29,1953,109.65376529494233
SIM,1904,45,50-100,1949,3
STAT,1782,85,na,1867,72.70164657995352
STAT,1859,21,50-100,1880,0.35211295628000716
STAT,1873,48,40-44,1921,0.16196816474090597
SIM,1854,26,45-49,1880,3
STAT,1822,45,30-34,1867,0.13396101837648747
STAT,1887,65,na,1952,1785.756855275009
SIM,1867,97,na,1964,15
STAT,1898,27,20-24,1925,14.99771735241477
SIM,1836,22,35-39,1858,10
STAT,1837,31,45-49,1868,1.433791523698509
STAT,1853,16,35-39,1869,0.5024915770549565
SIM,1849,31,50-100,1880,4
STAT,1874,38,50-100,1912,1.1791682184476593
SIM,1843,43,45-49,1886,2
SIM,1897,32,20-24,1929,3
STAT,1793,108,na,1901,3.038121272892365E-4
STAT,1908,32,40-44,1940,3.489666761730781
SIM,1938,33,30-34,1971,14
STAT,1889,32,20-24,1921,3.1524554063024666
SIM,1928,15,15-19,1943,47
SIM,1869,98,na,1967,28
STAT,1908,52,na,1960,3085.9790499421447
STAT,1759,99,na,1858,0.14044831982979133
SIM,1852,32,na,1884,1883
STAT,1863,23,40-44,1886,1.7492903047612423
SIM,1871,23,40-44,1894,4
STAT,1917,22,50-100,1939,0.660657675699906
SIM,1825,34,na,1859,1613
SIM,1922,32,25-29,1954,13
STAT,1903,29,50-100,1932,0.8536984983379214
STAT,1878,80,na,1958,714.8217099231682
STAT,1885,44,50-100,1929,0.9813731797906213
STAT,1852,97,na,1949,3.8948018338148884
STAT,1877,33,na,1910,2328.5607163670024
STAT,1857,21,na,1878,1852.3680148689464
STAT,1899,32,50-100,1931,1.185990704977322
SIM,1908,29,20-24,1937,15
STAT,1905,32,15-19,1937,0.11165714728798799
STAT,1846,43,20-24,1889,0.11770058484187329
STAT,1807,70,na,1877,718.7350771579262
SIM,1920,35,25-29,1955,1
STAT,1899,44,50-100,1943,0.09367842657852572
STAT,1827,49,25-29,1876,0.05130703512956769
SIM,1924,37,na,1961,4187
SIM,1859,43,40-44,1902,9
STAT,1837,33,40-44,1870,3.4924134480306352
STAT,1857,26,20-24,1883,9.06811132429589
STAT,1914,32,25-29,1946,8.789318534786968
STAT,1889,16,15-19,1905,6.938197286791838
STAT,1847,11,na,1858,2207.130680703728
SIM,1937,24,25-29,1961,82
STAT,1861,33,45-49,1894,1.3639695674454673
STAT,1859,34,30-34,1893,13.015401070824215
STAT,1914,43,20-24,1957,0.016505867641835443
SIM,1894,65,na,1959,2193
STAT,1858,25,25-29,1883,32.53989903646141
SIM,1845,33,40-44,1878,2
STAT,1911,39,25-29,1950,0.8893970191941482
SIM,1877,23,35-39,1900,6
STAT,1929,8,na,1937,4808.3579550537925
STAT,1845,45,50-100,1890,0.1755262909143689
STAT,1870,27,50-100,1897,0.5928421404170838
STAT,1889,3,na,1892,3083.1598589458213
STAT,1844,46,20-24,1890,0.008357947132757667
SIM,1897,16,15-19,1913,7
SIM,1842,44,40-44,1886,4
STAT,1845,10,na,1855,2161.85127
STAT,1852,20,30-34,1872,15.56351417680854
STAT,1863,21,45-49,1884,0.5938764172671231
STAT,1910,27,15-19,1937,0.644020961657344
STAT,1831,38,35-39,1869,5.3574461460623635
STAT,1912,35,25-29,1947,0.9164979179322735
SIM,1943,21,45-49,1964,5
STAT,1920,40,40-44,1960,0.2616907567645358
STAT,1934,22,40-44,1956,4.268695376179071
SIM,1932,32,na,1964,4699
STAT,1827,36,50-100,1863,1.3052860538726445
SIM,1842,51,50-100,1893,1
STAT,1904,29,40-44,1933,4.030146471063735
STAT,1887,27,45-49,1914,1.1732398763294645
STAT,1877,53,35-39,1930,0.008300861314921873
STAT,1930,33,20-24,1963,2.971833340649624
STAT,1952,15,40-44,1967,1.5842935247456964
SIM,1876,24,30-34,1900,18
STAT,1927,25,na,1952,4331.472449925894
STAT,1930,39,35-39,1969,2.974043261472406
SIM,1841,20,20-24,1861,57
SIM,1866,25,25-29,1891,49
SIM,1914,27,na,1941,3552
STAT,1925,41,50-100,1966,0.13455572677757488
SIM,1907,21,35-39,1928,9
STAT,1894,13,na,1907,3130.4341142886014
SIM,1928,27,na,1955,4330
STAT,1875,20,25-29,1895,55.917988520853456
SIM,1869,66,na,1935,1471
STAT,1870,50,50-100,1920,0.014197781196283192
STAT,1856,29,50-100,1885,0.48159422526201023
STAT,1841,54,25-29,1895,0.002374755117712839
STAT,1935,18,45-49,1953,0.6434406048768732
STAT,1843,42,25-29,1885,0.44658729815801357
STAT,1845,101,na,1946,0.4037897105745934
STAT,1903,43,45-49,1946,0.13868828369920594
STAT,1860,102,na,1962,0.7147438211411495
STAT,1935,21,45-49,1956,1.447934076544723
STAT,1833,46,45-49,1879,0.17180152634029852
STAT,1813,48,50-100,1861,0.6605446496075441
SIM,1836,71,na,1907,846
SIM,1912,29,40-44,1941,5
STAT,1877,3,na,1880,3004.1003593377336
STAT,1920,5,na,1925,4261.543404806047
SIM,1932,17,30-34,1949,18
STAT,1857,13,na,1870,2081.0210887023027
STAT,1899,23,20-24,1922,88.92488761784224
SIM,1835,23,30-34,1858,23
STAT,1864,15,na,1879,2223.1810272977923
SIM,1882,62,na,1944,1709
STAT,1858,41,30-34,1899,0.8553909686148117
STAT,1796,99,na,1895,0.40788051601145925
STAT,1907,42,35-39,1949,0.17428722925551315
SIM,1911,40,40-44,1951,1
SIM,1856,15,15-19,1871,7
SIM,1875,60,na,1935,1800
STAT,1853,39,25-29,1892,2.1570349612499022
STAT,1883,16,20-24,1899,16.460731568625796
SIM,1852,23,30-34,1875,16
STAT,1854,70,na,1924,1003.8785802574079
STAT,1872,10,na,1882,2525.2400001430806
SIM,1822,32,20-24,1854,3
STAT,1909,28,45-49,1937,1.554324914471412
SIM,1915,17,30-34,1932,3
STAT,1832,47,40-44,1879,0.12233287584040624
STAT,1871,32,35-39,1903,9.499920101562846
STAT,1924,42,35-39,1966,0.22626671202061424
STAT,1780,76,na,1856,290.3884722999
STAT,1858,60,na,1918,1412.6126508670602
STAT,1834,44,40-44,1878,1.6402407612015557
STAT,1871,52,45-49,1923,0.013541220934386202
SIM,1934,19,20-24,1953,179
STAT,1926,19,20-24,1945,156.18266529645618
STAT,1868,27,35-39,1895,8.696985565597695
STAT,1858,50,20-24,1908,5.544175615340561E-4
SIM,1836,28,na,1864,1734
SIM,1816,73,na,1889,505
SIM,1918,49,na,1967,3672
SIM,1861,92,na,1953,32
SIM,1880,46,50-100,1926,2
STAT,1915,42,25-29,1957,0.06791825742153403
STAT,1935,20,na,1955,4701.027128268068
STAT,1909,31,45-49,1940,1.4244236866201514
SIM,1873,15,15-19,1888,4
SIM,1895,27,45-49,1922,1
STAT,1907,17,30-34,1924,2.2118567379794567
SIM,1917,28,45-49,1945,1
SIM,1921,49,50-100,1970,2
STAT,1885,84,na,1969,616.5105572827152
STAT,1841,20,na,1861,1894.4352750131911
STAT,1865,15,15-19,1880,5.8227303959084304
SIM,1855,29,50-100,1884,1
SIM,1828,36,45-49,1864,1
SIM,1880,39,35-39,1919,17
STAT,1904,43,20-24,1947,0.014836020285638518
STAT,1812,49,na,1861,1295.6647948179484
STAT,1915,32,na,1947,3638.915769579479
STAT,1839,25,15-19,1864,0.3860699127909317
STAT,1859,44,45-49,1903,1.1101199976601057
STAT,1932,26,na,1958,4637.353996577765
STAT,1854,78,na,1932,559.0318486984789
SIM,1920,25,50-100,1945,1
SIM,1926,21,45-49,1947,1
STAT,1821,41,35-39,1862,3.2098235391972674
STAT,1848,31,20-24,1879,2.3667511222111486
STAT,1878,82,na,1960,616.6861228672697
STAT,1875,50,20-24,1925,7.268273962114525E-4
SIM,1898,31,25-29,1929,12
STAT,1803,64,na,1867,840.4549356882975
STAT,1929,38,na,1967,4558.137642401757
SIM,1878,27,45-49,1905,3
STAT,1817,105,na,1922,0.013570836208084015
SIM,1879,19,30-34,1898,2
STAT,1865,43,30-34,1908,0.9773107809214598
STAT,1924,17,30-34,1941,13.711758407620735
SIM,1827,65,na,1892,938
SIM,1867,44,45-49,1911,4
SIM,1873,43,30-34,1916,1
STAT,1872,39,35-39,1911,6.634685471214886
SIM,1878,35,na,1913,2402
STAT,1791,68,na,1859,669.7407815676121
SIM,1882,40,na,1922,2205
STAT,1881,43,15-19,1924,0.012511899437908524
SIM,1927,19,15-19,1946,53
STAT,1874,33,30-34,1907,16.781410155214683
SIM,1869,37,45-49,1906,4
STAT,1821,85,na,1906,146.04953276543796
SIM,1887,4,na,1891,2717
STAT,1861,50,35-39,1911,0.006859482478096577
SIM,1887,18,na,1905,2616
STAT,1809,53,45-49,1862,0.03823159282996696
STAT,1954,7,na,1961,4590.068746238544
SIM,1857,30,25-29,1887,5
STAT,1859,15,30-34,1874,1.4076422848110097
SIM,1929,24,20-24,1953,129
SIM,1876,0,na,1876,3457
SIM,1916,32,40-44,1948,5
STAT,1899,21,25-29,1920,74.32258443844995
STAT,1870,94,na,1964,53.87615027843457
SIM,1827,43,na,1870,1452
SIM,1901,33,35-39,1934,17
SIM,1815,42,30-34,1857,2
SIM,1872,3,na,1875,2837
SIM,1931,39,na,1970,4662
STAT,1860,51,30-34,1911,0.004584517502524503
SIM,1829,91,na,1920,36
STAT,1824,42,30-34,1866,1.5111576389238872
SIM,1910,43,na,1953,3298
SIM,1917,31,45-49,1948,2
STAT,1857,35,na,1892,1772.0174270056693
SIM,1892,64,na,1956,2320
STAT,1923,41,na,1964,4106.61365719392
SIM,1903,33,na,1936,3245
SIM,1766,89,na,1855,24
SIM,1856,31,20-24,1887,2
STAT,1933,32,35-39,1965,11.634016936222617
SIM,1816,51,na,1867,1298
SIM,1906,27,30-34,1933,41
STAT,1891,33,30-34,1924,20.32047428434444
STAT,1820,58,na,1878,1116.5253171476602
STAT,1876,44,45-49,1920,1.4410109106600324
STAT,1808,54,40-44,1862,0.03653274639480981
STAT,1904,49,35-39,1953,0.10477674304483382
STAT,1919,19,15-19,1938,47.124485541322066
STAT,1891,0,na,1891,3431.935005555354
SIM,1863,39,35-39,1902,10
SIM,1901,40,40-44,1941,3
SIM,1882,33,30-34,1915,20
STAT,1868,30,35-39,1898,9.201322859849947
STAT,1819,40,50-100,1859,2.3868702686974457
STAT,1884,15,25-29,1899,5.313447937368786
SIM,1898,55,na,1953,2581
STAT,1910,33,35-39,1943,8.289149512921862
STAT,1854,56,na,1910,1459.3275912933614
STAT,1855,110,na,1965,0.0012324157413013972
STAT,1908,16,35-39,1924,0.7708453107979283
SIM,1849,78,na,1927,554
SIM,1857,87,na,1944,101
SIM,1884,44,45-49,1928,6
SIM,1832,42,30-34,1874,1
STAT,1838,42,50-100,1880,0.8294700730459856
SIM,1907,57,na,1964,2983
STAT,1885,47,20-24,1932,0.011247043384021774
SIM,1831,45,50-100,1876,2
STAT,1862,42,35-39,1904,1.460827118201026
STAT,1867,31,30-34,1898,15.551426455943234
SIM,1770,94,na,1864,5
STAT,1848,15,15-19,1863,5.531464236210798
SIM,1867,15,30-34,1882,1
STAT,1923,43,30-34,1966,0.1409366955377228
SIM,1916,16,35-39,1932,1
STAT,1803,86,na,1889,73.17669716438184
STAT,1938,30,50-100,1968,0.7862666236041108
STAT,1884,40,20-24,1924,0.14971912117642236
STAT,1844,23,30-34,1867,15.335162592472887
SIM,1877,10,na,1887,2550
SIM,1911,30,na,1941,3486
STAT,1883,37,45-49,1920,1.846394035170496
STAT,1810,91,na,1901,24.514184402459666
SIM,1935,24,50-100,1959,1
SIM,1822,38,35-39,1860,13
STAT,1881,29,35-39,1910,8.742739012345394
STAT,1905,42,25-29,1947,0.060816117468847485
STAT,1936,24,50-100,1960,0.5938635240814661
SIM,1909,38,na,1947,3384
STAT,1850,35,35-39,1885,5.171104947907199
STAT,1927,24,50-100,1951,0.7610417821966867
SIM,1854,23,40-44,1877,1
SIM,1851,17,na,1868,2067
STAT,1760,98,na,1858,0.4213449594893741
STAT,1863,26,45-49,1889,0.9271171893903609
SIM,1942,25,45-49,1967,2
SIM,1847,63,na,1910,1340
STAT,1834,58,na,1892,1226.0509468579405
STAT,1855,1,na,1856,2683.1586022508873
STAT,1896,17,45-49,1913,0.0815019383469612
STAT,1905,22,na,1927,3229.4606141032937
STAT,1894,23,50-100,1917,0.4935479374250205
SIM,1948,22,35-39,1970,9
STAT,1898,42,15-19,1940,0.001224473155512048
SIM,1779,88,na,1867,40
STAT,1950,22,25-29,1972,103.5214031272603
SIM,1880,81,na,1961,765
SIM,1866,35,50-100,1901,1
STAT,1829,26,45-49,1855,1.9778561363385132
SIM,1835,42,40-44,1877,4
SIM,1871,26,45-49,1897,2
STAT,1925,38,15-19,1963,0.02175096751536673
STAT,1793,106,na,1899,0.0020138369274525104
STAT,1846,23,40-44,1869,1.8933261793356013
STAT,1890,31,na,1921,2767.370892146547
STAT,1820,49,15-19,1869,6.514255219619804E-4
STAT,1864,19,15-19,1883,5.108288967900972
STAT,1868,47,20-24,1915,0.010765680544465722
STAT,1867,22,50-100,1889,0.3632321470727992
SIM,1880,33,20-24,1913,3
SIM,1928,41,na,1969,4487
SIM,1937,21,20-24,1958,100
SIM,1849,44,na,1893,1715
STAT,1825,54,40-44,1879,0.009946279293613221
STAT,1921,29,40-44,1950,4.872360398761431
STAT,1864,22,15-19,1886,2.822352617693806
STAT,1912,33,45-49,1945,1.4566305930819383
SIM,1819,56,na,1875,1175
SIM,1849,46,na,1895,1710
SIM,1933,16,35-39,1949,7
STAT,1869,23,35-39,1892,5.324067432255501
STAT,1898,57,na,1955,2569.1516726350774
SIM,1878,89,na,1967,224
STAT,1816,46,45-49,1862,0.5662717125216868
STAT,1925,16,35-39,1941,4.800216577311942
SIM,1872,19,15-19,1891,6
STAT,1894,33,40-44,1927,5.242770092959133
SIM,1891,37,45-49,1928,2
STAT,1857,29,25-29,1886,31.998646474835873
STAT,1929,21,20-24,1950,133.23423068959013
STAT,1892,45,40-44,1937,0.11540693407603807
STAT,1942,9,na,1951,3901.6598021660943
STAT,1868,43,40-44,1911,2.012721794900178
SIM,1882,21,20-24,1903,59
STAT,1859,40,35-39,1899,1.3752720842286248
SIM,1937,18,20-24,1955,119
STAT,1931,35,35-39,1966,3.0313445718309544
STAT,1929,18,20-24,1947,163.01911625581093
STAT,1859,37,35-39,1896,5.318062611836841
STAT,1901,40,30-34,1941,0.10663482000238392
STAT,1934,25,45-49,1959,2.1974327161316514
STAT,1836,59,na,1895,1258.5224115362196
STAT,1870,53,40-44,1923,0.009599965015621381
SIM,1865,29,25-29,1894,37
SIM,1900,21,25-29,1921,78
SIM,1898,23,na,1921,2951
SIM,1872,86,na,1958,236
STAT,1865,101,na,1966,2.5099922642383916
STAT,1937,35,na,1972,3560.136630889068
SIM,1854,47,na,1901,1805
STAT,1865,64,na,1929,1488.4975174537765
STAT,1880,47,50-100,1927,0.24346125639623215
SIM,1903,39,40-44,1942,1
STAT,1931,32,25-29,1963,11.440882770725322
SIM,1874,11,na,1885,2469
STAT,1872,33,20-24,1905,2.5505480634531685
SIM,1908,49,50-100,1957,3
STAT,1830,46,50-100,1876,0.1864277449114189
STAT,1918,21,45-49,1939,1.1498864635578232
SIM,1879,76,na,1955,876
STAT,1816,53,na,1869,1260.0263208594706
SIM,1839,39,25-29,1878,1
SIM,1856,48,na,1904,1747
STAT,1914,46,25-29,1960,0.049823504040568026
SIM,1866,22,20-24,1888,58
SIM,1773,83,na,1856,109
SIM,1872,22,15-19,1894,7
SIM,1920,33,45-49,1953,3
SIM,1962,9,na,1971,4629
SIM,1846,89,na,1935,60
STAT,1837,36,45-49,1873,1.5916488436675311
STAT,1952,18,45-49,1970,0.5653381678134713
SIM,1884,33,50-100,1917,3
SIM,1859,30,35-39,1889,10
STAT,1831,42,na,1873,1496.2095836873461
STAT,1818,62,na,1880,1010.2075669493479
STAT,1842,30,15-19,1872,0.1271968396534894
STAT,1838,29,20-24,1867,9.875425210697516
STAT,1865,31,20-24,1896,2.3239964500184795
SIM,1809,46,na,1855,1323
SIM,1846,29,20-24,1875,9
STAT,1906,16,25-29,1922,7.81602250078209
STAT,1822,48,35-39,1870,0.18559298168493638
SIM,1861,78,na,1939,628
STAT,1832,77,na,1909,520.7110506895962
SIM,1841,40,na,1881,1630
STAT,1908,35,45-49,1943,0.6087129143723596
SIM,1892,15,25-29,1907,10
SIM,1943,15,40-44,1958,3
SIM,1850,36,45-49,1886,2
STAT,1868,15,40-44,1883,0.16983792453376675
STAT,1918,18,45-49,1936,0.5123097400612094
STAT,1884,20,50-100,1904,0.3828701083022169
STAT,1935,15,40-44,1950,1.8147594564703893
SIM,1848,26,20-24,1874,11
SIM,1861,32,40-44,1893,3
STAT,1946,24,25-29,1970,97.0396417210713
STAT,1850,54,40-44,1904,0.0072171085840322495
STAT,1840,42,15-19,1882,0.00945382837090411
STAT,1941,17,30-34,1958,11.860313907417945
SIM,1820,35,20-24,1855,5
SIM,1837,26,45-49,1863,3
STAT,1889,74,na,1963,1540.2833488270498
SIM,1785,70,na,1855,586
SIM,1896,14,na,1910,3241
STAT,1851,44,40-44,1895,1.5961607674697695
SIM,1830,88,na,1918,66
STAT,1858,22,20-24,1880,58.5637345903989
STAT,1831,35,30-34,1866,4.184708115937501
SIM,1811,50,na,1861,1183
STAT,1915,54,na,1969,3406.0058334763703
SIM,1834,45,na,1879,1496
SIM,1844,39,25-29,1883,2
STAT,1924,32,25-29,1956,10.186555726948619
STAT,1926,40,35-39,1966,0.23515857327669662
SIM,1845,62,na,1907,1275
STAT,1848,36,20-24,1884,0.5964277723938192
SIM,1917,19,20-24,1936,134
SIM,1866,16,na,1882,2316
SIM,1864,35,na,1899,2068
STAT,1841,52,na,1893,1476.517154538738
STAT,1921,36,50-100,1957,0.4432764794461277
STAT,1839,48,na,1887,1506.7785522478084
SIM,1902,20,45-49,1922,5
STAT,1844,49,25-29,1893,0.03916929920229295
STAT,1853,32,40-44,1885,3.379790811807022
SIM,1932,32,25-29,1964,8
SIM,1845,36,45-49,1881,1
STAT,1870,16,35-39,1886,0.5164082225058307
STAT,1849,77,na,1926,648.1800123076882
STAT,1931,22,15-19,1953,6.522107331174622
STAT,1895,52,na,1947,2637.793718977529
SIM,1841,58,na,1899,1308
STAT,1830,39,30-34,1869,4.213333080004365
STAT,1870,7,na,1877,2544.7285768687716
STAT,1948,18,30-34,1966,13.173766822098166
STAT,1844,17,na,1861,2026.5512312414307
SIM,1871,70,na,1941,1262
SIM,1838,22,45-49,1860,1
SIM,1872,19,20-24,1891,13
SIM,1852,26,35-39,1878,12
STAT,1832,106,na,1938,0.007314171138461884
STAT,1889,37,20-24,1926,0.8990062638561912
STAT,1831,32,20-24,1863,2.1573380369958026
STAT,1940,21,na,1961,3515.4746337362085
STAT,1844,26,35-39,1870,8.262984565455488
STAT,1905,45,35-39,1950,0.10891043020002948
STAT,1917,8,na,1925,4041.3607115968302
STAT,1902,46,20-24,1948,0.009050265707647873
SIM,1864,40,45-49,1904,1
SIM,1791,88,na,1879,35
SIM,1867,41,40-44,1908,4
STAT,1829,71,na,1900,806.5339925421406
STAT,1806,75,na,1881,431.96078591747084
STAT,1867,19,40-44,1886,0.1639192850006085
STAT,1858,53,25-29,1911,0.0025813801655508693
STAT,1947,17,25-29,1964,46.11716298398184
SIM,1895,24,40-44,1919,2
STAT,1839,53,30-34,1892,0.0038995636024991153
SIM,1901,30,30-34,1931,27
SIM,1875,31,30-34,1906,23
STAT,1850,40,15-19,1890,0.009833100192078939
STAT,1891,36,35-39,1927,8.30648597000152
STAT,1892,12,na,1904,3055.75473013198
STAT,1842,50,25-29,1892,0.0026019240386117417
SIM,1823,53,na,1876,1193
SIM,1828,33,40-44,1861,2
SIM,1863,59,na,1922,1612
STAT,1914,48,40-44,1962,0.14730861288665908
SIM,1858,29,na,1887,1978
SIM,1854,98,na,1952,5
STAT,1867,51,40-44,1918,0.009383529673039693
STAT,1875,40,na,1915,2266.8929893523537
SIM,1872,30,na,1902,2271
SIM,1890,30,45-49,1920,2
STAT,1915,22,30-34,1937,28.066958422438756
SIM,1913,11,na,1924,3695
STAT,1899,26,25-29,1925,54.94297778127496
SIM,1935,24,15-19,1959,9
STAT,1840,28,35-39,1868,7.838619711770259
STAT,1887,24,40-44,1911,2.188143628833527
SIM,1844,23,na,1867,1769
STAT,1809,51,na,1860,1200.2816573059001
STAT,1927,24,15-19,1951,6.156827309177973
STAT,1802,53,35-39,1855,0.024703165733653134
STAT,1937,31,20-24,1968,2.2810595838715515
SIM,1885,20,35-39,1905,9
STAT,1890,40,45-49,1930,1.7460101234443102
STAT,1824,45,35-39,1869,0.175587056961592
STAT,1840,56,na,1896,1338.5254401500133
SIM,1923,22,30-34,1945,47
STAT,1848,92,na,1940,30.94793118335873
SIM,1899,16,25-29,1915,8
STAT,1827,45,na,1872,1497.1668930251885
STAT,1829,49,35-39,1878,0.11147044669223478
STAT,1937,28,20-24,1965,16.801676560687227
STAT,1918,40,45-49,1958,0.167630520039173
STAT,1818,36,35-39,1854,24.717636270250402
SIM,1929,27,25-29,1956,94
SIM,1799,76,na,1875,358
STAT,1880,53,na,1933,2109.9838882126323
STAT,1857,47,45-49,1904,0.17501464515788018
SIM,1800,98,na,1898,1
SIM,1876,43,40-44,1919,6
SIM,1834,30,30-34,1864,19
SIM,1906,23,15-19,1929,4
STAT,1827,42,40-44,1869,2.1576995662176954
STAT,1893,21,30-34,1914,21.404033953159896
STAT,1836,52,35-39,1888,0.005640855511705338
STAT,1818,45,50-100,1863,0.539704191403248
STAT,1855,16,45-49,1871,0.055538982852705907
STAT,1872,36,30-34,1908,5.074493520499547
STAT,1833,25,20-24,1858,9.625727342560667
STAT,1865,52,20-24,1917,6.284917229613957E-4
STAT,1824,40,na,1864,1554.3373092340553
STAT,1878,32,45-49,1910,1.7168288709628912
STAT,1956,14,na,1970,4907.855022559642
STAT,1884,43,25-29,1927,0.5950089752499669
STAT,1775,97,na,1872,0.8442739548825255
STAT,1898,35,na,1933,3040.5320461300944
SIM,1841,25,20-24,1866,15
STAT,1914,35,50-100,1949,0.39978678859476524
SIM,1795,101,na,1896,1
SIM,1935,21,na,1956,4597
STAT,1816,40,50-100,1856,3.123666319280925
STAT,1887,44,20-24,1931,0.16555004660842593
STAT,1864,50,45-49,1914,0.012394635906093174
STAT,1865,46,35-39,1911,0.1202176191663137
STAT,1817,52,25-29,1869,0.007651309040720643
SIM,1889,27,20-24,1916,14
SIM,1869,34,40-44,1903,4
STAT,1852,46,na,1898,1635.734651877867
SIM,1900,31,35-39,1931,13
STAT,1872,75,na,1947,975.4948508802047
STAT,1933,21,35-39,1954,11.834590306099543
SIM,1886,32,45-49,1918,1
STAT,1910,40,50-100,1950,0.10607968273501073
SIM,1823,75,na,1898,502
SIM,1837,18,15-19,1855,4
STAT,1826,30,30-34,1856,27.616289155542077
SIM,1854,76,na,1930,716
STAT,1909,25,40-44,1934,4.272849758684057
SIM,1873,18,na,1891,2428
STAT,1887,43,na,1930,2424.608492335136
STAT,1835,32,na,1867,1756.0862026765485
STAT,1945,22,na,1967,3780.963175172396
STAT,1851,42,50-100,1893,0.7590156029390236
STAT,1862,46,15-19,1908,3.2400444624003193E-4
STAT,1822,99,na,1921,0.9623450133707907
STAT,1837,98,na,1935,2.1082510142248716
STAT,1848,19,30-34,1867,1.4509176836890723
SIM,1852,10,na,1862,2227
STAT,1829,89,na,1918,63.47707325708104
SIM,1879,23,45-49,1902,4
STAT,1842,103,na,1945,0.10393103633489946
SIM,1880,36,30-34,1916,6
SIM,1939,17,40-44,1956,1
STAT,1883,31,15-19,1914,0.1324389175856988
STAT,1838,32,15-19,1870,0.11880251191573188
STAT,1862,31,50-100,1893,0.7430929033592656
STAT,1869,18,50-100,1887,0.04518998365214117
STAT,1893,41,40-44,1934,2.706887517893518
STAT,1838,29,15-19,1867,0.3819225250229384
SIM,1893,31,40-44,1924,10
STAT,1816,40,15-19,1856,0.04083224245148036
SIM,1826,40,40-44,1866,6
SIM,1915,20,na,1935,3408
STAT,1883,51,25-29,1934,0.003296356394691682
SIM,1840,40,50-100,1880,1
STAT,1864,19,20-24,1883,15.260204998302367
SIM,1856,19,30-34,1875,2
STAT,1826,50,40-44,1876,0.009755511541344297
STAT,1916,39,50-100,1955,0.40208824577352165
SIM,1852,64,na,1916,1294
STAT,1844,49,na,1893,1529.9424864151042
STAT,1856,41,20-24,1897,0.11758721766489028
STAT,1887,11,na,1898,2732.968967678495
STAT,1910,23,na,1933,3375.170701444392
STAT,1935,30,35-39,1965,11.957089787142316
SIM,1925,11,na,1936,4510
SIM,1831,81,na,1912,273
SIM,1906,29,50-100,1935,3
STAT,1899,45,35-39,1944,0.10324022857915889
STAT,1810,99,na,1909,0.8011795456464812
STAT,1936,35,20-24,1971,0.24489516159252936
STAT,1904,32,50-100,1936,0.7129063204928586
STAT,1927,45,50-100,1972,0.26946806992385686
STAT,1866,37,45-49,1903,1.7369674659868217
STAT,1922,42,25-29,1964,0.07743043472188346
SIM,1861,40,35-39,1901,1
STAT,1928,21,na,1949,4320.184818655979
SIM,1796,97,na,1893,1
SIM,1937,29,50-100,1966,5
STAT,1912,30,40-44,1942,3.6670921627546034
SIM,1862,44,50-100,1906,6
STAT,1863,43,20-24,1906,0.13070767623277843
SIM,1891,19,25-29,1910,6
STAT,1863,81,na,1944,448.3031258787366
SIM,1903,19,na,1922,3393
STAT,1872,48,25-29,1920,0.053894644286043125
SIM,1825,87,na,1912,84
SIM,1837,23,40-44,1860,1
STAT,1850,31,na,1881,1778.0823083093053
STAT,1867,96,na,1963,21.72064813544364
STAT,1901,43,35-39,1944,0.16507885207908576
STAT,1800,81,na,1881,210.4442684146042
STAT,1905,23,25-29,1928,77.92702092330352
SIM,1874,37,45-49,1911,4
STAT,1842,54,40-44,1896,0.007414284075316864
STAT,1832,91,na,1923,34.90784672607484
STAT,1872,54,50-100,1926,0.01391747828081037
SIM,1865,31,na,1896,2123
STAT,1892,20,25-29,1912,68.14003876319006
SIM,1792,72,na,1864,496
STAT,1859,18,35-39,1877,0.4760856416492601
STAT,1829,57,na,1886,1243.7343523896095
STAT,1881,26,30-34,1907,23.060030701786715
STAT,1797,106,na,1903,0.0029794394342155593
SIM,1925,22,50-100,1947,4
STAT,1911,48,30-34,1959,0.07950815345471007
STAT,1870,47,20-24,1917,0.011069288542086268
SIM,1850,86,na,1936,161
STAT,1841,37,40-44,1878,3.5556826145060025
STAT,1853,52,35-39,1905,0.006480618365082673
SIM,1822,35,30-34,1857,5
STAT,1910,21,40-44,1931,2.992035848885952
STAT,1868,18,45-49,1886,0.059590889011110676
SIM,1873,50,50-100,1923,1
SIM,1801,74,na,1875,432
STAT,1865,96,na,1961,16.566425590358612
SIM,1882,38,50-100,1920,1
STAT,1918,15,40-44,1933,0.28989274277759386
STAT,1856,0,na,1856,2932.725642940352
STAT,1845,41,45-49,1886,1.0923721800992072
STAT,1876,59,na,1935,1896.8303356910603
SIM,1803,84,na,1887,89
SIM,1852,42,40-44,1894,5
SIM,1835,94,na,1929,7
STAT,1962,1,na,1963,4764.870739519423
STAT,1865,19,na,1884,2202.336187091928
SIM,1937,21,na,1958,3244
STAT,1849,51,25-29,1900,0.0026687502813803037
STAT,1768,95,na,1863,1.6597640762283565
STAT,1878,69,na,1947,1444.8266947885309
STAT,1925,35,45-49,1960,0.7742788489322084
SIM,1807,77,na,1884,314
SIM,1832,30,20-24,1862,1
STAT,1933,7,na,1940,5055.0462740205785
STAT,1876,56,na,1932,1990.6925874224728
STAT,1808,87,na,1895,68.12122023638655
STAT,1860,42,25-29,1902,0.49161357653315163
STAT,1793,91,na,1884,16.928790599447495
STAT,1878,37,na,1915,2319.5080558095233
STAT,1866,49,na,1915,1919.4039480206366
SIM,1788,68,na,1856,675
SIM,1914,32,30-34,1946,17
STAT,1860,49,45-49,1909,0.17711930701696874
STAT,1843,33,35-39,1876,8.138398861951819
STAT,1859,41,40-44,1900,1.698861505289717
SIM,1849,29,40-44,1878,5
SIM,1859,22,na,1881,1990
STAT,1909,40,35-39,1949,0.17995302347562672
SIM,1829,29,20-24,1858,8
SIM,1871,56,na,1927,1953
STAT,1844,42,40-44,1886,1.5999281989198293
STAT,1920,46,15-19,1966,3.8563309539270206E-4
STAT,1813,51,45-49,1864,0.03870906879477209
STAT,1860,30,30-34,1890,13.490617112406822
STAT,1891,21,20-24,1912,80.78679811451211
STAT,1841,45,35-39,1886,0.09947165085124517
STAT,1879,33,15-19,1912,0.14022885784942243
SIM,1763,92,na,1855,5
STAT,1880,42,45-49,1922,1.4887210100912116
SIM,1850,54,na,1904,1557
STAT,1821,45,15-19,1866,6.496980107266279E-4
STAT,1821,51,na,1872,1306.915678093811
STAT,1921,43,20-24,1964,0.018761413597430283
STAT,1853,36,20-24,1889,0.5894646232954425
STAT,1848,39,25-29,1887,2.1593907312042124
STAT,1824,30,20-24,1854,9.332925965225483
STAT,1856,53,30-34,1909,0.004317046186251941
STAT,1874,44,na,1918,2200.7502465250345
STAT,1922,49,45-49,1971,0.23448973718871693
STAT,1793,94,na,1887,3.8838580098055595
STAT,1906,32,30-34,1938,13.79394519372686
STAT,1902,49,25-29,1951,0.04241383197720085
STAT,1844,46,na,1890,1567.0041280145085
SIM,1917,47,50-100,1964,2
STAT,1893,29,na,1922,2838.6861714025877
STAT,1910,43,45-49,1953,0.14770358256911315
STAT,1940,25,35-39,1965,14.47557272226636
STAT,1843,39,50-100,1882,0.8628685083822463
SIM,1803,52,na,1855,1148
STAT,1891,48,na,1939,2597.0137882001954
SIM,1859,24,30-34,1883,18
SIM,1929,26,na,1955,4373
STAT,1776,90,na,1866,27.222644168072865
SIM,1866,41,30-34,1907,1
SIM,1913,23,25-29,1936,81
STAT,1879,14,na,1893,2545.50651104128
STAT,1892,27,45-49,1919,1.3137665169225134
SIM,1942,29,50-100,1971,1
SIM,1833,36,45-49,1869,3
SIM,1803,87,na,1890,52
SIM,1920,30,40-44,1950,9
SIM,1898,16,30-34,1914,2
STAT,1822,42,20-24,1864,0.23114398938642375
STAT,1909,19,20-24,1928,24.982738883989647
STAT,1799,85,na,1884,87.04502489949262
STAT,1846,27,na,1873,1941.0555418307288
SIM,1889,41,25-29,1930,3
STAT,1866,22,50-100,1888,0.35821767290444345
SIM,1786,87,na,1873,66
STAT,1834,51,50-100,1885,0.009802591176245018
STAT,1912,39,40-44,1951,1.3664328628239835
STAT,1851,40,25-29,1891,0.4665921930774458
STAT,1825,36,45-49,1861,2.6088878079681646
STAT,1880,21,45-49,1901,0.6965835806365206
SIM,1933,35,45-49,1968,3
SIM,1920,39,40-44,1959,2
STAT,1900,33,40-44,1933,5.659302885667764
SIM,1949,5,na,1954,4255
STAT,1910,22,45-49,1932,0.998235062745776
SIM,1848,40,25-29,1888,2
SIM,1889,41,na,1930,2821
SIM,1940,25,35-39,1965,17
STAT,1847,50,45-49,1897,0.010855345113181605
SIM,1796,65,na,1861,824
STAT,1815,52,30-34,1867,0.012862918203934237
STAT,1851,19,na,1870,1983.9898975152012
SIM,1847,12,na,1859,2227
STAT,1842,18,25-29,1860,5.23870826743875
SIM,1850,18,25-29,1868,6
STAT,1817,43,35-39,1860,4.421523960827288
STAT,1913,49,50-100,1962,0.2073372744155364
STAT,1937,34,25-29,1971,8.627384564374633
STAT,1920,43,45-49,1963,0.17336942379600684
STAT,1823,45,50-100,1868,0.31130470447209296
SIM,1934,4,na,1938,5027
STAT,1850,34,na,1884,1723.5467892111353
STAT,1883,52,50-100,1935,0.013913901211405033
SIM,1928,34,25-29,1962,9
STAT,1901,42,50-100,1943,0.09689045344389383
SIM,1902,56,na,1958,2759
STAT,1892,63,na,1955,2111.27855933634
SIM,1928,19,30-34,1947,16
SIM,1960,10,na,1970,4854
STAT,1854,45,50-100,1899,0.17747500555523324
SIM,1878,19,15-19,1897,6
STAT,1943,10,na,1953,3947.037908488087
STAT,1840,25,30-34,1865,20.904387552742232
SIM,1939,11,na,1950,3706
STAT,1921,18,na,1939,3953.142397543931
STAT,1921,24,20-24,1945,117.90356705347217
SIM,1805,65,na,1870,808
STAT,1847,29,50-100,1876,0.5588633654617221
STAT,1890,45,15-19,1935,4.665917394480107E-4
STAT,1831,47,25-29,1878,0.04103522869895861
STAT,1910,26,na,1936,3429.2351999019816
STAT,1842,36,45-49,1878,1.71118428735663
SIM,1808,47,50-100,1855,3
STAT,1887,47,30-34,1934,0.10181017280580301
STAT,1921,25,25-29,1946,69.76977907175718
STAT,1852,12,na,1864,2093.233339692599
STAT,1893,44,45-49,1937,0.12283007090566843
STAT,1897,42,20-24,1939,0.013915809615683663
STAT,1879,18,20-24,1897,17.485337569125758
SIM,1879,34,na,1913,2389
SIM,1915,23,na,1938,3407
SIM,1857,15,30-34,1872,3
SIM,1860,61,na,1921,1537
STAT,1827,46,20-24,1873,0.01112275220858449
SIM,1861,49,na,1910,1912
STAT,1867,54,45-49,1921,0.012519627300037358
SIM,1851,33,35-39,1884,8
SIM,1868,81,na,1949,398
STAT,1890,63,na,1953,2060.8104124719857
STAT,1906,35,35-39,1941,2.1204418625601282
STAT,1927,37,50-100,1964,0.49312657713129426
STAT,1936,19,15-19,1955,40.82548916373747
STAT,1850,20,20-24,1870,59.15227620160441
SIM,1837,75,na,1912,622
SIM,1935,3,na,1938,5143
STAT,1861,26,na,1887,1901.8579110982337
STAT,1936,36,25-29,1972,0.9139576983131454
SIM,1869,17,15-19,1886,5
SIM,1947,24,15-19,1971,9
STAT,1900,31,25-29,1931,13.477833530353625
STAT,1892,41,na,1933,2747.1493807132983
STAT,1915,44,40-44,1959,0.23710493878574324
STAT,1939,4,na,1943,3808.4275397580122
STAT,1877,37,20-24,1914,0.7553815350438835
SIM,1938,18,na,1956,3286
STAT,1826,53,45-49,1879,0.012670468257812139
SIM,1849,22,20-24,1871,60
SIM,1944,19,15-19,1963,40
SIM,1922,32,30-34,1954,23
SIM,1895,69,na,1964,2029
STAT,1912,46,15-19,1958,3.35284684962002E-4
STAT,1779,87,na,1866,45.58304080080437
STAT,1883,29,50-100,1912,0.5882569928373331
STAT,1939,24,15-19,1963,5.046921225983898
SIM,1847,34,na,1881,1829
STAT,1825,64,na,1889,932.3135420129236
SIM,1897,70,na,1967,2121
STAT,1768,107,na,1875,0.005416445504424189
STAT,1849,15,30-34,1864,1.488670910303632
SIM,1794,87,na,1881,47
STAT,1829,46,30-34,1875,0.08016381065544702
SIM,1890,43,30-34,1933,1
STAT,1812,51,35-39,1863,0.02809888348505527
STAT,1883,19,25-29,1902,5.2204524747622925
SIM,1860,93,na,1953,19
SIM,1903,32,20-24,1935,4
STAT,1851,26,45-49,1877,0.9419164922938661
SIM,1812,66,na,1878,804
STAT,1896,37,30-34,1933,6.649636603787082
STAT,1893,26,na,1919,2868.9325927643067
SIM,1902,34,na,1936,3167
SIM,1922,29,30-34,1951,49
SIM,1885,2,na,1887,2872
STAT,1943,18,na,1961,3686.1187371880046
STAT,1932,25,35-39,1957,18.59307107552533
STAT,1855,86,na,1941,157.67113546382296
SIM,1856,57,na,1913,1575
SIM,1900,2,na,1902,3525
STAT,1874,18,50-100,1892,0.04716421298376822
STAT,1914,32,30-34,1946,14.982421738797758
STAT,1882,43,30-34,1925,1.0485879864947762
STAT,1898,48,45-49,1946,0.1680494725729203
SIM,1825,43,35-39,1868,2
SIM,1899,45,50-100,1944,1
STAT,1831,54,30-34,1885,0.003585419515307524
STAT,1901,19,50-100,1920,0.06443658762610116
SIM,1814,92,na,1906,7
SIM,1887,63,na,1950,1842
STAT,1836,19,45-49,1855,0.08065950433883153
STAT,1855,16,50-100,1871,0.041654237139529426
STAT,1882,34,na,1916,2173.570679897069
STAT,1897,49,40-44,1946,0.11945877651962174
STAT,1884,34,35-39,1918,9.37087795828003
STAT,1820,106,na,1926,0.0063963355086183804
SIM,1892,34,35-39,1926,19
STAT,1870,40,35-39,1910,1.6951256709916367
SIM,1849,44,50-100,1893,3
STAT,1833,28,25-29,1861,33.96366216865273
STAT,1854,52,45-49,1906,0.010328138650477445
SIM,1841,28,25-29,1869,43
STAT,1846,46,30-34,1892,0.07200077341696265
SIM,1866,44,35-39,1910,4
STAT,1907,59,na,1966,2907.646380027518
SIM,1913,17,20-24,1930,20
STAT,1841,51,20-24,1892,5.111645054782568E-4
SIM,1799,101,na,1900,1
SIM,1839,68,na,1907,1017
SIM,1873,19,30-34,1892,4
STAT,1830,35,15-19,1865,0.04690006706785836
STAT,1934,36,na,1970,4909.046150938661
STAT,1820,36,na,1856,1492.3806477896662
SIM,1875,15,25-29,1890,6
STAT,1874,41,15-19,1915,0.013389883858320116
SIM,1876,30,35-39,1906,13
STAT,1830,68,na,1898,922.3372332411112
SIM,1933,33,45-49,1966,2
STAT,1921,23,50-100,1944,0.6999213505180188
SIM,1772,84,na,1856,74
SIM,1903,34,20-24,1937,1
STAT,1839,41,20-24,1880,0.12404348186298504
SIM,1917,33,na,1950,3710
SIM,1876,27,35-39,1903,10
STAT,1799,56,na,1855,1016.6537419548864
STAT,1840,18,15-19,1858,5.012739294393732
STAT,1883,17,50-100,1900,0.0453769329626444
SIM,1913,20,20-24,1933,82
SIM,1909,19,20-24,1928,19
STAT,1830,43,na,1873,1528.2541864153511
STAT,1835,104,na,1939,0.04245297402299815
STAT,1869,55,na,1924,1892.3496405859776
SIM,1887,18,20-24,1905,20
STAT,1816,50,na,1866,1337.158755419232
SIM,1843,40,40-44,1883,2
STAT,1925,18,50-100,1943,0.4264204827672054
STAT,1901,37,15-19,1938,0.016027403033292503
STAT,1858,44,35-39,1902,1.3231320484727833
SIM,1862,31,45-49,1893,1
STAT,1827,90,na,1917,45.54081260352487
SIM,1906,44,40-44,1950,1
STAT,1866,30,25-29,1896,8.996336712341918
STAT,1839,29,30-34,1868,20.819260853601342
STAT,1881,45,30-34,1926,0.08922102430220233
STAT,1925,33,45-49,1958,1.7641259013008785
STAT,1856,16,50-100,1872,0.04295167936167139
STAT,1863,46,25-29,1909,0.04788697070358685
STAT,1865,19,30-34,1884,1.3898589781161264
STAT,1867,15,25-29,1882,5.200004449269574
STAT,1805,54,20-24,1859,0.002602249267682549
SIM,1891,16,20-24,1907,17
SIM,1924,21,35-39,1945,10
SIM,1863,27,na,1890,1954
SIM,1781,80,na,1861,186
STAT,1843,30,30-34,1873,14.475091678116755
STAT,1835,35,na,1870,1720.6230748610349
SIM,1826,80,na,1906,292
STAT,1940,22,30-34,1962,27.659194128798852
STAT,1835,40,40-44,1875,1.7598499276659512
STAT,1872,45,20-24,1917,0.011484290783455978
STAT,1843,83,na,1926,268.1435553064008
STAT,1881,33,50-100,1914,0.8326430032954641
STAT,1814,54,30-34,1868,0.01670708198192671
STAT,1813,107,na,1920,0.0019408350251744525
SIM,1857,41,na,1898,1854
STAT,1952,8,na,1960,4449.191622651788
STAT,1915,47,45-49,1962,0.20689583336045392
STAT,1845,42,na,1887,1665.4598672802608
STAT,1856,51,50-100,1907,0.011185163275688416
STAT,1931,26,50-100,1957,1.2144957715686855
STAT,1921,49,35-39,1970,0.13650091676950216
SIM,1862,42,na,1904,1966
STAT,1894,37,20-24,1931,0.9358486788922079
SIM,1830,32,na,1862,1700
STAT,1829,30,50-100,1859,0.9666674256637426
SIM,1787,83,na,1870,95
STAT,1841,42,30-34,1883,0.823605386669117
SIM,1841,72,na,1913,816
STAT,1836,47,50-100,1883,0.1664427393208528
STAT,1822,45,25-29,1867,0.07971234074502578
STAT,1860,46,40-44,1906,0.13159903260129582
STAT,1860,33,35-39,1893,7.7297363555868905
SIM,1828,28,na,1856,1721
STAT,1834,52,25-29,1886,0.0022538960432399707
STAT,1930,36,30-34,1966,2.2478233582388905
STAT,1916,21,35-39,1937,9.349059867242426
SIM,1803,55,na,1858,1077
SIM,1933,32,40-44,1965,4
STAT,1904,48,na,1952,3010.9143118277943
STAT,1814,72,na,1886,636.2021852486682
STAT,1816,53,50-100,1869,0.033477265679346994
STAT,1911,36,20-24,1947,0.24169735949358684
SIM,1898,58,na,1956,2470
SIM,1914,35,35-39,1949,5
STAT,1886,48,50-100,1934,0.2420072674103996
STAT,1910,40,40-44,1950,0.2258526586345085
STAT,1867,45,na,1912,2015.6814920987918
STAT,1909,37,na,1946,3364.2411449705637
STAT,1827,79,na,1906,403.8253709877058
STAT,1821,49,30-34,1870,0.1482993818085249
STAT,1870,32,40-44,1902,4.019100957955191
SIM,1866,29,40-44,1895,2
SIM,1813,62,na,1875,935
STAT,1858,29,40-44,1887,2.2388340496605887
SIM,1890,38,40-44,1928,6
STAT,1894,35,50-100,1929,1.5046962878795174
STAT,1925,32,40-44,1957,4.389931610113915
SIM,1775,95,na,1870,1
STAT,1903,40,40-44,1943,0.2120674194227212
SIM,1907,23,na,1930,3284
STAT,1876,88,na,1964,282.785578167136
SIM,1849,25,25-29,1874,49
STAT,1940,19,30-34,1959,11.683452854587577
SIM,1884,74,na,1958,1127
STAT,1915,46,40-44,1961,0.15046028829040659
SIM,1839,18,25-29,1857,3
SIM,1861,46,na,1907,1962
STAT,1853,93,na,1946,22.117664799719076
STAT,1905,17,20-24,1922,24.208210254335157
SIM,1926,26,50-100,1952,1
SIM,1901,21,40-44,1922,1
STAT,1892,24,40-44,1916,2.4502319532238155
STAT,1777,87,na,1864,47.73966523335812
STAT,1843,61,na,1904,1262.1637284064846
STAT,1861,30,40-44,1891,3.4338164629868513
STAT,1838,31,na,1869,1826.8391926488907
STAT,1925,41,30-34,1966,0.14642829122633017
STAT,1918,34,15-19,1952,0.12789854245641435
STAT,1899,42,30-34,1941,0.10321182623057663
SIM,1838,38,na,1876,1696
STAT,1877,50,30-34,1927,0.005916933743849493
STAT,1831,44,20-24,1875,0.11415912259301773
STAT,1854,31,45-49,1885,1.2910346647107909
STAT,1843,86,na,1929,149.86553588852757
STAT,1818,94,na,1912,9.815137080601177
STAT,1840,21,15-19,1861,2.773159561427154
STAT,1850,47,35-39,1897,0.09822917948289854
SIM,1950,18,na,1968,4002
STAT,1905,20,20-24,1925,94.66107607425533
SIM,1894,33,na,1927,2974
STAT,1921,22,20-24,1943,118.64631359732067
STAT,1830,51,45-49,1881,0.00975541740499187
STAT,1819,79,na,1898,369.0541177236475
SIM,1849,12,na,1861,2237
SIM,1836,79,na,1915,445
STAT,1852,43,45-49,1895,1.0772054508162296
SIM,1850,15,20-24,1865,23
STAT,1868,24,30-34,1892,15.954454096057907
STAT,1838,17,20-24,1855,15.7216680519883
STAT,1929,43,30-34,1972,0.15615510099464672
SIM,1855,19,20-24,1874,22
STAT,1873,40,45-49,1913,1.4484217121487255
STAT,1891,48,35-39,1939,0.091140833350509
SIM,1874,96,na,1970,37
STAT,1909,15,na,1924,3594.8546309239337
STAT,1797,75,na,1872,416.5837663865732
STAT,1878,54,20-24,1932,7.065186527504436E-4
STAT,1897,45,25-29,1942,0.041458044295514355
STAT,1910,30,30-34,1940,14.466954255884433
SIM,1904,60,na,1964,2827
SIM,1905,45,na,1950,3063
STAT,1892,41,25-29,1933,0.7632705732459503
STAT,1900,36,45-49,1936,0.5665933790493307
SIM,1812,69,na,1881,700
STAT,1817,40,30-34,1857,3.161196269647023
STAT,1937,32,na,1969,3534.85512317202
SIM,1915,52,na,1967,3282
STAT,1805,76,na,1881,402.7095935734052
SIM,1835,26,35-39,1861,7
SIM,1916,37,na,1953,3539
STAT,1882,38,40-44,1920,4.001731559356605
SIM,1940,22,30-34,1962,31
STAT,1855,32,15-19,1887,0.10304114671870518
STAT,1816,39,na,1855,1458.088195785332
SIM,1851,39,50-100,1890,1
SIM,1938,17,25-29,1955,45
STAT,1859,53,40-44,1912,0.007788545782468208
STAT,1884,31,30-34,1915,16.36210973257956
SIM,1885,59,na,1944,1842
STAT,1922,46,40-44,1968,0.17153275088315653
STAT,1815,47,40-44,1862,0.38543014625393685
STAT,1806,50,50-100,1856,0.05535276210217655
STAT,1868,59,na,1927,1751.7260853876421
SIM,1874,67,na,1941,1471
STAT,1839,16,na,1855,2011.0855851445092
STAT,1918,26,50-100,1944,1.004133237640944
STAT,1856,82,na,1938,343.9075507225649
STAT,1833,40,15-19,1873,0.01053349301336469
SIM,1846,17,20-24,1863,21
STAT,1847,19,20-24,1866,16.124932423732787
STAT,1821,34,50-100,1855,2.456277204155266
STAT,1825,50,25-29,1875,0.0036232513702792314
STAT,1859,45,na,1904,1708.4988178228305
SIM,1884,41,40-44,1925,8
SIM,1838,20,na,1858,1851
STAT,1829,39,15-19,1868,0.049076751552013506
SIM,1842,57,na,1899,1335
STAT,1858,35,50-100,1893,0.9180026815615477
SIM,1892,31,30-34,1923,29
STAT,1911,44,15-19,1955,0.001367702968872846
SIM,1833,29,50-100,1862,1
SIM,1854,90,na,1944,57
STAT,1840,36,50-100,1876,0.9629112895168196
STAT,1863,30,na,1893,1994.1949277115623
SIM,1885,5,na,1890,2512
STAT,1858,111,na,1969,8.295916241197652E-4
SIM,1881,15,na,1896,1969
STAT,1865,30,na,1895,2059.7419238730768
SIM,1877,42,45-49,1919,5
STAT,1839,102,na,1941,0.19519539197735722
STAT,1829,42,15-19,1871,0.011780164338613527
STAT,1871,36,15-19,1907,0.052930576361920306
STAT,1869,42,45-49,1911,1.3680229645557909
STAT,1876,70,na,1946,1369.4071573192687
STAT,1926,40,na,1966,4337.173114420919
SIM,1951,14,na,1965,4293
SIM,1820,38,25-29,1858,2
STAT,1862,103,na,1965,0.5922313515832671
STAT,1849,18,35-39,1867,0.5034907328260939
SIM,1847,29,30-34,1876,29
STAT,1955,9,na,1964,4927.579368283794
SIM,1939,32,35-39,1971,11
SIM,1927,9,na,1936,4655
STAT,1866,51,25-29,1917,0.003100997785312038
STAT,1896,33,15-19,1929,0.17693017177054118
SIM,1814,47,na,1861,1277
SIM,1926,15,40-44,1941,1
STAT,1859,4,na,1863,2326.3383001916563
STAT,1900,35,40-44,1935,5.791219485851502
SIM,1922,35,35-39,1957,2
SIM,1872,19,na,1891,2395
STAT,1838,18,50-100,1856,0.04319011869400293
SIM,1762,99,na,1861,3
STAT,1842,68,na,1910,1106.693599133511
STAT,1894,22,na,1916,2871.285993815708
STAT,1828,41,45-49,1869,1.29028016878635
STAT,1855,29,15-19,1884,0.3312533920160355
STAT,1872,16,45-49,1888,0.062469672512287466
SIM,1845,53,na,1898,1476
SIM,1885,37,na,1922,2256
SIM,1865,82,na,1947,370
STAT,1922,32,15-19,1954,0.13716433266465897
STAT,1928,40,45-49,1968,0.2009847132594489
STAT,1809,50,40-44,1859,0.029459448183519987
STAT,1900,47,50-100,1947,0.18070936380663255
SIM,1851,30,30-34,1881,20
STAT,1876,41,40-44,1917,2.2052372446067365
STAT,1895,32,45-49,1927,2.1476891434204584
STAT,1846,49,35-39,1895,0.10167046379521175
SIM,1935,29,na,1964,4740
STAT,1936,33,20-24,1969,2.2367104313337043
STAT,1939,28,30-34,1967,37.194199454735504
STAT,1774,98,na,1872,0.4374680328039375
STAT,1918,29,na,1947,3739.364880300167
STAT,1914,35,35-39,1949,2.3031376311343887
SIM,1889,44,na,1933,2766
SIM,1883,20,25-29,1903,61
STAT,1930,22,50-100,1952,0.7963011366102533
STAT,1939,1,na,1940,3940.426336109236
STAT,1817,102,na,1919,0.1356936802027157
STAT,1901,18,40-44,1919,0.2412266923737884
STAT,1818,52,40-44,1870,0.02154857608292474
STAT,1875,53,25-29,1928,0.003384124087209272
SIM,1881,40,45-49,1921,6
STAT,1867,74,na,1941,984.4690894523877
STAT,1894,20,35-39,1914,7.126831981101288
SIM,1928,28,20-24,1956,20
STAT,1842,15,20-24,1857,16.682504329144013
STAT,1882,52,20-24,1934,6.743288656729603E-4
STAT,1856,48,40-44,1904,0.12460216596743467
STAT,1910,24,45-49,1934,0.9919859377597333
SIM,1878,24,40-44,1902,2
STAT,1882,46,35-39,1928,0.12898532757813838
STAT,1932,22,30-34,1954,35.62505989587187
STAT,1844,50,35-39,1894,0.00606511907600458
STAT,1944,24,15-19,1968,5.425911508811145
STAT,1860,54,35-39,1914,0.006417461019633529
SIM,1836,41,45-49,1877,7
SIM,1928,31,20-24,1959,5
STAT,1916,48,15-19,1964,3.559416622928582E-4
SIM,1874,45,na,1919,2151
SIM,1822,76,na,1898,490
STAT,1871,6,na,1877,2588.3298313107193
SIM,1844,101,na,1945,1
SIM,1950,9,na,1959,4260
SIM,1850,83,na,1933,239
SIM,1851,3,na,1854,2448
STAT,1904,46,30-34,1950,0.07420057166783267
STAT,1900,16,na,1916,3317.947091508519
STAT,1837,53,20-24,1890,4.712284656257682E-4
STAT,1907,37,na,1944,3295.253118461004
SIM,1827,68,na,1895,879
SIM,1873,31,20-24,1904,2
STAT,1857,67,na,1924,1181.0839705855224
STAT,1874,41,50-100,1915,1.0243260403103698
STAT,1894,17,35-39,1911,0.6661600414211313
STAT,1789,97,na,1886,0.876962378587628
STAT,1836,22,50-100,1858,0.34851179473792293
STAT,1885,43,40-44,1928,2.102716057169791
STAT,1949,17,35-39,1966,4.610506370993271
STAT,1918,11,na,1929,4080.3056758542425
STAT,1919,39,na,1958,3810.106085915083
STAT,1909,35,50-100,1944,0.3790089203809697
SIM,1859,27,40-44,1886,3
STAT,1847,16,15-19,1863,5.494265786103901
SIM,1854,22,na,1876,1991
SIM,1942,25,40-44,1967,9
STAT,1913,15,25-29,1928,8.409412159724269
STAT,1765,109,na,1874,0.002140239100413605
STAT,1831,39,40-44,1870,3.2758907145114393
STAT,1923,37,30-34,1960,1.99497222893488
STAT,1889,43,na,1932,2676.0229605408213
STAT,1927,34,na,1961,4389.321258017943
STAT,1878,91,na,1969,190.89920014882392
SIM,1920,34,20-24,1954,5
SIM,1872,6,na,1878,2626
STAT,1878,16,45-49,1894,0.06446930154196616
STAT,1882,42,50-100,1924,0.9693836386586452
SIM,1869,75,na,1944,875
STAT,1811,107,na,1918,0.0020452746749039185
STAT,1912,34,20-24,1946,2.2480452407445615
SIM,1850,32,na,1882,1882
STAT,1885,53,na,1938,1995.0172340975816
STAT,1937,31,15-19,1968,0.12017511273992171
SIM,1869,30,25-29,1899,12
STAT,1853,20,na,1873,1939.638182082383
STAT,1916,41,25-29,1957,0.06923103850996724
STAT,1893,15,30-34,1908,1.91837148898858
STAT,1812,46,na,1858,1346.3964585023057
STAT,1946,24,20-24,1970,116.81670486845302
SIM,1928,2,na,1930,4846
SIM,1921,15,25-29,1936,62
SIM,1846,27,na,1873,1866
SIM,1933,32,35-39,1965,12
STAT,1955,17,25-29,1972,54.340234780359786
STAT,1902,27,15-19,1929,0.6048904888833364
STAT,1899,73,na,1972,1964.368906616198
STAT,1906,38,40-44,1944,1.2935684718514338
SIM,1920,44,na,1964,3935
STAT,1865,50,50-100,1915,0.013117811519074374
STAT,1871,36,50-100,1907,1.1572547278278618
SIM,1855,16,15-19,1871,6
STAT,1929,25,30-34,1954,46.50003234425571
SIM,1880,30,na,1910,2431
SIM,1882,65,na,1947,1570
SIM,1940,28,40-44,1968,6
SIM,1950,0,na,1950,4463
STAT,1927,28,30-34,1955,44.84102581142616
STAT,1864,45,30-34,1909,0.0823154172587058
SIM,1919,29,30-34,1948,40
SIM,1900,25,35-39,1925,13
STAT,1822,48,30-34,1870,0.12832429013543123
STAT,1932,28,40-44,1960,5.7645339621541005
STAT,1908,35,40-44,1943,1.3366743238015317
SIM,1907,54,na,1961,3025
SIM,1929,30,20-24,1959,3
SIM,1914,38,40-44,1952,1
SIM,1938,27,50-100,1965,1
SIM,1912,42,45-49,1954,1
SIM,1905,29,30-34,1934,35
STAT,1914,44,25-29,1958,0.0666243191805823
STAT,1925,32,35-39,1957,10.251333515199423
SIM,1883,36,50-100,1919,1
STAT,1926,27,50-100,1953,1.127170856928714
SIM,1890,60,na,1950,2409
SIM,1935,28,30-34,1963,56
STAT,1901,34,45-49,1935,2.2861866011905265
SIM,1875,46,50-100,1921,2
SIM,1937,27,25-29,1964,51
SIM,1855,63,na,1918,1391
SIM,1871,14,na,1885,2487
STAT,1805,49,40-44,1854,0.6361272202852469
STAT,1933,27,45-49,1960,2.1670444513302276
SIM,1868,30,35-39,1898,11
SIM,1902,20,40-44,1922,3
STAT,1868,81,na,1949,487.4138225959829
STAT,1859,33,25-29,1892,7.668817551188808
STAT,1884,12,na,1896,2410.3092655322575
SIM,1859,45,na,1904,1828
SIM,1903,19,25-29,1922,8
STAT,1859,31,30-34,1890,13.181444498839237
STAT,1938,2,na,1940,3811.3329446451303
STAT,1904,42,45-49,1946,0.14065730665852666
STAT,1928,28,20-24,1956,21.23417186357931
STAT,1842,76,na,1918,686.0929483560479
STAT,1902,45,45-49,1947,0.1792540860095867
STAT,1913,22,na,1935,3493.4954764988966
STAT,1869,23,40-44,1892,1.9011869869857236
STAT,1875,31,15-19,1906,0.13884504011591195
STAT,1902,50,na,1952,2912.0034050236245
SIM,1942,23,45-49,1965,1
SIM,1863,50,na,1913,1815
STAT,1930,30,20-24,1960,2.9770401260689323
SIM,1839,15,20-24,1854,11
STAT,1900,32,50-100,1932,1.2007438921121405
SIM,1808,61,na,1869,992
STAT,1850,50,25-29,1900,0.002532728463504701
SIM,1941,27,45-49,1968,2
STAT,1900,31,20-24,1931,3.5568469314152287
SIM,1804,71,na,1875,569
SIM,1937,25,30-34,1962,47
STAT,1937,33,50-100,1970,0.7722745365108882
SIM,1936,28,20-24,1964,15
SIM,1844,91,na,1935,20
STAT,1827,99,na,1926,1.0939576740152916
STAT,1904,22,20-24,1926,93.38031586523752
STAT,1929,27,25-29,1956,77.81720522601103
SIM,1910,30,45-49,1940,1
STAT,1899,53,na,1952,2742.3918643382494
SIM,1886,55,na,1941,1996
STAT,1934,25,40-44,1959,5.928606330033546
STAT,1853,32,50-100,1885,0.7140698041687075
SIM,1893,9,na,1902,3248
STAT,1865,30,45-49,1895,1.5051783275088484
SIM,1863,19,na,1882,2151
SIM,1838,83,na,1921,233
SIM,1879,73,na,1952,1137
STAT,1912,18,15-19,1930,8.647072870471995
SIM,1943,24,45-49,1967,1
STAT,1794,107,na,1901,8.882734706052151E-4
STAT,1913,33,25-29,1946,8.65081697596125
SIM,1781,89,na,1870,34
STAT,1788,79,na,1867,248.5080069607718
SIM,1867,31,30-34,1898,27
SIM,1920,18,15-19,1938,49
SIM,1905,16,25-29,1921,10
STAT,1945,26,25-29,1971,68.24816875712986
SIM,1880,50,na,1930,2212
STAT,1784,97,na,1881,0.8820805718035397
SIM,1900,23,40-44,1923,2
SIM,1925,28,45-49,1953,2
STAT,1917,28,45-49,1945,1.7055689832972045
SIM,1921,33,25-29,1954,10
SIM,1889,34,50-100,1923,1
STAT,1876,17,na,1893,2465.003703270079
STAT,1848,53,na,1901,1574.2399639943665
STAT,1935,24,45-49,1959,1.4464721552250175
STAT,1944,27,20-24,1971,18.637736129989555
STAT,1943,19,50-100,1962,0.3750699993788347
STAT,1833,53,50-100,1886,0.009362679712527714
SIM,1877,19,na,1896,2450
STAT,1859,54,50-100,1913,0.011043342297872101
STAT,1919,47,na,1966,3764.3537969369304
STAT,1937,19,30-34,1956,11.168680021670374
SIM,1901,21,35-39,1922,7
SIM,1825,65,na,1890,917
STAT,1902,30,45-49,1932,2.3436065921309743
SIM,1852,20,30-34,1872,18
STAT,1867,20,na,1887,2137.2056166793527
STAT,1913,45,20-24,1958,0.010238176081082517
SIM,1932,21,na,1953,4488
SIM,1872,55,na,1927,1930
SIM,1849,35,30-34,1884,3
SIM,1835,20,30-34,1855,17
STAT,1896,25,na,1921,2997.831521041277
SIM,1932,36,35-39,1968,8
STAT,1868,24,35-39,1892,5.226836908271442
STAT,1904,42,15-19,1946,0.0012978760464478056
SIM,1843,50,na,1893,1537
SIM,1921,17,20-24,1938,144
STAT,1860,20,15-19,1880,2.9061576960131434
STAT,1934,23,45-49,1957,1.427996188124337
SIM,1805,96,na,1901,1
STAT,1934,38,15-19,1972,0.02500908233094127
STAT,1810,109,na,1919,3.009752017625682E-4
SIM,1857,98,na,1955,7
STAT,1912,1,na,1913,3976.3758839865704
SIM,1928,16,na,1944,4367
SIM,1914,36,na,1950,3554
STAT,1770,101,na,1871,0.09632061282665744
STAT,1910,21,35-39,1931,8.378871056997333
SIM,1852,22,25-29,1874,54
STAT,1845,33,na,1878,1804.6330558091163
SIM,1915,34,40-44,1949,3
SIM,1921,30,20-24,1951,3
STAT,1909,34,45-49,1943,1.4064805703028895
SIM,1867,15,25-29,1882,6
SIM,1894,42,na,1936,2927
STAT,1840,44,30-34,1884,0.767120883540774
STAT,1907,34,40-44,1941,3.4260542121526916
STAT,1902,8,na,1910,3465.79676385846
SIM,1912,22,20-24,1934,97
STAT,1877,17,40-44,1894,0.17923304452888703
SIM,1891,14,na,1905,3045
SIM,1867,40,na,1907,2242
SIM,1875,83,na,1958,446
STAT,1864,32,50-100,1896,0.7714529015375827
STAT,1839,22,15-19,1861,2.822221949150034
STAT,1913,17,20-24,1930,26.18742976716456
STAT,1853,26,50-100,1879,0.564883467739276
SIM,1840,22,na,1862,1822
STAT,1928,26,25-29,1954,76.86610691057841
STAT,1844,22,25-29,1866,49.64099499354128
STAT,1858,35,30-34,1893,3.9850095978768474
STAT,1922,33,50-100,1955,0.8787859026996305
SIM,1886,75,na,1961,1151
STAT,1912,16,20-24,1928,25.96322887181682
STAT,1907,36,35-39,1943,2.128740537477732
SIM,1888,41,45-49,1929,1
STAT,1947,20,20-24,1967,118.80598092812097
SIM,1837,20,35-39,1857,11
STAT,1915,45,25-29,1960,0.05073427542426787
SIM,1932,34,40-44,1966,7
STAT,1843,104,na,1947,0.04505232250743446
STAT,1924,34,40-44,1958,4.307423573921547
STAT,1933,29,40-44,1962,5.840832997780618
SIM,1874,42,na,1916,2159
SIM,1903,44,na,1947,3080
STAT,1927,45,20-24,1972,0.013166192862840528
SIM,1847,22,15-19,1869,3
SIM,1941,29,40-44,1970,12
STAT,1917,38,15-19,1955,0.018749514509661072
STAT,1930,32,15-19,1962,0.15666489981485773
SIM,1920,16,20-24,1936,142
SIM,1936,26,25-29,1962,48
STAT,1885,20,20-24,1905,65.27818350922756
STAT,1904,40,20-24,1944,0.015094762279666891
SIM,1926,24,45-49,1950,1
SIM,1858,49,50-100,1907,4
SIM,1915,36,35-39,1951,6
STAT,1819,43,50-100,1862,2.1468725135889737
STAT,1869,25,35-39,1894,8.890507184527447
STAT,1918,39,15-19,1957,0.01908082421996314
STAT,1861,51,50-100,1912,0.011919775582002587
SIM,1808,53,na,1861,1193
STAT,1928,44,25-29,1972,0.08571081614709064
STAT,1846,58,na,1904,1466.7915808792502
STAT,1889,31,45-49,1920,2.0420522655125475
SIM,1819,45,na,1864,1405
STAT,1839,16,50-100,1855,0.042922821895628065
STAT,1904,24,15-19,1928,4.442378368563843
STAT,1918,37,20-24,1955,0.26248644417538325
SIM,1856,17,na,1873,2152
STAT,1923,19,30-34,1942,13.448333808513897
SIM,1893,20,20-24,1913,76
STAT,1812,109,na,1921,3.090492048071564E-4
SIM,1917,34,45-49,1951,4
STAT,1953,18,30-34,1971,13.924310543012936
SIM,1836,21,30-34,1857,12
SIM,1916,35,40-44,1951,3
STAT,1919,36,25-29,1955,1.0001824992963095
STAT,1940,24,na,1964,3511.92519913197
STAT,1928,29,30-34,1957,45.55651880193538
SIM,1897,31,45-49,1928,2
SIM,1848,81,na,1929,374
STAT,1943,18,45-49,1961,0.5002684264543721
SIM,1941,26,35-39,1967,22
STAT,1811,84,na,1895,144.27359482857418
SIM,1931,19,30-34,1950,20
STAT,1851,30,15-19,1881,0.10885904720362581
STAT,1943,28,15-19,1971,0.7099229547990836
SIM,1831,44,30-34,1875,5
SIM,1890,80,na,1970,1259
SIM,1945,19,30-34,1964,15
SIM,1879,0,na,1879,3472
STAT,1844,20,30-34,1864,15.67028276139435
STAT,1916,42,50-100,1958,0.11373221336703178
STAT,1946,3,na,1949,4195.300318680938
SIM,1835,63,na,1898,1148
SIM,1880,7,na,1887,2704
SIM,1931,37,30-34,1968,1
STAT,1862,96,na,1958,10.637822024207699
SIM,1828,81,na,1909,300
STAT,1908,33,45-49,1941,1.397296348872653
SIM,1900,22,30-34,1922,28
STAT,1907,18,35-39,1925,0.7594638410553435
SIM,1839,45,na,1884,1591
SIM,1956,6,na,1962,4790
SIM,1930,36,30-34,1966,1
STAT,1839,40,45-49,1879,1.1840478974881439
STAT,1866,100,na,1966,4.483247891911214
STAT,1858,51,na,1909,1602.441985725116
SIM,1934,36,na,1970,4830
STAT,1860,10,na,1870,2136.834414455347
STAT,1876,30,20-24,1906,2.6594045186793336
STAT,1868,100,na,1968,5.820639315267498
SIM,1903,64,na,1967,2570
SIM,1916,33,45-49,1949,2
STAT,1868,9,na,1877,2456.8340827478482
SIM,1863,9,na,1872,2297
STAT,1924,36,35-39,1960,2.69678837545227
STAT,1938,18,35-39,1956,3.9091399412577497
STAT,1868,32,50-100,1900,0.8258507041982197
SIM,1946,18,35-39,1964,5
STAT,1810,49,20-24,1859,0.03874768551939186
STAT,1865,33,na,1898,2034.694648217962
SIM,1927,36,25-29,1963,1
STAT,1834,30,15-19,1864,0.11558109775414385
SIM,1847,40,45-49,1887,2
STAT,1890,35,30-34,1925,6.213939498449038
STAT,1922,36,30-34,1958,1.960940493734857
STAT,1938,30,20-24,1968,2.319601841429721
SIM,1912,24,15-19,1936,5
STAT,1771,90,na,1861,20.237496627724884
STAT,1880,45,15-19,1925,4.0234522331681206E-4
STAT,1886,27,na,1913,2381.536337379168
STAT,1849,15,na,1864,2143.9385711433574
STAT,1823,44,30-34,1867,1.4522695027569272
STAT,1807,79,na,1886,306.2626178338921
STAT,1867,25,30-34,1892,22.489861077581438
SIM,1887,60,na,1947,1962
SIM,1925,25,40-44,1950,6
STAT,1904,0,na,1904,3978.9015647277915
STAT,1906,37,30-34,1943,1.5827606836298733
STAT,1888,49,35-39,1937,0.08632689228397046
STAT,1915,32,50-100,1947,0.7955023112210043
STAT,1905,23,20-24,1928,93.80885628825067
STAT,1852,15,na,1867,2036.6646930482532
STAT,1920,40,35-39,1960,0.2106781302925181
STAT,1840,47,40-44,1887,0.1132973303820554
STAT,1860,2,na,1862,2647.526670181076
SIM,1923,32,50-100,1955,5
SIM,1858,83,na,1941,291
STAT,1927,29,15-19,1956,0.8074891814914114
SIM,1946,15,30-34,1961,16
SIM,1915,39,40-44,1954,3
STAT,1916,42,35-39,1958,0.19494296111815976
SIM,1936,29,30-34,1965,32
SIM,1939,0,na,1939,3915
SIM,1902,59,na,1961,2666
SIM,1876,24,35-39,1900,8
SIM,1839,16,30-34,1855,1
SIM,1869,35,na,1904,2187
STAT,1844,71,na,1915,927.0506429229758
STAT,1859,48,50-100,1907,0.18234399829468406
STAT,1930,15,25-29,1945,53.17191683548923
SIM,1822,39,40-44,1861,4
STAT,1879,27,50-100,1906,0.6325746562096753
SIM,1931,36,na,1967,4687
SIM,1914,37,30-34,1951,1
STAT,1905,47,na,1952,3058.390999260608
STAT,1942,17,45-49,1959,0.49317246625696043
SIM,1895,20,25-29,1915,71
SIM,1879,65,na,1944,1680
SIM,1851,93,na,1944,18
STAT,1762,110,na,1872,9.21281068247806E-4
STAT,1826,38,na,1864,1533.9449167522034
STAT,1860,41,na,1901,1779.6036535172698
SIM,1922,4,na,1926,4371
STAT,1878,51,na,1929,2129.9805668078257
STAT,1937,24,na,1961,3357.1898048738744
STAT,1839,110,na,1949,1.8398541210817092E-4
STAT,1933,26,35-39,1959,18.8408642711402
SIM,1851,24,30-34,1875,19
STAT,1900,55,na,1955,2709.7478692920868
STAT,1914,43,15-19,1957,0.0014352929159418865
STAT,1801,54,na,1855,1051.8001148430396
STAT,1893,18,35-39,1911,0.6556464226552324
STAT,1922,23,25-29,1945,99.75901449980728
SIM,1930,23,25-29,1953,113
STAT,1903,28,15-19,1931,0.607698634786404
STAT,1907,34,na,1941,3311.1254512458404
STAT,1843,24,30-34,1867,14.885596778262547
SIM,1824,71,na,1895,666
SIM,1908,41,40-44,1949,1
STAT,1919,38,20-24,1957,0.2672654660153711
STAT,1873,20,na,1893,2279.5074649091357
STAT,1887,20,25-29,1907,60.851459998295255
STAT,1924,14,na,1938,4442.916399246463
SIM,1826,30,30-34,1856,23
STAT,1889,23,50-100,1912,0.47411798217594425
SIM,1866,55,na,1921,1824
SIM,1843,49,50-100,1892,4
STAT,1852,17,35-39,1869,0.4811319924968387
STAT,1828,61,na,1889,1068.4472295161963
STAT,1832,37,35-39,1869,5.405778576168621
SIM,1933,35,40-44,1968,2
STAT,1916,27,45-49,1943,1.6874984323228261
SIM,1822,37,na,1859,1544
STAT,1908,32,35-39,1940,8.149042173912113
STAT,1885,21,30-34,1906,16.823460501039715
STAT,1901,15,35-39,1916,0.7289522130044839
STAT,1953,19,15-19,1972,51.82708415415315
STAT,1862,47,20-24,1909,0.009647435275670012
STAT,1897,10,na,1907,3272.57223417802
STAT,1907,39,40-44,1946,1.2979917552049876
SIM,1893,49,na,1942,2757
STAT,1881,48,40-44,1929,0.1542750939172099
SIM,1947,17,40-44,1964,1
STAT,1925,35,40-44,1960,1.700241004246522
STAT,1939,17,40-44,1956,1.322656114853946
SIM,1924,27,45-49,1951,2
STAT,1866,27,na,1893,2079.428577043208
STAT,1893,37,50-100,1930,1.470869785479794
STAT,1922,38,25-29,1960,1.0573256567649547
SIM,1858,41,30-34,1899,4
STAT,1822,49,40-44,1871,0.22372673270971397
SIM,1869,7,na,1876,2553
SIM,1925,28,50-100,1953,1
SIM,1930,38,25-29,1968,1
STAT,1954,16,25-29,1970,50.61976346527212
SIM,1893,21,30-34,1914,26
STAT,1888,81,na,1969,998.8448745617393
SIM,1891,22,na,1913,2786
STAT,1917,25,40-44,1942,4.649156620261185
STAT,1871,81,na,1952,507.27620300533226
STAT,1901,30,25-29,1931,13.653094645120037
STAT,1905,36,50-100,1941,0.3635942024734044
STAT,1794,87,na,1881,57.96927269584092
SIM,1913,23,20-24,1936,82
STAT,1859,15,25-29,1874,5.004629837146854
STAT,1959,5,na,1964,4857.5387866051515
SIM,1856,8,na,1864,2303
SIM,1901,24,40-44,1925,2
SIM,1879,45,na,1924,2317
SIM,1921,32,45-49,1953,2
STAT,1911,20,40-44,1931,3.030570803466403
STAT,1921,49,na,1970,3889.527338301265
SIM,1916,32,35-39,1948,14
SIM,1899,26,30-34,1925,36
STAT,1904,25,25-29,1929,57.70969425505057
STAT,1921,42,45-49,1963,0.17708572289335392
SIM,1861,24,na,1885,2043
SIM,1903,48,50-100,1951,1
STAT,1831,84,na,1915,194.23724880715397
STAT,1869,26,45-49,1895,1.0196248202451201
STAT,1913,42,na,1955,3421.585299487173
SIM,1912,25,25-29,1937,61
STAT,1883,6,na,1889,2432.2575900171705
SIM,1904,15,25-29,1919,13
SIM,1855,83,na,1938,274
STAT,1899,36,30-34,1935,6.931823231768074
SIM,1835,22,25-29,1857,59
STAT,1798,104,na,1902,0.018946046132989513
SIM,1892,25,30-34,1917,40
STAT,1930,14,na,1944,4823.524919630585
STAT,1852,35,na,1887,1753.356287799098
SIM,1900,41,40-44,1941,3
SIM,1921,18,30-34,1939,19
STAT,1934,22,35-39,1956,11.954017246124419
SIM,1928,34,20-24,1962,1
SIM,1909,38,30-34,1947,1
STAT,1926,31,40-44,1957,4.472664115636827
STAT,1924,37,45-49,1961,0.7593919468270212
SIM,1932,33,30-34,1965,25
SIM,1835,23,35-39,1858,6
SIM,1900,28,40-44,1928,4
STAT,1916,45,45-49,1961,0.21158236269039635
SIM,1814,61,na,1875,935
SIM,1846,78,na,1924,527
SIM,1930,39,35-39,1969,5
SIM,1909,46,50-100,1955,3
SIM,1896,17,15-19,1913,6
SIM,1879,20,40-44,1899,4
SIM,1838,91,na,1929,28
STAT,1855,94,na,1949,14.202640025262681
STAT,1862,3,na,1865,2613.654137690854
SIM,1910,46,na,1956,3246
STAT,1790,97,na,1887,0.918279798960681
STAT,1863,49,30-34,1912,0.07857333870581604
SIM,1904,33,25-29,1937,10
STAT,1931,39,na,1970,4696.879585860309
SIM,1897,39,na,1936,3033
SIM,1898,15,25-29,1913,10
SIM,1840,37,35-39,1877,16
STAT,1900,19,35-39,1919,0.7152294747521357
STAT,1859,25,na,1884,1851.8748462591975
SIM,1932,32,20-24,1964,2
STAT,1872,35,na,1907,2253.6724249450954
STAT,1924,33,30-34,1957,17.353410211881357
STAT,1936,35,15-19,1971,0.017840047128783065
SIM,1861,32,50-100,1893,1
STAT,1936,20,45-49,1956,1.0168990239230868
SIM,1773,94,na,1867,2
STAT,1945,23,20-24,1968,115.08967900085564
SIM,1825,34,30-34,1859,17
STAT,1840,47,35-39,1887,0.09264968627375286
STAT,1783,95,na,1878,2.1593602272939365
STAT,1815,43,50-100,1858,2.5639747405777156
SIM,1877,25,35-39,1902,12
STAT,1868,21,30-34,1889,16.171069218898143
SIM,1951,15,40-44,1966,2
STAT,1913,18,30-34,1931,2.34819151709983
SIM,1862,65,na,1927,1440
STAT,1850,45,50-100,1895,0.17485520657964806
SIM,1852,98,na,1950,2
SIM,1853,37,na,1890,1784
SIM,1921,38,na,1959,3980
STAT,1862,68,na,1930,1234.3534826215275
STAT,1810,46,45-49,1856,0.8006400648669129
STAT,1844,48,50-100,1892,0.16843173604997694
STAT,1835,22,50-100,1857,0.3450036889039109
STAT,1943,15,40-44,1958,1.4019432505888803
STAT,1895,63,na,1958,2266.153541481559
STAT,1861,101,na,1962,1.3658583584387365
STAT,1872,66,na,1938,1553.0887372918025
STAT,1877,19,na,1896,2461.6564240154344
SIM,1876,21,30-34,1897,22
SIM,1849,38,35-39,1887,8
SIM,1903,18,15-19,1921,8
STAT,1912,17,30-34,1929,2.3284845396852893
STAT,1836,28,na,1864,1799.6110499766642
STAT,1895,20,50-100,1915,0.5052307520197608
STAT,1895,15,35-39,1910,0.6789292832908583
STAT,1806,86,na,1892,76.94299014110761
STAT,1890,7,na,1897,3009.097330203075
SIM,1944,20,45-49,1964,2
SIM,1938,26,na,1964,3342
SIM,1877,22,30-34,1899,27
SIM,1865,26,50-100,1891,2
SIM,1881,38,35-39,1919,7
STAT,1857,26,50-100,1883,0.49446582936328526
STAT,1918,21,40-44,1939,3.4362103071195307
SIM,1860,30,na,1890,1982
STAT,1879,45,na,1924,2246.9876086196987
SIM,1920,17,30-34,1937,13
SIM,1815,55,na,1870,1215
SIM,1930,20,15-19,1950,6
STAT,1938,33,25-29,1971,8.774211916894325
STAT,1835,63,na,1898,1135.6667960941138
STAT,1928,25,15-19,1953,0.8271794848512117
STAT,1869,22,30-34,1891,16.301613595983408
STAT,1946,25,30-34,1971,41.26934562687718
STAT,1901,16,45-49,1917,0.0865908288591748
SIM,1881,24,na,1905,1828
SIM,1844,12,na,1856,2059
SIM,1926,21,40-44,1947,6
STAT,1817,38,na,1855,1423.0169434435002
STAT,1867,28,35-39,1895,8.529223754047218
STAT,1948,19,35-39,1967,4.533643788369836
STAT,1835,43,na,1878,1582.917114913766
STAT,1888,17,15-19,1905,6.62561862420899
SIM,1863,39,30-34,1902,7
SIM,1934,31,40-44,1965,5
STAT,1906,40,na,1946,3223.2246303466854
STAT,1938,15,30-34,1953,11.41153022433561
SIM,1927,33,20-24,1960,2
SIM,1886,47,na,1933,2178
SIM,1915,0,na,1915,3971
STAT,1848,61,na,1909,1388.5046575158538
STAT,1884,25,30-34,1909,23.662239336329648
STAT,1914,16,na,1930,3783.6638371835907
STAT,1922,39,35-39,1961,2.594475157562947
SIM,1807,68,na,1875,722
SIM,1938,23,25-29,1961,80
STAT,1790,107,na,1897,9.358422439690315E-4
SIM,1942,22,35-39,1964,9
SIM,1922,29,35-39,1951,18
SIM,1856,48,50-100,1904,5
STAT,1832,40,50-100,1872,0.8018049182965052
STAT,1840,29,40-44,1869,2.4160705697167817
STAT,1919,33,20-24,1952,2.4755419792395656
STAT,1877,10,na,1887,2570.094493593497
STAT,1883,58,na,1941,1831.6772229895141
STAT,1891,25,na,1916,2808.2472706521767
STAT,1881,48,35-39,1929,0.12615953970921748
STAT,1830,39,25-29,1869,2.276168433024886
STAT,1890,60,na,1950,2202.727328914928
STAT,1902,17,45-49,1919,0.08709001709109046
STAT,1914,47,na,1961,3442.0937641509054
SIM,1944,26,na,1970,3721
STAT,1824,71,na,1895,735.9915241657222
STAT,1873,38,35-39,1911,6.743056136701828
SIM,1890,29,na,1919,2967
STAT,1922,20,15-19,1942,5.801269283757769
SIM,1836,24,35-39,1860,4
STAT,1950,22,20-24,1972,124.61947490949383
SIM,1900,21,20-24,1921,76
STAT,1925,0,na,1925,5141.066936055822
STAT,1851,73,na,1924,854.4015124362221
STAT,1903,29,25-29,1932,56.45316423101947
STAT,1766,92,na,1858,8.836491328867837
STAT,1863,45,15-19,1908,3.3491261370837197E-4
STAT,1954,15,15-19,1969,53.02542365558407
STAT,1839,25,20-24,1864,9.982664807838642
STAT,1866,25,50-100,1891,0.5611590485769524
STAT,1878,17,50-100,1895,0.04823351381489126
STAT,1893,30,20-24,1923,3.2643693617311738
STAT,1952,18,15-19,1970,51.36098293904981
SIM,1876,32,50-100,1908,4
STAT,1929,40,20-24,1969,0.02166508213652722
SIM,1822,38,30-34,1860,2
STAT,1953,15,50-100,1968,0.42836526949347153
STAT,1904,9,na,1913,3515.8741793644886
STAT,1931,26,30-34,1957,47.80940230142799
STAT,1886,42,50-100,1928,1.0529463678533333
STAT,1886,78,na,1964,1047.0120042028145
STAT,1888,46,30-34,1934,0.10837902441046957
STAT,1904,17,na,1921,3422.338749278494
SIM,1950,16,35-39,1966,6
STAT,1905,24,30-34,1929,24.170309233129675
STAT,1905,26,25-29,1931,57.96057824534182
SIM,1880,36,25-29,1916,3
SIM,1846,58,na,1904,1422
SIM,1925,41,40-44,1966,2
SIM,1929,15,30-34,1944,15
SIM,1878,22,45-49,1900,1
STAT,1927,45,15-19,1972,4.3887270938062904E-4
STAT,1852,22,50-100,1874,0.3512093890451649
STAT,1804,71,na,1875,620.7685260101916
STAT,1860,24,30-34,1884,13.87320319218602
SIM,1868,50,na,1918,1963
STAT,1894,17,40-44,1911,0.2220533599970017
STAT,1892,48,45-49,1940,0.15553937841318133
STAT,1897,23,15-19,1920,4.1550499318118534
STAT,1922,20,20-24,1942,121.18127382224928
SIM,1927,23,na,1950,4189
SIM,1830,63,na,1893,1048
STAT,1797,84,na,1881,111.25541100808933
STAT,1804,82,na,1886,173.25026990478509
STAT,1858,31,15-19,1889,0.10657969398376023
SIM,1868,32,30-34,1900,21
STAT,1913,25,50-100,1938,0.9433151681676056
STAT,1872,54,25-29,1926,0.003264033971170096
SIM,1911,29,25-29,1940,68
SIM,1856,18,25-29,1874,5
SIM,1893,24,35-39,1917,7
SIM,1938,27,40-44,1965,6
STAT,1916,24,40-44,1940,3.3075980265046607
STAT,1764,110,na,1874,0.0012429478905129701
SIM,1906,28,40-44,1934,3
SIM,1934,27,50-100,1961,1
SIM,1884,15,30-34,1899,3
STAT,1858,20,na,1878,1843.416277437371
SIM,1941,25,25-29,1966,52
STAT,1859,76,na,1935,712.3438279572405
SIM,1826,33,35-39,1859,8
STAT,1876,15,30-34,1891,1.5628518837758796
STAT,1882,30,45-49,1912,1.6149539558644406
SIM,1901,27,45-49,1928,1
SIM,1858,25,30-34,1883,24
STAT,1911,20,45-49,1931,1.0141440809194195
STAT,1902,19,50-100,1921,0.06496722838716334
SIM,1782,74,na,1856,421
STAT,1840,30,50-100,1870,0.7477393974767217
STAT,1933,25,25-29,1958,82.63406786121449
SIM,1850,63,na,1913,1320
SIM,1848,50,na,1898,1558
STAT,1848,18,25-29,1866,5.189051582406087
STAT,1863,101,na,1964,1.8892387852718628
STAT,1920,26,20-24,1946,18.981408874535088
STAT,1881,29,30-34,1910,22.816914705621624
STAT,1841,104,na,1945,0.04598380360393333
SIM,1873,15,20-24,1888,20
STAT,1845,24,35-39,1869,5.05297674807873
STAT,1875,36,50-100,1911,1.1978941504714489
STAT,1903,40,35-39,1943,0.17072810661072946
STAT,1920,44,20-24,1964,0.018364561441628388
SIM,1897,19,25-29,1916,8
SIM,1924,24,40-44,1948,3
STAT,1880,61,na,1941,1861.0393098095267
STAT,1840,33,na,1873,1714.4275231259717
STAT,1831,53,25-29,1884,0.0021761550935615655
SIM,1899,42,na,1941,3076
STAT,1903,47,25-29,1950,0.043469508742695964
STAT,1787,77,na,1864,320.53987244771815
STAT,1942,16,35-39,1958,4.143809750823027
STAT,1899,32,15-19,1931,0.1843328755792536
STAT,1921,39,50-100,1960,0.4419302791294598
STAT,1859,37,40-44,1896,3.291402872311552
STAT,1904,27,20-24,1931,15.896778149418731
SIM,1867,34,35-39,1901,12
STAT,1907,35,25-29,1942,0.8705928944654392
STAT,1924,32,20-24,1956,2.6882673240835597
STAT,1849,45,30-34,1894,0.07331088618492006
SIM,1847,25,20-24,1872,8
SIM,1857,10,na,1867,2254
SIM,1912,27,20-24,1939,24
STAT,1904,43,25-29,1947,0.0599891247363323
STAT,1891,49,40-44,1940,0.11051379112920719
SIM,1933,38,45-49,1971,1
SIM,1878,80,na,1958,658
SIM,1932,37,45-49,1969,2
SIM,1870,29,na,1899,2175
STAT,1924,39,40-44,1963,1.6640008190199458
SIM,1928,35,30-34,1963,3
SIM,1930,20,20-24,1950,127
STAT,1876,25,na,1901,2345.0605865911953
SIM,1933,31,na,1964,4863
STAT,1796,107,na,1903,0.0010156709143320428
STAT,1889,19,25-29,1908,6.5734077058672415
SIM,1913,26,25-29,1939,63
STAT,1871,25,na,1896,2253.9196322618945
SIM,1833,29,na,1862,1694
STAT,1866,35,na,1901,2072.308949512403
STAT,1922,35,20-24,1957,0.2838553782917606
STAT,1872,36,25-29,1908,2.741393036255855
STAT,1900,16,30-34,1916,2.0939030930316878
STAT,1923,22,25-29,1945,101.53055744917857
SIM,1866,35,30-34,1901,5
STAT,1868,23,25-29,1891,51.43844318132478
SIM,1835,26,40-44,1861,2
SIM,1890,42,50-100,1932,1
STAT,1888,50,na,1938,2438.512112202207
SIM,1932,39,40-44,1971,3
SIM,1821,48,50-100,1869,1
SIM,1889,24,15-19,1913,3
STAT,1841,74,na,1915,765.1014759885749
STAT,1909,60,na,1969,2969.871819332906
STAT,1853,51,na,1904,1637.3055548229247
STAT,1859,19,40-44,1878,0.15776050820746057
STAT,1841,16,50-100,1857,0.04381973333775687
STAT,1925,38,45-49,1963,0.7721592549668996
STAT,1828,84,na,1912,187.34933632036683
SIM,1862,88,na,1950,91
SIM,1865,21,20-24,1886,59
STAT,1924,18,40-44,1942,1.5693580167284515
SIM,1843,81,na,1924,338
STAT,1851,81,na,1932,388.99513960955284
STAT,1811,53,na,1864,1186.5159888950795
SIM,1923,25,35-39,1948,24
STAT,1856,25,na,1881,1849.2417339895533
STAT,1807,48,na,1855,1301.4597626527661
STAT,1843,20,15-19,1863,2.837592780432757
STAT,1832,52,30-34,1884,0.0037421000955966317
SIM,1876,23,25-29,1899,46
SIM,1848,23,15-19,1871,2
STAT,1872,46,50-100,1918,0.23338572335905555
STAT,1810,100,na,1910,0.44911721790304776
STAT,1831,35,25-29,1866,2.260704372062159
SIM,1827,31,30-34,1858,17
SIM,1851,25,na,1876,1909
STAT,1852,52,50-100,1904,0.010890997188111878
SIM,1887,49,na,1936,2298
SIM,1924,42,40-44,1966,1
STAT,1926,31,45-49,1957,1.7984876218514052
SIM,1838,38,50-100,1876,1
STAT,1921,36,15-19,1957,0.020274602454038518
STAT,1897,41,45-49,1938,0.1318971482833642
STAT,1921,42,15-19,1963,0.0016340090918216454
STAT,1911,35,45-49,1946,0.6279655451138824
STAT,1902,30,40-44,1932,5.828322073745237
SIM,1928,37,25-29,1965,1
SIM,1872,95,na,1967,35
STAT,1840,28,30-34,1868,20.457332321222495
SIM,1828,30,na,1858,1717
STAT,1848,48,50-100,1896,0.18020199400463638
STAT,1857,21,20-24,1878,59.70237177439533
STAT,1873,35,30-34,1908,5.154841181434433
STAT,1815,66,na,1881,856.8162838235821
STAT,1830,54,20-24,1884,4.674151934678226E-4
STAT,1930,33,25-29,1963,11.261062344702403
STAT,1906,34,25-29,1940,8.022826823166602
SIM,1859,27,35-39,1886,8
STAT,1923,46,50-100,1969,0.25057600552523923
STAT,1851,47,45-49,1898,0.16897348559934636
STAT,1905,42,30-34,1947,0.10888046792616242
STAT,1825,33,na,1858,1537.0465667157155
SIM,1904,30,20-24,1934,6
STAT,1921,27,20-24,1948,19.218862857527874
SIM,1948,16,na,1964,3974
SIM,1910,30,40-44,1940,7
SIM,1925,23,45-49,1948,1
STAT,1821,46,20-24,1867,0.019208044413831126
STAT,1855,66,na,1921,1164.7243349433115
SIM,1876,27,40-44,1903,3
STAT,1880,49,35-39,1929,0.13651967041179225
SIM,1883,50,na,1933,1996
SIM,1934,31,45-49,1965,1
STAT,1916,42,40-44,1958,0.24214554662175322
SIM,1894,22,30-34,1916,34
STAT,1946,21,15-19,1967,5.597977836178952
SIM,1825,96,na,1921,4
STAT,1917,23,45-49,1940,1.1262337334414787
SIM,1839,15,15-19,1854,4
STAT,1932,27,30-34,1959,48.48223316037861
STAT,1776,93,na,1869,6.2455072604954465
STAT,1920,24,na,1944,3811.2075154806885
SIM,1904,32,45-49,1936,1
STAT,1886,22,30-34,1908,17.775062409960373
SIM,1860,42,35-39,1902,3
SIM,1859,23,25-29,1882,51
STAT,1884,43,na,1927,2141.5453381432617
STAT,1847,99,na,1946,1.3965512599994463
STAT,1910,57,na,1967,3096.0058739013
SIM,1914,34,25-29,1948,12
SIM,1896,20,40-44,1916,3
STAT,1869,86,na,1955,203.0587425316457
STAT,1921,24,15-19,1945,5.644356759247067
SIM,1805,56,na,1861,1073
SIM,1924,26,35-39,1950,24
SIM,1815,63,na,1878,988
STAT,1865,15,20-24,1880,17.39448571718536
STAT,1877,17,35-39,1894,0.5376991024545227
STAT,1915,46,35-39,1961,0.12303995566141318
SIM,1827,43,50-100,1870,4
STAT,1926,28,15-19,1954,0.7966331328892151
STAT,1931,16,25-29,1947,53.715133030143015
STAT,1867,40,20-24,1907,0.14230108097780794
SIM,1853,21,30-34,1874,20
SIM,1907,26,35-39,1933,11
STAT,1829,49,30-34,1878,0.07707385167798861
STAT,1915,27,30-34,1942,37.75582079123339
STAT,1896,27,50-100,1923,0.7981348796340492
STAT,1905,36,30-34,1941,1.578346573154047
STAT,1887,47,25-29,1934,0.06058125926751346
STAT,1926,46,45-49,1972,0.25396158958946696
SIM,1859,14,na,1873,2222
SIM,1864,22,15-19,1886,6
STAT,1832,34,30-34,1866,13.479875209808055
STAT,1850,48,40-44,1898,0.119166498677932
STAT,1840,19,50-100,1859,0.04113824918740072
STAT,1901,45,50-100,1946,0.18502210462255664
SIM,1839,31,20-24,1870,2
SIM,1881,35,30-34,1916,6
SIM,1905,32,25-29,1937,11
SIM,1855,32,na,1887,1931
SIM,1913,24,30-34,1937,29
SIM,1801,83,na,1884,118
STAT,1822,44,15-19,1866,0.01904300314292528
SIM,1914,33,50-100,1947,3
SIM,1868,17,35-39,1885,2
STAT,1897,19,na,1916,3173.6946461272023
SIM,1851,20,15-19,1871,3
SIM,1840,34,30-34,1874,20
STAT,1794,104,na,1898,0.012563286217402124
STAT,1931,16,na,1947,4562.399501079001
STAT,1791,99,na,1890,0.3506621920178578
STAT,1917,41,45-49,1958,0.16431655078240667
STAT,1916,26,35-39,1942,14.715286953338016
STAT,1856,22,15-19,1878,2.824119358743986
STAT,1931,32,30-34,1963,19.502323195674958
STAT,1850,15,50-100,1865,0.042703420795355634
SIM,1842,88,na,1930,69
SIM,1909,24,45-49,1933,4
STAT,1804,74,na,1878,467.1303368572032
STAT,1857,23,15-19,1880,2.8172158997309884
SIM,1934,28,15-19,1962,3
STAT,1853,19,45-49,1872,0.0587696016917663
STAT,1845,21,30-34,1866,15.76081776777536
SIM,1849,20,25-29,1869,64
STAT,1827,48,na,1875,1440.716029659369
STAT,1888,20,40-44,1908,2.3403456725027443
SIM,1879,17,15-19,1896,7
STAT,1866,58,na,1924,1723.1228458924754
STAT,1882,65,na,1947,1552.5945261594393
STAT,1915,25,35-39,1940,14.565015725106342
STAT,1814,81,na,1895,248.5494402155031
STAT,1930,17,20-24,1947,165.5806388446236
STAT,1776,82,na,1858,147.92922545234381
STAT,1917,44,45-49,1961,0.16353400244691904
SIM,1944,18,30-34,1962,13
STAT,1878,30,25-29,1908,10.165112024608876
STAT,1952,18,50-100,1970,0.42400362586010343
SIM,1880,39,na,1919,2350
SIM,1922,26,30-34,1948,44
STAT,1787,85,na,1872,83.74100042953445
SIM,1866,1,na,1867,3028
SIM,1884,30,20-24,1914,1
SIM,1911,39,na,1950,3364
STAT,1900,32,30-34,1932,22.881037681792026
STAT,1933,4,na,1937,5104.19587641262
STAT,1783,92,na,1875,9.412125011867905
STAT,1863,49,35-39,1912,0.11363912627891845
STAT,1912,34,15-19,1946,0.11843578842091969
SIM,1873,29,na,1902,2272
SIM,1923,27,30-34,1950,47
STAT,1906,19,30-34,1925,2.1812503685613223
STAT,1909,47,20-24,1956,0.009593564150645007
SIM,1914,19,30-34,1933,3
STAT,1936,18,30-34,1954,10.994924391508647
STAT,1898,22,20-24,1920,88.09908337792679
STAT,1951,16,na,1967,4141.84118892067
SIM,1865,23,15-19,1888,2
SIM,1852,95,na,1947,6
SIM,1908,23,45-49,1931,4
SIM,1886,30,25-29,1916,13
STAT,1864,100,na,1964,3.397388369958395
SIM,1856,88,na,1944,98
STAT,1828,100,na,1928,0.5978975073954476
STAT,1904,26,50-100,1930,0.8697939602107226
STAT,1922,36,50-100,1958,0.4517300617269067
SIM,1911,26,20-24,1937,20
SIM,1892,21,15-19,1913,3
STAT,1893,33,25-29,1926,12.219139960308663
STAT,1937,15,15-19,1952,41.90264624917102
STAT,1933,22,20-24,1955,139.33666361689203
STAT,1942,15,50-100,1957,0.3700754637832429
STAT,1875,48,45-49,1923,0.22628006611972015
STAT,1920,29,25-29,1949,67.72183158935765
SIM,1877,20,35-39,1897,5
SIM,1856,5,na,1861,2372
SIM,1872,29,30-34,1901,31
STAT,1934,28,45-49,1962,2.194467514728208
SIM,1828,31,45-49,1859,2
STAT,1862,65,na,1927,1365.014045651654
STAT,1855,39,30-34,1894,3.7492222625036797
SIM,1835,29,45-49,1864,4
SIM,1929,18,35-39,1947,8
STAT,1826,42,25-29,1868,0.6274233143128463
SIM,1900,47,na,1947,2992
STAT,1927,30,45-49,1957,1.8306631688932997
STAT,1898,40,20-24,1938,0.014241060423971124
SIM,1873,18,25-29,1891,4
STAT,1916,42,na,1958,3595.452030628011
SIM,1895,22,45-49,1917,4
STAT,1887,22,45-49,1909,0.7368487572454538
STAT,1901,31,40-44,1932,5.758056964036168
STAT,1860,41,50-100,1901,0.8134446587199146
SIM,1836,48,na,1884,1450
SIM,1942,28,45-49,1970,1
STAT,1896,5,na,1901,3269.732522046312
SIM,1947,23,na,1970,3867
STAT,1830,36,20-24,1866,0.6351325581497768
STAT,1848,84,na,1932,247.1880546301653
STAT,1893,68,na,1961,1978.736915515846
STAT,1862,76,na,1938,765.235491439029
SIM,1847,88,na,1935,80
SIM,1867,33,50-100,1900,1
STAT,1893,57,na,1950,2407.5935160966733
STAT,1884,21,15-19,1905,3.0883433824390205
STAT,1856,28,na,1884,1809.6943810982593
STAT,1939,29,40-44,1968,4.422254848224422
STAT,1876,18,35-39,1894,0.5341396349035016
STAT,1880,20,50-100,1900,0.40855590340419606
SIM,1802,68,na,1870,690
SIM,1840,30,na,1870,1770
STAT,1889,16,20-24,1905,20.726766551465243
STAT,1941,15,35-39,1956,4.08522369511892
SIM,1842,96,na,1938,3
SIM,1903,31,45-49,1934,3
STAT,1829,28,50-100,1857,0.7956151522034105
STAT,1855,54,25-29,1909,0.0024478316692532823
STAT,1869,41,50-100,1910,0.9712284050921512
STAT,1769,89,na,1858,27.02580949044396
STAT,1856,40,45-49,1896,1.1142713313859693
SIM,1900,24,25-29,1924,70
STAT,1931,29,35-39,1960,18.292723707358924
STAT,1929,24,20-24,1953,132.0016367640035
STAT,1859,34,35-39,1893,7.549253105576767
STAT,1864,48,35-39,1912,0.1163949330726767
SIM,1940,27,30-34,1967,44
STAT,1880,35,50-100,1915,1.2343644415892596
SIM,1770,97,na,1867,1
SIM,1897,16,20-24,1913,20
STAT,1914,16,25-29,1930,8.489445461904946
STAT,1869,20,35-39,1889,5.3954326465729165
SIM,1910,54,na,1964,3136
STAT,1835,74,na,1909,706.3537710987046
STAT,1873,53,30-34,1926,0.005611652433647901
STAT,1827,29,45-49,1856,1.6389352290098023
SIM,1866,20,25-29,1886,64
SIM,1922,16,25-29,1938,52
STAT,1899,38,50-100,1937,0.34131211527345967
STAT,1814,53,25-29,1867,0.010142772873087099
STAT,1803,89,na,1892,35.31298441202793
SIM,1848,73,na,1921,847
STAT,1876,28,na,1904,2321.0591459549464
STAT,1845,73,na,1918,840.4880359935753
STAT,1908,38,45-49,1946,0.5999954686478043
STAT,1849,41,15-19,1890,0.010402405748379627
SIM,1816,44,30-34,1860,4
STAT,1811,52,50-100,1863,0.04808141814933391
STAT,1773,100,na,1873,0.17725688373691567
STAT,1903,44,20-24,1947,0.014623625594013735
SIM,1858,80,na,1938,454
SIM,1883,35,30-34,1918,10
SIM,1929,28,50-100,1957,1
STAT,1851,25,50-100,1876,0.5466023645897006
STAT,1913,30,20-24,1943,2.3110842483187732
SIM,1815,86,na,1901,99
STAT,1862,22,40-44,1884,1.7230024706345717
SIM,1860,22,na,1882,2024
SIM,1941,24,40-44,1965,3
STAT,1918,24,45-49,1942,1.139248483642602
STAT,1858,20,25-29,1878,49.35509156576316
STAT,1879,53,na,1932,2095.023067738847
STAT,1767,109,na,1876,0.0026867543751040923
SIM,1939,19,35-39,1958,7
STAT,1831,46,50-100,1877,0.1772370714174789
STAT,1835,66,na,1901,1043.190589742692
STAT,1875,35,30-34,1910,5.2242467606693275
STAT,1922,22,45-49,1944,1.2189533882675905
SIM,1870,37,50-100,1907,4
SIM,1930,22,45-49,1952,1
STAT,1935,37,20-24,1972,0.3482217407591959
SIM,1853,29,na,1882,1863
SIM,1918,28,30-34,1946,49
SIM,1870,22,40-44,1892,5
SIM,1900,44,na,1944,3057
STAT,1852,32,25-29,1884,7.688474742212668
SIM,1927,17,20-24,1944,153
STAT,1919,17,20-24,1936,141.53597237169495
STAT,1772,101,na,1873,0.11509073579990328
STAT,1810,49,15-19,1859,0.001291588381187914
STAT,1911,17,15-19,1928,8.579675469888283
SIM,1931,34,25-29,1965,15
STAT,1915,43,30-34,1958,0.12140346837107978
STAT,1846,46,25-29,1892,0.04284343500874488
SIM,1860,32,25-29,1892,12
SIM,1900,26,45-49,1926,1
STAT,1848,15,20-24,1863,16.524374152631374
STAT,1872,26,15-19,1898,0.4313935741931578
STAT,1814,41,na,1855,1495.607761448156
STAT,1923,38,40-44,1961,1.6369357144192977
SIM,1873,40,na,1913,2242
SIM,1888,23,15-19,1911,8
SIM,1831,28,30-34,1859,27
SIM,1846,47,na,1893,1585
STAT,1903,26,20-24,1929,15.822971224816273
STAT,1911,32,40-44,1943,3.6000394250803724
STAT,1846,21,45-49,1867,0.642775967511776
SIM,1941,22,20-24,1963,114
STAT,1834,47,45-49,1881,0.1553255707885083
STAT,1881,44,25-29,1925,0.5781262882442468
STAT,1923,34,25-29,1957,9.996738932422874
STAT,1897,37,50-100,1934,1.5511085758080951
STAT,1839,28,25-29,1867,35.2258315584383
SIM,1856,15,20-24,1871,12
SIM,1917,24,na,1941,3624
STAT,1871,37,20-24,1908,0.7231119884823005
STAT,1847,22,45-49,1869,0.6303712965164812
SIM,1868,35,35-39,1903,15
SIM,1932,35,25-29,1967,1
STAT,1913,48,25-29,1961,0.048777052207299276
STAT,1924,35,25-29,1959,1.098691353757521
STAT,1868,27,40-44,1895,2.700027900385868
SIM,1931,38,40-44,1969,1
SIM,1918,24,15-19,1942,5
STAT,1874,21,20-24,1895,66.71676927002837
STAT,1770,97,na,1867,0.6699508174069803
STAT,1822,48,na,1870,1307.4488924617706
STAT,1858,91,na,1949,42.92087432759415
STAT,1861,21,50-100,1882,0.3314509845500627
SIM,1886,24,na,1910,2283
STAT,1891,20,45-49,1911,0.8198792219963008
STAT,1869,46,na,1915,2064.876510415957
STAT,1866,8,na,1874,2413.3904160245925
STAT,1890,19,30-34,1909,1.830992544785094
SIM,1847,28,25-29,1875,39
STAT,1906,32,na,1938,3311.263357384323
STAT,1933,24,40-44,1957,4.2104638731570985
STAT,1798,69,na,1867,701.4226498533397
STAT,1907,37,45-49,1944,0.5971067344107768
STAT,1863,46,30-34,1909,0.08047671543026201
STAT,1836,32,40-44,1868,3.5497748140811765
STAT,1906,31,20-24,1937,2.1442625250103893
STAT,1921,21,45-49,1942,1.2041998829249627
STAT,1812,106,na,1918,0.005274197910014114
STAT,1842,99,na,1941,1.3715049604048835
SIM,1925,21,25-29,1946,106
STAT,1930,19,40-44,1949,1.6991137734806145
STAT,1901,40,na,1941,3097.7491038238745
STAT,1880,49,30-34,1929,0.09439360064194804
STAT,1940,22,25-29,1962,88.89188844571945
STAT,1852,66,na,1918,1188.2598329020161
SIM,1859,20,20-24,1879,61
SIM,1936,23,20-24,1959,78
SIM,1839,22,na,1861,1838
STAT,1833,27,50-100,1860,0.5173312486812153
STAT,1886,25,35-39,1911,9.69409065738828
SIM,1852,23,35-39,1875,7
SIM,1927,31,na,1958,4334
SIM,1904,18,30-34,1922,2
STAT,1844,23,35-39,1867,5.023950888578867
STAT,1887,16,50-100,1903,0.05189609443760363
STAT,1905,20,15-19,1925,4.531677013088206
SIM,1908,20,40-44,1928,4
STAT,1915,57,na,1972,3343.717080386342
SIM,1829,55,na,1884,1205
STAT,1822,47,50-100,1869,0.33028064597445334
STAT,1823,47,35-39,1870,0.17243930106211297
SIM,1913,39,35-39,1952,6
SIM,1787,74,na,1861,379
STAT,1868,50,na,1918,1968.6299805376516
STAT,1937,35,30-34,1972,1.72468313453051
SIM,1899,29,35-39,1928,13
STAT,1870,40,na,1910,2163.5807578051317
STAT,1917,21,25-29,1938,93.02311440127681
SIM,1869,32,45-49,1901,2
SIM,1819,48,na,1867,1346
STAT,1788,70,na,1858,583.1969400006449
SIM,1844,32,40-44,1876,4
SIM,1916,38,45-49,1954,3
STAT,1900,35,35-39,1935,9.357124915862505
STAT,1890,38,35-39,1928,8.12846436841162
SIM,1827,34,35-39,1861,9
SIM,1835,55,na,1890,1284
SIM,1915,32,20-24,1947,2
STAT,1855,29,20-24,1884,8.565266210595334
STAT,1955,0,na,1955,4966.849551931535
SIM,1878,21,35-39,1899,7
STAT,1821,49,25-29,1870,0.08824425939921535
STAT,1920,47,25-29,1967,0.055393494587534405
SIM,1913,20,15-19,1933,4
SIM,1795,92,na,1887,8
STAT,1893,43,35-39,1936,0.14955968598554673
STAT,1864,91,na,1955,48.790426587391345
STAT,1915,19,45-49,1934,0.09824125071633605
SIM,1848,25,35-39,1873,11
STAT,1875,94,na,1969,82.4238392650641
SIM,1845,22,na,1867,1870
SIM,1862,101,na,1963,4
SIM,1847,49,50-100,1896,3
STAT,1937,33,45-49,1970,1.4698128366260923
SIM,1771,90,na,1861,17
SIM,1829,32,45-49,1861,1
STAT,1857,98,na,1955,2.4203613192309223
STAT,1907,32,20-24,1939,2.1538871586525663
STAT,1839,25,na,1864,1840.7955991227284
STAT,1866,15,35-39,1881,0.4965651551094327
STAT,1868,61,na,1929,1684.2799377005172
STAT,1790,74,na,1864,417.550396876826
SIM,1866,47,na,1913,1989
SIM,1896,38,50-100,1934,1
STAT,1831,31,50-100,1862,0.7406838824719909
STAT,1926,43,40-44,1969,0.290829988050416
SIM,1822,45,na,1867,1439
SIM,1873,30,45-49,1903,1
STAT,1888,23,45-49,1911,0.7761177883397807
SIM,1853,24,35-39,1877,5
STAT,1842,53,30-34,1895,0.004241517515885754
SIM,1858,28,35-39,1886,9
SIM,1909,49,50-100,1958,2
STAT,1796,104,na,1900,0.014365130583884233
STAT,1865,18,25-29,1883,4.97068166636276
STAT,1874,13,na,1887,2511.9190552094497
SIM,1937,24,20-24,1961,91
STAT,1821,74,na,1895,591.2577363704522
STAT,1885,24,35-39,1909,5.460542993610865
STAT,1786,92,na,1878,10.301903971206434
STAT,1828,33,na,1861,1604.8932220592742
STAT,1857,10,na,1867,2116.7046889976878
STAT,1928,23,20-24,1951,130.74538046552087
SIM,1894,25,35-39,1919,14
STAT,1899,45,na,1944,2941.780179756477
STAT,1850,88,na,1938,96.7744130880035
SIM,1885,43,50-100,1928,1
SIM,1943,16,na,1959,3550
SIM,1769,89,na,1858,23
SIM,1906,6,na,1912,3572
SIM,1914,31,20-24,1945,3
STAT,1929,43,25-29,1972,0.0872217684800034
SIM,1945,15,15-19,1960,41
STAT,1928,41,20-24,1969,0.021298732905939175
STAT,1891,15,50-100,1906,0.05752683055868167
STAT,1894,53,na,1947,2572.151162879562
STAT,1905,39,35-39,1944,2.063621331891282
STAT,1867,43,25-29,1910,0.5655284355416182
SIM,1909,21,40-44,1930,1
SIM,1901,18,na,1919,3327
STAT,1900,47,na,1947,2935.226310424187
SIM,1830,47,50-100,1877,4
STAT,1834,34,30-34,1868,13.594156172506144
SIM,1842,34,30-34,1876,26
SIM,1893,57,na,1950,2499
SIM,1838,16,15-19,1854,5
STAT,1917,41,40-44,1958,0.24694863414115092
STAT,1876,1,na,1877,3371.468757822116
SIM,1889,75,na,1964,1422
STAT,1842,26,50-100,1868,0.5770257615136789
STAT,1853,16,40-44,1869,0.16749720204954036
SIM,1798,66,na,1864,761
SIM,1885,33,40-44,1918,7
STAT,1846,36,15-19,1882,0.04394834065869776
STAT,1887,40,45-49,1927,1.5974338430784576
STAT,1910,54,na,1964,3153.680115115043
STAT,1877,33,40-44,1910,4.231765038541856
SIM,1877,39,na,1916,2245
SIM,1903,17,30-34,1920,3
SIM,1832,24,30-34,1856,14
SIM,1886,44,na,1930,2220
STAT,1870,41,45-49,1911,1.3933041494308518
SIM,1833,51,na,1884,1353
SIM,1922,25,20-24,1947,20
STAT,1895,60,na,1955,2348.880004244577
STAT,1847,19,15-19,1866,5.39775280983881
SIM,1921,5,na,1926,4364
SIM,1882,54,na,1936,1965
SIM,1926,18,15-19,1944,49
SIM,1852,29,45-49,1881,4
STAT,1927,41,35-39,1968,0.23891580675518892
SIM,1862,30,35-39,1892,10
STAT,1829,39,20-24,1868,0.6736898683622823
STAT,1949,18,45-49,1967,0.5486940660727182
STAT,1858,48,45-49,1906,0.1726044493311347
SIM,1868,36,45-49,1904,1
STAT,1859,22,na,1881,1845.0025761602951
STAT,1912,37,20-24,1949,0.2430660144255311
STAT,1924,15,35-39,1939,4.7423731927555055
SIM,1878,49,na,1927,2251
STAT,1920,22,40-44,1942,3.5312387488823105
SIM,1887,30,40-44,1917,5
STAT,1897,16,50-100,1913,0.06204749272170324
SIM,1899,22,15-19,1921,4
STAT,1879,30,40-44,1909,4.322933973615908
STAT,1879,53,50-100,1932,0.014694911460920891
SIM,1844,15,na,1859,1995
STAT,1868,42,30-34,1910,1.0349686095731723
STAT,1844,29,45-49,1873,0.9304884116830746
SIM,1885,35,35-39,1920,12
SIM,1914,26,40-44,1940,5
STAT,1828,40,35-39,1868,1.5875489544992487
SIM,1941,6,na,1947,3799
STAT,1865,19,35-39,1884,0.478476033017672
SIM,1869,17,20-24,1886,16
STAT,1828,30,na,1858,1651.5535603796366
SIM,1919,40,40-44,1959,1
STAT,1856,28,25-29,1884,32.07705769792729
STAT,1850,47,30-34,1897,0.06791846121168228
STAT,1879,22,na,1901,2338.7331717284014
SIM,1872,32,50-100,1904,4
STAT,1930,26,15-19,1956,0.8483698143585426
SIM,1883,38,35-39,1921,11
SIM,1855,19,15-19,1874,4
STAT,1860,19,na,1879,2005.408847424839
STAT,1922,27,35-39,1949,16.049176289592598
STAT,1877,18,15-19,1895,5.800235403081998
STAT,1891,70,na,1961,1798.259100479113
SIM,1965,0,na,1965,4604
STAT,1877,35,35-39,1912,6.996825382945313
STAT,1930,37,40-44,1967,1.8445924247350862
STAT,1898,25,25-29,1923,54.445855304533545
STAT,1903,25,45-49,1928,1.5025414841495943
STAT,1892,44,30-34,1936,0.09319006576948294
STAT,1936,32,45-49,1968,1.4438624616127138
SIM,1830,27,30-34,1857,29
SIM,1859,42,na,1901,1863
SIM,1901,40,na,1941,3102
STAT,1848,15,50-100,1863,0.045664252478425336
STAT,1865,28,35-39,1893,8.23296867705029
SIM,1863,29,20-24,1892,11
SIM,1880,53,na,1933,2132
STAT,1875,47,35-39,1922,0.13530828550267326
STAT,1829,46,25-29,1875,0.04770077943441705
SIM,1905,26,30-34,1931,43
STAT,1894,32,30-34,1926,21.196960558122804
STAT,1880,27,20-24,1907,11.683761320636965
STAT,1896,37,25-29,1933,3.5923323984182356
STAT,1901,37,45-49,1938,0.5689727400171105
STAT,1911,10,na,1921,3744.8759507407362
SIM,1903,30,35-39,1933,13
STAT,1818,103,na,1921,0.07048004216960015
STAT,1891,15,30-34,1906,1.871539934679021
STAT,1798,60,na,1858,981.1152085788366
STAT,1873,25,20-24,1898,11.316329597631364
SIM,1853,51,na,1904,1632
STAT,1868,84,na,1952,299.8433451405642
STAT,1923,2,na,1925,4536.802845569914
SIM,1799,62,na,1861,875
SIM,1914,13,na,1927,3880
SIM,1894,26,45-49,1920,2
STAT,1927,11,na,1938,4660.997122954132
SIM,1888,36,30-34,1924,7
STAT,1870,23,na,1893,2185.0627149270817
SIM,1818,60,na,1878,1021
STAT,1890,49,25-29,1939,0.03674270254589421
SIM,1864,28,25-29,1892,39
SIM,1843,36,40-44,1879,3
STAT,1884,38,45-49,1922,1.8513340502006268
SIM,1836,40,35-39,1876,7
STAT,1921,28,30-34,1949,41.10863183591355
STAT,1919,47,15-19,1966,3.7745115936022885E-4
SIM,1835,41,30-34,1876,1
SIM,1865,62,na,1927,1596
SIM,1910,23,na,1933,3375
SIM,1876,42,30-34,1918,1
STAT,1814,50,20-24,1864,0.0022441014058861416
STAT,1866,54,30-34,1920,0.005043955656770663
STAT,1895,31,35-39,1926,12.523451772057328
STAT,1882,16,30-34,1898,1.4679087226086867
STAT,1761,111,na,1872,0.0015089397420075213
STAT,1840,64,na,1904,1140.8110189811246
STAT,1929,37,30-34,1966,2.2103901947059597
STAT,1931,32,50-100,1963,1.0234367769884114
STAT,1881,41,20-24,1922,0.1455895963594687
SIM,1892,38,45-49,1930,1
STAT,1946,6,na,1952,4145.6540327184
SIM,1907,23,30-34,1930,31
SIM,1890,15,20-24,1905,19
SIM,1911,25,45-49,1936,1
STAT,1833,48,40-44,1881,0.11054325345358568
SIM,1919,8,na,1927,4226
STAT,1875,22,20-24,1897,66.9150426989113
STAT,1923,21,na,1944,4026.0991276678346
SIM,1869,52,na,1921,1954
STAT,1847,35,20-24,1882,0.6021470537310298
SIM,1859,76,na,1935,721
STAT,1812,69,na,1881,751.999628551195
STAT,1817,47,45-49,1864,0.5320301077770023
SIM,1918,45,50-100,1963,1
SIM,1940,21,20-24,1961,96
SIM,1855,52,na,1907,1710
SIM,1863,36,25-29,1899,4
STAT,1849,18,40-44,1867,0.16783025399253615
STAT,1914,25,20-24,1939,17.502450413912683
SIM,1910,33,45-49,1943,2
SIM,1921,25,50-100,1946,5
STAT,1906,63,na,1969,2739.6060178111015
STAT,1887,46,15-19,1933,4.238734120398744E-4
STAT,1904,47,40-44,1951,0.1302491567655658
STAT,1906,26,40-44,1932,4.135752047866921
SIM,1901,60,na,1961,2634
STAT,1835,36,40-44,1871,3.480424071705433
SIM,1886,39,30-34,1925,5
STAT,1875,32,na,1907,2317.143044085994
SIM,1923,24,25-29,1947,112
STAT,1913,36,25-29,1949,0.9223827396906109
STAT,1913,11,na,1924,3820.4063699797143
STAT,1845,47,20-24,1892,0.008451958379126942
SIM,1826,39,45-49,1865,1
STAT,1818,39,45-49,1857,5.2743718436756994
STAT,1957,15,50-100,1972,0.46681399152737774
STAT,1868,47,50-100,1915,0.22033758641965678
SIM,1865,24,25-29,1889,48
SIM,1834,38,50-100,1872,1
STAT,1889,34,15-19,1923,0.16466170039752556
STAT,1909,20,50-100,1929,0.5811967044439953
SIM,1888,27,30-34,1915,32
STAT,1919,16,na,1935,4055.2641492722664
SIM,1873,26,na,1899,2297
STAT,1902,33,45-49,1935,2.3151074099470885
SIM,1903,41,na,1944,3147
SIM,1921,36,25-29,1957,5
SIM,1889,37,50-100,1926,2
STAT,1915,24,25-29,1939,89.63769015932466
STAT,1932,21,20-24,1953,138.24300904576108
SIM,1838,38,25-29,1876,1
STAT,1937,30,40-44,1967,3.6616860508865647
STAT,1891,48,30-34,1939,0.06301737617379402
STAT,1895,38,20-24,1933,0.9446675794390845
SIM,1788,90,na,1878,23
STAT,1935,36,45-49,1971,0.9013539453588292
SIM,1906,25,35-39,1931,16
STAT,1808,95,na,1903,5.140789345166489
STAT,1876,37,40-44,1913,4.272463752005036
SIM,1857,32,20-24,1889,2
STAT,1873,37,na,1910,2257.2958189689525
STAT,1874,48,30-34,1922,0.09225962864472166
STAT,1911,2,na,1913,3853.787431694746
STAT,1943,19,20-24,1962,135.7253577312212
SIM,1835,32,na,1867,1719
SIM,1840,33,na,1873,1704
STAT,1819,35,45-49,1854,6.45941497239185
STAT,1881,26,25-29,1907,38.73703231001658
STAT,1822,45,na,1867,1358.673084415288
STAT,1813,96,na,1909,3.533810236858955
STAT,1874,24,25-29,1898,54.908899318950326
STAT,1904,21,45-49,1925,0.9477628256876107
STAT,1899,42,na,1941,2998.310891345308
SIM,1912,21,45-49,1933,2
STAT,1834,46,35-39,1880,0.10256080200641028
STAT,1859,21,25-29,1880,49.4296116392352
SIM,1847,38,35-39,1885,11
STAT,1849,46,na,1895,1691.87355142875
STAT,1862,14,na,1876,2188.380288697688
SIM,1829,38,na,1867,1523
STAT,1815,97,na,1912,2.3979501822326337
SIM,1822,35,25-29,1857,5
SIM,1897,16,na,1913,3276
STAT,1897,29,25-29,1926,53.060903616505
STAT,1845,49,15-19,1894,2.771414026846949E-4
SIM,1842,37,35-39,1879,11
SIM,1808,84,na,1892,91
SIM,1921,33,20-24,1954,3
STAT,1878,39,30-34,1917,5.194269599122578
STAT,1931,30,na,1961,4686.865255723155
STAT,1822,32,50-100,1854,2.6716355414470283
STAT,1874,23,15-19,1897,3.174455723417766
STAT,1949,23,25-29,1972,101.79248807064428
SIM,1768,90,na,1858,17
SIM,1884,37,40-44,1921,1
STAT,1869,40,25-29,1909,0.5936254004094507
SIM,1787,97,na,1884,1
SIM,1867,21,25-29,1888,54
STAT,1877,41,na,1918,2275.1119003577587
STAT,1919,36,na,1955,3821.7123646916825
STAT,1859,33,50-100,1892,0.6860091196794298
SIM,1912,58,na,1970,3129
STAT,1831,34,15-19,1865,0.1107536511525971
STAT,1864,22,45-49,1886,0.5965665448669186
STAT,1834,37,35-39,1871,5.459880981726835
STAT,1870,19,45-49,1889,0.060397242327708676
STAT,1886,26,45-49,1912,1.1117853277461582
STAT,1828,47,20-24,1875,0.009716586703250464
STAT,1917,28,50-100,1945,0.9826501205699084
SIM,1863,81,na,1944,406
STAT,1831,81,na,1912,315.74460953015137
STAT,1808,47,35-39,1855,0.5311403698835003
STAT,1776,99,na,1875,0.32873242221677823
STAT,1859,22,35-39,1881,4.552327479582345
STAT,1766,110,na,1876,0.0016281784342043674
STAT,1932,16,40-44,1948,1.7539563141513237
SIM,1888,29,25-29,1917,51
SIM,1902,32,40-44,1934,6
STAT,1809,46,40-44,1855,0.49176010412855187
STAT,1827,41,30-34,1868,1.1220049646532477
STAT,1849,32,20-24,1881,2.13588606727685
STAT,1929,39,25-29,1968,1.1915767119334564
STAT,1840,18,20-24,1858,14.974765467687785
STAT,1881,25,15-19,1906,0.4168609510579303
SIM,1880,59,na,1939,1947
STAT,1913,45,na,1958,3403.5381927457966
STAT,1835,97,na,1932,3.419303177172457
STAT,1851,46,35-39,1897,0.10099394324158063
SIM,1851,37,45-49,1888,1
STAT,1889,12,na,1901,3011.863826409038
STAT,1923,16,30-34,1939,13.554050743785568
STAT,1918,36,45-49,1954,0.6820814559811287
STAT,1843,37,45-49,1880,1.5719125238404634
SIM,1951,19,20-24,1970,153
STAT,1850,17,35-39,1867,0.47266087443379384
STAT,1852,50,25-29,1902,0.0026048126275009854
STAT,1893,51,na,1944,2591.9676637103903
SIM,1827,35,45-49,1862,2
SIM,1940,16,40-44,1956,2
SIM,1906,24,25-29,1930,82
STAT,1866,89,na,1955,91.53537318647616
STAT,1938,20,45-49,1958,1.0527403630509677
SIM,1831,25,25-29,1856,34
SIM,1888,79,na,1967,1121
STAT,1873,43,50-100,1916,1.0048899211318951
STAT,1869,48,20-24,1917,0.010844281161869517
STAT,1875,38,35-39,1913,6.833845687826459
STAT,1832,69,na,1901,884.0502098328853
STAT,1872,35,15-19,1907,0.05371613488847994
SIM,1867,22,35-39,1889,7
STAT,1909,46,45-49,1955,0.18914249452222404
SIM,1883,81,na,1964,678
SIM,1852,48,50-100,1900,1
SIM,1931,16,30-34,1947,11
SIM,1949,21,40-44,1970,3
STAT,1928,40,40-44,1968,0.3020566107695218
STAT,1837,38,30-34,1875,4.167806335712404
STAT,1948,19,na,1967,3976.804617015236
STAT,1818,54,na,1872,1225.6401356892195
STAT,1919,44,50-100,1963,0.11986958490654144
SIM,1866,23,30-34,1889,17
SIM,1845,38,30-34,1883,8
SIM,1915,15,35-39,1930,3
STAT,1906,33,50-100,1939,0.7208195636978092
SIM,1932,15,35-39,1947,5
STAT,1848,33,15-19,1881,0.11113547213073677
STAT,1841,17,25-29,1858,5.038630144475838
STAT,1931,20,50-100,1951,0.8110040411854308
SIM,1866,24,na,1890,2080
STAT,1954,13,na,1967,4586.397909231261
SIM,1926,38,na,1964,4284
STAT,1844,41,30-34,1885,0.8283127864016732
STAT,1858,23,30-34,1881,13.67610083269815
STAT,1862,0,na,1862,3112.866541908089
STAT,1890,16,25-29,1906,6.560951981978868
STAT,1881,19,20-24,1900,16.092407414993502
STAT,1886,48,20-24,1934,0.011824459787887652
SIM,1868,59,na,1927,1739
SIM,1946,20,45-49,1966,2
SIM,1867,37,40-44,1904,3
STAT,1864,53,50-100,1917,0.012511918473101366
SIM,1929,37,40-44,1966,2
SIM,1904,29,na,1933,3260
STAT,1852,69,na,1921,1063.9487888108288
STAT,1860,37,45-49,1897,1.5280268478792574
SIM,1823,61,na,1884,983
SIM,1941,15,na,1956,3526
STAT,1892,47,35-39,1939,0.09300760328620454
SIM,1907,8,na,1915,3610
STAT,1839,38,35-39,1877,5.569347699763128
STAT,1940,18,25-29,1958,41.553049043944185
STAT,1922,42,30-34,1964,0.13862545514457372
SIM,1823,100,na,1923,1
STAT,1853,31,30-34,1884,13.749141862452028
STAT,1879,15,15-19,1894,5.895784177425009
STAT,1838,54,na,1892,1405.7783535979927
STAT,1928,34,50-100,1962,0.9753564238717316
STAT,1824,54,50-100,1878,0.0170324185125656
SIM,1894,73,na,1967,1791
STAT,1855,51,20-24,1906,5.268941860047285E-4
SIM,1793,91,na,1884,19
STAT,1857,110,na,1967,0.001806553465082519
STAT,1899,49,45-49,1948,0.1687177966052964
STAT,1840,98,na,1938,2.1318800274066754
STAT,1861,29,45-49,1890,0.8658955595183095
STAT,1904,36,15-19,1940,0.01650296805683129
SIM,1889,49,50-100,1938,4
STAT,1903,7,na,1910,3501.995376068161
STAT,1907,15,35-39,1922,0.7649967122072091
STAT,1865,33,15-19,1898,0.12142429282695037
STAT,1839,29,35-39,1868,7.977299578901016
SIM,1847,29,35-39,1876,10
STAT,1880,42,15-19,1922,0.013736757689607273
STAT,1886,40,25-29,1926,0.6472812325164896
STAT,1840,25,25-29,1865,35.115908843475296
STAT,1854,30,35-39,1884,7.575807630062714
STAT,1918,18,15-19,1936,46.5433493028804
STAT,1940,13,na,1953,3779.104385263675
SIM,1846,24,na,1870,1872
SIM,1888,59,na,1947,2196
STAT,1914,26,30-34,1940,37.44440989404128
STAT,1853,31,na,1884,1879.1672525308877
SIM,1861,31,30-34,1892,22
SIM,1879,39,25-29,1918,3
SIM,1871,28,30-34,1899,29
SIM,1909,18,15-19,1927,8
STAT,1846,39,20-24,1885,0.5847872653662971
SIM,1840,84,na,1924,194
STAT,1830,38,15-19,1868,0.04500872166297783
STAT,1839,43,15-19,1882,0.009567301123922449
STAT,1865,25,30-34,1890,21.708695555686486
SIM,1843,42,35-39,1885,4
SIM,1943,26,50-100,1969,4
SIM,1891,45,na,1936,2687
STAT,1899,22,na,1921,3061.325268618072
SIM,1868,33,40-44,1901,3
STAT,1906,29,45-49,1935,1.516751747513159
STAT,1891,18,35-39,1909,0.6396406900707502
SIM,1890,69,na,1959,1996
STAT,1875,2,na,1877,3172.773669276448
STAT,1802,79,na,1881,287.54874668119425
STAT,1914,28,25-29,1942,62.46463536640005
STAT,1935,26,50-100,1961,1.2823241628709794
STAT,1765,100,na,1865,0.14358601828650536
SIM,1931,26,40-44,1957,4
STAT,1832,24,20-24,1856,59.624054439358865
SIM,1879,42,na,1921,2334
STAT,1877,36,45-49,1913,1.9628889364653594
SIM,1832,27,35-39,1859,9
STAT,1886,21,50-100,1907,0.40816686839371913
SIM,1858,31,25-29,1889,11
SIM,1848,28,40-44,1876,2
STAT,1834,21,20-24,1855,57.61059828886103
STAT,1879,76,na,1955,936.8620790363489
STAT,1846,83,na,1929,294.44676563056373
STAT,1767,88,na,1855,37.2278
STAT,1822,79,na,1901,355.241652646605
SIM,1885,36,45-49,1921,2
STAT,1840,15,15-19,1855,5.102368146545146
SIM,1873,25,30-34,1898,32
STAT,1858,47,35-39,1905,0.1032119731517681
SIM,1837,67,na,1904,1003
SIM,1898,33,20-24,1931,1
STAT,1916,23,30-34,1939,28.363361171516097
STAT,1923,26,40-44,1949,5.072717251611942
SIM,1874,37,50-100,1911,1
STAT,1860,52,40-44,1912,0.008026586868433907
STAT,1881,80,na,1961,746.3499653927331
SIM,1857,45,50-100,1902,2
STAT,1917,16,50-100,1933,0.07635183681789781
SIM,1922,28,25-29,1950,73
SIM,1824,60,na,1884,1067
STAT,1839,26,30-34,1865,21.27422532965479
STAT,1912,4,na,1916,3843.1728278308447
SIM,1867,48,50-100,1915,2
SIM,1906,38,na,1944,3250
STAT,1895,30,25-29,1925,12.716177544626762
STAT,1891,41,50-100,1932,1.2403481452625844
STAT,1837,78,na,1915,507.07236676081726
SIM,1878,54,50-100,1932,2
STAT,1848,19,35-39,1867,0.4994962427538686
STAT,1865,16,30-34,1881,1.4147099543079675
SIM,1892,47,50-100,1939,3
STAT,1789,106,na,1895,0.002682790074095344
SIM,1924,23,30-34,1947,32
STAT,1866,37,50-100,1903,1.069758444175813
STAT,1824,103,na,1927,0.0791322971166186
STAT,1949,15,40-44,1964,1.5376503930514915
STAT,1920,25,45-49,1945,1.8024651537546736
STAT,1872,51,20-24,1923,7.025812043914275E-4
SIM,1844,17,15-19,1861,7
SIM,1840,53,na,1893,1390
SIM,1852,26,40-44,1878,2
STAT,1911,38,15-19,1949,0.017435843772457372
SIM,1845,30,35-39,1875,10
SIM,1873,16,30-34,1889,2
SIM,1864,15,na,1879,2297
SIM,1928,16,25-29,1944,68
STAT,1934,13,na,1947,5055.105313630351
STAT,1863,28,30-34,1891,20.802746007968867
STAT,1896,36,15-19,1932,0.07040044728010493
SIM,1798,69,na,1867,686
SIM,1889,72,na,1961,1618
STAT,1852,36,40-44,1888,3.2241551844461265
SIM,1840,24,20-24,1864,57
STAT,1844,26,40-44,1870,2.5652898580675467
SIM,1930,8,na,1938,4907
STAT,1837,32,50-100,1869,0.7455659983640806
STAT,1917,29,20-24,1946,17.95542769031292
SIM,1826,36,40-44,1862,6
SIM,1905,22,na,1927,3191
STAT,1876,43,35-39,1919,1.7545959040077004
SIM,1955,7,na,1962,4604
STAT,1824,42,50-100,1866,1.388631340828791
STAT,1854,33,40-44,1887,3.1446878785271584
SIM,1839,48,na,1887,1532
STAT,1860,36,35-39,1896,5.447556535507373
STAT,1915,21,20-24,1936,108.91380389032861
STAT,1898,24,15-19,1922,4.19113448762812
STAT,1903,47,20-24,1950,0.009056148077172466
STAT,1835,49,50-100,1884,0.1605990580586466
SIM,1886,31,35-39,1917,14
SIM,1918,6,na,1924,4131
STAT,1871,50,na,1921,2048.852731198339
STAT,1908,38,50-100,1946,0.36952345488437754
STAT,1885,27,40-44,1912,2.820753486812304
SIM,1860,36,40-44,1896,2
STAT,1817,78,na,1895,361.63354366105284
STAT,1871,70,na,1941,1316.1850461733593
STAT,1792,75,na,1867,400.0844449388456
SIM,1845,32,50-100,1877,5
SIM,1846,32,45-49,1878,1
STAT,1873,51,na,1924,2072.8517048682556
STAT,1850,22,15-19,1872,2.7912581706160644
SIM,1860,39,na,1899,1944
STAT,1913,33,20-24,1946,2.282980550686118
SIM,1819,40,35-39,1859,4
SIM,1888,39,35-39,1927,13
SIM,1849,23,30-34,1872,30
SIM,1870,24,35-39,1894,6
SIM,1947,20,na,1967,3817
STAT,1944,26,45-49,1970,1.7647307551282965
SIM,1923,16,40-44,1939,1
SIM,1832,58,na,1890,1137
STAT,1862,24,35-39,1886,4.756041649393366
STAT,1932,24,25-29,1956,114.09907826912618
SIM,1878,40,40-44,1918,4
SIM,1893,27,40-44,1920,3
STAT,1830,29,15-19,1859,0.4089086022082344
SIM,1842,21,20-24,1863,64
SIM,1832,75,na,1907,563
STAT,1868,20,20-24,1888,63.01538531197518
STAT,1921,47,40-44,1968,0.16790528236069557
STAT,1915,49,40-44,1964,0.14920742450248267
SIM,1866,38,35-39,1904,12
STAT,1940,16,30-34,1956,11.694559182487748
STAT,1818,36,40-44,1854,15.297995709109264
STAT,1915,16,40-44,1931,0.27723792941907005
SIM,1884,43,35-39,1927,6
SIM,1925,29,20-24,1954,18
SIM,1928,38,35-39,1966,6
STAT,1901,34,40-44,1935,5.6855241306962
SIM,1869,39,30-34,1908,5
STAT,1884,23,na,1907,2200.52815081019
SIM,1887,71,na,1958,1476
SIM,1864,43,na,1907,2015
STAT,1860,27,35-39,1887,7.475242774182832
STAT,1875,60,na,1935,1851.8994456888163
STAT,1860,33,na,1893,1821.4115787587766
STAT,1931,17,35-39,1948,5.188491672222882
SIM,1862,33,40-44,1895,6
SIM,1844,35,45-49,1879,1
SIM,1900,46,50-100,1946,2
STAT,1858,29,na,1887,1783.6473086814312
SIM,1908,22,35-39,1930,10
STAT,1890,46,20-24,1936,0.007840159810039365
SIM,1825,48,50-100,1873,3
STAT,1840,24,15-19,1864,2.7138535670923734
STAT,1876,21,25-29,1897,56.04067409339964
STAT,1800,98,na,1898,1.291402442929456
STAT,1836,35,45-49,1871,1.6177909809900803
STAT,1857,24,25-29,1881,44.16607032259241
STAT,1897,41,na,1938,2943.3217321593092
SIM,1931,22,25-29,1953,113
STAT,1873,31,50-100,1904,0.8814556478449459
SIM,1914,29,45-49,1943,1
STAT,1934,21,25-29,1955,117.30670297503436
STAT,1809,52,35-39,1861,0.023140635711236215
STAT,1878,31,35-39,1909,10.01105007782319
STAT,1831,50,20-24,1881,4.81123821266629E-4
STAT,1908,17,45-49,1925,0.09154245206155903
STAT,1809,49,na,1858,1237.6287434952485
SIM,1920,13,na,1933,4257
SIM,1853,26,na,1879,1900
SIM,1888,26,20-24,1914,14
SIM,1942,21,25-29,1963,93
STAT,1836,34,35-39,1870,8.119031446527421
SIM,1839,76,na,1915,629
SIM,1842,34,na,1876,1722
STAT,1906,33,15-19,1939,0.11203354494480705
STAT,1820,44,na,1864,1397.9185417017725
SIM,1876,20,20-24,1896,61
STAT,1810,45,35-39,1855,0.48284521982826434
STAT,1949,20,20-24,1969,122.66327416146669
STAT,1908,22,25-29,1930,80.22355638263626
SIM,1883,22,20-24,1905,55
STAT,1815,49,35-39,1864,0.3057925414872322
STAT,1880,46,30-34,1926,0.09668021064678974
SIM,1912,20,35-39,1932,9
STAT,1920,47,na,1967,3836.4150052988516
STAT,1855,36,25-29,1891,2.055882001011134
SIM,1804,94,na,1898,13
SIM,1888,25,na,1913,2705
STAT,1829,36,15-19,1865,0.05191531709010501
STAT,1848,50,50-100,1898,0.011383487225698558
SIM,1919,23,20-24,1942,118
SIM,1940,24,25-29,1964,85
SIM,1827,32,40-44,1859,9
STAT,1817,48,50-100,1865,0.5450550958562546
STAT,1826,38,50-100,1864,1.2968404903675896
SIM,1824,49,na,1873,1370
SIM,1910,18,20-24,1928,24
STAT,1945,22,45-49,1967,1.1649703000171252
STAT,1855,35,15-19,1890,0.04028391165388706
STAT,1902,18,20-24,1920,23.574308454167767
STAT,1808,64,na,1872,888.8573173715631
STAT,1880,84,na,1964,565.5470870652605
STAT,1838,47,15-19,1885,2.7627944704766336E-4
STAT,1870,16,40-44,1886,0.17213608413508422
SIM,1849,24,40-44,1873,1
STAT,1851,43,30-34,1894,0.821031644298478
STAT,1939,25,25-29,1964,62.56451902778525
SIM,1836,43,40-44,1879,7
STAT,1861,32,35-39,1893,7.95468014928506
STAT,1925,3,na,1928,4628.603826333372
SIM,1870,25,45-49,1895,1
SIM,1893,71,na,1964,1912
SIM,1874,39,40-44,1913,7
STAT,1899,27,35-39,1926,12.489598894433009
SIM,1872,72,na,1944,1124
SIM,1784,86,na,1870,55
STAT,1871,39,15-19,1910,0.05214686793535358
SIM,1923,21,20-24,1944,111
SIM,1921,19,40-44,1940,2
STAT,1908,31,25-29,1939,8.275695567800193
SIM,1894,23,40-44,1917,2
SIM,1835,86,na,1921,123
STAT,1838,32,45-49,1870,1.4547703164782289
STAT,1874,49,40-44,1923,0.16179603069448353
SIM,1916,22,25-29,1938,83
STAT,1878,50,45-49,1928,0.014493091848245303
STAT,1862,99,na,1961,3.775422031677734
STAT,1822,90,na,1912,40.061855184027145
STAT,1843,21,na,1864,1825.865425536759
STAT,1921,40,na,1961,3962.6864579544313
STAT,1841,20,15-19,1861,2.9230187062309434
SIM,1858,21,15-19,1879,5
SIM,1887,15,15-19,1902,6
STAT,1898,22,50-100,1920,0.5213272543641926
SIM,1823,43,50-100,1866,1
STAT,1828,43,40-44,1871,1.8754622304632578
STAT,1939,26,35-39,1965,14.264935052833627
STAT,1845,87,na,1932,124.67060365441874
STAT,1935,33,40-44,1968,5.111432667941429
STAT,1895,34,40-44,1929,5.295366080688074
SIM,1868,25,na,1893,2155
STAT,1866,18,40-44,1884,0.1626141520872759
STAT,1913,19,40-44,1932,0.2687235833846425
SIM,1847,35,30-34,1882,8
STAT,1848,27,50-100,1875,0.5674524739816372
STAT,1886,23,40-44,1909,2.073028976407727
STAT,1829,45,15-19,1874,3.356244424346714E-4
SIM,1909,60,na,1969,3024
STAT,1847,45,30-34,1892,0.07209265921555014
SIM,1828,84,na,1912,166
SIM,1920,3,na,1923,4328
SIM,1860,101,na,1961,2
STAT,1946,18,na,1964,3855.5112470710196
STAT,1900,38,40-44,1938,1.2320826896133783
STAT,1849,48,35-39,1897,0.10366242406540106
STAT,1891,18,50-100,1909,0.05711076531790695
STAT,1929,36,20-24,1965,0.31999322117724505
STAT,1862,25,45-49,1887,0.9131847375701325
SIM,1917,47,na,1964,3590
STAT,1825,53,30-34,1878,0.005736698363018168
SIM,1913,27,35-39,1940,18
STAT,1839,35,30-34,1874,4.329393732312444
STAT,1858,26,35-39,1884,7.369038895516514
STAT,1880,33,na,1913,2366.581071127194
STAT,1932,23,15-19,1955,6.577751232402019
SIM,1886,78,na,1964,977
STAT,1888,36,20-24,1924,0.8647550416037738
STAT,1793,71,na,1864,538.4262715246584
STAT,1841,46,50-100,1887,0.17228028895073508
STAT,1830,88,na,1918,82.8569363483623
STAT,1855,26,15-19,1881,0.3384922909855651
SIM,1907,20,25-29,1927,90
STAT,1906,19,35-39,1925,0.7509222444871345
SIM,1847,26,30-34,1873,27
STAT,1906,49,na,1955,3031.4949939896837
SIM,1873,57,na,1930,1974
SIM,1896,54,na,1950,2614
STAT,1932,19,45-49,1951,0.6215270124297367
SIM,1920,30,35-39,1950,21
SIM,1928,19,na,1947,4361
STAT,1842,52,50-100,1894,0.01087891969234952
STAT,1785,73,na,1858,488.6241430272622
SIM,1857,33,na,1890,1854
SIM,1903,38,30-34,1941,2
STAT,1883,27,na,1910,2210.4297267504357
SIM,1940,23,15-19,1963,4
SIM,1916,31,25-29,1947,13
STAT,1909,43,40-44,1952,0.21969451590573633
STAT,1896,27,15-19,1923,0.566078053240805
STAT,1891,23,15-19,1914,3.843922846642055
SIM,1914,19,35-39,1933,3
STAT,1896,48,na,1944,2772.337705517403
SIM,1830,29,25-29,1859,34
SIM,1887,33,45-49,1920,2
SIM,1852,44,35-39,1896,4
STAT,1835,42,35-39,1877,1.3809520140664746
SIM,1839,34,25-29,1873,12
STAT,1871,21,50-100,1892,0.38369179903089584
STAT,1940,15,20-24,1955,130.11053398572204
STAT,1891,56,na,1947,2383.885967510498
STAT,1824,32,15-19,1856,0.3468041152226808
STAT,1924,31,50-100,1955,0.9117605827706978
STAT,1928,43,45-49,1971,0.2001116937042061
SIM,1890,21,15-19,1911,3
STAT,1910,27,45-49,1937,1.5760513148877064
STAT,1814,106,na,1920,0.005580636657188672
STAT,1912,30,35-39,1942,8.563364564669364
STAT,1928,44,20-24,1972,0.021197298887855317
SIM,1815,66,na,1881,887
SIM,1873,28,35-39,1901,8
SIM,1902,48,na,1950,2933
STAT,1905,27,35-39,1932,13.175557700122178
SIM,1932,31,50-100,1963,4
STAT,1919,32,45-49,1951,1.6038125673021122
SIM,1866,26,35-39,1892,11
STAT,1844,44,35-39,1888,1.2554616356352575
STAT,1849,15,35-39,1864,0.5124932549605578
SIM,1881,55,na,1936,1611
STAT,1904,20,35-39,1924,7.954584690430085
SIM,1927,32,45-49,1959,1
STAT,1879,33,45-49,1912,1.7171419747225973
STAT,1882,21,15-19,1903,3.040014503391023
SIM,1838,19,15-19,1857,4
SIM,1844,34,35-39,1878,9
SIM,1896,36,20-24,1932,4
STAT,1825,36,na,1861,1532.2139835912412
STAT,1802,70,na,1872,674.8174886452047
STAT,1884,77,na,1961,988.9282609358822
STAT,1876,33,25-29,1909,9.954644350536007
STAT,1872,29,20-24,1901,11.037005041240043
SIM,1895,21,35-39,1916,10
STAT,1922,23,20-24,1945,120.09029658506304
STAT,1896,33,45-49,1929,2.166559930683533
STAT,1891,44,15-19,1935,0.015922800985473235
SIM,1877,44,40-44,1921,3
STAT,1832,27,25-29,1859,34.653840178290764
STAT,1923,29,45-49,1952,1.8603757350469998
SIM,1822,68,na,1890,804
STAT,1852,27,45-49,1879,0.9375636620906165
STAT,1799,96,na,1895,2.7413081448086554
STAT,1841,27,35-39,1868,8.262211943096288
SIM,1839,30,45-49,1869,1
SIM,1854,28,30-34,1882,30
STAT,1848,100,na,1948,0.788863865888373
STAT,1857,28,40-44,1885,2.28236303078808
STAT,1879,48,15-19,1927,3.9057885890837616E-4
STAT,1881,16,15-19,1897,5.429211181359649
SIM,1826,42,35-39,1868,1
SIM,1898,34,30-34,1932,32
STAT,1846,31,50-100,1877,0.8114799975230332
STAT,1854,15,45-49,1869,0.05657340224393232
STAT,1931,28,25-29,1959,80.23720483616107
SIM,1930,16,15-19,1946,50
SIM,1884,12,na,1896,2527
SIM,1899,65,na,1964,2435
SIM,1880,29,20-24,1909,8
STAT,1925,17,45-49,1942,0.5700541856560257
SIM,1918,27,20-24,1945,22
STAT,1847,68,na,1915,1126.9039375890857
SIM,1866,44,30-34,1910,1
SIM,1828,30,35-39,1858,9
SIM,1837,42,45-49,1879,6
STAT,1931,19,na,1950,4526.814353741389
STAT,1857,75,na,1932,767.0120362572807
STAT,1846,28,30-34,1874,22.43293768953047
STAT,1914,29,35-39,1943,14.19628219096524
STAT,1806,83,na,1889,142.54552327106305
STAT,1869,44,40-44,1913,2.030727450576581
STAT,1835,25,50-100,1860,0.5383280076802625
SIM,1956,14,na,1970,4786
STAT,1829,42,45-49,1871,1.2766752205645537
STAT,1898,21,45-49,1919,0.8941609955919584
STAT,1789,89,na,1878,33.62927177776602
STAT,1845,56,na,1901,1443.3038529980804
SIM,1927,18,30-34,1945,18
SIM,1884,33,25-29,1917,13
SIM,1842,68,na,1910,983
STAT,1853,85,na,1938,207.46387552140655
STAT,1887,21,35-39,1908,6.18487664467135
SIM,1931,7,na,1938,4921
STAT,1914,17,35-39,1931,0.8200187655900679
STAT,1843,27,35-39,1870,8.020746808824216
SIM,1931,29,45-49,1960,3
SIM,1896,39,25-29,1935,1
SIM,1859,11,na,1870,2251
STAT,1863,27,20-24,1890,9.725575985670705
STAT,1919,39,30-34,1958,1.8457790777284775
STAT,1900,27,na,1927,3127.549371400084
STAT,1818,42,35-39,1860,4.270814299093222
STAT,1851,50,na,1901,1571.123875888839
SIM,1871,45,na,1916,2170
SIM,1871,27,20-24,1898,13
SIM,1826,58,na,1884,1114
SIM,1831,70,na,1901,841
STAT,1851,21,20-24,1872,59.62641685561751
STAT,1895,32,50-100,1927,1.1284468311025067
STAT,1928,10,na,1938,4730.6133140845905
SIM,1889,22,20-24,1911,85
SIM,1922,17,35-39,1939,4
SIM,1884,21,25-29,1905,66
STAT,1884,26,50-100,1910,0.5990870359098608
STAT,1910,24,40-44,1934,2.9643555358508844
SIM,1902,17,15-19,1919,7
STAT,1863,92,na,1955,34.52808427941987
STAT,1885,33,35-39,1918,9.495844310531515
STAT,1826,83,na,1909,216.78780705519242
SIM,1893,33,35-39,1926,13
STAT,1908,39,20-24,1947,0.23081828592776948
STAT,1827,68,na,1895,882.735382304634
STAT,1913,3,na,1916,3905.0148501214308
STAT,1906,18,na,1924,3465.886613758816
STAT,1889,17,30-34,1906,1.858857991470449
STAT,1862,21,30-34,1883,14.834642918263967
STAT,1905,38,25-29,1943,0.8443767088544036
SIM,1843,32,25-29,1875,16
SIM,1886,17,20-24,1903,19
SIM,1863,32,45-49,1895,1
SIM,1937,21,15-19,1958,4
STAT,1940,19,35-39,1959,4.022172221666204
STAT,1911,23,45-49,1934,1.0050138904814712
SIM,1945,16,25-29,1961,45
SIM,1831,28,na,1859,1706
SIM,1897,17,30-34,1914,4
STAT,1880,23,40-44,1903,2.068925072874553
STAT,1902,16,50-100,1918,0.0654779337560201
STAT,1855,54,50-100,1909,0.010437282330030322
STAT,1860,33,30-34,1893,13.326565877805225
STAT,1908,17,50-100,1925,0.06865683904616925
STAT,1936,17,20-24,1953,122.61726021969788
STAT,1823,36,15-19,1859,0.09649540129669401
SIM,1851,27,35-39,1878,8
STAT,1929,21,15-19,1950,6.378276326574675
STAT,1939,17,50-100,1956,0.35428280175456917
STAT,1922,16,15-19,1938,49.73975470670487
STAT,1899,39,35-39,1938,1.9561830544052583
STAT,1841,39,35-39,1880,5.6269907585812575
STAT,1826,37,45-49,1863,2.175310736828117
STAT,1832,38,na,1870,1601.9924359692186
STAT,1909,21,30-34,1930,25.31228635581917
STAT,1837,49,20-24,1886,0.007879961195874155
STAT,1875,15,50-100,1890,0.04779285873049933
STAT,1873,46,20-24,1919,0.011530017269454995
STAT,1890,27,15-19,1917,0.5240109244981203
SIM,1927,39,30-34,1966,2
STAT,1867,31,25-29,1898,9.123120625929364
STAT,1869,27,20-24,1896,10.736500452855683
STAT,1821,48,15-19,1869,6.218242371254655E-4
STAT,1859,43,35-39,1902,1.3516983018256914
STAT,1934,29,20-24,1963,23.174895811900395
SIM,1857,33,30-34,1890,24
SIM,1897,30,na,1927,3092
SIM,1930,23,20-24,1953,128
SIM,1917,21,30-34,1938,39
STAT,1872,18,30-34,1890,1.506357412428826
SIM,1836,25,45-49,1861,4
SIM,1845,16,20-24,1861,17
STAT,1920,28,15-19,1948,0.7290019109234298
STAT,1937,16,25-29,1953,39.92438240238229
SIM,1929,27,30-34,1956,58
STAT,1897,32,15-19,1929,0.1799153460729898
STAT,1897,4,na,1901,3323.5645454422056
STAT,1903,52,na,1955,2878.856861268104
STAT,1944,23,40-44,1967,3.428444576711158
STAT,1843,15,35-39,1858,0.47926075416004815
STAT,1858,44,30-34,1902,0.8400437973240076
STAT,1895,16,45-49,1911,0.08064870142119902
STAT,1944,25,50-100,1969,1.0171629173192411
SIM,1845,93,na,1938,15
SIM,1925,22,na,1947,4065
STAT,1875,18,na,1893,2445.9753198486183
STAT,1880,30,na,1910,2395.713898748584
SIM,1942,29,20-24,1971,18
SIM,1859,21,30-34,1880,14
STAT,1930,29,50-100,1959,1.1944270929372274
STAT,1862,46,45-49,1908,0.191162784180094
SIM,1913,38,25-29,1951,1
STAT,1855,63,na,1918,1267.9742003080926
STAT,1845,22,40-44,1867,1.830575100642606
STAT,1930,18,30-34,1948,14.847392622640516
STAT,1884,50,35-39,1934,0.008150479806403783
STAT,1857,20,45-49,1877,0.6084938611479378
SIM,1843,20,25-29,1863,65
SIM,1834,37,45-49,1871,1
STAT,1859,56,na,1915,1533.5814837649034
STAT,1910,40,45-49,1950,0.1502795509719106
SIM,1899,30,50-100,1929,1
SIM,1880,18,30-34,1898,2
STAT,1899,20,15-19,1919,4.295744400411156
SIM,1877,33,na,1910,2301
STAT,1825,31,20-24,1856,5.261996626037592
STAT,1855,32,45-49,1887,1.2617679475378194
SIM,1901,20,25-29,1921,80
STAT,1837,37,20-24,1874,0.6091069709061104
STAT,1835,32,25-29,1867,8.299585930820522
SIM,1865,28,40-44,1893,4
SIM,1853,22,40-44,1875,4
STAT,1892,22,20-24,1914,81.5407299860926
SIM,1944,17,20-24,1961,110
SIM,1919,26,25-29,1945,74
SIM,1825,37,35-39,1862,13
STAT,1913,32,45-49,1945,1.4790591025329414
SIM,1914,22,25-29,1936,96
STAT,1872,89,na,1961,180.49062127971908
STAT,1941,18,40-44,1959,1.3605841566782522
SIM,1844,31,30-34,1875,16
STAT,1853,82,na,1935,353.1077770239554
STAT,1846,20,35-39,1866,5.417920180927996
SIM,1938,20,20-24,1958,93
SIM,1881,28,25-29,1909,38
STAT,1838,36,25-29,1874,2.3568033073989225
STAT,1916,45,40-44,1961,0.15348686635406675
SIM,1855,38,25-29,1893,5
STAT,1862,45,na,1907,1835.3551770482002
SIM,1831,73,na,1904,693
STAT,1877,95,na,1972,71.34742498385486
STAT,1878,38,20-24,1916,0.755152382649141
SIM,1794,76,na,1870,320
SIM,1848,21,20-24,1869,60
STAT,1863,20,35-39,1883,5.005748796962936
STAT,1860,30,na,1890,1843.833320485254
SIM,1868,21,40-44,1889,2
SIM,1887,40,na,1927,2423
STAT,1849,33,30-34,1882,13.653695537652059
SIM,1836,33,50-100,1869,4
SIM,1875,28,35-39,1903,15
STAT,1866,32,20-24,1898,2.3552327101399513
SIM,1918,40,na,1958,3742
STAT,1909,49,15-19,1958,3.179107983453462E-4
STAT,1820,37,50-100,1857,2.824229776347922
STAT,1886,58,na,1944,1973.465074283176
STAT,1904,37,na,1941,3217.6729682939836
STAT,1817,50,50-100,1867,0.03395491068232148
STAT,1951,21,25-29,1972,104.2890588236585
STAT,1835,20,25-29,1855,66.24944430065335
STAT,1900,24,na,1924,3080.003943181578
SIM,1949,20,30-34,1969,42
SIM,1837,64,na,1901,1092
SIM,1943,7,na,1950,3862
SIM,1847,28,50-100,1875,2
STAT,1873,28,25-29,1901,40.38693927338043
STAT,1820,98,na,1918,1.711356455593148
STAT,1893,28,45-49,1921,1.3254916352024333
STAT,1877,21,40-44,1898,2.0481614515200386
SIM,1915,12,na,1927,3744
STAT,1906,22,25-29,1928,78.76445499044485
STAT,1921,40,20-24,1961,0.018843263291725323
STAT,1857,38,50-100,1895,0.9102061149739418
SIM,1841,80,na,1921,369
SIM,1895,29,30-34,1924,29
SIM,1838,60,na,1898,1265
STAT,1926,34,45-49,1960,1.7951265422854268
SIM,1828,39,na,1867,1585
SIM,1859,24,35-39,1883,3
SIM,1829,36,25-29,1865,2
SIM,1867,43,35-39,1910,4
STAT,1835,37,50-100,1872,0.9660587059012693
STAT,1831,53,na,1884,1277.905512115024
STAT,1861,22,25-29,1883,46.195005525132316
SIM,1904,33,20-24,1937,1
STAT,1832,48,25-29,1880,0.04063410920662898
SIM,1846,36,25-29,1882,2
STAT,1873,82,na,1955,447.03937847783396
SIM,1839,38,40-44,1877,9
STAT,1842,45,na,1887,1671.8617576949864
STAT,1837,110,na,1947,1.793389766332606E-4
STAT,1816,103,na,1919,0.0668782418315665
SIM,1860,20,25-29,1880,44
STAT,1840,19,30-34,1859,1.3383646456666813
STAT,1898,29,40-44,1927,3.8022168450564826
STAT,1866,49,50-100,1915,0.20952843161955778
SIM,1942,8,na,1950,3832
SIM,1837,98,na,1935,1
SIM,1896,27,25-29,1923,56
SIM,1849,27,45-49,1876,1
STAT,1877,39,15-19,1916,0.05447397052759856
STAT,1888,27,25-29,1915,47.227345854329755
SIM,1899,32,25-29,1931,18
STAT,1797,61,na,1858,935.9699931236687
SIM,1952,1,na,1953,4450
SIM,1828,38,30-34,1866,2
SIM,1937,28,35-39,1965,13
STAT,1857,42,20-24,1899,0.11817971713256999
STAT,1900,34,25-29,1934,13.308056562298807
SIM,1934,34,45-49,1968,1
STAT,1852,20,25-29,1872,50.01845533119723
STAT,1821,45,45-49,1866,0.3833221489644661
STAT,1936,31,35-39,1967,8.389947241823412
SIM,1930,33,50-100,1963,1
SIM,1821,80,na,1901,354
STAT,1882,15,20-24,1897,16.363148155629887
SIM,1870,21,30-34,1891,19
SIM,1875,35,40-44,1910,4
STAT,1846,49,30-34,1895,0.07029786350654628
SIM,1938,32,20-24,1970,5
SIM,1964,1,na,1965,4613
STAT,1919,18,30-34,1937,12.691339800915323
STAT,1888,39,25-29,1927,3.1821222951999837
STAT,1852,39,45-49,1891,1.4307046654347872
STAT,1855,97,na,1952,3.8176586887963104
STAT,1875,48,50-100,1923,0.2354846785920829
SIM,1907,24,40-44,1931,5
STAT,1888,36,na,1924,2642.986411729395
SIM,1879,34,50-100,1913,4
STAT,1875,23,30-34,1898,17.24254366698185
STAT,1878,29,na,1907,2332.788394329609
STAT,1897,39,35-39,1936,1.9093032108866606
SIM,1875,38,na,1913,2278
SIM,1773,91,na,1864,15
STAT,1856,31,15-19,1887,0.10735968814852284
STAT,1781,83,na,1864,125.58545606912773
STAT,1929,28,35-39,1957,17.741537286032784
SIM,1894,8,na,1902,3291
SIM,1921,15,na,1936,4018
STAT,1882,25,30-34,1907,23.29195360016675
STAT,1909,28,15-19,1937,0.6351429148848305
SIM,1929,1,na,1930,4894
STAT,1887,29,30-34,1916,26.41913629852792
SIM,1777,84,na,1861,84
STAT,1837,30,35-39,1867,8.413506671865916
SIM,1860,39,45-49,1899,2
SIM,1824,46,na,1870,1426
STAT,1939,22,20-24,1961,105.49560935047299
SIM,1834,27,35-39,1861,8
SIM,1942,14,na,1956,3802
STAT,1914,47,30-34,1961,0.08352351402465756
STAT,1791,90,na,1881,29.038669237814446
SIM,1871,20,35-39,1891,6
STAT,1869,15,na,1884,2371.26660979804
SIM,1877,26,45-49,1903,1
STAT,1884,16,35-39,1900,0.5133793899494193
STAT,1902,59,na,1961,2713.8774310632025
SIM,1830,26,20-24,1856,15
STAT,1833,31,na,1864,1729.549097683011
STAT,1868,30,na,1898,2168.171749443327
SIM,1834,20,15-19,1854,2
STAT,1817,37,35-39,1854,25.25738510442733
SIM,1828,53,na,1881,1337
STAT,1864,37,15-19,1901,0.047280556474362266
STAT,1867,35,40-44,1902,3.920065774789968
STAT,1853,50,40-44,1903,0.008081777610424147
STAT,1856,38,35-39,1894,5.1874354520043084
SIM,1860,27,45-49,1887,3
SIM,1854,20,35-39,1874,6
STAT,1836,38,15-19,1874,0.04417385745846352
STAT,1836,31,30-34,1867,14.440644470675622
STAT,1879,37,25-29,1916,2.8471609121533645
SIM,1840,27,25-29,1867,41
SIM,1947,22,20-24,1969,111
STAT,1893,37,na,1930,2822.525805807429
STAT,1847,48,35-39,1895,0.10193983732175979
SIM,1889,29,40-44,1918,4
STAT,1831,28,20-24,1859,9.826105008703784
STAT,1836,103,na,1939,0.09293552958258755
STAT,1857,45,25-29,1902,0.04334336201952862
SIM,1825,100,na,1925,1
SIM,1929,20,45-49,1949,2
SIM,1859,31,40-44,1890,4
STAT,1838,103,na,1941,0.09634883120759055
STAT,1924,37,na,1961,4190.8565700322615
STAT,1800,92,na,1892,16.55701795959421
STAT,1855,19,50-100,1874,0.040922533476675016
SIM,1823,34,30-34,1857,18
SIM,1840,15,25-29,1855,5
SIM,1893,6,na,1899,3273
SIM,1948,21,25-29,1969,98
STAT,1859,110,na,1969,0.002488954299569521
SIM,1892,28,35-39,1920,15
STAT,1906,16,30-34,1922,2.198397110106251
STAT,1757,106,na,1863,0.013895393142886719
STAT,1884,28,35-39,1912,8.973845286334564
SIM,1864,97,na,1961,17
SIM,1914,16,30-34,1930,5
STAT,1861,104,na,1965,0.2858463337411653
SIM,1890,25,30-34,1915,39
SIM,1890,30,50-100,1920,1
SIM,1936,34,50-100,1970,1
STAT,1842,17,40-44,1859,0.1700898262561135
SIM,1887,37,25-29,1924,4
STAT,1854,16,na,1870,1976.288257143728
STAT,1896,48,15-19,1944,2.7798186289957596E-4
STAT,1927,27,20-24,1954,20.96380947195092
SIM,1837,28,30-34,1865,21
SIM,1942,5,na,1947,3868
STAT,1775,83,na,1858,115.22922736747466
STAT,1860,64,na,1924,1332.4685429425572
SIM,1879,11,na,1890,2588
STAT,1864,23,na,1887,2008.7985292440642
STAT,1928,22,50-100,1950,0.7760852703141766
STAT,1852,24,40-44,1876,1.7690007648949964
STAT,1871,15,45-49,1886,0.062405960597430525
SIM,1875,52,na,1927,2055
STAT,1895,69,na,1964,2027.2885136066673
SIM,1850,38,40-44,1888,7
SIM,1856,30,45-49,1886,2
STAT,1896,30,40-44,1926,5.4543512814307755
STAT,1933,11,na,1944,5018.194346723389
STAT,1842,38,40-44,1880,3.6803632463306983
STAT,1935,18,15-19,1953,58.45659078209771
STAT,1856,25,20-24,1881,9.09033231731903
SIM,1828,50,na,1878,1410
SIM,1943,18,15-19,1961,45
SIM,1883,44,30-34,1927,3
STAT,1820,50,45-49,1870,0.02434401608908786
STAT,1924,1,na,1925,4697.873858819564
STAT,1841,24,30-34,1865,15.333728692965144
SIM,1872,16,15-19,1888,6
SIM,1929,33,25-29,1962,18
STAT,1893,25,50-100,1918,0.7715684731391337
STAT,1860,15,35-39,1875,0.49084115899353
STAT,1864,16,15-19,1880,5.713875052530105
SIM,1857,19,na,1876,2123
SIM,1936,14,na,1950,2953
STAT,1881,18,na,1899,2298.845774349412
STAT,1854,37,20-24,1891,0.5515308341142712
STAT,1882,18,25-29,1900,5.192470476098075
STAT,1931,25,20-24,1956,22.28224820712408
SIM,1899,11,na,1910,3425
SIM,1931,19,35-39,1950,5
STAT,1850,29,35-39,1879,7.889777285505694
STAT,1929,15,20-24,1944,164.2067485258095
STAT,1953,17,na,1970,4206.19118466867
STAT,1801,77,na,1878,331.3684417330508
SIM,1835,44,35-39,1879,4
SIM,1935,27,20-24,1962,24
STAT,1867,17,45-49,1884,0.05923836033141865
STAT,1913,26,15-19,1939,0.6668194071236192
SIM,1824,91,na,1915,15
SIM,1845,19,25-29,1864,7
STAT,1837,19,25-29,1856,5.118774939560155
STAT,1834,25,35-39,1859,7.96605098911363
SIM,1875,38,45-49,1913,2
SIM,1933,31,25-29,1964,14
SIM,1802,99,na,1901,3
STAT,1830,32,40-44,1862,3.719838857966787
STAT,1922,26,25-29,1948,70.60190993642651
STAT,1938,27,30-34,1965,36.67209893966103
SIM,1930,26,25-29,1956,83
STAT,1839,31,15-19,1870,0.11789841629653022
SIM,1885,24,45-49,1909,3
SIM,1890,18,25-29,1908,11
STAT,1824,39,35-39,1863,10.022905457878306
SIM,1791,65,na,1856,732
SIM,1860,24,40-44,1884,3
SIM,1813,51,na,1864,1258
SIM,1937,15,20-24,1952,115
STAT,1849,54,30-34,1903,0.004340879616888203
STAT,1844,36,50-100,1880,1.0005174311281682
SIM,1819,79,na,1898,355
STAT,1848,30,na,1878,1917.415489426059
STAT,1848,30,45-49,1878,1.5427974142870025
STAT,1870,50,40-44,1920,0.00989682468476719
SIM,1877,30,na,1907,2336
SIM,1852,36,50-100,1888,2
STAT,1840,36,15-19,1876,0.04404168616808315
STAT,1877,32,30-34,1909,17.109382067636297
SIM,1870,60,na,1930,1733
SIM,1908,34,35-39,1942,10
STAT,1873,49,25-29,1922,0.05403512238846585
SIM,1901,28,20-24,1929,18
STAT,1935,21,40-44,1956,4.326867178224145
STAT,1837,75,na,1912,668.1043406675828
STAT,1923,19,35-39,1942,4.629754178454161
SIM,1836,22,40-44,1858,1
STAT,1808,53,30-34,1861,0.021076055874469854
STAT,1826,34,40-44,1860,5.230039013688956
STAT,1845,25,45-49,1870,0.970197825319909
STAT,1883,35,25-29,1918,2.692077370370036
STAT,1953,17,20-24,1970,154.92899829916252
STAT,1835,39,45-49,1874,1.5363504453540529
SIM,1826,32,25-29,1858,16
STAT,1948,10,na,1958,4248.082747722315
SIM,1903,16,20-24,1919,25
STAT,1796,68,na,1864,706.8455625026605
STAT,1925,31,25-29,1956,10.374306681754074
SIM,1860,53,na,1913,1758
SIM,1893,23,25-29,1916,75
STAT,1885,23,25-29,1908,53.738395791829625
STAT,1875,63,na,1938,1732.5856044136847
STAT,1832,45,20-24,1877,0.008797576149155578
STAT,1814,95,na,1909,6.110975445725099
STAT,1875,44,30-34,1919,1.1012761648876526
STAT,1905,35,20-24,1940,0.2293499409195391
SIM,1839,79,na,1918,425
SIM,1878,29,30-34,1907,31
SIM,1923,41,na,1964,4173
STAT,1816,44,25-29,1860,1.5845136470796617
SIM,1843,39,45-49,1882,1
STAT,1897,36,30-34,1933,6.765702383480351
STAT,1781,111,na,1892,4.7471007293998287E-4
SIM,1885,32,30-34,1917,27
STAT,1901,19,15-19,1920,7.805420227247587
STAT,1918,15,45-49,1933,0.10353309724390322
STAT,1860,15,50-100,1875,0.043825095361816814
STAT,1911,27,50-100,1938,0.917029416989423
SIM,1834,34,40-44,1868,4
SIM,1898,48,50-100,1946,1
SIM,1911,22,40-44,1933,3
STAT,1878,17,20-24,1895,17.4541043751881
STAT,1881,22,45-49,1903,0.6363802001335529
SIM,1891,35,25-29,1926,2
STAT,1918,51,na,1969,3646.2588581550363
STAT,1885,70,na,1955,1321.1958040110756
STAT,1853,47,50-100,1900,0.18500259747515177
SIM,1817,98,na,1915,2
STAT,1831,38,30-34,1869,4.0369352436914205
STAT,1867,34,na,1901,2098.7205913392927
SIM,1864,25,20-24,1889,8
STAT,1862,28,15-19,1890,0.365173997426167
STAT,1830,57,na,1887,1221.5330831424112
SIM,1891,39,40-44,1930,11
STAT,1908,44,na,1952,3206.26859276302
STAT,1870,22,35-39,1892,5.408097010384765
STAT,1899,24,30-34,1923,22.91193089104691
SIM,1888,70,na,1958,1644
STAT,1915,28,40-44,1943,4.475510705963273
STAT,1862,42,na,1904,1864.532817540733
SIM,1923,28,40-44,1951,7
SIM,1898,37,35-39,1935,3
STAT,1816,48,40-44,1864,0.39793007794260604
STAT,1921,43,25-29,1964,0.07586136705512918
STAT,1847,38,25-29,1885,2.1800976192472588
STAT,1903,22,40-44,1925,2.8009563403906923
STAT,1819,50,na,1869,1370.999306243509
SIM,1900,13,na,1913,3429
STAT,1883,39,40-44,1922,4.013694866255245
SIM,1907,34,na,1941,3326
SIM,1818,41,30-34,1859,1
SIM,1902,23,45-49,1925,5
STAT,1893,25,40-44,1918,3.613115782035997
STAT,1868,45,35-39,1913,0.12744593539437835
STAT,1928,37,15-19,1965,0.02292622796253995
STAT,1774,87,na,1861,41.83931887080201
SIM,1926,33,40-44,1959,6
SIM,1875,25,30-34,1900,33
STAT,1809,49,45-49,1858,0.643026482663976
SIM,1837,24,15-19,1861,2
STAT,1834,43,30-34,1877,0.8491833547266221
SIM,1833,31,20-24,1864,3
STAT,1858,38,35-39,1896,5.212797538856817
SIM,1865,93,na,1958,41
STAT,1853,34,35-39,1887,7.730244683379554
STAT,1763,95,na,1858,1.264034878468122
STAT,1928,22,45-49,1950,1.327105761670713
STAT,1947,23,25-29,1970,98.59150164561649
STAT,1853,9,na,1862,2217.9699531421334
STAT,1842,90,na,1932,57.094942400605625
STAT,1916,48,45-49,1964,0.2100057575110728
STAT,1896,15,15-19,1911,7.438854763788853
STAT,1917,22,35-39,1939,9.454010232736898
SIM,1890,28,35-39,1918,14
SIM,1842,65,na,1907,1096
STAT,1857,49,40-44,1906,0.1248912023006388
SIM,1915,33,30-34,1948,21
STAT,1849,36,35-39,1885,5.483794130097548
STAT,1918,33,40-44,1951,3.9119284136576504
SIM,1861,34,35-39,1895,6
STAT,1845,43,40-44,1888,1.6001762877546104
STAT,1846,43,50-100,1889,0.7829647451096796
STAT,1792,107,na,1899,8.596901813802274E-4
STAT,1874,20,45-49,1894,0.6770870260965518
STAT,1888,24,20-24,1912,76.45559043016517
SIM,1873,71,na,1944,1228
STAT,1839,56,na,1895,1357.9847395673894
STAT,1930,32,45-49,1962,1.9184059512676899
SIM,1893,26,na,1919,2977
STAT,1790,101,na,1891,0.11323555947425043
STAT,1804,51,na,1855,1184.0205836251307
SIM,1934,24,35-39,1958,12
STAT,1919,20,45-49,1939,1.1708850392178358
SIM,1862,34,na,1896,2014
SIM,1934,33,na,1967,4791
STAT,1919,35,15-19,1954,0.019598042796036084
STAT,1879,27,15-19,1906,0.448654280189872
STAT,1824,57,na,1881,1199.503685283163
SIM,1924,26,na,1950,4135
STAT,1921,20,35-39,1941,10.106863967768538
SIM,1853,25,45-49,1878,1
SIM,1853,43,40-44,1896,5
STAT,1859,30,20-24,1889,2.062010506533916
STAT,1907,33,30-34,1940,13.853773160131983
STAT,1917,49,50-100,1966,0.22187471890704283
STAT,1937,34,20-24,1971,2.2767966561410633
SIM,1943,21,40-44,1964,1
STAT,1898,6,na,1904,3339.688791799431
STAT,1829,49,na,1878,1446.3394031826272
STAT,1882,28,35-39,1910,8.833415343892025
SIM,1891,48,na,1939,2627
STAT,1867,38,45-49,1905,1.759607153211503
SIM,1878,43,45-49,1921,1
SIM,1925,22,35-39,1947,12
STAT,1915,42,20-24,1957,0.016796988609184105
SIM,1855,86,na,1941,132
SIM,1908,19,na,1927,3513
STAT,1842,34,25-29,1876,8.776370462403944
STAT,1910,20,25-29,1930,82.43762426450795
SIM,1850,34,25-29,1884,16
STAT,1839,47,30-34,1886,0.06566547100902394
STAT,1861,51,45-49,1912,0.01145385603409042
STAT,1815,43,na,1858,1408.1011652463083
STAT,1833,22,15-19,1855,2.725273802407961
SIM,1848,24,25-29,1872,49
SIM,1857,36,35-39,1893,8
STAT,1850,43,15-19,1893,0.009664549279912109
SIM,1841,22,15-19,1863,2
SIM,1939,25,na,1964,3498
SIM,1869,31,35-39,1900,6
SIM,1872,26,25-29,1898,46
SIM,1907,27,45-49,1934,1
STAT,1897,26,20-24,1923,14.872171693528946
SIM,1864,38,35-39,1902,10
STAT,1864,26,25-29,1890,35.73882952926683
STAT,1904,28,30-34,1932,34.002781806920524
SIM,1867,30,20-24,1897,2
SIM,1920,19,25-29,1939,46
SIM,1882,23,15-19,1905,3
STAT,1876,48,na,1924,2168.2643934974885
STAT,1846,45,15-19,1891,2.9963905814465633E-4
STAT,1838,26,15-19,1864,0.3902686994002104
SIM,1821,39,25-29,1860,2
STAT,1827,44,35-39,1871,1.678581869282313
SIM,1832,39,35-39,1871,20
SIM,1901,49,na,1950,2942
SIM,1927,20,45-49,1947,2
SIM,1831,29,40-44,1860,2
STAT,1831,50,na,1881,1356.1325027256037
STAT,1872,39,30-34,1911,4.999358813758761
SIM,1822,65,na,1887,913
STAT,1912,19,25-29,1931,8.23412992622
SIM,1919,5,na,1924,4251
STAT,1769,106,na,1875,0.009792939003658536
SIM,1850,94,na,1944,11
SIM,1859,42,30-34,1901,1
SIM,1906,21,20-24,1927,96
STAT,1840,21,45-49,1861,0.5861685062148875
SIM,1875,21,15-19,1896,3
STAT,1948,16,35-39,1964,4.537953484751795
SIM,1874,32,20-24,1906,1
STAT,1886,55,na,1941,2063.392851562231
SIM,1839,90,na,1929,33
STAT,1789,86,na,1875,63.44374952174036
SIM,1853,20,na,1873,1930
STAT,1894,35,35-39,1929,8.668427128932189
SIM,1867,33,25-29,1900,11
SIM,1840,87,na,1927,108
STAT,1863,2,na,1865,2833.072685937861
SIM,1917,31,40-44,1948,3
STAT,1921,49,30-34,1970,0.09438063383785622
STAT,1926,24,35-39,1950,10.7386129578409
SIM,1912,28,30-34,1940,43
STAT,1813,65,na,1878,832.2308121747512
STAT,1911,19,na,1930,3631.7281651268418
STAT,1926,18,na,1944,4251.919962541609
STAT,1955,15,30-34,1970,15.29227363982379
SIM,1826,72,na,1898,665
SIM,1834,24,30-34,1858,15
SIM,1823,37,35-39,1860,14
SIM,1859,34,45-49,1893,1
STAT,1900,17,40-44,1917,0.23969527534516857
SIM,1842,43,30-34,1885,6
STAT,1844,32,35-39,1876,8.410875737989961
STAT,1867,21,15-19,1888,2.9597990889830372
SIM,1896,24,20-24,1920,83
SIM,1851,79,na,1930,470
SIM,1866,78,na,1944,634
STAT,1848,16,30-34,1864,1.4768604026133696
SIM,1905,29,35-39,1934,16
STAT,1861,26,40-44,1887,2.3872119943548653
SIM,1864,35,30-34,1899,4
SIM,1882,85,na,1967,463
SIM,1868,18,15-19,1886,6
STAT,1933,23,30-34,1956,36.003414387598056
SIM,1864,12,na,1876,2369
STAT,1779,103,na,1882,0.043958209912404636
STAT,1828,64,na,1892,979.0091075396656
STAT,1947,5,na,1952,4216.347452184878
SIM,1856,16,30-34,1872,1
SIM,1916,48,na,1964,3460
SIM,1941,23,30-34,1964,34
STAT,1886,44,40-44,1930,2.2142781730829606
SIM,1877,23,40-44,1900,1
STAT,1856,35,30-34,1891,3.9656211296357466
STAT,1919,23,50-100,1942,0.6785636123570471
SIM,1829,33,20-24,1862,2
SIM,1880,39,30-34,1919,8
STAT,1920,26,50-100,1946,1.0350179597469138
SIM,1889,25,25-29,1914,47
STAT,1862,49,15-19,1911,3.163413287992527E-4
STAT,1898,46,25-29,1944,0.04165531513590813
SIM,1811,73,na,1884,459
SIM,1852,32,35-39,1884,12
STAT,1816,106,na,1922,0.005658047970909809
STAT,1909,31,40-44,1940,3.5424034234111903
SIM,1795,72,na,1867,522
STAT,1819,53,40-44,1872,0.018768277277127494
STAT,1945,25,15-19,1970,0.7323011229388425
STAT,1942,25,na,1967,3717.609912894028
STAT,1923,33,15-19,1956,0.1390824786141148
STAT,1837,44,50-100,1881,0.7176224499329668
STAT,1821,43,na,1864,1443.9031165354656
STAT,1778,94,na,1872,3.730889055711536
SIM,1860,23,30-34,1883,15
STAT,1883,52,na,1935,1983.6760553238666
SIM,1856,23,na,1879,1955
STAT,1819,43,40-44,1862,4.570874011328375
STAT,1928,43,50-100,1971,0.1412553127981838
SIM,1841,18,25-29,1859,4
STAT,1908,26,40-44,1934,4.212366322307507
STAT,1938,4,na,1942,3761.330062983202
SIM,1881,34,30-34,1915,23
STAT,1925,30,25-29,1955,10.380015690383788
STAT,1859,52,25-29,1911,0.0026490283050003074
STAT,1845,39,25-29,1884,2.0966826081046857
SIM,1819,39,na,1858,1499
STAT,1886,47,50-100,1933,0.2439441842332113
STAT,1881,53,20-24,1934,6.626173870126806E-4
STAT,1854,87,na,1941,126.054712150993
STAT,1858,45,45-49,1903,0.17654351704265997
STAT,1929,18,25-29,1947,52.10725256453592
SIM,1823,44,na,1867,1382
STAT,1846,41,50-100,1887,0.8032862378612516
STAT,1879,47,na,1926,2214.4350695095945
STAT,1926,17,45-49,1943,0.5785730482891036
STAT,1841,51,25-29,1892,0.002453589511842496
SIM,1885,36,40-44,1921,8
SIM,1888,37,20-24,1925,4
STAT,1903,49,50-100,1952,0.18232923591915554
STAT,1875,33,na,1908,2307.3647004399513
SIM,1843,26,35-39,1869,9
SIM,1868,39,45-49,1907,1
SIM,1883,42,40-44,1925,7
STAT,1909,8,na,1917,3682.986559861864
SIM,1924,32,25-29,1956,11
STAT,1905,30,50-100,1935,1.2611849125124057
STAT,1835,35,50-100,1870,0.9863310551997602
SIM,1897,22,15-19,1919,3
STAT,1835,26,35-39,1861,8.061677027416138
STAT,1874,40,50-100,1914,1.0300013477363976
SIM,1912,27,na,1939,3451
STAT,1890,38,na,1928,2707.5765727143703
SIM,1808,87,na,1895,47
STAT,1866,30,20-24,1896,2.374164405370271
STAT,1873,52,50-100,1925,0.014393130745868087
STAT,1875,42,40-44,1917,2.1813908832387976
SIM,1937,18,25-29,1955,40
STAT,1813,89,na,1902,43.234426140125905
STAT,1862,48,15-19,1910,3.190275406918782E-4
SIM,1864,37,35-39,1901,14
STAT,1882,18,20-24,1900,16.244800992904487
STAT,1862,36,20-24,1898,0.6256256805467024
SIM,1814,43,30-34,1857,1
STAT,1894,40,25-29,1934,0.7874769532502385
STAT,1903,45,20-24,1948,0.009189274859044798
SIM,1931,22,15-19,1953,6
SIM,1827,43,40-44,1870,8
SIM,1834,28,35-39,1862,11
SIM,1836,36,45-49,1872,4
STAT,1874,3,na,1877,2986.446761605502
STAT,1852,23,30-34,1875,15.230677330188701
STAT,1837,29,50-100,1866,0.5252393182945436
SIM,1889,16,30-34,1905,2
STAT,1873,34,30-34,1907,16.585185949142602
SIM,1916,26,40-44,1942,8
SIM,1890,74,na,1964,1677
SIM,1891,16,na,1907,2999
SIM,1853,39,25-29,1892,1
SIM,1886,69,na,1955,1348
SIM,1921,6,na,1927,4350
SIM,1878,18,20-24,1896,13
SIM,1882,55,na,1937,1944
SIM,1865,105,na,1970,1
SIM,1920,46,na,1966,3918
STAT,1815,49,40-44,1864,0.3739405927277513
STAT,1895,27,45-49,1922,1.3674478808126564
STAT,1927,32,na,1959,4394.988968108386
STAT,1854,37,25-29,1891,2.0600224595386645
SIM,1821,33,20-24,1854,5
SIM,1950,2,na,1952,4311
SIM,1811,59,na,1870,985
STAT,1831,27,na,1858,1666.680312520737
SIM,1827,30,35-39,1857,11
STAT,1848,35,50-100,1883,0.9598548983059202
SIM,1872,36,30-34,1908,5
STAT,1916,32,25-29,1948,9.014597776675005
SIM,1853,33,40-44,1886,3
STAT,1895,6,na,1901,3217.3758509752715
SIM,1928,26,na,1954,4357
STAT,1944,28,na,1972,3823.0814716436985
STAT,1899,47,50-100,1946,0.1784890409894466
STAT,1932,20,15-19,1952,6.637507741216548
STAT,1940,14,na,1954,3772.71769885258
STAT,1838,49,35-39,1887,0.09425162993539667
STAT,1886,21,35-39,1907,5.840867203079628
SIM,1924,12,na,1936,4479
SIM,1894,21,35-39,1915,7
STAT,1863,41,35-39,1904,1.5079884929190424
STAT,1849,52,40-44,1901,0.007852321836957702
STAT,1865,39,na,1904,1997.0399044629805
STAT,1917,24,40-44,1941,3.3548263778833034
STAT,1880,24,20-24,1904,68.20270461116087
STAT,1847,47,35-39,1894,0.10275571772046023
SIM,1834,20,25-29,1854,54
STAT,1917,37,50-100,1954,0.4119759159652656
STAT,1923,22,15-19,1945,5.851134071835526
STAT,1866,44,40-44,1910,1.9333878044870887
STAT,1956,13,na,1969,4908.8367899176255
SIM,1943,15,na,1958,3596
STAT,1934,16,40-44,1950,1.7916541911100605
SIM,1887,31,45-49,1918,1
SIM,1787,76,na,1863,320
STAT,1841,21,na,1862,1880.8332297385964
STAT,1864,36,30-34,1900,4.508951986428393
STAT,1833,93,na,1926,17.93054210837319
SIM,1877,37,45-49,1914,2
SIM,1898,54,na,1952,2619
SIM,1873,19,na,1892,2412
SIM,1894,29,45-49,1923,1
STAT,1890,46,25-29,1936,0.03763276533272497
SIM,1892,35,45-49,1927,2
STAT,1849,49,na,1898,1651.8585890725167
SIM,1899,38,35-39,1937,3
SIM,1871,41,35-39,1912,5
STAT,1866,72,na,1938,1100.3872545132663
STAT,1796,60,na,1856,952.5140711311002
STAT,1858,31,25-29,1889,7.665693885814523
STAT,1850,54,30-34,1904,0.004080701590121581
STAT,1825,41,15-19,1866,0.015385407027613957
SIM,1825,44,45-49,1869,2
STAT,1870,53,45-49,1923,0.013233596645753022
STAT,1912,38,25-29,1950,0.9033726487493766
STAT,1901,43,45-49,1944,0.1364379072488902
STAT,1907,19,50-100,1926,0.06762278349721661
SIM,1874,44,40-44,1918,9
STAT,1856,23,15-19,1879,2.803842181748204
SIM,1869,73,na,1942,1028
SIM,1942,16,40-44,1958,1
SIM,1844,38,na,1882,1652
STAT,1914,46,35-39,1960,0.12109879576505907
SIM,1890,18,20-24,1908,25
STAT,1786,98,na,1884,0.5422409589242373
SIM,1894,40,na,1934,2945
STAT,1857,36,na,1893,1763.7952661443633
SIM,1861,18,na,1879,2249
SIM,1832,96,na,1928,4
STAT,1874,16,na,1890,2443.7613560745467
SIM,1820,95,na,1915,6
SIM,1842,41,40-44,1883,7
STAT,1845,35,na,1880,1786.6451740006626
STAT,1858,39,35-39,1897,5.186055887482484
STAT,1929,31,50-100,1960,0.9926686578155536
SIM,1938,27,30-34,1965,38
SIM,1927,8,na,1935,4662
STAT,1850,15,20-24,1865,15.452947645493767
STAT,1896,47,30-34,1943,0.0678100795379479
STAT,1845,44,20-24,1889,0.11154425040484098
SIM,1825,35,30-34,1860,3
STAT,1819,110,na,1929,1.458774750602371E-4
STAT,1869,37,45-49,1906,1.8244180012678044
SIM,1919,27,20-24,1946,24
STAT,1817,44,45-49,1861,3.5124720821035207
SIM,1887,3,na,1890,2729
SIM,1835,61,na,1896,1199
STAT,1889,22,15-19,1911,3.847502817942946
SIM,1933,30,25-29,1963,12
STAT,1851,36,45-49,1887,1.4644852394342514
SIM,1799,77,na,1876,325
STAT,1892,32,15-19,1924,0.16850392468873657
STAT,1884,35,45-49,1919,1.8782324268450656
STAT,1801,54,35-39,1855,0.023103086747232604
STAT,1886,34,40-44,1920,4.290602804396858
STAT,1875,23,25-29,1898,55.414567070481674
STAT,1912,43,20-24,1955,0.015994868009050832
STAT,1859,40,30-34,1899,0.8731470039763611
STAT,1884,26,30-34,1910,23.583444079339674
STAT,1909,23,50-100,1932,0.5759642757454306
SIM,1949,20,35-39,1969,13
STAT,1854,71,na,1925,955.0298485420822
SIM,1894,34,40-44,1928,9
STAT,1858,85,na,1943,203.04629375834813
STAT,1862,90,na,1952,63.680987264625
STAT,1882,27,35-39,1909,8.864618802075325
STAT,1872,41,50-100,1913,1.0055993852374212
SIM,1877,92,na,1969,132
STAT,1826,39,15-19,1865,0.057446462128391385
STAT,1828,47,25-29,1875,0.046639613999993765
SIM,1853,20,35-39,1873,6
STAT,1874,50,25-29,1924,0.0034679638068244
SIM,1849,44,30-34,1893,3
STAT,1760,104,na,1864,0.024352956633630386
STAT,1927,32,50-100,1959,0.9607872518371229
STAT,1942,22,25-29,1964,91.49316107205979
SIM,1823,36,35-39,1859,13
SIM,1892,26,30-34,1918,33
STAT,1832,33,30-34,1865,13.629797636145906
SIM,1840,33,30-34,1873,29
SIM,1791,81,na,1872,171
STAT,1867,17,40-44,1884,0.16586744926278757
SIM,1858,7,na,1865,2350
SIM,1875,29,35-39,1904,9
SIM,1839,17,30-34,1856,1
SIM,1863,19,15-19,1882,5
SIM,1866,31,25-29,1897,18
STAT,1875,51,50-100,1926,0.01473515777235635
SIM,1890,27,35-39,1917,13
STAT,1908,49,15-19,1957,3.128816246021303E-4
STAT,1875,37,45-49,1912,1.9357048408156947
STAT,1848,17,30-34,1865,1.468161694841977
STAT,1948,18,35-39,1966,4.535231119261577
STAT,1865,21,15-19,1886,2.879858438898859
SIM,1870,54,na,1924,1909
STAT,1888,18,50-100,1906,0.0545535897044044
SIM,1866,49,na,1915,1939
STAT,1892,37,45-49,1929,2.358793768808174
STAT,1925,25,na,1950,4208.173162762652
STAT,1881,48,25-29,1929,0.051905638670868025
STAT,1848,21,15-19,1869,3.006375176147748
SIM,1868,44,40-44,1912,3
STAT,1895,35,20-24,1930,0.9583928303481735
STAT,1834,41,40-44,1875,1.7045108854117068
STAT,1810,65,na,1875,813.5667564832318
STAT,1871,26,45-49,1897,1.0451189098660367
STAT,1916,26,50-100,1942,0.9755753829298315
STAT,1922,45,30-34,1967,0.09720296291870707
SIM,1862,26,45-49,1888,3
STAT,1825,46,45-49,1871,0.24409799465126425
STAT,1879,79,na,1958,800.0278885255107
STAT,1899,37,30-34,1936,1.4890064766760247
STAT,1844,37,50-100,1881,0.9010657027389611
STAT,1890,26,30-34,1916,29.184042830006817
SIM,1847,23,15-19,1870,2
SIM,1856,21,15-19,1877,3
STAT,1829,40,45-49,1869,1.3172907115600891
STAT,1810,51,50-100,1861,0.04914880323631817
SIM,1863,30,45-49,1893,1
STAT,1854,26,45-49,1880,0.921778474869576
STAT,1818,51,25-29,1869,0.0073960755984831305
STAT,1886,17,na,1903,2520.3285990234485
SIM,1841,89,na,1930,70
STAT,1877,45,50-100,1922,0.243071345854179
SIM,1898,34,25-29,1932,19
STAT,1845,30,50-100,1875,0.7870821108593067
STAT,1849,46,30-34,1895,0.07279331132845454
STAT,1882,52,25-29,1934,0.0032367784042434864
SIM,1856,17,30-34,1873,3
STAT,1949,22,35-39,1971,10.37990696182843
STAT,1840,35,30-34,1875,4.223585544799203
STAT,1886,29,45-49,1915,1.100064059853145
STAT,1839,39,25-29,1878,2.243713027504402
STAT,1828,44,20-24,1872,0.13024082503403975
STAT,1854,55,na,1909,1479.418088941183
SIM,1876,1,na,1877,3266
STAT,1879,31,45-49,1910,1.7314660899858991
STAT,1938,33,15-19,1971,0.12199193380024906
STAT,1819,38,45-49,1857,5.126087096330529
SIM,1837,40,45-49,1877,1
STAT,1897,24,15-19,1921,4.141836873028693
SIM,1851,34,45-49,1885,2
SIM,1857,88,na,1945,82
SIM,1853,74,na,1927,837
STAT,1830,28,25-29,1858,39.90875342349438
STAT,1888,45,30-34,1933,0.10914962073284346
SIM,1925,24,40-44,1949,3
STAT,1857,37,50-100,1894,0.9147432414515411
STAT,1843,34,45-49,1877,1.3869089025344834
STAT,1844,100,na,1944,0.7373376258825219
STAT,1883,84,na,1967,577.7112861043026
STAT,1844,41,25-29,1885,0.4626611979011177
SIM,1847,39,25-29,1886,2
STAT,1820,54,45-49,1874,0.02247883509073013
SIM,1827,38,45-49,1865,1
STAT,1795,59,na,1854,1021.0
STAT,1834,24,50-100,1858,0.33362069084803714
SIM,1862,37,25-29,1899,2
STAT,1829,29,15-19,1858,0.5082773198384194
STAT,1869,45,20-24,1914,0.011091762370754652
STAT,1819,49,25-29,1868,0.10588806286903656
STAT,1828,36,45-49,1864,1.8617518033356482
STAT,1866,40,na,1906,2034.1527738905693
STAT,1859,18,45-49,1877,0.05667685160022914
STAT,1937,17,20-24,1954,124.5986219728319
STAT,1891,1,na,1892,3181.2664727495912
STAT,1907,12,na,1919,3583.819382054891
STAT,1838,54,30-34,1892,0.0038864475330275955
STAT,1881,36,30-34,1917,4.887217099249338
STAT,1915,31,na,1946,3653.786681372666
SIM,1932,31,na,1963,4708
STAT,1881,40,15-19,1921,0.012730108482336747
STAT,1960,2,na,1962,4840.741000823364
SIM,1888,24,15-19,1912,2
STAT,1838,30,45-49,1868,1.4852980802927565
STAT,1860,25,30-34,1885,19.7921818299742
STAT,1845,36,45-49,1881,1.497626139918482
STAT,1874,91,na,1965,149.51727360338236
SIM,1832,25,20-24,1857,9
SIM,1929,21,20-24,1950,115
STAT,1855,30,45-49,1885,1.2882456350840061
STAT,1899,24,25-29,1923,73.63500163305089
STAT,1819,54,20-24,1873,0.0012895429529217897
STAT,1843,25,30-34,1868,21.23651151514447
STAT,1808,51,40-44,1859,0.038805090521903444
STAT,1865,29,25-29,1894,35.96239580603416
STAT,1927,2,na,1929,4803.901943357936
STAT,1918,40,35-39,1958,0.2028193951334002
STAT,1885,42,25-29,1927,0.6039385781027625
SIM,1851,25,30-34,1876,27
STAT,1815,96,na,1911,3.8327342479543423
STAT,1866,42,15-19,1908,0.012017984599131832
SIM,1861,93,na,1954,32
STAT,1886,45,20-24,1931,0.012094310002857139
STAT,1954,17,20-24,1971,158.3211192726001
STAT,1891,16,20-24,1907,20.771665442107885
STAT,1814,45,30-34,1859,0.306139854415234
STAT,1929,43,15-19,1972,0.0018757370818352466
SIM,1848,18,35-39,1866,1
STAT,1845,19,na,1864,2028.8870463459205
SIM,1906,24,30-34,1930,31
STAT,1807,61,na,1868,1005.3309731103882
STAT,1820,59,na,1879,1094.6302556783955
STAT,1896,31,45-49,1927,2.1846330164439425
SIM,1904,8,na,1912,3586
SIM,1945,17,20-24,1962,128
STAT,1835,51,25-29,1886,0.0023434020435645774
SIM,1853,36,45-49,1889,1
SIM,1883,37,45-49,1920,2
SIM,1886,85,na,1971,509
SIM,1882,71,na,1953,1200
STAT,1823,35,30-34,1858,9.614142207050593
STAT,1790,71,na,1861,554.8818476403798
STAT,1853,39,50-100,1892,0.9197994792516364
STAT,1788,107,na,1895,0.001272282982711142
STAT,1846,52,na,1898,1588.510956309177
SIM,1873,21,15-19,1894,2
SIM,1884,27,35-39,1911,9
STAT,1860,34,45-49,1894,1.3252126625792398
STAT,1808,46,45-49,1854,0.9113617001716043
STAT,1849,33,25-29,1882,8.009831878291068
STAT,1938,21,20-24,1959,103.9991444130463
SIM,1896,47,na,1943,2794
SIM,1892,33,na,1925,3139
SIM,1900,42,40-44,1942,2
STAT,1929,39,na,1968,4553.032528242267
STAT,1939,28,35-39,1967,14.251671744460461
STAT,1866,39,50-100,1905,1.0589918012637394
STAT,1848,29,25-29,1877,36.9874422641149
STAT,1817,106,na,1923,0.005619683273767591
SIM,1856,29,25-29,1885,38
SIM,1883,20,20-24,1903,69
STAT,1899,46,45-49,1945,0.172804851226466
STAT,1881,43,50-100,1924,0.9571602370569249
SIM,1831,35,30-34,1866,3
SIM,1812,76,na,1888,360
SIM,1846,30,45-49,1876,2
SIM,1878,34,na,1912,2386
STAT,1918,25,50-100,1943,1.0074881732578926
STAT,1936,34,50-100,1970,0.7576612638543129
SIM,1799,61,na,1860,906
STAT,1884,48,50-100,1932,0.226343365435985
STAT,1890,22,na,1912,2731.5502951474687
SIM,1881,38,na,1919,1822
SIM,1946,21,20-24,1967,115
STAT,1876,27,35-39,1903,9.417400464321116
SIM,1857,33,25-29,1890,14
STAT,1875,45,45-49,1920,0.2314440842297285
STAT,1943,17,45-49,1960,0.5004285635947223
STAT,1836,43,40-44,1879,1.7107131653610044
STAT,1864,20,45-49,1884,0.6052263950262888
STAT,1885,17,35-39,1902,0.5166884366992177
SIM,1815,41,na,1856,1513
STAT,1871,18,45-49,1889,0.061309729503337226
SIM,1869,9,na,1878,2506
STAT,1902,15,50-100,1917,0.06562098750878927
SIM,1899,12,na,1911,3421
SIM,1843,23,30-34,1866,18
STAT,1876,52,25-29,1928,0.0034386180757023537
SIM,1819,55,na,1874,1196
SIM,1866,42,40-44,1908,2
SIM,1931,34,50-100,1965,1
SIM,1929,37,30-34,1966,2
STAT,1913,21,50-100,1934,0.6041799645799083
STAT,1925,26,40-44,1951,5.218466851895613
STAT,1873,37,35-39,1910,6.776668412025475
STAT,1942,30,25-29,1972,9.311643302708557
SIM,1893,30,30-34,1923,30
SIM,1868,31,35-39,1899,11
STAT,1909,17,45-49,1926,0.09254765478156163
STAT,1899,45,30-34,1944,0.07138324372809789
SIM,1938,22,25-29,1960,77
STAT,1847,42,na,1889,1713.8303343210687
STAT,1857,54,40-44,1911,0.007628043275398029
SIM,1888,28,na,1916,2681
STAT,1894,68,na,1962,2025.761788718139
SIM,1815,50,50-100,1865,1
STAT,1847,44,30-34,1891,0.8363303275262546
STAT,1830,33,20-24,1863,2.2806330750474753
STAT,1890,34,30-34,1924,19.99272886033338
STAT,1898,16,30-34,1914,2.042638413184736
STAT,1828,39,na,1867,1532.0703386901957
STAT,1885,30,30-34,1915,16.572984363149192
STAT,1813,50,35-39,1863,0.023427464347616445
STAT,1888,83,na,1971,847.805924062199
SIM,1875,21,25-29,1896,69
SIM,1874,20,na,1894,2203
STAT,1910,38,15-19,1948,0.017264725491257814
SIM,1851,26,50-100,1877,3
STAT,1835,23,30-34,1858,14.96155862377738
STAT,1843,26,50-100,1869,0.5355948439782711
STAT,1808,54,45-49,1862,0.050360561664943494
STAT,1902,28,15-19,1930,0.6027612743624674
SIM,1821,36,25-29,1857,1
SIM,1942,20,25-29,1962,92
STAT,1823,43,30-34,1866,1.4921808691708514
STAT,1867,29,35-39,1896,8.498177379582485
SIM,1838,69,na,1907,930
SIM,1912,1,na,1913,3899
STAT,1854,34,20-24,1888,1.9398243386132294
SIM,1877,34,40-44,1911,2
STAT,1861,52,40-44,1913,0.00822531142256924
SIM,1881,37,35-39,1918,11
SIM,1866,23,25-29,1889,61
STAT,1869,34,40-44,1903,3.9349369019332894
SIM,1831,43,30-34,1874,2
STAT,1828,32,50-100,1860,0.9506658974356926
SIM,1839,25,30-34,1864,24
STAT,1928,27,20-24,1955,21.244369160776486
SIM,1875,35,45-49,1910,1
SIM,1840,100,na,1940,1
SIM,1903,38,25-29,1941,1
STAT,1923,34,50-100,1957,0.8942518229076144
SIM,1928,17,20-24,1945,147
SIM,1899,26,40-44,1925,10
SIM,1911,53,na,1964,3182
SIM,1936,27,20-24,1963,15
STAT,1868,20,50-100,1888,0.37289420670209444
STAT,1903,48,25-29,1951,0.04312436084327897
STAT,1841,25,20-24,1866,10.191261677607798
SIM,1833,22,na,1855,1721
STAT,1774,81,na,1855,148.9112
STAT,1858,23,25-29,1881,43.95263375829267
STAT,1867,21,25-29,1888,51.3592831325684
SIM,1841,15,20-24,1856,10
STAT,1853,53,45-49,1906,0.010806595901576965
STAT,1866,33,25-29,1899,8.886937703219191
STAT,1834,22,25-29,1856,47.51351228995692
STAT,1829,43,50-100,1872,0.8872188456468632
STAT,1774,97,na,1871,0.7146068685745003
STAT,1877,40,na,1917,2287.717222252369
STAT,1894,43,50-100,1937,0.08842193510610065
SIM,1899,35,30-34,1934,8
STAT,1926,15,na,1941,4282.896190808247
SIM,1849,39,35-39,1888,14
STAT,1930,39,30-34,1969,2.2409968726097524
SIM,1873,27,35-39,1900,10
SIM,1900,3,na,1903,3525
STAT,1820,40,25-29,1860,1.2545933349685998
STAT,1875,20,20-24,1895,67.31429595189532
STAT,1825,90,na,1915,41.90263192166556
STAT,1874,75,na,1949,993.6608878389075
SIM,1876,42,25-29,1918,3
SIM,1898,70,na,1968,2053
STAT,1904,31,na,1935,3246.8005394836537
STAT,1862,25,40-44,1887,2.463744521460905
STAT,1812,52,45-49,1864,0.04642665010864113
STAT,1895,24,40-44,1919,2.5503500422464955
STAT,1871,38,15-19,1909,0.052415760788197
STAT,1870,61,na,1931,1731.7791048182512
STAT,1901,35,45-49,1936,0.5743763430734423
STAT,1892,39,50-100,1931,1.4381059582026765
STAT,1810,44,35-39,1854,6.331211272886171
SIM,1857,44,40-44,1901,5
STAT,1845,28,45-49,1873,0.9494494531265595
SIM,1890,24,30-34,1914,24
SIM,1836,33,40-44,1869,3
STAT,1846,29,15-19,1875,0.40127249036460083
SIM,1893,23,na,1916,2945
SIM,1840,28,35-39,1868,8
SIM,1870,25,40-44,1895,7
STAT,1841,80,na,1921,426.4676588580662
SIM,1906,16,30-34,1922,4
SIM,1862,34,20-24,1896,2
STAT,1828,33,40-44,1861,4.339122411733222
STAT,1917,1,na,1918,4231.524757585493
SIM,1840,36,35-39,1876,16
STAT,1832,28,35-39,1860,7.806760057397678
STAT,1903,46,na,1949,3033.2784669798875
STAT,1871,34,20-24,1905,2.513955184676607
SIM,1858,25,40-44,1883,5
SIM,1803,56,na,1859,1051
SIM,1933,26,40-44,1959,9
STAT,1882,24,30-34,1906,16.261974070212553
STAT,1870,37,50-100,1907,1.1378244618724294
STAT,1834,44,45-49,1878,1.0913958089733649
STAT,1889,27,20-24,1916,13.681862125943693
SIM,1844,43,40-44,1887,6
STAT,1821,35,20-24,1856,1.8082331530984206
SIM,1916,30,25-29,1946,6
STAT,1916,32,na,1948,3688.742967268301
STAT,1845,94,na,1939,14.14272500059251
SIM,1842,22,25-29,1864,55
STAT,1856,28,20-24,1884,8.895929079794985
STAT,1916,40,25-29,1956,0.06932323841706196
STAT,1839,23,15-19,1862,2.801958395555138
STAT,1868,7,na,1875,2495.9659951147114
SIM,1908,24,40-44,1932,2
STAT,1852,26,35-39,1878,8.206685187841098
SIM,1930,23,50-100,1953,1
SIM,1860,26,35-39,1886,8
SIM,1842,44,45-49,1886,1
SIM,1878,41,45-49,1919,3
STAT,1821,104,na,1925,0.03553552108030578
SIM,1897,27,20-24,1924,15
SIM,1939,26,na,1965,3500
STAT,1895,38,25-29,1933,3.5284272611299605
STAT,1824,73,na,1897,654.9112129437594
SIM,1845,87,na,1932,99
STAT,1844,16,35-39,1860,0.4873028607654247
SIM,1853,58,na,1911,1499
SIM,1845,23,na,1868,1851
SIM,1774,85,na,1859,70
STAT,1807,77,na,1884,370.1874871557468
STAT,1897,37,20-24,1934,0.9738769026270455
STAT,1873,46,25-29,1919,0.055344080311736356
SIM,1841,73,na,1914,755
SIM,1864,28,20-24,1892,8
STAT,1890,45,50-100,1935,0.2864875686823011
STAT,1908,30,25-29,1938,8.308263962533326
STAT,1906,26,30-34,1932,34.76677409767031
STAT,1923,30,15-19,1953,0.14028742154382498
SIM,1850,43,40-44,1893,3
STAT,1873,29,35-39,1902,9.178703812024322
STAT,1872,19,15-19,1891,5.593287959790179
STAT,1843,87,na,1930,119.00072877228534
STAT,1900,44,50-100,1944,0.09484374377031161
STAT,1852,18,35-39,1870,0.4782981250610322
STAT,1812,49,15-19,1861,0.0012955350268440895
STAT,1817,43,30-34,1860,2.807182988500368
STAT,1922,48,35-39,1970,0.13953524548561158
SIM,1883,34,40-44,1917,2
STAT,1851,31,15-19,1882,0.10773453324601237
SIM,1898,31,20-24,1929,3
STAT,1832,30,50-100,1862,0.7393129473699573
STAT,1901,21,25-29,1922,75.92680705871109
STAT,1881,45,20-24,1926,0.011060457967464781
SIM,1932,17,35-39,1949,5
STAT,1894,52,na,1946,2600.2074007334754
SIM,1862,23,40-44,1885,2
SIM,1867,66,na,1933,1578
STAT,1767,115,na,1882,1.6272766488987562E-4
STAT,1854,51,35-39,1905,0.006189124512436701
SIM,1829,28,50-100,1857,1
STAT,1836,35,40-44,1871,3.5525115608838878
STAT,1933,28,na,1961,4696.760284149753
STAT,1810,81,na,1891,228.76445630365214
STAT,1924,17,35-39,1941,4.720441333888272
STAT,1859,41,50-100,1900,0.7979303435320311
STAT,1899,24,50-100,1923,0.524540599265325
STAT,1849,49,35-39,1898,0.10278958645477035
STAT,1856,36,20-24,1892,0.57091026120193
SIM,1853,28,45-49,1881,2
STAT,1845,20,35-39,1865,5.2007410533495255
SIM,1869,38,25-29,1907,2
STAT,1875,34,40-44,1909,4.174962318988053
STAT,1884,34,30-34,1918,16.156000243608553
STAT,1870,100,na,1970,7.301192090290803
STAT,1820,51,40-44,1871,0.01731128724346666
SIM,1866,36,30-34,1902,4
STAT,1840,38,35-39,1878,5.433235666028503
STAT,1872,42,15-19,1914,0.013069769592439887
SIM,1919,22,15-19,1941,4
STAT,1826,33,50-100,1859,1.1758498501949284
STAT,1840,52,20-24,1892,4.816872547555709E-4
STAT,1842,43,40-44,1885,1.6638056585408472
SIM,1823,33,30-34,1856,17
SIM,1832,26,35-39,1858,10
SIM,1844,35,40-44,1879,7
SIM,1925,27,45-49,1952,2
STAT,1816,53,40-44,1869,0.023335944171375602
STAT,1913,16,20-24,1929,26.25174654620275
SIM,1892,34,30-34,1926,27
STAT,1863,34,50-100,1897,0.7530801575320188
STAT,1832,36,35-39,1868,5.46455927931007
STAT,1838,48,20-24,1886,0.008182879488535674
STAT,1858,27,40-44,1885,2.2713333032117284
STAT,1938,24,25-29,1962,86.30486705032885
STAT,1877,47,20-24,1924,0.011704394182864328
STAT,1849,41,25-29,1890,0.48371183499368353
STAT,1873,23,15-19,1896,3.151075658172227
SIM,1879,51,na,1930,2180
SIM,1838,40,50-100,1878,3
SIM,1856,26,20-24,1882,13
STAT,1861,35,50-100,1896,0.9735349531428409
STAT,1910,3,na,1913,3784.445841724928
STAT,1857,15,30-34,1872,1.4123454116158818
SIM,1849,31,25-29,1880,15
SIM,1860,18,35-39,1878,1
STAT,1915,47,na,1962,3497.2689979940506
STAT,1897,29,20-24,1926,14.715378197320343
STAT,1903,26,50-100,1929,0.8627947220616725
STAT,1911,33,na,1944,3464.591702906498
STAT,1881,20,45-49,1901,0.640177206827267
SIM,1816,43,40-44,1859,5
SIM,1825,43,30-34,1868,3
SIM,1866,27,40-44,1893,6
STAT,1867,35,45-49,1902,1.785172812714284
SIM,1880,19,15-19,1899,5
SIM,1867,40,30-34,1907,4
SIM,1840,30,50-100,1870,5
SIM,1897,4,na,1901,3414
SIM,1807,49,50-100,1856,1
SIM,1808,55,na,1863,1151
STAT,1891,17,35-39,1908,0.641320950962271
SIM,1911,26,50-100,1937,2
STAT,1869,21,na,1890,2171.002249100562
STAT,1923,49,40-44,1972,0.173214172883413
STAT,1826,28,35-39,1854,30.789746229744342
STAT,1897,25,50-100,1922,0.8136590249686038
SIM,1862,35,na,1897,2048
STAT,1876,24,30-34,1900,17.276041483447013
STAT,1919,36,50-100,1955,0.42649625923367857
STAT,1939,25,30-34,1964,37.24445688241804
SIM,1921,16,20-24,1937,137
STAT,1860,28,35-39,1888,7.421570531064201
SIM,1864,3,na,1867,2675
SIM,1891,7,na,1898,3078
SIM,1791,97,na,1888,1
STAT,1860,31,40-44,1891,3.337719675471662
STAT,1862,33,40-44,1895,3.488064283664173
SIM,1928,10,na,1938,4743
SIM,1857,72,na,1929,914
STAT,1860,24,na,1884,1842.0322443609475
STAT,1883,44,40-44,1927,2.0551885857276186
STAT,1951,16,40-44,1967,1.573929781498841
SIM,1921,31,na,1952,4006
SIM,1933,4,na,1937,5153
STAT,1931,6,na,1937,4955.935319358612
STAT,1855,72,na,1927,897.4468114088073
SIM,1865,15,30-34,1880,2
STAT,1843,33,30-34,1876,14.03112649440696
STAT,1859,86,na,1945,166.82659952690014
SIM,1833,38,na,1871,1601
SIM,1850,93,na,1943,18
SIM,1903,50,na,1953,2929
SIM,1884,24,30-34,1908,17
STAT,1830,37,15-19,1867,0.04563498706917661
SIM,1879,39,20-24,1918,3
SIM,1821,96,na,1917,10
STAT,1880,41,35-39,1921,1.8116127673561204
SIM,1907,64,na,1971,2735
SIM,1798,76,na,1874,351
SIM,1794,62,na,1856,791
STAT,1934,20,25-29,1954,117.65142164044087
SIM,1828,75,na,1903,597
SIM,1869,14,na,1883,2440
STAT,1852,29,15-19,1881,0.34364722341296927
SIM,1946,24,25-29,1970,96
STAT,1816,38,na,1854,1464.6803761110607
STAT,1893,19,35-39,1912,0.6538433949929304
SIM,1842,33,40-44,1875,3
SIM,1851,33,30-34,1884,21
STAT,1861,41,25-29,1902,0.5066884119394385
STAT,1917,27,45-49,1944,1.7115937934501486
SIM,1883,23,25-29,1906,48
STAT,1804,96,na,1900,2.876242742134809
STAT,1869,48,25-29,1917,0.05205254714886695
STAT,1939,0,na,1939,4250.913023333516
STAT,1848,26,20-24,1874,10.48188848599356
SIM,1867,27,35-39,1894,11
SIM,1918,21,45-49,1939,1
STAT,1880,27,25-29,1907,42.129459739299094
STAT,1959,7,na,1966,4856.081633778038
SIM,1888,38,35-39,1926,16
STAT,1857,40,20-24,1897,0.11951934102520263
STAT,1870,18,na,1888,2349.013213753836
STAT,1849,107,na,1956,0.0044975222840975635
STAT,1888,48,35-39,1936,0.08705993695311573
STAT,1921,36,25-29,1957,1.0395340345735142
SIM,1882,19,25-29,1901,10
STAT,1904,49,30-34,1953,0.07244563372959734
SIM,1788,93,na,1881,2
STAT,1938,28,50-100,1966,0.9311292060028681
STAT,1915,20,15-19,1935,5.018054564577018
STAT,1841,39,40-44,1880,3.4826016346708513
STAT,1831,41,15-19,1872,0.010334414476137
SIM,1940,16,30-34,1956,15
STAT,1849,30,20-24,1879,2.3963810917126236
STAT,1899,28,40-44,1927,3.8638172791770105
STAT,1881,39,35-39,1920,6.389829477971334
STAT,1864,44,30-34,1908,0.9549221879942046
SIM,1885,6,na,1891,2505
STAT,1932,16,30-34,1948,15.284475842578235
STAT,1940,30,na,1970,3701.961280428571
STAT,1952,9,na,1961,4448.65771965707
STAT,1868,50,25-29,1918,0.003238443892727961
SIM,1906,27,35-39,1933,17
STAT,1861,41,na,1902,1823.6635943588292
STAT,1836,46,20-24,1882,0.00823724181026865
STAT,1850,41,na,1891,1636.6189109247164
STAT,1865,55,na,1920,1770.5131961285347
SIM,1954,7,na,1961,4487
STAT,1857,20,na,1877,1865.7642018381448
STAT,1877,36,40-44,1913,4.310313088317943
STAT,1786,82,na,1868,149.37671349312535
STAT,1814,48,35-39,1862,0.4211272929065173
STAT,1876,15,40-44,1891,0.17934366594344425
STAT,1814,54,20-24,1868,0.0020711259421791603
SIM,1862,102,na,1964,2
STAT,1841,17,20-24,1858,15.76350686068178
STAT,1854,23,40-44,1877,1.7392171785668262
SIM,1881,29,35-39,1910,9
SIM,1923,20,15-19,1943,9
STAT,1854,18,45-49,1872,0.05557962661665678
STAT,1850,16,35-39,1866,0.4754613417366227
STAT,1851,35,30-34,1886,3.956161883355507
STAT,1897,3,na,1900,3339.9302034390566
SIM,1894,47,50-100,1941,1
SIM,1898,22,50-100,1920,1
STAT,1857,19,25-29,1876,4.9040890746098
STAT,1874,16,20-24,1890,17.154020743475808
SIM,1819,71,na,1890,639
STAT,1948,5,na,1953,4274.539535712468
SIM,1854,27,25-29,1881,39
STAT,1920,48,25-29,1968,0.05523950067258107
STAT,1872,46,30-34,1918,0.09198590423255983
STAT,1894,39,45-49,1933,2.3958333170992967
STAT,1853,31,25-29,1884,8.065824705503326
STAT,1899,48,35-39,1947,0.10093671578107422
STAT,1887,41,45-49,1928,1.588631982603095
SIM,1869,102,na,1971,4
SIM,1801,97,na,1898,2
STAT,1858,21,na,1879,1830.180548565371
STAT,1895,27,20-24,1922,14.448440150440813
SIM,1858,29,35-39,1887,8
STAT,1931,25,50-100,1956,1.2150060741198154
STAT,1806,60,na,1866,1007.3891387086313
STAT,1839,28,20-24,1867,9.769178403819753
STAT,1886,49,15-19,1935,3.90829584095436E-4
SIM,1921,39,30-34,1960,2
STAT,1942,26,40-44,1968,4.623590004593134
STAT,1879,49,20-24,1928,0.011618715767700303
SIM,1849,36,50-100,1885,1
STAT,1884,53,na,1937,1977.3839827277516
STAT,1919,24,15-19,1943,5.472122130796472
SIM,1870,43,45-49,1913,2
SIM,1871,34,50-100,1905,5
SIM,1849,35,40-44,1884,4
SIM,1852,19,15-19,1871,3
SIM,1824,45,na,1869,1438
STAT,1859,27,35-39,1886,7.3801652312701504
STAT,1800,82,na,1882,170.3125464279392
STAT,1888,67,na,1955,1769.8136202580329
STAT,1899,43,40-44,1942,0.20071786740604963
SIM,1947,16,40-44,1963,1
STAT,1812,45,20-24,1857,0.04153353193799297
SIM,1811,47,50-100,1858,1
SIM,1889,34,na,1923,2864
SIM,1885,20,na,1905,2279
STAT,1827,48,45-49,1875,0.21302225774382605
STAT,1842,52,30-34,1894,0.004287782691122971
STAT,1840,31,15-19,1871,0.11501703878496017
SIM,1865,19,25-29,1884,7
STAT,1846,27,25-29,1873,37.956145031712296
STAT,1873,90,na,1963,166.38885530818186
SIM,1960,3,na,1963,4858
SIM,1872,18,na,1890,2402
STAT,1855,49,35-39,1904,0.09741050708806114
STAT,1872,68,na,1940,1448.0852392872134
SIM,1901,33,45-49,1934,4
STAT,1849,42,15-19,1891,0.010342799963441411
SIM,1873,18,20-24,1891,12
SIM,1805,63,na,1868,870
STAT,1814,41,15-19,1855,0.051136823528234295
SIM,1788,77,na,1865,333
STAT,1834,38,35-39,1872,5.403480411185595
STAT,1859,101,na,1960,0.9781879773546186
STAT,1844,45,40-44,1889,0.12077753920075888
STAT,1864,2,na,1866,2866.487251245185
SIM,1809,77,na,1886,342
STAT,1902,16,45-49,1918,0.08730391167469347
STAT,1843,16,40-44,1859,0.15881264530107794
SIM,1855,22,na,1877,2004
STAT,1943,29,15-19,1972,0.7095608940921363
SIM,1882,40,50-100,1922,1
SIM,1892,17,na,1909,3311
STAT,1833,54,30-34,1887,0.0036178123252332754
SIM,1842,38,35-39,1880,3
SIM,1859,36,na,1895,1911
SIM,1882,16,20-24,1898,19
SIM,1891,75,na,1966,1475
STAT,1827,40,35-39,1867,1.7979738051245548
STAT,1886,48,25-29,1934,0.05675740433428545
STAT,1836,46,45-49,1882,0.16199908278737252
STAT,1920,19,50-100,1939,0.39496122764943137
STAT,1910,30,40-44,1940,3.593361667028947
STAT,1899,21,20-24,1920,89.46982137838869
STAT,1900,17,na,1917,3309.818121134323
SIM,1847,37,35-39,1884,16
STAT,1865,18,20-24,1883,15.550927990989843
SIM,1822,53,50-100,1875,1
STAT,1793,95,na,1888,2.3776201964427672
STAT,1894,31,35-39,1925,12.34500322984115
STAT,1847,20,45-49,1867,0.6395218615616904
STAT,1901,32,40-44,1933,5.734621672192541
SIM,1881,54,na,1935,1632
STAT,1939,16,40-44,1955,1.3230265622913875
STAT,1882,19,35-39,1901,0.5014040946543468
STAT,1843,31,40-44,1874,3.558242568386621
STAT,1816,81,na,1897,251.99717205573202
SIM,1803,83,na,1886,115
SIM,1913,17,na,1930,3616
STAT,1898,41,20-24,1939,0.014162592181035048
STAT,1850,29,40-44,1879,2.4494255668265037
SIM,1845,29,25-29,1874,37
STAT,1853,30,35-39,1883,8.058080806707633
SIM,1882,15,30-34,1897,3
SIM,1943,5,na,1948,3876
STAT,1921,5,na,1926,4329.661984010911
SIM,1887,54,na,1941,2167
SIM,1888,36,50-100,1924,4
SIM,1933,32,na,1965,4860
STAT,1917,39,15-19,1956,0.018728515053410246
STAT,1882,17,50-100,1899,0.045009591655592006
SIM,1927,24,15-19,1951,6
STAT,1843,36,35-39,1879,5.635383301977545
SIM,1828,37,25-29,1865,2
STAT,1888,47,20-24,1935,0.013334919829204425
STAT,1823,37,20-24,1860,1.2543618454508765
STAT,1818,88,na,1906,67.41979473017139
SIM,1884,40,30-34,1924,4
STAT,1876,40,30-34,1916,1.1334039220913958
STAT,1940,32,50-100,1972,0.8083704383759016
SIM,1925,20,25-29,1945,116
STAT,1904,7,na,1911,3530.404566582682
SIM,1894,30,25-29,1924,24
STAT,1841,18,35-39,1859,0.4850167291312745
SIM,1844,46,45-49,1890,3
SIM,1883,40,na,1923,2142
STAT,1821,39,15-19,1860,0.10593837796276254
SIM,1847,28,20-24,1875,9
SIM,1861,38,45-49,1899,2
SIM,1921,47,na,1968,3932
STAT,1884,17,40-44,1901,0.17070721336509181
STAT,1916,16,na,1932,3880.6430190651286
STAT,1919,37,20-24,1956,0.2675356770491908
SIM,1880,41,50-100,1921,1
STAT,1837,29,25-29,1866,34.732896396092286
SIM,1903,18,na,1921,3398
SIM,1860,92,na,1952,32
STAT,1890,28,20-24,1918,13.501731248020553
SIM,1790,96,na,1886,2
SIM,1862,26,20-24,1888,12
STAT,1847,46,20-24,1893,0.008874010870754774
STAT,1874,15,30-34,1889,1.551356009673158
SIM,1861,31,25-29,1892,7
SIM,1914,50,na,1964,3426
STAT,1939,17,30-34,1956,11.52600282710312
STAT,1854,26,20-24,1880,9.739501821599818
SIM,1914,26,30-34,1940,37
SIM,1916,34,40-44,1950,3
STAT,1827,100,na,1927,0.6132398533227521
SIM,1851,31,40-44,1882,4
STAT,1853,38,45-49,1891,1.5011800529635648
STAT,1892,36,30-34,1928,6.336576783338279
STAT,1925,44,45-49,1969,0.18971279352582754
STAT,1823,46,35-39,1869,0.1749282194570466
STAT,1906,49,40-44,1955,0.13009820930930138
STAT,1840,36,na,1876,1679.805265506556
SIM,1884,16,30-34,1900,1
STAT,1895,19,45-49,1914,0.0800196692809882
SIM,1858,21,25-29,1879,55
STAT,1862,43,45-49,1905,1.2001314474594427
SIM,1836,28,45-49,1864,1
SIM,1879,35,na,1914,2407
STAT,1896,43,15-19,1939,0.0011878656866458619
SIM,1947,17,30-34,1964,12
SIM,1837,95,na,1932,7
STAT,1884,22,15-19,1906,3.0790474688578793
SIM,1833,81,na,1914,272
SIM,1820,34,40-44,1854,6
STAT,1910,49,30-34,1959,0.07811497247708483
SIM,1859,42,25-29,1901,3
STAT,1814,108,na,1922,8.419078383836848E-4
SIM,1892,22,15-19,1914,3
STAT,1920,21,na,1941,3846.795492629263
SIM,1908,25,50-100,1933,4
STAT,1887,28,25-29,1915,44.54190590525189
STAT,1825,45,30-34,1870,0.1015178976938982
SIM,1895,28,25-29,1923,56
SIM,1862,62,na,1924,1569
STAT,1920,16,15-19,1936,48.21907190474613
SIM,1861,30,35-39,1891,12
STAT,1808,48,35-39,1856,0.5218207846383627
STAT,1845,48,15-19,1893,2.7949474846678527E-4
STAT,1759,104,na,1863,0.013260237530154737
STAT,1890,37,35-39,1927,8.168982521719355
STAT,1828,28,45-49,1856,1.5709164030573204
STAT,1947,23,15-19,1970,5.681758368763515
SIM,1864,36,20-24,1900,3
STAT,1875,39,35-39,1914,6.798788059447908
SIM,1885,32,25-29,1917,12
STAT,1847,39,35-39,1886,5.300218510781216
STAT,1821,42,45-49,1863,2.5755812811927457
STAT,1882,17,30-34,1899,1.4643123462382956
SIM,1891,30,20-24,1921,2
STAT,1908,34,40-44,1942,3.459789627991812
STAT,1887,17,45-49,1904,0.06902526534164201
STAT,1893,15,40-44,1908,0.22014099931553952
STAT,1817,41,40-44,1858,5.948616048612919
STAT,1832,35,20-24,1867,0.6020191130184229
SIM,1885,45,50-100,1930,2
STAT,1882,26,20-24,1908,10.814851331221673
SIM,1924,36,40-44,1960,3
STAT,1866,53,30-34,1919,0.005103307118559513
SIM,1876,41,35-39,1917,4
STAT,1838,19,15-19,1857,5.200949012577496
STAT,1825,74,na,1899,589.8367282411732
SIM,1834,24,40-44,1858,1
SIM,1883,39,35-39,1922,11
STAT,1911,18,15-19,1929,8.557196720157185
STAT,1817,46,35-39,1863,0.32060358898295443
STAT,1824,89,na,1913,57.92513189531472
STAT,1941,17,35-39,1958,4.083058812526166
STAT,1806,52,20-24,1858,0.0025976351888538675
SIM,1836,20,35-39,1856,7
SIM,1875,69,na,1944,1356
STAT,1901,48,15-19,1949,2.9461516176801643E-4
SIM,1928,16,30-34,1944,16
STAT,1868,36,na,1904,2133.7621640384464
STAT,1845,47,25-29,1892,0.040569398327359556
STAT,1868,41,35-39,1909,1.6395478713731813
STAT,1873,30,15-19,1903,0.1375396001610252
SIM,1892,17,40-44,1909,1
SIM,1843,15,30-34,1858,2
STAT,1894,32,25-29,1926,12.435028299344019
STAT,1837,43,na,1880,1589.5622317753548
STAT,1865,27,35-39,1892,8.26205109691141
SIM,1867,45,50-100,1912,1
SIM,1846,19,15-19,1865,4
SIM,1856,87,na,1943,125
SIM,1852,73,na,1925,854
SIM,1938,16,15-19,1954,31
SIM,1829,30,45-49,1859,1
STAT,1877,13,na,1890,2526.7676067077373
SIM,1820,37,45-49,1857,1
SIM,1825,41,40-44,1866,5
STAT,1873,43,20-24,1916,0.1510618864484882
SIM,1880,17,25-29,1897,2
SIM,1835,88,na,1923,61
SIM,1831,74,na,1905,639
SIM,1839,21,15-19,1860,2
SIM,1947,21,15-19,1968,3
STAT,1921,28,25-29,1949,69.05569295382493
SIM,1881,38,25-29,1919,1
STAT,1867,37,35-39,1904,6.274233419817148
STAT,1884,32,40-44,1916,4.047547348874952
SIM,1839,29,25-29,1868,45
SIM,1834,44,na,1878,1501
STAT,1868,20,na,1888,2162.6622511619807
STAT,1880,16,20-24,1896,17.699827048884117
STAT,1757,105,na,1862,0.022173381752575865
STAT,1842,46,45-49,1888,0.1731396454371836
STAT,1868,42,25-29,1910,0.5780905770818012
SIM,1875,37,35-39,1912,13
STAT,1916,36,40-44,1952,1.4551870545945231
SIM,1813,46,50-100,1859,1
SIM,1838,39,35-39,1877,14
STAT,1806,92,na,1898,14.443327729603386
STAT,1872,17,25-29,1889,5.38732583006274
SIM,1851,36,35-39,1887,13
STAT,1864,38,20-24,1902,0.6458138080238591
SIM,1830,30,na,1860,1737
SIM,1898,49,50-100,1947,3
SIM,1828,26,45-49,1854,3
SIM,1892,32,40-44,1924,4
STAT,1909,37,15-19,1946,0.01717204453873995
SIM,1902,33,na,1935,3191
STAT,1868,49,45-49,1917,0.2082753758100566
STAT,1873,38,25-29,1911,2.7449178222316784
SIM,1868,72,na,1940,1092
SIM,1843,37,na,1880,1784
STAT,1856,35,na,1891,1753.0305818148565
STAT,1852,21,na,1873,1854.7793370916338
STAT,1893,20,15-19,1913,3.9759038287593453
SIM,1854,40,45-49,1894,4
SIM,1847,73,na,1920,850
SIM,1923,24,30-34,1947,40
STAT,1875,17,na,1892,2452.400609445365
SIM,1890,16,30-34,1906,2
SIM,1875,27,45-49,1902,1
SIM,1892,37,35-39,1929,11
STAT,1939,21,15-19,1960,5.05202205126594
STAT,1892,43,30-34,1935,1.3505184658245737
STAT,1871,24,na,1895,2204.697847291167
STAT,1887,2,na,1889,2961.092387060145
SIM,1942,24,40-44,1966,4
SIM,1864,29,35-39,1893,7
STAT,1856,29,35-39,1885,7.264223087013572
STAT,1870,45,45-49,1915,0.22089616470618378
SIM,1850,77,na,1927,614
STAT,1827,41,25-29,1868,0.6267054783164271
STAT,1934,24,40-44,1958,4.265793156357588
SIM,1871,76,na,1947,801
STAT,1883,47,45-49,1930,0.21756729395428137
SIM,1835,40,35-39,1875,6
SIM,1875,32,40-44,1907,2
STAT,1846,16,45-49,1862,0.0612235295988261
STAT,1893,27,35-39,1920,11.559683127164607
STAT,1873,15,50-100,1888,0.04749770309750805
STAT,1915,24,30-34,1939,27.89125438467692
SIM,1822,38,na,1860,1526
SIM,1929,0,na,1929,5001
STAT,1773,96,na,1869,1.2620790619049944
SIM,1890,26,20-24,1916,15
STAT,1862,36,45-49,1898,1.6179260260733992
STAT,1910,15,40-44,1925,0.263047276199017
SIM,1899,27,30-34,1926,44
SIM,1820,49,50-100,1869,1
SIM,1877,29,45-49,1906,1
STAT,1826,36,35-39,1862,7.972782270020213
SIM,1868,51,na,1919,1945
STAT,1864,47,35-39,1911,0.11732650552655755
STAT,1877,32,25-29,1909,10.037082892708273
SIM,1918,30,35-39,1948,12
STAT,1884,37,35-39,1921,6.601304130762426
STAT,1883,30,20-24,1913,2.5237335082147325
SIM,1855,39,35-39,1894,15
STAT,1803,54,45-49,1857,0.040619740298741804
SIM,1792,82,na,1874,134
SIM,1853,30,50-100,1883,3
STAT,1935,27,15-19,1962,0.9090805717822329
SIM,1939,18,35-39,1957,2
SIM,1822,59,na,1881,1126
SIM,1926,25,50-100,1951,1
STAT,1900,39,20-24,1939,0.21584848614061394
STAT,1888,21,45-49,1909,0.7808738560319283
STAT,1904,47,na,1951,3035.012309565747
STAT,1858,42,40-44,1900,1.663945828874658
STAT,1867,28,45-49,1895,0.9814585961630121
SIM,1796,96,na,1892,2
SIM,1834,36,35-39,1870,12
STAT,1945,27,20-24,1972,18.91874454050784
SIM,1871,55,na,1926,1980
SIM,1802,98,na,1900,3
STAT,1821,60,na,1881,1093.6233112907832
STAT,1836,74,na,1910,718.6619794613329
SIM,1819,39,25-29,1858,1
STAT,1831,45,30-34,1876,0.0707609107188263
STAT,1847,53,20-24,1900,5.354102336956061E-4
STAT,1846,8,na,1854,2288.0
SIM,1889,50,na,1939,2623
SIM,1924,26,50-100,1950,1
STAT,1900,33,na,1933,3114.074212903166
SIM,1902,65,na,1967,2446
STAT,1876,19,35-39,1895,0.5326707509075168
STAT,1877,54,45-49,1931,0.01383014328277467
STAT,1933,19,50-100,1952,0.47125144896393784
STAT,1846,40,45-49,1886,1.1526622304244634
STAT,1869,54,50-100,1923,0.013441784503860596
SIM,1877,65,na,1942,1595
STAT,1912,28,50-100,1940,0.9233991210440735
STAT,1912,49,40-44,1961,0.14230704309915018
STAT,1834,35,30-34,1869,4.200454969951859
STAT,1906,22,15-19,1928,4.53913972130837
STAT,1830,26,50-100,1856,0.6961829315568625
STAT,1860,16,40-44,1876,0.16265004427292962
SIM,1823,60,na,1883,1023
SIM,1875,21,na,1896,2277
STAT,1857,16,20-24,1873,15.616919866714525
STAT,1828,39,25-29,1867,2.5142450321350283
STAT,1860,40,na,1900,1789.4635979419302
SIM,1830,89,na,1919,51
STAT,1852,51,25-29,1903,0.0025801971481711023
SIM,1864,27,30-34,1891,26
SIM,1837,27,25-29,1864,41
STAT,1819,46,45-49,1865,0.4540428052760361
STAT,1930,18,25-29,1948,52.78734869283716
STAT,1894,36,40-44,1930,5.340083947219863
SIM,1886,27,20-24,1913,15
SIM,1860,55,na,1915,1711
STAT,1841,32,50-100,1873,0.7664049980725213
SIM,1829,92,na,1921,24
STAT,1838,22,na,1860,1862.3229820092013
STAT,1814,74,na,1888,526.3412554080303
STAT,1878,27,20-24,1905,11.54985546518637
STAT,1864,53,20-24,1917,6.113315456912521E-4
STAT,1922,41,15-19,1963,0.0016675720541510753
SIM,1833,59,na,1892,1157
STAT,1862,10,na,1872,2236.056490775158
STAT,1893,17,45-49,1910,0.07825816749163272
STAT,1844,40,35-39,1884,1.3214772306916243
STAT,1935,31,45-49,1966,2.0578092839595605
STAT,1874,19,25-29,1893,5.440326249720754
SIM,1836,39,25-29,1875,1
SIM,1905,36,30-34,1941,3
STAT,1910,33,45-49,1943,1.427343601931867
STAT,1942,29,45-49,1971,1.7112629763909992
STAT,1930,28,50-100,1958,1.1950365615836351
STAT,1775,82,na,1857,142.3813510039227
SIM,1842,35,30-34,1877,7
STAT,1848,108,na,1956,0.0016423612457871612
SIM,1879,37,30-34,1916,8
STAT,1875,32,15-19,1907,0.13827994080264022
STAT,1851,33,40-44,1884,3.2133896122063845
STAT,1829,27,25-29,1856,60.79174363006783
SIM,1872,40,na,1912,2207
SIM,1923,27,35-39,1950,15
STAT,1872,49,35-39,1921,0.129890959528818
SIM,1912,54,na,1966,3220
STAT,1856,27,30-34,1883,19.233465525457277
SIM,1893,45,50-100,1938,2
STAT,1862,40,40-44,1902,1.8351137691109538
STAT,1868,46,40-44,1914,0.15474788397093767
SIM,1834,26,45-49,1860,4
SIM,1870,40,40-44,1910,4
STAT,1866,47,45-49,1913,0.2046731651331846
STAT,1810,60,na,1870,980.3022162473583
STAT,1920,45,20-24,1965,0.011594627164294453
STAT,1880,17,na,1897,2515.3391919481
STAT,1847,49,25-29,1896,0.04158781832427179
SIM,1920,28,50-100,1948,1
SIM,1838,37,30-34,1875,5
STAT,1896,18,25-29,1914,7.051770406788119
STAT,1900,21,50-100,1921,0.5360245874207179
STAT,1905,32,na,1937,3286.211963890338
STAT,1921,33,20-24,1954,2.5534594750148503
SIM,1884,38,50-100,1922,1
STAT,1850,25,na,1875,1820.5994599513535
SIM,1884,20,15-19,1904,3
SIM,1876,17,35-39,1893,1
STAT,1912,46,25-29,1958,0.04828103485196004
SIM,1898,38,40-44,1936,3
STAT,1835,29,15-19,1864,0.37096169888343256
STAT,1888,41,15-19,1929,0.01548772223651472
STAT,1855,42,15-19,1897,0.009801551148301672
STAT,1841,15,30-34,1856,1.4340488286955901
SIM,1894,37,45-49,1931,3
STAT,1886,19,50-100,1905,0.04862732040510384
STAT,1834,26,40-44,1860,2.45534827040539
STAT,1908,13,na,1921,3613.4986504210956
SIM,1900,69,na,1969,2250
SIM,1827,30,50-100,1857,4
SIM,1852,40,35-39,1892,3
SIM,1878,28,25-29,1906,44
SIM,1911,16,15-19,1927,7
STAT,1868,17,35-39,1885,0.503529348297312
SIM,1858,73,na,1931,924
STAT,1828,48,15-19,1876,3.196362344991168E-4
STAT,1925,41,40-44,1966,0.28648057614508604
STAT,1942,21,35-39,1963,9.329671742697508
SIM,1839,26,20-24,1865,12
STAT,1812,48,25-29,1860,0.1896763850845356
SIM,1798,92,na,1890,8
STAT,1763,97,na,1860,0.4737152126401184
SIM,1861,77,na,1938,710
STAT,1858,48,50-100,1906,0.17962564697502295
STAT,1895,39,15-19,1934,0.06846382174178914
SIM,1832,37,na,1869,1572
STAT,1897,28,30-34,1925,31.70238187500049
STAT,1903,16,15-19,1919,7.996531284228786
STAT,1825,48,35-39,1873,0.14084870970854593
STAT,1852,17,45-49,1869,0.05727760754220648
STAT,1930,16,20-24,1946,165.98730774860763
STAT,1805,97,na,1902,1.8753234953154017
SIM,1858,26,30-34,1884,19
STAT,1860,106,na,1966,0.06840240725191628
STAT,1904,28,25-29,1932,57.11904179655185
STAT,1886,37,45-49,1923,1.989321096555785
SIM,1866,48,50-100,1914,1
STAT,1954,6,na,1960,4590.7114458409615
SIM,1914,22,15-19,1936,3
STAT,1832,37,25-29,1869,2.2005478904438163
STAT,1844,48,45-49,1892,0.1618480853952653
STAT,1869,29,45-49,1898,1.0088751769729905
SIM,1896,20,na,1916,2946
SIM,1861,35,40-44,1896,1
SIM,1944,20,35-39,1964,13
STAT,1864,54,na,1918,1763.052708295273
STAT,1911,17,na,1928,3651.3093888608787
SIM,1863,36,na,1899,1959
SIM,1901,30,40-44,1931,6
STAT,1826,37,na,1863,1549.3892715133502
SIM,1862,29,25-29,1891,44
STAT,1854,29,25-29,1883,31.27468160065582
STAT,1823,52,20-24,1875,8.746177877192992E-4
STAT,1879,20,na,1899,2352.6873857438577
SIM,1811,75,na,1886,377
STAT,1785,81,na,1866,203.67482713061978
STAT,1836,58,na,1894,1280.626016582433
STAT,1832,44,na,1876,1501.1798829436077
SIM,1865,100,na,1965,3
SIM,1842,26,40-44,1868,4
STAT,1855,46,30-34,1901,0.06898396631106188
SIM,1912,46,50-100,1958,1
STAT,1890,43,20-24,1933,0.18209861174641978
STAT,1936,20,35-39,1956,8.50983852842794
SIM,1882,39,na,1921,2196
SIM,1840,37,25-29,1877,5
STAT,1853,35,40-44,1888,3.3823965627801598
STAT,1861,25,na,1886,1915.6120052962613
SIM,1797,81,na,1878,157
STAT,1834,31,15-19,1865,0.11438714501434358
STAT,1876,16,30-34,1892,1.5594448666692482
STAT,1897,27,30-34,1924,31.814368451951353
SIM,1812,60,na,1872,1005
SIM,1912,28,25-29,1940,52
STAT,1871,51,35-39,1922,0.008114560159342595
STAT,1852,16,45-49,1868,0.057616971504367204
SIM,1888,29,20-24,1917,13
SIM,1944,6,na,1950,3940
SIM,1889,13,na,1902,3125
STAT,1880,39,na,1919,2322.784325563072
SIM,1833,43,40-44,1876,5
STAT,1931,20,20-24,1951,137.05155839467716
STAT,1867,25,40-44,1892,2.675326987386003
STAT,1940,30,15-19,1970,0.12578325454512138
SIM,1883,36,30-34,1919,5
STAT,1855,19,15-19,1874,4.957083891569547
SIM,1856,27,35-39,1883,9
STAT,1914,32,50-100,1946,0.7862428112788542
SIM,1924,39,45-49,1963,1
STAT,1923,26,30-34,1949,42.6432756864882
SIM,1826,41,na,1867,1459
SIM,1899,22,25-29,1921,75
STAT,1908,37,45-49,1945,0.6029862805995779
STAT,1825,40,25-29,1865,0.7320122106287739
STAT,1869,21,35-39,1890,5.356693440170523
STAT,1916,31,35-39,1947,8.949335376634602
STAT,1832,38,25-29,1870,2.176849644917676
STAT,1816,52,50-100,1868,0.03415358382837524
STAT,1855,43,50-100,1898,0.7453196964048664
STAT,1831,54,20-24,1885,4.444735100828465E-4
SIM,1864,23,15-19,1887,3
STAT,1892,39,35-39,1931,8.284805912514669
STAT,1867,34,30-34,1901,15.355528945659305
STAT,1871,23,40-44,1894,1.9487231301532488
STAT,1824,39,40-44,1863,6.2032778139055
SIM,1838,36,30-34,1874,11
STAT,1811,82,na,1893,202.35338950073637
STAT,1899,67,na,1966,2304.1941310008747
STAT,1925,22,25-29,1947,104.44773919434566
SIM,1914,45,50-100,1959,2
STAT,1916,39,45-49,1955,0.6528709403199966
STAT,1841,16,30-34,1857,1.4256022810945732
SIM,1897,26,30-34,1923,40
SIM,1909,50,na,1959,3219
STAT,1849,37,40-44,1886,3.358916019473305
SIM,1898,27,na,1925,2993
SIM,1869,39,50-100,1908,4
SIM,1875,34,30-34,1909,20
SIM,1877,21,35-39,1898,5
SIM,1933,22,25-29,1955,112
STAT,1880,28,15-19,1908,0.45026763546394494
STAT,1914,46,na,1960,3450.651379572245
SIM,1869,27,45-49,1896,1
STAT,1830,25,45-49,1855,1.357545512040997
STAT,1910,32,na,1942,3445.1280620412545
SIM,1840,38,25-29,1878,1
STAT,1914,43,30-34,1957,0.11948812678294768
STAT,1895,53,na,1948,2609.331924749761
STAT,1875,36,30-34,1911,5.200006255699819
SIM,1814,56,na,1870,1070
STAT,1834,106,na,1940,0.007527482464700731
SIM,1832,39,40-44,1871,5
STAT,1889,26,30-34,1915,29.469298044215193
SIM,1877,30,25-29,1907,8
STAT,1888,49,25-29,1937,0.035517349609855434
STAT,1900,16,35-39,1916,0.7208518714864356
STAT,1894,47,20-24,1941,0.008179588075118645
STAT,1813,109,na,1922,2.9279889035584004E-4
SIM,1878,50,na,1928,2236
STAT,1831,59,na,1890,1134.7607375775315
SIM,1781,82,na,1863,121
SIM,1809,56,na,1865,1095
STAT,1944,20,30-34,1964,29.336067961073212
SIM,1839,37,50-100,1876,1
STAT,1917,20,25-29,1937,93.29647306736413
SIM,1924,31,35-39,1955,13
STAT,1848,50,20-24,1898,5.561964662736455E-4
SIM,1880,91,na,1971,205
STAT,1871,37,25-29,1908,2.700895117545812
STAT,1909,41,45-49,1950,0.1479119209872761
SIM,1825,30,na,1855,1694
SIM,1904,26,25-29,1930,57
STAT,1837,26,20-24,1863,9.842971682651955
SIM,1931,26,30-34,1957,53
STAT,1811,50,25-29,1861,0.011737557938597305
STAT,1840,37,20-24,1877,0.5983269309069426
STAT,1898,17,20-24,1915,22.66450215309192
SIM,1857,37,40-44,1894,5
SIM,1909,28,na,1937,3406
STAT,1915,27,35-39,1942,14.466867744099966
SIM,1929,24,25-29,1953,110
STAT,1867,30,15-19,1897,0.1273421544939757
SIM,1905,14,na,1919,3481
STAT,1881,32,15-19,1913,0.12996216887875642
STAT,1893,24,30-34,1917,21.206018157240436
STAT,1858,20,20-24,1878,59.4138546158843
SIM,1906,20,15-19,1926,3
SIM,1864,26,30-34,1890,29
STAT,1860,21,15-19,1881,2.62561523888253
SIM,1834,33,30-34,1867,16
SIM,1929,27,na,1956,4372
STAT,1851,30,25-29,1881,7.829635283917967
STAT,1840,63,na,1903,1170.963324589299
STAT,1810,97,na,1907,2.272667812526359
STAT,1831,48,35-39,1879,0.09846244547087557
STAT,1889,28,35-39,1917,11.213498777192745
STAT,1824,102,na,1926,0.16165283771167382
SIM,1845,26,20-24,1871,11
STAT,1922,16,25-29,1938,47.495032675068906
STAT,1914,40,15-19,1954,0.001447613696730675
STAT,1829,88,na,1917,82.9516266443828
STAT,1845,33,40-44,1878,3.6111074486938515
STAT,1853,46,20-24,1899,0.009107338107278045
STAT,1905,30,20-24,1935,3.7206804379377223
STAT,1846,36,na,1882,1843.8624385434305
STAT,1885,50,25-29,1935,0.0033832435216513594
SIM,1813,82,na,1895,196
SIM,1902,0,na,1902,3566
STAT,1806,48,25-29,1854,0.20955287657285354
STAT,1877,51,40-44,1928,0.010365768626029268
STAT,1913,39,30-34,1952,1.6821091388009315
STAT,1926,31,na,1957,4322.626284087248
SIM,1930,16,25-29,1946,66
STAT,1827,45,40-44,1872,0.16080302618396064
SIM,1897,28,35-39,1925,14
SIM,1910,47,na,1957,3239
SIM,1849,37,45-49,1886,5
STAT,1847,48,25-29,1895,0.04194096121772504
STAT,1830,50,35-39,1880,0.00648670809015259
SIM,1866,20,20-24,1886,67
SIM,1942,27,45-49,1969,2
STAT,1880,19,25-29,1899,5.613426446752126
STAT,1856,26,30-34,1882,19.372560509918483
SIM,1867,87,na,1954,150
STAT,1861,19,15-19,1880,5.2949406503312195
STAT,1825,43,40-44,1868,2.393966308721038
STAT,1872,30,45-49,1902,1.6656885258734955
SIM,1863,73,na,1936,945
STAT,1852,42,35-39,1894,1.3111988172274667
STAT,1879,9,na,1888,2598.3214991961954
STAT,1932,39,40-44,1971,1.8960530482060438
SIM,1834,27,45-49,1861,4
STAT,1888,30,35-39,1918,11.397226784868739
STAT,1847,40,15-19,1887,0.010506045187210858
SIM,1846,88,na,1934,78
SIM,1856,25,30-34,1881,26
STAT,1883,68,na,1951,1415.436996052717
SIM,1879,38,30-34,1917,11
SIM,1912,26,20-24,1938,15
STAT,1864,17,na,1881,2199.805810046779
STAT,1892,34,40-44,1926,5.087487976156583
STAT,1851,38,35-39,1889,5.089220904190669
SIM,1865,16,20-24,1881,18
STAT,1869,49,15-19,1918,3.584320951938025E-4
SIM,1928,42,na,1970,4472
SIM,1899,71,na,1970,2102
SIM,1842,74,na,1916,686
STAT,1803,51,40-44,1854,0.03129932496003423
STAT,1863,91,na,1954,48.03974215908377
STAT,1830,36,25-29,1866,2.3722832045718483
STAT,1853,49,25-29,1902,0.04268130027555192
STAT,1934,27,45-49,1961,2.1955213649834002
SIM,1844,22,na,1866,1800
SIM,1848,36,na,1884,1775
SIM,1907,32,25-29,1939,11
STAT,1870,42,40-44,1912,2.081975356752675
SIM,1880,30,45-49,1910,1
STAT,1826,33,30-34,1859,22.406663824967396
STAT,1893,18,45-49,1911,0.07805313109280464
STAT,1848,25,30-34,1873,22.662392992198953
STAT,1856,17,50-100,1873,0.04269869397023114
STAT,1904,26,20-24,1930,15.951331703845879
SIM,1913,30,20-24,1943,2
SIM,1868,8,na,1876,2448
STAT,1896,49,20-24,1945,0.008269244942322052
SIM,1896,30,35-39,1926,11
STAT,1841,32,20-24,1873,2.2610071335103124
STAT,1866,45,30-34,1911,0.08518477629203998
STAT,1868,53,40-44,1921,0.009336657564149814
SIM,1941,29,na,1970,3559
STAT,1923,34,30-34,1957,17.040611067334414
SIM,1944,21,35-39,1965,13
STAT,1880,46,50-100,1926,0.24529607100736728
STAT,1883,89,na,1972,305.04479147998507
STAT,1921,26,20-24,1947,19.28481693143338
SIM,1893,18,na,1911,3147
STAT,1906,37,35-39,1943,2.100493223888847
STAT,1884,36,35-39,1920,6.633076567520849
STAT,1886,44,45-49,1930,1.4733531656862526
STAT,1860,19,45-49,1879,0.05706888354016214
SIM,1871,40,45-49,1911,1
STAT,1864,32,15-19,1896,0.11990324301664797
SIM,1923,15,40-44,1938,1
STAT,1869,17,50-100,1886,0.04545772967995609
SIM,1881,22,15-19,1903,2
SIM,1894,44,45-49,1938,1
STAT,1901,28,45-49,1929,1.4630322077621474
SIM,1793,83,na,1876,111
SIM,1802,61,na,1863,897
STAT,1913,18,25-29,1931,8.348590729775319
STAT,1835,21,40-44,1856,1.7757183800047551
SIM,1876,48,na,1924,2158
STAT,1886,22,25-29,1908,57.12599063819925
STAT,1885,15,45-49,1900,0.06179630361371565
SIM,1840,34,20-24,1874,2
STAT,1908,50,na,1958,3110.503609110738
STAT,1936,21,35-39,1957,8.506774986557708
STAT,1856,51,na,1907,1594.6455438884375
STAT,1891,26,25-29,1917,49.610775850929976
STAT,1941,29,40-44,1970,4.550522107734451
STAT,1824,35,25-29,1859,4.9616643530691595
SIM,1843,21,40-44,1864,1
STAT,1812,45,na,1857,1363.7445013876418
STAT,1863,40,45-49,1903,1.2532601084961283
STAT,1855,104,na,1959,0.10136536690368964
SIM,1861,72,na,1933,1046
STAT,1819,53,45-49,1872,0.025872157952346535
STAT,1796,81,na,1877,205.78259412922353
STAT,1817,45,35-39,1862,0.32567804563072583
STAT,1882,20,15-19,1902,3.0489479207989634
STAT,1869,40,50-100,1909,0.9766095235670057
SIM,1919,26,30-34,1945,46
SIM,1809,93,na,1902,10
SIM,1876,40,35-39,1916,3
SIM,1952,17,15-19,1969,44
SIM,1834,23,40-44,1857,2
SIM,1921,18,25-29,1939,55
STAT,1814,53,50-100,1867,0.04324765686117485
STAT,1854,1,na,1855,2717.0345614623748
STAT,1935,37,50-100,1972,0.5546180702277725
STAT,1801,83,na,1884,132.1746441743838
STAT,1826,53,na,1879,1265.7896568531178
STAT,1889,68,na,1957,1835.5814645546757
SIM,1832,35,25-29,1867,1
SIM,1931,21,25-29,1952,121
SIM,1768,94,na,1862,6
STAT,1826,52,35-39,1878,0.007667090160798181
STAT,1836,50,40-44,1886,0.007176669617429673
STAT,1864,70,na,1934,1181.3488894675866
STAT,1851,20,na,1871,1863.3905278249135
STAT,1910,26,45-49,1936,1.5814599077722873
SIM,1888,33,na,1921,2663
STAT,1944,17,15-19,1961,46.138131984197244
STAT,1818,105,na,1923,0.014399343850643596
STAT,1850,62,na,1912,1288.4104203419204
STAT,1875,30,25-29,1905,10.025664190431257
SIM,1883,30,25-29,1913,12
SIM,1892,36,35-39,1928,16
STAT,1912,24,50-100,1936,0.6169354491964594
SIM,1842,42,30-34,1884,3
SIM,1909,33,35-39,1942,8
STAT,1877,46,45-49,1923,0.2319211806251016
STAT,1866,41,25-29,1907,0.5620568321846978
STAT,1938,28,40-44,1966,4.360309870666456
SIM,1886,28,20-24,1914,12
STAT,1927,23,35-39,1950,10.92524892013957
STAT,1859,51,35-39,1910,0.006504041182813741
STAT,1839,37,50-100,1876,0.9768378373152047
SIM,1918,27,na,1945,3745
STAT,1815,42,20-24,1857,0.4019852246184401
SIM,1890,20,15-19,1910,4
SIM,1922,32,na,1954,4014
SIM,1851,78,na,1929,540
SIM,1853,29,20-24,1882,11
STAT,1924,41,50-100,1965,0.13219725376218616
STAT,1845,21,25-29,1866,50.65255510707974
STAT,1827,30,50-100,1857,1.198840176503731
STAT,1932,27,35-39,1959,18.57689861778006
STAT,1869,26,40-44,1895,2.7509166124576683
SIM,1793,61,na,1854,898
SIM,1953,14,na,1967,4439
STAT,1838,42,15-19,1880,0.010842746845206428
STAT,1929,12,na,1941,4776.8445566123255
STAT,1834,42,30-34,1876,0.8601328458543477
STAT,1867,32,40-44,1899,3.847006037225326
STAT,1901,18,50-100,1919,0.06461427688754193
SIM,1922,23,25-29,1945,117
STAT,1832,34,20-24,1866,2.086912045648465
SIM,1851,35,35-39,1886,7
STAT,1914,36,30-34,1950,1.7274044902756491
STAT,1895,20,25-29,1915,70.92428555987642
SIM,1834,21,15-19,1855,2
SIM,1935,23,35-39,1958,13
STAT,1770,108,na,1878,0.003655876946635624
SIM,1940,27,35-39,1967,21
STAT,1934,29,na,1963,4756.053114913783
STAT,1851,41,50-100,1892,0.7633898266457034
STAT,1922,42,15-19,1964,0.001665170750393097
STAT,1878,28,20-24,1906,11.509199973948915
STAT,1909,29,15-19,1938,0.6328309946746496
SIM,1900,35,40-44,1935,2
SIM,1837,24,20-24,1861,49
STAT,1845,29,20-24,1874,9.959844242568467
SIM,1848,90,na,1938,50
STAT,1860,112,na,1972,4.293472441322102E-4
SIM,1901,64,na,1965,2514
SIM,1905,31,25-29,1936,8
STAT,1892,31,25-29,1923,12.16909298614021
SIM,1826,89,na,1915,44
SIM,1866,104,na,1970,1
STAT,1826,43,na,1869,1461.1548102398813
SIM,1853,21,25-29,1874,52
SIM,1901,54,na,1955,2788
SIM,1922,36,30-34,1958,1
SIM,1869,24,40-44,1893,2
STAT,1882,33,20-24,1915,2.4728618950749217
STAT,1896,15,20-24,1911,22.22240154410479
STAT,1891,6,na,1897,3053.2741948548814
STAT,1870,30,35-39,1900,9.460813673960656
STAT,1851,42,na,1893,1660.5271490656974
SIM,1903,23,15-19,1926,4
STAT,1845,43,45-49,1888,1.0647374064735455
STAT,1855,20,40-44,1875,1.755065973629944
STAT,1880,29,15-19,1909,0.4486286612708561
SIM,1853,43,45-49,1896,4
STAT,1801,53,50-100,1854,0.041351766075152355
STAT,1865,24,30-34,1889,15.216571223352425
SIM,1873,24,30-34,1897,20
STAT,1933,39,45-49,1972,0.8753253930261645
STAT,1864,92,na,1956,39.86324223469636
SIM,1890,33,20-24,1923,2
SIM,1924,44,40-44,1968,1
STAT,1902,39,30-34,1941,1.5182371050297288
STAT,1871,30,40-44,1901,4.100854016705889
STAT,1821,34,45-49,1855,4.674850191604835
STAT,1916,44,40-44,1960,0.24133987148393915
SIM,1910,39,30-34,1949,4
STAT,1831,33,50-100,1864,0.7218895614623587
STAT,1865,36,25-29,1901,2.477225076154107
SIM,1868,32,25-29,1900,12
SIM,1858,35,45-49,1893,3
STAT,1841,19,35-39,1860,0.4821599805966913
STAT,1937,16,30-34,1953,11.229451666418784
STAT,1899,35,40-44,1934,5.72006447488302
STAT,1901,12,na,1913,3414.9598656701987
SIM,1897,29,35-39,1926,16
STAT,1855,40,na,1895,1659.0013319028913
STAT,1946,24,na,1970,3836.433543808339
SIM,1884,35,na,1919,2352
STAT,1918,49,20-24,1967,0.011044714834710381
STAT,1894,30,35-39,1924,12.393586087303383
STAT,1867,35,na,1902,2109.7840166408605
SIM,1905,20,na,1925,3202
STAT,1826,59,na,1885,1124.0159017925128
STAT,1909,15,40-44,1924,0.2603374684195215
SIM,1851,56,na,1907,1521
SIM,1873,33,20-24,1906,3
STAT,1912,0,na,1912,4289.69522308036
STAT,1871,33,45-49,1904,1.628928086173241
STAT,1801,61,na,1862,899.9087477135685
STAT,1889,46,na,1935,2631.3374499133565
STAT,1871,40,na,1911,2189.9870104344204
STAT,1888,46,20-24,1934,0.013435416746468004
STAT,1867,53,35-39,1920,0.007514288739261004
STAT,1914,23,25-29,1937,88.87695271509953
STAT,1843,35,35-39,1878,5.694204433778477
SIM,1955,16,15-19,1971,48
SIM,1813,45,na,1858,1362
STAT,1849,53,30-34,1902,0.004391958089468727
SIM,1950,21,35-39,1971,9
STAT,1839,34,30-34,1873,14.011447557548546
SIM,1804,78,na,1882,307
SIM,1863,20,40-44,1883,1
SIM,1842,29,45-49,1871,4
STAT,1940,29,35-39,1969,14.44866689852637
SIM,1898,33,na,1931,2977
STAT,1819,39,20-24,1858,1.8356870312149394
STAT,1874,70,na,1944,1354.2800572044764
SIM,1890,40,50-100,1930,1
STAT,1937,27,25-29,1964,60.612799749533856
SIM,1783,83,na,1866,97
STAT,1851,37,35-39,1888,5.1423412897134115
SIM,1845,27,20-24,1872,10
STAT,1843,55,na,1898,1396.6303023406283
STAT,1835,50,35-39,1885,0.005809697072963115
SIM,1821,74,na,1895,632
STAT,1835,95,na,1930,8.462290810508666
SIM,1818,76,na,1894,426
SIM,1884,22,40-44,1906,1
STAT,1889,29,35-39,1918,11.172681641643766
STAT,1834,29,45-49,1863,0.8906101215319808
SIM,1902,18,15-19,1920,7
STAT,1924,46,40-44,1970,0.17775567462883887
STAT,1860,35,35-39,1895,5.472951028278587
SIM,1856,24,30-34,1880,15
SIM,1905,20,45-49,1925,3
STAT,1894,43,40-44,1937,0.188257813470343
STAT,1928,29,25-29,1957,76.52740638483695
STAT,1938,26,15-19,1964,0.6610190324165961
STAT,1874,40,20-24,1914,0.15483680685968723
STAT,1782,79,na,1861,230.22920686290595
SIM,1813,55,na,1868,1151
STAT,1866,18,na,1884,2245.4479611928136
SIM,1936,29,25-29,1965,43
STAT,1819,105,na,1924,0.015478233580737081
STAT,1954,16,30-34,1970,14.237720234963634
STAT,1827,52,40-44,1879,0.009297098180031434
STAT,1923,21,25-29,1944,101.83708708129328
SIM,1878,25,20-24,1903,13
STAT,1850,25,25-29,1875,35.600700576241884
SIM,1862,36,50-100,1898,1
STAT,1794,96,na,1890,1.6173398783715747
STAT,1880,23,45-49,1903,0.6923408996488627
STAT,1946,14,na,1960,4114.4395559135655
STAT,1876,51,35-39,1927,0.008442685770521905
STAT,1944,23,35-39,1967,9.600986246545327
SIM,1901,26,45-49,1927,1
STAT,1919,39,25-29,1958,0.9971450135290509
STAT,1928,26,30-34,1954,45.7581461351756
SIM,1838,74,na,1912,690
SIM,1897,25,30-34,1922,32
STAT,1830,32,45-49,1862,1.4957716404292491
SIM,1934,25,50-100,1959,1
STAT,1887,31,50-100,1918,0.9721388952056671
SIM,1847,34,30-34,1881,24
STAT,1904,21,15-19,1925,4.483860040507343
SIM,1933,16,na,1949,4713
STAT,1901,18,na,1919,3330.964603162558
STAT,1843,50,50-100,1893,0.010347696423835175
STAT,1900,54,na,1954,2744.2152123593196
STAT,1891,40,20-24,1931,0.18749064130850626
STAT,1899,47,35-39,1946,0.10174456764820097
STAT,1829,30,40-44,1859,4.57537017285717
SIM,1916,23,25-29,1939,95
STAT,1931,39,50-100,1970,0.5241633546123928
STAT,1947,16,15-19,1963,48.31029067741664
SIM,1894,22,25-29,1916,67
STAT,1841,26,na,1867,1865.7676072793413
STAT,1794,64,na,1858,822.678105909329
STAT,1853,42,40-44,1895,1.7001475078725625
STAT,1837,27,20-24,1864,9.772299145970514
STAT,1908,23,25-29,1931,79.97566559341396
STAT,1838,26,50-100,1864,0.5502546153087124
STAT,1923,30,50-100,1953,0.9026039302722052
STAT,1896,21,40-44,1917,2.6077873879724804
SIM,1812,49,50-100,1861,2
STAT,1844,72,na,1916,877.110424788715
STAT,1819,89,na,1908,55.45722155052093
SIM,1882,39,50-100,1921,1
STAT,1828,49,15-19,1877,3.1544257002150616E-4
STAT,1808,52,30-34,1860,0.021504274782988733
STAT,1917,27,na,1944,3711.4173148410605
SIM,1900,29,20-24,1929,12
STAT,1840,35,50-100,1875,0.9729619868408865
SIM,1931,34,30-34,1965,24
STAT,1907,46,40-44,1953,0.13439482037254738
STAT,1828,60,na,1888,1109.0380210880169
STAT,1844,52,40-44,1896,0.007272777993733757
SIM,1856,28,35-39,1884,11
SIM,1861,40,na,1901,2027
STAT,1858,34,40-44,1892,3.1846246309027784
SIM,1827,31,25-29,1858,7
STAT,1814,58,na,1872,1161.6057032162262
SIM,1945,16,30-34,1961,17
STAT,1918,27,15-19,1945,0.7097469537751809
STAT,1921,32,na,1953,3976.056283047198
STAT,1850,94,na,1944,14.088653549821693
SIM,1893,41,35-39,1934,1
STAT,1885,41,35-39,1926,1.7128565131903484
STAT,1859,24,30-34,1883,13.69675005057075
SIM,1912,21,15-19,1933,4
STAT,1825,47,35-39,1872,0.14281245589586145
STAT,1894,15,na,1909,3080.4568323947246
SIM,1837,30,40-44,1867,4
STAT,1847,45,20-24,1892,0.008937106845081045
STAT,1875,43,30-34,1918,1.1082804976326912
SIM,1927,39,25-29,1966,1
STAT,1892,38,35-39,1930,8.327526121518053
SIM,1896,68,na,1964,2150
STAT,1889,25,30-34,1914,29.567758680621665
STAT,1818,50,35-39,1868,0.018338801626686052
SIM,1877,44,45-49,1921,4
STAT,1777,84,na,1861,90.06389978742827
SIM,1927,21,35-39,1948,15
STAT,1863,17,20-24,1880,16.770955064864644
SIM,1922,39,35-39,1961,7
STAT,1875,86,na,1961,346.03049128413716
SIM,1813,77,na,1890,338
STAT,1899,46,na,1945,2921.0112116873984
STAT,1897,33,na,1930,3002.100783285324
STAT,1836,31,25-29,1867,8.471489210032278
SIM,1864,39,25-29,1903,4
SIM,1913,33,25-29,1946,12
STAT,1824,32,20-24,1856,6.582734417456436
STAT,1817,76,na,1893,438.49814385256616
STAT,1899,33,15-19,1932,0.18355499084430918
STAT,1852,21,40-44,1873,1.807658837907198
STAT,1929,30,45-49,1959,1.890312290232299
STAT,1913,15,20-24,1928,26.309100385042143
SIM,1921,37,40-44,1958,3
STAT,1918,39,50-100,1957,0.4171761495363322
STAT,1818,40,na,1858,1486.555841865053
STAT,1836,21,na,1857,1840.4752463005123
STAT,1866,48,35-39,1914,0.120452239270819
STAT,1896,32,na,1928,2977.3655552163814
STAT,1883,41,25-29,1924,0.597465642100014
STAT,1807,50,50-100,1857,0.057618605550201034
STAT,1835,89,na,1924,66.86404333873296
STAT,1901,25,40-44,1926,3.988033284483966
SIM,1831,58,na,1889,1189
SIM,1832,32,20-24,1864,3
STAT,1926,29,15-19,1955,0.7937333882854986
STAT,1956,16,40-44,1972,1.7487009232738875
STAT,1848,28,35-39,1876,8.497827548228356
STAT,1825,52,30-34,1877,0.0058518311553997756
STAT,1862,110,na,1972,0.0041010105891634285
SIM,1909,30,30-34,1939,20
SIM,1892,33,30-34,1925,29
STAT,1885,38,na,1923,2207.487039106086
STAT,1816,75,na,1891,479.73106517602383
STAT,1904,37,15-19,1941,0.016423918839839066
STAT,1843,19,45-49,1862,0.05572245860679874
SIM,1861,56,na,1917,1767
SIM,1854,24,20-24,1878,71
STAT,1914,39,35-39,1953,2.2585082488025274
SIM,1872,31,50-100,1903,4
STAT,1906,33,na,1939,3297.2898260161605
STAT,1854,39,15-19,1893,0.039773376775561864
STAT,1873,26,30-34,1899,24.209940547122176
STAT,1905,33,25-29,1938,7.996996959527
SIM,1844,31,25-29,1875,10
SIM,1901,48,na,1949,2968
SIM,1949,2,na,1951,4305
SIM,1868,35,na,1903,2135
SIM,1920,23,15-19,1943,4
SIM,1914,21,25-29,1935,94
SIM,1830,57,na,1887,1201
SIM,1870,32,50-100,1902,5
STAT,1837,50,45-49,1887,0.00983480241480128
SIM,1891,69,na,1960,1834
SIM,1911,20,45-49,1931,2
STAT,1874,54,50-100,1928,0.014176654866512496
SIM,1945,11,na,1956,3889
SIM,1818,86,na,1904,134
STAT,1851,26,na,1877,1835.192646791623
STAT,1884,33,30-34,1917,16.22674886867598
SIM,1836,21,25-29,1857,44
STAT,1816,107,na,1923,0.00219764241238108
SIM,1828,34,20-24,1862,4
SIM,1860,21,40-44,1881,1
STAT,1849,40,25-29,1889,0.48994888429070416
SIM,1843,43,na,1886,1647
SIM,1888,71,na,1959,1604
SIM,1871,17,20-24,1888,17
SIM,1940,24,30-34,1964,36
SIM,1834,23,na,1857,1752
SIM,1878,31,40-44,1909,5
STAT,1870,39,na,1909,2161.453193818447
STAT,1854,15,40-44,1869,0.1584055648032822
STAT,1924,16,35-39,1940,4.7320348191953
STAT,1900,28,40-44,1928,3.9118814158816355
SIM,1927,3,na,1930,4728
STAT,1912,23,15-19,1935,4.8046531902376755
SIM,1868,29,na,1897,2133
SIM,1905,27,40-44,1932,4
SIM,1848,74,na,1922,794
STAT,1897,47,25-29,1944,0.04085743368102718
SIM,1932,16,35-39,1948,8
STAT,1891,23,20-24,1914,80.29475003594419
STAT,1864,103,na,1967,0.8014604463622713
STAT,1897,20,35-39,1917,7.416430895125216
STAT,1856,30,15-19,1886,0.10848028953946552
STAT,1906,32,50-100,1938,0.7238743132999349
STAT,1908,20,20-24,1928,97.14964687638188
STAT,1852,91,na,1943,42.011370882681064
STAT,1863,109,na,1972,0.011481241875015376
STAT,1862,21,25-29,1883,47.67598858020917
STAT,1878,51,45-49,1929,0.014356132130279392
SIM,1837,43,50-100,1880,1
SIM,1873,41,na,1914,2227
SIM,1931,37,25-29,1968,4
STAT,1790,66,na,1856,708.1704842800002
STAT,1904,33,50-100,1937,0.709897855820379
STAT,1868,31,30-34,1899,15.80149066640102
STAT,1869,30,25-29,1899,9.449272346697795
SIM,1849,34,40-44,1883,4
STAT,1906,21,25-29,1927,79.00225176826734
STAT,1854,92,na,1946,29.7995318244678
STAT,1832,42,20-24,1874,0.11744748063838864
STAT,1893,40,30-34,1933,1.3912321392829903
STAT,1834,78,na,1912,484.4027725304759
SIM,1916,20,20-24,1936,100
STAT,1846,24,20-24,1870,62.163584457631536
STAT,1825,101,na,1926,0.3032782644404914
STAT,1817,92,na,1909,19.27709542526451
SIM,1895,25,20-24,1920,17
SIM,1829,60,na,1889,1087
STAT,1821,38,na,1859,1499.765540900137
SIM,1908,27,na,1935,3281
SIM,1883,24,na,1907,2193
STAT,1933,36,40-44,1969,1.9279845388891
SIM,1833,75,na,1908,572
SIM,1836,43,45-49,1879,1
STAT,1887,25,20-24,1912,12.480541907832563
SIM,1864,8,na,1872,2427
STAT,1816,50,25-29,1866,0.00833687081910754
STAT,1903,20,45-49,1923,0.9428988652017086
STAT,1923,17,40-44,1940,1.5515722460537493
SIM,1898,30,45-49,1928,4
STAT,1876,25,50-100,1901,0.628578587947703
STAT,1913,37,40-44,1950,1.3956641550198055
SIM,1926,19,15-19,1945,47
SIM,1947,24,na,1971,3820
SIM,1876,86,na,1962,339
SIM,1906,26,35-39,1932,12
STAT,1836,53,45-49,1889,0.009322401751921634
SIM,1836,89,na,1925,59
SIM,1903,13,na,1916,3473
STAT,1895,16,40-44,1911,0.22581641889226264
SIM,1931,17,40-44,1948,2
STAT,1907,6,na,1913,3625.2405198974493
SIM,1851,32,30-34,1883,25
STAT,1895,34,45-49,1929,2.1293014863319986
STAT,1893,67,na,1960,2021.223023469168
STAT,1836,37,na,1873,1702.3822279472633
STAT,1903,38,20-24,1941,0.22253208105699526
SIM,1848,52,na,1900,1530
STAT,1885,16,na,1901,2384.061725249658
SIM,1886,20,25-29,1906,58
STAT,1765,99,na,1864,0.2345486920293139
STAT,1850,42,25-29,1892,0.45211419668153846
STAT,1923,37,25-29,1960,1.077743612014213
SIM,1812,42,45-49,1854,2
STAT,1869,8,na,1877,2503.849970323981
STAT,1927,20,30-34,1947,33.651306973332424
SIM,1843,21,na,1864,1987
STAT,1862,35,45-49,1897,1.6254681985145067
SIM,1834,31,40-44,1865,2
SIM,1870,21,25-29,1891,63
SIM,1937,24,na,1961,3267
STAT,1938,32,25-29,1970,8.779655303182299
STAT,1931,23,25-29,1954,112.823771939964
STAT,1865,19,50-100,1884,0.042721066461379804
STAT,1893,22,40-44,1915,2.496460618287989
STAT,1901,41,50-100,1942,0.09744883526999086
STAT,1851,42,30-34,1893,0.8259875697167788
SIM,1928,27,25-29,1955,83
SIM,1825,29,45-49,1854,2
SIM,1921,15,20-24,1936,125
STAT,1849,32,50-100,1881,0.7239931856088386
STAT,1826,31,40-44,1857,6.370403672520214
STAT,1835,73,na,1908,755.9760382493946
SIM,1935,20,30-34,1955,46
STAT,1906,11,na,1917,3558.586430668795
STAT,1874,18,35-39,1892,0.5282392832883676
SIM,1938,26,40-44,1964,5
SIM,1857,32,50-100,1889,4
SIM,1881,70,na,1951,1048
STAT,1834,49,15-19,1883,2.566034326912675E-4
SIM,1863,43,50-100,1906,1
STAT,1843,32,30-34,1875,14.177580905157239
STAT,1848,22,na,1870,1934.4694306288038
STAT,1884,69,na,1953,1369.6886439501818
SIM,1860,103,na,1963,1
SIM,1892,38,na,1930,3092
STAT,1914,20,20-24,1934,103.60080013240172
STAT,1867,50,30-34,1917,0.005356257250369466
SIM,1873,36,25-29,1909,3
STAT,1823,88,na,1911,73.47158935507272
SIM,1894,67,na,1961,2148
STAT,1845,40,40-44,1885,1.6628765517675526
STAT,1940,26,30-34,1966,37.76267217074298
STAT,1922,29,30-34,1951,41.585987903799065
SIM,1891,53,na,1944,2493
STAT,1910,37,15-19,1947,0.017350785386776226
STAT,1870,88,na,1958,173.46013590318222
SIM,1925,17,40-44,1942,2
SIM,1936,26,20-24,1962,16
STAT,1897,31,15-19,1928,0.18065059399053127
STAT,1901,33,40-44,1934,5.710421568735891
STAT,1927,34,15-19,1961,0.14913800314347622
STAT,1769,97,na,1866,0.7047615639915665
SIM,1930,29,30-34,1959,59
STAT,1877,30,35-39,1907,10.003632312018318
STAT,1847,36,30-34,1883,4.120183195141249
SIM,1885,30,35-39,1915,7
STAT,1860,39,15-19,1899,0.042609806118662726
SIM,1908,21,25-29,1929,97
STAT,1851,54,50-100,1905,0.010565302135327725
SIM,1928,33,50-100,1961,1
STAT,1925,37,45-49,1962,0.772939924290433
SIM,1817,75,na,1892,468
STAT,1872,20,40-44,1892,1.9863512711333011
STAT,1876,20,15-19,1896,3.239074821615671
STAT,1851,10,na,1861,2114.0117619338025
SIM,1897,32,na,1929,3078
STAT,1858,32,15-19,1890,0.105478725744908
STAT,1919,32,15-19,1951,0.13097391353074198
SIM,1948,6,na,1954,4248
STAT,1905,42,15-19,1947,0.0013078735813034856
SIM,1825,40,na,1865,1537
SIM,1888,65,na,1953,1908
SIM,1904,15,30-34,1919,3
STAT,1862,37,50-100,1899,0.9916705856254995
STAT,1917,17,40-44,1934,0.28434856179918294
SIM,1840,88,na,1928,88
SIM,1858,22,15-19,1880,5
SIM,1879,48,50-100,1927,1
SIM,1853,40,40-44,1893,5
STAT,1879,43,15-19,1922,0.013557521197227957
SIM,1862,33,45-49,1895,2
SIM,1922,20,20-24,1942,124
STAT,1839,43,20-24,1882,0.11002395698261862
STAT,1825,44,30-34,1869,1.1963018101523057
STAT,1869,91,na,1960,94.13406244719937
SIM,1886,2,na,1888,2883
STAT,1839,37,35-39,1876,5.627479563655691
STAT,1882,73,na,1955,1091.2066152445254
STAT,1851,34,30-34,1885,12.803537232568384
SIM,1836,25,40-44,1861,2
SIM,1870,39,25-29,1909,2
STAT,1842,43,na,1885,1709.640820477934
SIM,1818,92,na,1910,28
STAT,1918,19,15-19,1937,46.415355092297496
STAT,1757,111,na,1868,0.0013429670641807948
SIM,1855,36,30-34,1891,8
STAT,1899,38,45-49,1937,0.5541886985840977
STAT,1921,39,40-44,1960,1.5756973668434306
STAT,1915,39,40-44,1954,1.4142755613137281
STAT,1821,44,na,1865,1425.754451761725
SIM,1863,41,na,1904,1933
SIM,1923,39,40-44,1962,2
STAT,1938,21,45-49,1959,1.0523613765202693
SIM,1851,21,15-19,1872,2
STAT,1762,103,na,1865,0.0242727964793479
STAT,1842,40,25-29,1882,0.4936206291430202
SIM,1933,37,45-49,1970,1
SIM,1871,39,na,1910,2210
SIM,1883,18,na,1901,2353
STAT,1919,48,15-19,1967,3.764018451372074E-4
SIM,1946,21,45-49,1967,1
STAT,1821,38,50-100,1859,2.4550906043947434
STAT,1812,94,na,1906,8.681701681482595
STAT,1845,34,50-100,1879,0.7550603485868056
STAT,1854,33,45-49,1887,1.2644996534267992
STAT,1833,23,na,1856,1750.4019078353233
STAT,1899,44,30-34,1943,0.10194417032386664
SIM,1849,42,40-44,1891,6
SIM,1878,71,na,1949,1279
SIM,1888,28,30-34,1916,31
STAT,1905,16,25-29,1921,7.756890310408805
SIM,1901,23,40-44,1924,2
SIM,1847,37,50-100,1884,1
SIM,1861,42,40-44,1903,10
STAT,1891,43,25-29,1934,0.7451193506704981
STAT,1825,95,na,1920,7.06638816032921
STAT,1889,38,50-100,1927,1.4247589386859751
STAT,1913,48,50-100,1961,0.20797993240667295
STAT,1862,39,25-29,1901,2.30217498683229
STAT,1847,74,na,1921,818.366131046365
SIM,1842,95,na,1937,5
STAT,1875,4,na,1879,2823.7798607303007
SIM,1833,44,30-34,1877,1
STAT,1858,46,35-39,1904,0.10398981698279951
SIM,1913,33,na,1946,3394
STAT,1947,24,15-19,1971,5.6797697533344484
STAT,1843,21,15-19,1864,2.81721886426925
STAT,1878,52,50-100,1930,0.01478981285164908
STAT,1884,47,na,1931,2090.0335201217026
STAT,1850,22,20-24,1872,58.30589895715303
SIM,1899,23,15-19,1922,4
SIM,1914,15,15-19,1929,8
STAT,1819,50,40-44,1869,0.019926122505482723
STAT,1830,58,na,1888,1197.5788193819883
SIM,1825,62,na,1887,1004
STAT,1907,49,45-49,1956,0.18185444995951142
STAT,1858,37,45-49,1895,1.4765386710636426
SIM,1871,92,na,1963,85
SIM,1926,31,45-49,1957,2
STAT,1943,18,20-24,1961,135.77287823860473
SIM,1879,30,35-39,1909,12
STAT,1794,80,na,1874,254.93594216894266
STAT,1843,52,35-39,1895,0.005784004589015027
SIM,1907,31,35-39,1938,6
STAT,1892,35,30-34,1927,6.366115559534517
STAT,1928,26,20-24,1954,21.31727423867275
SIM,1859,68,na,1927,1199
SIM,1898,17,na,1915,3181
SIM,1808,46,50-100,1854,2
STAT,1827,35,50-100,1862,1.3370684884954154
STAT,1882,29,25-29,1911,38.5852043627543
STAT,1844,56,na,1900,1416.5741351529448
STAT,1952,19,15-19,1971,51.34300659502116
SIM,1870,4,na,1874,2577
STAT,1828,36,20-24,1864,0.7199091430636737
SIM,1820,41,40-44,1861,6
SIM,1839,91,na,1930,24
STAT,1886,41,40-44,1927,2.254731904800337
SIM,1823,38,25-29,1861,1
STAT,1873,35,20-24,1908,0.7455756817498601
STAT,1806,55,na,1861,1112.2512441102338
SIM,1908,49,na,1957,3081
STAT,1824,52,25-29,1876,0.004156707204028494
SIM,1849,20,20-24,1869,68
STAT,1871,19,20-24,1890,16.541457490220434
STAT,1928,29,35-39,1957,17.455854980173847
SIM,1904,39,30-34,1943,2
STAT,1836,45,45-49,1881,0.16408792203487652
SIM,1913,16,25-29,1929,6
SIM,1845,60,na,1905,1321
SIM,1877,26,40-44,1903,5
STAT,1915,15,40-44,1930,0.2778436285292639
STAT,1864,21,45-49,1885,0.60088086951
SIM,1921,48,50-100,1969,1
STAT,1906,15,15-19,1921,8.20330851019728
STAT,1918,31,45-49,1949,1.5861339203247933
STAT,1890,22,15-19,1912,3.8102599817256406
STAT,1919,21,35-39,1940,9.769748756267147
SIM,1890,29,25-29,1919,52
STAT,1945,22,15-19,1967,5.511467252194551
STAT,1825,36,50-100,1861,1.606754194958792
SIM,1914,37,35-39,1951,2
STAT,1913,2,na,1915,3937.5389216139624
STAT,1860,38,50-100,1898,0.9364089667562221
SIM,1836,73,na,1909,737
SIM,1936,29,35-39,1965,12
STAT,1823,31,15-19,1854,0.43160861438313414
STAT,1930,27,15-19,1957,0.8479880479420816
STAT,1853,86,na,1939,167.91503693076083
SIM,1877,49,na,1926,2121
STAT,1882,50,20-24,1932,6.876801293089242E-4
STAT,1852,24,45-49,1876,0.5919748361622712
SIM,1918,38,30-34,1956,2
SIM,1843,27,na,1870,1903
STAT,1897,17,na,1914,3190.806286124398
SIM,1843,35,50-100,1878,1
STAT,1907,29,40-44,1936,4.092576266161005
STAT,1846,17,20-24,1863,16.51820062597259
STAT,1897,35,30-34,1932,6.7972415844321175
STAT,1899,31,25-29,1930,13.312235352797641
STAT,1851,52,35-39,1903,0.006159898310728526
STAT,1916,26,na,1942,3671.72627517725
SIM,1832,29,50-100,1861,1
SIM,1858,67,na,1925,1282
STAT,1876,34,na,1910,2309.1106326315207
SIM,1937,31,20-24,1968,2
SIM,1908,25,40-44,1933,4
SIM,1873,20,15-19,1893,3
STAT,1773,106,na,1879,0.010735852537709912
SIM,1846,31,45-49,1877,1
SIM,1904,15,20-24,1919,25
STAT,1834,33,40-44,1867,3.4118165502206055
STAT,1871,15,40-44,1886,0.17473673216440855
SIM,1904,37,40-44,1941,1
STAT,1861,19,na,1880,2048.045624835795
SIM,1838,44,30-34,1882,1
SIM,1877,41,40-44,1918,7
STAT,1839,30,15-19,1869,0.11912901906345572
STAT,1931,39,35-39,1970,3.019660432283851
SIM,1923,11,na,1934,4456
STAT,1811,44,na,1855,1329.9637037769737
SIM,1866,34,50-100,1900,1
SIM,1900,31,25-29,1931,14
STAT,1827,54,na,1881,1298.0503372066848
SIM,1938,15,25-29,1953,51
STAT,1864,49,na,1913,1854.7508574497444
STAT,1840,44,20-24,1884,0.10596865236671274
SIM,1877,40,50-100,1917,1
SIM,1769,95,na,1864,1
STAT,1924,42,25-29,1966,0.08023948248907943
SIM,1828,40,40-44,1868,5
STAT,1865,71,na,1936,1142.9446227405276
STAT,1902,48,20-24,1950,0.00891124811657664
SIM,1915,29,40-44,1944,3
SIM,1840,25,30-34,1865,26
STAT,1929,31,20-24,1960,2.9285181101085316
STAT,1883,48,35-39,1931,0.12804056521934704
STAT,1920,38,20-24,1958,0.2723817418686537
SIM,1871,24,20-24,1895,64
SIM,1883,56,na,1939,1859
STAT,1853,20,30-34,1873,16.158708950121632
STAT,1842,19,50-100,1861,0.045024650357220745
SIM,1854,30,40-44,1884,3
STAT,1837,39,15-19,1876,0.043460045191418294
STAT,1859,111,na,1970,9.81245343062288E-4
STAT,1913,27,15-19,1940,0.6645388847512567
STAT,1917,28,20-24,1945,18.02102421846816
STAT,1941,15,na,1956,3583.46116515929
STAT,1797,82,na,1879,169.86427963374024
STAT,1944,21,45-49,1965,1.1480453401512891
SIM,1923,3,na,1926,4545
STAT,1838,31,45-49,1869,1.4699549511233323
STAT,1862,32,40-44,1894,3.502846295029196
STAT,1876,0,na,1876,3573.7425883210894
STAT,1919,36,30-34,1955,1.8514016577966081
SIM,1854,41,50-100,1895,4
SIM,1861,20,30-34,1881,17
STAT,1865,53,25-29,1918,0.002984209287694009
STAT,1878,20,25-29,1898,56.69575668091651
STAT,1832,25,30-34,1857,21.264296971358505
SIM,1849,36,30-34,1885,13
SIM,1808,92,na,1900,12
STAT,1932,18,45-49,1950,0.6232409249734137
SIM,1849,15,na,1864,2184
SIM,1925,28,20-24,1953,21
SIM,1911,16,na,1927,3651
SIM,1918,20,30-34,1938,30
STAT,1907,16,35-39,1923,0.7633290193745974
SIM,1945,19,25-29,1964,49
STAT,1892,46,35-39,1938,0.09370854318926018
STAT,1826,75,na,1901,562.1716299257969
STAT,1924,30,na,1954,4187.136798452514
STAT,1815,69,na,1884,766.1391184235745
STAT,1817,49,15-19,1866,8.739034985772557E-4
STAT,1949,21,20-24,1970,122.61911538276854
STAT,1841,23,30-34,1864,15.444621072263994
STAT,1867,46,50-100,1913,0.21848493303861447
STAT,1869,37,20-24,1906,0.7054727689960797
STAT,1857,18,35-39,1875,0.4776763093684781
STAT,1880,20,40-44,1900,2.087720514505853
STAT,1867,26,30-34,1893,22.414969840193088
STAT,1841,28,25-29,1869,35.961907379829825
STAT,1867,19,na,1886,2263.469812315313
STAT,1945,13,na,1958,4053.0032468711056
SIM,1929,39,45-49,1968,1
STAT,1916,11,na,1927,3964.260541304438
STAT,1940,15,15-19,1955,43.5539499922122
STAT,1856,46,25-29,1902,0.042576220403245595
SIM,1866,71,na,1937,1153
STAT,1826,34,45-49,1860,2.1030330435578097
STAT,1823,47,25-29,1870,0.0709464545782035
SIM,1845,17,na,1862,2033
SIM,1835,30,30-34,1865,24
SIM,1929,11,na,1940,4753
SIM,1858,57,na,1915,1663
STAT,1947,22,25-29,1969,98.62404758131832
SIM,1927,36,30-34,1963,5
SIM,1858,52,na,1910,1768
SIM,1811,81,na,1892,234
SIM,1833,91,na,1924,21
SIM,1906,63,na,1969,2696
SIM,1911,48,na,1959,3249
STAT,1837,19,20-24,1856,16.014242277041845
STAT,1863,16,45-49,1879,0.062160345855096256
SIM,1931,30,na,1961,4653
STAT,1890,38,25-29,1928,3.3088804630865036
STAT,1939,27,35-39,1966,14.258515832059851
STAT,1937,31,50-100,1968,0.773202100988599
STAT,1808,62,na,1870,957.6763621319649
SIM,1872,93,na,1965,61
STAT,1845,57,na,1902,1422.072853320479
STAT,1937,19,25-29,1956,39.70831928049248
SIM,1933,21,35-39,1954,14
STAT,1936,28,30-34,1964,35.40656637744158
STAT,1833,50,25-29,1883,0.002330224002052213
STAT,1851,45,35-39,1896,0.1017120301746134
STAT,1929,36,15-19,1965,0.023310767389482377
STAT,1821,38,25-29,1859,5.7574682158162265
SIM,1803,62,na,1865,881
STAT,1864,31,50-100,1895,0.7746055461102513
STAT,1930,29,40-44,1959,5.593286312522336
STAT,1954,16,20-24,1970,158.36546160184872
SIM,1922,27,40-44,1949,5
SIM,1845,19,20-24,1864,23
SIM,1934,15,40-44,1949,1
SIM,1896,37,30-34,1933,6
SIM,1834,34,45-49,1868,1
SIM,1866,86,na,1952,167
STAT,1914,27,40-44,1941,4.439042016044614
STAT,1910,20,50-100,1930,0.5872462806370835
SIM,1886,24,40-44,1910,1
SIM,1915,16,35-39,1931,3
STAT,1891,23,na,1914,2755.6829813785785
STAT,1827,30,30-34,1857,22.844761012922362
SIM,1853,25,40-44,1878,6
SIM,1883,34,na,1917,2178
SIM,1929,21,45-49,1950,1
STAT,1865,20,15-19,1885,2.900685359782095
STAT,1843,26,45-49,1869,0.9296227969457175
SIM,1845,34,20-24,1879,1
STAT,1905,49,35-39,1954,0.10558383794694125
SIM,1851,26,45-49,1877,1
STAT,1820,81,na,1901,284.87889603953056
STAT,1839,27,30-34,1866,21.12147639178786
STAT,1863,29,15-19,1892,0.37343899920591395
SIM,1935,32,50-100,1967,5
STAT,1837,34,20-24,1871,2.154321468038014
SIM,1847,27,30-34,1874,27
STAT,1894,21,30-34,1915,21.690280540850274
SIM,1782,77,na,1859,325
STAT,1860,23,40-44,1883,1.6347242902493426
STAT,1925,21,35-39,1946,10.679296192163134
SIM,1798,60,na,1858,949
STAT,1878,24,40-44,1902,2.0387096507909406
STAT,1888,37,30-34,1925,5.95019760720692
STAT,1845,25,40-44,1870,2.6175640902908026
STAT,1930,15,30-34,1945,14.955559339581338
STAT,1925,34,40-44,1959,4.38427042191446
SIM,1860,15,30-34,1875,2
SIM,1828,38,na,1866,1602
SIM,1828,54,na,1882,1302
STAT,1883,41,15-19,1924,0.01284872434415765
STAT,1901,36,45-49,1937,0.5717112368415819
STAT,1860,56,na,1916,1563.3992074525556
STAT,1913,18,35-39,1931,0.8083937863901753
SIM,1849,37,na,1886,1810
STAT,1927,30,35-39,1957,10.631385949548147
SIM,1866,39,35-39,1905,20
STAT,1949,15,35-39,1964,4.612950912070104
SIM,1881,28,20-24,1909,9
SIM,1919,29,25-29,1948,60
STAT,1878,35,20-24,1913,0.7661241320264298
SIM,1844,42,40-44,1886,3
SIM,1920,39,25-29,1959,1
SIM,1874,39,50-100,1913,1
STAT,1922,23,50-100,1945,0.71063559567248
SIM,1803,77,na,1880,320
SIM,1887,32,45-49,1919,2
SIM,1868,19,na,1887,2278
SIM,1914,28,45-49,1942,2
SIM,1845,26,45-49,1871,1
STAT,1907,43,50-100,1950,0.10107130720572781
SIM,1881,26,30-34,1907,24
SIM,1890,36,25-29,1926,8
STAT,1894,47,50-100,1941,0.16740889597593875
STAT,1828,43,45-49,1871,1.2479092500518063
STAT,1865,17,30-34,1882,1.4063773126770933
STAT,1830,109,na,1939,4.2939856278732537E-4
STAT,1862,32,50-100,1894,0.7400685152425932
STAT,1867,99,na,1966,7.708778481747675
SIM,1954,17,25-29,1971,48
STAT,1931,15,na,1946,4572.367261709529
STAT,1882,40,50-100,1922,0.9803720681030782
STAT,1906,37,25-29,1943,0.8550546174971467
STAT,1872,41,na,1913,2199.9878181748763
SIM,1933,34,40-44,1967,12
STAT,1893,25,45-49,1918,1.3391981832891526
STAT,1856,34,30-34,1890,12.758989370174133
SIM,1926,1,na,1927,4658
STAT,1896,54,na,1950,2612.6712623813946
SIM,1839,75,na,1914,695
SIM,1858,34,30-34,1892,32
STAT,1879,32,45-49,1911,1.7244190229996557
STAT,1954,1,na,1955,4598.1558988113065
STAT,1832,45,25-29,1877,0.0422283635461109
STAT,1882,36,25-29,1918,2.6578939938119372
SIM,1905,23,25-29,1928,73
STAT,1931,32,15-19,1963,0.15906789427952941
SIM,1859,15,na,1874,2183
SIM,1873,17,30-34,1890,1
SIM,1828,27,20-24,1855,8
SIM,1784,84,na,1868,73
SIM,1859,40,35-39,1899,1
STAT,1812,44,45-49,1856,5.2678591820022405
STAT,1815,107,na,1922,0.002105009712470406
STAT,1849,44,40-44,1893,1.66389323838971
SIM,1895,18,20-24,1913,19
SIM,1858,28,45-49,1886,3
STAT,1950,1,na,1951,4561.635757297133
SIM,1937,17,25-29,1954,48
STAT,1840,48,50-100,1888,0.16046496248772457
STAT,1929,17,25-29,1946,52.24413219087602
STAT,1932,24,30-34,1956,35.50254821833234
SIM,1866,37,45-49,1903,1
SIM,1864,34,30-34,1898,20
SIM,1798,82,na,1880,139
SIM,1935,30,35-39,1965,10
STAT,1887,18,20-24,1905,18.68437911308107
STAT,1926,18,45-49,1944,0.5770571869025861
STAT,1846,30,40-44,1876,3.8809367608907177
SIM,1820,44,45-49,1864,2
STAT,1902,17,20-24,1919,23.6362353908919
SIM,1914,37,25-29,1951,4
SIM,1892,20,25-29,1912,84
STAT,1866,31,20-24,1897,2.364857680901219
STAT,1785,97,na,1882,0.9774109027612754
STAT,1940,17,40-44,1957,1.3416228885886545
SIM,1929,32,25-29,1961,10
STAT,1879,16,50-100,1895,0.048565741696251344
STAT,1893,16,30-34,1909,1.914189439142585
STAT,1817,42,30-34,1859,2.9215958792314614
STAT,1892,31,15-19,1923,0.1691925383196978
STAT,1921,17,30-34,1938,13.125186746497866
STAT,1874,51,25-29,1925,0.0034351915488499084
SIM,1910,17,20-24,1927,21
SIM,1825,36,45-49,1861,1
STAT,1764,98,na,1862,0.35506314977420445
STAT,1916,48,na,1964,3549.8376802213197
STAT,1926,25,50-100,1951,1.1348179541313488
STAT,1928,11,na,1939,4723.3754757140405
STAT,1945,26,30-34,1971,40.62791527974595
STAT,1842,47,35-39,1889,0.1014024615189387
SIM,1848,89,na,1937,63
STAT,1906,28,45-49,1934,1.5222928936460316
STAT,1884,27,45-49,1911,1.0362689051118992
STAT,1876,18,45-49,1894,0.06358803999287421
STAT,1836,49,25-29,1885,0.03804791419040167
STAT,1927,17,15-19,1944,53.306861345573765
SIM,1892,27,45-49,1919,2
STAT,1873,22,15-19,1895,3.160842661997801
SIM,1862,19,na,1881,2213
SIM,1895,31,40-44,1926,7
STAT,1863,27,25-29,1890,35.068609387466566
STAT,1827,38,na,1865,1606.657613183977
SIM,1918,17,15-19,1935,43
SIM,1815,62,na,1877,1023
STAT,1856,39,25-29,1895,2.1008333959636087
SIM,1860,24,45-49,1884,1
STAT,1880,60,na,1940,1899.4267238995365
STAT,1912,39,25-29,1951,0.8987383470612925
STAT,1852,15,30-34,1867,1.414183933901843
STAT,1910,16,na,1926,3624.354497555683
SIM,1825,42,30-34,1867,2
STAT,1835,57,na,1892,1279.0818616286003
SIM,1848,6,na,1854,2302
STAT,1884,20,25-29,1904,53.747300189092925
SIM,1938,28,30-34,1966,43
SIM,1854,17,20-24,1871,21
STAT,1842,40,15-19,1882,0.010615498109909123
STAT,1887,31,40-44,1918,4.60126739239638
SIM,1876,31,30-34,1907,20
SIM,1935,17,15-19,1952,58
SIM,1931,30,50-100,1961,1
STAT,1946,17,25-29,1963,45.407157456563375
SIM,1835,39,na,1874,1595
STAT,1865,93,na,1958,36.761778396363795
STAT,1915,9,na,1924,3923.216775120063
SIM,1839,28,35-39,1867,8
SIM,1949,22,25-29,1971,101
SIM,1809,72,na,1881,546
STAT,1869,44,45-49,1913,1.3512207970632792
SIM,1908,26,45-49,1934,1
STAT,1857,51,25-29,1908,0.0026516423229132184
STAT,1929,38,40-44,1967,1.813692742203339
SIM,1849,23,25-29,1872,58
STAT,1836,42,40-44,1878,1.7327713445774757
SIM,1871,27,25-29,1898,46
SIM,1919,15,15-19,1934,8
STAT,1837,26,45-49,1863,0.9315712027177383
SIM,1869,35,20-24,1904,3
STAT,1848,37,na,1885,1804.0563192058453
STAT,1892,16,50-100,1908,0.05811203029040796
STAT,1818,37,50-100,1855,3.899670527824786
STAT,1898,19,35-39,1917,0.6977186309302356
SIM,1923,33,na,1956,4157
STAT,1841,35,25-29,1876,2.387740638984177
SIM,1942,9,na,1951,3825
STAT,1864,48,25-29,1912,0.047888200552374194
STAT,1839,23,na,1862,1815.9749755770574
SIM,1923,17,30-34,1940,16
STAT,1906,34,30-34,1940,13.675846941521094
STAT,1924,29,40-44,1953,5.090108807823367
SIM,1842,42,na,1884,1610
STAT,1871,29,25-29,1900,39.398177964071046
STAT,1865,50,20-24,1915,6.409354416177294E-4
STAT,1881,23,na,1904,2151.689403257415
SIM,1868,36,40-44,1904,9
STAT,1776,83,na,1859,119.71912215858187
SIM,1858,43,50-100,1901,1
STAT,1874,85,na,1959,362.2760659988091
SIM,1908,28,45-49,1936,1
STAT,1884,37,na,1921,2198.882298515579
SIM,1933,26,na,1959,4730
SIM,1870,86,na,1956,209
STAT,1832,27,20-24,1859,9.61054805810773
STAT,1835,24,45-49,1859,0.5815149269486293
SIM,1835,24,na,1859,1757
STAT,1837,40,40-44,1877,1.7672737183971452
STAT,1883,45,30-34,1928,0.09055130042035517
SIM,1886,27,45-49,1913,2
SIM,1818,54,na,1872,1171
STAT,1900,16,25-29,1916,7.444512010299126
SIM,1885,39,45-49,1924,3
STAT,1816,54,30-34,1870,0.01293333997107485
STAT,1882,53,25-29,1935,0.003201853565261698
SIM,1937,34,25-29,1971,6
STAT,1850,18,25-29,1868,4.852597846794632
STAT,1877,39,45-49,1916,1.933825723750577
STAT,1932,15,40-44,1947,1.7577882926292554
SIM,1837,68,na,1905,960
STAT,1817,38,35-39,1855,23.13599915944249
SIM,1856,93,na,1949,15
SIM,1789,83,na,1872,103
SIM,1940,15,40-44,1955,1
SIM,1867,24,30-34,1891,19
STAT,1927,38,30-34,1965,2.1384789140406038
SIM,1897,18,30-34,1915,3
SIM,1936,26,30-34,1962,36
STAT,1914,52,na,1966,3384.1754744303253
STAT,1940,22,15-19,1962,5.122776534098108
STAT,1855,31,45-49,1886,1.2749380576735876
STAT,1905,25,15-19,1930,0.6237313580930444
STAT,1897,38,35-39,1935,8.891482776157153
STAT,1951,15,50-100,1966,0.4216936552241139
SIM,1914,34,30-34,1948,21
SIM,1837,17,20-24,1854,17
SIM,1824,61,na,1885,1027
STAT,1876,22,40-44,1898,2.0338074259645693
STAT,1825,40,15-19,1865,0.015742199129422308
STAT,1916,47,45-49,1963,0.2105912010499918
SIM,1939,1,na,1940,3821
STAT,1832,49,40-44,1881,0.10850319158554696
STAT,1837,37,25-29,1874,2.275075050596676
STAT,1861,49,50-100,1910,0.1888877106267215
STAT,1834,36,45-49,1870,1.5549172363961012
STAT,1933,32,25-29,1965,11.766747851843565
SIM,1863,31,45-49,1894,1
STAT,1823,44,20-24,1867,0.20061380856964742
SIM,1872,39,35-39,1911,10
STAT,1911,29,30-34,1940,35.841439604957024
STAT,1860,26,45-49,1886,0.8663976386760931
STAT,1854,32,50-100,1886,0.6713329886584943
STAT,1886,70,na,1956,1428.2017028155074
STAT,1937,16,20-24,1953,124.90463833675699
STAT,1765,101,na,1866,0.08998105007960433
STAT,1884,29,35-39,1913,8.9411804894923
SIM,1931,37,35-39,1968,5
SIM,1871,6,na,1877,2608
STAT,1845,36,20-24,1881,0.5791076711121063
STAT,1879,47,30-34,1926,0.095276660182632
STAT,1820,50,50-100,1870,0.02533428110873153
STAT,1931,36,30-34,1967,2.2823014518884013
STAT,1768,114,na,1882,2.0558276853957315E-4
STAT,1890,35,20-24,1925,0.8987594408523208
STAT,1923,37,35-39,1960,2.647542166080284
SIM,1945,16,20-24,1961,128
STAT,1858,43,30-34,1901,0.8453866408944605
STAT,1863,48,50-100,1911,0.20104832208161588
STAT,1847,32,15-19,1879,0.12329799637686717
SIM,1867,34,na,1901,2263
STAT,1896,22,na,1918,2950.8367118250244
SIM,1862,19,20-24,1881,19
SIM,1849,75,na,1924,766
STAT,1854,19,20-24,1873,14.995467088983142
SIM,1902,49,na,1951,2900
SIM,1907,44,40-44,1951,2
SIM,1840,27,20-24,1867,14
SIM,1888,35,30-34,1923,6
SIM,1880,20,40-44,1900,3
SIM,1842,36,45-49,1878,1
SIM,1919,33,na,1952,3907
STAT,1906,25,40-44,1931,4.149570116354381
STAT,1885,48,na,1933,2091.928469457837
STAT,1832,44,50-100,1876,0.7612815405829221
STAT,1834,28,50-100,1862,0.5168288296676551
STAT,1843,23,40-44,1866,1.7540178927090888
STAT,1863,30,40-44,1893,3.6241118025445695
SIM,1892,29,35-39,1921,15
STAT,1908,21,35-39,1929,8.202486016521188
SIM,1849,20,30-34,1869,18
SIM,1845,37,25-29,1882,1
SIM,1851,94,na,1945,14
SIM,1864,42,na,1906,2034
STAT,1901,40,40-44,1941,0.20862638234432482
STAT,1902,67,na,1969,2424.978282035376
SIM,1932,15,na,1947,4620
SIM,1929,36,40-44,1965,4
STAT,1877,43,40-44,1920,2.188221094862798
SIM,1834,25,30-34,1859,23
SIM,1909,31,45-49,1940,3
SIM,1885,43,40-44,1928,3
SIM,1894,20,35-39,1914,8
STAT,1854,50,45-49,1904,0.010532628935575501
STAT,1878,27,45-49,1905,1.093116295953908
STAT,1932,27,25-29,1959,81.44212194174702
STAT,1881,52,20-24,1933,6.698450147215257E-4
STAT,1908,48,15-19,1956,3.1385142550694676E-4
STAT,1928,38,15-19,1966,0.022903072472297795
SIM,1838,90,na,1928,38
STAT,1937,10,na,1947,3652.489951910155
SIM,1843,53,na,1896,1484
SIM,1875,26,30-34,1901,26
STAT,1926,16,45-49,1942,0.5799940336715991
SIM,1844,38,45-49,1882,3
STAT,1862,21,35-39,1883,4.85997569452208
STAT,1858,15,na,1873,2009.6536718009731
SIM,1907,48,na,1955,3086
SIM,1870,21,35-39,1891,5
STAT,1841,42,na,1883,1655.7381186132855
STAT,1854,30,40-44,1884,3.2441903619704355
STAT,1844,30,30-34,1874,14.805189640534143
STAT,1886,20,35-39,1906,5.858031234596995
SIM,1825,38,35-39,1863,11
SIM,1881,60,na,1941,1465
STAT,1867,22,15-19,1889,2.9385477315241384
STAT,1838,46,30-34,1884,0.06772178079259504
SIM,1862,32,50-100,1894,5
SIM,1914,34,na,1948,3552
STAT,1815,45,25-29,1860,0.1336384913682829
SIM,1836,29,20-24,1865,11
STAT,1950,19,40-44,1969,1.5613758217792533
STAT,1915,17,30-34,1932,2.410011401927145
STAT,1873,28,20-24,1901,11.20050819215862
STAT,1876,25,45-49,1901,1.0910130887141993
SIM,1889,18,na,1907,3050
STAT,1908,38,20-24,1946,0.23200848947879565
SIM,1875,22,15-19,1897,1
SIM,1880,5,na,1885,2742
STAT,1871,26,20-24,1897,11.042715580735292
SIM,1837,41,45-49,1878,3
STAT,1905,46,30-34,1951,0.07477213842383443
STAT,1834,45,35-39,1879,0.10388323559554152
SIM,1897,69,na,1966,2167
STAT,1889,18,30-34,1907,1.8539877835327965
STAT,1936,24,15-19,1960,4.80435535672664
SIM,1903,27,30-34,1930,43
STAT,1856,43,20-24,1899,0.11621196225022438
SIM,1918,23,35-39,1941,11
STAT,1836,38,45-49,1874,1.5681717532814827
SIM,1904,18,25-29,1922,8
SIM,1862,30,40-44,1892,7
STAT,1948,17,35-39,1965,4.536682857776065
SIM,1906,39,40-44,1945,2
SIM,1852,30,30-34,1882,28
SIM,1819,52,50-100,1871,2
STAT,1828,29,20-24,1857,14.366533512357732
SIM,1823,39,na,1862,1462
SIM,1905,20,50-100,1925,2
SIM,1819,36,45-49,1855,1
STAT,1888,33,15-19,1921,0.1583198522626353
SIM,1859,20,15-19,1879,3
STAT,1856,37,35-39,1893,5.213293387204845
STAT,1931,19,30-34,1950,14.990508753985289
STAT,1914,32,15-19,1946,0.12220196810844226
SIM,1868,20,40-44,1888,3
STAT,1836,42,50-100,1878,0.8138572979233973
SIM,1841,94,na,1935,9
STAT,1879,84,na,1963,539.6415736396856
STAT,1896,32,45-49,1928,2.175741560067015
STAT,1866,56,na,1922,1777.176600963264
STAT,1829,41,45-49,1870,1.2968138181718833
STAT,1858,36,30-34,1894,3.9665191533426998
STAT,1885,5,na,1890,2467.7074097786326
SIM,1832,23,30-34,1855,16
SIM,1944,24,15-19,1968,4
SIM,1908,12,na,1920,3593
STAT,1811,76,na,1887,402.91764179553223
STAT,1921,48,30-34,1969,0.0946731739453473
STAT,1840,47,25-29,1887,0.038118727682258165
SIM,1812,92,na,1904,15
STAT,1931,15,15-19,1946,56.3767322661186
STAT,1880,16,45-49,1896,0.0652167409362772
STAT,1795,75,na,1870,429.2118199655378
STAT,1849,47,45-49,1896,0.17614381075258345
STAT,1802,62,na,1864,909.3544438534815
SIM,1921,15,30-34,1936,18
STAT,1892,8,na,1900,3075.9138990579927
SIM,1845,23,40-44,1868,2
SIM,1942,17,40-44,1959,2
STAT,1878,38,25-29,1916,2.8205691729450195
SIM,1869,41,40-44,1910,2
STAT,1866,41,15-19,1907,0.012087244510175139
STAT,1889,0,na,1889,3364.839963905771
SIM,1831,38,35-39,1869,12
SIM,1886,48,na,1934,2154
STAT,1922,27,40-44,1949,4.982556706949451
STAT,1819,35,40-44,1854,14.18424668922619
STAT,1823,61,na,1884,1061.0843358902923
STAT,1819,44,50-100,1863,2.0725599793344864
STAT,1905,29,30-34,1934,34.13998159509257
SIM,1919,26,20-24,1945,23
STAT,1911,17,50-100,1928,0.07082834672873417
STAT,1839,36,20-24,1875,0.6197177488759391
STAT,1843,39,15-19,1882,0.03946592429045262
STAT,1854,7,na,1861,2118.4382750297386
STAT,1764,101,na,1865,0.08338785068541123
SIM,1884,25,45-49,1909,3
SIM,1884,19,na,1903,2468
STAT,1871,89,na,1960,164.77595016828943
STAT,1893,23,50-100,1916,0.4870345863098304
STAT,1909,27,50-100,1936,0.8986753802800913
SIM,1851,72,na,1923,909
SIM,1940,27,25-29,1967,67
STAT,1823,38,35-39,1861,10.862521710005987
SIM,1858,32,40-44,1890,5
STAT,1792,100,na,1892,0.19353154462541555
SIM,1875,85,na,1960,359
STAT,1864,45,20-24,1909,0.010204390946919079
SIM,1866,34,40-44,1900,4
STAT,1798,101,na,1899,0.16208477140296337
SIM,1862,1,na,1863,2944
STAT,1865,42,50-100,1907,0.9034903061181376
STAT,1926,15,40-44,1941,1.6275317083168255
STAT,1860,32,30-34,1892,13.38304231638035
STAT,1830,25,20-24,1855,14.343811824526203
STAT,1856,56,na,1912,1503.3689506129951
STAT,1930,18,35-39,1948,5.1113973680740665
SIM,1873,42,50-100,1915,1
STAT,1867,1,na,1868,3163.5566780350277
SIM,1913,29,30-34,1942,46
SIM,1873,56,na,1929,1974
STAT,1906,30,15-19,1936,0.11341268804390053
SIM,1858,37,35-39,1895,12
SIM,1869,28,20-24,1897,12
SIM,1867,20,15-19,1887,3
STAT,1884,50,30-34,1934,0.005635474606445325
SIM,1849,27,40-44,1876,3
SIM,1886,38,25-29,1924,1
STAT,1847,38,20-24,1885,0.583678616136665
SIM,1936,22,15-19,1958,4
STAT,1861,40,35-39,1901,1.4367231793596418
STAT,1810,51,35-39,1861,0.02801641886798729
SIM,1930,27,40-44,1957,5
STAT,1935,19,15-19,1954,58.29583515744694
SIM,1908,59,na,1967,2882
STAT,1838,41,50-100,1879,0.8401653783118962
STAT,1913,15,30-34,1928,2.3652986397851765
SIM,1832,28,25-29,1860,40
STAT,1861,16,35-39,1877,0.4983243581876075
STAT,1820,43,na,1863,1415.6727154088244
STAT,1821,47,15-19,1868,6.309770834936213E-4
STAT,1851,20,20-24,1871,60.057630643638845
STAT,1813,95,na,1908,5.47173441441084
SIM,1846,41,50-100,1887,1
SIM,1870,28,45-49,1898,5
STAT,1848,6,na,1854,2298.0
SIM,1836,40,40-44,1876,6
STAT,1900,2,na,1902,3493.3592632100504
STAT,1911,25,15-19,1936,0.654816691641777
STAT,1825,30,20-24,1855,5.954129937059585
SIM,1916,21,35-39,1937,12
SIM,1817,91,na,1908,17
STAT,1862,28,45-49,1890,0.8936556309055776
STAT,1886,26,40-44,1912,2.9995628459185086
STAT,1837,23,40-44,1860,1.7576941564556436
STAT,1834,94,na,1928,12.390766953784674
STAT,1856,41,na,1897,1711.2717368295716
STAT,1866,34,na,1900,2061.442038452378
SIM,1914,25,40-44,1939,3
STAT,1954,18,20-24,1972,158.27045651443294
STAT,1851,26,50-100,1877,0.5426777596119469
STAT,1895,31,40-44,1926,5.362921489226572
STAT,1841,52,25-29,1893,0.0024289064013533605
STAT,1919,17,15-19,1936,47.378567083987235
STAT,1876,18,na,1894,2458.54539356751
STAT,1934,17,40-44,1951,1.7872646383418407
SIM,1927,17,15-19,1944,50
STAT,1870,52,45-49,1922,0.013377944668728606
STAT,1828,40,40-44,1868,1.9719507037907769
STAT,1853,45,45-49,1898,0.18038449048195868
STAT,1890,29,35-39,1919,11.064532961271828
STAT,1891,19,25-29,1910,6.587647202076287
SIM,1866,30,25-29,1896,12
SIM,1850,44,30-34,1894,3
STAT,1875,46,35-39,1921,0.1363280190854322
STAT,1897,44,20-24,1941,0.013744894528719073
STAT,1849,71,na,1920,1000.92427043171
STAT,1865,26,20-24,1891,10.079717616637412
SIM,1943,19,15-19,1962,36
SIM,1871,49,na,1920,2101
STAT,1892,21,20-24,1913,81.78690858092112
SIM,1887,70,na,1957,1518
SIM,1891,37,50-100,1928,1
SIM,1942,28,20-24,1970,20
STAT,1825,49,50-100,1874,0.24369182858622326
SIM,1858,89,na,1947,71
STAT,1888,39,20-24,1927,0.8519511792693272
SIM,1927,39,35-39,1966,6
STAT,1906,48,na,1954,3057.2369289312846
STAT,1908,27,40-44,1935,4.197960029485214
STAT,1923,15,15-19,1938,50.57687680856166
SIM,1840,21,15-19,1861,2
STAT,1854,49,na,1903,1576.1174993333289
STAT,1899,20,45-49,1919,0.9080004314552024
STAT,1859,15,40-44,1874,0.161532727647283
STAT,1762,113,na,1875,2.2672993348555996E-4
STAT,1894,46,45-49,1940,0.1620775662345538
SIM,1873,29,25-29,1902,42
SIM,1931,15,15-19,1946,54
SIM,1940,20,15-19,1960,2
STAT,1819,46,20-24,1865,0.023086923178326564
STAT,1904,39,40-44,1943,1.26743313294917
STAT,1928,22,15-19,1950,6.278529114037775
SIM,1834,76,na,1910,548
SIM,1894,26,40-44,1920,7
STAT,1816,91,na,1907,27.00378041452739
STAT,1892,66,na,1958,2013.0174161145285
STAT,1927,21,45-49,1948,1.3135333291530515
SIM,1833,49,50-100,1882,1
STAT,1863,24,20-24,1887,57.434454130402884
STAT,1886,37,20-24,1923,0.7692381139817105
STAT,1883,37,50-100,1920,1.1371517596487197
STAT,1864,39,35-39,1903,5.895263855183123
SIM,1899,33,40-44,1932,5
STAT,1910,23,40-44,1933,2.973812258833976
STAT,1919,39,35-39,1958,2.4495468491628993
SIM,1923,48,na,1971,4116
STAT,1853,25,50-100,1878,0.5689686627377327
STAT,1855,93,na,1948,20.7683444349175
SIM,1916,27,40-44,1943,6
STAT,1841,26,35-39,1867,8.321963642046178
SIM,1852,57,na,1909,1516
SIM,1932,29,40-44,1961,10
SIM,1938,24,15-19,1962,3
SIM,1798,97,na,1895,2
SIM,1888,20,35-39,1908,7
STAT,1858,30,25-29,1888,7.745707039532897
STAT,1884,24,40-44,1908,1.9326867831776169
SIM,1825,33,40-44,1858,3
SIM,1832,80,na,1912,347
SIM,1938,25,na,1963,3364
STAT,1869,41,40-44,1910,2.0678278043060137
SIM,1830,26,25-29,1856,40
STAT,1934,28,20-24,1962,23.186721039630605
SIM,1827,35,40-44,1862,6
STAT,1848,49,50-100,1897,0.17868469321511732
SIM,1905,20,20-24,1925,89
SIM,1861,25,50-100,1886,2
SIM,1917,26,na,1943,3675
STAT,1834,72,na,1906,782.9568498394729
STAT,1836,31,35-39,1867,8.375929371946308
STAT,1859,20,15-19,1879,2.869194303465144
SIM,1917,27,50-100,1944,4
STAT,1870,20,30-34,1890,16.606228957193395
STAT,1929,34,25-29,1963,11.076191134279748
SIM,1820,35,50-100,1855,2
STAT,1880,40,45-49,1920,1.5055963782421193
SIM,1870,32,40-44,1902,4
STAT,1838,60,na,1898,1280.385367080195
SIM,1848,15,30-34,1863,1
SIM,1873,26,20-24,1899,12
SIM,1888,55,na,1943,2347
STAT,1869,48,na,1917,2033.1587501191486
STAT,1843,28,35-39,1871,7.963157846736854
STAT,1912,36,20-24,1948,0.24423590440764373
SIM,1892,24,40-44,1916,2
SIM,1844,31,35-39,1875,14
SIM,1849,53,na,1902,1614
STAT,1840,103,na,1943,0.09418283118776323
STAT,1907,42,25-29,1949,0.06180633887782766
SIM,1851,28,35-39,1879,7
STAT,1842,44,30-34,1886,0.8395921130674622
STAT,1951,20,25-29,1971,104.32661640556452
SIM,1861,71,na,1932,1115
STAT,1870,23,35-39,1893,5.391385990622676
SIM,1928,38,40-44,1966,1
STAT,1831,28,30-34,1859,21.09201879629444
STAT,1911,32,35-39,1943,8.406783542900811
STAT,1914,33,15-19,1947,0.12168627580302466
SIM,1916,22,35-39,1938,9
STAT,1873,24,15-19,1897,3.1410552375792404
SIM,1898,64,na,1962,2346
STAT,1860,18,na,1878,2017.2906895865026
STAT,1801,82,na,1883,163.31971354798443
SIM,1840,43,50-100,1883,1
STAT,1828,32,40-44,1860,4.499632734074141
SIM,1847,52,50-100,1899,1
STAT,1871,37,15-19,1908,0.052677038901146694
STAT,1849,22,30-34,1871,16.148846377705027
STAT,1833,49,45-49,1882,0.15044452943446035
STAT,1881,21,45-49,1902,0.6383014876112629
STAT,1759,98,na,1857,0.22942324125223196
STAT,1857,41,20-24,1898,0.11886078945615378
STAT,1863,38,na,1901,1943.458210074816
STAT,1946,26,15-19,1972,0.743237922365484
SIM,1939,17,35-39,1956,5
STAT,1889,26,20-24,1915,13.728814672122354
STAT,1958,5,na,1963,4877.46163372359
SIM,1897,26,20-24,1923,15
STAT,1923,48,40-44,1971,0.1737510636701538
STAT,1929,9,na,1938,4799.2701585187415
STAT,1793,109,na,1902,1.1800366836041236E-4
SIM,1876,49,na,1925,2140
STAT,1927,42,40-44,1969,0.29633843067706106
STAT,1889,4,na,1893,3068.0523756369867
SIM,1848,26,25-29,1874,35
SIM,1869,51,na,1920,1973
STAT,1838,36,15-19,1874,0.04596602759570078
SIM,1817,38,na,1855,1522
SIM,1895,30,50-100,1925,1
SIM,1922,47,na,1969,3976
STAT,1860,93,na,1953,22.4015470277996
STAT,1782,112,na,1894,1.0100809191863967E-4
STAT,1932,33,35-39,1965,11.469070230487189
SIM,1940,17,30-34,1957,15
STAT,1861,22,50-100,1883,0.32907116648099327
STAT,1813,44,15-19,1857,0.03979993825631824
STAT,1898,24,20-24,1922,87.5475678043603
SIM,1849,46,50-100,1895,3
SIM,1875,91,na,1966,173
STAT,1936,35,45-49,1971,0.6333215977543722
SIM,1862,22,40-44,1884,1
SIM,1839,53,na,1892,1447
STAT,1887,40,na,1927,2466.893958650667
SIM,1876,20,15-19,1896,3
STAT,1863,20,40-44,1883,1.7875176439817606
STAT,1920,30,35-39,1950,9.531990837123478
SIM,1859,30,40-44,1889,4
STAT,1932,17,30-34,1949,15.24702887676392
SIM,1886,79,na,1965,932
STAT,1859,21,na,1880,1846.199607628363
SIM,1826,74,na,1900,572
STAT,1883,52,30-34,1935,0.005483980621918968
STAT,1856,88,na,1944,101.18868654169421
STAT,1846,23,45-49,1869,0.6335788412620947
STAT,1854,40,40-44,1894,1.6255618286527818
STAT,1906,27,30-34,1933,34.64787173025624
SIM,1914,28,na,1942,3570
STAT,1905,35,15-19,1940,0.0167076136922462
STAT,1875,53,35-39,1928,0.008225301683857648
SIM,1839,33,20-24,1872,3
STAT,1868,20,15-19,1888,3.016713784926415
SIM,1903,40,na,1943,3163
STAT,1850,16,50-100,1866,0.04245189764687098
SIM,1833,30,20-24,1863,4
SIM,1871,20,40-44,1891,2
STAT,1839,17,na,1856,1999.2402910480082
SIM,1889,27,25-29,1916,55
STAT,1857,23,20-24,1880,58.84812351626567
STAT,1844,49,20-24,1893,0.00816027104779833
STAT,1846,41,45-49,1887,1.13798884023116
STAT,1854,22,40-44,1876,1.7517950671489555
STAT,1950,15,25-29,1965,48.43286018799638
SIM,1822,40,50-100,1862,1
STAT,1837,25,45-49,1862,0.9383082559957877
STAT,1847,36,na,1883,1821.3558248883178
SIM,1912,19,20-24,1931,22
SIM,1922,15,15-19,1937,44
SIM,1899,18,na,1917,3329
SIM,1830,95,na,1925,10
STAT,1843,22,na,1865,1812.755711781404
STAT,1851,41,na,1892,1670.096803751192
STAT,1916,21,30-34,1937,28.537172502392973
STAT,1940,23,15-19,1963,5.121086017841854
STAT,1906,64,na,1970,2700.484443876758
SIM,1845,30,40-44,1875,6
SIM,1864,20,na,1884,2123
SIM,1953,15,na,1968,4173
STAT,1839,72,na,1911,840.8332061279262
SIM,1793,82,na,1875,137
SIM,1906,32,20-24,1938,1
SIM,1905,38,45-49,1943,1
SIM,1865,23,20-24,1888,54
STAT,1880,35,15-19,1915,0.056457424422549314
STAT,1904,19,20-24,1923,23.894328651540153
STAT,1914,15,15-19,1929,8.91009975950453
STAT,1937,28,15-19,1965,0.6497886014796869
SIM,1907,24,35-39,1931,7
STAT,1850,46,40-44,1896,0.12102552441325892
STAT,1899,16,35-39,1915,0.7119949765012638
STAT,1900,48,45-49,1948,0.1722670581985955
STAT,1927,10,na,1937,4668.139376199717
STAT,1945,23,50-100,1968,0.6810443884164766
SIM,1930,19,40-44,1949,1
STAT,1833,54,40-44,1887,0.0063984449269863936
STAT,1874,17,50-100,1891,0.04728810782627306
STAT,1887,24,45-49,1911,0.7322359559607834
SIM,1857,22,30-34,1879,18
STAT,1822,44,na,1866,1365.7090328812462
SIM,1843,58,na,1901,1380
STAT,1922,37,40-44,1959,1.609172698931968
SIM,1893,17,na,1910,3157
STAT,1766,115,na,1881,1.5736078779931992E-4
STAT,1901,17,na,1918,3339.714655560126
SIM,1874,31,20-24,1905,2
SIM,1940,24,20-24,1964,103
STAT,1914,42,30-34,1956,0.11967721678546872
SIM,1873,18,30-34,1891,2
SIM,1924,21,30-34,1945,38
STAT,1866,0,na,1866,3307.063074508667
SIM,1858,20,na,1878,2020
STAT,1922,19,40-44,1941,1.5210242208552713
STAT,1913,46,na,1959,3396.016373339826
STAT,1865,18,30-34,1883,1.3980937503054254
STAT,1915,49,45-49,1964,0.20568313209521571
SIM,1880,54,na,1934,2104
STAT,1837,30,40-44,1867,3.602918472603217
SIM,1855,87,na,1942,95
SIM,1899,21,25-29,1920,101
SIM,1856,0,na,1856,3030
SIM,1789,77,na,1866,277
SIM,1884,68,na,1952,1458
STAT,1872,29,30-34,1901,23.691250762985725
SIM,1819,92,na,1911,17
STAT,1894,48,20-24,1942,0.008114642145802207
STAT,1942,27,na,1969,3714.376294898082
STAT,1798,61,na,1859,945.2063919448511
STAT,1868,85,na,1953,247.08890699653332
STAT,1932,24,20-24,1956,137.35292212061853
SIM,1925,1,na,1926,4660
STAT,1923,3,na,1926,4499.328854065507
SIM,1898,23,30-34,1921,24
SIM,1877,33,40-44,1910,3
STAT,1860,52,35-39,1912,0.006563797687921608
STAT,1945,15,15-19,1960,46.85860636082931
SIM,1880,29,30-34,1909,24
SIM,1886,41,40-44,1927,7
STAT,1924,25,25-29,1949,72.88782805625753
SIM,1787,98,na,1885,1
SIM,1821,75,na,1896,594
STAT,1880,15,45-49,1895,0.06535922404469463
STAT,1866,48,45-49,1914,0.20304806020202718
STAT,1839,28,30-34,1867,20.96982419129483
STAT,1889,19,30-34,1908,1.8488893171280805
STAT,1891,7,na,1898,3045.0914200126704
STAT,1866,50,na,1916,1903.061272328571
STAT,1898,5,na,1903,3350.2756628941765
STAT,1904,24,45-49,1928,0.9389947583839376
SIM,1900,9,na,1909,3458
STAT,1863,15,45-49,1878,0.06252863954199862
SIM,1846,94,na,1940,10
SIM,1842,80,na,1922,364
SIM,1880,31,50-100,1911,1
STAT,1842,51,30-34,1893,0.004331356133829295
SIM,1829,39,na,1868,1504
STAT,1895,41,40-44,1936,0.19323915507861253
STAT,1841,27,na,1868,1852.3713958590752
STAT,1865,25,20-24,1890,10.113395222729102
SIM,1832,74,na,1906,617
SIM,1847,28,30-34,1875,29
SIM,1873,72,na,1945,1171
SIM,1912,24,45-49,1936,2
SIM,1904,17,20-24,1921,20
STAT,1854,105,na,1959,0.046527210906054495
STAT,1869,33,40-44,1902,3.952168355965299
SIM,1953,15,15-19,1968,40
SIM,1828,33,45-49,1861,3
STAT,1922,41,25-29,1963,0.07754209533917188
STAT,1936,21,50-100,1957,0.5944637304136199
SIM,1852,33,35-39,1885,14
STAT,1878,41,40-44,1919,2.2244782991906593
STAT,1914,38,45-49,1952,0.6398377413231711
SIM,1830,48,50-100,1878,1
SIM,1799,83,na,1882,128
STAT,1816,44,na,1860,1422.9852588203155
STAT,1869,18,15-19,1887,5.474014460761611
SIM,1877,86,na,1963,401
STAT,1887,42,45-49,1929,1.579529121342779
STAT,1872,19,na,1891,2380.3726509075395
STAT,1874,18,25-29,1892,5.455328402828533
STAT,1821,39,25-29,1860,5.431748894186979
SIM,1936,15,15-19,1951,31
STAT,1788,95,na,1883,2.342435294714363
SIM,1846,23,na,1869,1850
STAT,1778,102,na,1880,0.0771196351374758
STAT,1848,25,20-24,1873,10.557692719721159
SIM,1952,9,na,1961,4388
SIM,1869,67,na,1936,1414
STAT,1877,20,40-44,1897,2.0541801995045876
SIM,1873,25,na,1898,2306
SIM,1896,69,na,1965,2104
STAT,1919,43,45-49,1962,0.1701129434218828
STAT,1928,15,15-19,1943,54.27125573282924
STAT,1844,33,35-39,1877,8.323991391616525
STAT,1881,55,na,1936,1887.0088413212418
SIM,1820,89,na,1909,49
STAT,1830,36,15-19,1866,0.04626794052088864
STAT,1840,20,45-49,1860,0.5904076330199705
STAT,1940,28,45-49,1968,1.663457850554199
SIM,1823,38,na,1861,1476
STAT,1874,23,20-24,1897,66.31041750348048
STAT,1905,9,na,1914,3542.9569464381134
SIM,1911,30,35-39,1941,9
STAT,1891,47,40-44,1938,0.11234423201379036
SIM,1921,22,45-49,1943,2
STAT,1858,15,35-39,1873,0.48039340560744503
SIM,1877,18,15-19,1895,6
SIM,1878,42,45-49,1920,1
STAT,1881,30,50-100,1911,0.8428929141821467
STAT,1765,98,na,1863,0.383136809483018
STAT,1874,47,40-44,1921,0.16447585975943893
SIM,1941,14,na,1955,3752
STAT,1919,25,15-19,1944,0.7254791385629965
SIM,1831,42,50-100,1873,3
STAT,1846,54,50-100,1900,0.010893725604943592
SIM,1907,7,na,1914,3615
STAT,1875,15,35-39,1890,0.5352801169562551
SIM,1939,32,30-34,1971,24
STAT,1923,35,35-39,1958,2.6521283691407076
SIM,1856,25,20-24,1881,13
SIM,1931,35,35-39,1966,5
STAT,1913,43,25-29,1956,0.06568438773826887
STAT,1828,50,40-44,1878,0.00856453353225192
STAT,1903,49,25-29,1952,0.04276125372497857
SIM,1867,72,na,1939,1162
STAT,1913,22,45-49,1935,1.0300379254885603
STAT,1954,12,na,1966,4587.177729445267
SIM,1919,9,na,1928,4220
STAT,1850,44,50-100,1894,0.7346653499428343
SIM,1884,4,na,1888,2574
STAT,1890,32,na,1922,2756.1076926155115
SIM,1883,15,35-39,1898,1
STAT,1923,40,30-34,1963,0.14155155461456218
STAT,1839,35,20-24,1874,0.6261862528680663
STAT,1786,76,na,1862,333.210983403363
SIM,1841,54,50-100,1895,1
SIM,1885,35,50-100,1920,1
SIM,1897,19,30-34,1916,3
STAT,1859,32,40-44,1891,3.2607360302312176
STAT,1870,24,na,1894,2178.1142154936138
STAT,1895,46,15-19,1941,2.786784390298664E-4
SIM,1905,51,na,1956,2917
SIM,1932,25,25-29,1957,90
SIM,1837,58,na,1895,1262
STAT,1920,49,25-29,1969,0.055068810615502777
SIM,1909,13,na,1922,3666
SIM,1838,75,na,1913,637
STAT,1875,55,na,1930,2007.7802111427577
SIM,1931,28,45-49,1959,1
STAT,1831,30,45-49,1861,1.4276460506202329
STAT,1923,28,45-49,1951,1.8671722420079087
SIM,1836,32,40-44,1868,2
STAT,1834,52,35-39,1886,0.005478219604822483
SIM,1867,32,40-44,1899,5
STAT,1859,92,na,1951,31.315799484311928
STAT,1794,95,na,1889,2.641935179802631
STAT,1908,22,35-39,1930,8.177796533611456
STAT,1930,22,45-49,1952,1.3616748917198216
SIM,1852,35,na,1887,1849
STAT,1895,23,40-44,1918,2.558486027814949
STAT,1866,19,na,1885,2232.2222727013877
STAT,1850,63,na,1913,1257.7977887545965
STAT,1864,26,15-19,1890,0.38331567582713094
SIM,1901,27,20-24,1928,19
STAT,1900,38,45-49,1938,0.561082554955737
SIM,1917,32,na,1949,3730
SIM,1857,66,na,1923,1230
SIM,1889,71,na,1960,1677
SIM,1884,48,50-100,1932,5
STAT,1807,71,na,1878,653.7398641305348
STAT,1870,23,50-100,1893,0.37675657733392004
SIM,1845,40,40-44,1885,6
STAT,1864,108,na,1972,0.02988520297170344
SIM,1853,52,na,1905,1624
STAT,1882,48,30-34,1930,0.08781421804507758
STAT,1856,29,na,1885,1796.7007754419749
STAT,1914,29,30-34,1943,37.04964307304571
STAT,1910,27,20-24,1937,16.652541875048115
STAT,1889,29,25-29,1918,48.981636784310865
STAT,1875,50,30-34,1925,0.005863074112450392
STAT,1853,23,35-39,1876,5.180542139816968
SIM,1840,23,15-19,1863,1
SIM,1923,33,35-39,1956,14
SIM,1817,97,na,1914,3
STAT,1917,46,15-19,1963,3.643934315003076E-4
STAT,1837,52,50-100,1889,0.009837386701167261
STAT,1929,26,15-19,1955,0.8350017025690851
STAT,1904,32,45-49,1936,1.3568217151200943
STAT,1845,47,15-19,1892,2.817316981500971E-4
STAT,1949,23,35-39,1972,10.37648159253103
SIM,1888,29,30-34,1917,34
STAT,1931,27,40-44,1958,5.684705040367958
SIM,1818,55,na,1873,1147
SIM,1912,32,45-49,1944,1
STAT,1849,25,35-39,1874,8.701418557791165
STAT,1883,31,20-24,1914,2.513840472862531
SIM,1902,32,35-39,1934,19
STAT,1797,102,na,1899,0.07194197289676765
SIM,1902,1,na,1903,3565
STAT,1921,44,15-19,1965,0.0016285723595810186
SIM,1858,48,50-100,1906,4
STAT,1885,23,50-100,1908,0.38280667762695386
STAT,1816,40,20-24,1856,0.4695707628300994
SIM,1861,23,35-39,1884,9
STAT,1828,35,45-49,1863,1.9044525192728887
STAT,1905,19,40-44,1924,0.24841372615462118
SIM,1853,80,na,1933,430
STAT,1907,31,30-34,1938,13.969339051886168
STAT,1906,40,30-34,1946,0.11095410466263869
STAT,1892,67,na,1959,1974.5687834667408
STAT,1840,49,50-100,1889,0.15842224351525583
SIM,1903,34,45-49,1937,2
STAT,1824,52,50-100,1876,0.017723737786655466
SIM,1924,24,35-39,1948,11
STAT,1868,14,na,1882,2385.5275331388934
STAT,1845,72,na,1917,893.6608569841311
STAT,1855,36,15-19,1891,0.04009699430381304
STAT,1854,43,45-49,1897,1.063088241826563
STAT,1881,19,30-34,1900,1.4467750250857556
STAT,1836,47,20-24,1883,0.00813238172202393
STAT,1915,33,35-39,1948,8.755412378227078
STAT,1833,56,na,1889,1257.6230787148895
STAT,1873,84,na,1957,372.5973275912979
STAT,1870,4,na,1874,2740.3651191296444
STAT,1887,16,45-49,1903,0.0691947925834715
SIM,1881,7,na,1888,2035
STAT,1833,46,40-44,1879,0.12462890373997586
STAT,1878,23,40-44,1901,2.0452134294967377
STAT,1930,40,20-24,1970,0.02201193321364213
SIM,1920,31,40-44,1951,8
SIM,1915,31,30-34,1946,17
SIM,1886,23,40-44,1909,2
STAT,1830,36,50-100,1866,1.0115852989875544
STAT,1913,25,25-29,1938,62.37931332180731
SIM,1919,28,20-24,1947,26
SIM,1893,5,na,1898,3287
SIM,1918,47,50-100,1965,1
STAT,1824,79,na,1903,385.47745177202233
STAT,1860,28,50-100,1888,0.49202584602954824
SIM,1950,8,na,1958,4260
STAT,1892,38,45-49,1930,2.3470941517148844
SIM,1817,42,na,1859,1460
STAT,1842,44,40-44,1886,1.642625412507622
SIM,1841,95,na,1936,3
SIM,1894,34,na,1928,2946
SIM,1921,25,25-29,1946,69
STAT,1955,16,15-19,1971,56.92441529046512
STAT,1910,53,na,1963,3169.304787718495
SIM,1850,44,40-44,1894,6
STAT,1868,69,na,1937,1322.7586586929797
STAT,1864,55,na,1919,1740.956477008196
SIM,1892,9,na,1901,3406
STAT,1825,47,45-49,1872,0.24074099674598004
STAT,1877,48,20-24,1925,0.011611461293052386
SIM,1856,28,25-29,1884,42
SIM,1931,32,30-34,1963,21
STAT,1854,18,na,1872,1953.0761430644216
SIM,1834,38,na,1872,1605
STAT,1902,42,35-39,1944,0.16744294810749513
STAT,1874,15,20-24,1889,17.255656560617847
SIM,1941,30,na,1971,3694
STAT,1916,24,35-39,1940,9.262568622892786
STAT,1933,21,30-34,1954,36.12403277506502
STAT,1852,51,50-100,1903,0.01100167402884203
SIM,1856,18,30-34,1874,1
STAT,1773,97,na,1870,0.7726195601169994
SIM,1849,30,25-29,1879,14
SIM,1904,22,45-49,1926,1
STAT,1827,33,35-39,1860,11.65554031963509
STAT,1830,29,25-29,1859,38.12501222611492
SIM,1900,48,na,1948,2970
SIM,1930,14,na,1944,4862
SIM,1879,38,50-100,1917,1
SIM,1871,77,na,1948,725
SIM,1891,31,20-24,1922,2
SIM,1941,21,30-34,1962,35
SIM,1907,21,30-34,1928,30
SIM,1913,27,40-44,1940,6
STAT,1848,18,30-34,1866,1.4595142224593578
STAT,1815,90,na,1905,35.19121851334491
SIM,1830,24,na,1854,1748
SIM,1882,49,na,1931,2074
STAT,1894,24,35-39,1918,7.040210866811509
STAT,1939,33,20-24,1972,2.3496391324327193
STAT,1827,91,na,1918,33.47249726359077
STAT,1918,45,na,1963,3710.6915024859463
SIM,1884,25,50-100,1909,1
SIM,1882,15,20-24,1897,18
SIM,1936,33,45-49,1969,2
SIM,1805,57,na,1862,1054
STAT,1905,45,40-44,1950,0.1331818971946176
STAT,1816,54,40-44,1870,0.022873840898194824
SIM,1885,20,40-44,1905,3
STAT,1880,38,na,1918,2334.76165284215
STAT,1822,38,30-34,1860,8.883949657440649
STAT,1829,46,15-19,1875,3.312551368078474E-4
SIM,1829,38,50-100,1867,1
SIM,1905,47,50-100,1952,1
SIM,1835,23,na,1858,1750
SIM,1835,33,35-39,1868,11
STAT,1925,15,50-100,1940,0.42952705540453967
STAT,1835,105,na,1940,0.018661902850769754
STAT,1841,47,30-34,1888,0.06703761081017641
STAT,1941,23,35-39,1964,9.189399428217643
SIM,1862,25,45-49,1887,3
SIM,1875,20,na,1895,2312
STAT,1870,39,20-24,1909,0.7072028589515328
SIM,1921,18,35-39,1939,2
SIM,1857,25,35-39,1882,8
SIM,1787,82,na,1869,120
STAT,1897,66,na,1963,2256.0959636988255
STAT,1885,85,na,1970,554.7978504987154
STAT,1928,33,45-49,1961,1.8575680984860543
STAT,1845,41,na,1886,1686.9345440257084
STAT,1883,45,40-44,1928,0.16014858061198178
STAT,1854,25,45-49,1879,0.928444707872098
SIM,1878,27,50-100,1905,1
STAT,1819,104,na,1923,0.03521061348242015
STAT,1911,48,20-24,1959,0.009856383024453281
STAT,1832,23,15-19,1855,3.115297416936283
SIM,1868,32,35-39,1900,18
STAT,1888,27,15-19,1915,0.5065353911170867
STAT,1893,52,na,1945,2565.8924690134645
STAT,1886,48,15-19,1934,3.9414831288996945E-4
SIM,1905,35,40-44,1940,1
SIM,1837,39,30-34,1876,7
SIM,1864,52,na,1916,1907
STAT,1821,36,20-24,1857,1.714179564176636
STAT,1900,22,35-39,1922,7.647422710254294
STAT,1835,48,50-100,1883,0.16266984518788835
STAT,1875,23,na,1898,2289.4007223415842
STAT,1896,37,15-19,1933,0.07006322913763326
SIM,1921,29,40-44,1950,6
STAT,1825,54,35-39,1879,0.008133639628020262
STAT,1921,24,45-49,1945,1.1930594316069854
STAT,1875,28,50-100,1903,0.6189642447861163
SIM,1840,15,15-19,1855,8
STAT,1844,21,40-44,1865,1.8200597117294477
SIM,1860,4,na,1864,2441
STAT,1904,53,na,1957,2906.370219366292
STAT,1922,17,15-19,1939,49.617892307673436
STAT,1914,25,15-19,1939,0.6768903529267032
SIM,1851,41,na,1892,1731
STAT,1886,22,35-39,1908,5.823286192798358
SIM,1865,27,50-100,1892,1
SIM,1913,37,40-44,1950,1
SIM,1944,17,15-19,1961,36
STAT,1911,38,20-24,1949,0.23934655258107013
STAT,1892,45,35-39,1937,0.09437482948542733
SIM,1842,64,na,1906,1122
SIM,1830,38,30-34,1868,5
STAT,1906,34,20-24,1940,2.117251775145438
SIM,1928,32,na,1960,4462
SIM,1898,35,50-100,1933,2
STAT,1937,18,20-24,1955,124.2721735832631
SIM,1945,18,20-24,1963,134
STAT,1931,35,40-44,1966,1.8761298914538884
SIM,1852,21,40-44,1873,1
STAT,1905,27,40-44,1932,4.0904257141915705
SIM,1848,18,25-29,1866,4
STAT,1870,24,50-100,1894,0.3755584914179982
STAT,1804,59,na,1863,1010.7139712052584
SIM,1827,31,35-39,1858,5
STAT,1874,38,na,1912,2262.7650379471434
SIM,1832,24,20-24,1856,53
STAT,1878,31,40-44,1909,4.287034962028004
SIM,1894,22,35-39,1916,7
STAT,1829,39,30-34,1868,4.657829328336574
STAT,1955,8,na,1963,4928.170748773647
SIM,1852,67,na,1919,1171
SIM,1908,23,40-44,1931,2
STAT,1848,28,25-29,1876,37.25493268076278
STAT,1857,42,na,1899,1719.8945073420655
SIM,1833,60,na,1893,1137
SIM,1849,23,35-39,1872,10
STAT,1797,76,na,1873,378.91209639223536
STAT,1876,49,na,1925,2150.0076073042405
STAT,1913,29,40-44,1942,4.356248507229947
STAT,1850,108,na,1958,0.0024850108853089518
SIM,1877,36,45-49,1913,2
STAT,1924,22,20-24,1946,123.94868122050552
STAT,1903,46,20-24,1949,0.009124398578539946
STAT,1913,47,40-44,1960,0.14538039713769915
SIM,1916,47,na,1963,3473
SIM,1863,35,na,1898,1983
STAT,1927,26,na,1953,4317.048646667639
STAT,1879,85,na,1964,485.62345211835316
SIM,1898,26,35-39,1924,13
STAT,1898,42,20-24,1940,0.014081440527837717
SIM,1912,33,na,1945,3451
STAT,1869,36,45-49,1905,1.8331990245956171
SIM,1861,87,na,1948,128
STAT,1904,21,40-44,1925,2.83220343359467
SIM,1841,17,25-29,1858,3
STAT,1909,43,35-39,1952,0.1768684168244681
SIM,1912,21,40-44,1933,5
STAT,1785,82,na,1867,164.83403759681056
STAT,1925,38,20-24,1963,0.29858142559923534
STAT,1888,35,15-19,1923,0.06328906959044664
SIM,1914,27,30-34,1941,46
STAT,1912,31,40-44,1943,3.652717161476605
STAT,1945,22,50-100,1967,0.6812692072548708
SIM,1778,77,na,1855,279
STAT,1868,34,35-39,1902,9.049801218415391
STAT,1923,32,30-34,1955,17.06261475255504
SIM,1932,22,20-24,1954,119
STAT,1905,37,40-44,1942,1.2901812667206525
SIM,1934,32,na,1966,4779
STAT,1949,21,50-100,1970,0.725599907559097
STAT,1840,25,15-19,1865,0.3766345598866846
SIM,1853,21,35-39,1874,6
STAT,1886,23,na,1909,2352.813848161369
SIM,1889,19,25-29,1908,9
STAT,1919,40,40-44,1959,0.25677529477109845
STAT,1868,15,45-49,1883,0.060656386869082556
STAT,1851,44,35-39,1895,1.2850135415343558
STAT,1931,17,40-44,1948,1.7294973242101255
SIM,1836,35,45-49,1871,1
STAT,1837,49,30-34,1886,0.06356501796088382
SIM,1904,66,na,1970,2593
STAT,1810,59,na,1869,999.9104603753185
SIM,1830,79,na,1909,405
STAT,1923,25,40-44,1948,5.0896658388553275
STAT,1834,73,na,1907,736.3709172740242
STAT,1866,26,50-100,1892,0.5592903889451911
SIM,1876,34,35-39,1910,11
SIM,1901,17,na,1918,3332
STAT,1876,40,na,1916,2278.5427438522315
STAT,1936,17,15-19,1953,41.04560834695246
STAT,1847,34,15-19,1881,0.10989507198802549
STAT,1885,22,40-44,1907,1.9622051944077021
STAT,1851,37,45-49,1888,1.4493571069108955
STAT,1923,43,35-39,1966,0.2219858765291105
STAT,1860,42,35-39,1902,1.3862974198766789
STAT,1867,20,25-29,1887,51.73070962769526
SIM,1850,30,20-24,1880,2
STAT,1922,35,15-19,1957,0.020678208967269497
SIM,1931,25,40-44,1956,10
STAT,1903,28,20-24,1931,15.71335028777284
STAT,1934,5,na,1939,5137.704733645504
STAT,1895,26,45-49,1921,1.3721406016703699
STAT,1928,36,25-29,1964,1.1765607597013927
SIM,1911,28,20-24,1939,19
STAT,1939,11,na,1950,3744.258647720902
SIM,1927,40,40-44,1967,2
SIM,1882,33,na,1915,2263
STAT,1897,70,na,1967,2064.3762502176282
STAT,1905,35,50-100,1940,0.36528914410203794
SIM,1812,98,na,1910,1
SIM,1874,16,25-29,1890,6
STAT,1899,34,50-100,1933,1.175836726008795
SIM,1869,16,15-19,1885,6
SIM,1889,12,na,1901,3133
SIM,1914,34,20-24,1948,2
SIM,1886,31,40-44,1917,6
SIM,1819,40,40-44,1859,5
SIM,1871,61,na,1932,1749
SIM,1826,31,40-44,1857,4
SIM,1847,24,15-19,1871,2
SIM,1871,30,40-44,1901,4
STAT,1852,50,35-39,1902,0.006331141866841536
STAT,1920,22,35-39,1942,9.888850148427906
SIM,1888,34,na,1922,2666
SIM,1875,20,25-29,1895,60
STAT,1842,30,20-24,1872,2.4143399037842577
STAT,1828,53,45-49,1881,0.010123194163815154
STAT,1895,44,45-49,1939,0.12627200611454617
STAT,1908,6,na,1914,3660.9372686592646
SIM,1865,37,na,1902,2092
SIM,1930,17,15-19,1947,55
STAT,1840,73,na,1913,779.4717764954352
STAT,1840,18,30-34,1858,1.3462943192068095
STAT,1911,11,na,1922,3739.1462905361027
SIM,1897,29,25-29,1926,62
STAT,1866,16,25-29,1882,5.0980124076565465
STAT,1915,25,na,1940,3634.2309263708707
SIM,1843,48,50-100,1891,4
SIM,1798,98,na,1896,1
SIM,1931,6,na,1937,4933
STAT,1901,19,20-24,1920,23.31745786390742
STAT,1811,45,na,1856,1339.3522328085617
STAT,1833,40,20-24,1873,0.12113516311107858
SIM,1875,36,na,1911,2302
STAT,1894,20,40-44,1914,2.544941511975428
STAT,1909,25,35-39,1934,13.76315876955645
STAT,1924,31,30-34,1955,17.374253067781286
STAT,1813,42,45-49,1855,4.8953531167584154
SIM,1915,39,45-49,1954,3
SIM,1869,26,45-49,1895,2
STAT,1828,47,15-19,1875,3.2388593854057506E-4
STAT,1865,48,30-34,1913,0.08184509370599169
STAT,1942,22,35-39,1964,9.326592951022414
STAT,1858,50,30-34,1908,0.00447230149752434
STAT,1828,46,50-100,1874,0.20151032397679067
STAT,1859,22,40-44,1881,1.6256040846223692
SIM,1858,15,25-29,1873,8
STAT,1814,89,na,1903,48.28533268290443
SIM,1930,33,25-29,1963,16
STAT,1822,45,50-100,1867,0.3398845664077919
SIM,1904,25,25-29,1929,59
STAT,1886,54,na,1940,2089.6387138076557
STAT,1882,40,na,1922,2144.7970620989045
SIM,1858,24,40-44,1882,1
STAT,1865,33,20-24,1898,2.304770435016454
SIM,1884,13,na,1897,2526
STAT,1795,81,na,1876,216.25285635977139
STAT,1928,30,40-44,1958,4.6276852571322245
SIM,1853,21,na,1874,1918
STAT,1931,29,30-34,1960,47.740589759677675
STAT,1878,52,45-49,1930,0.014211709441048777
SIM,1864,35,20-24,1899,3
STAT,1869,26,15-19,1895,0.4166487163590518
STAT,1910,41,35-39,1951,0.18082426150036665
STAT,1935,33,35-39,1968,11.936177069098692
STAT,1825,44,40-44,1869,2.340512403345014
STAT,1821,37,50-100,1858,2.593479047392033
SIM,1836,40,na,1876,1583
STAT,1848,36,25-29,1884,2.2277169844856193
SIM,1857,35,na,1892,1870
STAT,1922,33,25-29,1955,9.823847177876377
STAT,1910,22,na,1932,3385.632305267668
STAT,1892,35,40-44,1927,5.228873636683429
SIM,1839,85,na,1924,177
STAT,1856,35,20-24,1891,0.5735716335817495
SIM,1852,63,na,1915,1338
SIM,1784,78,na,1862,246
SIM,1821,42,45-49,1863,2
STAT,1841,17,30-34,1858,1.4172054836589263
STAT,1916,41,50-100,1957,0.11389622392949031
SIM,1920,34,45-49,1954,2
STAT,1842,37,na,1879,1819.5076602903237
SIM,1900,43,40-44,1943,2
STAT,1829,55,na,1884,1293.986913762308
STAT,1905,48,45-49,1953,0.1794955361338215
SIM,1788,67,na,1855,696
SIM,1773,90,na,1863,20
STAT,1851,41,30-34,1892,0.8307477543491996
STAT,1895,38,15-19,1933,0.06881685219354206
STAT,1826,101,na,1927,0.31160778236020287
SIM,1844,23,35-39,1867,6
STAT,1852,48,20-24,1900,0.008590521700304037
SIM,1892,40,30-34,1932,4
SIM,1943,15,35-39,1958,4
STAT,1836,23,35-39,1859,4.951395080012172
SIM,1869,20,na,1889,2185
SIM,1936,30,40-44,1966,4
STAT,1861,48,50-100,1909,0.19049165032243648
SIM,1845,15,15-19,1860,6
STAT,1855,62,na,1917,1298.8345082234828
STAT,1915,35,25-29,1950,0.948587115101824
STAT,1861,49,20-24,1910,0.009229041601235194
SIM,1948,22,30-34,1970,39
STAT,1918,20,50-100,1938,0.6744243131625894
STAT,1845,35,45-49,1880,1.6629209765136548
STAT,1845,21,35-39,1866,5.163399732586474
STAT,1893,36,50-100,1929,1.4779491619656093
SIM,1900,20,30-34,1920,34
SIM,1840,78,na,1918,486
STAT,1853,76,na,1929,716.9914181434383
STAT,1915,19,50-100,1934,0.07368093803725202
SIM,1833,39,45-49,1872,3
STAT,1807,50,20-24,1857,0.002815241424990507
STAT,1831,23,50-100,1854,0.7461125360336552
STAT,1857,15,20-24,1872,15.70944851848842
STAT,1909,24,45-49,1933,0.9817668955779091
SIM,1886,1,na,1887,3024
SIM,1870,92,na,1962,67
SIM,1922,19,30-34,1941,16
STAT,1768,108,na,1876,0.0033943239042575077
SIM,1856,36,25-29,1892,2
SIM,1866,87,na,1953,132
SIM,1910,29,50-100,1939,1
SIM,1809,78,na,1887,316
STAT,1900,27,40-44,1927,3.9256998794573232
STAT,1859,40,40-44,1899,1.7082740955562312
STAT,1940,27,30-34,1967,37.74567896826616
SIM,1868,43,40-44,1911,6
SIM,1796,63,na,1859,877
STAT,1891,17,na,1908,2951.8810564796945
STAT,1916,48,20-24,1964,0.010678259261738168
STAT,1924,46,na,1970,4141.989660360817
STAT,1871,25,45-49,1896,1.048610783776011
STAT,1884,75,na,1959,1082.8288452222428
STAT,1924,36,40-44,1960,1.6690696693234666
STAT,1854,22,na,1876,1797.4593575016936
SIM,1899,25,40-44,1924,6
STAT,1844,23,50-100,1867,0.3510797677567267
SIM,1801,82,na,1883,142
STAT,1814,40,50-100,1854,3.9947261890200325
STAT,1943,16,45-49,1959,0.5005687228371166
STAT,1870,53,35-39,1923,0.007850438699102805
STAT,1869,54,45-49,1923,0.012916372752935725
STAT,1885,20,15-19,1905,3.1250399417905337
STAT,1914,19,30-34,1933,2.369185354930657
SIM,1885,53,na,1938,2025
STAT,1912,34,45-49,1946,1.450279683696101
SIM,1879,39,30-34,1918,5
STAT,1820,96,na,1916,4.5235171581059515
STAT,1844,47,50-100,1891,0.16977978756322884
SIM,1928,24,20-24,1952,139
STAT,1943,12,na,1955,3935.1268520667727
SIM,1892,39,na,1931,3057
STAT,1878,68,na,1946,1504.5419653950612
STAT,1887,12,na,1899,2728.8968439166542
STAT,1820,48,20-24,1868,0.019833004101997464
STAT,1902,35,15-19,1937,0.01631285774128224
SIM,1814,43,50-100,1857,3
STAT,1825,39,45-49,1864,2.304301968243927
STAT,1861,53,40-44,1914,0.008136560312319718
SIM,1833,44,40-44,1877,3
STAT,1909,18,45-49,1927,0.09230517992603393
SIM,1913,18,na,1931,3585
SIM,1932,31,30-34,1963,19
STAT,1907,39,45-49,1946,0.5910971207220083
SIM,1874,14,na,1888,2429
SIM,1882,23,20-24,1905,70
SIM,1917,24,45-49,1941,1
SIM,1932,36,40-44,1968,1
STAT,1888,41,50-100,1929,1.184810664515079
STAT,1891,38,30-34,1929,6.1982141246871985
SIM,1867,22,40-44,1889,3
STAT,1874,41,20-24,1915,0.15398365605389028
SIM,1858,88,na,1946,95
SIM,1930,15,25-29,1945,49
SIM,1885,24,35-39,1909,7
STAT,1799,95,na,1894,4.244628067461491
STAT,1924,45,na,1969,4151.163732209
SIM,1893,20,15-19,1913,3
STAT,1880,33,45-49,1913,1.7294042992799858
STAT,1858,102,na,1960,0.5114127234858942
STAT,1877,24,35-39,1901,5.682591012363065
STAT,1839,52,50-100,1891,0.010001854078855047
STAT,1857,27,50-100,1884,0.49091556470845704
STAT,1825,51,30-34,1876,0.0059692746679880886
STAT,1874,69,na,1943,1416.5072193505455
STAT,1895,16,na,1911,3118.1727475561433
STAT,1837,51,45-49,1888,0.009641941939447028
STAT,1870,55,na,1925,1916.2768825587407
SIM,1909,19,15-19,1928,6
STAT,1845,88,na,1933,97.14582777959617
STAT,1791,82,na,1873,157.79759754398586
SIM,1903,28,na,1931,3176
SIM,1824,55,na,1879,1211
STAT,1922,15,25-29,1937,47.59879805482843
STAT,1846,15,45-49,1861,0.0615862727452959
SIM,1808,93,na,1901,9
STAT,1902,29,15-19,1931,0.600567223323788
SIM,1894,33,40-44,1927,6
STAT,1841,24,20-24,1865,59.323416168082176
STAT,1861,21,40-44,1882,1.6937144078266708
STAT,1808,89,na,1897,40.61949290890029
STAT,1941,25,25-29,1966,64.37919947332298
STAT,1856,28,30-34,1884,19.0953692429845
STAT,1888,34,na,1922,2641.3829612984728
STAT,1885,17,na,1902,2378.220774022794
STAT,1897,40,50-100,1937,0.09361971373235657
STAT,1889,37,25-29,1926,3.3578777110147735
STAT,1941,20,30-34,1961,28.07845352810937
SIM,1859,34,35-39,1893,7
STAT,1832,49,30-34,1881,0.061349935542888805
SIM,1928,18,20-24,1946,138
STAT,1830,39,50-100,1869,0.970600188219549
STAT,1911,40,35-39,1951,0.18362828205208567
STAT,1836,39,20-24,1875,0.6001225397813503
STAT,1916,16,50-100,1932,0.07527697601394895
SIM,1803,93,na,1896,6
STAT,1790,102,na,1892,0.05817816574668039
STAT,1811,47,20-24,1858,0.03997033574742164
STAT,1896,53,na,1949,2643.4141691688283
STAT,1902,0,na,1902,3914.816129159009
STAT,1814,96,na,1910,3.946651272112639
STAT,1843,42,35-39,1885,1.259328156785358
SIM,1885,21,30-34,1906,21
STAT,1877,35,50-100,1912,1.2145337353670402
STAT,1886,33,40-44,1919,4.309391752437489
SIM,1864,28,30-34,1892,24
SIM,1923,29,50-100,1952,1
STAT,1916,10,na,1926,3970.3351540901963
STAT,1800,60,na,1860,974.0917481481698
SIM,1865,15,20-24,1880,16
STAT,1869,48,15-19,1917,3.614757207626238E-4
SIM,1876,30,40-44,1906,6
SIM,1891,54,na,1945,2453
STAT,1851,29,45-49,1880,0.9217729365703482
STAT,1887,3,na,1890,2793.494557952541
STAT,1946,18,15-19,1964,47.53798478643304
STAT,1801,53,35-39,1854,0.023571853697475376
SIM,1830,40,45-49,1870,1
SIM,1848,15,20-24,1863,17
STAT,1908,28,na,1936,3333.7883018506895
STAT,1934,16,50-100,1950,0.47990725591729566
STAT,1872,31,50-100,1903,0.8717615172019335
STAT,1850,37,30-34,1887,3.8164373019451747
STAT,1826,81,na,1907,295.3022458516048
SIM,1913,39,30-34,1952,1
STAT,1905,39,30-34,1944,1.5549770277146466
STAT,1917,26,45-49,1943,1.7174675324109943
STAT,1932,38,40-44,1970,1.8981790086957826
SIM,1809,71,na,1880,600
STAT,1886,34,50-100,1920,0.9065028207066171
STAT,1831,24,15-19,1855,3.3499074664348694
SIM,1827,42,40-44,1869,4
STAT,1906,23,15-19,1929,4.525113779569527
SIM,1923,32,na,1955,4147
STAT,1872,31,45-49,1903,1.6591590268520713
STAT,1877,22,30-34,1899,17.454873445150106
SIM,1819,77,na,1896,440
STAT,1878,34,45-49,1912,1.7021300675277922
STAT,1819,42,40-44,1861,4.737815636811618
STAT,1900,48,50-100,1948,0.17927453145800792
SIM,1897,37,25-29,1934,2
STAT,1935,15,35-39,1950,5.444278054193944
STAT,1907,42,50-100,1949,0.10168139557920305
STAT,1836,36,na,1872,1720.1513918248158
SIM,1923,38,40-44,1961,1
STAT,1950,21,30-34,1971,32.22188033931946
STAT,1820,52,40-44,1872,0.016969722930682263
STAT,1851,34,40-44,1885,3.180195297512293
STAT,1904,17,30-34,1921,2.1597829907704638
STAT,1916,32,35-39,1948,8.9129115816517
STAT,1897,36,20-24,1933,0.97856422526607
STAT,1833,25,25-29,1858,34.70857384116539
STAT,1912,16,15-19,1928,8.691080862396287
STAT,1873,91,na,1964,138.38394707126176
STAT,1853,22,45-49,1875,0.6235355286596446
SIM,1914,23,15-19,1937,4
STAT,1884,43,35-39,1927,1.6778613255748276
STAT,1870,47,50-100,1917,0.22655142985826837
STAT,1893,8,na,1901,3114.328285804654
SIM,1886,34,45-49,1920,1
SIM,1839,18,30-34,1857,1
STAT,1835,21,50-100,1856,0.3474987297837582
STAT,1876,48,50-100,1924,0.2366948542408525
STAT,1915,30,30-34,1945,15.280717300340655
STAT,1936,30,na,1966,3474.217102320507
SIM,1912,17,30-34,1929,3
STAT,1932,35,25-29,1967,1.2519086929034746
STAT,1815,42,50-100,1857,2.674075573660715
STAT,1922,43,15-19,1965,0.0016625397806074762
SIM,1819,43,45-49,1862,1
SIM,1849,17,25-29,1866,6
STAT,1806,82,na,1888,176.1343423589066
SIM,1919,27,na,1946,3872
STAT,1852,9,na,1861,2136.2725769748536
SIM,1925,26,45-49,1951,2
STAT,1847,38,30-34,1885,4.0354998705461815
STAT,1880,27,15-19,1907,0.45185817624432495
SIM,1905,15,15-19,1920,5
SIM,1920,16,15-19,1936,44
STAT,1871,34,50-100,1905,0.8521458379811397
STAT,1822,40,45-49,1862,2.2995015531300025
STAT,1857,73,na,1930,884.948173916109
STAT,1869,54,na,1923,1916.3673549209504
SIM,1915,13,na,1928,3739
STAT,1823,42,50-100,1865,1.4092711375053455
SIM,1931,31,na,1962,4647
STAT,1915,38,40-44,1953,1.421568206211594
SIM,1869,36,na,1905,2172
SIM,1889,16,20-24,1905,15
STAT,1867,24,40-44,1891,1.8369291529144227
SIM,1918,42,na,1960,3727
STAT,1868,1,na,1869,3201.2383617201685
SIM,1838,38,30-34,1876,3
STAT,1898,16,20-24,1914,22.72016656116678
SIM,1853,32,40-44,1885,6
SIM,1964,2,na,1966,4612
STAT,1865,61,na,1926,1600.0494426286982
STAT,1817,52,35-39,1869,0.01859693188385824
STAT,1897,29,30-34,1926,31.586985204975488
SIM,1924,32,35-39,1956,13
STAT,1825,102,na,1927,0.15581830670423574
STAT,1931,38,45-49,1969,0.8520386554541172
STAT,1906,48,40-44,1954,0.13120293804766275
STAT,1874,39,50-100,1913,1.173119085487023
STAT,1936,31,na,1967,3472.306282914232
SIM,1903,16,15-19,1919,6
STAT,1796,59,na,1855,971.5664899999999
SIM,1947,4,na,1951,4167
SIM,1895,31,50-100,1926,1
STAT,1936,32,40-44,1968,3.590745769671917
SIM,1886,16,15-19,1902,4
SIM,1900,28,45-49,1928,1
SIM,1952,0,na,1952,4546
SIM,1848,58,na,1906,1401
SIM,1923,30,30-34,1953,26
SIM,1863,1,na,1864,2888
STAT,1812,49,25-29,1861,0.1865571992651058
STAT,1901,37,20-24,1938,0.22001250486688065
SIM,1841,25,25-29,1866,41
SIM,1839,25,20-24,1864,10
STAT,1845,50,40-44,1895,0.00755672327116003
STAT,1887,36,15-19,1923,0.05962323905712003
STAT,1900,21,20-24,1921,90.58278542791675
SIM,1932,39,45-49,1971,3
STAT,1835,58,na,1893,1258.6932967542402
STAT,1837,22,na,1859,1816.4729156422516
STAT,1868,30,40-44,1898,3.9402852338604495
STAT,1914,45,35-39,1959,0.12136701687234697
STAT,1930,23,50-100,1953,0.7938405660981277
SIM,1913,43,na,1956,3287
STAT,1827,32,45-49,1859,2.092269925884628
SIM,1844,20,30-34,1864,15
SIM,1894,18,15-19,1912,9
STAT,1856,24,15-19,1880,2.783710594883253
STAT,1877,50,na,1927,2140.2846942418464
STAT,1945,19,30-34,1964,12.569934950706395
SIM,1890,25,20-24,1915,16
SIM,1854,20,40-44,1874,6
SIM,1862,25,na,1887,2063
STAT,1908,16,50-100,1924,0.06882546142666462
STAT,1848,53,25-29,1901,0.002589662784518556
STAT,1863,23,45-49,1886,0.5853789676697807
STAT,1919,22,50-100,1941,0.6806668729946006
STAT,1830,42,45-49,1872,1.1642695514835268
STAT,1858,53,35-39,1911,0.006274187965693615
SIM,1919,34,20-24,1953,2
STAT,1870,3,na,1873,2904.7754071757945
SIM,1903,20,35-39,1923,11
SIM,1889,33,50-100,1922,1
STAT,1850,49,45-49,1899,0.16288840876502436
STAT,1937,26,25-29,1963,60.640087789038894
SIM,1919,29,35-39,1948,17
SIM,1875,24,40-44,1899,2
STAT,1862,51,35-39,1913,0.0069869674664590755
STAT,1833,43,25-29,1876,0.4713379184820827
SIM,1899,49,na,1948,2917
SIM,1940,30,30-34,1970,16
STAT,1859,25,45-49,1884,0.8615639644800335
STAT,1796,66,na,1862,761.5724972467076
SIM,1832,59,na,1891,1116
SIM,1855,38,30-34,1893,6
SIM,1864,9,na,1873,2402
SIM,1871,23,45-49,1894,4
STAT,1845,32,40-44,1877,3.6487995480249493
STAT,1960,12,na,1972,4832.03455610755
STAT,1815,52,20-24,1867,0.0015945766958656226
SIM,1915,36,40-44,1951,1
STAT,1901,21,35-39,1922,7.739796234056075
SIM,1843,31,40-44,1874,5
STAT,1924,39,45-49,1963,0.7577753010044498
SIM,1884,72,na,1956,1222
STAT,1882,49,45-49,1931,0.21228985589195334
STAT,1862,29,20-24,1891,9.407985967091188
STAT,1874,26,25-29,1900,40.9704402576022
SIM,1890,68,na,1958,2049
STAT,1836,20,30-34,1856,18.8181154165191
STAT,1846,20,40-44,1866,1.9347011426081655
SIM,1887,17,na,1904,2625
STAT,1861,105,na,1966,0.15565476257541416
STAT,1882,25,20-24,1907,10.85098511164345
SIM,1821,46,50-100,1867,2
STAT,1886,18,15-19,1904,5.906633846771932
SIM,1881,39,na,1920,1805
STAT,1885,45,50-100,1930,0.2335732998668952
SIM,1859,32,30-34,1891,18
SIM,1823,34,20-24,1857,2
STAT,1846,35,15-19,1881,0.04440706564682949
SIM,1892,32,na,1924,3143
STAT,1894,23,45-49,1917,0.8439669408392285
STAT,1909,49,20-24,1958,0.00953733233971549
STAT,1878,16,15-19,1894,5.857037230293439
SIM,1870,29,20-24,1899,15
STAT,1880,30,40-44,1910,4.353804583154878
STAT,1932,30,30-34,1962,19.808063470481844
STAT,1825,37,na,1862,1517.333484100185
STAT,1839,88,na,1927,91.40317291005584
SIM,1845,88,na,1933,78
SIM,1864,24,15-19,1888,2
STAT,1813,46,50-100,1859,0.6825397776568735
STAT,1808,56,na,1864,1116.8889466869819
STAT,1903,47,na,1950,3010.589544046878
SIM,1866,17,25-29,1883,7
SIM,1844,44,na,1888,1528
STAT,1887,21,40-44,1908,2.208575894760906
STAT,1871,22,40-44,1893,1.9547633489013536
SIM,1849,43,na,1892,1728
STAT,1835,31,40-44,1866,3.5507218793113684
STAT,1915,32,20-24,1947,2.346848474263779
STAT,1864,76,na,1940,797.6871439216173
STAT,1860,62,na,1922,1400.9736023242574
SIM,1796,59,na,1855,1021
SIM,1849,47,na,1896,1701
SIM,1918,42,40-44,1960,1
STAT,1859,30,15-19,1889,0.1086347532724382
STAT,1837,33,45-49,1870,1.404322389135222
STAT,1830,24,45-49,1854,1.5432639094789238
SIM,1931,27,30-34,1958,56
STAT,1870,50,30-34,1920,0.005595868173251184
SIM,1788,92,na,1880,6
STAT,1869,9,na,1878,2484.144671057531
SIM,1879,13,na,1892,2584
STAT,1858,17,25-29,1875,4.902934899292716
SIM,1814,93,na,1907,5
SIM,1905,47,na,1952,3019
STAT,1846,51,na,1897,1604.6537732682552
STAT,1923,27,30-34,1950,42.49743568364039
SIM,1882,26,25-29,1908,45
STAT,1907,36,40-44,1943,1.317499102749415
SIM,1931,23,15-19,1954,5
STAT,1902,15,45-49,1917,0.08749465001171901
STAT,1923,23,15-19,1946,5.833054067553557
STAT,1918,15,35-39,1933,0.8696781779794495
SIM,1937,28,40-44,1965,5
SIM,1893,24,na,1917,2940
SIM,1927,28,30-34,1955,55
STAT,1793,105,na,1898,0.004863165726762883
SIM,1917,21,40-44,1938,6
SIM,1897,38,na,1935,3067
STAT,1848,51,20-24,1899,5.509404096673594E-4
SIM,1870,21,na,1891,2171
SIM,1919,0,na,1919,4426
STAT,1909,21,40-44,1930,2.9612130928513802
SIM,1926,33,35-39,1959,11
STAT,1818,55,na,1873,1201.7191152327675
SIM,1899,43,40-44,1942,1
SIM,1874,10,na,1884,2479
STAT,1887,49,na,1936,2328.1665081517913
SIM,1856,33,20-24,1889,4
STAT,1890,48,40-44,1938,0.11013481298692888
STAT,1807,53,25-29,1860,0.01271992754165421
STAT,1926,16,na,1942,4273.559477112285
STAT,1857,69,na,1926,1093.409331074869
STAT,1929,28,40-44,1957,5.507959661047522
STAT,1841,42,50-100,1883,0.7568265698730028
STAT,1839,46,25-29,1885,0.03957748976774145
SIM,1926,15,35-39,1941,6
SIM,1822,60,na,1882,1080
SIM,1923,32,20-24,1955,2
STAT,1847,43,na,1890,1692.0132741651612
STAT,1919,28,30-34,1947,39.854223188059876
SIM,1845,33,45-49,1878,2
SIM,1945,24,20-24,1969,100
STAT,1857,18,25-29,1875,4.933145300429329
STAT,1848,33,20-24,1881,2.1094769793188046
STAT,1778,96,na,1874,1.3982042208399812
STAT,1815,108,na,1923,8.176068224206306E-4
STAT,1859,18,50-100,1877,0.04250763870017185
STAT,1918,33,35-39,1951,9.135104237979004
STAT,1841,42,20-24,1883,0.11377131659413724
SIM,1867,25,45-49,1892,2
STAT,1853,47,20-24,1900,0.009039215218235608
STAT,1779,101,na,1880,0.11193404268912494
STAT,1947,3,na,1950,4253.357111861895
SIM,1898,17,25-29,1915,8
STAT,1869,51,40-44,1920,0.00968089257695811
SIM,1876,76,na,1952,858
STAT,1830,44,15-19,1874,0.010447512441415672
SIM,1872,87,na,1959,214
SIM,1778,78,na,1856,254
SIM,1865,18,25-29,1883,3
STAT,1774,82,na,1856,120.51383416
STAT,1904,46,50-100,1950,0.18826095407586188
STAT,1883,48,45-49,1931,0.21583980964028443
STAT,1849,16,25-29,1865,5.261539086554372
STAT,1871,45,15-19,1916,3.7896947224617364E-4
STAT,1905,17,15-19,1922,8.103595815954264
STAT,1882,18,30-34,1900,1.4604758478911513
STAT,1892,42,30-34,1934,1.3586704887571166
SIM,1827,96,na,1923,2
STAT,1870,17,na,1887,2362.9308766171093
STAT,1931,25,15-19,1956,0.8617444127098594
STAT,1890,31,50-100,1921,1.0625569001042485
STAT,1879,37,15-19,1916,0.05552974091922813
STAT,1849,108,na,1957,0.0021078987441108463
SIM,1854,39,30-34,1893,4
STAT,1941,22,20-24,1963,108.55550371797172
SIM,1806,97,na,1903,3
SIM,1843,22,na,1865,1960
SIM,1900,25,40-44,1925,3
STAT,1917,23,40-44,1940,3.365528759337999
STAT,1866,87,na,1953,153.51007286675136
STAT,1925,4,na,1929,4605.923667584339
STAT,1886,36,45-49,1922,1.998895807473584
STAT,1879,29,50-100,1908,0.6280535267237692
STAT,1921,21,40-44,1942,3.598515314925969
STAT,1937,24,20-24,1961,102.22406986725153
STAT,1900,45,40-44,1945,0.1278185192188829
STAT,1889,34,20-24,1923,3.125465341573902
SIM,1876,33,45-49,1909,1
SIM,1864,21,na,1885,2134
SIM,1897,34,20-24,1931,3
SIM,1890,18,30-34,1908,2
STAT,1900,24,25-29,1924,74.55098769787071
SIM,1911,47,na,1958,3257
STAT,1846,39,30-34,1885,4.043164968596667
SIM,1859,31,30-34,1890,19
SIM,1894,36,45-49,1930,2
SIM,1930,37,40-44,1967,1
SIM,1904,29,40-44,1933,6
SIM,1858,20,25-29,1878,67
SIM,1862,40,40-44,1902,5
STAT,1824,47,30-34,1871,0.11800536791528504
STAT,1848,21,na,1869,1948.4593688974878
STAT,1931,31,na,1962,4684.287479832507
SIM,1858,51,na,1909,1786
STAT,1833,42,25-29,1875,0.4774157042677581
SIM,1895,21,40-44,1916,3
STAT,1868,33,45-49,1901,1.565147468995922
STAT,1884,68,na,1952,1426.2984285805437
STAT,1888,28,50-100,1916,0.711669500292412
STAT,1872,25,15-19,1897,0.43283491445830397
STAT,1927,27,15-19,1954,0.8107550689517875
SIM,1913,17,15-19,1930,4
STAT,1945,26,20-24,1971,18.927261808321592
STAT,1845,53,45-49,1898,0.010104516440311137
STAT,1863,69,na,1932,1216.6188441618374
STAT,1860,25,na,1885,1875.7322674207328
SIM,1818,82,na,1900,235
SIM,1919,36,25-29,1955,3
SIM,1945,19,35-39,1964,6
SIM,1867,65,na,1932,1628
SIM,1922,35,40-44,1957,3
SIM,1857,16,25-29,1873,6
STAT,1817,70,na,1887,730.5506499526774
STAT,1836,21,30-34,1857,15.333085094152597
SIM,1931,34,20-24,1965,3
STAT,1884,40,30-34,1924,1.0838362284947134
SIM,1953,18,30-34,1971,14
STAT,1945,18,30-34,1963,12.574335968295298
SIM,1812,97,na,1909,3
STAT,1784,96,na,1880,1.4408843343518898
STAT,1898,19,25-29,1917,7.2056062184577945
STAT,1923,34,20-24,1957,2.638174014827331
STAT,1856,53,20-24,1909,5.351710346309609E-4
STAT,1866,45,40-44,1911,0.15065737266709367
STAT,1780,82,na,1862,130.17960928358377
STAT,1800,97,na,1897,2.1356437892630202
SIM,1828,30,40-44,1858,4
SIM,1816,39,45-49,1855,2
STAT,1937,19,35-39,1956,3.8449553479562186
STAT,1889,15,50-100,1904,0.05740248372277338
SIM,1844,21,30-34,1865,17
STAT,1842,54,35-39,1896,0.006063082785853431
SIM,1918,31,35-39,1949,11
STAT,1914,35,40-44,1949,1.4254352322915307
STAT,1938,16,15-19,1954,42.39661606959345
STAT,1856,40,50-100,1896,0.7865444669596812
STAT,1913,35,50-100,1948,0.39515452424520775
STAT,1854,37,15-19,1891,0.04017774793749039
SIM,1884,32,40-44,1916,3
STAT,1920,28,20-24,1948,18.8499064027384
SIM,1911,22,35-39,1933,12
STAT,1914,17,40-44,1931,0.2733396043560597
STAT,1868,40,35-39,1908,1.6486318327717542
STAT,1901,47,15-19,1948,2.9697312840757257E-4
STAT,1940,25,40-44,1965,4.4940226621495745
STAT,1783,96,na,1879,1.3219171439448019
STAT,1848,54,25-29,1902,0.0025595450063346037
SIM,1836,21,35-39,1857,4
SIM,1843,59,na,1902,1358
STAT,1842,92,na,1934,30.161767892243294
SIM,1908,28,na,1936,3284
STAT,1843,77,na,1920,583.8508218277332
SIM,1905,19,30-34,1924,1
STAT,1874,43,25-29,1917,0.615347519118807
SIM,1922,17,40-44,1939,1
SIM,1869,31,40-44,1900,6
STAT,1882,43,20-24,1925,0.14484999457177478
STAT,1812,46,20-24,1858,0.04084943761512846
STAT,1925,31,na,1956,4245.131259391581
STAT,1890,16,15-19,1906,6.8710373242337095
STAT,1940,32,30-34,1972,15.404079573363612
STAT,1833,22,20-24,1855,56.92756787119545
SIM,1841,22,20-24,1863,50
STAT,1866,52,30-34,1918,0.005158972431090984
SIM,1839,28,25-29,1867,45
SIM,1817,41,40-44,1858,6
SIM,1926,13,na,1939,4508
SIM,1948,5,na,1953,4255
STAT,1903,22,35-39,1925,7.843773670409424
SIM,1857,73,na,1930,846
STAT,1919,29,30-34,1948,39.709153815655334
SIM,1896,53,na,1949,2654
STAT,1865,65,na,1930,1447.0577465678634
STAT,1826,74,na,1900,606.036555837301
SIM,1925,23,40-44,1948,7
STAT,1876,32,40-44,1908,4.232656114878963
STAT,1897,25,15-19,1922,0.5770885706275917
STAT,1831,37,na,1868,1572.141810528934
SIM,1864,2,na,1866,2834
STAT,1819,45,45-49,1864,0.46098870641385165
SIM,1879,50,na,1929,2206
STAT,1807,52,25-29,1859,0.012979021684630955
STAT,1825,96,na,1921,4.563685465585415
STAT,1953,17,15-19,1970,51.86182576889385
STAT,1920,46,20-24,1966,0.011569003038261362
SIM,1905,37,30-34,1942,1
STAT,1919,36,20-24,1955,0.26777935626339044
SIM,1927,29,30-34,1956,53
SIM,1946,16,15-19,1962,47
STAT,1842,47,45-49,1889,0.1709355777507682
STAT,1895,31,na,1926,2950.9881080440073
STAT,1927,45,45-49,1972,0.25893511647586964
STAT,1900,31,50-100,1931,1.2056508912394852
SIM,1945,26,25-29,1971,75
SIM,1878,72,na,1950,1194
STAT,1845,17,15-19,1862,5.307749934439967
STAT,1938,34,15-19,1972,0.12191019920460296
SIM,1853,17,15-19,1870,6
STAT,1878,35,na,1913,2341.5367048783382
SIM,1903,31,40-44,1934,10
STAT,1906,17,na,1923,3474.991090415705
STAT,1832,43,50-100,1875,0.7712162726217325
STAT,1906,43,35-39,1949,0.1717654348810422
SIM,1828,85,na,1913,131
SIM,1920,4,na,1924,4312
SIM,1887,18,25-29,1905,8
SIM,1877,30,50-100,1907,4
SIM,1918,17,na,1935,3776
STAT,1930,15,20-24,1945,166.34995064100494
SIM,1853,89,na,1942,63
SIM,1832,81,na,1913,300
SIM,1851,88,na,1939,94
SIM,1936,34,20-24,1970,4
STAT,1812,45,45-49,1857,0.8168260971150804
STAT,1934,31,40-44,1965,5.050436265629105
SIM,1834,34,35-39,1868,8
SIM,1877,93,na,1970,102
STAT,1877,21,30-34,1898,17.50757123456614
STAT,1858,52,na,1910,1586.3214193487204
SIM,1839,54,na,1893,1430
STAT,1855,48,20-24,1903,0.008420371872510957
SIM,1881,39,25-29,1920,5
STAT,1882,46,40-44,1928,0.15773062878895
STAT,1911,48,na,1959,3276.6164403094613
STAT,1950,18,40-44,1968,1.561922494652381
STAT,1952,17,50-100,1969,0.4241393504522485
STAT,1881,88,na,1969,329.73525187270855
SIM,1912,18,30-34,1930,2
STAT,1910,45,15-19,1955,3.262202083151479E-4
SIM,1823,37,25-29,1860,3
SIM,1889,40,45-49,1929,3
SIM,1885,22,30-34,1907,24
STAT,1880,17,20-24,1897,17.65646247261435
STAT,1867,23,50-100,1890,0.36062414025681666
STAT,1824,42,na,1866,1515.3136977667662
STAT,1826,41,40-44,1867,2.2423309888449445
SIM,1912,26,na,1938,3480
SIM,1938,31,na,1969,3442
SIM,1879,19,na,1898,2528
STAT,1882,28,25-29,1910,38.72616761286514
STAT,1896,28,50-100,1924,0.795325444857737
STAT,1900,41,25-29,1941,0.05870335736773583
STAT,1918,30,30-34,1948,15.94338899636928
SIM,1860,31,40-44,1891,3
SIM,1875,28,45-49,1903,1
SIM,1892,25,40-44,1917,5
STAT,1829,42,20-24,1871,0.13547188257710144
SIM,1928,26,25-29,1954,82
STAT,1873,39,25-29,1912,2.7308363938036306
SIM,1904,7,na,1911,3594
SIM,1909,22,40-44,1931,5
STAT,1893,25,35-39,1918,11.638107813148716
STAT,1844,32,45-49,1876,1.4483041538277426
SIM,1890,28,25-29,1918,50
SIM,1903,18,20-24,1921,22
SIM,1852,32,45-49,1884,1
STAT,1858,38,45-49,1896,1.469215039255167
STAT,1883,53,na,1936,1962.325968023649
STAT,1832,52,20-24,1884,4.6389672323422136E-4
STAT,1871,20,50-100,1891,0.38481931963743365
STAT,1846,67,na,1913,1175.7621011593387
SIM,1854,21,na,1875,2010
STAT,1787,108,na,1895,6.750819783753275E-4
SIM,1832,39,50-100,1871,1
STAT,1920,44,45-49,1964,0.17306602730436393
STAT,1923,45,25-29,1968,0.05889717340645875
STAT,1854,51,45-49,1905,0.010433095592134317
STAT,1885,54,na,1939,1971.815183665027
SIM,1823,45,na,1868,1376
SIM,1949,19,na,1968,3975
STAT,1826,34,35-39,1860,12.213145667988865
STAT,1854,86,na,1940,158.74908651973178
SIM,1928,11,na,1939,4732
STAT,1861,45,40-44,1906,0.1358160608188691
STAT,1896,16,na,1912,3158.9013052053556
STAT,1935,37,15-19,1972,0.025367149869409425
SIM,1831,64,na,1895,1039
STAT,1842,19,40-44,1861,0.16809206887607797
STAT,1835,32,35-39,1867,8.205965190940391
SIM,1851,31,30-34,1882,19
STAT,1914,47,25-29,1961,0.049699941750547406
SIM,1926,30,30-34,1956,28
STAT,1855,32,20-24,1887,1.9558375265641563
SIM,1804,62,na,1866,894
SIM,1863,32,20-24,1895,2
STAT,1867,27,45-49,1894,0.9849255340428427
STAT,1871,49,30-34,1920,0.08890945125133881
SIM,1827,69,na,1896,829
SIM,1866,35,40-44,1901,2
SIM,1843,32,35-39,1875,12
STAT,1873,69,na,1942,1406.0745549523995
STAT,1920,20,45-49,1940,1.188737204169702
SIM,1910,20,40-44,1930,4
STAT,1808,93,na,1901,11.300151114877854
STAT,1857,43,25-29,1900,0.4749899683298186
STAT,1867,35,35-39,1902,6.333820574875656
SIM,1890,75,na,1965,1600
STAT,1922,37,50-100,1959,0.4513189873707352
STAT,1851,26,40-44,1877,2.5412619178651785
STAT,1855,34,na,1889,1691.161777409187
STAT,1873,46,15-19,1919,3.84333570908929E-4
STAT,1884,25,40-44,1909,2.8147896183126235
STAT,1911,19,15-19,1930,8.53366442917675
SIM,1842,36,na,1878,1693
STAT,1902,29,50-100,1931,0.8467624663339176
STAT,1852,31,40-44,1883,3.2892768040788782
STAT,1899,39,45-49,1938,0.5513457105603614
SIM,1797,75,na,1872,350
SIM,1835,30,na,1865,1733
STAT,1853,50,30-34,1903,0.0045696032367911294
STAT,1912,24,15-19,1936,4.9910072094189895
SIM,1825,41,30-34,1866,4
STAT,1870,43,40-44,1913,2.0694835046121596
SIM,1942,26,45-49,1968,1
STAT,1837,19,30-34,1856,1.439747650839968
SIM,1845,19,30-34,1864,1
STAT,1919,20,35-39,1939,9.798458238907143
SIM,1943,27,50-100,1970,6
STAT,1909,47,15-19,1956,3.1978519039421765E-4
STAT,1821,52,45-49,1873,0.02200930969668714
STAT,1861,22,35-39,1883,4.709007841185101
SIM,1804,72,na,1876,519
STAT,1904,25,20-24,1929,16.004627112129278
SIM,1920,24,15-19,1944,4
STAT,1873,59,na,1932,1862.0611248492523
STAT,1803,52,40-44,1855,0.030676060027040635
STAT,1863,16,20-24,1879,16.870321257068777
SIM,1825,34,40-44,1859,3
SIM,1875,35,35-39,1910,12
STAT,1870,38,45-49,1908,1.8383227701399485
SIM,1924,26,40-44,1950,5
STAT,1849,45,40-44,1894,0.12965726954134718
STAT,1841,43,15-19,1884,0.00976721859135279
STAT,1930,15,na,1945,4516.260374995565
SIM,1898,32,50-100,1930,1
SIM,1856,22,na,1878,1952
STAT,1928,34,20-24,1962,2.8774444812276867
STAT,1796,91,na,1887,18.761762682775732
SIM,1826,42,45-49,1868,1
SIM,1872,56,na,1928,1897
STAT,1830,48,30-34,1878,0.07160232094019058
STAT,1896,33,20-24,1929,3.3583348065307224
SIM,1848,21,15-19,1869,5
STAT,1847,15,50-100,1862,0.045625902285211274
STAT,1881,38,20-24,1919,0.6999924361593467
SIM,1868,52,50-100,1920,2
SIM,1907,29,45-49,1936,5
STAT,1846,19,25-29,1865,5.21784605959616
SIM,1929,18,40-44,1947,1
STAT,1889,78,na,1967,1282.2376048206888
SIM,1875,49,50-100,1924,2
STAT,1847,15,na,1862,2137.7344345653646
STAT,1895,17,50-100,1912,0.06033833407703783
SIM,1871,16,20-24,1887,20
STAT,1885,33,45-49,1918,1.63512946659357
SIM,1902,29,50-100,1931,1
SIM,1892,32,30-34,1924,34
STAT,1895,5,na,1900,3227.5749879371533
STAT,1818,42,45-49,1860,3.5298341239843083
STAT,1884,32,30-34,1916,16.295515945967963
SIM,1760,102,na,1862,1
SIM,1880,75,na,1955,1007
SIM,1925,34,45-49,1959,2
STAT,1893,73,na,1966,1723.1307064023185
STAT,1904,18,30-34,1922,2.1541243593346446
SIM,1905,39,35-39,1944,6
SIM,1854,19,25-29,1873,13
STAT,1864,46,20-24,1910,0.010132347946833823
SIM,1951,13,na,1964,4293
STAT,1882,50,50-100,1932,0.01407451942260893
STAT,1917,34,45-49,1951,1.543338599275147
SIM,1858,42,40-44,1900,3
SIM,1893,33,45-49,1926,2
STAT,1820,44,40-44,1864,3.886320235237583
STAT,1817,41,30-34,1858,3.0405052059054065
STAT,1900,49,20-24,1949,0.008685588612767815
SIM,1868,24,35-39,1892,7
STAT,1916,26,40-44,1942,4.56844328836899
SIM,1909,34,na,1943,3417
STAT,1933,26,40-44,1959,5.849251883398491
STAT,1839,16,15-19,1855,5.199385544416552
STAT,1859,19,35-39,1878,0.4732814972199461
SIM,1894,34,50-100,1928,2
STAT,1903,26,15-19,1929,0.6119381185734571
STAT,1813,50,45-49,1863,0.03949201127378365
STAT,1790,72,na,1862,504.7038821582601
SIM,1888,37,50-100,1925,1
SIM,1884,33,35-39,1917,10
STAT,1894,47,45-49,1941,0.16086522603911932
STAT,1910,22,40-44,1932,2.983029820980807
STAT,1913,23,20-24,1936,105.75074688517897
STAT,1882,44,15-19,1926,0.012516047859140081
STAT,1860,24,40-44,1884,1.6229869698453523
SIM,1889,22,15-19,1911,3
STAT,1830,50,45-49,1880,0.010934736479584628
SIM,1811,44,na,1855,1275
STAT,1905,15,25-29,1920,7.773837275669764
SIM,1817,42,35-39,1859,1
SIM,1904,23,20-24,1927,101
STAT,1876,30,15-19,1906,0.14010779907419682
SIM,1893,30,40-44,1923,14
STAT,1804,50,35-39,1854,0.03167270961593799
STAT,1840,21,20-24,1861,57.92784160303852
STAT,1825,36,40-44,1861,5.72886374554016
SIM,1915,28,40-44,1943,6
STAT,1770,102,na,1872,0.06036123844008143
STAT,1938,15,20-24,1953,126.92988917723122
SIM,1841,88,na,1929,70
STAT,1805,75,na,1880,442.7472251430955
STAT,1838,17,25-29,1855,5.025256833285944
SIM,1880,85,na,1965,515
STAT,1814,47,20-24,1861,0.03670444978118884
SIM,1929,15,20-24,1944,160
SIM,1837,19,25-29,1856,7
SIM,1935,29,20-24,1964,21
STAT,1871,44,50-100,1915,0.977651230827847
STAT,1934,26,45-49,1960,2.196509794390876
SIM,1949,18,40-44,1967,1
STAT,1920,26,15-19,1946,0.7340876419176701
STAT,1913,49,30-34,1962,0.08171925169084039
STAT,1932,32,50-100,1964,1.0383070365815228
STAT,1926,35,50-100,1961,0.48556570092520324
STAT,1875,27,40-44,1902,2.9087364998718668
STAT,1902,20,40-44,1922,2.7947757705027856
SIM,1941,26,40-44,1967,4
STAT,1876,40,40-44,1916,2.217455423992938
STAT,1915,29,50-100,1944,0.952251091936436
SIM,1867,93,na,1960,49
STAT,1880,41,45-49,1921,1.4973005421980063
STAT,1918,45,15-19,1963,3.7207044958982013E-4
STAT,1924,28,40-44,1952,5.1087044921748825
SIM,1822,81,na,1903,275
SIM,1846,17,25-29,1863,7
SIM,1912,25,20-24,1937,20
SIM,1913,15,25-29,1928,9
SIM,1847,16,15-19,1863,3
SIM,1814,62,na,1876,906
SIM,1833,36,40-44,1869,5
STAT,1927,29,20-24,1956,20.87936295400971
SIM,1898,20,15-19,1918,2
STAT,1810,66,na,1876,783.7902131959453
STAT,1929,42,25-29,1971,0.08735979695919897
STAT,1828,37,20-24,1865,0.7037479421698806
STAT,1760,105,na,1865,0.015261267333597157
STAT,1804,52,45-49,1856,0.05128296518279169
SIM,1852,36,na,1888,1814
STAT,1838,32,na,1870,1807.9679437888262
SIM,1817,69,na,1886,781
SIM,1927,20,35-39,1947,17
STAT,1875,54,na,1929,2033.2629710537146
STAT,1911,4,na,1915,3803.2275672861533
STAT,1925,24,na,1949,4103.460285744704
STAT,1824,53,25-29,1877,0.004074834107835953
STAT,1810,48,15-19,1858,0.0013130368924128045
STAT,1895,28,20-24,1923,14.39758164111126
SIM,1921,23,20-24,1944,122
STAT,1821,50,35-39,1871,0.013587026293278617
SIM,1867,33,35-39,1900,8
STAT,1871,43,45-49,1914,1.3938148239960169
SIM,1932,28,40-44,1960,6
SIM,1918,11,na,1929,4092
SIM,1833,69,na,1902,853
STAT,1865,51,20-24,1916,6.348786016944417E-4
STAT,1891,44,25-29,1935,0.7404101963742603
STAT,1778,78,na,1856,266.39626233779995
SIM,1901,22,40-44,1923,3
SIM,1883,27,40-44,1910,5
SIM,1861,19,na,1880,2234
SIM,1909,44,na,1953,3295
STAT,1874,17,na,1891,2437.7741407521644
SIM,1828,29,25-29,1857,37
STAT,1869,22,35-39,1891,5.340569792915612
STAT,1870,22,45-49,1892,0.6462506371619222
STAT,1885,49,45-49,1934,0.21758793398001564
SIM,1884,40,40-44,1924,4
SIM,1810,96,na,1906,2
STAT,1951,18,50-100,1969,0.42133531664552715
SIM,1844,37,na,1881,1674
SIM,1906,38,40-44,1944,1
STAT,1834,34,40-44,1868,3.376572485256828
STAT,1908,41,40-44,1949,0.21987994482431297
STAT,1788,108,na,1896,4.941674333148346E-4
SIM,1760,98,na,1858,1
STAT,1807,51,50-100,1858,0.056468369539572356
STAT,1907,28,40-44,1935,4.142394191107857
SIM,1888,27,na,1915,2701
STAT,1843,31,30-34,1874,14.32556398108181
STAT,1786,97,na,1883,0.8857541228466095
STAT,1848,86,na,1934,164.86687891518451
STAT,1865,18,50-100,1883,0.042974184407540215
STAT,1881,22,20-24,1903,62.88998989504246
SIM,1893,23,35-39,1916,9
STAT,1823,45,20-24,1868,0.015210328182286346
STAT,1871,41,35-39,1912,1.7063603457242569
STAT,1881,54,25-29,1935,0.003143573358009303
STAT,1943,24,45-49,1967,1.1301274708609639
SIM,1931,29,35-39,1960,21
SIM,1869,29,na,1898,2184
STAT,1858,21,50-100,1879,0.34905775129556904
SIM,1902,30,45-49,1932,1
STAT,1908,36,45-49,1944,0.6058884864496719
STAT,1846,57,na,1903,1490.550963233187
SIM,1859,74,na,1933,841
STAT,1890,36,20-24,1926,0.8945891970467661
SIM,1826,32,35-39,1858,12
SIM,1862,27,20-24,1889,9
SIM,1831,29,30-34,1860,25
SIM,1930,39,30-34,1969,2
STAT,1899,43,30-34,1942,0.10259255527319318
STAT,1866,71,na,1937,1163.0402318003516
STAT,1922,39,30-34,1961,1.9549852517221726
STAT,1923,29,35-39,1952,16.167325827956226
STAT,1850,43,25-29,1893,0.44940151150144936
STAT,1909,7,na,1916,3691.2179759482283
SIM,1877,22,35-39,1899,7
SIM,1950,16,40-44,1966,1
STAT,1953,19,20-24,1972,154.82521322234987
STAT,1841,58,na,1899,1363.3792846687056
STAT,1866,37,40-44,1903,3.814211524421404
STAT,1942,16,40-44,1958,1.3812699969148943
STAT,1854,27,20-24,1881,8.799310625041164
SIM,1851,24,40-44,1875,7
SIM,1857,46,50-100,1903,1
SIM,1924,11,na,1935,4487
SIM,1853,73,na,1926,902
SIM,1863,17,25-29,1880,4
STAT,1855,17,25-29,1872,4.78962966932381
STAT,1862,53,45-49,1915,0.01153373738689836
STAT,1865,44,15-19,1909,0.011665276223653829
SIM,1874,41,na,1915,2176
SIM,1946,15,20-24,1961,134
STAT,1840,45,20-24,1885,0.00814751743600722
STAT,1843,24,40-44,1867,1.7414240442394386
STAT,1940,21,25-29,1961,88.92123245242874
STAT,1823,94,na,1917,10.696172006097179
SIM,1914,46,50-100,1960,2
STAT,1876,33,35-39,1909,9.842354270391176
SIM,1867,40,40-44,1907,8
STAT,1860,31,30-34,1891,13.437733893326186
STAT,1853,39,na,1892,1765.0493551399722
STAT,1927,35,15-19,1962,0.022593719064735385
SIM,1858,27,45-49,1885,3
SIM,1892,28,45-49,1920,1
STAT,1872,48,20-24,1920,0.011228051416683043
SIM,1933,36,45-49,1969,1
STAT,1815,75,na,1890,459.509948424764
SIM,1882,70,na,1952,1260
STAT,1935,24,na,1959,4694.590027520569
STAT,1944,26,50-100,1970,1.016735708893967
STAT,1850,40,20-24,1890,0.11308064610132386
SIM,1838,37,na,1875,1699
STAT,1911,30,45-49,1941,1.459235512016483
STAT,1914,31,25-29,1945,8.82523725039608
SIM,1835,31,30-34,1866,18
STAT,1856,38,25-29,1894,2.111666243794273
SIM,1851,34,35-39,1885,10
STAT,1891,19,50-100,1910,0.056953710713282694
STAT,1851,49,15-19,1900,2.8172921382822556E-4
SIM,1865,37,50-100,1902,3
STAT,1894,22,30-34,1916,21.624992796422315
STAT,1934,34,45-49,1968,2.0270183398873094
SIM,1868,21,30-34,1889,19
SIM,1887,15,20-24,1902,19
STAT,1924,34,35-39,1958,10.05866140278122
STAT,1932,10,na,1942,4971.426574832418
SIM,1862,56,na,1918,1756
SIM,1930,30,20-24,1960,3
SIM,1907,49,na,1956,3072
STAT,1846,42,20-24,1888,0.11921823294729232
STAT,1898,40,45-49,1938,0.13420651290867647
STAT,1932,7,na,1939,5000.272914746801
SIM,1916,33,40-44,1949,5
STAT,1936,19,20-24,1955,121.95968898967799
STAT,1840,46,35-39,1886,0.09384432452495556
SIM,1869,23,40-44,1892,1
SIM,1834,31,30-34,1865,26
SIM,1848,21,na,1869,1925
STAT,1812,61,na,1873,1013.3617096558879
STAT,1869,38,20-24,1907,0.7019736240618596
STAT,1831,108,na,1939,0.0010695170403938374
SIM,1865,21,15-19,1886,4
STAT,1884,28,45-49,1912,1.0326212385659053
STAT,1912,51,na,1963,3293.0391002762212
STAT,1916,43,40-44,1959,0.24176295665809083
STAT,1834,41,30-34,1875,0.8712235212802455
SIM,1799,102,na,1901,1
SIM,1934,24,45-49,1958,2
STAT,1881,24,na,1905,2144.8470309550557
SIM,1792,66,na,1858,715
STAT,1908,12,na,1920,3619.1082682368633
STAT,1893,22,30-34,1915,21.33960781096088
STAT,1877,54,35-39,1931,0.008204322297829332
STAT,1831,53,30-34,1884,0.0036571495674824895
STAT,1881,46,20-24,1927,0.010982371134214476
STAT,1925,36,45-49,1961,0.7736439402760842
SIM,1811,44,40-44,1855,5
SIM,1944,19,20-24,1963,127
STAT,1921,18,30-34,1939,13.090798757222043
SIM,1893,40,35-39,1933,5
STAT,1898,44,25-29,1942,0.056238680882957685
STAT,1903,44,45-49,1947,0.13781177374622697
STAT,1812,42,40-44,1854,8.593800856314726
SIM,1909,25,45-49,1934,1
STAT,1811,54,40-44,1865,0.03219929318727505
STAT,1800,76,na,1876,379.9120341725576
STAT,1840,102,na,1942,0.19239833140170626
STAT,1899,36,40-44,1935,5.693523375719563
STAT,1920,41,40-44,1961,0.26134270805803883
STAT,1855,53,50-100,1908,0.010560096249410972
STAT,1922,30,20-24,1952,2.6244617743930667
SIM,1908,34,45-49,1942,3
STAT,1865,34,na,1899,2025.8233795517315
SIM,1842,34,40-44,1876,5
STAT,1922,47,30-34,1969,0.09674761377261751
SIM,1820,42,40-44,1862,6
STAT,1866,9,na,1875,2394.397033450479
STAT,1827,60,na,1887,1152.6568082346273
STAT,1873,36,20-24,1909,0.7421162105865409
STAT,1857,21,15-19,1878,2.8581110316625127
SIM,1842,41,30-34,1883,1
SIM,1847,89,na,1936,58
SIM,1889,19,na,1908,3030
STAT,1884,35,35-39,1919,6.663997515995064
SIM,1866,38,45-49,1904,1
SIM,1825,44,35-39,1869,1
SIM,1922,16,na,1938,4006
STAT,1912,42,45-49,1954,0.1516441074625353
STAT,1926,24,45-49,1950,1.2832305805376472
STAT,1864,49,25-29,1913,0.04748498190372319
SIM,1802,67,na,1869,714
SIM,1875,40,30-34,1915,4
STAT,1881,47,35-39,1928,0.12716926366269937
STAT,1824,50,20-24,1874,9.011295664141934E-4
SIM,1875,32,30-34,1907,22
STAT,1826,31,30-34,1857,25.647387338572
STAT,1885,30,40-44,1915,4.116466096834959
SIM,1932,34,35-39,1966,14
STAT,1844,53,40-44,1897,0.007194304719181375
SIM,1837,89,na,1926,46
SIM,1850,32,25-29,1882,10
STAT,1817,44,35-39,1861,4.249807630189973
STAT,1846,16,20-24,1862,16.616069273996416
SIM,1827,90,na,1917,40
STAT,1879,78,na,1957,847.801503232672
SIM,1845,54,na,1899,1459
STAT,1938,18,40-44,1956,1.3030467225307676
STAT,1928,18,30-34,1946,14.47045870869136
SIM,1789,84,na,1873,82
STAT,1830,42,na,1872,1547.9521058520777
SIM,1861,21,30-34,1882,18
STAT,1858,35,40-44,1893,3.2731280846859563
STAT,1865,54,25-29,1919,0.0029495029336781267
STAT,1867,40,30-34,1907,1.0301360688323116
SIM,1816,44,40-44,1860,3
SIM,1883,31,25-29,1914,13
STAT,1870,35,40-44,1905,4.095429005894986
SIM,1892,35,35-39,1927,20
SIM,1922,31,25-29,1953,16
STAT,1885,40,35-39,1925,1.7223466431943495
STAT,1875,35,40-44,1910,4.290988107729231
STAT,1891,41,20-24,1932,0.18645756787489637
STAT,1906,45,25-29,1951,0.04515044839276573
SIM,1901,25,45-49,1926,1
STAT,1876,17,45-49,1893,0.06375507829801497
STAT,1892,27,40-44,1919,3.5445019231916706
STAT,1891,54,na,1945,2447.4447246940213
STAT,1858,112,na,1970,3.0720607432779015E-4
STAT,1918,37,15-19,1955,0.01912153145167883
STAT,1853,21,30-34,1874,16.042689419859755
STAT,1928,37,25-29,1965,1.1754900894100655
SIM,1772,83,na,1855,89
SIM,1870,85,na,1955,239
STAT,1842,32,25-29,1874,8.96053902948996
STAT,1875,31,25-29,1906,9.986363586804767
SIM,1827,47,50-100,1874,2
SIM,1861,43,40-44,1904,5
STAT,1831,47,20-24,1878,0.008549006377737098
STAT,1857,112,na,1969,2.6374057293523196E-4
SIM,1821,102,na,1923,1
STAT,1863,41,45-49,1904,1.2463546452983143
SIM,1918,29,20-24,1947,18
STAT,1840,53,25-29,1893,0.00228715116983919
SIM,1871,41,45-49,1912,2
SIM,1885,84,na,1969,575
STAT,1921,25,20-24,1946,19.34924993371265
STAT,1941,28,40-44,1969,4.552844058204135
SIM,1882,18,na,1900,2379
SIM,1883,35,40-44,1918,5
SIM,1875,25,40-44,1900,3
STAT,1882,36,na,1918,2174.890145076631
STAT,1920,25,na,1945,3908.462630936494
STAT,1933,18,40-44,1951,1.7641906950373387
SIM,1888,17,15-19,1905,6
STAT,1862,20,na,1882,1983.9332708627724
SIM,1897,48,na,1945,2906
STAT,1819,47,50-100,1866,0.46539643289471805
STAT,1935,30,30-34,1965,20.614796860440336
STAT,1934,35,na,1969,4913.074872333978
SIM,1941,18,40-44,1959,2
STAT,1871,51,45-49,1922,0.013678829963822253
STAT,1875,42,30-34,1917,1.1149703195499912
SIM,1871,19,25-29,1890,6
STAT,1853,22,50-100,1875,0.3646406739287329
STAT,1872,54,30-34,1926,0.00548539047663937
STAT,1841,45,50-100,1886,0.17450169553489425
STAT,1913,26,25-29,1939,62.17159020844568
SIM,1905,9,na,1914,3498
SIM,1875,42,40-44,1917,9
STAT,1859,16,30-34,1875,1.3993512717534735
SIM,1866,22,na,1888,2107
STAT,1873,53,20-24,1926,6.95659418346893E-4
STAT,1861,72,na,1933,991.9877111724303
STAT,1883,33,25-29,1916,9.44680259559922
STAT,1873,53,na,1926,2029.8577494849
STAT,1886,30,25-29,1916,10.303360750291034
SIM,1891,33,25-29,1924,14
STAT,1948,24,50-100,1972,0.7132607096805635
SIM,1867,16,30-34,1883,2
SIM,1829,54,na,1883,1233
SIM,1870,43,35-39,1913,3
SIM,1936,18,30-34,1954,13
STAT,1862,43,35-39,1905,1.4520621554918196
STAT,1877,47,45-49,1924,0.2301864101940258
SIM,1779,84,na,1863,79
SIM,1782,83,na,1865,105
STAT,1906,27,na,1933,3283.626411691115
STAT,1843,27,45-49,1870,0.9229481052636471
STAT,1864,86,na,1950,186.81348596559536
SIM,1854,16,20-24,1870,18
STAT,1903,13,na,1916,3465.9049605524992
SIM,1851,27,45-49,1878,4
SIM,1939,15,30-34,1954,13
STAT,1908,44,45-49,1952,0.1436804136616445
SIM,1944,7,na,1951,3929
STAT,1802,61,na,1863,943.9012288286091
STAT,1863,19,25-29,1882,4.820895422927793
STAT,1870,46,45-49,1916,0.2193366377833581
STAT,1939,25,50-100,1964,0.946115893959166
SIM,1842,30,25-29,1872,10
SIM,1883,42,30-34,1925,1
STAT,1817,60,na,1877,1060.678856367843
STAT,1896,26,na,1922,2987.84874207621
SIM,1942,23,40-44,1965,4
STAT,1808,51,30-34,1859,0.021941196083414174
STAT,1927,15,45-49,1942,0.5894829054550763
SIM,1815,39,40-44,1854,4
SIM,1868,7,na,1875,2474
STAT,1871,5,na,1876,2608.8615718814262
SIM,1922,37,30-34,1959,2
STAT,1825,58,na,1883,1125.9981551856526
STAT,1873,28,50-100,1901,0.6107411316938165
STAT,1934,23,40-44,1957,4.267286706704935
STAT,1936,29,30-34,1965,35.3885090285891
STAT,1946,16,25-29,1962,45.41987502156943
SIM,1812,91,na,1903,21
SIM,1876,32,30-34,1908,23
SIM,1848,37,na,1885,1756
SIM,1881,28,50-100,1909,1
STAT,1899,46,35-39,1945,0.10251135256539008
STAT,1921,26,50-100,1947,1.0515621894243503
STAT,1867,42,40-44,1909,1.9928267168627776
STAT,1868,32,30-34,1900,15.737178599388761
SIM,1899,28,45-49,1927,1
STAT,1914,37,30-34,1951,1.7191302227672283
STAT,1841,27,25-29,1868,36.221981204880855
STAT,1834,30,25-29,1864,8.313115578138875
STAT,1925,19,45-49,1944,0.5669971019194611
SIM,1954,16,25-29,1970,57
STAT,1831,58,na,1889,1157.4584987377789
STAT,1833,29,40-44,1862,2.387822244114956
SIM,1906,34,25-29,1940,10
STAT,1841,17,50-100,1858,0.04356163510839748
STAT,1888,52,na,1940,2391.168562924113
SIM,1895,17,20-24,1912,20
STAT,1918,12,na,1930,4074.2260203972196
STAT,1885,46,40-44,1931,0.16166708248661674
STAT,1817,37,45-49,1854,7.118736104955673
STAT,1821,75,na,1896,548.4625014119589
STAT,1858,86,na,1944,164.33957877919423
STAT,1886,20,50-100,1906,0.40936631168696186
STAT,1801,105,na,1906,0.010364985079320814
STAT,1900,70,na,1970,2192.7476183500307
STAT,1849,52,30-34,1901,0.004439864224450544
STAT,1821,35,45-49,1856,4.676258616894012
STAT,1890,46,15-19,1936,2.613384304524577E-4
STAT,1936,36,20-24,1972,0.24469434756002345
SIM,1851,19,na,1870,2051
SIM,1918,39,30-34,1957,2
STAT,1926,10,na,1936,4603.03121828518
STAT,1894,21,na,1915,2879.9546573342836
STAT,1859,43,45-49,1902,1.1171805789188727
SIM,1892,60,na,1952,2533
SIM,1935,31,35-39,1966,10
SIM,1929,16,15-19,1945,49
STAT,1816,42,25-29,1858,1.7322316565819929
STAT,1856,57,na,1913,1481.2543933494785
STAT,1887,17,20-24,1904,18.73346078032552
STAT,1944,27,15-19,1971,0.7207964306960805
SIM,1941,29,45-49,1970,1
STAT,1827,31,30-34,1858,21.86376565413125
SIM,1867,43,45-49,1910,2
STAT,1908,33,40-44,1941,3.474940367996277
SIM,1820,96,na,1916,1
SIM,1928,19,35-39,1947,9
SIM,1921,26,25-29,1947,67
STAT,1893,30,30-34,1923,21.085359934842817
SIM,1841,29,40-44,1870,3
STAT,1893,32,40-44,1925,5.195506303424844
STAT,1914,44,20-24,1958,0.016476982373462234
STAT,1890,39,25-29,1929,3.291905906310869
STAT,1926,41,45-49,1967,0.19410039967539916
STAT,1871,40,40-44,1911,2.131273853810492
STAT,1764,102,na,1866,0.052256664389026666
STAT,1901,15,40-44,1916,0.2429840850699833
SIM,1936,30,na,1966,2877
SIM,1904,35,na,1939,3314
STAT,1933,29,45-49,1962,2.164899607815893
SIM,1849,74,na,1923,826
STAT,1885,20,30-34,1905,16.8728980924506
SIM,1828,26,20-24,1854,10
SIM,1834,41,40-44,1875,3
SIM,1867,35,na,1902,2289
SIM,1923,4,na,1927,4528
SIM,1919,34,na,1953,3886
STAT,1927,31,35-39,1958,10.625538687275894
STAT,1859,50,35-39,1909,0.006566090740309666
SIM,1893,20,30-34,1913,19
STAT,1876,71,na,1947,1302.7718050441126
SIM,1854,37,na,1891,1872
STAT,1821,42,35-39,1863,3.1162454035598537
SIM,1929,18,25-29,1947,56
SIM,1866,18,na,1884,2275
STAT,1926,41,na,1967,4331.404674178738
STAT,1823,48,25-29,1871,0.06993731097394566
SIM,1850,62,na,1912,1351
STAT,1843,34,35-39,1877,8.054329201707857
SIM,1770,98,na,1868,1
STAT,1897,39,25-29,1936,0.7772262762401365
SIM,1852,31,30-34,1883,19
SIM,1873,35,na,1908,2284
SIM,1899,40,na,1939,3111
SIM,1840,19,30-34,1859,2
STAT,1869,52,35-39,1921,0.007836976604923133
STAT,1921,32,45-49,1953,1.6542924460458763
STAT,1840,35,na,1875,1697.3387750528518
STAT,1763,102,na,1865,0.04268080008251385
STAT,1903,41,40-44,1944,0.21089892794170198
STAT,1906,42,20-24,1948,0.01515520219472725
STAT,1941,14,na,1955,3820.869557651763
STAT,1838,93,na,1931,19.620472548467426
STAT,1783,86,na,1869,58.545194235700485
SIM,1920,20,35-39,1940,12
SIM,1837,20,40-44,1857,2
SIM,1883,55,na,1938,1886
STAT,1876,50,35-39,1926,0.008523230296826917
SIM,1913,30,50-100,1943,3
STAT,1949,20,30-34,1969,31.70561454609395
STAT,1931,31,25-29,1962,11.447522333678853
SIM,1908,31,40-44,1939,7
STAT,1839,38,25-29,1877,2.267132506294425
STAT,1883,37,40-44,1920,4.054501621634679
STAT,1808,47,45-49,1855,0.8953509079839854
STAT,1802,95,na,1897,4.661344793520582
STAT,1874,21,15-19,1895,3.1939088612444295
SIM,1891,37,40-44,1928,7
SIM,1847,38,25-29,1885,2
STAT,1860,20,25-29,1880,50.428482288882506
STAT,1860,34,35-39,1894,7.696034705076529
SIM,1870,33,40-44,1903,5
STAT,1879,26,50-100,1905,0.6347454857710122
SIM,1891,16,25-29,1907,6
STAT,1913,45,30-34,1958,0.08258795066420457
STAT,1839,24,15-19,1863,2.7818403342750515
STAT,1897,17,15-19,1914,7.497606887475382
SIM,1906,64,na,1970,2647
STAT,1816,46,40-44,1862,0.4107869368444752
STAT,1814,53,30-34,1867,0.017045493464886718
STAT,1892,23,25-29,1915,67.52658398683019
STAT,1844,31,30-34,1875,14.652252031547423
STAT,1869,85,na,1954,250.8849383244322
STAT,1913,45,15-19,1958,3.412722358413973E-4
SIM,1889,1,na,1890,3222
STAT,1840,48,25-29,1888,0.03763347627886301
STAT,1945,14,na,1959,4052.1926462217316
STAT,1872,32,20-24,1904,2.561356989950762
STAT,1922,45,40-44,1967,0.17191267790131845
STAT,1824,39,50-100,1863,1.739811434291267
STAT,1891,42,50-100,1933,1.2332409503902304
SIM,1887,55,na,1942,2134
SIM,1941,24,35-39,1965,10
STAT,1841,102,na,1943,0.20211833332410886
STAT,1936,25,15-19,1961,0.6387824298575436
STAT,1924,24,25-29,1948,102.31960115187808
STAT,1933,3,na,1936,5129.329591410532
SIM,1932,24,25-29,1956,130
STAT,1825,32,25-29,1857,17.917206663725377
STAT,1834,44,35-39,1878,1.3205008119963946
SIM,1875,43,35-39,1918,6
STAT,1830,26,20-24,1856,12.767443067929522
SIM,1871,39,30-34,1910,9
STAT,1846,26,na,1872,1955.0931103631365
SIM,1902,64,na,1966,2494
STAT,1861,50,50-100,1911,0.012033492082179183
STAT,1856,20,na,1876,1856.907158166008
SIM,1782,76,na,1858,355
STAT,1853,43,40-44,1896,1.6899466228253275
SIM,1833,32,25-29,1865,13
SIM,1906,30,na,1936,3316
STAT,1932,32,20-24,1964,3.06315802009244
SIM,1798,61,na,1859,910
SIM,1927,25,na,1952,4266
STAT,1827,53,na,1880,1324.0096575717146
SIM,1906,5,na,1911,3582
STAT,1867,43,35-39,1910,1.5947293738039632
SIM,1851,44,45-49,1895,2
STAT,1798,102,na,1900,0.08327591385141453
STAT,1864,48,na,1912,1870.5004714190927
SIM,1851,23,na,1874,1897
STAT,1858,52,40-44,1910,0.00775612413115845
SIM,1769,94,na,1863,2
STAT,1851,75,na,1926,740.5362970974741
STAT,1912,28,30-34,1940,36.35019659702818
SIM,1884,43,45-49,1927,2
STAT,1814,80,na,1894,284.3229543292036
STAT,1926,40,30-34,1966,0.14929991386473132
STAT,1848,90,na,1938,58.58311603764397
SIM,1930,38,35-39,1968,11
STAT,1840,50,20-24,1890,4.912243424522503E-4
SIM,1862,94,na,1956,9
SIM,1883,38,45-49,1921,2
SIM,1913,49,na,1962,3239
STAT,1848,31,15-19,1879,0.1246896770913448
STAT,1926,21,40-44,1947,3.870490249112105
STAT,1922,38,35-39,1960,2.597384227898194
SIM,1813,83,na,1896,170
STAT,1773,105,na,1878,0.017131588455981474
SIM,1937,18,15-19,1955,35
STAT,1919,47,25-29,1966,0.054353012223177524
SIM,1794,61,na,1855,828
STAT,1851,22,25-29,1873,49.17602965812715
STAT,1876,43,45-49,1919,1.4501760231261906
STAT,1912,20,35-39,1932,8.575920613522523
SIM,1880,32,20-24,1912,3
STAT,1827,53,40-44,1880,0.009114520780723879
STAT,1904,33,20-24,1937,2.094302777396123
SIM,1882,18,25-29,1900,5
SIM,1920,27,50-100,1947,4
STAT,1904,47,30-34,1951,0.07364555139175728
STAT,1843,44,45-49,1887,1.0145054947128107
STAT,1875,38,45-49,1913,1.9261037448052492
STAT,1894,44,40-44,1938,0.18706802408921044
SIM,1912,33,20-24,1945,4
SIM,1837,80,na,1917,351
STAT,1837,52,20-24,1889,4.8065409237728704E-4
STAT,1870,21,30-34,1891,16.557572706348815
STAT,1880,36,50-100,1916,1.2286369905802856
STAT,1840,43,30-34,1883,0.7770122494766112
STAT,1882,27,50-100,1909,0.587695225365611
SIM,1807,76,na,1883,336
SIM,1895,74,na,1969,1686
STAT,1834,25,50-100,1859,0.5281231190928432
STAT,1846,51,50-100,1897,0.011255363001353366
SIM,1915,34,35-39,1949,7
STAT,1840,32,na,1872,1732.3224136590698
STAT,1852,20,na,1872,1868.1929625628347
SIM,1883,51,50-100,1934,2
STAT,1882,67,na,1949,1456.3639768404885
STAT,1916,47,na,1963,3559.7337400185734
SIM,1919,18,30-34,1937,16
SIM,1934,21,40-44,1955,3
STAT,1891,15,20-24,1906,20.817046603703968
STAT,1842,36,40-44,1878,3.7575941732083122
STAT,1837,53,na,1890,1374.934927481572
STAT,1853,39,20-24,1892,0.5775040392803414
SIM,1920,28,30-34,1948,44
STAT,1895,37,na,1932,2901.6184162516233
SIM,1921,37,na,1958,3984
STAT,1795,71,na,1866,627.0860828218339
STAT,1907,34,35-39,1941,8.000494652129602
STAT,1833,60,na,1893,1170.1045264156787
STAT,1874,48,na,1922,2144.312749619722
SIM,1894,38,20-24,1932,3
SIM,1779,94,na,1873,2
SIM,1782,73,na,1855,460
SIM,1850,36,40-44,1886,4
STAT,1935,27,50-100,1962,1.2817471169976875
STAT,1886,38,20-24,1924,0.7654226929363613
STAT,1905,41,25-29,1946,0.06116660209887402
STAT,1865,28,25-29,1893,36.093777154877905
STAT,1863,35,15-19,1898,0.04699522320837946
SIM,1868,88,na,1956,95
STAT,1819,47,20-24,1866,0.022739240292556053
STAT,1839,15,50-100,1854,0.043177135222086147
STAT,1862,40,30-34,1902,0.9379783335842623
STAT,1918,39,20-24,1957,0.2619276449739553
SIM,1849,16,na,1865,2165
SIM,1868,82,na,1950,342
STAT,1930,23,20-24,1953,134.15110304707514
STAT,1873,16,15-19,1889,5.719667819736385
SIM,1878,17,20-24,1895,14
STAT,1887,43,20-24,1930,0.1666029774257567
STAT,1808,54,35-39,1862,0.02987490950390298
SIM,1834,42,35-39,1876,3
STAT,1937,18,50-100,1955,0.3434197179349851
SIM,1767,99,na,1866,1
SIM,1850,15,25-29,1865,9
SIM,1858,40,30-34,1898,1
STAT,1954,0,na,1954,4960.468519473663
SIM,1887,48,na,1935,2313
STAT,1884,45,45-49,1929,0.22245962347958698
STAT,1879,15,20-24,1894,17.61272233004132
STAT,1893,33,35-39,1926,12.0813059848166
SIM,1889,40,na,1929,2837
STAT,1929,18,15-19,1947,54.569958478222574
SIM,1946,18,40-44,1964,1
STAT,1850,35,na,1885,1722.4855738325448
STAT,1845,37,20-24,1882,0.5731254888695183
STAT,1895,40,50-100,1935,1.3142535888270095
STAT,1898,22,15-19,1920,4.217537002270263
STAT,1910,25,45-49,1935,1.600212752282247
SIM,1843,42,45-49,1885,2
SIM,1890,37,na,1927,2947
SIM,1848,68,na,1916,1092
SIM,1837,90,na,1927,33
SIM,1821,40,35-39,1861,1
SIM,1881,16,15-19,1897,3
SIM,1843,80,na,1923,391
STAT,1840,42,na,1882,1582.2109796425152
STAT,1846,20,na,1866,1985.1332715589674
STAT,1833,54,50-100,1887,0.009179077528739513
STAT,1815,68,na,1883,795.2450886688551
STAT,1912,35,20-24,1947,0.24537444181767776
SIM,1879,29,na,1908,2395
STAT,1878,46,15-19,1924,3.949260023209933E-4
SIM,1899,43,na,1942,3052
SIM,1944,21,50-100,1965,1
STAT,1880,31,35-39,1911,10.1271154457986
STAT,1862,47,15-19,1909,3.215808929821566E-4
STAT,1920,22,na,1942,3835.2166381964503
STAT,1927,22,50-100,1949,0.765836048965516
SIM,1866,0,na,1866,3208
STAT,1890,30,15-19,1920,0.1657980767903418
STAT,1842,53,50-100,1895,0.01076153614886907
STAT,1820,80,na,1900,325.8812785004584
SIM,1914,29,35-39,1943,16
SIM,1907,32,35-39,1939,7
STAT,1820,105,na,1925,0.015446354766042936
STAT,1863,39,30-34,1902,4.373843796452285
SIM,1905,17,25-29,1922,9
STAT,1858,45,35-39,1903,0.10472920517130889
STAT,1906,29,35-39,1935,13.181111342299753
SIM,1919,37,na,1956,3883
STAT,1822,48,50-100,1870,0.325583115452965
SIM,1885,44,40-44,1929,5
SIM,1874,30,20-24,1904,2
STAT,1812,50,45-49,1862,0.048325763878888844
STAT,1871,27,20-24,1898,11.004949493449175
SIM,1868,41,na,1909,2093
STAT,1842,15,25-29,1857,5.332377493223499
STAT,1877,44,40-44,1921,2.1743915375432645
SIM,1903,28,30-34,1931,45
STAT,1832,51,25-29,1883,0.002271245412943698
SIM,1877,55,na,1932,1977
STAT,1915,19,35-39,1934,0.8252266589120769
STAT,1909,40,30-34,1949,0.1142504418624633
STAT,1877,51,30-34,1928,0.005861018719970116
STAT,1844,93,na,1937,20.297728152683778
STAT,1900,45,50-100,1945,0.18336581949317485
SIM,1831,95,na,1926,9
SIM,1862,41,35-39,1903,3
SIM,1856,56,na,1912,1595
STAT,1852,33,30-34,1885,12.970520706820666
STAT,1878,53,20-24,1931,7.148321506626501E-4
STAT,1906,46,50-100,1952,0.19115733012247887
STAT,1925,16,40-44,1941,1.6000722850795905
STAT,1865,92,na,1957,45.8730919119067
STAT,1827,49,20-24,1876,0.010688966150603836
STAT,1889,32,15-19,1921,0.16608364224181
STAT,1921,47,30-34,1968,0.09493709908079195
STAT,1864,40,15-19,1904,0.011744812387748766
STAT,1857,47,40-44,1904,0.12695977637162115
SIM,1933,16,40-44,1949,5
STAT,1837,22,40-44,1859,1.7704056691602144
STAT,1847,26,15-19,1873,0.40503645847811265
SIM,1845,22,40-44,1867,2
STAT,1806,61,na,1867,970.5186962318952
SIM,1900,23,35-39,1923,10
STAT,1853,51,45-49,1904,0.011035487951848095
SIM,1939,10,na,1949,3711
STAT,1852,42,45-49,1894,1.0837076969982185
SIM,1860,33,30-34,1893,16
STAT,1763,112,na,1875,3.986773823960654E-4
STAT,1932,19,35-39,1951,5.220827871704905
STAT,1902,40,45-49,1942,0.13996057397040598
STAT,1838,16,50-100,1854,0.0437034289229892
STAT,1826,42,35-39,1868,1.7692662760376798
SIM,1940,19,35-39,1959,8
SIM,1844,75,na,1919,647
STAT,1837,45,15-19,1882,2.7647679131785835E-4
STAT,1841,53,25-29,1894,0.0024026985012827588
SIM,1923,19,35-39,1942,6
SIM,1843,90,na,1933,39
SIM,1864,16,15-19,1880,5
STAT,1870,51,45-49,1921,0.013513894446864053
STAT,1862,37,20-24,1899,0.6226289335368841
SIM,1899,33,na,1932,3131
STAT,1868,54,40-44,1922,0.009228072236678757
STAT,1817,54,45-49,1871,0.030120651802917793
STAT,1876,33,na,1909,2319.222442480738
STAT,1909,62,na,1971,2903.0723148139996
STAT,1930,37,30-34,1967,2.2457778389828937
SIM,1874,37,40-44,1911,8
STAT,1950,2,na,1952,4467.437978908947
STAT,1861,32,45-49,1893,1.3697499120744212
SIM,1921,21,50-100,1942,1
SIM,1869,27,20-24,1896,13
SIM,1876,70,na,1946,1334
SIM,1825,95,na,1920,7
STAT,1916,46,45-49,1962,0.21111476566885057
STAT,1905,43,15-19,1948,0.0013000263398156649
STAT,1831,31,20-24,1862,2.1851260706246305
STAT,1856,16,15-19,1872,5.202881146177289
STAT,1907,33,na,1940,3325.6251770176364
STAT,1820,40,50-100,1860,2.0640083768129127
STAT,1931,33,15-19,1964,0.15896927218507614
STAT,1826,43,30-34,1869,1.1010215277140303
STAT,1854,49,30-34,1903,0.06781287627689946
SIM,1949,1,na,1950,4331
STAT,1826,46,50-100,1872,0.2298560628331731
STAT,1912,18,20-24,1930,25.831761959402844
SIM,1834,46,50-100,1880,1
SIM,1838,68,na,1906,981
STAT,1821,46,15-19,1867,6.402675839265225E-4
SIM,1873,28,25-29,1901,46
SIM,1927,2,na,1929,4756
STAT,1923,42,20-24,1965,0.019499542322195383
SIM,1966,0,na,1966,4466
STAT,1925,22,35-39,1947,10.64715151062472
SIM,1825,61,na,1886,1052
SIM,1851,20,25-29,1871,63
SIM,1920,18,20-24,1938,135
STAT,1922,48,45-49,1970,0.23521655634783176
STAT,1920,15,na,1935,4126.08852908434
SIM,1878,21,40-44,1899,5
STAT,1853,46,45-49,1899,0.17911097597915604
STAT,1893,34,30-34,1927,20.73813938881603
STAT,1868,43,50-100,1911,0.9453459203345849
SIM,1903,12,na,1915,3475
SIM,1933,22,35-39,1955,13
STAT,1917,31,40-44,1948,3.887098089366107
STAT,1923,29,na,1952,4034.035845178879
STAT,1800,66,na,1866,778.8246994647378
STAT,1877,40,25-29,1917,0.6356215093042414
STAT,1790,65,na,1855,735.0742
STAT,1867,40,15-19,1907,0.012374007709879392
STAT,1943,18,50-100,1961,0.3752013198407791
STAT,1903,30,35-39,1933,13.721736324989187
SIM,1822,91,na,1913,21
STAT,1919,44,20-24,1963,0.018019611146445853
STAT,1892,20,20-24,1912,82.02724841878816
SIM,1922,2,na,1924,4417
SIM,1876,43,50-100,1919,2
SIM,1925,31,40-44,1956,3
STAT,1904,1,na,1905,3688.282594440074
STAT,1823,39,na,1862,1507.6742923539584
SIM,1865,26,25-29,1891,44
STAT,1833,87,na,1920,108.09151094573618
SIM,1813,76,na,1889,367
STAT,1860,89,na,1949,80.52454090158754
SIM,1938,23,15-19,1961,4
STAT,1821,105,na,1926,0.01562105971169162
SIM,1903,24,15-19,1927,4
STAT,1816,49,45-49,1865,0.5399013793177367
STAT,1843,41,40-44,1884,1.58442578286479
STAT,1901,18,45-49,1919,0.08615236918338924
STAT,1836,32,50-100,1868,0.7499834005935767
SIM,1829,61,na,1890,1051
STAT,1904,36,25-29,1940,0.8461520764930437
STAT,1913,48,35-39,1961,0.11855533642242028
SIM,1852,94,na,1946,8
STAT,1852,23,50-100,1875,0.34868770563182067
STAT,1815,65,na,1880,889.3671204313703
STAT,1853,53,35-39,1906,0.00641069249292343
STAT,1905,48,na,1953,3034.1073747264795
STAT,1943,21,40-44,1964,3.380577664916804
STAT,1806,54,na,1860,1134.299250912922
STAT,1895,47,na,1942,2758.495671163109
STAT,1926,0,na,1926,5217.894795788694
STAT,1772,84,na,1856,88.42047615
STAT,1830,40,35-39,1870,1.448570860207457
STAT,1835,42,45-49,1877,1.1413588139085467
STAT,1854,45,15-19,1899,2.890469975065185E-4
SIM,1839,16,na,1855,2046
SIM,1937,25,na,1962,3329
STAT,1884,21,25-29,1905,53.589820599538896
STAT,1861,48,45-49,1909,0.18304572292315893
SIM,1860,32,35-39,1892,11
SIM,1817,76,na,1893,429
SIM,1839,36,25-29,1875,2
SIM,1873,25,20-24,1898,13
STAT,1882,51,20-24,1933,6.811815520869551E-4
STAT,1820,47,45-49,1867,0.3958440181854919
SIM,1918,48,na,1966,3689
STAT,1896,7,na,1903,3250.6649748283444
STAT,1842,39,45-49,1881,1.509417549606978
STAT,1816,54,na,1870,1235.317229848761
STAT,1872,74,na,1946,1051.610412539838
SIM,1850,39,45-49,1889,1
STAT,1828,38,na,1866,1547.8169114276573
SIM,1903,49,na,1952,2953
SIM,1867,42,30-34,1909,4
SIM,1893,55,na,1948,2580
STAT,1777,83,na,1860,111.28617297346877
STAT,1898,35,50-100,1933,1.5844768218714131
SIM,1832,27,25-29,1859,40
SIM,1848,23,20-24,1871,53
STAT,1813,48,30-34,1861,0.26034496028984205
STAT,1873,52,25-29,1925,0.0033755876429699566
STAT,1893,30,15-19,1923,0.1719797057668094
SIM,1858,43,35-39,1901,1
SIM,1825,30,25-29,1855,8
SIM,1907,26,40-44,1933,7
STAT,1852,32,35-39,1884,7.601747440403226
STAT,1926,43,35-39,1969,0.23413711234206075
STAT,1849,48,45-49,1897,0.174745228895208
SIM,1837,23,45-49,1860,1
STAT,1822,34,15-19,1856,0.3094848244652222
SIM,1834,43,30-34,1877,1
STAT,1875,45,35-39,1920,0.1372973382937864
SIM,1900,38,na,1938,3139
SIM,1902,19,15-19,1921,7
STAT,1787,83,na,1870,127.85539673874683
SIM,1820,62,na,1882,1034
STAT,1801,55,na,1856,1031.3295644033
STAT,1880,39,30-34,1919,5.254490535757501
SIM,1832,43,na,1875,1485
SIM,1938,16,25-29,1954,49
STAT,1951,14,na,1965,4417.3472321518475
STAT,1938,28,na,1966,3504.446330941874
STAT,1865,102,na,1967,1.5521541162823789
STAT,1898,27,25-29,1925,54.07896584329567
STAT,1918,41,35-39,1959,0.2025496453378728
SIM,1823,76,na,1899,452
SIM,1791,87,na,1878,44
STAT,1858,42,30-34,1900,0.8504895783646484
SIM,1853,42,na,1895,1756
STAT,1860,27,45-49,1887,0.8601769036303989
STAT,1883,16,25-29,1899,5.261490289871692
SIM,1943,25,na,1968,3645
STAT,1886,33,na,1919,2371.275402761857
STAT,1938,18,25-29,1956,40.37117803776268
SIM,1922,26,na,1948,3971
SIM,1884,30,30-34,1914,21
SIM,1870,82,na,1952,409
SIM,1802,77,na,1879,333
SIM,1874,33,25-29,1907,15
STAT,1887,18,na,1905,2661.7761702404314
STAT,1931,37,30-34,1968,2.2802245575671836
STAT,1855,54,30-34,1909,0.004113717150475845
SIM,1870,40,30-34,1910,3
STAT,1859,42,30-34,1901,0.8633603989108203
STAT,1849,46,50-100,1895,0.18469046710831605
SIM,1892,42,40-44,1934,6
STAT,1774,105,na,1879,0.0158452508999152
SIM,1892,21,25-29,1913,68
STAT,1817,39,na,1856,1415.157005660494
STAT,1889,47,na,1936,2612.1406224404545
STAT,1948,15,30-34,1963,13.184970888529735
SIM,1912,23,na,1935,3644
STAT,1884,42,40-44,1926,2.096711160979308
SIM,1892,34,50-100,1926,1
STAT,1831,47,50-100,1878,0.17496965693684602
SIM,1770,88,na,1858,39
SIM,1820,58,na,1878,1187
STAT,1891,18,25-29,1909,6.605813188344234
STAT,1930,26,25-29,1956,79.09862832431985
SIM,1955,10,na,1965,4604
SIM,1946,18,25-29,1964,55
STAT,1893,33,50-100,1926,1.0930552710973886
STAT,1809,52,45-49,1861,0.03900850014455962
STAT,1876,30,30-34,1906,17.177744083152245
STAT,1879,18,25-29,1897,5.588994234644721
STAT,1812,52,35-39,1864,0.027541233153690576
SIM,1888,39,25-29,1927,2
SIM,1855,16,na,1871,2225
STAT,1870,31,25-29,1901,9.531241306202777
STAT,1922,35,30-34,1957,1.962549784558194
SIM,1792,76,na,1868,330
STAT,1845,31,50-100,1876,0.77895155265413
SIM,1851,57,na,1908,1499
STAT,1834,79,na,1913,433.4242247493684
STAT,1859,17,45-49,1876,0.0570126561449227
SIM,1876,15,na,1891,2486
SIM,1871,71,na,1942,1199
STAT,1838,38,na,1876,1717.1248326065415
STAT,1933,29,na,1962,4694.364936404836
STAT,1898,48,40-44,1946,0.12190707490781776
SIM,1833,28,na,1861,1729
STAT,1907,17,35-39,1924,0.7614588632771294
STAT,1852,28,50-100,1880,0.536291490854666
SIM,1915,17,35-39,1932,2
SIM,1924,29,45-49,1953,2
STAT,1884,34,50-100,1918,0.8478294945911686
STAT,1916,29,45-49,1945,1.6754375651273081
STAT,1841,50,20-24,1891,5.160410938148066E-4
STAT,1866,23,30-34,1889,15.534601181396772
SIM,1892,70,na,1962,2109
SIM,1930,35,30-34,1965,1
STAT,1935,14,na,1949,5100.499531750565
SIM,1875,44,30-34,1919,1
STAT,1924,44,50-100,1968,0.13156767177306183
SIM,1842,44,35-39,1886,2
STAT,1875,92,na,1967,131.06220848160493
STAT,1867,44,30-34,1911,1.0060794609968318
STAT,1850,17,25-29,1867,4.881348992359628
STAT,1885,32,30-34,1917,16.440830630109353
STAT,1856,19,na,1875,1977.0869216155977
SIM,1819,61,na,1880,1033
STAT,1830,80,na,1910,373.3512020908106
SIM,1923,16,30-34,1939,15
STAT,1881,44,30-34,1925,1.035032544073418
SIM,1884,41,na,1925,2284
STAT,1845,54,20-24,1899,5.078136250738893E-4
STAT,1871,34,na,1905,2219.36687593998
SIM,1886,26,45-49,1912,1
STAT,1915,16,30-34,1931,2.415930431484281
STAT,1899,32,25-29,1931,13.258054554911757
STAT,1905,47,30-34,1952,0.07421284282842419
SIM,1776,80,na,1856,189
SIM,1886,70,na,1956,1306
SIM,1937,16,25-29,1953,45
STAT,1796,97,na,1893,1.1570152098028128
STAT,1881,49,25-29,1930,0.05146859319325932
STAT,1910,2,na,1912,3815.9657185602355
SIM,1945,6,na,1951,3920
STAT,1825,68,na,1893,812.2151032078609
STAT,1902,23,45-49,1925,0.9268182967128271
STAT,1902,34,na,1936,3181.0971433687278
STAT,1857,26,25-29,1883,32.697914692387634
SIM,1910,23,45-49,1933,1
SIM,1819,35,45-49,1854,1
STAT,1914,15,na,1929,3791.930245117948
SIM,1851,41,40-44,1892,3
STAT,1907,24,25-29,1931,78.94400303834699
STAT,1854,93,na,1947,20.910331481229058
SIM,1881,23,na,1904,1839
STAT,1904,63,na,1967,2667.880710650889
SIM,1828,41,50-100,1869,3
STAT,1835,45,50-100,1880,0.18576230415972872
STAT,1864,45,50-100,1909,0.20884985977803128
STAT,1775,98,na,1873,0.5168476296999844
STAT,1928,19,50-100,1947,0.4435654307379229
STAT,1942,19,45-49,1961,0.49284209593988454
SIM,1826,41,30-34,1867,7
STAT,1862,50,40-44,1912,0.008625574734810324
SIM,1889,24,20-24,1913,88
STAT,1933,24,35-39,1957,11.790946253690295
STAT,1894,20,50-100,1914,0.4980316432738902
STAT,1817,51,40-44,1868,0.023200508257388616
SIM,1841,57,na,1898,1334
STAT,1881,51,20-24,1932,6.766521352016543E-4
STAT,1913,40,20-24,1953,0.016454664088521097
STAT,1929,16,25-29,1945,52.37244468034287
STAT,1798,105,na,1903,0.00832849241960086
SIM,1843,45,50-100,1888,5
STAT,1917,33,na,1950,3725.6248250119265
STAT,1781,98,na,1879,0.5632993189056273
SIM,1893,32,30-34,1925,29
STAT,1845,51,35-39,1896,0.006121166562449402
SIM,1934,11,na,1945,4952
SIM,1949,10,na,1959,4244
SIM,1915,24,25-29,1939,97
STAT,1818,41,30-34,1859,2.804092228293013
SIM,1897,15,15-19,1912,8
STAT,1927,39,30-34,1966,2.136083817656879
STAT,1760,99,na,1859,0.257938957300205
STAT,1833,94,na,1927,12.261980526232088
SIM,1842,37,45-49,1879,2
SIM,1913,12,na,1925,3690
STAT,1863,60,na,1923,1581.0849285212425
STAT,1925,33,40-44,1958,4.387209852515643
STAT,1793,79,na,1872,252.24075886361697
SIM,1933,33,40-44,1966,6
STAT,1834,37,45-49,1871,1.5388549413441293
SIM,1863,42,na,1905,1923
STAT,1843,20,25-29,1863,49.23872419842251
SIM,1956,15,30-34,1971,22
STAT,1866,29,50-100,1895,0.5533939336536792
SIM,1872,45,50-100,1917,2
STAT,1928,42,50-100,1970,0.1414788493802045
SIM,1911,41,40-44,1952,1
STAT,1878,26,45-49,1904,1.0968675830880685
STAT,1910,43,50-100,1953,0.10426135210295265
STAT,1877,18,na,1895,2468.4446467941184
STAT,1889,15,15-19,1904,6.953355602004209
STAT,1946,20,15-19,1966,5.599993833959179
STAT,1824,49,35-39,1873,0.16589100259376857
STAT,1917,26,na,1943,3724.1539212517414
SIM,1855,53,na,1908,1694
STAT,1903,2,na,1905,3583.052807229576
SIM,1902,24,45-49,1926,5
SIM,1860,44,40-44,1904,4
STAT,1777,102,na,1879,0.07346443959341295
STAT,1882,45,35-39,1927,0.12990243879603838
SIM,1903,17,15-19,1920,8
STAT,1845,51,40-44,1896,0.007485312236247565
SIM,1844,28,20-24,1872,9
STAT,1863,31,35-39,1894,8.429822219134845
SIM,1859,43,na,1902,1853
STAT,1780,97,na,1877,0.7719216933956832
STAT,1889,48,25-29,1937,0.037416888993804125
STAT,1913,12,na,1925,3814.7139644884446
STAT,1784,87,na,1871,51.64469015956586
SIM,1857,15,25-29,1872,5
SIM,1896,75,na,1971,1661
STAT,1829,47,15-19,1876,3.269429110341436E-4
STAT,1771,101,na,1872,0.09375340816884645
STAT,1849,28,30-34,1877,22.22342626097547
STAT,1841,46,30-34,1887,0.06790200331234254
SIM,1837,40,na,1877,1655
STAT,1937,35,20-24,1972,0.24945129414680628
STAT,1840,28,40-44,1868,2.433543411410711
SIM,1855,102,na,1957,1
STAT,1851,39,50-100,1890,0.874279418917589
STAT,1850,20,15-19,1870,2.831776496227244
STAT,1955,15,15-19,1970,56.93864995295335
STAT,1839,94,na,1933,13.306695389753367
STAT,1840,17,30-34,1857,1.3542709752510391
STAT,1878,45,15-19,1923,3.97734004392001E-4
STAT,1815,54,35-39,1869,0.01787558439266249
STAT,1836,28,20-24,1864,9.75961818923706
STAT,1798,95,na,1893,3.776577631518019
STAT,1828,54,45-49,1882,0.009924450091737315
STAT,1804,53,20-24,1857,0.0025556092977974663
SIM,1851,43,30-34,1894,1
STAT,1809,72,na,1881,572.361287909117
SIM,1842,27,na,1869,1826
STAT,1882,8,na,1890,2388.2430663954187
STAT,1850,31,25-29,1881,7.631944517692057
SIM,1855,18,25-29,1873,7
STAT,1911,21,40-44,1932,3.021691231012245
SIM,1847,58,na,1905,1510
SIM,1900,27,45-49,1927,1
STAT,1824,41,25-29,1865,0.8662191496052873
STAT,1857,34,15-19,1891,0.1051939963556659
STAT,1939,32,20-24,1971,2.3510968124564418
SIM,1880,21,35-39,1901,6
STAT,1893,48,45-49,1941,0.15748187421533286
STAT,1792,82,na,1874,163.13659224334145
STAT,1866,15,50-100,1881,0.04433616634890455
STAT,1905,17,na,1922,3448.7010132462283
STAT,1871,55,na,1926,1939.6648200258135
STAT,1929,11,na,1940,4783.972675899416
SIM,1806,76,na,1882,390
SIM,1857,26,35-39,1883,7
STAT,1915,0,na,1915,4439.88964591251
STAT,1884,42,35-39,1926,1.6879892611416782
SIM,1848,22,20-24,1870,61
STAT,1843,54,40-44,1897,0.006915321972042548
STAT,1849,15,25-29,1864,5.292713167108639
SIM,1878,39,30-34,1917,3
STAT,1842,25,40-44,1867,2.7216488447846725
SIM,1874,23,30-34,1897,24
SIM,1850,25,40-44,1875,3
SIM,1892,42,35-39,1934,7
STAT,1876,48,15-19,1924,3.8549618144550086E-4
STAT,1875,18,30-34,1893,1.543615719737597
STAT,1953,18,15-19,1971,51.845229984647794
SIM,1825,55,na,1880,1249
STAT,1843,43,30-34,1886,0.7893572362158858
STAT,1892,19,45-49,1911,0.07687836858111154
SIM,1873,31,45-49,1904,1
SIM,1850,22,na,1872,1973
STAT,1817,51,35-39,1868,0.018972378291617003
STAT,1824,30,15-19,1854,0.49169492896835826
STAT,1910,33,50-100,1943,0.7499601929957357
STAT,1921,43,15-19,1964,0.0016314273574565678
STAT,1860,50,25-29,1910,0.0027540026556783915
STAT,1909,48,20-24,1957,0.009566894042306219
STAT,1834,63,na,1897,1106.214956619552
SIM,1821,65,na,1886,879
STAT,1847,18,25-29,1865,5.184693663027532
STAT,1853,17,40-44,1870,0.1665106435294685
SIM,1884,31,20-24,1915,2
STAT,1885,63,na,1948,1680.1786222526462
STAT,1897,42,45-49,1939,0.13114137762370048
SIM,1814,71,na,1885,569
STAT,1882,47,30-34,1929,0.08851704336943085
SIM,1772,90,na,1862,17
SIM,1872,15,20-24,1887,14
STAT,1829,38,30-34,1867,4.745595811210608
STAT,1801,92,na,1893,14.723249429278889
STAT,1850,33,20-24,1883,1.9727002680822803
SIM,1872,49,na,1921,2062
STAT,1833,36,25-29,1869,2.231676585300317
STAT,1855,37,15-19,1892,0.03990492970109776
STAT,1948,17,50-100,1965,0.405060894396137
STAT,1939,30,25-29,1969,8.919003131597874
STAT,1831,39,25-29,1870,2.1546383185111537
STAT,1851,18,45-49,1869,0.05679387008160658
SIM,1867,34,25-29,1901,15
STAT,1880,49,50-100,1929,0.23949450679519393
SIM,1897,17,na,1914,3270
SIM,1857,28,30-34,1885,25
STAT,1896,29,30-34,1925,31.194531554862174
STAT,1761,110,na,1871,0.0024078697592154097
STAT,1843,41,35-39,1884,1.275566113409055
STAT,1895,45,45-49,1940,0.16558947914022953
SIM,1893,37,50-100,1930,1
STAT,1927,28,15-19,1955,0.8079012111090771
STAT,1877,21,50-100,1898,0.40081440323513784
STAT,1932,35,50-100,1967,0.5338369495578175
STAT,1895,30,50-100,1925,1.1375174470964498
STAT,1949,17,40-44,1966,1.5368355459787015
STAT,1864,15,20-24,1879,17.17043144441742
SIM,1908,42,40-44,1950,1
STAT,1817,53,30-34,1870,0.012603993279834478
STAT,1829,49,40-44,1878,0.13631243164072362
SIM,1868,20,na,1888,2135
STAT,1862,18,20-24,1880,16.303722177790423
SIM,1797,82,na,1879,137
STAT,1884,44,30-34,1928,1.0585255691598379
STAT,1832,51,30-34,1883,0.0038169541335398584
SIM,1818,61,na,1879,980
STAT,1830,43,20-24,1873,0.12183239629215961
STAT,1853,15,45-49,1868,0.06017484459121724
STAT,1855,41,na,1896,1649.8602345641038
STAT,1900,46,35-39,1946,0.10378654735527629
STAT,1839,54,20-24,1893,4.7779485377404715E-4
SIM,1862,41,40-44,1903,3
SIM,1939,24,40-44,1963,3
SIM,1764,95,na,1859,1
STAT,1805,82,na,1887,180.53257118276724
SIM,1956,8,na,1964,4789
STAT,1901,27,na,1928,3155.799530178721
STAT,1826,68,na,1894,834.522538491136
SIM,1843,68,na,1911,1070
SIM,1851,63,na,1914,1326
SIM,1836,18,15-19,1854,5
STAT,1889,53,na,1942,2470.890924108528
STAT,1898,37,40-44,1935,5.596285425226159
SIM,1869,42,35-39,1911,2
SIM,1870,18,20-24,1888,19
SIM,1837,38,30-34,1875,4
SIM,1851,41,35-39,1892,2
STAT,1837,44,15-19,1881,0.00938068630551859
STAT,1861,23,25-29,1884,45.863325385461856
SIM,1869,30,40-44,1899,7
STAT,1933,25,35-39,1958,18.848780759059007
STAT,1950,22,30-34,1972,32.2112471188075
SIM,1833,23,15-19,1856,2
STAT,1856,66,na,1922,1208.0779897775428
STAT,1893,26,50-100,1919,0.7689991501235804
STAT,1917,42,40-44,1959,0.24659302810798758
SIM,1936,1,na,1937,3078
SIM,1941,22,30-34,1963,41
STAT,1841,30,45-49,1871,1.489250784422412
SIM,1922,28,35-39,1950,19
SIM,1904,28,na,1932,3276
SIM,1826,32,40-44,1858,4
STAT,1824,43,20-24,1867,0.20342318429431117
SIM,1898,29,30-34,1927,35
SIM,1919,32,45-49,1951,2
STAT,1851,35,na,1886,1748.8490557769167
SIM,1922,17,25-29,1939,61
STAT,1868,91,na,1959,83.59111301918085
STAT,1918,22,35-39,1940,9.593768902826667
SIM,1863,88,na,1951,97
STAT,1805,49,25-29,1854,0.21402410983168008
STAT,1846,88,na,1934,101.82376158356361
STAT,1842,74,na,1916,803.6892309687847
STAT,1885,23,40-44,1908,1.9561419803569833
STAT,1914,17,25-29,1931,8.468646320523279
SIM,1867,19,na,1886,2440
STAT,1864,61,na,1925,1573.3384234406792
SIM,1771,89,na,1860,32
STAT,1839,52,25-29,1891,0.0023457116892420383
STAT,1891,21,45-49,1912,0.8174769758758514
STAT,1834,54,45-49,1888,0.008876078818303185
STAT,1855,25,na,1880,1786.390852812737
STAT,1857,36,40-44,1893,3.2772043972338305
SIM,1872,29,40-44,1901,6
STAT,1854,44,15-19,1898,0.009747355001648958
STAT,1859,36,45-49,1895,1.5060979680875137
SIM,1926,31,na,1957,4273
STAT,1874,34,20-24,1908,2.586717864035734
SIM,1808,83,na,1891,115
SIM,1874,29,45-49,1903,3
SIM,1800,63,na,1863,823
STAT,1843,56,na,1899,1377.6640628348428
SIM,1888,40,na,1928,2627
STAT,1935,22,35-39,1957,12.112922468516947
STAT,1933,22,30-34,1955,36.01529943641208
SIM,1848,83,na,1931,274
SIM,1887,26,20-24,1913,15
STAT,1824,30,45-49,1854,6.020943293971868
SIM,1843,33,25-29,1876,11
STAT,1840,26,15-19,1866,0.37393032374669827
STAT,1902,52,na,1954,2855.4670540193183
STAT,1808,48,50-100,1856,0.9154227451288272
STAT,1833,38,na,1871,1625.681173599104
STAT,1929,25,15-19,1954,0.8377915484253414
STAT,1928,32,45-49,1960,1.858720505199277
SIM,1880,20,na,1900,2417
SIM,1943,22,35-39,1965,10
STAT,1903,27,20-24,1930,15.768856663227401
STAT,1859,45,35-39,1904,0.1063141167798615
SIM,1884,34,na,1918,2314
STAT,1873,38,na,1911,2246.099631706867
STAT,1860,71,na,1931,1023.1375855649652
STAT,1869,52,40-44,1921,0.009583502797633913
SIM,1916,13,na,1929,3877
STAT,1868,28,40-44,1896,2.6905238021765103
SIM,1865,50,50-100,1915,1
SIM,1882,34,20-24,1916,2
SIM,1917,54,na,1971,3495
SIM,1863,29,na,1892,1968
STAT,1811,46,45-49,1857,0.7991546306732603
STAT,1879,26,20-24,1905,11.640729016558401
STAT,1827,109,na,1936,4.109617294220651E-4
STAT,1839,41,15-19,1880,0.01078639030979837
SIM,1888,42,45-49,1930,7
SIM,1926,22,35-39,1948,12
SIM,1834,91,na,1925,40
SIM,1825,34,50-100,1859,5
SIM,1911,27,20-24,1938,19
STAT,1819,74,na,1893,585.851761587607
SIM,1934,32,40-44,1966,8
SIM,1881,30,50-100,1911,3
STAT,1891,21,15-19,1912,3.8674784944273335
STAT,1930,36,50-100,1966,0.5178175409262231
STAT,1864,16,50-100,1880,0.04717012022257015
SIM,1793,92,na,1885,14
STAT,1810,50,40-44,1860,0.03495354663348644
STAT,1905,38,35-39,1943,2.074262297477341
SIM,1900,14,na,1914,3421
STAT,1849,26,35-39,1875,8.638942372546223
STAT,1890,17,15-19,1907,6.854203282789337
SIM,1893,23,40-44,1916,3
STAT,1820,49,20-24,1869,0.01954278284934195
STAT,1850,39,35-39,1889,4.960722967369923
STAT,1891,32,25-29,1923,11.97136375391893
SIM,1852,22,40-44,1874,1
STAT,1913,49,25-29,1962,0.04862633111597873
SIM,1821,40,40-44,1861,1
STAT,1892,17,na,1909,2988.424244340604
STAT,1905,27,25-29,1932,57.76235306774275
STAT,1867,10,na,1877,2408.807071025496
STAT,1907,21,20-24,1928,95.9204956079695
SIM,1872,65,na,1937,1542
STAT,1868,20,30-34,1888,16.28801718226682
SIM,1854,12,na,1866,2280
STAT,1791,107,na,1898,8.731904938024787E-4
STAT,1863,34,15-19,1897,0.11704765509288609
STAT,1818,44,35-39,1862,3.99180528591569
STAT,1868,26,45-49,1894,1.004197318752988
STAT,1871,44,20-24,1915,0.14696718129204595
SIM,1810,81,na,1891,194
SIM,1835,22,40-44,1857,4
SIM,1842,17,30-34,1859,1
SIM,1822,39,25-29,1861,3
SIM,1884,34,25-29,1918,16
STAT,1871,47,50-100,1918,0.2293164638274336
STAT,1924,38,45-49,1962,0.7586249609607257
STAT,1815,40,45-49,1855,4.21325168935254
SIM,1898,16,25-29,1914,12
STAT,1818,92,na,1910,20.453973595577104
STAT,1926,32,40-44,1958,4.4700699704497575
SIM,1823,101,na,1924,1
STAT,1838,53,na,1891,1422.319934435476
STAT,1880,31,40-44,1911,4.336737669188911
STAT,1876,34,25-29,1910,9.911242101167675
STAT,1835,33,25-29,1868,8.213851208155145
STAT,1924,32,30-34,1956,17.364176001001972
STAT,1907,38,45-49,1945,0.5941450850080998
STAT,1833,33,20-24,1866,2.1132406639913914
STAT,1851,51,40-44,1902,0.007609224428931865
SIM,1939,26,50-100,1965,5
STAT,1792,109,na,1901,1.2969486220773237E-4
SIM,1898,27,35-39,1925,14
STAT,1790,99,na,1889,0.3441385341795018
STAT,1862,1,na,1863,2936.678295636091
SIM,1836,40,50-100,1876,2
SIM,1841,33,20-24,1874,2
STAT,1924,21,20-24,1945,124.32289312882324
STAT,1896,38,15-19,1934,0.06971571552111057
SIM,1932,32,30-34,1964,24
STAT,1913,48,40-44,1961,0.14497623963365638
STAT,1926,38,50-100,1964,0.48423646129679077
STAT,1844,22,40-44,1866,1.8069916829992296
STAT,1848,47,25-29,1895,0.04260060540891266
STAT,1885,24,25-29,1909,53.5675076932116
SIM,1932,21,20-24,1953,125
STAT,1860,41,40-44,1901,1.7318928006493592
STAT,1809,56,na,1865,1087.2666970548414
STAT,1882,31,45-49,1913,1.6086233363574516
STAT,1881,29,40-44,1910,2.714232314297543
STAT,1879,38,15-19,1917,0.05525431340426874
SIM,1822,38,40-44,1860,6
SIM,1876,20,30-34,1896,15
SIM,1934,22,50-100,1956,4
SIM,1826,44,35-39,1870,6
SIM,1826,33,25-29,1859,12
STAT,1813,61,na,1874,966.089190800082
STAT,1922,29,na,1951,3975.9341229893244
SIM,1930,38,40-44,1968,2
SIM,1893,35,35-39,1928,19
SIM,1915,21,20-24,1936,101
STAT,1922,38,40-44,1960,1.607547434506047
SIM,1846,25,20-24,1871,16
STAT,1885,35,35-39,1920,6.723423476938355
SIM,1832,30,45-49,1862,1
STAT,1830,40,40-44,1870,1.799321097583361
STAT,1887,70,na,1957,1538.7125075061838
STAT,1918,9,na,1927,4093.35307586812
SIM,1932,38,45-49,1970,1
STAT,1812,46,50-100,1858,0.8360517900881506
STAT,1820,36,15-19,1856,0.1366901985908198
STAT,1869,50,45-49,1919,0.013472470513677882
STAT,1874,20,na,1894,2296.4207475588396
STAT,1907,32,30-34,1939,13.912483841944987
STAT,1937,22,45-49,1959,1.035103249671902
SIM,1915,32,30-34,1947,18
SIM,1945,22,45-49,1967,1
STAT,1889,13,na,1902,3007.195437478104
SIM,1917,32,35-39,1949,11
STAT,1883,4,na,1887,2598.6339821266065
STAT,1854,44,45-49,1898,1.0563695241382192
STAT,1859,38,40-44,1897,3.275077514064887
STAT,1880,91,na,1971,210.04616074056122
SIM,1930,7,na,1937,4914
STAT,1838,25,20-24,1863,10.164212477741097
STAT,1909,32,35-39,1941,8.238524585341558
SIM,1893,24,25-29,1917,67
STAT,1891,34,20-24,1925,3.132235810389204
STAT,1935,25,45-49,1960,2.2266432758338914
STAT,1834,51,35-39,1885,0.0055877962900707685
STAT,1855,25,20-24,1880,9.687626973856988
STAT,1828,51,40-44,1879,0.008396370747002098
SIM,1890,31,45-49,1921,2
SIM,1815,96,na,1911,1
STAT,1846,31,35-39,1877,8.96911474640379
STAT,1865,45,35-39,1910,0.12107239024141811
SIM,1859,83,na,1942,285
STAT,1936,18,15-19,1954,40.93806885308344
STAT,1807,49,35-39,1856,0.5204897213585231
STAT,1948,24,40-44,1972,3.644761961297418
SIM,1860,24,na,1884,2000
STAT,1918,38,20-24,1956,0.2622213328667659
STAT,1795,107,na,1902,9.822160189241478E-4
SIM,1841,31,25-29,1872,14
SIM,1899,5,na,1904,3466
SIM,1937,15,na,1952,3304
SIM,1841,20,15-19,1861,6
STAT,1844,34,35-39,1878,8.238004560541128
STAT,1940,18,35-39,1958,4.023580474832394
SIM,1852,34,35-39,1886,8
SIM,1934,26,na,1960,4682
STAT,1862,35,na,1897,1921.039128738281
SIM,1847,41,45-49,1888,2
SIM,1874,15,25-29,1889,7
SIM,1930,36,na,1966,4655
STAT,1889,45,20-24,1934,0.014134583624968007
STAT,1866,25,na,1891,2093.536103295185
SIM,1819,86,na,1905,116
STAT,1822,38,na,1860,1440.8805836445076
SIM,1867,33,40-44,1900,3
STAT,1844,23,25-29,1867,49.284572649487664
SIM,1823,40,45-49,1863,2
SIM,1877,40,na,1917,2265
STAT,1798,79,na,1877,287.9463497426457
SIM,1863,25,20-24,1888,8
STAT,1861,20,20-24,1881,56.41696978582213
STAT,1867,42,35-39,1909,1.6043555068450341
STAT,1900,49,15-19,1949,2.8951936575449507E-4
STAT,1839,41,45-49,1880,1.1689749677531196
SIM,1873,50,na,1923,2121
STAT,1793,64,na,1857,740.3724719421123
STAT,1799,104,na,1903,0.021294125801190705
STAT,1902,46,15-19,1948,3.016752582244265E-4
SIM,1854,31,35-39,1885,12
STAT,1867,66,na,1933,1453.9299314730752
STAT,1822,49,30-34,1871,0.1264996948973654
STAT,1942,15,35-39,1957,4.144845962313604
STAT,1821,53,20-24,1874,0.0010970456792820384
STAT,1873,18,50-100,1891,0.04681684560085581
SIM,1878,2,na,1880,3081
STAT,1847,51,45-49,1898,0.010752762101862042
SIM,1891,44,na,1935,2700
STAT,1915,42,50-100,1957,0.1117364873137083
STAT,1872,35,25-29,1907,2.7541723961741043
SIM,1852,23,25-29,1875,54
SIM,1862,44,45-49,1906,4
STAT,1881,18,30-34,1899,1.4507646278122386
STAT,1887,41,50-100,1928,1.1213872786239996
STAT,1804,50,40-44,1854,0.03873119909817132
STAT,1895,45,15-19,1940,2.806598979091046E-4
SIM,1876,23,35-39,1899,8
SIM,1871,31,40-44,1902,5
STAT,1889,37,na,1926,2747.66983147607
STAT,1882,42,30-34,1924,1.0549174914434365
SIM,1827,81,na,1908,283
SIM,1890,22,na,1912,2966
SIM,1890,42,30-34,1932,1
SIM,1957,4,na,1961,4913
SIM,1942,21,na,1963,3545
STAT,1830,33,na,1863,1675.002479793674
STAT,1805,66,na,1871,825.5599980386968
STAT,1861,22,40-44,1883,1.681553538378476
SIM,1898,24,30-34,1922,24
STAT,1933,28,45-49,1961,2.166004269993589
STAT,1844,41,na,1885,1665.2016569811767
SIM,1813,44,25-29,1857,3
SIM,1865,55,na,1920,1818
STAT,1815,51,30-34,1866,0.013122165441700183
SIM,1941,28,45-49,1969,1
STAT,1846,47,15-19,1893,2.9529812981832665E-4
STAT,1868,23,35-39,1891,5.243511274123152
STAT,1923,14,na,1937,4381.055640704594
STAT,1871,41,40-44,1912,2.1195305348759965
SIM,1786,82,na,1868,149
SIM,1939,27,45-49,1966,6
STAT,1885,23,na,1908,2220.1512823661055
STAT,1863,47,20-24,1910,0.009901828829126965
SIM,1883,49,na,1932,2011
SIM,1950,15,35-39,1965,6
STAT,1938,17,35-39,1955,3.910391266463017
SIM,1864,41,45-49,1905,1
STAT,1881,33,na,1914,2168.5728177411306
STAT,1893,32,35-39,1925,12.132505156577356
STAT,1866,26,35-39,1892,8.43616875495153
STAT,1875,52,40-44,1927,0.010168082503274787
STAT,1849,22,50-100,1871,0.3697080615634668
STAT,1838,37,15-19,1875,0.04549119853063717
SIM,1814,55,na,1869,1094
STAT,1874,32,25-29,1906,9.886401393030543
SIM,1935,5,na,1940,5112
STAT,1801,76,na,1877,364.31329280104956
STAT,1888,12,na,1900,2883.2377044631085
STAT,1881,27,15-19,1908,0.41405188710091667
SIM,1858,35,50-100,1893,1
STAT,1847,15,15-19,1862,5.526818748532761
SIM,1839,23,na,1862,1835
STAT,1891,35,35-39,1926,8.345207733886753
STAT,1908,16,40-44,1924,0.2569484518096517
STAT,1865,44,20-24,1909,0.13415066932642483
STAT,1867,33,50-100,1900,0.8093513858621855
STAT,1917,36,50-100,1953,0.4139587785143494
SIM,1882,32,25-29,1914,11
STAT,1866,15,25-29,1881,5.1282176093757705
STAT,1926,19,na,1945,4240.227182644621
SIM,1834,41,35-39,1875,3
STAT,1872,21,35-39,1893,5.546262446710165
SIM,1946,11,na,1957,4001
STAT,1777,93,na,1870,5.805577160663537
STAT,1914,28,35-39,1942,14.248145440368184
SIM,1915,47,na,1962,3347
STAT,1823,79,na,1902,374.14795039079763
SIM,1944,18,15-19,1962,44
STAT,1873,3,na,1876,2974.709527340667
STAT,1824,44,35-39,1868,2.26053103407297
STAT,1842,98,na,1940,2.3525359961661154
SIM,1894,7,na,1901,3292
STAT,1895,42,40-44,1937,0.19213189472001213
SIM,1882,21,15-19,1903,2
SIM,1921,16,na,1937,4012
STAT,1826,41,35-39,1867,1.805222721916354
STAT,1893,48,15-19,1941,2.669182062127266E-4
STAT,1944,28,15-19,1972,0.7204504484093464
STAT,1909,47,na,1956,3189.2459880241445
STAT,1931,25,30-34,1956,47.82949068751674
SIM,1825,71,na,1896,731
SIM,1874,24,15-19,1898,6
SIM,1876,55,na,1931,1976
STAT,1832,54,35-39,1886,0.005201935898505302
SIM,1832,44,35-39,1876,4
STAT,1850,20,45-49,1870,0.598558489679446
STAT,1881,15,20-24,1896,16.254343800424277
STAT,1866,24,15-19,1890,2.8565150360366296
STAT,1848,31,na,1879,1897.6085874202886
STAT,1885,38,15-19,1923,0.05261530923691474
SIM,1865,36,40-44,1901,5
STAT,1821,48,50-100,1869,0.381800402322919
SIM,1855,15,15-19,1870,4
SIM,1894,12,na,1906,3264
STAT,1861,5,na,1866,2270.2028268840786
SIM,1871,24,na,1895,2228
SIM,1895,32,35-39,1927,18
STAT,1850,10,na,1860,2082.143539383759
SIM,1805,94,na,1899,1
STAT,1768,97,na,1865,0.6220204091645041
STAT,1906,42,na,1948,3187.097350116586
STAT,1927,16,20-24,1943,159.63692389759174
SIM,1839,32,20-24,1871,2
STAT,1948,20,25-29,1968,100.26482024929716
STAT,1921,47,na,1968,3912.4598689190507
SIM,1905,0,na,1905,3703
SIM,1924,25,35-39,1949,23
SIM,1945,26,na,1971,3692
STAT,1803,59,na,1862,995.1510172557104
SIM,1901,39,na,1940,3117
SIM,1866,77,na,1943,707
STAT,1813,43,15-19,1856,0.04217977480071249
STAT,1898,23,20-24,1921,87.826857210289
STAT,1806,54,50-100,1860,0.0510636022340382
STAT,1928,26,na,1954,4374.823920125187
SIM,1904,44,na,1948,3168
SIM,1824,35,40-44,1859,6
STAT,1855,28,30-34,1883,18.51855504918728
SIM,1888,80,na,1968,1032
SIM,1863,28,30-34,1891,28
STAT,1865,31,45-49,1896,1.4992780284650138
SIM,1827,38,na,1865,1520
SIM,1844,93,na,1937,15
STAT,1916,25,35-39,1941,14.764452580430849
STAT,1900,30,25-29,1930,13.530874558623427
SIM,1927,32,na,1959,4359
STAT,1834,105,na,1939,0.018177933988651848
STAT,1844,27,40-44,1871,2.546871076886622
STAT,1852,107,na,1959,0.008277988667150038
SIM,1889,65,na,1954,1972
STAT,1887,46,25-29,1933,0.06103782217740041
SIM,1963,0,na,1963,4702
SIM,1891,26,40-44,1917,5
SIM,1900,21,30-34,1921,20
STAT,1864,27,15-19,1891,0.38200473621580217
STAT,1868,51,na,1919,1950.026427221571
STAT,1905,35,30-34,1940,1.5857042408315054
SIM,1828,41,35-39,1869,2
SIM,1885,29,20-24,1914,9
STAT,1902,39,50-100,1941,0.34974714600589646
STAT,1876,31,20-24,1907,2.6489796529661107
SIM,1946,17,35-39,1963,7
SIM,1843,38,50-100,1881,3
STAT,1924,5,na,1929,4523.156908777556
STAT,1887,35,15-19,1922,0.05990118053480149
STAT,1920,39,15-19,1959,0.019820157576438954
SIM,1831,31,50-100,1862,3
STAT,1859,55,na,1914,1554.6942314276916
SIM,1893,27,na,1920,2968
STAT,1918,38,15-19,1956,0.019102218704912632
SIM,1875,14,na,1889,2519
STAT,1863,20,na,1883,2028.7686831473825
SIM,1929,19,30-34,1948,21
SIM,1762,101,na,1863,2
STAT,1860,44,45-49,1904,1.1317042771397348
STAT,1848,44,20-24,1892,0.11641442083351601
SIM,1832,68,na,1900,878
SIM,1900,54,na,1954,2780
SIM,1862,63,na,1925,1530
STAT,1852,47,15-19,1899,2.8864229125238054E-4
STAT,1865,31,15-19,1896,0.12243719425957601
SIM,1876,26,45-49,1902,2
SIM,1880,24,15-19,1904,8
STAT,1901,31,50-100,1932,1.2165411522919825
STAT,1889,45,15-19,1934,4.7115237305725313E-4
SIM,1841,36,25-29,1877,3
SIM,1876,46,50-100,1922,3
STAT,1917,45,45-49,1962,0.215468490905462
SIM,1848,39,45-49,1887,3
STAT,1880,34,15-19,1914,0.1406144856880893
STAT,1900,49,45-49,1949,0.1708165695685633
STAT,1854,41,35-39,1895,1.3014724686726038
STAT,1870,24,35-39,1894,5.374241383172495
STAT,1897,48,na,1945,2807.216063923381
STAT,1852,76,na,1928,686.8546310332521
SIM,1880,35,25-29,1915,2
STAT,1968,0,na,1968,4672.8162250752985
SIM,1932,35,40-44,1967,7
STAT,1909,35,45-49,1944,0.6153970250057116
STAT,1835,30,20-24,1865,2.236251795982298
STAT,1931,22,50-100,1953,0.80619382966873
STAT,1880,34,45-49,1914,1.7218640965351253
STAT,1939,15,50-100,1954,0.3551562693898815
STAT,1929,39,35-39,1968,2.927180039663758
STAT,1834,23,na,1857,1759.9500848891792
SIM,1843,12,na,1855,2220
STAT,1873,51,50-100,1924,0.014539397080497897
SIM,1882,37,25-29,1919,2
STAT,1937,30,15-19,1967,0.12024124542490544
SIM,1913,24,20-24,1937,98
STAT,1866,29,45-49,1895,0.9605163720298937
STAT,1818,37,40-44,1855,13.904230763175223
STAT,1813,43,45-49,1856,4.571232773090559
STAT,1877,29,20-24,1906,11.413891161663576
SIM,1876,23,40-44,1899,1
SIM,1885,18,40-44,1903,1
STAT,1842,42,50-100,1884,0.7915414488810363
SIM,1822,66,na,1888,865
STAT,1848,44,15-19,1892,0.010122993662709566
STAT,1944,28,20-24,1972,18.628790016647166
STAT,1856,52,30-34,1908,0.004364135205115133
STAT,1895,42,35-39,1937,0.15467870875390677
STAT,1849,23,30-34,1872,16.0328976607131
STAT,1852,47,45-49,1899,0.17029909517676628
STAT,1901,70,na,1971,2228.5301809978823
STAT,1831,34,25-29,1865,7.965903773391043
SIM,1926,33,50-100,1959,6
STAT,1802,53,40-44,1855,0.03020844259891742
STAT,1854,41,40-44,1895,1.6166049829769047
STAT,1894,16,45-49,1910,0.07949952598121762
SIM,1775,79,na,1854,229
STAT,1868,23,40-44,1891,1.8724209502081044
STAT,1905,24,20-24,1929,93.51054412525403
SIM,1829,28,25-29,1857,38
STAT,1874,37,25-29,1911,2.7790684941511303
STAT,1887,32,35-39,1919,10.701111647945645
STAT,1794,89,na,1883,37.96793106544777
STAT,1828,51,35-39,1879,0.006866191047261178
STAT,1876,27,na,1903,2329.258134588697
SIM,1846,17,na,1863,2050
STAT,1822,46,20-24,1868,0.016370396296087716
STAT,1884,78,na,1962,938.3742482368399
STAT,1855,39,40-44,1894,3.07946176332142
STAT,1875,52,35-39,1927,0.008315020757834682
STAT,1806,101,na,1907,0.1978828221391224
STAT,1831,23,15-19,1854,6.036049721623347
STAT,1790,75,na,1865,379.7913144872546
STAT,1885,28,40-44,1913,2.810824434538726
STAT,1834,51,40-44,1885,0.006833076590385827
STAT,1924,35,40-44,1959,1.6704394296557832
SIM,1843,30,20-24,1873,2
STAT,1883,26,40-44,1909,2.7840527888694524
SIM,1845,91,na,1936,31
SIM,1856,6,na,1862,2350
SIM,1875,42,35-39,1917,4
STAT,1822,34,50-100,1856,1.9912135802898616
STAT,1840,43,50-100,1883,0.7140112547089784
STAT,1939,29,na,1968,3554.232436921105
SIM,1937,20,15-19,1957,5
SIM,1935,16,20-24,1951,167
STAT,1889,28,50-100,1917,0.7434182831930078
SIM,1895,34,na,1929,2979
SIM,1939,22,15-19,1961,4
SIM,1826,40,na,1866,1484
SIM,1874,27,25-29,1901,39
STAT,1850,34,35-39,1884,7.314416155298182
STAT,1859,34,25-29,1893,7.635381506665623
STAT,1858,54,30-34,1912,0.004287700102731002
SIM,1908,18,na,1926,3501
STAT,1857,22,20-24,1879,59.27370874505519
STAT,1881,73,na,1954,1083.950796801854
STAT,1867,100,na,1967,5.1259522514381155
SIM,1937,28,25-29,1965,58
SIM,1904,21,45-49,1925,5
STAT,1929,28,25-29,1957,77.77985296750248
SIM,1896,19,25-29,1915,7
SIM,1835,25,45-49,1860,5
STAT,1888,19,25-29,1907,6.292680558191622
SIM,1829,45,na,1874,1415
STAT,1929,20,15-19,1949,6.3970195939850525
STAT,1843,40,20-24,1883,0.11331290637212725
SIM,1865,22,20-24,1887,55
SIM,1826,37,40-44,1863,3
SIM,1850,23,20-24,1873,62
STAT,1874,37,30-34,1911,5.144233198262988
STAT,1877,16,45-49,1893,0.06416900010163949
STAT,1894,25,35-39,1919,11.793749906409117
STAT,1919,19,20-24,1938,140.7769439667399
SIM,1937,31,na,1968,3424
STAT,1851,108,na,1959,0.0031412634267771952
STAT,1940,15,30-34,1955,11.697483553376097
SIM,1893,28,40-44,1921,7
STAT,1856,27,50-100,1883,0.48858511984748765
STAT,1857,51,na,1908,1611.9169414271423
SIM,1835,34,35-39,1869,9
SIM,1915,23,40-44,1938,4
STAT,1871,31,50-100,1902,0.8630170524244891
SIM,1941,25,40-44,1966,3
STAT,1918,27,na,1945,3766.28321146069
SIM,1882,6,na,1888,2515
SIM,1934,32,35-39,1966,20
STAT,1821,53,na,1874,1256.161042507561
SIM,1899,64,na,1963,2482
STAT,1871,44,45-49,1915,1.3850059143083626
STAT,1907,23,40-44,1930,2.8828236573027937
STAT,1915,16,50-100,1931,0.07426014160760877
SIM,1852,88,na,1940,67
SIM,1763,94,na,1857,2
SIM,1895,35,45-49,1930,9
STAT,1892,18,30-34,1910,1.881005339438559
STAT,1884,40,15-19,1924,0.013019054718511492
STAT,1910,47,na,1957,3238.1822684446274
STAT,1804,53,45-49,1857,0.0502603142826237
STAT,1874,48,40-44,1922,0.163169921432949
STAT,1930,21,45-49,1951,1.365785907300796
STAT,1867,44,25-29,1911,0.561954295828995
SIM,1869,33,45-49,1902,3
STAT,1795,104,na,1899,0.01389196163277702
STAT,1907,35,40-44,1942,1.323640796043055
SIM,1886,40,45-49,1926,4
SIM,1927,19,20-24,1946,156
SIM,1937,25,20-24,1962,20
STAT,1842,23,20-24,1865,62.49322337233558
STAT,1925,1,na,1926,4765.563407046305
STAT,1766,93,na,1859,5.409523261706312
SIM,1835,23,25-29,1858,54
SIM,1893,38,45-49,1931,7
SIM,1865,39,45-49,1904,1
STAT,1874,34,15-19,1908,0.13627838270197884
STAT,1808,71,na,1879,646.4099482985637
SIM,1835,22,35-39,1857,7
STAT,1887,35,45-49,1922,2.1264916560935907
STAT,1844,37,15-19,1881,0.04121298953381876
SIM,1826,56,na,1882,1157
SIM,1895,50,na,1945,2771
SIM,1917,20,40-44,1937,5
STAT,1882,44,20-24,1926,0.14393454260608118
STAT,1874,22,20-24,1896,66.51595179452558
STAT,1926,32,35-39,1958,10.438471979332052
STAT,1845,66,na,1911,1159.8108479339983
SIM,1837,96,na,1933,4
STAT,1856,52,25-29,1908,0.002596840758181028
SIM,1880,28,30-34,1908,37
SIM,1925,46,na,1971,4179
SIM,1863,28,25-29,1891,35
STAT,1846,45,25-29,1891,0.04314806031456571
STAT,1855,28,25-29,1883,31.10810538598316
STAT,1827,34,35-39,1861,11.198881247579536
STAT,1941,21,20-24,1962,108.59133885979543
SIM,1854,52,na,1906,1727
STAT,1924,47,35-39,1971,0.1450004540598918
STAT,1943,29,50-100,1972,1.0004367693766523
STAT,1922,32,na,1954,4036.920895525403
SIM,1929,15,15-19,1944,44
STAT,1870,33,na,1903,2202.2079959482035
SIM,1864,73,na,1937,976
STAT,1909,20,40-44,1929,2.9699149436362346
SIM,1915,35,40-44,1950,1
STAT,1881,18,25-29,1899,5.157943904762126
SIM,1933,15,35-39,1948,5
SIM,1882,35,35-39,1917,13
SIM,1824,30,na,1854,1652
STAT,1846,34,15-19,1880,0.12225610318747425
SIM,1883,65,na,1948,1487
SIM,1884,10,na,1894,2527
SIM,1895,53,na,1948,2670
STAT,1860,54,40-44,1914,0.007847638028768589
SIM,1828,32,45-49,1860,1
SIM,1861,24,35-39,1885,6
STAT,1941,24,na,1965,3562.699594510531
STAT,1953,12,na,1965,4488.894810170643
STAT,1860,43,30-34,1903,0.8748660021174058
STAT,1884,51,25-29,1935,0.003321651164199942
SIM,1894,19,15-19,1913,6
SIM,1850,78,na,1928,544
STAT,1829,33,na,1862,1700.1176604919367
STAT,1919,42,45-49,1961,0.1703821472144816
STAT,1856,54,20-24,1910,5.289469954982027E-4
SIM,1899,67,na,1966,2326
STAT,1880,46,15-19,1926,3.9950466604019556E-4
STAT,1839,54,na,1893,1394.1528872015267
STAT,1914,25,30-34,1939,37.56951638359866
STAT,1944,15,45-49,1959,0.5081187186225188
STAT,1876,33,40-44,1909,4.214794306074174
SIM,1878,38,50-100,1916,2
STAT,1853,24,35-39,1877,5.143345847253083
STAT,1888,68,na,1956,1732.612137960209
SIM,1815,44,35-39,1859,2
STAT,1882,31,15-19,1913,0.13136678066691262
SIM,1915,27,50-100,1942,5
SIM,1828,44,45-49,1872,2
STAT,1898,35,20-24,1933,0.9948274438264653
SIM,1852,27,40-44,1879,2
STAT,1885,37,50-100,1922,1.156096079474726
STAT,1925,15,35-39,1940,4.810703911839752
SIM,1900,36,35-39,1936,5
STAT,1874,35,35-39,1909,6.891785686356644
SIM,1884,33,40-44,1917,4
STAT,1920,46,na,1966,3845.952968661133
STAT,1781,82,na,1863,155.17787726322467
SIM,1890,42,25-29,1932,3
STAT,1831,23,45-49,1854,1.2758523880039234
STAT,1899,15,na,1914,3284.3403130891425
SIM,1833,27,30-34,1860,18
SIM,1862,87,na,1949,115
SIM,1882,37,30-34,1919,7
SIM,1874,91,na,1965,147
SIM,1831,27,na,1858,1741
STAT,1818,47,15-19,1865,8.528552297878094E-4
STAT,1819,58,na,1877,1170.2094361356862
STAT,1815,44,na,1859,1390.706061747061
STAT,1877,12,na,1889,2538.291449890239
STAT,1809,54,40-44,1863,0.02718173969321607
STAT,1833,33,15-19,1866,0.11133375771391214
SIM,1817,42,40-44,1859,4
SIM,1887,79,na,1966,1015
STAT,1880,33,50-100,1913,0.9086700499446971
STAT,1938,19,30-34,1957,11.351146694182296
SIM,1946,19,30-34,1965,17
STAT,1859,48,45-49,1907,0.17521654588037588
STAT,1870,28,20-24,1898,10.833984544329308
STAT,1917,15,50-100,1932,0.07651864746938104
STAT,1844,25,na,1869,1865.9420803841706
STAT,1766,90,na,1856,23.57879364
STAT,1896,63,na,1959,2316.714598539236
STAT,1876,45,40-44,1921,0.16875785717996197
SIM,1927,16,na,1943,4294
STAT,1841,43,20-24,1884,0.11232300773389382
STAT,1883,29,45-49,1912,1.0210275867153493
SIM,1876,24,25-29,1900,52
STAT,1846,34,45-49,1880,1.4970605171344475
STAT,1869,76,na,1945,867.0538293376429
STAT,1946,24,30-34,1970,30.194411835351765
STAT,1822,49,25-29,1871,0.07527254499858614
SIM,1856,38,50-100,1894,3
STAT,1862,54,20-24,1916,5.796407010359375E-4
SIM,1948,15,na,1963,3993
SIM,1848,38,30-34,1886,2
STAT,1868,35,na,1903,2143.7089736763046
STAT,1911,21,35-39,1932,8.461917730076033
SIM,1915,21,15-19,1936,4
STAT,1852,32,40-44,1884,3.2552985746927448
STAT,1854,40,na,1894,1670.343434769202
STAT,1928,42,na,1970,4472.615112601203
SIM,1874,72,na,1946,1184
STAT,1858,16,35-39,1874,0.4775638884484172
SIM,1905,29,na,1934,3203
STAT,1815,40,15-19,1855,0.03887660424596164
STAT,1867,50,na,1917,1937.4757108450187
SIM,1871,31,35-39,1902,9
STAT,1835,32,40-44,1867,3.5140429222980836
STAT,1820,90,na,1910,41.53381645094114
SIM,1904,47,50-100,1951,1
STAT,1906,40,50-100,1946,0.10195782568247225
SIM,1876,35,35-39,1911,16
STAT,1840,22,50-100,1862,0.34032739094421044
SIM,1885,35,na,1920,2276
SIM,1923,42,na,1965,4169
STAT,1807,49,na,1856,1284.9126250386996
STAT,1907,43,na,1950,3195.198844485003
STAT,1815,51,25-29,1866,0.007808230600798402
STAT,1869,17,na,1886,2343.4153533529725
STAT,1846,47,20-24,1893,0.008858951687178694
STAT,1882,42,25-29,1924,0.5892331958297012
SIM,1883,49,50-100,1932,1
STAT,1794,105,na,1899,0.005522694988307801
SIM,1885,75,na,1960,1096
SIM,1848,36,40-44,1884,3
STAT,1858,31,50-100,1889,0.6857296942113857
SIM,1843,32,40-44,1875,4
STAT,1777,77,na,1854,279.0
SIM,1859,26,45-49,1885,4
STAT,1907,21,15-19,1928,4.59196876961007
STAT,1835,44,40-44,1879,1.6719350264580304
SIM,1932,30,50-100,1962,1
SIM,1840,63,na,1903,1187
SIM,1935,19,25-29,1954,67
STAT,1861,34,40-44,1895,3.3772705168460964
STAT,1831,27,30-34,1858,21.660467755799313
STAT,1852,33,25-29,1885,7.609052798125613
STAT,1799,80,na,1879,250.72419863199943
STAT,1847,51,50-100,1898,0.011190162575763189
STAT,1809,96,na,1905,3.44575804573725
SIM,1813,86,na,1899,94
STAT,1847,15,20-24,1862,16.510496493256696
STAT,1898,38,25-29,1936,0.7905325315168317
SIM,1818,45,na,1863,1366
STAT,1887,23,45-49,1910,0.7345718945855655
SIM,1860,33,25-29,1893,13
STAT,1863,22,45-49,1885,0.5896123845911451
STAT,1937,35,15-19,1972,0.018171950866548707
SIM,1897,60,na,1957,2549
SIM,1909,23,40-44,1932,2
STAT,1927,19,25-29,1946,50.628185688480684
SIM,1836,58,na,1894,1252
STAT,1844,22,na,1866,1854.0947913621014
STAT,1955,15,20-24,1970,170.09520723446508
STAT,1826,42,40-44,1868,2.1976682157346574
STAT,1962,3,na,1965,4760.249883186109
STAT,1862,101,na,1963,1.6117448416057574
STAT,1929,25,20-24,1954,21.66289557844753
SIM,1895,23,45-49,1918,4
SIM,1939,24,35-39,1963,15
STAT,1933,13,na,1946,5002.950625429193
STAT,1862,18,15-19,1880,5.457601922503284
STAT,1878,40,45-49,1918,1.4883409614752854
SIM,1824,33,20-24,1857,3
STAT,1883,24,20-24,1907,63.42810072425958
SIM,1880,39,40-44,1919,5
STAT,1815,53,20-24,1868,0.0015630736180760269
STAT,1831,38,40-44,1869,3.3157777409682603
STAT,1900,46,40-44,1946,0.12691612047319753
STAT,1911,47,25-29,1958,0.04744252653423112
STAT,1841,30,15-19,1871,0.12161832837651554
SIM,1950,13,na,1963,4258
STAT,1946,25,20-24,1971,19.226083936613446
STAT,1870,17,40-44,1887,0.17112220259952857
SIM,1817,60,na,1877,1084
SIM,1843,44,40-44,1887,7
STAT,1851,51,na,1902,1556.2767552616892
SIM,1842,67,na,1909,1019
STAT,1832,53,20-24,1885,4.5479927495671097E-4
STAT,1850,31,50-100,1881,0.6827106662894292
STAT,1872,28,30-34,1900,23.777801962127874
STAT,1855,65,na,1920,1200.9324482582988
SIM,1820,46,50-100,1866,4
SIM,1845,32,45-49,1877,1
SIM,1910,34,45-49,1944,1
STAT,1891,32,na,1923,2789.075581961324
STAT,1818,89,na,1907,51.591649521369064
STAT,1833,78,na,1911,479.3680153759388
STAT,1928,21,50-100,1949,0.778428339616422
SIM,1867,30,30-34,1897,24
SIM,1923,31,20-24,1954,2
STAT,1902,34,45-49,1936,1.3235388535244568
STAT,1857,37,25-29,1894,2.1451775054095568
STAT,1873,30,50-100,1903,0.8849245520891353
STAT,1796,69,na,1865,680.9750149150631
SIM,1851,47,na,1898,1686
STAT,1896,43,50-100,1939,0.09087171838809122
SIM,1870,18,15-19,1888,5
STAT,1890,53,na,1943,2446.973336428477
SIM,1889,39,30-34,1928,11
STAT,1868,35,35-39,1903,6.435667299079674
SIM,1848,43,na,1891,1643
SIM,1857,17,na,1874,2145
STAT,1872,39,40-44,1911,4.106274109717152
SIM,1894,49,na,1943,2793
STAT,1846,22,45-49,1868,0.6381608360650415
STAT,1859,48,15-19,1907,2.9697694644674434E-4
STAT,1843,43,25-29,1886,0.4409022418524621
STAT,1899,48,50-100,1947,0.17707183800399037
SIM,1855,15,20-24,1870,22
STAT,1899,17,35-39,1916,0.7102505888088357
STAT,1902,46,45-49,1948,0.17798855216235904
SIM,1812,45,na,1857,1329
SIM,1885,25,35-39,1910,9
SIM,1918,19,25-29,1937,47
STAT,1907,64,na,1971,2738.3316785144953
STAT,1826,43,25-29,1869,0.614984999978099
STAT,1903,50,na,1953,2935.856314919899
STAT,1866,26,40-44,1892,2.6190558600941203
SIM,1896,16,na,1912,3192
STAT,1776,92,na,1868,10.202076612263463
STAT,1911,36,15-19,1947,0.01760709462869007
STAT,1929,36,30-34,1965,2.212403481874465
STAT,1837,32,45-49,1869,1.4189804572587041
SIM,1887,39,na,1926,2432
SIM,1861,22,na,1883,2082
STAT,1842,15,na,1857,2160.00554397395
STAT,1859,30,30-34,1889,13.319030079561102
STAT,1915,31,20-24,1946,2.3564391817334336
STAT,1893,34,25-29,1927,12.165864510081722
STAT,1872,24,15-19,1896,3.106510334606008
STAT,1841,41,25-29,1882,0.4659635555432497
SIM,1860,32,40-44,1892,3
SIM,1907,22,30-34,1929,21
SIM,1794,77,na,1871,292
SIM,1872,25,na,1897,2277
STAT,1816,38,45-49,1854,7.341287157469565
STAT,1881,40,50-100,1921,0.9738532277358685
SIM,1824,38,45-49,1862,3
STAT,1853,36,50-100,1889,0.9388492835826064
STAT,1926,22,50-100,1948,0.7551546681423744
STAT,1827,69,na,1896,847.699614980963
SIM,1931,21,na,1952,4440
STAT,1841,49,35-39,1890,0.09450245420549797
SIM,1891,24,20-24,1915,69
STAT,1915,42,30-34,1957,0.1215955894023355
STAT,1897,17,50-100,1914,0.06189547636453508
SIM,1854,34,45-49,1888,2
SIM,1891,29,45-49,1920,1
STAT,1851,17,30-34,1868,1.3939812613620064
SIM,1861,28,20-24,1889,11
STAT,1833,21,20-24,1854,61.917724824480004
STAT,1930,34,20-24,1964,2.9698422123113883
STAT,1859,45,40-44,1904,0.13000697679099107
STAT,1913,21,45-49,1934,1.0331477000657587
SIM,1878,20,35-39,1898,9
SIM,1928,23,20-24,1951,129
SIM,1920,17,15-19,1937,42
STAT,1908,19,15-19,1927,8.272033052415123
SIM,1938,16,na,1954,3286
STAT,1891,37,30-34,1928,6.229110512830839
STAT,1861,10,na,1871,2182.2654164229493
STAT,1831,74,na,1905,647.989571267958
STAT,1822,110,na,1932,1.4041776757282338E-4
SIM,1863,24,15-19,1887,6
SIM,1913,9,na,1922,3708
STAT,1857,91,na,1948,43.17465785708786
STAT,1897,42,15-19,1939,0.0012100704667207505
SIM,1840,60,na,1900,1242
STAT,1878,50,na,1928,2150.300910411213
SIM,1916,32,na,1948,3576
STAT,1876,48,45-49,1924,0.22744293848771152
STAT,1865,24,na,1889,2020.3996477048222
SIM,1878,65,na,1943,1664
STAT,1915,45,35-39,1960,0.12331247623389006
STAT,1879,75,na,1954,1018.0074531249378
STAT,1875,61,na,1936,1814.472557891445
SIM,1874,51,na,1925,2020
STAT,1838,28,25-29,1866,35.86645886216076
STAT,1840,19,20-24,1859,14.886564099083104
STAT,1917,42,na,1959,3661.489612421089
STAT,1909,23,45-49,1932,0.98489887399722
STAT,1855,24,15-19,1879,2.699622994265513
SIM,1876,28,40-44,1904,6
SIM,1863,35,25-29,1898,2
STAT,1868,24,25-29,1892,51.27486893200818
STAT,1888,16,20-24,1904,19.84159917483381
SIM,1816,97,na,1913,4
STAT,1876,86,na,1962,368.7361015400505
STAT,1892,16,40-44,1908,0.21695163250806748
STAT,1904,36,50-100,1940,0.360814846911433
STAT,1912,17,15-19,1929,8.669787714283416
SIM,1900,24,40-44,1924,2
STAT,1905,57,na,1962,2877.456897550918
STAT,1824,43,15-19,1867,0.017688973502728175
STAT,1887,27,na,1914,2521.80163653205
SIM,1835,49,50-100,1884,2
STAT,1831,36,20-24,1867,0.5981209003657684
STAT,1891,48,40-44,1939,0.11145221881160085
SIM,1854,38,30-34,1892,2
STAT,1833,40,50-100,1873,0.8058121566388603
SIM,1889,37,40-44,1926,7
STAT,1885,23,35-39,1908,5.477962915682738
SIM,1913,27,25-29,1940,63
STAT,1845,54,45-49,1899,0.009987000914110316
SIM,1841,21,20-24,1862,58
SIM,1896,16,20-24,1912,21
STAT,1787,92,na,1879,10.895423632427057
STAT,1850,33,15-19,1883,0.10392954168978488
STAT,1824,46,30-34,1870,0.11969333839323187
SIM,1885,48,50-100,1933,2
STAT,1853,28,20-24,1881,9.292270554500583
SIM,1886,42,35-39,1928,3
SIM,1829,25,20-24,1854,7
SIM,1873,87,na,1960,204
STAT,1856,8,na,1864,2140.2107549924376
SIM,1913,38,35-39,1951,7
SIM,1928,34,30-34,1962,17
SIM,1841,40,50-100,1881,1
SIM,1906,31,20-24,1937,2
SIM,1861,25,na,1886,2083
SIM,1863,39,40-44,1902,7
STAT,1889,33,20-24,1922,3.139152044487869
SIM,1826,44,40-44,1870,6
STAT,1851,15,40-44,1866,0.16186623795966543
STAT,1940,24,50-100,1964,0.6327928587249335
STAT,1896,36,25-29,1932,3.609622490146036
STAT,1846,38,30-34,1884,4.085366807720421
STAT,1911,49,15-19,1960,3.275306052565106E-4
STAT,1864,21,na,1885,2037.958552402082
STAT,1845,18,15-19,1863,5.276487287326114
STAT,1878,53,na,1931,2085.801675842462
STAT,1765,110,na,1875,0.001341223637056194
STAT,1862,45,50-100,1907,0.20035339205606917
SIM,1893,35,40-44,1928,8
STAT,1885,35,40-44,1920,4.161194961207569
SIM,1815,93,na,1908,18
STAT,1834,53,30-34,1887,0.003713518843591417
STAT,1820,36,45-49,1856,4.852501472893005
SIM,1946,15,15-19,1961,41
STAT,1803,56,na,1859,1056.069190761222
STAT,1877,48,50-100,1925,0.2376478983887033
SIM,1906,33,40-44,1939,3
SIM,1895,20,40-44,1915,3
STAT,1784,111,na,1895,1.0835054722508651E-4
STAT,1865,47,30-34,1912,0.08250014485614951
STAT,1922,24,15-19,1946,5.730759355786027
STAT,1899,12,na,1911,3342.806747739719
STAT,1839,29,50-100,1868,0.528868863795209
STAT,1848,45,35-39,1893,0.10506523940322818
STAT,1872,24,45-49,1896,0.6566295526969254
SIM,1850,28,45-49,1878,4
SIM,1895,39,30-34,1934,12
SIM,1853,18,15-19,1871,10
STAT,1823,52,50-100,1875,0.017900510013260287
STAT,1842,28,45-49,1870,0.9872033379691801
STAT,1860,51,50-100,1911,0.011631792311068055
STAT,1870,34,50-100,1904,0.8418709011127882
STAT,1877,28,na,1905,2330.404815268131
SIM,1886,17,na,1903,2492
STAT,1891,34,15-19,1925,0.16501839509280394
STAT,1895,40,45-49,1935,1.8618592561736607
SIM,1852,22,35-39,1874,7
STAT,1810,53,45-49,1863,0.04537230076209856
STAT,1856,41,15-19,1897,0.010224976001380698
SIM,1930,26,50-100,1956,1
STAT,1890,21,50-100,1911,0.4724059245739677
SIM,1838,19,30-34,1857,1
SIM,1858,98,na,1956,1
SIM,1884,50,na,1934,2143
SIM,1839,47,na,1886,1560
SIM,1916,19,15-19,1935,44
SIM,1835,33,na,1868,1680
STAT,1887,39,30-34,1926,5.575000797859694
STAT,1887,48,20-24,1935,0.012520884765091429
STAT,1920,27,20-24,1947,18.91649245618418
STAT,1941,24,25-29,1965,90.11575158628109
STAT,1829,45,25-29,1874,0.04832995996877836
SIM,1906,14,na,1920,3523
SIM,1830,30,35-39,1860,13
SIM,1883,18,30-34,1901,1
STAT,1830,89,na,1919,63.40461340185729
STAT,1866,28,30-34,1894,21.864291926565866
SIM,1897,33,20-24,1930,3
SIM,1872,18,25-29,1890,7
SIM,1878,35,45-49,1913,1
STAT,1842,26,25-29,1868,38.157417570349956
STAT,1938,15,15-19,1953,42.4892426185018
SIM,1862,66,na,1928,1397
SIM,1850,26,25-29,1876,47
STAT,1863,76,na,1939,785.4140125004251
STAT,1831,36,50-100,1867,0.9526362679151584
STAT,1871,44,15-19,1915,0.012779755585206186
SIM,1864,14,na,1878,2351
STAT,1896,25,15-19,1921,0.5699185126270643
SIM,1911,54,na,1965,3159
STAT,1892,57,na,1949,2377.896509240444
STAT,1867,41,20-24,1908,0.14151700202162026
SIM,1870,45,50-100,1915,1
STAT,1865,42,25-29,1907,0.5491803856023308
SIM,1905,18,30-34,1923,2
STAT,1864,18,25-29,1882,4.906655486800722
STAT,1829,34,15-19,1863,0.1345889196198745
STAT,1844,22,35-39,1866,5.060283725729604
STAT,1897,46,30-34,1943,0.06918065915060531
SIM,1887,29,25-29,1916,48
STAT,1857,39,45-49,1896,1.470320609084211
STAT,1852,35,45-49,1887,1.4835850263782744
SIM,1915,1,na,1916,3875
STAT,1948,22,15-19,1970,5.774204269005579
STAT,1840,24,25-29,1864,47.09156586047814
STAT,1842,16,50-100,1858,0.045829700748440914
STAT,1830,43,15-19,1873,0.010594121988907239
SIM,1827,41,na,1868,1497
STAT,1875,16,35-39,1891,0.5341132063012906
SIM,1856,32,20-24,1888,2
SIM,1829,85,na,1914,142
SIM,1871,42,50-100,1913,1
STAT,1932,31,na,1963,4752.348910103599
SIM,1874,26,40-44,1900,3
SIM,1879,16,15-19,1895,6
SIM,1913,23,30-34,1936,31
SIM,1826,96,na,1922,5
SIM,1796,81,na,1877,178
SIM,1804,93,na,1897,17
SIM,1888,24,na,1912,2647
SIM,1902,21,35-39,1923,9
SIM,1880,37,20-24,1917,3
STAT,1850,47,40-44,1897,0.1201202534906477
STAT,1826,40,20-24,1866,0.1615439640766905
STAT,1887,20,40-44,1907,2.215066038252987
SIM,1918,16,20-24,1934,22
SIM,1849,84,na,1933,213
STAT,1849,24,15-19,1873,2.9481421958813083
SIM,1866,40,na,1906,2076
SIM,1860,30,20-24,1890,2
SIM,1891,27,25-29,1918,50
STAT,1835,47,15-19,1882,2.683504803421086E-4
STAT,1832,37,na,1869,1618.7057070138876
STAT,1863,42,50-100,1905,0.874738609150328
SIM,1907,25,35-39,1932,18
STAT,1886,19,15-19,1905,5.89039060369331
STAT,1868,39,20-24,1907,0.6878057275910623
STAT,1790,96,na,1886,1.500016006665819
STAT,1931,17,25-29,1948,53.583530954219135
SIM,1860,35,45-49,1895,3
SIM,1835,27,40-44,1862,1
SIM,1840,19,25-29,1859,6
SIM,1854,44,50-100,1898,3
SIM,1838,22,na,1860,1805
STAT,1861,37,45-49,1898,1.5658581775625893
STAT,1935,4,na,1939,5212.528062890517
STAT,1894,18,40-44,1912,0.2214715801938096
SIM,1900,33,30-34,1933,27
STAT,1931,28,35-39,1959,18.302057756814897
STAT,1848,32,20-24,1880,2.3423025831187076
SIM,1859,23,40-44,1882,4
STAT,1879,29,25-29,1908,41.531769071911214
SIM,1797,66,na,1863,738
SIM,1922,25,30-34,1947,48
STAT,1766,109,na,1875,0.0025981432559470967
STAT,1910,40,35-39,1950,0.1818261234405239
STAT,1879,52,50-100,1931,0.014855199058764963
STAT,1819,55,na,1874,1241.8438114538044
STAT,1815,41,na,1856,1443.2805377933119
STAT,1833,34,35-39,1867,7.835494284545721
SIM,1876,39,na,1915,2261
STAT,1849,19,40-44,1868,0.1668417337965201
SIM,1841,34,35-39,1875,9
STAT,1875,22,50-100,1897,0.3959704703877371
STAT,1846,44,50-100,1890,0.7729976039044334
SIM,1857,24,15-19,1881,2
STAT,1846,49,40-44,1895,0.12432845258285756
STAT,1878,42,35-39,1920,1.7805885708303837
SIM,1930,4,na,1934,4954
STAT,1914,19,50-100,1933,0.07282330553025616
STAT,1862,50,35-39,1912,0.0070536242152936
STAT,1827,27,40-44,1854,8.429980159199063
SIM,1865,37,25-29,1902,1
STAT,1875,54,30-34,1929,0.00562106635435667
STAT,1905,23,30-34,1928,24.247416016060747
STAT,1841,34,30-34,1875,14.304229510834631
STAT,1930,24,na,1954,4391.7106525894405
SIM,1875,54,na,1929,2002
SIM,1923,34,25-29,1957,11
SIM,1871,40,na,1911,2219
SIM,1910,31,40-44,1941,8
SIM,1858,43,40-44,1901,6
SIM,1928,38,25-29,1966,3
STAT,1830,43,45-49,1873,1.14813788993947
STAT,1894,29,20-24,1923,14.140767902198935
STAT,1873,52,30-34,1925,0.005672862621332074
STAT,1866,65,na,1931,1472.500367481807
STAT,1857,34,20-24,1891,1.9967010480126555
STAT,1921,29,50-100,1950,1.0404758386506872
STAT,1852,30,20-24,1882,2.0715931606648033
STAT,1911,44,20-24,1955,0.015728583292523284
STAT,1908,19,45-49,1927,0.09105152865735557
SIM,1917,23,45-49,1940,1
STAT,1827,38,20-24,1865,0.7813743812340463
STAT,1851,54,45-49,1905,0.010152326172770187
SIM,1939,21,30-34,1960,29
SIM,1873,10,na,1883,2542
SIM,1815,56,na,1871,1188
SIM,1848,22,15-19,1870,4
STAT,1837,41,35-39,1878,1.4046587592763287
STAT,1877,68,na,1945,1497.5337287857965
STAT,1883,27,25-29,1910,39.1801414773457
STAT,1899,21,50-100,1920,0.5294386109281195
SIM,1889,23,15-19,1912,3
STAT,1826,45,45-49,1871,0.2238877962061975
STAT,1845,47,50-100,1892,0.17298340797726555
STAT,1933,25,40-44,1958,5.851709601431092
STAT,1822,78,na,1900,397.02451232353354
STAT,1856,10,na,1866,2106.6563957283674
SIM,1929,17,35-39,1946,6
STAT,1904,44,20-24,1948,0.014742256637433282
STAT,1893,31,20-24,1924,3.2515730338331887
STAT,1913,45,50-100,1958,0.20954132882986598
STAT,1856,41,45-49,1897,1.108131696350033
STAT,1858,52,35-39,1910,0.006342624888237702
SIM,1822,34,25-29,1856,12
STAT,1893,36,45-49,1929,2.3997469939997442
SIM,1906,54,na,1960,2970
STAT,1902,31,40-44,1933,5.805475051216157
SIM,1865,34,20-24,1899,2
SIM,1902,40,na,1942,3114
STAT,1850,36,30-34,1886,3.856272597881287
STAT,1915,34,25-29,1949,8.816692570924895
SIM,1846,28,25-29,1874,45
SIM,1926,25,45-49,1951,1
SIM,1833,25,40-44,1858,2
SIM,1824,36,25-29,1860,4
STAT,1908,46,na,1954,3162.448991398757
SIM,1948,23,30-34,1971,36
STAT,1904,32,na,1936,3261.0917847523774
SIM,1899,27,na,1926,3140
SIM,1921,45,50-100,1966,3
STAT,1859,33,35-39,1892,7.58231198583501
STAT,1880,32,na,1912,2376.610366875409
STAT,1788,77,na,1865,300.37800657991534
SIM,1845,41,35-39,1886,6
STAT,1911,32,na,1943,3479.2742402001422
STAT,1924,23,40-44,1947,3.736437923766533
SIM,1932,23,40-44,1955,3
STAT,1872,37,20-24,1909,0.7304388741975566
STAT,1856,110,na,1966,0.0015163106933199126
STAT,1835,47,45-49,1882,0.1583269166629261
STAT,1841,45,40-44,1886,0.12163961847472203
SIM,1930,34,25-29,1964,10
SIM,1838,81,na,1919,324
STAT,1889,46,35-39,1935,0.16373925110103374
STAT,1817,48,na,1865,1324.4193989394137
STAT,1922,34,25-29,1956,9.817265200267205
STAT,1918,25,45-49,1943,1.748679965917914
STAT,1861,37,15-19,1898,0.044108686303702
STAT,1913,46,20-24,1959,0.010215549711943325
STAT,1940,7,na,1947,3818.4561416140527
SIM,1836,55,na,1891,1302
SIM,1873,4,na,1877,2659
STAT,1859,22,25-29,1881,44.657983202379626
STAT,1881,25,25-29,1906,38.8664576138708
STAT,1852,36,na,1888,1735.2441173461332
STAT,1941,21,50-100,1962,0.6425903921458146
SIM,1867,22,25-29,1889,66
SIM,1915,28,na,1943,3444
STAT,1849,27,25-29,1876,37.60165529532141
STAT,1842,24,35-39,1866,5.253903191957544
SIM,1899,33,25-29,1932,22
SIM,1862,49,50-100,1911,4
STAT,1864,42,50-100,1906,0.8884075553855965
SIM,1893,8,na,1901,3256
SIM,1799,86,na,1885,70
SIM,1945,23,20-24,1968,98
STAT,1924,26,45-49,1950,1.9067466896941447
SIM,1957,14,na,1971,4913
STAT,1817,52,40-44,1869,0.022741390936959538
STAT,1898,49,40-44,1947,0.12088061733709395
STAT,1854,62,na,1916,1307.7142567295857
STAT,1880,38,30-34,1918,5.281585067151989
STAT,1896,26,15-19,1922,0.5680206839800164
STAT,1943,20,40-44,1963,3.3817951111568205
SIM,1846,35,25-29,1881,2
SIM,1860,37,40-44,1897,7
SIM,1874,24,20-24,1898,64
SIM,1914,15,30-34,1929,2
STAT,1930,37,25-29,1967,1.2132362971584518
STAT,1828,108,na,1936,0.0010315905364786486
SIM,1919,6,na,1925,4240
STAT,1833,106,na,1939,0.007449243758516573
STAT,1833,24,25-29,1857,46.55082651046208
SIM,1872,5,na,1877,2654
SIM,1897,36,25-29,1933,3
STAT,1878,90,na,1968,229.53167664493253
STAT,1850,72,na,1922,890.2441505833347
SIM,1781,88,na,1869,41
SIM,1928,37,35-39,1965,5
SIM,1874,35,na,1909,2225
SIM,1879,1,na,1880,3274
STAT,1889,49,30-34,1938,0.06235170189823717
STAT,1897,30,45-49,1927,2.2208231785324615
SIM,1932,26,45-49,1958,6
STAT,1911,33,40-44,1944,3.5848472587065325
STAT,1925,19,15-19,1944,51.51169713307685
STAT,1815,44,30-34,1859,2.683648779282667
SIM,1885,13,na,1898,2479
STAT,1866,24,20-24,1890,59.66903341799448
STAT,1906,15,30-34,1921,2.2032000862943746
STAT,1848,68,na,1916,1135.5394507844987
SIM,1844,90,na,1934,30
STAT,1845,50,35-39,1895,0.006179563436928374
SIM,1851,42,40-44,1893,7
SIM,1838,29,40-44,1867,3
STAT,1887,67,na,1954,1675.0747935790437
SIM,1835,43,50-100,1878,1
STAT,1820,37,20-24,1857,1.7732170331556953
SIM,1939,29,35-39,1968,17
STAT,1882,35,30-34,1917,4.942866362282286
SIM,1910,31,35-39,1941,10
STAT,1829,73,na,1902,717.682388985244
SIM,1824,76,na,1900,450
STAT,1836,27,15-19,1863,0.3801734457405764
STAT,1865,49,45-49,1914,0.19785956688003942
STAT,1908,27,50-100,1935,0.8964599546887008
STAT,1829,35,15-19,1864,0.05287871916203258
STAT,1891,72,na,1963,1698.99852940765
STAT,1844,21,35-39,1865,5.0968793192417605
STAT,1939,31,30-34,1970,15.195122389994292
STAT,1919,33,50-100,1952,0.8391250596728342
SIM,1902,18,na,1920,3371
STAT,1809,45,50-100,1854,0.7179454176424327
SIM,1862,40,35-39,1902,4
STAT,1866,101,na,1967,2.878289979085918
STAT,1849,16,na,1865,2131.310772959324
STAT,1944,15,50-100,1959,0.38108903896688917
SIM,1852,21,35-39,1873,9
STAT,1909,36,20-24,1945,0.2368598677768462
SIM,1829,29,30-34,1858,23
STAT,1900,30,30-34,1930,23.064958714342314
STAT,1855,24,45-49,1879,0.5706249290169255
SIM,1830,45,50-100,1875,1
SIM,1795,96,na,1891,1
STAT,1813,47,30-34,1860,0.2646380877960307
SIM,1905,15,20-24,1920,19
SIM,1836,95,na,1931,9
SIM,1877,18,na,1895,2451
STAT,1932,34,25-29,1966,11.592147345669321
SIM,1907,25,40-44,1932,4
STAT,1838,35,25-29,1873,2.381403202480547
SIM,1882,30,na,1912,2319
STAT,1835,21,25-29,1856,48.78186659135435
STAT,1931,16,35-39,1947,5.201234697231096
STAT,1871,58,na,1929,1855.1294171822706
SIM,1928,20,40-44,1948,3
STAT,1822,75,na,1897,523.1083715510402
STAT,1900,23,25-29,1923,74.78881613317421
SIM,1922,29,25-29,1951,71
STAT,1813,80,na,1893,254.5812379426881
STAT,1902,31,35-39,1933,13.556899343733049
SIM,1833,53,na,1886,1298
STAT,1875,17,25-29,1892,5.50247646739307
STAT,1840,29,30-34,1869,20.310448675156117
SIM,1831,40,na,1871,1556
STAT,1950,16,45-49,1966,0.5581641752192982
SIM,1839,44,na,1883,1598
STAT,1879,36,25-29,1915,2.8608644528826734
STAT,1898,30,20-24,1928,3.483420249190264
STAT,1886,15,35-39,1901,0.5501066106644686
SIM,1909,26,45-49,1935,1
STAT,1901,26,35-39,1927,12.802967934219769
STAT,1942,16,50-100,1958,0.36998294491729733
STAT,1862,91,na,1953,46.80552563949936
STAT,1856,17,15-19,1873,5.172236176226305
STAT,1873,35,na,1908,2278.733630886021
STAT,1831,29,20-24,1860,9.60777416772203
STAT,1833,37,30-34,1870,4.0882961288086
SIM,1864,17,15-19,1881,6
SIM,1952,19,25-29,1971,60
STAT,1913,47,35-39,1960,0.11888583905499316
STAT,1889,36,25-29,1925,3.3740393595470026
STAT,1880,30,35-39,1910,10.166969968073447
SIM,1808,86,na,1894,59
STAT,1854,48,30-34,1902,0.06838870920843447
STAT,1857,22,15-19,1879,2.837589794455176
SIM,1841,24,25-29,1865,46
SIM,1844,13,na,1857,2047
STAT,1852,37,40-44,1889,3.1908496613908
SIM,1874,38,40-44,1912,3
SIM,1824,37,50-100,1861,3
SIM,1827,59,na,1886,1104
SIM,1848,80,na,1928,428
STAT,1792,106,na,1898,0.0022133574866255432
STAT,1847,19,30-34,1866,1.449699159997406
SIM,1890,35,30-34,1925,11
SIM,1865,22,15-19,1887,2
STAT,1811,49,50-100,1860,0.7915270099142222
STAT,1844,78,na,1922,542.6540704895139
STAT,1857,11,na,1868,2100.0462230952758
SIM,1887,36,25-29,1923,2
SIM,1800,82,na,1882,120
STAT,1898,21,50-100,1919,0.5229011869368725
STAT,1820,74,na,1894,584.6451471733413
STAT,1876,49,20-24,1925,0.011467519195143624
STAT,1947,19,35-39,1966,4.462532088201649
SIM,1852,47,50-100,1899,2
STAT,1869,30,na,1899,2201.4814110756392
SIM,1823,44,30-34,1867,4
STAT,1855,25,15-19,1880,0.3746596097277774
STAT,1907,27,50-100,1934,0.8877188309192487
SIM,1825,58,na,1883,1169
STAT,1863,0,na,1863,3183.2150041488158
STAT,1915,44,35-39,1959,0.19088494299188752
SIM,1806,73,na,1879,508
STAT,1874,25,50-100,1899,0.6216350203030633
SIM,1855,19,30-34,1874,5
SIM,1924,15,30-34,1939,12
STAT,1913,15,na,1928,3747.993767496438
SIM,1855,56,na,1911,1613
STAT,1851,53,30-34,1904,0.004213173677877249
STAT,1929,26,20-24,1955,21.5907581361713
SIM,1933,19,15-19,1952,55
STAT,1940,29,na,1969,3605.19982116753
SIM,1824,34,35-39,1858,11
SIM,1841,37,30-34,1878,4
STAT,1842,77,na,1919,625.977484221091
STAT,1884,43,40-44,1927,2.0841308940134313
STAT,1875,38,50-100,1913,1.1862431425527369
SIM,1894,71,na,1965,1930
STAT,1885,22,35-39,1907,5.49494228735065
STAT,1890,41,15-19,1931,0.0160220505612217
SIM,1848,32,25-29,1880,13
STAT,1819,71,na,1890,704.6344769439431
SIM,1907,55,na,1962,3009
STAT,1877,28,15-19,1905,0.4430338519074757
SIM,1962,1,na,1963,4640
STAT,1867,46,45-49,1913,0.20994480570763757
STAT,1920,26,45-49,1946,1.7964629447926705
STAT,1967,1,na,1968,4645.585924448834
SIM,1900,17,na,1917,3365
SIM,1886,20,na,1906,2341
SIM,1919,33,20-24,1952,1
STAT,1919,12,na,1931,4136.471751826544
SIM,1892,43,40-44,1935,2
STAT,1920,15,20-24,1935,28.963142428532308
SIM,1867,41,na,1908,2230
STAT,1922,31,20-24,1953,2.6141738842374456
SIM,1911,15,20-24,1926,22
STAT,1881,46,50-100,1927,0.2247725203142574
STAT,1891,33,15-19,1924,0.1657410259660158
STAT,1924,20,30-34,1944,32.22901862418761
STAT,1825,89,na,1914,55.834441852768336
STAT,1859,32,35-39,1891,7.614444943496563
STAT,1876,41,25-29,1917,0.6295842343038833
STAT,1794,86,na,1880,71.62890485090932
STAT,1862,97,na,1959,7.754865877427171
STAT,1807,92,na,1899,15.491424437401136
SIM,1890,81,na,1971,1179
SIM,1920,37,na,1957,3957
SIM,1929,26,30-34,1955,56
STAT,1794,108,na,1902,3.4501429871777153E-4
STAT,1920,37,25-29,1957,1.018401452241849
STAT,1875,49,50-100,1924,0.2335018975983376
SIM,1913,26,35-39,1939,16
SIM,1925,30,40-44,1955,5
STAT,1944,19,25-29,1963,44.02643623798103
SIM,1856,35,25-29,1891,1
SIM,1867,32,35-39,1899,10
STAT,1908,18,45-49,1926,0.09130261083715774
SIM,1895,30,45-49,1925,2
STAT,1896,25,45-49,1921,1.3947074314059915
STAT,1887,30,45-49,1917,1.8574811704200622
STAT,1897,18,15-19,1915,7.477963157430195
STAT,1866,28,na,1894,2072.108988452015
STAT,1916,15,30-34,1931,2.454361959968991
STAT,1761,113,na,1874,5.925837067151754E-4
SIM,1849,68,na,1917,1147
SIM,1852,26,na,1878,1942
STAT,1798,76,na,1874,382.65130092460413
STAT,1829,34,45-49,1863,1.6480793379920144
STAT,1874,44,25-29,1918,0.6114585227979761
STAT,1946,4,na,1950,4174.743347119402
STAT,1832,53,na,1885,1315.277860647795
STAT,1907,20,30-34,1927,24.866083483009245
STAT,1905,26,35-39,1931,13.220772742902902
SIM,1884,22,25-29,1906,46
STAT,1864,25,25-29,1889,35.99729007198366
STAT,1895,49,30-34,1944,0.06584519160199247
STAT,1902,9,na,1911,3459.246407974768
STAT,1903,37,na,1940,3191.780331162545
STAT,1850,38,45-49,1888,1.4127622328701206
SIM,1932,20,30-34,1952,37
STAT,1914,29,25-29,1943,62.23726409366634
STAT,1938,26,30-34,1964,36.68860881362718
SIM,1856,32,na,1888,1876
SIM,1861,62,na,1923,1573
SIM,1930,31,20-24,1961,2
STAT,1918,26,45-49,1944,1.742856861631407
SIM,1819,46,na,1865,1382
SIM,1888,18,15-19,1906,7
STAT,1915,22,na,1937,3566.1241342164262
STAT,1807,100,na,1907,0.3948769595421979
STAT,1903,15,20-24,1918,23.94056233269456
STAT,1927,16,45-49,1943,0.5881978327211844
STAT,1948,24,35-39,1972,10.206759560895833
SIM,1822,39,30-34,1861,7
STAT,1921,10,na,1931,4279.58146590897
STAT,1848,48,30-34,1896,0.07102423886282516
STAT,1824,42,15-19,1866,0.018152044997398493
STAT,1925,18,45-49,1943,0.5685606436896073
SIM,1837,34,45-49,1871,1
SIM,1887,25,45-49,1912,1
STAT,1887,15,50-100,1902,0.05200947509330704
SIM,1941,15,30-34,1956,14
SIM,1836,18,na,1854,1970
SIM,1879,40,45-49,1919,3
STAT,1917,30,40-44,1947,3.9023954796463207
STAT,1933,34,30-34,1967,20.03193212278998
SIM,1936,12,na,1948,2969
SIM,1869,82,na,1951,421
STAT,1926,44,40-44,1970,0.2903210355713277
SIM,1878,30,45-49,1908,2
STAT,1856,45,30-34,1901,0.07206045120836826
STAT,1933,15,30-34,1948,15.485661864094677
STAT,1770,98,na,1868,0.4101304914002051
STAT,1879,25,45-49,1904,1.1053978424539546
SIM,1889,33,25-29,1922,18
SIM,1899,32,50-100,1931,1
STAT,1837,74,na,1911,720.2349460636714
SIM,1851,8,na,1859,2226
STAT,1906,41,20-24,1947,0.015242541960158956
STAT,1820,68,na,1888,796.3783711883955
STAT,1894,37,na,1931,2860.2728203350853
SIM,1898,28,25-29,1926,51
SIM,1874,29,na,1903,2192
SIM,1906,36,45-49,1942,3
SIM,1843,21,25-29,1864,46
STAT,1874,2,na,1876,3165.6209048182127
SIM,1895,37,na,1932,2973
STAT,1899,52,na,1951,2772.3050356731624
STAT,1843,42,40-44,1885,1.5642560426489218
SIM,1920,15,na,1935,3944
STAT,1814,40,na,1854,1514.629941868725
SIM,1887,33,20-24,1920,1
SIM,1840,23,na,1863,1834
SIM,1865,35,35-39,1900,10
STAT,1841,48,45-49,1889,0.16135822709814288
SIM,1802,83,na,1885,124
STAT,1833,28,50-100,1861,0.513606770964727
SIM,1956,5,na,1961,4790
STAT,1862,75,na,1937,831.5155999076693
SIM,1857,97,na,1954,7
SIM,1946,19,25-29,1965,46
SIM,1902,36,45-49,1938,1
STAT,1938,19,25-29,1957,40.35704812544949
STAT,1940,23,na,1963,3513.1548033131303
SIM,1902,25,20-24,1927,15
SIM,1804,56,na,1860,1059
STAT,1892,29,50-100,1921,0.7515063971891608
STAT,1869,51,35-39,1920,0.007916617779787792
STAT,1782,83,na,1865,111.00055909723491
SIM,1862,10,na,1872,2367
SIM,1870,45,na,1915,2091
STAT,1855,35,25-29,1890,2.0654657621474977
STAT,1907,44,30-34,1951,0.10929423118498068
STAT,1944,16,45-49,1960,0.5079916889428636
SIM,1846,73,na,1919,816
SIM,1876,21,20-24,1897,64
STAT,1923,41,20-24,1964,0.019527662155699586
STAT,1886,44,50-100,1930,1.0400139963276496
SIM,1915,20,30-34,1935,36
STAT,1829,95,na,1924,8.03363701743439
STAT,1854,45,20-24,1899,0.008671417552863181
SIM,1872,25,25-29,1897,38
STAT,1856,104,na,1960,0.12471553601389129
STAT,1937,23,20-24,1960,102.25986081853803
STAT,1879,38,na,1917,2318.207047789294
STAT,1883,43,na,1926,2125.2372151520076
STAT,1838,24,45-49,1862,0.5986969811364237
STAT,1918,29,25-29,1947,65.70102612463312
SIM,1857,27,25-29,1884,32
STAT,1860,53,40-44,1913,0.007939979996123505
STAT,1899,18,25-29,1917,7.315810748959429
STAT,1848,35,25-29,1883,2.250969499414571
STAT,1891,39,45-49,1930,2.3064999485579687
SIM,1844,47,na,1891,1486
SIM,1940,31,20-24,1971,1
SIM,1911,37,25-29,1948,1
SIM,1865,15,na,1880,2344
STAT,1878,13,na,1891,2538.5925058095368
STAT,1850,32,15-19,1882,0.10501433982012678
STAT,1903,37,25-29,1940,0.8353226313735164
STAT,1868,21,20-24,1889,62.562934845435194
SIM,1833,21,25-29,1854,57
SIM,1869,40,45-49,1909,2
SIM,1824,70,na,1894,701
STAT,1824,48,45-49,1872,0.2836428257718328
SIM,1926,29,25-29,1955,89
SIM,1787,67,na,1854,661
SIM,1951,20,40-44,1971,3
STAT,1904,47,25-29,1951,0.043822145860347016
STAT,1881,17,na,1898,2304.884571927864
STAT,1913,24,50-100,1937,0.6237911751128
STAT,1917,42,35-39,1959,0.19852347384094407
STAT,1876,9,na,1885,2587.479724154632
STAT,1851,18,50-100,1869,0.04259540256120491
SIM,1837,37,na,1874,1685
STAT,1821,53,45-49,1874,0.021575230873760627
STAT,1877,25,35-39,1902,9.519467312570837
STAT,1895,46,20-24,1941,0.008360360524947501
STAT,1924,45,45-49,1969,0.2455797596020479
STAT,1933,35,na,1968,4849.350050001364
STAT,1871,40,35-39,1911,1.7158144835284992
STAT,1941,31,30-34,1972,15.63585608214381
STAT,1858,92,na,1950,30.84894921421503
STAT,1834,52,40-44,1886,0.006699079958448359
SIM,1926,22,40-44,1948,8
STAT,1923,15,30-34,1938,13.583663129407675
STAT,1851,27,40-44,1878,2.523015657294906
STAT,1854,46,na,1900,1614.2976939468606
SIM,1919,30,40-44,1949,5
STAT,1910,16,35-39,1926,0.7874214538199448
STAT,1926,42,45-49,1968,0.1938208950998665
STAT,1905,39,25-29,1944,0.8400450563379807
SIM,1909,29,25-29,1938,68
STAT,1850,56,na,1906,1437.785713231419
STAT,1936,24,na,1960,3295.8720161119927
STAT,1932,31,20-24,1963,3.0649356827884575
SIM,1833,23,20-24,1856,52
STAT,1869,14,na,1883,2412.045465634401
STAT,1832,99,na,1931,1.1408681733130583
STAT,1924,2,na,1926,4600.862763634939
SIM,1906,30,30-34,1936,19
STAT,1900,33,35-39,1933,13.215559260843552
SIM,1870,61,na,1931,1698
STAT,1909,39,25-29,1948,0.8715960356738475
STAT,1874,60,na,1934,1840.8544519952889
STAT,1912,29,15-19,1941,0.6525379405647906
STAT,1837,42,50-100,1879,0.8090636784386285
SIM,1902,24,na,1926,3133
STAT,1835,40,25-29,1875,0.5024283767694573
STAT,1874,25,25-29,1899,41.1073276587057
SIM,1834,42,40-44,1876,10
STAT,1918,22,40-44,1940,3.425867314095101
STAT,1947,16,30-34,1963,12.974915725415158
STAT,1922,36,20-24,1958,0.2836226168815613
SIM,1908,6,na,1914,3633
SIM,1846,21,35-39,1867,5
STAT,1893,33,40-44,1926,5.1735812668243915
SIM,1955,16,30-34,1971,16
STAT,1857,32,25-29,1889,7.678479272868303
STAT,1862,41,na,1903,1875.278161405587
STAT,1832,44,30-34,1876,0.8284534430405496
STAT,1911,36,45-49,1947,0.6250517849845542
STAT,1828,50,35-39,1878,0.007003707343927452
STAT,1801,79,na,1880,274.1469389266639
STAT,1895,41,35-39,1936,0.15557012557344252
STAT,1879,33,20-24,1912,2.6617023511767965
STAT,1893,49,20-24,1942,0.007940129631894884
SIM,1840,44,30-34,1884,7
STAT,1857,29,na,1886,1805.2706477502752
SIM,1917,22,30-34,1939,33
SIM,1865,32,25-29,1897,10
STAT,1909,22,30-34,1931,25.236096373888145
STAT,1925,25,50-100,1950,1.1181089866234735
STAT,1903,26,45-49,1929,1.497538021007377
STAT,1813,64,na,1877,863.8476356391442
STAT,1893,21,na,1914,2841.947901644223
STAT,1920,23,40-44,1943,3.520327221148264
STAT,1913,44,30-34,1957,0.11739044865888612
SIM,1844,24,35-39,1868,5
SIM,1831,24,na,1855,1725
STAT,1838,21,35-39,1859,5.119635071616712
STAT,1884,46,45-49,1930,0.22088905853782106
SIM,1891,47,na,1938,2646
SIM,1871,30,35-39,1901,10
SIM,1929,19,25-29,1948,58
STAT,1915,41,30-34,1956,0.12177093955529511
STAT,1828,91,na,1919,32.63506533661116
SIM,1806,57,na,1863,1087
STAT,1877,65,na,1942,1656.052826365684
SIM,1839,31,45-49,1870,1
SIM,1933,25,50-100,1958,1
STAT,1875,64,na,1939,1687.9715251000318
STAT,1918,48,25-29,1966,0.0531789516943602
STAT,1900,20,20-24,1920,90.84897291856815
STAT,1838,32,20-24,1870,2.255006067519757
SIM,1889,35,20-24,1924,1
STAT,1896,20,45-49,1916,0.875229115624318
STAT,1836,43,na,1879,1599.0009427272992
SIM,1886,14,na,1900,2539
STAT,1865,43,15-19,1908,0.011739469671980748
STAT,1873,54,20-24,1927,6.875688993115183E-4
SIM,1875,43,40-44,1918,8
SIM,1778,84,na,1862,92
STAT,1873,19,40-44,1892,0.1743022796809814
SIM,1849,22,na,1871,1969
STAT,1880,69,na,1949,1461.577619085952
STAT,1867,43,40-44,1910,1.980869756561601
SIM,1846,32,20-24,1878,2
SIM,1868,57,na,1925,1803
SIM,1910,3,na,1913,3762
STAT,1930,21,na,1951,4432.7192037409195
STAT,1924,30,50-100,1954,0.9153487498701891
STAT,1806,54,30-34,1860,0.020126045232181543
STAT,1857,35,35-39,1892,5.319805415948075
SIM,1820,80,na,1900,308
STAT,1893,47,50-100,1940,0.16519960112002974
STAT,1873,45,30-34,1918,0.0936701135329494
STAT,1880,22,50-100,1902,0.4061326845150539
STAT,1933,37,35-39,1970,3.112293611630483
SIM,1928,23,45-49,1951,2
STAT,1809,50,25-29,1859,0.009911589965892545
STAT,1937,20,40-44,1957,3.0953385869757337
STAT,1836,24,35-39,1860,4.915844063337684
STAT,1859,49,20-24,1908,0.008834299787674145
STAT,1895,68,na,1963,2074.8651720006424
STAT,1913,34,15-19,1947,0.1197519120204909
STAT,1945,20,na,1965,3783.573391323891
STAT,1866,19,40-44,1885,0.16165635473148185
STAT,1835,67,na,1902,1008.9530745873373
STAT,1854,40,35-39,1894,1.3086833137312635
STAT,1898,33,25-29,1931,13.039088059218937
SIM,1893,22,35-39,1915,11
SIM,1948,19,35-39,1967,5
STAT,1901,23,30-34,1924,23.481145601565576
STAT,1888,15,50-100,1903,0.05495102532462666
STAT,1838,105,na,1943,0.019684437004552774
STAT,1924,39,na,1963,4181.9347862350405
STAT,1895,46,50-100,1941,0.17110870530261738
STAT,1906,18,35-39,1924,0.7529929751688488
SIM,1914,18,35-39,1932,3
SIM,1945,20,40-44,1965,5
SIM,1931,15,30-34,1946,13
SIM,1940,8,na,1948,3729
STAT,1931,29,25-29,1960,80.19628386169461
SIM,1850,25,na,1875,1947
STAT,1865,46,40-44,1911,0.14700897395578685
SIM,1917,44,40-44,1961,3
SIM,1937,26,20-24,1963,20
STAT,1945,8,na,1953,4069.220058540832
STAT,1863,46,15-19,1909,3.325481306555908E-4
SIM,1924,27,na,1951,4104
STAT,1813,44,20-24,1857,0.45769926522692433
STAT,1903,53,na,1956,2865.844428255172
SIM,1769,88,na,1857,28
STAT,1824,58,na,1882,1175.9814180147603
STAT,1908,15,40-44,1923,0.25750982322428057
STAT,1864,22,20-24,1886,58.95542314252897
SIM,1908,33,45-49,1941,1
STAT,1889,50,na,1939,2547.29827153455
SIM,1944,18,20-24,1962,135
SIM,1891,25,35-39,1916,15
STAT,1878,21,45-49,1899,0.6886001395426651
STAT,1879,22,40-44,1901,2.0606227036905818
STAT,1878,30,35-39,1908,10.050447833329848
STAT,1911,37,15-19,1948,0.017522756645418643
SIM,1826,31,35-39,1857,8
STAT,1870,92,na,1962,85.66850686572391
SIM,1861,49,50-100,1910,1
STAT,1927,41,na,1968,4406.470064986888
SIM,1929,29,35-39,1958,21
STAT,1867,48,40-44,1915,0.14995953916831856
STAT,1900,48,na,1948,2911.920613519419
STAT,1924,18,50-100,1942,0.42036365225888356
STAT,1865,86,na,1951,189.9850722777732
STAT,1930,15,50-100,1945,0.4596994764025481
SIM,1887,22,40-44,1909,1
STAT,1906,44,25-29,1950,0.060527087286349
SIM,1829,39,40-44,1868,4
SIM,1933,27,35-39,1960,23
STAT,1772,100,na,1872,0.1836544525825447
STAT,1857,44,25-29,1901,0.4719880317299743
STAT,1853,49,50-100,1902,0.18198832329211195
STAT,1889,40,20-24,1929,0.18708537184062973
SIM,1905,25,30-34,1930,35
STAT,1907,27,na,1934,3311.8443457649882
STAT,1942,15,40-44,1957,1.3816154007650852
SIM,1845,78,na,1923,509
SIM,1774,94,na,1868,2
SIM,1831,24,25-29,1855,44
STAT,1875,53,40-44,1928,0.010058368893064457
STAT,1850,35,40-44,1885,3.200449284046227
SIM,1939,23,20-24,1962,98
STAT,1862,54,45-49,1916,0.01139960002108873
STAT,1936,18,20-24,1954,122.29600299792232
SIM,1886,30,35-39,1916,8
STAT,1883,25,35-39,1908,8.997597822288933
STAT,1886,85,na,1971,599.731873500566
SIM,1859,46,na,1905,1812
SIM,1915,23,35-39,1938,8
STAT,1866,38,40-44,1904,3.7952930352602756
SIM,1870,17,15-19,1887,8
SIM,1950,15,40-44,1965,1
STAT,1877,71,na,1948,1308.0173734311606
SIM,1829,51,50-100,1880,1
STAT,1822,45,15-19,1867,5.535574607343926E-4
SIM,1922,26,20-24,1948,20
SIM,1864,11,na,1875,2378
SIM,1882,86,na,1968,408
STAT,1914,26,20-24,1940,17.444167254034355
STAT,1885,39,20-24,1924,0.7185593912102513
STAT,1890,15,25-29,1905,6.575286105689273
SIM,1893,39,20-24,1932,5
STAT,1807,47,30-34,1854,0.37348447937679097
STAT,1907,23,35-39,1930,8.073034189612175
SIM,1874,28,30-34,1902,30
STAT,1862,17,15-19,1879,5.48993765529296
SIM,1858,32,25-29,1890,11
STAT,1841,73,na,1914,818.8508454862952
STAT,1843,50,25-29,1893,0.0024268212940072014
STAT,1898,22,45-49,1920,0.8914695709952265
STAT,1818,48,20-24,1866,0.02520259335980045
SIM,1857,63,na,1920,1373
SIM,1907,33,na,1940,3317
STAT,1874,38,30-34,1912,5.118717801599604
STAT,1857,21,45-49,1878,0.6041248752248957
STAT,1810,52,30-34,1862,0.018987030441763354
STAT,1882,18,na,1900,2314.23393367878
STAT,1804,81,na,1885,214.07422452092564
SIM,1891,15,25-29,1906,8
STAT,1891,36,40-44,1927,5.140968389432985
STAT,1898,36,35-39,1934,9.085681901743447
STAT,1844,38,20-24,1882,0.5598977624780378
STAT,1876,22,25-29,1898,55.87199166437851
STAT,1893,38,40-44,1931,5.218357361887559
STAT,1900,26,na,1926,3138.2822968553273
STAT,1904,31,45-49,1935,2.3726340417373444
SIM,1882,64,na,1946,1621
SIM,1907,37,35-39,1944,7
STAT,1868,46,50-100,1914,0.22199813245038566
SIM,1882,38,30-34,1920,4
SIM,1918,28,20-24,1946,24
STAT,1935,26,20-24,1961,23.5168085886179
SIM,1846,21,40-44,1867,1
STAT,1769,107,na,1876,0.006136941085422695
STAT,1842,21,na,1863,1967.1051718238493
SIM,1857,101,na,1958,3
STAT,1915,56,na,1971,3366.9490286842633
STAT,1810,50,na,1860,1194.8133019278655
STAT,1881,15,15-19,1896,5.441072719889004
STAT,1939,9,na,1948,3756.2314860847846
STAT,1955,16,20-24,1971,170.05268343265652
SIM,1819,40,na,1859,1492
STAT,1933,18,35-39,1951,5.292571778678406
SIM,1889,30,20-24,1919,3
STAT,1807,86,na,1893,82.5264468184577
SIM,1941,18,35-39,1959,9
SIM,1837,43,na,1880,1595
STAT,1824,45,40-44,1869,0.21471788630358285
STAT,1855,40,50-100,1895,0.7583181623494765
STAT,1861,30,25-29,1891,8.110104354271195
STAT,1845,26,na,1871,1876.7225545291774
SIM,1850,24,35-39,1874,5
STAT,1826,84,na,1910,181.66167867803955
SIM,1904,22,20-24,1926,86
SIM,1943,26,20-24,1969,19
STAT,1826,47,40-44,1873,0.1580670213658002
STAT,1774,88,na,1862,33.86056076214007
STAT,1918,33,50-100,1951,0.826497884574407
STAT,1918,37,45-49,1955,0.6788142858069789
SIM,1859,35,35-39,1894,13
STAT,1900,34,50-100,1934,1.1904636022448383
SIM,1855,29,40-44,1884,3
STAT,1879,22,35-39,1901,5.7705498207092925
SIM,1924,25,40-44,1949,7
SIM,1865,92,na,1957,41
SIM,1872,22,20-24,1894,60
STAT,1838,21,40-44,1859,1.8281856306523032
SIM,1887,22,35-39,1909,8
STAT,1898,23,15-19,1921,4.20450481293325
STAT,1926,23,45-49,1949,1.287324271721722
SIM,1902,33,40-44,1935,3
STAT,1907,47,35-39,1954,0.10908023737925307
SIM,1833,37,40-44,1870,6
STAT,1948,21,30-34,1969,31.186712400325945
STAT,1870,70,na,1940,1300.3148539436581
SIM,1824,92,na,1916,9
STAT,1843,45,45-49,1888,0.16278027136578407
SIM,1835,20,20-24,1855,58
STAT,1833,47,40-44,1880,0.1230423698363346
STAT,1848,39,40-44,1887,3.2831162356019035
STAT,1892,28,40-44,1920,3.5320252764220372
STAT,1890,47,na,1937,2586.8557740644055
STAT,1916,25,40-44,1941,4.583707032788177
SIM,1921,34,20-24,1955,2
SIM,1848,29,40-44,1877,2
STAT,1911,31,45-49,1942,1.4535153088093786
STAT,1880,35,20-24,1915,0.7750063650196966
SIM,1912,31,45-49,1943,1
STAT,1920,34,20-24,1954,2.502327966349236
STAT,1847,29,40-44,1876,2.617056186259412
STAT,1882,12,na,1894,2372.5908092153372
SIM,1885,69,na,1954,1353
STAT,1912,41,45-49,1953,0.15251803580771345
STAT,1825,37,40-44,1862,5.494773978608039
SIM,1897,63,na,1960,2436
SIM,1791,66,na,1857,701
STAT,1863,100,na,1963,2.942693704571367
STAT,1907,45,45-49,1952,0.18658115099170217
STAT,1854,49,50-100,1903,0.17205415672089755
STAT,1865,32,15-19,1897,0.12193887487893948
SIM,1878,19,na,1897,2547
STAT,1877,32,50-100,1909,0.8978607658111367
STAT,1855,9,na,1864,2059.2266987222533
STAT,1892,17,25-29,1909,6.7051582093636855
SIM,1897,32,45-49,1929,2
SIM,1878,81,na,1959,622
SIM,1869,0,na,1869,3287
SIM,1943,22,40-44,1965,3
STAT,1899,15,20-24,1914,23.05447777022888
STAT,1837,48,30-34,1885,0.06438463435623874
SIM,1946,22,15-19,1968,5
STAT,1829,31,35-39,1860,10.38898803725497
STAT,1859,52,na,1911,1610.3278961314766
STAT,1876,44,35-39,1920,1.743506857894371
STAT,1913,34,20-24,1947,2.273026755485127
SIM,1930,39,25-29,1969,1
SIM,1810,59,na,1869,1033
SIM,1891,22,25-29,1913,72
STAT,1926,22,30-34,1948,32.9851523271276
SIM,1833,26,25-29,1859,50
SIM,1871,46,na,1917,2160
STAT,1837,19,50-100,1856,0.04425452945054875
SIM,1884,44,35-39,1928,3
STAT,1922,39,25-29,1961,1.056141452029378
STAT,1928,19,30-34,1947,14.430664947242464
SIM,1924,28,45-49,1952,4
STAT,1785,75,na,1860,404.24734593314673
SIM,1956,13,na,1969,4786
STAT,1864,29,40-44,1893,2.5041537825401305
SIM,1934,22,30-34,1956,45
STAT,1923,18,35-39,1941,4.642521111510816
SIM,1930,34,30-34,1964,26
STAT,1901,18,15-19,1919,7.826944324138973
SIM,1852,20,20-24,1872,53
STAT,1879,91,na,1970,200.42476269695817
STAT,1922,34,30-34,1956,16.734677093551376
STAT,1896,22,35-39,1918,7.280843519989961
SIM,1894,4,na,1898,3312
STAT,1880,88,na,1968,347.4811386770353
STAT,1821,50,40-44,1871,0.016614992114607475
SIM,1833,21,30-34,1854,21
SIM,1921,22,20-24,1943,117
STAT,1853,61,na,1914,1414.1761667317783
STAT,1859,21,35-39,1880,5.03873581461653
STAT,1881,26,15-19,1907,0.41547280409090737
SIM,1829,32,20-24,1861,1
STAT,1916,28,45-49,1944,1.681558437841049
SIM,1867,21,35-39,1888,5
STAT,1883,22,25-29,1905,53.021650728077354
SIM,1909,5,na,1914,3719
SIM,1927,33,50-100,1960,4
SIM,1909,26,20-24,1935,15
STAT,1922,47,50-100,1969,0.24546708554931507
SIM,1822,69,na,1891,772
SIM,1910,22,45-49,1932,5
STAT,1789,65,na,1854,702.0
STAT,1809,53,35-39,1862,0.02267975849007265
SIM,1893,73,na,1966,1857
STAT,1860,49,na,1909,1688.5179612933691
SIM,1830,61,na,1891,1098
SIM,1931,18,35-39,1949,4
SIM,1932,35,35-39,1967,11
STAT,1848,15,na,1863,2139.5312763701236
STAT,1857,25,25-29,1882,32.93438356639437
SIM,1809,87,na,1896,69
SIM,1875,32,25-29,1907,8
STAT,1888,28,15-19,1916,0.5047523865403544
STAT,1913,44,25-29,1957,0.06556944005972692
SIM,1822,44,na,1866,1442
STAT,1822,94,na,1916,10.15567723000887
SIM,1948,18,na,1966,3984
STAT,1883,34,25-29,1917,9.405614536282407
SIM,1902,28,25-29,1930,59
STAT,1805,49,30-34,1854,0.359679410267001
STAT,1870,27,15-19,1897,0.42047394906520985
SIM,1882,36,40-44,1918,2
STAT,1861,2,na,1863,2703.8154441490547
STAT,1833,51,50-100,1884,0.009740974906651548
STAT,1842,12,na,1854,2220.0
SIM,1824,31,25-29,1855,8
STAT,1848,49,45-49,1897,0.17170027552127132
SIM,1874,25,35-39,1899,2
SIM,1889,59,na,1948,2302
STAT,1844,20,20-24,1864,60.62548283850964
SIM,1882,22,15-19,1904,3
SIM,1916,27,50-100,1943,6
SIM,1911,38,na,1949,3390
STAT,1892,73,na,1965,1683.3570878562246
SIM,1891,34,25-29,1925,13
STAT,1863,103,na,1966,0.6941957624944995
STAT,1912,11,na,1923,3778.418506081374
SIM,1817,41,35-39,1858,4
STAT,1866,25,35-39,1891,8.46435505729231
STAT,1816,43,25-29,1859,1.6554655169418167
SIM,1884,32,35-39,1916,10
STAT,1902,22,45-49,1924,0.9296910420327084
STAT,1904,44,15-19,1948,0.0012819354290152496
SIM,1936,19,30-34,1955,12
SIM,1919,33,45-49,1952,1
STAT,1874,36,40-44,1910,4.245604602080361
STAT,1942,29,50-100,1971,0.9859306697912739
SIM,1948,16,30-34,1964,20
STAT,1873,15,25-29,1888,5.493902100436367
STAT,1884,3,na,1887,2761.2336419501194
STAT,1912,17,20-24,1929,25.899618961080872
STAT,1924,35,35-39,1959,2.6990015567287866
STAT,1903,27,15-19,1930,0.6098452902079359
STAT,1855,21,35-39,1876,4.8795826459464955
STAT,1937,23,45-49,1960,1.0347616655995102
SIM,1863,29,30-34,1892,20
SIM,1867,38,40-44,1905,8
STAT,1918,45,20-24,1963,0.01116212330626995
SIM,1929,16,20-24,1945,139
STAT,1889,20,45-49,1909,0.81810701612137
SIM,1889,38,25-29,1927,3
SIM,1796,87,na,1883,50
SIM,1841,21,15-19,1862,1
SIM,1855,37,na,1892,1880
STAT,1876,32,35-39,1908,9.884065024795811
STAT,1922,27,25-29,1949,70.36045140444392
STAT,1848,42,25-29,1890,0.47657247514328255
SIM,1817,45,50-100,1862,4
SIM,1932,23,35-39,1955,11
STAT,1955,13,na,1968,4924.869752948688
SIM,1857,5,na,1862,2347
SIM,1942,15,na,1957,3563
SIM,1905,16,35-39,1921,3
STAT,1857,50,50-100,1907,0.011414172245458322
STAT,1909,32,40-44,1941,3.527985841477908
SIM,1945,23,45-49,1968,1
SIM,1917,32,40-44,1949,3
SIM,1897,54,na,1951,2721
SIM,1963,3,na,1966,4694
STAT,1919,46,50-100,1965,0.23233138837415818
SIM,1930,27,25-29,1957,81
STAT,1836,27,na,1863,1812.6257025207633
STAT,1930,34,15-19,1964,0.15646286717269592
STAT,1833,21,15-19,1854,2.9641658633767483
STAT,1912,33,na,1945,3500.98027440403
STAT,1855,29,30-34,1884,18.385591823934124
STAT,1892,70,na,1962,1841.9541597371692
SIM,1837,27,50-100,1864,1
SIM,1929,36,na,1965,4529
SIM,1920,17,20-24,1937,127
STAT,1822,39,20-24,1861,1.2170227543836158
STAT,1885,31,50-100,1916,0.866302585467196
STAT,1942,18,45-49,1960,0.49301465106775816
STAT,1888,23,20-24,1911,76.69949482370455
SIM,1863,21,35-39,1884,5
STAT,1823,54,30-34,1877,0.006779948961481487
STAT,1883,15,25-29,1898,5.2729853980394195
SIM,1891,60,na,1951,2252
STAT,1823,57,na,1880,1168.817332115416
STAT,1909,44,40-44,1953,0.21830604656521208
SIM,1950,10,na,1960,4259
SIM,1939,20,25-29,1959,97
STAT,1877,23,45-49,1900,0.681218083303889
STAT,1830,36,na,1866,1643.0830631041304
STAT,1835,43,35-39,1878,1.3633724949274089
STAT,1889,32,45-49,1921,2.0337411127919114
STAT,1862,51,40-44,1913,0.008544063053566368
STAT,1882,43,15-19,1925,0.01259565238219555
SIM,1950,18,45-49,1968,2
SIM,1896,23,20-24,1919,79
STAT,1859,77,na,1936,649.928261751627
STAT,1903,39,15-19,1942,0.01612778617676476
STAT,1955,17,35-39,1972,5.261763280688257
SIM,1858,42,na,1900,1887
STAT,1884,44,na,1928,2128.0107716061957
SIM,1843,43,35-39,1886,2
STAT,1942,24,30-34,1966,28.44923888584974
SIM,1883,38,50-100,1921,1
SIM,1843,31,35-39,1874,15
STAT,1868,38,15-19,1906,0.050363423670759445
STAT,1898,26,25-29,1924,54.26455060636943
STAT,1929,24,30-34,1953,34.11936493056479
STAT,1930,30,na,1960,4616.062085057096
STAT,1898,45,25-29,1943,0.0419514926741879
SIM,1841,38,45-49,1879,2
STAT,1847,27,15-19,1874,0.40212829670623973
STAT,1893,22,25-29,1915,68.58182592645605
SIM,1866,93,na,1959,35
STAT,1861,27,40-44,1888,2.3700718122353988
STAT,1919,43,20-24,1962,0.01805120074775442
STAT,1904,38,na,1942,3201.713310371245
SIM,1924,22,30-34,1946,35
STAT,1929,29,25-29,1958,77.74018524248908
SIM,1929,33,na,1962,4492
STAT,1773,87,na,1860,45.23588781904331
SIM,1845,94,na,1939,9
STAT,1901,17,45-49,1918,0.08637868132846979
STAT,1847,25,25-29,1872,38.037095284725645
STAT,1847,25,50-100,1872,0.5752062186066825
STAT,1948,23,20-24,1971,120.576116194941
STAT,1936,3,na,1939,3668.390402029059
STAT,1791,97,na,1888,0.9356871585363142
STAT,1833,38,45-49,1871,1.5133958913187997
SIM,1848,32,30-34,1880,15
SIM,1777,83,na,1860,99
SIM,1855,31,na,1886,1957
STAT,1846,46,15-19,1892,2.975236063941549E-4
STAT,1841,42,15-19,1883,0.00989315849904564
STAT,1900,23,na,1923,3089.8296013137538
SIM,1846,54,na,1900,1505
SIM,1889,26,25-29,1915,55
SIM,1937,29,25-29,1966,69
STAT,1920,18,25-29,1938,45.809834931137594
STAT,1838,25,15-19,1863,0.39309109345119014
STAT,1916,34,30-34,1950,15.23487526731283
SIM,1848,37,25-29,1885,1
SIM,1903,29,20-24,1932,19
STAT,1857,38,30-34,1895,3.95116504240208
STAT,1883,19,40-44,1902,0.16849876119551607
STAT,1889,43,25-29,1932,0.7435087416254635
STAT,1811,54,na,1865,1163.2484527599472
STAT,1835,31,35-39,1866,8.291617600756199
STAT,1851,16,25-29,1867,4.985424570554107
STAT,1945,5,na,1950,4102.237023514974
STAT,1910,19,45-49,1929,0.09300948720008212
STAT,1859,31,20-24,1890,2.0407099380014215
STAT,1878,49,30-34,1927,0.09331176958633619
SIM,1881,15,25-29,1896,7
SIM,1933,24,30-34,1957,43
STAT,1916,22,30-34,1938,28.451275613160767
STAT,1872,37,na,1909,2232.47038319971
SIM,1903,17,20-24,1920,24
STAT,1852,31,35-39,1883,7.68109313246155
STAT,1861,96,na,1957,9.014924541574448
SIM,1839,23,25-29,1862,52
STAT,1836,104,na,1940,0.043192716728803385
STAT,1842,21,25-29,1863,52.66670207003795
SIM,1867,31,20-24,1898,2
STAT,1838,102,na,1940,0.19682307404721067
STAT,1891,16,50-100,1907,0.05740142206806378
STAT,1924,36,na,1960,4194.673723120299
STAT,1832,40,15-19,1872,0.010481110808983278
SIM,1908,34,na,1942,3284
SIM,1877,34,na,1911,2300
SIM,1907,21,25-29,1928,75
SIM,1878,20,40-44,1898,3
SIM,1905,28,35-39,1933,14
STAT,1888,16,15-19,1904,6.641891257790579
SIM,1860,31,35-39,1891,10
STAT,1893,36,na,1929,2836.1107764265103
STAT,1800,91,na,1891,23.036171577474764
STAT,1842,33,25-29,1875,8.86797666131533
SIM,1830,37,30-34,1867,5
STAT,1893,58,na,1951,2369.2164754500923
STAT,1884,22,na,1906,2207.348858783832
SIM,1865,25,25-29,1890,41
STAT,1936,31,50-100,1967,0.7590798601102803
SIM,1900,34,45-49,1934,4
SIM,1896,16,15-19,1912,10
STAT,1797,60,na,1857,971.527914805552
STAT,1872,59,na,1931,1841.5824270796063
STAT,1916,16,45-49,1932,0.10036930135193196
STAT,1898,39,30-34,1937,1.4558193200728613
STAT,1952,15,35-39,1967,4.752880299050976
SIM,1848,25,25-29,1873,48
SIM,1834,54,na,1888,1288
SIM,1879,44,na,1923,2315
SIM,1892,23,na,1915,3107
STAT,1888,15,45-49,1903,0.07326803376616887
SIM,1850,21,25-29,1871,56
STAT,1904,16,na,1920,3430.744072255518
STAT,1836,22,45-49,1858,0.595955146294251
SIM,1900,60,na,1960,2633
STAT,1807,48,45-49,1855,0.8938032713146123
STAT,1817,54,na,1871,1194.3899607936542
SIM,1907,34,30-34,1941,13
STAT,1930,41,20-24,1971,0.021982657342468
SIM,1850,9,na,1859,2259
STAT,1827,43,50-100,1870,0.996194299540262
SIM,1809,62,na,1871,914
STAT,1949,10,na,1959,4317.2099939296895
SIM,1869,30,35-39,1899,8
SIM,1924,34,30-34,1958,22
STAT,1861,33,35-39,1894,7.921111399055073
STAT,1901,24,45-49,1925,0.9163250004781415
SIM,1840,16,15-19,1856,5
SIM,1889,33,30-34,1922,30
STAT,1874,39,45-49,1913,1.9047942050030537
SIM,1855,25,25-29,1880,39
STAT,1891,29,50-100,1920,0.7423167918300265
STAT,1897,11,na,1908,3267.5651986597272
STAT,1943,28,na,1971,3767.2171636220937
SIM,1937,24,30-34,1961,35
STAT,1861,21,35-39,1882,4.743063033767548
STAT,1822,37,30-34,1859,9.381048068722341
STAT,1802,77,na,1879,347.56755075615973
STAT,1847,67,na,1914,1168.9511089790626
STAT,1898,73,na,1971,1924.85562974072
STAT,1937,2,na,1939,3758.7145892719054
SIM,1879,19,25-29,1898,4
STAT,1859,71,na,1930,1003.6239298873868
STAT,1860,31,na,1891,1836.6054938689524
SIM,1850,33,25-29,1883,13
STAT,1826,31,25-29,1857,15.045835768994987
STAT,1935,34,40-44,1969,5.108008008053911
SIM,1859,20,30-34,1879,19
SIM,1882,21,45-49,1903,1
SIM,1895,6,na,1901,3314
STAT,1877,74,na,1951,1087.5202782233473
STAT,1831,39,30-34,1870,3.988373079563204
SIM,1834,69,na,1903,859
SIM,1810,44,45-49,1854,4
STAT,1873,81,na,1954,518.1142978579935
STAT,1841,76,na,1917,653.1513764590354
SIM,1868,22,30-34,1890,16
STAT,1935,22,40-44,1957,4.325439312055328
SIM,1860,83,na,1943,270
SIM,1910,53,na,1963,3159
SIM,1935,14,na,1949,5030
SIM,1904,37,25-29,1941,4
SIM,1834,31,25-29,1865,13
STAT,1852,44,40-44,1896,1.6086827675513486
SIM,1821,81,na,1902,306
SIM,1908,32,30-34,1940,21
STAT,1833,31,25-29,1864,8.175705401110292
STAT,1907,26,45-49,1933,1.5460859839126455
STAT,1937,25,na,1962,3452.772434283175
STAT,1851,57,na,1908,1445.6139107740955
STAT,1902,41,45-49,1943,0.13918939120782908
STAT,1914,1,na,1915,4067.6952812518653
SIM,1879,66,na,1945,1629
STAT,1890,19,40-44,1909,0.21011390695803503
STAT,1926,20,40-44,1946,3.88186411095721
SIM,1929,22,15-19,1951,6
SIM,1896,26,25-29,1922,53
STAT,1860,34,na,1894,1813.4702242753883
STAT,1863,23,na,1886,1985.3820184552867
STAT,1879,26,15-19,1905,0.4501939434765618
STAT,1862,24,50-100,1886,0.3323579459158823
SIM,1839,39,40-44,1878,5
STAT,1848,32,15-19,1880,0.12340163272699121
STAT,1926,25,35-39,1951,17.11725421432028
SIM,1955,9,na,1964,4604
STAT,1761,99,na,1860,0.4210801890134384
STAT,1779,97,na,1876,0.7785488608778134
STAT,1842,27,30-34,1869,22.55189429890426
STAT,1893,45,40-44,1938,0.11684822493928404
STAT,1922,37,35-39,1959,2.600010238238815
SIM,1879,41,na,1920,2334
STAT,1892,15,35-39,1907,0.6522768233153079
SIM,1919,19,30-34,1938,17
SIM,1939,26,30-34,1965,40
SIM,1913,49,50-100,1962,1
STAT,1808,108,na,1916,7.08245497566624E-4
STAT,1873,41,15-19,1914,0.013291266524983804
SIM,1843,37,40-44,1880,3
SIM,1856,19,na,1875,2138
SIM,1857,24,20-24,1881,60
SIM,1926,26,20-24,1952,20
STAT,1809,47,40-44,1856,0.48319623416773355
SIM,1891,24,15-19,1915,3
STAT,1853,106,na,1959,0.021233754690530814
STAT,1863,38,30-34,1901,4.396397314676578
STAT,1826,54,40-44,1880,0.009010783467707539
STAT,1866,22,30-34,1888,15.646946255511349
STAT,1888,26,25-29,1914,47.38941766273632
STAT,1911,24,45-49,1935,1.0018179463097399
SIM,1904,34,20-24,1938,1
SIM,1905,23,na,1928,3209
SIM,1950,19,15-19,1969,49
STAT,1826,36,50-100,1862,1.3839437890330206
STAT,1928,29,na,1957,4355.546826210481
STAT,1938,16,20-24,1954,126.65318201882485
SIM,1883,17,25-29,1900,7
STAT,1871,45,20-24,1916,0.011369094168019013
SIM,1834,36,50-100,1870,3
SIM,1934,20,40-44,1954,3
STAT,1827,37,15-19,1864,0.05828696906093761
STAT,1935,29,25-29,1964,84.67516723873176
SIM,1899,30,20-24,1929,3
STAT,1943,23,45-49,1966,1.1305231539648517
SIM,1921,37,25-29,1958,1
SIM,1882,39,45-49,1921,2
STAT,1889,47,40-44,1936,0.11210139489504414
STAT,1802,55,na,1857,1081.7466166885133
STAT,1864,19,30-34,1883,1.3719565320389695
STAT,1900,45,35-39,1945,0.1045244902564871
SIM,1936,32,50-100,1968,1
STAT,1913,37,25-29,1950,0.9179645263674929
STAT,1928,33,20-24,1961,2.8793736615809458
SIM,1872,19,30-34,1891,1
STAT,1847,52,na,1899,1579.308979403273
SIM,1831,28,40-44,1859,2
SIM,1880,38,na,1918,2355
STAT,1804,54,20-24,1858,0.002504647417920177
SIM,1930,24,20-24,1954,141
STAT,1905,49,50-100,1954,0.18522421800735725
STAT,1942,19,15-19,1961,44.774713476564216
STAT,1835,37,40-44,1872,3.4444712910447146
SIM,1918,7,na,1925,4118
STAT,1934,11,na,1945,5070.507947452502
STAT,1861,38,20-24,1899,0.6024886505760584
SIM,1930,37,35-39,1967,7
STAT,1866,27,25-29,1893,36.85812982634889
SIM,1876,52,na,1928,2070
SIM,1833,24,35-39,1857,5
STAT,1867,51,25-29,1918,0.003157075379435786
STAT,1887,47,15-19,1934,4.2070283891781625E-4
SIM,1850,27,30-34,1877,21
STAT,1918,34,40-44,1952,3.894872405774102
STAT,1871,74,na,1945,1041.0619195969941
SIM,1924,18,35-39,1942,6
STAT,1811,51,na,1862,1234.456576400604
STAT,1848,46,40-44,1894,0.1275727109400361
SIM,1922,16,35-39,1938,4
STAT,1792,79,na,1871,273.8395532227
SIM,1936,33,20-24,1969,4
SIM,1839,20,20-24,1859,57
STAT,1896,47,na,1943,2794.52624389392
SIM,1926,34,40-44,1960,5
SIM,1880,23,na,1903,2385
STAT,1894,28,15-19,1922,0.5488784485419682
STAT,1874,22,15-19,1896,3.184295195572084
STAT,1879,29,na,1908,2343.101721931461
STAT,1913,41,20-24,1954,0.016363998889393338
SIM,1859,33,45-49,1892,2
STAT,1776,98,na,1874,0.536986543527685
SIM,1946,16,20-24,1962,137
STAT,1802,104,na,1906,0.02338467843551596
STAT,1916,29,15-19,1945,0.6846331091491192
STAT,1933,16,45-49,1949,0.6332745893319972
STAT,1865,89,na,1954,89.95377779157481
SIM,1874,34,25-29,1908,11
STAT,1942,27,35-39,1969,14.886216710003303
SIM,1864,67,na,1931,1407
STAT,1852,21,25-29,1873,49.65932282191923
SIM,1826,43,35-39,1869,2
SIM,1860,21,25-29,1881,48
STAT,1868,33,50-100,1901,0.8223656142265029
SIM,1846,29,30-34,1875,31
STAT,1922,26,na,1948,4018.298009494945
SIM,1800,66,na,1866,747
SIM,1893,34,35-39,1927,12
STAT,1842,18,40-44,1860,0.16908799717946502
SIM,1907,15,30-34,1922,1
SIM,1874,22,30-34,1896,17
SIM,1934,25,35-39,1959,18
STAT,1866,34,25-29,1900,8.848190654833154
STAT,1883,28,30-34,1911,23.241712344624847
SIM,1888,30,45-49,1918,1
SIM,1823,91,na,1914,26
STAT,1883,24,15-19,1907,3.0364715673683706
SIM,1932,22,na,1954,4486
SIM,1871,38,30-34,1909,8
SIM,1856,16,na,1872,2185
STAT,1902,18,50-100,1920,0.06514638093473386
STAT,1935,24,50-100,1959,0.8458901814852325
STAT,1838,56,na,1894,1369.3086104300016
STAT,1871,71,na,1942,1252.1394818265635
SIM,1868,41,50-100,1909,1
SIM,1877,19,15-19,1896,4
STAT,1838,29,30-34,1867,21.197886037339327
STAT,1885,34,35-39,1919,9.454442429337595
STAT,1882,53,50-100,1935,0.013652347937080561
STAT,1914,16,35-39,1930,0.8220327458173204
SIM,1941,25,35-39,1966,12
STAT,1921,19,20-24,1940,145.20788758586426
STAT,1934,14,na,1948,5046.562185650316
SIM,1790,65,na,1855,702
STAT,1844,34,50-100,1878,0.7453328571878318
SIM,1889,23,20-24,1912,88
STAT,1805,69,na,1874,738.1906962372406
SIM,1793,76,na,1869,329
STAT,1807,95,na,1902,4.945251534146955
SIM,1829,35,25-29,1864,1
SIM,1900,24,35-39,1924,10
STAT,1857,48,40-44,1905,0.12595171574723052
SIM,1839,60,na,1899,1306
SIM,1842,16,25-29,1858,9
SIM,1852,26,50-100,1878,1
SIM,1908,30,40-44,1938,4
STAT,1869,19,15-19,1888,5.441772515587724
STAT,1842,23,15-19,1865,2.99171650666689
SIM,1893,70,na,1963,1965
STAT,1836,19,50-100,1855,0.06049462825412364
SIM,1902,27,na,1929,3156
SIM,1848,35,35-39,1883,9
STAT,1849,93,na,1942,21.915187587366983
STAT,1835,48,20-24,1883,0.007948038353179799
SIM,1878,32,35-39,1910,12
SIM,1768,91,na,1859,12
SIM,1872,71,na,1943,1192
SIM,1915,22,20-24,1937,97
STAT,1925,15,40-44,1940,1.603568063457929
STAT,1816,47,40-44,1863,0.40430639111389316
STAT,1903,18,25-29,1921,7.596989400290429
SIM,1849,49,50-100,1898,1
STAT,1848,31,45-49,1879,1.5268603169974173
STAT,1847,22,20-24,1869,62.296162670878914
STAT,1929,16,50-100,1945,0.4527876147847644
STAT,1796,106,na,1902,0.002614945326670381
SIM,1925,33,45-49,1958,2
SIM,1891,28,30-34,1919,32
SIM,1846,79,na,1925,470
SIM,1911,18,25-29,1929,13
STAT,1919,46,25-29,1965,0.05448814281736462
SIM,1911,34,20-24,1945,2
STAT,1822,91,na,1913,29.445463560259967
STAT,1931,26,20-24,1957,22.272889662877102
SIM,1908,35,35-39,1943,5
STAT,1924,23,35-39,1947,10.463488125441891
STAT,1826,50,25-29,1876,0.003282228156582655
SIM,1956,10,na,1966,4787
STAT,1929,27,35-39,1956,17.75005731354329
SIM,1852,42,na,1894,1770
SIM,1853,27,na,1880,1970
SIM,1898,25,20-24,1923,19
SIM,1893,21,20-24,1914,84
STAT,1835,42,na,1877,1603.3274736533729
STAT,1899,4,na,1903,3405.169282147138
SIM,1923,26,na,1949,4139
SIM,1948,22,25-29,1970,106
STAT,1830,44,20-24,1874,0.12014638658706954
STAT,1907,22,20-24,1929,95.63177491618953
SIM,1938,19,40-44,1957,2
SIM,1824,37,30-34,1861,8
STAT,1893,41,25-29,1934,0.772802885253122
STAT,1828,94,na,1922,11.255764041907568
STAT,1818,43,35-39,1861,4.128629125375405
STAT,1903,34,20-24,1937,2.0683922265359125
SIM,1920,12,na,1932,4266
STAT,1890,45,30-34,1935,0.11291529609155306
STAT,1923,47,50-100,1970,0.24995457703153665
STAT,1953,18,20-24,1971,154.87942101970677
STAT,1857,29,40-44,1886,2.2659756642270215
SIM,1850,23,15-19,1873,3
STAT,1916,18,35-39,1934,0.83883317083865
STAT,1916,37,35-39,1953,2.3399466521247203
STAT,1883,38,40-44,1921,4.034391293591372
STAT,1889,33,15-19,1922,0.1653827692715495
SIM,1933,15,40-44,1948,2
SIM,1881,85,na,1966,363
SIM,1914,12,na,1926,3884
SIM,1917,48,na,1965,3578
STAT,1911,40,50-100,1951,0.10713108508652802
SIM,1872,15,15-19,1887,4
STAT,1917,33,45-49,1950,1.5500970222923416
STAT,1814,65,na,1879,926.5944425869772
STAT,1829,79,na,1908,422.4242508296259
STAT,1779,94,na,1873,3.3935047584035436
STAT,1887,33,na,1920,2510.936363848971
STAT,1838,39,40-44,1877,3.473358266121178
STAT,1872,36,15-19,1908,0.05346689202259738
STAT,1858,53,40-44,1911,0.007672435551783248
SIM,1826,30,20-24,1856,3
SIM,1831,43,na,1874,1502
STAT,1855,19,na,1874,1917.3650181400901
STAT,1857,45,na,1902,1692.9802781323604
SIM,1944,25,na,1969,3739
STAT,1909,44,na,1953,3241.475754445087
STAT,1909,47,45-49,1956,0.18867342113580882
SIM,1790,87,na,1877,40
SIM,1855,22,20-24,1877,63
STAT,1922,24,20-24,1946,119.70840944192257
STAT,1938,29,35-39,1967,14.037711243568697
STAT,1920,16,50-100,1936,0.39806600561916067
SIM,1952,16,20-24,1968,144
STAT,1926,36,15-19,1962,0.02219061780492738
STAT,1874,21,45-49,1895,0.6751031611100891
SIM,1840,57,na,1897,1311
SIM,1846,39,40-44,1885,7
SIM,1860,86,na,1946,147
STAT,1938,15,50-100,1953,0.3507641773848748
STAT,1944,16,20-24,1960,137.868972099428
SIM,1935,11,na,1946,5056
STAT,1864,15,15-19,1879,5.747729177384903
STAT,1907,35,35-39,1942,2.1386639381507515
STAT,1898,35,15-19,1933,0.072470882509311
SIM,1865,29,40-44,1894,2
SIM,1924,37,35-39,1961,5
SIM,1865,38,30-34,1903,4
STAT,1790,108,na,1898,3.634904859800115E-4
STAT,1799,101,na,1900,0.18217275987215872
STAT,1872,34,na,1906,2241.854468068503
STAT,1785,72,na,1857,537.2034511112527
STAT,1895,62,na,1957,2296.0480875818744
STAT,1918,26,20-24,1944,18.41500755487764
STAT,1875,48,na,1923,2157.1784711713804
SIM,1828,51,50-100,1879,1
STAT,1789,107,na,1896,0.0010420224926793729
STAT,1920,27,15-19,1947,0.7315770621823117
STAT,1873,17,15-19,1890,5.685978976278138
STAT,1860,25,50-100,1885,0.50277811446106
STAT,1903,23,40-44,1926,2.792301385298886
STAT,1880,47,20-24,1927,0.011895501597825753
SIM,1867,56,na,1923,1974
SIM,1781,73,na,1854,392
SIM,1881,17,15-19,1898,4
SIM,1892,48,na,1940,2946
STAT,1837,90,na,1927,51.1662607583276
STAT,1926,35,45-49,1961,0.7884133373267875
SIM,1891,38,40-44,1929,5
STAT,1842,37,40-44,1879,3.71877822539907
STAT,1853,2,na,1855,2726.426
STAT,1921,31,45-49,1952,1.6610529314769875
STAT,1835,64,na,1899,1106.4233760946909
STAT,1897,38,50-100,1935,1.5434150772720872
SIM,1884,38,40-44,1922,5
STAT,1772,106,na,1878,0.011123331738960334
STAT,1933,35,45-49,1968,0.8787123381051196
STAT,1802,52,50-100,1854,0.044217234616008405
STAT,1876,38,40-44,1914,4.251272331795091
STAT,1894,30,50-100,1924,1.1213087904198025
STAT,1946,7,na,1953,4134.543679910715
STAT,1913,22,20-24,1935,101.7930393055775
SIM,1868,25,35-39,1893,6
STAT,1885,21,20-24,1906,65.08691843154556
SIM,1846,57,na,1903,1450
SIM,1818,45,50-100,1863,3
SIM,1856,31,45-49,1887,2
STAT,1822,33,15-19,1855,0.3603854558372723
SIM,1850,37,40-44,1887,5
STAT,1862,4,na,1866,2465.721313497552
SIM,1905,18,25-29,1923,11
SIM,1937,27,35-39,1964,13
SIM,1838,18,25-29,1856,6
SIM,1911,23,40-44,1934,2
STAT,1880,85,na,1965,508.935823650028
SIM,1858,42,35-39,1900,3
STAT,1905,63,na,1968,2703.8744988638277
STAT,1853,27,15-19,1880,0.3977676037303075
STAT,1905,36,20-24,1941,0.22828575719367245
STAT,1909,48,15-19,1957,3.188961875649218E-4
SIM,1915,35,35-39,1950,6
SIM,1833,50,na,1883,1384
SIM,1812,51,na,1863,1219
STAT,1833,35,40-44,1868,3.4284399079964816
STAT,1852,40,25-29,1892,0.4702526435777059
SIM,1837,31,35-39,1868,13
STAT,1935,37,45-49,1972,0.9005337132685526
SIM,1879,16,20-24,1895,21
STAT,1814,43,na,1857,1459.735762234774
SIM,1832,28,na,1860,1655
SIM,1902,21,40-44,1923,3
STAT,1923,44,25-29,1967,0.07858363538344323
SIM,1906,33,35-39,1939,5
SIM,1895,20,35-39,1915,10
STAT,1811,43,40-44,1854,8.198052398115951
SIM,1859,23,35-39,1882,4
STAT,1859,44,35-39,1903,1.3431555685581529
STAT,1887,20,35-39,1907,6.2030515858177955
STAT,1927,28,20-24,1955,20.89001686260965
STAT,1849,24,20-24,1873,61.58301041226715
SIM,1935,28,20-24,1963,21
SIM,1889,36,35-39,1925,15
STAT,1820,65,na,1885,890.634533742562
STAT,1831,35,15-19,1866,0.0440917573501781
SIM,1841,35,40-44,1876,1
STAT,1884,24,50-100,1908,0.378216619136578
STAT,1867,32,25-29,1899,9.085989524981832
SIM,1867,44,35-39,1911,4
STAT,1901,21,40-44,1922,2.7638267300973496
STAT,1840,94,na,1934,13.116016538732167
STAT,1899,37,50-100,1936,0.3430134620452037
STAT,1890,42,20-24,1932,0.1831977985376456
STAT,1858,28,40-44,1886,2.2550251300946678
STAT,1878,45,50-100,1923,0.24420888384209438
STAT,1898,24,50-100,1922,0.5180636551451958
SIM,1885,21,25-29,1906,53
STAT,1887,18,50-100,1905,0.05163331435983518
SIM,1910,21,30-34,1931,29
STAT,1819,80,na,1899,326.5538455265921
STAT,1873,45,25-29,1918,0.05573758768076253
STAT,1879,18,30-34,1897,1.5720052971462157
STAT,1837,93,na,1930,18.966810743655753
SIM,1858,36,na,1894,1936
STAT,1808,51,25-29,1859,0.013055918204795564
SIM,1908,35,50-100,1943,1
SIM,1832,38,40-44,1870,3
STAT,1854,43,50-100,1897,0.7504152273742213
STAT,1844,15,35-39,1859,0.4901900803386191
SIM,1888,31,20-24,1919,1
STAT,1941,28,35-39,1969,14.665040702342308
STAT,1760,114,na,1874,2.2747870202832459E-4
STAT,1898,48,35-39,1946,0.09969036522460822
SIM,1840,26,na,1866,1808
SIM,1856,25,50-100,1881,1
SIM,1928,27,30-34,1955,64
SIM,1897,37,30-34,1934,8
STAT,1869,39,na,1908,2134.464602528735
STAT,1902,21,30-34,1923,23.819592798391067
STAT,1782,86,na,1868,58.83744257715638
SIM,1909,32,45-49,1941,5
SIM,1941,7,na,1948,3791
STAT,1843,37,50-100,1880,0.9681048890162739
STAT,1805,60,na,1865,1032.5445279835074
SIM,1922,45,50-100,1967,2
STAT,1824,38,40-44,1862,6.525719135308397
STAT,1900,42,30-34,1942,0.1044957345955543
STAT,1809,48,50-100,1857,0.6810884027702473
STAT,1868,31,25-29,1899,9.26981880584856
STAT,1902,38,25-29,1940,0.8244263594618796
STAT,1904,17,25-29,1921,7.678736646379826
SIM,1883,24,25-29,1907,49
STAT,1869,18,45-49,1887,0.06025331153618823
SIM,1846,18,15-19,1864,3
STAT,1875,42,25-29,1917,0.6227762170715044
SIM,1907,37,40-44,1944,3
STAT,1930,38,30-34,1968,2.243509603365522
STAT,1823,51,20-24,1874,8.921981226575644E-4
STAT,1833,25,30-34,1858,20.661902336425076
SIM,1827,44,na,1871,1435
STAT,1873,44,na,1917,2184.541583108084
SIM,1836,30,45-49,1866,1
SIM,1899,34,30-34,1933,29
SIM,1910,38,25-29,1948,3
SIM,1912,17,25-29,1929,14
SIM,1931,23,50-100,1954,5
STAT,1918,48,30-34,1966,0.08937018356991451
STAT,1900,24,30-34,1924,23.196944932587897
STAT,1794,71,na,1865,598.2819756490911
STAT,1838,18,15-19,1856,5.231764103145019
STAT,1903,28,na,1931,3196.5589506100887
STAT,1934,30,35-39,1964,11.800228879567634
STAT,1943,25,35-39,1968,15.118389292403792
STAT,1806,54,25-29,1860,0.01197582845248838
STAT,1836,39,15-19,1875,0.043717541510917605
STAT,1919,15,na,1934,4064.1239394602903
SIM,1845,69,na,1914,990
STAT,1867,39,50-100,1906,1.0781423187819807
STAT,1891,29,40-44,1920,3.4761354425477564
STAT,1913,40,45-49,1953,0.15506732101823698
STAT,1832,62,na,1894,1101.0278214716607
STAT,1861,30,30-34,1891,13.82462170422365
SIM,1804,87,na,1891,57
STAT,1883,19,35-39,1902,0.5054962543189161
STAT,1927,38,50-100,1965,0.4926285192883919
STAT,1947,17,50-100,1964,0.39870738048618937
SIM,1870,36,na,1906,2195
SIM,1887,19,15-19,1906,6
SIM,1905,21,20-24,1926,77
STAT,1924,40,20-24,1964,0.019899256170779037
SIM,1897,24,25-29,1921,86
SIM,1863,82,na,1945,353
STAT,1899,40,15-19,1939,0.0012538353067211214
STAT,1831,80,na,1911,361.18946845060674
SIM,1924,32,40-44,1956,10
SIM,1871,18,na,1889,2383
STAT,1809,50,na,1859,1224.289932321541
STAT,1946,17,30-34,1963,12.771580905845651
STAT,1811,54,35-39,1865,0.02633119776059721
STAT,1872,47,50-100,1919,0.23163999814832992
STAT,1827,75,na,1902,594.6499534459715
STAT,1857,7,na,1864,2167.477140359321
SIM,1841,25,30-34,1866,24
STAT,1934,32,30-34,1966,20.321375865804303
STAT,1823,85,na,1908,146.71157886218634
STAT,1876,80,na,1956,640.0802015554063
STAT,1917,35,35-39,1952,2.3958982255112855
STAT,1872,90,na,1962,152.64633313489685
STAT,1907,43,25-29,1950,0.061435500844560675
SIM,1891,19,35-39,1910,2
STAT,1852,15,50-100,1867,0.04346875962245164
SIM,1923,38,35-39,1961,6
STAT,1909,40,25-29,1949,0.06381556238247695
STAT,1930,25,25-29,1955,79.13186370707682
STAT,1872,48,15-19,1920,3.742680513371712E-4
STAT,1856,72,na,1928,930.8517967144443
STAT,1916,32,40-44,1948,3.816778786138442
STAT,1833,109,na,1942,4.364991415307091E-4
SIM,1893,31,50-100,1924,1
STAT,1830,49,20-24,1879,0.008762296437638893
SIM,1800,97,na,1897,1
STAT,1786,109,na,1895,3.3429544189683707E-4
STAT,1902,26,50-100,1928,0.8557847860986171
SIM,1877,31,45-49,1908,2
SIM,1925,17,35-39,1942,6
STAT,1932,35,30-34,1967,2.317362912350679
STAT,1940,1,na,1941,3989.2157001089336
STAT,1910,16,40-44,1926,0.26247383313690337
STAT,1872,18,50-100,1890,0.046301960230663845
SIM,1877,15,na,1892,2485
STAT,1833,43,30-34,1876,0.8438469151201653
STAT,1835,22,30-34,1857,15.069759496965592
STAT,1904,49,50-100,1953,0.18380834295481654
STAT,1900,40,35-39,1940,0.1664543183721743
STAT,1849,35,50-100,1884,0.9618321367427166
STAT,1822,104,na,1926,0.033892797623686535
STAT,1869,31,45-49,1900,1.6024496425714583
STAT,1885,16,35-39,1901,0.5179574324086186
STAT,1913,22,15-19,1935,4.8731030265451025
SIM,1913,3,na,1916,3761
STAT,1877,34,na,1911,2318.408191643644
SIM,1843,22,30-34,1865,18
STAT,1816,46,35-39,1862,0.3359238977269364
STAT,1864,52,20-24,1916,6.179997631354841E-4
SIM,1954,17,30-34,1971,17
STAT,1915,38,35-39,1953,2.296889509098733
STAT,1917,17,35-39,1934,0.8530456360072206
STAT,1881,79,na,1960,795.6144096374862
STAT,1907,25,25-29,1932,59.10111183866331
STAT,1835,40,30-34,1875,0.8995088644069184
STAT,1912,27,30-34,1939,36.478601273510904
STAT,1944,22,45-49,1966,1.147666485189039
STAT,1825,80,na,1905,328.7750664400375
STAT,1892,11,na,1903,3060.314598884318
SIM,1906,17,na,1923,3464
STAT,1917,49,25-29,1966,0.052035764327719544
STAT,1851,23,25-29,1874,48.82294576518177
STAT,1927,22,45-49,1949,1.3095795938323007
SIM,1864,36,na,1900,2057
SIM,1872,31,na,1903,2259
STAT,1820,53,50-100,1873,0.023864083057228758
SIM,1821,59,na,1880,1063
SIM,1872,2,na,1874,3008
STAT,1871,20,45-49,1891,0.658041011506765
SIM,1795,65,na,1860,799
SIM,1867,26,35-39,1893,12
SIM,1842,23,25-29,1865,55
STAT,1922,30,15-19,1952,0.13826687906327928
STAT,1807,109,na,1916,2.6462617738084266E-4
STAT,1839,17,20-24,1856,15.440856114214574
STAT,1860,47,40-44,1907,0.13061467183743808
STAT,1871,49,na,1920,2066.447401540091
STAT,1839,33,25-29,1872,8.30550007074121
STAT,1852,39,50-100,1891,0.8811382060636751
STAT,1834,23,25-29,1857,47.17236527171504
STAT,1944,10,na,1954,4000.2005225969588
STAT,1814,49,35-39,1863,0.41415504738200704
STAT,1927,35,20-24,1962,0.3101501045032282
STAT,1860,31,25-29,1891,7.883139697522916
STAT,1866,37,35-39,1903,6.162787263844448
STAT,1877,2,na,1879,3184.3336435634237
SIM,1929,25,25-29,1954,93
SIM,1895,28,na,1923,3002
STAT,1818,39,na,1857,1461.1829847258914
STAT,1920,6,na,1926,4248.07692764686
SIM,1873,23,25-29,1896,64
SIM,1856,49,50-100,1905,2
SIM,1915,25,25-29,1940,66
STAT,1899,29,40-44,1928,3.8497529842808054
SIM,1920,27,30-34,1947,42
SIM,1882,61,na,1943,1747
STAT,1889,24,25-29,1913,66.34502515771057
SIM,1906,38,35-39,1944,6
STAT,1869,30,30-34,1899,16.107390221739976
STAT,1910,32,45-49,1942,1.4333925183593437
SIM,1826,40,30-34,1866,3
SIM,1916,0,na,1916,4091
STAT,1904,48,30-34,1952,0.07306080571370675
STAT,1822,60,na,1882,1046.4239712894614
SIM,1802,92,na,1894,15
SIM,1874,37,35-39,1911,13
SIM,1884,23,30-34,1907,25
STAT,1830,47,25-29,1877,0.0431607905151322
STAT,1854,20,45-49,1874,0.594726773156521
STAT,1784,81,na,1865,183.80970323721064
STAT,1891,40,15-19,1931,0.016303534907394668
SIM,1856,36,30-34,1892,4
SIM,1925,32,30-34,1957,24
SIM,1911,19,30-34,1930,2
SIM,1893,31,30-34,1924,29
SIM,1907,58,na,1965,2954
STAT,1855,111,na,1966,4.858675818506628E-4
SIM,1802,52,na,1854,1091
SIM,1935,22,45-49,1957,1
STAT,1922,43,20-24,1965,0.019119206444341022
SIM,1878,56,na,1934,2061
STAT,1885,69,na,1954,1381.9027937400776
STAT,1885,31,30-34,1916,16.508018264445656
SIM,1847,33,25-29,1880,11
SIM,1886,23,na,1909,2307
SIM,1946,25,25-29,1971,75
STAT,1848,77,na,1925,642.293521162877
STAT,1818,40,30-34,1858,2.8964568663658397
STAT,1892,26,50-100,1918,0.7595137561478227
STAT,1848,36,30-34,1884,4.123646355620205
STAT,1903,19,30-34,1922,2.1309139325911866
SIM,1856,41,na,1897,1824
SIM,1858,36,35-39,1894,12
STAT,1865,23,25-29,1888,49.257106428598654
STAT,1917,32,30-34,1949,15.585850004181834
STAT,1834,41,25-29,1875,0.4866293562196471
STAT,1848,23,25-29,1871,51.421049040323105
STAT,1883,74,na,1957,1090.2641834264593
STAT,1908,24,30-34,1932,24.80572907336848
SIM,1831,39,35-39,1870,12
SIM,1859,42,50-100,1901,1
SIM,1870,76,na,1946,787
STAT,1809,50,30-34,1859,0.016656977742106973
STAT,1851,41,25-29,1892,0.46402127009358907
STAT,1825,33,25-29,1858,16.25539211094442
STAT,1865,39,40-44,1904,3.7105825613559857
STAT,1925,15,na,1940,4219.835174694347
STAT,1854,77,na,1931,618.4596350283535
STAT,1855,47,30-34,1902,0.06846796624305514
STAT,1932,25,na,1957,4639.302503629288
SIM,1944,25,20-24,1969,17
STAT,1810,75,na,1885,420.3461199806749
SIM,1912,35,25-29,1947,1
SIM,1961,2,na,1963,4756
SIM,1816,72,na,1888,567
STAT,1828,57,na,1885,1176.927787989084
STAT,1928,33,15-19,1961,0.15169663118293042
STAT,1936,25,20-24,1961,16.51708841102506
STAT,1828,30,45-49,1858,1.9507359766667107
STAT,1855,18,15-19,1873,4.986454106255393
STAT,1933,15,25-29,1948,55.056605111447425
STAT,1878,16,50-100,1894,0.04835197615647461
SIM,1815,59,na,1874,1124
STAT,1938,25,25-29,1963,61.656682139880225
SIM,1833,33,25-29,1866,9
SIM,1941,15,25-29,1956,46
SIM,1847,17,20-24,1864,16
SIM,1938,10,na,1948,3541
STAT,1895,21,45-49,1916,0.8614131954946378
SIM,1926,37,na,1963,4295
STAT,1894,46,na,1940,2739.6822761283115
SIM,1873,39,40-44,1912,5
STAT,1904,35,25-29,1939,0.8500965243661025
STAT,1908,40,35-39,1948,0.17799847077413108
SIM,1874,38,na,1912,2197
STAT,1771,107,na,1878,0.005678328219412578
STAT,1865,49,na,1914,1886.239496514435
SIM,1866,28,40-44,1894,2
STAT,1857,14,na,1871,2071.5732529595944
STAT,1859,41,30-34,1900,0.8683359639844512
SIM,1833,44,na,1877,1501
STAT,1923,46,45-49,1969,0.24078150407604818
STAT,1876,41,30-34,1917,1.127158866480672
SIM,1955,15,25-29,1970,51
STAT,1790,81,na,1871,191.35297016073662
SIM,1916,24,30-34,1940,40
STAT,1840,39,35-39,1879,5.3771103415984305
STAT,1942,22,40-44,1964,3.3304606632085307
STAT,1838,29,50-100,1867,0.5384870280583811
SIM,1847,15,25-29,1862,7
SIM,1853,30,45-49,1883,1
STAT,1941,19,50-100,1960,0.36431454146763675
SIM,1844,16,na,1860,1986
STAT,1900,27,35-39,1927,12.644963847088276
STAT,1870,95,na,1965,41.330549924598294
STAT,1889,37,30-34,1926,6.215646009828128
STAT,1871,48,25-29,1919,0.05335403792828048
SIM,1925,30,35-39,1955,10
STAT,1892,24,25-29,1916,67.3118494497521
STAT,1840,51,20-24,1891,4.865822724160768E-4
STAT,1803,65,na,1868,809.694285042106
STAT,1879,69,na,1948,1451.21431702957
SIM,1912,17,na,1929,3678
SIM,1841,79,na,1920,428
SIM,1856,23,25-29,1879,54
STAT,1818,102,na,1920,0.1439778602908975
STAT,1845,30,45-49,1875,1.4979949944309212
STAT,1908,42,30-34,1950,0.11174285619217338
STAT,1839,15,25-29,1854,4.994156315316421
SIM,1778,93,na,1871,5
STAT,1933,33,25-29,1966,11.759452468175425
SIM,1901,32,45-49,1933,3
STAT,1858,37,50-100,1895,0.9093663194348223
SIM,1818,42,50-100,1860,1
STAT,1902,35,20-24,1937,0.22393101900172885
SIM,1888,18,20-24,1906,18
STAT,1919,43,na,1962,3796.117882848617
STAT,1947,15,25-29,1962,46.141614809918046
SIM,1884,41,30-34,1925,3
STAT,1930,40,45-49,1970,0.20743854116432592
STAT,1943,22,30-34,1965,28.887455603751814
SIM,1898,48,na,1946,2789
STAT,1882,80,na,1962,774.8586606573203
SIM,1932,25,na,1957,4552
SIM,1814,77,na,1891,315
SIM,1846,17,30-34,1863,1
STAT,1842,52,na,1894,1550.9850309858466
SIM,1882,29,40-44,1911,3
STAT,1884,18,40-44,1902,0.17025996046607528
SIM,1863,18,15-19,1881,3
SIM,1810,87,na,1897,53
STAT,1874,29,40-44,1903,2.8707230845204936
STAT,1775,104,na,1879,0.02987283371689605
STAT,1859,49,na,1908,1656.3139267950257
STAT,1853,39,15-19,1892,0.042069835969099696
SIM,1857,94,na,1951,16
SIM,1850,16,na,1866,2168
SIM,1876,21,na,1897,2312
SIM,1931,12,na,1943,4888
SIM,1944,10,na,1954,3906
STAT,1920,15,15-19,1935,9.695289215307081
STAT,1819,40,na,1859,1539.1433072735665
SIM,1899,37,35-39,1936,5
STAT,1840,36,30-34,1876,4.1799559061214255
SIM,1771,83,na,1854,90
STAT,1791,101,na,1892,0.10565478821940488
STAT,1842,33,30-34,1875,15.116503717982756
SIM,1854,8,na,1862,2338
STAT,1894,21,25-29,1915,69.70882771259366
STAT,1820,37,na,1857,1479.5411091149138
STAT,1807,55,na,1862,1152.1474340741643
STAT,1879,19,15-19,1898,5.837046526081175
STAT,1857,103,na,1960,0.2608863296184527
SIM,1850,15,30-34,1865,2
STAT,1901,33,na,1934,3142.202654860771
STAT,1924,43,25-29,1967,0.0801127041067467
STAT,1930,22,20-24,1952,134.56691481384993
SIM,1910,24,35-39,1934,12
SIM,1950,19,na,1969,3979
STAT,1833,28,35-39,1861,7.747090740672074
STAT,1843,35,40-44,1878,3.5242008597552528
STAT,1883,24,50-100,1907,0.3753364545038908
SIM,1851,35,40-44,1886,2
STAT,1902,24,35-39,1926,7.731341037587347
SIM,1835,30,25-29,1865,8
STAT,1825,36,35-39,1861,9.256374037271252
STAT,1829,70,na,1899,847.7873237140668
STAT,1854,48,25-29,1902,0.0406941075665339
STAT,1921,35,25-29,1956,1.0403871520381855
STAT,1939,24,30-34,1963,27.249631720822336
SIM,1789,93,na,1882,3
STAT,1903,68,na,1971,2408.6219085990942
STAT,1962,9,na,1971,4755.301323539469
SIM,1856,20,15-19,1876,2
STAT,1813,49,20-24,1862,0.0317519609928874
SIM,1879,23,20-24,1902,72
STAT,1901,22,25-29,1923,75.69826736946438
STAT,1929,42,50-100,1971,0.1437209553842996
SIM,1831,49,na,1880,1415
STAT,1835,25,35-39,1860,8.119978472851214
STAT,1925,24,30-34,1949,32.29602921644554
SIM,1924,35,45-49,1959,1
STAT,1909,34,50-100,1943,0.7389982611905508
SIM,1876,31,25-29,1907,15
STAT,1918,32,45-49,1950,1.5796783552690716
STAT,1848,20,15-19,1868,3.0281170566142377
STAT,1922,49,35-39,1971,0.139104081577061
STAT,1938,22,20-24,1960,103.96482469538999
SIM,1833,36,35-39,1869,11
SIM,1850,33,30-34,1883,19
STAT,1883,34,na,1917,2191.3100608857653
STAT,1893,20,50-100,1913,0.49145912070183345
STAT,1961,4,na,1965,4798.619256361967
STAT,1914,31,na,1945,3611.257279399126
SIM,1901,31,30-34,1932,31
STAT,1843,93,na,1936,19.740195687057597
STAT,1898,48,50-100,1946,0.17488538303442897
SIM,1907,32,40-44,1939,3
SIM,1919,43,na,1962,3867
STAT,1890,56,na,1946,2355.70756700453
SIM,1856,39,35-39,1895,9
SIM,1913,16,30-34,1929,5
STAT,1896,19,15-19,1915,7.364744035790041
STAT,1905,43,20-24,1948,0.014950302100401342
SIM,1843,25,35-39,1868,11
STAT,1843,17,40-44,1860,0.15787723882025462
SIM,1856,72,na,1928,996
SIM,1883,21,20-24,1904,53
SIM,1889,28,na,1917,2871
STAT,1908,43,45-49,1951,0.14459424931733
SIM,1918,38,25-29,1956,1
STAT,1795,65,na,1860,830.7260412673278
STAT,1905,16,30-34,1921,2.1817651164780503
SIM,1839,69,na,1908,983
SIM,1841,28,40-44,1869,2
STAT,1830,67,na,1897,956.7515878563028
STAT,1921,17,25-29,1938,46.664342154560075
STAT,1869,15,35-39,1884,0.5151775861166783
SIM,1897,21,20-24,1918,90
STAT,1841,38,40-44,1879,3.518952413098156
SIM,1915,53,na,1968,3264
SIM,1838,22,20-24,1860,61
STAT,1829,28,15-19,1857,0.5642909337513177
STAT,1867,44,na,1911,2022.5755451446548
SIM,1926,32,45-49,1958,4
STAT,1827,49,15-19,1876,3.562985582744427E-4
STAT,1881,37,30-34,1918,4.863807329343933
STAT,1897,31,20-24,1928,3.428952628869056
SIM,1918,22,45-49,1940,1
STAT,1889,21,20-24,1910,80.6121738108412
SIM,1869,20,25-29,1889,62
STAT,1859,26,35-39,1885,7.43353803435683
SIM,1897,23,na,1920,3028
SIM,1891,78,na,1969,1266
STAT,1899,47,40-44,1946,0.12441907100858965
STAT,1951,17,40-44,1968,1.5734890811600215
SIM,1891,16,30-34,1907,1
STAT,1838,17,30-34,1855,1.4134439990074334
STAT,1816,60,na,1876,1097.0257149504184
SIM,1868,44,50-100,1912,3
SIM,1862,41,na,1903,1972
STAT,1814,46,30-34,1860,0.3010690190253652
SIM,1937,3,na,1940,3610
STAT,1876,23,30-34,1899,17.331154554931693
SIM,1868,66,na,1934,1462
STAT,1906,45,30-34,1951,0.0758778376135865
SIM,1916,25,45-49,1941,1
STAT,1856,30,20-24,1886,2.059078610150175
SIM,1842,20,20-24,1862,56
SIM,1904,22,15-19,1926,4
STAT,1947,19,40-44,1966,1.4875107821923172
SIM,1825,49,na,1874,1400
SIM,1903,68,na,1971,2436
STAT,1904,13,na,1917,3494.0213752692166
SIM,1824,43,30-34,1867,1
STAT,1853,52,45-49,1905,0.010924470943052506
SIM,1859,35,40-44,1894,7
SIM,1925,35,35-39,1960,8
STAT,1833,46,35-39,1879,0.10191615983547793
STAT,1853,20,25-29,1873,51.93130887083577
STAT,1788,71,na,1859,530.4584407163865
STAT,1883,34,30-34,1917,16.032970376191425
SIM,1922,36,25-29,1958,3
STAT,1871,18,na,1889,2370.457605993066
STAT,1964,1,na,1965,4683.866554408173
SIM,1886,51,na,1937,2098
SIM,1912,49,50-100,1961,1
SIM,1892,36,40-44,1928,6
STAT,1848,39,35-39,1887,5.304673532902086
STAT,1816,43,30-34,1859,2.963817284333906
SIM,1832,90,na,1922,45
STAT,1942,25,45-49,1967,1.7144496330105263
SIM,1891,34,30-34,1925,33
STAT,1834,35,50-100,1869,0.9676335354998321
STAT,1853,24,na,1877,1884.528864869306
STAT,1869,43,50-100,1912,0.9598692867329873
STAT,1935,30,25-29,1965,12.093506596943234
STAT,1840,54,30-34,1894,0.0037989825895280633
SIM,1933,19,na,1952,4688
SIM,1864,30,20-24,1894,2
SIM,1887,18,30-34,1905,1
STAT,1908,25,45-49,1933,1.5665264013213924
SIM,1879,69,na,1948,1445
STAT,1920,33,15-19,1953,0.1324097001479086
STAT,1876,26,35-39,1902,9.449718501596584
SIM,1946,22,20-24,1968,133
SIM,1838,28,na,1866,1761
STAT,1917,46,20-24,1963,0.010931812560995574
STAT,1862,72,na,1934,1020.0636218756176
STAT,1849,52,25-29,1901,0.002641902653549618
SIM,1862,46,50-100,1908,2
STAT,1936,15,na,1951,3344.421651497468
STAT,1923,43,40-44,1966,0.2757365082900813
STAT,1884,16,na,1900,2362.989847290901
STAT,1919,30,50-100,1949,0.8494547652614086
STAT,1916,35,45-49,1951,0.6657720341390484
SIM,1927,30,50-100,1957,1
SIM,1910,50,na,1960,3193
SIM,1869,23,35-39,1892,4
STAT,1789,96,na,1885,1.432523732542109
STAT,1808,49,40-44,1857,0.6269294198320872
SIM,1837,34,na,1871,1722
STAT,1853,52,na,1905,1620.8342609414065
STAT,1812,70,na,1882,724.4764421462219
STAT,1894,74,na,1968,1699.8685223756295
STAT,1921,16,50-100,1937,0.40442888595541454
SIM,1874,66,na,1940,1515
SIM,1898,32,20-24,1930,3
STAT,1817,45,40-44,1862,0.39825772345285976
SIM,1819,49,na,1868,1332
SIM,1842,39,40-44,1881,3
STAT,1861,59,na,1920,1526.5661021078822
SIM,1841,28,35-39,1869,12
STAT,1892,27,35-39,1919,11.417097600667658
STAT,1936,28,25-29,1964,59.47716737616624
SIM,1886,20,30-34,1906,23
STAT,1831,47,15-19,1878,2.8496662859154703E-4
STAT,1871,50,45-49,1921,0.01380932811450432
STAT,1925,27,40-44,1952,5.200619695262134
SIM,1830,64,na,1894,1029
STAT,1869,15,40-44,1884,0.17172587198161587
SIM,1897,21,15-19,1918,3
STAT,1838,87,na,1925,118.27899627434073
STAT,1922,46,25-29,1968,0.057711953118882046
STAT,1851,53,25-29,1904,0.0025070124122606014
SIM,1858,33,30-34,1891,18
STAT,1850,87,na,1937,124.19395432355878
STAT,1933,19,40-44,1952,1.7593391706259867
STAT,1889,21,15-19,1910,3.8591187654268793
SIM,1905,24,25-29,1929,67
STAT,1863,45,50-100,1908,0.20563651755998796
STAT,1827,30,25-29,1857,13.40169732865692
SIM,1885,38,na,1923,2228
STAT,1909,36,15-19,1945,0.017254694525517172
STAT,1785,110,na,1895,2.042565323900872E-4
SIM,1912,32,20-24,1944,2
STAT,1832,44,25-29,1876,0.46273976287090157
SIM,1861,20,25-29,1881,56
SIM,1868,97,na,1965,12
SIM,1763,91,na,1854,9
STAT,1846,18,50-100,1864,0.045378330294722345
SIM,1906,35,30-34,1941,1
STAT,1896,48,30-34,1944,0.06727166750641655
SIM,1856,20,20-24,1876,58
STAT,1890,16,na,1906,2924.1529217788384
SIM,1941,19,40-44,1960,1
STAT,1834,39,40-44,1873,3.3097225175589586
STAT,1855,6,na,1861,2108.62045116533
SIM,1865,44,30-34,1909,5
STAT,1834,20,20-24,1854,93.7414561527442
STAT,1918,21,na,1939,3732.0079097960133
STAT,1907,58,na,1965,2933.2536846949047
SIM,1882,25,50-100,1907,1
STAT,1813,55,na,1868,1107.1748628447772
STAT,1812,51,45-49,1863,0.04736668923734537
STAT,1851,26,35-39,1877,8.185588828514703
STAT,1874,15,15-19,1889,5.776257923946509
STAT,1920,33,45-49,1953,1.621394179995052
STAT,1904,32,20-24,1936,2.103178189355203
SIM,1891,38,na,1929,2752
STAT,1884,36,40-44,1920,4.105278342907633
STAT,1912,42,20-24,1954,0.016091416508099435
SIM,1866,31,na,1897,2128
STAT,1848,20,20-24,1868,63.25358542324055
STAT,1913,32,50-100,1945,0.7771327439912766
STAT,1912,24,20-24,1936,104.25591051026916
STAT,1914,36,25-29,1950,0.9331955241067259
SIM,1795,93,na,1888,5
STAT,1857,44,30-34,1901,0.8450108275430803
SIM,1856,39,40-44,1895,5
STAT,1923,44,50-100,1967,0.12928275417300686
SIM,1816,44,na,1860,1399
SIM,1933,27,40-44,1960,8
STAT,1903,36,50-100,1939,0.3579113672866329
SIM,1808,77,na,1885,349
STAT,1844,87,na,1931,122.36172735484874
STAT,1934,33,45-49,1967,2.0283773527136284
STAT,1836,52,na,1888,1410.764210129591
STAT,1897,26,na,1923,3025.438412007688
STAT,1903,21,45-49,1924,0.9401361715266675
STAT,1962,0,na,1962,4793.19854290801
SIM,1920,24,20-24,1944,121
SIM,1882,15,15-19,1897,2
STAT,1912,36,na,1948,3485.7032625705688
SIM,1879,26,25-29,1905,49
SIM,1817,82,na,1899,186
STAT,1840,54,25-29,1894,0.0022605516017339612
SIM,1932,25,30-34,1957,61
SIM,1814,49,na,1863,1239
SIM,1835,70,na,1905,877
STAT,1855,87,na,1942,125.19876511504862
SIM,1854,77,na,1931,650
STAT,1903,15,15-19,1918,8.014001808170596
SIM,1886,45,50-100,1931,5
STAT,1815,59,na,1874,1093.072547208401
STAT,1951,17,35-39,1968,4.720466970170642
SIM,1901,16,35-39,1917,4
STAT,1821,39,30-34,1860,10.054513965709184
SIM,1842,27,40-44,1869,3
SIM,1875,39,50-100,1914,1
STAT,1933,37,40-44,1970,1.9262300729587107
STAT,1834,27,40-44,1861,2.4377188698238794
SIM,1898,20,20-24,1918,85
SIM,1917,17,na,1934,3920
STAT,1860,35,40-44,1895,3.3872648837195123
STAT,1859,31,50-100,1890,0.6917316946596097
STAT,1920,31,na,1951,3929.494023600526
STAT,1897,34,25-29,1931,12.829535938527405
STAT,1900,25,45-49,1925,1.4649287896121848
SIM,1852,30,25-29,1882,15
SIM,1838,27,20-24,1865,10
STAT,1923,23,50-100,1946,0.7210203632970323
STAT,1868,16,35-39,1884,0.5065127081483054
STAT,1830,27,na,1857,1713.8952064366597
SIM,1908,30,35-39,1938,9
STAT,1909,42,45-49,1951,0.14706438568001895
STAT,1941,9,na,1950,3851.275237161932
STAT,1847,52,20-24,1899,5.412503246991091E-4
STAT,1914,45,50-100,1959,0.21291242323813866
STAT,1906,41,15-19,1947,0.0013254385029062518
SIM,1921,32,50-100,1953,3
STAT,1818,40,25-29,1858,1.6178407788237292
SIM,1911,15,15-19,1926,10
SIM,1951,18,20-24,1969,155
STAT,1924,21,na,1945,4082.947879755864
SIM,1827,75,na,1902,552
STAT,1912,27,25-29,1939,61.27800844804243
STAT,1883,16,30-34,1899,1.4798889136960174
STAT,1920,37,30-34,1957,1.8851261027958166
SIM,1930,28,30-34,1958,60
SIM,1929,29,40-44,1958,6
SIM,1908,40,na,1948,3242
STAT,1922,28,30-34,1950,41.737913910433036
SIM,1866,62,na,1928,1614
SIM,1881,79,na,1960,654
STAT,1826,50,30-34,1876,0.005515966816307946
STAT,1774,114,na,1888,2.3618334108405016E-4
STAT,1836,52,45-49,1888,0.009508870706475617
SIM,1904,38,30-34,1942,2
SIM,1906,17,30-34,1923,5
SIM,1786,88,na,1874,56
STAT,1868,54,50-100,1922,0.013238402685006508
STAT,1935,32,45-49,1967,2.0566157545748642
STAT,1895,49,25-29,1944,0.03918060950125447
SIM,1906,23,30-34,1929,31
STAT,1893,41,30-34,1934,1.383566450195541
SIM,1890,28,na,1918,2969
STAT,1828,85,na,1913,154.38709408816155
SIM,1853,36,na,1889,1805
SIM,1841,48,na,1889,1476
STAT,1828,88,na,1916,77.31540527706743
SIM,1877,3,na,1880,2853
SIM,1916,40,40-44,1956,3
STAT,1844,47,na,1891,1555.2829371369608
SIM,1887,20,45-49,1907,2
SIM,1833,33,30-34,1866,15
SIM,1904,50,na,1954,3018
STAT,1764,111,na,1875,7.78918154547763E-4
STAT,1898,64,na,1962,2379.69345072272
STAT,1904,32,15-19,1936,0.11080362731644385
STAT,1899,43,25-29,1942,0.05730395002669285
STAT,1911,25,20-24,1936,16.931688605264544
STAT,1930,40,15-19,1970,0.0019140812523935449
SIM,1898,39,40-44,1937,2
STAT,1872,43,15-19,1915,0.012991350974885244
SIM,1913,19,35-39,1932,2
STAT,1849,31,20-24,1880,2.371626475035233
STAT,1858,36,na,1894,1753.4275594811609
SIM,1917,8,na,1925,4052
STAT,1876,24,na,1900,2293.8484376377346
SIM,1879,28,20-24,1907,12
STAT,1892,24,30-34,1916,20.944447729176677
STAT,1909,53,na,1962,3121.409402291574
SIM,1893,31,25-29,1924,19
SIM,1790,93,na,1883,7
STAT,1841,22,25-29,1863,49.995319756291316
STAT,1857,32,30-34,1889,13.088866255490467
STAT,1848,25,15-19,1873,0.408308561495085
SIM,1865,26,30-34,1891,29
SIM,1908,43,na,1951,3174
STAT,1893,39,50-100,1932,1.4560661353318212
STAT,1861,42,30-34,1903,0.901937813965078
STAT,1885,31,25-29,1916,9.684297601139141
SIM,1857,35,50-100,1892,4
STAT,1832,93,na,1925,17.605418460914347
STAT,1841,67,na,1908,1092.8680756800425
STAT,1845,17,45-49,1862,0.058423212552401294
STAT,1867,72,na,1939,1120.2863560636813
STAT,1825,40,na,1865,1489.8630835626568
STAT,1831,42,15-19,1873,0.010196759643417945
STAT,1873,13,na,1886,2502.046794037968
SIM,1907,33,25-29,1940,14
STAT,1874,54,na,1928,2021.13629930334
STAT,1908,40,40-44,1948,0.2210981958836318
STAT,1924,25,30-34,1949,43.389889532896206
STAT,1860,17,40-44,1877,0.1616920355121621
SIM,1901,34,35-39,1935,6
STAT,1847,109,na,1956,5.991011201018285E-4
STAT,1840,26,na,1866,1782.9135903273816
STAT,1922,46,30-34,1968,0.09698814437065674
SIM,1823,85,na,1908,130
SIM,1929,22,20-24,1951,142
STAT,1825,33,30-34,1858,27.7092176340834
STAT,1899,25,25-29,1924,55.126549190077924
SIM,1857,31,20-24,1888,1
STAT,1925,27,35-39,1952,16.75157298018807
STAT,1903,33,15-19,1936,0.10944816114709964
STAT,1858,46,40-44,1904,0.12716469018856696
SIM,1939,32,25-29,1971,18
STAT,1928,20,na,1948,4332.880157517501
STAT,1935,26,15-19,1961,0.9094898422112281
SIM,1854,74,na,1928,844
STAT,1857,26,30-34,1883,19.464963414244043
STAT,1907,28,35-39,1935,13.342951930953072
STAT,1842,101,na,1943,0.41323549966875744
SIM,1915,28,35-39,1943,16
SIM,1900,51,na,1951,2884
STAT,1932,31,15-19,1963,0.16147276196729674
STAT,1795,96,na,1891,1.7883874607884376
SIM,1837,74,na,1911,661
SIM,1828,69,na,1897,835
SIM,1902,29,30-34,1931,39
SIM,1939,26,25-29,1965,64
STAT,1860,29,40-44,1889,2.28752494705883
SIM,1925,43,na,1968,4198
STAT,1916,33,25-29,1949,8.976556174057439
SIM,1860,39,50-100,1899,1
STAT,1877,50,40-44,1927,0.010464659659814515
SIM,1831,29,50-100,1860,1
STAT,1859,41,25-29,1900,0.48501648637215394
SIM,1842,89,na,1931,56
STAT,1826,32,30-34,1858,23.930751509330257
STAT,1845,20,50-100,1865,0.36343407841100817
SIM,1845,20,45-49,1865,1
SIM,1847,95,na,1942,7
STAT,1827,47,na,1874,1459.2924337449115
STAT,1912,29,20-24,1941,16.872766613603467
STAT,1804,75,na,1879,424.88774049520606
STAT,1813,43,50-100,1856,3.2267525364643084
STAT,1912,45,25-29,1957,0.04838797227067823
SIM,1922,33,20-24,1955,3
STAT,1852,11,na,1863,2102.779960714242
STAT,1875,21,20-24,1896,67.11706506475623
STAT,1843,62,na,1905,1234.534964391667
STAT,1920,19,30-34,1939,12.849407885277776
SIM,1887,64,na,1951,1785
STAT,1930,22,15-19,1952,6.442075453545069
STAT,1771,86,na,1857,47.175729851773006
STAT,1797,91,na,1888,19.136280218546993
STAT,1833,28,40-44,1861,2.40512772947187
STAT,1893,23,30-34,1916,21.27366842282501
STAT,1796,103,na,1899,0.03090870682477888
SIM,1920,29,20-24,1949,21
SIM,1933,10,na,1943,5088
STAT,1906,18,40-44,1924,0.25099767292208214
SIM,1869,20,30-34,1889,24
SIM,1851,31,25-29,1882,7
SIM,1916,22,40-44,1938,3
STAT,1813,47,25-29,1860,0.15747059617913273
SIM,1839,24,30-34,1863,16
SIM,1850,56,na,1906,1509
SIM,1876,61,na,1937,1806
SIM,1865,32,30-34,1897,23
SIM,1903,39,25-29,1942,1
SIM,1902,55,na,1957,2759
SIM,1924,21,25-29,1945,107
STAT,1898,27,30-34,1925,32.19303437307481
STAT,1848,46,na,1894,1676.5086859754506
SIM,1830,37,25-29,1867,1
STAT,1898,15,30-34,1913,2.047101093568716
STAT,1905,43,50-100,1948,0.09945200772858913
STAT,1901,26,40-44,1927,3.9747531336466357
SIM,1860,25,35-39,1885,10
STAT,1925,40,40-44,1965,0.28686210274173257
STAT,1926,20,35-39,1946,10.87073834981174
STAT,1914,33,20-24,1947,2.309743168261803
SIM,1895,68,na,1963,2076
STAT,1852,43,35-39,1895,1.3033316243241022
SIM,1810,56,na,1866,1082
SIM,1834,32,30-34,1866,16
SIM,1878,87,na,1965,312
SIM,1924,33,25-29,1957,11
STAT,1880,38,25-29,1918,2.8532700780861444
SIM,1934,6,na,1940,4989
STAT,1897,16,25-29,1913,7.176828106630277
STAT,1921,47,25-29,1968,0.05649149642923747
SIM,1868,21,25-29,1889,57
SIM,1864,17,20-24,1881,19
STAT,1856,17,20-24,1873,15.451237164698137
STAT,1925,22,40-44,1947,3.8020228252236175
STAT,1817,45,na,1862,1376.2953609816313
STAT,1831,49,35-39,1880,0.097202816712449
STAT,1849,38,40-44,1887,3.324218416992145
SIM,1856,9,na,1865,2282
STAT,1843,31,25-29,1874,8.403978156224467
STAT,1786,100,na,1886,0.20321258181599675
STAT,1820,41,30-34,1861,2.1796690781652956
STAT,1879,60,na,1939,1885.9588569749963
STAT,1905,31,20-24,1936,2.1280400870854037
STAT,1905,19,35-39,1924,0.7452411353152885
SIM,1838,25,25-29,1863,39
SIM,1848,26,30-34,1874,25
STAT,1861,28,na,1889,1874.6452768346387
STAT,1834,26,na,1860,1771.2497263483583
SIM,1857,38,40-44,1895,6
SIM,1907,15,25-29,1922,14
SIM,1841,70,na,1911,930
STAT,1889,26,15-19,1915,0.5309486379856435
SIM,1933,22,40-44,1955,2
SIM,1859,38,45-49,1897,1
SIM,1911,32,na,1943,3458
STAT,1880,57,na,1937,2001.461571400422
STAT,1832,22,na,1854,1639.3581769420682
STAT,1856,15,25-29,1871,4.997513939301039
STAT,1906,17,50-100,1923,0.06740811243826472
SIM,1893,64,na,1957,2192
SIM,1839,42,30-34,1881,2
SIM,1871,38,25-29,1909,3
STAT,1846,11,na,1857,2234.4043396110933
STAT,1852,25,35-39,1877,8.266035321449097
SIM,1920,27,25-29,1947,77
SIM,1903,27,25-29,1930,60
SIM,1822,41,na,1863,1487
SIM,1934,20,35-39,1954,16
SIM,1924,15,25-29,1939,59
STAT,1861,87,na,1948,138.38774049810272
STAT,1878,23,35-39,1901,5.72739782385063
STAT,1942,23,25-29,1965,91.46296832890594
SIM,1886,23,35-39,1909,5
STAT,1898,33,30-34,1931,22.226651090109236
STAT,1931,21,20-24,1952,136.6499973285808
STAT,1884,32,25-29,1916,9.559634806362476
STAT,1916,21,25-29,1937,91.71355979593503
SIM,1913,58,na,1971,3098
SIM,1947,24,30-34,1971,35
SIM,1889,68,na,1957,1807
STAT,1867,51,30-34,1918,0.0053056406193534725
STAT,1817,41,25-29,1858,1.6983002120489044
STAT,1934,30,40-44,1964,5.053215534172904
SIM,1938,16,30-34,1954,12
STAT,1842,15,30-34,1857,1.4998272164550654
SIM,1864,15,25-29,1879,6
STAT,1865,40,na,1905,1999.0056329797324
STAT,1839,32,na,1871,1775.7201128020492
STAT,1867,33,30-34,1900,15.422772232593418
SIM,1826,34,na,1860,1539
STAT,1898,45,30-34,1943,0.070501814756941
STAT,1847,27,20-24,1874,10.397888731462338
STAT,1856,50,50-100,1906,0.011291871460994822
SIM,1828,29,na,1857,1705
SIM,1938,19,na,1957,3282
STAT,1864,39,na,1903,1963.701577667457
STAT,1919,43,15-19,1962,0.0015696697150187349
SIM,1944,19,na,1963,3653
STAT,1837,20,45-49,1857,0.6154886259455763
SIM,1840,29,35-39,1869,8
STAT,1858,34,50-100,1892,0.6728358094221104
SIM,1848,44,30-34,1892,3
SIM,1769,85,na,1854,51
STAT,1886,15,40-44,1901,0.18336888083832897
STAT,1933,32,50-100,1965,1.0525868272979981
SIM,1847,33,na,1880,1880
STAT,1950,15,30-34,1965,13.622614297849998
SIM,1839,36,30-34,1875,4
SIM,1889,27,30-34,1916,29
STAT,1886,79,na,1965,988.012877765986
STAT,1851,23,30-34,1874,15.191524878938587
STAT,1863,14,na,1877,2237.836051106774
STAT,1910,45,20-24,1955,0.009786614858086748
SIM,1933,23,25-29,1956,126
STAT,1832,29,35-39,1861,7.7192549785168145
STAT,1783,71,na,1854,489.0
STAT,1925,23,25-29,1948,104.1249956802351
STAT,1897,18,20-24,1915,22.339231681920282
STAT,1916,15,25-29,1931,8.726061463597041
STAT,1856,33,25-29,1889,7.563086303633005
STAT,1848,25,50-100,1873,0.5756896998863205
STAT,1915,36,45-49,1951,0.6537313934337227
SIM,1875,33,30-34,1908,19
SIM,1942,24,na,1966,3543
SIM,1864,76,na,1940,783
STAT,1868,30,50-100,1898,0.8324890095216443
STAT,1926,39,25-29,1965,1.1343180152746803
SIM,1846,29,50-100,1875,2
STAT,1863,38,25-29,1901,2.37506520293711
SIM,1864,33,25-29,1897,15
STAT,1876,53,30-34,1929,0.005716435635462635
STAT,1832,41,20-24,1873,0.11898020089280519
STAT,1931,33,20-24,1964,3.017416614733017
SIM,1915,25,30-34,1940,38
STAT,1915,18,45-49,1933,0.09851215915400958
STAT,1923,41,15-19,1964,0.0016980576704700512
STAT,1883,7,na,1890,2413.1157227837352
STAT,1916,37,40-44,1953,1.4482167086030162
SIM,1849,43,30-34,1892,8
STAT,1941,26,45-49,1967,1.689078119236893
STAT,1805,54,50-100,1859,0.053259366236558504
STAT,1823,54,25-29,1877,0.004034349756379228
STAT,1830,47,30-34,1877,0.07253410698144824
STAT,1838,47,na,1885,1553.924572814823
SIM,1855,27,20-24,1882,8
SIM,1875,76,na,1951,826
STAT,1924,28,35-39,1952,16.455507449015403
SIM,1835,48,na,1883,1456
STAT,1834,88,na,1922,85.11169611931561
STAT,1842,21,30-34,1863,16.387530540183274
STAT,1915,53,na,1968,3422.8806350069553
SIM,1784,93,na,1877,5
SIM,1919,18,25-29,1937,58
STAT,1853,40,45-49,1893,1.144080355318022
SIM,1831,89,na,1920,41
STAT,1873,42,20-24,1915,0.15197372882141671
SIM,1857,34,25-29,1891,12
SIM,1892,32,25-29,1924,18
STAT,1893,44,35-39,1937,0.14861446877011808
STAT,1799,55,na,1854,1036.9890981700003
STAT,1867,36,35-39,1903,6.304431647408232
STAT,1917,30,35-39,1947,9.112843006003684
SIM,1875,36,35-39,1911,12
SIM,1832,34,na,1866,1602
STAT,1934,17,35-39,1951,5.36179360458405
STAT,1860,3,na,1863,2497.6766606488272
SIM,1911,37,30-34,1948,2
SIM,1932,28,35-39,1960,24
STAT,1926,36,20-24,1962,0.3046166242693357
SIM,1940,20,na,1960,3444
SIM,1858,32,50-100,1890,6
STAT,1892,42,na,1934,2731.4082147618105
SIM,1843,74,na,1917,754
SIM,1942,17,35-39,1959,5
SIM,1924,37,40-44,1961,1
SIM,1793,67,na,1860,715
STAT,1863,53,20-24,1916,6.019256621197757E-4
SIM,1871,21,na,1892,2266
STAT,1852,14,na,1866,2074.269925856495
STAT,1899,40,20-24,1939,0.014419105248504495
STAT,1806,51,20-24,1857,0.0026505448031135226
STAT,1843,47,40-44,1890,0.115097371555285
STAT,1951,15,45-49,1966,0.5622582069654851
SIM,1929,42,na,1971,4522
STAT,1863,54,na,1917,1735.9265627176733
STAT,1876,38,50-100,1914,1.1923393462345224
STAT,1926,40,25-29,1966,0.08339274502240225
STAT,1843,29,40-44,1872,2.454456527163909
STAT,1857,47,35-39,1904,0.10382224727229378
STAT,1846,73,na,1919,880.9606685838789
STAT,1921,29,25-29,1950,68.80433023147303
STAT,1887,44,50-100,1931,1.101267680358612
STAT,1939,18,30-34,1957,11.522314506198448
SIM,1947,18,30-34,1965,11
SIM,1850,21,30-34,1871,22
SIM,1902,31,45-49,1933,2
STAT,1867,13,na,1880,2368.199182188687
STAT,1843,100,na,1943,0.7170846369043987
STAT,1849,34,25-29,1883,7.927090314988322
SIM,1923,17,na,1940,4147
STAT,1862,42,45-49,1904,1.2073757016694588
STAT,1896,17,50-100,1913,0.0611264537602209
SIM,1816,41,na,1857,1445
STAT,1827,49,50-100,1876,0.21876749855411398
STAT,1865,25,15-19,1890,0.39112578523054825
SIM,1938,19,35-39,1957,6
STAT,1879,20,45-49,1899,0.6936769348742192
SIM,1914,43,na,1957,3468
SIM,1851,29,40-44,1880,5
STAT,1821,59,na,1880,1115.4982316127077
STAT,1841,53,30-34,1894,0.004037868353572139
STAT,1857,29,35-39,1886,7.29887185275443
STAT,1911,28,25-29,1939,60.42763897931513
STAT,1913,40,15-19,1953,0.0014308404328045043
STAT,1851,29,na,1880,1795.9457436463035
STAT,1944,6,na,1950,4034.2231121583145
SIM,1812,42,na,1854,1379
STAT,1857,24,50-100,1881,0.31461800068472756
STAT,1917,23,50-100,1940,0.6586162434819931
SIM,1847,17,15-19,1864,3
SIM,1896,13,na,1909,3245
STAT,1852,22,30-34,1874,15.340824449737823
STAT,1932,22,50-100,1954,0.8155921190363665
STAT,1849,87,na,1936,132.11233239130783
STAT,1861,45,35-39,1906,0.1110645359724925
SIM,1901,33,na,1934,3122
STAT,1901,29,45-49,1930,1.4577067705258937
STAT,1848,24,30-34,1872,15.885059270296134
STAT,1799,58,na,1857,977.1715385268573
STAT,1827,50,45-49,1877,0.013334686813196214
STAT,1851,50,20-24,1901,5.384451801753583E-4
STAT,1961,1,na,1962,4804.62265284773
STAT,1871,48,30-34,1919,0.08966442571586643
STAT,1919,49,50-100,1968,0.2303967942922285
STAT,1835,52,30-34,1887,0.0038609889187161462
SIM,1860,22,30-34,1882,22
SIM,1898,35,25-29,1933,7
STAT,1929,17,30-34,1946,14.694603197078614
SIM,1934,3,na,1937,5041
SIM,1908,28,20-24,1936,17
SIM,1937,17,30-34,1954,10
STAT,1868,54,na,1922,1887.371630571667
SIM,1896,5,na,1901,3313
STAT,1847,28,50-100,1875,0.5629050235306723
SIM,1952,16,15-19,1968,51
SIM,1888,16,25-29,1904,7
STAT,1903,37,30-34,1940,1.5462355176260576
STAT,1878,20,30-34,1898,17.64119277625864
STAT,1908,22,40-44,1930,2.9202335525890337
STAT,1826,53,35-39,1879,0.007516379485451824
SIM,1940,22,50-100,1962,1
SIM,1951,20,35-39,1971,13
STAT,1872,47,30-34,1919,0.09129784966890028
STAT,1944,16,15-19,1960,46.151054279395474
STAT,1858,42,25-29,1900,0.47504823490409165
STAT,1913,38,30-34,1951,1.6907828548462926
STAT,1939,3,na,1942,3827.1807253120414
SIM,1865,29,35-39,1894,10
STAT,1907,25,30-34,1932,35.18270172588558
SIM,1811,97,na,1908,2
STAT,1893,26,35-39,1919,11.599352914130932
SIM,1872,62,na,1934,1676
SIM,1887,61,na,1948,1915
STAT,1817,85,na,1902,126.88091102702299
STAT,1922,26,50-100,1948,1.067659276738969
STAT,1858,39,na,1897,1727.4657043835787
STAT,1873,17,20-24,1890,16.985962489450923
SIM,1824,31,30-34,1855,16
SIM,1834,35,35-39,1869,13
SIM,1829,31,45-49,1860,2
SIM,1881,17,20-24,1898,14
STAT,1934,35,35-39,1969,3.158654064178554
STAT,1943,20,35-39,1963,9.470349490671172
SIM,1891,22,30-34,1913,29
STAT,1899,22,20-24,1921,89.20051721603981
STAT,1888,40,45-49,1928,1.6877814553586268
STAT,1837,22,35-39,1859,4.957828572138857
SIM,1845,22,35-39,1867,5
STAT,1902,43,na,1945,3069.722988859248
STAT,1761,104,na,1865,0.03975571464526889
STAT,1883,37,35-39,1920,6.551034413026492
STAT,1814,42,15-19,1856,0.04893414684878878
STAT,1888,22,45-49,1910,0.7785234257252723
SIM,1921,38,30-34,1959,1
STAT,1826,35,35-39,1861,8.229908457553352
SIM,1888,34,25-29,1922,15
SIM,1820,49,na,1869,1394
SIM,1907,30,20-24,1937,2
STAT,1853,55,na,1908,1564.8376219772274
STAT,1912,38,50-100,1950,0.3852147539641023
STAT,1918,44,45-49,1962,0.1666103022998879
SIM,1891,37,35-39,1928,12
STAT,1905,54,na,1959,2931.0598782785937
SIM,1921,22,15-19,1943,5
STAT,1839,17,15-19,1856,5.168761163559939
SIM,1864,100,na,1964,10
STAT,1881,33,15-19,1914,0.12941372852608798
STAT,1883,22,30-34,1905,16.497974743924807
STAT,1866,34,30-34,1900,15.082776155092727
SIM,1829,70,na,1899,835
SIM,1837,31,40-44,1868,5
STAT,1871,80,na,1951,580.288044802366
SIM,1848,36,50-100,1884,1
STAT,1875,24,25-29,1899,55.23834874719756
SIM,1806,82,na,1888,151
SIM,1933,25,45-49,1958,3
SIM,1807,67,na,1874,751
STAT,1884,48,40-44,1932,0.1577768085950333
SIM,1823,82,na,1905,217
STAT,1923,45,30-34,1968,0.09897997292869788
STAT,1945,23,na,1968,3779.715457324589
STAT,1901,36,na,1937,3155.102978231318
STAT,1822,52,20-24,1874,9.549187744400418E-4
SIM,1847,36,na,1883,1825
STAT,1852,40,30-34,1892,0.8419039229606018
SIM,1805,97,na,1902,1
STAT,1832,107,na,1939,0.0028408972118899797
STAT,1870,20,25-29,1890,53.36956113373994
STAT,1914,42,50-100,1956,0.1099736584264018
STAT,1931,36,25-29,1967,1.2329674442519662
STAT,1908,24,50-100,1932,0.5678967894601337
STAT,1920,21,45-49,1941,1.1852542041614849
STAT,1934,20,na,1954,4651.314168651923
STAT,1877,53,45-49,1930,0.013992880482789509
SIM,1938,29,45-49,1967,1
SIM,1865,21,na,1886,2155
STAT,1850,28,40-44,1878,2.4671396293653465
STAT,1820,44,35-39,1864,3.128741309019712
STAT,1875,79,na,1954,678.8414565462989
STAT,1875,46,40-44,1921,0.16670969152573406
STAT,1917,7,na,1924,4050.393088183479
STAT,1908,45,35-39,1953,0.1117736061524159
STAT,1880,54,na,1934,2085.4447755927204
STAT,1844,49,15-19,1893,2.720087956584063E-4
STAT,1918,26,15-19,1944,0.7121826183298687
STAT,1875,39,na,1914,2264.6638329557563
SIM,1847,30,20-24,1877,2
SIM,1883,28,40-44,1911,6
SIM,1907,25,50-100,1932,4
SIM,1839,39,35-39,1878,12
SIM,1863,51,na,1914,1791
SIM,1871,35,20-24,1906,2
STAT,1831,46,30-34,1877,0.06985565373587795
SIM,1870,42,45-49,1912,1
STAT,1939,20,15-19,1959,5.053841434182244
SIM,1881,17,na,1898,1964
STAT,1908,27,35-39,1935,13.521933523787407
SIM,1874,34,30-34,1908,24
STAT,1861,38,50-100,1899,0.95959285019973
STAT,1942,27,40-44,1969,4.621509389091066
STAT,1829,31,40-44,1860,4.448879447168556
STAT,1896,22,40-44,1918,2.599937947934683
SIM,1878,8,na,1886,2693
STAT,1927,38,25-29,1965,1.1552702115882856
SIM,1832,22,25-29,1854,58
STAT,1839,30,20-24,1869,2.261203542533823
STAT,1868,51,45-49,1919,0.013143235897539206
SIM,1916,27,35-39,1943,16
STAT,1820,34,na,1854,1440.2506205711034
STAT,1905,46,25-29,1951,0.04449251169115517
SIM,1881,76,na,1957,772
STAT,1887,64,na,1951,1836.8960410580655
STAT,1900,42,25-29,1942,0.05836698713001873
STAT,1834,45,40-44,1879,0.12703435637816352
STAT,1941,16,35-39,1957,4.08420238919514
STAT,1856,19,40-44,1875,0.15753619438265465
SIM,1920,43,na,1963,3946
SIM,1933,20,20-24,1953,131
STAT,1839,49,40-44,1888,0.11319763326949292
SIM,1911,2,na,1913,3808
STAT,1909,13,na,1922,3653.177494392703
SIM,1868,25,40-44,1893,3
SIM,1863,21,40-44,1884,1
SIM,1852,11,na,1863,2214
STAT,1809,59,na,1868,1024.5489301912799
STAT,1925,43,45-49,1968,0.19004537292845233
SIM,1874,22,25-29,1896,53
STAT,1776,106,na,1882,0.012188635915510206
STAT,1822,34,20-24,1856,5.874372062683192
STAT,1822,63,na,1885,935.6805583611837
SIM,1897,25,50-100,1922,4
STAT,1921,19,15-19,1940,48.60772514455689
SIM,1911,33,45-49,1944,1
SIM,1906,28,50-100,1934,6
SIM,1903,24,20-24,1927,92
SIM,1947,20,15-19,1967,6
STAT,1842,36,35-39,1878,6.07130814981666
STAT,1865,20,20-24,1885,60.591696344813364
SIM,1825,89,na,1914,48
SIM,1850,36,35-39,1886,9
SIM,1902,58,na,1960,2702
STAT,1881,17,50-100,1898,0.04471030697323278
STAT,1938,29,40-44,1967,4.358086112632412
STAT,1821,41,45-49,1862,2.6529237440813604
SIM,1825,39,40-44,1864,3
SIM,1878,28,na,1906,2393
STAT,1847,21,45-49,1868,0.6349300945956778
STAT,1940,20,na,1960,3516.740660373945
STAT,1918,44,15-19,1962,0.0015373500714855595
SIM,1860,77,na,1937,655
STAT,1803,93,na,1896,9.8239055093129
SIM,1812,82,na,1894,175
SIM,1830,34,20-24,1864,2
SIM,1799,55,na,1854,1084
STAT,1875,28,40-44,1903,2.898497747392318
STAT,1811,60,na,1871,1033.0779621423685
STAT,1866,22,25-29,1888,50.28659166945454
STAT,1869,79,na,1948,639.813750121134
STAT,1921,32,20-24,1953,2.5642807397365397
STAT,1827,44,na,1871,1509.4332599911206
SIM,1821,56,na,1877,1126
STAT,1815,50,50-100,1865,0.03396444597786346
STAT,1855,21,40-44,1876,1.7424645999392814
STAT,1925,20,20-24,1945,126.48480617550081
SIM,1839,20,15-19,1859,2
STAT,1925,25,45-49,1950,1.9406826169469698
STAT,1817,39,40-44,1856,12.908235519336742
SIM,1859,21,na,1880,1995
SIM,1934,18,20-24,1952,180
STAT,1950,18,35-39,1968,4.685767212656796
STAT,1903,39,50-100,1942,0.3526120077522001
STAT,1886,18,45-49,1904,0.06501521905921799
SIM,1884,28,na,1912,2322
STAT,1898,67,na,1965,2257.845270373711
STAT,1903,33,45-49,1936,1.3402236489988064
SIM,1873,20,20-24,1893,66
SIM,1957,7,na,1964,4912
STAT,1862,69,na,1931,1185.3619928962792
STAT,1916,2,na,1918,4085.80362012315
SIM,1924,19,40-44,1943,1
STAT,1844,30,25-29,1874,8.685346734140502
STAT,1889,25,50-100,1914,0.7511057692370634
STAT,1916,19,40-44,1935,0.2788421426842421
STAT,1919,47,30-34,1966,0.09134325753319317
STAT,1926,18,20-24,1944,156.6133520144961
SIM,1882,25,25-29,1907,41
SIM,1800,57,na,1857,997
STAT,1842,18,35-39,1860,0.5072639621684152
STAT,1890,45,25-29,1935,0.0671892664482397
SIM,1827,27,45-49,1854,4
STAT,1922,35,na,1957,4051.147273409764
STAT,1867,54,35-39,1921,0.007426897561223398
STAT,1886,33,35-39,1919,10.063257477658075
STAT,1889,43,30-34,1932,1.3311204835928645
STAT,1857,40,15-19,1897,0.01039298673743879
STAT,1872,44,50-100,1916,0.9875572190450922
SIM,1855,7,na,1862,2383
STAT,1849,38,50-100,1887,0.9323318067425603
SIM,1834,94,na,1928,13
STAT,1883,50,50-100,1933,0.014189387213465523
STAT,1884,21,50-100,1905,0.38174829888489165
STAT,1913,29,35-39,1942,14.031792183377414
SIM,1939,18,40-44,1957,3
SIM,1838,84,na,1922,193
SIM,1893,34,50-100,1927,2
STAT,1941,23,40-44,1964,3.281469822357241
SIM,1836,42,45-49,1878,2
SIM,1876,24,na,1900,2317
SIM,1857,16,30-34,1873,4
STAT,1878,46,20-24,1924,0.011847790491340835
STAT,1850,53,40-44,1903,0.007302031206969305
SIM,1940,16,25-29,1956,55
STAT,1852,50,40-44,1902,0.007742082036454949
STAT,1915,26,35-39,1941,14.516514222741746
SIM,1834,29,40-44,1863,1
STAT,1870,24,40-44,1894,1.9191037515238907
STAT,1855,43,15-19,1898,0.00974274184141186
SIM,1797,97,na,1894,1
SIM,1919,15,20-24,1934,25
SIM,1827,42,35-39,1869,1
SIM,1949,21,25-29,1970,101
STAT,1798,70,na,1868,675.7505808687074
SIM,1848,16,20-24,1864,11
STAT,1850,21,20-24,1871,58.72756285847689
STAT,1904,29,25-29,1933,56.91112848441242
SIM,1881,33,25-29,1914,11
SIM,1878,25,na,1903,2414
STAT,1819,42,35-39,1861,3.8142506536149754
SIM,1860,43,35-39,1903,2
STAT,1932,23,30-34,1955,35.514978460793635
SIM,1899,22,30-34,1921,20
STAT,1860,40,20-24,1900,0.12296004256134745
SIM,1865,86,na,1951,174
SIM,1894,33,35-39,1927,15
SIM,1917,18,20-24,1935,1
SIM,1878,32,40-44,1910,6
STAT,1853,27,45-49,1880,0.9734188670902784
SIM,1921,29,35-39,1950,20
STAT,1923,45,na,1968,4079.0710445098925
STAT,1929,39,40-44,1968,1.811661406332071
STAT,1832,33,50-100,1865,0.7152602294497389
STAT,1828,42,45-49,1870,1.2688757935714432
STAT,1874,17,35-39,1891,0.5296269057815153
SIM,1903,65,na,1968,2530
SIM,1872,34,na,1906,2231
SIM,1864,39,na,1903,2031
STAT,1921,37,15-19,1958,0.020256152565805353
SIM,1783,77,na,1860,284
SIM,1778,90,na,1868,20
SIM,1909,44,45-49,1953,1
STAT,1895,33,45-49,1928,2.1386258952352244
SIM,1829,48,na,1877,1365
SIM,1895,39,25-29,1934,4
SIM,1913,0,na,1913,3910
STAT,1929,36,na,1965,4566.901896603702
STAT,1810,44,40-44,1854,7.8642214402478015
STAT,1901,20,35-39,1921,7.7625404776556035
SIM,1872,27,20-24,1899,9
SIM,1873,81,na,1954,421
STAT,1918,0,na,1918,4632.432256577209
SIM,1832,24,15-19,1856,1
STAT,1841,36,na,1877,1757.867721645394
STAT,1821,81,na,1902,288.10099942915724
STAT,1864,27,20-24,1891,9.87755095723881
STAT,1931,40,na,1971,4700.051399895205
SIM,1890,17,30-34,1907,4
STAT,1872,21,40-44,1893,1.9805312619088808
STAT,1899,17,40-44,1916,0.23675020997716673
SIM,1935,34,45-49,1969,3
STAT,1920,3,na,1923,4298.949779138166
SIM,1853,32,35-39,1885,8
STAT,1930,19,25-29,1949,52.642183483931845
SIM,1879,72,na,1951,1207
STAT,1949,16,35-39,1965,4.6117976743420845
SIM,1935,16,15-19,1951,51
STAT,1892,20,15-19,1912,3.926862143577451
SIM,1855,37,30-34,1892,9
SIM,1924,33,na,1957,4160
STAT,1886,40,40-44,1926,2.267224310752584
STAT,1866,49,35-39,1915,0.11943803141615865
SIM,1915,31,25-29,1946,13
STAT,1929,31,45-49,1960,1.889272618472672
STAT,1950,18,50-100,1968,0.41837199504425754
SIM,1861,27,45-49,1888,4
STAT,1839,42,20-24,1881,0.11144262155501393
STAT,1851,48,45-49,1899,0.16763183612368754
STAT,1932,16,25-29,1948,54.34132284338653
STAT,1838,53,25-29,1891,0.0023398088336032486
STAT,1937,31,na,1968,3536.906528958815
STAT,1760,111,na,1871,9.243235702780571E-4
SIM,1899,15,25-29,1914,5
SIM,1915,50,na,1965,3325
STAT,1883,46,30-34,1929,0.08991200823938747
STAT,1915,16,na,1931,3828.2236532848415
SIM,1844,45,50-100,1889,2
SIM,1911,60,na,1971,3014
STAT,1869,43,45-49,1912,1.359814826768456
SIM,1857,57,na,1914,1551
STAT,1875,54,25-29,1929,0.0033447667240750273
SIM,1894,40,40-44,1934,5
STAT,1833,31,30-34,1864,13.936446363480211
STAT,1849,16,30-34,1865,1.4799026386419436
STAT,1813,100,na,1913,0.43691647109668613
STAT,1848,27,35-39,1875,8.55928320161596
STAT,1843,53,35-39,1896,0.005721595179499556
SIM,1830,39,na,1869,1608
SIM,1889,17,20-24,1906,20
STAT,1927,16,15-19,1943,53.43778391616838
SIM,1785,78,na,1863,281
STAT,1864,40,20-24,1904,0.13506533516411473
SIM,1937,31,45-49,1968,1
STAT,1909,16,na,1925,3587.0178478285197
SIM,1929,37,25-29,1966,1
STAT,1913,21,na,1934,3504.0426448599233
SIM,1841,31,30-34,1872,18
STAT,1843,37,na,1880,1688.8655350049974
STAT,1927,35,50-100,1962,0.4939807952986917
STAT,1949,23,40-44,1972,3.705368503580246
SIM,1923,26,35-39,1949,20
SIM,1940,23,30-34,1963,39
STAT,1766,100,na,1866,0.17430624689890328
STAT,1868,35,40-44,1903,3.9830997450622436
STAT,1923,11,na,1934,4401.843597130206
STAT,1940,18,40-44,1958,1.3411935692643062
SIM,1910,13,na,1923,3705
STAT,1852,73,na,1925,861.1043559257209
SIM,1849,21,20-24,1870,66
SIM,1876,35,40-44,1911,8
STAT,1822,69,na,1891,745.7139491686274
SIM,1877,71,na,1948,1252
STAT,1831,27,25-29,1858,36.38599836042104
STAT,1852,19,40-44,1871,0.15849365887806807
STAT,1935,30,na,1965,4948.62205882483
SIM,1840,16,20-24,1856,19
STAT,1845,32,35-39,1877,8.52064779568219
SIM,1865,52,na,1917,1887
STAT,1847,37,30-34,1884,4.077621702735438
STAT,1812,79,na,1891,303.68255934734856
STAT,1898,27,50-100,1925,0.8177952920966947
STAT,1809,81,na,1890,217.00453734986502
SIM,1932,21,15-19,1953,6
STAT,1881,51,45-49,1932,0.013307491487276139
STAT,1878,19,50-100,1897,0.04797484736817233
STAT,1878,1,na,1879,3381.021082774745
STAT,1879,38,20-24,1917,0.7584909340284739
STAT,1889,18,25-29,1907,6.591534425537471
STAT,1890,49,40-44,1939,0.10920747786157889
SIM,1931,18,40-44,1949,6
STAT,1847,21,na,1868,1946.822994946063
SIM,1853,47,50-100,1900,2
STAT,1923,18,40-44,1941,1.5475071267690885
STAT,1830,64,na,1894,1049.1789445736945
STAT,1870,46,20-24,1916,0.011152710819012479
SIM,1922,20,45-49,1942,1
STAT,1792,85,na,1877,86.47289668101939
STAT,1864,51,45-49,1915,0.012277506596780592
STAT,1905,26,na,1931,3269.9673942532118
STAT,1861,56,na,1917,1602.1062962225492
SIM,1880,28,25-29,1908,53
STAT,1827,78,na,1905,451.32255687302273
STAT,1882,5,na,1887,2445.5287877143132
STAT,1892,48,na,1940,2629.1638514729866
SIM,1905,33,20-24,1938,4
STAT,1854,38,15-19,1892,0.03997846630772046
STAT,1942,18,na,1960,3632.670876091799
STAT,1956,16,50-100,1972,0.4684019191161316
STAT,1776,103,na,1879,0.04952658585523724
SIM,1930,24,15-19,1954,5
STAT,1823,32,15-19,1855,0.37328194405791726
SIM,1882,22,20-24,1904,64
SIM,1905,60,na,1965,2733
STAT,1889,22,na,1911,2758.249439234596
SIM,1888,49,na,1937,2489
SIM,1880,69,na,1949,1403
STAT,1839,35,15-19,1874,0.04561622283558889
STAT,1894,41,45-49,1935,1.825216679755118
STAT,1879,51,20-24,1930,7.332000797857636E-4
STAT,1910,44,45-49,1954,0.14677009592727636
STAT,1885,32,na,1917,2247.0544586408428
STAT,1909,20,35-39,1929,8.316923867153182
STAT,1818,44,40-44,1862,4.9583625252300285
STAT,1878,84,na,1962,513.9940962815576
STAT,1950,21,25-29,1971,103.55557646749456
STAT,1919,46,na,1965,3773.7126041953356
SIM,1908,38,50-100,1946,3
STAT,1963,2,na,1965,4721.767745464682
SIM,1874,69,na,1943,1404
SIM,1835,34,40-44,1869,5
SIM,1901,70,na,1971,2216
SIM,1823,51,na,1874,1249
STAT,1867,36,50-100,1903,1.0943455780326632
STAT,1848,42,30-34,1890,0.8532184600720347
STAT,1927,34,45-49,1961,1.8262369754088998
STAT,1872,28,25-29,1900,39.94276914803746
SIM,1859,52,na,1911,1714
STAT,1890,23,15-19,1913,3.798486278382109
STAT,1915,31,15-19,1946,0.12414640386067648
STAT,1840,32,15-19,1872,0.11382891277431154
STAT,1858,21,20-24,1879,58.98726313974225
STAT,1818,47,50-100,1865,0.5236535509800191
SIM,1779,78,na,1857,260
SIM,1858,24,35-39,1882,9
STAT,1851,51,35-39,1902,0.006222496626794074
SIM,1813,92,na,1905,19
SIM,1877,40,40-44,1917,4
SIM,1873,1,na,1874,3172
SIM,1897,18,25-29,1915,9
STAT,1929,30,na,1959,4543.324897882679
SIM,1896,28,20-24,1924,13
STAT,1907,31,25-29,1938,8.19500163511743
SIM,1868,43,35-39,1911,1
STAT,1837,45,20-24,1882,0.008294311035487929
STAT,1881,70,na,1951,1280.4546400500697
SIM,1866,21,20-24,1887,58
STAT,1815,81,na,1896,241.37525363721855
SIM,1886,54,na,1940,2032
SIM,1840,94,na,1934,15
STAT,1820,48,15-19,1868,6.610995552075548E-4
SIM,1932,31,25-29,1963,12
SIM,1800,94,na,1894,4
STAT,1901,29,50-100,1930,0.8398462611835823
STAT,1839,45,25-29,1884,0.04008780755795421
STAT,1914,28,40-44,1942,4.42341658814814
STAT,1811,52,45-49,1863,0.04620201425846386
STAT,1921,37,50-100,1958,0.44287309784983175
SIM,1799,92,na,1891,8
SIM,1856,17,25-29,1873,9
SIM,1875,2,na,1877,3027
STAT,1823,103,na,1926,0.07680653340369355
SIM,1862,32,45-49,1894,2
SIM,1877,19,20-24,1896,20
STAT,1888,28,20-24,1916,13.05145446161097
STAT,1809,87,na,1896,70.69996106468473
STAT,1824,31,20-24,1855,7.7049673995838655
SIM,1917,20,35-39,1937,9
STAT,1835,36,na,1871,1702.8490384977226
STAT,1890,41,45-49,1931,1.736389607664133
STAT,1812,49,50-100,1861,0.7954591747003661
STAT,1840,88,na,1928,90.09340730111265
STAT,1870,39,15-19,1909,0.05151809554448271
STAT,1890,30,20-24,1920,3.147035050997258
STAT,1911,26,na,1937,3463.2238569202095
STAT,1827,34,40-44,1861,4.795700258290242
STAT,1891,15,15-19,1906,6.968418151775231
STAT,1879,44,15-19,1923,0.013471837663261477
SIM,1811,66,na,1877,728
STAT,1869,19,20-24,1888,16.25643432934432
SIM,1846,37,20-24,1883,4
STAT,1853,21,na,1874,1925.711579935031
SIM,1898,17,30-34,1915,3
STAT,1903,39,20-24,1942,0.22139049148117296
SIM,1791,72,na,1863,477
SIM,1905,28,40-44,1933,6
STAT,1824,64,na,1888,973.6991096490308
STAT,1803,96,na,1899,2.8863430592281603
STAT,1863,35,20-24,1898,0.6451161646946918
STAT,1928,15,20-24,1943,162.12678906819474
STAT,1863,28,15-19,1891,0.3748032831566042
STAT,1863,19,50-100,1882,0.04167920273718971
STAT,1894,25,40-44,1919,3.661435741993139
SIM,1912,48,na,1960,3288
SIM,1916,9,na,1925,3904
SIM,1877,33,35-39,1910,12
STAT,1925,46,na,1971,4215.885074720589
SIM,1922,28,40-44,1950,6
STAT,1891,22,20-24,1913,80.54362985218745
STAT,1924,31,25-29,1955,10.192467358016268
STAT,1889,49,50-100,1938,0.15819811928355626
SIM,1859,45,50-100,1904,1
STAT,1848,17,25-29,1865,5.219796181917581
STAT,1845,42,45-49,1887,1.078466282246544
STAT,1840,50,45-49,1890,0.00966074503493292
STAT,1854,32,45-49,1886,1.2776982766243286
SIM,1776,95,na,1871,2
SIM,1920,20,40-44,1940,3
SIM,1785,72,na,1857,484
SIM,1912,29,25-29,1941,63
STAT,1838,37,20-24,1875,0.624470010352387
STAT,1933,21,25-29,1954,116.09642264693277
STAT,1916,29,50-100,1945,0.9652901415907227
SIM,1901,44,45-49,1945,1
SIM,1854,43,na,1897,1834
STAT,1858,16,40-44,1874,0.1591879720329328
STAT,1830,29,30-34,1859,22.695697114950917
STAT,1834,53,25-29,1887,0.0022096971418320344
STAT,1839,52,30-34,1891,0.003942098849080694
STAT,1902,47,20-24,1949,0.008982569720154664
SIM,1852,34,40-44,1886,7
STAT,1896,44,15-19,1940,0.00118035837550626
STAT,1923,23,20-24,1946,121.84521827994277
STAT,1900,15,35-39,1915,0.7224267618272192
SIM,1931,23,20-24,1954,129
STAT,1884,51,30-34,1935,0.005582219371414417
STAT,1844,34,40-44,1878,3.52776315110245
STAT,1810,44,na,1854,1260.5026187192236
STAT,1936,18,na,1954,3320.23298012154
SIM,1871,86,na,1957,248
STAT,1892,49,45-49,1941,0.15422973684694233
SIM,1899,25,35-39,1924,19
SIM,1941,21,25-29,1962,110
SIM,1892,54,na,1946,2761
SIM,1832,31,20-24,1863,2
STAT,1912,20,40-44,1932,3.062400857861486
STAT,1869,33,35-39,1902,9.229072232441082
STAT,1914,20,45-49,1934,1.0483305535950032
SIM,1884,36,45-49,1920,2
SIM,1819,42,45-49,1861,3
STAT,1883,30,15-19,1913,0.13296012126104206
STAT,1859,18,na,1877,1991.6327881777452
SIM,1909,41,40-44,1950,1
STAT,1915,23,30-34,1938,27.980231520913417
SIM,1874,16,30-34,1890,1
STAT,1878,49,25-29,1927,0.055524358226981645
SIM,1853,42,45-49,1895,1
STAT,1938,13,na,1951,3686.7214830072526
SIM,1900,36,40-44,1936,3
STAT,1836,110,na,1946,1.7894730691175737E-4
STAT,1878,33,45-49,1911,1.709583853127428
STAT,1941,30,na,1971,3755.483162322599
SIM,1921,26,30-34,1947,47
SIM,1883,71,na,1954,1195
STAT,1843,16,50-100,1859,0.04253909107548602
STAT,1892,30,25-29,1922,12.21698356170208
STAT,1884,44,25-29,1928,0.5912485185263872
STAT,1898,33,na,1931,3037.832853847248
STAT,1857,17,35-39,1874,0.48050649260995076
STAT,1836,42,35-39,1878,1.394993967740734
STAT,1897,57,na,1954,2538.9323968330445
STAT,1920,42,50-100,1962,0.12257208033341706
STAT,1939,19,45-49,1958,0.47206062927608994
SIM,1841,42,na,1883,1584
STAT,1831,24,20-24,1855,69.97538540501778
STAT,1866,16,30-34,1882,1.433907814768512
STAT,1836,89,na,1925,68.029148716596
STAT,1913,26,30-34,1939,37.01054762047274
SIM,1845,32,na,1877,1792
SIM,1900,23,na,1923,3115
SIM,1939,29,50-100,1968,4
STAT,1823,50,45-49,1873,0.017899259007937648
STAT,1849,26,40-44,1875,2.682008065871437
STAT,1858,19,45-49,1877,0.05585414917992755
STAT,1897,36,15-19,1933,0.07128614458432941
STAT,1900,22,40-44,1922,2.7308407952592635
SIM,1810,50,na,1860,1220
SIM,1870,30,45-49,1900,2
SIM,1863,57,na,1920,1672
STAT,1864,43,25-29,1907,0.5367723643868746
STAT,1876,36,45-49,1912,1.9550171234745297
STAT,1894,43,na,1937,2795.3102882410276
SIM,1912,19,15-19,1931,6
STAT,1929,29,30-34,1958,46.27848215390606
SIM,1881,30,20-24,1911,2
STAT,1836,27,45-49,1863,0.9303623557576374
STAT,1852,53,45-49,1905,0.010352369990596137
SIM,1867,16,na,1883,2478
STAT,1921,16,na,1937,3973.261328112999
STAT,1940,23,20-24,1963,106.97309444553241
STAT,1938,18,50-100,1956,0.3490302872309984
STAT,1852,36,50-100,1888,0.9042674250788111
STAT,1932,26,35-39,1958,18.585261985673604
SIM,1828,60,na,1888,1142
SIM,1807,92,na,1899,15
SIM,1871,45,50-100,1916,1
STAT,1766,99,na,1865,0.28473038468898576
SIM,1844,42,35-39,1886,2
STAT,1818,95,na,1913,6.529421791499125
STAT,1811,91,na,1902,25.13154455763307
SIM,1848,39,50-100,1887,1
SIM,1940,26,35-39,1966,15
STAT,1791,66,na,1857,721.5949092479282
STAT,1904,19,15-19,1923,7.998525279289578
SIM,1937,29,30-34,1966,43
STAT,1817,103,na,1920,0.06642477033283341
STAT,1873,30,20-24,1903,2.610657198118407
STAT,1817,53,25-29,1870,0.00749989675538718
STAT,1860,50,30-34,1910,0.004628254507621525
STAT,1886,43,45-49,1929,1.4827239812477384
SIM,1882,24,na,1906,2187
SIM,1916,15,35-39,1931,2
STAT,1872,99,na,1971,13.294421560931285
STAT,1853,92,na,1945,31.520115148523686
STAT,1883,49,35-39,1932,0.12696246366020014
STAT,1887,32,40-44,1919,4.582540234109327
STAT,1822,37,25-29,1859,5.067922492064825
STAT,1862,17,45-49,1879,0.06042858056545841
STAT,1920,39,20-24,1959,0.2720766743177608
SIM,1895,36,20-24,1931,4
STAT,1844,19,na,1863,2002.7487630553762
STAT,1866,40,25-29,1906,0.5651709239758045
STAT,1859,46,na,1905,1696.4368161690013
SIM,1836,32,35-39,1868,8
STAT,1809,45,45-49,1854,0.689882405707994
STAT,1810,47,45-49,1857,0.7875588407863584
STAT,1802,52,35-39,1854,0.025205264108460527
SIM,1865,17,35-39,1882,1
SIM,1878,39,25-29,1917,2
SIM,1838,59,na,1897,1292
STAT,1858,54,25-29,1912,0.0025513587142255135
STAT,1923,33,30-34,1956,17.052035931408454
STAT,1895,23,35-39,1918,7.164761924952412
STAT,1862,32,35-39,1894,8.1798189156512
SIM,1904,13,na,1917,3558
STAT,1831,77,na,1908,504.7061301728131
STAT,1829,53,50-100,1882,0.0106379963474351
SIM,1907,27,na,1934,3317
STAT,1843,50,30-34,1893,0.0040784080472914324
STAT,1861,50,na,1911,1715.5900234351109
SIM,1868,40,30-34,1908,7
STAT,1912,35,50-100,1947,0.39081161074961795
STAT,1857,21,50-100,1878,0.353289414177651
STAT,1887,36,20-24,1923,0.8184643604447385
STAT,1906,36,35-39,1942,2.1106030123178496
STAT,1908,15,35-39,1923,0.772529424944307
SIM,1894,43,45-49,1937,1
SIM,1898,23,25-29,1921,83
SIM,1923,23,30-34,1946,43
SIM,1895,32,40-44,1927,10
SIM,1899,2,na,1901,3518
SIM,1817,51,na,1868,1308
STAT,1870,27,45-49,1897,1.02898594883444
SIM,1863,26,na,1889,1974
SIM,1860,15,na,1875,2249
STAT,1873,27,30-34,1900,24.12714255045102
SIM,1881,27,30-34,1908,24
SIM,1915,22,na,1937,3412
STAT,1850,24,25-29,1874,47.74168720331319
STAT,1923,48,35-39,1971,0.1420861505252226
SIM,1935,31,40-44,1966,7
STAT,1903,49,30-34,1952,0.0718626632026354
STAT,1933,31,35-39,1964,11.640768582000177
SIM,1908,20,25-29,1928,85
STAT,1837,38,15-19,1875,0.04391367343803314
STAT,1885,60,na,1945,1795.8834768575996
STAT,1838,50,20-24,1888,5.126877203262823E-4
SIM,1807,98,na,1905,1
STAT,1819,52,45-49,1871,0.026393608393018436
STAT,1903,45,15-19,1948,3.063088925284215E-4
SIM,1844,84,na,1928,190
STAT,1924,21,15-19,1945,5.951666940174724
SIM,1828,41,40-44,1869,5
STAT,1847,92,na,1939,30.712579370685035
STAT,1914,18,30-34,1932,2.375718581028485
SIM,1887,40,35-39,1927,3
SIM,1875,21,30-34,1896,27
SIM,1852,37,45-49,1889,1
STAT,1856,35,15-19,1891,0.04178336929276289
STAT,1901,41,30-34,1942,0.10604726214417079
SIM,1854,31,40-44,1885,7
STAT,1867,75,na,1942,913.2132167578237
STAT,1845,63,na,1908,1262.625145107266
SIM,1885,41,45-49,1926,2
SIM,1877,9,na,1886,2572
STAT,1835,35,45-49,1870,1.6015063614612315
STAT,1858,24,25-29,1882,43.63705384790814
STAT,1830,31,45-49,1861,1.5206160303521943
SIM,1847,67,na,1914,1167
STAT,1888,38,30-34,1926,5.920684627075171
STAT,1950,13,na,1963,4387.156723173887
SIM,1924,30,20-24,1954,1
STAT,1877,28,45-49,1905,1.0841946557789968
SIM,1885,28,45-49,1913,3
SIM,1910,43,40-44,1953,2
SIM,1837,38,25-29,1875,2
STAT,1898,18,35-39,1916,0.6996426482128209
STAT,1927,31,40-44,1958,4.550177602611471
SIM,1862,22,35-39,1884,5
STAT,1850,19,na,1869,1954.0817235260386
SIM,1813,61,na,1874,974
SIM,1896,38,30-34,1934,5
SIM,1832,34,25-29,1866,13
STAT,1912,47,15-19,1959,3.3445317894329607E-4
STAT,1849,22,na,1871,1938.4543113850475
STAT,1882,23,25-29,1905,52.429912311038535
SIM,1890,53,na,1943,2657
SIM,1931,33,30-34,1964,31
STAT,1867,21,30-34,1888,15.98072003326936
SIM,1914,2,na,1916,3978
STAT,1905,34,25-29,1939,7.962130052783464
SIM,1886,42,50-100,1928,1
STAT,1879,40,35-39,1919,1.8087336669510983
SIM,1922,18,30-34,1940,14
SIM,1948,16,25-29,1964,49
SIM,1815,41,30-34,1856,3
SIM,1854,15,na,1869,2209
STAT,1842,48,35-39,1890,0.10011160818380263
STAT,1899,15,15-19,1914,7.717388755097301
STAT,1910,48,25-29,1958,0.046625709509691776
STAT,1844,37,45-49,1881,1.4630609544568383
STAT,1824,34,25-29,1858,19.269197951914055
STAT,1854,22,35-39,1876,4.905711604822609
SIM,1923,33,40-44,1956,10
STAT,1854,46,50-100,1900,0.17622203201601325
SIM,1913,34,25-29,1947,9
STAT,1849,22,25-29,1871,51.899612260914225
STAT,1878,42,50-100,1920,1.038818114257703
STAT,1874,32,30-34,1906,16.85252782262616
STAT,1925,45,35-39,1970,0.14828197308617064
STAT,1818,47,45-49,1865,0.5031850090971004
SIM,1901,41,40-44,1942,2
STAT,1907,47,40-44,1954,0.13338954711616072
SIM,1822,75,na,1897,544
STAT,1837,37,na,1874,1692.3331170258452
STAT,1891,25,25-29,1916,49.77653170149594
STAT,1839,63,na,1902,1187.9866289333656
STAT,1874,23,na,1897,2275.746408334912
SIM,1844,100,na,1944,1
SIM,1849,30,50-100,1879,6
STAT,1816,69,na,1885,784.2898338640382
STAT,1916,30,20-24,1946,2.398106171435629
SIM,1850,84,na,1934,197
SIM,1801,76,na,1877,363
SIM,1839,27,35-39,1866,12
STAT,1841,46,25-29,1887,0.04040449744933658
STAT,1879,54,25-29,1933,0.003406282367257929
STAT,1870,49,25-29,1919,0.05226688564161988
STAT,1918,6,na,1924,4121.315189688963
STAT,1932,28,na,1960,4633.042259029415
STAT,1840,17,25-29,1857,4.8148773331523484
STAT,1882,58,na,1940,1816.8491889805834
STAT,1888,74,na,1962,1453.8791536136985
SIM,1869,42,na,1911,2127
SIM,1919,12,na,1931,4207
STAT,1851,45,40-44,1896,0.12437928232669436
STAT,1823,31,50-100,1854,2.776953396066641
STAT,1865,29,50-100,1894,0.5438321078090419
SIM,1882,32,30-34,1914,23
STAT,1910,34,35-39,1944,8.253008821045528
STAT,1909,18,20-24,1927,25.051630868879062
STAT,1931,24,25-29,1955,112.46499234519496
STAT,1878,39,15-19,1917,0.05472890066183539
STAT,1885,38,45-49,1923,1.8678432557782303
STAT,1915,33,40-44,1948,3.749332855259657
STAT,1865,35,25-29,1900,2.4887729827942717
SIM,1857,22,25-29,1879,58
STAT,1939,32,15-19,1971,0.12386494701724277
STAT,1832,26,30-34,1858,20.921121191242566
STAT,1873,75,na,1948,986.3425131587275
STAT,1823,42,25-29,1865,0.8566157948486303
STAT,1944,13,na,1957,3992.8022119773755
STAT,1928,37,30-34,1965,2.175907198724676
STAT,1910,30,50-100,1940,0.759192270988755
SIM,1895,65,na,1960,2222
STAT,1839,19,40-44,1858,0.15743035229574323
SIM,1914,26,25-29,1940,61
SIM,1815,40,50-100,1855,1
SIM,1836,18,20-24,1854,14
STAT,1889,28,na,1917,2773.4971389325424
SIM,1843,32,50-100,1875,6
SIM,1873,35,25-29,1908,2
STAT,1876,89,na,1965,243.02309802105498
STAT,1771,83,na,1854,89.0
SIM,1916,38,na,1954,3526
SIM,1844,27,45-49,1871,4
STAT,1866,46,30-34,1912,0.08458337177141821
STAT,1826,29,40-44,1855,5.965272624024432
SIM,1853,67,na,1920,1223
STAT,1912,23,45-49,1935,1.0155695411744854
SIM,1866,24,25-29,1890,53
SIM,1795,62,na,1857,896
STAT,1907,41,35-39,1948,0.17529165041237613
SIM,1840,26,30-34,1866,23
SIM,1816,75,na,1891,415
STAT,1828,54,na,1882,1248.9330734195335
STAT,1847,47,40-44,1894,0.12565556309410092
STAT,1890,33,25-29,1923,11.779935873353343
SIM,1814,46,na,1860,1298
STAT,1892,46,40-44,1938,0.11459216112146124
SIM,1808,46,na,1854,1338
SIM,1870,39,na,1909,2140
STAT,1834,54,na,1888,1315.5677036061154
SIM,1830,33,na,1863,1691
SIM,1900,20,25-29,1920,91
STAT,1898,41,15-19,1939,0.0012315298213886048
STAT,1871,32,45-49,1903,1.635831294234912
SIM,1843,35,45-49,1878,2
STAT,1837,48,25-29,1885,0.038311517594802
STAT,1846,31,40-44,1877,3.840846684150717
STAT,1882,47,25-29,1929,0.05267129802623785
SIM,1874,97,na,1971,27
SIM,1920,23,45-49,1943,1
SIM,1851,32,na,1883,1829
STAT,1829,38,25-29,1867,2.5637126655463787
STAT,1942,20,20-24,1962,110.21586535898425
SIM,1890,23,25-29,1913,60
STAT,1902,43,40-44,1945,0.2067388870113363
STAT,1844,19,15-19,1863,5.177831836023037
STAT,1894,33,50-100,1927,1.1076732324682825
STAT,1943,7,na,1950,3969.940307919993
SIM,1849,31,30-34,1880,19
SIM,1834,60,na,1894,1154
STAT,1835,32,50-100,1867,0.742434097577841
SIM,1894,30,30-34,1924,26
SIM,1777,77,na,1854,296
STAT,1886,30,30-34,1916,17.563283828759033
SIM,1823,32,25-29,1855,9
STAT,1865,54,30-34,1919,0.004956803589093142
STAT,1896,29,25-29,1925,52.40164648362333
STAT,1921,44,20-24,1965,0.018728581123634777
STAT,1862,104,na,1966,0.33730536629424984
STAT,1928,18,25-29,1946,51.44722504584418
SIM,1828,54,50-100,1882,2
STAT,1845,44,50-100,1889,0.7420117385483552
SIM,1880,25,20-24,1905,11
SIM,1950,20,20-24,1970,123
STAT,1906,26,25-29,1932,58.40242231039847
STAT,1865,32,20-24,1897,2.3145377844669044
STAT,1874,28,50-100,1902,0.6152726533252002
SIM,1856,78,na,1934,548
STAT,1860,41,35-39,1901,1.3942866825677924
SIM,1886,30,40-44,1916,3
STAT,1816,110,na,1926,1.2877401485205856E-4
STAT,1872,25,20-24,1897,11.191874126970946
STAT,1836,80,na,1916,400.5822776582321
STAT,1823,36,30-34,1859,9.158289739959528
STAT,1914,37,na,1951,3548.674163273573
SIM,1831,29,25-29,1860,43
STAT,1888,34,15-19,1922,0.15762957770677027
STAT,1920,49,30-34,1969,0.09254619650966683
STAT,1836,40,45-49,1876,1.1828891765079073
STAT,1836,24,40-44,1860,1.7554132967300322
STAT,1832,36,40-44,1868,3.3820711451957863
SIM,1936,18,25-29,1954,35
SIM,1913,27,na,1940,3386
SIM,1838,53,na,1891,1391
SIM,1873,42,30-34,1915,1
STAT,1919,18,15-19,1937,47.2544352382272
SIM,1914,8,na,1922,3910
STAT,1884,41,20-24,1925,0.14889416881874026
SIM,1818,39,na,1857,1462
STAT,1819,49,na,1868,1387.026229687649
STAT,1919,8,na,1927,4163.760536486021
STAT,1882,89,na,1971,294.1952458204365
STAT,1905,38,40-44,1943,1.2837819676377173
SIM,1862,72,na,1934,1066
SIM,1877,30,30-34,1907,20
SIM,1829,76,na,1905,539
STAT,1863,82,na,1945,386.80490307069147
STAT,1934,15,45-49,1949,0.6412743192390021
STAT,1874,54,40-44,1928,0.00988209818778272
SIM,1904,26,30-34,1930,34
STAT,1878,42,40-44,1920,2.2117320385362964
STAT,1865,42,30-34,1907,0.9832100411684709
SIM,1939,32,na,1971,3571
STAT,1896,72,na,1968,1909.618229935783
STAT,1832,90,na,1922,47.493669015067816
STAT,1862,38,na,1900,1893.5277125285738
STAT,1880,53,20-24,1933,7.231197184964283E-4
SIM,1927,18,15-19,1945,39
SIM,1794,83,na,1877,102
STAT,1875,19,45-49,1894,0.06308895342370771
SIM,1868,29,20-24,1897,10
STAT,1810,52,25-29,1862,0.011298067591994834
STAT,1874,47,35-39,1921,0.13450128749663245
SIM,1844,40,45-49,1884,3
SIM,1831,36,30-34,1867,10
STAT,1852,42,na,1894,1673.5541082040477
STAT,1929,19,50-100,1948,0.44925602707944573
SIM,1940,29,na,1969,3501
STAT,1825,43,na,1868,1433.966230060597
STAT,1888,43,na,1931,2561.7394220107867
STAT,1911,37,20-24,1948,0.24053962914161245
STAT,1924,41,35-39,1965,0.22659300594918108
STAT,1846,28,15-19,1874,0.40417446300900545
STAT,1940,26,25-29,1966,63.435034883856204
STAT,1947,24,20-24,1971,118.64330029519282
STAT,1919,25,20-24,1944,18.75881757529184
SIM,1921,22,na,1943,3913
STAT,1869,70,na,1939,1284.0787095564522
STAT,1900,37,45-49,1937,0.5638793967636845
STAT,1881,27,20-24,1908,10.706198709195512
SIM,1849,90,na,1939,33
SIM,1831,80,na,1911,319
STAT,1832,48,40-44,1880,0.12077360330435971
SIM,1876,92,na,1968,128
SIM,1949,18,35-39,1967,4
STAT,1915,41,25-29,1956,0.06801620075061493
SIM,1889,44,50-100,1933,1
STAT,1866,19,35-39,1885,0.4849690361153152
STAT,1806,50,45-49,1856,0.05318913630931552
STAT,1813,58,na,1871,1043.3087156398733
SIM,1913,30,45-49,1943,1
STAT,1873,41,45-49,1914,1.440440908514787
STAT,1890,27,30-34,1917,29.0842334035282
STAT,1959,12,na,1971,4853.0230709701755
STAT,1865,47,25-29,1912,0.04909099481317192
SIM,1842,58,na,1900,1310
SIM,1840,36,40-44,1876,2
SIM,1853,9,na,1862,2227
SIM,1884,26,35-39,1910,13
STAT,1883,40,25-29,1923,0.600775917404915
STAT,1759,110,na,1869,8.031279335252122E-4
STAT,1859,23,30-34,1882,13.795803922735992
SIM,1881,41,45-49,1922,5
STAT,1861,25,45-49,1886,0.8912169615686825
STAT,1888,48,40-44,1936,0.10646186551429679
SIM,1829,79,na,1908,393
STAT,1931,28,40-44,1959,5.681976381948577
STAT,1858,51,20-24,1909,5.491783155775591E-4
SIM,1887,30,na,1917,2502
STAT,1847,40,20-24,1887,0.120819513127358
STAT,1907,52,na,1959,3040.0762105289164
STAT,1847,45,15-19,1892,2.9790329945680915E-4
STAT,1860,53,35-39,1913,0.006492974310868933
STAT,1891,44,30-34,1935,1.325573088085181
STAT,1819,41,50-100,1860,2.3080197339744064
SIM,1886,42,40-44,1928,5
SIM,1794,86,na,1880,54
SIM,1845,41,40-44,1886,8
SIM,1927,25,20-24,1952,23
STAT,1910,31,30-34,1941,14.41024379520136
SIM,1849,18,30-34,1867,5
STAT,1824,53,30-34,1877,0.006847985163890871
SIM,1807,61,na,1868,932
STAT,1865,52,50-100,1917,0.012863130087324922
SIM,1848,29,35-39,1877,15
SIM,1918,31,40-44,1949,3
SIM,1850,53,na,1903,1572
STAT,1817,50,20-24,1867,0.0016590347895774557
STAT,1852,45,na,1897,1647.3650491246876
STAT,1836,45,50-100,1881,0.17076268468465944
STAT,1888,41,20-24,1929,0.17810879610010846
SIM,1832,41,30-34,1873,4
SIM,1845,38,na,1883,1699
SIM,1958,6,na,1964,4786
STAT,1878,30,40-44,1908,4.303906274624534
STAT,1897,46,25-29,1943,0.041165350502788016
SIM,1874,3,na,1877,2772
SIM,1900,30,35-39,1930,14
STAT,1891,32,30-34,1923,20.406590094543404
STAT,1847,33,15-19,1880,0.12202432807429409
STAT,1941,6,na,1947,3877.5836924896175
STAT,1890,42,50-100,1932,1.2186635931281518
SIM,1817,48,50-100,1865,3
STAT,1849,56,na,1905,1529.4562854407056
SIM,1887,33,na,1920,2475
SIM,1914,43,40-44,1957,2
STAT,1877,41,45-49,1918,1.4732456308782427
STAT,1824,95,na,1919,7.330985188137334
SIM,1925,12,na,1937,4500
SIM,1913,24,15-19,1937,6
STAT,1923,36,35-39,1959,2.649953623878013
STAT,1942,30,30-34,1972,15.872785414507982
SIM,1875,24,35-39,1899,7
SIM,1849,93,na,1942,14
SIM,1782,98,na,1880,2
STAT,1841,53,50-100,1894,0.010244839515242844
SIM,1834,23,35-39,1857,3
STAT,1870,30,na,1900,2229.3173761064113
SIM,1931,36,35-39,1967,3
STAT,1885,34,50-100,1919,0.8553899839687853
SIM,1867,36,45-49,1903,1
STAT,1840,57,na,1897,1318.8357309254063
STAT,1865,18,na,1883,2215.3848035850456
STAT,1905,24,15-19,1929,4.476597994315773
SIM,1898,27,40-44,1925,1
STAT,1840,26,20-24,1866,9.668769722211707
STAT,1882,20,20-24,1902,63.68871617364218
STAT,1915,48,45-49,1963,0.2063206629437119
SIM,1885,25,40-44,1910,6
STAT,1850,52,50-100,1902,0.01058960567184604
SIM,1872,37,30-34,1909,9
SIM,1914,36,35-39,1950,8
STAT,1827,46,50-100,1873,0.22764565285594196
SIM,1805,66,na,1871,773
STAT,1926,25,na,1951,4271.059902325008
STAT,1937,23,15-19,1960,4.895451011664551
STAT,1863,34,45-49,1897,1.4332815989891896
STAT,1882,25,15-19,1907,0.4196513612736339
STAT,1801,54,40-44,1855,0.028251774585749755
STAT,1856,49,40-44,1905,0.12355301572998885
STAT,1839,23,50-100,1862,0.3463484200402169
SIM,1830,30,40-44,1860,4
SIM,1826,65,na,1891,890
SIM,1880,21,40-44,1901,2
STAT,1850,43,30-34,1893,0.804573670525202
STAT,1837,106,na,1943,0.007879761565332922
STAT,1906,48,35-39,1954,0.10729212248266613
STAT,1856,53,50-100,1909,0.010953166741782467
SIM,1881,37,40-44,1918,3
STAT,1841,41,30-34,1882,0.8342250718335582
STAT,1863,85,na,1948,227.26218305943314
STAT,1903,15,50-100,1918,0.06615850456651368
SIM,1929,34,20-24,1963,2
STAT,1921,19,na,1940,3942.271255950686
STAT,1870,64,na,1934,1611.0432775535628
STAT,1883,52,25-29,1935,0.0032631950493610833
STAT,1815,41,20-24,1856,0.4207522493079684
SIM,1869,11,na,1880,2477
SIM,1859,41,35-39,1900,1
SIM,1944,24,45-49,1968,1
STAT,1873,49,40-44,1922,0.16060439279378755
STAT,1947,24,na,1971,3896.421642034553
STAT,1864,37,30-34,1901,4.4873541064134015
STAT,1896,26,20-24,1922,14.687391853719538
SIM,1838,50,na,1888,1467
STAT,1906,46,45-49,1952,0.18368538266692122
STAT,1929,35,25-29,1964,1.196187345776407
STAT,1836,83,na,1919,257.0755064867608
STAT,1877,25,40-44,1902,2.9553719673198184
STAT,1931,20,45-49,1951,1.3868168575853939
STAT,1811,46,15-19,1857,0.0013544982339633125
STAT,1876,55,na,1931,2018.098363194656
STAT,1828,32,35-39,1860,10.507506710726581
STAT,1819,43,na,1862,1482.3263983550005
STAT,1828,40,50-100,1868,0.9261963365493238
SIM,1840,22,15-19,1862,2
STAT,1905,30,45-49,1935,2.400319687018133
STAT,1855,56,na,1911,1449.4183454990173
STAT,1830,95,na,1925,8.024466522555931
STAT,1914,21,50-100,1935,0.6112625642691978
SIM,1903,20,40-44,1923,4
STAT,1841,31,20-24,1872,2.2846071251127267
STAT,1894,77,na,1971,1491.3237282928735
STAT,1925,42,30-34,1967,0.14621743448696434
STAT,1900,20,15-19,1920,4.3491815148477535
STAT,1832,34,15-19,1866,0.10994666344420546
STAT,1901,64,na,1965,2517.901914203828
STAT,1829,47,20-24,1876,0.009808295958728043
SIM,1945,23,15-19,1968,7
SIM,1857,26,na,1883,1953
STAT,1849,53,na,1902,1588.6675571469225
STAT,1896,38,20-24,1934,0.9570065199287289
SIM,1875,36,50-100,1911,1
SIM,1832,65,na,1897,978
STAT,1879,50,45-49,1929,0.014557166242887377
STAT,1882,39,40-44,1921,3.981202676457107
STAT,1923,20,50-100,1943,0.7275705744820602
SIM,1930,19,35-39,1949,5
SIM,1885,31,35-39,1916,10
STAT,1832,22,15-19,1854,4.756145481955305
STAT,1859,8,na,1867,2143.258174426584
STAT,1850,31,30-34,1881,13.009542321012184
SIM,1940,26,na,1966,3525
STAT,1837,44,45-49,1881,1.016631806984992
STAT,1799,86,na,1885,70.44553865115937
STAT,1829,35,20-24,1864,0.7258805080788655
SIM,1890,32,20-24,1922,3
SIM,1857,26,40-44,1883,2
STAT,1867,18,40-44,1885,0.16489048998662972
SIM,1869,42,40-44,1911,1
STAT,1855,37,20-24,1892,0.5477857842495222
STAT,1932,36,45-49,1968,0.8660806254801756
STAT,1922,19,35-39,1941,4.56307239836935
STAT,1916,40,30-34,1956,0.1241109585937148
SIM,1930,30,45-49,1960,5
SIM,1818,36,na,1854,1500
STAT,1832,40,45-49,1872,1.1358903041750887
STAT,1914,21,20-24,1935,103.29724978801376
STAT,1826,28,na,1854,1418.4579866106426
STAT,1826,90,na,1916,43.0534849975314
SIM,1826,47,50-100,1873,1
STAT,1874,40,15-19,1914,0.01346407088891806
SIM,1913,38,40-44,1951,3
SIM,1839,17,25-29,1856,6
STAT,1832,54,50-100,1886,0.009125681805668407
STAT,1821,50,na,1871,1333.0569136903096
SIM,1922,21,20-24,1943,116
STAT,1882,32,20-24,1914,2.483341596612627
STAT,1845,23,50-100,1868,0.355661781535232
STAT,1862,30,45-49,1892,1.419839369322422
STAT,1876,35,50-100,1911,1.2096630662944028
SIM,1881,48,na,1929,1743
SIM,1904,19,25-29,1923,11
STAT,1936,24,45-49,1960,1.0155065874855984
STAT,1768,94,na,1862,2.711235382123488
SIM,1906,48,na,1954,3040
SIM,1897,49,50-100,1946,5
STAT,1877,31,35-39,1908,9.964418073355207
SIM,1909,22,35-39,1931,8
STAT,1873,37,40-44,1910,4.194148791403498
STAT,1901,42,45-49,1943,0.13726147610552336
SIM,1844,24,40-44,1868,1
STAT,1911,49,20-24,1960,0.009825926800907719
STAT,1945,15,20-24,1960,139.9826719855354
SIM,1928,23,15-19,1951,4
SIM,1898,6,na,1904,3281
SIM,1849,34,35-39,1883,8
SIM,1890,20,20-24,1910,88
SIM,1828,91,na,1919,24
STAT,1841,24,15-19,1865,2.839969420756219
STAT,1877,21,25-29,1898,56.26632004864287
STAT,1815,48,40-44,1863,0.37964551848365136
SIM,1880,18,15-19,1898,5
STAT,1941,31,25-29,1972,9.17265059454106
SIM,1863,20,na,1883,2017
SIM,1890,39,40-44,1929,8
STAT,1831,43,na,1874,1477.1665895197098
STAT,1846,42,na,1888,1735.0082484210468
STAT,1872,18,15-19,1890,5.608711917563476
STAT,1769,113,na,1882,3.716938554753013E-4
STAT,1922,30,45-49,1952,1.6931169902873728
SIM,1850,87,na,1937,115
SIM,1894,18,na,1912,3178
STAT,1846,35,20-24,1881,0.609587824456168
SIM,1840,40,45-49,1880,2
STAT,1884,84,na,1968,597.2928262696322
STAT,1842,51,25-29,1893,0.002577335856446861
STAT,1888,46,15-19,1934,4.4784683094093515E-4
STAT,1886,48,na,1934,2216.929229731554
SIM,1801,73,na,1874,462
SIM,1953,15,20-24,1968,150
SIM,1848,19,25-29,1867,5
STAT,1789,93,na,1882,6.244021855515358
STAT,1863,16,15-19,1879,5.647268563693389
SIM,1935,2,na,1937,5173
SIM,1924,29,50-100,1953,1
SIM,1818,40,35-39,1858,5
STAT,1848,22,50-100,1870,0.36894805265776287
SIM,1889,15,30-34,1904,3
STAT,1818,64,na,1882,937.6136066970386
STAT,1937,27,30-34,1964,36.082604675528465
SIM,1918,33,na,1951,3749
SIM,1827,28,20-24,1855,11
SIM,1840,38,30-34,1878,6
STAT,1852,52,30-34,1904,0.004292542876761473
SIM,1835,79,na,1914,414
SIM,1871,16,15-19,1887,5
SIM,1839,38,na,1877,1706
STAT,1854,22,50-100,1876,0.34281706352224917
STAT,1830,98,na,1928,1.9606434369032713
STAT,1861,15,35-39,1876,0.5012768790049466
SIM,1936,15,20-24,1951,93
STAT,1825,51,25-29,1876,0.0035519650574620614
STAT,1880,23,na,1903,2348.1560642257577
SIM,1953,18,25-29,1971,64
SIM,1814,40,na,1854,1377
STAT,1900,34,40-44,1934,5.634628325086253
SIM,1836,24,na,1860,1782
STAT,1834,57,na,1891,1245.9107644431651
STAT,1945,18,25-29,1963,44.70588703413984
STAT,1849,19,35-39,1868,0.5005251724097481
STAT,1913,52,na,1965,3330.59299744303
STAT,1872,96,na,1968,37.45904147757759
STAT,1886,31,45-49,1917,1.7472897537299321
STAT,1810,50,35-39,1860,0.02858350782694547
STAT,1815,50,na,1865,1306.216038878594
SIM,1855,93,na,1948,13
STAT,1906,23,20-24,1929,94.52397831869806
STAT,1856,45,25-29,1901,0.04287894576031341
STAT,1941,0,na,1941,4358.473678404177
STAT,1925,28,50-100,1953,1.1066652624737676
STAT,1819,40,45-49,1859,3.381399557011216
STAT,1895,30,40-44,1925,5.3840268745749045
STAT,1870,15,45-49,1885,0.061841403824200836
STAT,1846,15,50-100,1861,0.0461897045589719
SIM,1831,26,20-24,1857,10
STAT,1847,43,25-29,1890,0.4701105628906394
SIM,1848,106,na,1954,1
SIM,1921,19,25-29,1940,53
STAT,1892,42,25-29,1934,0.7588970328612505
SIM,1908,17,35-39,1925,4
STAT,1899,19,30-34,1918,2.052044860370878
STAT,1875,16,40-44,1891,0.17803774574193656
STAT,1834,50,20-24,1884,4.885341397087733E-4
SIM,1844,30,35-39,1874,4
STAT,1823,39,35-39,1862,10.262355804606438
SIM,1849,28,40-44,1877,2
STAT,1845,97,na,1942,3.8015535763584363
STAT,1848,54,30-34,1902,0.004301457621546928
SIM,1914,23,20-24,1937,100
SIM,1882,44,30-34,1926,1
STAT,1923,26,25-29,1949,71.63364045063689
SIM,1845,44,45-49,1889,1
SIM,1861,24,40-44,1885,5
STAT,1832,38,30-34,1870,4.029487662711613
SIM,1824,39,na,1863,1533
STAT,1844,25,45-49,1869,0.9576987038672119
STAT,1867,41,na,1908,2059.52696772382
STAT,1883,42,15-19,1925,0.012775101153665624
SIM,1835,19,15-19,1854,4
SIM,1888,18,na,1906,2842
SIM,1918,16,15-19,1934,9
STAT,1869,40,40-44,1909,2.0792846627980315
STAT,1874,51,50-100,1925,0.014647275179676887
STAT,1838,43,15-19,1881,0.00974129486805171
STAT,1874,44,30-34,1918,1.0947079960141584
SIM,1893,33,na,1926,2962
STAT,1941,25,30-34,1966,38.32473031310134
STAT,1853,24,40-44,1877,1.836652581656361
STAT,1803,103,na,1906,0.048241540124885615
STAT,1888,44,25-29,1932,0.7072577970390825
STAT,1858,18,30-34,1876,1.3709162135677901
STAT,1913,19,25-29,1932,8.325632105268436
SIM,1890,59,na,1949,2470
STAT,1836,30,35-39,1866,8.46335583775027
STAT,1875,51,20-24,1926,7.199588773172543E-4
STAT,1850,36,25-29,1886,2.0832736908678404
SIM,1923,35,30-34,1958,1
SIM,1873,32,20-24,1905,2
STAT,1908,37,na,1945,3327.7005718177284
STAT,1895,22,na,1917,2912.7907865113943
STAT,1868,38,45-49,1906,1.7879013276867683
STAT,1905,23,na,1928,3219.4815808057137
SIM,1894,31,45-49,1925,1
STAT,1842,45,30-34,1887,0.07193229855934281
SIM,1903,34,na,1937,3211
STAT,1915,35,30-34,1950,1.7558953078059507
STAT,1818,61,na,1879,1048.5858075039946
STAT,1842,41,15-19,1883,0.010480362818969979
STAT,1932,38,35-39,1970,3.066970288456088
STAT,1840,29,25-29,1869,34.11818989900548
STAT,1938,10,na,1948,3703.621265480833
STAT,1837,26,15-19,1863,0.3806674161934333
SIM,1876,38,45-49,1914,2
SIM,1854,46,na,1900,1821
SIM,1900,20,na,1920,3136
STAT,1890,17,20-24,1907,20.475847755022713
STAT,1780,111,na,1891,6.425251121591729E-4
STAT,1883,27,50-100,1910,0.5924916415136667
SIM,1866,18,30-34,1884,2
STAT,1864,33,15-19,1897,0.11939725133111771
STAT,1891,47,35-39,1938,0.09187028340071066
STAT,1837,68,na,1905,991.7756440759036
STAT,1911,47,30-34,1958,0.07972980230511834
SIM,1887,38,20-24,1925,3
SIM,1855,90,na,1945,36
SIM,1937,32,20-24,1969,2
STAT,1946,25,15-19,1971,0.7435502134551353
STAT,1811,51,30-34,1862,0.019334254970364794
STAT,1861,49,15-19,1910,3.0763444943542956E-4
STAT,1872,20,50-100,1892,0.3887184766434233
STAT,1799,89,na,1888,37.34067079404189
STAT,1834,38,50-100,1872,0.9379552709399329
STAT,1897,43,20-24,1940,0.013832314757989564
SIM,1847,64,na,1911,1309
SIM,1881,39,30-34,1920,3
STAT,1842,83,na,1925,287.49095125933525
STAT,1857,82,na,1939,347.63236847147215
SIM,1933,28,50-100,1961,1
STAT,1942,8,na,1950,3909.047902702201
STAT,1901,44,35-39,1945,0.16403555373394596
STAT,1929,32,20-24,1961,2.9268195696046697
STAT,1806,48,30-34,1854,0.35216525430127466
SIM,1874,60,na,1934,1739
SIM,1913,28,30-34,1941,38
STAT,1875,70,na,1945,1362.4056396886758
STAT,1905,28,30-34,1933,34.264705121735695
STAT,1911,43,15-19,1954,0.0013764018284285146
STAT,1866,52,25-29,1918,0.003069801747591799
SIM,1859,31,25-29,1890,10
SIM,1881,23,15-19,1904,2
STAT,1868,29,na,1897,2135.699775362756
SIM,1918,34,45-49,1952,1
STAT,1873,39,30-34,1912,5.054952501384968
SIM,1841,43,30-34,1884,3
SIM,1904,29,35-39,1933,15
STAT,1907,40,20-24,1947,0.015458706638192838
SIM,1869,45,na,1914,2094
STAT,1867,24,35-39,1891,5.144120354988421
STAT,1878,45,45-49,1923,0.23466326010336896
STAT,1806,76,na,1882,392.89857204695375
SIM,1835,37,45-49,1872,4
STAT,1835,19,40-44,1854,0.3053553699817593
STAT,1850,46,35-39,1896,0.098969471126928
SIM,1906,45,na,1951,3129
SIM,1898,3,na,1901,3305
STAT,1890,19,50-100,1909,0.05628049710631814
STAT,1832,32,25-29,1864,8.084641101837649
STAT,1836,20,25-29,1856,60.47818344143968
SIM,1889,18,35-39,1907,1
STAT,1931,18,30-34,1949,15.031846331396633
SIM,1848,103,na,1951,1
STAT,1859,33,40-44,1892,3.2469757241836423
STAT,1894,28,45-49,1922,1.3432180814610744
SIM,1925,15,na,1940,4182
STAT,1805,91,na,1896,20.228220651096066
STAT,1902,12,na,1914,3443.0823496327416
SIM,1858,21,30-34,1879,19
SIM,1866,37,50-100,1903,3
SIM,1854,38,25-29,1892,5
STAT,1824,41,30-34,1865,1.550811696980457
STAT,1793,61,na,1854,828.0
STAT,1824,46,25-29,1870,0.07122248166325966
STAT,1938,34,20-24,1972,2.3139934877296007
STAT,1920,45,15-19,1965,3.8648723217581056E-4
SIM,1884,59,na,1943,1878
STAT,1941,21,15-19,1962,5.198555673985647
SIM,1909,59,na,1968,3061
STAT,1861,111,na,1972,0.0013701274034518607
STAT,1906,43,40-44,1949,0.21335592155483377
STAT,1933,30,20-24,1963,3.1087974461688086
STAT,1887,29,15-19,1916,0.4759938432674682
STAT,1857,50,25-29,1907,0.0026769394002455382
SIM,1881,45,na,1926,1781
STAT,1871,22,35-39,1893,5.474102208196182
STAT,1841,34,25-29,1875,8.391462458959866
STAT,1879,0,na,1879,3588.7168943368365
SIM,1877,43,45-49,1920,1
SIM,1826,35,45-49,1861,1
SIM,1849,24,25-29,1873,55
STAT,1841,44,35-39,1885,1.264422800620893
STAT,1781,76,na,1857,346.1514976208467
STAT,1891,37,25-29,1928,3.3651516378843556
SIM,1875,45,na,1920,2194
SIM,1914,33,30-34,1947,17
STAT,1847,100,na,1947,0.7828647398178894
STAT,1943,26,50-100,1969,1.001878783338102
SIM,1941,30,20-24,1971,1
STAT,1922,16,30-34,1938,13.358833417742293
STAT,1838,47,30-34,1885,0.0668596825231053
STAT,1845,18,20-24,1863,15.762670863277181
STAT,1880,22,45-49,1902,0.6944868640588046
SIM,1908,27,45-49,1935,2
SIM,1870,20,35-39,1890,9
SIM,1896,44,na,1940,2853
STAT,1858,30,na,1888,1804.586579529429
SIM,1840,32,25-29,1872,9
STAT,1844,16,na,1860,2038.5583398632252
SIM,1880,60,na,1940,1906
STAT,1856,42,20-24,1898,0.11691344290767042
STAT,1858,67,na,1925,1174.1414799310323
STAT,1796,75,na,1871,408.4307751130553
STAT,1917,11,na,1928,4020.8652097982917
SIM,1820,40,na,1860,1548
SIM,1946,14,na,1960,4000
SIM,1860,46,na,1906,1886
SIM,1910,16,na,1926,3636
STAT,1909,37,50-100,1946,0.3754432899624381
STAT,1915,45,40-44,1960,0.1507935420182669
STAT,1803,62,na,1865,905.5264659641249
STAT,1812,76,na,1888,410.24286315832546
STAT,1837,41,40-44,1878,1.7447763239619503
SIM,1852,25,45-49,1877,4
STAT,1881,6,na,1887,2424.676286729074
STAT,1878,27,15-19,1905,0.44667949671023793
STAT,1887,39,25-29,1926,3.0117820236902926
STAT,1936,21,40-44,1957,3.03770944140871
SIM,1930,16,30-34,1946,19
SIM,1853,18,20-24,1871,19
STAT,1906,33,30-34,1939,13.735734745009331
SIM,1944,21,40-44,1965,3
STAT,1895,20,30-34,1915,22.06847685483559
STAT,1865,15,na,1880,2252.190968598052
SIM,1927,28,25-29,1955,77
STAT,1877,37,na,1914,2308.7036637446313
STAT,1822,33,45-49,1855,4.413021704578231
STAT,1905,22,50-100,1927,0.5568355174853005
SIM,1868,41,45-49,1909,3
STAT,1862,20,35-39,1882,4.895122675330956
SIM,1867,23,30-34,1890,25
STAT,1807,53,30-34,1860,0.021376545102415146
STAT,1879,48,30-34,1927,0.09452016350078192
SIM,1952,14,na,1966,4382
STAT,1882,35,25-29,1917,2.670284112092045
SIM,1823,54,na,1877,1176
STAT,1919,28,25-29,1947,66.94849418421933
STAT,1914,24,25-29,1938,88.59432400546554
SIM,1928,39,30-34,1967,2
STAT,1858,6,na,1864,2158.502747215612
STAT,1934,27,50-100,1961,1.264932321789769
SIM,1934,29,na,1963,4673
SIM,1936,4,na,1940,3023
STAT,1924,47,40-44,1971,0.17731484055575938
SIM,1893,26,45-49,1919,1
STAT,1898,36,na,1934,3026.42397743605
SIM,1825,80,na,1905,320
STAT,1900,37,50-100,1937,0.34728039413335327
SIM,1931,26,25-29,1957,90
SIM,1931,15,na,1946,4564
STAT,1918,36,50-100,1954,0.42007833274931466
SIM,1844,53,na,1897,1414
SIM,1844,20,25-29,1864,44
STAT,1827,37,45-49,1864,2.069187155586329
SIM,1871,34,45-49,1905,2
STAT,1866,96,na,1962,18.99726044792022
SIM,1903,23,45-49,1926,4
SIM,1949,15,30-34,1964,14
STAT,1846,38,25-29,1884,2.2070372288371853
SIM,1919,37,30-34,1956,2
STAT,1864,30,na,1894,2025.3568576462762
STAT,1873,33,25-29,1906,9.772174088559257
SIM,1773,84,na,1857,83
SIM,1883,74,na,1957,1043
STAT,1850,29,50-100,1879,0.5230664220783204
STAT,1885,26,45-49,1911,1.0490977104033794
SIM,1788,83,na,1871,118
STAT,1843,31,na,1874,1778.2140938011228
STAT,1859,15,na,1874,2027.2436089740968
STAT,1833,53,40-44,1886,0.006526428208287272
STAT,1863,31,40-44,1894,3.6099052842785944
SIM,1878,59,na,1937,1938
STAT,1837,103,na,1940,0.09313894160156429
STAT,1901,67,na,1968,2388.977003119231
SIM,1894,19,20-24,1913,20
STAT,1860,43,25-29,1903,0.48866389507395264
STAT,1838,16,na,1854,2047.6081681953483
STAT,1849,29,45-49,1878,0.9728247345950396
STAT,1825,39,50-100,1864,1.419166758577959
STAT,1917,15,45-49,1932,0.10202486329250807
SIM,1899,58,na,1957,2644
STAT,1883,37,na,1920,2182.1375477373495
SIM,1922,24,25-29,1946,119
SIM,1904,16,20-24,1920,23
STAT,1863,21,50-100,1884,0.34729616368158756
STAT,1910,41,40-44,1951,0.22460821048543247
SIM,1890,35,25-29,1925,2
STAT,1896,40,35-39,1936,0.15847533099868255
SIM,1808,49,50-100,1857,1
STAT,1851,97,na,1948,3.8644846638516634
STAT,1815,44,25-29,1859,1.4989749999666109
STAT,1886,19,20-24,1905,17.59660988195226
SIM,1900,32,25-29,1932,21
STAT,1932,33,40-44,1965,4.9114033670626025
SIM,1870,46,na,1916,2080
STAT,1953,16,20-24,1969,154.97239056852175
STAT,1928,42,15-19,1970,0.0018493968590661883
SIM,1952,18,20-24,1970,156
SIM,1882,79,na,1961,781
STAT,1950,15,40-44,1965,1.5632508833833627
STAT,1837,23,35-39,1860,4.9222313629909005
SIM,1838,33,45-49,1871,3
STAT,1900,33,30-34,1933,22.784479702774863
SIM,1905,23,30-34,1928,24
SIM,1823,68,na,1891,776
SIM,1873,40,50-100,1913,1
SIM,1903,15,20-24,1918,22
STAT,1932,39,35-39,1971,3.063535281733018
SIM,1937,29,35-39,1966,15
STAT,1920,32,45-49,1952,1.6282654602372535
SIM,1914,29,40-44,1943,4
STAT,1803,71,na,1874,611.2099443947562
STAT,1839,31,45-49,1870,1.4436994102417895
STAT,1906,29,40-44,1935,4.092149873524147
STAT,1897,24,45-49,1921,0.8754686771790158
STAT,1883,76,na,1959,1002.9542255834773
SIM,1901,43,40-44,1944,4
STAT,1824,65,na,1889,938.0617222358768
SIM,1855,30,40-44,1885,6
STAT,1932,19,na,1951,4579.586168216217
STAT,1894,28,na,1922,2887.158563554275
STAT,1921,25,15-19,1946,0.7483135393479929
STAT,1807,85,na,1892,101.96380742856502
STAT,1890,14,na,1904,2973.0535939659953
STAT,1898,17,15-19,1915,7.586846069530976
STAT,1902,41,40-44,1943,0.20918544043216364
SIM,1834,35,50-100,1869,1
SIM,1885,12,na,1897,2483
SIM,1885,47,50-100,1932,3
SIM,1919,38,30-34,1957,5
STAT,1915,27,40-44,1942,4.491320152901487
STAT,1918,28,20-24,1946,18.287429089673747
STAT,1932,31,25-29,1963,11.61385173733841
SIM,1845,23,35-39,1868,5
STAT,1942,19,50-100,1961,0.3696315719549133
STAT,1888,31,40-44,1919,4.861505726626536
STAT,1906,21,30-34,1927,24.58197993628038
STAT,1930,23,15-19,1953,6.422169440393614
STAT,1940,30,20-24,1970,2.3875084593566647
SIM,1876,22,25-29,1898,59
STAT,1831,48,40-44,1879,0.12040550446957324
SIM,1862,20,30-34,1882,24
STAT,1854,63,na,1917,1276.6429659896905
STAT,1933,18,45-49,1951,0.6300679521536728
STAT,1858,77,na,1935,640.2392488719029
STAT,1877,20,25-29,1897,56.43166482658477
STAT,1925,41,35-39,1966,0.2306355520293616
STAT,1941,17,40-44,1958,1.3610196829768049
STAT,1923,33,25-29,1956,10.00344123805236
SIM,1907,31,40-44,1938,4
STAT,1854,20,30-34,1874,15.191616154357051
SIM,1861,85,na,1946,181
SIM,1843,15,25-29,1858,9
SIM,1829,40,40-44,1869,5
STAT,1816,46,na,1862,1405.3138825306457
SIM,1931,33,25-29,1964,12
STAT,1845,27,na,1872,1863.2476865876586
STAT,1781,104,na,1885,0.03255765513769775
SIM,1849,33,20-24,1882,1
SIM,1787,68,na,1855,634
SIM,1809,96,na,1905,4
SIM,1896,31,40-44,1927,5
STAT,1914,35,25-29,1949,0.9375457363232659
STAT,1865,21,45-49,1886,0.6087216699391588
STAT,1922,17,30-34,1939,13.326104275868826
SIM,1783,86,na,1869,41
SIM,1914,21,30-34,1935,28
STAT,1919,44,15-19,1963,0.0015669227930174524
STAT,1847,30,40-44,1877,3.8335651444016414
STAT,1947,25,35-39,1972,16.06040323689826
STAT,1824,110,na,1934,1.5236919101188441E-4
STAT,1860,16,na,1876,2041.2659871109186
STAT,1896,19,na,1915,3134.2629612058595
STAT,1912,27,15-19,1939,0.6572353244631817
STAT,1931,32,20-24,1963,3.0192885736486783
SIM,1936,21,na,1957,2739
STAT,1909,17,15-19,1926,8.407956138304076
SIM,1856,37,50-100,1893,3
SIM,1865,16,15-19,1881,7
STAT,1796,84,na,1880,109.07802324536289
STAT,1846,21,35-39,1867,5.379019514028933
SIM,1928,34,na,1962,4477
STAT,1929,34,30-34,1963,18.880663634673247
SIM,1924,20,na,1944,4116
STAT,1924,25,40-44,1949,5.161532214299394
STAT,1841,45,na,1886,1598.5383976630064
SIM,1899,32,20-24,1931,3
SIM,1836,86,na,1922,132
SIM,1887,20,35-39,1907,7
SIM,1854,21,35-39,1875,7
SIM,1842,49,50-100,1891,2
STAT,1786,74,na,1860,402.7606683153473
SIM,1907,26,45-49,1933,1
STAT,1858,20,15-19,1878,2.844298949343901
SIM,1930,17,30-34,1947,18
STAT,1944,18,20-24,1962,137.78626306922823
SIM,1832,72,na,1904,723
SIM,1840,91,na,1931,28
STAT,1903,40,45-49,1943,0.14110702419576904
STAT,1870,26,na,1896,2219.3274453900763
SIM,1884,36,50-100,1920,1
STAT,1873,66,na,1939,1570.3593380494765
SIM,1907,40,na,1947,3274
SIM,1873,21,45-49,1894,3
SIM,1953,17,25-29,1970,57
SIM,1802,74,na,1876,414
STAT,1915,47,35-39,1962,0.12273481657137289
SIM,1870,48,50-100,1918,2
STAT,1835,20,20-24,1855,79.75134332022141
STAT,1914,40,20-24,1954,0.016647556613253765
SIM,1820,47,50-100,1867,2
STAT,1857,16,15-19,1873,5.227697758752652
STAT,1875,57,na,1932,1951.3811867585111
STAT,1930,36,20-24,1966,0.32511621091415743
STAT,1794,93,na,1887,7.049590396961757
SIM,1937,34,30-34,1971,13
STAT,1850,52,35-39,1902,0.006036420189576886
SIM,1808,79,na,1887,296
STAT,1860,39,20-24,1899,0.5849163558553933
STAT,1913,39,25-29,1952,0.9087256217202255
SIM,1848,24,15-19,1872,2
SIM,1804,65,na,1869,809
SIM,1899,27,25-29,1926,63
STAT,1929,29,35-39,1958,17.732489102016913
STAT,1945,17,25-29,1962,44.72019749733899
STAT,1946,26,30-34,1972,41.25201250171387
SIM,1917,17,15-19,1934,7
STAT,1900,20,25-29,1920,75.46824568175231
STAT,1902,36,45-49,1938,0.5764193273380207
SIM,1884,16,25-29,1900,8
STAT,1887,58,na,1945,2089.6962082228397
STAT,1883,44,na,1927,2111.805715952246
STAT,1872,49,40-44,1921,0.15883808728608426
SIM,1856,31,na,1887,1883
SIM,1835,46,50-100,1881,3
STAT,1873,20,40-44,1893,2.008439822124959
SIM,1888,32,45-49,1920,3
STAT,1855,49,40-44,1904,0.11911913410726951
STAT,1891,63,na,1954,2085.4613249973236
SIM,1823,36,na,1859,1498
SIM,1870,78,na,1948,638
STAT,1879,39,na,1918,2306.314645634136
STAT,1895,77,na,1972,1527.4726185703396
STAT,1933,23,40-44,1956,4.211938051475114
STAT,1931,23,50-100,1954,0.803702690735054
STAT,1800,104,na,1904,0.02651546985164797
STAT,1916,23,40-44,1939,3.3181497426864035
STAT,1938,32,30-34,1970,14.965949629988883
SIM,1875,23,20-24,1898,65
STAT,1920,29,15-19,1949,0.7263483439676688
STAT,1903,29,15-19,1932,0.6054866117557816
SIM,1935,26,20-24,1961,24
STAT,1919,27,25-29,1946,67.18498533259006
STAT,1859,24,25-29,1883,44.0189967898067
SIM,1871,95,na,1966,46
STAT,1910,30,35-39,1940,8.391189695205949
SIM,1811,67,na,1878,695
STAT,1914,18,35-39,1932,0.8178703164242219
STAT,1832,52,na,1884,1341.5863693154033
SIM,1930,21,15-19,1951,11
STAT,1865,47,na,1912,1917.4812977164138
SIM,1862,59,na,1921,1664
SIM,1919,41,na,1960,3877
STAT,1922,34,20-24,1956,2.590810275540163
STAT,1887,22,35-39,1909,6.166260165970891
STAT,1903,38,na,1941,3175.94910071998
SIM,1915,25,40-44,1940,3
SIM,1843,20,20-24,1863,67
SIM,1924,23,40-44,1947,3
STAT,1910,38,45-49,1948,0.6128976820511292
SIM,1929,32,30-34,1961,21
SIM,1936,17,25-29,1953,42
SIM,1959,5,na,1964,4880
SIM,1890,66,na,1956,2087
STAT,1904,46,20-24,1950,0.00919841831577878
STAT,1918,48,15-19,1966,3.6929796803494255E-4
SIM,1922,18,35-39,1940,6
STAT,1765,103,na,1868,0.035336934077537185
SIM,1836,30,30-34,1866,16
SIM,1886,21,30-34,1907,19
SIM,1930,34,20-24,1964,2
SIM,1932,25,40-44,1957,8
SIM,1895,22,35-39,1917,10
STAT,1858,33,20-24,1891,1.9936566485579432
STAT,1875,25,na,1900,2333.0707390472576
SIM,1848,12,na,1860,2192
SIM,1830,42,50-100,1872,2
STAT,1927,26,20-24,1953,21.03575174291168
STAT,1925,24,45-49,1949,1.2643363975567938
STAT,1870,45,15-19,1915,3.743999640366547E-4
SIM,1867,24,25-29,1891,59
SIM,1828,31,35-39,1859,8
SIM,1941,23,40-44,1964,3
STAT,1782,92,na,1874,9.459108849913088
STAT,1890,20,50-100,1910,0.473794141408294
STAT,1932,19,40-44,1951,1.7402760579948757
STAT,1907,45,35-39,1952,0.11068373379344865
SIM,1940,19,40-44,1959,1
SIM,1879,34,45-49,1913,2
SIM,1904,0,na,1904,3749
SIM,1943,23,na,1966,3580
STAT,1906,7,na,1913,3584.719489566643
SIM,1926,28,20-24,1954,26
STAT,1896,20,35-39,1916,7.3242851788842565
STAT,1860,54,45-49,1914,0.01081800570372951
STAT,1837,83,na,1920,257.6381787826932
SIM,1900,31,30-34,1931,28
STAT,1880,52,20-24,1932,7.310072871245022E-4
SIM,1921,19,30-34,1940,16
SIM,1906,35,40-44,1941,3
STAT,1779,110,na,1889,0.0016684466753065872
STAT,1825,82,na,1907,247.9818775362519
STAT,1868,22,25-29,1890,51.59788063247916
STAT,1907,25,40-44,1932,4.185229561521868
STAT,1829,96,na,1925,5.188363794969651
STAT,1915,39,na,1954,3554.330081798521
STAT,1778,87,na,1865,50.11493431050317
STAT,1864,30,40-44,1894,3.680743336652457
STAT,1911,25,na,1936,3474.7949240171865
STAT,1828,107,na,1935,0.0026559319700281895
SIM,1824,85,na,1909,113
SIM,1902,19,20-24,1921,21
STAT,1852,29,na,1881,1807.620660920413
STAT,1908,24,45-49,1932,0.9711034729750059
SIM,1828,99,na,1927,2
STAT,1895,21,30-34,1916,22.003816217650932
SIM,1795,87,na,1882,47
SIM,1791,73,na,1864,433
SIM,1939,18,na,1957,3453
SIM,1927,27,25-29,1954,71
SIM,1921,23,15-19,1944,5
SIM,1901,30,35-39,1931,18
SIM,1928,31,50-100,1959,2
SIM,1816,98,na,1914,2
SIM,1878,22,35-39,1900,10
STAT,1834,49,20-24,1883,0.007698109752251699
STAT,1867,23,20-24,1890,60.94186700314711
STAT,1828,30,30-34,1858,19.53140579469205
STAT,1933,35,35-39,1968,3.117684880056524
SIM,1925,3,na,1928,4576
STAT,1927,38,15-19,1965,0.022531868594908473
STAT,1817,49,20-24,1866,0.026217128018776473
STAT,1913,19,30-34,1932,2.341733990427806
STAT,1878,0,na,1878,3583.8680122691803
STAT,1889,22,45-49,1911,0.8132546755768165
SIM,1799,69,na,1868,690
STAT,1898,10,na,1908,3311.523552082369
STAT,1820,51,na,1871,1282.4593484212464
SIM,1882,47,na,1929,2110
SIM,1884,21,20-24,1905,67
STAT,1911,57,na,1968,3141.485876687071
STAT,1938,27,35-39,1965,14.051618906449775
STAT,1924,45,35-39,1969,0.14568290844159837
SIM,1815,49,na,1864,1376
STAT,1914,23,30-34,1937,27.65454679505565
SIM,1897,22,45-49,1919,1
STAT,1824,33,na,1857,1583.0026834369717
SIM,1845,20,30-34,1865,18
SIM,1916,24,45-49,1940,1
SIM,1869,81,na,1950,490
SIM,1908,5,na,1913,3644
STAT,1937,28,30-34,1965,36.06528502528418
SIM,1874,28,na,1902,2210
SIM,1909,28,20-24,1937,17
STAT,1923,46,30-34,1969,0.09876122718852544
SIM,1901,38,45-49,1939,4
STAT,1849,22,15-19,1871,2.99093787372232
STAT,1923,5,na,1928,4460.178924895546
SIM,1857,22,15-19,1879,2
STAT,1828,47,na,1875,1404.1374692001089
STAT,1904,33,15-19,1937,0.11033603600916843
STAT,1806,68,na,1874,747.5674785192408
STAT,1802,54,na,1856,1103.2180268704976
SIM,1931,30,20-24,1961,3
SIM,1812,52,na,1864,1196
SIM,1868,20,25-29,1888,64
SIM,1889,17,15-19,1906,10
STAT,1836,34,na,1870,1737.4692611982537
STAT,1852,15,25-29,1867,5.027887544433278
STAT,1925,17,na,1942,4200.319875975181
STAT,1938,24,30-34,1962,26.854228363737416
STAT,1928,38,30-34,1966,2.173709532453963
SIM,1888,24,45-49,1912,4
SIM,1920,15,20-24,1935,160
STAT,1887,26,na,1913,2530.455795352153
STAT,1877,16,40-44,1893,0.1796732439766298
STAT,1787,91,na,1878,17.797745160617886
STAT,1891,31,50-100,1922,1.0752669471028202
STAT,1891,31,na,1922,2800.473509143539
STAT,1950,18,45-49,1968,0.5578293267256768
STAT,1832,39,45-49,1871,1.4909644137821527
STAT,1895,45,na,1940,2799.0459855331196
SIM,1923,39,35-39,1962,6
STAT,1808,109,na,1917,2.7508963370985256E-4
STAT,1915,39,35-39,1954,2.285106465917056
SIM,1844,30,na,1874,1793
STAT,1935,21,50-100,1956,0.8467451062661739
SIM,1848,44,na,1892,1630
STAT,1915,31,25-29,1946,8.929171153049623
SIM,1878,42,na,1920,2332
STAT,1956,15,35-39,1971,5.247414319658485
STAT,1814,48,40-44,1862,0.5149785169952276
STAT,1899,34,20-24,1933,3.4688907718967235
STAT,1901,24,35-39,1925,7.668192819723292
STAT,1912,15,20-24,1927,26.019952367979023
STAT,1795,67,na,1862,771.0297024223996
STAT,1816,50,50-100,1866,0.03554749110446819
STAT,1854,23,35-39,1877,4.870488595499983
SIM,1852,39,50-100,1891,1
SIM,1907,34,45-49,1941,4
STAT,1803,102,na,1905,0.09854866016686875
STAT,1923,30,20-24,1953,2.662813956344775
STAT,1831,67,na,1898,925.5858706811903
STAT,1914,0,na,1914,4388.210150655762
SIM,1932,39,na,1971,4711
STAT,1901,15,45-49,1916,0.08678000927940388
SIM,1948,22,na,1970,3953
STAT,1847,33,45-49,1880,1.4942223654041877
STAT,1922,29,25-29,1951,69.85757208677987
STAT,1930,19,30-34,1949,14.806562292928248
STAT,1913,23,15-19,1936,5.062568995101556
STAT,1944,20,na,1964,3727.374316247917
STAT,1868,12,na,1880,2407.3365297716023
STAT,1930,28,20-24,1958,21.916023177978623
STAT,1906,46,30-34,1952,0.07534214008003458
STAT,1852,49,15-19,1901,2.839394004901447E-4
SIM,1862,23,35-39,1885,5
STAT,1903,37,15-19,1940,0.016291755448783952
STAT,1910,43,40-44,1953,0.22198127820671482
SIM,1817,83,na,1900,161
SIM,1855,33,45-49,1888,1
SIM,1930,29,25-29,1959,88
STAT,1861,65,na,1926,1327.4438278412736
SIM,1899,15,30-34,1914,3
STAT,1865,79,na,1944,598.6201827391552
SIM,1852,17,na,1869,2138
STAT,1902,44,45-49,1946,0.1366920963951559
SIM,1935,34,50-100,1969,1
SIM,1946,24,30-34,1970,36
SIM,1894,31,50-100,1925,2
SIM,1902,34,45-49,1936,3
STAT,1848,26,15-19,1874,0.4053769060235499
SIM,1816,66,na,1882,835
STAT,1893,6,na,1899,3129.6762922019734
STAT,1928,17,25-29,1945,51.582370857490815
SIM,1817,37,50-100,1854,1
SIM,1865,24,na,1889,2107
STAT,1908,49,45-49,1957,0.18460031389021198
STAT,1874,51,na,1925,2088.2316618611812
STAT,1907,20,na,1927,3301.625942628232
SIM,1912,16,25-29,1928,7
STAT,1844,85,na,1929,190.39285498572272
STAT,1888,34,45-49,1922,1.9302187045461094
STAT,1848,99,na,1947,1.4072530921889739
SIM,1866,32,50-100,1898,1
STAT,1840,71,na,1911,875.9731235145366
SIM,1906,27,40-44,1933,3
STAT,1905,25,30-34,1930,34.61902710759764
STAT,1907,33,40-44,1940,3.4410572216390385
SIM,1866,33,20-24,1899,2
SIM,1866,8,na,1874,2448
STAT,1816,78,na,1894,364.10235919800454
STAT,1913,44,20-24,1957,0.016216098286476573
STAT,1923,16,35-39,1939,4.66614853256348
SIM,1846,40,40-44,1886,5
SIM,1873,11,na,1884,2534
SIM,1899,24,20-24,1923,91
SIM,1931,16,35-39,1947,8
SIM,1842,82,na,1924,270
STAT,1881,39,40-44,1920,3.9547302528113093
STAT,1931,40,20-24,1971,0.022349561831996424
STAT,1889,81,na,1970,1058.2063333975536
STAT,1900,41,na,1941,3053.1027996882754
STAT,1922,21,15-19,1943,5.78427156475636
STAT,1847,61,na,1908,1377.9454028078057
STAT,1871,49,25-29,1920,0.05290479692892436
STAT,1925,46,40-44,1971,0.18092693537755683
SIM,1898,23,15-19,1921,4
SIM,1849,36,25-29,1885,2
SIM,1849,61,na,1910,1408
SIM,1829,43,45-49,1872,1
SIM,1838,30,40-44,1868,2
SIM,1860,15,25-29,1875,6
STAT,1924,28,45-49,1952,1.893536821847016
SIM,1878,30,35-39,1908,9
SIM,1913,25,30-34,1938,43
SIM,1792,90,na,1882,19
SIM,1840,39,45-49,1879,1
SIM,1896,34,45-49,1930,2
SIM,1889,45,50-100,1934,2
STAT,1874,16,15-19,1890,5.742235764774466
STAT,1936,33,na,1969,3468.1407640160737
STAT,1935,16,50-100,1951,0.48503647513746817
SIM,1920,38,na,1958,3954
STAT,1897,21,40-44,1918,2.6405955638968197
STAT,1908,41,35-39,1949,0.17701769920016563
SIM,1882,16,15-19,1898,5
STAT,1941,21,25-29,1962,90.20682982654266
SIM,1915,33,40-44,1948,6
SIM,1907,23,40-44,1930,2
SIM,1852,49,na,1901,1686
SIM,1871,63,na,1934,1664
SIM,1846,96,na,1942,3
STAT,1846,44,na,1890,1691.116101534427
STAT,1904,16,25-29,1920,7.697595755981983
STAT,1842,30,na,1872,1935.7642176133058
SIM,1875,77,na,1952,738
STAT,1936,36,15-19,1972,0.017825418290137448
SIM,1878,10,na,1888,2648
STAT,1869,17,45-49,1886,0.060610306239941465
STAT,1916,18,45-49,1934,0.09986107326462304
STAT,1838,40,40-44,1878,1.8118483122615263
SIM,1905,15,30-34,1920,1
STAT,1904,55,na,1959,2876.338027133793
STAT,1941,29,35-39,1970,14.657561531584113
SIM,1834,20,na,1854,1786
STAT,1919,49,20-24,1968,0.01125717280525605
STAT,1852,26,50-100,1878,0.5440763792170914
SIM,1900,22,40-44,1922,3
SIM,1932,28,45-49,1960,2
STAT,1841,30,50-100,1871,0.7824876954594682
SIM,1801,89,na,1890,39
STAT,1924,42,30-34,1966,0.1436545567717191
STAT,1931,15,30-34,1946,15.141356836611317
SIM,1849,20,15-19,1869,2
STAT,1940,25,25-29,1965,63.461688793149285
STAT,1916,26,45-49,1942,1.693289482352471
STAT,1839,23,45-49,1862,0.5922557757021302
SIM,1863,33,na,1896,1974
SIM,1939,27,50-100,1966,1
SIM,1904,39,25-29,1943,1
STAT,1852,52,45-49,1904,0.01046529047481944
STAT,1873,23,45-49,1896,0.6660494178598051
STAT,1920,24,45-49,1944,1.1742890255826461
SIM,1896,39,na,1935,2942
SIM,1892,25,na,1917,3159
STAT,1920,18,na,1938,3890.9476016199887
STAT,1882,27,na,1909,2192.535565731656
SIM,1887,41,40-44,1928,5
STAT,1899,3,na,1902,3421.9367723315627
SIM,1838,28,50-100,1866,1
STAT,1900,28,35-39,1928,12.600453574346528
STAT,1892,80,na,1972,1195.3408275590318
STAT,1879,41,40-44,1920,2.234312784606709
SIM,1918,29,25-29,1947,71
STAT,1912,48,20-24,1960,0.010005710774531386
SIM,1914,37,40-44,1951,2
STAT,1876,21,20-24,1897,67.46198532981923
STAT,1901,32,35-39,1933,13.391443094397298
SIM,1841,15,15-19,1856,2
STAT,1956,6,na,1962,4913.453582359845
STAT,1853,37,50-100,1890,0.9291509704831982
SIM,1938,25,35-39,1963,13
STAT,1807,53,na,1860,1198.4875542215864
STAT,1913,27,30-34,1940,36.88397154761075
STAT,1775,90,na,1865,26.201697755782163
STAT,1887,5,na,1892,2769.1875740383307
SIM,1825,32,20-24,1857,5
SIM,1859,26,40-44,1885,1
SIM,1913,17,30-34,1930,1
SIM,1925,19,15-19,1944,45
STAT,1857,105,na,1962,0.08091200553147769
SIM,1883,64,na,1947,1534
STAT,1906,37,40-44,1943,1.3000165539590705
STAT,1880,7,na,1887,2641.6763857461447
STAT,1884,23,20-24,1907,64.11871721469578
STAT,1849,30,15-19,1879,0.1262506994120668
SIM,1921,27,30-34,1948,47
STAT,1862,21,50-100,1883,0.33962098276378566
SIM,1897,30,45-49,1927,4
SIM,1789,91,na,1880,9
STAT,1889,30,45-49,1919,2.0500886128750175
STAT,1901,1,na,1902,3599.2379296455438
SIM,1887,78,na,1965,1077
STAT,1858,16,30-34,1874,1.3872094152719379
STAT,1917,19,15-19,1936,45.73919243243475
SIM,1866,16,30-34,1882,1
STAT,1905,17,30-34,1922,2.176419791942679
SIM,1848,16,15-19,1864,5
STAT,1866,51,50-100,1917,0.013222310094539233
SIM,1924,26,45-49,1950,4
STAT,1836,98,na,1934,2.103646671637989
SIM,1857,48,na,1905,1764
STAT,1928,34,15-19,1962,0.15159499444003788
SIM,1892,23,20-24,1915,93
STAT,1911,43,50-100,1954,0.10529473218052364
STAT,1832,84,na,1916,200.39677717962016
SIM,1895,4,na,1899,3336
STAT,1936,32,50-100,1968,0.7586395937914167
STAT,1923,49,35-39,1972,0.14164710432009972
SIM,1906,55,na,1961,2948
SIM,1902,41,na,1943,3092
STAT,1943,17,15-19,1960,45.463944202476114
SIM,1928,36,30-34,1964,4
STAT,1830,48,25-29,1878,0.0426063393223722
STAT,1821,38,30-34,1859,10.657441223949597
STAT,1912,42,na,1954,3383.980645961219
STAT,1916,43,35-39,1959,0.19463495123959323
SIM,1870,39,30-34,1909,4
STAT,1935,3,na,1938,5238.1952194659
SIM,1835,21,25-29,1856,46
SIM,1879,31,40-44,1910,5
SIM,1933,21,40-44,1954,6
STAT,1878,20,40-44,1898,2.0637934593594194
STAT,1899,17,30-34,1916,2.0631088904128387
SIM,1937,1,na,1938,3660
SIM,1865,99,na,1964,3
STAT,1908,16,45-49,1924,0.09176728190221944
STAT,1811,48,15-19,1859,0.0013105562055009193
SIM,1923,31,25-29,1954,9
STAT,1889,27,15-19,1916,0.5291327936437327
SIM,1832,29,na,1861,1646
STAT,1877,80,na,1957,677.772492769951
STAT,1942,16,45-49,1958,0.493310593223063
STAT,1916,56,na,1972,3427.086124974859
SIM,1862,34,50-100,1896,4
SIM,1882,5,na,1887,2528
STAT,1873,17,50-100,1890,0.04693982795008502
STAT,1890,20,40-44,1910,2.4210878864530523
SIM,1951,17,15-19,1968,48
STAT,1862,50,na,1912,1764.1458187930139
SIM,1898,30,na,1928,3019
STAT,1904,38,20-24,1942,0.22433732509859053
STAT,1853,46,na,1899,1707.5049868878273
STAT,1866,64,na,1930,1514.6687453524187
STAT,1862,39,30-34,1901,4.2614728713589205
STAT,1856,11,na,1867,2090.077009893985
STAT,1868,30,25-29,1898,9.306299499888125
STAT,1925,21,40-44,1946,3.8135014646321603
STAT,1919,21,na,1940,3789.0252576020225
STAT,1843,22,20-24,1865,58.42565547029754
STAT,1861,33,na,1894,1866.5066122790963
SIM,1851,22,20-24,1873,56
STAT,1895,24,35-39,1919,7.141977982031061
SIM,1890,28,50-100,1918,4
SIM,1879,19,20-24,1898,13
STAT,1934,31,35-39,1965,11.793738753683867
STAT,1867,26,25-29,1893,37.653436899384985
SIM,1840,16,na,1856,2012
SIM,1935,34,20-24,1969,3
STAT,1806,49,45-49,1855,0.8428664525004097
STAT,1924,17,40-44,1941,1.5734805357320705
SIM,1927,24,20-24,1951,130
STAT,1837,41,50-100,1878,0.819495860745924
STAT,1923,41,25-29,1964,0.0789596764033274
STAT,1924,43,na,1967,4166.581472788779
SIM,1905,26,35-39,1931,15
STAT,1890,78,na,1968,1286.6242108935069
STAT,1932,27,40-44,1959,5.7673022672423775
SIM,1861,2,na,1863,2780
STAT,1927,34,20-24,1961,2.830808007029906
STAT,1824,97,na,1921,2.962183823140844
STAT,1879,20,35-39,1899,5.804980207278584
STAT,1922,37,25-29,1959,1.058394635346655
SIM,1845,41,50-100,1886,1
SIM,1927,20,50-100,1947,4
SIM,1944,19,25-29,1963,49
STAT,1910,35,40-44,1945,1.3654179698415592
STAT,1932,34,50-100,1966,1.0369680518170756
STAT,1820,83,na,1903,209.1357990543316
STAT,1936,19,25-29,1955,38.98306200424439
SIM,1903,26,na,1929,3229
SIM,1829,84,na,1913,170
SIM,1930,37,25-29,1967,3
SIM,1836,33,35-39,1869,10
STAT,1914,27,25-29,1941,62.68528757867697
SIM,1858,31,20-24,1889,3
STAT,1905,42,20-24,1947,0.015040545372637163
SIM,1922,27,25-29,1949,65
STAT,1828,33,35-39,1861,10.132684277694135
SIM,1790,88,na,1878,34
SIM,1828,67,na,1895,918
SIM,1940,27,40-44,1967,3
STAT,1919,24,20-24,1943,114.30580065942105
SIM,1914,42,na,1956,3474
SIM,1824,53,na,1877,1255
SIM,1868,0,na,1868,3235
STAT,1840,38,40-44,1878,3.362684643333876
STAT,1866,2,na,1868,2943.297909457259
STAT,1896,40,50-100,1936,0.09245653218342417
STAT,1919,16,20-24,1935,28.46598959590398
SIM,1849,24,30-34,1873,19
STAT,1860,48,na,1908,1702.856008888208
SIM,1777,90,na,1867,22
SIM,1849,29,na,1878,1926
SIM,1938,2,na,1940,3616
STAT,1914,26,35-39,1940,14.34754467895829
SIM,1914,30,20-24,1944,2
STAT,1882,52,50-100,1934,0.01380126357101178
STAT,1940,17,25-29,1957,41.56635027603253
STAT,1851,52,50-100,1903,0.010806221575151466
STAT,1926,42,40-44,1968,0.2912902266084573
STAT,1894,60,na,1954,2315.4104608449325
SIM,1906,39,35-39,1945,10
STAT,1871,46,50-100,1917,0.23104467801901596
STAT,1874,53,35-39,1927,0.008176244805830572
STAT,1834,22,50-100,1856,0.3384635792360445
SIM,1826,33,na,1859,1565
SIM,1955,0,na,1955,4608
STAT,1898,74,na,1972,1854.7908848181573
SIM,1834,52,na,1886,1334
STAT,1870,49,30-34,1919,0.08783740588317543
SIM,1809,64,na,1873,858
SIM,1805,50,na,1855,1208
SIM,1888,21,40-44,1909,1
STAT,1829,32,na,1861,1717.061545293447
SIM,1867,15,35-39,1882,1
SIM,1915,17,40-44,1932,1
SIM,1946,6,na,1952,4025
SIM,1921,28,20-24,1949,19
STAT,1827,30,na,1857,1709.5603378815165
STAT,1830,28,30-34,1858,23.75755251074943
SIM,1845,15,na,1860,2063
SIM,1877,25,na,1902,2323
STAT,1906,43,50-100,1949,0.10021014853227192
SIM,1942,17,na,1959,3575
STAT,1887,30,35-39,1917,10.787128704125406
STAT,1905,61,na,1966,2772.424305588385
SIM,1922,26,35-39,1948,22
STAT,1854,54,20-24,1908,5.134514348906228E-4
STAT,1888,16,50-100,1904,0.054831232089418994
STAT,1914,30,50-100,1944,0.7925627427302463
STAT,1759,112,na,1871,3.154006184380137E-4
STAT,1826,35,50-100,1861,1.428576663502992
STAT,1851,109,na,1960,0.0013932759803127572
STAT,1920,37,15-19,1957,0.019862442109738174
STAT,1855,40,40-44,1895,1.61452380551793
STAT,1876,24,25-29,1900,55.52222328600734
SIM,1930,25,30-34,1955,53
SIM,1831,38,40-44,1869,5
STAT,1926,34,na,1960,4314.548001702488
SIM,1872,80,na,1952,520
STAT,1901,41,25-29,1942,0.059233606124683626
STAT,1901,21,30-34,1922,23.62503860292185
STAT,1913,47,25-29,1960,0.04891303043189997
STAT,1902,28,45-49,1930,1.475080402006855
SIM,1889,3,na,1892,3194
SIM,1904,35,30-34,1939,2
STAT,1842,41,50-100,1883,0.8017476970646693
SIM,1834,63,na,1897,1083
SIM,1879,27,na,1906,2397
SIM,1910,28,45-49,1938,1
SIM,1927,16,20-24,1943,164
STAT,1825,109,na,1934,3.7813067219031276E-4
STAT,1936,28,15-19,1964,0.6379204610047077
STAT,1823,38,40-44,1861,6.722924825533671
STAT,1856,43,na,1899,1691.257352878874
STAT,1859,15,35-39,1874,0.4845981548841923
STAT,1924,21,25-29,1945,103.27503262939632
SIM,1875,26,25-29,1901,34
SIM,1884,24,25-29,1908,51
SIM,1918,18,20-24,1936,121
STAT,1881,10,na,1891,2363.948349317732
SIM,1798,84,na,1882,88
STAT,1759,101,na,1860,0.05388086879043982
STAT,1815,39,45-49,1854,6.111754430479001
SIM,1794,70,na,1864,543
STAT,1851,53,40-44,1904,0.007451398061116413
STAT,1929,43,20-24,1972,0.021570975276038223
STAT,1921,16,25-29,1937,46.77895058348962
SIM,1876,94,na,1970,88
SIM,1932,21,25-29,1953,110
STAT,1851,98,na,1949,2.3368152313844632
SIM,1870,14,na,1884,2420
STAT,1907,41,40-44,1948,0.2177359585792196
SIM,1932,29,35-39,1961,22
STAT,1919,48,30-34,1967,0.09108932327725093
STAT,1785,89,na,1874,37.48121662921045
STAT,1922,25,30-34,1947,42.169514313528275
STAT,1848,24,na,1872,1906.7901761468493
STAT,1907,17,50-100,1924,0.06798738591044017
SIM,1917,39,na,1956,3632
SIM,1920,22,45-49,1942,1
SIM,1780,89,na,1869,30
STAT,1900,24,40-44,1924,2.7137452572608103
STAT,1940,16,35-39,1956,4.025995711530096
SIM,1913,25,na,1938,3412
STAT,1781,75,na,1856,380.5660890539999
STAT,1859,62,na,1921,1374.2537194122865
SIM,1839,62,na,1901,1241
SIM,1872,39,40-44,1911,7
STAT,1834,49,50-100,1883,0.15755464002475092
SIM,1925,31,35-39,1956,11
STAT,1830,29,na,1859,1697.5170356847148
STAT,1929,30,15-19,1959,0.15437065620670296
SIM,1876,83,na,1959,464
STAT,1909,54,na,1963,3106.020853938277
STAT,1939,28,40-44,1967,4.424511349012416
SIM,1847,81,na,1928,346
STAT,1907,36,45-49,1943,0.5999806416844454
STAT,1905,40,na,1945,3198.8392946547224
SIM,1902,31,40-44,1933,9
STAT,1841,29,45-49,1870,0.9371300006712511
STAT,1929,38,25-29,1967,1.192912774240606
STAT,1822,51,20-24,1873,9.74113160062282E-4
STAT,1921,46,20-24,1967,0.011798322144002307
SIM,1901,22,35-39,1923,8
SIM,1913,21,15-19,1934,3
STAT,1819,49,30-34,1868,0.17795077403663917
STAT,1854,49,25-29,1903,0.040351463180823714
SIM,1860,29,20-24,1889,10
SIM,1898,19,na,1917,3159
STAT,1865,26,15-19,1891,0.3898233363657305
STAT,1876,36,50-100,1912,1.204050229666797
STAT,1910,46,45-49,1956,0.19204472601710576
STAT,1912,22,45-49,1934,1.0187173778721104
SIM,1895,30,35-39,1925,14
SIM,1892,14,na,1906,3388
STAT,1810,52,40-44,1862,0.03358036782651613
STAT,1905,29,25-29,1934,57.34951471725509
SIM,1903,30,45-49,1933,3
STAT,1926,37,50-100,1963,0.48472603459172864
STAT,1899,37,25-29,1936,0.8044057933288447
STAT,1876,31,na,1907,2338.5690137464558
SIM,1929,19,35-39,1948,7
STAT,1852,29,20-24,1881,8.885735277003668
SIM,1809,53,na,1862,1163
STAT,1811,51,45-49,1862,0.047137233147859496
STAT,1938,16,30-34,1954,11.38665308844656
STAT,1940,22,20-24,1962,107.00840721991501
SIM,1843,23,25-29,1866,51
SIM,1923,35,na,1958,4201
SIM,1946,16,30-34,1962,21
STAT,1917,27,15-19,1944,0.699407608376663
STAT,1906,30,20-24,1936,2.1527011133748175
STAT,1884,61,na,1945,1744.0362901733035
STAT,1864,39,40-44,1903,3.648638574280013
SIM,1872,30,40-44,1902,4
SIM,1913,29,25-29,1942,63
STAT,1918,36,20-24,1954,0.26374980574490137
STAT,1905,21,15-19,1926,4.518399199439859
STAT,1888,75,na,1963,1396.6253925443912
STAT,1903,24,50-100,1927,0.5447009920544297
SIM,1877,57,na,1934,1921
SIM,1873,43,na,1916,2185
SIM,1952,16,na,1968,4114
SIM,1933,30,30-34,1963,20
STAT,1902,33,40-44,1935,5.757447374397769
SIM,1853,39,30-34,1892,4
STAT,1838,52,50-100,1890,0.010085507584948123
STAT,1856,19,50-100,1875,0.04219718466262291
SIM,1829,49,50-100,1878,5
SIM,1939,29,45-49,1968,1
STAT,1835,23,25-29,1858,48.08387380940178
STAT,1926,38,20-24,1964,0.30403204032387804
SIM,1903,23,20-24,1926,93
STAT,1846,33,na,1879,1879.9932071105309
STAT,1866,32,na,1898,2079.243692917051
STAT,1884,23,50-100,1907,0.3794231848644468
STAT,1836,40,30-34,1876,0.9086553529705531
STAT,1873,54,30-34,1927,0.005546388915844576
STAT,1845,59,na,1904,1375.251281530765
STAT,1876,42,na,1918,2253.0038622464035
STAT,1830,101,na,1931,0.34439748069375925
STAT,1858,13,na,1871,2056.094840293787
SIM,1847,20,40-44,1867,5
STAT,1901,16,35-39,1917,0.7273630971801341
SIM,1897,56,na,1953,2653
SIM,1893,42,na,1935,2895
STAT,1856,20,40-44,1876,1.8097326018820616
SIM,1885,76,na,1961,1045
SIM,1881,62,na,1943,1392
STAT,1898,25,15-19,1923,0.5839572839102881
SIM,1868,24,40-44,1892,4
STAT,1921,17,15-19,1938,48.869803884479566
SIM,1927,17,na,1944,4304
STAT,1889,27,50-100,1916,0.7460443593378767
STAT,1929,37,35-39,1966,2.9334249164455217
STAT,1946,18,30-34,1964,12.767493999955782
STAT,1915,35,40-44,1950,1.4422224349999075
SIM,1913,36,na,1949,3405
STAT,1893,16,25-29,1909,6.805571049160807
STAT,1935,36,20-24,1971,0.3485389111683591
SIM,1876,30,25-29,1906,9
STAT,1925,30,30-34,1955,17.693951142304034
STAT,1841,51,30-34,1892,0.004123393524920423
SIM,1908,57,na,1965,2925
STAT,1875,39,50-100,1914,1.180157715231441
SIM,1910,33,40-44,1943,8
STAT,1920,40,45-49,1960,0.17412577588345063
STAT,1941,28,45-49,1969,1.6875076414268768
STAT,1895,13,na,1908,3175.684924984886
STAT,1922,39,50-100,1961,0.45035818845967407
SIM,1864,20,40-44,1884,1
SIM,1904,43,na,1947,3182
STAT,1936,27,25-29,1963,59.505730126627036
STAT,1911,31,40-44,1942,3.614751463536969
STAT,1941,23,na,1964,3563.9469759521144
SIM,1825,70,na,1895,779
SIM,1944,27,25-29,1971,65
STAT,1843,25,25-29,1868,35.673822092979755
STAT,1847,50,na,1897,1610.5782481830033
STAT,1881,8,na,1889,2386.6620589086615
STAT,1949,17,45-49,1966,0.5488697043781191
STAT,1839,20,40-44,1859,1.8085167170113778
SIM,1844,40,30-34,1884,1
SIM,1851,25,25-29,1876,37
STAT,1802,86,na,1888,73.48604072229006
STAT,1880,79,na,1959,838.4332564945657
SIM,1845,47,na,1892,1573
STAT,1926,23,na,1949,4178.068458752908
SIM,1841,33,na,1874,1702
SIM,1897,45,na,1942,2945
SIM,1899,35,25-29,1934,2
STAT,1836,49,30-34,1885,0.06394163418624083
SIM,1893,31,na,1924,2975
STAT,1888,42,45-49,1930,1.6688640789428388
STAT,1937,32,15-19,1969,0.12010541117453256
SIM,1864,37,40-44,1901,7
STAT,1950,19,35-39,1969,4.6841271941323654
STAT,1827,62,na,1889,1069.8263828258919
SIM,1940,23,25-29,1963,94
SIM,1910,16,15-19,1926,10
STAT,1905,46,50-100,1951,0.1897111275770127
STAT,1902,20,35-39,1922,7.826465656480105
STAT,1882,52,30-34,1934,0.005439585981779584
SIM,1825,35,25-29,1860,4
STAT,1949,19,na,1968,4041.5174694252833
STAT,1949,22,40-44,1971,3.7065916788342603
STAT,1863,52,20-24,1915,6.084912830640366E-4
SIM,1870,7,na,1877,2504
STAT,1822,85,na,1907,139.29800679907086
STAT,1808,70,na,1878,710.6764166568416
STAT,1826,99,na,1925,1.0342083861390354
SIM,1913,57,na,1970,3117
SIM,1928,28,30-34,1956,54
STAT,1862,30,30-34,1892,14.215895547741711
STAT,1921,20,45-49,1941,1.2077385568966696
SIM,1880,13,na,1893,2627
STAT,1894,20,25-29,1914,69.9136747796982
SIM,1765,89,na,1854,28
STAT,1826,39,20-24,1865,0.7885831536371722
STAT,1919,6,na,1925,4184.280346052076
STAT,1931,19,25-29,1950,53.29617346233552
STAT,1939,32,25-29,1971,8.908927503221173
STAT,1822,42,50-100,1864,1.5376099870422304
STAT,1919,34,50-100,1953,0.8354664744126606
STAT,1847,41,45-49,1888,1.1240982838449984
STAT,1884,26,25-29,1910,39.61628009506799
STAT,1910,32,50-100,1942,0.7531384372007229
SIM,1862,70,na,1932,1192
SIM,1862,3,na,1865,2620
STAT,1867,17,35-39,1884,0.4976023189777803
STAT,1813,49,na,1862,1235.646968710859
STAT,1944,26,20-24,1970,18.646126887088744
SIM,1892,26,25-29,1918,62
SIM,1920,19,15-19,1939,40
SIM,1919,17,25-29,1936,49
STAT,1914,54,na,1968,3352.2704278095603
STAT,1927,37,25-29,1964,1.1564382141846117
SIM,1923,35,40-44,1958,4
STAT,1912,19,15-19,1931,8.623293420078195
SIM,1890,27,40-44,1917,4
SIM,1910,20,35-39,1930,8
STAT,1901,40,35-39,1941,0.16795784729050406
STAT,1932,23,25-29,1955,114.13902692855115
STAT,1802,53,45-49,1855,0.04164247932153329
STAT,1902,16,15-19,1918,7.931561980643956
STAT,1910,40,na,1950,3353.5301864487387
STAT,1863,32,50-100,1895,0.759583407440831
STAT,1845,39,30-34,1884,3.881093359711272
STAT,1929,18,30-34,1947,14.656103336702264
SIM,1866,84,na,1950,251
SIM,1834,25,25-29,1859,39
SIM,1938,17,35-39,1955,7
SIM,1900,25,45-49,1925,1
STAT,1898,42,na,1940,2961.2882240337276
SIM,1827,82,na,1909,235
SIM,1938,22,30-34,1960,30
SIM,1858,65,na,1923,1371
SIM,1922,23,30-34,1945,37
STAT,1879,82,na,1961,647.4577669148038
SIM,1855,41,45-49,1896,4
SIM,1854,51,na,1905,1753
SIM,1779,92,na,1871,5
STAT,1862,48,20-24,1910,0.009570834639581189
STAT,1846,29,50-100,1875,0.5657692768056596
STAT,1899,59,na,1958,2578.7036920029386
SIM,1937,18,30-34,1955,16
STAT,1920,21,40-44,1941,3.541899867483436
STAT,1879,37,50-100,1916,1.2140819093756348
STAT,1901,48,45-49,1949,0.1738230917470796
STAT,1859,43,50-100,1902,0.7885980534476106
SIM,1912,37,30-34,1949,1
STAT,1923,17,25-29,1940,48.07103099283399
SIM,1864,16,20-24,1880,13
SIM,1914,33,25-29,1947,11
STAT,1880,25,50-100,1905,0.6414141915433146
SIM,1789,70,na,1859,541
SIM,1858,34,25-29,1892,11
STAT,1821,47,20-24,1868,0.018929329155676893
SIM,1911,32,45-49,1943,1
STAT,1905,26,20-24,1931,16.074204758742145
SIM,1885,41,30-34,1926,4
SIM,1867,58,na,1925,1912
SIM,1863,44,na,1907,1895
STAT,1768,101,na,1869,0.08942953041434566
STAT,1882,27,40-44,1909,2.7520705779443975
STAT,1872,28,na,1900,2253.4549637755317
SIM,1823,36,40-44,1859,3
STAT,1837,20,30-34,1857,15.721953970747208
SIM,1930,28,35-39,1958,16
STAT,1934,27,15-19,1961,0.8971546595337847
STAT,1919,19,25-29,1938,44.99778886684376
STAT,1873,98,na,1971,21.08929555351273
SIM,1801,68,na,1869,707
STAT,1905,45,25-29,1950,0.04480886225870162
SIM,1892,46,na,1938,2987
SIM,1820,71,na,1891,671
STAT,1900,36,35-39,1936,2.010282016537377
STAT,1856,16,20-24,1872,15.542784163420684
SIM,1924,27,35-39,1951,27
STAT,1906,33,25-29,1939,8.057959526703026
STAT,1948,18,40-44,1966,1.5117437939486884
STAT,1911,27,20-24,1938,16.817592535407854
SIM,1935,18,20-24,1953,172
STAT,1951,20,30-34,1971,32.46179360588434
SIM,1952,7,na,1959,4389
STAT,1849,84,na,1933,249.45348351390862
STAT,1845,16,45-49,1861,0.058769364106991476
SIM,1912,20,45-49,1932,1
STAT,1861,42,45-49,1903,1.1741442721210358
STAT,1950,16,na,1966,4112.710928581058
SIM,1924,28,50-100,1952,1
STAT,1879,16,15-19,1895,5.882931367918223
STAT,1845,70,na,1915,992.8557723928442
STAT,1922,28,35-39,1950,15.992683189053242
SIM,1886,20,40-44,1906,2
SIM,1907,15,40-44,1922,2
STAT,1825,38,50-100,1863,1.4782186894935823
STAT,1843,39,20-24,1882,0.5417594380070572
STAT,1881,30,40-44,1911,3.9895283487116906
STAT,1910,22,35-39,1932,8.353650655115777
STAT,1904,21,50-100,1925,0.5542472876023906
SIM,1886,61,na,1947,1788
SIM,1865,24,15-19,1889,2
STAT,1853,15,40-44,1868,0.16848960582786646
SIM,1931,17,25-29,1948,60
SIM,1933,24,45-49,1957,1
STAT,1947,22,30-34,1969,30.68740832843604
SIM,1898,27,30-34,1925,34
SIM,1912,21,50-100,1933,3
STAT,1924,15,50-100,1939,0.42342609947380827
STAT,1857,24,15-19,1881,2.545259332521227
SIM,1893,10,na,1903,3242
STAT,1957,7,na,1964,4894.88692255562
STAT,1897,27,50-100,1924,0.808176092987237
STAT,1902,21,na,1923,3162.676807537658
SIM,1897,24,na,1921,3028
SIM,1892,57,na,1949,2651
SIM,1918,34,20-24,1952,5
STAT,1872,43,50-100,1915,0.9938382769554504
STAT,1903,32,45-49,1935,2.3439625251680596
STAT,1915,40,15-19,1955,0.0014646620929116604
STAT,1906,35,na,1941,3298.20531831444
STAT,1871,54,20-24,1925,6.731860942445937E-4
STAT,1873,49,35-39,1922,0.13133536824171946
SIM,1904,19,30-34,1923,4
STAT,1876,20,30-34,1896,17.488601872918743
STAT,1897,17,20-24,1914,22.397914217169262
STAT,1919,53,na,1972,3684.2844294335982
SIM,1923,19,40-44,1942,1
STAT,1931,35,25-29,1966,1.2339793072839393
STAT,1865,52,30-34,1917,0.0050698330442572855
STAT,1921,49,25-29,1970,0.05616037661845047
SIM,1835,26,na,1861,1765
STAT,1885,20,50-100,1905,0.38628433888194197
STAT,1900,27,45-49,1927,1.4550572037703158
STAT,1806,100,na,1906,0.36816093720650134
STAT,1912,35,15-19,1947,0.017874961586663483
STAT,1928,39,20-24,1967,0.3140445582791906
STAT,1832,100,na,1932,0.639536471914101
SIM,1838,66,na,1904,1070
STAT,1889,60,na,1949,2224.257569249079
SIM,1857,80,na,1937,394
STAT,1843,28,50-100,1871,0.5279313132183777
STAT,1820,41,45-49,1861,2.837497135191861
SIM,1933,24,na,1957,4621
STAT,1827,108,na,1935,0.0010580616601582476
STAT,1848,21,45-49,1869,0.6354637759167164
SIM,1914,24,35-39,1938,10
SIM,1880,43,50-100,1923,1
STAT,1832,48,35-39,1880,0.09876346087384838
STAT,1902,49,15-19,1951,2.9454025449352536E-4
SIM,1904,38,35-39,1942,7
STAT,1908,37,15-19,1945,0.01698553105096882
STAT,1836,66,na,1902,1061.3681767618923
STAT,1901,58,na,1959,2697.133121414034
STAT,1916,27,35-39,1943,14.664960671957605
STAT,1838,25,na,1863,1874.2242274627347
STAT,1838,49,40-44,1887,0.11525627862663367
STAT,1851,15,50-100,1866,0.04335701748156552
STAT,1847,26,50-100,1873,0.5710762379570864
SIM,1854,29,na,1883,1981
SIM,1850,15,na,1865,2168
SIM,1946,19,35-39,1965,3
STAT,1915,19,40-44,1934,0.27507556889723966
STAT,1916,28,50-100,1944,0.9688166341389884
STAT,1925,38,na,1963,4261.31551738244
SIM,1913,26,20-24,1939,23
STAT,1926,45,45-49,1971,0.2545240878235571
SIM,1859,22,25-29,1881,51
STAT,1921,41,15-19,1962,0.0016363654580812828
STAT,1936,31,45-49,1967,1.4447003878376594
STAT,1817,52,na,1869,1242.6487363027766
SIM,1840,30,45-49,1870,1
STAT,1842,51,na,1893,1566.746500783731
STAT,1930,27,30-34,1957,47.06596972834338
STAT,1927,18,20-24,1945,158.82858940284544
SIM,1788,85,na,1873,79
STAT,1921,24,na,1945,3872.127707145677
SIM,1838,77,na,1915,528
SIM,1867,47,na,1914,2168
STAT,1855,80,na,1935,439.59102708261355
STAT,1906,24,35-39,1930,7.978795938079627
STAT,1941,25,40-44,1966,4.558995937646613
STAT,1859,94,na,1953,15.02734240321917
STAT,1811,90,na,1901,34.19257762943277
STAT,1817,63,na,1880,948.4268439925029
SIM,1871,84,na,1955,276
SIM,1784,71,na,1855,489
SIM,1842,15,30-34,1857,5
STAT,1822,54,25-29,1876,0.004404754554359254
STAT,1866,30,15-19,1896,0.12508023775259175
STAT,1931,39,40-44,1970,1.868898459018282
STAT,1832,30,45-49,1862,1.4070794891641667
SIM,1837,21,35-39,1858,5
STAT,1854,48,50-100,1902,0.17351515432027412
STAT,1891,16,15-19,1907,6.953227000204364
STAT,1877,41,30-34,1918,1.131697335070718
SIM,1849,27,35-39,1876,12
STAT,1841,26,40-44,1867,2.583600242870734
STAT,1880,30,50-100,1910,0.9198558606708639
STAT,1772,115,na,1887,1.6580019279517817E-4
STAT,1955,15,na,1970,4617.94092183106
STAT,1850,15,15-19,1865,5.172808752425583
SIM,1883,16,30-34,1899,2
STAT,1936,24,20-24,1960,100.35698629830934
SIM,1912,17,15-19,1929,7
STAT,1859,40,25-29,1899,0.4877037339461975
STAT,1830,24,50-100,1854,0.9024935487027471
SIM,1819,63,na,1882,957
STAT,1920,17,50-100,1937,0.3970907439053935
SIM,1788,74,na,1862,432
STAT,1850,81,na,1931,381.1975451439996
SIM,1858,38,40-44,1896,5
SIM,1897,15,20-24,1912,21
STAT,1789,109,na,1898,1.5720193917817543E-4
STAT,1841,54,35-39,1895,0.005771974302686106
STAT,1942,17,35-39,1959,4.142649484092796
SIM,1886,24,35-39,1910,11
STAT,1859,21,20-24,1880,59.503562175343106
STAT,1896,41,40-44,1937,0.19576318203442256
STAT,1925,33,35-39,1958,10.244977688420008
SIM,1931,37,40-44,1968,3
STAT,1867,25,50-100,1892,0.5713068950262531
SIM,1933,33,35-39,1966,16
STAT,1875,16,30-34,1891,1.5514717224735513
SIM,1855,14,na,1869,2280
STAT,1904,17,15-19,1921,8.041651005091428
SIM,1859,28,na,1887,1928
SIM,1881,31,45-49,1912,2
STAT,1905,49,40-44,1954,0.12911395010593657
STAT,1923,37,40-44,1960,1.6385906910172248
STAT,1941,30,15-19,1971,0.1276017923373997
STAT,1932,20,20-24,1952,138.64925135222308
SIM,1903,26,25-29,1929,61
SIM,1939,30,25-29,1969,13
STAT,1854,95,na,1949,9.512758563119768
SIM,1944,24,20-24,1968,113
SIM,1848,15,25-29,1863,6
STAT,1820,38,15-19,1858,0.12152233478053076
SIM,1821,34,na,1855,1525
SIM,1774,93,na,1867,6
SIM,1953,8,na,1961,4443
STAT,1822,37,50-100,1859,2.16105559382671
STAT,1878,24,35-39,1902,5.709184698770788
STAT,1889,15,20-24,1904,20.77204961963605
SIM,1825,48,na,1873,1413
STAT,1907,42,30-34,1949,0.11065328366724447
SIM,1863,45,50-100,1908,2
SIM,1905,27,25-29,1932,50
STAT,1829,50,40-44,1879,0.008648089326263849
STAT,1833,52,35-39,1885,0.0054437850710026565
SIM,1929,16,30-34,1945,15
STAT,1924,29,35-39,1953,16.395609401900987
SIM,1914,10,na,1924,3901
SIM,1918,24,na,1942,3707
STAT,1901,45,40-44,1946,0.12897306325128213
SIM,1868,43,na,1911,2069
SIM,1867,21,20-24,1888,60
SIM,1805,71,na,1876,565
SIM,1839,51,na,1890,1453
STAT,1855,45,50-100,1900,0.1762699002294024
STAT,1915,44,30-34,1959,0.12119101230143041
SIM,1809,85,na,1894,118
STAT,1938,19,35-39,1957,3.907771742278309
SIM,1904,15,15-19,1919,9
STAT,1917,39,45-49,1956,0.6648622053276877
STAT,1890,46,na,1936,2606.3512816511547
STAT,1795,99,na,1894,0.3944454556887409
STAT,1915,38,45-49,1953,0.6473730439596819
SIM,1813,90,na,1903,38
SIM,1869,40,35-39,1909,1
SIM,1940,20,20-24,1960,96
SIM,1868,27,45-49,1895,2
SIM,1838,26,20-24,1864,10
STAT,1935,16,na,1951,4765.180570213774
STAT,1917,31,35-39,1948,9.077120661420151
STAT,1897,38,40-44,1935,5.503028844266305
SIM,1914,21,na,1935,3545
STAT,1854,107,na,1961,0.011935567431519925
STAT,1868,26,40-44,1894,2.7092936847878435
SIM,1903,58,na,1961,2773
SIM,1918,35,na,1953,3776
STAT,1813,48,25-29,1861,0.1549160079356082
STAT,1911,34,45-49,1945,1.4352057324523804
STAT,1924,41,40-44,1965,0.28145918668473197
SIM,1889,16,25-29,1905,7
SIM,1960,0,na,1960,4864
STAT,1933,32,30-34,1965,20.057798350652885
STAT,1931,16,20-24,1947,168.04941894205626
STAT,1874,83,na,1957,443.0313120473558
SIM,1887,46,na,1933,2340
SIM,1916,21,40-44,1937,3
STAT,1823,48,na,1871,1376.3064612006178
STAT,1903,25,20-24,1928,15.875837764572294
SIM,1906,31,25-29,1937,15
STAT,1829,41,50-100,1870,0.9153979866746093
STAT,1880,39,25-29,1919,2.838632802585563
SIM,1814,86,na,1900,74
SIM,1900,34,35-39,1934,13
SIM,1870,30,30-34,1900,16
STAT,1914,32,20-24,1946,2.319531591578263
STAT,1830,53,20-24,1883,4.767678059220592E-4
SIM,1840,48,na,1888,1471
SIM,1899,39,40-44,1938,1
STAT,1858,36,25-29,1894,2.1428321745258048
STAT,1918,43,45-49,1961,0.16690238146745595
STAT,1943,29,45-49,1972,1.7364409649787298
SIM,1793,85,na,1878,79
STAT,1849,26,30-34,1875,22.5460248765093
STAT,1873,31,45-49,1904,1.6776091465768588
STAT,1907,17,40-44,1924,0.2538196357882307
SIM,1853,66,na,1919,1266
SIM,1927,19,25-29,1946,64
SIM,1857,102,na,1959,3
STAT,1937,19,50-100,1956,0.34329952103370776
SIM,1911,25,20-24,1936,15
STAT,1839,95,na,1934,8.852146041079532
STAT,1835,81,na,1916,344.1836188957488
STAT,1890,29,40-44,1919,3.4350462553768635
SIM,1948,16,40-44,1964,1
SIM,1922,32,20-24,1954,2
STAT,1892,37,50-100,1929,1.4527270093791036
SIM,1856,95,na,1951,5
SIM,1852,81,na,1933,348
SIM,1908,19,15-19,1927,5
STAT,1913,28,20-24,1941,17.122592309242876
STAT,1804,101,na,1905,0.1911397955714086
STAT,1837,51,na,1888,1430.4885926947095
STAT,1908,21,40-44,1929,2.92904999306817
SIM,1858,30,30-34,1888,22
SIM,1879,27,20-24,1906,12
STAT,1851,66,na,1917,1179.01040845074
STAT,1871,29,30-34,1900,23.453608582478076
STAT,1904,37,30-34,1941,1.5587790234515495
STAT,1943,21,35-39,1964,9.46694016485453
SIM,1834,22,20-24,1856,51
SIM,1864,23,45-49,1887,1
STAT,1965,0,na,1965,4670.421750540886
STAT,1868,48,15-19,1916,3.5600638820940654E-4
SIM,1814,40,45-49,1854,2
STAT,1839,36,15-19,1875,0.04514500725369724
SIM,1813,44,50-100,1857,1
SIM,1941,26,45-49,1967,1
STAT,1923,42,15-19,1965,0.0016956124674245747
STAT,1772,93,na,1865,5.699641011359906
STAT,1861,17,40-44,1878,0.16512975213344314
STAT,1861,39,15-19,1900,0.043664751995598904
STAT,1869,30,40-44,1899,4.000819906867041
STAT,1889,38,na,1927,2734.041389111952
SIM,1857,26,30-34,1883,27
SIM,1883,32,na,1915,2225
STAT,1893,75,na,1968,1595.0218521658906
STAT,1916,24,na,1940,3592.3243614529088
SIM,1859,39,na,1898,1873
SIM,1888,40,45-49,1928,3
STAT,1878,21,30-34,1899,17.589504081424202
STAT,1869,61,na,1930,1710.1555607148366
STAT,1857,28,na,1885,1818.3262300822662
STAT,1856,23,45-49,1879,0.592653955509083
STAT,1912,10,na,1922,3784.208344848993
STAT,1933,26,45-49,1959,2.168020060357388
SIM,1929,35,35-39,1964,6
STAT,1868,22,50-100,1890,0.3675586694851539
STAT,1878,15,45-49,1893,0.06461015167261244
STAT,1885,24,na,1909,2213.0912012881813
SIM,1950,17,35-39,1967,6
STAT,1852,31,25-29,1883,7.768725678471274
STAT,1853,14,na,1867,2153.596137423161
SIM,1881,16,20-24,1897,8
STAT,1900,21,15-19,1921,4.336438413009249
STAT,1835,27,40-44,1862,2.484822752563821
SIM,1855,39,40-44,1894,3
SIM,1894,22,40-44,1916,2
SIM,1909,42,na,1951,3336
SIM,1933,22,30-34,1955,40
STAT,1864,94,na,1958,25.069633028487267
STAT,1850,23,15-19,1873,2.771216936951042
STAT,1875,36,25-29,1911,2.8091987663941356
SIM,1802,85,na,1887,83
SIM,1897,23,20-24,1920,95
STAT,1822,38,25-29,1860,4.799375075950016
SIM,1764,94,na,1858,3
STAT,1805,83,na,1888,146.10500985821358
SIM,1847,59,na,1906,1480
SIM,1866,30,na,1896,2124
SIM,1830,38,25-29,1868,1
STAT,1858,27,35-39,1885,7.316129196246704
STAT,1822,53,na,1875,1201.9558722527354
STAT,1905,18,na,1923,3439.665416591523
STAT,1913,37,na,1950,3507.556254218821
STAT,1854,29,30-34,1883,18.6177173338403
STAT,1856,37,40-44,1893,3.2265601368920667
STAT,1898,21,20-24,1919,88.36506221519453
SIM,1934,37,50-100,1971,1
SIM,1920,49,50-100,1969,4
STAT,1814,42,45-49,1856,5.303237792408289
SIM,1855,78,na,1933,564
SIM,1858,11,na,1869,2284
SIM,1866,27,35-39,1893,8
SIM,1890,39,35-39,1929,16
STAT,1849,21,25-29,1870,52.27494637589313
SIM,1935,30,40-44,1965,7
STAT,1889,23,20-24,1912,80.12118931636246
SIM,1885,44,35-39,1929,5
STAT,1856,75,na,1931,758.7936414661434
SIM,1857,21,25-29,1878,53
STAT,1881,64,na,1945,1586.4371877384663
STAT,1864,48,30-34,1912,0.080478782259494
SIM,1848,23,25-29,1871,52
STAT,1861,37,50-100,1898,0.9643761559331585
STAT,1877,44,35-39,1921,1.7505270316661397
SIM,1848,36,30-34,1884,7
SIM,1929,33,20-24,1962,2
STAT,1942,29,15-19,1971,0.6992724267879967
STAT,1873,16,20-24,1889,17.086602578639102
SIM,1787,89,na,1876,18
SIM,1922,30,50-100,1952,3
STAT,1817,43,25-29,1860,1.5679760900822386
STAT,1945,21,45-49,1966,1.1653548671232759
SIM,1846,15,15-19,1861,5
STAT,1867,25,35-39,1892,8.617422134499
STAT,1883,65,na,1948,1565.26587201225
SIM,1918,33,45-49,1951,1
SIM,1883,36,25-29,1919,2
STAT,1882,26,15-19,1908,0.41825392224059255
SIM,1826,48,50-100,1874,2
SIM,1839,30,20-24,1869,2
SIM,1872,48,na,1920,2084
SIM,1822,42,45-49,1864,3
SIM,1865,48,50-100,1913,3
STAT,1892,33,20-24,1925,3.1848978776653847
SIM,1830,92,na,1922,23
SIM,1920,39,30-34,1959,9
STAT,1871,38,20-24,1909,0.7195253530194288
STAT,1869,52,50-100,1921,0.01374829605946232
SIM,1901,31,25-29,1932,23
SIM,1863,97,na,1960,5
STAT,1894,38,15-19,1932,0.06783627054741438
STAT,1871,32,na,1903,2238.5322958348233
STAT,1818,49,15-19,1867,8.275123752237428E-4
STAT,1845,48,na,1893,1572.0480265139622
STAT,1864,19,50-100,1883,0.04217078646842672
STAT,1884,34,25-29,1918,9.477789029356613
SIM,1926,22,na,1948,4088
STAT,1848,42,15-19,1890,0.010248871117686683
STAT,1856,65,na,1921,1245.63385036608
STAT,1827,47,15-19,1874,3.6587392771622677E-4
SIM,1832,83,na,1915,207
STAT,1825,42,20-24,1867,0.17292168783553868
SIM,1938,31,20-24,1969,5
SIM,1910,39,na,1949,3367
STAT,1865,17,25-29,1882,5.000132446472484
STAT,1875,24,30-34,1899,17.187712378120857
STAT,1890,25,na,1915,2775.0527649624296
SIM,1879,80,na,1959,688
SIM,1889,24,25-29,1913,75
SIM,1909,52,na,1961,3184
STAT,1880,19,30-34,1899,1.5788772968730653
SIM,1838,98,na,1936,2
STAT,1944,27,50-100,1971,1.0162781778249648
SIM,1887,16,15-19,1903,4
SIM,1832,26,40-44,1858,2
SIM,1925,23,35-39,1948,15
SIM,1927,31,45-49,1958,2
STAT,1916,24,30-34,1940,28.273165682990683
STAT,1918,32,40-44,1950,3.928506711982216
STAT,1870,15,na,1885,2391.0140730988896
STAT,1930,39,50-100,1969,0.516244964509712
STAT,1790,90,na,1880,28.49843893497344
STAT,1837,22,45-49,1859,0.5924449704825778
STAT,1912,39,30-34,1951,1.6636220558201478
SIM,1879,36,50-100,1915,3
STAT,1855,106,na,1961,0.028664612111885604
SIM,1811,49,50-100,1860,4
STAT,1861,19,20-24,1880,15.81779736534773
STAT,1950,16,30-34,1966,13.619208644275528
SIM,1902,23,40-44,1925,2
SIM,1905,24,20-24,1929,80
STAT,1815,48,35-39,1863,0.3104577845226753
STAT,1778,111,na,1889,0.0011495162307622049
STAT,1830,37,20-24,1867,0.6264438345876352
SIM,1942,20,30-34,1962,38
STAT,1889,43,15-19,1932,0.01598943637166997
STAT,1788,86,na,1874,63.5087780075821
STAT,1858,46,50-100,1904,0.1824278498101824
STAT,1900,62,na,1962,2546.5195531589848
SIM,1942,15,35-39,1957,4
STAT,1835,28,na,1863,1781.5098652941124
SIM,1825,37,50-100,1862,2
SIM,1855,26,20-24,1881,9
STAT,1899,28,35-39,1927,12.445635506324601
STAT,1837,29,na,1866,1776.142323504543
STAT,1856,97,na,1953,3.9597605167597805
STAT,1925,42,25-29,1967,0.08167099977732574
SIM,1865,20,20-24,1885,73
STAT,1939,24,25-29,1963,87.57562537196988
STAT,1863,39,25-29,1902,2.362881118446042
STAT,1849,34,30-34,1883,13.512652862748117
STAT,1853,37,15-19,1890,0.042497554956827714
STAT,1866,43,20-24,1909,0.13737757453279387
STAT,1876,23,35-39,1899,5.677857590442805
SIM,1926,32,40-44,1958,6
STAT,1919,31,45-49,1950,1.6103667600153746
STAT,1934,15,35-39,1949,5.386705279635867
SIM,1907,32,30-34,1939,19
STAT,1891,17,40-44,1908,0.2137736626979971
STAT,1841,25,15-19,1866,0.394137195111881
SIM,1888,25,20-24,1913,16
STAT,1886,22,40-44,1908,2.07945449078425
STAT,1847,39,40-44,1886,3.2803589772401462
SIM,1906,20,20-24,1926,79
STAT,1850,49,40-44,1899,0.11816311675906378
STAT,1870,15,40-44,1885,0.1731559728149643
STAT,1915,15,25-29,1930,8.608190635119813
SIM,1849,50,na,1899,1663
STAT,1836,26,45-49,1862,0.937090666744866
STAT,1935,27,45-49,1962,2.2247065170194964
STAT,1777,111,na,1888,0.0010950332628770496
SIM,1785,88,na,1873,39
STAT,1853,23,40-44,1876,1.8499351157877173
SIM,1876,26,40-44,1902,3
SIM,1929,20,15-19,1949,5
SIM,1843,27,40-44,1870,4
STAT,1843,47,na,1890,1512.5628492450724
STAT,1917,23,35-39,1940,9.424797341117742
STAT,1882,39,35-39,1921,6.432602122918488
STAT,1859,30,na,1889,1820.381621731372
STAT,1847,26,20-24,1873,10.473085485246404
STAT,1765,91,na,1856,11.890494575999998
STAT,1873,45,na,1918,2177.095460469551
SIM,1909,40,40-44,1949,1
SIM,1860,47,na,1907,1872
SIM,1947,24,25-29,1971,98
STAT,1843,33,25-29,1876,8.231248746781546
SIM,1877,25,45-49,1902,1
STAT,1848,78,na,1926,580.5755367143363
SIM,1861,23,40-44,1884,2
STAT,1934,20,30-34,1954,36.60787916176644
SIM,1827,31,40-44,1858,7
SIM,1851,33,25-29,1884,11
SIM,1889,37,30-34,1926,6
SIM,1923,15,25-29,1938,53
SIM,1830,70,na,1900,804
SIM,1804,86,na,1890,72
STAT,1798,86,na,1884,73.58765227546971
SIM,1924,24,30-34,1948,38
STAT,1805,51,na,1856,1233.7897398039497
STAT,1900,23,50-100,1923,0.5327598229485365
STAT,1944,25,45-49,1969,1.7654722534747556
STAT,1871,64,na,1935,1630.705874214364
STAT,1927,25,45-49,1952,1.9975445316127056
SIM,1838,21,15-19,1859,3
SIM,1868,11,na,1879,2406
STAT,1938,20,15-19,1958,4.980508117617693
SIM,1849,32,30-34,1881,20
STAT,1813,70,na,1883,690.6801915620402
STAT,1880,21,35-39,1901,5.829304240948218
SIM,1925,36,40-44,1961,1
SIM,1933,7,na,1940,5122
STAT,1868,21,35-39,1889,5.297802164251642
SIM,1881,4,na,1885,2088
STAT,1886,17,45-49,1903,0.06518600639597542
SIM,1911,21,40-44,1932,2
SIM,1933,26,50-100,1959,1
SIM,1866,32,30-34,1898,28
SIM,1890,77,na,1967,1439
SIM,1843,77,na,1920,591
SIM,1916,30,30-34,1946,12
STAT,1767,102,na,1869,0.07078734642939352
STAT,1924,30,15-19,1954,0.14226828803407296
SIM,1867,23,35-39,1890,7
SIM,1882,24,15-19,1906,8
STAT,1896,44,45-49,1940,0.12792132996440286
SIM,1819,39,30-34,1858,6
STAT,1850,19,45-49,1869,0.05560824290321999
STAT,1839,27,25-29,1866,35.4805821381905
STAT,1865,22,20-24,1887,59.72472323266852
SIM,1847,27,25-29,1874,38
STAT,1930,39,na,1969,4625.925131492427
STAT,1820,72,na,1892,665.3027388411614
STAT,1829,53,45-49,1882,0.010222178917418051
STAT,1835,29,20-24,1864,9.592009565648441
STAT,1909,37,45-49,1946,0.6096075086280268
STAT,1947,23,20-24,1970,118.68483998918903
STAT,1808,48,na,1856,1286.884266052729
STAT,1868,76,na,1944,853.934813420936
STAT,1873,77,na,1950,828.1866241461241
STAT,1844,39,15-19,1883,0.040365926962828924
STAT,1915,18,na,1933,3808.839132730318
SIM,1946,20,15-19,1966,8
SIM,1893,26,40-44,1919,5
SIM,1935,25,45-49,1960,3
SIM,1856,22,20-24,1878,64
STAT,1796,73,na,1869,493.68076125497004
STAT,1851,35,25-29,1886,2.137236867781828
STAT,1847,29,na,1876,1889.9280847440011
STAT,1917,36,40-44,1953,1.4759653006163556
SIM,1826,29,20-24,1855,7
STAT,1903,21,40-44,1924,2.8094126725350237
SIM,1817,37,40-44,1854,8
SIM,1897,27,50-100,1924,1
STAT,1860,27,na,1887,1848.8934505607133
SIM,1932,26,30-34,1958,49
STAT,1859,39,45-49,1898,1.483798160491343
SIM,1870,67,na,1937,1428
SIM,1855,46,na,1901,1815
SIM,1882,15,25-29,1897,5
SIM,1772,91,na,1863,9
SIM,1826,35,40-44,1861,2
STAT,1876,28,40-44,1904,2.9133933720795775
SIM,1904,21,50-100,1925,1
STAT,1828,39,30-34,1867,4.654028063755041
SIM,1889,80,na,1969,1051
STAT,1839,44,15-19,1883,0.009445509380614912
STAT,1858,32,30-34,1890,12.932089212988874
SIM,1843,29,20-24,1872,9
SIM,1898,22,25-29,1920,83
SIM,1903,22,45-49,1925,4
SIM,1857,34,30-34,1891,17
STAT,1834,48,45-49,1882,0.15334827627237058
STAT,1924,26,30-34,1950,43.24540120075166
SIM,1927,34,50-100,1961,5
SIM,1836,24,45-49,1860,1
STAT,1848,22,20-24,1870,62.34852481070001
SIM,1919,52,na,1971,3748
STAT,1857,20,20-24,1877,60.13413486270956
STAT,1899,45,25-29,1944,0.04247597932965606
STAT,1891,24,15-19,1915,3.8316991719897353
SIM,1884,28,40-44,1912,3
SIM,1833,25,30-34,1858,33
STAT,1929,22,15-19,1951,6.359077714831682
SIM,1858,4,na,1862,2402
STAT,1865,58,na,1923,1693.3498405171547
STAT,1874,15,25-29,1889,5.515579247528614
STAT,1876,95,na,1971,67.3796512122921
SIM,1836,39,30-34,1875,4
STAT,1812,53,na,1865,1208.0898290661269
STAT,1885,26,40-44,1911,2.8304335696204057
STAT,1824,33,15-19,1857,0.30257596450110447
SIM,1862,48,na,1910,1884
SIM,1937,22,15-19,1959,4
STAT,1923,37,na,1960,4118.074542296074
SIM,1850,47,na,1897,1676
SIM,1883,10,na,1893,2413
SIM,1877,42,35-39,1919,2
SIM,1886,31,50-100,1917,4
SIM,1946,20,na,1966,3706
STAT,1894,16,40-44,1910,0.22259872687785245
STAT,1845,81,na,1926,382.660559634584
SIM,1858,33,35-39,1891,10
STAT,1828,30,50-100,1858,1.0249629644639167
SIM,1869,60,na,1929,1725
STAT,1899,25,30-34,1924,32.81665736892399
STAT,1860,70,na,1930,1075.4699535023917
STAT,1814,42,50-100,1856,3.743461960384362
STAT,1904,20,45-49,1924,0.9505479311258097
STAT,1954,16,15-19,1970,53.01216729967021
STAT,1868,98,na,1966,12.739033142339734
STAT,1877,27,45-49,1904,1.0880245020261279
SIM,1886,44,50-100,1930,1
STAT,1880,25,na,1905,2392.946831325448
STAT,1938,33,20-24,1971,2.3155449028144854
SIM,1916,22,na,1938,3568
STAT,1855,15,15-19,1870,5.075612973613446
STAT,1915,1,na,1916,4115.60010617506
STAT,1886,4,na,1890,2625.190633165184
SIM,1873,17,25-29,1890,10
SIM,1917,37,45-49,1954,1
SIM,1852,25,40-44,1877,3
STAT,1805,73,na,1878,535.1599352219877
STAT,1903,59,na,1962,2753.4499636202345
STAT,1800,54,50-100,1854,0.04227668908149306
STAT,1835,49,15-19,1884,2.615617640861543E-4
STAT,1855,26,na,1881,1780.505172342097
STAT,1875,49,45-49,1924,0.2243747879629922
SIM,1862,29,30-34,1891,24
STAT,1840,32,45-49,1872,1.393867190102146
SIM,1836,43,50-100,1879,3
STAT,1850,41,50-100,1891,0.7480873108011947
STAT,1953,15,45-49,1968,0.5711536926579621
STAT,1881,33,45-49,1914,1.5847076612156568
STAT,1929,20,na,1949,4388.467609252879
SIM,1835,25,40-44,1860,3
STAT,1844,25,40-44,1869,2.5838418424966725
STAT,1932,20,50-100,1952,0.8204584060997779
SIM,1818,36,45-49,1854,2
STAT,1917,40,25-29,1957,0.07059649668559953
STAT,1908,30,30-34,1938,14.162407939962815
SIM,1868,32,40-44,1900,4
SIM,1842,28,na,1870,1817
STAT,1895,15,45-49,1910,0.0808248997025506
SIM,1910,1,na,1911,3808
SIM,1911,28,25-29,1939,61
STAT,1890,38,30-34,1928,6.12494897593112
STAT,1856,49,35-39,1905,0.10103634487201096
SIM,1863,37,25-29,1900,2
SIM,1863,15,15-19,1878,5
SIM,1879,22,15-19,1901,3
STAT,1949,21,15-19,1970,5.870102576368519
STAT,1930,17,na,1947,4495.3742108060005
SIM,1856,10,na,1866,2266
SIM,1876,21,35-39,1897,10
SIM,1916,25,35-39,1941,20
SIM,1845,29,30-34,1874,26
STAT,1834,35,25-29,1869,2.2692112931496546
STAT,1927,30,40-44,1957,4.552681577479085
STAT,1884,31,20-24,1915,2.5331305640201465
STAT,1948,22,25-29,1970,100.19564943478578
STAT,1869,42,35-39,1911,1.655197335992082
SIM,1873,27,40-44,1900,6
STAT,1869,6,na,1875,2543.730741397013
STAT,1823,47,30-34,1870,0.11922945953748623
STAT,1880,48,15-19,1928,3.933680311513775E-4
STAT,1903,28,25-29,1931,56.659404463265744
SIM,1842,18,na,1860,2028
STAT,1845,24,45-49,1869,0.6038148791968377
STAT,1855,16,na,1871,1951.6479153023984
STAT,1867,22,30-34,1889,15.865978463430478
SIM,1898,35,30-34,1933,14
STAT,1943,26,40-44,1969,4.691617360981981
STAT,1910,31,25-29,1941,8.453654895588699
STAT,1837,29,30-34,1866,20.676381475117775
SIM,1842,35,25-29,1877,2
STAT,1908,25,35-39,1933,13.613670760771797
STAT,1839,32,20-24,1871,2.2147283678877727
SIM,1892,31,20-24,1923,3
SIM,1870,33,35-39,1903,14
SIM,1875,22,30-34,1897,24
SIM,1847,32,20-24,1879,2
SIM,1918,30,40-44,1948,5
STAT,1849,46,25-29,1895,0.04331502781103788
STAT,1927,33,45-49,1960,1.8274613745298351
STAT,1902,25,40-44,1927,4.020875076626954
SIM,1882,26,na,1908,2255
STAT,1860,38,45-49,1898,1.5204478347137758
STAT,1892,36,25-29,1928,3.423208128529452
STAT,1817,40,20-24,1857,0.43668177434432887
STAT,1880,47,na,1927,2230.2486259500706
SIM,1827,34,45-49,1861,1
SIM,1906,36,30-34,1942,2
STAT,1886,25,45-49,1911,1.115499942554866
STAT,1839,37,40-44,1876,3.4829041610875975
STAT,1852,27,40-44,1879,2.529518114968688
STAT,1849,17,40-44,1866,0.1688246310695357
SIM,1916,22,30-34,1938,30
SIM,1922,18,na,1940,3983
SIM,1870,99,na,1969,9
SIM,1846,32,na,1878,1813
SIM,1908,25,na,1933,3322
STAT,1870,18,45-49,1888,0.060755089806669944
STAT,1966,1,na,1967,4645.047535756523
SIM,1933,25,35-39,1958,25
STAT,1874,50,30-34,1924,0.0058281058981947825
STAT,1920,16,45-49,1936,0.5307546741588808
STAT,1942,22,30-34,1964,28.468594241811548
STAT,1815,51,na,1866,1280.6011617953413
STAT,1825,45,25-29,1870,0.06040734350012233
STAT,1835,31,25-29,1866,8.386215537321048
STAT,1917,41,na,1958,3666.7697608767503
STAT,1898,33,15-19,1931,0.1812884829317957
STAT,1877,38,15-19,1915,0.05475486297465856
STAT,1897,45,15-19,1942,2.8790284556624315E-4
STAT,1845,48,20-24,1893,0.008384849829596674
STAT,1893,43,na,1936,2758.42058411582
STAT,1868,34,40-44,1902,3.875399076136318
SIM,1929,36,25-29,1965,1
SIM,1881,29,40-44,1910,2
STAT,1925,25,35-39,1950,16.865221151704482
STAT,1929,2,na,1931,4930.647891101611
STAT,1873,29,40-44,1902,2.8495800291857343
STAT,1878,76,na,1954,932.7384144730833
SIM,1917,42,40-44,1959,1
STAT,1825,71,na,1896,709.4274042297898
SIM,1851,30,20-24,1881,1
STAT,1895,32,35-39,1927,12.472481323345052
SIM,1871,19,30-34,1890,1
STAT,1768,88,na,1856,29.473492049999997
STAT,1844,39,50-100,1883,0.8825458370503408
STAT,1932,15,25-29,1947,54.4600457431065
SIM,1885,27,45-49,1912,1
SIM,1892,0,na,1892,3564
SIM,1948,20,25-29,1968,96
STAT,1925,29,15-19,1954,0.7820465222586649
STAT,1812,49,20-24,1861,0.038866084993225226
STAT,1832,31,na,1863,1704.001723501378
SIM,1814,64,na,1878,841
STAT,1863,77,na,1940,716.596036725138
SIM,1909,32,40-44,1941,4
SIM,1840,15,20-24,1855,16
SIM,1843,31,25-29,1874,12
STAT,1908,22,30-34,1930,24.96199550361592
STAT,1886,31,50-100,1917,0.9180674920553032
SIM,1876,34,40-44,1910,6
SIM,1961,1,na,1962,4756
STAT,1885,2,na,1887,2939.043739698957
SIM,1865,23,25-29,1888,56
STAT,1838,46,na,1884,1573.9610975871074
SIM,1822,73,na,1895,619
STAT,1856,36,15-19,1892,0.04158949445924446
SIM,1842,71,na,1913,848
SIM,1792,68,na,1860,665
SIM,1827,29,na,1856,1616
STAT,1889,39,30-34,1928,6.153088297458552
SIM,1842,23,30-34,1865,19
STAT,1900,30,na,1930,3152.4087488933123
STAT,1940,21,50-100,1961,0.6334324101796818
STAT,1909,42,40-44,1951,0.22102063974420164
STAT,1884,17,35-39,1901,0.5121216104440434
STAT,1834,23,30-34,1857,14.677937789134743
STAT,1868,44,na,1912,2055.09820525051
SIM,1872,43,50-100,1915,2
STAT,1855,43,45-49,1898,1.0558695729326237
SIM,1822,36,25-29,1858,1
SIM,1892,17,35-39,1909,3
SIM,1836,41,35-39,1877,3
STAT,1865,27,40-44,1892,2.5650000575275635
SIM,1848,76,na,1924,671
SIM,1860,27,40-44,1887,3
STAT,1856,6,na,1862,2174.2995607034486
SIM,1872,33,45-49,1905,2
STAT,1843,30,20-24,1873,2.240988341119655
STAT,1935,24,40-44,1959,4.322498512911372
SIM,1940,15,25-29,1955,45
STAT,1935,32,40-44,1967,5.114603722249224
SIM,1775,88,na,1863,40
STAT,1863,19,30-34,1882,1.3559636713978798
SIM,1929,19,na,1948,4376
SIM,1850,21,15-19,1871,3
STAT,1844,19,20-24,1863,15.467953312930051
SIM,1883,24,30-34,1907,25
STAT,1828,41,35-39,1869,1.5611348298908496
STAT,1826,37,40-44,1863,4.776770690344279
SIM,1840,70,na,1910,876
SIM,1942,23,35-39,1965,10
STAT,1863,13,na,1876,2248.042162524636
STAT,1857,15,25-29,1872,5.02135099492218
STAT,1793,87,na,1880,52.169680236070846
SIM,1930,39,50-100,1969,1
SIM,1916,28,50-100,1944,4
STAT,1892,16,30-34,1908,1.8905784364885723
STAT,1857,16,50-100,1873,0.043156549539604044
SIM,1834,49,50-100,1883,2
SIM,1839,33,25-29,1872,17
STAT,1840,26,25-29,1866,34.86377661797914
STAT,1934,21,na,1955,4637.685818137778
SIM,1883,20,15-19,1903,3
STAT,1780,90,na,1870,23.95627483770892
SIM,1926,39,25-29,1965,4
STAT,1881,27,25-29,1908,38.604551659516346
STAT,1918,39,25-29,1957,0.9783257762677027
SIM,1865,46,na,1911,2003
SIM,1876,62,na,1938,1777
STAT,1842,21,15-19,1863,3.0351447157912053
STAT,1898,38,50-100,1936,0.33709764741101866
SIM,1873,22,20-24,1895,2
STAT,1876,15,35-39,1891,0.5380309666789796
SIM,1873,97,na,1970,22
SIM,1923,20,20-24,1943,113
STAT,1839,26,50-100,1865,0.5404262647620136
SIM,1879,7,na,1886,2673
STAT,1910,62,na,1972,2947.617502426415
STAT,1934,23,35-39,1957,11.950072420433196
SIM,1862,31,35-39,1893,8
STAT,1882,17,25-29,1899,5.20611048557027
STAT,1893,28,40-44,1921,3.5761359340737413
SIM,1869,27,na,1896,2203
STAT,1868,41,50-100,1909,0.9565331687941977
SIM,1833,99,na,1932,1
SIM,1876,41,50-100,1917,1
STAT,1909,39,50-100,1948,0.3716646202461415
SIM,1888,28,25-29,1916,51
SIM,1832,29,45-49,1861,4
STAT,1946,22,15-19,1968,5.596130503493015
STAT,1764,104,na,1868,0.020521991052486956
STAT,1848,38,30-34,1886,4.038891851679689
SIM,1863,65,na,1928,1380
SIM,1864,29,na,1893,2078
STAT,1838,78,na,1916,524.5478318195842
STAT,1860,25,25-29,1885,33.24758743595381
STAT,1858,24,30-34,1882,13.577906428719382
STAT,1837,49,25-29,1886,0.03782381197582018
STAT,1836,37,15-19,1873,0.04463493635096901
STAT,1951,19,15-19,1970,51.019898467528975
STAT,1826,49,50-100,1875,0.22069266924795453
STAT,1908,28,50-100,1936,0.885785474035091
STAT,1884,82,na,1966,716.6272918568335
STAT,1930,26,50-100,1956,1.196148721526531
STAT,1951,15,35-39,1966,4.722969813563942
SIM,1908,31,35-39,1939,8
SIM,1848,98,na,1946,3
SIM,1856,38,30-34,1894,4
STAT,1866,46,25-29,1912,0.05033060089956649
SIM,1884,32,25-29,1916,15
STAT,1876,32,25-29,1908,9.996830977260048
SIM,1866,36,25-29,1902,1
SIM,1852,19,20-24,1871,14
STAT,1898,24,25-29,1922,72.72576831244449
STAT,1929,35,20-24,1964,0.3202558309586311
SIM,1866,24,30-34,1890,19
SIM,1903,39,30-34,1942,5
SIM,1848,20,20-24,1868,60
SIM,1902,26,45-49,1928,1
STAT,1780,105,na,1885,0.0171161143907573
STAT,1928,26,15-19,1954,0.8244249771666572
SIM,1865,15,25-29,1880,5
STAT,1833,47,na,1880,1471.112506154511
SIM,1931,22,20-24,1953,130
STAT,1899,42,20-24,1941,0.014257489749827943
SIM,1861,37,50-100,1898,1
STAT,1854,31,35-39,1885,7.497549537244169
SIM,1888,38,40-44,1926,7
STAT,1833,27,30-34,1860,20.365075260290062
STAT,1883,22,15-19,1905,3.0556001554045085
STAT,1807,64,na,1871,898.9364464754912
STAT,1833,43,50-100,1876,0.7754268932736904
STAT,1858,44,25-29,1902,0.46921365447914076
STAT,1886,49,20-24,1935,0.011724897836473638
SIM,1939,26,40-44,1965,4
STAT,1841,38,35-39,1879,5.685724290502149
STAT,1859,36,40-44,1895,3.307244573820152
SIM,1847,24,20-24,1871,60
STAT,1915,20,20-24,1935,104.82089599728134
SIM,1934,21,35-39,1955,13
STAT,1843,16,35-39,1859,0.4764379083180456
STAT,1810,52,na,1862,1148.4122804276742
STAT,1830,40,na,1870,1588.1126883032484
SIM,1871,39,25-29,1910,1
SIM,1867,9,na,1876,2614
STAT,1896,38,25-29,1934,3.574514429722082
STAT,1927,22,40-44,1949,3.9134219254974933
SIM,1804,54,na,1858,1107
SIM,1899,26,35-39,1925,15
SIM,1935,22,40-44,1957,6
STAT,1910,18,15-19,1928,8.473214963165713
SIM,1857,59,na,1916,1499
STAT,1831,49,30-34,1880,0.06720880466786447
STAT,1845,21,40-44,1866,1.843813682885726
STAT,1897,37,15-19,1934,0.07094468395177049
STAT,1818,38,45-49,1856,5.733019815518471
STAT,1829,47,25-29,1876,0.0470798184057518
STAT,1932,32,15-19,1964,0.1613791077653556
STAT,1872,3,na,1875,2951.671392142872
STAT,1888,27,20-24,1915,13.097557865296817
STAT,1923,22,20-24,1945,122.22288700077516
SIM,1859,92,na,1951,28
SIM,1922,39,40-44,1961,1
STAT,1850,16,40-44,1866,0.15848712308842292
SIM,1909,30,50-100,1939,3
SIM,1853,21,40-44,1874,1
SIM,1943,24,40-44,1967,3
SIM,1826,38,45-49,1864,1
SIM,1852,28,45-49,1880,1
STAT,1869,93,na,1962,61.634418720185174
STAT,1876,10,na,1886,2567.116258725535
STAT,1846,65,na,1911,1253.4516311547377
SIM,1868,35,45-49,1903,2
SIM,1852,71,na,1923,969
STAT,1879,24,15-19,1903,3.2418937639548036
SIM,1858,33,na,1891,1939
STAT,1906,42,15-19,1948,0.0013178437402845988
SIM,1867,20,30-34,1887,24
STAT,1827,33,40-44,1860,4.991255508979304
SIM,1822,83,na,1905,197
STAT,1862,33,35-39,1895,8.145300079827157
STAT,1869,25,45-49,1894,1.0230315151907055
STAT,1939,20,na,1959,3467.0238398304846
STAT,1851,15,30-34,1866,1.410548588845912
SIM,1897,39,30-34,1936,2
STAT,1866,48,40-44,1914,0.14729588082577744
STAT,1847,34,20-24,1881,2.0859327814490625
SIM,1900,39,na,1939,3126
SIM,1924,32,30-34,1956,20
SIM,1850,69,na,1919,1066
SIM,1909,20,na,1929,3387
SIM,1930,27,na,1957,4499
SIM,1899,57,na,1956,2644
SIM,1797,89,na,1886,32
SIM,1859,50,na,1909,1747
SIM,1928,24,15-19,1952,5
SIM,1916,33,35-39,1949,9
STAT,1839,24,20-24,1863,58.10917211193508
STAT,1866,26,30-34,1892,22.016823635264963
STAT,1894,24,40-44,1918,2.5140097220645403
STAT,1908,33,35-39,1941,8.114653215938208
STAT,1898,16,25-29,1914,7.262249265621575
STAT,1800,74,na,1874,459.2094270768806
SIM,1890,9,na,1899,3240
SIM,1908,23,35-39,1931,8
SIM,1915,38,na,1953,3415
STAT,1844,28,45-49,1872,0.9372176342973293
SIM,1858,25,35-39,1883,13
SIM,1905,32,20-24,1937,1
STAT,1838,23,15-19,1861,2.852915632692583
STAT,1950,20,15-19,1970,5.9699836768686385
SIM,1892,34,25-29,1926,22
SIM,1891,51,na,1942,2545
SIM,1835,33,40-44,1868,5
SIM,1797,67,na,1864,716
SIM,1844,43,35-39,1887,1
STAT,1865,54,50-100,1919,0.012576352875376551
STAT,1861,21,25-29,1882,46.52908435077085
STAT,1916,32,30-34,1948,15.366436562882754
SIM,1852,28,na,1880,1902
STAT,1857,23,25-29,1880,48.885138717159194
STAT,1919,23,45-49,1942,1.1603437329181328
STAT,1879,1,na,1880,3385.5955181173717
SIM,1889,21,20-24,1910,76
STAT,1922,4,na,1926,4412.796398576658
SIM,1846,10,na,1856,2157
SIM,1917,34,40-44,1951,4
STAT,1893,65,na,1958,2096.898383446256
SIM,1839,25,25-29,1864,38
SIM,1893,29,45-49,1922,1
SIM,1924,2,na,1926,4603
STAT,1850,17,na,1867,1977.305788828279
STAT,1907,21,25-29,1928,79.68115979633883
STAT,1881,42,na,1923,2106.655594754968
SIM,1847,37,40-44,1884,4
SIM,1932,22,15-19,1954,9
STAT,1908,20,15-19,1928,4.650811503917289
SIM,1921,15,15-19,1936,43
SIM,1837,82,na,1919,260
STAT,1873,24,20-24,1897,65.61272304693688
STAT,1917,44,40-44,1961,0.24577255515411073
STAT,1878,23,45-49,1901,0.6844060832924929
STAT,1836,43,35-39,1879,1.3772356945313953
SIM,1915,21,25-29,1936,104
SIM,1859,37,45-49,1896,1
SIM,1891,22,15-19,1913,4
STAT,1885,29,45-49,1914,1.038037342000683
SIM,1910,25,40-44,1935,5
STAT,1863,99,na,1962,4.425436054697897
SIM,1834,21,30-34,1855,19
STAT,1887,42,50-100,1929,1.1149617295174834
STAT,1913,15,15-19,1928,8.806859886040902
STAT,1862,16,45-49,1878,0.060786613720270805
SIM,1941,21,na,1962,3465
STAT,1851,32,20-24,1883,2.0237992542747505
SIM,1808,90,na,1898,24
SIM,1945,5,na,1950,3934
STAT,1855,48,na,1903,1578.7079379728455
SIM,1896,27,20-24,1923,12
SIM,1811,89,na,1900,40
SIM,1916,20,15-19,1936,5
STAT,1926,21,35-39,1947,10.838887086446787
STAT,1815,53,50-100,1868,0.031990905450019036
SIM,1841,27,30-34,1868,27
STAT,1909,34,40-44,1943,3.4977806350751215
SIM,1935,33,45-49,1968,3
STAT,1835,71,na,1906,849.5685302485678
SIM,1927,23,45-49,1950,1
STAT,1919,20,50-100,1939,0.6847281191999465
STAT,1775,113,na,1888,4.45273206430738E-4
SIM,1905,32,50-100,1937,3
STAT,1858,35,35-39,1893,5.288535243543974
STAT,1920,40,na,1960,3885.6653609053237
SIM,1840,28,40-44,1868,1
SIM,1846,23,15-19,1869,5
SIM,1880,77,na,1957,952
STAT,1832,28,40-44,1860,2.423652403192542
STAT,1858,41,20-24,1899,0.11816211777781785
SIM,1892,36,50-100,1928,1
SIM,1853,34,na,1887,1807
STAT,1843,79,na,1922,472.2083340775583
STAT,1886,41,na,1927,2316.846131573599
STAT,1866,17,40-44,1883,0.1635776242943697
SIM,1824,32,na,1856,1620
STAT,1945,26,15-19,1971,0.7319935564672081
STAT,1883,26,30-34,1909,23.403853341869343
STAT,1912,49,50-100,1961,0.2041507579417433
SIM,1824,35,30-34,1859,11
SIM,1919,21,45-49,1940,1
SIM,1868,41,30-34,1909,1
STAT,1888,49,30-34,1937,0.05968887978072432
STAT,1942,25,35-39,1967,14.899176177333285
SIM,1887,56,na,1943,2107
SIM,1925,32,25-29,1957,11
STAT,1878,22,na,1900,2328.4390726085917
STAT,1900,42,50-100,1942,0.09602310725547186
SIM,1826,31,25-29,1857,14
SIM,1924,15,40-44,1939,1
SIM,1880,26,20-24,1906,11
STAT,1842,110,na,1952,2.001191486206673E-4
STAT,1926,30,25-29,1956,10.569503252279107
SIM,1872,16,na,1888,2443
STAT,1825,47,40-44,1872,0.17463923137848683
STAT,1874,24,15-19,1898,3.164360954217297
SIM,1882,28,30-34,1910,24
SIM,1947,15,35-39,1962,5
SIM,1929,8,na,1937,4770
SIM,1832,51,na,1883,1315
SIM,1842,26,35-39,1868,10
STAT,1843,38,45-49,1881,1.4156639543414782
STAT,1812,47,50-100,1859,0.8222885478950094
SIM,1847,35,25-29,1882,2
SIM,1886,32,35-39,1918,8
STAT,1922,26,20-24,1948,19.580024751868276
STAT,1882,21,45-49,1903,0.6425741905046592
SIM,1944,18,na,1962,3649
STAT,1899,49,40-44,1948,0.12239189301899758
SIM,1851,38,45-49,1889,3
STAT,1911,39,15-19,1950,0.017346397893904665
SIM,1913,28,35-39,1941,17
SIM,1958,4,na,1962,4785
STAT,1816,49,40-44,1865,0.39165727141905604
STAT,1909,45,45-49,1954,0.1904873351080871
STAT,1783,87,na,1870,47.380625694952414
STAT,1878,32,35-39,1910,9.970305104006451
SIM,1874,1,na,1875,3137
STAT,1916,15,40-44,1931,0.28164810499476545
STAT,1849,48,50-100,1897,0.18185350909397588
STAT,1903,60,na,1963,2726.713964473481
SIM,1834,30,20-24,1864,2
SIM,1941,27,35-39,1968,16
STAT,1839,49,35-39,1888,0.09256815826095534
SIM,1911,3,na,1914,3792
SIM,1854,39,25-29,1893,2
SIM,1890,21,45-49,1911,1
SIM,1893,22,25-29,1915,81
STAT,1854,31,na,1885,1766.6997826625327
STAT,1889,28,40-44,1917,3.481293527624989
STAT,1839,35,25-29,1874,2.3388678655367956
STAT,1811,69,na,1880,738.5720610330974
STAT,1905,28,35-39,1933,13.129179737017745
SIM,1904,53,na,1957,2982
STAT,1857,39,35-39,1896,5.216720117601175
STAT,1933,27,35-39,1960,18.832385882218194
STAT,1823,39,30-34,1862,7.732875833267354
SIM,1796,72,na,1868,523
STAT,1854,38,20-24,1892,0.5487952411770646
STAT,1893,21,20-24,1914,82.80832661801368
SIM,1858,22,30-34,1880,17
SIM,1835,36,45-49,1871,1
STAT,1863,48,15-19,1911,3.27439988913419E-4
STAT,1935,35,45-49,1970,0.9020936621618019
STAT,1943,25,na,1968,3772.307490795168
STAT,1890,16,20-24,1906,20.526136790158592
SIM,1897,28,40-44,1925,5
SIM,1920,18,25-29,1938,58
STAT,1867,81,na,1948,479.7003254780907
STAT,1846,25,15-19,1871,0.41300691023612546
STAT,1855,37,25-29,1892,2.0460343262262906
STAT,1885,22,25-29,1907,53.904962124795226
SIM,1888,16,30-34,1904,1
STAT,1837,27,15-19,1864,0.3779342241451645
STAT,1846,39,25-29,1885,2.184238534263296
STAT,1912,18,25-29,1930,8.256836225841063
STAT,1897,28,25-29,1925,53.254750909816735
STAT,1940,29,40-44,1969,4.485669598408937
SIM,1885,66,na,1951,1514
SIM,1846,43,45-49,1889,2
STAT,1914,39,40-44,1953,1.3978136550521754
STAT,1933,20,15-19,1953,6.710215491851504
SIM,1868,64,na,1932,1550
STAT,1911,26,45-49,1937,1.5971344518790571
SIM,1850,25,30-34,1875,32
STAT,1875,27,35-39,1902,9.369251091774835
STAT,1809,45,40-44,1854,0.500457066735133
SIM,1894,31,30-34,1925,29
STAT,1860,51,40-44,1911,0.008108154906796278
STAT,1900,19,45-49,1919,0.0851463502663263
STAT,1853,29,15-19,1882,0.3567893087360733
SIM,1915,37,35-39,1952,7
STAT,1886,63,na,1949,1780.5757477966467
STAT,1919,36,15-19,1955,0.019507107877462477
SIM,1919,20,40-44,1939,5
STAT,1904,49,25-29,1953,0.04310814527486881
STAT,1861,28,45-49,1889,0.8721576514557619
SIM,1900,23,30-34,1923,30
STAT,1858,18,45-49,1876,0.056185079296986795
STAT,1952,20,25-29,1972,104.98731504838626
SIM,1921,23,na,1944,3895
SIM,1847,15,30-34,1862,1
SIM,1909,39,25-29,1948,1
STAT,1886,28,15-19,1914,0.45116078281098104
SIM,1849,82,na,1931,299
STAT,1869,34,35-39,1903,9.188833477507636
SIM,1877,22,40-44,1899,2
SIM,1879,38,25-29,1917,3
STAT,1800,84,na,1884,111.54901073686935
SIM,1877,34,35-39,1911,10
STAT,1843,37,40-44,1880,3.4517669335898327
STAT,1857,48,50-100,1905,0.1806877416175733
SIM,1861,31,na,1892,2063
SIM,1871,17,15-19,1888,6
SIM,1884,37,45-49,1921,2
SIM,1838,37,25-29,1875,1
STAT,1838,43,45-49,1881,1.0557127572057274
SIM,1942,19,15-19,1961,40
STAT,1827,36,45-49,1863,2.119393795605778
STAT,1874,28,30-34,1902,24.22060125404721
STAT,1878,44,na,1922,2244.7486756895405
SIM,1864,38,30-34,1902,4
STAT,1859,20,30-34,1879,15.491521385825562
STAT,1894,27,45-49,1921,1.3479629109074687
STAT,1892,38,40-44,1930,5.153990352540614
SIM,1831,25,20-24,1856,8
SIM,1831,39,30-34,1870,10
STAT,1863,17,15-19,1880,5.614006151853236
SIM,1929,24,30-34,1953,40
SIM,1865,37,35-39,1902,12
SIM,1883,27,35-39,1910,10
SIM,1911,23,na,1934,3406
STAT,1917,32,25-29,1949,9.143314926680029
STAT,1919,40,35-39,1959,0.20672086273326257
STAT,1839,48,30-34,1887,0.06482954956307906
STAT,1865,25,25-29,1890,36.46701307660376
SIM,1941,20,15-19,1961,5
STAT,1882,48,25-29,1930,0.05225308791990952
STAT,1857,35,50-100,1892,0.9234306688582002
STAT,1846,12,na,1858,2224.260143909259
SIM,1910,26,50-100,1936,4
STAT,1842,39,40-44,1881,3.31453405179584
STAT,1890,17,25-29,1907,6.544877649623023
STAT,1842,25,30-34,1867,22.879261006137277
STAT,1899,49,50-100,1948,0.17558089312799677
STAT,1932,40,na,1972,4768.341875661639
STAT,1862,48,50-100,1910,0.1958830745345715
SIM,1882,29,35-39,1911,11
SIM,1932,34,30-34,1966,29
STAT,1907,41,na,1948,3233.010911562491
SIM,1831,26,25-29,1857,37
SIM,1902,27,20-24,1929,19
SIM,1930,26,20-24,1956,20
SIM,1874,81,na,1955,447
SIM,1845,31,35-39,1876,10
SIM,1851,37,40-44,1888,2
STAT,1875,15,40-44,1890,0.17842671598277904
SIM,1807,47,50-100,1854,2
STAT,1876,36,40-44,1912,4.29302735302603
SIM,1879,42,45-49,1921,3
STAT,1908,46,40-44,1954,0.13571816929557654
STAT,1923,25,25-29,1948,71.8729774655973
SIM,1850,39,40-44,1889,3
STAT,1939,15,35-39,1954,3.977750954149228
STAT,1785,101,na,1886,0.14052496793989536
STAT,1871,23,35-39,1894,5.457187232372856
STAT,1874,29,35-39,1903,9.246807125709621
SIM,1919,19,na,1938,3866
SIM,1860,20,20-24,1880,52
STAT,1871,11,na,1882,2488.0696166332673
STAT,1907,37,35-39,1944,2.118543870303214
STAT,1924,34,30-34,1958,17.341783427039395
SIM,1884,36,40-44,1920,4
STAT,1848,37,50-100,1885,0.9401267211672781
SIM,1836,32,na,1868,1731
SIM,1867,39,45-49,1906,2
STAT,1848,34,15-19,1882,0.10998744270362622
STAT,1849,43,20-24,1892,0.1182285399964726
STAT,1841,16,25-29,1857,5.0684835123636605
SIM,1873,25,25-29,1898,48
SIM,1902,63,na,1965,2532
STAT,1833,69,na,1902,900.3761852361818
SIM,1892,39,45-49,1931,3
STAT,1841,98,na,1939,2.239583029889892
STAT,1852,23,25-29,1875,48.94877500347033
STAT,1827,39,15-19,1866,0.0556099798620717
STAT,1891,26,30-34,1917,29.533135246555346
STAT,1832,22,45-49,1854,1.0053163659517967
STAT,1907,30,15-19,1937,0.11438730310454481
STAT,1944,8,na,1952,4014.4391868086245
STAT,1905,34,20-24,1939,2.101233687297871
SIM,1822,51,na,1873,1312
SIM,1914,25,25-29,1939,69
SIM,1912,29,30-34,1941,39
STAT,1819,40,30-34,1859,2.5974764745765353
SIM,1875,25,35-39,1900,11
STAT,1846,107,na,1953,0.0034978408601646317
SIM,1838,45,na,1883,1570
STAT,1931,18,35-39,1949,5.174897824041658
STAT,1861,24,50-100,1885,0.3243626689387291
STAT,1925,26,50-100,1951,1.1143856836980166
SIM,1901,18,15-19,1919,7
STAT,1833,79,na,1912,428.91932543777494
SIM,1843,35,40-44,1878,7
STAT,1941,26,30-34,1967,38.30863392636985
SIM,1787,90,na,1877,12
STAT,1921,29,30-34,1950,40.95899641603084
STAT,1906,25,25-29,1931,58.59755215908821
SIM,1854,61,na,1915,1502
STAT,1838,39,25-29,1877,2.2845178506567696
SIM,1834,37,40-44,1871,6
STAT,1809,108,na,1917,7.350562560159837E-4
STAT,1885,14,na,1899,2423.93044074401
STAT,1839,15,30-34,1854,1.40469641814771
STAT,1835,35,40-44,1870,3.5167521211165664
STAT,1936,20,40-44,1956,3.0388034106365387
SIM,1838,41,45-49,1879,1
SIM,1875,39,45-49,1914,1
STAT,1845,27,15-19,1872,0.39077878728720433
STAT,1873,36,15-19,1909,0.05406145260610022
SIM,1932,18,na,1950,4528
SIM,1848,27,40-44,1875,2
STAT,1873,38,30-34,1911,5.081018124362953
SIM,1860,23,25-29,1883,51
STAT,1886,31,30-34,1917,17.494435756150285
STAT,1862,27,15-19,1889,0.36781490846897424
STAT,1910,30,na,1940,3472.820490997077
STAT,1856,15,30-34,1871,1.4056408103707196
STAT,1926,37,45-49,1963,0.7870499705672447
STAT,1937,18,na,1955,3373.8843390453994
SIM,1887,44,45-49,1931,1
SIM,1913,34,20-24,1947,2
STAT,1869,22,40-44,1891,1.9070798637647564
SIM,1807,84,na,1891,103
STAT,1915,23,25-29,1938,89.92364735792286
SIM,1907,35,35-39,1942,3
STAT,1930,39,25-29,1969,1.2106534762584042
SIM,1859,21,35-39,1880,12
STAT,1842,26,35-39,1868,8.703683804158567
STAT,1875,20,15-19,1895,3.222514049788866
STAT,1900,19,na,1919,3292.0682450633963
STAT,1911,19,20-24,1930,25.492972185844966
STAT,1887,37,20-24,1924,0.8145439161582079
STAT,1841,20,45-49,1861,0.6178445454425299
STAT,1856,29,40-44,1885,2.25521876075643
STAT,1934,36,40-44,1970,1.9533199902246254
STAT,1955,16,30-34,1971,15.288450571413835
SIM,1855,17,30-34,1872,1
STAT,1899,19,45-49,1918,0.08410018209709563
STAT,1847,17,30-34,1864,1.4669286891184459
SIM,1928,39,35-39,1967,9
SIM,1865,36,30-34,1901,4
SIM,1872,26,na,1898,2256
STAT,1817,37,50-100,1854,4.3842663776140895
STAT,1858,49,45-49,1907,0.17115111986776654
STAT,1817,47,40-44,1864,0.38594726427267995
STAT,1870,35,50-100,1905,1.1486305186609465
STAT,1904,29,30-34,1933,33.879011681143346
SIM,1907,49,50-100,1956,2
STAT,1893,48,50-100,1941,0.16388791628713673
SIM,1853,12,na,1865,2174
STAT,1826,30,20-24,1856,4.275467361365315
STAT,1879,44,45-49,1923,1.4600103042517036
SIM,1895,37,20-24,1932,4
STAT,1950,9,na,1959,4389.570494041129
SIM,1850,26,35-39,1876,9
SIM,1794,91,na,1885,12
SIM,1864,29,40-44,1893,2
STAT,1884,38,40-44,1922,4.065349413909266
STAT,1917,51,na,1968,3578.9341763413117
SIM,1864,15,30-34,1879,6
SIM,1935,36,na,1971,4896
STAT,1814,87,na,1901,80.97727338094373
STAT,1878,31,50-100,1909,0.9057490200593304
STAT,1878,28,15-19,1906,0.445107184881818
SIM,1803,91,na,1894,15
SIM,1934,37,45-49,1971,2
STAT,1920,17,20-24,1937,143.69393275275002
SIM,1822,42,50-100,1864,2
STAT,1845,30,30-34,1875,14.998415195398119
STAT,1840,17,na,1857,1950.379872089013
STAT,1851,37,40-44,1888,3.182647164344498
STAT,1830,72,na,1902,762.2149343577798
SIM,1923,23,25-29,1946,113
STAT,1931,24,20-24,1955,135.38580301630182
STAT,1864,43,50-100,1907,0.8830771100532829
SIM,1875,38,40-44,1913,4
STAT,1866,22,15-19,1888,2.8979806401723502
SIM,1892,38,40-44,1930,5
STAT,1817,48,45-49,1865,0.5237500115363786
SIM,1881,38,30-34,1919,3
STAT,1916,35,35-39,1951,2.362169409019356
SIM,1854,83,na,1937,281
STAT,1832,37,30-34,1869,4.073354628075266
STAT,1883,27,35-39,1910,8.936966507031034
SIM,1944,20,40-44,1964,3
STAT,1841,47,25-29,1888,0.039890148196806495
STAT,1889,35,15-19,1924,0.06611250227876914
SIM,1900,26,35-39,1926,18
STAT,1914,24,20-24,1938,106.65019796872676
SIM,1891,27,35-39,1918,11
STAT,1822,47,15-19,1869,5.379159096502655E-4
SIM,1922,24,20-24,1946,126
SIM,1875,31,20-24,1906,1
SIM,1927,20,40-44,1947,3
STAT,1860,5,na,1865,2222.941119706368
SIM,1874,22,15-19,1896,2
SIM,1912,41,na,1953,3361
SIM,1829,27,30-34,1856,26
STAT,1900,40,40-44,1940,0.20675879589902657
SIM,1840,37,30-34,1877,4
SIM,1917,30,25-29,1947,14
STAT,1872,15,15-19,1887,5.708996887855348
SIM,1908,20,30-34,1928,30
STAT,1947,17,35-39,1964,4.465523488800515
STAT,1867,38,40-44,1905,3.8639260744130572
STAT,1828,43,50-100,1871,0.8808771151593613
SIM,1824,36,35-39,1860,9
STAT,1847,37,25-29,1884,2.202853091684358
STAT,1840,49,na,1889,1451.2411385275961
STAT,1951,0,na,1951,4938.031972135841
SIM,1874,26,30-34,1900,31
STAT,1915,36,30-34,1951,1.747747953577731
SIM,1821,99,na,1920,2
SIM,1910,21,25-29,1931,88
SIM,1924,35,35-39,1959,6
SIM,1893,63,na,1956,2226
SIM,1905,35,25-29,1940,4
STAT,1884,39,45-49,1923,1.8418367065230974
SIM,1831,32,45-49,1863,2
SIM,1903,18,25-29,1921,12
STAT,1873,5,na,1878,2647.502069299111
SIM,1891,26,30-34,1917,41
SIM,1853,30,30-34,1883,25
STAT,1897,32,45-49,1929,2.2031142332373044
STAT,1858,104,na,1962,0.17307567432019857
STAT,1836,30,50-100,1866,0.7657214974318208
STAT,1831,25,20-24,1856,10.835578104613223
STAT,1890,23,45-49,1913,0.802893947628147
SIM,1823,37,30-34,1860,6
STAT,1855,32,50-100,1887,0.6629628158003026
STAT,1867,39,45-49,1906,1.7505803685155283
SIM,1896,18,30-34,1914,3
SIM,1905,38,na,1943,3189
SIM,1880,15,15-19,1895,6
STAT,1846,38,20-24,1884,0.5908911711644257
SIM,1859,34,40-44,1893,5
STAT,1834,97,na,1931,3.330628604106396
STAT,1856,27,25-29,1883,32.309036580575814
STAT,1783,103,na,1886,0.045691718970249914
STAT,1877,20,50-100,1897,0.40199224049980253
SIM,1934,30,25-29,1964,15
SIM,1885,20,25-29,1905,58
STAT,1868,37,45-49,1905,1.796813522759656
SIM,1904,23,15-19,1927,7
STAT,1774,113,na,1887,3.7688630552611444E-4
STAT,1871,17,15-19,1888,5.60299167345497
STAT,1888,18,30-34,1906,1.7748104792204444
STAT,1909,38,20-24,1947,0.2345561114775046
STAT,1882,28,30-34,1910,23.053562982528497
STAT,1919,20,40-44,1939,3.4989604345490797
SIM,1876,37,45-49,1913,2
SIM,1885,44,na,1929,2178
SIM,1890,28,30-34,1918,37
STAT,1823,32,45-49,1855,4.57094284570287
SIM,1923,36,30-34,1959,2
STAT,1902,21,25-29,1923,76.55207075076814
STAT,1857,32,15-19,1889,0.1067574551440614
SIM,1889,37,na,1926,2867
SIM,1839,22,20-24,1861,67
STAT,1878,44,50-100,1922,1.0260592670729405
STAT,1918,36,na,1954,3764.203140472347
SIM,1857,27,na,1884,1949
SIM,1864,27,25-29,1891,45
STAT,1928,0,na,1928,5362.519049272589
STAT,1816,38,35-39,1854,26.04699965901462
STAT,1849,30,na,1879,1921.3652401766078
SIM,1884,39,45-49,1923,2
SIM,1939,22,25-29,1961,92
SIM,1872,27,25-29,1899,41
STAT,1856,31,45-49,1887,1.3146497072015921
STAT,1857,36,30-34,1893,3.989972478707337
SIM,1799,90,na,1889,18
SIM,1883,33,20-24,1916,2
STAT,1872,29,25-29,1901,39.797377468338595
SIM,1908,44,40-44,1952,1
STAT,1909,30,25-29,1939,8.399494745034348
SIM,1869,32,35-39,1901,9
STAT,1889,26,25-29,1915,49.50353992390058
STAT,1933,15,40-44,1948,1.7770432355735648
STAT,1907,34,30-34,1941,13.793370709153807
STAT,1833,23,15-19,1856,2.702867389106737
SIM,1797,57,na,1854,1004
STAT,1808,47,40-44,1855,0.6495087936739813
STAT,1923,29,40-44,1952,5.019236893158034
SIM,1867,36,40-44,1903,8
STAT,1829,25,15-19,1854,1.2907315992123107
STAT,1917,47,45-49,1964,0.21445912462282027
STAT,1917,20,30-34,1937,29.02970456835584
STAT,1819,64,na,1883,968.9199749361277
STAT,1859,32,25-29,1891,7.701317109390435
STAT,1864,27,25-29,1891,35.61660273227674
STAT,1927,18,na,1945,4312.061782840684
STAT,1854,27,15-19,1881,0.34030483353126634
SIM,1869,59,na,1928,1760
SIM,1838,39,40-44,1877,8
STAT,1878,26,15-19,1904,0.4482123830603042
SIM,1910,29,20-24,1939,22
SIM,1930,37,na,1967,4651
STAT,1846,36,20-24,1882,0.6032907822295359
STAT,1936,16,20-24,1952,122.91841032499411
STAT,1871,96,na,1967,34.19761707338514
STAT,1875,33,20-24,1908,2.61363342604365
SIM,1841,23,15-19,1864,2
SIM,1929,40,na,1969,4527
SIM,1808,47,na,1855,1319
SIM,1860,79,na,1939,519
STAT,1902,29,20-24,1931,15.528952364289415
STAT,1924,37,35-39,1961,2.694334298030608
STAT,1831,27,20-24,1858,10.0909274148532
STAT,1832,32,50-100,1864,0.7232063467641149
STAT,1840,39,30-34,1879,4.051752580503423
STAT,1871,20,30-34,1891,16.808906058790598
STAT,1928,20,40-44,1948,3.989457636918334
SIM,1915,34,30-34,1949,16
STAT,1903,38,50-100,1941,0.3544302348570166
STAT,1932,36,30-34,1968,2.3154626747625526
SIM,1834,33,25-29,1867,8
SIM,1842,37,40-44,1879,6
STAT,1893,15,35-39,1908,0.660422959708915
STAT,1840,50,na,1890,1433.338659644382
SIM,1864,31,45-49,1895,1
SIM,1944,16,20-24,1960,140
SIM,1859,82,na,1941,322
SIM,1933,20,15-19,1953,6
SIM,1941,24,30-34,1965,31
STAT,1876,39,45-49,1915,1.9260704635463843
SIM,1934,17,15-19,1951,50
STAT,1865,39,35-39,1904,5.995349446183866
STAT,1888,47,15-19,1935,4.444969366454971E-4
SIM,1932,5,na,1937,4978
STAT,1953,19,25-29,1972,49.48816233352351
STAT,1941,22,15-19,1963,5.196840150613232
SIM,1863,12,na,1875,2258
SIM,1834,24,35-39,1858,4
SIM,1880,29,25-29,1909,39
SIM,1814,54,na,1868,1120
STAT,1937,5,na,1942,3695.232119715796
SIM,1824,38,35-39,1862,10
STAT,1863,67,na,1930,1314.1729947916833
SIM,1881,20,40-44,1901,4
SIM,1925,20,30-34,1945,36
STAT,1841,18,40-44,1859,0.1616722524043887
STAT,1861,25,40-44,1886,2.404476132989732
STAT,1880,15,na,1895,2527.025824671399
SIM,1891,29,35-39,1920,12
SIM,1846,64,na,1910,1244
STAT,1833,49,40-44,1882,0.10913603142241293
SIM,1937,26,30-34,1963,48
STAT,1850,27,na,1877,1794.5495079780526
SIM,1883,6,na,1889,2444
SIM,1782,91,na,1873,13
STAT,1910,19,na,1929,3596.0857787008886
SIM,1873,39,35-39,1912,11
STAT,1883,29,35-39,1912,8.873092334405156
STAT,1934,32,25-29,1966,11.921373504469159
SIM,1832,37,30-34,1869,5
SIM,1874,27,35-39,1901,9
STAT,1851,39,40-44,1890,3.1172332907071363
STAT,1904,25,15-19,1929,0.6189634844374718
SIM,1890,45,na,1935,2858
STAT,1928,32,50-100,1960,0.9766158526354056
SIM,1929,27,35-39,1956,20
STAT,1895,19,50-100,1914,0.06001475196074115
STAT,1849,37,35-39,1886,5.427146536733643
SIM,1876,30,na,1906,2356
STAT,1897,25,20-24,1922,14.921861492298294
SIM,1936,20,40-44,1956,1
SIM,1861,53,na,1914,1838
SIM,1827,43,35-39,1870,2
STAT,1925,20,15-19,1945,6.055163457056056
STAT,1933,24,30-34,1957,35.99081319256239
STAT,1875,18,45-49,1893,0.06326292647150435
SIM,1883,38,40-44,1921,4
STAT,1842,28,35-39,1870,8.579147600519798
STAT,1926,17,15-19,1943,52.56337207357149
SIM,1873,38,30-34,1911,3
STAT,1898,20,45-49,1918,0.8967885861493757
SIM,1831,87,na,1918,73
SIM,1943,28,20-24,1971,17
STAT,1880,28,20-24,1908,11.64263448078832
SIM,1895,39,20-24,1934,5
STAT,1848,24,50-100,1872,0.36366897877918714
STAT,1904,23,na,1927,3194.871496328554
SIM,1924,41,na,1965,4183
SIM,1947,21,20-24,1968,111
STAT,1900,16,40-44,1916,0.24028397107430055
SIM,1856,25,25-29,1881,41
STAT,1809,48,45-49,1857,0.6544660558540802
SIM,1850,28,35-39,1878,9
STAT,1918,35,45-49,1953,0.6852610673335561
STAT,1836,23,40-44,1859,1.7681083144276228
SIM,1932,37,35-39,1969,6
STAT,1943,16,50-100,1959,0.37542654212783744
SIM,1872,26,20-24,1898,13
SIM,1936,30,35-39,1966,7
STAT,1867,38,50-100,1905,1.0837017085468263
STAT,1929,26,30-34,1955,46.34518723654932
STAT,1913,36,20-24,1949,0.24694998806376892
SIM,1841,87,na,1928,95
STAT,1894,7,na,1901,3163.0312769964526
STAT,1864,26,20-24,1890,9.911448109774241
STAT,1876,63,na,1939,1741.4895081428165
STAT,1844,31,na,1875,1818.7654673024756
SIM,1911,17,20-24,1928,22
STAT,1896,16,15-19,1912,7.422638060403796
STAT,1801,69,na,1870,667.8079875747184
STAT,1826,33,25-29,1859,13.144691098204913
STAT,1935,28,20-24,1963,23.494943036261123
SIM,1786,72,na,1858,491
STAT,1903,17,20-24,1920,23.8298453956376
STAT,1908,42,25-29,1950,0.06241492893928702
STAT,1875,25,50-100,1900,0.6253647855061077
SIM,1827,72,na,1899,699
SIM,1906,23,25-29,1929,90
STAT,1804,99,na,1903,0.6343820363136677
STAT,1887,39,20-24,1926,0.8063458939512095
SIM,1889,28,40-44,1917,6
SIM,1857,37,35-39,1894,9
STAT,1814,49,30-34,1863,0.2863586326315025
STAT,1869,31,30-34,1900,16.044249252070752
STAT,1893,24,25-29,1917,68.15249177663512
STAT,1875,38,40-44,1913,4.229536387138724
STAT,1865,38,30-34,1903,4.540902063888979
SIM,1833,46,na,1879,1474
SIM,1867,32,25-29,1899,13
STAT,1858,15,40-44,1873,0.16013114447388394
STAT,1909,22,na,1931,3350.7548760393743
STAT,1865,48,25-29,1913,0.04870121231435533
STAT,1939,21,20-24,1960,105.53043439382293
SIM,1868,44,35-39,1912,2
SIM,1832,38,35-39,1870,18
STAT,1898,38,35-39,1936,1.9419908292821333
STAT,1928,21,45-49,1949,1.3311124100248877
STAT,1952,17,na,1969,4166.904336968327
SIM,1899,25,na,1924,3183
STAT,1846,97,na,1943,3.984612554689316
STAT,1810,84,na,1894,140.72949236855484
STAT,1831,35,na,1866,1605.0748819303049
STAT,1832,35,15-19,1867,0.043855702492590506
STAT,1921,28,50-100,1949,1.0442770069560072
SIM,1878,74,na,1952,1049
SIM,1875,38,50-100,1913,2
STAT,1844,26,50-100,1870,0.547808843765628
SIM,1926,35,45-49,1961,1
STAT,1911,23,40-44,1934,3.003287018951041
SIM,1899,23,30-34,1922,31
SIM,1844,20,na,1864,1856
SIM,1936,21,45-49,1957,1
SIM,1931,25,25-29,1956,92
STAT,1859,23,35-39,1882,4.519641768278944
STAT,1786,101,na,1887,0.12734722864663073
SIM,1941,15,40-44,1956,1
SIM,1918,26,20-24,1944,16
SIM,1931,29,40-44,1960,4
STAT,1837,31,35-39,1868,8.326595147945538
STAT,1870,29,15-19,1899,0.41746874303851755
SIM,1884,81,na,1965,795
SIM,1838,34,20-24,1872,1
SIM,1877,31,30-34,1908,25
SIM,1866,20,15-19,1886,3
SIM,1935,29,25-29,1964,68
STAT,1874,26,30-34,1900,24.389571267227026
STAT,1824,38,35-39,1862,10.543887908944745
STAT,1830,49,15-19,1879,2.920762910010391E-4
STAT,1899,16,40-44,1915,0.23733167257497534
STAT,1905,32,50-100,1937,0.7183978355011441
SIM,1902,31,na,1933,3169
STAT,1893,11,na,1904,3098.5341695309476
SIM,1929,29,na,1958,4381
STAT,1917,39,50-100,1956,0.4094733910048053
SIM,1921,39,25-29,1960,1
STAT,1850,27,30-34,1877,20.889743831737892
STAT,1764,95,na,1859,1.5476337438012298
STAT,1874,17,40-44,1891,0.17654231214876104
SIM,1914,22,20-24,1936,97
SIM,1911,24,45-49,1935,3
STAT,1829,64,na,1893,1050.3779638618623
SIM,1861,26,45-49,1887,4
STAT,1863,45,na,1908,1883.7517210003966
STAT,1900,25,30-34,1925,33.22488172116479
STAT,1944,22,40-44,1966,3.4295763369023353
SIM,1887,1,na,1888,3094
STAT,1837,25,15-19,1862,0.38342037448221555
SIM,1844,23,40-44,1867,2
STAT,1869,49,20-24,1918,0.010752972314486582
SIM,1850,79,na,1929,473
SIM,1894,26,na,1920,2990
SIM,1880,45,na,1925,2298
STAT,1834,32,20-24,1866,2.148768939760685
STAT,1825,49,40-44,1874,0.16986987412227225
STAT,1905,37,25-29,1942,0.8485856938961284
STAT,1852,20,20-24,1872,60.21241454286625
SIM,1928,21,45-49,1949,1
STAT,1843,90,na,1933,53.25260074534411
SIM,1847,49,na,1896,1643
SIM,1852,8,na,1860,2268
STAT,1934,19,15-19,1953,57.67936168901177
SIM,1860,90,na,1950,56
SIM,1865,39,35-39,1904,17
STAT,1926,34,40-44,1960,4.464305437054944
SIM,1864,24,20-24,1888,53
SIM,1905,45,50-100,1950,3
STAT,1877,26,na,1903,2346.662402279288
STAT,1882,19,40-44,1901,0.16713470789501583
STAT,1848,25,25-29,1873,38.06906681581675
SIM,1890,17,25-29,1907,11
STAT,1891,29,35-39,1920,11.196884211300143
SIM,1841,65,na,1906,1100
SIM,1853,33,35-39,1886,12
STAT,1819,43,35-39,1862,3.679851754855056
STAT,1881,41,50-100,1922,0.9684872964510438
STAT,1927,29,25-29,1956,75.28708065950204
STAT,1831,28,25-29,1859,35.43109825661374
SIM,1865,78,na,1943,634
SIM,1871,15,15-19,1886,5
STAT,1898,37,30-34,1935,6.813436735435388
STAT,1906,22,20-24,1928,94.81696273354473
SIM,1871,31,na,1902,2287
SIM,1879,59,na,1938,1957
STAT,1819,37,15-19,1856,0.1558288877491784
SIM,1905,39,40-44,1944,2
STAT,1907,28,45-49,1935,1.5353747595858012
STAT,1865,34,15-19,1899,0.12089488291022485
SIM,1901,35,40-44,1936,2
SIM,1868,28,20-24,1896,8
SIM,1949,17,na,1966,3983
STAT,1822,101,na,1923,0.28995529286063804
SIM,1887,38,25-29,1925,3
SIM,1836,21,40-44,1857,1
SIM,1867,37,45-49,1904,2
STAT,1880,17,15-19,1897,5.910426004830677
SIM,1876,3,na,1879,2882
SIM,1882,26,30-34,1908,38
STAT,1864,0,na,1864,3220.759309373082
STAT,1863,9,na,1872,2304.7279084331853
STAT,1867,36,40-44,1903,3.9018766695949423
STAT,1914,15,30-34,1929,2.3930262447925146
STAT,1780,80,na,1860,198.7576635921996
SIM,1913,37,25-29,1950,3
STAT,1830,50,na,1880,1403.1346922310192
STAT,1860,16,35-39,1876,0.4879501045670581
SIM,1871,21,35-39,1892,5
SIM,1875,36,40-44,1911,8
SIM,1922,15,30-34,1937,22
SIM,1917,21,35-39,1938,6
SIM,1915,28,45-49,1943,2
STAT,1815,83,na,1898,177.19882814470353
STAT,1860,22,20-24,1882,54.452031856710065
STAT,1853,26,45-49,1879,0.9804585595478319
STAT,1936,23,45-49,1959,1.0158621392343306
STAT,1909,21,35-39,1930,8.292555280222423
SIM,1844,83,na,1927,227
SIM,1812,73,na,1885,490
SIM,1849,35,35-39,1884,4
STAT,1879,38,25-29,1917,2.833038994029083
STAT,1838,36,20-24,1874,0.63098811760727
STAT,1847,48,30-34,1895,0.07048411605910365
SIM,1875,34,25-29,1909,15
SIM,1833,21,15-19,1854,2
STAT,1848,27,40-44,1875,2.657277429904407
STAT,1925,16,45-49,1941,0.5714542485650103
STAT,1841,13,na,1854,2113.0
STAT,1862,29,15-19,1891,0.36384476407553584
STAT,1811,47,na,1858,1305.4929952002508
SIM,1898,62,na,1960,2387
STAT,1913,59,na,1972,3185.507862868792
STAT,1824,37,30-34,1861,8.360202331130631
STAT,1906,49,35-39,1955,0.10638872281136208
STAT,1931,27,25-29,1958,80.2757371900123
SIM,1944,23,45-49,1967,1
STAT,1877,24,40-44,1901,2.0292132326524257
STAT,1898,25,50-100,1923,0.8233434838833068
SIM,1826,98,na,1924,1
STAT,1863,21,35-39,1884,4.969807520600743
STAT,1886,34,35-39,1920,10.019381675055486
SIM,1945,24,15-19,1969,5
SIM,1885,24,40-44,1909,2
STAT,1906,16,35-39,1922,0.7568252209781146
SIM,1894,34,35-39,1928,21
STAT,1850,49,na,1899,1552.8516259375942
STAT,1928,36,na,1964,4495.6563490416975
SIM,1923,27,40-44,1950,6
STAT,1867,31,20-24,1898,2.40762311911538
SIM,1859,30,25-29,1889,13
STAT,1856,18,35-39,1874,0.4754087131046772
STAT,1857,8,na,1865,2150.4190952646927
STAT,1809,98,na,1907,1.3036139954542756
STAT,1841,110,na,1951,1.9051077217830276E-4
STAT,1845,33,35-39,1878,8.432629503952793
STAT,1838,37,25-29,1875,2.332457529233492
SIM,1914,16,35-39,1930,1
STAT,1824,87,na,1911,97.14376976374967
SIM,1931,22,50-100,1953,4
STAT,1891,28,30-34,1919,29.32853081963961
SIM,1859,60,na,1919,1510
SIM,1880,67,na,1947,1538
STAT,1846,53,50-100,1899,0.011021910423164999
SIM,1934,34,40-44,1968,6
SIM,1917,20,30-34,1937,37
STAT,1899,21,15-19,1920,4.283157869317953
SIM,1910,60,na,1970,2984
STAT,1921,38,20-24,1959,0.27778085337885927
SIM,1911,45,na,1956,3269
SIM,1868,96,na,1964,14
SIM,1842,32,20-24,1874,2
STAT,1857,37,35-39,1894,5.269757886742936
STAT,1865,26,na,1891,2050.5118881080652
SIM,1898,38,35-39,1936,5
SIM,1865,35,50-100,1900,2
STAT,1930,15,15-19,1945,55.68494117640289
STAT,1873,54,50-100,1927,0.014072242915418825
STAT,1823,53,50-100,1876,0.017547789376089685
STAT,1864,33,45-49,1897,1.462053068615293
STAT,1946,22,50-100,1968,0.6917343816733085
SIM,1827,50,na,1877,1325
STAT,1834,26,35-39,1860,7.908854743011794
STAT,1915,32,15-19,1947,0.12364112799696357
STAT,1856,24,20-24,1880,58.14823952146147
SIM,1829,94,na,1923,10
STAT,1879,37,20-24,1916,0.7622718021672233
SIM,1895,44,na,1939,2910
SIM,1869,20,40-44,1889,2
SIM,1879,37,na,1916,2376
STAT,1908,29,15-19,1937,0.6259575256640051
SIM,1856,27,40-44,1883,2
STAT,1862,82,na,1944,376.86727685185826
SIM,1847,27,na,1874,1945
STAT,1937,24,15-19,1961,4.893737603810467
STAT,1782,103,na,1885,0.04591980479798781
STAT,1821,39,20-24,1860,1.4542448236128012
STAT,1761,106,na,1867,0.015612676962342737
SIM,1846,37,25-29,1883,3
STAT,1872,28,20-24,1900,11.07732650973548
STAT,1828,48,20-24,1876,0.009589095469861182
STAT,1829,42,na,1871,1575.5630660924946
SIM,1904,27,30-34,1931,39
STAT,1844,21,25-29,1865,49.99999495733495
STAT,1867,34,25-29,1901,9.008198909795953
STAT,1909,20,30-34,1929,25.386669296858976
STAT,1835,38,45-49,1873,1.5523865989209058
STAT,1960,5,na,1965,4836.530742026031
SIM,1843,38,45-49,1881,2
SIM,1907,19,na,1926,3487
STAT,1903,24,45-49,1927,0.9314386609225952
SIM,1852,21,25-29,1873,52
STAT,1882,59,na,1941,1785.4903719787787
STAT,1895,39,20-24,1934,0.9398214347565623
STAT,1925,22,30-34,1947,32.49948161979536
STAT,1847,46,15-19,1893,2.95800102162644E-4
SIM,1897,26,25-29,1923,55
STAT,1850,28,35-39,1878,7.9468355648613995
SIM,1880,28,20-24,1908,15
STAT,1872,26,20-24,1898,11.154605186128135
STAT,1824,32,25-29,1856,24.943721325029312
STAT,1833,91,na,1924,35.552498625585905
STAT,1893,26,40-44,1919,3.601084106481818
STAT,1939,23,20-24,1962,105.4607957993873
STAT,1834,54,30-34,1888,0.0036406967390685894
STAT,1884,20,30-34,1904,16.723764516902165
SIM,1783,76,na,1859,309
SIM,1855,27,25-29,1882,42
SIM,1821,67,na,1888,817
STAT,1919,25,45-49,1944,1.7753961723751484
STAT,1835,46,45-49,1881,0.16036840647738326
STAT,1838,47,25-29,1885,0.03978427351461103
STAT,1829,86,na,1915,134.06547948070266
STAT,1852,43,40-44,1895,1.6189143059650482
STAT,1855,44,20-24,1899,0.11133342268598773
STAT,1870,48,50-100,1918,0.2247526115051937
STAT,1878,49,20-24,1927,0.011567575170216407
SIM,1834,35,40-44,1869,5
SIM,1902,19,na,1921,3353
STAT,1868,50,40-44,1918,0.009625374978318627
STAT,1931,8,na,1939,4931.631295592404
STAT,1936,22,40-44,1958,3.0367069972930447
STAT,1875,48,40-44,1923,0.16414892917103857
SIM,1872,34,20-24,1906,2
SIM,1883,22,30-34,1905,21
STAT,1876,29,45-49,1905,1.075916046194534
STAT,1916,30,15-19,1946,0.12634158333796822
STAT,1881,54,50-100,1935,0.013403847607181857
STAT,1841,31,15-19,1872,0.1203620110443861
SIM,1944,22,40-44,1966,3
STAT,1827,33,50-100,1860,1.054534153830447
STAT,1889,42,25-29,1931,0.7479967219572067
SIM,1823,34,25-29,1857,12
SIM,1853,17,20-24,1870,14
STAT,1885,77,na,1962,1020.746753430755
STAT,1898,35,30-34,1933,6.878144769719445
STAT,1845,17,20-24,1862,15.856063074787674
STAT,1891,23,25-29,1914,66.70085228260204
STAT,1826,35,40-44,1861,5.093573790530486
SIM,1861,95,na,1956,21
SIM,1950,20,15-19,1970,6
SIM,1813,48,na,1861,1309
SIM,1857,35,35-39,1892,12
STAT,1868,52,35-39,1920,0.007718398706596576
SIM,1840,31,20-24,1871,1
SIM,1852,26,45-49,1878,3
SIM,1892,28,40-44,1920,8
STAT,1858,33,35-39,1891,7.46927625125894
SIM,1890,25,25-29,1915,58
STAT,1850,37,25-29,1887,2.0617534736411764
STAT,1893,39,45-49,1932,2.3642155097406974
STAT,1806,49,30-34,1855,0.34571810457122254
SIM,1883,11,na,1894,2413
SIM,1909,41,na,1950,3353
SIM,1927,25,45-49,1952,4
STAT,1870,31,40-44,1901,4.035525546931204
STAT,1842,16,40-44,1858,0.17109759106750108
SIM,1947,23,20-24,1970,99
STAT,1849,35,35-39,1884,5.5410330009978574
STAT,1866,32,30-34,1898,15.213023993485773
STAT,1884,28,40-44,1912,2.7859805520080045
STAT,1829,49,25-29,1878,0.045862126176294725
STAT,1873,34,15-19,1907,0.1352746838771301
STAT,1855,31,50-100,1886,0.6698827041340066
STAT,1912,45,30-34,1957,0.08131867640529415
STAT,1919,48,50-100,1967,0.23111092705683406
SIM,1839,44,30-34,1883,5
SIM,1832,32,25-29,1864,14
STAT,1843,52,30-34,1895,0.0039992260283066095
STAT,1874,5,na,1879,2657.948249579368
STAT,1846,46,20-24,1892,0.008925716043181695
STAT,1844,44,45-49,1888,1.037640836727412
STAT,1911,35,na,1946,3465.553646559638
SIM,1928,24,na,1952,4240
STAT,1867,44,50-100,1911,0.9245054486170027
STAT,1943,6,na,1949,3980.6083382665474
STAT,1815,41,15-19,1856,0.036587154089840264
STAT,1819,50,45-49,1869,0.027468253011581605
STAT,1960,4,na,1964,4837.546626817662
SIM,1853,76,na,1929,708
STAT,1886,41,45-49,1927,1.5002705757994705
SIM,1880,78,na,1958,900
STAT,1847,27,25-29,1874,37.492843499987934
SIM,1885,43,45-49,1928,5
STAT,1824,55,na,1879,1247.969125226714
SIM,1800,73,na,1873,473
STAT,1824,47,25-29,1871,0.07021806948771547
SIM,1938,25,20-24,1963,16
SIM,1866,38,40-44,1904,8
SIM,1846,29,25-29,1875,42
STAT,1798,85,na,1883,90.92753277581824
STAT,1877,43,45-49,1920,1.4560151098128307
STAT,1895,8,na,1903,3201.5977638720196
STAT,1817,37,40-44,1854,15.632051735298692
SIM,1860,25,40-44,1885,3
STAT,1885,27,45-49,1912,1.0455097962338
STAT,1910,45,50-100,1955,0.20029937616513233
STAT,1883,66,na,1949,1518.0731059710808
SIM,1823,46,na,1869,1361
SIM,1870,68,na,1938,1360
STAT,1832,31,20-24,1863,2.1572233935044847
STAT,1829,54,20-24,1883,5.095704918059813E-4
STAT,1942,20,15-19,1962,5.2763260702122015
SIM,1865,34,30-34,1899,20
STAT,1835,28,45-49,1863,0.9143846042858471
STAT,1876,51,30-34,1927,0.005837514158686869
SIM,1860,42,30-34,1902,1
STAT,1861,36,45-49,1897,1.5733947383593307
STAT,1833,30,25-29,1863,8.26106150651109
STAT,1851,29,40-44,1880,2.486915219968523
STAT,1849,40,30-34,1889,0.8771665473186286
STAT,1901,20,50-100,1921,0.5424557223067169
SIM,1881,17,25-29,1898,2
SIM,1947,18,25-29,1965,58
STAT,1878,50,50-100,1928,0.015082641322386238
SIM,1837,29,30-34,1866,31
STAT,1886,18,20-24,1904,17.64513400045351
STAT,1835,47,50-100,1882,0.1647673333413235
STAT,1880,53,45-49,1933,0.014221353924058695
SIM,1889,36,40-44,1925,9
STAT,1859,54,35-39,1913,0.006295064846891757
STAT,1886,19,na,1905,2506.812593414248
SIM,1843,28,45-49,1871,5
SIM,1866,33,35-39,1899,7
SIM,1893,27,45-49,1920,1
SIM,1825,37,40-44,1862,5
STAT,1873,17,25-29,1890,5.429374528694285
SIM,1868,10,na,1878,2417
STAT,1877,50,35-39,1927,0.008557548806966186
SIM,1892,20,30-34,1912,30
STAT,1786,84,na,1870,97.83674172432795
STAT,1849,48,40-44,1897,0.12676433542192872
STAT,1832,39,30-34,1871,3.986086685171815
STAT,1852,25,40-44,1877,2.5662369823599676
STAT,1898,28,40-44,1926,3.816107476270105
STAT,1807,63,na,1870,933.0874470370474
STAT,1865,29,40-44,1894,2.5466675219484043
SIM,1909,21,na,1930,3374
STAT,1875,47,na,1922,2174.4435529820553
STAT,1870,33,35-39,1903,9.345766441456997
SIM,1802,84,na,1886,104
STAT,1882,25,25-29,1907,39.12662436755377
STAT,1818,36,45-49,1854,6.966609133078855
STAT,1882,30,20-24,1912,2.50330304927819
SIM,1840,39,30-34,1879,4
STAT,1892,15,40-44,1907,0.21742562036045335
STAT,1855,39,25-29,1894,2.025441900808892
STAT,1827,51,35-39,1878,0.007755061973798421
STAT,1816,68,na,1884,814.0853579655783
STAT,1867,49,45-49,1916,0.20497934390336556
STAT,1835,51,40-44,1886,0.006965111683706421
STAT,1856,42,50-100,1898,0.7777285401689287
STAT,1858,99,na,1957,1.9372170717436255
STAT,1884,46,40-44,1930,0.1602381643524819
STAT,1829,36,20-24,1865,0.7126556267553943
STAT,1767,93,na,1860,5.594018057837509
STAT,1884,36,50-100,1920,1.1513929274501162
STAT,1863,46,50-100,1909,0.20418472374601443
STAT,1796,74,na,1870,449.037210014683
SIM,1862,49,na,1911,1870
STAT,1894,42,35-39,1936,0.15247466863849682
STAT,1894,38,na,1932,2846.0858671462233
STAT,1896,27,20-24,1923,14.63716097357982
SIM,1853,40,45-49,1893,1
SIM,1910,38,na,1948,3387
SIM,1919,30,35-39,1949,14
SIM,1839,37,40-44,1876,5
SIM,1890,30,20-24,1920,3
STAT,1925,39,50-100,1964,0.47502256240092783
SIM,1873,33,25-29,1906,15
STAT,1812,54,na,1866,1184.3992311710888
STAT,1815,82,na,1897,208.26339634326484
STAT,1890,24,na,1914,2714.450315556405
STAT,1771,115,na,1886,1.3506154984207534E-4
STAT,1849,28,45-49,1877,0.9798601303308149
SIM,1910,2,na,1912,3778
STAT,1885,42,40-44,1927,2.115408508219106
STAT,1918,37,50-100,1955,0.41806615753544524
SIM,1820,93,na,1913,14
STAT,1834,24,35-39,1858,4.774111527257546
STAT,1843,27,40-44,1870,2.4900857891981536
SIM,1814,85,na,1899,92
STAT,1891,30,15-19,1921,0.16778131302745186
STAT,1923,36,na,1959,4121.825403413178
STAT,1838,52,20-24,1890,4.927772630745812E-4
STAT,1866,27,50-100,1893,0.5573776158149986
STAT,1956,15,20-24,1971,169.54146057594315
STAT,1810,50,25-29,1860,0.011760071672986311
STAT,1850,52,20-24,1902,5.174074637353212E-4
STAT,1929,43,50-100,1972,0.14349387627479235
STAT,1801,90,na,1891,27.87048428718302
STAT,1834,21,30-34,1855,14.89100495321922
SIM,1888,26,25-29,1914,47
STAT,1840,32,50-100,1872,0.7323708919734438
STAT,1860,27,40-44,1887,2.3207310050381125
STAT,1874,30,15-19,1904,0.13856010400620275
SIM,1847,39,40-44,1886,6
STAT,1848,41,25-29,1889,0.48271746851751046
STAT,1852,82,na,1934,338.26585056034867
SIM,1873,96,na,1969,32
STAT,1942,19,na,1961,3631.3994412851685
SIM,1842,21,30-34,1863,18
SIM,1951,20,na,1971,4006
SIM,1878,37,20-24,1915,5
STAT,1871,30,45-49,1901,1.6489803386488011
SIM,1872,19,25-29,1891,4
STAT,1864,19,25-29,1883,4.877755285983466
SIM,1873,30,20-24,1903,2
STAT,1888,43,20-24,1931,0.17602570330226414
SIM,1833,24,40-44,1857,4
STAT,1817,38,50-100,1855,4.016028690534212
STAT,1820,73,na,1893,625.717225880112
STAT,1844,51,35-39,1895,0.006007803700736338
SIM,1906,17,25-29,1923,8
STAT,1930,38,na,1968,4631.111976906562
STAT,1821,90,na,1911,42.0035818587379
SIM,1945,20,35-39,1965,12
STAT,1874,52,50-100,1926,0.014499923591369337
STAT,1885,47,50-100,1932,0.23018947881250848
SIM,1968,0,na,1968,4594
STAT,1834,47,40-44,1881,0.11267685463873031
STAT,1915,17,na,1932,3818.844505334295
SIM,1829,31,na,1860,1623
SIM,1870,32,45-49,1902,1
STAT,1881,29,25-29,1910,38.3286377020337
SIM,1847,7,na,1854,2303
SIM,1857,28,45-49,1885,4
SIM,1898,36,35-39,1934,16
STAT,1820,35,45-49,1855,5.186612274008156
STAT,1856,44,na,1900,1680.5686064086792
STAT,1859,47,45-49,1906,0.17661889994594673
STAT,1903,37,50-100,1940,0.3561969718373299
SIM,1893,42,40-44,1935,3
STAT,1813,71,na,1884,628.2219818390845
STAT,1835,53,35-39,1888,0.005474571176476985
STAT,1896,45,20-24,1941,0.008529781087805237
SIM,1865,27,40-44,1892,6
STAT,1818,51,40-44,1869,0.0219827804221812
SIM,1894,18,20-24,1912,23
SIM,1851,85,na,1936,156
STAT,1870,16,45-49,1886,0.0614771579556763
STAT,1879,45,20-24,1924,0.011984782493585835
STAT,1899,31,30-34,1930,22.692262608568843
STAT,1825,39,40-44,1864,5.060022881907907
STAT,1922,19,na,1941,4002.6186945170043
STAT,1835,27,na,1862,1794.3936114241346
STAT,1840,35,15-19,1875,0.0445013854800925
STAT,1915,2,na,1917,4030.612963982545
STAT,1900,63,na,1963,2513.3638685768556
SIM,1875,12,na,1887,2543
STAT,1860,41,25-29,1901,0.4944467564475964
STAT,1767,101,na,1868,0.11295793069620937
STAT,1857,34,30-34,1891,12.897180317026821
STAT,1894,40,40-44,1934,2.7582862021584007
SIM,1907,20,15-19,1927,4
SIM,1933,6,na,1939,5127
SIM,1806,66,na,1872,807
SIM,1827,27,20-24,1854,10
STAT,1903,47,30-34,1950,0.07305292511888206
STAT,1848,37,40-44,1885,3.3520110954164277
SIM,1857,40,30-34,1897,1
SIM,1811,57,na,1868,1020
STAT,1820,34,35-39,1854,30.243371904659618
STAT,1928,30,35-39,1958,10.806533948031788
STAT,1837,17,50-100,1854,0.06006398150477117
STAT,1840,15,20-24,1855,15.242517481363532
SIM,1791,63,na,1854,786
SIM,1833,39,40-44,1872,4
STAT,1882,32,15-19,1914,0.13083211786959828
SIM,1896,25,20-24,1921,17
SIM,1947,15,na,1962,3850
SIM,1852,44,45-49,1896,2
STAT,1837,48,20-24,1885,0.007981566537901646
STAT,1839,39,40-44,1878,3.4113190179913624
STAT,1844,63,na,1907,1239.2415631935999
STAT,1848,19,40-44,1867,0.1664987572247023
STAT,1948,16,25-29,1964,46.86517515693126
STAT,1843,46,na,1889,1532.0660500623671
STAT,1855,29,25-29,1884,30.8847491893118
SIM,1863,66,na,1929,1335
STAT,1880,20,45-49,1900,0.6986305682013504
STAT,1850,22,25-29,1872,48.43471275275703
STAT,1834,37,40-44,1871,3.379175699386495
STAT,1891,38,25-29,1929,3.3484604857604494
STAT,1887,36,na,1923,2501.5062983944968
STAT,1937,20,35-39,1957,8.668159142436322
SIM,1830,48,na,1878,1429
SIM,1855,47,na,1902,1799
STAT,1847,28,na,1875,1903.5959033299105
STAT,1838,79,na,1917,469.34441799889123
STAT,1888,25,20-24,1913,13.186415998469245
STAT,1838,29,25-29,1867,35.60893768753049
STAT,1853,41,35-39,1894,1.3766176702652428
STAT,1839,46,30-34,1885,0.06651217094515578
STAT,1859,52,40-44,1911,0.007873500856712129
STAT,1855,27,na,1882,1767.7211452046815
STAT,1851,13,na,1864,2078.373559247953
SIM,1944,4,na,1948,3966
SIM,1816,39,40-44,1855,7
SIM,1831,33,20-24,1864,2
SIM,1936,23,45-49,1959,4
SIM,1819,84,na,1903,169
SIM,1888,62,na,1950,2065
STAT,1857,27,40-44,1884,2.2988689095587116
STAT,1928,23,45-49,1951,1.3230050048671511
SIM,1842,49,na,1891,1476
STAT,1876,52,40-44,1928,0.010220337137902028
STAT,1864,83,na,1947,334.2518478915459
SIM,1893,37,45-49,1930,5
STAT,1864,63,na,1927,1502.3338277940097
SIM,1842,29,na,1871,1808
STAT,1843,45,40-44,1888,0.1180846713237542
SIM,1879,8,na,1887,2643
SIM,1843,66,na,1909,1151
STAT,1805,52,na,1857,1209.5951733312163
SIM,1850,48,na,1898,1656
STAT,1847,42,20-24,1889,0.11776302747561437
SIM,1891,26,50-100,1917,4
STAT,1797,68,na,1865,720.9554338785719
STAT,1876,47,45-49,1923,0.22926328900239046
STAT,1840,33,20-24,1873,2.138282515797543
STAT,1844,26,45-49,1870,0.9508224271734453
STAT,1949,4,na,1953,4349.677517987807
SIM,1863,29,25-29,1892,39
SIM,1875,3,na,1878,2828
STAT,1948,23,15-19,1971,5.772298781596808
SIM,1799,79,na,1878,276
STAT,1818,53,35-39,1871,0.017273439352797168
STAT,1852,50,na,1902,1583.449459691553
STAT,1811,44,35-39,1855,6.3341979576106935
STAT,1823,33,20-24,1856,6.145161346367581
STAT,1914,43,50-100,1957,0.10979990004608807
STAT,1861,40,30-34,1901,0.9121617125711396
STAT,1896,47,15-19,1943,2.8020670413037116E-4
SIM,1924,42,na,1966,4178
STAT,1929,21,na,1950,4375.609399157773
SIM,1884,29,45-49,1913,1
SIM,1916,23,na,1939,3524
SIM,1888,44,25-29,1932,3
SIM,1851,27,40-44,1878,3
SIM,1792,69,na,1861,641
STAT,1760,106,na,1866,0.009563778399945332
STAT,1845,36,50-100,1881,0.9223536080947987
STAT,1890,24,20-24,1914,79.09331771666815
STAT,1892,59,na,1951,2299.6045624840285
SIM,1919,51,na,1970,3769
STAT,1948,12,na,1960,4246.93584184592
STAT,1885,44,35-39,1929,1.6821249491815888
STAT,1850,18,40-44,1868,0.15662564302956428
STAT,1856,64,na,1920,1281.305392493088
SIM,1939,21,20-24,1960,93
STAT,1857,49,50-100,1906,0.17916635083315327
STAT,1840,28,25-29,1868,34.36493009710269
SIM,1858,5,na,1863,2384
STAT,1826,38,45-49,1864,2.105680728772721
STAT,1829,39,25-29,1868,2.5162985888517126
STAT,1891,22,15-19,1913,3.8558373841591083
SIM,1908,30,30-34,1938,27
STAT,1818,46,45-49,1864,0.5108367551148416
STAT,1819,39,15-19,1858,0.1337255621450766
SIM,1883,25,35-39,1908,8
STAT,1885,50,40-44,1935,0.010055751656524729
SIM,1866,45,50-100,1911,2
SIM,1938,28,25-29,1966,61
STAT,1860,19,40-44,1879,0.15979291277009391
STAT,1876,26,40-44,1902,2.9337180581315407
SIM,1870,17,20-24,1887,14
SIM,1857,70,na,1927,1036
SIM,1929,41,na,1970,4519
STAT,1820,42,35-39,1862,3.327649692933318
SIM,1841,37,25-29,1878,2
STAT,1936,25,45-49,1961,1.5632315536956023
STAT,1939,26,25-29,1965,62.53824192979359
STAT,1868,53,45-49,1921,0.012870626093159783
SIM,1861,34,45-49,1895,4
SIM,1835,26,45-49,1861,4
STAT,1835,43,40-44,1878,1.6934931948281935
SIM,1843,43,40-44,1886,6
SIM,1878,29,20-24,1907,14
SIM,1912,3,na,1915,3845
STAT,1872,51,45-49,1923,0.013817429828656042
STAT,1839,25,25-29,1864,35.99562363276932
SIM,1855,24,20-24,1879,75
SIM,1898,26,40-44,1924,3
STAT,1774,95,na,1869,1.9068165475134993
STAT,1858,48,40-44,1906,0.12521136312940717
STAT,1917,26,50-100,1943,0.9895053758165594
STAT,1856,38,50-100,1894,0.9004534216124865
STAT,1862,17,20-24,1879,16.400320062961267
SIM,1848,38,45-49,1886,3
SIM,1860,78,na,1938,585
STAT,1882,49,na,1931,2023.8066685728531
STAT,1830,39,20-24,1869,0.6093997027255356
SIM,1918,34,na,1952,3753
STAT,1850,25,30-34,1875,21.192982511491273
STAT,1840,25,20-24,1865,9.73869354184213
STAT,1891,19,40-44,1910,0.21262723836854866
SIM,1823,31,20-24,1854,2
STAT,1846,49,25-29,1895,0.04183013325363506
STAT,1914,44,50-100,1958,0.10960775022100745
SIM,1938,20,15-19,1958,4
STAT,1878,39,20-24,1917,0.7512784509261506
SIM,1799,91,na,1890,15
STAT,1844,43,35-39,1887,1.271649736784525
STAT,1898,36,40-44,1934,5.623220652149958
SIM,1877,78,na,1955,711
STAT,1885,37,45-49,1922,1.877153939317244
SIM,1831,33,na,1864,1660
STAT,1882,22,20-24,1904,63.310966889465284
SIM,1925,26,50-100,1951,1
STAT,1847,83,na,1930,292.74108502031095
STAT,1865,33,25-29,1898,8.733384609405368
STAT,1847,44,15-19,1891,0.01004601065230775
SIM,1855,37,25-29,1892,2
SIM,1875,23,35-39,1898,8
SIM,1835,47,na,1882,1476
SIM,1882,23,25-29,1905,63
STAT,1849,34,50-100,1883,0.7091127429106039
STAT,1902,48,25-29,1950,0.042773988964280085
SIM,1834,38,45-49,1872,1
STAT,1873,35,25-29,1908,2.784799243649072
STAT,1873,41,50-100,1914,1.016781814861425
SIM,1894,40,35-39,1934,2
STAT,1886,40,35-39,1926,1.8252634699393748
STAT,1783,102,na,1885,0.07291192967630478
STAT,1823,41,20-24,1864,0.21779008995174318
STAT,1876,54,35-39,1930,0.008171420339065783
SIM,1863,39,25-29,1902,2
SIM,1904,22,na,1926,3278
SIM,1871,85,na,1956,248
SIM,1895,12,na,1907,3284
STAT,1866,54,25-29,1920,0.0030013620147715525
STAT,1894,17,45-49,1911,0.07930475214256362
SIM,1911,55,na,1966,3148
STAT,1919,22,40-44,1941,3.4782074679496198
STAT,1893,29,45-49,1922,1.3206668456502961
SIM,1890,22,20-24,1912,82
STAT,1935,37,na,1972,4969.775679813376
SIM,1927,22,40-44,1949,4
STAT,1849,31,na,1880,1901.517537245584
STAT,1890,32,20-24,1922,3.1219404499958063
STAT,1875,25,35-39,1900,9.432815167597294
SIM,1939,23,15-19,1962,5
STAT,1859,37,45-49,1896,1.498883758820374
STAT,1894,35,45-49,1929,2.4431763193526326
STAT,1859,30,50-100,1889,0.6989518674503717
SIM,1863,11,na,1874,2267
SIM,1901,57,na,1958,2712
STAT,1856,105,na,1961,0.06791259798100438
SIM,1843,25,40-44,1868,6
STAT,1880,15,15-19,1895,5.937886706026686
STAT,1880,50,40-44,1930,0.010635524894254938
SIM,1835,44,45-49,1879,3
STAT,1836,27,20-24,1863,9.83019901818764
STAT,1852,28,45-49,1880,0.9308319549968058
SIM,1859,61,na,1920,1479
SIM,1847,18,35-39,1865,1
SIM,1885,40,40-44,1925,6
SIM,1838,51,50-100,1889,1
STAT,1846,98,na,1944,2.4094553656950826
STAT,1842,84,na,1926,240.90879242678517
STAT,1810,83,na,1893,167.94096730020743
STAT,1815,42,25-29,1857,1.625418496167842
STAT,1885,19,45-49,1904,0.06118064849019562
SIM,1867,25,na,1892,2309
SIM,1867,48,na,1915,2153
STAT,1857,81,na,1938,402.90253873516167
STAT,1817,53,na,1870,1218.2804174096163
SIM,1849,33,35-39,1882,9
SIM,1860,28,45-49,1888,3
STAT,1827,44,45-49,1871,1.3873503147519421
STAT,1910,47,20-24,1957,0.00974076927288103
STAT,1913,33,50-100,1946,0.7738532438116335
SIM,1878,64,na,1942,1711
SIM,1829,29,25-29,1858,37
SIM,1898,33,30-34,1931,30
STAT,1807,47,25-29,1854,0.2222386963302359
SIM,1919,23,45-49,1942,1
STAT,1928,15,45-49,1943,0.597371984047579
STAT,1840,18,25-29,1858,4.7865177056600805
SIM,1930,38,na,1968,4644
STAT,1791,75,na,1866,386.9908238116069
STAT,1831,49,50-100,1880,0.170521512229206
STAT,1877,40,40-44,1917,2.226383936282461
STAT,1852,109,na,1961,0.0017208144367077073
STAT,1874,38,25-29,1912,2.765284314420139
STAT,1821,35,na,1856,1540.5154179716362
SIM,1844,52,na,1896,1430
SIM,1876,27,45-49,1903,1
STAT,1832,41,15-19,1873,0.010346104984263407
SIM,1832,24,25-29,1856,42
SIM,1944,25,45-49,1969,1
SIM,1947,15,20-24,1962,149
SIM,1842,24,35-39,1866,7
SIM,1837,39,25-29,1876,1
STAT,1842,24,40-44,1866,1.876131830884948
STAT,1831,45,na,1876,1445.1868327001732
STAT,1861,11,na,1872,2165.0909875957004
SIM,1894,58,na,1952,2479
STAT,1910,18,na,1928,3606.0022849845973
STAT,1933,26,na,1959,4701.131320833764
SIM,1868,43,45-49,1911,4
SIM,1924,20,15-19,1944,10
SIM,1844,27,20-24,1871,11
STAT,1888,38,25-29,1926,3.1985307579884648
SIM,1842,29,40-44,1871,3
SIM,1822,38,25-29,1860,1
SIM,1832,28,40-44,1860,2
STAT,1824,31,15-19,1855,0.4059277243125942
STAT,1814,45,15-19,1859,0.0012650396547704804
STAT,1918,21,35-39,1939,9.622733330150417
SIM,1882,38,25-29,1920,2
STAT,1849,43,35-39,1892,1.348062353147032
STAT,1849,105,na,1954,0.021986633015124726
STAT,1839,43,25-29,1882,0.4448794725499463
STAT,1832,34,25-29,1866,7.907861565622199
SIM,1852,36,45-49,1888,5
SIM,1847,25,25-29,1872,45
SIM,1861,41,35-39,1902,1
SIM,1921,33,50-100,1954,2
SIM,1926,21,35-39,1947,15
STAT,1881,36,15-19,1917,0.05149367279334555
STAT,1947,25,20-24,1972,19.526711120305013
STAT,1861,33,40-44,1894,3.3920598980013823
STAT,1856,40,20-24,1896,0.11823871297337354
STAT,1879,53,20-24,1932,7.179924450845712E-4
SIM,1813,91,na,1904,25
SIM,1782,90,na,1872,18
SIM,1896,38,25-29,1934,4
STAT,1834,29,40-44,1863,2.4028388971114736
STAT,1881,26,20-24,1907,10.742939562499254
STAT,1916,20,15-19,1936,5.30091914741519
SIM,1871,28,20-24,1899,14
STAT,1866,28,45-49,1894,0.9640254245753481
STAT,1844,36,45-49,1880,1.6245407890762327
SIM,1812,74,na,1886,443
SIM,1840,34,25-29,1874,14
SIM,1890,44,na,1934,2858
STAT,1824,35,30-34,1859,9.184357469927255
STAT,1852,46,45-49,1898,0.17158253252001593
STAT,1863,28,20-24,1891,9.691341958201141
STAT,1865,57,na,1922,1720.7790587130407
STAT,1896,48,25-29,1944,0.04002942160149139
SIM,1865,77,na,1942,709
STAT,1845,17,na,1862,2053.000165407381
STAT,1888,45,15-19,1933,4.5103111058164157E-4
SIM,1850,24,40-44,1874,2
SIM,1873,29,40-44,1902,8
STAT,1851,65,na,1916,1215.6626369549308
STAT,1855,36,20-24,1891,0.5504223071005335
STAT,1837,30,na,1867,1800.4630893806423
STAT,1834,65,na,1899,1047.7259204724112
STAT,1881,31,na,1912,2186.6626946735278
SIM,1830,27,20-24,1857,11
SIM,1898,72,na,1970,1926
STAT,1859,104,na,1963,0.2047148192995044
STAT,1839,50,50-100,1889,0.010305587818092083
STAT,1874,93,na,1967,97.89665937704918
STAT,1916,34,na,1950,3657.1614225287417
SIM,1894,33,45-49,1927,3
STAT,1866,36,25-29,1902,2.5207804205628475
STAT,1893,76,na,1969,1527.440776289622
STAT,1930,25,50-100,1955,1.1966513150788638
STAT,1829,28,20-24,1857,14.590951170007873
STAT,1842,49,40-44,1891,0.12139139998736913
STAT,1871,19,15-19,1890,5.537182811089105
STAT,1892,44,25-29,1936,0.052052109021150574
STAT,1845,40,45-49,1885,1.1064573825794435
STAT,1857,17,40-44,1874,0.16016884014356841
STAT,1910,46,50-100,1956,0.19985671454380732
SIM,1832,35,30-34,1867,6
STAT,1864,42,20-24,1906,0.13355146512015145
STAT,1875,22,30-34,1897,17.29598827073843
STAT,1829,29,30-34,1858,28.21096949087247
STAT,1857,38,na,1895,1746.640167252907
SIM,1871,46,50-100,1917,2
STAT,1955,14,na,1969,4923.884778998098
SIM,1827,42,45-49,1869,4
STAT,1870,48,na,1918,2058.866410236377
SIM,1857,25,40-44,1882,2
STAT,1898,43,30-34,1941,0.10132575867331817
SIM,1850,23,30-34,1873,18
SIM,1872,79,na,1951,589
STAT,1844,18,45-49,1862,0.05733086302380923
STAT,1891,15,25-29,1906,6.653938077573472
SIM,1917,40,na,1957,3641
STAT,1912,20,na,1932,3475.7155973205327
STAT,1911,49,30-34,1960,0.07926247326053501
STAT,1808,49,na,1857,1270.519379299443
SIM,1837,28,20-24,1865,8
STAT,1926,20,30-34,1946,33.18196053101735
STAT,1870,26,45-49,1896,1.0325171575131347
STAT,1854,25,15-19,1879,0.3793898383645353
SIM,1874,36,25-29,1910,6
SIM,1840,16,25-29,1856,4
STAT,1863,38,20-24,1901,0.6358773839509678
STAT,1881,16,20-24,1897,16.218909330939354
STAT,1853,42,45-49,1895,1.131257013372449
SIM,1836,64,na,1900,1086
STAT,1825,53,25-29,1878,0.0034135725467476547
STAT,1835,25,40-44,1860,2.5208928153170014
STAT,1883,24,30-34,1907,16.394694554679827
SIM,1939,24,25-29,1963,95
SIM,1860,38,45-49,1898,1
STAT,1863,46,na,1909,1870.4524338501342
STAT,1832,26,25-29,1858,35.14401858468225
STAT,1876,44,40-44,1920,2.1656715314163733
SIM,1820,40,35-39,1860,4
SIM,1806,98,na,1904,2
STAT,1815,39,30-34,1854,16.339748107449978
STAT,1855,26,20-24,1881,8.752443453878094
STAT,1888,46,25-29,1934,0.06448999737476717
STAT,1852,38,45-49,1890,1.438082026229344
SIM,1884,44,40-44,1928,6
SIM,1841,30,25-29,1871,12
STAT,1850,48,na,1898,1566.0376630605651
STAT,1868,45,45-49,1913,0.21483743365102034
STAT,1860,37,40-44,1897,3.355398259860437
STAT,1896,19,20-24,1915,22.001007470875617
STAT,1849,25,40-44,1874,2.7014041476515747
STAT,1880,38,50-100,1918,1.2166869703712049
SIM,1962,2,na,1964,4637
STAT,1893,46,35-39,1939,0.09487884780040069
STAT,1777,112,na,1889,6.862244948471607E-4
STAT,1965,1,na,1966,4642.81955799519
SIM,1834,48,50-100,1882,3
STAT,1831,50,45-49,1881,0.00946210145915428
STAT,1861,43,35-39,1904,1.4120960528500015
STAT,1839,18,35-39,1857,0.4750893055518412
STAT,1850,21,15-19,1871,2.811444340984332
SIM,1823,39,30-34,1862,2
SIM,1840,26,25-29,1866,38
SIM,1824,33,30-34,1857,18
SIM,1907,18,na,1925,3508
STAT,1840,36,25-29,1876,2.258137086313545
STAT,1900,43,45-49,1943,0.13521653925439406
SIM,1897,6,na,1903,3398
STAT,1809,53,40-44,1862,0.027734104603902254
STAT,1921,25,na,1946,3970.937395594398
SIM,1863,26,20-24,1889,10
STAT,1888,28,25-29,1916,47.06110559692251
SIM,1848,65,na,1913,1223
STAT,1862,29,na,1891,1913.8618562917525
STAT,1804,102,na,1906,0.09820380416867831
STAT,1832,33,15-19,1865,0.11116948415246497
STAT,1887,19,50-100,1906,0.05149132274534564
SIM,1818,99,na,1917,1
STAT,1843,53,40-44,1896,0.006996693517652853
STAT,1860,22,35-39,1882,4.610974420095095
STAT,1881,19,25-29,1900,5.143759559024031
SIM,1859,81,na,1940,384
SIM,1891,24,30-34,1915,24
STAT,1855,46,15-19,1901,2.8505747183272195E-4
STAT,1829,46,20-24,1875,0.009937662845734564
STAT,1822,37,20-24,1859,1.3568374006470512
SIM,1805,72,na,1877,522
STAT,1845,29,15-19,1874,0.3851873494861138
STAT,1857,35,40-44,1892,3.292481511446944
STAT,1865,15,25-29,1880,5.559954447755031
STAT,1813,44,50-100,1857,3.0446950541217297
SIM,1899,26,na,1925,3174
STAT,1894,43,45-49,1937,0.1252644084259372
STAT,1904,48,50-100,1952,0.18536915120798775
SIM,1934,20,30-34,1954,38
STAT,1903,39,30-34,1942,1.5306733449067094
STAT,1873,27,25-29,1900,40.529603477621656
STAT,1897,41,20-24,1938,0.013996006734271042
STAT,1827,107,na,1934,0.0027240844987468085
SIM,1881,27,25-29,1908,29
STAT,1842,23,30-34,1865,16.15305041815566
SIM,1801,67,na,1868,725
STAT,1826,48,45-49,1874,0.21496123931401837
SIM,1839,27,40-44,1866,3
SIM,1789,69,na,1858,590
STAT,1837,38,20-24,1875,0.6028148958966504
STAT,1839,96,na,1935,5.7169814777103936
SIM,1829,37,25-29,1866,2
SIM,1892,37,50-100,1929,1
STAT,1835,82,na,1917,296.96851005562996
STAT,1811,68,na,1879,766.6307463494887
SIM,1834,22,35-39,1856,3
STAT,1865,36,30-34,1901,4.585501761882271
SIM,1810,44,40-44,1854,2
STAT,1847,45,25-29,1892,0.042898110855311304
SIM,1911,39,30-34,1950,1
STAT,1884,37,50-100,1921,1.1458777553276298
SIM,1873,15,25-29,1888,6
SIM,1896,28,25-29,1924,52
STAT,1896,37,20-24,1933,0.9617769335189827
SIM,1884,26,40-44,1910,3
SIM,1873,36,30-34,1909,8
STAT,1886,15,45-49,1901,0.06548887008842971
STAT,1819,42,45-49,1861,3.1524836182688154
STAT,1893,12,na,1905,3093.9173536183466
STAT,1857,42,30-34,1899,0.8555183726372809
STAT,1849,32,30-34,1881,13.796210390990998
SIM,1887,25,na,1912,2499
STAT,1827,52,45-49,1879,0.012816093297245928
STAT,1921,38,35-39,1959,2.5487773204867294
SIM,1815,40,25-29,1855,1
STAT,1938,22,15-19,1960,4.977072158700898
SIM,1874,29,35-39,1903,12
SIM,1863,19,30-34,1882,1
STAT,1880,14,na,1894,2563.6842898509635
SIM,1857,32,30-34,1889,19
SIM,1948,17,30-34,1965,15
STAT,1852,45,35-39,1897,0.10250996862548956
STAT,1898,18,40-44,1916,0.23321422957376592
STAT,1839,42,15-19,1881,0.009690663267315368
STAT,1874,31,25-29,1905,9.926803483207197
SIM,1882,31,25-29,1913,10
STAT,1850,28,na,1878,1781.6646425107695
SIM,1949,21,30-34,1970,40
STAT,1883,17,40-44,1900,0.16940725758948064
STAT,1886,33,45-49,1919,1.732834732071948
STAT,1855,19,30-34,1874,1.3313466931175837
STAT,1896,61,na,1957,2375.4489584485277
STAT,1876,22,50-100,1898,0.3980053960727546
STAT,1835,50,30-34,1885,0.004016990545771236
SIM,1874,2,na,1876,2960
STAT,1848,14,na,1862,2179.0358506984553
STAT,1885,34,40-44,1919,4.048678702630609
STAT,1949,23,30-34,1972,31.67328580400939
STAT,1862,31,35-39,1893,8.21324683025033
STAT,1883,28,25-29,1911,39.04222737934543
SIM,1872,42,50-100,1914,3
SIM,1839,84,na,1923,209
STAT,1841,28,40-44,1869,2.546632934176271
SIM,1844,34,45-49,1878,1
STAT,1781,85,na,1866,82.25426535664577
STAT,1888,42,na,1930,2577.2026378378137
STAT,1919,49,35-39,1968,0.1313336779269283
SIM,1891,61,na,1952,2210
STAT,1860,47,35-39,1907,0.10681106366478427
SIM,1815,43,30-34,1858,2
STAT,1858,105,na,1963,0.09424662769432093
SIM,1943,21,35-39,1964,8
STAT,1848,47,35-39,1895,0.10354313919151982
STAT,1868,27,45-49,1895,1.0007629639228526
SIM,1847,28,na,1875,1933
SIM,1843,14,na,1857,2202
SIM,1851,33,na,1884,1811
STAT,1844,40,30-34,1884,0.8389931694487558
STAT,1947,20,15-19,1967,5.687557707108994
SIM,1888,18,25-29,1906,9
STAT,1874,34,30-34,1908,16.708243206937947
SIM,1880,39,25-29,1919,2
SIM,1833,34,35-39,1867,10
SIM,1882,34,30-34,1916,18
SIM,1919,29,50-100,1948,5
STAT,1924,22,15-19,1946,5.9337524226848
SIM,1942,16,na,1958,3565
STAT,1911,43,20-24,1954,0.01582862017201039
SIM,1864,32,20-24,1896,2
SIM,1838,24,20-24,1862,60
SIM,1870,40,45-49,1910,1
STAT,1905,62,na,1967,2739.5433533241076
STAT,1848,33,25-29,1881,7.99336606595539
SIM,1798,74,na,1872,417
SIM,1925,30,30-34,1955,24
STAT,1888,35,20-24,1923,0.868786209616394
STAT,1840,41,20-24,1881,0.11012085892753604
SIM,1891,0,na,1891,3204
STAT,1818,48,50-100,1866,0.5158130570081935
SIM,1849,38,40-44,1887,4
STAT,1854,48,20-24,1902,0.008477939471833543
STAT,1829,54,50-100,1883,0.010429208986042746
SIM,1858,36,40-44,1894,2
SIM,1931,5,na,1936,4942
SIM,1828,45,na,1873,1503
SIM,1824,31,na,1855,1635
SIM,1856,15,25-29,1871,6
STAT,1935,21,35-39,1956,12.11692105246427
STAT,1852,17,40-44,1869,0.16037734011793622
STAT,1902,45,20-24,1947,0.009114614888762536
STAT,1836,34,45-49,1870,1.3980502548565603
STAT,1865,41,25-29,1906,0.5523453243106308
STAT,1892,26,25-29,1918,50.224938775234236
STAT,1856,32,20-24,1888,2.0167577680779756
SIM,1891,28,25-29,1919,49
STAT,1857,38,45-49,1895,1.4779022476144734
SIM,1849,30,30-34,1879,25
STAT,1870,79,na,1949,647.903681330627
STAT,1928,35,na,1963,4499.345812608039
STAT,1802,52,40-44,1854,0.030822437181551664
SIM,1874,28,45-49,1902,1
SIM,1818,90,na,1908,47
STAT,1895,26,15-19,1921,0.5606970416948643
SIM,1923,1,na,1924,4603
STAT,1845,32,45-49,1877,1.4672062672440396
SIM,1833,35,25-29,1868,2
STAT,1947,18,na,1965,3915.7976523379225
STAT,1830,29,20-24,1859,10.573208058036766
STAT,1828,35,15-19,1863,0.05364655621855967
SIM,1807,52,na,1859,1166
STAT,1928,1,na,1929,4970.840657913719
STAT,1883,20,15-19,1903,3.0738316061016686
SIM,1853,32,45-49,1885,2
STAT,1825,35,25-29,1860,3.9273998358803253
STAT,1853,27,20-24,1880,10.285133671131582
SIM,1897,16,25-29,1913,8
SIM,1829,26,20-24,1855,11
SIM,1917,31,35-39,1948,10
SIM,1815,71,na,1886,641
SIM,1852,33,40-44,1885,3
STAT,1877,35,45-49,1912,1.9720391983456826
SIM,1954,9,na,1963,4486
STAT,1872,46,15-19,1918,3.8010672199600206E-4
STAT,1843,15,50-100,1858,0.042791130836110705
STAT,1836,41,35-39,1877,1.412981218654202
STAT,1951,16,50-100,1967,0.4215882318103078
STAT,1839,54,30-34,1893,0.0038542116778020495
SIM,1891,20,15-19,1911,3
STAT,1850,26,40-44,1876,2.50295300122869
STAT,1848,48,25-29,1896,0.042262356601965895
STAT,1869,36,15-19,1905,0.05163941528472715
STAT,1843,69,na,1912,991.2473354739639
SIM,1855,34,20-24,1889,2
SIM,1932,15,25-29,1947,54
SIM,1834,62,na,1896,1107
SIM,1889,32,25-29,1921,16
STAT,1841,29,30-34,1870,21.25429826380854
SIM,1835,19,20-24,1854,16
STAT,1859,44,40-44,1903,1.6683810355657311
STAT,1825,34,35-39,1859,14.685890542867972
STAT,1902,47,15-19,1949,2.994187272929078E-4
SIM,1849,48,50-100,1897,1
SIM,1861,27,20-24,1888,6
SIM,1879,25,20-24,1904,12
SIM,1847,80,na,1927,403
SIM,1875,20,30-34,1895,24
STAT,1869,40,35-39,1909,1.673959793308083
SIM,1818,44,45-49,1862,2
SIM,1946,5,na,1951,4033
STAT,1909,31,35-39,1940,8.272192408443924
STAT,1871,22,45-49,1893,0.6541380513595076
SIM,1847,29,40-44,1876,6
SIM,1927,39,na,1966,4366
SIM,1927,38,na,1965,4373
STAT,1759,111,na,1870,5.032961821022447E-4
STAT,1860,58,na,1918,1515.8476035254603
SIM,1812,47,50-100,1859,3
SIM,1923,25,na,1948,4130
STAT,1851,88,na,1939,98.7539841464087
STAT,1924,15,25-29,1939,48.97629539060341
STAT,1849,54,25-29,1903,0.0025830027223446533
STAT,1851,25,25-29,1876,36.14558666475664
SIM,1856,33,25-29,1889,9
STAT,1844,33,40-44,1877,3.564585317431517
SIM,1833,28,35-39,1861,9
STAT,1839,47,40-44,1886,0.1161356261974617
STAT,1831,45,15-19,1876,2.924002111321785E-4
STAT,1851,43,25-29,1894,0.45859425364665707
SIM,1885,35,45-49,1920,2
SIM,1877,58,na,1935,1884
STAT,1889,16,25-29,1905,6.625081060116939
SIM,1865,38,25-29,1903,2
STAT,1857,50,na,1907,1627.2948780244724
SIM,1870,6,na,1876,2535
STAT,1862,35,50-100,1897,1.00108860134133
SIM,1838,44,na,1882,1575
STAT,1862,40,45-49,1902,1.2210618855306559
STAT,1892,25,35-39,1917,11.494554939621723
STAT,1810,53,30-34,1863,0.018610333550439326
STAT,1872,39,25-29,1911,2.700803022492266
STAT,1912,37,30-34,1949,1.680535902173151
SIM,1833,27,45-49,1860,3
STAT,1773,115,na,1888,1.600245737828977E-4
SIM,1896,17,20-24,1913,19
STAT,1882,29,40-44,1911,2.732401014336217
STAT,1892,19,35-39,1911,0.6457784157287039
STAT,1888,17,20-24,1905,19.79298725685547
SIM,1798,85,na,1883,74
STAT,1841,99,na,1940,1.305654510595508
STAT,1848,40,15-19,1888,0.01051487589175948
SIM,1794,92,na,1886,8
SIM,1853,8,na,1861,2246
STAT,1895,24,na,1919,2894.556209944796
STAT,1860,40,15-19,1900,0.010692178191524012
STAT,1915,17,25-29,1932,8.56838068882539
SIM,1899,37,40-44,1936,1
SIM,1917,49,na,1966,3572
STAT,1841,21,20-24,1862,60.61981411152517
STAT,1852,2,na,1854,2626.0
SIM,1913,35,na,1948,3420
STAT,1827,37,20-24,1864,0.8001210200777525
STAT,1831,38,25-29,1869,2.1808730507122704
STAT,1850,18,50-100,1868,0.04195328703806921
STAT,1892,18,45-49,1910,0.0770903670906107
STAT,1950,19,50-100,1969,0.41822556484599194
STAT,1852,35,40-44,1887,3.2578083446463246
SIM,1921,13,na,1934,4286
SIM,1850,27,45-49,1877,6
STAT,1857,53,20-24,1910,5.409674021847006E-4
STAT,1932,17,25-29,1949,54.20818660242023
SIM,1948,18,40-44,1966,2
STAT,1826,77,na,1903,472.0297646787591
STAT,1834,96,na,1930,5.323469358437458
STAT,1814,97,na,1911,2.4692223683972725
STAT,1858,8,na,1866,2124.6616049432423
SIM,1903,37,30-34,1940,1
STAT,1889,34,25-29,1923,11.843214619826785
STAT,1853,16,45-49,1869,0.05982041475657498
SIM,1893,47,50-100,1940,1
STAT,1839,29,40-44,1868,2.4765973532219983
STAT,1872,43,45-49,1915,1.4079375630548474
STAT,1841,35,30-34,1876,4.419860355998882
STAT,1893,18,40-44,1911,0.21854882020546015
SIM,1880,43,45-49,1923,4
SIM,1890,13,na,1903,3224
STAT,1877,28,20-24,1905,11.455589507470771
SIM,1838,17,30-34,1855,3
STAT,1803,51,45-49,1854,0.04314626575528545
SIM,1920,37,30-34,1957,5
STAT,1856,39,40-44,1895,3.1940862442881954
STAT,1891,10,na,1901,3027.5244304363614
STAT,1898,31,15-19,1929,0.18280076156900243
STAT,1844,32,na,1876,1799.9776200252415
STAT,1821,49,20-24,1870,0.018384221565742702
SIM,1844,51,na,1895,1444
SIM,1894,27,na,1921,2987
STAT,1810,46,40-44,1856,0.5808033007635803
STAT,1762,94,na,1856,1.8738217619999997
SIM,1856,44,30-34,1900,1
SIM,1880,14,na,1894,2624
SIM,1928,20,35-39,1948,11
STAT,1811,50,40-44,1861,0.034886630811309285
STAT,1870,23,40-44,1893,1.925225970108837
STAT,1899,37,na,1936,3073.6466282477054
SIM,1919,16,20-24,1935,147
SIM,1923,17,25-29,1940,53
STAT,1873,40,20-24,1913,0.15369642407844855
STAT,1889,48,35-39,1937,0.09094382833321318
STAT,1861,15,40-44,1876,0.16709230267609385
STAT,1862,24,45-49,1886,0.5683320658610798
STAT,1902,11,na,1913,3448.2201977273553
STAT,1842,27,25-29,1869,37.88344731219484
STAT,1917,15,35-39,1932,0.8570090104404351
SIM,1912,35,30-34,1947,2
STAT,1851,18,35-39,1869,0.47706859707494886
STAT,1893,7,na,1900,3121.288759738872
STAT,1894,28,20-24,1922,14.192428341361493
SIM,1866,94,na,1960,26
STAT,1861,98,na,1959,4.656178820645347
SIM,1826,66,na,1892,863
SIM,1841,29,45-49,1870,4
STAT,1895,23,na,1918,2903.7902629810733
STAT,1898,46,35-39,1944,0.1012455586436711
STAT,1884,83,na,1967,657.3192171827621
SIM,1834,27,40-44,1861,2
SIM,1862,80,na,1942,476
SIM,1792,89,na,1881,33
STAT,1883,46,25-29,1929,0.05350135975903844
STAT,1889,49,25-29,1938,0.0371018387884763
STAT,1851,24,35-39,1875,4.941159656286833
STAT,1939,33,15-19,1972,0.12378815075009206
SIM,1897,34,25-29,1931,19
SIM,1820,41,45-49,1861,1
STAT,1833,29,45-49,1862,0.8850442123208767
STAT,1842,27,45-49,1869,0.9943427186893699
STAT,1904,35,30-34,1939,1.5735829367199003
STAT,1874,15,50-100,1889,0.04768511355327623
SIM,1841,36,35-39,1877,15
SIM,1868,25,45-49,1893,5
SIM,1881,24,20-24,1905,52
STAT,1876,64,na,1940,1696.6461533081385
STAT,1872,50,na,1922,2069.612599722142
SIM,1929,38,25-29,1967,3
STAT,1805,101,na,1906,0.19919128224743027
STAT,1897,33,20-24,1930,3.4005855052087144
STAT,1906,24,na,1930,3233.7082792129836
SIM,1849,39,na,1888,1778
STAT,1930,25,30-34,1955,47.10694386629466
STAT,1909,21,na,1930,3360.871098044488
SIM,1889,39,45-49,1928,1
STAT,1847,49,40-44,1896,0.12360823875942102
STAT,1902,10,na,1912,3453.50405893753
STAT,1877,51,45-49,1928,0.014289260502184627
STAT,1833,22,25-29,1855,47.289733060811784
STAT,1879,61,na,1940,1847.8436284755321
SIM,1861,42,45-49,1903,1
STAT,1919,7,na,1926,4173.0664747246565
STAT,1870,42,45-49,1912,1.3853205166546134
SIM,1917,38,50-100,1955,1
SIM,1916,54,na,1970,3395
STAT,1832,42,25-29,1874,0.4748963286875849
STAT,1897,47,30-34,1944,0.06866318782015879
SIM,1912,40,na,1952,3383
SIM,1815,39,45-49,1854,3
SIM,1885,28,20-24,1913,11
STAT,1936,5,na,1941,3636.4707026549104
SIM,1850,27,25-29,1877,39
SIM,1870,24,45-49,1894,1
SIM,1925,15,35-39,1940,6
STAT,1832,23,20-24,1855,65.07467432626501
STAT,1802,54,35-39,1856,0.024211070848522163
SIM,1874,32,30-34,1906,21
STAT,1889,41,15-19,1930,0.016178655781804763
STAT,1910,39,20-24,1949,0.23578176805062862
SIM,1873,32,na,1905,2284
STAT,1851,17,45-49,1868,0.057130367948825145
STAT,1852,42,30-34,1894,0.8324675037097519
STAT,1883,26,50-100,1909,0.5945249167288792
STAT,1868,38,20-24,1906,0.6913523652246647
STAT,1922,10,na,1932,4345.092376456709
STAT,1833,36,35-39,1869,5.482248092006069
SIM,1905,21,15-19,1926,3
STAT,1926,24,na,1950,4164.782201054072
SIM,1840,23,20-24,1863,48
SIM,1848,31,25-29,1879,18
STAT,1949,16,40-44,1965,1.5372659804532285
STAT,1859,61,na,1920,1405.0093746227794
SIM,1859,42,40-44,1901,6
SIM,1865,49,50-100,1914,3
SIM,1767,90,na,1857,20
STAT,1867,28,na,1895,2109.5804395394584
STAT,1942,6,na,1948,3928.312439614243
SIM,1846,63,na,1909,1276
STAT,1833,37,25-29,1870,2.2086197356232606
SIM,1841,22,25-29,1863,54
SIM,1862,81,na,1943,411
SIM,1848,39,35-39,1887,16
SIM,1908,35,na,1943,3312
SIM,1858,44,na,1902,1859
SIM,1904,21,na,1925,3285
STAT,1842,45,25-29,1887,0.04280268963931421
SIM,1860,35,40-44,1895,4
STAT,1867,80,na,1947,548.7431941683529
STAT,1831,42,45-49,1873,1.1050737487705111
STAT,1897,15,20-24,1912,22.50197819313796
SIM,1893,32,na,1925,2967
STAT,1790,89,na,1879,35.21368952795433
STAT,1853,34,45-49,1887,1.3311034229735268
SIM,1940,17,25-29,1957,54
STAT,1865,19,40-44,1884,0.15949202024028838
STAT,1898,39,45-49,1937,0.544537781177633
SIM,1888,15,20-24,1903,21
STAT,1892,48,40-44,1940,0.11283195576292791
STAT,1907,10,na,1917,3594.667081879621
STAT,1895,49,20-24,1944,0.008162627360191896
STAT,1848,44,30-34,1892,0.8427391626879533
STAT,1858,30,30-34,1888,13.203463849005818
STAT,1879,27,20-24,1906,11.600917723321777
STAT,1850,19,30-34,1869,1.3568414026983266
STAT,1866,21,25-29,1887,50.650260540132706
SIM,1939,20,30-34,1959,35
STAT,1860,44,30-34,1904,0.8693368489840235
STAT,1855,47,na,1902,1591.3432030047034
SIM,1831,34,na,1865,1632
SIM,1864,35,25-29,1899,3
STAT,1890,79,na,1969,1214.1229366096575
SIM,1838,27,25-29,1865,39
STAT,1920,39,na,1959,3883.0431325767354
STAT,1878,75,na,1953,1013.5266214704966
STAT,1885,3,na,1888,2772.693864031996
SIM,1824,34,20-24,1858,2
STAT,1889,38,40-44,1927,5.079961736264016
SIM,1844,31,40-44,1875,6
STAT,1828,32,45-49,1860,1.8093318804820457
STAT,1856,35,25-29,1891,2.142347035284481
SIM,1790,78,na,1868,260
STAT,1820,40,40-44,1860,4.394449222775059
SIM,1895,18,15-19,1913,10
STAT,1823,43,15-19,1866,0.017924095795019013
SIM,1903,36,na,1939,3223
STAT,1812,85,na,1897,119.08056080013996
SIM,1869,91,na,1960,103
SIM,1819,85,na,1904,137
SIM,1891,25,20-24,1916,15
STAT,1897,18,25-29,1915,7.140487656189278
STAT,1887,18,15-19,1905,6.2545167450928245
STAT,1847,53,25-29,1900,0.0025699690018569916
SIM,1833,31,30-34,1864,25
SIM,1883,19,35-39,1902,1
SIM,1886,39,na,1925,2299
SIM,1882,25,na,1907,2276
SIM,1882,37,35-39,1919,11
STAT,1839,51,25-29,1890,0.002369549355760993
STAT,1840,18,na,1858,1938.8921346424086
SIM,1872,37,25-29,1909,4
SIM,1919,20,na,1939,3874
SIM,1887,27,20-24,1914,15
SIM,1902,20,35-39,1922,6
STAT,1834,43,25-29,1877,0.4743186325086954
SIM,1825,32,35-39,1857,10
STAT,1883,25,20-24,1908,10.939544347732898
STAT,1892,22,30-34,1914,21.07638959109343
SIM,1907,24,30-34,1931,29
STAT,1860,33,25-29,1893,7.817923865508011
STAT,1895,23,45-49,1918,0.8561665869201106
STAT,1855,58,na,1913,1405.3335290546372
STAT,1936,23,na,1959,3297.025975203313
STAT,1861,29,20-24,1890,9.149043516596569
STAT,1919,46,30-34,1965,0.09157035200616848
STAT,1911,46,25-29,1957,0.0475604765159908
STAT,1884,23,35-39,1907,5.429545139918241
STAT,1836,31,40-44,1867,3.586826734245935
SIM,1892,23,35-39,1915,7
SIM,1903,9,na,1912,3491
STAT,1899,39,40-44,1938,1.2107015268503558
SIM,1818,41,40-44,1859,5
SIM,1874,21,25-29,1895,46
STAT,1870,30,30-34,1900,16.31105523962005
STAT,1822,53,20-24,1875,9.3610261944875E-4
STAT,1866,10,na,1876,2375.5531287972235
STAT,1864,37,25-29,1901,2.4242027798125574
STAT,1933,30,15-19,1963,0.16378357067938612
SIM,1890,36,30-34,1926,6
SIM,1903,25,na,1928,3247
SIM,1880,36,20-24,1916,3
STAT,1884,50,25-29,1934,0.003353340229367466
STAT,1819,96,na,1915,4.532852976649107
STAT,1893,36,40-44,1929,5.269610870350574
STAT,1874,37,35-39,1911,6.82694932140625
SIM,1939,28,40-44,1967,6
STAT,1836,44,na,1880,1578.645660726381
STAT,1832,30,na,1862,1721.7641324081558
STAT,1806,78,na,1884,325.0518977365446
STAT,1825,31,30-34,1856,33.98852290939618
STAT,1925,32,30-34,1957,17.673962621883636
SIM,1846,26,20-24,1872,9
SIM,1875,42,25-29,1917,1
SIM,1864,17,25-29,1881,5
SIM,1885,42,35-39,1927,2
SIM,1877,79,na,1956,673
STAT,1872,18,20-24,1890,16.75513937763974
STAT,1872,36,20-24,1908,0.7339545163307807
STAT,1850,59,na,1909,1369.9933250928302
STAT,1855,52,20-24,1907,5.215936304935208E-4
STAT,1882,36,30-34,1918,4.919931462361294
STAT,1884,49,45-49,1933,0.21566475122783899
SIM,1860,14,na,1874,2295
STAT,1839,39,50-100,1878,0.9567606048873705
STAT,1883,43,20-24,1926,0.1460321734002272
STAT,1895,43,50-100,1938,0.08970008506895163
STAT,1846,43,na,1889,1712.921593418646
STAT,1886,36,15-19,1922,0.05630693085045577
SIM,1880,18,20-24,1898,15
STAT,1893,43,30-34,1936,0.09495400454315966
STAT,1850,29,45-49,1879,0.9078774296426285
SIM,1885,32,40-44,1917,4
STAT,1802,64,na,1866,844.0078334022159
STAT,1826,45,40-44,1871,0.16241351981162527
STAT,1880,6,na,1886,2662.6312940301623
SIM,1917,0,na,1917,4257
SIM,1896,38,na,1934,2931
SIM,1888,33,20-24,1921,3
SIM,1856,37,40-44,1893,5
STAT,1899,36,50-100,1935,1.5968424061673685
STAT,1917,20,na,1937,3688.448477823746
SIM,1854,17,15-19,1871,5
SIM,1939,19,na,1958,3426
STAT,1866,29,35-39,1895,8.347228388947673
STAT,1849,62,na,1911,1370.5570986586083
SIM,1778,85,na,1863,79
STAT,1867,46,40-44,1913,0.15229894366257252
STAT,1877,32,40-44,1909,4.249698767340034
STAT,1836,50,45-49,1886,0.009893072612488847
SIM,1803,90,na,1893,26
SIM,1889,31,50-100,1920,1
SIM,1889,43,30-34,1932,1
SIM,1886,83,na,1969,662
STAT,1856,17,25-29,1873,4.938816599349409
STAT,1864,44,15-19,1908,0.011470537605744834
STAT,1816,52,20-24,1868,0.0016687419469350992
SIM,1866,30,30-34,1896,25
SIM,1773,86,na,1859,60
SIM,1832,29,30-34,1861,24
SIM,1920,28,na,1948,3915
STAT,1846,17,15-19,1863,5.529397674318107
STAT,1858,38,40-44,1896,3.2262532513218765
STAT,1826,52,30-34,1878,0.005301245194492347
STAT,1873,76,na,1949,907.7211514348453
STAT,1819,45,15-19,1864,7.813361328940191E-4
SIM,1852,59,na,1911,1463
SIM,1842,25,25-29,1867,49
SIM,1933,32,30-34,1965,26
STAT,1826,108,na,1934,0.0010002729246109338
STAT,1851,47,40-44,1898,0.12257737588230873
STAT,1907,40,50-100,1947,0.10283400306768882
STAT,1865,16,50-100,1881,0.04348492827918871
SIM,1806,67,na,1873,779
STAT,1906,57,na,1963,2915.4822961772243
STAT,1844,15,40-44,1859,0.16339670290668057
STAT,1853,24,50-100,1877,0.3594232319529951
STAT,1873,43,25-29,1916,0.6108154460961638
SIM,1802,53,na,1855,1073
SIM,1875,28,40-44,1903,2
STAT,1861,41,40-44,1902,1.7747715024264183
SIM,1849,51,na,1900,1654
SIM,1873,65,na,1938,1611
STAT,1806,52,25-29,1858,0.01246864832487075
STAT,1823,70,na,1893,750.8988627237965
STAT,1859,51,30-34,1910,0.004497079901507533
STAT,1838,44,20-24,1882,0.11059880814684848
SIM,1847,39,50-100,1886,1
STAT,1834,25,25-29,1859,34.92359566567388
STAT,1850,30,25-29,1880,8.474291747796848
STAT,1931,24,na,1955,4446.270219931833
STAT,1851,51,25-29,1902,0.0025601128720468104
STAT,1854,22,45-49,1876,0.586217156286494
STAT,1802,102,na,1904,0.10278558666909463
SIM,1890,29,40-44,1919,6
STAT,1824,40,25-29,1864,0.8888607842821707
STAT,1828,44,50-100,1872,0.8663846021891041
STAT,1851,21,30-34,1872,15.41204735086719
STAT,1846,28,20-24,1874,10.450796745438202
STAT,1850,109,na,1959,0.0011022017280699326
STAT,1860,26,50-100,1886,0.49916816759922983
SIM,1908,27,50-100,1935,1
SIM,1887,24,na,1911,2467
STAT,1848,23,50-100,1871,0.3662990056396801
SIM,1893,41,30-34,1934,3
STAT,1881,42,20-24,1923,0.144755367972329
STAT,1808,50,50-100,1858,0.056800065779315526
SIM,1863,43,45-49,1906,1
STAT,1867,53,30-34,1920,0.005195593925934518
STAT,1899,34,35-39,1933,12.996271689752017
STAT,1863,54,20-24,1917,5.949252666693225E-4
STAT,1829,107,na,1936,0.002849546948388122
SIM,1823,38,40-44,1861,3
STAT,1891,31,25-29,1922,12.02028631923823
STAT,1846,53,45-49,1899,0.010591086580370248
STAT,1883,18,30-34,1901,1.4723953763105162
SIM,1909,10,na,1919,3683
STAT,1854,19,15-19,1873,5.01966907441258
STAT,1900,40,na,1940,3070.0186021863237
SIM,1862,19,15-19,1881,6
STAT,1885,41,30-34,1926,1.0874761073714379
SIM,1857,58,na,1915,1527
STAT,1866,25,40-44,1891,2.6278064555912395
STAT,1831,35,20-24,1866,0.6052595020194341
SIM,1867,44,40-44,1911,4
SIM,1864,42,50-100,1906,3
STAT,1877,42,35-39,1919,1.7722944944302912
SIM,1834,85,na,1919,159
SIM,1891,18,30-34,1909,4
STAT,1875,24,na,1899,2282.120428044538
STAT,1883,40,30-34,1923,1.0755826864370905
STAT,1871,65,na,1936,1585.307022676236
STAT,1904,38,35-39,1942,2.0584063998467874
STAT,1943,20,30-34,1963,28.907398274362205
STAT,1879,48,25-29,1927,0.05624340253277964
STAT,1894,46,50-100,1940,0.16867055170267478
SIM,1854,28,20-24,1882,16
STAT,1930,7,na,1937,4882.002795807794
SIM,1846,19,30-34,1865,1
SIM,1859,101,na,1960,1
STAT,1838,26,20-24,1864,10.091233432150915
STAT,1847,50,20-24,1897,5.519667216175435E-4
STAT,1889,45,30-34,1934,0.11401897035497209
SIM,1839,29,na,1868,1807
STAT,1907,15,25-29,1922,7.900412605050822
STAT,1861,18,45-49,1879,0.05862753499088101
SIM,1870,31,35-39,1901,13
STAT,1811,53,45-49,1864,0.045285351326877096
STAT,1893,32,25-29,1925,12.270923256450885
STAT,1902,27,50-100,1929,0.8528580021301596
STAT,1941,31,50-100,1972,0.8205335330363489
STAT,1810,49,45-49,1859,0.7620377862951575
STAT,1869,33,45-49,1902,1.5891928577481316
STAT,1898,36,20-24,1934,0.9902114444871107
SIM,1808,78,na,1886,317
SIM,1922,39,na,1961,4024
STAT,1939,28,50-100,1967,0.9448392113303905
STAT,1871,10,na,1881,2507.8060502487247
STAT,1871,25,15-19,1896,0.42849323432073955
STAT,1874,27,40-44,1901,2.8913883785297494
SIM,1867,80,na,1947,504
SIM,1879,28,25-29,1907,47
SIM,1948,21,15-19,1969,5
STAT,1841,24,25-29,1865,49.27996434331319
SIM,1848,42,30-34,1890,1
SIM,1882,27,40-44,1909,7
SIM,1836,33,na,1869,1695
SIM,1877,33,45-49,1910,2
STAT,1815,45,30-34,1860,0.22458691126956717
SIM,1824,52,na,1876,1281
STAT,1930,28,35-39,1958,18.02557365748784
STAT,1945,15,45-49,1960,0.5157798225505302
SIM,1951,20,30-34,1971,47
STAT,1854,21,50-100,1875,0.3452962908908455
SIM,1831,36,25-29,1867,3
SIM,1883,26,25-29,1909,40
STAT,1848,15,25-29,1863,5.2818329360275875
STAT,1939,22,30-34,1961,27.268170927579344
SIM,1850,17,30-34,1867,1
STAT,1838,19,30-34,1857,1.3968426640396838
SIM,1852,70,na,1922,1026
SIM,1859,6,na,1865,2336
STAT,1926,9,na,1935,4610.684955310997
SIM,1874,35,35-39,1909,13
STAT,1885,16,40-44,1901,0.17265248746591264
STAT,1773,89,na,1862,29.627990666872552
STAT,1807,53,50-100,1860,0.054236358094947264
SIM,1885,33,50-100,1918,1
SIM,1912,38,35-39,1950,5
STAT,1856,42,15-19,1898,0.010166386888892785
SIM,1864,39,40-44,1903,3
STAT,1828,29,15-19,1857,0.5556117977505066
STAT,1843,22,35-39,1865,4.947459142750675
STAT,1866,35,35-39,1901,6.221316001255368
STAT,1819,45,50-100,1864,0.47974078859872366
STAT,1897,43,15-19,1940,0.0012028100439204264
STAT,1877,33,50-100,1910,0.8940717933794134
STAT,1920,39,30-34,1959,1.8811129166515097
SIM,1947,22,30-34,1969,34
SIM,1936,20,na,1956,2705
STAT,1929,32,15-19,1961,0.15419626660942876
STAT,1833,26,40-44,1859,2.440150174234799
STAT,1850,70,na,1920,989.0598170859839
STAT,1864,34,20-24,1898,2.2564138486632115
SIM,1841,26,40-44,1867,3
SIM,1841,33,30-34,1874,17
STAT,1879,2,na,1881,3193.9708117919286
STAT,1818,50,30-34,1868,0.012679971404705255
STAT,1791,74,na,1865,425.46568577636344
STAT,1890,27,25-29,1917,48.85669510306602
SIM,1909,7,na,1916,3697
STAT,1795,88,na,1883,49.17321855412077
SIM,1852,40,30-34,1892,4
SIM,1915,15,25-29,1930,11
SIM,1910,27,50-100,1937,4
STAT,1887,47,20-24,1934,0.01262109626947103
STAT,1907,40,15-19,1947,0.0013442354324461757
STAT,1949,19,45-49,1968,0.5485020231495925
SIM,1827,45,50-100,1872,1
STAT,1875,26,25-29,1901,41.21625993866153
STAT,1845,35,15-19,1880,0.046842849979595126
STAT,1814,51,20-24,1865,0.0021995481224596205
STAT,1844,25,50-100,1869,0.5517705563602947
STAT,1890,34,15-19,1924,0.16306781755212021
SIM,1893,34,40-44,1927,11
STAT,1842,42,20-24,1884,0.11898989327652416
SIM,1848,35,40-44,1883,9
SIM,1868,65,na,1933,1504
STAT,1842,29,na,1871,1909.6175253354604
STAT,1852,108,na,1960,0.0038797277285198793
SIM,1879,18,30-34,1897,1
STAT,1787,70,na,1857,622.342077864384
STAT,1910,49,15-19,1959,3.227888704774257E-4
STAT,1823,36,25-29,1859,4.947581786382294
SIM,1836,32,45-49,1868,5
SIM,1915,22,15-19,1937,5
STAT,1835,39,20-24,1874,0.5940817302170363
SIM,1864,51,na,1915,1934
STAT,1808,53,25-29,1861,0.012541124035839787
STAT,1889,82,na,1971,979.2323947360941
STAT,1917,30,30-34,1947,15.711131281447688
STAT,1919,18,20-24,1937,141.1651481240812
STAT,1833,33,30-34,1866,13.649938193750934
SIM,1860,31,25-29,1891,7
STAT,1866,43,na,1909,1999.2850008761004
STAT,1766,102,na,1868,0.06845272810797753
STAT,1901,25,na,1926,3177.209510405729
STAT,1844,52,45-49,1896,0.010025558458449421
STAT,1856,46,30-34,1902,0.07155170442283718
STAT,1813,47,20-24,1860,0.032806375734312214
SIM,1858,39,45-49,1897,3
SIM,1851,22,35-39,1873,4
STAT,1875,44,25-29,1919,0.6151272297513346
STAT,1818,70,na,1888,749.6589893489105
STAT,1842,24,20-24,1866,62.04452202852226
STAT,1862,21,40-44,1883,1.73546309566142
SIM,1895,29,20-24,1924,11
SIM,1797,88,na,1885,36
SIM,1850,24,20-24,1874,48
SIM,1892,79,na,1971,1383
SIM,1826,43,40-44,1869,2
STAT,1887,29,20-24,1916,12.307840705802928
STAT,1907,22,15-19,1929,4.578146943613547
STAT,1832,85,na,1917,165.13896820263773
SIM,1915,8,na,1923,3764
SIM,1872,16,20-24,1888,13
SIM,1927,18,20-24,1945,141
STAT,1874,23,25-29,1897,55.08406665090018
SIM,1870,21,40-44,1891,3
STAT,1857,50,30-34,1907,0.004498745424326455
STAT,1880,38,20-24,1918,0.7639074121903313
STAT,1818,43,40-44,1861,5.128316255320233
STAT,1843,48,45-49,1891,0.15740248629035436
STAT,1864,16,20-24,1880,17.0692976032098
STAT,1895,30,35-39,1925,12.572736900708104
STAT,1897,36,25-29,1933,3.655034600896842
STAT,1910,21,30-34,1931,25.575757576078903
SIM,1859,24,40-44,1883,3
STAT,1818,48,na,1866,1359.2309713717646
STAT,1824,66,na,1890,903.7286632020431
STAT,1860,80,na,1940,474.16004183912764
SIM,1890,37,40-44,1927,9
STAT,1934,33,35-39,1967,11.779590508207908
STAT,1879,52,45-49,1931,0.014274539835611857
STAT,1909,49,25-29,1958,0.04577919309516213
STAT,1824,44,40-44,1868,2.8078855464253287
STAT,1916,42,30-34,1958,0.1237674089357181
SIM,1893,38,20-24,1931,1
STAT,1807,47,45-49,1854,0.910561333161035
STAT,1834,40,20-24,1874,0.12190099685181066
STAT,1858,76,na,1934,701.7243351146482
STAT,1826,67,na,1893,865.6603409552984
STAT,1862,81,na,1943,436.78551360869966
SIM,1892,16,25-29,1908,8
STAT,1891,37,35-39,1928,8.266697902205213
SIM,1851,64,na,1915,1289
STAT,1915,38,na,1953,3572.6578163966387
STAT,1921,31,15-19,1952,0.1356483964851432
SIM,1857,79,na,1936,447
STAT,1885,78,na,1963,968.5661793953748
STAT,1857,35,20-24,1892,0.579783913005525
STAT,1841,43,30-34,1884,0.8131208900968191
SIM,1832,44,40-44,1876,7
STAT,1906,48,45-49,1954,0.18086386336149637
STAT,1885,38,20-24,1923,0.7222646086526393
SIM,1850,41,50-100,1891,3
STAT,1923,45,40-44,1968,0.1750554889875448
STAT,1858,33,50-100,1891,0.6757822199008781
STAT,1807,84,na,1891,123.73347502434902
STAT,1913,47,50-100,1960,0.20855972845176896
STAT,1850,41,30-34,1891,0.8140950164818677
STAT,1922,25,50-100,1947,1.0712264608536117
STAT,1873,46,30-34,1919,0.09300880253140678
STAT,1824,46,35-39,1870,0.17311020023395002
SIM,1839,38,30-34,1877,8
STAT,1874,38,45-49,1912,1.9146161860374258
STAT,1912,33,15-19,1945,0.1189544297345624
SIM,1857,29,35-39,1886,10
STAT,1884,16,25-29,1900,5.301864620865324
STAT,1933,31,50-100,1964,1.0531976819535307
SIM,1791,94,na,1885,4
SIM,1809,95,na,1904,5
SIM,1839,30,na,1869,1833
SIM,1783,75,na,1858,346
SIM,1841,19,30-34,1860,1
STAT,1842,17,30-34,1859,1.4822112840010007
STAT,1847,39,na,1886,1765.4930648189018
STAT,1882,37,40-44,1919,4.021679087631256
STAT,1836,45,15-19,1881,2.7811488800822705E-4
STAT,1900,0,na,1900,3848.0821058178944
STAT,1846,20,45-49,1866,0.6474244752440281
STAT,1815,46,40-44,1861,0.39128662210225784
STAT,1891,35,40-44,1926,5.164933681716146
STAT,1892,18,50-100,1910,0.05781777531795803
SIM,1891,29,na,1920,2775
SIM,1881,39,40-44,1920,4
STAT,1869,15,45-49,1884,0.061330653650778104
STAT,1914,21,15-19,1935,4.945113575640864
STAT,1827,84,na,1911,192.15681300579294
STAT,1841,34,na,1875,1775.565873058999
SIM,1922,21,15-19,1943,5
STAT,1907,19,na,1926,3486.0577111864764
SIM,1888,31,na,1919,2696
STAT,1923,4,na,1927,4477.282142680586
SIM,1900,33,45-49,1933,2
STAT,1859,48,20-24,1907,0.008909316230333557
SIM,1836,97,na,1933,3
SIM,1841,44,35-39,1885,1
STAT,1848,52,30-34,1900,0.004399543293620943
SIM,1926,23,50-100,1949,3
STAT,1914,47,40-44,1961,0.1477192724641093
SIM,1891,40,30-34,1931,2
STAT,1833,37,45-49,1870,1.5291950533168643
STAT,1823,40,45-49,1863,2.110178122541522
STAT,1826,41,25-29,1867,0.6401743132719359
STAT,1847,39,50-100,1886,0.9200307044751289
STAT,1879,19,20-24,1898,17.43725289081066
STAT,1882,44,30-34,1926,1.0419609104201293
STAT,1832,45,30-34,1877,0.07096711164340716
SIM,1874,43,35-39,1917,4
STAT,1860,30,20-24,1890,2.088575073352922
STAT,1911,58,na,1969,3116.950871990144
STAT,1850,34,40-44,1884,3.1322546127352977
STAT,1784,72,na,1856,484.8081047514
STAT,1792,91,na,1883,18.378363890269792
SIM,1900,15,30-34,1915,2
STAT,1932,38,45-49,1970,0.8644185466939561
STAT,1937,16,15-19,1953,41.811298480347844
STAT,1958,8,na,1966,4875.36462468303
SIM,1945,16,15-19,1961,43
STAT,1769,95,na,1864,1.8805458936482526
STAT,1856,47,40-44,1903,0.12559942540515157
SIM,1828,30,45-49,1858,2
STAT,1866,43,35-39,1909,1.5664029717345336
STAT,1832,51,na,1883,1368.4211071920763
STAT,1833,44,35-39,1877,1.3122017267723278
STAT,1851,17,25-29,1868,4.956060419833545
SIM,1774,92,na,1866,9
STAT,1809,49,20-24,1858,0.03269626307120407
STAT,1892,26,na,1918,2833.5450947054514
STAT,1911,19,50-100,1930,0.07044850882503906
STAT,1841,14,na,1855,2103.40698
SIM,1867,89,na,1956,99
SIM,1890,44,30-34,1934,8
SIM,1907,27,35-39,1934,14
STAT,1948,20,30-34,1968,31.197943660043563
STAT,1917,29,na,1946,3684.891120514568
STAT,1904,22,50-100,1926,0.5525790032667074
SIM,1895,21,45-49,1916,4
STAT,1915,46,45-49,1961,0.20741021068294763
STAT,1865,47,35-39,1912,0.11931839137494964
STAT,1898,29,30-34,1927,31.962944729874422
STAT,1933,19,35-39,1952,5.27801720628704
STAT,1880,49,25-29,1929,0.0561680924026291
STAT,1902,37,20-24,1939,0.2218243264937985
SIM,1781,74,na,1855,351
STAT,1815,53,30-34,1868,0.012608793385836495
SIM,1829,40,50-100,1869,4
STAT,1926,46,20-24,1972,0.012913301655629551
STAT,1886,32,50-100,1918,0.9143309573626378
STAT,1877,59,na,1936,1904.467861469535
SIM,1919,19,25-29,1938,56
STAT,1900,34,35-39,1934,13.157939422466278
SIM,1848,38,25-29,1886,1
SIM,1841,37,45-49,1878,1
STAT,1816,47,na,1863,1387.4312501145098
STAT,1794,72,na,1866,544.1793365911439
STAT,1872,40,40-44,1912,2.1528688490581263
STAT,1887,21,45-49,1908,0.7390733680833848
SIM,1800,72,na,1872,507
SIM,1941,19,35-39,1960,5
STAT,1822,43,50-100,1865,1.496491922305714
STAT,1888,11,na,1899,2887.5401392706217
SIM,1920,26,25-29,1946,74
STAT,1809,65,na,1874,833.6135914421913
STAT,1928,18,15-19,1946,53.87873657499741
STAT,1860,15,25-29,1875,5.06910371993844
STAT,1875,78,na,1953,758.6855207500323
STAT,1881,45,25-29,1926,0.053090195767320776
SIM,1863,40,40-44,1903,2
STAT,1848,38,50-100,1886,0.93041521213762
STAT,1923,36,50-100,1959,0.45998833716830256
SIM,1882,46,na,1928,2125
STAT,1912,26,25-29,1938,61.48829842866847
STAT,1891,42,30-34,1933,1.3420563313108476
STAT,1843,15,25-29,1858,4.949508465660731
SIM,1880,40,40-44,1920,7
STAT,1830,24,15-19,1854,7.301171968471458
SIM,1875,13,na,1888,2529
STAT,1844,37,20-24,1881,0.5657418760577145
STAT,1907,26,30-34,1933,35.0655433291384
STAT,1889,49,45-49,1938,0.15201447969151233
STAT,1874,42,30-34,1916,1.108320476775554
STAT,1864,62,na,1926,1538.8980453515626
SIM,1840,38,40-44,1878,2
SIM,1842,81,na,1923,321
STAT,1854,47,50-100,1901,0.17490389121653344
STAT,1814,54,25-29,1868,0.009941404058721083
STAT,1840,47,30-34,1887,0.06406064019453553
SIM,1799,70,na,1869,626
SIM,1829,30,na,1859,1647
SIM,1879,17,20-24,1896,20
SIM,1882,42,30-34,1924,1
SIM,1888,41,na,1929,2625
STAT,1877,46,15-19,1923,3.930864159677543E-4
STAT,1945,18,15-19,1963,46.81878777169506
STAT,1854,35,50-100,1889,0.8918725421486765
STAT,1915,40,50-100,1955,0.11204664192009842
SIM,1858,45,50-100,1903,1
STAT,1794,62,na,1856,886.3732798000002
SIM,1836,87,na,1923,107
SIM,1851,15,25-29,1866,9
STAT,1875,41,20-24,1916,0.15490754686349656
SIM,1791,74,na,1865,396
SIM,1877,30,40-44,1907,4
STAT,1867,42,25-29,1909,0.5689420880700383
STAT,1865,45,40-44,1910,0.14805423686807553
STAT,1906,8,na,1914,3576.7255651049095
SIM,1936,18,15-19,1954,36
STAT,1837,84,na,1921,215.89306467453346
SIM,1842,17,25-29,1859,8
STAT,1929,40,15-19,1969,0.001883920287537142
SIM,1878,36,45-49,1914,1
STAT,1841,39,45-49,1880,1.5859544489561093
STAT,1846,16,50-100,1862,0.04591764719911956
SIM,1953,18,15-19,1971,45
STAT,1856,54,30-34,1910,0.00426683893910583
STAT,1843,15,na,1858,2004.9153945607736
STAT,1851,34,na,1885,1749.926513574543
STAT,1828,48,na,1876,1386.263103017318
STAT,1824,32,na,1856,1585.7774371604323
STAT,1865,53,50-100,1918,0.012724336913682686
SIM,1901,8,na,1909,3427
SIM,1849,30,na,1879,1946
SIM,1889,39,25-29,1928,4
STAT,1857,28,30-34,1885,19.18645000519542
STAT,1868,16,40-44,1884,0.16883757915826295
SIM,1865,28,30-34,1893,33
SIM,1874,27,na,1901,2225
SIM,1819,95,na,1914,4
STAT,1915,17,50-100,1932,0.07407820426067013
STAT,1816,67,na,1883,845.0128274502578
STAT,1872,81,na,1953,512.4161465060474
STAT,1850,36,35-39,1886,5.117687433795316
STAT,1920,28,25-29,1948,67.96923962158017
SIM,1837,17,15-19,1854,3
STAT,1849,29,35-39,1878,8.454192430807911
STAT,1853,108,na,1961,0.004916008020565875
SIM,1888,2,na,1890,2972
STAT,1797,69,na,1866,694.568464998616
STAT,1898,11,na,1909,3306.456921047683
STAT,1852,51,na,1903,1568.4858622974675
SIM,1861,36,50-100,1897,3
STAT,1765,102,na,1867,0.056388424653385644
STAT,1899,27,25-29,1926,54.75507279726298
SIM,1869,31,45-49,1900,1
STAT,1903,33,20-24,1936,2.077449908135382
SIM,1833,27,25-29,1860,36
SIM,1915,19,40-44,1934,1
SIM,1883,18,25-29,1901,9
SIM,1906,21,30-34,1927,35
STAT,1927,44,15-19,1971,0.0018133689248452235
STAT,1849,95,na,1944,9.969898782869404
STAT,1920,35,15-19,1955,0.019896848811152893
SIM,1897,14,na,1911,3334
SIM,1851,54,na,1905,1574
STAT,1818,47,20-24,1865,0.025585679399649838
SIM,1911,33,20-24,1944,2
STAT,1908,43,35-39,1951,0.17494736745704617
STAT,1859,26,40-44,1885,2.307783534876273
STAT,1808,50,20-24,1858,0.0027752476235266502
STAT,1821,34,15-19,1855,0.38176744418108016
SIM,1828,78,na,1906,431
STAT,1907,44,45-49,1951,0.14227942717865247
STAT,1874,20,20-24,1894,66.91282384389093
STAT,1807,51,30-34,1858,0.022256262970484556
STAT,1882,15,50-100,1897,0.045218712782630587
STAT,1860,48,45-49,1908,0.1786233153320647
STAT,1824,51,30-34,1875,0.007125934401840818
SIM,1896,60,na,1956,2381
STAT,1924,44,30-34,1968,0.14317658430251876
STAT,1838,51,45-49,1889,0.009885133269426518
SIM,1869,51,50-100,1920,1
SIM,1882,35,40-44,1917,7
SIM,1860,1,na,1861,2926
STAT,1851,44,na,1895,1640.132421778701
STAT,1849,36,25-29,1885,2.2323059360613238
STAT,1800,105,na,1905,0.011655935392085932
STAT,1918,47,25-29,1965,0.05332720131401317
SIM,1823,69,na,1892,742
SIM,1893,30,25-29,1923,18
STAT,1909,38,50-100,1947,0.37358109124422456
STAT,1824,39,45-49,1863,2.824932932073343
SIM,1866,9,na,1875,2430
SIM,1815,44,40-44,1859,4
STAT,1924,44,45-49,1968,0.1863875355459551
STAT,1864,52,na,1916,1803.255408172823
STAT,1842,18,50-100,1860,0.04529141680218561
STAT,1919,28,15-19,1947,0.7180539383030891
STAT,1895,20,40-44,1915,2.581728954990401
SIM,1867,26,40-44,1893,3
SIM,1857,36,25-29,1893,1
SIM,1915,26,30-34,1941,49
STAT,1892,18,25-29,1910,6.687590694855153
STAT,1900,35,45-49,1935,2.637284212190855
STAT,1904,34,50-100,1938,0.7068027011690019
STAT,1885,30,25-29,1915,9.722409446168115
STAT,1917,48,20-24,1965,0.010874386595213253
SIM,1900,30,40-44,1930,6
SIM,1876,38,20-24,1914,1
STAT,1857,38,25-29,1895,2.134537424982726
STAT,1848,30,20-24,1878,2.3914548508201205
STAT,1844,47,15-19,1891,2.7651407970894875E-4
STAT,1831,99,na,1930,1.105801691797405
STAT,1849,85,na,1934,205.56463762447154
SIM,1901,32,35-39,1933,24
SIM,1823,90,na,1913,34
STAT,1858,45,50-100,1903,0.18372494794265748
SIM,1873,37,40-44,1910,8
SIM,1900,32,35-39,1932,17
STAT,1891,34,30-34,1925,20.23187701646469
SIM,1877,89,na,1966,246
STAT,1869,51,50-100,1920,0.013888009434372099
STAT,1904,31,15-19,1935,0.19375902905246709
SIM,1886,60,na,1946,1829
SIM,1884,27,na,1911,2340
STAT,1841,46,35-39,1887,0.09820537673590884
SIM,1904,11,na,1915,3568
STAT,1824,47,45-49,1871,0.28769903720871326
STAT,1934,30,30-34,1964,20.34435850106014
SIM,1863,25,45-49,1888,4
STAT,1819,65,na,1884,933.4575038534655
SIM,1860,37,na,1897,1971
STAT,1873,97,na,1970,29.765699218801046
STAT,1851,40,20-24,1891,0.11539376965480262
SIM,1891,28,45-49,1919,1
STAT,1905,31,15-19,1936,0.11211344902552184
STAT,1857,59,na,1916,1447.9993267575098
STAT,1911,42,50-100,1953,0.10593031406491311
SIM,1874,28,25-29,1902,41
SIM,1808,48,na,1856,1306
STAT,1810,54,40-44,1864,0.03226113752237172
STAT,1844,96,na,1940,5.963637039877886
SIM,1811,88,na,1899,53
SIM,1848,35,20-24,1883,3
STAT,1848,48,45-49,1896,0.1731582681390018
STAT,1857,53,35-39,1910,0.0063112861281049305
STAT,1897,40,45-49,1937,0.13262792816756752
SIM,1831,88,na,1919,60
STAT,1874,62,na,1936,1764.1688678692017
SIM,1861,54,na,1915,1822
STAT,1927,34,50-100,1961,0.9595482353932776
STAT,1881,48,30-34,1929,0.08723031027369971
SIM,1902,10,na,1912,3467
STAT,1871,48,20-24,1919,0.011115425086895453
SIM,1818,78,na,1896,349
STAT,1887,25,na,1912,2538.9103668738444
STAT,1834,32,na,1866,1721.0275234846451
SIM,1824,37,45-49,1861,1
STAT,1900,42,35-39,1942,0.16458862717934702
STAT,1816,44,35-39,1860,4.468158093184387
STAT,1869,28,50-100,1897,0.5833789772685923
STAT,1909,46,20-24,1955,0.009617415340689921
STAT,1908,40,30-34,1948,0.11300951517239527
SIM,1857,28,25-29,1885,40
STAT,1761,105,na,1866,0.02491371369675066
STAT,1918,40,40-44,1958,0.2519291438807202
SIM,1893,33,50-100,1926,1
STAT,1832,53,30-34,1885,0.003668714015540688
STAT,1836,44,50-100,1880,0.7932683790535823
SIM,1919,10,na,1929,4214
SIM,1869,21,30-34,1890,19
SIM,1844,62,na,1906,1201
STAT,1863,49,25-29,1912,0.04675438291152647
SIM,1912,48,50-100,1960,1
STAT,1907,19,40-44,1926,0.25245845311452364
STAT,1824,43,30-34,1867,1.4726069397250234
STAT,1853,15,na,1868,2114.552769386434
SIM,1889,29,30-34,1918,37
STAT,1883,35,35-39,1918,6.613250380658442
STAT,1924,36,45-49,1960,0.7600836229238822
STAT,1817,84,na,1901,153.97047669711304
STAT,1850,37,45-49,1887,1.4275083945861962
SIM,1881,84,na,1965,399
STAT,1920,33,20-24,1953,2.513285892842027
SIM,1833,45,na,1878,1494
SIM,1934,31,35-39,1965,16
STAT,1924,43,35-39,1967,0.22590921061562166
STAT,1950,15,na,1965,4113.73936342191
SIM,1842,40,na,1882,1631
SIM,1837,35,45-49,1872,1
SIM,1954,0,na,1954,4587
STAT,1884,22,50-100,1906,0.3805992365052481
STAT,1920,49,na,1969,3813.928204789927
STAT,1822,48,25-29,1870,0.07635825455126881
STAT,1865,44,30-34,1909,0.9711341767860363
STAT,1831,34,na,1865,1603.5620968968626
STAT,1896,26,45-49,1922,1.3900630556594096
STAT,1933,16,30-34,1949,15.451903121230949
SIM,1923,43,40-44,1966,1
SIM,1875,23,na,1898,2286
STAT,1927,19,na,1946,4300.203612937872
STAT,1928,44,15-19,1972,0.001843243481107813
SIM,1926,40,40-44,1966,3
STAT,1883,28,45-49,1911,1.0247577047606782
STAT,1871,32,50-100,1903,0.8595045730211214
SIM,1938,32,30-34,1970,15
STAT,1837,30,45-49,1867,1.448757185423938
STAT,1897,35,na,1932,3004.7682267084547
SIM,1820,72,na,1892,625
STAT,1938,30,15-19,1968,0.12220566914452152
SIM,1941,16,30-34,1957,17
SIM,1873,44,30-34,1917,4
STAT,1805,52,45-49,1857,0.05327011548647642
STAT,1912,41,15-19,1953,0.0014073176149082777
SIM,1856,30,20-24,1886,1
STAT,1865,37,40-44,1902,3.7483076102054773
STAT,1887,59,na,1946,2053.6280516689144
STAT,1900,31,30-34,1931,22.974544076182095
SIM,1903,59,na,1962,2749
STAT,1891,38,45-49,1929,2.3183933062188715
SIM,1867,79,na,1946,568
SIM,1898,29,25-29,1927,56
STAT,1832,38,40-44,1870,3.3096605947307784
STAT,1944,7,na,1951,4023.41139421773
SIM,1819,64,na,1883,920
STAT,1829,35,45-49,1864,1.877194307007846
STAT,1926,31,35-39,1957,10.44452980661989
SIM,1845,30,45-49,1875,1
STAT,1846,50,40-44,1896,0.007920607670988178
SIM,1810,72,na,1882,537
STAT,1898,39,25-29,1937,0.7864770996301507
STAT,1814,66,na,1880,892.6810859882937
STAT,1931,21,15-19,1952,6.541798143586823
SIM,1848,28,30-34,1876,26
STAT,1842,34,35-39,1876,8.677371511974235
STAT,1915,43,40-44,1958,0.2375205998354552
SIM,1784,92,na,1876,6
SIM,1839,15,25-29,1854,4
STAT,1878,21,na,1899,2335.4688337983243
SIM,1891,43,35-39,1934,5
STAT,1883,43,35-39,1926,1.6650842116037217
STAT,1873,47,40-44,1920,0.16326448474981953
STAT,1890,45,na,1935,2624.395009962524
STAT,1957,6,na,1963,4895.572302677995
SIM,1883,5,na,1888,2463
STAT,1840,44,25-29,1884,0.4284819367038342
SIM,1892,56,na,1948,2696
STAT,1850,44,35-39,1894,1.2592548277116409
STAT,1804,66,na,1870,792.2586575139345
STAT,1929,18,50-100,1947,0.45049488802150495
SIM,1928,16,15-19,1944,53
STAT,1816,52,35-39,1868,0.019468655335876273
STAT,1849,51,20-24,1900,5.559896678896026E-4
SIM,1850,34,35-39,1884,7
STAT,1861,51,35-39,1912,0.006794660368678565
STAT,1948,23,35-39,1971,10.210333177507959
STAT,1950,8,na,1958,4390.097305717815
SIM,1859,27,45-49,1886,4
SIM,1865,13,na,1878,2397
STAT,1925,17,35-39,1942,4.788456046697527
STAT,1857,45,35-39,1902,0.10534845041609547
STAT,1891,45,35-39,1936,0.09322079082115185
SIM,1871,30,na,1901,2292
SIM,1897,31,20-24,1928,2
STAT,1875,19,35-39,1894,0.5299473069457646
SIM,1914,11,na,1925,3889
STAT,1824,36,40-44,1860,7.208843037593732
SIM,1855,16,20-24,1871,15
STAT,1861,44,45-49,1905,1.1597233382393037
STAT,1910,31,50-100,1941,0.7562162372864787
SIM,1899,25,25-29,1924,52
SIM,1895,43,na,1938,2932
SIM,1845,19,15-19,1864,6
STAT,1820,50,35-39,1870,0.014441365496710141
SIM,1833,90,na,1923,27
STAT,1888,21,na,1909,2648.42605913746
STAT,1824,54,35-39,1878,0.009709033383549106
STAT,1764,96,na,1860,0.9474304252802368
STAT,1821,99,na,1920,1.0089881599288646
SIM,1860,39,20-24,1899,4
SIM,1859,29,na,1888,1935
STAT,1875,18,25-29,1893,5.4880599790485
SIM,1832,36,40-44,1868,8
SIM,1808,68,na,1876,767
STAT,1830,47,20-24,1877,0.008991831776763161
SIM,1786,73,na,1859,437
SIM,1841,64,na,1905,1130
SIM,1933,17,35-39,1950,7
SIM,1831,40,45-49,1871,2
STAT,1917,19,na,1936,3709.6223503678334
STAT,1847,16,20-24,1863,16.41324966891142
STAT,1866,40,30-34,1906,1.0118382629780411
SIM,1872,70,na,1942,1260
SIM,1826,97,na,1923,3
STAT,1889,31,20-24,1920,3.1653383333190748
SIM,1945,13,na,1958,3888
STAT,1789,108,na,1897,4.047319563815952E-4
STAT,1907,29,35-39,1936,13.182484783888079
STAT,1882,71,na,1953,1226.301831546905
SIM,1833,24,20-24,1857,52
STAT,1922,49,40-44,1971,0.1701044193648115
STAT,1846,54,20-24,1900,5.322667444424119E-4
SIM,1915,41,40-44,1956,2
SIM,1898,61,na,1959,2420
SIM,1870,21,50-100,1891,1
STAT,1890,31,45-49,1921,2.022285725585146
SIM,1907,19,35-39,1926,3
STAT,1901,31,30-34,1932,23.182065825943763
STAT,1839,17,25-29,1856,4.935498411692302
STAT,1837,39,na,1876,1657.5501018334444
STAT,1919,42,15-19,1961,0.0015721537178930063
SIM,1891,35,35-39,1926,15
STAT,1787,69,na,1856,645.98513376
STAT,1883,12,na,1895,2391.9544732011545
SIM,1793,75,na,1868,359
STAT,1881,15,45-49,1896,0.059890716773319204
STAT,1849,28,25-29,1877,37.33167541030102
SIM,1843,45,na,1888,1623
SIM,1850,42,35-39,1892,2
STAT,1873,39,40-44,1912,4.151936549375406
STAT,1867,28,40-44,1895,2.647945305975532
STAT,1826,49,20-24,1875,0.010783029869010828
STAT,1859,95,na,1954,9.99678926031752
SIM,1847,17,25-29,1864,5
STAT,1806,48,40-44,1854,0.6228377213291654
STAT,1881,44,15-19,1925,0.012432824233460944
SIM,1911,24,na,1935,3347
STAT,1920,25,20-24,1945,19.044828152282182
SIM,1813,79,na,1892,302
SIM,1922,40,na,1962,4029
SIM,1872,41,45-49,1913,4
STAT,1859,18,40-44,1877,0.1586952230713508
SIM,1824,44,35-39,1868,5
STAT,1900,32,40-44,1932,5.68328635408199
SIM,1878,18,15-19,1896,3
STAT,1911,20,35-39,1931,8.486784007217182
STAT,1843,41,25-29,1884,0.4523456583893094
STAT,1870,27,20-24,1897,10.872254881512227
STAT,1824,86,na,1910,122.3396130769469
STAT,1836,67,na,1903,1026.5340732005666
SIM,1840,46,50-100,1886,4
STAT,1842,42,35-39,1884,1.3567434355177785
STAT,1885,33,50-100,1918,0.8591358161270993
STAT,1896,30,na,1926,3001.298042667806
STAT,1832,46,40-44,1878,0.1239122819278981
STAT,1853,31,40-44,1884,3.415068469092751
STAT,1851,54,30-34,1905,0.0041641744680035375
STAT,1877,17,45-49,1894,0.06401178605139046
SIM,1915,29,35-39,1944,15
SIM,1821,44,50-100,1865,3
STAT,1855,25,45-49,1880,0.916868868720067
STAT,1881,35,50-100,1916,1.1310870385444773
STAT,1852,39,20-24,1891,0.553230225331312
STAT,1854,108,na,1962,0.005593961743804757
STAT,1850,33,30-34,1883,12.742153410610648
STAT,1904,22,na,1926,3204.7742487572127
STAT,1892,15,20-24,1907,21.074753886007436
STAT,1919,52,na,1971,3701.0130082308024
STAT,1862,35,15-19,1897,0.045787842023166984
STAT,1864,41,45-49,1905,1.2658305829766663
STAT,1924,40,15-19,1964,0.0017303701952656656
SIM,1898,41,na,1939,2919
STAT,1823,49,na,1872,1358.787815795882
STAT,1948,2,na,1950,4347.9742529781115
STAT,1885,48,15-19,1933,3.719244014943789E-4
STAT,1840,43,15-19,1883,0.009333481135742502
SIM,1889,36,20-24,1925,1
STAT,1891,27,40-44,1918,3.5011588804835143
STAT,1863,20,45-49,1883,0.5981712871085626
STAT,1850,80,na,1930,436.0629906243561
STAT,1832,46,50-100,1878,0.17776201179477993
STAT,1795,98,na,1893,0.676590431548982
SIM,1865,38,45-49,1903,1
STAT,1930,21,15-19,1951,6.461524642719653
STAT,1839,85,na,1924,182.51822137452982
STAT,1865,48,45-49,1913,0.19953969107892391
STAT,1837,19,15-19,1856,5.360699752212155
SIM,1856,63,na,1919,1374
STAT,1820,43,45-49,1863,2.6664996595613095
SIM,1893,62,na,1955,2258
STAT,1837,50,na,1887,1459.1015745720672
STAT,1846,13,na,1859,2214.162002855911
STAT,1911,45,15-19,1956,3.3101234908852826E-4
STAT,1843,19,40-44,1862,0.15602292203990895
SIM,1854,0,na,1854,3049
STAT,1916,34,45-49,1950,1.5216118899159656
STAT,1877,47,50-100,1924,0.23954992479154819
SIM,1915,22,35-39,1937,12
SIM,1846,25,45-49,1871,1
STAT,1865,30,20-24,1895,2.333142368101438
STAT,1816,41,30-34,1857,3.2499707407080254
STAT,1881,37,25-29,1918,2.6275740600494544
SIM,1845,16,na,1861,2037
STAT,1830,28,na,1858,1706.4400555856232
STAT,1856,33,na,1889,1762.0397949083822
SIM,1879,26,na,1905,2401
STAT,1829,31,na,1860,1734.1410675476668
SIM,1883,42,na,1925,2101
STAT,1799,71,na,1870,588.397883893446
STAT,1910,32,35-39,1942,8.324277965938125
STAT,1851,29,50-100,1880,0.5310722088225818
SIM,1821,98,na,1919,2
STAT,1879,92,na,1971,163.7530438662957
SIM,1832,50,na,1882,1347
STAT,1858,52,25-29,1910,0.0026095370705420187
STAT,1831,43,20-24,1874,0.1157004735867543
STAT,1933,31,40-44,1964,4.98492980336416
STAT,1814,46,25-29,1860,0.17914850546203984
SIM,1850,31,30-34,1881,23
STAT,1951,21,na,1972,4123.037105529697
STAT,1863,46,20-24,1909,0.009976452695287718
STAT,1834,32,35-39,1866,8.050407688207734
SIM,1842,32,35-39,1874,10
SIM,1853,45,na,1898,1727
SIM,1868,75,na,1943,857
STAT,1823,44,25-29,1867,0.811177563417393
SIM,1853,35,na,1888,1819
STAT,1886,30,na,1916,2400.4660180314186
SIM,1938,3,na,1941,3597
SIM,1851,10,na,1861,2193
SIM,1891,25,40-44,1916,7
SIM,1960,1,na,1961,4858
SIM,1875,44,50-100,1919,1
SIM,1930,25,50-100,1955,1
STAT,1826,98,na,1924,1.773972771641084
SIM,1917,18,na,1935,3965
STAT,1831,35,50-100,1866,0.9640060274960764
STAT,1920,41,50-100,1961,0.12274883866108897
SIM,1867,29,45-49,1896,5
STAT,1833,52,20-24,1885,4.6661016600057424E-4
SIM,1895,5,na,1900,3324
STAT,1922,45,25-29,1967,0.05783977903053955
STAT,1860,45,40-44,1905,0.1325347277794185
SIM,1861,31,40-44,1892,5
STAT,1855,51,45-49,1906,0.010362251931509274
STAT,1785,102,na,1887,0.08806278165889422
STAT,1913,33,15-19,1946,0.12027631676157134
SIM,1813,70,na,1883,676
STAT,1893,21,50-100,1914,0.4900191454781771
SIM,1779,91,na,1870,7
SIM,1898,26,20-24,1924,13
STAT,1838,25,45-49,1863,0.9619744877714413
STAT,1859,44,50-100,1903,0.7836141137498217
SIM,1906,43,40-44,1949,2
STAT,1881,49,40-44,1930,0.15297609762642692
STAT,1859,29,45-49,1888,0.8370850682320168
STAT,1922,31,15-19,1953,0.13772487289735114
SIM,1868,40,40-44,1908,6
SIM,1857,25,20-24,1882,9
STAT,1839,41,na,1880,1642.1574940585238
STAT,1872,44,20-24,1916,0.14845631680407104
STAT,1883,25,40-44,1908,2.793354659886877
STAT,1945,25,50-100,1970,1.0324990789989898
SIM,1855,39,50-100,1894,4
SIM,1826,43,na,1869,1427
STAT,1939,33,35-39,1972,8.802972058204082
STAT,1822,45,20-24,1867,0.01660673842987188
STAT,1842,31,30-34,1873,15.43371740455368
STAT,1942,24,45-49,1966,1.1137408863827707
STAT,1912,22,50-100,1934,0.5957411793498006
STAT,1866,51,20-24,1917,6.460412354093688E-4
STAT,1918,23,50-100,1941,0.6683525699744081
STAT,1920,43,15-19,1963,0.0015997179789426547
SIM,1835,41,40-44,1876,8
SIM,1925,37,na,1962,4228
STAT,1863,50,40-44,1913,0.008853022812428498
SIM,1892,15,na,1907,3333
SIM,1855,13,na,1868,2290
SIM,1887,26,45-49,1913,1
STAT,1890,34,50-100,1924,1.0491721310700306
SIM,1875,16,25-29,1891,3
STAT,1839,40,20-24,1879,0.12564291618603324
SIM,1921,44,na,1965,3965
STAT,1843,52,50-100,1895,0.010146796591062077
STAT,1879,26,45-49,1905,1.101716867638583
SIM,1817,73,na,1890,544
STAT,1890,35,25-29,1925,3.3569558025736588
STAT,1811,52,35-39,1863,0.027407974598314924
STAT,1924,33,40-44,1957,4.310311482614899
SIM,1885,77,na,1962,992
STAT,1873,12,na,1885,2513.457892871605
STAT,1888,65,na,1953,1886.755634464586
SIM,1890,8,na,1898,3242
SIM,1882,20,20-24,1902,66
SIM,1816,42,35-39,1858,4
SIM,1932,33,40-44,1965,11
STAT,1907,22,35-39,1929,8.098057186317895
STAT,1867,50,25-29,1917,0.0031871943661963423
STAT,1894,32,50-100,1926,1.1123674229933138
SIM,1792,80,na,1872,191
STAT,1840,48,40-44,1888,0.11185505536629185
SIM,1912,22,50-100,1934,1
STAT,1855,47,25-29,1902,0.04074126877676276
SIM,1839,61,na,1900,1280
STAT,1875,33,35-39,1908,9.792032190078984
STAT,1867,16,25-29,1883,5.169376423063376
STAT,1892,30,30-34,1922,20.825277792917824
SIM,1917,9,na,1926,4043
STAT,1805,53,20-24,1858,0.002654916647315036
STAT,1890,49,35-39,1939,0.0893051807002298
STAT,1855,18,20-24,1873,14.896242627274768
STAT,1817,51,25-29,1868,0.007805778418354063
SIM,1762,102,na,1864,1
SIM,1898,19,30-34,1917,4
STAT,1811,45,45-49,1856,0.8124465369487989
STAT,1949,23,50-100,1972,0.725121090637938
STAT,1924,40,30-34,1964,0.14405330854549356
SIM,1863,18,20-24,1881,9
STAT,1894,32,40-44,1926,5.264988343769841
STAT,1894,46,15-19,1940,2.7470750816375176E-4
SIM,1858,24,25-29,1882,50
STAT,1870,37,15-19,1907,0.05204187385662416
SIM,1888,10,na,1898,2918
STAT,1882,40,15-19,1922,0.012815322088134974
STAT,1884,42,25-29,1926,0.5986005787223009
STAT,1800,73,na,1873,504.8643062951513
STAT,1827,41,40-44,1868,2.195153860087596
STAT,1899,22,50-100,1921,0.5278450007092258
STAT,1920,36,25-29,1956,1.0193290416697687
STAT,1935,17,na,1952,4753.505877816754
SIM,1883,33,35-39,1916,8
SIM,1838,19,25-29,1857,5
SIM,1839,16,20-24,1855,19
STAT,1839,31,na,1870,1794.254764519536
STAT,1939,15,20-24,1954,128.51924119033598
SIM,1890,33,25-29,1923,21
STAT,1790,68,na,1858,657.2810416846263
STAT,1868,42,40-44,1910,2.024871021026337
SIM,1804,96,na,1900,4
SIM,1842,50,na,1892,1466
SIM,1879,24,45-49,1903,3
SIM,1807,83,na,1890,116
SIM,1894,30,40-44,1924,7
STAT,1835,54,45-49,1889,0.009047590710434546
SIM,1865,42,30-34,1907,1
SIM,1954,17,na,1971,4224
STAT,1869,16,40-44,1885,0.17071440659564416
SIM,1855,19,25-29,1874,7
SIM,1866,53,na,1919,1866
STAT,1828,40,45-49,1868,1.3121114805382321
SIM,1830,43,50-100,1873,1
STAT,1808,80,na,1888,275.44391424809953
STAT,1864,45,25-29,1909,0.04898107426038048
SIM,1858,75,na,1933,778
STAT,1921,3,na,1924,4367.666279995039
STAT,1858,19,35-39,1877,0.46917494003833843
STAT,1797,90,na,1887,31.259237836170726
STAT,1949,18,35-39,1967,4.6090310089545525
STAT,1927,41,45-49,1968,0.19746425584993538
STAT,1820,36,20-24,1856,1.876383399122624
STAT,1912,23,20-24,1935,100.36320766858002
STAT,1921,35,30-34,1956,1.9258230366847764
SIM,1834,31,na,1865,1711
STAT,1901,20,40-44,1921,2.7719485393175503
SIM,1920,23,20-24,1943,110
STAT,1874,53,20-24,1927,7.008210089762514E-4
STAT,1835,33,50-100,1868,0.7347647533498616
STAT,1901,49,20-24,1950,0.008764042772321743
STAT,1893,47,45-49,1940,0.15874228798190917
SIM,1837,28,na,1865,1794
SIM,1876,42,40-44,1918,7
SIM,1897,55,na,1952,2693
SIM,1899,48,50-100,1947,3
SIM,1924,16,30-34,1940,14
STAT,1789,71,na,1860,529.915288883145
SIM,1889,26,na,1915,2871
STAT,1849,25,20-24,1874,10.579440877579353
STAT,1890,42,15-19,1932,0.015930244211505906
STAT,1842,50,20-24,1892,5.420675333300564E-4
STAT,1882,33,25-29,1915,9.370327598582776
SIM,1827,83,na,1910,211
SIM,1803,70,na,1873,624
SIM,1819,40,45-49,1859,1
STAT,1886,30,40-44,1916,4.36244075574799
STAT,1866,25,20-24,1891,10.291212093835354
SIM,1862,47,50-100,1909,2
STAT,1822,52,45-49,1874,0.01878006851794525
SIM,1822,50,na,1872,1339
STAT,1878,31,45-49,1909,1.723844919786422
STAT,1932,35,40-44,1967,1.9033895513992825
STAT,1910,5,na,1915,3751.5163112423515
SIM,1825,29,40-44,1854,4
STAT,1866,33,na,1899,2070.469284532942
STAT,1762,105,na,1867,0.009532298281798015
STAT,1932,21,30-34,1953,35.73261506722422
SIM,1821,88,na,1909,82
SIM,1834,21,na,1855,1772
STAT,1898,32,25-29,1930,13.09434620018372
SIM,1874,25,20-24,1899,1
STAT,1934,19,50-100,1953,0.47616414433617105
SIM,1857,18,30-34,1875,1
SIM,1886,31,45-49,1917,1
STAT,1884,62,na,1946,1705.8593357814098
STAT,1882,47,35-39,1929,0.12802051732785386
SIM,1889,36,na,1925,2865
STAT,1916,16,30-34,1932,2.449011450896258
STAT,1873,22,na,1895,2265.9872942277616
STAT,1857,31,25-29,1888,7.75862587819001
SIM,1923,21,30-34,1944,32
STAT,1901,16,50-100,1917,0.0649431216443811
SIM,1891,32,30-34,1923,32
STAT,1866,18,30-34,1884,1.4170661259838404
SIM,1904,42,na,1946,3209
STAT,1849,18,30-34,1867,1.462520726489071
STAT,1883,51,20-24,1934,6.867409475953234E-4
SIM,1869,24,35-39,1893,3
STAT,1810,102,na,1912,0.12402444379070536
STAT,1834,86,na,1920,137.556559301355
SIM,1824,34,40-44,1858,2
STAT,1938,17,50-100,1955,0.34914201267505435
SIM,1866,63,na,1929,1562
SIM,1874,82,na,1956,407
SIM,1881,35,25-29,1916,1
SIM,1929,9,na,1938,4770
STAT,1934,22,na,1956,4636.155381817789
STAT,1876,48,20-24,1924,0.011564895616232302
STAT,1830,102,na,1932,0.1769445376308396
SIM,1865,35,40-44,1900,5
SIM,1857,43,35-39,1900,4
STAT,1880,24,50-100,1904,0.40359022332412925
STAT,1917,40,na,1957,3671.6530594458145
STAT,1922,41,na,1963,4032.8866863727026
STAT,1915,21,30-34,1936,28.151695024462388
STAT,1852,50,30-34,1902,0.00437753237451807
STAT,1887,80,na,1967,998.5513875982263
SIM,1873,42,na,1915,2214
STAT,1886,40,na,1926,2329.682683157796
SIM,1865,31,25-29,1896,8
SIM,1924,34,45-49,1958,3
STAT,1793,86,na,1879,64.46272116158512
STAT,1883,32,30-34,1915,16.171423649849114
STAT,1830,73,na,1903,716.8631457634917
SIM,1903,19,15-19,1922,7
STAT,1840,28,na,1868,1757.402864644854
STAT,1916,41,35-39,1957,0.19522408379883016
STAT,1873,42,15-19,1915,0.013215107567795639
STAT,1893,40,25-29,1933,0.7770846215176843
SIM,1939,16,25-29,1955,52
SIM,1907,16,30-34,1923,1
STAT,1821,102,na,1923,0.15619369716385917
SIM,1780,88,na,1868,42
STAT,1821,68,na,1889,811.5604882533646
STAT,1911,38,25-29,1949,0.8939831527678471
STAT,1869,41,45-49,1910,1.375906911156719
SIM,1901,24,na,1925,3107
STAT,1906,45,40-44,1951,0.13419716710098975
SIM,1854,82,na,1936,333
STAT,1812,44,15-19,1856,0.04860770059374925
STAT,1906,31,30-34,1937,13.850315979764503
SIM,1881,30,na,1911,1852
STAT,1914,22,na,1936,3524.6151080970744
SIM,1883,15,20-24,1898,20
SIM,1912,30,na,1942,3499
STAT,1892,41,20-24,1933,0.1887658431070517
SIM,1849,26,25-29,1875,49
STAT,1868,45,na,1913,2048.0932970405465
STAT,1847,19,25-29,1866,5.154155817352299
STAT,1856,7,na,1863,2157.1878231607125
SIM,1919,18,15-19,1937,48
STAT,1825,50,20-24,1875,7.548440706862173E-4
STAT,1925,43,35-39,1968,0.2299395574042409
STAT,1841,32,25-29,1873,8.567553888035597
STAT,1875,15,20-24,1890,17.2946459565883
STAT,1832,49,45-49,1881,0.14957215676134944
SIM,1824,41,30-34,1865,1
SIM,1860,43,40-44,1903,4
STAT,1931,36,50-100,1967,0.5257600518908749
SIM,1877,41,45-49,1918,5
SIM,1932,22,35-39,1954,11
STAT,1864,49,40-44,1913,0.14113591953479762
STAT,1922,42,20-24,1964,0.019149462595241494
SIM,1833,35,na,1868,1650
SIM,1850,20,25-29,1870,56
STAT,1845,108,na,1953,0.0012961804473078375
STAT,1895,44,na,1939,2817.7951123085318
STAT,1817,94,na,1911,9.250394952876759
STAT,1874,35,40-44,1909,4.26539603970459
STAT,1881,34,20-24,1915,2.445708975691483
SIM,1878,41,na,1919,2344
STAT,1930,33,15-19,1963,0.15656776757697258
STAT,1901,30,35-39,1931,13.499085417071319
STAT,1810,73,na,1883,508.08314443296075
STAT,1831,46,25-29,1877,0.04156700016949242
STAT,1879,51,na,1930,2139.39727490894
SIM,1899,36,na,1935,3160
SIM,1866,26,25-29,1892,44
STAT,1912,48,35-39,1960,0.11673328810220852
STAT,1922,5,na,1927,4395.939516334095
SIM,1924,31,40-44,1955,8
STAT,1853,49,30-34,1902,0.07172829698772064
STAT,1847,60,na,1907,1406.368102152304
STAT,1908,59,na,1967,2951.549629686392
SIM,1782,80,na,1862,223
STAT,1865,1,na,1866,3078.112778021138
SIM,1844,31,na,1875,1758
STAT,1820,46,15-19,1866,6.808940214889876E-4
SIM,1849,23,20-24,1872,73
STAT,1830,46,25-29,1876,0.04372246755351669
STAT,1861,34,na,1895,1858.3686434495587
SIM,1943,22,na,1965,3555
STAT,1880,48,na,1928,2212.5404518600276
STAT,1787,90,na,1877,29.072732138615912
SIM,1911,36,25-29,1947,1
STAT,1815,49,45-49,1864,0.5154788549312809
STAT,1870,21,50-100,1891,0.37906535032196714
SIM,1846,28,50-100,1874,2
STAT,1918,44,20-24,1962,0.017679524867197434
STAT,1844,41,40-44,1885,1.6205579009995528
STAT,1890,46,30-34,1936,0.06324395346036556
STAT,1847,50,50-100,1897,0.01129691845516449
STAT,1903,23,50-100,1926,0.5464386670155393
STAT,1880,46,20-24,1926,0.011985150523743352
SIM,1911,23,50-100,1934,1
STAT,1882,81,na,1963,722.3929807442132
STAT,1834,108,na,1942,0.0011356135293566787
SIM,1818,68,na,1886,758
SIM,1797,68,na,1865,695
STAT,1900,43,30-34,1943,0.10386876018798095
STAT,1875,52,25-29,1927,0.003421037077273046
STAT,1891,41,na,1932,2713.556561323112
STAT,1876,40,25-29,1916,0.6330724635781996
SIM,1803,69,na,1872,677
STAT,1939,30,30-34,1969,15.203484306362798
STAT,1776,112,na,1888,7.382246323305992E-4
STAT,1833,41,30-34,1874,0.865749615821028
STAT,1835,47,20-24,1882,0.008050521491770036
STAT,1897,44,25-29,1941,0.05557718151472403
STAT,1902,30,35-39,1932,13.610251529729588
SIM,1940,9,na,1949,3729
SIM,1950,21,40-44,1971,8
STAT,1911,42,45-49,1953,0.1500679453553326
SIM,1940,21,30-34,1961,30
STAT,1912,30,45-49,1942,1.4745618477911149
SIM,1899,29,40-44,1928,3
STAT,1858,26,25-29,1884,32.306262561379604
STAT,1923,48,45-49,1971,0.23951665340860995
STAT,1814,43,20-24,1857,0.536836913301362
STAT,1891,20,20-24,1911,81.0241990176338
STAT,1924,22,35-39,1946,10.495920519848228
STAT,1933,34,45-49,1967,2.000726987337067
STAT,1863,53,45-49,1916,0.011837870905771706
STAT,1903,36,25-29,1939,0.8393430847494663
SIM,1906,32,35-39,1938,10
STAT,1820,52,50-100,1872,0.024344415588386674
STAT,1914,43,25-29,1957,0.06674111613381646
SIM,1852,41,40-44,1893,3
STAT,1875,88,na,1963,265.3725310121674
STAT,1897,48,40-44,1945,0.12047316053129521
STAT,1904,43,15-19,1947,0.0012900887901691183
STAT,1904,56,na,1960,2858.878655309091
SIM,1846,18,20-24,1864,13
SIM,1920,30,45-49,1950,3
SIM,1910,30,35-39,1940,5
STAT,1931,24,50-100,1955,0.8011469161785165
SIM,1846,97,na,1943,2
STAT,1871,47,25-29,1918,0.053781059541036284
STAT,1825,42,35-39,1867,1.9716831267703008
STAT,1838,45,na,1883,1594.2559761636717
STAT,1825,72,na,1897,671.2105499639306
SIM,1884,37,na,1921,2312
STAT,1861,47,15-19,1908,3.1272980149963026E-4
SIM,1871,64,na,1935,1619
STAT,1840,40,45-49,1880,1.1551103672683716
STAT,1882,26,na,1908,2200.0597701455554
STAT,1868,11,na,1879,2418.3156829722966
STAT,1920,47,30-34,1967,0.09309184596792335
STAT,1824,50,50-100,1874,0.01844311772906586
STAT,1900,9,na,1909,3400.2782667093325
STAT,1926,23,50-100,1949,0.7528212402178144
SIM,1841,34,40-44,1875,6
STAT,1916,19,35-39,1935,0.8365263796188438
STAT,1875,30,30-34,1905,17.089917553687133
STAT,1833,34,40-44,1867,3.3553960555077125
STAT,1848,45,na,1893,1688.428994677877
SIM,1804,55,na,1859,1085
STAT,1838,18,20-24,1856,15.629067427162092
SIM,1836,40,45-49,1876,6
STAT,1815,72,na,1887,610.6418077870584
SIM,1934,23,50-100,1957,1
STAT,1865,40,15-19,1905,0.011944207447562263
STAT,1867,54,40-44,1921,0.00908203471106611
SIM,1898,15,15-19,1913,7
SIM,1927,18,na,1945,4320
SIM,1865,23,na,1888,2121
SIM,1904,1,na,1905,3674
STAT,1838,28,50-100,1866,0.54238132597891
SIM,1831,98,na,1929,1
SIM,1913,56,na,1969,3136
STAT,1823,48,40-44,1871,0.20786923145747185
STAT,1842,20,25-29,1862,53.04758372115586
STAT,1829,40,50-100,1869,0.9298522643189815
SIM,1922,19,na,1941,3978
SIM,1908,46,50-100,1954,3
STAT,1862,32,45-49,1894,1.4085175054467698
SIM,1875,67,na,1942,1467
STAT,1895,31,45-49,1926,2.1564659598771585
SIM,1858,28,40-44,1886,2
STAT,1863,12,na,1875,2258.2948210120303
STAT,1878,11,na,1889,2554.129179103242
STAT,1885,45,45-49,1930,0.22444339926351037
STAT,1892,41,50-100,1933,1.2557031932533447
SIM,1827,28,na,1855,1635
STAT,1865,78,na,1943,669.0287705520532
STAT,1890,39,40-44,1929,5.004981067532855
SIM,1848,34,na,1882,1818
STAT,1933,36,na,1969,4845.373582960365
STAT,1782,91,na,1873,15.451515648850158
SIM,1860,68,na,1928,1232
SIM,1928,30,50-100,1958,4
STAT,1901,23,45-49,1924,0.9192482097852587
SIM,1912,19,na,1931,3646
STAT,1820,39,25-29,1859,5.844258911392698
STAT,1940,23,30-34,1963,27.65006659473634
STAT,1818,54,45-49,1872,0.02854294376604204
SIM,1849,16,30-34,1865,1
STAT,1843,29,50-100,1872,0.5241407663894702
STAT,1949,15,30-34,1964,13.399524319565685
STAT,1869,92,na,1961,76.91035304123531
SIM,1813,69,na,1882,733
STAT,1897,25,na,1922,3035.5467827943917
STAT,1908,15,na,1923,3555.809258444776
STAT,1867,59,na,1926,1724.0043969894584
STAT,1841,36,40-44,1877,3.5927961992441935
SIM,1922,30,na,1952,4034
SIM,1844,42,45-49,1886,1
STAT,1908,17,35-39,1925,0.7689567397864735
STAT,1860,52,30-34,1912,0.004538397256449106
STAT,1885,21,50-100,1906,0.3851525257690178
SIM,1840,17,na,1857,2005
STAT,1874,45,35-39,1919,0.1364784772918443
SIM,1869,28,50-100,1897,3
STAT,1868,19,45-49,1887,0.05923989867483524
STAT,1814,50,45-49,1864,0.0441339926408633
STAT,1909,55,na,1964,3089.155160701392
SIM,1843,35,na,1878,1822
SIM,1838,16,20-24,1854,14
STAT,1842,20,na,1862,1981.331129332458
STAT,1936,26,50-100,1962,0.9002652626139631
STAT,1911,35,20-24,1946,0.24282406314658697
STAT,1917,41,35-39,1958,0.19880975989519317
STAT,1939,18,25-29,1957,40.96560581685911
SIM,1883,30,30-34,1913,20
STAT,1889,46,40-44,1935,0.20022971231322567
SIM,1924,19,35-39,1943,5
STAT,1787,79,na,1866,265.1882731376001
SIM,1914,52,na,1966,3396
SIM,1916,17,35-39,1933,2
STAT,1864,15,45-49,1879,0.063266131142523
STAT,1861,37,20-24,1898,0.6054918903522052
SIM,1812,84,na,1896,116
STAT,1834,51,25-29,1885,0.0022989790218586183
STAT,1869,19,45-49,1888,0.05989841953124007
STAT,1872,4,na,1876,2784.6067913475854
STAT,1856,43,25-29,1899,0.46990053700796824
SIM,1833,42,35-39,1875,2
SIM,1961,10,na,1971,4754
SIM,1891,21,25-29,1912,65
SIM,1915,37,na,1952,3438
SIM,1862,30,45-49,1892,1
STAT,1842,61,na,1903,1353.2327879742556
STAT,1857,60,na,1917,1420.965179326947
STAT,1892,33,35-39,1925,11.932286383183431
STAT,1870,41,35-39,1911,1.6857855285444727
STAT,1866,74,na,1940,966.9824439369582
SIM,1904,48,50-100,1952,1
SIM,1835,57,na,1892,1258
STAT,1842,53,25-29,1895,0.0025238781669460874
SIM,1861,3,na,1864,2637
STAT,1872,47,25-29,1919,0.054325992667825666
STAT,1784,102,na,1886,0.0794737081209539
STAT,1775,112,na,1887,7.105385712268626E-4
STAT,1942,21,40-44,1963,3.331560078034283
SIM,1809,54,na,1863,1136
SIM,1839,19,25-29,1858,7
STAT,1763,105,na,1868,0.010503868251871998
STAT,1818,79,na,1897,343.329690231076
SIM,1893,21,50-100,1914,1
SIM,1828,68,na,1896,877
STAT,1844,86,na,1930,154.0982650397944
SIM,1847,18,20-24,1865,13
SIM,1861,64,na,1925,1489
STAT,1876,18,40-44,1894,0.17804655527651697
STAT,1883,21,25-29,1904,53.18172772854025
SIM,1882,38,45-49,1920,1
SIM,1940,31,25-29,1971,10
STAT,1854,30,45-49,1884,1.3045102556516723
STAT,1924,22,na,1946,4070.658206637797
STAT,1881,41,na,1922,2118.796297539873
SIM,1918,49,50-100,1967,2
STAT,1840,46,50-100,1886,0.16462975738103597
SIM,1881,32,20-24,1913,2
SIM,1811,43,45-49,1854,1
SIM,1852,50,na,1902,1672
SIM,1822,84,na,1906,160
SIM,1785,87,na,1872,49
SIM,1939,27,30-34,1966,43
STAT,1839,18,20-24,1857,15.349909471701848
STAT,1866,28,25-29,1894,36.72838920936013
STAT,1870,34,45-49,1904,1.602270434589301
SIM,1809,104,na,1913,1
STAT,1843,49,20-24,1892,0.007936126946387886
STAT,1903,43,15-19,1946,0.0012797074365510424
SIM,1889,4,na,1893,3185
STAT,1836,42,45-49,1878,1.1529645086954476
STAT,1853,45,15-19,1898,3.057361672125265E-4
SIM,1906,23,na,1929,3216
STAT,1881,41,45-49,1922,1.3720236739040224
SIM,1824,30,25-29,1854,10
STAT,1956,7,na,1963,4912.765698858315
SIM,1864,82,na,1946,379
SIM,1876,63,na,1939,1717
STAT,1925,40,30-34,1965,0.14662330021561698
SIM,1891,30,na,1921,2809
SIM,1887,19,20-24,1906,16
STAT,1874,52,na,1926,2067.2240513428583
STAT,1828,79,na,1907,393.72226287699607
STAT,1912,41,na,1953,3403.482601266476
STAT,1858,45,na,1903,1683.0288267098651
SIM,1839,20,na,1859,1895
STAT,1873,32,20-24,1905,2.5898396985746435
STAT,1906,41,25-29,1947,0.06163288626882603
SIM,1879,81,na,1960,645
STAT,1905,6,na,1911,3567.1592479651176
SIM,1949,16,35-39,1965,9
STAT,1927,40,na,1967,4412.338475158851
STAT,1896,16,50-100,1912,0.061276581384613185
SIM,1826,87,na,1913,76
STAT,1847,27,50-100,1874,0.5669759105685545
STAT,1916,31,40-44,1947,3.8323765587324825
STAT,1807,54,35-39,1861,0.030299325504904023
STAT,1896,40,na,1936,2922.8572674562756
SIM,1878,39,50-100,1917,4
STAT,1893,44,40-44,1937,0.18459928776002063
STAT,1848,45,40-44,1893,0.1284797781739442
STAT,1852,53,35-39,1905,0.006141236443660854
SIM,1944,26,50-100,1970,4
STAT,1812,48,30-34,1860,0.31876170578369073
STAT,1851,32,35-39,1883,7.582206152801648
SIM,1882,15,na,1897,2414
STAT,1831,68,na,1899,892.2925469127877
SIM,1848,75,na,1923,734
STAT,1826,53,40-44,1879,0.0091914583210131
STAT,1867,19,35-39,1886,0.4917578265296322
STAT,1929,16,30-34,1945,14.730693395898559
SIM,1839,24,20-24,1863,61
SIM,1896,51,na,1947,2710
STAT,1839,19,na,1858,1975.7585982635635
SIM,1938,32,na,1970,3435
STAT,1954,10,na,1964,4588.416519313984
STAT,1831,90,na,1921,46.03387207657402
STAT,1908,42,45-49,1950,0.14546705162709253
STAT,1898,15,20-24,1913,22.769804735490144
STAT,1950,17,35-39,1967,4.687267138141001
STAT,1909,35,15-19,1944,0.017335129526520224
SIM,1935,19,30-34,1954,20
SIM,1781,75,na,1856,325
STAT,1843,24,na,1867,1786.8179916677802
STAT,1901,25,45-49,1926,1.4781610254593252
STAT,1905,44,15-19,1949,0.0012918101733480302
SIM,1924,30,30-34,1954,21
STAT,1903,22,45-49,1925,0.9373063616503724
SIM,1855,77,na,1932,629
SIM,1868,29,45-49,1897,1
STAT,1904,15,15-19,1919,8.07901368845687
STAT,1913,36,na,1949,3524.438313741647
SIM,1797,98,na,1895,1
STAT,1835,80,na,1915,393.7216807702634
SIM,1931,28,30-34,1959,53
STAT,1860,49,20-24,1909,0.0090060668002727
STAT,1923,31,30-34,1954,17.132343390152958
STAT,1932,37,40-44,1969,1.9000981077846453
SIM,1889,18,25-29,1907,9
STAT,1927,19,30-34,1946,14.240089136941657
SIM,1907,33,35-39,1940,12
STAT,1864,54,30-34,1918,0.004874055348787526
SIM,1876,32,25-29,1908,13
SIM,1945,22,15-19,1967,5
SIM,1903,28,25-29,1931,73
STAT,1868,32,25-29,1900,9.232090643308755
SIM,1909,43,na,1952,3321
SIM,1838,97,na,1935,3
STAT,1853,48,20-24,1901,0.008967443849402812
SIM,1920,25,20-24,1945,19
STAT,1911,41,35-39,1952,0.18261649021797866
STAT,1855,105,na,1960,0.05519749689373515
SIM,1883,22,15-19,1905,6
STAT,1903,47,15-19,1950,3.0187133703610193E-4
SIM,1851,87,na,1938,121
STAT,1943,27,45-49,1970,1.7381613191828302
STAT,1900,61,na,1961,2577.0837666312314
STAT,1835,29,na,1864,1768.7186244613015
STAT,1801,102,na,1903,0.1036386372286671
SIM,1937,16,30-34,1953,10
SIM,1804,85,na,1889,89
SIM,1859,36,40-44,1895,7
STAT,1873,46,na,1919,2161.7251665186386
STAT,1866,32,15-19,1898,0.12408284223309371
STAT,1844,65,na,1909,1173.7189953138773
SIM,1862,33,50-100,1895,5
SIM,1910,18,15-19,1928,8
SIM,1928,29,40-44,1957,5
SIM,1880,76,na,1956,952
STAT,1848,79,na,1927,519.4757672305195
STAT,1902,18,15-19,1920,7.891399874098445
STAT,1935,22,50-100,1957,0.8464656803811055
SIM,1947,17,na,1964,3887
SIM,1848,17,25-29,1865,5
STAT,1830,25,50-100,1855,0.7821391419228038
STAT,1906,47,40-44,1953,0.1322530270826993
SIM,1817,43,50-100,1860,3
SIM,1905,38,30-34,1943,1
STAT,1886,16,40-44,1902,0.1829691366781015
STAT,1787,109,na,1896,2.6220859122076093E-4
STAT,1832,109,na,1941,4.285843672785215E-4
STAT,1912,25,20-24,1937,17.109521958865706
STAT,1934,32,45-49,1966,2.029635726864283
STAT,1896,39,na,1935,2909.9334663848813
STAT,1841,31,50-100,1872,0.7744045975653716
STAT,1900,1,na,1901,3567.0181888089555
SIM,1910,23,40-44,1933,3
STAT,1838,51,50-100,1889,0.010287240368575897
STAT,1766,101,na,1867,0.10923249574413571
STAT,1927,39,25-29,1966,1.1539763089513067
STAT,1929,36,25-29,1965,1.195206472152871
SIM,1867,22,30-34,1889,21
STAT,1930,41,45-49,1971,0.20716264790457745
SIM,1840,31,50-100,1871,1
STAT,1937,22,15-19,1959,4.897067043789002
SIM,1941,9,na,1950,3782
SIM,1884,58,na,1942,1922
STAT,1826,44,na,1870,1442.6115705130153
STAT,1913,24,25-29,1937,87.56779601511805
SIM,1813,46,na,1859,1351
STAT,1885,79,na,1964,913.9874751864454
STAT,1922,45,50-100,1967,0.24662239288392984
SIM,1921,24,25-29,1945,109
STAT,1829,105,na,1934,0.017716591986123964
STAT,1936,33,50-100,1969,0.7581692372432656
STAT,1849,20,20-24,1869,63.38388368038829
STAT,1930,21,20-24,1951,134.97318409798484
SIM,1880,68,na,1948,1465
STAT,1923,40,15-19,1963,0.0017003190948662239
STAT,1942,17,na,1959,3633.833702876719
SIM,1955,12,na,1967,4602
STAT,1951,9,na,1960,4420.661745892038
SIM,1906,34,30-34,1940,22
SIM,1850,46,na,1896,1691
STAT,1928,37,20-24,1965,0.31471454425335804
STAT,1900,40,20-24,1940,0.014598472386168442
STAT,1818,49,na,1867,1341.9324689271725
STAT,1813,46,25-29,1859,0.16007447441241485
SIM,1923,21,25-29,1944,100
STAT,1933,36,45-49,1969,0.8779917939878733
SIM,1845,21,40-44,1866,6
STAT,1805,50,na,1855,1258.4682508540066
SIM,1900,32,40-44,1932,4
SIM,1835,31,25-29,1866,9
STAT,1914,22,20-24,1936,107.3220526710201
SIM,1868,21,35-39,1889,8
STAT,1822,54,na,1876,1178.3855246673475
SIM,1880,44,na,1924,2304
SIM,1904,26,20-24,1930,19
SIM,1909,18,20-24,1927,26
SIM,1888,19,20-24,1907,18
STAT,1917,10,na,1927,4027.0265604357587
STAT,1916,38,40-44,1954,1.4410335537283445
STAT,1838,20,45-49,1858,0.6162046895419651
SIM,1909,29,30-34,1938,49
STAT,1887,15,45-49,1902,0.06934596679107607
STAT,1894,22,25-29,1916,69.49900414117876
STAT,1845,19,50-100,1864,0.04330276044934965
SIM,1905,36,35-39,1941,2
STAT,1948,16,40-44,1964,1.5126512491646347
SIM,1922,22,20-24,1944,115
STAT,1852,52,na,1904,1552.706894522754
STAT,1827,85,na,1912,158.34874332555376
STAT,1880,37,25-29,1917,2.8674928425853676
SIM,1905,25,25-29,1930,62
STAT,1917,37,45-49,1954,0.668925556697154
STAT,1837,21,40-44,1858,1.7832091105741361
STAT,1872,80,na,1952,586.1677760942225
STAT,1934,34,40-44,1968,5.040997825283207
STAT,1770,115,na,1885,1.3875987555223303E-4
SIM,1891,38,50-100,1929,1
STAT,1915,21,25-29,1936,90.47470154117246
STAT,1916,30,30-34,1946,15.489954163726217
SIM,1924,38,40-44,1962,2
SIM,1830,26,na,1856,1758
STAT,1844,31,25-29,1875,8.595627102376831
STAT,1917,18,na,1935,3916.123207312222
STAT,1924,44,25-29,1968,0.07997250687455994
SIM,1901,55,na,1956,2767
STAT,1812,47,20-24,1859,0.04017696647157482
STAT,1856,25,50-100,1881,0.49567749531571176
SIM,1916,44,40-44,1960,3
STAT,1838,69,na,1907,985.2354780433969
STAT,1913,26,20-24,1939,17.24204453166373
STAT,1814,67,na,1881,860.0089582411223
STAT,1946,19,40-44,1965,1.4646095278845022
SIM,1921,37,30-34,1958,2
SIM,1897,40,45-49,1937,1
STAT,1845,18,45-49,1863,0.05807909983046767
STAT,1921,23,na,1944,3884.480354673539
STAT,1935,33,45-49,1968,2.055340652807027
STAT,1906,66,na,1972,2612.10184831293
STAT,1913,37,30-34,1950,1.6992109411142193
STAT,1896,30,35-39,1926,12.736957898428702
STAT,1918,46,20-24,1964,0.011137455013763092
SIM,1867,8,na,1875,2635
STAT,1867,31,50-100,1898,0.816102861692526
STAT,1907,15,40-44,1922,0.25499891883320297
STAT,1929,43,na,1972,4536.316788014267
STAT,1942,28,40-44,1970,4.619291064584301
STAT,1851,11,na,1862,2097.3744893673834
STAT,1942,20,30-34,1962,28.48824774835408
SIM,1867,0,na,1867,3252
SIM,1889,81,na,1970,984
STAT,1864,85,na,1949,230.81345486686595
STAT,1922,47,25-29,1969,0.057568827475147216
SIM,1904,37,30-34,1941,3
SIM,1905,61,na,1966,2688
STAT,1946,23,na,1969,3837.7767656763262
STAT,1889,40,45-49,1929,1.7630762473762907
STAT,1940,26,35-39,1966,14.469492981723011
STAT,1868,75,na,1943,927.8975251506982
SIM,1850,38,na,1888,1784
SIM,1915,27,35-39,1942,14
STAT,1875,77,na,1952,839.3374569924351
STAT,1859,39,na,1898,1753.6081776676597
STAT,1924,43,40-44,1967,0.2806098203168857
STAT,1917,29,15-19,1946,0.694408811270491
STAT,1955,6,na,1961,4929.50162449533
SIM,1843,76,na,1919,649
STAT,1809,88,na,1897,55.09082366082358
STAT,1948,19,45-49,1967,0.5397193986182822
SIM,1849,26,30-34,1875,33
SIM,1906,21,25-29,1927,86
STAT,1784,71,na,1855,533.00802
SIM,1884,6,na,1890,2539
SIM,1833,66,na,1899,970
SIM,1857,20,20-24,1877,64
STAT,1859,25,35-39,1884,7.487296825564381
STAT,1904,31,20-24,1935,3.6777655548223462
STAT,1859,31,na,1890,1801.5770795788876
STAT,1863,44,na,1907,1890.194546586044
SIM,1866,26,30-34,1892,26
SIM,1855,69,na,1924,1122
STAT,1930,41,15-19,1971,0.0019115355243278624
SIM,1861,21,25-29,1882,51
SIM,1950,20,30-34,1970,41
SIM,1860,48,na,1908,1862
STAT,1928,35,25-29,1963,1.1775263312930546
STAT,1902,23,40-44,1925,2.7696148140902404
SIM,1921,26,20-24,1947,24
SIM,1926,33,45-49,1959,1
SIM,1858,16,25-29,1874,7
STAT,1869,32,50-100,1901,0.8385382634391841
SIM,1912,31,20-24,1943,1
STAT,1794,73,na,1867,494.9691991832067
STAT,1918,33,45-49,1951,1.573012112609836
STAT,1819,98,na,1917,1.7148884225944105
SIM,1902,24,15-19,1926,4
STAT,1759,96,na,1855,0.61218
STAT,1890,44,30-34,1934,1.3099043313220358
STAT,1909,43,45-49,1952,0.14618199936593884
STAT,1870,21,25-29,1891,53.21318831961807
STAT,1888,17,50-100,1905,0.054696895570799896
STAT,1899,23,50-100,1922,0.5262139596570342
SIM,1818,77,na,1895,390
STAT,1859,42,50-100,1901,0.7933582026635925
SIM,1776,96,na,1872,1
STAT,1853,21,25-29,1874,51.55844207314317
STAT,1851,21,15-19,1872,2.854474868059361
STAT,1920,18,50-100,1938,0.39605036615636136
STAT,1898,3,na,1901,3379.683239834651
STAT,1801,60,na,1861,934.0966864371685
STAT,1892,49,na,1941,2607.026291843582
STAT,1840,53,30-34,1893,0.003843684641913517
STAT,1885,35,50-100,1920,1.1670756640296474
SIM,1912,15,15-19,1927,8
SIM,1896,4,na,1900,3324
STAT,1852,60,na,1912,1382.679055794291
SIM,1936,35,25-29,1971,4
SIM,1931,15,25-29,1946,65
STAT,1908,44,40-44,1952,0.21593492400874859
SIM,1951,19,15-19,1970,43
STAT,1903,25,50-100,1928,0.8656774278965678
SIM,1873,74,na,1947,1013
STAT,1808,47,na,1855,1303.459774566329
STAT,1907,27,35-39,1934,13.390085030259579
STAT,1858,26,30-34,1884,19.231814160754887
STAT,1907,43,40-44,1950,0.21518940154734126
STAT,1817,83,na,1900,183.74223026732818
STAT,1940,15,25-29,1955,41.58838921112717
STAT,1919,45,25-29,1964,0.05460882832796944
STAT,1895,48,25-29,1943,0.03951331158479847
STAT,1900,29,45-49,1929,1.4446576375482612
SIM,1800,95,na,1895,2
SIM,1932,27,35-39,1959,22
STAT,1923,28,30-34,1951,42.34784471003399
STAT,1920,47,15-19,1967,3.846767253161281E-4
STAT,1869,16,35-39,1885,0.5121431901344511
SIM,1931,26,35-39,1957,23
STAT,1823,53,30-34,1876,0.006916229706813752
STAT,1922,27,30-34,1949,41.88535034364265
STAT,1913,41,15-19,1954,0.001422956502019751
STAT,1923,15,25-29,1938,48.294376013514274
STAT,1848,55,na,1903,1536.431158639033
STAT,1922,16,20-24,1938,148.58964677980723
STAT,1944,19,30-34,1963,12.383228193645795
SIM,1930,16,20-24,1946,157
STAT,1826,34,50-100,1860,1.1049834567432422
STAT,1879,18,15-19,1897,5.853142668419329
SIM,1875,16,30-34,1891,1
SIM,1831,67,na,1898,940
SIM,1897,25,na,1922,3107
STAT,1871,31,na,1902,2247.680354879183
SIM,1893,11,na,1904,3240
SIM,1915,43,40-44,1958,5
SIM,1931,31,30-34,1962,21
SIM,1898,21,20-24,1919,85
STAT,1834,21,15-19,1855,2.75797228177605
STAT,1924,27,35-39,1951,16.51363544578457
SIM,1857,49,50-100,1906,3
STAT,1923,26,35-39,1949,16.339589938801197
SIM,1842,21,15-19,1863,3
SIM,1878,40,35-39,1918,4
STAT,1812,52,na,1864,1232.254291172471
STAT,1868,15,35-39,1883,0.5095137441010607
SIM,1930,27,30-34,1957,54
STAT,1923,38,na,1961,4113.915287008348
STAT,1934,29,15-19,1963,0.8962666960443071
SIM,1941,30,30-34,1971,16
STAT,1852,39,15-19,1891,0.040301544664241164
SIM,1856,94,na,1950,9
SIM,1852,80,na,1932,401
SIM,1899,17,25-29,1916,8
STAT,1933,17,35-39,1950,5.306474742503765
SIM,1924,33,35-39,1957,13
STAT,1922,44,15-19,1966,0.001659630335991413
SIM,1863,13,na,1876,2245
STAT,1909,23,na,1932,3340.4010434724128
STAT,1772,94,na,1866,3.489206234334307
STAT,1917,34,40-44,1951,3.8381332667439843
STAT,1867,16,30-34,1883,1.4539802295063475
STAT,1842,82,na,1924,337.89073299249594
STAT,1910,17,40-44,1927,0.261830772245718
SIM,1858,21,20-24,1879,55
SIM,1905,22,20-24,1927,88
STAT,1877,26,40-44,1903,2.9455305786686443
SIM,1901,23,na,1924,3089
STAT,1872,29,na,1901,2245.25238770739
SIM,1914,31,30-34,1945,23
STAT,1894,49,20-24,1943,0.008046316858934553
STAT,1848,36,50-100,1884,0.9499395972064202
STAT,1916,33,35-39,1949,8.875299094777127
STAT,1876,62,na,1938,1783.8743630078834
STAT,1946,16,30-34,1962,12.775157950071668
SIM,1914,28,30-34,1942,38
STAT,1880,34,20-24,1914,2.6690220037832604
STAT,1907,48,40-44,1955,0.13233043411205833
STAT,1936,29,25-29,1965,59.44683402080441
SIM,1858,32,30-34,1890,28
STAT,1914,53,na,1967,3368.879001285899
STAT,1934,3,na,1937,5182.801753250633
SIM,1801,69,na,1870,672
SIM,1925,34,40-44,1959,6
STAT,1931,22,20-24,1953,136.23868083662168
STAT,1887,40,35-39,1927,1.9327659768822734
STAT,1933,30,30-34,1963,20.08048289064527
SIM,1911,19,15-19,1930,7
SIM,1820,48,50-100,1868,2
SIM,1954,16,30-34,1970,17
STAT,1797,78,na,1875,313.4806404766202
STAT,1863,36,na,1899,1962.5464106156778
SIM,1862,79,na,1941,560
STAT,1906,19,40-44,1925,0.2503074293215464
SIM,1928,8,na,1936,4761
STAT,1920,38,na,1958,3887.3970172360405
STAT,1921,15,15-19,1936,49.0968601205076
STAT,1813,43,20-24,1856,0.48506738400928273
STAT,1907,40,30-34,1947,0.11190759181923139
SIM,1835,49,na,1884,1447
SIM,1888,3,na,1891,2954
SIM,1931,34,35-39,1965,14
STAT,1843,15,30-34,1858,1.39213840623747
STAT,1919,47,20-24,1966,0.011323544741373872
SIM,1869,69,na,1938,1296
SIM,1941,17,35-39,1958,5
STAT,1942,26,45-49,1968,1.713729564164662
STAT,1906,58,na,1964,2892.7123794440813
SIM,1856,36,50-100,1892,1
SIM,1916,45,na,1961,3491
STAT,1842,50,na,1892,1581.6935044003123
STAT,1927,28,na,1955,4287.140299418194
SIM,1907,30,30-34,1937,22
SIM,1895,10,na,1905,3291
STAT,1842,53,40-44,1895,0.0075015268323774115
SIM,1851,15,30-34,1866,1
STAT,1789,94,na,1883,3.8224652995093913
STAT,1901,42,35-39,1943,0.1660753039025008
SIM,1879,29,20-24,1908,11
SIM,1894,36,na,1930,2976
STAT,1923,34,35-39,1957,9.883974018240043
STAT,1879,23,40-44,1902,2.0542553795361775
STAT,1902,44,na,1946,3050.3223395696564
STAT,1868,67,na,1935,1428.8235927159003
SIM,1849,35,50-100,1884,3
STAT,1903,19,15-19,1922,7.934161089801091
STAT,1851,67,na,1918,1140.3152868453865
STAT,1846,40,50-100,1886,0.8136439250268432
STAT,1943,24,40-44,1967,3.377164430404736
STAT,1896,41,50-100,1937,0.0919470966910935
SIM,1907,38,40-44,1945,6
SIM,1844,25,40-44,1869,2
SIM,1818,69,na,1887,734
STAT,1838,22,40-44,1860,1.81505925782422
STAT,1933,38,40-44,1971,1.924284580585024
SIM,1904,24,25-29,1928,71
STAT,1855,57,na,1912,1428.0974016367268
SIM,1924,40,na,1964,4188
SIM,1888,28,50-100,1916,4
STAT,1837,40,50-100,1877,0.830062557097779
SIM,1885,26,40-44,1911,3
SIM,1904,21,15-19,1925,4
STAT,1939,26,40-44,1965,4.428629017414744
STAT,1860,4,na,1864,2356.3081616561035
STAT,1870,48,20-24,1918,0.010981398391062106
STAT,1871,95,na,1966,45.68514738278691
SIM,1854,28,na,1882,1969
STAT,1905,32,20-24,1937,2.1193789639309664
STAT,1860,79,na,1939,535.8709391970614
SIM,1869,25,45-49,1894,1
SIM,1845,40,50-100,1885,1
SIM,1916,23,35-39,1939,9
SIM,1933,20,30-34,1953,40
SIM,1870,38,20-24,1908,2
SIM,1906,37,35-39,1943,7
STAT,1877,0,na,1877,3577.8886587413467
STAT,1916,36,45-49,1952,0.6626828519006428
STAT,1817,110,na,1927,1.279008557510776E-4
STAT,1906,42,50-100,1948,0.10081503876486107
STAT,1897,24,na,1921,2969.255585507403
SIM,1875,1,na,1876,3195
SIM,1869,22,35-39,1891,6
STAT,1884,38,na,1922,2187.975842314943
STAT,1902,21,45-49,1923,0.9324978605930934
STAT,1913,41,45-49,1954,0.1542129000794265
STAT,1830,49,35-39,1879,0.10222678803543184
SIM,1933,25,na,1958,4741
STAT,1937,27,20-24,1964,16.809745238401664
SIM,1905,33,30-34,1938,18
STAT,1942,18,50-100,1960,0.3697609883008186
STAT,1899,27,30-34,1926,32.595518667467864
SIM,1846,22,40-44,1868,1
STAT,1880,24,na,1904,2340.688927941518
SIM,1838,28,20-24,1866,19
STAT,1849,23,25-29,1872,51.52697304488084
STAT,1908,8,na,1916,3642.9839458956403
SIM,1901,33,40-44,1934,5
STAT,1880,16,na,1896,2521.516908373617
SIM,1910,21,45-49,1931,5
SIM,1903,8,na,1911,3497
STAT,1850,26,na,1876,1807.527555828905
STAT,1827,31,25-29,1858,12.82620420478932
STAT,1919,35,50-100,1954,0.4284844269748418
SIM,1928,26,30-34,1954,51
STAT,1885,47,na,1932,2108.671319736544
SIM,1863,3,na,1866,2546
SIM,1886,22,40-44,1908,6
SIM,1926,30,40-44,1956,6
STAT,1930,6,na,1936,4895.121722022815
STAT,1804,100,na,1904,0.35561553809635277
STAT,1924,12,na,1936,4457.346525971386
STAT,1798,63,na,1861,877.2834447288817
SIM,1859,59,na,1918,1539
SIM,1934,10,na,1944,4962
SIM,1907,5,na,1912,3635
SIM,1941,12,na,1953,3764
SIM,1908,58,na,1966,2905
STAT,1904,34,25-29,1938,7.9012666223524946
STAT,1923,23,30-34,1946,31.49416605318466
STAT,1921,18,25-29,1939,46.542081578115116
SIM,1814,87,na,1901,51
STAT,1911,29,20-24,1940,16.697394053303977
STAT,1924,41,20-24,1965,0.0198727901600719
STAT,1857,9,na,1866,2133.4952969849596
SIM,1852,9,na,1861,2248
STAT,1843,110,na,1953,1.8665164855094995E-4
STAT,1862,38,20-24,1900,0.619540694026541
STAT,1875,50,50-100,1925,0.014875733453491845
STAT,1878,22,40-44,1900,2.051552727424481
SIM,1857,23,25-29,1880,1
STAT,1827,93,na,1920,16.88151451682475
STAT,1830,100,na,1930,0.640751419921783
SIM,1801,80,na,1881,231
SIM,1912,34,25-29,1946,10
STAT,1791,73,na,1864,467.76574180806693
STAT,1862,22,50-100,1884,0.3371825041075418
STAT,1897,19,20-24,1916,22.277798794795004
SIM,1868,95,na,1963,20
STAT,1809,107,na,1916,0.0018924751062433607
STAT,1936,26,15-19,1962,0.6385141412370037
STAT,1891,27,50-100,1918,0.7476604611076009
STAT,1932,34,30-34,1966,19.760171360692674
SIM,1794,93,na,1887,4
SIM,1876,31,na,1907,2349
STAT,1905,18,40-44,1923,0.2490987477108259
STAT,1908,23,35-39,1931,8.152527142322597
STAT,1918,30,40-44,1948,3.960084607220047
STAT,1940,24,15-19,1964,5.119293637735611
STAT,1842,39,na,1881,1783.8861301926522
STAT,1886,30,50-100,1916,0.9216804795350804
STAT,1855,48,30-34,1903,0.0679243305910853
STAT,1876,22,30-34,1898,17.384873815020114
STAT,1901,35,na,1936,3169.8109008110796
SIM,1849,29,35-39,1878,9
STAT,1822,62,na,1884,971.2274842860536
STAT,1830,49,na,1879,1420.571254241482
SIM,1802,54,na,1856,1053
STAT,1853,38,50-100,1891,0.924542381669601
STAT,1898,37,50-100,1935,1.5695704213892188
SIM,1883,33,na,1916,2204
SIM,1918,39,25-29,1957,1
STAT,1836,25,40-44,1861,2.546526044980222
STAT,1893,74,na,1967,1660.408748689274
STAT,1832,46,35-39,1878,0.10133013732424981
SIM,1904,29,25-29,1933,64
SIM,1931,23,30-34,1954,40
SIM,1873,66,na,1939,1555
SIM,1825,79,na,1904,363
SIM,1811,98,na,1909,1
SIM,1820,48,na,1868,1408
SIM,1928,32,50-100,1960,2
STAT,1893,34,na,1927,2834.390161055043
STAT,1918,49,25-29,1967,0.05301462873362464
STAT,1829,30,45-49,1859,1.8397864021363288
STAT,1877,46,50-100,1923,0.24135526215244849
STAT,1884,16,30-34,1900,1.4912449215081736
SIM,1865,79,na,1944,576
SIM,1902,27,50-100,1929,1
STAT,1935,25,15-19,1960,0.9098719884463751
SIM,1821,57,na,1878,1099
STAT,1827,45,50-100,1872,0.23068471496459328
SIM,1828,36,na,1864,1622
SIM,1911,19,20-24,1930,25
SIM,1939,28,50-100,1967,4
SIM,1835,45,50-100,1880,1
SIM,1882,17,25-29,1899,5
SIM,1885,46,50-100,1931,3
STAT,1856,18,20-24,1874,15.360229377798063
SIM,1936,16,15-19,1952,35
SIM,1868,44,na,1912,2049
SIM,1887,23,40-44,1910,2
STAT,1882,82,na,1964,668.4807925912725
SIM,1847,26,na,1873,1955
SIM,1932,24,30-34,1956,32
SIM,1935,33,50-100,1968,1
STAT,1870,46,na,1916,2090.985216148214
STAT,1919,42,20-24,1961,0.018079766779265663
SIM,1910,26,45-49,1936,1
STAT,1924,24,30-34,1948,31.837299903570084
STAT,1895,45,20-24,1940,0.008419804343613408
STAT,1902,26,45-49,1928,1.4853709952235166
STAT,1873,47,35-39,1920,0.13351067708928546
SIM,1898,24,25-29,1922,69
STAT,1926,40,40-44,1966,0.29209878080369855
STAT,1911,39,50-100,1950,0.3792552878367364
STAT,1928,16,15-19,1944,54.15294439533168
STAT,1854,47,25-29,1901,0.04101980481677913
STAT,1828,54,20-24,1882,5.046330746630336E-4
SIM,1930,19,25-29,1949,52
STAT,1804,57,na,1861,1051.551442463209
STAT,1826,49,15-19,1875,3.5943401279662287E-4
STAT,1927,33,50-100,1960,0.960191563740984
STAT,1914,34,15-19,1948,0.12115572364052345
STAT,1922,19,25-29,1941,47.12458775126349
SIM,1909,51,na,1960,3202
SIM,1891,20,na,1911,2817
STAT,1870,36,50-100,1906,1.1433008730543603
STAT,1909,24,50-100,1933,0.5741327093485604
SIM,1805,59,na,1864,1011
SIM,1864,18,20-24,1882,16
STAT,1903,19,20-24,1922,23.7020508198991
STAT,1862,15,40-44,1877,0.1712109925518947
SIM,1870,49,50-100,1919,3
SIM,1839,39,na,1878,1699
SIM,1894,30,50-100,1924,1
STAT,1866,49,45-49,1915,0.20133839553512609
SIM,1925,14,na,1939,4487
SIM,1892,16,30-34,1908,3
STAT,1918,49,50-100,1967,0.2260484880005547
SIM,1846,41,na,1887,1669
STAT,1856,42,na,1898,1701.4661497775385
STAT,1874,17,25-29,1891,5.469658909170559
STAT,1885,87,na,1972,434.9853087392859
STAT,1780,81,na,1861,160.85457714516713
STAT,1920,31,35-39,1951,9.494625433041953
SIM,1938,32,25-29,1970,9
STAT,1935,15,na,1950,4775.591359377219
STAT,1877,36,na,1913,2319.815580374626
STAT,1942,23,35-39,1965,9.323515175348579
STAT,1903,61,na,1964,2697.3745222157468
SIM,1911,14,na,1925,3721
SIM,1896,29,20-24,1925,23
SIM,1871,34,20-24,1905,2
SIM,1929,37,35-39,1966,5
STAT,1924,20,na,1944,4094.9460717460784
STAT,1910,33,40-44,1943,3.5496649693216176
STAT,1867,21,20-24,1888,61.82650835828256
STAT,1821,77,na,1898,460.5188374781248
SIM,1866,61,na,1927,1645
SIM,1856,54,na,1910,1644
SIM,1946,23,20-24,1969,109
STAT,1894,44,50-100,1938,0.08786310847623009
SIM,1944,26,20-24,1970,17
STAT,1814,43,50-100,1857,3.5711324421468214
STAT,1825,108,na,1933,9.735348528367257E-4
SIM,1938,1,na,1939,3642
STAT,1914,13,na,1927,3853.4504601682756
SIM,1911,18,30-34,1929,2
STAT,1843,18,35-39,1861,0.4708419983896184
STAT,1912,40,45-49,1952,0.15336306630304317
STAT,1925,26,45-49,1951,1.9342201438325353
SIM,1821,97,na,1918,2
STAT,1860,39,50-100,1899,0.931605188756763
STAT,1938,23,20-24,1961,103.93051630324051
STAT,1938,29,50-100,1967,0.9306543301078066
SIM,1877,24,na,1901,2301
SIM,1853,49,50-100,1902,3
STAT,1867,32,30-34,1899,15.488132150267546
SIM,1843,41,25-29,1884,3
STAT,1883,46,40-44,1929,0.15901793163286126
SIM,1847,18,15-19,1865,3
STAT,1829,32,40-44,1861,4.327038962394235
SIM,1841,39,50-100,1880,4
STAT,1873,14,na,1887,2490.687501593036
SIM,1844,28,45-49,1872,4
SIM,1828,47,na,1875,1464
SIM,1863,22,40-44,1885,2
STAT,1785,88,na,1873,46.31313064279063
SIM,1940,27,na,1967,3500
STAT,1897,48,35-39,1945,0.09851777168970106
STAT,1860,47,na,1907,1716.4848989861568
SIM,1822,42,na,1864,1460
SIM,1926,3,na,1929,4604
SIM,1929,26,25-29,1955,95
STAT,1763,103,na,1866,0.026746776987708963
STAT,1781,74,na,1855,418.4022
STAT,1854,24,45-49,1878,0.5778292988235476
STAT,1854,33,50-100,1887,0.664398118885652
STAT,1871,21,40-44,1892,1.9606649504020635
SIM,1852,45,50-100,1897,1
SIM,1837,30,45-49,1867,1
STAT,1836,20,35-39,1856,6.165000670720335
STAT,1836,106,na,1942,0.00786255245621596
SIM,1921,21,15-19,1942,5
STAT,1839,18,15-19,1857,5.1383171603065705
STAT,1931,37,25-29,1968,1.2318454438776976
STAT,1890,47,40-44,1937,0.11101628226813785
STAT,1882,50,na,1932,2006.5750607697983
STAT,1824,96,na,1920,4.734570164054735
SIM,1858,66,na,1924,1335
STAT,1933,33,35-39,1966,11.626803845722158
STAT,1907,24,30-34,1931,24.563855527441802
STAT,1928,39,40-44,1967,1.783398743412365
SIM,1849,92,na,1941,22
STAT,1886,64,na,1950,1734.7259222908829
SIM,1779,93,na,1872,3
STAT,1896,21,45-49,1917,0.8726646943155385
STAT,1785,100,na,1885,0.22424077734676198
STAT,1854,44,20-24,1898,0.11209457646463758
SIM,1889,31,20-24,1920,3
STAT,1840,45,50-100,1885,0.16675251692144588
STAT,1855,22,40-44,1877,1.7299537041117177
STAT,1837,47,25-29,1884,0.03880551175950044
SIM,1844,20,35-39,1864,3
STAT,1855,17,15-19,1872,5.015998336457122
STAT,1926,24,40-44,1950,3.8346830639359992
STAT,1937,19,na,1956,3372.703479526734
SIM,1859,33,30-34,1892,20
SIM,1842,59,na,1901,1282
STAT,1856,44,30-34,1900,0.8359566898565046
STAT,1902,39,20-24,1941,0.21959176331509883
SIM,1828,44,na,1872,1514
STAT,1816,41,15-19,1857,0.039038690343100584
STAT,1907,43,35-39,1950,0.17324150587998002
STAT,1937,25,25-29,1962,60.66556732731638
STAT,1900,18,na,1918,3301.146397656951
SIM,1915,24,30-34,1939,42
SIM,1810,49,na,1859,1236
SIM,1875,46,na,1921,2173
STAT,1842,45,40-44,1887,0.12721910630724076
STAT,1864,1,na,1865,3038.464332462566
STAT,1947,16,25-29,1963,46.13007940621557
STAT,1859,102,na,1961,0.6049016633163224
SIM,1847,18,na,1865,2144
STAT,1835,41,25-29,1876,0.49603246353318203
SIM,1879,28,na,1907,2386
STAT,1856,21,45-49,1877,0.6012570099297964
SIM,1843,36,na,1879,1811
SIM,1955,16,25-29,1971,69
STAT,1841,19,50-100,1860,0.043049990291421904
SIM,1818,37,na,1855,1494
SIM,1862,2,na,1864,2781
SIM,1864,44,30-34,1908,1
STAT,1866,23,25-29,1889,49.92553394126785
STAT,1841,89,na,1930,72.42515060046297
SIM,1837,32,40-44,1869,6
SIM,1902,7,na,1909,3488
STAT,1800,83,na,1883,137.8339438241312
STAT,1896,23,40-44,1919,2.5919041396755653
STAT,1938,34,30-34,1972,14.946649771821674
STAT,1877,29,45-49,1906,1.080248187231961
STAT,1901,33,50-100,1934,1.2064769207203894
SIM,1818,38,45-49,1856,1
STAT,1896,15,50-100,1911,0.06141045617908358
SIM,1830,33,20-24,1863,1
STAT,1841,36,35-39,1877,5.805036903832865
SIM,1933,26,45-49,1959,2
STAT,1957,15,na,1972,4586.156044655713
STAT,1802,85,na,1887,90.8019779096628
SIM,1875,21,20-24,1896,79
SIM,1885,21,35-39,1906,5
STAT,1905,47,25-29,1952,0.04415970770370535
STAT,1851,99,na,1950,1.3623399117448278
STAT,1888,29,20-24,1917,13.003947167370708
STAT,1910,31,45-49,1941,1.4392502669458125
STAT,1828,34,45-49,1862,1.6846187614478474
STAT,1883,13,na,1896,2388.2469437676928
STAT,1864,44,50-100,1908,0.8774960627177457
STAT,1774,115,na,1889,1.4800901435714172E-4
STAT,1832,31,50-100,1863,0.7312258180158734
STAT,1883,38,50-100,1921,1.1315114869208627
SIM,1844,31,50-100,1875,4
SIM,1899,56,na,1955,2671
STAT,1922,32,20-24,1954,2.6035341965286003
SIM,1904,28,40-44,1932,4
STAT,1834,95,na,1929,8.24283380833572
STAT,1762,104,na,1866,0.01521103336971295
SIM,1845,48,na,1893,1564
SIM,1857,25,na,1882,1978
STAT,1822,33,20-24,1855,6.840523625757676
STAT,1920,19,15-19,1939,47.8429797239085
SIM,1853,11,na,1864,2189
SIM,1930,32,20-24,1962,3
STAT,1845,31,40-44,1876,3.686885070806379
SIM,1900,30,na,1930,3179
SIM,1934,24,40-44,1958,4
STAT,1906,44,30-34,1950,0.10836301066606457
STAT,1936,26,20-24,1962,16.510151233892444
STAT,1939,29,45-49,1968,1.6391048657307574
SIM,1885,29,45-49,1914,4
SIM,1884,22,30-34,1906,22
STAT,1921,34,25-29,1955,9.633546944224147
SIM,1911,22,na,1933,3398
STAT,1867,45,45-49,1912,0.21143755484484222
STAT,1862,18,45-49,1880,0.06007265622592788
STAT,1895,25,45-49,1920,1.3767250962408513
SIM,1823,43,30-34,1866,1
STAT,1906,26,35-39,1932,13.321557106150411
STAT,1861,31,25-29,1892,8.078312745202451
STAT,1909,31,na,1940,3423.5716680231053
STAT,1921,15,20-24,1936,146.66910092985302
STAT,1886,61,na,1947,1864.7308527750201
SIM,1859,20,25-29,1879,56
SIM,1890,34,30-34,1924,32
SIM,1898,30,50-100,1928,1
STAT,1952,17,45-49,1969,0.5655191339363312
SIM,1859,31,35-39,1890,10
STAT,1906,31,25-29,1937,8.12517769663109
STAT,1900,43,25-29,1943,0.058016785207238596
SIM,1881,21,na,1902,1863
STAT,1892,6,na,1898,3091.072591998466
SIM,1874,23,25-29,1897,51
STAT,1858,14,na,1872,2046.7601697188531
STAT,1895,18,50-100,1913,0.06018024764175596
STAT,1908,29,50-100,1937,0.8825612149096037
STAT,1928,13,na,1941,4709.027322903531
SIM,1928,29,35-39,1957,26
STAT,1855,20,45-49,1875,0.5873117258121894
SIM,1836,34,45-49,1870,1
SIM,1849,31,20-24,1880,2
SIM,1881,61,na,1942,1426
STAT,1911,32,45-49,1943,1.4475995015025245
STAT,1835,21,30-34,1856,15.178742870777773
STAT,1848,47,na,1895,1663.9684010043538
STAT,1867,90,na,1957,88.51206972750376
SIM,1916,53,na,1969,3414
STAT,1953,1,na,1954,4591.803726621274
SIM,1928,25,25-29,1953,85
SIM,1843,21,30-34,1864,20
SIM,1853,43,na,1896,1738
SIM,1939,16,40-44,1955,1
SIM,1842,51,na,1893,1450
SIM,1945,25,25-29,1970,70
SIM,1932,16,na,1948,4591
STAT,1883,32,15-19,1915,0.131899891191125
STAT,1835,40,na,1875,1644.9411067546675
STAT,1822,36,25-29,1858,5.342733139789569
STAT,1886,72,na,1958,1349.367614563746
SIM,1849,42,30-34,1891,4
STAT,1925,44,40-44,1969,0.2851162285066748
SIM,1921,24,na,1945,3879
STAT,1905,44,20-24,1949,0.014855816191126806
SIM,1943,18,20-24,1961,134
STAT,1914,21,na,1935,3545.119365047094
SIM,1901,15,na,1916,3344
SIM,1914,15,25-29,1929,12
STAT,1925,39,15-19,1964,0.02172660643174951
STAT,1935,18,20-24,1953,174.6298152751599
STAT,1879,30,35-39,1909,10.094881165261034
SIM,1887,30,35-39,1917,11
STAT,1922,24,50-100,1946,0.7083757744782417
SIM,1914,26,35-39,1940,23
SIM,1853,14,na,1867,2157
STAT,1857,83,na,1940,295.7795243902674
SIM,1835,92,na,1927,18
SIM,1914,31,25-29,1945,12
STAT,1906,15,25-29,1921,7.833098655851848
SIM,1857,28,na,1885,1921
STAT,1853,77,na,1930,654.1686300857102
STAT,1920,34,45-49,1954,1.6143249013702738
SIM,1862,28,na,1890,2029
STAT,1783,78,na,1861,251.8614813332461
STAT,1937,27,na,1964,3449.7691748393395
SIM,1893,35,50-100,1928,3
STAT,1836,28,45-49,1864,0.9236823540432976
STAT,1898,43,15-19,1941,0.0012171263165789755
STAT,1926,43,45-49,1969,0.19351465808560872
SIM,1807,85,na,1892,86
SIM,1918,23,45-49,1941,1
SIM,1845,21,35-39,1866,5
STAT,1845,49,50-100,1894,0.17016496419390117
STAT,1836,22,30-34,1858,15.222993543176575
STAT,1901,34,35-39,1935,13.27679090448715
STAT,1914,41,30-34,1955,0.1198498004981861
SIM,1840,17,20-24,1857,13
STAT,1935,29,30-34,1964,50.406854623687195
STAT,1951,16,45-49,1967,0.5621176424137436
STAT,1932,16,35-39,1948,5.261868637798037
STAT,1801,68,na,1869,693.17831386207
STAT,1847,23,15-19,1870,2.96086989804344
STAT,1844,54,na,1898,1454.302734718236
STAT,1911,18,50-100,1929,0.07064277646030491
STAT,1901,23,25-29,1924,75.46435972329272
STAT,1872,22,40-44,1894,1.974569862810535
STAT,1895,46,na,1941,2779.284720875255
SIM,1937,19,35-39,1956,3
STAT,1914,38,30-34,1952,1.7106033368623035
STAT,1884,19,35-39,1903,0.5093752072321619
STAT,1894,6,na,1900,3171.530980022914
SIM,1940,16,35-39,1956,4
STAT,1941,27,40-44,1968,4.5550304728310955
SIM,1922,38,30-34,1960,2
STAT,1837,21,35-39,1858,4.9936832176415225
SIM,1894,28,na,1922,2974
SIM,1908,34,40-44,1942,3
STAT,1783,89,na,1872,31.032722105426792
STAT,1948,19,50-100,1967,0.4047895489637117
SIM,1890,35,na,1925,2985
STAT,1869,35,45-49,1904,1.841744720096867
SIM,1899,33,30-34,1932,32
SIM,1890,46,na,1936,2831
STAT,1875,24,50-100,1899,0.39349162642344226
SIM,1848,30,20-24,1878,2
SIM,1899,20,25-29,1919,93
STAT,1828,70,na,1898,790.1836669546743
STAT,1861,36,50-100,1897,0.9690177509602581
STAT,1921,27,50-100,1948,1.047965846736519
SIM,1807,74,na,1881,424
STAT,1815,43,30-34,1858,2.79020781204564
STAT,1866,46,40-44,1912,0.14959373161606407
SIM,1844,22,30-34,1866,19
STAT,1878,48,25-29,1926,0.05599584322695257
SIM,1877,35,45-49,1912,1
STAT,1946,19,35-39,1965,4.393828329256071
SIM,1821,100,na,1921,1
STAT,1898,30,45-49,1928,2.247256205352445
SIM,1952,19,30-34,1971,13
STAT,1912,37,15-19,1949,0.017706797980647483
STAT,1832,29,na,1861,1697.708475123346
SIM,1907,33,40-44,1940,8
STAT,1901,22,35-39,1923,7.716499447391567
SIM,1899,22,20-24,1921,77
STAT,1903,69,na,1972,2353.3922082349172
STAT,1852,21,30-34,1873,15.451768145019054
SIM,1860,21,30-34,1881,17
SIM,1919,35,25-29,1954,1
SIM,1935,35,na,1970,4901
STAT,1840,59,na,1899,1275.4132285478527
STAT,1842,31,15-19,1873,0.12588289629986887
SIM,1821,89,na,1910,59
STAT,1882,34,30-34,1916,15.903178168798933
STAT,1831,47,30-34,1878,0.0689619822281733
STAT,1925,42,45-49,1967,0.1903461197977328
SIM,1854,9,na,1863,2321
STAT,1925,23,40-44,1948,3.7902745746936755
STAT,1838,77,na,1915,580.309800554905
SIM,1941,20,na,1961,3491
SIM,1792,67,na,1859,683
STAT,1932,30,15-19,1962,0.16156162085876907
STAT,1863,37,25-29,1900,2.3869042480072267
SIM,1852,18,na,1870,2127
STAT,1898,18,25-29,1916,7.225476278222909
SIM,1929,34,30-34,1963,20
SIM,1920,28,25-29,1948,78
STAT,1854,21,40-44,1875,1.7644639180807755
STAT,1821,37,na,1858,1513.242406865348
STAT,1929,19,35-39,1948,5.031668435538168
STAT,1894,9,na,1903,3150.012919363151
STAT,1837,44,20-24,1881,0.1078778866868854
STAT,1931,34,20-24,1965,3.015394945601146
SIM,1923,37,40-44,1960,3
STAT,1825,31,15-19,1856,0.27722249880815203
SIM,1889,34,25-29,1923,17
STAT,1872,72,na,1944,1196.690490016505
SIM,1929,23,20-24,1952,112
SIM,1931,13,na,1944,4881
SIM,1934,27,45-49,1961,2
STAT,1804,97,na,1901,1.7995212716166435
STAT,1942,24,25-29,1966,91.43095628999086
SIM,1935,27,na,1962,4748
STAT,1795,66,na,1861,800.3214681569436
STAT,1892,22,15-19,1914,3.903571214619904
STAT,1951,1,na,1952,4577.35811689104
SIM,1855,23,15-19,1878,2
STAT,1802,53,na,1855,1125.284809439997
STAT,1857,29,50-100,1886,0.4838913250748016
STAT,1774,96,na,1870,1.167314954056814
STAT,1823,54,50-100,1877,0.01720201922147045
STAT,1840,70,na,1910,920.7781902522089
STAT,1912,28,25-29,1940,61.062309858305326
SIM,1920,50,na,1970,3867
STAT,1927,36,20-24,1963,0.30989578141753577
STAT,1920,22,45-49,1942,1.181686589006959
STAT,1813,93,na,1906,12.027613191630941
SIM,1875,24,25-29,1899,53
STAT,1841,33,30-34,1874,14.453534522451555
STAT,1940,28,30-34,1968,37.72756104236139
STAT,1885,32,25-29,1917,9.644882509902502
SIM,1854,92,na,1946,25
SIM,1880,36,na,1916,2385
SIM,1846,33,na,1879,1785
STAT,1826,44,45-49,1870,1.4050747473150424
STAT,1867,24,25-29,1891,50.4634258924554
SIM,1871,37,25-29,1908,2
STAT,1886,19,45-49,1905,0.06483642720680514
STAT,1900,36,50-100,1936,0.3489518736079353
STAT,1881,54,30-34,1935,0.005282949722015275
SIM,1844,85,na,1929,146
SIM,1908,37,45-49,1945,3
SIM,1889,15,20-24,1904,23
SIM,1848,99,na,1947,2
STAT,1845,22,50-100,1867,0.35823390094400986
SIM,1893,32,25-29,1925,18
STAT,1856,47,35-39,1903,0.10270981073172755
STAT,1883,49,45-49,1932,0.2140224384431133
STAT,1865,41,50-100,1906,0.9086971407345467
STAT,1877,21,35-39,1898,5.7356534389749
STAT,1893,35,45-49,1928,2.4109337264906605
SIM,1890,43,na,1933,2873
STAT,1835,34,50-100,1869,0.727174633447758
STAT,1925,40,25-29,1965,0.0818976995546178
STAT,1940,31,30-34,1971,15.413019124455792
STAT,1827,29,na,1856,1645.90192567301
STAT,1866,20,20-24,1886,61.413936216635356
SIM,1925,4,na,1929,4563
SIM,1873,41,50-100,1914,1
STAT,1937,29,40-44,1966,4.288031034241081
SIM,1859,39,45-49,1898,1
SIM,1901,31,45-49,1932,3
SIM,1924,34,25-29,1958,12
STAT,1818,41,25-29,1859,1.5662497195089022
STAT,1922,35,25-29,1957,1.0602280387114629
SIM,1896,24,15-19,1920,4
SIM,1920,39,na,1959,3952
STAT,1827,47,50-100,1874,0.22464678033020566
SIM,1817,52,na,1869,1281
STAT,1874,29,50-100,1903,0.6130330608670966
STAT,1918,29,30-34,1947,39.111609465786735
STAT,1842,48,45-49,1890,0.16875956784600094
STAT,1793,88,na,1881,42.220922215052134
STAT,1923,44,30-34,1967,0.14069005632053186
STAT,1926,27,45-49,1953,1.9564111500227275
STAT,1828,31,40-44,1859,4.67066285395668
SIM,1833,22,25-29,1855,55
STAT,1896,31,na,1927,2989.5329543405473
STAT,1908,39,15-19,1947,0.016814579236105038
STAT,1909,26,50-100,1935,0.9094139328084919
SIM,1885,23,30-34,1908,15
STAT,1932,21,25-29,1953,114.83847351583944
SIM,1917,26,50-100,1943,1
STAT,1857,42,15-19,1899,0.01027649769700515
STAT,1874,27,50-100,1901,0.6174460634686098
STAT,1918,18,20-24,1936,139.04089140857656
SIM,1930,35,25-29,1965,1
SIM,1830,36,25-29,1866,2
SIM,1862,21,40-44,1883,2
STAT,1897,56,na,1953,2576.8376790924954
STAT,1918,25,15-19,1943,0.7145621101566908
SIM,1926,29,30-34,1955,48
STAT,1872,2,na,1874,3128.7591606348014
STAT,1893,42,na,1935,2765.5201486351866
SIM,1852,31,25-29,1883,13
STAT,1916,45,35-39,1961,0.12551496109301116
STAT,1863,34,20-24,1897,2.2216968998991895
STAT,1912,43,na,1955,3363.676762085452
SIM,1874,20,20-24,1894,73
SIM,1868,26,40-44,1894,7
STAT,1877,23,30-34,1900,17.40093788620458
STAT,1911,45,20-24,1956,0.009930379207748061
SIM,1849,22,15-19,1871,3
SIM,1933,23,40-44,1956,5
SIM,1926,18,20-24,1944,161
STAT,1852,34,45-49,1886,1.282073156846539
STAT,1928,32,15-19,1960,0.15179074144262478
STAT,1800,103,na,1903,0.057051961983922816
SIM,1854,84,na,1938,239
SIM,1904,49,50-100,1953,2
STAT,1897,45,30-34,1942,0.06967254733478893
SIM,1822,74,na,1896,581
SIM,1864,34,20-24,1898,3
STAT,1839,62,na,1901,1216.9001771422656
STAT,1906,40,15-19,1946,0.0013327821324560845
STAT,1921,31,20-24,1952,2.574760012989405
STAT,1916,34,25-29,1950,8.937418389138548
STAT,1915,37,40-44,1952,1.4286543316968094
STAT,1825,59,na,1884,1103.9173313624622
SIM,1910,51,na,1961,3183
STAT,1888,24,15-19,1912,3.6601320843076195
SIM,1903,25,20-24,1928,16
SIM,1860,34,45-49,1894,1
SIM,1839,27,25-29,1866,42
STAT,1839,21,45-49,1860,0.600853050084565
STAT,1856,34,20-24,1890,1.9753067585924826
STAT,1938,26,25-29,1964,61.630786333381494
SIM,1907,17,na,1924,3509
STAT,1907,18,45-49,1925,0.09041234527913979
STAT,1946,18,50-100,1964,0.392443383325618
SIM,1860,99,na,1959,5
STAT,1882,37,35-39,1919,6.498001618901609
SIM,1952,15,15-19,1967,56
SIM,1853,34,45-49,1887,1
SIM,1822,82,na,1904,228
SIM,1849,34,25-29,1883,21
SIM,1902,32,45-49,1934,2
SIM,1811,90,na,1901,33
SIM,1859,51,na,1910,1729
SIM,1905,29,40-44,1934,3
SIM,1807,82,na,1889,144
SIM,1914,23,30-34,1937,34
STAT,1815,46,35-39,1861,0.319977378625265
SIM,1879,90,na,1969,187
STAT,1836,31,50-100,1867,0.75781159436335
STAT,1900,26,40-44,1926,3.939171847174661
SIM,1845,70,na,1915,933
STAT,1906,23,30-34,1929,24.432258493206263
STAT,1893,49,50-100,1942,0.16250798003199912
SIM,1875,37,50-100,1912,3
STAT,1779,81,na,1860,162.23555948071834
SIM,1927,26,15-19,1953,2
STAT,1850,18,na,1868,1965.6594577320811
SIM,1929,20,na,1949,4324
SIM,1940,21,25-29,1961,90
STAT,1907,7,na,1914,3615.524875304124
STAT,1911,16,45-49,1927,0.09466973649271947
STAT,1845,34,45-49,1879,1.437050349729629
SIM,1888,64,na,1952,1958
SIM,1924,3,na,1927,4576
SIM,1930,18,40-44,1948,2
STAT,1895,22,40-44,1917,2.5664162540399307
STAT,1922,18,40-44,1940,1.525218571928073
STAT,1935,30,40-44,1965,5.120388127429408
STAT,1923,35,na,1958,4125.208074033884
SIM,1855,28,20-24,1883,12
STAT,1904,19,30-34,1923,2.148200517346474
STAT,1897,35,20-24,1932,0.983125929579318
STAT,1881,42,50-100,1923,0.9629378642423793
STAT,1913,28,na,1941,3513.9730141076093
STAT,1852,24,35-39,1876,4.95389429050581
SIM,1836,31,40-44,1867,2
STAT,1839,104,na,1943,0.0444087699589641
STAT,1775,114,na,1889,2.790393602739506E-4
STAT,1843,49,15-19,1892,2.6453733218354545E-4
STAT,1919,26,15-19,1945,0.7230632930315816
SIM,1887,18,15-19,1905,6
STAT,1902,65,na,1967,2515.770392702448
STAT,1847,28,20-24,1875,10.323231890370435
STAT,1830,46,30-34,1876,0.0734780364578307
STAT,1878,45,20-24,1923,0.011932030627571488
SIM,1856,62,na,1918,1410
STAT,1816,39,50-100,1855,4.032467227079514
SIM,1858,23,40-44,1881,1
STAT,1815,40,50-100,1855,2.974060007491005
SIM,1930,23,15-19,1953,5
STAT,1913,21,15-19,1934,4.887815350750865
STAT,1834,55,na,1889,1289.804804232189
SIM,1879,68,na,1947,1511
SIM,1953,16,15-19,1969,45
SIM,1846,17,15-19,1863,6
SIM,1848,33,25-29,1881,17
SIM,1931,19,40-44,1950,1
STAT,1869,32,40-44,1901,3.968917186492295
STAT,1943,8,na,1951,3961.0873410333315
SIM,1806,89,na,1895,45
SIM,1865,17,25-29,1882,6
SIM,1854,46,50-100,1900,2
SIM,1888,19,15-19,1907,6
STAT,1757,112,na,1869,8.415971701101787E-4
STAT,1858,26,50-100,1884,0.4885431704536065
STAT,1860,45,35-39,1905,0.10838120287329571
SIM,1928,19,20-24,1947,152
STAT,1815,52,na,1867,1255.4885920615222
SIM,1891,39,na,1930,2725
SIM,1933,27,50-100,1960,1
STAT,1862,51,na,1913,1747.4746408054207
SIM,1832,52,na,1884,1286
SIM,1881,18,20-24,1899,13
STAT,1811,67,na,1878,795.7553937611466
STAT,1871,98,na,1969,17.662956533835406
STAT,1857,17,25-29,1874,4.962373681412848
STAT,1874,39,na,1913,2251.157053302474
STAT,1873,18,20-24,1891,16.94145926772856
STAT,1896,71,na,1967,1967.157589426508
SIM,1958,5,na,1963,4785
SIM,1860,24,35-39,1884,4
SIM,1912,19,30-34,1931,2
SIM,1921,29,25-29,1950,78
SIM,1911,25,na,1936,3435
SIM,1851,48,50-100,1899,1
STAT,1871,24,45-49,1895,0.6500430334688037
STAT,1922,23,15-19,1945,5.749041307142741
STAT,1838,17,15-19,1855,5.262761769970143
STAT,1938,12,na,1950,3692.4447724044794
SIM,1922,17,na,1939,3978
STAT,1903,18,30-34,1921,2.1367901053809844
STAT,1923,19,40-44,1942,1.5432514821704737
SIM,1890,37,35-39,1927,16
STAT,1845,15,40-44,1860,0.16552922666008438
STAT,1879,16,na,1895,2503.638116976896
STAT,1857,80,na,1937,460.8919658824974
STAT,1879,21,45-49,1900,0.6916444614550378
STAT,1923,24,15-19,1947,5.8145049556187365
SIM,1919,39,40-44,1958,4
STAT,1841,23,20-24,1864,59.75243867778868
STAT,1871,47,30-34,1918,0.09038205926644194
STAT,1913,29,25-29,1942,61.51613106000993
STAT,1859,42,25-29,1901,0.48223734190524153
STAT,1872,25,45-49,1897,1.0592357650996327
SIM,1899,24,40-44,1923,3
STAT,1909,40,40-44,1949,0.22352601492151855
SIM,1878,33,40-44,1911,8
STAT,1914,44,35-39,1958,0.1878734156050169
STAT,1945,16,15-19,1961,46.846891709239095
STAT,1863,47,na,1910,1856.461449644934
SIM,1843,44,na,1887,1634
STAT,1849,32,na,1881,1885.6003549266693
SIM,1895,13,na,1908,3279
SIM,1877,32,40-44,1909,6
SIM,1928,22,20-24,1950,123
STAT,1910,15,45-49,1925,0.09394543294017799
SIM,1899,34,50-100,1933,1
STAT,1858,29,35-39,1887,7.211446745007378
SIM,1832,41,na,1873,1512
STAT,1925,27,50-100,1952,1.11057448465977
SIM,1866,29,35-39,1895,15
SIM,1931,24,15-19,1955,6
SIM,1825,36,50-100,1861,1
STAT,1872,48,30-34,1920,0.09057294474252923
STAT,1871,87,na,1958,220.17861418532067
STAT,1901,27,40-44,1928,3.961159477929562
STAT,1930,38,50-100,1968,0.5168238071737464
STAT,1794,70,na,1864,657.7635318327245
STAT,1944,15,15-19,1959,46.1625949281275
STAT,1843,48,50-100,1891,0.16380529902297286
STAT,1811,78,na,1889,333.3408503238828
STAT,1800,75,na,1875,417.6831185863184
STAT,1908,23,40-44,1931,2.9112100309115343
SIM,1762,93,na,1855,8
SIM,1903,29,30-34,1932,46
SIM,1879,82,na,1961,583
STAT,1790,80,na,1870,236.44256784966836
SIM,1876,33,30-34,1909,23
STAT,1820,52,na,1872,1257.3103323132816
STAT,1887,35,20-24,1922,0.8222797384310584
STAT,1856,17,30-34,1873,1.3891311262561103
STAT,1930,17,15-19,1947,55.42741731202699
STAT,1937,34,15-19,1971,0.11995052508590523
STAT,1823,101,na,1924,0.30538698860489094
SIM,1840,25,na,1865,1833
STAT,1850,54,50-100,1904,0.010353515577942913
STAT,1881,50,20-24,1931,6.831075010869256E-4
SIM,1874,20,15-19,1894,2
SIM,1935,32,35-39,1967,17
STAT,1864,53,25-29,1917,0.0029343912824368068
STAT,1840,16,25-29,1856,4.843404988534821
STAT,1866,95,na,1961,25.37874617316174
STAT,1784,74,na,1858,401.0902703628745
SIM,1836,31,35-39,1867,13
SIM,1866,39,45-49,1905,2
STAT,1911,24,na,1935,3397.784078725522
STAT,1828,56,na,1884,1200.4689847806324
SIM,1843,34,45-49,1877,1
SIM,1937,15,25-29,1952,47
STAT,1868,33,30-34,1901,15.670767705699339
SIM,1872,28,20-24,1900,11
STAT,1906,35,40-44,1941,1.312362968699509
SIM,1853,65,na,1918,1301
SIM,1905,17,30-34,1922,2
STAT,1824,33,30-34,1857,37.09695333348618
SIM,1950,21,20-24,1971,120
STAT,1871,28,20-24,1899,10.966212071232237
STAT,1886,10,na,1896,2584.913233384349
SIM,1832,26,25-29,1858,34
STAT,1905,45,50-100,1950,0.1910600112564835
SIM,1896,32,45-49,1928,2
STAT,1808,100,na,1908,0.41049059936572774
STAT,1921,39,25-29,1960,1.0363770408880417
STAT,1836,43,50-100,1879,0.8034968945208326
STAT,1890,15,na,1905,2930.541502253752
SIM,1923,28,45-49,1951,2
STAT,1888,32,45-49,1920,1.9468871753440447
STAT,1916,31,20-24,1947,2.388705595243602
SIM,1828,76,na,1904,548
STAT,1825,37,50-100,1862,1.5410998642360694
STAT,1855,38,20-24,1893,0.5450687667596442
SIM,1881,28,30-34,1909,27
STAT,1863,32,40-44,1895,3.595212969771581
SIM,1878,19,25-29,1897,10
SIM,1933,35,35-39,1968,6
STAT,1849,49,45-49,1898,0.17327387406791034
STAT,1923,47,35-39,1970,0.14248225118351282
STAT,1942,21,20-24,1963,110.176187647455
SIM,1931,27,25-29,1958,92
STAT,1843,20,20-24,1863,59.27377111839955
SIM,1870,69,na,1939,1296
SIM,1869,43,40-44,1912,5
STAT,1844,38,45-49,1882,1.447947534797299
SIM,1869,26,20-24,1895,13
SIM,1939,23,35-39,1962,12
SIM,1940,25,40-44,1965,4
STAT,1891,24,30-34,1915,20.688333862659995
STAT,1915,28,45-49,1943,1.6588441025102625
STAT,1813,47,15-19,1860,0.0010935448958910576
STAT,1846,35,45-49,1881,1.576450642983912
STAT,1923,27,25-29,1950,71.38865340029565
STAT,1843,13,na,1856,2051.247066012
SIM,1919,50,na,1969,3788
STAT,1833,39,40-44,1872,3.288935062189021
STAT,1876,16,45-49,1892,0.0639116618695955
STAT,1931,21,45-49,1952,1.3827534841926699
SIM,1834,23,25-29,1857,48
STAT,1899,50,na,1949,2827.1948339522924
STAT,1828,31,35-39,1859,10.906894891631511
SIM,1867,30,25-29,1897,8
SIM,1852,38,45-49,1890,3
STAT,1925,35,35-39,1960,2.7471532554886426
STAT,1767,94,na,1861,3.424545974646966
STAT,1871,3,na,1874,2931.2934117717755
STAT,1876,49,50-100,1925,0.23470188356814448
SIM,1851,20,20-24,1871,59
STAT,1895,22,35-39,1917,7.186969661205535
SIM,1837,37,25-29,1874,5
STAT,1952,0,na,1952,4946.339825906511
SIM,1910,37,na,1947,3411
STAT,1873,28,30-34,1901,24.042215008673438
SIM,1930,18,35-39,1948,6
STAT,1839,25,50-100,1864,0.5443345870973729
STAT,1887,28,15-19,1915,0.4777327906253443
STAT,1932,25,40-44,1957,5.772323097368024
SIM,1916,23,40-44,1939,5
STAT,1922,18,35-39,1940,4.5756554508592115
STAT,1900,47,40-44,1947,0.12596678789205804
STAT,1958,11,na,1969,4873.658445971545
STAT,1866,97,na,1963,13.848812893929363
STAT,1903,34,45-49,1937,1.3343802738891712
SIM,1845,56,na,1901,1421
SIM,1854,35,45-49,1889,2
STAT,1943,20,25-29,1963,92.90340169329362
STAT,1882,46,25-29,1928,0.0530682485252064
SIM,1839,23,30-34,1862,19
SIM,1934,28,20-24,1962,25
STAT,1884,21,20-24,1905,64.51163819136747
STAT,1856,37,25-29,1893,2.122192317690015
STAT,1831,23,20-24,1854,126.08554410129894
STAT,1952,2,na,1954,4490.377693264589
STAT,1896,39,20-24,1935,0.9520970764814939
STAT,1850,51,30-34,1901,0.004216168036780299
SIM,1909,20,30-34,1929,30
STAT,1851,28,35-39,1879,8.068465759686756
SIM,1919,39,35-39,1958,5
STAT,1883,67,na,1950,1468.24994663311
STAT,1898,47,30-34,1945,0.06948044148661026
SIM,1924,31,20-24,1955,2
STAT,1850,19,50-100,1869,0.04170618217741499
STAT,1896,28,25-29,1924,52.593085314166885
STAT,1835,34,45-49,1869,1.383977536718018
SIM,1828,98,na,1926,2
STAT,1859,30,25-29,1889,7.813503049411906
SIM,1915,20,15-19,1935,5
STAT,1929,28,30-34,1957,46.302096222979785
SIM,1825,30,20-24,1855,1
SIM,1937,28,30-34,1965,42
STAT,1870,50,45-49,1920,0.013642819087238455
SIM,1858,26,45-49,1884,3
STAT,1912,44,25-29,1956,0.06456171917829505
STAT,1807,108,na,1915,6.813062933004881E-4
STAT,1881,86,na,1967,429.9557710966723
STAT,1890,43,25-29,1933,0.7363117685234934
SIM,1886,30,na,1916,2368
SIM,1905,37,25-29,1942,4
SIM,1904,33,50-100,1937,4
SIM,1861,94,na,1955,24
STAT,1903,15,na,1918,3410.5718971795045
STAT,1880,38,15-19,1918,0.05564889133325347
STAT,1869,20,40-44,1889,1.9266710024513647
STAT,1881,47,20-24,1928,0.010900222998130553
STAT,1919,38,15-19,1957,0.019469672159320602
SIM,1841,39,40-44,1880,2
SIM,1938,24,30-34,1962,30
STAT,1917,16,45-49,1933,0.1018024490905304
STAT,1837,42,40-44,1879,1.722565321357914
STAT,1905,33,50-100,1938,0.7153661966353292
SIM,1951,20,25-29,1971,90
STAT,1921,34,na,1955,3942.014876393413
STAT,1927,32,35-39,1959,10.619375874837274
STAT,1829,48,20-24,1877,0.009680619069764564
STAT,1928,36,30-34,1964,2.1778890777854603
SIM,1873,27,25-29,1900,40
SIM,1787,69,na,1856,617
SIM,1911,34,45-49,1945,2
STAT,1841,45,25-29,1886,0.04092547879438914
STAT,1939,31,15-19,1970,0.12393683037886248
SIM,1863,75,na,1938,820
SIM,1892,21,20-24,1913,82
STAT,1926,28,20-24,1954,20.598656556689356
STAT,1854,106,na,1960,0.024162045895623156
STAT,1866,36,30-34,1902,4.666125484953788
STAT,1887,43,50-100,1930,1.1082719591403787
STAT,1874,92,na,1966,122.1600980521715
STAT,1900,45,45-49,1945,0.17619842618672713
SIM,1922,34,20-24,1956,2
STAT,1912,46,20-24,1958,0.010058549396695041
SIM,1892,29,45-49,1921,2
SIM,1855,31,45-49,1886,1
SIM,1933,5,na,1938,5141
SIM,1848,13,na,1861,2182
STAT,1885,39,45-49,1924,1.8582612198760877
STAT,1814,56,na,1870,1208.5398911958334
STAT,1803,80,na,1883,260.4447223539568
STAT,1833,26,35-39,1859,7.859900573685877
STAT,1929,15,25-29,1944,52.48686604832821
STAT,1884,29,45-49,1913,1.0288624972575255
SIM,1841,26,35-39,1867,7
STAT,1823,92,na,1915,22.289981076154525
STAT,1849,27,40-44,1876,2.66275124795848
STAT,1905,31,45-49,1936,1.3728608519322607
STAT,1870,47,45-49,1917,0.21769599973273862
STAT,1928,16,20-24,1944,161.77335266802606
STAT,1852,54,45-49,1906,0.010231971927605506
SIM,1936,16,20-24,1952,111
STAT,1850,23,30-34,1873,14.962516268658355
STAT,1818,48,45-49,1866,0.49565098393264706
STAT,1914,34,20-24,1948,2.2996726880481817
SIM,1857,27,40-44,1884,2
STAT,1845,38,20-24,1883,0.5672051025694964
STAT,1858,34,25-29,1892,7.521554621279368
SIM,1896,62,na,1958,2382
STAT,1781,105,na,1886,0.02040290574514105
SIM,1874,36,30-34,1910,5
STAT,1845,28,na,1873,1849.869568197959
SIM,1925,2,na,1927,4608
STAT,1839,47,35-39,1886,0.09497072257675071
STAT,1907,16,50-100,1923,0.06815436410249129
SIM,1840,92,na,1932,26
STAT,1865,24,15-19,1889,2.818270612998785
STAT,1834,38,45-49,1872,1.522958569800045
STAT,1918,22,50-100,1940,0.6704241806927488
SIM,1959,6,na,1965,4879
STAT,1840,49,25-29,1889,0.0371544021258331
STAT,1864,31,45-49,1895,1.4742492742780733
SIM,1840,27,30-34,1867,27
STAT,1844,109,na,1953,4.941256577810197E-4
STAT,1923,42,50-100,1965,0.129714344279295
STAT,1937,30,50-100,1967,0.7736275961664906
SIM,1875,4,na,1879,2677
SIM,1873,34,30-34,1907,14
SIM,1893,36,40-44,1929,8
STAT,1840,27,20-24,1867,9.599347955606225
STAT,1911,56,na,1967,3163.312734555505
SIM,1901,24,35-39,1925,9
STAT,1819,48,20-24,1867,0.022396966434682888
STAT,1890,18,20-24,1908,20.422201033904557
STAT,1943,15,50-100,1958,0.37552042223339577
SIM,1842,35,40-44,1877,4
SIM,1886,52,na,1938,2079
STAT,1858,68,na,1926,1131.9076108979136
STAT,1835,26,na,1861,1807.3705318427678
SIM,1846,95,na,1941,7
STAT,1879,24,50-100,1903,0.40072857072580415
STAT,1900,64,na,1964,2477.473032533578
STAT,1778,88,na,1866,40.558016337490216
STAT,1900,17,45-49,1917,0.08560543466331154
STAT,1879,30,na,1909,2378.727112382128
STAT,1844,32,30-34,1876,14.50089426806154
SIM,1873,12,na,1885,2523
SIM,1815,58,na,1873,1137
STAT,1879,49,30-34,1928,0.09372430372410531
SIM,1919,42,na,1961,3871
STAT,1927,1,na,1928,4905.194203663589
SIM,1941,17,40-44,1958,1
STAT,1947,24,30-34,1971,30.666544435168372
SIM,1913,31,45-49,1944,1
STAT,1881,34,15-19,1915,0.12884948466971433
STAT,1910,24,35-39,1934,8.301355350150267
SIM,1811,68,na,1879,670
STAT,1823,49,25-29,1872,0.06894281481071231
SIM,1868,22,25-29,1890,61
STAT,1889,26,50-100,1915,0.7486045870255043
SIM,1795,64,na,1859,825
SIM,1924,17,40-44,1941,4
STAT,1887,36,45-49,1923,2.1166247348093163
STAT,1833,70,na,1903,860.8226594187565
STAT,1886,18,na,1904,2513.7253380940065
STAT,1922,48,30-34,1970,0.09647865540632963
STAT,1814,43,15-19,1857,0.04668147324316437
STAT,1937,29,35-39,1966,13.812058758466911
SIM,1816,38,35-39,1854,15
STAT,1823,52,25-29,1875,0.004198165185219891
STAT,1886,39,20-24,1925,0.7614960745215977
SIM,1943,24,na,1967,3570
STAT,1933,17,40-44,1950,1.7688250165807804
STAT,1857,22,50-100,1879,0.3507527961838554
STAT,1897,38,25-29,1935,3.61948485131216
STAT,1918,45,45-49,1963,0.2195217500257299
SIM,1842,28,35-39,1870,9
STAT,1849,41,20-24,1890,0.11962765964517189
STAT,1885,36,40-44,1921,4.1418870165875665
SIM,1835,32,30-34,1867,14
STAT,1840,52,25-29,1892,0.002312098714973757
SIM,1866,31,20-24,1897,2
SIM,1836,19,20-24,1855,17
STAT,1829,37,25-29,1866,2.612397231074102
STAT,1891,62,na,1953,2136.2178613838023
SIM,1877,20,40-44,1897,3
STAT,1883,21,na,1904,2197.153064865315
STAT,1891,64,na,1955,2031.760695878642
STAT,1916,17,40-44,1933,0.28034557855116843
SIM,1895,36,45-49,1931,2
SIM,1936,22,na,1958,2721
STAT,1894,23,30-34,1917,21.558171568681367
STAT,1928,19,25-29,1947,51.30574517696811
STAT,1964,0,na,1964,4711.712776919769
SIM,1818,40,50-100,1858,1
STAT,1860,40,35-39,1900,1.4020117674062007
STAT,1907,20,15-19,1927,4.60546277554241
STAT,1824,34,na,1858,1577.2090206252642
STAT,1889,38,35-39,1927,8.20791487011567
SIM,1904,25,30-34,1929,43
SIM,1906,16,35-39,1922,4
STAT,1870,22,30-34,1892,16.507734412502707
SIM,1837,42,50-100,1879,2
STAT,1850,16,25-29,1866,4.910270485519337
SIM,1906,33,25-29,1939,6
STAT,1827,32,30-34,1859,20.94848992548459
STAT,1825,45,40-44,1870,0.17954405013421018
STAT,1943,28,20-24,1971,18.35657911262154
SIM,1912,18,na,1930,3641
SIM,1869,80,na,1949,566
STAT,1820,50,na,1870,1308.1114010431845
STAT,1865,46,25-29,1911,0.04946096281502833
SIM,1894,39,20-24,1933,3
SIM,1851,28,45-49,1879,4
SIM,1898,28,40-44,1926,2
STAT,1834,28,35-39,1862,7.7956913093454006
STAT,1870,28,45-49,1898,1.0253639182945424
SIM,1817,44,45-49,1861,3
SIM,1896,39,30-34,1935,3
STAT,1893,22,50-100,1915,0.48854418785028786
STAT,1873,21,45-49,1894,0.670130984041187
STAT,1871,42,na,1913,2165.4406993640273
STAT,1871,21,35-39,1892,5.490629001490668
STAT,1876,35,45-49,1911,1.9641306898755524
STAT,1913,25,30-34,1938,37.13420452152944
STAT,1830,42,15-19,1872,0.0107429723942279
SIM,1831,56,na,1887,1234
SIM,1899,27,45-49,1926,2
STAT,1848,37,35-39,1885,5.415989950958818
SIM,1867,35,45-49,1902,2
STAT,1881,28,20-24,1909,10.668512889739144
STAT,1903,35,15-19,1938,0.01644648022440926
STAT,1873,99,na,1972,14.491298546640738
STAT,1924,20,15-19,1944,5.969156568921664
SIM,1921,25,30-34,1946,42
SIM,1795,86,na,1881,59
SIM,1883,29,35-39,1912,9
SIM,1832,33,30-34,1865,24
STAT,1875,36,40-44,1911,4.271077922909367
STAT,1923,27,na,1950,4063.075405711212
STAT,1831,24,45-49,1855,0.7080769108531536
STAT,1871,43,15-19,1914,0.012861037341202584
STAT,1865,48,na,1913,1902.2564962125448
SIM,1852,32,30-34,1884,17
SIM,1882,48,na,1930,2091
SIM,1888,38,25-29,1926,1
STAT,1853,22,30-34,1875,15.927502909825165
SIM,1873,24,15-19,1897,3
SIM,1883,36,40-44,1919,4
STAT,1830,27,20-24,1857,11.757274886877104
STAT,1892,29,35-39,1921,11.33549746683502
STAT,1895,49,15-19,1944,2.720873393357688E-4
SIM,1861,22,30-34,1883,20
STAT,1841,26,25-29,1867,36.48393586438715
STAT,1870,19,15-19,1889,5.487090575817272
SIM,1848,11,na,1859,2206
SIM,1898,20,45-49,1918,3
SIM,1824,86,na,1910,94
SIM,1878,38,25-29,1916,4
STAT,1875,29,35-39,1904,9.302287300298111
STAT,1952,18,20-24,1970,153.43280959422123
STAT,1869,39,20-24,1908,0.6983724993704221
SIM,1922,17,30-34,1939,20
STAT,1934,38,50-100,1972,0.5467894127625558
SIM,1870,77,na,1947,720
STAT,1842,85,na,1927,198.5232994872166
STAT,1934,25,50-100,1959,1.2660335316819948
STAT,1914,17,30-34,1931,2.3819593144322986
STAT,1891,17,25-29,1908,6.62316588295758
STAT,1860,20,20-24,1880,60.706006617759826
STAT,1940,27,25-29,1967,63.40648911815845
SIM,1831,27,20-24,1858,9
SIM,1856,37,35-39,1893,9
STAT,1854,21,35-39,1875,4.94118934431479
STAT,1929,21,45-49,1950,1.3481895375143804
STAT,1776,113,na,1889,4.626232303426166E-4
SIM,1951,11,na,1962,4294
STAT,1838,48,30-34,1886,0.0660085587645862
SIM,1928,25,na,1953,4361
STAT,1899,32,20-24,1931,3.4988464988806185
STAT,1825,38,35-39,1863,8.515891940265611
SIM,1877,39,20-24,1916,3
SIM,1833,38,35-39,1871,11
STAT,1859,46,40-44,1905,0.12908912753484666
STAT,1904,27,15-19,1931,0.614792530045058
SIM,1873,63,na,1936,1702
SIM,1882,24,30-34,1906,32
SIM,1862,21,35-39,1883,4
STAT,1844,62,na,1906,1269.4025682143736
SIM,1804,88,na,1892,57
STAT,1781,103,na,1884,0.051953428658939704
STAT,1860,28,45-49,1888,0.8540008334623326
STAT,1782,93,na,1875,5.790677255739794
STAT,1906,55,na,1961,2953.667657228998
SIM,1937,21,45-49,1958,2
SIM,1834,20,20-24,1854,53
STAT,1803,101,na,1904,0.1918110089276904
STAT,1844,35,40-44,1879,3.604568677025351
STAT,1905,18,35-39,1923,0.7472961998649168
SIM,1874,39,35-39,1913,14
STAT,1896,45,15-19,1941,2.843257861575254E-4
SIM,1773,85,na,1858,69
STAT,1866,12,na,1878,2346.1573925070315
STAT,1843,23,25-29,1866,48.185718976876366
SIM,1857,20,15-19,1877,3
SIM,1879,32,45-49,1911,3
STAT,1876,25,35-39,1901,9.4812912012969
STAT,1942,7,na,1949,3917.7845622760765
SIM,1886,84,na,1970,588
STAT,1839,17,30-34,1856,1.388197826210538
STAT,1908,26,45-49,1934,1.5613098684049924
STAT,1818,39,15-19,1857,0.14857387242049297
STAT,1887,16,20-24,1903,18.779470483008893
STAT,1870,44,40-44,1914,2.05640436886301
SIM,1940,28,45-49,1968,2
STAT,1860,18,35-39,1878,0.4822189803490809
SIM,1820,70,na,1890,712
SIM,1903,35,na,1938,3236
STAT,1864,50,20-24,1914,6.302357479562596E-4
STAT,1836,65,na,1901,1094.3632280887687
SIM,1954,15,25-29,1969,56
SIM,1884,25,35-39,1909,9
SIM,1924,0,na,1924,4759
STAT,1917,38,20-24,1955,0.25737966679565266
STAT,1883,17,35-39,1900,0.5082217433430074
STAT,1845,31,35-39,1876,8.60958480673577
STAT,1910,36,45-49,1946,0.6189174224321539
STAT,1946,15,25-29,1961,45.43123282977686
SIM,1829,36,50-100,1865,1
SIM,1914,27,25-29,1941,69
SIM,1851,23,25-29,1874,51
STAT,1909,19,15-19,1928,8.36286599316536
SIM,1939,17,na,1956,3439
SIM,1895,16,20-24,1911,19
SIM,1847,17,30-34,1864,1
SIM,1833,77,na,1910,450
STAT,1914,37,25-29,1951,0.9287255175462547
STAT,1832,75,na,1907,620.1494100393475
SIM,1862,26,na,1888,2049
STAT,1904,39,25-29,1943,0.8336236560962916
STAT,1906,47,35-39,1953,0.10815084015348479
STAT,1824,36,35-39,1860,11.647640875364317
STAT,1932,28,45-49,1960,2.1366194374416763
STAT,1940,19,40-44,1959,1.3407241515150634
STAT,1866,39,35-39,1905,6.100761551241628
STAT,1888,39,30-34,1927,5.890311514938276
STAT,1844,94,na,1938,13.880804374494325
STAT,1929,0,na,1929,5431.315959871259
SIM,1852,35,40-44,1887,6
STAT,1803,53,40-44,1856,0.030065208616700586
SIM,1906,24,na,1930,3218
SIM,1868,33,na,1901,2135
SIM,1917,19,15-19,1936,40
STAT,1864,47,20-24,1911,0.010056557984191508
SIM,1853,31,35-39,1884,10
STAT,1849,49,50-100,1898,0.18032230254740464
STAT,1857,30,15-19,1887,0.10899771694976536
STAT,1866,27,40-44,1893,2.6100986890525992
STAT,1933,37,na,1970,4840.96429299987
STAT,1810,74,na,1884,462.13718568188835
SIM,1920,24,45-49,1944,3
STAT,1843,28,45-49,1871,0.9163213378678543
STAT,1911,29,15-19,1940,0.6457555762999316
STAT,1879,39,20-24,1918,0.7545998755369078
STAT,1921,36,20-24,1957,0.27831496230720715
SIM,1842,73,na,1915,731
STAT,1851,25,30-34,1876,21.51735144686989
STAT,1859,93,na,1952,21.974296498141676
STAT,1912,24,45-49,1936,1.0549595779289653
STAT,1949,20,na,1969,4028.443535677016
SIM,1832,23,20-24,1855,53
SIM,1949,20,25-29,1969,101
SIM,1848,37,40-44,1885,11
STAT,1900,32,na,1932,3127.2712977797964
SIM,1899,59,na,1958,2628
STAT,1839,34,15-19,1873,0.11428235684667448
SIM,1832,36,35-39,1868,13
STAT,1934,16,45-49,1950,0.6398763412230609
STAT,1849,20,15-19,1869,3.0343547800930915
SIM,1846,41,45-49,1887,3
SIM,1881,17,30-34,1898,2
STAT,1812,48,50-100,1860,0.8087590365520378
STAT,1808,58,na,1866,1073.5140641878336
STAT,1873,17,30-34,1890,1.5271093797864161
STAT,1790,88,na,1878,43.51129312733761
STAT,1772,116,na,1888,1.039020068189543E-4
STAT,1918,20,30-34,1938,29.45885080404779
SIM,1886,38,na,1924,2304
SIM,1914,38,45-49,1952,3
SIM,1880,25,45-49,1905,1
STAT,1898,17,35-39,1915,0.7014805271940693
STAT,1912,41,20-24,1953,0.016184151697325087
STAT,1848,45,20-24,1893,0.009005592278058265
STAT,1840,33,15-19,1873,0.1126530601053529
STAT,1852,51,40-44,1903,0.007668919361210453
STAT,1858,31,20-24,1889,2.0230031565178774
STAT,1858,46,na,1904,1671.1466431932934
STAT,1855,28,50-100,1883,0.47042434584312126
SIM,1828,90,na,1918,35
SIM,1837,59,na,1896,1239
STAT,1819,41,35-39,1860,3.956066517479231
STAT,1892,36,40-44,1928,5.204611663009219
STAT,1915,25,40-44,1940,4.521790743554416
SIM,1788,84,na,1872,92
STAT,1838,41,45-49,1879,1.1902342893526223
STAT,1818,45,40-44,1863,0.3762107395590994
STAT,1890,69,na,1959,1799.6272158992545
STAT,1849,40,na,1889,1763.4149949426478
SIM,1926,20,30-34,1946,44
SIM,1932,23,25-29,1955,121
STAT,1964,8,na,1972,4675.020823775321
STAT,1912,49,25-29,1961,0.04787900478212021
STAT,1875,51,35-39,1926,0.008399519928313517
STAT,1891,27,35-39,1918,11.277486518594008
STAT,1779,111,na,1890,0.001045565478014379
STAT,1885,20,25-29,1905,54.22658982780873
SIM,1922,37,25-29,1959,1
STAT,1861,74,na,1935,871.724656361313
STAT,1893,45,na,1938,2722.74930485684
STAT,1872,24,20-24,1896,64.89112314498391
STAT,1928,39,35-39,1967,2.8815148273469573
STAT,1906,27,25-29,1933,58.2026860260969
STAT,1850,26,35-39,1876,8.062193031392159
SIM,1893,20,25-29,1913,68
SIM,1898,21,15-19,1919,3
SIM,1909,23,35-39,1932,9
STAT,1834,30,20-24,1864,2.1938599826160328
SIM,1880,24,20-24,1904,71
STAT,1899,68,na,1967,2255.7599703672363
SIM,1839,26,35-39,1865,8
SIM,1917,28,20-24,1945,20
SIM,1916,26,45-49,1942,2
STAT,1868,78,na,1946,704.2480725683139
STAT,1877,22,25-29,1899,56.096958425296464
STAT,1884,24,25-29,1908,53.09404344825886
STAT,1778,86,na,1864,61.92380367045987
SIM,1936,19,25-29,1955,42
STAT,1924,23,25-29,1947,102.64601548110794
STAT,1855,51,50-100,1906,0.010783767246605878
SIM,1886,22,35-39,1908,5
STAT,1851,50,35-39,1901,0.006281860205738303
SIM,1906,46,na,1952,3101
SIM,1923,25,40-44,1948,7
STAT,1832,27,30-34,1859,20.629319563015674
STAT,1899,18,40-44,1917,0.2361299244270266
STAT,1854,42,40-44,1896,1.6073418364244467
STAT,1846,48,20-24,1894,0.008788611610782497
STAT,1868,24,40-44,1892,1.8664666515864423
STAT,1949,21,30-34,1970,31.694200524857354
STAT,1822,37,15-19,1859,0.09884247208572583
SIM,1805,81,na,1886,178
SIM,1934,20,25-29,1954,114
SIM,1941,23,na,1964,3483
STAT,1870,25,35-39,1895,9.0029205103222
STAT,1878,38,15-19,1916,0.055011107644049345
SIM,1825,33,25-29,1858,17
STAT,1909,28,20-24,1937,16.422980953199463
STAT,1838,38,20-24,1876,0.6180192351454467
STAT,1880,54,20-24,1934,7.147098361703152E-4
SIM,1827,41,35-39,1868,4
SIM,1901,26,na,1927,3157
SIM,1836,42,50-100,1878,1
STAT,1908,38,na,1946,3311.1951769815114
STAT,1846,32,40-44,1878,3.8011707379034387
SIM,1888,18,30-34,1906,5
STAT,1842,49,35-39,1891,0.099268668442895
STAT,1823,47,na,1870,1394.0509641226724
STAT,1828,42,50-100,1870,0.8956770281896349
SIM,1893,39,45-49,1932,2
SIM,1854,32,40-44,1886,4
SIM,1906,28,45-49,1934,2
SIM,1842,30,20-24,1872,3
SIM,1888,19,na,1907,2837
STAT,1819,52,50-100,1871,0.027467246655420652
STAT,1886,32,35-39,1918,10.105904394201604
STAT,1878,22,35-39,1900,5.745150338396277
STAT,1894,59,na,1953,2359.461609086579
SIM,1888,0,na,1888,3338
SIM,1894,32,35-39,1926,14
STAT,1784,101,na,1885,0.12681907243198795
SIM,1879,20,35-39,1899,6
SIM,1801,58,na,1859,1021
STAT,1844,29,15-19,1873,0.38022495590243205
STAT,1918,46,15-19,1964,3.7124817389622665E-4
STAT,1881,7,na,1888,2405.594084352516
STAT,1890,40,20-24,1930,0.18527443363166454
STAT,1837,45,45-49,1882,0.16312144417409108
STAT,1876,73,na,1949,1159.2522943759561
SIM,1959,4,na,1963,4882
STAT,1926,20,25-29,1946,106.64110892740428
SIM,1947,6,na,1953,4142
STAT,1830,47,15-19,1877,2.9972746224161723E-4
STAT,1906,38,45-49,1944,0.5890827858512828
STAT,1900,10,na,1910,3394.633804786595
STAT,1849,5,na,1854,2321.0
STAT,1865,37,35-39,1902,6.056303446529409
STAT,1912,36,50-100,1948,0.3889982448757398
STAT,1896,18,15-19,1914,7.38505293135126
SIM,1863,27,25-29,1890,45
STAT,1792,69,na,1861,667.0592116475566
STAT,1931,38,50-100,1969,0.5247510758173085
STAT,1858,17,40-44,1875,0.15825035487765884
STAT,1890,21,45-49,1911,0.8078141002414546
SIM,1865,16,35-39,1881,1
STAT,1864,31,na,1895,2017.4174587643035
STAT,1902,27,20-24,1929,15.640739658575713
STAT,1817,86,na,1903,102.6936029579416
SIM,1855,15,na,1870,2230
STAT,1892,26,30-34,1918,29.898744459388453
STAT,1944,11,na,1955,3994.0802157973853
STAT,1887,33,40-44,1920,4.563201914321385
STAT,1817,38,45-49,1855,6.5208283383095536
STAT,1863,27,15-19,1890,0.376127251080407
SIM,1875,44,na,1919,2204
SIM,1901,21,30-34,1922,30
SIM,1895,33,40-44,1928,9
STAT,1900,42,40-44,1942,0.2044413548838533
STAT,1871,48,15-19,1919,3.7051384364658065E-4
STAT,1890,37,20-24,1927,0.8903041147929116
STAT,1934,30,25-29,1964,11.934856084625697
SIM,1833,35,30-34,1868,5
STAT,1864,28,20-24,1892,9.842781977869334
STAT,1930,29,25-29,1959,78.98478089260244
SIM,1892,24,25-29,1916,81
STAT,1829,108,na,1937,0.0011067925302234306
STAT,1862,49,50-100,1911,0.19423373904699048
SIM,1847,44,30-34,1891,1
STAT,1840,19,35-39,1859,0.46074847626461196
SIM,1825,38,45-49,1863,1
STAT,1851,35,40-44,1886,3.249433721533328
SIM,1832,23,15-19,1855,2
STAT,1818,36,50-100,1854,4.290574862983641
STAT,1878,43,50-100,1921,1.0325852055721563
STAT,1829,27,15-19,1856,0.6520199066728414
STAT,1869,53,50-100,1922,0.013599951944980725
STAT,1924,18,45-49,1942,0.5604848696785113
SIM,1831,30,45-49,1861,1
STAT,1825,35,30-34,1860,7.269867821217322
STAT,1897,22,45-49,1919,0.8809837888119609
STAT,1828,78,na,1906,440.0311400565471
STAT,1855,27,25-29,1882,31.33307687796695
SIM,1909,31,50-100,1940,3
SIM,1828,42,40-44,1870,5
STAT,1924,23,na,1947,4058.0798727792844
STAT,1846,15,20-24,1861,16.71451778374266
STAT,1886,32,na,1918,2381.3245925423835
STAT,1806,77,na,1883,357.36875417674787
SIM,1910,27,20-24,1937,15
STAT,1846,34,20-24,1880,2.320559136616784
SIM,1855,27,30-34,1882,25
SIM,1952,15,na,1967,4066
STAT,1807,49,40-44,1856,0.6364845720791877
STAT,1849,39,35-39,1888,5.315600814121799
SIM,1932,18,45-49,1950,1
STAT,1905,23,15-19,1928,4.49087898950239
STAT,1921,19,30-34,1940,13.054799060639684
SIM,1886,43,50-100,1929,1
STAT,1927,15,15-19,1942,53.554532797667285
SIM,1883,31,20-24,1914,3
STAT,1833,25,na,1858,1774.3953685987178
SIM,1899,36,35-39,1935,8
SIM,1847,34,20-24,1881,2
STAT,1839,44,30-34,1883,0.7863386002011961
SIM,1838,31,45-49,1869,1
STAT,1939,17,35-39,1956,3.967968114821204
STAT,1914,29,40-44,1943,4.407315351767279
SIM,1947,17,35-39,1964,8
SIM,1801,91,na,1892,21
SIM,1922,29,40-44,1951,4
SIM,1808,70,na,1878,674
STAT,1875,31,20-24,1906,2.6354359251973465
SIM,1826,36,50-100,1862,1
STAT,1820,103,na,1923,0.07560481550891304
STAT,1867,20,30-34,1887,16.096291405561285
SIM,1913,23,15-19,1936,4
SIM,1915,9,na,1924,3761
SIM,1857,39,35-39,1896,13
SIM,1854,34,20-24,1888,3
STAT,1884,60,na,1944,1780.0102983019867
STAT,1834,50,35-39,1884,0.005699564754914648
STAT,1861,24,45-49,1885,0.5546601427510874
SIM,1861,38,50-100,1899,1
SIM,1810,44,35-39,1854,2
SIM,1854,15,20-24,1869,21
SIM,1935,15,15-19,1950,53
STAT,1812,55,na,1867,1161.3509628145523
STAT,1895,43,40-44,1938,0.19097910335169202
SIM,1891,31,na,1922,2808
STAT,1901,20,20-24,1921,91.66958279711876
STAT,1940,24,20-24,1964,106.93565386247653
SIM,1887,42,45-49,1929,1
STAT,1850,54,35-39,1904,0.005901841145412396
STAT,1861,25,50-100,1886,0.5134676247725879
SIM,1852,35,35-39,1887,9
SIM,1868,42,35-39,1910,1
STAT,1870,25,40-44,1895,2.7950071182112577
STAT,1899,35,25-29,1934,3.76223481672996
SIM,1883,73,na,1956,1084
STAT,1877,89,na,1966,257.33395681689217
SIM,1860,25,50-100,1885,1
STAT,1858,22,15-19,1880,2.8036014468684796
SIM,1863,17,15-19,1880,5
STAT,1863,38,15-19,1901,0.04632219936091462
SIM,1884,29,na,1913,2298
STAT,1892,24,50-100,1916,0.47949748170009515
SIM,1840,47,na,1887,1495
SIM,1859,19,15-19,1878,4
STAT,1852,25,50-100,1877,0.5480110989072455
SIM,1846,30,na,1876,1853
SIM,1902,17,20-24,1919,26
STAT,1838,53,50-100,1891,0.009976684958106533
STAT,1859,49,45-49,1908,0.1737412225640631
STAT,1908,40,25-29,1948,0.06312243215635974
STAT,1847,27,30-34,1874,22.319369106224567
STAT,1848,44,na,1892,1694.2037756138081
STAT,1862,59,na,1921,1569.772013917654
STAT,1828,52,40-44,1880,0.008231509832237072
STAT,1837,37,15-19,1874,0.044372036575861806
STAT,1861,110,na,1971,0.00347536374658041
STAT,1869,38,na,1907,2145.470868081999
SIM,1812,83,na,1895,149
STAT,1865,34,30-34,1899,14.822168168488195
SIM,1918,20,40-44,1938,3
STAT,1863,35,45-49,1898,1.6683302254922068
SIM,1865,68,na,1933,1309
SIM,1908,30,25-29,1938,8
STAT,1870,15,50-100,1885,0.04638105286815063
SIM,1895,35,20-24,1930,1
SIM,1819,62,na,1881,993
STAT,1844,35,35-39,1879,5.824058207625032
SIM,1920,21,35-39,1941,14
SIM,1921,28,35-39,1949,18
SIM,1913,18,35-39,1931,3
SIM,1873,37,35-39,1910,13
STAT,1889,46,20-24,1935,0.014034793464575741
STAT,1855,44,15-19,1899,0.009681167712974139
SIM,1892,16,na,1908,3327
STAT,1908,36,na,1944,3343.71697613341
STAT,1879,42,45-49,1921,1.4781652480818641
STAT,1835,24,35-39,1859,4.866361372943645
STAT,1913,28,35-39,1941,14.083054501763838
SIM,1843,24,35-39,1867,5
SIM,1848,49,50-100,1897,2
SIM,1860,45,na,1905,1901
SIM,1888,35,20-24,1923,4
STAT,1881,17,25-29,1898,5.1714932169906405
SIM,1811,48,50-100,1859,2
STAT,1804,68,na,1872,735.3266017911744
STAT,1865,43,20-24,1908,0.13500389393610102
STAT,1791,84,na,1875,103.35213859381702
SIM,1848,96,na,1944,6
STAT,1857,16,35-39,1873,0.4833534443974517
STAT,1865,16,na,1881,2241.714429786763
STAT,1912,21,35-39,1933,8.550793166124901
STAT,1876,24,50-100,1900,0.3955138131200012
STAT,1819,95,na,1914,7.01864728589429
STAT,1827,35,40-44,1862,4.767302436849715
SIM,1873,24,20-24,1897,61
SIM,1927,29,25-29,1956,85
STAT,1924,48,40-44,1972,0.17682190529901434
SIM,1876,25,45-49,1901,1
STAT,1844,54,40-44,1898,0.00711063495529729
STAT,1915,30,15-19,1945,0.1246349729546588
STAT,1814,47,30-34,1861,0.2960825506104292
SIM,1865,8,na,1873,2464
STAT,1860,23,25-29,1883,44.90853005665026
STAT,1885,36,35-39,1921,6.6922267920053615
SIM,1960,2,na,1962,4858
STAT,1826,97,na,1923,2.933689612265928
SIM,1843,42,30-34,1885,5
STAT,1835,39,15-19,1874,0.043277482480667435
STAT,1889,39,50-100,1928,1.4174499253305162
SIM,1780,87,na,1867,47
STAT,1842,46,30-34,1888,0.07101660039868238
STAT,1839,22,20-24,1861,58.95269363975842
SIM,1898,37,30-34,1935,1
SIM,1913,15,30-34,1928,6
STAT,1848,27,25-29,1875,37.52435756810174
STAT,1879,45,15-19,1924,3.9949239837906936E-4
STAT,1843,27,50-100,1870,0.531749272998507
STAT,1920,30,na,1950,3944.958259979647
SIM,1893,22,40-44,1915,3
STAT,1887,30,50-100,1917,0.9759646767384818
SIM,1856,27,25-29,1883,38
SIM,1919,46,50-100,1965,2
STAT,1822,34,45-49,1856,3.7897290955584637
STAT,1931,25,25-29,1956,80.34562269643546
SIM,1913,45,50-100,1958,1
SIM,1862,71,na,1933,1122
SIM,1861,44,40-44,1905,5
SIM,1903,24,45-49,1927,6
SIM,1839,38,50-100,1877,3
STAT,1845,79,na,1924,494.7070380783019
SIM,1884,49,50-100,1933,1
SIM,1946,7,na,1953,4017
STAT,1887,19,25-29,1906,5.95583086626652
SIM,1833,48,45-49,1881,3
SIM,1862,4,na,1866,2476
SIM,1838,23,15-19,1861,6
SIM,1858,23,35-39,1881,7
STAT,1888,41,na,1929,2592.055113638965
SIM,1906,25,40-44,1931,4
STAT,1905,27,30-34,1932,34.38574293687348
SIM,1840,79,na,1919,427
STAT,1865,24,20-24,1889,58.870155159869384
STAT,1894,48,45-49,1942,0.15958795614436877
STAT,1891,33,20-24,1924,3.1459521618147175
SIM,1901,36,45-49,1937,1
SIM,1866,22,15-19,1888,3
STAT,1822,84,na,1906,169.0386704840314
STAT,1859,35,45-49,1894,1.5131188395028055
STAT,1932,33,50-100,1965,1.0376632862188422
SIM,1893,36,35-39,1929,20
STAT,1833,34,20-24,1867,2.091405478876134
STAT,1907,51,na,1958,3052.7144483450666
STAT,1818,45,35-39,1863,0.30764896997509245
STAT,1843,25,40-44,1868,2.5262322509868294
SIM,1925,36,na,1961,4232
STAT,1874,24,30-34,1898,17.08520239829208
STAT,1900,26,35-39,1926,12.688358031556202
STAT,1931,17,30-34,1948,15.071333224444674
STAT,1881,38,30-34,1919,4.839682844990388
SIM,1855,24,na,1879,1944
SIM,1911,31,35-39,1942,10
STAT,1874,36,25-29,1910,2.7924443023594305
STAT,1918,14,na,1932,4061.0362005261927
SIM,1882,36,25-29,1918,2
SIM,1841,34,20-24,1875,1
STAT,1835,42,30-34,1877,0.876753136739171
STAT,1821,37,20-24,1858,1.6283381970127
STAT,1867,46,35-39,1913,0.12454352898324063
SIM,1906,37,40-44,1943,3
STAT,1908,32,30-34,1940,14.049476253243748
SIM,1899,24,35-39,1923,9
SIM,1932,27,40-44,1959,6
SIM,1935,23,45-49,1958,2
STAT,1906,24,20-24,1930,94.22339206764464
SIM,1851,31,na,1882,1860
SIM,1879,24,15-19,1903,3
SIM,1915,23,25-29,1938,97
SIM,1826,35,na,1861,1550
SIM,1839,82,na,1921,285
STAT,1855,89,na,1944,74.65383523880853
SIM,1938,4,na,1942,3585
STAT,1888,44,na,1932,2545.549228863681
STAT,1825,48,45-49,1873,0.23743068174912038
STAT,1898,51,na,1949,2765.897986564519
STAT,1927,36,15-19,1963,0.022575192215102305
STAT,1876,43,30-34,1919,1.1139760446986835
SIM,1946,4,na,1950,4047
SIM,1820,43,40-44,1863,5
STAT,1840,37,30-34,1877,4.136776961611194
STAT,1861,29,15-19,1890,0.3538304150810841
STAT,1897,35,15-19,1932,0.07161845421187252
STAT,1823,33,15-19,1856,0.3237510597383495
STAT,1824,42,20-24,1866,0.20874850619539442
STAT,1837,52,na,1889,1402.4367113919643
STAT,1836,21,25-29,1857,49.27789592752412
STAT,1904,36,20-24,1940,0.22654071482319768
SIM,1883,41,na,1924,2121
STAT,1933,34,25-29,1967,11.75157363502175
SIM,1841,35,25-29,1876,1
SIM,1916,32,30-34,1948,19
STAT,1859,34,40-44,1893,3.232818910026202
STAT,1890,24,15-19,1914,3.7864070920168533
STAT,1809,52,30-34,1861,0.016000096684518173
STAT,1839,34,20-24,1873,2.169208411035148
STAT,1924,27,40-44,1951,5.1267506544786485
STAT,1929,24,15-19,1953,6.319268783129131
SIM,1851,25,40-44,1876,5
STAT,1927,35,45-49,1962,0.8020769314115437
SIM,1841,24,na,1865,1768
SIM,1877,27,na,1904,2328
STAT,1884,51,na,1935,2019.2111654043417
SIM,1798,75,na,1873,383
SIM,1884,43,30-34,1927,1
SIM,1881,63,na,1944,1352
SIM,1857,36,30-34,1893,3
SIM,1836,42,na,1878,1553
SIM,1844,21,25-29,1865,53
STAT,1859,46,35-39,1905,0.10556353911539566
STAT,1889,28,25-29,1917,49.16058130024374
SIM,1873,34,na,1907,2281
STAT,1892,39,45-49,1931,2.335053558716588
STAT,1899,23,15-19,1922,4.25707044353814
SIM,1835,35,40-44,1870,3
STAT,1860,15,30-34,1875,1.4257767256461233
STAT,1851,64,na,1915,1250.4758856103222
STAT,1874,53,50-100,1927,0.014343469415818462
STAT,1919,29,25-29,1948,66.70480166538876
SIM,1833,37,50-100,1870,2
SIM,1796,94,na,1890,2
STAT,1868,20,25-29,1888,52.34688326875343
STAT,1812,43,40-44,1855,8.289288532378443
STAT,1856,34,na,1890,1743.8379238269786
SIM,1847,22,20-24,1869,58
STAT,1907,23,25-29,1930,79.1958458280803
STAT,1823,33,50-100,1856,2.0830019950030803
SIM,1854,1,na,1855,2890
SIM,1895,19,25-29,1914,7
SIM,1827,29,20-24,1856,9
SIM,1928,38,30-34,1966,1
SIM,1835,23,40-44,1858,1
STAT,1921,4,na,1925,4346.264715223063
STAT,1894,26,40-44,1920,3.6492431609723024
STAT,1925,47,45-49,1972,0.2487900927056735
SIM,1826,32,na,1858,1557
SIM,1851,34,na,1885,1782
STAT,1927,23,45-49,1950,1.305532992887359
SIM,1897,26,50-100,1923,3
STAT,1905,20,50-100,1925,0.5601579153014884
SIM,1913,35,25-29,1948,3
SIM,1876,93,na,1969,107
STAT,1823,46,20-24,1869,0.01499384793015051
SIM,1882,35,20-24,1917,3
SIM,1858,35,35-39,1893,8
STAT,1855,24,20-24,1879,56.3917545080794
SIM,1859,37,na,1896,1899
STAT,1823,41,50-100,1864,1.448777527278824
SIM,1863,24,20-24,1887,55
SIM,1879,49,50-100,1928,4
STAT,1929,19,40-44,1948,1.6772229089552622
SIM,1937,24,15-19,1961,3
STAT,1965,2,na,1967,4640.080294455973
SIM,1819,44,50-100,1863,1
SIM,1903,0,na,1903,3663
SIM,1916,20,30-34,1936,39
STAT,1944,20,40-44,1964,3.431943970527057
SIM,1900,30,20-24,1930,2
STAT,1874,35,20-24,1909,0.7511076365411044
STAT,1905,35,25-29,1940,0.8566448150571156
SIM,1880,27,25-29,1907,44
STAT,1894,15,45-49,1909,0.0796732135868369
SIM,1828,28,25-29,1856,35
SIM,1914,24,20-24,1938,113
STAT,1924,46,50-100,1970,0.2550046358467276
STAT,1907,44,25-29,1951,0.061047228479223066
STAT,1884,26,40-44,1910,2.805416368883643
SIM,1876,20,25-29,1896,57
STAT,1891,19,na,1910,2936.050723509413
STAT,1821,69,na,1890,781.857374383292
SIM,1871,32,40-44,1903,4
STAT,1789,72,na,1861,481.9950493094421
STAT,1922,11,na,1933,4338.44438512073
STAT,1952,15,50-100,1967,0.42436423379066107
STAT,1840,27,na,1867,1770.1122707488305
STAT,1930,26,20-24,1956,21.936419309670043
STAT,1867,29,na,1896,2101.901566739533
STAT,1896,49,30-34,1945,0.06670524006601254
STAT,1908,20,30-34,1928,25.110932984693733
SIM,1935,35,45-49,1970,3
STAT,1941,15,40-44,1956,1.361741310549504
STAT,1851,38,45-49,1889,1.4343852479965058
SIM,1868,42,na,1910,2086
SIM,1871,35,45-49,1906,2
STAT,1849,36,30-34,1885,4.132140797945264
STAT,1878,25,45-49,1903,1.100532355832993
STAT,1881,18,50-100,1899,0.04459316596896289
STAT,1925,20,30-34,1945,32.693392035654774
STAT,1836,48,20-24,1884,0.008028856502702564
SIM,1858,74,na,1932,862
SIM,1847,82,na,1929,290
SIM,1905,16,na,1921,3419
STAT,1839,30,na,1869,1812.9828776456159
SIM,1817,50,na,1867,1331
STAT,1915,37,35-39,1952,2.3083388698934035
SIM,1874,24,30-34,1898,20
STAT,1944,28,50-100,1972,1.0157903642996087
STAT,1850,32,20-24,1882,1.9932909637376899
SIM,1938,22,15-19,1960,4
SIM,1876,36,40-44,1912,3
STAT,1841,49,40-44,1890,0.11556300087622172
STAT,1893,36,35-39,1929,8.514339215138085
SIM,1816,57,na,1873,1140
SIM,1848,67,na,1915,1140
STAT,1921,15,50-100,1936,0.4053124671337659
SIM,1870,19,20-24,1889,17
STAT,1880,56,na,1936,2031.3426213606367
SIM,1849,60,na,1909,1440
STAT,1771,99,na,1870,0.24438189196324633
STAT,1805,102,na,1907,0.10234049699308474
STAT,1899,39,na,1938,3042.7117420924133
SIM,1881,24,15-19,1905,2
SIM,1885,22,na,1907,2278
STAT,1945,19,25-29,1964,44.69023997367791
SIM,1866,64,na,1930,1517
STAT,1872,19,50-100,1891,0.04617462984002951
STAT,1881,21,50-100,1902,0.3732757379721503
SIM,1826,64,na,1890,919
SIM,1892,26,40-44,1918,5
STAT,1868,36,40-44,1904,3.964618162245155
SIM,1897,28,25-29,1925,49
SIM,1932,15,40-44,1947,1
SIM,1844,29,20-24,1873,11
STAT,1904,15,20-24,1919,24.134775038108778
STAT,1934,22,30-34,1956,36.488572871857436
STAT,1836,29,20-24,1865,9.68954413063833
SIM,1876,24,40-44,1900,3
SIM,1923,37,35-39,1960,6
STAT,1893,28,50-100,1921,0.7636715535410916
SIM,1912,15,20-24,1927,27
STAT,1813,79,na,1892,287.71443192293304
STAT,1924,15,40-44,1939,1.5807911557777576
STAT,1905,48,30-34,1953,0.07362359285636648
SIM,1877,32,50-100,1909,1
SIM,1886,25,45-49,1911,1
SIM,1825,35,40-44,1860,9
SIM,1888,11,na,1899,2913
STAT,1829,42,50-100,1871,0.901182506051348
STAT,1853,79,na,1932,529.080147650652
STAT,1931,25,na,1956,4572.8600832956345
STAT,1946,24,15-19,1970,5.592325781103711
STAT,1888,76,na,1964,1337.4503746622854
SIM,1942,22,30-34,1964,32
STAT,1843,45,35-39,1888,0.09656456789398331
SIM,1866,34,25-29,1900,11
SIM,1904,41,45-49,1945,1
SIM,1869,22,40-44,1891,4
STAT,1915,16,35-39,1931,0.8317137401019736
STAT,1921,27,15-19,1948,0.7432709452009676
STAT,1941,27,35-39,1968,14.672083302327426
STAT,1821,46,50-100,1867,0.39312462677157795
SIM,1838,35,na,1873,1748
SIM,1908,56,na,1964,2951
STAT,1819,42,na,1861,1501.0278515500136
STAT,1931,41,30-34,1972,0.1615762079835132
STAT,1918,38,50-100,1956,0.4176439107163345
SIM,1917,19,na,1936,3705
SIM,1913,27,30-34,1940,52
SIM,1859,32,25-29,1891,12
SIM,1830,34,45-49,1864,1
STAT,1846,18,25-29,1864,5.248761263437809
SIM,1889,30,45-49,1919,3
STAT,1867,23,35-39,1890,5.160530843069379
SIM,1854,18,25-29,1872,6
STAT,1878,46,45-49,1924,0.23300653748703914
SIM,1899,21,30-34,1920,33
STAT,1858,12,na,1870,2065.472083553118
STAT,1862,19,20-24,1881,14.749000778676768
SIM,1907,20,20-24,1927,78
STAT,1856,34,15-19,1890,0.10406686177258061
STAT,1931,38,30-34,1969,2.2779215307640417
STAT,1884,46,35-39,1930,0.13103588236612926
SIM,1815,72,na,1887,586
STAT,1900,23,30-34,1923,23.270946542593347
STAT,1839,53,20-24,1892,4.8341699340737515E-4
STAT,1831,26,25-29,1857,37.569904413007244
SIM,1837,27,na,1864,1794
SIM,1877,56,na,1933,1949
STAT,1873,11,na,1884,2524.921034367634
STAT,1866,24,30-34,1890,15.42306274491435
SIM,1911,25,50-100,1936,4
STAT,1880,70,na,1950,1397.3705142795059
STAT,1912,25,15-19,1937,0.661694224709121
STAT,1883,47,30-34,1930,0.08923946641775685
STAT,1826,45,35-39,1871,0.13281479454476472
STAT,1835,107,na,1942,0.003001591297083363
SIM,1913,26,na,1939,3409
STAT,1861,32,30-34,1893,13.71438354035142
SIM,1871,31,50-100,1902,4
STAT,1950,17,40-44,1967,1.5624224698427311
SIM,1841,16,25-29,1857,4
SIM,1853,19,20-24,1872,14
STAT,1834,87,na,1921,109.22678591324097
SIM,1866,36,40-44,1902,10
SIM,1867,49,na,1916,2141
SIM,1784,94,na,1878,3
SIM,1860,13,na,1873,2306
SIM,1895,38,25-29,1933,2
SIM,1787,80,na,1867,191
STAT,1905,15,30-34,1920,2.186531755705489
STAT,1926,19,15-19,1945,52.2814854846322
SIM,1934,19,15-19,1953,55
SIM,1909,33,45-49,1942,1
STAT,1802,87,na,1889,59.472252756549345
STAT,1932,37,35-39,1969,3.0700710602269177
SIM,1923,16,35-39,1939,7
STAT,1853,28,45-49,1881,0.8794510373012134
SIM,1861,28,45-49,1889,1
STAT,1845,19,20-24,1864,15.669828731892478
STAT,1941,20,15-19,1961,5.200427828003732
STAT,1880,78,na,1958,888.5002453182492
STAT,1877,49,20-24,1926,0.011513692788964885
STAT,1827,54,40-44,1881,0.00813134128517836
SIM,1893,25,45-49,1918,2
SIM,1918,19,30-34,1937,19
STAT,1853,90,na,1943,59.66623592141064
STAT,1865,27,25-29,1892,36.221276046561805
STAT,1881,53,25-29,1934,0.0031805633092964218
SIM,1893,33,30-34,1926,33
SIM,1814,95,na,1909,1
STAT,1904,45,na,1949,3079.6274614241674
SIM,1922,25,25-29,1947,81
SIM,1903,21,40-44,1924,2
SIM,1912,2,na,1914,3862
STAT,1849,32,15-19,1881,0.11252680585351929
SIM,1928,22,15-19,1950,6
STAT,1850,39,40-44,1889,3.070241743149335
STAT,1808,46,50-100,1854,0.9484340389599213
STAT,1831,98,na,1929,1.8967764314952316
SIM,1826,34,45-49,1860,1
STAT,1897,58,na,1955,2498.461814427526
STAT,1922,15,30-34,1937,13.388019299815895
STAT,1827,38,45-49,1865,2.020706609103444
STAT,1927,20,40-44,1947,3.936771629406136
SIM,1930,15,30-34,1945,22
STAT,1835,45,35-39,1880,0.10589056458196057
SIM,1904,12,na,1916,3563
STAT,1757,114,na,1871,3.305080757972414E-4
STAT,1859,16,45-49,1875,0.057350450297173075
STAT,1891,30,na,1921,2811.4945678495087
STAT,1912,29,30-34,1941,36.217881881414975
STAT,1901,41,45-49,1942,0.13805251702809426
STAT,1885,33,30-34,1918,16.37145032485029
SIM,1848,45,na,1893,1633
STAT,1894,45,40-44,1939,0.11841089325403914
SIM,1920,29,30-34,1949,48
STAT,1887,38,25-29,1925,3.0273121349425485
SIM,1882,33,20-24,1915,1
STAT,1934,37,45-49,1971,0.8887199242881603
SIM,1797,90,na,1887,18
SIM,1841,23,30-34,1864,22
SIM,1905,34,20-24,1939,2
STAT,1837,24,45-49,1861,0.5839680026665445
STAT,1930,9,na,1939,4861.90952046625
SIM,1887,15,na,1902,2636
STAT,1919,44,na,1963,3789.4746765536306
SIM,1830,31,40-44,1861,7
STAT,1920,19,20-24,1939,142.92333164865332
STAT,1860,25,40-44,1885,2.354419087175401
SIM,1937,2,na,1939,3624
STAT,1943,19,15-19,1962,45.43348845182219
STAT,1875,39,45-49,1914,1.9162228325943984
STAT,1895,46,45-49,1941,0.1644204174174995
SIM,1815,40,na,1855,1525
STAT,1901,29,20-24,1930,15.402114644632086
STAT,1879,62,na,1941,1807.3943314482026
STAT,1874,33,20-24,1907,2.5980453417256575
STAT,1894,29,45-49,1923,1.3383287676445557
STAT,1850,42,50-100,1892,0.7438007705103032
SIM,1889,35,30-34,1924,10
SIM,1784,91,na,1875,13
SIM,1935,20,40-44,1955,5
STAT,1844,23,40-44,1867,1.7940174827152953
STAT,1890,40,50-100,1930,1.2324777306641608
STAT,1853,47,45-49,1900,0.17777122587883198
SIM,1875,78,na,1953,667
SIM,1927,26,20-24,1953,27
SIM,1927,40,na,1967,4369
SIM,1932,20,15-19,1952,7
SIM,1871,33,45-49,1904,2
SIM,1867,25,35-39,1892,11
STAT,1914,25,25-29,1939,63.11056515247388
SIM,1883,39,45-49,1922,1
STAT,1853,50,45-49,1903,0.011140768211446259
STAT,1885,25,45-49,1910,1.0526028779870769
SIM,1897,47,na,1944,2907
SIM,1897,22,na,1919,3076
STAT,1888,20,35-39,1908,6.553883579303881
STAT,1899,36,na,1935,3064.2609860565017
SIM,1880,17,15-19,1897,6
STAT,1808,48,45-49,1856,0.8796407500212245
STAT,1948,24,25-29,1972,100.1275279657676
SIM,1915,27,40-44,1942,5
STAT,1833,23,30-34,1856,14.59347939971476
STAT,1891,35,20-24,1926,0.9095101825137996
STAT,1804,65,na,1869,822.3569208157928
STAT,1914,55,na,1969,3334.067599386554
SIM,1917,30,na,1947,3738
STAT,1822,32,45-49,1854,5.084725739303174
SIM,1900,33,25-29,1933,18
SIM,1893,24,40-44,1917,2
STAT,1867,43,30-34,1910,1.0124783240045399
STAT,1890,28,30-34,1918,28.98185690194778
STAT,1905,39,40-44,1944,1.2771961661437359
SIM,1837,18,25-29,1855,5
SIM,1919,36,30-34,1955,2
STAT,1923,24,20-24,1947,121.45775048581257
STAT,1908,35,35-39,1943,2.1597227751760752
SIM,1875,43,30-34,1918,1
STAT,1868,18,50-100,1886,0.04469316675833302
STAT,1853,44,40-44,1897,1.679266160169071
SIM,1826,33,40-44,1859,2
STAT,1889,29,na,1918,2763.4016093468254
STAT,1870,49,na,1919,2041.5307550621872
STAT,1919,26,20-24,1945,18.696350712766108
STAT,1832,52,50-100,1884,0.009494419226284832
SIM,1831,37,30-34,1868,7
STAT,1812,46,45-49,1858,0.8033722426093228
SIM,1931,24,20-24,1955,126
STAT,1944,23,45-49,1967,1.147287755248927
STAT,1823,37,30-34,1860,8.672541575088033
STAT,1918,42,35-39,1960,0.20225797384858626
STAT,1922,31,45-49,1953,1.6864799716854466
STAT,1824,44,20-24,1868,0.19825439316753476
SIM,1845,24,45-49,1869,3
SIM,1879,28,30-34,1907,37
SIM,1854,37,25-29,1891,2
SIM,1883,34,25-29,1917,9
SIM,1897,35,30-34,1932,6
STAT,1872,17,15-19,1889,5.641942961607344
SIM,1841,32,20-24,1873,2
STAT,1824,49,40-44,1873,0.20286099698970197
STAT,1818,42,30-34,1860,2.7114988754274276
STAT,1866,41,na,1907,2022.9445921064319
STAT,1933,31,20-24,1964,3.107087607573416
STAT,1818,49,50-100,1867,0.5080930252062066
SIM,1826,49,50-100,1875,2
SIM,1896,20,35-39,1916,11
SIM,1830,32,45-49,1862,1
SIM,1869,29,25-29,1898,42
STAT,1848,24,20-24,1872,61.456414210508775
STAT,1824,45,25-29,1869,0.07224153127806353
SIM,1884,26,na,1910,2348
SIM,1866,7,na,1873,2463
SIM,1871,53,na,1924,2032
STAT,1867,26,na,1893,2124.297490983969
STAT,1875,34,25-29,1909,9.860567810514583
SIM,1847,37,25-29,1884,5
STAT,1846,37,25-29,1883,2.2300738921430225
STAT,1814,54,50-100,1868,0.04238904260497368
SIM,1817,84,na,1901,131
STAT,1891,36,25-29,1927,3.3813482962232655
STAT,1923,19,50-100,1942,0.4133708322027616
SIM,1878,16,20-24,1894,14
SIM,1846,86,na,1932,130
SIM,1858,20,30-34,1878,19
STAT,1914,31,50-100,1945,0.7894558967787436
SIM,1826,42,30-34,1868,3
STAT,1869,23,45-49,1892,0.6362093660267691
STAT,1885,24,40-44,1909,1.9499214488594474
STAT,1876,46,35-39,1922,0.1370286202877209
SIM,1938,27,35-39,1965,18
STAT,1875,26,na,1901,2325.3016134862305
SIM,1848,34,30-34,1882,8
STAT,1890,1,na,1891,3143.6627442126246
SIM,1913,39,40-44,1952,4
SIM,1947,14,na,1961,4116
SIM,1856,24,20-24,1880,55
STAT,1806,91,na,1897,20.095344254672593
SIM,1916,35,35-39,1951,4
SIM,1922,31,50-100,1953,1
STAT,1907,27,40-44,1934,4.157026925886977
STAT,1847,31,45-49,1878,1.525578014430538
STAT,1834,35,40-44,1869,3.4500863280061345
STAT,1893,5,na,1898,3139.5974200493297
STAT,1839,37,25-29,1876,2.2907964334519844
STAT,1833,32,20-24,1865,2.1353037181576173
SIM,1888,23,20-24,1911,78
STAT,1889,35,30-34,1924,6.274676753154732
STAT,1932,21,50-100,1953,0.8180544629699057
STAT,1934,25,35-39,1959,19.096470695374723
SIM,1853,97,na,1950,1
STAT,1775,91,na,1866,16.040155332134724
STAT,1878,44,45-49,1922,1.4535839658520981
STAT,1915,34,30-34,1949,15.029083985988853
SIM,1902,29,20-24,1931,20
STAT,1917,30,25-29,1947,9.216810191433067
SIM,1860,16,na,1876,2237
SIM,1909,30,40-44,1939,3
STAT,1941,18,45-49,1959,0.4859227949350763
SIM,1876,39,45-49,1915,4
STAT,1916,33,na,1949,3673.17647194643
SIM,1845,42,40-44,1887,3
STAT,1841,23,15-19,1864,2.8605078672430246
STAT,1843,16,na,1859,1993.1064428868106
STAT,1854,45,45-49,1899,0.17053787206768214
STAT,1880,8,na,1888,2620.8863925903224
SIM,1930,31,45-49,1961,1
STAT,1840,46,20-24,1886,0.008043799539046844
STAT,1855,71,na,1926,948.5449266050198
STAT,1872,42,50-100,1914,0.9998373007600108
STAT,1945,16,20-24,1961,139.94767631753896
STAT,1836,68,na,1904,989.6096425875425
SIM,1866,47,50-100,1913,4
STAT,1931,29,40-44,1960,5.679078573993786
SIM,1945,26,30-34,1971,53
STAT,1905,41,na,1946,3181.213690141173
SIM,1904,28,35-39,1932,18
STAT,1904,18,25-29,1922,7.658618356366312
STAT,1906,26,na,1932,3294.894952428419
SIM,1918,15,15-19,1933,10
STAT,1868,39,45-49,1907,1.7787293938757347
STAT,1838,44,15-19,1882,0.00961728818438141
STAT,1875,17,40-44,1892,0.17760155326486882
STAT,1919,22,na,1941,3777.6202915766394
STAT,1844,24,45-49,1868,0.5960358929807652
SIM,1870,23,na,1893,2174
STAT,1829,34,20-24,1863,2.5546499435889154
STAT,1849,36,50-100,1885,0.9518964107701643
STAT,1869,52,na,1921,1960.0660720736084
STAT,1891,44,50-100,1935,1.2180941863782613
STAT,1850,100,na,1950,0.7483784138183509
STAT,1853,23,na,1876,1898.157636700817
SIM,1897,25,20-24,1922,15
SIM,1883,26,30-34,1909,27
STAT,1872,27,25-29,1899,40.083864350551394
SIM,1842,33,25-29,1875,16
STAT,1854,53,na,1907,1515.8239052704255
SIM,1903,67,na,1970,2436
STAT,1846,75,na,1921,763.5559416806617
STAT,1861,35,35-39,1896,5.6084519293124275
SIM,1923,34,30-34,1957,25
SIM,1953,16,20-24,1969,127
STAT,1859,22,30-34,1881,13.89557414509779
STAT,1868,22,na,1890,2131.7179116647303
STAT,1939,22,25-29,1961,87.63520719099331
STAT,1925,23,35-39,1948,10.614251812456892
STAT,1908,47,45-49,1955,0.18568871152368635
SIM,1867,43,30-34,1910,6
SIM,1886,44,45-49,1930,4
STAT,1849,44,25-29,1893,0.4750332205829438
STAT,1869,32,35-39,1901,9.26818396878937
SIM,1885,22,25-29,1907,54
STAT,1866,63,na,1929,1554.7023303591673
SIM,1912,18,25-29,1930,12
STAT,1950,14,na,1964,4386.2792918292525
STAT,1826,46,na,1872,1413.0674978312115
STAT,1907,41,20-24,1948,0.015373529164616394
SIM,1877,32,35-39,1909,15
STAT,1876,37,50-100,1913,1.1982828290666931
STAT,1850,35,25-29,1885,2.105018532306568
STAT,1877,81,na,1958,631.8805172844974
SIM,1924,27,50-100,1951,1
SIM,1834,61,na,1895,1136
SIM,1895,66,na,1961,2181
SIM,1838,27,30-34,1865,22
SIM,1947,22,25-29,1969,103
STAT,1923,22,50-100,1945,0.7232552219328044
SIM,1896,29,na,1925,2944
STAT,1937,26,30-34,1963,36.09884915764938
STAT,1864,34,15-19,1898,0.11887667931531405
STAT,1866,34,50-100,1900,0.7915091787438469
STAT,1840,72,na,1912,828.7844513508086
STAT,1916,27,50-100,1943,0.9722389151202119
STAT,1935,29,50-100,1964,1.2804785011235542
STAT,1897,18,30-34,1915,2.008390767368586
STAT,1786,83,na,1869,120.89057422998631
SIM,1925,30,25-29,1955,13
SIM,1824,54,na,1878,1232
STAT,1875,26,30-34,1901,24.535906932462442
SIM,1914,41,na,1955,3479
SIM,1835,21,40-44,1856,1
STAT,1834,33,25-29,1867,8.058144213057384
STAT,1863,31,50-100,1894,0.7626875457520417
STAT,1875,22,15-19,1897,3.203400736651278
STAT,1809,49,15-19,1858,0.0010898744770160766
SIM,1893,15,35-39,1908,4
STAT,1807,54,na,1861,1174.985287946856
SIM,1933,23,35-39,1956,12
STAT,1929,33,20-24,1962,2.9250049414715145
STAT,1859,43,30-34,1902,0.8581802365173554
STAT,1889,25,20-24,1914,13.774684371078049
STAT,1817,61,na,1878,1021.8580102247802
STAT,1911,17,20-24,1928,25.63042288956501
STAT,1941,24,30-34,1965,28.040005795462292
STAT,1857,104,na,1961,0.14858780903418975
STAT,1868,19,15-19,1887,5.3819458836770755
SIM,1837,34,20-24,1871,1
SIM,1842,25,30-34,1867,28
SIM,1864,38,na,1902,2047
STAT,1811,101,na,1912,0.24747528077918746
STAT,1818,46,na,1864,1394.4997521681998
STAT,1849,46,40-44,1895,0.12874188921838528
SIM,1835,46,na,1881,1486
SIM,1861,25,40-44,1886,3
STAT,1903,31,35-39,1934,13.667947118595233
SIM,1845,43,45-49,1888,2
STAT,1874,27,35-39,1901,9.313371535537252
STAT,1904,20,50-100,1924,0.555876004294975
SIM,1926,23,35-39,1949,11
STAT,1831,76,na,1907,553.1753547565854
STAT,1896,25,20-24,1921,14.73646427977117
STAT,1853,25,40-44,1878,2.6643774679618275
STAT,1853,45,na,1898,1719.6456854269397
SIM,1948,21,20-24,1969,103
SIM,1882,27,35-39,1909,10
STAT,1882,15,25-29,1897,5.230298834146291
STAT,1907,9,na,1916,3600.6441511705643
STAT,1918,23,35-39,1941,9.564124156916932
STAT,1834,25,30-34,1859,20.789904136744653
SIM,1856,34,30-34,1890,23
STAT,1885,15,35-39,1900,0.5190890465300542
STAT,1946,21,na,1967,3840.3109526952403
STAT,1866,20,15-19,1886,2.940048165286833
STAT,1850,34,20-24,1884,1.9523222743129889
STAT,1921,48,50-100,1969,0.24020383740611834
SIM,1837,72,na,1909,768
SIM,1942,25,35-39,1967,12
SIM,1864,17,30-34,1881,4
STAT,1902,39,15-19,1941,0.0159967529826177
SIM,1937,33,20-24,1970,1
STAT,1934,17,50-100,1951,0.47873148314029834
SIM,1902,9,na,1911,3471
STAT,1842,53,na,1895,1534.2499025015088
STAT,1847,107,na,1954,0.0034775784561264828
STAT,1848,34,30-34,1882,13.484874900666506
SIM,1829,41,45-49,1870,1
SIM,1890,24,15-19,1914,2
SIM,1833,23,30-34,1856,18
STAT,1767,91,na,1858,14.926761368879621
STAT,1878,66,na,1944,1613.6392512281407
SIM,1839,31,na,1870,1818
SIM,1872,89,na,1961,150
STAT,1846,27,15-19,1873,0.4070974225025739
STAT,1826,42,30-34,1868,1.12329012264158
STAT,1839,64,na,1903,1157.3959732383312
STAT,1882,24,15-19,1906,3.0118903239576955
SIM,1816,46,50-100,1862,1
STAT,1787,68,na,1855,670.5264000000001
STAT,1858,47,50-100,1905,0.18106328949360212
SIM,1872,38,30-34,1910,8
STAT,1864,38,30-34,1902,4.4650968300455895
SIM,1880,42,50-100,1922,4
STAT,1931,34,15-19,1965,0.15886276277271216
STAT,1852,38,50-100,1890,0.8856817534589193
STAT,1893,33,30-34,1926,20.828953626628135
SIM,1926,44,na,1970,4262
SIM,1907,23,25-29,1930,83
SIM,1876,19,15-19,1895,4
STAT,1878,43,40-44,1921,2.1984616463050783
SIM,1860,38,50-100,1898,1
STAT,1888,73,na,1961,1508.7994537294508
SIM,1897,5,na,1902,3406
STAT,1854,48,15-19,1902,2.8259773381185594E-4
STAT,1931,22,na,1953,4474.279990300978
SIM,1886,43,40-44,1929,6
SIM,1918,32,40-44,1950,6
STAT,1845,25,na,1870,1890.2948717080417
STAT,1892,27,na,1919,2823.8543704815584
SIM,1868,33,45-49,1901,2
STAT,1796,82,na,1878,166.5398534287806
SIM,1809,94,na,1903,6
SIM,1866,39,50-100,1905,1
SIM,1825,31,25-29,1856,11
STAT,1870,44,45-49,1914,1.36830589924342
SIM,1872,47,na,1919,2113
STAT,1826,40,35-39,1866,1.8419523437946546
STAT,1889,31,15-19,1920,0.16676236506763523
STAT,1898,37,25-29,1935,3.6808221242252483
STAT,1896,17,na,1913,3151.1619970076026
SIM,1874,44,25-29,1918,4
STAT,1884,22,25-29,1906,53.428515239534285
SIM,1909,21,35-39,1930,9
STAT,1805,50,45-49,1855,0.055448229965670455
SIM,1832,27,30-34,1859,27
SIM,1832,29,25-29,1861,40
SIM,1898,40,na,1938,2939
STAT,1828,109,na,1937,4.00680080273672E-4
STAT,1876,19,45-49,1895,0.06341317288289373
SIM,1853,19,15-19,1872,7
STAT,1866,44,25-29,1910,0.5519725750494211
STAT,1850,35,30-34,1885,3.896523687573926
STAT,1877,45,40-44,1922,0.16943735521427722
STAT,1887,34,15-19,1921,0.14919160374673995
SIM,1866,36,45-49,1902,2
STAT,1813,45,50-100,1858,0.693858391276204
STAT,1830,37,50-100,1867,0.9977466366332992
STAT,1871,25,20-24,1896,11.079610684314055
STAT,1833,38,35-39,1871,5.3695518809704526
STAT,1850,9,na,1859,2098.6599935328627
STAT,1871,27,15-19,1898,0.42560578492712287
STAT,1845,19,15-19,1864,5.245408777203763
STAT,1859,19,50-100,1878,0.042257268708227845
STAT,1881,63,na,1944,1628.3676548508768
SIM,1858,12,na,1870,2274
SIM,1841,38,35-39,1879,17
STAT,1854,28,25-29,1882,31.500857759368074
SIM,1869,29,20-24,1898,11
SIM,1948,15,35-39,1963,3
STAT,1809,74,na,1883,473.5245584032244
STAT,1820,41,na,1861,1451.8324719577374
STAT,1864,47,25-29,1911,0.048271476072388964
STAT,1854,61,na,1915,1336.9807656905514
STAT,1815,52,25-29,1867,0.007653967783118647
STAT,1820,52,35-39,1872,0.01387710990522369
STAT,1872,27,na,1899,2261.4151450862364
STAT,1872,41,45-49,1913,1.4245991331687178
STAT,1822,76,na,1898,481.4114032547069
STAT,1837,43,45-49,1880,1.131582758476511
STAT,1908,17,40-44,1925,0.2563189281027181
STAT,1893,31,35-39,1924,12.182086247605106
STAT,1879,28,30-34,1907,24.814051652382858
SIM,1957,13,na,1970,4912
STAT,1778,110,na,1888,0.0018343246537447216
STAT,1910,37,20-24,1947,0.23817893306998864
SIM,1799,99,na,1898,2
STAT,1801,104,na,1905,0.02357875538415528
SIM,1841,36,40-44,1877,7
STAT,1816,39,45-49,1855,6.547519600550182
STAT,1788,87,na,1875,51.3976540415362
STAT,1792,92,na,1884,11.250866806345362
STAT,1905,19,na,1924,3430.2063366958955
SIM,1928,18,15-19,1946,46
SIM,1862,28,25-29,1890,37
SIM,1885,32,35-39,1917,13
SIM,1894,38,45-49,1932,3
STAT,1816,50,20-24,1866,0.0017368481683332107
STAT,1877,58,na,1935,1937.9162967514656
STAT,1841,43,50-100,1884,0.7471921676385193
STAT,1886,38,45-49,1924,1.9794540639168685
SIM,1864,25,25-29,1889,43
STAT,1849,46,45-49,1895,0.17747129604701517
STAT,1841,44,20-24,1885,0.1108931358454414
STAT,1765,90,na,1855,19.4232
STAT,1886,3,na,1889,2782.6909403913332
STAT,1915,49,na,1964,3476.7700712159713
SIM,1844,44,40-44,1888,5
STAT,1845,37,15-19,1882,0.04175086868049803
STAT,1856,25,25-29,1881,32.77803944033863
STAT,1873,22,20-24,1895,66.02605764311156
SIM,1816,44,35-39,1860,5
SIM,1892,22,25-29,1914,70
STAT,1948,21,20-24,1969,120.65573584118656
STAT,1888,10,na,1898,2891.9648454842127
SIM,1887,28,30-34,1915,37
STAT,1833,36,40-44,1869,3.393018930726892
STAT,1883,41,20-24,1924,0.14776032197714958
SIM,1857,43,40-44,1900,8
STAT,1891,18,30-34,1909,1.8580039427604773
STAT,1877,32,35-39,1909,9.923862891796649
SIM,1821,43,na,1864,1417
STAT,1845,35,20-24,1880,0.643024496089999
STAT,1831,40,45-49,1871,1.1351034866763217
SIM,1837,18,20-24,1855,9
STAT,1863,15,15-19,1878,5.680728051919193
STAT,1846,66,na,1912,1215.6600644754221
SIM,1880,41,45-49,1921,3
SIM,1874,26,25-29,1900,38
SIM,1859,42,35-39,1901,2
STAT,1882,43,25-29,1925,0.5856977966547232
SIM,1843,33,40-44,1876,3
SIM,1888,39,30-34,1927,3
SIM,1855,55,na,1910,1644
STAT,1906,19,50-100,1925,0.06704661654992136
STAT,1913,14,na,1927,3802.364283886732
SIM,1851,21,25-29,1872,49
STAT,1890,32,50-100,1922,1.0582322935208244
SIM,1889,38,35-39,1927,17
SIM,1891,23,20-24,1914,81
SIM,1888,42,na,1930,2605
STAT,1882,27,20-24,1909,10.777864539668897
STAT,1821,33,40-44,1854,13.5965084763847
STAT,1847,32,20-24,1879,2.3403354479582057
STAT,1931,35,50-100,1966,0.52619152894461
SIM,1818,41,35-39,1859,2
STAT,1871,42,40-44,1913,2.107385624911157
STAT,1850,71,na,1921,940.9321663865798
SIM,1848,37,35-39,1885,6
STAT,1876,21,50-100,1897,0.39920700917035723
STAT,1814,53,20-24,1867,0.0021130777804623502
SIM,1824,39,45-49,1863,2
SIM,1885,14,na,1899,2474
SIM,1913,20,50-100,1933,1
STAT,1841,42,25-29,1883,0.46003183948118404
STAT,1881,44,20-24,1925,0.1429774709624634
SIM,1939,22,30-34,1961,33
STAT,1843,21,25-29,1864,48.885190158677844
STAT,1850,17,30-34,1867,1.3729673266869031
STAT,1895,29,25-29,1924,51.72601806933735
SIM,1917,33,35-39,1950,11
STAT,1827,39,20-24,1866,0.7633732638804036
STAT,1867,41,35-39,1908,1.613601443114078
STAT,1892,34,25-29,1926,12.015801902190326
SIM,1892,26,45-49,1918,1
STAT,1887,49,15-19,1936,2.334448872474758E-4
SIM,1836,38,25-29,1874,5
STAT,1858,43,na,1901,1699.5261431646575
STAT,1920,29,30-34,1949,40.31458845720618
STAT,1835,33,40-44,1868,3.4777428589107418
SIM,1838,17,25-29,1855,4
STAT,1857,36,25-29,1893,2.1555023617222067
STAT,1927,42,na,1969,4400.124748093309
STAT,1871,33,na,1904,2229.0856895464026
SIM,1872,29,25-29,1901,46
STAT,1820,50,40-44,1870,0.017659726909537328
STAT,1803,53,45-49,1856,0.04144503060754962
STAT,1825,43,25-29,1868,0.683465440787171
SIM,1874,42,30-34,1916,1
SIM,1890,27,20-24,1917,16
STAT,1867,26,40-44,1893,2.666418148518007
STAT,1863,33,45-49,1896,1.4395580721839116
SIM,1853,37,45-49,1890,1
STAT,1824,31,na,1855,1583.7493665809
STAT,1866,42,30-34,1908,1.0004971469633583
SIM,1831,65,na,1896,1012
SIM,1869,83,na,1952,348
STAT,1935,5,na,1940,5192.616205690275
SIM,1894,50,na,1944,2773
STAT,1828,38,25-29,1866,2.5702313618099164
STAT,1841,35,na,1876,1776.2160332690642
STAT,1877,34,50-100,1911,0.8901736403602791
STAT,1884,26,45-49,1910,1.0398251069777629
SIM,1926,21,na,1947,4106
STAT,1802,54,40-44,1856,0.02960668085505926
STAT,1851,16,35-39,1867,0.4827385095042635
STAT,1852,48,45-49,1900,0.16894692036106276
STAT,1910,39,15-19,1949,0.017176157449487677
SIM,1836,96,na,1932,4
SIM,1842,32,40-44,1874,3
SIM,1861,63,na,1924,1528
STAT,1840,46,25-29,1886,0.038610235986364594
STAT,1856,53,25-29,1909,0.002568820846400255
STAT,1876,34,40-44,1910,4.19641780289969
SIM,1783,84,na,1867,73
SIM,1916,8,na,1924,3910
STAT,1882,45,20-24,1927,0.011134495160980857
SIM,1810,71,na,1881,593
SIM,1921,34,50-100,1955,3
STAT,1864,17,30-34,1881,1.38826209782381
STAT,1829,94,na,1923,12.076298805595556
STAT,1906,30,50-100,1936,0.7296929179012772
SIM,1883,17,35-39,1900,1
STAT,1949,22,50-100,1971,0.7253604595896022
STAT,1823,46,25-29,1869,0.07197046670750004
STAT,1842,40,20-24,1882,0.12207822167040411
STAT,1819,45,20-24,1864,0.023440104605517105
SIM,1821,44,45-49,1865,1
SIM,1772,92,na,1864,7
SIM,1872,17,30-34,1889,2
SIM,1838,35,25-29,1873,2
STAT,1824,100,na,1924,0.5853771282515581
STAT,1834,41,na,1875,1591.607972547659
STAT,1901,49,na,1950,2913.4832280888986
STAT,1815,54,20-24,1869,0.0015321930039536363
SIM,1934,30,30-34,1964,34
STAT,1888,40,50-100,1928,1.1913751415449922
STAT,1856,96,na,1952,6.329034630799615
STAT,1880,48,20-24,1928,0.011801051315139019
STAT,1886,23,45-49,1909,0.6937142216224236
STAT,1886,38,15-19,1924,0.05575927603724975
STAT,1897,26,25-29,1923,53.62627166063277
SIM,1842,35,45-49,1877,1
STAT,1917,22,30-34,1939,28.857524144893315
SIM,1833,26,35-39,1859,10
SIM,1882,36,30-34,1918,4
STAT,1834,35,45-49,1869,1.5711471868361186
SIM,1925,22,30-34,1947,40
SIM,1842,34,35-39,1876,9
SIM,1817,43,40-44,1860,6
STAT,1840,45,15-19,1885,2.715836756393194E-4
STAT,1854,20,50-100,1874,0.34779344784638233
STAT,1870,29,20-24,1899,10.794548840587945
STAT,1804,51,40-44,1855,0.03795883547536604
STAT,1830,44,45-49,1874,1.1322490813455923
STAT,1947,22,15-19,1969,5.683633967972946
SIM,1836,88,na,1924,80
STAT,1819,47,15-19,1866,7.579740096787705E-4
STAT,1862,34,40-44,1896,3.472856323387397
STAT,1851,34,35-39,1885,7.426366862562904
STAT,1899,33,25-29,1932,13.202105564690026
STAT,1865,46,30-34,1911,0.08312189664303947
STAT,1900,48,15-19,1948,2.919778189903942E-4
STAT,1886,36,20-24,1922,0.7729404989717855
SIM,1876,22,40-44,1898,6
STAT,1813,44,45-49,1857,4.313318005699485
STAT,1831,37,15-19,1868,0.04305169828844002
STAT,1855,107,na,1962,0.014159745091029248
STAT,1892,17,35-39,1909,0.6492602654338709
STAT,1848,47,40-44,1895,0.1266184670622047
SIM,1880,22,na,1902,2409
SIM,1882,57,na,1939,1891
STAT,1834,34,35-39,1868,7.884945315518327
SIM,1827,32,45-49,1859,1
STAT,1899,35,50-100,1934,1.6042862945741931
STAT,1825,42,40-44,1867,2.4490973449782403
SIM,1768,87,na,1855,46
SIM,1873,28,30-34,1901,30
STAT,1868,22,40-44,1890,1.878224664421166
STAT,1902,42,na,1944,3088.252503882544
STAT,1890,37,25-29,1927,3.3253743197122763
STAT,1917,25,50-100,1942,0.9928114379047819
STAT,1949,20,25-29,1969,101.89638708236495
STAT,1926,30,30-34,1956,18.016954860434836
STAT,1865,45,20-24,1910,0.010377633828631156
SIM,1892,55,na,1947,2731
SIM,1910,28,50-100,1938,4
STAT,1881,28,15-19,1909,0.4125944244583214
SIM,1884,34,40-44,1918,4
STAT,1878,12,na,1890,2542.5334326301136
SIM,1892,38,50-100,1930,4
STAT,1850,19,25-29,1869,4.82401604547701
SIM,1900,16,na,1916,3363
STAT,1819,47,45-49,1866,0.4472050421153783
STAT,1909,16,45-49,1925,0.09277495341743429
STAT,1874,20,15-19,1894,3.20329451417095
STAT,1871,40,45-49,1911,1.4181231236561451
STAT,1880,35,45-49,1915,2.0042383286475487
STAT,1894,31,50-100,1925,1.1169132599613563
STAT,1880,18,25-29,1898,5.628905938081853
STAT,1833,48,na,1881,1452.4465237549705
STAT,1889,44,20-24,1933,0.18271639617004037
SIM,1816,88,na,1904,56
STAT,1869,38,15-19,1907,0.05113715785558517
STAT,1925,47,na,1972,4205.429679735281
SIM,1833,44,35-39,1877,3
SIM,1851,25,45-49,1876,4
STAT,1838,27,30-34,1865,21.50559775593683
SIM,1816,42,40-44,1858,3
SIM,1894,36,20-24,1930,1
STAT,1892,35,35-39,1927,8.448518296921907
STAT,1824,45,30-34,1869,0.12140590790128264
SIM,1831,28,25-29,1859,39
STAT,1875,35,35-39,1910,6.9331359024807035
SIM,1902,39,30-34,1941,1
SIM,1785,79,na,1864,258
SIM,1902,22,35-39,1924,14
STAT,1881,46,15-19,1927,3.6607871579183774E-4
STAT,1800,106,na,1906,0.0048267228458627855
STAT,1861,53,35-39,1914,0.006653729242708518
STAT,1895,55,na,1950,2546.5933379104413
SIM,1898,36,50-100,1934,1
STAT,1802,56,na,1858,1060.533565535251
STAT,1839,51,50-100,1890,0.010103495240979296
STAT,1875,33,40-44,1908,4.193244866606456
STAT,1851,33,na,1884,1768.191936276278
SIM,1873,43,25-29,1916,4
STAT,1828,37,15-19,1865,0.05126641283335894
STAT,1865,43,25-29,1908,0.5458853032887167
STAT,1891,36,30-34,1927,6.259091561409993
SIM,1862,57,na,1919,1725
SIM,1883,35,35-39,1918,15
STAT,1865,15,50-100,1880,0.048068760740050696
STAT,1929,29,na,1958,4424.571968363855
STAT,1928,31,50-100,1959,0.977182618554167
STAT,1963,9,na,1972,4715.066783770574
STAT,1895,28,15-19,1923,0.5568125541207684
STAT,1860,111,na,1971,0.0011594265456839141
SIM,1861,29,20-24,1890,9
SIM,1863,41,45-49,1904,1
SIM,1883,33,40-44,1916,5
STAT,1890,19,25-29,1909,6.509778812488014
STAT,1918,20,25-29,1938,94.67567519206776
STAT,1861,51,40-44,1912,0.008308898945965655
STAT,1798,77,na,1875,348.04814378199217
SIM,1882,18,30-34,1900,5
STAT,1809,66,na,1875,803.1033339954075
STAT,1871,73,na,1944,1114.197867628103
SIM,1916,26,50-100,1942,1
STAT,1848,30,15-19,1878,0.1259911658344143
STAT,1830,24,20-24,1854,152.5123686314325
STAT,1933,34,na,1967,4808.704245538838
STAT,1861,26,45-49,1887,0.8848180237846195
STAT,1853,29,20-24,1882,9.22555205191927
STAT,1847,20,na,1867,1960.9022732681278
STAT,1865,30,15-19,1895,0.1229190368841619
SIM,1920,36,na,1956,3961
SIM,1880,23,15-19,1903,3
STAT,1805,84,na,1889,118.24278447825222
STAT,1869,36,20-24,1905,0.7088682479035376
STAT,1874,36,30-34,1910,5.16899267316746
SIM,1926,20,25-29,1946,113
SIM,1846,27,30-34,1873,23
SIM,1851,65,na,1916,1249
SIM,1871,47,50-100,1918,2
STAT,1952,20,30-34,1972,32.667373578837676
STAT,1848,43,20-24,1891,0.11715483941864181
STAT,1873,40,50-100,1913,1.0224153232927673
SIM,1932,29,50-100,1961,2
STAT,1830,26,45-49,1856,1.2083527899794642
SIM,1837,50,na,1887,1454
STAT,1841,29,25-29,1870,35.70370088484263
SIM,1863,98,na,1961,2
SIM,1779,79,na,1858,233
STAT,1855,54,20-24,1909,5.099649548828814E-4
SIM,1867,34,40-44,1901,6
STAT,1824,51,50-100,1875,0.018079850047221926
STAT,1872,38,15-19,1910,0.052946860113184495
SIM,1879,36,25-29,1915,1
STAT,1889,48,40-44,1937,0.11121130981957748
SIM,1857,44,25-29,1901,4
SIM,1837,19,30-34,1856,2
STAT,1938,26,na,1964,3507.707741476574
STAT,1825,44,35-39,1869,1.8842651653411377
STAT,1876,96,na,1972,50.437037914961245
STAT,1860,25,45-49,1885,0.8726633616124706
STAT,1848,49,35-39,1897,0.10185609579020859
STAT,1873,68,na,1941,1464.1881839743412
SIM,1933,17,40-44,1950,2
STAT,1856,22,20-24,1878,58.99232815770804
STAT,1893,30,25-29,1923,12.369558681428476
STAT,1912,40,na,1952,3422.3396929747673
STAT,1862,52,40-44,1914,0.008458109779247488
STAT,1885,25,na,1910,2262.5003751413055
SIM,1810,63,na,1873,899
STAT,1957,15,35-39,1972,5.228317673789428
STAT,1889,83,na,1972,898.1911217477352
STAT,1851,15,25-29,1866,5.014962700862185
SIM,1862,25,20-24,1887,10
STAT,1858,32,25-29,1890,7.58650726797406
STAT,1883,42,30-34,1925,1.0635270956607887
STAT,1898,34,20-24,1932,3.4260574588607553
SIM,1814,53,na,1867,1137
STAT,1871,28,25-29,1899,39.54211124901749
STAT,1847,17,25-29,1864,5.2154124423127515
SIM,1859,40,40-44,1899,3
STAT,1907,20,20-24,1927,96.20236854781459
STAT,1901,57,na,1958,2718.3635406666394
STAT,1859,19,45-49,1878,0.056343024944303786
SIM,1850,91,na,1941,45
STAT,1812,86,na,1898,96.38023349480927
STAT,1820,53,45-49,1873,0.022931285060079354
STAT,1876,16,40-44,1892,0.17895269675168757
SIM,1891,42,30-34,1933,5
SIM,1889,37,25-29,1926,2
STAT,1844,54,45-49,1898,0.00980204352208315
STAT,1850,36,40-44,1886,3.1673886429420315
STAT,1861,35,na,1896,1868.1650512012259
STAT,1789,80,na,1869,225.8039836392941
STAT,1872,40,35-39,1912,1.7331998634276484
STAT,1841,27,30-34,1868,21.562828870814354
SIM,1816,96,na,1912,7
STAT,1853,107,na,1960,0.01048905014202841
SIM,1861,44,45-49,1905,4
STAT,1855,30,50-100,1885,0.6768748210353016
STAT,1914,2,na,1916,3983.697373694014
SIM,1863,27,30-34,1890,26
STAT,1833,39,45-49,1872,1.4977599339177368
SIM,1918,17,45-49,1935,3
STAT,1816,51,30-34,1867,0.013733132277590054
STAT,1860,22,40-44,1882,1.6465464940768142
SIM,1854,33,45-49,1887,2
SIM,1943,20,25-29,1963,86
SIM,1866,32,25-29,1898,18
SIM,1833,29,45-49,1862,3
SIM,1840,61,na,1901,1217
STAT,1799,79,na,1878,275.65135023362626
STAT,1875,36,45-49,1911,1.9450214937708576
SIM,1929,17,20-24,1946,155
STAT,1849,86,na,1935,166.37785075411853
SIM,1880,40,35-39,1920,5
STAT,1825,110,na,1935,1.4686973438543936E-4
STAT,1909,15,35-39,1924,0.7810123600388776
SIM,1835,41,35-39,1876,4
STAT,1861,63,na,1924,1401.5480458555598
STAT,1874,19,40-44,1893,0.17559555191988127
STAT,1822,47,20-24,1869,0.016137491484582833
STAT,1835,36,45-49,1871,1.5849628007473369
SIM,1915,20,20-24,1935,112
SIM,1841,35,30-34,1876,6
SIM,1890,15,25-29,1905,6
STAT,1848,46,25-29,1894,0.04292165942138462
SIM,1829,63,na,1892,1028
SIM,1883,36,45-49,1919,5
STAT,1833,35,30-34,1868,4.1741006112875185
STAT,1823,49,30-34,1872,0.1158622315624439
STAT,1832,86,na,1918,133.6585266941689
STAT,1782,90,na,1872,25.24015101579627
STAT,1844,39,20-24,1883,0.5541140185916401
STAT,1855,27,30-34,1882,18.652479854542893
STAT,1901,49,15-19,1950,2.9213450210592974E-4
STAT,1846,51,45-49,1897,0.010815413976717715
STAT,1854,25,20-24,1879,9.809937170483895
SIM,1845,45,na,1890,1583
STAT,1867,29,45-49,1896,0.9778860868729786
STAT,1873,29,50-100,1902,0.6085180339744508
SIM,1820,43,45-49,1863,2
STAT,1839,33,na,1872,1757.3769240368044
STAT,1853,48,na,1901,1681.2766707601925
STAT,1885,48,50-100,1933,0.2283617743507373
STAT,1938,32,15-19,1970,0.12206761572199674
SIM,1819,53,na,1872,1249
STAT,1893,49,45-49,1942,0.15615587683443977
STAT,1935,20,25-29,1955,118.90887279525886
STAT,1862,35,20-24,1897,0.628542115964779
STAT,1857,52,30-34,1909,0.004411402583329101
STAT,1872,30,50-100,1902,0.8751922709038762
STAT,1845,22,45-49,1867,0.6125799472732071
SIM,1872,41,50-100,1913,1
SIM,1883,32,30-34,1915,17
SIM,1870,34,40-44,1904,4
STAT,1815,39,25-29,1854,8.827220193499924
SIM,1908,36,na,1944,3309
SIM,1891,27,40-44,1918,5
STAT,1842,22,20-24,1864,62.94516969071494
SIM,1843,36,45-49,1879,1
STAT,1826,109,na,1935,3.885160066481329E-4
STAT,1948,22,30-34,1970,31.17642078523383
STAT,1882,25,na,1907,2207.4104469338417
SIM,1816,41,30-34,1857,2
SIM,1855,17,25-29,1872,7
STAT,1895,26,20-24,1921,14.498023390436105
SIM,1850,22,20-24,1872,54
STAT,1838,24,20-24,1862,59.16596255816934
STAT,1861,50,30-34,1911,0.004742842168420291
SIM,1874,50,na,1924,2041
SIM,1834,21,25-29,1855,53
STAT,1795,89,na,1884,39.79588577584994
STAT,1868,53,na,1921,1909.5800465126074
STAT,1818,49,20-24,1867,0.024825393093954692
SIM,1846,39,25-29,1885,4
STAT,1846,33,45-49,1879,1.5126865693963116
SIM,1841,17,30-34,1858,2
SIM,1833,25,25-29,1858,44
STAT,1865,25,na,1890,2057.3629065870023
STAT,1812,43,45-49,1855,5.515589526614079
SIM,1823,39,25-29,1862,3
SIM,1856,29,40-44,1885,2
STAT,1828,35,20-24,1863,0.7364208154377817
STAT,1872,23,15-19,1895,3.116420551961244
SIM,1856,96,na,1952,2
STAT,1897,39,30-34,1936,1.4386954554058575
STAT,1925,17,40-44,1942,1.5961521079811458
STAT,1868,42,35-39,1910,1.6301532620702135
STAT,1883,27,40-44,1910,2.7745313283315207
STAT,1847,35,25-29,1882,2.249079068485864
STAT,1851,28,50-100,1879,0.5349128833248538
STAT,1881,47,25-29,1928,0.05232106795039415
SIM,1909,29,na,1938,3360
STAT,1821,51,40-44,1872,0.016287302233592794
STAT,1866,66,na,1932,1428.104481402231
STAT,1891,37,40-44,1928,5.116343150847599
STAT,1832,52,25-29,1884,0.0022267041676546973
STAT,1849,94,na,1943,14.986920183496789
STAT,1864,32,20-24,1896,2.275899188980304
SIM,1916,31,na,1947,3611
STAT,1848,29,40-44,1877,2.619255915039957
SIM,1864,22,20-24,1886,62
STAT,1836,76,na,1912,613.5069344722508
STAT,1889,47,30-34,1936,0.0633844336795986
STAT,1894,30,na,1924,2920.3869528411783
STAT,1914,48,45-49,1962,0.2030656114074641
STAT,1824,42,25-29,1866,0.8440700360055892
SIM,1890,0,na,1890,3368
STAT,1873,37,25-29,1910,2.7586004806155313
SIM,1914,44,na,1958,3461
STAT,1861,43,na,1904,1802.3347179513735
SIM,1930,5,na,1935,4939
SIM,1824,36,40-44,1860,1
SIM,1881,37,25-29,1918,2
STAT,1889,15,na,1904,2959.1856571722897
STAT,1891,33,25-29,1924,11.920844598877395
SIM,1878,19,20-24,1897,15
SIM,1833,68,na,1901,901
STAT,1856,37,20-24,1893,0.5681756010507729
SIM,1876,42,35-39,1918,2
SIM,1880,30,50-100,1910,5
STAT,1834,32,40-44,1866,3.447428486486005
STAT,1807,49,45-49,1856,0.8773969576383395
STAT,1824,46,40-44,1870,0.21168904436933678
SIM,1882,39,35-39,1921,13
SIM,1865,22,na,1887,2137
SIM,1898,32,na,1930,2984
STAT,1858,36,40-44,1894,3.2579407703730143
SIM,1865,37,40-44,1902,3
STAT,1874,53,na,1927,2044.91870382887
STAT,1909,33,35-39,1942,8.203758011591416
STAT,1917,25,35-39,1942,14.975270445478
STAT,1885,45,na,1930,2139.6691153148454
SIM,1769,92,na,1861,5
SIM,1854,30,na,1884,1978
STAT,1902,45,15-19,1947,3.038202290414593E-4
STAT,1840,43,20-24,1883,0.10733502726378066
SIM,1945,21,45-49,1966,3
STAT,1866,27,35-39,1893,8.40731705780959
STAT,1910,19,20-24,1929,25.242779901488728
STAT,1883,23,20-24,1906,63.63044554108021
STAT,1859,84,na,1943,250.12630110402398
SIM,1869,44,45-49,1913,2
STAT,1876,37,45-49,1913,1.9456525914530869
SIM,1838,32,20-24,1870,2
SIM,1857,50,na,1907,1715
SIM,1861,31,35-39,1892,8
SIM,1908,22,30-34,1930,27
STAT,1853,32,45-49,1885,1.3590360872910237
STAT,1845,37,45-49,1882,1.4821556618931246
STAT,1912,29,na,1941,3462.702696105953
STAT,1863,48,20-24,1911,0.009823208308223697
STAT,1881,17,30-34,1898,1.454575615925965
STAT,1833,35,25-29,1868,2.2549738810758098
SIM,1849,83,na,1932,253
SIM,1896,6,na,1902,3306
STAT,1841,43,na,1884,1634.6605723633386
SIM,1795,89,na,1884,32
SIM,1897,29,30-34,1926,47
STAT,1880,32,40-44,1912,4.319087146875311
STAT,1883,25,50-100,1908,0.5965112993557341
SIM,1850,71,na,1921,971
STAT,1809,46,45-49,1855,0.6778936021038746
SIM,1813,68,na,1881,758
SIM,1939,25,35-39,1964,17
SIM,1821,35,na,1856,1535
STAT,1868,25,45-49,1893,1.0075524684730037
SIM,1953,9,na,1962,4443
SIM,1875,26,45-49,1901,4
SIM,1907,62,na,1969,2818
SIM,1925,25,35-39,1950,20
SIM,1935,32,40-44,1967,4
STAT,1937,21,45-49,1958,1.0354449465042483
STAT,1869,39,25-29,1908,2.608490667865628
SIM,1859,5,na,1864,2354
STAT,1816,99,na,1915,0.8825452304698179
STAT,1889,29,30-34,1918,29.158610784386404
STAT,1845,50,45-49,1895,0.010416978350585611
SIM,1922,31,na,1953,4013
SIM,1824,32,20-24,1856,1
STAT,1880,50,35-39,1930,0.00869727505040558
STAT,1821,110,na,1931,1.472235663469198E-4
STAT,1900,32,35-39,1932,13.271565266267196
STAT,1897,38,20-24,1935,0.9690464731900152
SIM,1897,47,50-100,1944,2
STAT,1838,42,20-24,1880,0.12469158198517323
STAT,1850,32,25-29,1882,7.553106530824296
STAT,1887,16,15-19,1903,6.286348178287786
STAT,1856,50,20-24,1906,5.517201258014442E-4
STAT,1892,16,25-29,1908,6.721626193537854
SIM,1909,42,40-44,1951,1
STAT,1916,15,50-100,1931,0.07544143834955098
SIM,1846,24,20-24,1870,50
STAT,1840,33,50-100,1873,0.7248055006593581
STAT,1861,54,45-49,1915,0.01108584101098341
STAT,1853,31,35-39,1884,7.974840831974343
STAT,1884,43,30-34,1927,1.0652579997180562
SIM,1832,27,na,1859,1665
STAT,1897,23,20-24,1920,86.7938064764095
STAT,1759,103,na,1862,0.02115984095322057
STAT,1818,71,na,1889,681.8673269420879
STAT,1889,47,50-100,1936,0.16081835611048967
STAT,1875,32,30-34,1907,16.953641771813793
STAT,1836,44,40-44,1880,1.6889357867659585
STAT,1851,19,45-49,1870,0.05645935418682591
SIM,1895,16,15-19,1911,7
SIM,1858,26,40-44,1884,3
STAT,1834,36,50-100,1870,0.9576378810781185
STAT,1782,104,na,1886,0.028776564072755022
STAT,1864,29,25-29,1893,35.362044205121144
SIM,1917,15,35-39,1932,3
STAT,1817,52,30-34,1869,0.012858450039583417
STAT,1927,32,40-44,1959,4.547538499601955
SIM,1882,20,15-19,1902,3
SIM,1877,39,25-29,1916,3
STAT,1817,39,50-100,1856,3.6203272571033795
STAT,1837,18,50-100,1855,0.04776448955690144
STAT,1846,15,15-19,1861,5.595114011114247
STAT,1925,39,na,1964,4256.542844002973
SIM,1842,36,50-100,1878,1
SIM,1871,22,na,1893,2249
SIM,1895,34,45-49,1929,2
SIM,1850,41,30-34,1891,1
SIM,1871,18,20-24,1889,26
SIM,1848,36,25-29,1884,2
SIM,1867,88,na,1955,119
SIM,1841,39,45-49,1880,2
STAT,1839,53,25-29,1892,0.002320401460115117
STAT,1846,48,15-19,1894,2.929534626675692E-4
STAT,1849,43,40-44,1892,1.6744759262435698
STAT,1865,47,40-44,1912,0.14590934683059756
SIM,1932,6,na,1938,4966
SIM,1828,43,45-49,1871,1
SIM,1949,18,na,1967,3965
STAT,1912,16,50-100,1928,0.07174803883080738
SIM,1887,25,20-24,1912,12
STAT,1807,48,35-39,1855,0.5302222803325929
STAT,1834,31,30-34,1865,14.02429498173946
STAT,1935,23,35-39,1958,12.108925204102345
STAT,1772,92,na,1864,9.310400554346607
SIM,1809,86,na,1895,88
SIM,1951,15,35-39,1966,10
STAT,1852,100,na,1952,0.7696780648035619
STAT,1894,32,35-39,1926,12.294759066695699
SIM,1815,94,na,1909,11
STAT,1889,47,25-29,1936,0.03771635686733073
SIM,1919,31,45-49,1950,1
STAT,1848,46,30-34,1894,0.07213223388947146
STAT,1899,5,na,1904,3392.1615354893356
STAT,1882,40,20-24,1922,0.1473761960536358
SIM,1892,47,na,1939,2970
STAT,1851,33,25-29,1884,7.589492731145025
STAT,1920,16,na,1936,3910.7500010209096
STAT,1943,15,35-39,1958,4.205829508254114
STAT,1795,80,na,1875,267.20975702430667
STAT,1863,18,20-24,1881,15.171678381995385
SIM,1864,83,na,1947,321
STAT,1843,42,30-34,1885,0.79953532085031
STAT,1811,47,45-49,1858,0.7860832398672114
SIM,1879,33,20-24,1912,2
STAT,1880,15,20-24,1895,17.738496972283702
STAT,1825,29,45-49,1854,3.6728931884452876
STAT,1857,51,20-24,1908,5.524255097093685E-4
SIM,1928,16,20-24,1944,166
SIM,1854,15,15-19,1869,5
STAT,1827,41,35-39,1868,1.767242055720681
STAT,1852,30,35-39,1882,7.761267020786277
SIM,1856,28,30-34,1884,32
STAT,1842,41,30-34,1883,0.8724901428379092
STAT,1854,43,15-19,1897,0.009809350094244587
STAT,1874,39,35-39,1913,6.758239113113358
STAT,1875,50,25-29,1925,0.003488771339073477
STAT,1871,27,45-49,1898,1.041544603194295
STAT,1841,26,20-24,1867,10.118088418762571
STAT,1920,29,50-100,1949,1.0241060305484346
SIM,1891,62,na,1953,2162
SIM,1945,18,15-19,1963,46
SIM,1899,27,40-44,1926,3
STAT,1923,21,15-19,1944,5.868799157298999
SIM,1802,76,na,1878,359
SIM,1878,40,na,1918,2361
STAT,1873,25,25-29,1898,40.80456961560546
SIM,1875,75,na,1950,920
STAT,1837,61,na,1898,1212.7144504392204
SIM,1860,30,35-39,1890,9
SIM,1933,23,na,1956,4633
STAT,1856,38,30-34,1894,3.9088290259272265
SIM,1909,24,40-44,1933,2
STAT,1861,23,40-44,1884,1.6694799839729182
STAT,1899,37,40-44,1936,1.2230105843871042
SIM,1885,30,40-44,1915,6
STAT,1819,56,na,1875,1217.4912543111952
STAT,1877,30,40-44,1907,4.283858449963993
SIM,1931,21,15-19,1952,5
SIM,1880,90,na,1970,258
STAT,1887,34,45-49,1921,1.826893329936393
SIM,1809,55,na,1864,1114
STAT,1830,51,na,1881,1375.6231442527226
STAT,1846,33,15-19,1879,0.12353219071758692
SIM,1804,63,na,1867,862
STAT,1867,40,25-29,1907,0.5753913200803668
SIM,1878,12,na,1890,2622
SIM,1873,88,na,1961,177
STAT,1937,18,15-19,1955,41.59958358377743
STAT,1879,25,20-24,1904,11.679622158345696
SIM,1842,31,30-34,1873,20
STAT,1914,47,35-39,1961,0.1207984707515617
SIM,1943,23,35-39,1966,10
STAT,1848,28,30-34,1876,22.177741560993084
STAT,1858,53,30-34,1911,0.004338152820027925
SIM,1920,21,40-44,1941,5
STAT,1869,18,20-24,1887,16.35275203885317
SIM,1803,61,na,1864,915
SIM,1929,18,30-34,1947,14
STAT,1785,99,na,1884,0.3662987640020288
STAT,1832,24,25-29,1856,49.529704568096825
SIM,1895,75,na,1970,1611
SIM,1861,43,35-39,1904,1
STAT,1863,36,20-24,1899,0.6421228256905084
STAT,1876,30,25-29,1906,10.077186925322295
SIM,1889,2,na,1891,3194
STAT,1818,51,35-39,1869,0.017976572816604208
STAT,1945,16,na,1961,3799.4609718255597
STAT,1837,28,20-24,1865,9.702134038102447
STAT,1820,37,45-49,1857,4.585703683570409
STAT,1922,25,15-19,1947,0.7597685616973511
STAT,1846,37,30-34,1883,4.128009142158922
STAT,1869,53,40-44,1922,0.009480096802447447
STAT,1888,48,25-29,1936,0.03581894512783178
STAT,1954,18,15-19,1972,52.98036474918056
SIM,1860,70,na,1930,1126
SIM,1861,41,40-44,1902,5
STAT,1856,40,15-19,1896,0.010281627770395579
SIM,1921,46,na,1967,3937
STAT,1843,24,35-39,1867,4.876668682853488
SIM,1809,63,na,1872,889
SIM,1929,7,na,1936,4777
SIM,1939,21,15-19,1960,4
STAT,1820,51,50-100,1871,0.024834416728331657
STAT,1860,21,30-34,1881,14.17637508027081
STAT,1841,66,na,1907,1129.9531376579775
SIM,1837,33,45-49,1870,1
SIM,1884,30,25-29,1914,11
STAT,1912,21,40-44,1933,3.0534280233479514
SIM,1951,8,na,1959,4295
STAT,1849,33,50-100,1882,0.7165143360014994
SIM,1828,29,30-34,1857,18
STAT,1877,48,15-19,1925,3.8704836930747953E-4
STAT,1848,13,na,1861,2188.9737917128314
STAT,1896,24,45-49,1920,0.864591384658403
SIM,1868,73,na,1941,1014
STAT,1885,42,35-39,1927,1.7030418453697673
SIM,1854,19,30-34,1873,3
STAT,1869,83,na,1952,363.318309547717
SIM,1796,74,na,1870,432
SIM,1896,36,25-29,1932,4
STAT,1891,30,20-24,1921,3.1846791182471166
SIM,1872,31,45-49,1903,1
STAT,1854,33,na,1887,1730.3882877431636
STAT,1936,20,50-100,1956,0.5946778144268136
SIM,1870,91,na,1961,87
STAT,1871,24,40-44,1895,1.942526190599361
STAT,1864,17,25-29,1881,4.935726918349805
SIM,1876,17,na,1893,2465
STAT,1872,58,na,1930,1873.926396686414
SIM,1917,16,na,1933,3941
STAT,1953,11,na,1964,4489.568245407454
SIM,1872,17,25-29,1889,8
STAT,1833,51,30-34,1884,0.0038392767646566977
SIM,1833,26,40-44,1859,3
STAT,1784,104,na,1888,0.031210540244674692
SIM,1887,57,na,1944,2083
STAT,1893,16,45-49,1909,0.07845037090033853
SIM,1839,29,40-44,1868,3
SIM,1889,34,20-24,1923,2
STAT,1883,10,na,1893,2399.194571362806
STAT,1908,48,20-24,1956,0.00941555104744063
SIM,1930,39,40-44,1969,3
STAT,1821,34,20-24,1855,7.246377952180718
STAT,1844,51,40-44,1895,0.007346685651386707
SIM,1858,43,na,1901,1874
STAT,1838,27,50-100,1865,0.546303787170796
STAT,1875,17,35-39,1892,0.5328046289458521
SIM,1902,62,na,1964,2574
SIM,1837,19,na,1856,1965
STAT,1851,30,20-24,1881,2.0662678590728483
SIM,1889,35,na,1924,2892
STAT,1869,94,na,1963,48.36822643485252
STAT,1855,7,na,1862,2092.025608214659
STAT,1893,19,45-49,1912,0.07783848498229944
STAT,1922,39,40-44,1961,1.6057469813793999
SIM,1837,81,na,1918,299
STAT,1872,27,30-34,1899,23.861795482225308
SIM,1887,24,15-19,1911,2
STAT,1838,91,na,1929,38.90327571228256
SIM,1893,42,35-39,1935,2
SIM,1804,53,50-100,1857,1
STAT,1869,51,45-49,1920,0.013345155667323623
SIM,1880,38,20-24,1918,4
STAT,1837,53,50-100,1890,0.009644475547957368
STAT,1894,50,na,1944,2651.68978015191
SIM,1932,20,20-24,1952,116
STAT,1837,46,20-24,1883,0.00818872445600617
STAT,1825,45,45-49,1870,0.2475023123266251
STAT,1895,44,15-19,1939,0.001165139699929307
STAT,1876,49,45-49,1925,0.22552786894564494
SIM,1820,40,40-44,1860,5
SIM,1905,31,50-100,1936,1
SIM,1925,25,50-100,1950,1
STAT,1813,41,40-44,1854,7.962158673958266
STAT,1821,54,45-49,1875,0.021149713523729883
STAT,1879,39,15-19,1918,0.05497085877650485
STAT,1913,20,45-49,1933,1.0361837183605545
STAT,1849,42,30-34,1891,0.8610380359268711
SIM,1956,11,na,1967,4787
STAT,1867,22,25-29,1889,50.99052347967653
STAT,1899,36,35-39,1935,9.199273066432212
STAT,1841,48,35-39,1889,0.09572098231030826
STAT,1826,28,45-49,1854,3.5429790543976587
SIM,1834,30,na,1864,1730
SIM,1851,24,35-39,1875,5
SIM,1834,28,45-49,1862,1
STAT,1831,101,na,1932,0.33317890043179965
STAT,1923,38,45-49,1961,0.7454500259498663
STAT,1935,35,50-100,1970,0.555578806990961
STAT,1956,8,na,1964,4912.127039317464
SIM,1894,5,na,1899,3302
SIM,1898,25,30-34,1923,36
SIM,1770,89,na,1859,33
SIM,1834,25,45-49,1859,4
SIM,1874,27,40-44,1901,2
SIM,1923,24,na,1947,4036
STAT,1857,19,40-44,1876,0.15828760780009626
STAT,1872,38,20-24,1910,0.7268158973815366
SIM,1875,22,25-29,1897,54
STAT,1866,28,50-100,1894,0.5554156466073298
SIM,1881,19,25-29,1900,4
STAT,1872,5,na,1877,2626.998046957312
SIM,1877,47,na,1924,2163
STAT,1821,36,15-19,1857,0.12487402369749742
STAT,1799,70,na,1869,646.8967576914872
STAT,1838,27,25-29,1865,36.12584241066939
STAT,1890,18,15-19,1908,6.836245270188432
STAT,1845,34,40-44,1879,3.573804708748843
SIM,1856,65,na,1921,1304
SIM,1877,18,20-24,1895,19
STAT,1840,49,30-34,1889,0.06244003750770202
STAT,1894,61,na,1955,2268.616015431257
SIM,1870,37,45-49,1907,1
SIM,1847,29,na,1876,1906
STAT,1909,30,30-34,1939,14.31792148217669
STAT,1837,25,20-24,1862,9.914155317834002
SIM,1823,78,na,1901,358
STAT,1880,30,45-49,1910,1.7506934230515263
STAT,1948,4,na,1952,4290.930891718835
STAT,1934,38,20-24,1972,0.3433064506222813
STAT,1855,41,45-49,1896,1.0683647612010216
STAT,1892,36,45-49,1928,2.370146771845312
STAT,1912,48,40-44,1960,0.1427481348357928
SIM,1821,41,40-44,1862,4
SIM,1921,20,45-49,1941,1
STAT,1847,47,25-29,1894,0.0422766377212316
SIM,1790,86,na,1876,50
SIM,1929,36,30-34,1965,3
SIM,1881,32,na,1913,1845
STAT,1821,66,na,1887,874.3948897656782
STAT,1775,89,na,1864,32.37575405385167
STAT,1897,41,15-19,1938,0.0012170441295832632
STAT,1775,111,na,1886,0.0011338321145528947
STAT,1924,20,20-24,1944,124.68822964167335
STAT,1846,46,50-100,1892,0.18267964778435336
SIM,1833,22,20-24,1855,59
SIM,1845,25,20-24,1870,8
SIM,1850,60,na,1910,1412
STAT,1914,24,na,1938,3502.5504049422825
STAT,1857,37,40-44,1894,3.2615065881710796
STAT,1874,52,30-34,1926,0.005714953612664425
SIM,1885,42,na,1927,2202
SIM,1845,28,20-24,1873,11
STAT,1826,46,45-49,1872,0.22087146139136382
STAT,1884,20,na,1904,2220.5191591646517
STAT,1830,82,na,1912,281.60387305945994
STAT,1836,47,15-19,1883,2.710791522836724E-4
STAT,1855,23,45-49,1878,0.5747516458340137
STAT,1887,49,20-24,1936,0.00700335277780658
SIM,1878,38,30-34,1916,4
STAT,1793,85,na,1878,79.65244181587191
STAT,1939,31,20-24,1970,2.3524612399756277
SIM,1855,35,25-29,1890,1
STAT,1932,15,30-34,1947,15.317868796554727
SIM,1834,43,40-44,1877,9
SIM,1862,17,na,1879,2248
SIM,1862,40,45-49,1902,2
SIM,1881,25,25-29,1906,31
SIM,1883,87,na,1970,352
SIM,1896,18,25-29,1914,7
STAT,1898,38,40-44,1936,1.2019178148213219
SIM,1780,79,na,1859,241
SIM,1846,27,25-29,1873,40
SIM,1857,24,30-34,1881,16
STAT,1893,34,40-44,1927,5.151024452501038
STAT,1907,42,na,1949,3214.485759039238
SIM,1895,38,30-34,1933,7
STAT,1812,42,35-39,1854,6.918570296098395
STAT,1851,35,45-49,1886,1.4797712767227984
STAT,1926,46,15-19,1972,4.304430098886473E-4
SIM,1803,78,na,1881,290
SIM,1925,39,na,1964,4219
SIM,1861,32,na,1893,2043
STAT,1836,45,20-24,1881,0.008343453979426756
STAT,1858,39,45-49,1897,1.4616779661037882
STAT,1888,18,25-29,1906,6.310033149352339
STAT,1878,43,na,1921,2259.0257182287446
STAT,1826,43,40-44,1869,2.1541006793565614
SIM,1904,20,45-49,1924,1
STAT,1827,51,na,1878,1377.505705708205
SIM,1864,80,na,1944,485
STAT,1873,37,20-24,1910,0.7385614739378316
SIM,1875,26,40-44,1901,2
SIM,1878,16,15-19,1894,5
SIM,1893,32,50-100,1925,2
STAT,1851,16,40-44,1867,0.160912845818083
STAT,1835,48,45-49,1883,0.15631141501380702
SIM,1849,36,45-49,1885,2
SIM,1884,80,na,1964,840
STAT,1840,16,30-34,1856,1.3622948921658955
SIM,1940,15,30-34,1955,12
STAT,1904,14,na,1918,3488.116479145012
SIM,1863,10,na,1873,2280
SIM,1890,27,25-29,1917,54
STAT,1884,38,50-100,1922,1.1401942016612052
SIM,1886,26,20-24,1912,10
STAT,1841,46,40-44,1887,0.12009114613153883
SIM,1886,29,20-24,1915,13
SIM,1849,39,45-49,1888,1
SIM,1874,73,na,1947,1115
STAT,1764,97,na,1861,0.5799979577480553
STAT,1821,36,45-49,1857,4.433027314065801
STAT,1936,22,35-39,1958,8.503967750812143
SIM,1829,39,25-29,1868,4
SIM,1892,24,na,1916,3082
STAT,1825,73,na,1898,631.273522241077
STAT,1859,52,35-39,1911,0.006438610528514636
STAT,1911,39,30-34,1950,1.646330661588174
SIM,1905,46,50-100,1951,1
STAT,1880,51,45-49,1931,0.014522573187456356
SIM,1762,103,na,1865,1
SIM,1944,22,35-39,1966,9
STAT,1878,29,20-24,1907,11.467306486043745
SIM,1872,24,na,1896,2221
SIM,1829,27,25-29,1856,38
STAT,1860,51,25-29,1911,0.0027279773305822316
STAT,1890,36,15-19,1926,0.0651687576529946
STAT,1857,33,20-24,1890,2.0054447872852186
STAT,1858,51,35-39,1909,0.006407080114186415
STAT,1887,38,30-34,1925,5.6037480252291205
STAT,1849,24,30-34,1873,15.917781455509179
STAT,1945,7,na,1952,4078.314700322551
STAT,1823,45,15-19,1868,5.070104934258403E-4
STAT,1836,96,na,1932,5.560432359165503
STAT,1872,23,45-49,1895,0.6587242959580721
SIM,1859,43,45-49,1902,3
SIM,1865,33,20-24,1898,2
STAT,1878,26,20-24,1904,11.58949152620599
STAT,1928,9,na,1937,4738.479189539225
SIM,1889,27,na,1916,2874
STAT,1888,36,25-29,1924,3.2299459930720347
SIM,1947,15,15-19,1962,45
STAT,1826,47,50-100,1873,0.22675969870963153
STAT,1907,65,na,1972,2695.394637795388
SIM,1943,20,30-34,1963,44
STAT,1846,19,30-34,1865,1.4676131878135827
STAT,1882,27,25-29,1909,38.86296525054707
SIM,1792,81,na,1873,161
SIM,1841,19,25-29,1860,7
STAT,1840,41,na,1881,1602.6122333733579
STAT,1870,31,35-39,1901,9.42372728435873
STAT,1832,39,25-29,1871,2.153403139938676
STAT,1831,37,20-24,1868,0.5909823294227774
STAT,1873,4,na,1877,2806.3409680931854
STAT,1910,17,na,1927,3615.4748290366724
STAT,1892,17,40-44,1909,0.21642010100842268
STAT,1813,42,15-19,1855,0.045170504825383026
STAT,1879,28,25-29,1907,41.68349700099481
STAT,1842,26,40-44,1868,2.702107406079121
SIM,1871,18,25-29,1889,10
SIM,1862,42,40-44,1904,5
SIM,1905,39,na,1944,3169
SIM,1899,34,na,1933,3128
STAT,1829,66,na,1895,990.3482077913071
SIM,1866,95,na,1961,17
STAT,1863,18,25-29,1881,4.849458734876215
STAT,1915,43,35-39,1958,0.1912195772520787
STAT,1836,29,15-19,1865,0.37473375391328595
STAT,1852,36,45-49,1888,1.468259593055786
SIM,1840,39,25-29,1879,2
STAT,1832,36,25-29,1868,2.224475942707547
STAT,1879,93,na,1972,131.22841429357206
SIM,1840,36,25-29,1876,3
SIM,1899,23,25-29,1922,89
SIM,1909,20,25-29,1929,87
SIM,1936,31,50-100,1967,3
SIM,1919,28,na,1947,3852
STAT,1865,0,na,1865,3262.786493556432
SIM,1860,36,45-49,1896,1
SIM,1837,37,30-34,1874,5
STAT,1842,29,40-44,1871,2.644320912742825
STAT,1884,35,50-100,1919,1.1567602952199358
STAT,1864,46,15-19,1910,3.3774463446943935E-4
SIM,1887,28,25-29,1915,48
SIM,1830,29,20-24,1859,8
SIM,1868,30,40-44,1898,4
STAT,1914,44,30-34,1958,0.11927902256107752
SIM,1820,42,35-39,1862,3
STAT,1922,42,na,1964,4027.0793295443273
SIM,1845,14,na,1859,2097
SIM,1850,29,40-44,1879,7
STAT,1813,48,na,1861,1251.5705569207141
SIM,1850,26,40-44,1876,2
STAT,1762,93,na,1855,3.0608999999999997
STAT,1797,92,na,1889,11.714848024190097
STAT,1939,15,15-19,1954,43.021271471034076
SIM,1831,96,na,1927,5
STAT,1896,28,30-34,1924,31.308494474750255
SIM,1875,44,40-44,1919,5
SIM,1849,32,25-29,1881,16
STAT,1839,50,20-24,1889,5.035303693542643E-4
STAT,1909,20,na,1929,3370.7473878910087
SIM,1840,24,25-29,1864,49
STAT,1919,47,50-100,1966,0.2317552065309902
STAT,1939,26,50-100,1965,0.9457185252837029
STAT,1876,65,na,1941,1649.4115244000402
STAT,1878,47,20-24,1925,0.011759169018465604
STAT,1935,20,30-34,1955,36.99914192158317
SIM,1844,43,50-100,1887,3
SIM,1914,25,30-34,1939,54
STAT,1884,25,35-39,1909,9.06664137698748
SIM,1874,43,40-44,1917,5
STAT,1863,47,50-100,1910,0.20265742201239426
SIM,1954,16,na,1970,4218
STAT,1852,15,45-49,1867,0.05795834616326885
SIM,1938,23,20-24,1961,89
SIM,1817,81,na,1898,229
STAT,1877,48,45-49,1925,0.22835873009708527
STAT,1880,33,15-19,1913,0.14123024957624175
SIM,1925,28,na,1953,4104
SIM,1825,34,35-39,1859,11
STAT,1847,51,na,1898,1595.3582837376744
SIM,1845,25,na,1870,1901
SIM,1854,37,30-34,1891,4
SIM,1848,33,20-24,1881,2
STAT,1785,103,na,1888,0.055186303382179246
STAT,1861,38,45-49,1899,1.5580915210018786
STAT,1906,25,30-34,1931,34.88293426878536
STAT,1867,44,40-44,1911,1.9683506597001321
SIM,1834,22,na,1856,1766
SIM,1889,38,40-44,1927,6
STAT,1853,99,na,1952,1.4332712337412692
SIM,1859,22,40-44,1881,5
SIM,1840,18,25-29,1858,6
STAT,1866,43,40-44,1909,1.945684530721247
SIM,1892,25,35-39,1917,14
STAT,1877,46,20-24,1923,0.011792602852198771
SIM,1879,37,50-100,1916,1
SIM,1904,17,15-19,1921,7
STAT,1852,18,45-49,1870,0.05694024243378289
SIM,1881,40,50-100,1921,1
STAT,1857,54,25-29,1911,0.0025664444465094997
SIM,1861,55,na,1916,1791
STAT,1843,21,30-34,1864,15.210892560211198
SIM,1865,14,na,1879,2384
STAT,1875,53,30-34,1928,0.005687208590261411
STAT,1894,44,35-39,1938,0.15060196256030536
SIM,1946,18,30-34,1964,20
STAT,1874,61,na,1935,1803.6507835204643
SIM,1885,33,45-49,1918,2
STAT,1830,74,na,1904,669.8082488755763
STAT,1902,49,30-34,1951,0.07127880164865959
STAT,1868,13,na,1881,2396.4072219264394
STAT,1949,3,na,1952,4371.095887838214
STAT,1850,38,35-39,1888,5.012502114209709
SIM,1895,35,na,1930,2994
STAT,1837,28,25-29,1865,34.984082105610554
STAT,1913,17,15-19,1930,8.766131162207184
SIM,1902,11,na,1913,3461
SIM,1854,81,na,1935,393
STAT,1833,54,35-39,1887,0.005232373200022618
STAT,1829,37,30-34,1866,4.835714050022574
STAT,1854,28,20-24,1882,8.736131574753365
STAT,1870,41,40-44,1911,2.0939738267801253
STAT,1873,19,25-29,1892,5.400257906118678
STAT,1843,40,35-39,1883,1.2920134445582816
SIM,1810,94,na,1904,6
STAT,1834,33,na,1867,1703.2493091670497
SIM,1818,42,45-49,1860,4
SIM,1871,62,na,1933,1710
STAT,1868,36,35-39,1904,6.405805802811944
STAT,1793,77,na,1870,304.8898796151008
STAT,1878,20,na,1898,2342.331866166191
STAT,1894,46,20-24,1940,0.008241232494175079
STAT,1883,44,25-29,1927,0.5867460905895187
SIM,1865,36,25-29,1901,2
STAT,1877,33,45-49,1910,1.7016205204842278
SIM,1862,28,20-24,1890,8
STAT,1840,81,na,1921,354.8808471265218
STAT,1865,28,30-34,1893,21.486509412330776
STAT,1854,40,45-49,1894,1.0816286297623083
STAT,1910,44,50-100,1954,0.10360242035766197
SIM,1879,9,na,1888,2624
SIM,1918,32,35-39,1950,9
STAT,1815,74,na,1889,505.19470565735907
STAT,1898,20,na,1918,3041.564578899072
STAT,1822,35,20-24,1857,1.5027326317826626
STAT,1938,18,30-34,1956,11.35512098652758
SIM,1881,83,na,1964,453
SIM,1858,44,40-44,1902,3
STAT,1893,20,na,1913,2850.299278530317
STAT,1832,36,20-24,1868,0.5955600466721976
SIM,1845,28,25-29,1873,36
STAT,1867,68,na,1935,1355.6305072402658
SIM,1891,8,na,1899,3079
STAT,1925,16,na,1941,4210.635934013513
STAT,1776,110,na,1886,0.0018797960079384092
STAT,1776,85,na,1861,78.41201322608761
STAT,1846,52,50-100,1898,0.011142134049559754
STAT,1839,40,15-19,1879,0.010925471562792721
SIM,1851,21,30-34,1872,16
STAT,1872,54,20-24,1926,6.800071090475451E-4
STAT,1867,47,45-49,1914,0.20837441856094455
STAT,1888,13,na,1901,2878.7686860211907
SIM,1840,21,20-24,1861,56
STAT,1949,18,40-44,1967,1.536343758603989
STAT,1887,71,na,1958,1497.5827221805434
SIM,1921,17,15-19,1938,45
SIM,1883,4,na,1887,2494
SIM,1918,9,na,1927,4107
STAT,1842,47,40-44,1889,0.12400072408577086
STAT,1896,39,15-19,1935,0.06935807390048725
SIM,1940,7,na,1947,3734
SIM,1928,19,25-29,1947,58
SIM,1843,46,50-100,1889,1
STAT,1911,35,15-19,1946,0.017689172388573055
SIM,1812,75,na,1887,401
SIM,1833,42,40-44,1875,8
STAT,1889,20,50-100,1909,0.4784251738559005
STAT,1911,22,35-39,1933,8.436447357708508
SIM,1790,89,na,1879,28
STAT,1852,33,40-44,1885,3.2216713404161683
STAT,1827,53,35-39,1880,0.0074534632724533945
STAT,1835,46,50-100,1881,0.16689186680576085
STAT,1872,83,na,1955,376.1758478346995
SIM,1860,33,40-44,1893,3
SIM,1915,46,na,1961,3353
STAT,1899,33,30-34,1932,22.504533500231013
STAT,1828,38,20-24,1866,0.6881293163974238
STAT,1895,41,50-100,1936,0.09076159823247129
SIM,1825,93,na,1918,10
STAT,1901,28,15-19,1929,0.5978380275300734
STAT,1836,47,45-49,1883,0.15993683446348927
STAT,1956,16,25-29,1972,54.178499579183885
STAT,1892,33,40-44,1925,5.109766558350993
SIM,1891,26,25-29,1917,60
STAT,1847,29,25-29,1876,36.95637911339336
STAT,1833,50,50-100,1883,0.009935816301065896
STAT,1845,42,50-100,1887,0.7612703146983956
SIM,1862,48,50-100,1910,3
SIM,1823,36,25-29,1859,2
STAT,1871,45,45-49,1916,0.22359217681898766
SIM,1911,31,40-44,1942,9
STAT,1838,45,25-29,1883,0.0408168561831199
STAT,1877,15,45-49,1892,0.06430919414487529
STAT,1868,54,35-39,1922,0.007546320771696057
STAT,1817,50,35-39,1867,0.019355405170843786
STAT,1845,52,40-44,1897,0.007410009995150916
STAT,1862,37,15-19,1899,0.04535708033515019
STAT,1865,3,na,1868,2739.531330520303
STAT,1830,26,15-19,1856,0.4937685203983069
STAT,1878,29,25-29,1907,41.348964059088246
SIM,1866,35,35-39,1901,15
SIM,1878,43,na,1921,2310
STAT,1857,58,na,1915,1473.430741353267
STAT,1948,21,15-19,1969,5.776110385432773
STAT,1816,53,25-29,1869,0.007851345641396818
STAT,1895,29,20-24,1924,14.345174443937621
STAT,1927,21,50-100,1948,0.7681481749721826
STAT,1867,26,45-49,1893,0.9883055389861755
SIM,1841,63,na,1904,1163
STAT,1861,32,na,1893,1874.4166505443923
STAT,1898,12,na,1910,3301.5303002353216
STAT,1882,47,40-44,1929,0.15655080368560859
SIM,1841,55,na,1896,1380
SIM,1898,28,35-39,1926,12
SIM,1844,32,45-49,1876,1
STAT,1856,106,na,1962,0.035267691257515374
SIM,1855,29,25-29,1884,35
SIM,1871,36,20-24,1907,2
STAT,1920,40,50-100,1960,0.12291231203609702
SIM,1882,17,na,1899,2404
STAT,1830,71,na,1901,805.6133241285864
STAT,1883,26,25-29,1909,39.314597400455234
STAT,1919,32,50-100,1951,0.8426811742280768
SIM,1822,40,45-49,1862,1
STAT,1892,31,20-24,1923,3.2114657706952507
SIM,1935,21,50-100,1956,1
STAT,1893,16,40-44,1909,0.21966109193703173
SIM,1908,25,35-39,1933,16
SIM,1860,3,na,1863,2609
STAT,1879,15,45-49,1894,0.06489579509497552
STAT,1905,8,na,1913,3549.6658148281385
SIM,1881,22,20-24,1903,51
STAT,1860,24,35-39,1884,4.544998534220227
SIM,1824,35,25-29,1859,2
SIM,1905,36,na,1941,3231
STAT,1881,31,45-49,1912,1.5979270312689438
STAT,1903,31,40-44,1934,5.853029072980982
SIM,1834,25,40-44,1859,2
SIM,1912,32,na,1944,3458
STAT,1816,39,40-44,1855,14.37771587886669
SIM,1824,39,40-44,1863,2
STAT,1893,37,45-49,1930,2.388252205898485
STAT,1913,49,40-44,1962,0.14452826305318842
STAT,1840,27,15-19,1867,0.37124550402219697
STAT,1804,54,45-49,1858,0.049258064016406006
SIM,1864,91,na,1955,49
STAT,1853,45,20-24,1898,0.00917209308445429
SIM,1876,36,35-39,1912,12
STAT,1862,19,15-19,1881,4.93716552127962
STAT,1836,32,45-49,1868,1.4273877712312564
STAT,1922,50,na,1972,3951.1372351117443
SIM,1878,32,na,1910,2405
STAT,1814,40,45-49,1854,5.659195450662198
SIM,1870,19,15-19,1889,8
SIM,1917,30,30-34,1947,29
STAT,1831,53,20-24,1884,4.533656656402409E-4
STAT,1806,49,25-29,1855,0.20571655610930054
STAT,1892,35,na,1927,2814.1859492907456
STAT,1906,45,50-100,1951,0.19251649658839293
STAT,1926,24,50-100,1950,0.7504272686739218
SIM,1835,20,35-39,1855,5
STAT,1882,28,na,1910,2184.817840540282
STAT,1926,33,35-39,1959,10.43200012670486
SIM,1853,34,40-44,1887,5
SIM,1896,15,20-24,1911,25
STAT,1855,38,15-19,1893,0.03970700124978031
STAT,1938,16,50-100,1954,0.34999951147817576
STAT,1825,40,20-24,1865,0.18103528021048385
STAT,1863,98,na,1961,6.440370309831909
SIM,1847,40,na,1887,1760
STAT,1824,109,na,1933,3.9228956775542436E-4
SIM,1776,82,na,1858,127
STAT,1832,54,20-24,1886,4.45880236171565E-4
STAT,1847,47,20-24,1894,0.008807633269441529
STAT,1883,48,40-44,1931,0.1565753193928637
SIM,1906,30,20-24,1936,2
STAT,1862,73,na,1935,959.369836374018
STAT,1876,50,40-44,1926,0.010422693024655275
STAT,1886,86,na,1972,533.929292340084
SIM,1827,37,na,1864,1543
STAT,1829,33,15-19,1862,0.13825212050708527
STAT,1849,27,35-39,1876,8.57691476631134
SIM,1886,29,25-29,1915,40
STAT,1840,30,45-49,1870,1.423116926563136
STAT,1851,32,40-44,1883,3.246930403272186
SIM,1846,55,na,1901,1479
SIM,1857,27,35-39,1884,9
SIM,1906,21,na,1927,3231
STAT,1884,41,35-39,1925,1.697717180586438
SIM,1855,32,20-24,1887,1
STAT,1938,34,na,1972,3587.972332063324
STAT,1956,5,na,1961,4914.2398607375635
SIM,1892,22,30-34,1914,26
SIM,1914,21,15-19,1935,4
SIM,1850,25,25-29,1875,46
STAT,1864,35,25-29,1899,2.4472257273614484
SIM,1775,89,na,1864,28
SIM,1863,23,15-19,1886,2
STAT,1888,15,20-24,1903,19.884948362263543
SIM,1875,29,45-49,1904,2
STAT,1881,32,na,1913,2177.7629775062055
SIM,1825,31,30-34,1856,14
STAT,1822,103,na,1925,0.07292537572873424
SIM,1864,37,25-29,1901,2
STAT,1928,28,15-19,1956,0.8212110731317498
STAT,1842,43,25-29,1885,0.4750082169729144
STAT,1823,110,na,1933,1.4789093436654865E-4
STAT,1928,31,45-49,1959,1.85979918872874
SIM,1903,21,35-39,1924,9
SIM,1934,33,35-39,1967,14
SIM,1939,3,na,1942,3768
STAT,1863,50,35-39,1913,0.007239621475457022
STAT,1928,27,na,1955,4359.862022318357
SIM,1894,20,40-44,1914,3
SIM,1819,38,25-29,1857,2
SIM,1901,19,20-24,1920,23
STAT,1853,25,35-39,1878,8.582152938810813
STAT,1824,48,35-39,1872,0.1682626934890507
STAT,1839,38,30-34,1877,4.196607002773181
STAT,1833,31,15-19,1864,0.1136706203940889
STAT,1904,54,na,1958,2892.0418141848163
SIM,1910,30,50-100,1940,1
SIM,1861,25,35-39,1886,9
STAT,1862,37,45-49,1899,1.6101761604085083
STAT,1940,16,na,1956,3531.507785143692
STAT,1850,40,na,1890,1645.6866443350025
STAT,1854,41,50-100,1895,0.7592956608916593
STAT,1886,20,40-44,1906,2.0918617005294995
STAT,1830,41,40-44,1871,1.7743687990571007
STAT,1891,39,35-39,1930,8.183497264846741
SIM,1830,71,na,1901,765
STAT,1897,27,na,1924,3015.0914126386197
SIM,1847,38,30-34,1885,4
SIM,1940,13,na,1953,3701
SIM,1906,32,na,1938,3300
STAT,1829,48,15-19,1877,3.226870184789891E-4
STAT,1862,22,45-49,1884,0.5765820600544695
STAT,1823,78,na,1901,418.15453349590683
STAT,1855,23,15-19,1878,2.7191464658906073
STAT,1809,63,na,1872,898.1554362817932
STAT,1849,45,35-39,1894,0.10602814122458666
SIM,1835,35,35-39,1870,10
STAT,1844,41,35-39,1885,1.3046548255449195
STAT,1888,4,na,1892,2937.0266381700676
SIM,1871,15,20-24,1886,11
STAT,1842,25,25-29,1867,38.43336916092537
STAT,1918,24,40-44,1942,3.4044207892931264
SIM,1934,15,35-39,1949,7
STAT,1854,84,na,1938,238.0155318601968
STAT,1894,26,35-39,1920,11.754476719220769
SIM,1878,34,45-49,1912,1
STAT,1829,33,45-49,1862,1.692936267597939
SIM,1896,33,20-24,1929,2
SIM,1855,0,na,1855,3064
STAT,1888,33,20-24,1921,3.0050898899705727
SIM,1833,37,na,1870,1613
STAT,1906,21,15-19,1927,4.552843781089449
STAT,1852,15,40-44,1867,0.16228340872041908
STAT,1874,32,15-19,1906,0.13745521941851657
STAT,1922,3,na,1925,4434.525573888713
STAT,1819,44,40-44,1863,4.41265631121355
SIM,1859,25,45-49,1884,4
STAT,1880,18,20-24,1898,17.61020254093611
STAT,1902,30,50-100,1932,1.231386506908182
STAT,1891,20,15-19,1911,3.8788435058996185
SIM,1894,35,40-44,1929,7
SIM,1936,31,45-49,1967,1
SIM,1782,82,na,1864,139
SIM,1947,19,30-34,1966,20
STAT,1853,43,35-39,1896,1.3605172731085349
STAT,1886,35,40-44,1921,4.4098423415517525
SIM,1824,63,na,1887,954
STAT,1896,42,45-49,1938,0.1295120067927925
STAT,1896,24,15-19,1920,4.0903764696870635
STAT,1828,92,na,1920,23.456126860035916
STAT,1865,49,35-39,1914,0.11737431949924718
SIM,1851,40,35-39,1891,4
SIM,1852,41,35-39,1893,4
STAT,1866,46,45-49,1912,0.20621565825694668
STAT,1827,35,35-39,1862,7.702737656944398
SIM,1938,26,25-29,1964,66
STAT,1863,15,20-24,1878,16.970276183791313
SIM,1850,29,45-49,1879,1
STAT,1834,52,30-34,1886,0.003787797553617864
STAT,1866,41,20-24,1907,0.13900330435932487
STAT,1905,39,na,1944,3209.824787939903
STAT,1888,48,20-24,1936,0.007462280583059603
SIM,1926,24,40-44,1950,3
SIM,1872,58,na,1930,1836
SIM,1898,49,na,1947,2757
STAT,1939,19,30-34,1958,11.518281696121276
SIM,1849,36,40-44,1885,3
STAT,1884,22,30-34,1906,16.624572847568174
STAT,1826,66,na,1892,895.0354028777459
SIM,1937,16,na,1953,3311
STAT,1905,10,na,1915,3537.0756379070262
SIM,1762,100,na,1862,3
STAT,1829,51,45-49,1880,0.011687435146274456
STAT,1810,82,na,1892,197.3825481879172
STAT,1842,29,45-49,1871,0.9801152180025611
STAT,1895,41,45-49,1936,0.12857893119779382
STAT,1947,15,50-100,1962,0.39891877951501764
SIM,1793,74,na,1867,394
SIM,1827,44,40-44,1871,5
STAT,1926,15,35-39,1941,4.882594842254043
SIM,1789,92,na,1881,6
SIM,1962,3,na,1965,4637
STAT,1836,99,na,1935,1.2264049730982312
STAT,1916,39,15-19,1955,0.018390732900346984
STAT,1918,42,40-44,1960,0.2512317826468671
STAT,1844,40,na,1884,1686.6730043262496
STAT,1865,40,20-24,1905,0.13735837822812072
SIM,1884,83,na,1967,668
STAT,1828,50,45-49,1878,0.01180624950616157
STAT,1799,62,na,1861,871.7296916862342
STAT,1827,32,50-100,1859,1.09932825935665
SIM,1926,42,40-44,1968,6
STAT,1786,75,na,1861,366.33902107959034
STAT,1898,34,25-29,1932,12.982237635280745
STAT,1871,56,na,1927,1913.3241717698627
STAT,1904,38,40-44,1942,1.2739685918252324
STAT,1877,42,40-44,1919,2.2014296729001974
STAT,1910,49,20-24,1959,0.009683674632405428
STAT,1822,36,30-34,1858,9.889740121558411
STAT,1842,29,50-100,1871,0.5646856542153662
STAT,1875,46,na,1921,2190.8309686273924
STAT,1958,6,na,1964,4876.681239862194
SIM,1907,30,35-39,1937,9
STAT,1894,49,25-29,1943,0.038622319121261926
STAT,1900,72,na,1972,2071.712011882072
SIM,1806,75,na,1881,429
SIM,1931,25,30-34,1956,60
STAT,1837,92,na,1929,27.029800119218685
SIM,1912,47,50-100,1959,3
STAT,1894,41,30-34,1935,1.4020695592860057
STAT,1853,35,50-100,1888,0.9486488259547183
STAT,1896,46,25-29,1942,0.04065389010357054
STAT,1856,99,na,1955,1.3959273388748632
STAT,1861,41,35-39,1902,1.4288068346413696
STAT,1819,46,50-100,1865,0.4725123423417503
STAT,1858,16,25-29,1874,4.931984286741624
STAT,1844,45,50-100,1889,0.17326497433436433
STAT,1861,35,40-44,1896,3.4711277652641783
STAT,1957,15,30-34,1972,15.187018278700439
SIM,1791,96,na,1887,2
SIM,1894,35,45-49,1929,4
STAT,1914,41,25-29,1955,0.06694313208369512
STAT,1847,37,na,1884,1802.5412192172212
STAT,1835,52,45-49,1887,0.009413154792971633
SIM,1920,28,20-24,1948,19
STAT,1921,37,30-34,1958,1.922492799880462
SIM,1821,66,na,1887,838
SIM,1889,19,30-34,1908,2
STAT,1884,47,45-49,1931,0.21923680837995818
STAT,1935,2,na,1937,5281.823078090931
SIM,1898,63,na,1961,2387
STAT,1846,17,45-49,1863,0.060862923009489034
STAT,1811,48,20-24,1859,0.03931672074932434
SIM,1948,18,35-39,1966,7
STAT,1846,52,20-24,1898,5.444039653439412E-4
STAT,1905,41,15-19,1946,0.001315410885678423
SIM,1827,44,45-49,1871,2
STAT,1837,40,45-49,1877,1.1759219592582755
SIM,1814,41,50-100,1855,1
STAT,1856,19,25-29,1875,4.880808677728418
SIM,1830,94,na,1924,15
SIM,1864,19,25-29,1883,5
SIM,1926,24,na,1950,4093
STAT,1941,23,25-29,1964,90.14730314238089
SIM,1885,26,35-39,1911,14
STAT,1886,35,45-49,1921,2.008213920062675
SIM,1789,78,na,1867,256
STAT,1894,39,na,1933,2831.4854466477636
STAT,1903,16,45-49,1919,0.08801903870207828
STAT,1771,114,na,1885,2.1552260335116623E-4
STAT,1889,41,20-24,1930,0.18605453144178793
SIM,1830,36,30-34,1866,7
STAT,1873,40,15-19,1913,0.013364907163454428
STAT,1906,17,40-44,1923,0.251657014299547
SIM,1834,84,na,1918,188
SIM,1905,35,30-34,1940,1
STAT,1831,29,35-39,1860,7.902238446197689
STAT,1826,69,na,1895,801.400338938423
STAT,1914,16,20-24,1930,26.55948699247975
STAT,1858,54,na,1912,1550.9551569532973
STAT,1879,18,50-100,1897,0.04831982512934731
STAT,1878,48,30-34,1926,0.0941041263300351
SIM,1847,57,na,1904,1527
STAT,1849,23,20-24,1872,62.028374138582166
STAT,1868,51,30-34,1919,0.005390954390164789
SIM,1844,29,na,1873,1739
SIM,1875,23,40-44,1898,2
STAT,1905,16,na,1921,3457.171082398102
STAT,1842,17,50-100,1859,0.04555976381103259
STAT,1863,30,45-49,1893,1.4572791626124502
SIM,1912,30,45-49,1942,1
SIM,1890,24,20-24,1914,83
STAT,1767,100,na,1867,0.18025105828619428
STAT,1812,100,na,1912,0.461165299484157
STAT,1867,37,na,1904,2089.935644579577
STAT,1854,64,na,1918,1243.769409615456
STAT,1880,36,20-24,1916,0.771410335486005
STAT,1805,81,na,1886,223.07249621001756
STAT,1882,24,20-24,1906,62.91462923329118
STAT,1912,28,20-24,1940,16.934407858207358
STAT,1850,53,25-29,1903,0.0024567581439668175
STAT,1901,46,45-49,1947,0.17653477333995135
STAT,1925,30,na,1955,4247.467366443123
SIM,1865,33,25-29,1898,12
SIM,1922,16,20-24,1938,141
STAT,1813,45,20-24,1858,0.033901877137518265
SIM,1855,103,na,1958,1
SIM,1912,35,50-100,1947,2
SIM,1841,66,na,1907,1057
SIM,1867,71,na,1938,1243
STAT,1920,31,40-44,1951,4.06588628229715
SIM,1838,29,25-29,1867,42
STAT,1834,53,40-44,1887,0.006567711000463186
SIM,1916,14,na,1930,3872
STAT,1827,50,30-34,1877,0.005469481714965789
STAT,1852,83,na,1935,287.8101162907669
STAT,1877,9,na,1886,2590.481583656877
SIM,1829,32,na,1861,1601
STAT,1807,62,na,1869,968.5358594945476
STAT,1940,22,50-100,1962,0.6332233774843224
STAT,1881,32,20-24,1913,2.466828980665814
STAT,1843,51,25-29,1894,0.002403887832778832
SIM,1905,19,25-29,1924,9
STAT,1857,33,25-29,1890,7.599160581979573
STAT,1895,40,35-39,1935,2.2526993776098725
SIM,1894,45,50-100,1939,2
SIM,1866,16,25-29,1882,5
SIM,1938,23,na,1961,3264
SIM,1939,25,30-34,1964,48
STAT,1889,25,15-19,1914,0.5327226042578219
STAT,1903,1,na,1904,3658.6029583188606
STAT,1870,32,45-49,1902,1.616106896688878
STAT,1893,34,50-100,1927,1.088289550115404
SIM,1845,24,40-44,1869,2
SIM,1823,67,na,1890,799
STAT,1960,3,na,1963,4838.901519243051
SIM,1912,38,40-44,1950,1
STAT,1862,38,25-29,1900,2.31404604303305
STAT,1932,30,20-24,1962,3.066622325067245
STAT,1829,97,na,1926,3.246099808322763
STAT,1902,42,45-49,1944,0.13839183599620822
SIM,1906,31,30-34,1937,17
STAT,1867,23,40-44,1890,1.842789222642426
SIM,1870,38,25-29,1908,4
SIM,1840,39,na,1879,1636
STAT,1782,101,na,1883,0.11692899689902499
STAT,1835,45,40-44,1880,0.1294890329616095
STAT,1837,24,40-44,1861,1.7450739124122925
SIM,1823,33,20-24,1856,5
SIM,1881,18,15-19,1899,7
STAT,1862,28,na,1890,1920.8537639926853
STAT,1873,18,15-19,1891,5.671081711360292
STAT,1887,18,45-49,1905,0.06884441914644691
STAT,1930,42,20-24,1972,0.021951002315894835
STAT,1876,53,45-49,1929,0.01393676455268401
SIM,1850,49,na,1899,1642
STAT,1859,53,45-49,1912,0.010736546765998152
SIM,1851,96,na,1947,4
STAT,1848,24,15-19,1872,2.942081699621974
SIM,1854,39,na,1893,1861
STAT,1884,29,na,1913,2211.471994514681
STAT,1814,41,20-24,1855,0.5880734388123372
STAT,1843,46,45-49,1889,0.16070807851129765
SIM,1917,22,45-49,1939,1
SIM,1941,28,50-100,1969,5
STAT,1788,84,na,1872,96.96492717907154
SIM,1924,43,na,1967,4173
STAT,1886,6,na,1892,2606.8984917468615
STAT,1852,49,20-24,1901,0.008518189507587478
STAT,1915,33,25-29,1948,8.855301686277063
STAT,1859,45,50-100,1904,0.1865053357275045
STAT,1904,45,15-19,1949,3.087937580835275E-4
STAT,1947,25,15-19,1972,0.755176679215986
STAT,1810,51,30-34,1861,0.019371352465658298
SIM,1917,41,na,1958,3633
STAT,1913,42,20-24,1955,0.016270233175757112
SIM,1910,29,na,1939,3377
SIM,1800,64,na,1864,798
STAT,1904,30,45-49,1934,2.3819713695058065
STAT,1819,87,na,1906,93.00494251402499
STAT,1899,15,30-34,1914,2.0726943952018586
SIM,1923,33,25-29,1956,11
SIM,1865,76,na,1941,779
STAT,1890,25,25-29,1915,49.18815496485719
STAT,1862,31,40-44,1893,3.5171611408725494
SIM,1793,77,na,1870,305
SIM,1882,88,na,1970,309
SIM,1856,24,15-19,1880,2
SIM,1834,39,na,1873,1593
STAT,1838,20,40-44,1858,1.8414069324271296
STAT,1834,30,na,1864,1757.1425865706387
STAT,1899,2,na,1901,3450.4373851327596
STAT,1909,22,45-49,1931,0.9879516445789692
SIM,1902,41,40-44,1943,1
SIM,1823,47,na,1870,1337
STAT,1879,41,50-100,1920,1.0494239596506747
STAT,1918,27,45-49,1945,1.7368962911646284
STAT,1760,107,na,1867,0.005993333009893743
SIM,1877,16,na,1893,2479
STAT,1913,43,30-34,1956,0.11759624208253051
STAT,1892,58,na,1950,2339.992838883152
STAT,1930,35,15-19,1965,0.02370340215405745
STAT,1823,34,25-29,1857,20.403204437206924
STAT,1946,20,50-100,1966,0.6922119256672423
SIM,1831,34,25-29,1865,15
SIM,1908,4,na,1912,3656
STAT,1820,40,35-39,1860,3.537818291200432
STAT,1831,43,15-19,1874,0.010060911290072819
SIM,1819,93,na,1912,11
SIM,1846,20,40-44,1866,2
STAT,1890,23,na,1913,2723.109804735462
STAT,1819,44,45-49,1863,2.9361266458043715
SIM,1857,23,20-24,1880,3
SIM,1858,6,na,1864,2373
STAT,1777,92,na,1869,9.483447941232216
SIM,1926,27,45-49,1953,4
STAT,1895,47,20-24,1942,0.00829782502822089
SIM,1898,24,20-24,1922,81
STAT,1907,24,35-39,1931,8.047361940889202
STAT,1805,53,na,1858,1185.87506130308
STAT,1869,31,25-29,1900,9.412231199098736
STAT,1910,42,35-39,1952,0.1797881384819695
SIM,1799,68,na,1867,711
SIM,1924,29,na,1953,4059
SIM,1929,28,40-44,1957,5
SIM,1953,6,na,1959,4443
SIM,1877,87,na,1964,344
SIM,1892,35,50-100,1927,1
STAT,1853,23,50-100,1876,0.3620225538899248
SIM,1909,12,na,1921,3675
SIM,1843,67,na,1910,1113
STAT,1924,24,35-39,1948,10.430214233202992
SIM,1883,7,na,1890,2425
SIM,1858,22,25-29,1880,52
STAT,1828,106,na,1934,0.006837959810582087
STAT,1899,30,25-29,1929,13.364624681549312
STAT,1881,66,na,1947,1495.771312522408
STAT,1840,34,25-29,1874,8.018818850981145
STAT,1879,21,40-44,1900,2.0668439038411432
STAT,1885,43,45-49,1928,1.3991211208377639
STAT,1876,46,40-44,1922,0.16756642670827132
STAT,1923,25,30-34,1948,42.78575224145221
SIM,1829,52,na,1881,1280
STAT,1848,40,20-24,1888,0.1209210662241822
SIM,1882,17,20-24,1899,13
STAT,1883,75,na,1958,1047.3295798831252
STAT,1930,37,na,1967,4635.7941289768305
STAT,1837,47,30-34,1884,0.06521481900213595
STAT,1874,17,20-24,1891,17.111993392654295
STAT,1913,35,15-19,1948,0.018073597987867035
SIM,1915,24,35-39,1939,13
SIM,1877,31,25-29,1908,8
STAT,1812,63,na,1875,940.5410913208634
SIM,1874,59,na,1933,1782
SIM,1930,33,30-34,1963,27
STAT,1887,57,na,1944,2123.5455238733816
STAT,1860,42,30-34,1902,0.8801468834179131
STAT,1872,44,15-19,1916,0.012909245636723972
STAT,1865,9,na,1874,2362.339672676037
SIM,1887,21,40-44,1908,1
SIM,1814,84,na,1898,108
STAT,1825,81,na,1906,287.4085875805518
STAT,1868,35,50-100,1903,1.1171259273359853
STAT,1818,52,45-49,1870,0.02970481285168398
SIM,1863,67,na,1930,1291
STAT,1801,91,na,1892,20.484805951079515
STAT,1778,113,na,1891,2.797978771046154E-4
SIM,1906,18,30-34,1924,2
STAT,1846,89,na,1935,77.91859707659039
STAT,1861,66,na,1927,1287.4213964318587
STAT,1879,46,25-29,1925,0.057120812995542114
STAT,1898,29,na,1927,3029.172190648221
STAT,1875,54,40-44,1929,0.009941390062838116
STAT,1909,32,50-100,1941,0.7453799063934329
SIM,1932,24,35-39,1956,17
STAT,1816,45,na,1861,1423.426977854838
STAT,1780,107,na,1887,0.0067217598078117
STAT,1853,40,30-34,1893,0.8788437325609633
STAT,1922,33,30-34,1955,16.74589684443715
STAT,1923,49,50-100,1972,0.2484894908241691
STAT,1952,18,na,1970,4165.570927580497
STAT,1862,15,35-39,1877,0.5136329479169474
STAT,1813,62,na,1875,930.7303264167988
SIM,1861,40,30-34,1901,3
SIM,1864,18,15-19,1882,3
STAT,1840,19,na,1859,1927.4720599693646
STAT,1931,26,35-39,1957,18.31909055410666
SIM,1938,29,30-34,1967,33
STAT,1797,67,na,1864,748.3448555932861
STAT,1882,30,15-19,1912,0.13188376502581384
STAT,1919,30,na,1949,3885.7138404911784
STAT,1921,38,40-44,1959,1.577464126665296
SIM,1836,30,25-29,1866,9
STAT,1919,41,45-49,1960,0.17062785132038297
STAT,1927,17,na,1944,4323.389062183608
SIM,1917,1,na,1918,4167
STAT,1822,39,35-39,1861,11.166788341090628
STAT,1835,51,35-39,1886,0.005695768913362309
STAT,1854,24,40-44,1878,1.7267295992247162
SIM,1869,58,na,1927,1796
STAT,1820,34,40-44,1854,12.951128175065872
STAT,1827,51,40-44,1878,0.009483332906089558
STAT,1877,49,25-29,1926,0.05526572280903898
STAT,1944,17,45-49,1961,0.5078494512699593
STAT,1815,52,50-100,1867,0.03263566841658489
STAT,1894,42,40-44,1936,0.18939417854159254
SIM,1932,38,na,1970,4713
SIM,1778,86,na,1864,56
STAT,1900,20,30-34,1920,23.482354738656593
STAT,1941,20,20-24,1961,108.63044582029077
STAT,1832,33,20-24,1865,2.1101225659661655
STAT,1850,50,20-24,1900,5.276517878436352E-4
STAT,1836,45,na,1881,1564.2410812356527
STAT,1908,26,50-100,1934,0.8995363690709233
STAT,1856,18,15-19,1874,5.141771705148331
SIM,1844,60,na,1904,1258
STAT,1887,15,40-44,1902,0.19416875423199784
STAT,1907,11,na,1918,3589.167241244345
SIM,1803,100,na,1903,1
SIM,1867,31,35-39,1898,11
SIM,1868,42,40-44,1910,6
STAT,1831,34,50-100,1865,0.712584775756976
STAT,1874,30,20-24,1904,2.6300275155106436
STAT,1929,27,20-24,1956,21.581042295010036
SIM,1892,44,40-44,1936,2
STAT,1940,25,30-34,1965,37.77853915718901
SIM,1901,46,na,1947,3013
STAT,1926,36,50-100,1962,0.48516753705044446
STAT,1900,22,25-29,1922,75.02062987950188
SIM,1922,19,25-29,1941,51
STAT,1885,4,na,1889,2615.759391327785
SIM,1867,57,na,1924,1942
STAT,1878,74,na,1952,1092.6097124582227
SIM,1871,30,45-49,1901,2
STAT,1859,31,35-39,1890,7.645562382392901
STAT,1864,28,15-19,1892,0.3806600795443228
STAT,1937,22,20-24,1959,102.29361771238311
STAT,1927,39,20-24,1966,0.3089546491481231
STAT,1895,21,25-29,1916,70.71647740318599
STAT,1914,19,25-29,1933,8.423230706378808
STAT,1805,51,20-24,1856,0.002763471032248229
STAT,1884,44,40-44,1928,2.070959186763266
STAT,1872,42,20-24,1914,0.15030234219509864
STAT,1828,30,25-29,1858,11.457943846099989
SIM,1849,52,na,1901,1634
SIM,1845,27,45-49,1872,1
SIM,1906,15,25-29,1921,8
STAT,1875,27,50-100,1902,0.6211506952333377
STAT,1895,48,30-34,1943,0.066404315942226
SIM,1827,51,na,1878,1288
STAT,1849,63,na,1912,1337.9926619944802
STAT,1836,44,45-49,1880,1.1237968735462929
SIM,1823,92,na,1915,17
SIM,1921,28,40-44,1949,8
SIM,1840,33,20-24,1873,1
STAT,1860,43,40-44,1903,1.7116372405722282
STAT,1913,28,40-44,1941,4.37216318120955
STAT,1857,52,50-100,1909,0.011192566856062292
STAT,1809,97,na,1906,2.1558385213155096
STAT,1936,22,na,1958,3298.1143529397837
SIM,1862,24,40-44,1886,1
STAT,1852,45,40-44,1897,0.1253550470586584
SIM,1844,44,45-49,1888,2
SIM,1895,21,na,1916,2988
SIM,1931,31,25-29,1962,15
SIM,1859,36,35-39,1895,10
STAT,1837,27,45-49,1864,0.9248825214822247
STAT,1933,30,50-100,1963,1.0537772594462267
SIM,1824,32,25-29,1856,8
SIM,1863,30,50-100,1893,3
STAT,1837,21,na,1858,1829.6095119379665
SIM,1830,39,35-39,1869,12
STAT,1864,18,50-100,1882,0.04242064406195162
STAT,1915,40,na,1955,3542.1655333179897
STAT,1883,23,25-29,1906,52.857813827327604
SIM,1830,49,na,1879,1411
SIM,1857,81,na,1938,337
STAT,1931,41,25-29,1972,0.09024977419788548
SIM,1874,23,20-24,1897,65
STAT,1947,18,40-44,1965,1.4880315932499533
STAT,1802,103,na,1905,0.05031560038625521
STAT,1878,40,35-39,1918,1.8007723980581753
STAT,1955,17,20-24,1972,170.0050686812953
STAT,1853,41,40-44,1894,1.7099454955621336
SIM,1950,18,50-100,1968,1
STAT,1855,18,na,1873,1928.7252096247796
STAT,1918,34,na,1952,3764.216896034036
STAT,1885,18,40-44,1903,0.1717782476107775
STAT,1923,35,40-44,1958,1.6414291385925666
SIM,1931,35,40-44,1966,2
SIM,1824,94,na,1918,6
SIM,1862,20,25-29,1882,59
SIM,1865,90,na,1955,54
STAT,1848,27,20-24,1875,10.40662852666413
STAT,1923,31,25-29,1954,10.050552969915902
SIM,1903,28,20-24,1931,21
SIM,1891,23,25-29,1914,76
SIM,1795,78,na,1873,290
STAT,1876,52,35-39,1928,0.008357752351670454
SIM,1856,27,20-24,1883,10
STAT,1839,87,na,1926,117.30085586876082
STAT,1836,48,25-29,1884,0.03853850941525789
STAT,1901,43,40-44,1944,0.20505028056977673
STAT,1864,41,50-100,1905,0.8935274677759525
SIM,1851,43,40-44,1894,5
STAT,1866,23,20-24,1889,60.100555405808166
SIM,1834,22,40-44,1856,2
STAT,1853,37,na,1890,1782.9944007071797
STAT,1831,26,30-34,1857,22.365243219809493
STAT,1913,45,25-29,1958,0.049143242896800284
SIM,1953,0,na,1953,4589
STAT,1842,28,na,1870,1923.427736483411
SIM,1836,34,40-44,1870,3
STAT,1769,100,na,1869,0.16168868232093747
STAT,1838,23,45-49,1861,0.603026712935299
SIM,1881,86,na,1967,317
SIM,1923,30,20-24,1953,2
STAT,1899,18,35-39,1917,0.7083897322661569
SIM,1853,31,40-44,1884,3
SIM,1892,78,na,1970,1481
STAT,1895,25,40-44,1920,3.71436224662114
STAT,1932,33,25-29,1965,11.59991929159469
SIM,1933,34,na,1967,4842
SIM,1886,41,45-49,1927,2
STAT,1838,38,15-19,1876,0.045021274449815685
STAT,1831,36,na,1867,1588.5217156353333
STAT,1847,44,20-24,1891,0.11552911626171117
STAT,1907,49,15-19,1956,3.0822762185712444E-4
SIM,1831,42,na,1873,1519
STAT,1951,17,50-100,1968,0.42147018710540085
STAT,1783,111,na,1894,1.603816681518712E-4
SIM,1914,24,15-19,1938,5
STAT,1824,88,na,1912,75.69636827530906
STAT,1886,45,50-100,1931,0.24753020159144104
STAT,1831,41,20-24,1872,0.11884576005661275
STAT,1911,48,25-29,1959,0.047310636310465955
STAT,1859,50,40-44,1909,0.008029390943919123
STAT,1867,51,na,1918,1919.166565377534
SIM,1927,23,15-19,1950,6
STAT,1854,20,25-29,1874,48.82323910866381
SIM,1852,20,35-39,1872,7
STAT,1925,20,35-39,1945,10.710678480109856
STAT,1816,90,na,1906,36.739837298676726
SIM,1865,48,na,1913,1960
STAT,1877,27,na,1904,2338.6368168634936
STAT,1878,41,45-49,1919,1.4801402027775559
STAT,1915,18,50-100,1933,0.07388411936550718
STAT,1850,31,15-19,1881,0.10611046088102784
STAT,1900,29,40-44,1929,3.8976421675278257
SIM,1886,40,35-39,1926,5
STAT,1924,40,50-100,1964,0.1323733102648384
STAT,1876,93,na,1969,111.92246635737109
SIM,1856,85,na,1941,184
SIM,1857,103,na,1960,1
SIM,1897,28,20-24,1925,15
STAT,1888,19,na,1907,2804.5869396085745
STAT,1899,17,25-29,1916,7.3350285236914985
STAT,1915,30,20-24,1945,2.365712775814628
STAT,1915,40,30-34,1955,0.12193311059238299
SIM,1777,81,na,1858,163
SIM,1919,32,20-24,1951,2
STAT,1828,34,40-44,1862,4.1894833143749475
SIM,1923,31,30-34,1954,22
STAT,1932,32,na,1964,4749.592547735744
STAT,1844,20,35-39,1864,5.13373956934969
SIM,1850,22,25-29,1872,48
STAT,1773,88,na,1861,36.60940401195175
STAT,1911,47,15-19,1958,3.29461715383786E-4
STAT,1849,18,na,1867,2106.2778717003293
STAT,1919,23,15-19,1942,5.489578991991002
STAT,1773,114,na,1887,2.553570041375807E-4
STAT,1841,49,45-49,1890,0.15930413686718345
STAT,1804,88,na,1892,45.9854057102752
STAT,1858,32,50-100,1890,0.6786461064701821
STAT,1880,23,50-100,1903,0.40487773451990244
STAT,1854,46,20-24,1900,0.008610197344939965
STAT,1877,26,35-39,1903,9.487767486419973
SIM,1947,16,25-29,1963,57
STAT,1862,34,45-49,1896,1.3964583408453224
STAT,1882,16,50-100,1898,0.04512013598876446
STAT,1930,20,45-49,1950,1.3697994196002252
STAT,1857,27,na,1884,1831.4762294094248
STAT,1868,52,40-44,1920,0.009438498968014693
STAT,1913,9,na,1922,3832.622702304928
STAT,1915,31,30-34,1946,15.220816888523313
STAT,1923,40,20-24,1963,0.019553668534850945
STAT,1871,33,50-100,1904,0.8558774637229724
SIM,1859,90,na,1949,47
SIM,1945,22,20-24,1967,106
STAT,1810,54,35-39,1864,0.026381771399227476
STAT,1827,82,na,1909,269.5128133015805
STAT,1854,47,30-34,1901,0.06893606153703853
SIM,1830,44,50-100,1874,4
STAT,1824,41,15-19,1865,0.01862837005286052
STAT,1882,51,50-100,1933,0.013941515214065274
STAT,1842,22,25-29,1864,52.28855514917508
SIM,1827,41,40-44,1868,3
STAT,1813,46,30-34,1859,0.26901404986913807
STAT,1885,21,35-39,1906,5.511531998666637
STAT,1869,35,40-44,1904,4.044292178175456
STAT,1822,44,50-100,1866,1.4567896339810222
STAT,1889,28,20-24,1917,13.633701971260377
SIM,1907,31,na,1938,3359
STAT,1814,64,na,1878,961.7961828803996
SIM,1838,43,na,1881,1603
STAT,1787,100,na,1887,0.21492019072521415
SIM,1933,20,35-39,1953,12
STAT,1941,21,30-34,1962,28.06834528483925
STAT,1901,26,na,1927,3166.6294027360814
SIM,1852,58,na,1910,1488
SIM,1893,40,40-44,1933,6
STAT,1844,17,40-44,1861,0.16147755832119684
STAT,1933,39,15-19,1972,0.024657056257007343
STAT,1803,72,na,1875,555.9382291231387
SIM,1841,86,na,1927,122
SIM,1894,32,40-44,1926,4
STAT,1836,25,35-39,1861,8.202544963497035
STAT,1870,47,15-19,1917,3.689759601723824E-4
STAT,1886,32,40-44,1918,4.327654454234354
STAT,1821,37,25-29,1858,6.082004939865001
STAT,1846,35,na,1881,1863.1083477759566
STAT,1819,41,40-44,1860,4.913970136969393
SIM,1937,27,20-24,1964,14
STAT,1845,50,na,1895,1545.538955078799
SIM,1888,17,20-24,1905,22
STAT,1890,40,15-19,1930,0.016110821185956314
SIM,1894,25,na,1919,3008
SIM,1786,95,na,1881,1
STAT,1880,37,30-34,1917,5.307912312220605
STAT,1885,76,na,1961,1070.3129459580734
STAT,1906,24,15-19,1930,4.510723917750496
STAT,1798,94,na,1892,5.6770152599332855
STAT,1885,56,na,1941,1920.608257026462
STAT,1904,23,50-100,1927,0.5508715341466133
STAT,1876,42,25-29,1918,0.6259767166413225
SIM,1878,31,45-49,1909,2
SIM,1880,27,30-34,1907,31
SIM,1857,33,50-100,1890,1
STAT,1941,30,30-34,1971,15.6444605354383
STAT,1858,17,35-39,1875,0.4747510371454561
STAT,1888,45,20-24,1933,0.013530945219719223
SIM,1841,16,20-24,1857,12
STAT,1863,17,45-49,1880,0.061794221418009755
SIM,1877,35,40-44,1912,8
SIM,1844,25,35-39,1869,9
STAT,1931,31,15-19,1962,0.1591602071997053
STAT,1829,63,na,1892,1078.1400706819218
STAT,1874,84,na,1958,402.57369263119125
STAT,1891,32,15-19,1923,0.16644341718654304
STAT,1879,24,45-49,1903,0.6852458298312971
STAT,1913,46,35-39,1959,0.11918140894918715
SIM,1810,74,na,1884,451
STAT,1809,51,25-29,1860,0.009714188991179247
STAT,1833,39,50-100,1872,0.922436008751855
SIM,1849,33,40-44,1882,6
STAT,1843,78,na,1921,527.7485963583063
SIM,1913,36,35-39,1949,5
SIM,1836,34,na,1870,1678
STAT,1844,53,35-39,1897,0.005883193125047414
STAT,1915,41,50-100,1956,0.11189761988634467
SIM,1796,71,na,1867,580
STAT,1905,36,35-39,1941,2.094635225746824
SIM,1934,19,na,1953,4562
STAT,1777,103,na,1880,0.0460379603600041
SIM,1848,18,30-34,1866,1
STAT,1870,57,na,1927,1862.4482084705126
STAT,1882,49,35-39,1931,0.12593466045045207
STAT,1931,40,15-19,1971,0.0019434402642709288
STAT,1912,18,na,1930,3679.992147596894
STAT,1897,19,15-19,1916,7.457398758747264
SIM,1887,24,45-49,1911,1
STAT,1910,18,45-49,1928,0.09326596861377
STAT,1885,40,40-44,1925,2.1393876803566543
STAT,1882,28,50-100,1910,0.5856265381723244
SIM,1864,60,na,1924,1706
STAT,1879,43,20-24,1922,0.15591148534720672
SIM,1882,33,25-29,1915,8
STAT,1816,54,35-39,1870,0.018705243768295743
STAT,1904,47,50-100,1951,0.18685276213937443
STAT,1845,15,35-39,1860,0.4965876512284188
STAT,1865,70,na,1935,1201.4049895311114
STAT,1883,45,35-39,1928,0.13096262463424294
STAT,1875,15,na,1890,2463.7948203353817
STAT,1872,45,25-29,1917,0.05512459318917952
SIM,1913,17,25-29,1930,5
STAT,1916,17,35-39,1933,0.8410366869584813
STAT,1827,54,45-49,1881,0.01120909196876322
STAT,1929,42,15-19,1971,0.0018787054364247985
SIM,1847,16,20-24,1863,15
SIM,1886,21,25-29,1907,61
STAT,1931,23,30-34,1954,35.105729723993335
STAT,1865,27,20-24,1892,10.045244982388509
STAT,1859,28,40-44,1887,2.274762735095352
SIM,1870,46,50-100,1916,1
SIM,1842,15,25-29,1857,8
SIM,1946,17,20-24,1963,138
STAT,1827,31,na,1858,1693.9347361454036
STAT,1905,17,25-29,1922,7.737885929148301
STAT,1894,33,45-49,1927,2.1081522941628745
SIM,1915,15,na,1930,3674
STAT,1851,107,na,1958,0.006702362863312271
STAT,1926,32,na,1958,4320.11916084248
SIM,1858,16,30-34,1874,1
STAT,1830,27,25-29,1857,42.394535920180665
STAT,1942,23,40-44,1965,3.329361611189671
STAT,1870,40,30-34,1910,1.0762189663872475
STAT,1805,54,25-29,1859,0.012490795902215296
SIM,1909,6,na,1915,3705
STAT,1820,49,50-100,1869,0.39997560648045105
SIM,1833,29,40-44,1862,3
SIM,1893,21,35-39,1914,5
STAT,1874,33,25-29,1907,9.844680779151956
STAT,1859,53,na,1912,1592.952458132217
SIM,1805,73,na,1878,479
SIM,1823,98,na,1921,1
STAT,1869,60,na,1929,1745.4307154745773
SIM,1895,52,na,1947,2702
STAT,1843,22,40-44,1865,1.7667028189491443
STAT,1880,17,45-49,1897,0.06505695992098331
STAT,1865,42,15-19,1907,0.011810331661952462
STAT,1920,35,20-24,1955,0.2731294356800164
SIM,1861,35,50-100,1896,1
SIM,1938,18,40-44,1956,1
STAT,1858,40,15-19,1898,0.01033189606556968
SIM,1826,30,35-39,1856,7
SIM,1835,42,45-49,1877,3
SIM,1879,15,20-24,1894,18
SIM,1827,46,50-100,1873,4
STAT,1900,23,35-39,1923,7.623792174079607
SIM,1885,45,na,1930,2181
STAT,1894,45,45-49,1939,0.16322996982149357
STAT,1916,25,na,1941,3683.99397511438
STAT,1854,27,45-49,1881,0.8327956887759767
STAT,1907,21,30-34,1928,24.79322585840403
STAT,1895,15,na,1910,3124.9852153255533
SIM,1881,52,na,1933,1674
SIM,1815,80,na,1895,335
STAT,1896,62,na,1958,2347.276133801329
STAT,1918,37,na,1955,3746.1726074294866
STAT,1825,29,40-44,1854,9.90935360464035
STAT,1874,18,30-34,1892,1.5344093743664062
STAT,1811,44,40-44,1855,7.867931306975277
STAT,1853,44,45-49,1897,1.117362824233648
SIM,1915,21,30-34,1936,35
SIM,1894,39,25-29,1933,3
SIM,1904,21,20-24,1925,84
STAT,1860,46,45-49,1906,0.18140988155508678
STAT,1939,16,25-29,1955,40.99019626189466
STAT,1826,100,na,1926,0.5797461950179592
STAT,1928,44,na,1972,4457.733671057027
STAT,1827,42,45-49,1869,1.4357064641343003
SIM,1845,20,25-29,1865,51
SIM,1859,100,na,1959,1
STAT,1949,21,35-39,1970,10.383333461870848
SIM,1867,28,40-44,1895,3
SIM,1851,22,40-44,1873,1
SIM,1889,15,15-19,1904,9
SIM,1900,61,na,1961,2607
STAT,1890,22,20-24,1912,79.59157480798179
STAT,1938,17,20-24,1955,126.34288172287872
STAT,1893,46,40-44,1939,0.1160232764712127
STAT,1839,37,20-24,1876,0.613316064530051
STAT,1901,71,na,1972,2168.9615692598086
STAT,1924,46,45-49,1970,0.24503702833332736
STAT,1904,35,50-100,1939,0.36249683221290097
SIM,1841,32,25-29,1873,12
SIM,1861,32,45-49,1893,6
STAT,1874,30,na,1904,2321.8377106773714
STAT,1903,38,25-29,1941,0.8311794311219042
SIM,1893,40,na,1933,2916
STAT,1886,39,25-29,1925,2.8442634923290666
SIM,1927,22,35-39,1949,10
STAT,1866,26,25-29,1892,36.984617217231815
SIM,1963,2,na,1965,4694
STAT,1823,31,20-24,1854,8.192419743768738
STAT,1917,43,35-39,1960,0.19820980675227548
SIM,1902,42,na,1944,3076
STAT,1859,16,40-44,1875,0.16058129988144057
STAT,1936,29,20-24,1965,16.486388011254267
SIM,1878,18,na,1896,2558
STAT,1804,103,na,1907,0.048072726216651394
STAT,1839,16,20-24,1855,15.532341606275532
STAT,1833,53,25-29,1886,0.002195807604385649
SIM,1887,23,na,1910,2443
SIM,1839,93,na,1932,11
STAT,1922,44,20-24,1966,0.01908574783306343
SIM,1829,86,na,1915,111
STAT,1925,29,45-49,1954,1.9138281563650592
SIM,1899,17,30-34,1916,1
SIM,1831,31,20-24,1862,2
STAT,1898,40,na,1938,2994.855849292445
SIM,1935,17,45-49,1952,1
STAT,1828,37,45-49,1865,1.8199574391467945
SIM,1855,38,na,1893,1877
STAT,1835,49,20-24,1884,0.007846859824943823
STAT,1837,20,25-29,1857,50.52765355376923
SIM,1858,41,35-39,1899,2
SIM,1872,27,na,1899,2254
STAT,1871,46,20-24,1917,0.011288828363192805
SIM,1908,33,na,1941,3317
SIM,1870,34,45-49,1904,1
STAT,1843,43,40-44,1886,1.5443430632260007
STAT,1943,22,45-49,1965,1.1308963497602724
STAT,1823,43,20-24,1866,0.20612709050961522
SIM,1854,53,na,1907,1712
SIM,1821,45,50-100,1866,1
SIM,1807,51,na,1858,1191
STAT,1869,63,na,1932,1632.9764222203278
STAT,1912,12,na,1924,3772.7886625073124
SIM,1933,29,45-49,1962,1
STAT,1927,17,45-49,1944,0.5867567480310175
SIM,1870,15,na,1885,2372
STAT,1913,0,na,1913,4337.364674969336
SIM,1929,39,30-34,1968,5
STAT,1867,82,na,1949,413.8950348290062
STAT,1933,28,50-100,1961,1.2479262802665825
STAT,1902,28,50-100,1930,0.8498559419626617
SIM,1868,26,35-39,1894,13
STAT,1822,32,15-19,1854,0.41523956282952806
SIM,1934,22,45-49,1956,2
STAT,1895,28,45-49,1923,1.3626344642721961
STAT,1910,31,na,1941,3459.2070346723704
STAT,1921,18,20-24,1939,145.60831043957302
STAT,1904,18,20-24,1922,23.960219254490006
SIM,1819,37,45-49,1856,5
STAT,1911,41,40-44,1952,0.2268344011619674
STAT,1858,36,45-49,1894,1.483645332204904
STAT,1861,97,na,1958,6.571789841562358
SIM,1825,32,40-44,1857,6
STAT,1851,19,40-44,1870,0.15808623016572992
STAT,1873,34,20-24,1907,2.567666524939455
SIM,1767,91,na,1858,12
STAT,1769,109,na,1878,0.0024100705913240534
STAT,1857,30,20-24,1887,2.0688999677200783
SIM,1840,43,30-34,1883,5
STAT,1878,28,45-49,1906,1.0892685265921502
SIM,1892,23,40-44,1915,2
STAT,1884,23,40-44,1907,1.9388523335984598
SIM,1805,70,na,1875,638
STAT,1880,44,50-100,1924,1.0379551167062586
STAT,1915,18,30-34,1933,2.4036971720540965
STAT,1899,41,15-19,1940,0.0012469266741810877
SIM,1903,22,15-19,1925,4
STAT,1936,4,na,1940,3650.4152890591163
STAT,1921,33,15-19,1954,0.13452620109375046
STAT,1863,51,45-49,1914,0.012088606157385183
SIM,1909,27,45-49,1936,1
SIM,1869,38,na,1907,2163
STAT,1915,34,35-39,1949,8.717238780258006
SIM,1876,35,50-100,1911,2
SIM,1881,34,20-24,1915,2
STAT,1926,22,45-49,1948,1.2913144333206836
SIM,1853,38,25-29,1891,1
STAT,1939,29,50-100,1968,0.9443573433326125
STAT,1849,21,50-100,1870,0.37238176261907163
STAT,1919,22,35-39,1941,9.740341812510785
SIM,1836,37,45-49,1873,3
SIM,1836,31,na,1867,1736
STAT,1831,44,25-29,1875,0.46159992458705723
SIM,1839,24,15-19,1863,6
SIM,1887,41,50-100,1928,3
SIM,1912,18,20-24,1930,35
STAT,1806,53,30-34,1859,0.020535974695572702
STAT,1813,49,35-39,1862,0.37043953137516145
SIM,1849,38,na,1887,1813
SIM,1924,33,40-44,1957,4
STAT,1848,106,na,1954,0.009021980095657751
STAT,1821,33,45-49,1854,5.467245373889183
SIM,1913,33,30-34,1946,23
SIM,1940,18,30-34,1958,13
STAT,1852,51,35-39,1903,0.006271312576199886
SIM,1807,54,na,1861,1121
SIM,1923,34,35-39,1957,11
STAT,1932,18,30-34,1950,15.207081661106802
SIM,1928,28,25-29,1956,71
STAT,1814,98,na,1912,1.4931140739461473
SIM,1854,50,na,1904,1770
STAT,1821,46,na,1867,1401.71470311473
STAT,1901,3,na,1904,3495.7978795139124
STAT,1863,75,na,1938,853.4418634348142
STAT,1905,45,30-34,1950,0.07530378313275166
SIM,1847,71,na,1918,959
STAT,1898,15,15-19,1913,7.6220956628369745
STAT,1860,49,15-19,1909,3.002019626078818E-4
STAT,1898,43,na,1941,2943.5204946895265
SIM,1904,20,na,1924,3269
STAT,1895,44,50-100,1939,0.08913318053131586
SIM,1872,32,20-24,1904,2
STAT,1914,44,na,1958,3465.064087277546
STAT,1916,33,40-44,1949,3.8006719796609367
SIM,1930,29,na,1959,4481
SIM,1931,22,na,1953,4442
STAT,1913,34,50-100,1947,0.7704792436686146
SIM,1886,28,45-49,1914,2
SIM,1865,30,20-24,1895,2
STAT,1859,70,na,1929,1054.9581956896452
SIM,1816,68,na,1884,770
STAT,1872,20,45-49,1892,0.6647085697329541
SIM,1931,4,na,1935,4956
STAT,1770,91,na,1861,12.728232481829705
STAT,1899,28,na,1927,3078.2483821369765
STAT,1841,45,30-34,1886,0.06877754141454974
STAT,1941,24,35-39,1965,9.186183138417773
STAT,1906,43,25-29,1949,0.060912051451522606
STAT,1817,53,40-44,1870,0.022291359974270498
STAT,1848,16,na,1864,2126.929437152305
SIM,1922,35,30-34,1957,1
STAT,1905,33,30-34,1938,13.631816917012088
STAT,1858,103,na,1961,0.3038814402953183
STAT,1868,43,45-49,1911,1.3392400576450934
SIM,1788,76,na,1864,354
SIM,1858,97,na,1955,1
STAT,1912,43,15-19,1955,0.0013908581628650043
STAT,1830,45,20-24,1875,0.00922738890613594
STAT,1930,24,25-29,1954,111.08494996810043
STAT,1873,44,30-34,1917,1.0866454030528474
STAT,1874,54,25-29,1928,0.00332481805598739
SIM,1876,43,45-49,1919,2
STAT,1917,32,45-49,1949,1.5566661534599424
SIM,1896,37,na,1933,2953
SIM,1925,32,45-49,1957,1
STAT,1951,19,45-49,1970,0.5615837990462685
SIM,1787,91,na,1878,7
STAT,1812,83,na,1895,172.44617528196872
STAT,1842,44,35-39,1886,1.3224206118577764
SIM,1923,18,30-34,1941,23
SIM,1850,44,35-39,1894,1
STAT,1860,27,50-100,1887,0.4955841401558674
STAT,1869,38,45-49,1907,1.8153688879815166
SIM,1890,15,na,1905,3183
SIM,1830,40,na,1870,1593
STAT,1931,35,30-34,1966,2.2841744749578674
SIM,1803,92,na,1895,11
STAT,1902,2,na,1904,3553.941629230125
STAT,1853,68,na,1921,1156.533987113973
STAT,1832,43,30-34,1875,0.8392647691065092
SIM,1812,46,50-100,1858,5
STAT,1841,97,na,1938,3.7036878894803817
STAT,1882,46,30-34,1928,0.08918414074218242
STAT,1899,37,45-49,1936,0.5569511764191365
STAT,1914,35,30-34,1949,1.7354570108057878
STAT,1926,37,15-19,1963,0.02217042434272491
STAT,1956,15,15-19,1971,56.7532856051576
SIM,1877,38,45-49,1915,1
STAT,1906,28,30-34,1934,34.52591122176575
STAT,1921,45,15-19,1966,3.941481262191204E-4
SIM,1831,25,na,1856,1761
STAT,1877,45,45-49,1922,0.23357018613924468
SIM,1838,46,na,1884,1550
SIM,1908,32,45-49,1940,2
SIM,1834,53,na,1887,1315
STAT,1870,43,35-39,1913,1.6660692216011175
SIM,1818,46,na,1864,1349
STAT,1902,32,35-39,1934,13.50172276340406
STAT,1854,30,na,1884,1785.1402817732494
SIM,1939,28,na,1967,3497
STAT,1858,23,na,1881,1815.8617272434028
SIM,1889,58,na,1947,2339
SIM,1849,47,50-100,1896,1
STAT,1844,23,na,1867,1840.7823907601212
STAT,1898,31,20-24,1929,3.4697652418134366
STAT,1900,41,30-34,1941,0.10509794582513225
SIM,1841,32,na,1873,1705
STAT,1803,52,35-39,1855,0.025085563164075002
SIM,1798,83,na,1881,112
SIM,1924,17,35-39,1941,5
SIM,1794,90,na,1884,18
SIM,1910,32,35-39,1942,6
STAT,1924,29,50-100,1953,1.08697526397874
SIM,1859,8,na,1867,2294
STAT,1811,50,35-39,1861,0.02852878694419779
STAT,1911,26,15-19,1937,0.6526361520586098
SIM,1894,59,na,1953,2431
SIM,1836,19,15-19,1855,6
STAT,1946,18,25-29,1964,45.39262716617729
STAT,1855,45,25-29,1900,0.04134017174913331
STAT,1850,57,na,1907,1416.635885389785
STAT,1863,78,na,1941,647.7383235562193
SIM,1852,42,45-49,1894,6
SIM,1847,19,25-29,1866,4
STAT,1936,27,30-34,1963,35.42356969089321
STAT,1887,19,20-24,1906,18.63299707052009
STAT,1896,43,20-24,1939,0.013660454658614386
STAT,1898,19,30-34,1917,2.0267065359185175
SIM,1806,58,na,1864,1064
SIM,1944,27,30-34,1971,40
SIM,1878,66,na,1944,1622
STAT,1816,76,na,1892,441.491701970843
STAT,1849,60,na,1909,1430.1330120550033
SIM,1907,17,35-39,1924,2
STAT,1901,22,40-44,1923,2.7555076116397568
STAT,1908,29,45-49,1937,1.53184638408013
SIM,1857,100,na,1957,3
STAT,1847,54,30-34,1901,0.0042687460376167365
STAT,1866,45,35-39,1911,0.12320112279225327
STAT,1936,25,na,1961,3389.708865324143
SIM,1828,28,20-24,1856,10
STAT,1838,23,na,1861,1848.9515029983731
STAT,1876,31,35-39,1907,9.924457567093889
SIM,1865,45,na,1910,2015
STAT,1785,90,na,1875,30.333548618020025
STAT,1791,76,na,1867,351.9952436143232
STAT,1839,19,25-29,1858,4.877529463207014
STAT,1894,48,15-19,1942,2.7048783359642564E-4
STAT,1824,30,50-100,1854,3.1635464569652125
SIM,1921,46,50-100,1967,5
STAT,1868,40,40-44,1908,2.0478239072328877
SIM,1946,21,na,1967,3707
STAT,1806,69,na,1875,720.2065088054363
STAT,1837,43,15-19,1880,0.01044136413308015
STAT,1913,46,50-100,1959,0.2090782424931519
SIM,1883,16,25-29,1899,6
STAT,1843,25,45-49,1868,0.9363457594989196
STAT,1844,50,30-34,1894,0.004193596616365587
STAT,1920,38,25-29,1958,1.0173728667750845
SIM,1854,30,45-49,1884,2
STAT,1882,42,15-19,1924,0.0126716824770579
STAT,1858,54,40-44,1912,0.00758320512631601
STAT,1891,17,20-24,1908,20.720774861774732
SIM,1948,15,30-34,1963,17
STAT,1894,30,40-44,1924,5.3073090682937085
SIM,1867,26,na,1893,2300
STAT,1851,52,30-34,1903,0.00425912968720216
STAT,1881,48,50-100,1929,0.22131987756072008
STAT,1893,42,25-29,1935,0.7683747247206214
STAT,1848,43,25-29,1891,0.473713040292423
STAT,1875,16,25-29,1891,5.515990644472026
STAT,1931,38,35-39,1969,3.0230462440772174
STAT,1757,103,na,1860,0.056461722727128225
STAT,1934,19,45-49,1953,0.6348855257815613
STAT,1884,30,15-19,1914,0.13398039796003752
SIM,1832,26,20-24,1858,7
STAT,1870,71,na,1941,1237.0415331507597
SIM,1839,28,30-34,1867,27
STAT,1864,44,20-24,1908,0.13191117534142843
SIM,1888,73,na,1961,1500
STAT,1826,51,25-29,1877,0.003217709914417951
STAT,1865,56,na,1921,1746.469626925109
STAT,1844,24,50-100,1868,0.34855901502423337
SIM,1846,72,na,1918,868
SIM,1919,16,15-19,1935,44
STAT,1868,18,40-44,1886,0.16685452980595855
SIM,1879,18,25-29,1897,10
STAT,1917,40,30-34,1957,0.12639050161354407
STAT,1851,51,50-100,1902,0.010916036906430152
SIM,1836,45,50-100,1881,1
STAT,1828,45,50-100,1873,0.204189852854619
STAT,1846,30,45-49,1876,1.560550165447924
STAT,1878,44,15-19,1922,0.01341254041896357
SIM,1836,65,na,1901,1053
STAT,1924,4,na,1928,4540.501624984999
SIM,1887,26,na,1913,2501
SIM,1881,6,na,1887,2047
STAT,1923,47,40-44,1970,0.17423543818831727
SIM,1878,42,50-100,1920,1
STAT,1890,77,na,1967,1355.9398563501256
SIM,1854,18,20-24,1872,12
SIM,1870,31,40-44,1901,5
SIM,1921,21,20-24,1942,110
SIM,1910,20,na,1930,3435
SIM,1884,31,35-39,1915,10
SIM,1916,29,45-49,1945,1
STAT,1933,33,40-44,1966,4.978949680180879
STAT,1861,39,20-24,1900,0.5993978837986031
STAT,1845,38,25-29,1883,2.1185674094442444
SIM,1916,20,35-39,1936,11
STAT,1881,35,25-29,1916,2.6525284492899575
SIM,1852,27,na,1879,1929
SIM,1878,63,na,1941,1761
SIM,1905,16,20-24,1921,26
STAT,1852,41,25-29,1893,0.46766155151159267
SIM,1906,34,35-39,1940,10
STAT,1878,21,25-29,1899,56.529638113841436
SIM,1873,27,20-24,1900,10
STAT,1833,50,20-24,1883,4.8546335640639403E-4
STAT,1923,43,25-29,1966,0.07872139782964509
STAT,1847,82,na,1929,344.0612630110373
SIM,1850,40,50-100,1890,1
SIM,1895,19,20-24,1914,19
STAT,1855,42,20-24,1897,0.11271783211748115
STAT,1913,21,20-24,1934,102.10036139337157
SIM,1840,17,15-19,1857,7
SIM,1920,6,na,1926,4306
STAT,1842,40,50-100,1882,0.8120855460660907
STAT,1835,49,na,1884,1471.1497841823275
STAT,1901,47,20-24,1948,0.008909201689057643
STAT,1921,30,45-49,1951,1.6675898838215684
SIM,1817,40,35-39,1857,2
STAT,1814,44,25-29,1858,2.068111418060844
STAT,1911,44,45-49,1955,0.1482247988450427
STAT,1852,38,na,1890,1699.5791398727574
STAT,1885,22,na,1907,2227.032813760626
SIM,1908,7,na,1915,3626
STAT,1822,50,45-49,1872,0.019542635724041534
SIM,1794,79,na,1873,243
STAT,1849,26,25-29,1875,37.87358765468202
STAT,1903,35,20-24,1938,0.2257652910393285
STAT,1844,42,45-49,1886,1.0645723312474336
STAT,1939,32,30-34,1971,15.186309219008098
STAT,1832,83,na,1915,239.1455269038511
STAT,1905,48,35-39,1953,0.10648040293969348
SIM,1852,72,na,1924,914
STAT,1784,94,na,1878,3.8447742564745866
STAT,1890,34,20-24,1924,3.095211642141569
SIM,1882,37,40-44,1919,5
STAT,1821,91,na,1912,30.872632666172358
STAT,1876,11,na,1887,2546.913053769365
SIM,1870,5,na,1875,2561
SIM,1894,16,35-39,1910,1
STAT,1825,50,na,1875,1319.2491588215019
SIM,1863,64,na,1927,1423
STAT,1789,100,na,1889,0.20119555135184064
SIM,1868,23,30-34,1891,16
STAT,1888,29,15-19,1917,0.5029150878533478
STAT,1867,52,25-29,1919,0.003125315201118662
STAT,1928,32,20-24,1960,2.8811599807690214
SIM,1939,28,35-39,1967,13
SIM,1886,25,40-44,1911,3
SIM,1871,37,30-34,1908,10
STAT,1861,20,35-39,1881,4.777364510956214
SIM,1914,19,na,1933,3767
SIM,1869,41,45-49,1910,1
STAT,1819,48,25-29,1867,0.1075054338716479
STAT,1800,54,40-44,1854,0.029469744202106882
SIM,1944,23,15-19,1967,4
SIM,1857,26,25-29,1883,36
SIM,1892,40,25-29,1932,4
SIM,1928,33,na,1961,4452
SIM,1890,12,na,1902,3231
STAT,1833,32,25-29,1865,8.091230408563732
SIM,1930,36,35-39,1966,10
SIM,1825,35,45-49,1860,1
STAT,1878,25,40-44,1903,2.969202671508468
STAT,1936,23,15-19,1959,4.806037469841083
STAT,1824,49,45-49,1873,0.27964483255393074
STAT,1825,41,30-34,1866,1.2808350442643888
SIM,1845,79,na,1924,450
SIM,1876,85,na,1961,377
STAT,1883,20,20-24,1903,64.20850529820778
STAT,1850,16,20-24,1866,15.361929783861811
STAT,1900,44,35-39,1944,0.1625671364932401
STAT,1836,42,na,1878,1619.6186886336036
STAT,1940,31,25-29,1971,9.041925065878964
SIM,1940,30,20-24,1970,3
STAT,1874,37,40-44,1911,4.225268156036394
STAT,1897,28,50-100,1925,0.8053313131399222
STAT,1921,16,30-34,1937,13.157422431454933
SIM,1918,26,na,1944,3784
STAT,1869,50,35-39,1919,0.007992143536204931
STAT,1940,21,15-19,1961,5.124467608408883
STAT,1834,64,na,1898,1077.7299214865984
SIM,1954,8,na,1962,4486
STAT,1836,41,40-44,1877,1.7551139450985802
STAT,1775,80,na,1855,217.38723
STAT,1914,45,40-44,1959,0.1484145231473519
SIM,1913,34,na,1947,3397
STAT,1803,58,na,1861,1015.0562707246197
SIM,1929,18,na,1947,4429
STAT,1888,29,50-100,1917,0.7090790233113479
SIM,1891,20,20-24,1911,80
STAT,1907,46,45-49,1953,0.1852638880657008
STAT,1840,21,50-100,1861,0.3427886131868923
SIM,1866,20,50-100,1886,1
STAT,1863,33,15-19,1896,0.11756021764180435
STAT,1858,50,25-29,1908,0.0026612041712256855
STAT,1932,40,30-34,1972,0.16414217568277217
SIM,1870,12,na,1882,2430
STAT,1905,30,na,1935,3284.686604697401
STAT,1908,20,35-39,1928,8.226589925001438
STAT,1851,31,30-34,1882,13.208659712353475
SIM,1829,83,na,1912,219
SIM,1903,27,na,1930,3210
STAT,1858,33,40-44,1891,3.1985703978373476
STAT,1812,46,15-19,1858,0.00136164672275343
SIM,1896,29,50-100,1925,1
STAT,1780,104,na,1884,0.027312803215021143
STAT,1858,20,50-100,1878,0.35158211085148267
STAT,1846,18,20-24,1864,16.4209084242856
SIM,1841,35,na,1876,1695
SIM,1866,33,40-44,1899,3
STAT,1890,47,50-100,1937,0.1592616758477937
STAT,1768,87,na,1855,36.418499999999995
STAT,1878,77,na,1955,851.0118745969518
STAT,1848,39,50-100,1887,0.9208040229962384
SIM,1876,40,40-44,1916,6
SIM,1898,18,na,1916,3162
SIM,1844,41,40-44,1885,5
STAT,1836,90,na,1926,51.05451552883097
STAT,1871,45,50-100,1916,0.23268745142608405
STAT,1840,31,20-24,1871,2.1831535053081264
STAT,1861,12,na,1873,2155.261474512016
SIM,1895,31,45-49,1926,2
STAT,1841,41,15-19,1882,0.01002072229384631
SIM,1833,41,30-34,1874,3
SIM,1894,33,50-100,1927,1
SIM,1790,80,na,1870,194
STAT,1889,69,na,1958,1793.491581572437
STAT,1857,18,30-34,1875,1.387535971283718
STAT,1855,49,na,1904,1565.4152171351143
STAT,1906,40,20-24,1946,0.015326993695420723
STAT,1922,36,35-39,1958,2.602378402585166
SIM,1898,27,25-29,1925,53
STAT,1892,32,30-34,1924,20.659216078164434
STAT,1924,21,30-34,1945,32.13458759961874
STAT,1838,54,20-24,1892,4.817910343218045E-4
STAT,1890,47,35-39,1937,0.0907843431856401
SIM,1843,30,35-39,1873,12
SIM,1872,78,na,1950,665
SIM,1871,93,na,1964,62
STAT,1799,93,na,1892,9.33026727381171
STAT,1884,40,25-29,1924,0.6053860039784855
SIM,1922,48,na,1970,3962
SIM,1801,66,na,1867,757
SIM,1941,0,na,1941,3978
STAT,1806,109,na,1915,2.467224767604951E-4
STAT,1810,51,na,1861,1171.3830580848385
STAT,1853,47,15-19,1900,3.0130690890136356E-4
STAT,1889,44,25-29,1933,0.7388097663783907
SIM,1885,11,na,1896,2490
STAT,1847,28,15-19,1875,0.3992410155358889
SIM,1849,17,35-39,1866,2
STAT,1886,33,50-100,1919,0.9104724807225675
SIM,1800,81,na,1881,149
SIM,1932,21,30-34,1953,45
STAT,1932,18,na,1950,4592.214758802927
STAT,1931,33,na,1964,4678.6680193264865
SIM,1865,18,30-34,1883,1
STAT,1930,28,40-44,1958,5.596140344097822
SIM,1885,42,40-44,1927,6
STAT,1862,34,50-100,1896,0.7337323440504372
STAT,1921,26,na,1947,3957.7141740670695
STAT,1887,31,45-49,1918,1.8501998442320158
STAT,1818,57,na,1875,1155.049815142711
STAT,1914,31,15-19,1945,0.12270136265444587
STAT,1886,16,35-39,1902,0.5489073782532203
STAT,1919,49,40-44,1968,0.16060232578027636
STAT,1850,39,45-49,1889,1.398168399004572
STAT,1899,34,40-44,1933,5.565397303665919
SIM,1843,13,na,1856,2211
SIM,1936,32,20-24,1968,1
STAT,1863,37,30-34,1900,4.418312142905388
SIM,1888,38,20-24,1926,3
SIM,1903,26,30-34,1929,38
STAT,1874,51,20-24,1925,7.156649393941778E-4
STAT,1829,52,20-24,1881,5.301773929864285E-4
SIM,1887,77,na,1964,1140
STAT,1901,0,na,1901,3882.84060762659
STAT,1826,35,na,1861,1580.7297178238762
STAT,1860,50,50-100,1910,0.011742761406358136
STAT,1835,30,35-39,1865,8.37816403524023
SIM,1911,56,na,1967,3123
SIM,1818,91,na,1909,39
STAT,1912,47,30-34,1959,0.08093773750435491
SIM,1918,0,na,1918,4288
SIM,1858,19,35-39,1877,2
SIM,1861,86,na,1947,149
STAT,1823,72,na,1895,675.8775441803477
SIM,1883,19,na,1902,2357
STAT,1947,17,na,1964,3917.051108692704
SIM,1816,65,na,1881,861
STAT,1869,15,50-100,1884,0.045997990238083576
STAT,1820,38,20-24,1858,1.668170022105182
STAT,1851,16,50-100,1867,0.04310164464859911
SIM,1828,40,45-49,1868,3
STAT,1838,17,50-100,1855,0.04344601572663278
STAT,1887,66,na,1953,1731.9162860884674
SIM,1865,32,20-24,1897,2
STAT,1906,18,30-34,1924,2.1872653482690634
STAT,1846,68,na,1914,1133.4699383806376
STAT,1860,52,50-100,1912,0.011514776480418713
STAT,1898,20,15-19,1918,4.242701229921036
SIM,1859,21,40-44,1880,1
SIM,1862,31,40-44,1893,8
STAT,1842,38,45-49,1880,1.6760138185728437
SIM,1876,30,30-34,1906,23
STAT,1827,48,20-24,1875,0.010831640635326146
SIM,1845,34,45-49,1879,2
STAT,1824,47,40-44,1871,0.20870370815767308
STAT,1850,73,na,1923,837.2746236236262
STAT,1891,71,na,1962,1750.1916347233064
SIM,1954,15,20-24,1969,147
STAT,1845,48,50-100,1893,0.1716099197179261
STAT,1849,23,50-100,1872,0.3670535576814411
STAT,1838,27,15-19,1865,0.387466570138517
STAT,1951,19,20-24,1970,152.41387370593216
STAT,1902,30,30-34,1932,23.46495472557024
STAT,1822,35,50-100,1857,2.3934251505679223
STAT,1824,41,na,1865,1534.7018884723286
STAT,1857,5,na,1862,2202.0002390534155
STAT,1948,23,30-34,1971,31.166132566374696
STAT,1900,22,20-24,1922,90.31013124377876
STAT,1887,40,50-100,1927,1.127600356588804
SIM,1827,58,na,1885,1123
STAT,1821,47,50-100,1868,0.3874202547138721
SIM,1874,36,na,1910,2215
STAT,1803,95,na,1898,4.469199416608333
STAT,1930,34,25-29,1964,11.25351743293145
STAT,1911,49,na,1960,3266.4916955089066
STAT,1857,32,20-24,1889,2.0263772644267473
STAT,1828,55,na,1883,1224.4810583345738
STAT,1920,21,35-39,1941,9.918705451837939
SIM,1914,18,30-34,1932,2
STAT,1878,28,50-100,1906,0.6275734722377188
STAT,1915,43,50-100,1958,0.11155994366375264
STAT,1847,25,15-19,1872,0.40796565185845646
STAT,1926,45,15-19,1971,4.313963959236384E-4
STAT,1836,23,50-100,1859,0.3460094800517047
STAT,1846,32,45-49,1878,1.5284757236213196
STAT,1854,31,40-44,1885,3.210677875531281
STAT,1923,44,35-39,1967,0.2215974012451846
SIM,1939,26,35-39,1965,16
STAT,1889,35,20-24,1924,0.9075442352797235
STAT,1898,28,25-29,1926,53.88860788352728
SIM,1840,24,na,1864,1786
STAT,1844,24,35-39,1868,4.987878921198869
SIM,1907,20,30-34,1927,27
STAT,1861,21,30-34,1882,14.477777434991602
STAT,1830,45,15-19,1875,3.075793596472466E-4
STAT,1940,19,45-49,1959,0.47882993767302906
SIM,1921,31,45-49,1952,2
STAT,1873,54,25-29,1927,0.003300330562744034
STAT,1914,24,15-19,1938,5.105628106288011
STAT,1941,26,25-29,1967,64.35216020954418
SIM,1760,101,na,1861,1
SIM,1922,24,15-19,1946,6
STAT,1862,46,50-100,1908,0.19893889710815327
STAT,1891,38,40-44,1929,5.090966088819396
SIM,1962,0,na,1962,4643
STAT,1837,34,45-49,1871,1.3898157388554544
STAT,1918,39,30-34,1957,1.8109434681385859
SIM,1886,21,na,1907,2329
SIM,1926,39,30-34,1965,1
STAT,1876,34,50-100,1910,0.8866037591020456
SIM,1852,24,35-39,1876,4
STAT,1832,60,na,1892,1148.8877305576925
SIM,1830,39,30-34,1869,3
SIM,1897,35,20-24,1932,4
STAT,1967,0,na,1967,4673.204563418638
STAT,1832,53,50-100,1885,0.009308224792243707
STAT,1822,39,30-34,1861,8.414382559146016
STAT,1919,13,na,1932,4130.060220611213
STAT,1831,37,30-34,1868,4.08599706747229
STAT,1900,44,40-44,1944,0.20193038980786143
STAT,1829,72,na,1901,763.0860063638952
SIM,1915,34,25-29,1949,11
SIM,1824,77,na,1901,403
STAT,1922,28,40-44,1950,4.965018107340991
SIM,1912,19,35-39,1931,2
STAT,1879,16,20-24,1895,17.574326595361825
SIM,1932,31,20-24,1963,1
SIM,1909,23,45-49,1932,2
STAT,1850,37,40-44,1887,3.13466951826044
SIM,1854,32,45-49,1886,1
SIM,1903,66,na,1969,2495
SIM,1912,33,45-49,1945,1
STAT,1837,91,na,1928,37.6072016573708
STAT,1833,45,40-44,1878,0.1262358947473493
STAT,1807,107,na,1914,0.0017540905056525019
STAT,1843,49,50-100,1892,0.16242605840519939
STAT,1909,42,35-39,1951,0.17793603302260375
SIM,1849,69,na,1918,1099
STAT,1883,39,45-49,1922,1.827810900482572
STAT,1782,84,na,1866,89.8327524773922
STAT,1907,28,na,1935,3300.1866536678995
STAT,1903,14,na,1917,3460.047581169166
SIM,1795,63,na,1858,858
STAT,1917,19,45-49,1936,0.5034582628160824
STAT,1863,24,45-49,1887,0.5811759466819117
STAT,1879,28,15-19,1907,0.4470750171236035
STAT,1816,48,45-49,1864,0.5485484724305169
STAT,1853,22,na,1875,1911.8849707910983
SIM,1920,30,na,1950,3973
STAT,1808,94,na,1902,7.727721341420371
STAT,1882,19,na,1901,2307.869790361162
STAT,1918,48,50-100,1966,0.2267491428519672
STAT,1858,53,na,1911,1569.205011233948
SIM,1879,83,na,1962,527
STAT,1851,50,30-34,1901,0.004343457625999275
STAT,1929,23,20-24,1952,132.42274108063987
STAT,1935,15,45-49,1950,0.6481282197022415
STAT,1833,23,20-24,1856,56.45952586645136
STAT,1875,40,15-19,1915,0.013544854341350212
STAT,1889,34,50-100,1923,1.0594271126273536
STAT,1900,31,35-39,1931,13.32580127746649
SIM,1865,27,25-29,1892,47
SIM,1866,33,na,1899,2100
SIM,1924,44,na,1968,4165
STAT,1894,39,20-24,1933,0.9264297782046507
SIM,1930,28,40-44,1958,10
STAT,1946,15,20-24,1961,142.1329865194778
SIM,1836,19,na,1855,1948
SIM,1882,87,na,1969,358
STAT,1778,79,na,1857,242.3060483345927
SIM,1881,15,15-19,1896,4
SIM,1910,30,30-34,1940,15
STAT,1849,17,na,1866,2118.757352506592
SIM,1936,19,20-24,1955,103
STAT,1847,52,50-100,1899,0.011077589540251013
STAT,1928,19,20-24,1947,160.51157614261885
SIM,1848,35,25-29,1883,3
STAT,1873,15,15-19,1888,5.753556266143977
SIM,1907,15,35-39,1922,3
SIM,1795,95,na,1890,2
STAT,1835,31,30-34,1866,14.29528551904368
STAT,1908,61,na,1969,2891.439785491401
SIM,1841,23,20-24,1864,52
SIM,1926,20,40-44,1946,5
STAT,1811,98,na,1909,1.4088685668608627
SIM,1899,30,25-29,1929,17
STAT,1915,36,25-29,1951,0.9441856708877515
STAT,1913,42,25-29,1955,0.06578833330489062
STAT,1859,35,35-39,1894,5.3685688968694425
STAT,1879,31,na,1910,2369.4025021015896
STAT,1910,41,45-49,1951,0.14945151064605536
SIM,1929,29,30-34,1958,52
SIM,1874,68,na,1942,1471
STAT,1779,80,na,1859,200.4640547148379
STAT,1858,25,50-100,1883,0.4920762781305843
SIM,1843,31,30-34,1874,20
SIM,1893,22,30-34,1915,28
STAT,1847,19,50-100,1866,0.04456041594032933
STAT,1914,29,45-49,1943,1.633567554523038
STAT,1776,104,na,1880,0.031036825557901528
STAT,1869,42,40-44,1911,2.0559791509873397
STAT,1856,103,na,1959,0.21897205866717814
SIM,1856,39,na,1895,1840
STAT,1861,57,na,1918,1578.539312605115
SIM,1856,100,na,1956,1
STAT,1872,38,30-34,1910,5.025137770521536
SIM,1852,25,na,1877,1962
STAT,1839,39,na,1878,1669.0753545173484
STAT,1885,22,30-34,1907,16.77282188493158
SIM,1837,20,na,1857,1849
SIM,1895,33,45-49,1928,1
SIM,1778,83,na,1861,103
SIM,1920,18,30-34,1938,15
STAT,1938,29,30-34,1967,36.63580253904057
SIM,1923,36,25-29,1959,1
STAT,1887,33,45-49,1920,1.8348934654457365
STAT,1912,18,30-34,1930,2.3223839101913137
SIM,1922,29,45-49,1951,2
STAT,1781,112,na,1893,1.843821394306188E-4
STAT,1830,49,50-100,1879,0.1793349933233343
SIM,1920,14,na,1934,4243
STAT,1918,23,45-49,1941,1.1428828511091296
STAT,1900,65,na,1965,2438.626255383451
STAT,1904,33,45-49,1937,1.3510959274822871
SIM,1804,89,na,1893,39
SIM,1924,28,na,1952,4078
STAT,1866,88,na,1954,119.61811897922999
SIM,1845,55,na,1900,1438
STAT,1920,4,na,1924,4277.884925220389
SIM,1827,42,na,1869,1477
STAT,1904,19,35-39,1923,0.7395444270609812
SIM,1799,93,na,1892,7
STAT,1865,48,40-44,1913,0.1447508266167626
SIM,1878,33,45-49,1911,1
STAT,1860,43,35-39,1903,1.377979635357419
STAT,1917,41,30-34,1958,0.126222402246398
SIM,1906,36,25-29,1942,1
STAT,1857,49,45-49,1906,0.17216310613219638
STAT,1858,69,na,1927,1086.9821978213752
SIM,1863,38,30-34,1901,8
STAT,1839,28,50-100,1867,0.5326936038710027
STAT,1862,74,na,1936,896.3968003144275
STAT,1894,20,30-34,1914,21.7540198189197
STAT,1907,34,25-29,1941,8.091771206600777
STAT,1909,25,45-49,1934,1.5837280008427295
STAT,1820,36,50-100,1856,2.9885444187371166
SIM,1826,31,30-34,1857,13
SIM,1894,72,na,1966,1857
STAT,1835,25,na,1860,1820.441300379493
STAT,1917,47,15-19,1964,3.634897357901869E-4
STAT,1839,19,30-34,1858,1.3718930153155848
STAT,1887,50,na,1937,2307.977589409429
SIM,1905,29,45-49,1934,2
SIM,1847,19,30-34,1866,2
SIM,1889,36,25-29,1925,8
STAT,1878,14,na,1892,2534.302284474719
SIM,1886,32,40-44,1918,8
STAT,1851,3,na,1854,2471.0
STAT,1881,17,15-19,1898,5.415909613965318
STAT,1844,61,na,1905,1297.8116655737836
STAT,1878,32,40-44,1910,4.26958672973255
STAT,1848,75,na,1923,764.950057606319
SIM,1872,17,15-19,1889,5
STAT,1919,45,na,1964,3782.070981063487
SIM,1861,61,na,1922,1613
STAT,1895,32,40-44,1927,5.341094398765419
SIM,1813,93,na,1906,14
STAT,1810,52,35-39,1862,0.027460581229870808
SIM,1932,34,25-29,1966,11
SIM,1817,41,30-34,1858,4
SIM,1869,89,na,1958,147
SIM,1936,13,na,1949,2963
SIM,1927,16,15-19,1943,48
STAT,1878,73,na,1951,1169.366959692434
STAT,1871,46,15-19,1917,3.762939477721156E-4
STAT,1913,31,45-49,1944,1.4851034736707813
STAT,1876,32,30-34,1908,17.04076796852806
SIM,1884,32,30-34,1916,22
STAT,1859,23,40-44,1882,1.6139322472947808
STAT,1938,16,25-29,1954,40.483284998312584
STAT,1923,19,45-49,1942,0.5511611096036823
SIM,1946,16,25-29,1962,51
SIM,1836,41,40-44,1877,8
STAT,1924,34,25-29,1958,10.1734193015561
SIM,1857,56,na,1913,1578
STAT,1848,34,20-24,1882,2.08768608212244
STAT,1853,38,20-24,1891,0.5804819114862657
STAT,1901,32,50-100,1933,1.2115898298021543
STAT,1919,16,15-19,1935,9.52886941094937
STAT,1924,45,50-100,1969,0.25556944431867196
STAT,1904,37,50-100,1941,0.35908654379472726
SIM,1902,31,35-39,1933,17
SIM,1869,43,45-49,1912,4
STAT,1895,31,50-100,1926,1.133058378703832
STAT,1874,38,40-44,1912,4.204310825982454
SIM,1900,20,20-24,1920,88
STAT,1833,107,na,1940,0.0028933607682454215
STAT,1831,42,50-100,1873,0.7800520557203156
STAT,1898,36,50-100,1934,1.5771248494179304
STAT,1865,52,25-29,1917,0.003016760129491219
SIM,1856,34,20-24,1890,2
STAT,1828,41,40-44,1869,1.9391407854169647
STAT,1933,24,25-29,1957,115.66827784229874
SIM,1909,39,30-34,1948,2
SIM,1802,82,na,1884,146
SIM,1886,53,na,1939,2056
SIM,1901,18,20-24,1919,21
STAT,1899,51,na,1950,2800.4778427714427
STAT,1858,19,40-44,1877,0.15639165573433647
STAT,1892,15,25-29,1907,6.736311352285838
SIM,1867,23,40-44,1890,1
STAT,1904,44,25-29,1948,0.05960999346799868
SIM,1833,24,25-29,1857,47
STAT,1864,17,15-19,1881,5.169000469955848
STAT,1833,41,50-100,1874,0.7955536992789652
STAT,1952,15,na,1967,4169.11367537832
STAT,1767,95,na,1862,2.0964385547593793
SIM,1941,24,25-29,1965,96
STAT,1836,46,50-100,1882,0.16858887570862363
STAT,1922,46,50-100,1968,0.2460773573956563
STAT,1930,31,45-49,1961,1.9195192724457089
STAT,1770,99,na,1869,0.2510736842253775
SIM,1882,38,40-44,1920,11
STAT,1841,37,na,1878,1739.7089480807967
STAT,1815,80,na,1895,276.11619304630455
STAT,1894,36,na,1930,2874.03946939348
SIM,1877,17,na,1894,2468
SIM,1865,75,na,1940,848
STAT,1803,79,na,1882,286.338294308252
STAT,1807,47,40-44,1854,0.660542797012694
STAT,1824,51,25-29,1875,0.004240225388327855
SIM,1850,35,40-44,1885,5
STAT,1883,36,na,1919,2192.6402947491983
STAT,1921,27,na,1948,3944.1787915917616
STAT,1841,47,40-44,1888,0.11856238584128434
STAT,1887,25,45-49,1912,1.1811995208865858
STAT,1915,42,35-39,1957,0.19152218230011286
STAT,1855,27,15-19,1882,0.3360619163362886
SIM,1891,22,20-24,1913,85
STAT,1839,44,20-24,1883,0.10862335201022988
SIM,1903,29,35-39,1932,16
SIM,1863,68,na,1931,1231
STAT,1868,33,35-39,1901,9.089431138177845
STAT,1825,38,45-49,1863,2.400184626018287
STAT,1844,48,20-24,1892,0.008229563976480295
STAT,1939,16,50-100,1955,0.3543820287226116
STAT,1888,18,15-19,1906,6.608259503413562
SIM,1876,33,35-39,1909,10
STAT,1865,23,na,1888,2035.0110268778042
SIM,1862,34,45-49,1896,1
SIM,1915,22,30-34,1937,35
STAT,1784,110,na,1894,2.789592112074522E-4
STAT,1926,16,50-100,1942,0.43499552525369933
STAT,1854,34,45-49,1888,1.2514373720068999
STAT,1890,54,na,1944,2418.5150365258137
STAT,1791,77,na,1868,320.16431373428
SIM,1890,31,50-100,1921,1
SIM,1804,57,na,1861,1038
STAT,1892,29,45-49,1921,1.3043767816889764
STAT,1847,85,na,1932,202.14871403474416
STAT,1877,39,20-24,1916,0.7477789558873735
STAT,1849,16,35-39,1865,0.5094746696888403
SIM,1904,31,45-49,1935,2
SIM,1939,23,30-34,1962,37
SIM,1920,40,40-44,1960,4
STAT,1853,105,na,1958,0.040888399396373676
STAT,1904,41,45-49,1945,0.14146791782767928
SIM,1844,54,na,1898,1398
STAT,1937,26,na,1963,3451.3222698607765
STAT,1842,35,40-44,1877,3.7968152749990542
STAT,1883,22,20-24,1905,63.8276730508072
STAT,1902,33,35-39,1935,13.444745493342493
STAT,1880,49,20-24,1929,0.011701686463065547
STAT,1875,19,40-44,1894,0.17664911254302773
SIM,1918,32,na,1950,3781
SIM,1879,67,na,1946,1573
SIM,1902,23,35-39,1925,11
STAT,1912,40,40-44,1952,0.23048682297005904
STAT,1931,18,40-44,1949,1.7249660412206957
STAT,1894,15,35-39,1909,0.6692551181264708
STAT,1919,29,20-24,1948,18.49923987683673
SIM,1875,53,na,1928,2024
STAT,1895,21,na,1916,2921.584756628848
STAT,1899,35,na,1934,3078.54543688364
SIM,1921,34,25-29,1955,7
STAT,1933,12,na,1945,5010.7172371467705
STAT,1779,102,na,1881,0.07014570653199392
STAT,1840,95,na,1935,8.725298842226186
STAT,1778,95,na,1873,2.283975662125488
SIM,1833,38,45-49,1871,1
STAT,1920,24,15-19,1944,5.555554084953979
STAT,1882,31,50-100,1913,0.8452088664279913
SIM,1865,16,na,1881,2334
SIM,1908,32,40-44,1940,3
STAT,1894,38,50-100,1932,1.4831473640571027
SIM,1856,37,25-29,1893,2
SIM,1927,29,20-24,1956,22
SIM,1910,52,na,1962,3171
STAT,1910,18,20-24,1928,25.312388971159404
STAT,1913,34,25-29,1947,8.613099413946061
STAT,1930,31,20-24,1961,2.975402753999594
SIM,1837,36,na,1873,1712
STAT,1883,36,40-44,1919,4.0740161590364625
SIM,1846,15,20-24,1861,16
STAT,1836,38,20-24,1874,0.6063865124550103
STAT,1812,50,50-100,1862,0.050291557581197216
STAT,1917,16,40-44,1933,0.28504692676976884
STAT,1842,54,na,1896,1516.4065761354161
STAT,1856,54,50-100,1910,0.010825781412575536
SIM,1913,36,40-44,1949,2
STAT,1848,37,25-29,1885,2.204704668035884
SIM,1835,77,na,1912,516
SIM,1910,33,35-39,1943,8
SIM,1819,41,40-44,1860,7
SIM,1906,15,na,1921,3472
STAT,1922,32,25-29,1954,9.865479501372173
SIM,1822,37,30-34,1859,7
STAT,1908,45,na,1953,3184.934629885752
SIM,1784,95,na,1879,2
STAT,1905,28,40-44,1933,4.076027415677616
SIM,1854,91,na,1945,35
STAT,1923,41,30-34,1964,0.14136329104692472
STAT,1799,57,na,1856,996.7171620751511
SIM,1835,24,35-39,1859,4
SIM,1948,21,30-34,1969,33
STAT,1852,80,na,1932,448.4738102529947
SIM,1885,20,30-34,1905,22
STAT,1840,44,50-100,1884,0.7049218914365334
STAT,1854,46,15-19,1900,2.8700632570412233E-4
STAT,1856,19,30-34,1875,1.3728153534647587
SIM,1930,32,25-29,1962,13
STAT,1905,36,40-44,1941,1.2963909795125172
SIM,1841,37,40-44,1878,5
SIM,1925,16,40-44,1941,1
STAT,1825,50,50-100,1875,0.015449141368372638
STAT,1869,53,na,1922,1938.9169591559337
STAT,1833,37,40-44,1870,3.3579635253189255
STAT,1928,42,45-49,1970,0.200428370529643
SIM,1926,23,45-49,1949,1
STAT,1881,28,30-34,1909,22.900271694589918
SIM,1870,22,na,1892,2171
SIM,1896,18,15-19,1914,7
STAT,1881,20,50-100,1901,0.37437264983617047
SIM,1891,36,40-44,1927,4
STAT,1792,78,na,1870,301.0648473704057
STAT,1864,22,na,1886,2023.326009995835
STAT,1846,24,45-49,1870,0.6290297451818327
SIM,1851,9,na,1860,2208
STAT,1891,42,25-29,1933,0.7496170529884286
STAT,1913,39,50-100,1952,0.3874973603378915
SIM,1874,39,45-49,1913,2
STAT,1907,22,30-34,1929,24.71859824857023
SIM,1840,56,na,1896,1336
STAT,1803,63,na,1866,872.384197309838
STAT,1874,24,20-24,1898,66.0995503758194
STAT,1896,28,15-19,1924,0.5640854584933971
STAT,1816,45,40-44,1861,0.41737214953163965
STAT,1924,17,50-100,1941,0.421467898152042
SIM,1935,12,na,1947,5046
STAT,1856,9,na,1865,2123.367296350647
STAT,1911,39,20-24,1950,0.23811870476632926
STAT,1853,21,50-100,1874,0.3672777280158871
STAT,1921,33,45-49,1954,1.6473113319235626
STAT,1921,19,35-39,1940,4.4942750053997225
SIM,1826,46,50-100,1872,4
STAT,1827,44,50-100,1871,0.9793061017244552
STAT,1829,37,15-19,1866,0.05095101608076573
SIM,1816,42,na,1858,1436
STAT,1866,39,45-49,1905,1.7194856610447928
STAT,1850,89,na,1939,74.05468412733292
STAT,1888,26,15-19,1914,0.5082736871270612
STAT,1917,44,35-39,1961,0.19786293959045895
SIM,1905,26,40-44,1931,3
SIM,1841,26,25-29,1867,33
SIM,1878,30,40-44,1908,5
STAT,1863,1,na,1864,3003.045034913993
STAT,1850,49,35-39,1899,0.09662871719870683
STAT,1835,41,na,1876,1624.0010064656794
STAT,1918,20,40-44,1938,3.4463079895288504
STAT,1829,48,30-34,1877,0.07809032427269401
STAT,1887,34,na,1921,2499.988681302588
SIM,1934,22,40-44,1956,4
STAT,1868,16,45-49,1884,0.06029912075042368
STAT,1898,66,na,1964,2301.8098382849535
SIM,1811,43,na,1854,1289
SIM,1899,28,na,1927,3151
SIM,1906,33,20-24,1939,1
STAT,1896,42,50-100,1938,0.09142023982705358
STAT,1822,47,30-34,1869,0.13017575982457902
STAT,1904,16,30-34,1920,2.1650874550353008
SIM,1815,57,na,1872,1161
SIM,1961,4,na,1965,4755
STAT,1903,37,20-24,1940,0.22364134211388007
SIM,1881,22,na,1903,1826
STAT,1889,49,40-44,1938,0.1102749105908967
STAT,1932,33,20-24,1965,3.061258862119984
SIM,1923,27,na,1950,4130
STAT,1900,39,45-49,1939,0.5582042014488138
SIM,1915,51,na,1966,3312
SIM,1885,36,na,1921,2257
STAT,1883,20,na,1903,2203.6096411137787
STAT,1857,46,40-44,1903,0.12791659248339698
SIM,1852,41,na,1893,1785
STAT,1925,18,40-44,1943,1.591970189458235
SIM,1918,18,15-19,1936,41
STAT,1952,20,40-44,1972,3.8216640326717233
SIM,1801,65,na,1866,779
STAT,1839,55,na,1894,1376.6800547103558
STAT,1935,35,15-19,1970,0.025411092096980278
STAT,1885,49,20-24,1934,0.011063793673095212
SIM,1770,87,na,1857,50
SIM,1859,15,30-34,1874,1
STAT,1772,107,na,1879,0.006970658300854273
SIM,1960,11,na,1971,4854
STAT,1880,44,15-19,1924,0.013568041732722904
SIM,1866,92,na,1958,41
STAT,1896,39,30-34,1935,6.5827109691283265
STAT,1926,22,40-44,1948,3.8588400734622765
SIM,1912,16,30-34,1928,2
STAT,1833,26,25-29,1859,34.458226539464626
STAT,1851,28,45-49,1879,0.9284391295203033
STAT,1869,45,45-49,1914,0.21813798501310996
SIM,1898,17,35-39,1915,1
SIM,1933,29,20-24,1962,23
SIM,1936,20,50-100,1956,1
STAT,1893,19,na,1912,3009.5195372738517
STAT,1906,41,50-100,1947,0.10139603806296185
SIM,1869,35,45-49,1904,3
STAT,1852,49,45-49,1901,0.16752438729162258
STAT,1945,19,20-24,1964,139.81476794897245
SIM,1892,49,na,1941,2921
SIM,1796,80,na,1876,229
SIM,1806,96,na,1902,4
SIM,1924,15,35-39,1939,5
STAT,1871,48,50-100,1919,0.22749569110464388
STAT,1837,104,na,1941,0.043287254498743016
STAT,1849,33,na,1882,1866.1221032602764
SIM,1895,14,na,1909,3274
STAT,1840,16,15-19,1856,5.072315198161996
STAT,1853,22,35-39,1875,5.218007433187252
SIM,1848,27,25-29,1875,35
SIM,1917,34,35-39,1951,12
STAT,1904,30,40-44,1934,5.923731550565638
STAT,1898,33,20-24,1931,3.441060482564737
STAT,1913,38,40-44,1951,1.388741660810907
STAT,1823,46,50-100,1869,0.3068740754871328
STAT,1857,68,na,1925,1138.600380163561
SIM,1876,25,35-39,1901,10
STAT,1891,28,50-100,1919,0.7450286962845022
SIM,1861,22,35-39,1883,6
STAT,1868,30,30-34,1898,15.863676277408462
STAT,1924,31,20-24,1955,2.689827423989473
STAT,1928,20,50-100,1948,0.7807158370188875
STAT,1853,54,na,1907,1584.6985515745878
SIM,1947,13,na,1960,4117
SIM,1921,38,40-44,1959,3
SIM,1913,28,40-44,1941,5
STAT,1850,41,25-29,1891,0.4547197407963014
STAT,1852,37,na,1889,1717.3190456139484
STAT,1817,49,50-100,1866,0.5365771988731295
STAT,1916,15,35-39,1931,0.8449442660630283
STAT,1873,42,na,1915,2211.705932305128
STAT,1946,23,20-24,1969,116.85760503021359
STAT,1828,44,45-49,1872,1.227378189951774
SIM,1902,17,na,1919,3380
STAT,1904,41,20-24,1945,0.015011590139505928
STAT,1925,29,20-24,1954,20.22148848483783
STAT,1833,48,45-49,1881,0.152384391582005
STAT,1902,43,50-100,1945,0.09710222441366885
STAT,1879,15,na,1894,2509.1079723566336
STAT,1806,53,50-100,1859,0.052103671200451264
STAT,1914,38,35-39,1952,2.2701541395383593
STAT,1906,43,20-24,1949,0.01506427098155888
SIM,1874,25,25-29,1899,8
SIM,1888,16,15-19,1904,6
STAT,1878,40,40-44,1918,2.236803084184517
SIM,1925,45,na,1970,4186
STAT,1911,47,20-24,1958,0.009883860155686092
STAT,1880,32,50-100,1912,0.9125208880924469
STAT,1889,30,15-19,1919,0.16741864616058472
SIM,1807,81,na,1888,180
SIM,1835,32,35-39,1867,6
STAT,1921,35,50-100,1956,0.4436402644629873
SIM,1905,15,25-29,1920,9
STAT,1902,36,15-19,1938,0.016237166081362695
SIM,1933,18,40-44,1951,3
SIM,1849,85,na,1934,167
STAT,1929,35,15-19,1964,0.023329897905765097
SIM,1845,71,na,1916,894
STAT,1832,53,25-29,1885,0.0021830364179596267
SIM,1846,56,na,1902,1467
SIM,1912,30,40-44,1942,3
SIM,1931,14,na,1945,4868
SIM,1860,76,na,1936,720
STAT,1841,69,na,1910,1011.7419094173276
STAT,1820,75,na,1895,542.3285314209353
SIM,1935,28,na,1963,4742
STAT,1893,27,50-100,1920,0.7663691730301578
STAT,1933,28,40-44,1961,5.843813342585338
SIM,1887,16,20-24,1903,15
SIM,1836,44,45-49,1880,4
SIM,1895,25,45-49,1920,4
STAT,1849,92,na,1941,31.23156275811171
STAT,1909,45,15-19,1954,3.228596182680101E-4
STAT,1840,27,30-34,1867,20.605278218833714
STAT,1869,69,na,1938,1343.0802237874345
STAT,1935,32,35-39,1967,11.94358208999449
STAT,1821,92,na,1913,22.18939600248471
STAT,1914,16,15-19,1930,8.890675742028808
SIM,1889,20,15-19,1909,3
STAT,1931,26,40-44,1957,5.687264309307145
STAT,1922,26,15-19,1948,0.7572385323868985
STAT,1894,23,35-39,1917,7.062670157913677
STAT,1889,38,25-29,1927,3.3412226375681393
STAT,1871,35,na,1906,2231.066289263535
STAT,1860,51,35-39,1911,0.006630500523184848
SIM,1840,40,na,1880,1634
STAT,1872,22,45-49,1894,0.6607660630930297
STAT,1950,21,20-24,1971,124.6606129117547
SIM,1860,41,35-39,1901,5
STAT,1864,17,50-100,1881,0.042671982036144515
STAT,1827,32,35-39,1859,12.150639981553295
STAT,1875,49,na,1924,2139.015028444115
STAT,1895,35,45-49,1930,2.4784927339738685
SIM,1889,28,25-29,1917,51
SIM,1922,16,15-19,1938,47
STAT,1796,76,na,1872,371.4963801195818
SIM,1931,16,40-44,1947,2
STAT,1866,25,25-29,1891,37.108187481545365
SIM,1865,51,50-100,1916,1
SIM,1922,38,35-39,1960,6
STAT,1923,16,40-44,1939,1.5553829342426435
SIM,1828,34,45-49,1862,1
SIM,1928,25,20-24,1953,18
STAT,1848,48,40-44,1896,0.1256131164337308
STAT,1792,62,na,1854,866.0
STAT,1842,21,20-24,1863,63.40038445107364
STAT,1923,34,na,1957,4090.6318114387814
SIM,1850,21,20-24,1871,65
SIM,1894,56,na,1950,2570
STAT,1831,49,25-29,1880,0.039992015615275454
SIM,1886,40,40-44,1926,3
SIM,1897,21,na,1918,3061
SIM,1890,42,na,1932,2886
STAT,1867,32,50-100,1899,0.8127813230454373
STAT,1943,27,na,1970,3769.0262962442907
STAT,1804,104,na,1908,0.022342280236450907
STAT,1814,49,25-29,1863,0.1703952177748479
SIM,1884,34,50-100,1918,3
STAT,1891,39,na,1930,2725.9079295811607
STAT,1902,29,na,1931,3159.046973724834
SIM,1824,34,25-29,1858,14
SIM,1805,74,na,1879,443
SIM,1922,18,40-44,1940,1
SIM,1925,19,20-24,1944,138
SIM,1809,88,na,1897,49
STAT,1870,38,20-24,1908,0.7108495169736075
STAT,1875,29,45-49,1904,1.0704150926423284
SIM,1934,30,40-44,1964,9
SIM,1895,22,40-44,1917,3
STAT,1890,18,30-34,1908,1.8360416593483027
SIM,1818,38,na,1856,1480
SIM,1847,15,15-19,1862,5
STAT,1914,15,25-29,1929,8.507992886397291
SIM,1876,47,50-100,1923,1
STAT,1883,25,25-29,1908,39.445952422020575
STAT,1944,22,35-39,1966,9.604155617899231
SIM,1828,31,40-44,1859,5
STAT,1783,85,na,1868,72.34053408587728
STAT,1913,31,20-24,1944,2.3020247980653625
STAT,1839,47,25-29,1886,0.03907366832299809
STAT,1847,69,na,1916,1082.1771203061753
STAT,1880,87,na,1967,399.0275127776523
STAT,1917,19,20-24,1936,136.63860000123745
STAT,1931,22,25-29,1953,113.17347798694362
STAT,1872,57,na,1929,1904.2806299274575
STAT,1869,50,40-44,1919,0.009773249787449508
STAT,1926,31,30-34,1957,18.007045535261604
STAT,1937,32,45-49,1969,1.4707246859313694
SIM,1884,35,35-39,1919,5
SIM,1883,29,45-49,1912,4
STAT,1863,48,30-34,1911,0.07924054408702884
SIM,1836,41,50-100,1877,4
SIM,1882,27,25-29,1909,39
SIM,1937,30,na,1967,3438
STAT,1867,52,35-39,1919,0.007596252301595213
SIM,1891,28,40-44,1919,3
STAT,1921,41,45-49,1962,0.17734109406881304
STAT,1838,92,na,1930,27.961340385445954
SIM,1831,24,15-19,1855,2
SIM,1932,32,35-39,1964,11
STAT,1878,46,na,1924,2221.3034268926413
SIM,1817,44,35-39,1861,4
STAT,1768,109,na,1877,0.0021271209610810526
SIM,1867,26,45-49,1893,1
STAT,1902,31,45-49,1933,2.334419654289821
SIM,1904,51,na,1955,2994
STAT,1865,44,25-29,1909,0.5424353081719321
STAT,1882,41,20-24,1923,0.14656415321338032
SIM,1891,25,25-29,1916,56
STAT,1920,29,20-24,1949,18.781292743432445
SIM,1940,1,na,1941,3831
STAT,1839,15,15-19,1854,5.230191371595248
STAT,1866,16,35-39,1882,0.493640386345838
STAT,1874,42,25-29,1916,0.6190618904615764
STAT,1781,99,na,1880,0.3448405770476469
STAT,1838,22,45-49,1860,0.6073877570307799
STAT,1876,35,35-39,1911,6.968765873351654
SIM,1853,10,na,1863,2197
STAT,1838,17,na,1855,2035.5477560846778
STAT,1919,27,30-34,1946,39.99500560779934
SIM,1930,36,40-44,1966,1
STAT,1808,47,50-100,1855,0.9317719603377983
STAT,1913,36,15-19,1949,0.01798973649320332
SIM,1831,27,30-34,1858,20
STAT,1919,41,40-44,1960,0.25643378362905284
SIM,1918,29,30-34,1947,45
STAT,1807,51,25-29,1858,0.0132433960200884
SIM,1857,24,na,1881,1939
SIM,1927,27,30-34,1954,57
STAT,1907,38,40-44,1945,1.3046847881682904
STAT,1883,28,40-44,1911,2.764764978055793
SIM,1927,41,40-44,1968,1
SIM,1873,44,25-29,1917,2
SIM,1885,68,na,1953,1416
SIM,1863,15,20-24,1878,10
SIM,1832,33,20-24,1865,2
SIM,1838,17,15-19,1855,5
SIM,1915,38,40-44,1953,2
SIM,1898,5,na,1903,3287
STAT,1822,48,20-24,1870,0.015907970440243606
STAT,1846,37,15-19,1883,0.043494354299693415
STAT,1846,109,na,1955,5.27692415487743E-4
STAT,1906,41,30-34,1947,0.11034274754594754
SIM,1904,24,20-24,1928,80
STAT,1891,24,20-24,1915,80.03941273082992
STAT,1851,17,50-100,1868,0.04284777596161885
STAT,1924,32,35-39,1956,10.071649647062666
STAT,1822,93,na,1915,14.850520910725683
STAT,1929,27,15-19,1956,0.8346259518029294
SIM,1876,16,na,1892,2474
SIM,1827,74,na,1901,601
SIM,1934,31,30-34,1965,18
STAT,1819,38,20-24,1857,1.9821745101453514
STAT,1918,48,20-24,1966,0.011078948786460544
STAT,1901,50,na,1951,2888.218679379356
STAT,1836,105,na,1941,0.01898708634681468
STAT,1930,20,40-44,1950,4.093377071118075
SIM,1874,17,25-29,1891,6
STAT,1866,17,25-29,1883,5.0679851145754515
SIM,1857,6,na,1863,2327
STAT,1879,23,45-49,1902,0.6874318631561336
STAT,1914,14,na,1928,3846.9381288905915
STAT,1833,41,25-29,1874,0.48357185946415104
SIM,1848,26,35-39,1874,6
STAT,1886,29,20-24,1915,11.623265466610242
STAT,1937,28,25-29,1965,60.58370560565407
STAT,1830,26,na,1856,1718.8721776414625
SIM,1848,48,50-100,1896,3
STAT,1872,6,na,1878,2606.323572327758
STAT,1874,27,25-29,1901,40.83032135192119
STAT,1879,36,15-19,1915,0.055797008590376035
STAT,1905,64,na,1969,2665.2631710200517
STAT,1918,28,na,1946,3753.0258945563505
STAT,1824,33,20-24,1857,5.743234085148008
SIM,1872,28,30-34,1900,25
STAT,1896,20,40-44,1916,2.615450658401597
STAT,1768,96,na,1864,1.016074372185475
STAT,1874,49,45-49,1923,0.2230365845719782
SIM,1830,41,na,1871,1582
SIM,1865,35,25-29,1900,2
STAT,1879,90,na,1969,240.98493753316518
STAT,1890,15,15-19,1905,6.886048910859383
SIM,1906,26,50-100,1932,4
STAT,1797,98,na,1895,0.7971568881781435
SIM,1835,21,30-34,1856,18
STAT,1851,74,na,1925,798.3185971599086
STAT,1856,51,20-24,1907,5.465063706126206E-4
SIM,1780,86,na,1866,54
STAT,1940,28,35-39,1968,14.456039478660493
STAT,1793,84,na,1877,98.42140345467924
STAT,1910,40,30-34,1950,0.1154396549943619
STAT,1855,88,na,1943,97.55738175294817
STAT,1829,40,na,1869,1616.4132170412577
SIM,1856,55,na,1911,1618
SIM,1869,32,40-44,1901,2
STAT,1848,91,na,1939,43.05859028766832
STAT,1907,25,35-39,1932,13.480927763771106
STAT,1951,19,50-100,1970,0.42118784928470127
SIM,1894,29,20-24,1923,12
SIM,1913,28,na,1941,3391
STAT,1855,15,20-24,1870,15.162590635746866
STAT,1913,23,45-49,1936,1.0700857414570502
SIM,1834,55,na,1889,1261
SIM,1902,20,30-34,1922,29
STAT,1905,32,25-29,1937,8.030887303949669
SIM,1830,35,50-100,1865,4
SIM,1859,30,30-34,1889,20
STAT,1811,48,45-49,1859,0.7732288120591267
STAT,1899,40,25-29,1939,0.05830333786859014
SIM,1915,25,35-39,1940,16
STAT,1851,95,na,1946,9.564051902910343
STAT,1855,38,30-34,1893,3.7685549493940695
STAT,1914,18,40-44,1932,0.2726234545926469
SIM,1913,32,25-29,1945,11
SIM,1835,93,na,1928,13
STAT,1926,30,40-44,1956,4.4751254346258715
SIM,1874,48,50-100,1922,3
SIM,1921,23,45-49,1944,1
STAT,1891,46,40-44,1937,0.11319089994538181
STAT,1905,21,45-49,1926,0.9550634395718591
SIM,1855,16,25-29,1871,4
SIM,1777,82,na,1859,135
STAT,1826,51,35-39,1877,0.007820822787574911
SIM,1903,18,30-34,1921,1
STAT,1872,36,na,1908,2243.215384893348
SIM,1844,46,50-100,1890,1
STAT,1862,28,20-24,1890,9.442356143453356
STAT,1938,27,40-44,1965,4.362403824502215
SIM,1934,25,45-49,1959,2
SIM,1843,34,35-39,1877,9
STAT,1950,22,35-39,1972,10.552723038241396
SIM,1870,28,20-24,1898,13
STAT,1955,17,15-19,1972,56.908476454183756
SIM,1898,45,50-100,1943,1
SIM,1853,28,20-24,1881,11
STAT,1845,28,20-24,1873,10.031873091364462
STAT,1817,55,na,1872,1171.0880455876877
SIM,1937,26,25-29,1963,59
STAT,1805,59,na,1864,1053.1977355781953
STAT,1926,25,45-49,1951,1.9696840856567333
STAT,1946,26,25-29,1972,69.29654872524887
STAT,1813,41,na,1854,1341.4602280594795
STAT,1836,51,40-44,1887,0.007035935126231877
STAT,1841,40,20-24,1881,0.11672419921106872
STAT,1835,34,35-39,1869,8.037305599614525
SIM,1845,43,50-100,1888,1
SIM,1909,20,40-44,1929,3
STAT,1930,31,na,1961,4613.5232509103125
STAT,1922,49,na,1971,3963.7032553919994
STAT,1892,40,15-19,1932,0.016505366596246088
SIM,1805,100,na,1905,1
STAT,1811,53,40-44,1864,0.03285106839021432
SIM,1815,89,na,1904,46
STAT,1850,23,20-24,1873,57.8872626026407
STAT,1928,42,20-24,1970,0.021268062730554618
SIM,1861,48,50-100,1909,1
STAT,1866,22,20-24,1888,60.53519812836986
SIM,1851,40,na,1891,1728
STAT,1937,3,na,1940,3727.6676067645194
STAT,1842,24,25-29,1866,51.54038709774342
STAT,1900,40,25-29,1940,0.059028604981182155
SIM,1913,21,45-49,1934,6
SIM,1919,19,20-24,1938,153
STAT,1846,21,40-44,1867,1.9208099884042387
SIM,1854,21,40-44,1875,5
SIM,1895,7,na,1902,3304
STAT,1929,26,25-29,1955,77.85223873344103
SIM,1874,22,20-24,1896,54
SIM,1794,78,na,1872,264
SIM,1820,63,na,1883,996
STAT,1823,56,na,1879,1192.1963015895885
STAT,1841,48,30-34,1889,0.06618422202456291
STAT,1936,16,15-19,1952,41.14641706877095
SIM,1848,23,30-34,1871,14
STAT,1861,4,na,1865,2406.4053708756396
SIM,1848,105,na,1953,1
SIM,1906,47,na,1953,3071
STAT,1862,23,50-100,1885,0.3347615337280497
STAT,1841,96,na,1937,5.919744089315721
STAT,1911,20,30-34,1931,25.905152244569177
STAT,1865,28,50-100,1893,0.5458188885634128
SIM,1944,16,15-19,1960,48
STAT,1871,94,na,1965,59.552555443317914
STAT,1777,78,na,1855,253.77002999999996
STAT,1815,50,20-24,1865,0.0016595006835148911
STAT,1858,54,35-39,1912,0.006201219159652602
SIM,1790,64,na,1854,729
SIM,1855,17,15-19,1872,8
SIM,1953,17,30-34,1970,19
SIM,1862,41,50-100,1903,1
SIM,1907,23,35-39,1930,7
STAT,1850,45,40-44,1895,0.12188603985463259
STAT,1906,46,25-29,1952,0.044831686227112796
STAT,1949,11,na,1960,4316.691928730418
SIM,1938,19,30-34,1957,10
SIM,1865,38,40-44,1903,6
STAT,1955,12,na,1967,4925.707123159626
SIM,1917,31,30-34,1948,23
SIM,1824,37,40-44,1861,6
STAT,1901,27,45-49,1928,1.468200272722129
STAT,1866,21,50-100,1887,0.36080827632848206
SIM,1836,62,na,1898,1150
STAT,1847,17,15-19,1864,5.46190456062375
STAT,1945,17,30-34,1962,12.578361043829322
STAT,1922,39,45-49,1961,0.7312468769507116
SIM,1855,92,na,1947,21
SIM,1850,24,25-29,1874,42
SIM,1910,31,45-49,1941,2
STAT,1929,29,40-44,1958,5.5051506016203895
STAT,1882,49,30-34,1931,0.08707482232913807
STAT,1819,53,50-100,1872,0.0269245846722906
STAT,1837,31,40-44,1868,3.5657003247812264
STAT,1832,92,na,1924,25.08966575589903
STAT,1833,77,na,1910,530.3271513490711
SIM,1930,39,45-49,1969,2
STAT,1950,22,50-100,1972,0.7374370561402618
SIM,1889,24,30-34,1913,27
STAT,1906,19,45-49,1925,0.0893954887332285
STAT,1848,52,25-29,1900,0.002617910033783075
STAT,1861,24,35-39,1885,4.641629249241513
SIM,1955,8,na,1963,4604
SIM,1911,21,na,1932,3435
STAT,1884,21,na,1905,2214.013038028299
STAT,1863,49,20-24,1912,0.009740496894268457
SIM,1930,21,45-49,1951,3
STAT,1949,19,40-44,1968,1.535806038288477
STAT,1888,35,na,1923,2655.3070363781885
STAT,1905,34,15-19,1939,0.11070118336644143
STAT,1808,78,na,1886,332.9361290941171
SIM,1950,12,na,1962,4258
SIM,1917,7,na,1924,4057
STAT,1893,42,35-39,1935,2.1667340960971617
SIM,1908,35,45-49,1943,2
SIM,1937,29,40-44,1966,5
STAT,1955,16,25-29,1971,54.35545430756592
SIM,1888,17,na,1905,2849
SIM,1876,91,na,1967,163
STAT,1878,8,na,1886,2615.3939366253476
STAT,1872,27,15-19,1899,0.4299182081694172
STAT,1932,34,35-39,1966,11.46138595343276
SIM,1857,40,na,1897,1857
STAT,1857,84,na,1941,247.85436805331233
STAT,1892,72,na,1964,1740.2817023397583
STAT,1804,64,na,1868,853.5986306993909
STAT,1902,41,35-39,1943,0.16840792552072897
STAT,1922,21,45-49,1943,1.2226335151481869
SIM,1868,40,na,1908,2102
STAT,1847,16,25-29,1863,5.246313227221087
STAT,1887,22,40-44,1909,2.201928081317676
STAT,1883,16,35-39,1899,0.5094699447075409
SIM,1919,38,25-29,1957,1
STAT,1882,48,40-44,1930,0.15530779030434486
STAT,1822,43,15-19,1865,0.019561987341956365
SIM,1875,0,na,1875,3393
STAT,1903,21,35-39,1924,7.867454709083765
STAT,1864,28,30-34,1892,21.127816393286675
SIM,1930,17,25-29,1947,68
STAT,1922,28,na,1950,3990.4593951878073
SIM,1928,9,na,1937,4748
STAT,1911,38,30-34,1949,1.654819887611622
STAT,1820,47,20-24,1867,0.02012766270548565
SIM,1888,4,na,1892,2954
STAT,1919,44,45-49,1963,0.16981524577089446
SIM,1845,31,40-44,1876,3
STAT,1894,20,na,1914,2888.4177212575682
STAT,1838,50,50-100,1888,0.010493008260565586
STAT,1869,32,na,1901,2183.9266979161703
STAT,1927,26,15-19,1953,0.8135373667460589
STAT,1898,34,na,1932,3024.587902604473
STAT,1920,15,50-100,1935,0.08003814463463248
SIM,1934,27,na,1961,4676
STAT,1857,102,na,1959,0.4390547452346898
STAT,1844,21,30-34,1865,15.557770131167546
SIM,1864,69,na,1933,1268
SIM,1913,37,30-34,1950,4
SIM,1900,34,50-100,1934,1
STAT,1900,47,45-49,1947,0.17364580589742093
SIM,1841,41,na,1882,1613
SIM,1848,32,20-24,1880,1
SIM,1849,21,na,1870,1969
STAT,1861,39,45-49,1900,1.5500985114991386
STAT,1849,39,45-49,1888,1.4981899067765183
STAT,1909,46,50-100,1955,0.19683642617951783
STAT,1821,40,40-44,1861,4.105075677930275
SIM,1853,1,na,1854,2789
SIM,1896,17,25-29,1913,6
STAT,1884,25,50-100,1909,0.6010886611514954
STAT,1906,44,35-39,1950,0.17067987733259404
STAT,1922,17,25-29,1939,47.37866984501498
STAT,1898,39,40-44,1937,1.1957519764312883
SIM,1932,3,na,1935,5024
STAT,1864,25,15-19,1889,0.3860877861315556
STAT,1947,19,30-34,1966,12.962593442353871
SIM,1919,45,50-100,1964,1
STAT,1917,40,40-44,1957,0.2472775132337518
STAT,1854,39,na,1893,1668.7008972653941
SIM,1862,41,45-49,1903,2
SIM,1949,17,40-44,1966,1
STAT,1865,37,25-29,1902,2.4653591680393294
SIM,1878,26,20-24,1904,11
SIM,1911,21,35-39,1932,13
STAT,1814,63,na,1877,998.3352531455253
STAT,1906,16,40-44,1922,0.2522750882657982
STAT,1779,96,na,1875,1.2717646131494225
SIM,1930,13,na,1943,4869
STAT,1802,78,na,1880,316.1370171412803
STAT,1900,25,25-29,1925,55.81229849054444
SIM,1917,46,50-100,1963,1
SIM,1939,20,15-19,1959,5
SIM,1860,44,na,1904,1905
SIM,1882,24,20-24,1906,77
STAT,1859,91,na,1950,43.570414175239904
SIM,1876,54,na,1930,2007
STAT,1937,22,50-100,1959,0.6053235608843854
STAT,1909,46,na,1955,3197.174981979454
STAT,1950,20,30-34,1970,32.23348439370119
STAT,1886,49,na,1935,2198.262685617214
STAT,1882,35,na,1917,2185.028678143217
STAT,1847,41,15-19,1888,0.010372303231977664
STAT,1811,93,na,1904,12.674839613517332
SIM,1871,87,na,1958,221
STAT,1923,28,35-39,1951,16.226389887145437
STAT,1952,15,45-49,1967,0.5658189783875484
SIM,1931,28,35-39,1959,19
SIM,1887,20,40-44,1907,2
STAT,1857,35,25-29,1892,2.1655505161169892
STAT,1937,25,20-24,1962,16.82437926855762
SIM,1917,10,na,1927,4038
STAT,1927,29,30-34,1956,44.81815688826236
STAT,1885,16,45-49,1901,0.06166158767183775
STAT,1888,17,25-29,1905,6.326608864577533
STAT,1838,38,30-34,1876,4.272927728502804
STAT,1852,41,35-39,1893,1.318755285010577
STAT,1912,50,na,1962,3305.467658672832
SIM,1946,12,na,1958,4001
STAT,1852,54,40-44,1906,0.007422515222069745
SIM,1898,16,20-24,1914,21
STAT,1797,77,na,1874,344.6470755154855
STAT,1913,20,40-44,1933,3.096431939970335
STAT,1916,38,45-49,1954,0.6562374383788803
STAT,1831,29,30-34,1860,20.623365327018565
STAT,1792,99,na,1891,0.34524063832423346
STAT,1865,34,20-24,1899,2.294721635919782
STAT,1793,63,na,1856,768.49955568
STAT,1856,54,25-29,1910,0.0025389454599566196
SIM,1797,59,na,1856,967
STAT,1830,96,na,1926,5.182441214262297
STAT,1877,72,na,1949,1237.554477524424
STAT,1891,27,25-29,1918,49.44110699751979
STAT,1908,29,20-24,1937,16.18547303382246
STAT,1843,92,na,1935,28.131959080885842
STAT,1861,48,20-24,1909,0.00930740999337945
STAT,1865,41,20-24,1906,0.13660153356408375
SIM,1904,27,25-29,1931,54
STAT,1875,54,35-39,1929,0.008129641425274383
STAT,1869,31,50-100,1900,0.8419650612384249
SIM,1871,21,40-44,1892,1
STAT,1855,15,50-100,1870,0.041901034231150894
STAT,1820,49,25-29,1869,0.09380535330108214
SIM,1924,38,45-49,1962,3
SIM,1829,26,25-29,1855,47
STAT,1860,18,45-49,1878,0.057407010833974245
SIM,1850,18,na,1868,2143
STAT,1896,23,45-49,1919,0.8673495562472693
SIM,1859,33,35-39,1892,7
STAT,1891,49,45-49,1940,0.15234377763013784
SIM,1916,29,20-24,1945,19
SIM,1852,21,30-34,1873,19
STAT,1827,92,na,1919,24.058022683233236
STAT,1941,23,20-24,1964,108.5196804017448
SIM,1849,16,25-29,1865,8
STAT,1829,32,45-49,1861,1.7399307911201705
STAT,1953,16,15-19,1969,51.87635114721506
SIM,1935,29,30-34,1964,68
STAT,1880,48,30-34,1928,0.0951951437523428
STAT,1842,27,40-44,1869,2.6827062749034734
STAT,1863,21,40-44,1884,1.7746832672979715
STAT,1898,36,25-29,1934,3.698538121828808
SIM,1883,72,na,1955,1117
SIM,1893,25,35-39,1918,14
STAT,1867,31,15-19,1898,0.12684297324835928
STAT,1910,29,50-100,1939,0.9015396801335567
STAT,1877,52,40-44,1929,0.010261488993651414
SIM,1857,39,45-49,1896,2
STAT,1931,24,15-19,1955,6.4812778057392215
STAT,1941,31,na,1972,3753.4176465833216
SIM,1915,31,20-24,1946,2
SIM,1830,78,na,1908,445
STAT,1931,28,30-34,1959,47.764949884118565
STAT,1897,49,na,1946,2783.5793046651465
SIM,1837,32,45-49,1869,1
STAT,1905,37,30-34,1942,1.5707862930686394
SIM,1832,36,25-29,1868,3
STAT,1849,17,25-29,1866,5.230548621334565
SIM,1934,34,35-39,1968,13
STAT,1813,78,na,1891,321.5548660232163
SIM,1857,17,25-29,1874,9
STAT,1824,36,25-29,1860,4.741443104962759
STAT,1926,34,35-39,1960,10.42501068661997
STAT,1789,95,na,1884,2.3400368070536595
STAT,1893,35,na,1928,2849.331675400369
STAT,1868,68,na,1936,1377.4288080859094
SIM,1937,23,20-24,1960,89
STAT,1885,25,35-39,1910,9.147492829147005
STAT,1911,34,15-19,1945,0.1172047877248204
STAT,1932,31,30-34,1963,19.797169035573074
STAT,1862,41,40-44,1903,1.8250022922431526
STAT,1934,26,50-100,1960,1.2655017975986882
SIM,1850,27,40-44,1877,2
SIM,1867,32,30-34,1899,23
SIM,1923,33,20-24,1956,2
STAT,1926,39,50-100,1965,0.4836941164601385
STAT,1930,38,40-44,1968,1.842729386386104
STAT,1917,42,45-49,1959,0.16407993494927997
SIM,1932,30,30-34,1962,28
STAT,1899,15,35-39,1914,0.7135505166275119
STAT,1953,19,30-34,1972,13.91943703432288
STAT,1932,36,25-29,1968,1.2508821277752937
STAT,1879,39,50-100,1918,1.201862714981402
STAT,1932,27,na,1959,4635.2671872793035
SIM,1904,32,50-100,1936,3
SIM,1869,20,35-39,1889,9
STAT,1942,28,45-49,1970,1.7121361658355743
SIM,1858,41,40-44,1899,7
SIM,1837,25,20-24,1862,9
SIM,1886,35,45-49,1921,2
STAT,1769,108,na,1877,0.0038458368700018406
STAT,1861,73,na,1934,932.9644423576706
STAT,1907,31,20-24,1938,2.1626893041203363
STAT,1863,30,50-100,1893,0.7656890468155585
STAT,1865,87,na,1952,150.85764664216583
STAT,1833,49,35-39,1882,0.0892467548736743
SIM,1826,34,35-39,1860,9
SIM,1892,41,30-34,1933,4
STAT,1890,41,50-100,1931,1.225686778368201
STAT,1862,58,na,1920,1597.3421392409527
SIM,1941,21,20-24,1962,108
SIM,1963,1,na,1964,4697
STAT,1888,42,15-19,1930,0.015398977588099494
SIM,1816,74,na,1890,448
SIM,1929,27,40-44,1956,10
STAT,1850,26,25-29,1876,35.34508754610449
SIM,1833,21,20-24,1854,48
STAT,1901,9,na,1910,3430.9918988599543
STAT,1918,32,35-39,1950,9.173817748879273
SIM,1903,15,15-19,1918,6
SIM,1940,31,30-34,1971,19
STAT,1887,38,15-19,1925,0.059043329029075914
SIM,1898,18,25-29,1916,10
SIM,1921,20,40-44,1941,3
STAT,1930,23,45-49,1953,1.357467316304407
STAT,1781,78,na,1859,286.377221021197
STAT,1931,27,30-34,1958,47.78788807039236
SIM,1819,44,45-49,1863,3
STAT,1851,36,na,1887,1730.7834450307425
STAT,1801,106,na,1907,0.004292140321346749
STAT,1844,18,na,1862,2014.6148444894195
STAT,1863,44,15-19,1907,0.011294053107304823
SIM,1945,25,20-24,1970,21
STAT,1874,46,40-44,1920,0.165715411033973
SIM,1846,38,30-34,1884,3
STAT,1844,15,45-49,1859,0.058355951133103205
STAT,1869,52,45-49,1921,0.013210903401310354
STAT,1922,36,40-44,1958,1.6106383798576387
SIM,1846,40,na,1886,1697
STAT,1859,32,30-34,1891,13.127796019728962
SIM,1824,93,na,1917,8
STAT,1842,59,na,1901,1407.4223181288323
STAT,1829,25,20-24,1854,33.37463108346284
SIM,1926,32,35-39,1958,11
SIM,1849,15,25-29,1864,6
SIM,1865,91,na,1956,41
SIM,1905,16,15-19,1921,8
SIM,1876,15,30-34,1891,2
STAT,1877,23,35-39,1900,5.700719299736224
STAT,1885,86,na,1971,493.9254303419963
STAT,1841,43,25-29,1884,0.4541756341645886
STAT,1851,50,50-100,1901,0.011020177584604666
STAT,1896,16,20-24,1912,22.173956708738658
STAT,1915,33,20-24,1948,2.336944773702385
STAT,1834,53,35-39,1887,0.005370791718371912
STAT,1840,74,na,1914,728.307249086275
SIM,1866,17,na,1883,2294
STAT,1881,72,na,1953,1152.5260997361552
STAT,1844,88,na,1932,95.34670518944522
STAT,1840,39,25-29,1879,2.1888778188311355
STAT,1871,20,25-29,1891,54.02093044774758
SIM,1887,39,50-100,1926,4
STAT,1859,26,45-49,1885,0.855377935215067
STAT,1897,71,na,1968,2009.195473049311
SIM,1913,38,30-34,1951,2
SIM,1885,23,35-39,1908,5
SIM,1846,18,na,1864,2054
SIM,1910,4,na,1914,3741
STAT,1880,31,45-49,1911,1.7438307048331652
STAT,1895,40,40-44,1935,2.798157568947543
STAT,1850,48,45-49,1898,0.16427157543014628
STAT,1849,15,20-24,1864,16.558413284771294
SIM,1925,13,na,1938,4494
SIM,1842,28,45-49,1870,4
STAT,1859,54,na,1913,1574.42642104414
STAT,1952,16,50-100,1968,0.42425814273221346
STAT,1815,53,25-29,1868,0.007502753016782335
STAT,1863,21,na,1884,2014.202124002384
STAT,1877,20,30-34,1897,17.55901916070702
STAT,1855,22,45-49,1877,0.5789082067585402
STAT,1878,35,45-49,1913,1.9812680504503748
STAT,1911,23,35-39,1934,8.410378735373188
STAT,1842,22,na,1864,1952.9813566901555
SIM,1889,27,35-39,1916,16
SIM,1889,38,50-100,1927,1
STAT,1933,21,20-24,1954,139.75733318979331
STAT,1905,48,50-100,1953,0.1867970491612954
STAT,1868,15,30-34,1883,1.4800161405080594
STAT,1904,48,40-44,1952,0.12921497846084723
STAT,1924,38,40-44,1962,1.6658665896002984
STAT,1845,110,na,1955,1.9554479991855983E-4
SIM,1922,15,25-29,1937,52
STAT,1857,38,40-44,1895,3.2453295154937525
STAT,1924,30,30-34,1954,17.442628170208504
SIM,1897,53,na,1950,2755
SIM,1941,15,35-39,1956,6
SIM,1932,38,40-44,1970,3
SIM,1905,38,35-39,1943,5
STAT,1832,30,15-19,1862,0.11490788331623861
STAT,1834,52,50-100,1886,0.009610362363278856
STAT,1836,22,35-39,1858,4.987203198980854
STAT,1905,38,30-34,1943,1.562995193055019
STAT,1858,51,30-34,1909,0.004430038248372734
STAT,1831,26,15-19,1857,0.4029548110701102
SIM,1889,33,20-24,1922,3
STAT,1842,81,na,1923,391.6120778290906
STAT,1909,22,40-44,1931,2.952299841441897
SIM,1844,22,35-39,1866,3
STAT,1882,44,25-29,1926,0.5819961865798651
SIM,1870,41,40-44,1911,5
STAT,1935,23,50-100,1958,0.8461863467065801
STAT,1854,18,50-100,1872,0.04168471996249259
SIM,1907,32,na,1939,3340
STAT,1860,52,25-29,1912,0.0027005338786365743
STAT,1879,16,45-49,1895,0.06475432226166845
STAT,1944,12,na,1956,3993.4811037650156
STAT,1787,99,na,1886,0.35107352531153285
STAT,1879,39,30-34,1918,5.217233621130883
SIM,1900,23,25-29,1923,83
STAT,1912,27,20-24,1939,16.99422753914514
SIM,1867,35,35-39,1902,9
STAT,1933,15,35-39,1948,5.331129398054644
SIM,1831,63,na,1894,1060
STAT,1838,35,15-19,1873,0.04644581284236238
STAT,1934,19,20-24,1953,172.30796634185455
SIM,1935,36,50-100,1971,1
STAT,1812,56,na,1868,1138.5768704337584
SIM,1783,78,na,1861,265
SIM,1942,19,20-24,1961,135
STAT,1861,20,40-44,1881,1.7059632237733635
SIM,1921,31,20-24,1952,5
SIM,1913,48,50-100,1961,1
SIM,1917,22,40-44,1939,3
STAT,1807,93,na,1900,10.87033252772437
SIM,1857,15,20-24,1872,14
SIM,1887,39,30-34,1926,4
SIM,1910,36,na,1946,3427
SIM,1821,40,45-49,1861,1
SIM,1825,78,na,1903,408
STAT,1834,28,45-49,1862,0.897050947333838
STAT,1925,42,40-44,1967,0.28606804411543724
STAT,1908,18,40-44,1926,0.25564737251108893
SIM,1920,27,20-24,1947,17
STAT,1809,73,na,1882,520.6026566434957
SIM,1914,28,35-39,1942,13
STAT,1843,40,30-34,1883,0.8202868953353263
STAT,1889,30,na,1919,2805.4173956797517
STAT,1843,22,50-100,1865,0.34573443199285264
SIM,1842,26,na,1868,1818
STAT,1822,77,na,1899,439.2301361015294
STAT,1852,46,40-44,1898,0.12447004042642429
SIM,1850,45,na,1895,1700
SIM,1947,22,15-19,1969,4
SIM,1853,30,25-29,1883,20
STAT,1910,17,45-49,1927,0.09351096734822233
STAT,1938,19,40-44,1957,1.3025906561778815
STAT,1828,51,45-49,1879,0.01157443632067587
STAT,1928,43,20-24,1971,0.021234459191440343
STAT,1889,45,25-29,1934,0.06784599823501908
SIM,1899,42,40-44,1941,1
SIM,1835,40,na,1875,1592
SIM,1837,41,na,1878,1633
STAT,1829,44,15-19,1873,0.011418437985784425
STAT,1868,29,15-19,1897,0.4060184272696955
STAT,1921,49,50-100,1970,0.2394616075485335
STAT,1827,48,50-100,1875,0.22168756955915084
STAT,1941,25,35-39,1966,14.684856351915741
STAT,1861,31,35-39,1892,7.9871880044632215
SIM,1857,36,40-44,1893,7
STAT,1909,38,15-19,1947,0.017086871197827796
STAT,1887,37,15-19,1924,0.05933764374203641
SIM,1855,101,na,1956,1
STAT,1835,30,40-44,1865,3.5877836847750952
STAT,1894,5,na,1899,3181.584787952845
SIM,1791,70,na,1861,576
STAT,1839,93,na,1932,19.458215701683628
SIM,1857,18,25-29,1875,6
SIM,1871,17,na,1888,2413
SIM,1900,22,35-39,1922,10
STAT,1759,97,na,1856,0.37476435239999994
STAT,1895,42,45-49,1937,0.12784217392203046
STAT,1834,62,na,1896,1133.1383231782672
SIM,1863,95,na,1958,16
SIM,1834,43,35-39,1877,7
SIM,1858,35,na,1893,1944
SIM,1851,40,30-34,1891,1
STAT,1842,28,40-44,1870,2.663444443849666
STAT,1870,34,40-44,1904,3.9846910199782815
STAT,1901,19,45-49,1920,0.0859154501681349
STAT,1841,41,20-24,1882,0.11523830015511183
STAT,1780,98,na,1878,0.4725550222629693
STAT,1873,31,15-19,1904,0.13700044492839408
SIM,1810,80,na,1890,227
SIM,1898,65,na,1963,2298
STAT,1893,34,35-39,1927,12.028631490722796
STAT,1843,23,na,1866,1799.7401257708148
STAT,1913,49,45-49,1962,0.19923288616624035
STAT,1849,18,25-29,1867,5.199740689954905
STAT,1903,17,50-100,1920,0.06585254404294362
STAT,1894,34,50-100,1928,1.1028437771747202
STAT,1827,86,na,1913,128.1627223854034
SIM,1851,62,na,1913,1352
STAT,1921,48,40-44,1969,0.16743850567573282
SIM,1850,28,40-44,1878,2
STAT,1880,47,30-34,1927,0.09595704267115171
STAT,1900,21,30-34,1921,23.413551439272332
SIM,1884,67,na,1951,1518
STAT,1947,17,40-44,1964,1.4885079157830048
SIM,1913,2,na,1915,3779
STAT,1944,26,15-19,1970,0.7211209351168828
STAT,1834,51,30-34,1885,0.0038635620045266304
STAT,1835,41,35-39,1876,1.3987582060292272
STAT,1942,26,na,1968,3716.048516730614
SIM,1946,19,40-44,1965,2
SIM,1905,52,na,1957,2902
STAT,1935,28,15-19,1963,0.9086442131077772
STAT,1826,43,35-39,1869,1.7341915671749297
STAT,1877,35,na,1912,2330.6297021928
SIM,1808,76,na,1884,382
SIM,1899,20,20-24,1919,99
SIM,1874,32,25-29,1906,14
STAT,1844,47,45-49,1891,0.16314344434335137
STAT,1855,29,50-100,1884,0.4670466990399678
STAT,1921,17,20-24,1938,145.99080635221588
STAT,1917,43,45-49,1960,0.1638206886520602
STAT,1856,73,na,1929,875.4661148099349
STAT,1831,38,na,1869,1555.9320717694059
SIM,1922,27,30-34,1949,39
STAT,1854,60,na,1914,1364.5584928306594
STAT,1855,34,15-19,1889,0.10092331203491785
STAT,1857,42,25-29,1899,0.4778571109957933
STAT,1913,27,25-29,1940,61.95896336993283
STAT,1934,35,45-49,1969,0.8902594087537333
STAT,1923,48,50-100,1971,0.249259703307389
SIM,1939,16,30-34,1955,14
STAT,1833,33,25-29,1866,8.007627662379422
SIM,1843,30,40-44,1873,7
SIM,1904,32,20-24,1936,2
STAT,1817,50,30-34,1867,0.013382880140632901
STAT,1845,21,50-100,1866,0.3608246217280171
STAT,1822,55,na,1877,1155.3493274956872
STAT,1850,30,20-24,1880,2.236394931810513
SIM,1811,43,40-44,1854,6
SIM,1921,27,25-29,1948,76
STAT,1879,20,40-44,1899,2.072917552269292
STAT,1864,60,na,1924,1605.7914690297707
SIM,1884,57,na,1941,1963
STAT,1831,25,15-19,1856,0.41905551016823966
SIM,1816,47,50-100,1863,3
STAT,1806,108,na,1914,6.352114434759534E-4
STAT,1914,27,30-34,1941,37.31635001220366
STAT,1826,30,15-19,1856,0.22524829066318053
SIM,1867,1,na,1868,3086
STAT,1938,19,50-100,1957,0.34890812663046744
STAT,1881,34,50-100,1915,0.829012679801096
STAT,1917,49,na,1966,3603.8669985623656
STAT,1930,24,20-24,1954,133.72450253938547
STAT,1864,29,30-34,1893,21.050911141615117
STAT,1914,23,50-100,1937,0.6331169824695053
SIM,1896,52,na,1948,2686
SIM,1866,38,na,1904,2077
STAT,1932,18,35-39,1950,5.235224739739187
STAT,1878,20,35-39,1898,5.7794291771890345
STAT,1862,52,35-39,1914,0.006916678573746499
STAT,1881,40,na,1921,2130.53554841162
STAT,1845,30,25-29,1875,8.798700968880976
STAT,1954,11,na,1965,4587.865909331666
SIM,1821,58,na,1879,1081
SIM,1885,19,15-19,1904,6
SIM,1907,6,na,1913,3626
STAT,1800,107,na,1907,0.0018747474205615647
STAT,1943,9,na,1952,3953.6008859587787
SIM,1920,15,15-19,1935,52
STAT,1839,51,20-24,1890,4.936561388112269E-4
STAT,1820,35,40-44,1855,11.389295824828931
STAT,1884,41,30-34,1925,1.0778642908757077
STAT,1815,51,20-24,1866,0.0016267147843813906
STAT,1879,36,na,1915,2340.9759454141818
SIM,1818,46,50-100,1864,4
STAT,1900,35,50-100,1935,1.624242889362287
SIM,1940,18,35-39,1958,8
STAT,1902,48,30-34,1950,0.07188406548000117
SIM,1907,38,45-49,1945,1
SIM,1923,35,35-39,1958,6
STAT,1890,49,na,1939,2544.707757326116
STAT,1833,46,30-34,1879,0.07046774476859616
STAT,1935,30,45-49,1965,2.0589417018956038
SIM,1876,38,na,1914,2268
SIM,1900,26,40-44,1926,3
STAT,1939,22,15-19,1961,5.05035488398902
STAT,1932,32,30-34,1964,19.785686677532446
STAT,1919,19,30-34,1938,12.656438616462797
STAT,1849,36,40-44,1885,3.3939757893775746
STAT,1815,41,50-100,1856,2.7989170833460277
STAT,1816,43,na,1859,1440.6585988132763
STAT,1831,47,35-39,1878,0.09973840409421005
STAT,1912,15,15-19,1927,8.710068812407334
STAT,1915,35,35-39,1950,2.3302614438501634
STAT,1845,52,45-49,1897,0.010214733413846539
STAT,1838,54,50-100,1892,0.009860656112043753
STAT,1927,38,20-24,1965,0.30930106634242654
SIM,1875,44,35-39,1919,4
SIM,1876,18,35-39,1894,1
STAT,1829,28,25-29,1857,52.61224301023413
SIM,1831,23,15-19,1854,5
SIM,1833,43,na,1876,1521
SIM,1858,44,35-39,1902,4
SIM,1932,33,35-39,1965,18
STAT,1874,31,20-24,1905,2.619717807649841
STAT,1841,51,50-100,1892,0.010461833131243641
STAT,1882,42,20-24,1924,0.1457243406154676
SIM,1910,24,45-49,1934,5
STAT,1809,51,35-39,1860,0.023610876258485437
STAT,1918,50,na,1968,3660.0205353680203
STAT,1809,89,na,1898,42.157150989972024
SIM,1817,40,40-44,1857,2
STAT,1857,39,40-44,1896,3.2286809750792687
STAT,1784,70,na,1854,586.0
SIM,1915,33,35-39,1948,10
STAT,1839,61,na,1900,1244.1342764538406
SIM,1929,17,15-19,1946,51
STAT,1835,54,40-44,1889,0.006563336983956436
STAT,1807,88,na,1895,51.0623840774581
STAT,1834,25,40-44,1859,2.473105165493634
STAT,1908,39,50-100,1947,0.36762779956082065
SIM,1814,88,na,1902,36
STAT,1844,33,50-100,1877,0.7531125094100374
SIM,1930,22,20-24,1952,133
STAT,1867,44,35-39,1911,1.5846506841615227
STAT,1876,42,35-39,1918,1.765187026164688
SIM,1838,18,15-19,1856,9
STAT,1872,48,35-39,1920,0.13099392840599644
SIM,1898,37,40-44,1935,3
SIM,1889,82,na,1971,901
STAT,1907,37,40-44,1944,1.311188282047245
STAT,1848,44,25-29,1892,0.47071917387777484
STAT,1896,19,25-29,1915,7.03237803816945
STAT,1840,23,15-19,1863,2.7334799531560345
STAT,1854,104,na,1958,0.08544314633645736
STAT,1884,15,na,1899,2368.1524195655547
STAT,1920,17,15-19,1937,48.1009351785795
SIM,1868,41,25-29,1909,3
SIM,1830,25,na,1855,1786
SIM,1837,28,25-29,1865,39
SIM,1882,31,20-24,1913,2
STAT,1807,102,na,1909,0.10904590899821218
SIM,1929,39,35-39,1968,7
SIM,1846,93,na,1939,20
STAT,1896,48,20-24,1944,0.00833946322265682
STAT,1891,43,15-19,1934,0.01602407312763993
STAT,1907,33,35-39,1940,8.035529561015629
STAT,1850,47,45-49,1897,0.16558633089747216
SIM,1843,41,35-39,1884,2
STAT,1928,38,25-29,1966,1.1743028444197614
STAT,1892,18,na,1910,2980.5945728204297
SIM,1867,42,35-39,1909,2
SIM,1906,35,35-39,1941,5
STAT,1885,32,50-100,1917,0.8627767339443444
STAT,1898,4,na,1902,3363.122791959461
SIM,1826,95,na,1921,9
STAT,1772,85,na,1857,71.558691348195
STAT,1904,34,20-24,1938,2.0851716172866746
SIM,1884,31,40-44,1915,4
SIM,1912,34,20-24,1946,2
STAT,1897,65,na,1962,2295.8602634619874
SIM,1900,37,na,1937,3160
STAT,1879,68,na,1947,1511.1935906421575
STAT,1876,31,40-44,1907,4.249953425320015
SIM,1946,17,15-19,1963,43
STAT,1846,32,50-100,1878,0.8030974091486199
STAT,1938,17,15-19,1955,42.29274436022295
STAT,1859,42,35-39,1901,1.35985744650472
STAT,1885,45,40-44,1930,0.16281656745283377
STAT,1935,6,na,1941,5176.207538480294
SIM,1919,17,30-34,1936,13
STAT,1820,46,20-24,1866,0.02042683861279705
STAT,1897,39,50-100,1936,0.3314236148180551
SIM,1920,19,20-24,1939,129
STAT,1830,45,50-100,1875,0.18885388546836263
STAT,1818,54,40-44,1872,0.020705728679193843
STAT,1899,20,50-100,1919,0.5309944245921744
STAT,1874,26,50-100,1900,0.619564975685454
STAT,1913,32,20-24,1945,2.2926555571372367
STAT,1912,19,20-24,1931,25.76072461401449
STAT,1860,15,40-44,1875,0.16361372913754973
STAT,1925,19,50-100,1944,0.4252478264395956
SIM,1834,92,na,1926,26
STAT,1886,31,25-29,1917,10.262971576149887
SIM,1936,17,30-34,1953,10
SIM,1905,30,na,1935,3275
SIM,1957,12,na,1969,4912
STAT,1854,41,45-49,1895,1.0756688560123178
STAT,1951,8,na,1959,4421.192288966714
SIM,1901,31,40-44,1932,6
STAT,1936,28,20-24,1964,16.494800359437587
STAT,1784,80,na,1864,227.1218376834433
SIM,1898,19,25-29,1917,9
STAT,1846,45,50-100,1891,0.18397853625028027
STAT,1906,65,na,1971,2658.140847796771
SIM,1884,42,35-39,1926,1
STAT,1839,71,na,1910,888.7079007408348
STAT,1875,52,30-34,1927,0.005749242921383132
STAT,1818,41,35-39,1859,4.41665578145673
STAT,1909,40,45-49,1949,0.14873143117303947
STAT,1929,17,50-100,1946,0.4516782851285418
STAT,1929,28,na,1957,4426.829651486111
SIM,1867,7,na,1874,2658
SIM,1842,25,40-44,1867,7
STAT,1827,76,na,1903,547.2504056567927
SIM,1837,21,40-44,1858,1
SIM,1854,101,na,1955,1
SIM,1905,62,na,1967,2661
STAT,1856,52,20-24,1908,5.410085165242577E-4
SIM,1873,73,na,1946,1097
SIM,1841,30,20-24,1871,4
SIM,1941,23,35-39,1964,14
STAT,1857,28,50-100,1885,0.48739079095385046
SIM,1920,37,50-100,1957,1
STAT,1885,32,35-39,1917,9.536086595966495
STAT,1877,29,na,1906,2321.922141740557
SIM,1842,20,na,1862,1884
SIM,1884,5,na,1889,2554
STAT,1882,7,na,1889,2407.1876330676614
STAT,1918,36,15-19,1954,0.0192135644252759
STAT,1896,35,15-19,1931,0.07072862811455646
STAT,1830,41,45-49,1871,1.180642937714469
STAT,1879,35,15-19,1914,0.05605711359746827
STAT,1823,32,50-100,1855,2.4016818193573526
STAT,1854,17,na,1871,1964.647919309153
STAT,1919,48,25-29,1967,0.0542019108491971
SIM,1855,60,na,1915,1511
STAT,1868,18,35-39,1886,0.500563560435841
STAT,1928,17,30-34,1945,14.508470902455796
SIM,1852,46,50-100,1898,4
SIM,1894,31,25-29,1925,16
STAT,1840,36,20-24,1876,0.6045721613335173
SIM,1915,37,40-44,1952,1
STAT,1819,40,25-29,1859,1.450842721465351
STAT,1900,24,35-39,1924,7.599548514966035
STAT,1826,37,50-100,1863,1.3397240161352817
SIM,1893,32,35-39,1925,15
STAT,1922,22,20-24,1944,120.46252578975339
STAT,1834,40,na,1874,1612.1303924434649
STAT,1861,47,20-24,1908,0.009381902297622572
SIM,1860,23,na,1883,2032
SIM,1896,27,50-100,1923,4
STAT,1842,75,na,1917,745.5182044312639
SIM,1935,26,15-19,1961,4
SIM,1826,41,35-39,1867,2
STAT,1819,73,na,1892,627.0086065195501
STAT,1891,48,45-49,1939,0.15363740457667338
STAT,1908,45,45-49,1953,0.18841836439425716
STAT,1911,41,50-100,1952,0.10654079280770123
STAT,1913,44,15-19,1957,0.0014100955793323595
STAT,1824,40,20-24,1864,0.21982578816876908
SIM,1869,68,na,1937,1359
SIM,1846,39,30-34,1885,7
STAT,1838,39,30-34,1877,4.228788385067368
SIM,1878,29,25-29,1907,44
STAT,1929,40,50-100,1969,0.14411989146524218
SIM,1900,15,na,1915,3372
SIM,1775,86,na,1861,57
STAT,1860,88,na,1948,105.2292002425252
STAT,1891,31,20-24,1922,3.1721951761035885
SIM,1825,56,na,1881,1221
STAT,1924,33,35-39,1957,10.065405224281493
SIM,1898,15,20-24,1913,19
STAT,1847,90,na,1937,58.137605076997076
SIM,1786,81,na,1867,173
STAT,1908,42,40-44,1950,0.21862003274046968
STAT,1943,28,50-100,1971,1.000947252475415
STAT,1811,61,na,1872,995.2673087279583
STAT,1831,44,30-34,1875,0.8264127648310484
STAT,1881,37,20-24,1918,0.7034817054182204
STAT,1913,46,40-44,1959,0.14574183689319434
STAT,1903,40,50-100,1943,0.09960495797040615
SIM,1826,73,na,1899,611
SIM,1934,33,45-49,1967,5
SIM,1788,82,na,1870,151
SIM,1850,23,25-29,1873,57
STAT,1860,41,30-34,1901,0.8852191893730206
STAT,1861,40,25-29,1901,0.5094957334306413
STAT,1930,36,15-19,1966,0.023683965364291116
STAT,1875,26,40-44,1901,2.918718517200693
SIM,1867,20,25-29,1887,68
STAT,1823,40,15-19,1863,0.019471079775711164
STAT,1903,29,20-24,1932,15.656153692725347
SIM,1829,39,30-34,1868,10
STAT,1846,41,na,1887,1757.37969189892
SIM,1932,25,35-39,1957,24
SIM,1806,59,na,1865,1039
SIM,1929,19,40-44,1948,1
STAT,1893,31,30-34,1924,21.00270532389823
STAT,1843,43,35-39,1886,1.24329690934948
STAT,1922,6,na,1928,4382.048347462479
STAT,1925,45,45-49,1970,0.2499610399967904
STAT,1900,37,40-44,1937,1.2382242820523581
SIM,1886,16,na,1902,2500
STAT,1826,40,30-34,1866,1.1694378071766174
STAT,1926,33,45-49,1959,1.796330083441333
STAT,1872,73,na,1945,1125.487405860523
STAT,1811,45,40-44,1856,0.5893679957575435
STAT,1941,22,30-34,1963,28.059082730895256
STAT,1951,18,45-49,1969,0.5617804221940361
STAT,1852,59,na,1911,1408.984802048537
STAT,1837,46,15-19,1883,2.729572417643821E-4
STAT,1891,45,40-44,1936,0.11399570965554995
STAT,1882,45,15-19,1927,3.7114951222360515E-4
SIM,1831,32,50-100,1863,5
STAT,1877,15,35-39,1892,0.5401973309026578
STAT,1963,0,na,1963,4752.643355281898
STAT,1820,43,40-44,1863,4.007438360475941
STAT,1839,54,25-29,1893,0.002293415191133977
STAT,1874,47,30-34,1921,0.09299803302695572
STAT,1931,15,25-29,1946,53.832487853663984
SIM,1896,36,na,1932,2961
STAT,1879,52,na,1931,2117.874938323356
SIM,1845,41,45-49,1886,2
STAT,1814,46,20-24,1860,0.03732260704558749
STAT,1824,54,40-44,1878,0.011872760795931527
SIM,1908,8,na,1916,3623
STAT,1836,40,25-29,1876,0.5075372262583364
STAT,1761,103,na,1864,0.0634396327337656
STAT,1853,51,40-44,1904,0.00800540481200564
STAT,1901,16,40-44,1917,0.24245437976453077
STAT,1859,20,25-29,1879,49.78708289441709
STAT,1924,25,35-39,1949,16.625669370940216
STAT,1892,56,na,1948,2413.3975877563403
STAT,1911,49,25-29,1960,0.04716444644426661
STAT,1929,38,30-34,1967,2.2081577006093065
STAT,1938,27,na,1965,3506.12927299291
SIM,1878,22,40-44,1900,1
STAT,1852,30,40-44,1882,3.3236096921992977
SIM,1864,90,na,1954,66
SIM,1920,5,na,1925,4312
STAT,1858,39,50-100,1897,0.9002139519158497
SIM,1843,75,na,1918,693
SIM,1900,29,45-49,1929,1
STAT,1880,49,na,1929,2193.910861255365
SIM,1855,17,na,1872,2208
SIM,1903,19,20-24,1922,27
SIM,1923,32,30-34,1955,26
STAT,1848,70,na,1918,1042.5655477159148
SIM,1852,44,40-44,1896,6
STAT,1850,33,25-29,1883,7.475082940360882
SIM,1920,51,na,1971,3851
STAT,1883,32,25-29,1915,9.486837047941531
STAT,1878,47,15-19,1925,3.919719558236323E-4
SIM,1941,27,40-44,1968,5
SIM,1876,22,30-34,1898,18
SIM,1901,34,45-49,1935,4
STAT,1932,35,35-39,1967,3.0753891886679017
STAT,1855,18,25-29,1873,4.7614187505714956
STAT,1877,31,50-100,1908,0.9015299928821672
STAT,1904,46,15-19,1950,3.066136741514578E-4
STAT,1851,18,40-44,1869,0.15902287489888442
SIM,1860,30,40-44,1890,4
STAT,1933,27,40-44,1960,5.846619720050961
STAT,1871,42,45-49,1913,1.4022281931549467
SIM,1921,24,20-24,1945,118
SIM,1938,17,40-44,1955,2
SIM,1774,96,na,1870,1
STAT,1834,56,na,1890,1264.5117320211962
STAT,1811,49,20-24,1860,0.03867395967033461
SIM,1884,34,35-39,1918,10
SIM,1840,18,30-34,1858,2
SIM,1857,18,na,1875,2135
SIM,1863,18,25-29,1881,2
STAT,1809,100,na,1909,0.4260297935337671
STAT,1923,46,25-29,1969,0.05876701065323047
STAT,1848,16,50-100,1864,0.0453952900313274
STAT,1858,41,15-19,1899,0.010274967318248392
STAT,1915,32,30-34,1947,15.158868163787025
STAT,1844,44,40-44,1888,1.5594532999797561
STAT,1855,47,20-24,1902,0.00848776472442287
SIM,1841,62,na,1903,1198
STAT,1897,55,na,1952,2612.3128881130706
SIM,1859,25,35-39,1884,7
SIM,1928,36,25-29,1964,3
STAT,1876,34,35-39,1910,9.799441605772271
STAT,1864,41,15-19,1905,0.011680098471492265
STAT,1878,42,45-49,1920,1.47165899941564
STAT,1899,33,50-100,1932,1.1809858242023175
STAT,1817,53,35-39,1870,0.018228915908847967
STAT,1926,26,na,1952,4256.837272850261
STAT,1804,51,45-49,1855,0.05232643212825082
SIM,1891,32,25-29,1923,21
STAT,1826,40,40-44,1866,2.287954151209553
SIM,1843,39,50-100,1882,4
STAT,1862,30,25-29,1892,8.33964204216748
STAT,1829,93,na,1922,17.6590220302336
STAT,1868,22,30-34,1890,16.054960941906447
STAT,1926,38,15-19,1964,0.022148032214138746
SIM,1945,7,na,1952,3915
STAT,1885,48,45-49,1933,0.21943558157689305
STAT,1918,34,50-100,1952,0.8228943537976624
STAT,1816,41,25-29,1857,1.8152989797146522
STAT,1914,20,na,1934,3555.5370887170366
SIM,1818,44,na,1862,1379
SIM,1883,22,25-29,1905,52
STAT,1835,39,50-100,1874,0.9462030200991914
STAT,1861,44,40-44,1905,1.7429290780273354
STAT,1843,101,na,1944,0.38542582148974536
STAT,1870,72,na,1942,1170.4021057599286
SIM,1883,26,40-44,1909,5
SIM,1817,43,35-39,1860,7
SIM,1904,46,50-100,1950,2
SIM,1835,44,50-100,1879,1
STAT,1905,44,50-100,1949,0.09882347103974445
SIM,1885,31,50-100,1916,5
STAT,1842,23,25-29,1865,51.91312332320399
SIM,1893,34,na,1927,2935
STAT,1913,24,20-24,1937,105.41445951008409
SIM,1856,61,na,1917,1437
SIM,1886,42,45-49,1928,4
SIM,1911,29,20-24,1940,14
STAT,1931,21,50-100,1952,0.808627799344758
SIM,1879,19,15-19,1898,5
SIM,1830,30,45-49,1860,2
STAT,1818,56,na,1874,1178.1534033830528
STAT,1860,72,na,1932,968.0211638305805
STAT,1859,38,na,1897,1762.650575118016
STAT,1928,35,20-24,1963,0.31525970830192607
STAT,1936,19,30-34,1955,10.964688349431993
SIM,1835,56,na,1891,1258
SIM,1866,15,25-29,1881,6
SIM,1874,29,40-44,1903,6
STAT,1861,23,35-39,1884,4.675197164885389
SIM,1915,30,30-34,1945,19
STAT,1910,43,35-39,1953,0.1787094096510777
STAT,1812,50,40-44,1862,0.03505665579881467
STAT,1843,35,50-100,1878,0.9884201766357825
STAT,1925,28,45-49,1953,1.920819940950117
STAT,1832,51,20-24,1883,4.73176149768956E-4
SIM,1933,28,45-49,1961,5
STAT,1877,67,na,1944,1553.409882250341
STAT,1850,44,40-44,1894,1.564164958013003
STAT,1902,13,na,1915,3437.745571990811
STAT,1884,44,35-39,1928,1.6672572419971952
SIM,1913,25,25-29,1938,68
SIM,1800,80,na,1880,172
STAT,1824,62,na,1886,1049.0869602078274
SIM,1944,19,30-34,1963,16
STAT,1824,43,25-29,1867,0.8225372129415459
SIM,1803,94,na,1897,4
STAT,1898,13,na,1911,3296.412928269957
SIM,1878,40,45-49,1918,1
STAT,1843,30,15-19,1873,0.11806400343379622
SIM,1943,26,na,1969,3648
SIM,1891,24,25-29,1915,66
SIM,1868,20,30-34,1888,21
SIM,1847,41,na,1888,1752
STAT,1824,53,50-100,1877,0.01737463999903842
STAT,1891,34,25-29,1925,11.868869716426287
STAT,1842,31,25-29,1873,9.054067547253082
SIM,1825,49,50-100,1874,3
STAT,1863,36,15-19,1899,0.046777165372692595
STAT,1867,41,30-34,1908,1.0244600190930455
STAT,1895,48,na,1943,2736.5932155340734
SIM,1831,46,50-100,1877,3
SIM,1901,32,na,1933,3120
SIM,1867,18,na,1885,2454
STAT,1842,91,na,1933,41.96478266444514
STAT,1947,4,na,1951,4232.515662013771
SIM,1851,35,50-100,1886,3
STAT,1889,52,na,1941,2497.8426462616912
STAT,1939,22,na,1961,3464.6320052634333
STAT,1901,66,na,1967,2435.494956793996
STAT,1907,30,30-34,1937,14.024314364193808
STAT,1901,46,50-100,1947,0.18371584856392142
STAT,1850,30,50-100,1880,0.7580622935685285
SIM,1832,42,na,1874,1503
STAT,1919,45,50-100,1964,0.23284597798550608
STAT,1915,48,40-44,1963,0.1496699045074107
STAT,1922,38,30-34,1960,1.9571772902872937
SIM,1850,31,25-29,1881,15
SIM,1930,38,30-34,1968,4
SIM,1881,19,30-34,1900,1
STAT,1830,49,30-34,1879,0.07068252198103836
STAT,1959,10,na,1969,4854.333653678663
STAT,1821,51,35-39,1872,0.013319055595569191
STAT,1835,33,35-39,1868,8.121197570517973
SIM,1939,24,30-34,1963,35
STAT,1883,24,25-29,1907,52.6897259793567
STAT,1859,16,na,1875,2015.3031441172393
SIM,1903,27,20-24,1930,18
SIM,1874,90,na,1964,175
STAT,1934,32,40-44,1966,5.047507012595042
SIM,1809,103,na,1912,1
STAT,1902,35,na,1937,3195.9145622679803
SIM,1877,2,na,1879,3058
SIM,1921,35,25-29,1956,3
SIM,1844,18,15-19,1862,5
STAT,1836,18,15-19,1854,9.067425629680269
STAT,1841,44,15-19,1885,0.009642881898684872
STAT,1892,19,40-44,1911,0.2152594843728352
STAT,1913,35,25-29,1948,0.926682546707333
STAT,1913,51,na,1964,3344.4389747986966
SIM,1820,57,na,1877,1210
STAT,1855,52,50-100,1907,0.010675282548105021
SIM,1871,31,45-49,1902,1
STAT,1870,37,45-49,1907,1.8474863021988541
STAT,1931,32,na,1963,4681.570593094207
SIM,1824,33,25-29,1857,8
SIM,1851,43,35-39,1894,7
SIM,1900,21,na,1921,3173
STAT,1897,40,15-19,1937,0.0012237871970389475
SIM,1817,53,na,1870,1260
SIM,1955,11,na,1966,4602
STAT,1944,5,na,1949,4047.011669032457
STAT,1860,94,na,1954,15.319521950431035
STAT,1938,11,na,1949,3697.954724944647
STAT,1899,42,15-19,1941,0.0012397817843380309
STAT,1910,46,15-19,1956,3.254992616547715E-4
STAT,1892,34,na,1926,2799.428734434094
STAT,1906,28,35-39,1934,13.229265870066797
STAT,1888,3,na,1891,2951.488933946405
STAT,1890,31,15-19,1921,0.16514814832932365
STAT,1875,37,50-100,1912,1.1921562374906898
STAT,1857,0,na,1857,2946.7141070289777
SIM,1796,58,na,1854,1044
STAT,1905,25,25-29,1930,58.15423183736023
STAT,1893,47,40-44,1940,0.11515542236320804
STAT,1950,15,35-39,1965,4.689752378619005
SIM,1843,33,35-39,1876,11
STAT,1881,5,na,1886,2443.909857306073
STAT,1872,45,30-34,1917,0.09263994222466598
STAT,1926,1,na,1927,4836.779759904288
STAT,1940,17,30-34,1957,11.691284705916653
STAT,1876,51,25-29,1927,0.0034735621105343294
STAT,1857,90,na,1947,58.74103109807871
SIM,1776,81,na,1857,160
STAT,1857,51,50-100,1908,0.011306308317738739
STAT,1911,22,45-49,1933,1.0081290091196509
SIM,1910,15,na,1925,3648
STAT,1942,17,50-100,1959,0.36987934969272046
SIM,1883,3,na,1886,2660
STAT,1882,51,na,1933,1987.6129264455237
STAT,1812,77,na,1889,373.14460104291845
STAT,1833,45,na,1878,1509.2945600025196
STAT,1898,43,25-29,1941,0.05659636994098471
STAT,1907,15,50-100,1922,0.06830326522067234
SIM,1850,23,na,1873,1944
STAT,1858,15,25-29,1873,4.961205788837878
STAT,1805,54,30-34,1859,0.020991476649091317
SIM,1833,28,40-44,1861,7
SIM,1941,20,30-34,1961,40
SIM,1820,79,na,1899,354
STAT,1896,30,45-49,1926,2.1932304799252496
SIM,1833,35,40-44,1868,7
SIM,1835,31,35-39,1866,12
STAT,1825,42,na,1867,1452.3634681533795
SIM,1932,22,30-34,1954,41
STAT,1953,10,na,1963,4490.107058254444
SIM,1861,39,na,1900,2042
SIM,1826,57,na,1883,1137
STAT,1907,15,30-34,1922,2.222133346961683
SIM,1953,18,20-24,1971,151
STAT,1869,45,50-100,1914,0.22701139420013672
STAT,1933,20,30-34,1953,36.23018722363027
STAT,1894,22,35-39,1916,7.084561452802837
SIM,1895,51,na,1946,2738
STAT,1912,43,45-49,1955,0.15073424281776004
SIM,1850,20,20-24,1870,59
STAT,1915,44,25-29,1959,0.06769227741830211
SIM,1817,40,30-34,1857,4
STAT,1890,17,50-100,1907,0.05658394520474241
SIM,1882,7,na,1889,2495
SIM,1877,17,15-19,1894,2
STAT,1840,40,15-19,1880,0.010658458577773896
STAT,1869,17,15-19,1886,5.506447436160594
STAT,1919,9,na,1928,4155.891029072062
SIM,1927,15,15-19,1942,47
SIM,1929,17,25-29,1946,68
SIM,1938,29,35-39,1967,15
STAT,1890,70,na,1960,1755.0504497614306
STAT,1913,48,30-34,1961,0.08197254686063973
STAT,1882,88,na,1970,342.3303108256281
SIM,1852,89,na,1941,52
SIM,1917,33,45-49,1950,1
STAT,1831,46,20-24,1877,0.00865979210593282
SIM,1868,99,na,1967,4
STAT,1909,51,na,1960,3148.617510482604
STAT,1830,41,35-39,1871,1.4284826321591753
STAT,1802,94,na,1896,7.007012196381126
SIM,1845,39,na,1884,1700
STAT,1835,50,25-29,1885,0.0023902753430416236
SIM,1950,17,40-44,1967,1
STAT,1872,34,15-19,1906,0.13378695110078084
STAT,1896,18,50-100,1914,0.060966302451369116
STAT,1862,52,45-49,1914,0.011659543865203908
STAT,1910,48,na,1958,3229.1801217383527
SIM,1915,29,na,1944,3462
STAT,1899,29,na,1928,3067.0435580259946
STAT,1857,89,na,1946,78.27128117748468
STAT,1828,87,na,1915,99.22153599377252
SIM,1868,19,15-19,1887,7
STAT,1827,31,35-39,1858,12.68152244144413
SIM,1900,30,50-100,1930,1
SIM,1883,66,na,1949,1440
SIM,1921,20,na,1941,3976
STAT,1825,35,40-44,1860,5.97117973072357
STAT,1834,21,25-29,1855,47.85712645792481
SIM,1889,25,20-24,1914,13
SIM,1928,33,20-24,1961,3
STAT,1941,25,na,1966,3664.133297944394
SIM,1895,32,45-49,1927,1
STAT,1942,17,40-44,1959,1.380883241315758
STAT,1892,26,40-44,1918,3.5566657199539122
STAT,1916,27,40-44,1943,4.552819212322769
SIM,1854,54,na,1908,1688
SIM,1842,21,25-29,1863,54
SIM,1906,53,na,1959,2984
STAT,1870,56,na,1926,1890.253842493593
STAT,1873,52,20-24,1925,7.032474584232797E-4
STAT,1833,61,na,1894,1146.456713936818
SIM,1915,15,30-34,1930,2
SIM,1898,23,20-24,1921,82
STAT,1844,24,na,1868,1827.565573194464
SIM,1870,16,na,1886,2351
SIM,1843,30,30-34,1873,25
SIM,1894,19,na,1913,3171
STAT,1922,34,15-19,1956,0.13649398689636297
STAT,1887,32,45-49,1919,1.842669530865991
STAT,1804,51,35-39,1855,0.031041103848168723
SIM,1843,91,na,1934,29
SIM,1874,4,na,1878,2612
SIM,1927,14,na,1941,4620
STAT,1941,7,na,1948,3867.191768193745
SIM,1895,73,na,1968,1764
SIM,1858,30,25-29,1888,17
STAT,1824,94,na,1918,11.020060712129958
SIM,1835,72,na,1907,785
STAT,1866,36,40-44,1902,3.832569532481992
STAT,1872,47,20-24,1919,0.011317915667079652
STAT,1938,28,30-34,1966,36.65449633216999
STAT,1896,15,45-49,1911,0.0818806082387781
STAT,1899,16,25-29,1915,7.353043480218033
SIM,1869,42,45-49,1911,3
STAT,1902,19,na,1921,3349.159791726202
STAT,1900,30,50-100,1930,1.2103956421567401
STAT,1946,19,50-100,1965,0.3923060281414538
SIM,1861,21,35-39,1882,8
STAT,1882,51,25-29,1933,0.0032696712974962993
STAT,1884,31,15-19,1915,0.13345519480003412
STAT,1831,33,15-19,1864,0.11219984959118838
SIM,1887,22,na,1909,2449
STAT,1843,76,na,1919,639.9206710227463
STAT,1869,30,35-39,1899,9.342682948648232
STAT,1902,21,40-44,1923,2.786587077495212
STAT,1901,39,15-19,1940,0.01586609435075128
SIM,1914,9,na,1923,3901
STAT,1870,30,25-29,1900,9.568750809375533
STAT,1880,43,15-19,1923,0.013654337143469638
SIM,1927,28,20-24,1955,22
SIM,1828,41,45-49,1869,4
SIM,1954,10,na,1964,4484
STAT,1868,25,35-39,1893,8.755988771350596
STAT,1919,28,20-24,1947,18.566823112967935
SIM,1899,66,na,1965,2386
STAT,1820,110,na,1930,1.4557702727520806E-4
STAT,1902,44,15-19,1946,0.0012612881752435622
STAT,1941,20,50-100,1961,0.6428218079966936
STAT,1851,106,na,1957,0.013568085475752605
STAT,1895,47,15-19,1942,2.76593924305923E-4
STAT,1853,40,25-29,1893,0.4908856904659313
STAT,1896,70,na,1966,2021.1838332903592
STAT,1842,20,20-24,1862,63.85889129053972
STAT,1917,48,15-19,1965,3.624792343246901E-4
SIM,1857,22,20-24,1879,66
STAT,1891,47,30-34,1938,0.06352173877970486
STAT,1853,21,35-39,1874,5.255743672757652
STAT,1920,25,15-19,1945,0.7365403211872235
STAT,1898,32,20-24,1930,3.455643297279256
STAT,1817,40,15-19,1857,0.03797233025477306
STAT,1873,19,50-100,1892,0.046688099275453455
STAT,1924,22,30-34,1946,32.0378624909439
STAT,1863,16,na,1879,2184.3235718650585
STAT,1873,19,30-34,1892,1.5189198052400443
STAT,1821,76,na,1897,504.7445554244117
SIM,1851,24,na,1875,1857
STAT,1867,53,25-29,1920,0.003091593050098592
STAT,1939,26,30-34,1965,37.228814210527425
SIM,1901,16,na,1917,3327
STAT,1843,40,40-44,1883,1.6048555945838427
SIM,1884,31,30-34,1915,22
STAT,1810,50,30-34,1860,0.019763453974245972
SIM,1846,18,25-29,1864,5
STAT,1838,18,25-29,1856,4.995658070537893
STAT,1846,17,50-100,1863,0.04564719225711676
STAT,1919,15,15-19,1934,9.54968773020121
STAT,1909,33,45-49,1942,1.4126396793046578
STAT,1833,42,15-19,1875,0.01026700507856395
STAT,1943,25,45-49,1968,1.7396745072056172
STAT,1876,31,30-34,1907,17.110407326346294
STAT,1813,57,na,1870,1064.1772311425786
SIM,1775,80,na,1855,184
STAT,1922,33,na,1955,4019.885089346287
SIM,1897,34,50-100,1931,2
SIM,1906,31,na,1937,3306
STAT,1808,72,na,1880,587.9550966739247
SIM,1864,74,na,1938,915
STAT,1920,39,25-29,1959,1.016233409164297
STAT,1888,30,45-49,1918,1.9625365311349807
STAT,1822,35,15-19,1857,0.10947060284338721
SIM,1834,40,40-44,1874,7
STAT,1852,42,25-29,1894,0.46498185082143134
SIM,1812,44,na,1856,1359
STAT,1863,40,35-39,1903,1.5163435458567125
STAT,1873,53,25-29,1926,0.00333916505230231
STAT,1921,37,25-29,1958,1.0385880586020526
SIM,1868,23,35-39,1891,6
SIM,1911,0,na,1911,3918
STAT,1832,29,50-100,1861,0.5117613510004496
STAT,1882,56,na,1938,1873.8431063300181
STAT,1915,15,30-34,1930,2.4212086663769834
STAT,1850,46,30-34,1896,0.06843032000532208
STAT,1876,20,50-100,1896,0.4003801229305437
STAT,1930,42,25-29,1972,0.08875839953457307
STAT,1909,46,15-19,1955,3.2058022936303805E-4
STAT,1866,32,25-29,1898,8.924599513164745
SIM,1916,25,40-44,1941,5
SIM,1865,24,20-24,1889,56
SIM,1838,16,25-29,1854,8
STAT,1809,95,na,1904,5.335394834147141
STAT,1887,45,15-19,1932,4.2688723592550866E-4
STAT,1900,30,20-24,1930,3.570844642413489
STAT,1893,31,40-44,1924,5.216738428830182
STAT,1883,14,na,1897,2384.2108064327253
STAT,1857,24,20-24,1881,53.16729030083912
STAT,1846,31,45-49,1877,1.5444296822388468
SIM,1848,39,40-44,1887,3
SIM,1864,19,30-34,1883,2
STAT,1829,35,na,1864,1688.179545986084
STAT,1820,39,20-24,1859,1.5646863349742417
SIM,1848,24,20-24,1872,59
SIM,1879,30,45-49,1909,3
SIM,1948,17,35-39,1965,5
STAT,1874,37,na,1911,2274.0442976635563
STAT,1877,41,25-29,1918,0.632119234787975
STAT,1876,66,na,1942,1599.6817669393788
STAT,1849,22,20-24,1871,62.476958702062994
STAT,1947,25,na,1972,4007.356753684269
SIM,1899,33,50-100,1932,1
SIM,1958,7,na,1965,4785
SIM,1910,21,40-44,1931,3
STAT,1847,29,30-34,1876,22.000013582903087
SIM,1825,94,na,1919,8
SIM,1896,30,45-49,1926,1
STAT,1920,28,50-100,1948,1.0278473950664766
SIM,1923,15,30-34,1938,16
STAT,1935,23,45-49,1958,1.4469785977342249
STAT,1845,89,na,1934,74.33890179178039
STAT,1861,20,30-34,1881,14.582479638798166
STAT,1921,44,25-29,1965,0.07572860966278269
SIM,1887,19,25-29,1906,10
STAT,1821,51,45-49,1872,0.022452122258373456
STAT,1810,101,na,1911,0.2413960134507092
STAT,1835,30,30-34,1865,14.444497174859984
STAT,1898,21,15-19,1919,4.230270115317369
STAT,1769,114,na,1883,2.329293884107071E-4
STAT,1817,50,40-44,1867,0.023668895411477205
STAT,1845,52,35-39,1897,0.006059587626831162
STAT,1905,22,20-24,1927,94.09962412680251
STAT,1884,85,na,1969,537.503814360042
STAT,1863,31,45-49,1894,1.4515666282950093
STAT,1914,36,50-100,1950,0.3979317778956855
SIM,1907,16,na,1923,3520
SIM,1924,27,40-44,1951,8
STAT,1867,89,na,1956,104.65759725622101
SIM,1913,22,20-24,1935,110
STAT,1926,40,45-49,1966,0.19435889700842027
SIM,1824,30,20-24,1854,1
STAT,1917,35,45-49,1952,0.6752784237651238
SIM,1855,29,30-34,1884,24
STAT,1935,36,15-19,1971,0.025390255001460752
SIM,1811,96,na,1907,3
SIM,1939,27,35-39,1966,19
SIM,1943,23,45-49,1966,2
SIM,1854,7,na,1861,2355
SIM,1907,27,40-44,1934,4
STAT,1867,41,40-44,1908,2.0043114213068662
STAT,1826,52,25-29,1878,0.0031544599200394948
STAT,1900,48,20-24,1948,0.008759342274720966
STAT,1939,33,30-34,1972,15.176893707292313
STAT,1883,21,20-24,1904,64.020374377684
SIM,1886,20,35-39,1906,5
STAT,1930,27,25-29,1957,79.06303394157389
STAT,1912,37,50-100,1949,0.387134943282785
SIM,1829,87,na,1916,85
STAT,1908,29,na,1937,3321.6533124319526
SIM,1954,16,20-24,1970,135
SIM,1857,29,40-44,1886,1
SIM,1925,29,na,1954,4105
STAT,1911,31,35-39,1942,8.441138978543481
STAT,1843,52,25-29,1895,0.0023797047211810787
STAT,1874,43,15-19,1917,0.013233280864869076
STAT,1832,39,na,1871,1585.4517558893635
SIM,1865,28,50-100,1893,1
SIM,1937,16,20-24,1953,111
STAT,1857,20,15-19,1877,2.8787806769228172
STAT,1868,32,35-39,1900,9.12795109178518
SIM,1860,30,30-34,1890,24
STAT,1826,91,na,1917,31.644311473185574
SIM,1848,42,na,1890,1642
SIM,1844,76,na,1920,588
STAT,1907,44,na,1951,3175.005187787859
STAT,1857,74,na,1931,826.8601757802555
SIM,1889,0,na,1889,3397
STAT,1877,19,15-19,1896,5.784284755723523
STAT,1837,41,45-49,1878,1.1609524727169178
STAT,1849,29,40-44,1878,2.624651411255233
STAT,1870,51,50-100,1921,0.01406361216397832
STAT,1841,50,25-29,1891,0.002476997134766035
SIM,1894,29,na,1923,2982
STAT,1860,78,na,1938,598.8990781852801
STAT,1842,15,50-100,1857,0.04610123703457456
SIM,1915,45,na,1960,3364
STAT,1876,20,25-29,1896,56.20535578585219
SIM,1862,89,na,1951,73
SIM,1876,32,35-39,1908,11
STAT,1946,16,20-24,1962,142.09745327284796
STAT,1857,52,na,1909,1595.7010569963848
STAT,1898,47,40-44,1945,0.12288276405440979
SIM,1875,37,na,1912,2293
STAT,1859,7,na,1866,2160.2594160307463
SIM,1886,28,50-100,1914,3
SIM,1871,40,35-39,1911,1
SIM,1875,41,40-44,1916,7
SIM,1883,88,na,1971,308
STAT,1851,25,40-44,1876,2.5596401340274944
STAT,1929,16,20-24,1945,163.8487778140233
STAT,1870,54,45-49,1924,0.013079689916762916
STAT,1893,43,25-29,1936,0.05303737212399221
SIM,1839,34,20-24,1873,2
STAT,1880,36,15-19,1916,0.056195461973228715
STAT,1928,43,na,1971,4465.54838072329
SIM,1942,15,40-44,1957,1
SIM,1924,23,35-39,1947,12
STAT,1894,41,25-29,1935,0.7831379552378297
SIM,1854,31,45-49,1885,3
STAT,1916,23,35-39,1939,9.292117556723161
STAT,1897,20,45-49,1917,0.8862402398179322
STAT,1813,45,15-19,1858,0.0011300615772099412
STAT,1852,30,30-34,1882,13.380926785813022
SIM,1865,20,15-19,1885,3
STAT,1945,18,20-24,1963,139.86372025106024
STAT,1888,27,50-100,1915,0.7141834259517621
SIM,1844,86,na,1930,107
STAT,1844,46,50-100,1890,0.17105931121108783
SIM,1891,21,20-24,1912,71
STAT,1934,15,40-44,1949,1.7955685305065647
STAT,1866,29,40-44,1895,2.5914438251114653
SIM,1838,29,30-34,1867,28
STAT,1898,25,20-24,1923,15.099466791469686
STAT,1827,50,25-29,1877,0.003254567600678704
STAT,1911,27,15-19,1938,0.6504041364185694
STAT,1809,57,na,1866,1065.9453971255962
SIM,1938,26,30-34,1964,46
SIM,1805,58,na,1863,1034
SIM,1908,19,20-24,1927,18
STAT,1806,102,na,1908,0.10166823635863836
STAT,1867,67,na,1934,1406.2119511221292
STAT,1916,20,30-34,1936,28.62103212652369
STAT,1785,109,na,1894,5.258786653023536E-4
STAT,1891,55,na,1946,2416.704818951864
SIM,1885,15,na,1900,2438
STAT,1879,30,45-49,1909,1.7382801481667123
STAT,1912,37,25-29,1949,0.907875712282297
STAT,1816,38,50-100,1854,4.521330469112024
STAT,1924,29,na,1953,4090.99666417631
STAT,1932,11,na,1943,4963.820292172924
SIM,1864,15,15-19,1879,7
STAT,1859,48,na,1907,1670.3785138819119
STAT,1872,22,50-100,1894,0.3864129171170223
SIM,1874,52,na,1926,1987
SIM,1848,42,25-29,1890,3
SIM,1848,20,na,1868,1934
STAT,1850,42,15-19,1892,0.009722886599509165
SIM,1852,31,35-39,1883,11
SIM,1907,26,na,1933,3322
STAT,1791,100,na,1891,0.1965707049794506
STAT,1812,62,na,1874,976.2726710824822
SIM,1854,45,50-100,1899,1
STAT,1851,90,na,1941,56.71340683168565
STAT,1794,79,na,1873,280.2818278625533
SIM,1924,20,30-34,1944,34
STAT,1907,28,50-100,1935,0.8845940606344133
STAT,1903,25,15-19,1928,0.6139826809008572
STAT,1878,51,35-39,1929,0.008516349580682384
STAT,1833,30,20-24,1863,2.180122732892626
STAT,1933,23,35-39,1956,11.795074529775722
SIM,1892,41,40-44,1933,5
SIM,1821,101,na,1922,1
STAT,1893,40,20-24,1933,0.19218222068027063
SIM,1836,35,na,1871,1685
SIM,1825,72,na,1897,687
STAT,1905,47,35-39,1952,0.10733262397404741
SIM,1917,30,40-44,1947,9
STAT,1818,50,25-29,1868,0.007545106878841491
SIM,1795,79,na,1874,264
SIM,1890,1,na,1891,3300
SIM,1920,37,25-29,1957,1
STAT,1889,14,na,1903,3002.113277188766
SIM,1857,25,25-29,1882,35
SIM,1930,6,na,1936,4928
STAT,1853,38,na,1891,1774.1507484796718
STAT,1880,92,na,1972,171.61401470986075
STAT,1884,41,40-44,1925,2.108794553772423
STAT,1875,41,15-19,1916,0.013470222193929375
STAT,1846,44,15-19,1890,0.010104544580262702
STAT,1885,41,25-29,1926,0.6074190894855145
STAT,1948,16,30-34,1964,13.181674645807597
STAT,1851,42,40-44,1893,1.6160087157978964
SIM,1871,43,50-100,1914,3
SIM,1905,27,30-34,1932,45
STAT,1838,49,na,1887,1514.6134711743628
STAT,1863,43,50-100,1906,0.869490177495426
SIM,1806,80,na,1886,240
STAT,1777,94,na,1871,3.5540582262150044
STAT,1920,36,20-24,1956,0.27290546954275885
STAT,1868,15,na,1883,2345.196998431516
SIM,1904,35,25-29,1939,1
STAT,1799,78,na,1877,303.0567743369133
SIM,1871,60,na,1931,1800
STAT,1932,33,na,1965,4746.647800356147
SIM,1884,20,25-29,1904,54
STAT,1901,34,na,1935,3128.50265128558
STAT,1881,24,15-19,1905,2.9918632007212977
SIM,1874,74,na,1948,1020
STAT,1895,20,35-39,1915,7.229851215196982
STAT,1787,94,na,1881,4.083216381730181
STAT,1865,51,25-29,1916,0.003047417145979775
SIM,1943,20,40-44,1963,4
STAT,1891,33,na,1924,2777.3056830054475
STAT,1914,30,na,1944,3625.4691183430314
STAT,1918,21,50-100,1939,0.672448249925023
STAT,1886,43,50-100,1929,1.0466286896462134
STAT,1909,30,40-44,1939,3.556344293039908
SIM,1816,95,na,1911,7
SIM,1820,73,na,1893,577
STAT,1856,15,15-19,1871,5.233707684438631
SIM,1880,38,30-34,1918,8
STAT,1934,4,na,1938,5157.406024659705
STAT,1790,98,na,1888,0.5621525273277497
SIM,1856,71,na,1927,1060
SIM,1868,67,na,1935,1413
SIM,1898,26,25-29,1924,47
STAT,1902,24,45-49,1926,0.9238710145292801
STAT,1831,109,na,1940,4.1541111365937046E-4
STAT,1915,41,20-24,1956,0.016821211153244774
SIM,1922,15,na,1937,4001
STAT,1871,19,na,1890,2356.4956106937675
SIM,1785,80,na,1865,212
SIM,1874,89,na,1963,212
STAT,1889,42,20-24,1931,0.18498843897662642
STAT,1867,50,20-24,1917,6.639988572646058E-4
SIM,1937,14,na,1951,3530
STAT,1844,31,35-39,1875,8.498666967766994
STAT,1844,40,25-29,1884,0.46862681728515776
STAT,1772,95,na,1867,2.1360222725347757
STAT,1938,17,25-29,1955,40.384100950066724
STAT,1834,40,15-19,1874,0.010600087255286036
STAT,1828,49,na,1877,1368.6162728599722
STAT,1800,77,na,1877,345.5565889223332
STAT,1874,22,na,1896,2282.8002611418424
STAT,1889,36,na,1925,2760.8945162087102
SIM,1891,17,25-29,1908,10
SIM,1927,19,30-34,1946,17
SIM,1872,23,na,1895,2219
STAT,1916,0,na,1916,4500.684474128333
SIM,1957,5,na,1962,4913
SIM,1851,40,40-44,1891,4
STAT,1879,19,25-29,1898,5.573624500499448
SIM,1836,57,na,1893,1279
SIM,1873,2,na,1875,2982
STAT,1918,7,na,1925,4110.2700649805965
STAT,1937,33,20-24,1970,2.278323132639933
SIM,1919,11,na,1930,4211
SIM,1946,17,25-29,1963,52
STAT,1853,16,na,1869,2102.098053574748
STAT,1861,89,na,1950,82.51819072434738
SIM,1800,59,na,1859,956
SIM,1892,8,na,1900,3413
STAT,1878,2,na,1880,3189.6552894896945
STAT,1861,47,45-49,1908,0.18451073818434263
STAT,1818,72,na,1890,620.206064566715
SIM,1833,31,25-29,1864,12
SIM,1930,25,25-29,1955,79
STAT,1857,27,25-29,1884,32.46314366489632
SIM,1870,38,na,1908,2145
STAT,1919,51,na,1970,3716.3988996754583
STAT,1825,52,40-44,1877,0.010349519544918445
STAT,1848,41,20-24,1889,0.11938174105114831
SIM,1893,66,na,1959,2103
STAT,1931,37,35-39,1968,3.0261026077110067
STAT,1904,37,25-29,1941,0.8420990080466421
SIM,1891,37,na,1928,2756
STAT,1899,14,na,1913,3331.9848103593176
STAT,1892,22,25-29,1914,67.73588788038059
STAT,1939,29,35-39,1968,14.24440339187079
STAT,1873,50,20-24,1923,7.171712909873223E-4
SIM,1916,28,45-49,1944,2
STAT,1883,17,25-29,1900,5.248599638661507
SIM,1931,17,30-34,1948,14
SIM,1880,21,45-49,1901,1
STAT,1846,48,30-34,1894,0.0708947977032073
STAT,1783,110,na,1893,4.129184834372729E-4
SIM,1891,39,45-49,1930,3
SIM,1939,31,30-34,1970,19
SIM,1801,81,na,1882,179
SIM,1889,66,na,1955,1909
SIM,1853,68,na,1921,1181
STAT,1921,30,40-44,1951,4.147134148907675
SIM,1912,37,25-29,1949,4
STAT,1852,106,na,1958,0.0167577405302847
STAT,1849,23,na,1872,1924.5362094293037
STAT,1857,23,50-100,1880,0.34823439110725546
SIM,1890,52,na,1942,2691
STAT,1943,22,40-44,1965,3.3794620742873818
SIM,1883,15,25-29,1898,6
SIM,1874,36,40-44,1910,4
SIM,1821,47,50-100,1868,3
STAT,1825,31,25-29,1856,19.93909660171927
SIM,1907,16,35-39,1923,1
STAT,1855,23,na,1878,1762.3038032325305
STAT,1875,15,25-29,1890,5.52804177554271
SIM,1896,3,na,1899,3335
STAT,1923,17,30-34,1940,13.5208433194633
SIM,1839,46,50-100,1885,1
STAT,1868,49,20-24,1917,0.010590273748177927
STAT,1849,25,25-29,1874,38.14748660853128
STAT,1926,42,35-39,1968,0.23450763440441974
STAT,1904,52,na,1956,2919.5666606725317
STAT,1834,24,na,1858,1747.313643279678
STAT,1887,29,na,1916,2503.7778481544874
STAT,1931,34,50-100,1965,1.0221169686817335
STAT,1915,18,35-39,1933,0.8275022902101548
STAT,1935,20,40-44,1955,4.328425411372238
STAT,1819,57,na,1876,1193.616250814153
STAT,1870,28,50-100,1898,0.5907553360828158
SIM,1841,33,25-29,1874,11
STAT,1957,5,na,1962,4896.35571959313
SIM,1826,32,50-100,1858,5
STAT,1852,53,na,1905,1535.9531871308534
STAT,1948,18,50-100,1966,0.4049312749099303
SIM,1870,30,25-29,1900,13
STAT,1795,97,na,1892,1.118904614842286
STAT,1871,42,35-39,1913,1.6965829009432571
STAT,1899,30,20-24,1929,3.526970724265777
STAT,1881,41,15-19,1922,0.01265996558459907
STAT,1888,51,na,1939,2415.4681727418956
STAT,1870,21,35-39,1891,5.424424528214691
STAT,1873,2,na,1875,3153.1794862631623
STAT,1946,19,25-29,1965,45.37673974666911
SIM,1845,49,na,1894,1548
SIM,1900,31,na,1931,3163
SIM,1893,36,50-100,1929,1
SIM,1850,61,na,1911,1381
SIM,1923,18,35-39,1941,6
STAT,1921,46,15-19,1967,3.932770588601761E-4
STAT,1908,28,45-49,1936,1.537442675418654
SIM,1879,17,25-29,1896,7
STAT,1885,36,50-100,1921,1.1616604329485494
SIM,1889,43,25-29,1932,3
SIM,1794,94,na,1888,3
STAT,1852,33,35-39,1885,7.523221389343861
STAT,1859,22,50-100,1881,0.31812215320767784
STAT,1917,44,na,1961,3649.3069760305048
STAT,1923,43,20-24,1966,0.019468733045326314
SIM,1859,22,30-34,1881,16
STAT,1939,28,na,1967,3556.046020391504
STAT,1802,84,na,1886,112.1981686762174
STAT,1884,51,35-39,1935,0.008073457772233268
STAT,1921,41,20-24,1962,0.018818201751547324
SIM,1855,9,na,1864,2351
SIM,1938,28,50-100,1966,5
STAT,1792,83,na,1875,132.02644410253626
STAT,1843,38,na,1881,1673.0846238146655
SIM,1906,32,30-34,1938,19
STAT,1882,41,na,1923,2132.9792302867413
STAT,1870,51,40-44,1921,0.009803299691496143
SIM,1804,95,na,1899,8
STAT,1771,84,na,1855,72.02770000000001
SIM,1915,30,na,1945,3507
SIM,1860,38,na,1898,1953
STAT,1813,47,50-100,1860,0.6714371301116374
STAT,1822,54,30-34,1876,0.007402434808530684
STAT,1867,52,na,1919,1899.859749729835
STAT,1913,49,35-39,1962,0.11818900043287502
STAT,1915,15,na,1930,3836.5874138470276
SIM,1855,52,50-100,1907,1
SIM,1857,34,na,1891,1858
SIM,1899,31,25-29,1930,18
STAT,1822,39,na,1861,1427.676827587443
SIM,1850,16,25-29,1866,7
STAT,1804,58,na,1862,1030.930518676505
SIM,1819,87,na,1906,89
STAT,1919,45,20-24,1964,0.011376839765691586
STAT,1859,51,25-29,1910,0.002675948345354574
STAT,1851,51,30-34,1902,0.004302411951433583
SIM,1882,23,na,1905,2224
STAT,1934,18,45-49,1952,0.6366362755392946
STAT,1932,18,50-100,1950,0.46743069373006035
STAT,1941,31,20-24,1972,2.420694249313928
STAT,1956,16,30-34,1972,15.238678866757695
SIM,1839,37,25-29,1876,2
SIM,1884,52,na,1936,2107
STAT,1851,21,25-29,1872,49.53166702738374
SIM,1878,25,45-49,1903,1
SIM,1858,19,na,1877,2183
STAT,1922,25,25-29,1947,70.83779980979315
STAT,1860,30,15-19,1890,0.11003427822782887
SIM,1875,15,na,1890,2469
STAT,1873,74,na,1947,1063.304492312291
SIM,1838,42,na,1880,1620
STAT,1842,16,25-29,1858,5.3009697897884145
STAT,1900,33,25-29,1933,13.366333777569002
STAT,1819,35,na,1854,1564.7584672562386
SIM,1912,17,20-24,1929,20
STAT,1841,54,40-44,1895,0.0070582999881503294
SIM,1815,43,25-29,1858,3
STAT,1858,37,na,1895,1745.028641471247
STAT,1892,43,40-44,1935,2.6422305754151374
STAT,1904,17,20-24,1921,24.02315993351582
STAT,1900,71,na,1971,2134.1354745115336
SIM,1860,33,35-39,1893,9
STAT,1813,49,30-34,1862,0.2561324758633245
STAT,1920,48,na,1968,3825.749771584121
SIM,1835,48,50-100,1883,3
SIM,1882,34,25-29,1916,11
STAT,1837,38,na,1875,1674.8513159269698
STAT,1874,34,25-29,1908,9.801757970954851
SIM,1850,38,45-49,1888,4
STAT,1918,16,45-49,1934,0.10330739509191153
SIM,1807,91,na,1898,20
SIM,1900,53,na,1953,2809
STAT,1897,16,15-19,1913,7.516021139266583
STAT,1917,32,40-44,1949,3.8712776001423848
SIM,1929,15,25-29,1944,65
SIM,1925,32,40-44,1957,7
SIM,1820,47,na,1867,1428
STAT,1837,50,35-39,1887,0.0058342048304731615
STAT,1820,46,45-49,1866,0.40172781080599157
STAT,1887,49,30-34,1936,0.05649371031684332
STAT,1852,75,na,1927,746.3458594934771
SIM,1817,43,na,1860,1435
SIM,1887,30,45-49,1917,1
STAT,1902,45,na,1947,3030.02601639107
SIM,1865,85,na,1950,219
STAT,1865,40,45-49,1905,1.294453391248705
STAT,1868,41,25-29,1909,0.5814221258629962
STAT,1893,28,35-39,1921,11.51899304255699
SIM,1825,57,na,1882,1196
STAT,1921,45,25-29,1966,0.05675737745366079
STAT,1923,44,na,1967,4087.056140518782
SIM,1830,35,25-29,1865,2
SIM,1930,20,45-49,1950,2
SIM,1933,21,25-29,1954,140
SIM,1881,42,50-100,1923,1
STAT,1889,67,na,1956,1874.9938349656536
SIM,1853,42,40-44,1895,6
SIM,1827,34,40-44,1861,3
STAT,1896,29,15-19,1925,0.5620321874244811
SIM,1806,74,na,1880,470
SIM,1802,60,na,1862,926
STAT,1840,89,na,1929,68.94217806903043
STAT,1941,15,30-34,1956,11.866602376015061
STAT,1866,21,20-24,1887,60.97298415459991
STAT,1829,38,15-19,1867,0.0500014942961066
SIM,1848,24,30-34,1872,16
STAT,1869,54,20-24,1923,6.567647411753755E-4
STAT,1882,49,40-44,1931,0.1540000987099823
SIM,1887,40,45-49,1927,1
STAT,1871,100,na,1971,8.070447582321037
SIM,1877,45,50-100,1922,4
STAT,1848,69,na,1917,1090.4698899828625
SIM,1874,21,20-24,1895,57
SIM,1791,71,na,1862,523
SIM,1915,30,20-24,1945,2
SIM,1860,40,35-39,1900,3
STAT,1849,24,25-29,1873,51.15700937841859
SIM,1834,93,na,1927,15
STAT,1871,57,na,1928,1885.179173203128
SIM,1873,40,45-49,1913,2
STAT,1845,48,25-29,1893,0.04024727730464033
STAT,1897,50,na,1947,2759.4412302628043
SIM,1881,25,30-34,1906,25
STAT,1925,21,25-29,1946,104.76307605326599
SIM,1842,25,na,1867,1834
STAT,1882,17,20-24,1899,16.287474175243624
STAT,1813,42,20-24,1855,0.5194607774353767
STAT,1850,48,35-39,1898,0.09744923979780437
STAT,1826,37,35-39,1863,7.7180359254524555
STAT,1843,34,30-34,1877,13.886184957719742
STAT,1777,104,na,1881,0.02885060861880377
STAT,1923,31,15-19,1954,0.13973749485137318
SIM,1812,45,50-100,1857,3
SIM,1855,8,na,1863,2367
STAT,1847,38,35-39,1885,5.355541251913484
STAT,1858,75,na,1933,762.5034881555252
SIM,1843,35,35-39,1878,13
STAT,1852,74,na,1926,804.5814660027565
STAT,1873,19,20-24,1892,16.894870254742305
SIM,1855,38,35-39,1893,8
SIM,1910,14,na,1924,3703
STAT,1894,14,na,1908,3125.1436806354536
SIM,1919,23,15-19,1942,7
STAT,1871,35,20-24,1906,0.729979470658891
SIM,1877,70,na,1947,1328
STAT,1852,32,30-34,1884,13.105904702396423
STAT,1840,26,30-34,1866,20.75429405011354
SIM,1853,43,50-100,1896,3
STAT,1898,28,na,1926,3040.2386593683227
SIM,1851,34,30-34,1885,22
SIM,1897,24,50-100,1921,1
SIM,1860,32,30-34,1892,14
SIM,1834,37,35-39,1871,11
STAT,1835,35,35-39,1870,5.682169183158454
STAT,1893,20,25-29,1913,68.99102415741172
STAT,1845,42,40-44,1887,1.6208091887271068
STAT,1855,21,45-49,1876,0.5830948276208577
STAT,1781,106,na,1887,0.012785888943307542
SIM,1856,33,na,1889,1856
SIM,1839,26,30-34,1865,24
SIM,1874,58,na,1932,1823
STAT,1880,33,20-24,1913,2.6807098989426517
SIM,1870,44,na,1914,2101
SIM,1866,22,25-29,1888,56
STAT,1864,35,30-34,1899,4.529971052110182
STAT,1887,56,na,1943,2155.2492401966742
SIM,1914,31,50-100,1945,1
STAT,1879,21,na,1900,2345.7940117036273
STAT,1867,38,35-39,1905,6.243113222054851
STAT,1898,17,30-34,1915,2.037633949072433
SIM,1925,20,35-39,1945,22
STAT,1817,53,45-49,1870,0.030728743917790746
STAT,1886,43,40-44,1929,2.228361417239915
STAT,1861,32,25-29,1893,8.045434012329475
STAT,1932,17,na,1949,4604.277967076668
SIM,1825,44,30-34,1869,1
SIM,1907,31,25-29,1938,13
STAT,1894,31,25-29,1925,12.485845691307643
STAT,1847,29,20-24,1876,10.249111085397578
STAT,1883,42,na,1925,2138.065608804835
STAT,1891,61,na,1952,2184.0261947877043
STAT,1871,17,45-49,1888,0.06167298337541842
STAT,1912,47,25-29,1959,0.04816129788552714
SIM,1837,42,na,1879,1605
STAT,1880,28,25-29,1908,41.981164041016775
STAT,1884,44,45-49,1928,1.377990494110501
STAT,1803,73,na,1876,505.6647350635332
STAT,1861,25,35-39,1886,7.744991901175287
STAT,1879,40,45-49,1919,1.49492096159714
STAT,1851,45,45-49,1896,0.1714574220553209
STAT,1819,52,40-44,1871,0.019146549799846195
SIM,1839,33,50-100,1872,2
STAT,1858,22,25-29,1880,48.64889682430125
SIM,1797,96,na,1893,1
SIM,1889,25,30-34,1914,32
STAT,1876,40,20-24,1916,0.15656631019716993
SIM,1949,20,20-24,1969,121
STAT,1933,16,35-39,1949,5.319507535966883
SIM,1894,43,40-44,1937,2
STAT,1922,20,45-49,1942,1.226226358378235
STAT,1824,63,na,1887,1010.6903774642217
SIM,1855,29,20-24,1884,9
SIM,1888,28,20-24,1916,13
STAT,1807,87,na,1894,65.53012509619631
STAT,1798,93,na,1891,8.301429035085084
STAT,1829,47,30-34,1876,0.07912025113888244
SIM,1846,19,na,1865,2037
STAT,1843,50,35-39,1893,0.005898524038011919
STAT,1866,98,na,1964,9.812022423477892
SIM,1875,38,35-39,1913,12
STAT,1827,40,25-29,1867,0.6376036773759792
STAT,1859,43,25-29,1902,0.4793439178538101
STAT,1817,44,30-34,1861,2.698161943610998
SIM,1916,25,50-100,1941,5
SIM,1941,16,35-39,1957,2
SIM,1924,34,na,1958,4155
SIM,1903,37,25-29,1940,3
STAT,1853,26,40-44,1879,2.645247237741863
STAT,1862,39,15-19,1901,0.044900581496406244
STAT,1866,94,na,1960,33.082287683032746
SIM,1816,80,na,1896,220
STAT,1780,83,na,1863,105.35435779320434
STAT,1830,34,20-24,1864,2.2434709030151936
STAT,1886,25,40-44,1911,3.0095847631798986
SIM,1892,35,30-34,1927,8
STAT,1840,19,40-44,1859,0.15358283431380026
SIM,1877,28,45-49,1905,4
STAT,1896,38,30-34,1934,6.616654406232298
STAT,1836,29,45-49,1865,0.9170503147412666
STAT,1859,49,50-100,1908,0.18080866182904284
STAT,1858,40,25-29,1898,0.4804331349619977
SIM,1920,29,25-29,1949,74
STAT,1911,59,na,1970,3089.739890877671
SIM,1861,26,40-44,1887,3
STAT,1884,35,30-34,1919,5.02144598428958
STAT,1917,20,35-39,1937,9.510418241861958
SIM,1916,49,50-100,1965,1
STAT,1855,28,15-19,1883,0.33364899177699425
SIM,1821,37,25-29,1858,1
STAT,1912,29,25-29,1941,60.84004305042108
SIM,1894,25,40-44,1919,8
STAT,1886,49,25-29,1935,0.05627950698979078
STAT,1896,22,45-49,1918,0.8700379735856488
STAT,1830,31,40-44,1861,3.7816244437740765
SIM,1840,24,30-34,1864,22
SIM,1861,30,25-29,1891,14
STAT,1928,41,45-49,1969,0.20071740359081383
STAT,1833,71,na,1904,818.9350288114397
SIM,1911,29,30-34,1940,46
STAT,1831,40,15-19,1871,0.010473850670076626
STAT,1818,42,25-29,1860,1.5145309095885913
STAT,1912,15,50-100,1927,0.07190479127578857
STAT,1844,50,25-29,1894,0.0024953632518039523
STAT,1807,101,na,1908,0.2122424169843359
STAT,1876,36,35-39,1912,6.936430799699303
STAT,1843,43,45-49,1886,1.027586673060876
SIM,1865,16,30-34,1881,1
STAT,1869,49,25-29,1918,0.05161426470187349
STAT,1892,19,na,1911,2972.3979377451737
STAT,1838,55,na,1893,1388.159820796417
SIM,1827,29,45-49,1856,2
SIM,1906,28,35-39,1934,22
SIM,1936,23,na,1959,2724
STAT,1907,23,30-34,1930,24.642217779982147
STAT,1878,83,na,1961,565.6491793387745
SIM,1875,30,25-29,1905,13
STAT,1873,36,na,1909,2268.1603068387103
STAT,1778,89,na,1867,32.82360262193083
STAT,1911,27,na,1938,3451.379631329542
STAT,1947,18,30-34,1965,12.967131938532354
STAT,1881,31,15-19,1912,0.1304932765141691
STAT,1879,46,30-34,1925,0.09599470054269134
STAT,1899,20,20-24,1919,89.73273830161247
SIM,1851,43,45-49,1894,2
SIM,1817,58,na,1875,1153
SIM,1822,36,30-34,1858,9
SIM,1876,69,na,1945,1407
SIM,1887,40,50-100,1927,1
STAT,1770,109,na,1879,0.002291028406148146
STAT,1835,42,25-29,1877,0.4897179702724046
SIM,1837,31,45-49,1868,1
STAT,1839,32,15-19,1871,0.11668052565618707
STAT,1814,40,15-19,1854,0.052218646809526474
SIM,1884,36,35-39,1920,10
STAT,1829,31,45-49,1860,1.788923650418703
SIM,1905,31,na,1936,3276
STAT,1853,30,25-29,1883,8.150014353777852
STAT,1874,54,30-34,1928,0.0055875415090529505
STAT,1933,20,20-24,1953,140.1680255045216
STAT,1857,16,30-34,1873,1.4040266971414643
STAT,1903,36,na,1939,3207.142543948055
STAT,1903,29,30-34,1932,33.60638703455081
SIM,1959,7,na,1966,4879
STAT,1862,33,50-100,1895,0.7369454261082692
STAT,1828,27,45-49,1855,1.917042513445583
STAT,1848,26,30-34,1874,22.499677010514958
STAT,1895,44,20-24,1939,0.013399105825489685
STAT,1905,15,na,1920,3464.724181112928
SIM,1932,23,30-34,1955,44
STAT,1849,17,35-39,1866,0.5064738638843727
STAT,1854,17,45-49,1871,0.0559089302156268
SIM,1867,36,35-39,1903,9
STAT,1885,21,na,1906,2233.756420586592
STAT,1781,102,na,1883,0.08290396645593326
STAT,1828,53,20-24,1881,5.147387058301643E-4
STAT,1913,46,30-34,1959,0.08240543129323669
STAT,1819,72,na,1891,666.6758176709731
SIM,1865,53,na,1918,1858
SIM,1872,40,50-100,1912,1
STAT,1933,29,50-100,1962,1.247289837863646
STAT,1841,90,na,1931,54.35362702263545
STAT,1860,21,25-29,1881,45.56042906861201
SIM,1887,22,45-49,1909,3
SIM,1852,32,25-29,1884,13
SIM,1898,25,25-29,1923,51
STAT,1782,94,na,1876,3.5449368024187873
STAT,1847,91,na,1938,42.73113973159285
STAT,1924,23,30-34,1947,31.938865495846866
STAT,1834,45,45-49,1879,0.1751174540454973
STAT,1879,22,45-49,1901,0.6895626116260581
SIM,1941,20,20-24,1961,111
SIM,1893,26,35-39,1919,11
STAT,1840,17,15-19,1857,5.042439261644821
SIM,1793,78,na,1871,281
SIM,1859,85,na,1944,188
SIM,1896,36,30-34,1932,10
STAT,1891,49,35-39,1940,0.09037342753369777
SIM,1932,18,35-39,1950,6
STAT,1833,53,30-34,1886,0.0036901767040468303
STAT,1890,17,30-34,1907,1.8408647249276124
STAT,1869,44,50-100,1913,0.9538029128408347
STAT,1963,1,na,1964,4724.555233052182
SIM,1866,39,na,1905,2062
STAT,1865,8,na,1873,2381.078762537205
SIM,1863,90,na,1953,56
SIM,1912,49,na,1961,3278
SIM,1859,53,na,1912,1705
SIM,1848,35,50-100,1883,1
STAT,1891,30,45-49,1921,2.0545295711020852
STAT,1913,39,40-44,1952,1.3816174160909473
STAT,1879,37,na,1916,2329.7626706356473
SIM,1826,94,na,1920,12
SIM,1947,19,35-39,1966,2
STAT,1862,37,na,1899,1902.966426001541
STAT,1903,36,20-24,1939,0.22471774008890605
SIM,1868,35,40-44,1903,3
STAT,1882,6,na,1888,2426.2824761550014
STAT,1895,18,45-49,1913,0.08024033018900799
SIM,1831,26,30-34,1857,26
STAT,1839,92,na,1931,27.730106458149677
STAT,1895,39,25-29,1934,3.510326429280365
SIM,1831,57,na,1888,1211
SIM,1903,25,50-100,1928,1
STAT,1907,47,45-49,1954,0.18387811418296934
SIM,1907,23,50-100,1930,2
STAT,1875,46,45-49,1921,0.22981008899506658
SIM,1927,31,50-100,1958,1
STAT,1939,19,35-39,1958,3.965310020596703
STAT,1819,88,na,1907,72.47131130577858
STAT,1851,27,50-100,1878,0.5387813332979332
STAT,1885,26,35-39,1911,9.117031678025944
SIM,1921,39,40-44,1960,3
SIM,1818,39,45-49,1857,2
SIM,1906,15,30-34,1921,4
STAT,1845,27,45-49,1872,0.9563158005746855
STAT,1924,18,35-39,1942,4.708073777593483
SIM,1915,23,30-34,1938,36
SIM,1840,93,na,1933,19
STAT,1838,21,45-49,1859,0.6117803398710541
STAT,1860,34,30-34,1894,13.26846205057799
STAT,1809,45,35-39,1854,0.40925227514307355
STAT,1872,41,15-19,1913,0.013145090963661666
SIM,1898,30,20-24,1928,3
SIM,1893,33,25-29,1926,14
STAT,1892,46,45-49,1938,0.15796582972739112
STAT,1907,30,20-24,1937,2.171200409726464
SIM,1913,50,na,1963,3231
STAT,1871,41,na,1912,2177.920182006926
STAT,1823,102,na,1925,0.1569017270054208
STAT,1899,46,30-34,1945,0.07087927802737748
SIM,1857,24,25-29,1881,55
STAT,1867,36,na,1903,2099.994618803646
STAT,1924,30,20-24,1954,2.700413043118496
STAT,1849,42,25-29,1891,0.4809401661791697
STAT,1881,27,30-34,1908,22.981165396786615
STAT,1862,50,45-49,1912,0.011890395089204338
SIM,1826,35,35-39,1861,8
STAT,1934,12,na,1946,5062.952890610798
STAT,1937,31,45-49,1968,1.471578201288117
STAT,1811,92,na,1903,18.063046335353196
STAT,1838,45,30-34,1883,0.06859499507996296
SIM,1882,16,30-34,1898,1
STAT,1791,67,na,1858,695.184535569454
STAT,1885,33,25-29,1918,9.604181105710712
STAT,1899,15,25-29,1914,7.369108135954414
STAT,1874,16,30-34,1890,1.5422185227761835
STAT,1823,52,30-34,1875,0.007055249893158686
STAT,1839,50,45-49,1889,0.00990276355482119
SIM,1898,15,30-34,1913,2
SIM,1950,21,25-29,1971,107
STAT,1821,44,20-24,1865,0.2576701096231109
STAT,1841,16,20-24,1857,15.856904025391337
SIM,1857,21,20-24,1878,61
STAT,1879,29,15-19,1908,0.44544766406127373
STAT,1866,24,25-29,1890,49.567068607569574
STAT,1901,44,45-49,1945,0.1355756196750772
SIM,1864,19,20-24,1883,14
SIM,1830,32,20-24,1862,2
SIM,1840,19,35-39,1859,2
STAT,1888,14,na,1902,2873.903566941815
SIM,1877,25,40-44,1902,4
SIM,1929,20,20-24,1949,136
STAT,1846,38,15-19,1884,0.04304505761977758
SIM,1848,27,35-39,1875,9
SIM,1865,24,30-34,1889,23
SIM,1836,25,na,1861,1815
SIM,1860,54,na,1914,1735
STAT,1869,31,na,1900,2192.8516039442234
STAT,1893,41,35-39,1934,2.1792210326140418
STAT,1926,26,50-100,1952,1.1310390103440915
SIM,1864,68,na,1932,1337
SIM,1842,31,25-29,1873,12
STAT,1856,19,20-24,1875,15.269757626762836
STAT,1870,22,25-29,1892,53.05301662277602
STAT,1835,32,30-34,1867,14.147615219631968
STAT,1922,27,na,1949,4004.5554303024714
SIM,1844,34,40-44,1878,4
SIM,1881,28,35-39,1909,8
STAT,1942,21,25-29,1963,91.52336378210785
STAT,1918,47,20-24,1965,0.01110983412532896
STAT,1845,19,45-49,1864,0.05773701393246621
STAT,1836,34,40-44,1870,3.476815258987918
STAT,1822,32,20-24,1854,7.881716628340442
STAT,1941,18,35-39,1959,4.081752233706157
SIM,1883,37,50-100,1920,1
STAT,1924,3,na,1927,4562.859637207314
SIM,1880,26,25-29,1906,51
SIM,1879,38,20-24,1917,1
STAT,1890,43,30-34,1933,1.3182355801888292
STAT,1867,44,45-49,1911,1.30971605596058
STAT,1871,32,40-44,1903,4.068153619777732
STAT,1867,30,25-29,1897,9.159024000009403
STAT,1896,40,45-49,1936,0.13098008763519117
STAT,1868,51,25-29,1919,0.0032078405979416814
STAT,1903,39,25-29,1942,0.8269154806402484
SIM,1852,19,na,1871,2111
SIM,1875,44,45-49,1919,4
STAT,1880,5,na,1885,2683.7524256197903
STAT,1863,22,na,1885,1999.7401527520485
SIM,1929,28,30-34,1957,54
STAT,1844,32,25-29,1876,8.506834274409277
STAT,1924,32,50-100,1956,0.9112317616326908
STAT,1933,37,45-49,1970,0.8771928214553444
STAT,1862,16,40-44,1878,0.170202559805764
STAT,1876,43,25-29,1919,0.6222208563414745
SIM,1890,20,na,1910,2963
SIM,1957,6,na,1963,4913
STAT,1865,22,15-19,1887,2.8591810553075656
SIM,1918,20,45-49,1938,2
STAT,1809,52,25-29,1861,0.009520718596549028
STAT,1875,22,25-29,1897,55.58632882655573
SIM,1841,31,na,1872,1738
SIM,1874,24,25-29,1898,51
SIM,1816,64,na,1880,905
STAT,1853,49,15-19,1902,2.9639767168487043E-4
STAT,1887,44,15-19,1931,0.014395657004341547
SIM,1911,39,25-29,1950,4
STAT,1853,31,50-100,1884,0.7215231381861705
STAT,1903,20,na,1923,3197.953045093673
STAT,1861,22,30-34,1883,14.373826993008358
STAT,1880,25,20-24,1905,11.763027793826952
STAT,1854,43,20-24,1897,0.11280751999098057
SIM,1848,10,na,1858,2215
STAT,1897,28,20-24,1925,14.769137859127568
SIM,1924,31,25-29,1955,8
STAT,1864,29,20-24,1893,9.806954251469891
SIM,1812,50,na,1862,1239
SIM,1877,44,50-100,1921,4
SIM,1839,34,30-34,1873,24
STAT,1874,49,35-39,1923,0.13230983848986289
SIM,1858,30,50-100,1888,6
STAT,1803,57,na,1860,1035.359673930395
STAT,1887,28,na,1915,2512.9248947714555
STAT,1877,35,40-44,1912,4.330406172960477
STAT,1891,65,na,1956,1999.9026881672648
SIM,1833,40,50-100,1873,1
STAT,1812,48,15-19,1860,0.0013171960214356953
STAT,1890,25,30-34,1915,29.281550392814896
SIM,1781,81,na,1862,151
STAT,1840,29,35-39,1869,7.782338422239748
STAT,1928,28,na,1956,4357.769288547646
SIM,1928,17,30-34,1945,15
SIM,1952,19,15-19,1971,48
SIM,1934,28,na,1962,4651
STAT,1787,93,na,1880,6.669960439299196
STAT,1873,28,35-39,1901,9.212236352346869
STAT,1823,34,30-34,1857,34.779649012749445
STAT,1858,18,40-44,1876,0.15731826028742946
STAT,1872,21,45-49,1893,0.6627609736236367
SIM,1811,65,na,1876,758
SIM,1831,34,30-34,1865,18
STAT,1916,16,35-39,1932,0.8431022875630108
STAT,1895,47,25-29,1942,0.03982955827752199
SIM,1821,34,20-24,1855,1
SIM,1930,34,na,1964,4617
STAT,1908,25,40-44,1933,4.226440368735397
STAT,1826,50,35-39,1876,0.007977637961085441
SIM,1860,35,35-39,1895,10
STAT,1808,107,na,1915,0.0018234481541840437
SIM,1800,65,na,1865,772
STAT,1780,112,na,1892,2.495631788137444E-4
STAT,1944,19,15-19,1963,46.10722460323861
SIM,1836,24,40-44,1860,1
SIM,1849,22,25-29,1871,61
STAT,1825,40,50-100,1865,1.204278145399952
STAT,1832,54,na,1886,1289.4852618344796
STAT,1857,54,30-34,1911,0.004313052514174821
SIM,1804,79,na,1883,280
SIM,1895,36,na,1931,2991
STAT,1836,26,40-44,1862,2.528241987977265
STAT,1809,58,na,1867,1045.0422078879628
STAT,1849,53,40-44,1902,0.007767595284336932
STAT,1916,31,25-29,1947,9.051437125776921
STAT,1866,17,35-39,1883,0.49073284447026116
STAT,1939,27,na,1966,3557.7537421877537
SIM,1862,45,50-100,1907,2
STAT,1836,52,40-44,1888,0.006897960438406468
STAT,1911,55,na,1966,3182.631306586484
SIM,1839,37,na,1876,1729
STAT,1814,73,na,1887,578.6704216366311
STAT,1852,35,35-39,1887,5.263782474014241
STAT,1950,20,20-24,1970,124.70550689423658
STAT,1834,31,25-29,1865,8.227241094216698
SIM,1852,25,35-39,1877,9
SIM,1853,96,na,1949,1
STAT,1890,76,na,1966,1421.7826089715998
STAT,1908,21,25-29,1929,80.46575831516495
STAT,1834,89,na,1923,65.1300232213839
SIM,1856,26,50-100,1882,1
SIM,1916,21,25-29,1937,95
STAT,1768,115,na,1883,1.2883255356069433E-4
STAT,1898,44,na,1942,2924.917445163087
STAT,1843,36,50-100,1879,0.9782097962111349
STAT,1844,25,35-39,1869,8.322741851952507
SIM,1871,33,20-24,1904,1
STAT,1901,26,45-49,1927,1.4732387492445456
STAT,1881,71,na,1952,1218.1477172652333
SIM,1834,43,45-49,1877,4
SIM,1878,32,45-49,1910,2
STAT,1856,40,na,1896,1720.7530863352797
STAT,1838,39,20-24,1877,0.6116350964463944
SIM,1844,26,40-44,1870,4
STAT,1870,15,35-39,1885,0.51946788836832
SIM,1884,33,30-34,1917,19
SIM,1895,37,25-29,1932,3
STAT,1781,77,na,1858,314.84901769099355
STAT,1906,18,50-100,1924,0.06723150318367647
STAT,1934,28,na,1962,4758.479939683021
SIM,1864,27,20-24,1891,11
STAT,1900,3,na,1903,3464.504115695935
STAT,1931,34,30-34,1965,19.4771733000176
STAT,1808,52,40-44,1860,0.0380323536779547
SIM,1818,75,na,1893,470
SIM,1906,25,30-34,1931,45
STAT,1873,25,30-34,1898,24.290829007717875
STAT,1899,19,40-44,1918,0.2354805671348523
STAT,1853,29,45-49,1882,0.8731365788533906
SIM,1854,85,na,1939,196
SIM,1840,27,35-39,1867,11
SIM,1897,18,20-24,1915,20
STAT,1874,19,35-39,1893,0.5267866252593246
STAT,1889,18,20-24,1907,20.621814890163805
SIM,1890,15,30-34,1905,3
STAT,1858,101,na,1959,0.8270067812964214
STAT,1869,46,20-24,1915,0.011013454528417123
SIM,1872,18,15-19,1890,4
SIM,1898,22,20-24,1920,89
STAT,1856,27,20-24,1883,8.960263773690079
SIM,1924,16,35-39,1940,8
STAT,1849,32,25-29,1881,8.093437083362199
STAT,1855,37,30-34,1892,3.7873401565706613
SIM,1940,25,30-34,1965,44
SIM,1914,17,30-34,1931,2
STAT,1924,26,35-39,1950,16.57030589193498
SIM,1857,32,25-29,1889,12
SIM,1861,29,45-49,1890,4
STAT,1858,45,30-34,1903,0.07241276468563212
STAT,1871,29,15-19,1900,0.42256390070884575
STAT,1876,33,30-34,1909,16.968855927700872
SIM,1938,20,45-49,1958,4
STAT,1882,29,na,1911,2176.865103600715
SIM,1903,29,25-29,1932,74
STAT,1831,25,25-29,1856,39.071069579624606
STAT,1872,33,15-19,1905,0.13437281658107428
STAT,1895,15,40-44,1910,0.2263097742000187
STAT,1906,17,30-34,1923,2.1930110371864915
STAT,1880,9,na,1889,2600.2600166806365
SIM,1897,48,50-100,1945,3
STAT,1864,18,15-19,1882,5.138555057187807
SIM,1903,49,50-100,1952,1
SIM,1946,15,25-29,1961,53
STAT,1793,62,na,1855,797.6952000000002
STAT,1852,27,35-39,1879,8.147761188192396
SIM,1847,56,na,1903,1555
STAT,1792,84,na,1876,106.8490012121826
STAT,1858,7,na,1865,2141.5153305950253
STAT,1803,104,na,1907,0.02242073818844182
STAT,1875,71,na,1946,1296.1109812614245
STAT,1918,29,15-19,1947,0.7046742594319195
SIM,1775,81,na,1856,152
SIM,1838,29,20-24,1867,10
SIM,1883,43,40-44,1926,2
STAT,1875,43,40-44,1918,2.1683025379393643
SIM,1817,42,30-34,1859,3
STAT,1869,47,na,1916,2049.431234118046
STAT,1916,23,25-29,1939,91.15496009982812
SIM,1853,7,na,1860,2265
STAT,1938,15,25-29,1953,40.57173137270509
STAT,1888,20,45-49,1908,0.7831685398536995
STAT,1832,27,35-39,1859,7.904519926056479
STAT,1923,12,na,1935,4395.284850170482
SIM,1945,21,15-19,1966,4
SIM,1908,34,50-100,1942,5
SIM,1937,19,25-29,1956,53
SIM,1904,30,45-49,1934,2
SIM,1936,3,na,1939,3030
SIM,1818,36,40-44,1854,8
STAT,1846,74,na,1920,823.1344102980331
STAT,1905,44,30-34,1949,0.10754318930865586
SIM,1875,16,na,1891,2468
STAT,1910,33,na,1943,3430.58962161944
STAT,1780,99,na,1879,0.2892887335289445
SIM,1896,20,45-49,1916,1
SIM,1924,23,25-29,1947,98
STAT,1799,94,na,1893,6.380596577868876
STAT,1898,25,30-34,1923,32.411442488921104
STAT,1851,37,na,1888,1712.904452043574
SIM,1896,39,35-39,1935,7
STAT,1877,27,40-44,1904,2.935456864089597
STAT,1867,51,35-39,1918,0.007673447180228313
STAT,1813,45,25-29,1858,0.1627290026692315
STAT,1848,29,35-39,1877,8.436813146432081
STAT,1880,36,25-29,1916,2.8812942420045706
SIM,1947,16,30-34,1963,17
STAT,1834,42,40-44,1876,1.6828124618404159
STAT,1875,32,25-29,1907,9.945719087006468
SIM,1819,88,na,1907,70
SIM,1862,38,25-29,1900,1
SIM,1856,17,20-24,1873,18
STAT,1857,24,30-34,1881,13.742512779495248
SIM,1860,27,35-39,1887,12
STAT,1823,77,na,1900,462.60638060858565
SIM,1946,13,na,1959,4000
SIM,1925,27,50-100,1952,1
STAT,1929,19,25-29,1948,51.963957619983454
STAT,1836,91,na,1927,37.52506891369075
STAT,1881,54,20-24,1935,6.549111468017229E-4
SIM,1843,32,30-34,1875,25
STAT,1866,47,35-39,1913,0.1214162845703072
SIM,1872,35,30-34,1907,8
STAT,1921,6,na,1927,4315.980252141436
STAT,1939,16,30-34,1955,11.529231011786418
STAT,1899,13,na,1912,3337.625397280722
SIM,1842,42,40-44,1884,6
SIM,1865,31,20-24,1896,1
SIM,1883,32,25-29,1915,12
STAT,1848,17,20-24,1865,16.33029029035392
STAT,1859,36,35-39,1895,5.3436587371879725
STAT,1864,53,30-34,1917,0.004931407619401164
STAT,1880,22,na,1902,2355.4343563869907
STAT,1932,25,30-34,1957,48.5244402522789
SIM,1932,15,30-34,1947,15
SIM,1866,70,na,1936,1207
STAT,1882,41,50-100,1923,0.9749702180078302
SIM,1884,20,na,1904,2333
STAT,1828,45,20-24,1873,0.00997670330320991
STAT,1909,45,na,1954,3219.907529135148
SIM,1822,39,35-39,1861,16
STAT,1841,48,40-44,1889,0.11705308666952481
STAT,1905,31,na,1936,3299.641504814934
STAT,1834,93,na,1927,18.118864904782665
STAT,1849,21,20-24,1870,62.928787395563134
STAT,1850,53,30-34,1903,0.0041287185872917855
SIM,1881,16,na,1897,1976
STAT,1861,50,25-29,1911,0.002822187048223812
SIM,1898,33,25-29,1931,16
SIM,1870,24,40-44,1894,5
STAT,1917,12,na,1929,4014.874120635692
STAT,1815,42,na,1857,1425.6319081279094
STAT,1862,24,40-44,1886,1.698348980068826
STAT,1818,46,40-44,1864,0.37057310337245625
STAT,1857,31,20-24,1888,2.047528231053531
STAT,1924,15,30-34,1939,13.77546523690778
SIM,1876,53,na,1929,2035
STAT,1895,36,20-24,1931,0.953945887615358
STAT,1896,19,50-100,1915,0.06079864511962784
STAT,1831,32,15-19,1863,0.11365697925964006
SIM,1918,30,50-100,1948,5
STAT,1830,28,15-19,1858,0.42804006150838547
STAT,1918,22,45-49,1940,1.1464253053025144
STAT,1901,8,na,1909,3437.4887526023726
SIM,1885,27,40-44,1912,7
STAT,1888,39,35-39,1927,7.817075286042174
STAT,1921,27,25-29,1948,69.29962764312869
STAT,1937,21,15-19,1958,4.898683609380097
SIM,1840,16,30-34,1856,2
STAT,1852,43,na,1895,1663.5127835548228
SIM,1940,28,na,1968,3512
STAT,1867,83,na,1950,352.15845143391164
STAT,1908,22,50-100,1930,0.5714743180131321
SIM,1865,27,35-39,1892,12
STAT,1900,17,35-39,1917,0.7190857844012941
SIM,1861,34,40-44,1895,2
STAT,1924,33,25-29,1957,10.18024006239791
STAT,1863,44,50-100,1907,0.8639949995736551
STAT,1814,44,30-34,1858,3.7025865558952997
SIM,1923,21,15-19,1944,4
STAT,1840,52,30-34,1892,0.00388561037789096
STAT,1843,35,45-49,1878,1.6048984692652162
SIM,1921,21,na,1942,3943
STAT,1825,46,35-39,1871,0.14480389533397584
STAT,1916,37,45-49,1953,0.6595086010400392
SIM,1880,23,20-24,1903,64
SIM,1887,32,na,1919,2469
STAT,1860,32,40-44,1892,3.324135156392493
STAT,1907,50,na,1957,3064.235975613372
SIM,1891,39,35-39,1930,16
SIM,1884,41,35-39,1925,1
SIM,1833,23,25-29,1856,44
STAT,1874,50,50-100,1924,0.014787012447303911
STAT,1863,33,20-24,1896,2.2314259168968595
STAT,1903,18,15-19,1921,7.956040200352057
STAT,1951,15,40-44,1966,1.5743233623394264
STAT,1907,29,50-100,1936,0.8739556137633465
STAT,1851,31,25-29,1882,7.7487551514350965
STAT,1860,37,35-39,1897,5.421462739702293
STAT,1872,28,15-19,1900,0.42840489607666077
STAT,1879,42,15-19,1921,0.013639357341275608
STAT,1919,38,25-29,1957,0.9982630681653959
STAT,1834,37,50-100,1871,0.9477454817665815
SIM,1847,36,30-34,1883,8
STAT,1946,21,45-49,1967,1.1832562221440937
SIM,1868,98,na,1966,6
STAT,1858,38,50-100,1896,0.9048558624904254
SIM,1851,35,45-49,1886,1
STAT,1852,37,50-100,1889,0.8949263425777476
STAT,1883,39,35-39,1922,6.485101165559486
STAT,1892,37,35-39,1929,8.3690365427702
SIM,1794,84,na,1878,80
SIM,1952,13,na,1965,4386
SIM,1911,18,15-19,1929,8
SIM,1835,71,na,1906,837
STAT,1853,34,40-44,1887,3.3103249873948473
STAT,1825,41,na,1866,1470.9942666675454
STAT,1922,32,50-100,1954,0.8825100953018045
STAT,1915,21,15-19,1936,5.213992931061045
STAT,1916,27,na,1943,3659.1689713161427
SIM,1932,33,25-29,1965,13
STAT,1951,20,35-39,1971,10.634804544634944
SIM,1838,52,na,1890,1414
SIM,1875,47,na,1922,2155
SIM,1835,19,na,1854,1918
SIM,1820,42,na,1862,1518
STAT,1881,35,30-34,1916,4.909999496915024
SIM,1929,23,25-29,1952,108
STAT,1918,35,50-100,1953,0.4220365824920777
SIM,1900,52,na,1952,2851
SIM,1852,22,30-34,1874,17
STAT,1809,50,35-39,1859,0.02409067029908855
STAT,1913,42,15-19,1955,0.0014148029612631782
STAT,1912,13,na,1925,3766.940840080426
SIM,1837,73,na,1910,717
STAT,1857,27,35-39,1884,7.404823380075496
STAT,1937,17,30-34,1954,11.201939509836055
STAT,1825,41,25-29,1866,0.7154213790027477
SIM,1891,28,50-100,1919,3
STAT,1898,49,50-100,1947,0.1734128481092791
STAT,1913,1,na,1914,4020.563559109576
STAT,1851,96,na,1947,6.176751640456588
STAT,1892,71,na,1963,1792.7187250473944
SIM,1856,29,35-39,1885,9
STAT,1922,48,25-29,1970,0.05740878613476632
STAT,1911,26,50-100,1937,0.9201764203470095
STAT,1876,41,35-39,1917,1.7753598380366375
STAT,1840,58,na,1898,1297.8134893744552
SIM,1856,22,15-19,1878,3
SIM,1896,28,30-34,1924,32
STAT,1837,43,20-24,1880,0.12007568104502986
SIM,1893,72,na,1965,1857
STAT,1813,56,na,1869,1085.4631637843906
STAT,1849,50,25-29,1899,0.0026942105712788886
STAT,1849,55,na,1904,1550.5122416827578
STAT,1840,25,na,1865,1795.8074880918812
SIM,1878,17,na,1895,2562
STAT,1861,95,na,1956,12.043182875658871
SIM,1945,17,30-34,1962,15
STAT,1851,36,35-39,1887,5.196016136402445
STAT,1840,53,20-24,1893,4.7648984927675826E-4
STAT,1844,22,30-34,1866,15.446065341625758
SIM,1805,64,na,1869,832
STAT,1881,47,50-100,1928,0.2230912218623068
SIM,1826,67,na,1893,863
STAT,1923,43,50-100,1966,0.12950939561533364
STAT,1840,34,30-34,1874,13.66901488402287
SIM,1835,44,40-44,1879,5
SIM,1889,35,25-29,1924,3
STAT,1899,47,45-49,1946,0.17151227093929197
SIM,1870,42,40-44,1912,8
STAT,1942,27,45-49,1969,1.7129583858607884
SIM,1818,41,50-100,1859,4
SIM,1932,26,35-39,1958,23
STAT,1869,20,30-34,1889,16.469077570011187
SIM,1862,73,na,1935,1007
SIM,1956,12,na,1968,4786
STAT,1859,47,40-44,1906,0.12812354086088604
STAT,1909,20,25-29,1929,81.58838484723262
STAT,1848,22,15-19,1870,2.984789402383007
STAT,1920,32,na,1952,3913.5009829244696
SIM,1889,67,na,1956,1861
SIM,1900,22,25-29,1922,86
STAT,1922,47,35-39,1969,0.13992423485851824
SIM,1879,36,30-34,1915,5
SIM,1912,24,20-24,1936,99
STAT,1862,42,40-44,1904,1.8145450291085985
STAT,1852,105,na,1957,0.03226924289977991
STAT,1890,21,15-19,1911,3.821763489830029
SIM,1927,38,25-29,1965,1
STAT,1836,30,25-29,1866,8.559913112484239
SIM,1909,4,na,1913,3719
SIM,1872,94,na,1966,49
STAT,1880,86,na,1966,453.095385079147
SIM,1939,31,20-24,1970,2
SIM,1851,30,na,1881,1866
STAT,1888,28,30-34,1916,28.01532474764315
STAT,1928,33,50-100,1961,0.9760103508067721
SIM,1893,65,na,1958,2153
STAT,1897,29,50-100,1926,0.802399907160093
SIM,1920,19,30-34,1939,18
SIM,1843,11,na,1854,2229
STAT,1841,19,25-29,1860,4.979449882034751
SIM,1847,25,na,1872,1970
STAT,1858,43,40-44,1901,1.6539621539014102
STAT,1827,44,40-44,1871,2.085025906836225
STAT,1838,70,na,1908,941.9540834929505
STAT,1837,105,na,1942,0.019028644205102446
STAT,1845,16,40-44,1861,0.16455425951505653
STAT,1908,49,50-100,1957,0.19210947888549226
SIM,1866,43,40-44,1909,4
STAT,1904,42,20-24,1946,0.014925573728006555
STAT,1925,30,35-39,1955,10.262927349230234
STAT,1826,43,45-49,1869,1.4333118095627786
STAT,1912,19,30-34,1931,2.3159973544382884
STAT,1910,34,45-49,1944,1.421120383827444
SIM,1889,21,15-19,1910,8
STAT,1947,19,na,1966,3914.4271231596044
SIM,1820,41,na,1861,1533
SIM,1877,20,30-34,1897,20
SIM,1929,30,45-49,1959,3
STAT,1857,49,35-39,1906,0.10213065632249599
SIM,1885,46,na,1931,2159
STAT,1839,36,30-34,1875,4.284671095057656
SIM,1801,75,na,1876,393
SIM,1892,30,25-29,1922,14
SIM,1843,40,35-39,1883,6
STAT,1894,35,40-44,1929,5.364977442553311
STAT,1889,41,45-49,1930,1.7533616972532473
STAT,1918,38,na,1956,3742.388973095983
SIM,1829,37,30-34,1866,7
STAT,1821,47,25-29,1868,0.09086077570884622
STAT,1904,49,40-44,1953,0.1281269883422069
STAT,1931,41,15-19,1972,0.001940855488719449
STAT,1842,16,35-39,1858,0.5132927434834641
SIM,1805,101,na,1906,1
STAT,1893,34,45-49,1927,2.0712607694570857
STAT,1815,54,25-29,1869,0.007354526075909237
SIM,1830,39,40-44,1869,9
STAT,1837,69,na,1906,952.412068762531
SIM,1844,30,25-29,1874,9
STAT,1921,34,20-24,1955,2.5423263917037864
SIM,1940,28,35-39,1968,17
STAT,1908,39,na,1947,3294.208745723597
SIM,1879,20,45-49,1899,2
STAT,1834,25,na,1859,1784.0592719207457
STAT,1835,40,35-39,1875,1.4167939935673393
STAT,1896,46,30-34,1942,0.06832112152696963
SIM,1871,54,na,1925,2009
SIM,1892,36,45-49,1928,5
STAT,1855,55,na,1910,1469.3724230034034
SIM,1831,26,na,1857,1737
SIM,1903,26,20-24,1929,15
STAT,1932,28,35-39,1960,18.56798170644352
SIM,1784,85,na,1869,63
SIM,1855,39,na,1894,1863
STAT,1877,53,40-44,1930,0.010150767527409912
STAT,1842,38,35-39,1880,5.946522786055676
STAT,1882,45,25-29,1927,0.05344557427962053
STAT,1863,20,50-100,1883,0.34980778356760295
STAT,1912,26,20-24,1938,17.052547250742684
STAT,1892,25,50-100,1917,0.7620513872674234
SIM,1920,26,20-24,1946,20
SIM,1923,28,35-39,1951,24
SIM,1864,25,30-34,1889,25
STAT,1915,28,35-39,1943,14.415944369640734
STAT,1898,26,50-100,1924,0.8206017500819753
STAT,1883,20,45-49,1903,0.6497221818630119
STAT,1921,49,40-44,1970,0.16692112069319487
SIM,1850,55,na,1905,1527
STAT,1856,25,30-34,1881,19.512661418906237
STAT,1916,20,20-24,1936,110.7295840431024
SIM,1848,20,15-19,1868,7
STAT,1797,99,na,1896,0.46473449423897595
SIM,1862,18,na,1880,2266
SIM,1919,27,30-34,1946,48
SIM,1868,27,40-44,1895,4
STAT,1868,45,40-44,1913,0.1558481720657218
SIM,1848,34,25-29,1882,7
STAT,1896,64,na,1960,2283.631914072096
STAT,1892,50,na,1942,2584.4192137927025
STAT,1925,25,40-44,1950,5.235902406910628
SIM,1848,104,na,1952,1
STAT,1869,25,40-44,1894,2.760107771336218
SIM,1850,38,35-39,1888,14
STAT,1848,17,na,1865,2114.401822767476
SIM,1895,34,20-24,1929,1
STAT,1888,45,na,1933,2536.8725930481382
SIM,1897,23,15-19,1920,4
STAT,1904,24,20-24,1928,92.79573885842224
STAT,1879,40,50-100,1919,1.055238322809354
STAT,1878,49,15-19,1927,3.8558549983307004E-4
SIM,1867,24,na,1891,2256
STAT,1890,47,25-29,1937,0.03735127224803619
STAT,1910,16,45-49,1926,0.09374063189636844
STAT,1865,26,30-34,1891,21.636405599486036
SIM,1790,85,na,1875,57
SIM,1883,35,na,1918,2182
STAT,1833,40,na,1873,1603.353520400184
STAT,1887,34,20-24,1921,2.8318254071137368
STAT,1888,19,15-19,1907,6.590086789779178
SIM,1810,79,na,1889,276
SIM,1935,34,na,1969,4845
STAT,1858,48,35-39,1906,0.10239247008494308
STAT,1852,40,35-39,1892,1.3260618860024505
SIM,1885,35,40-44,1920,8
SIM,1931,20,na,1951,4486
STAT,1773,86,na,1859,55.89507947490833
STAT,1904,24,50-100,1928,0.5491197626680271
SIM,1903,29,na,1932,3179
STAT,1812,53,45-49,1865,0.045505268646490904
STAT,1889,23,15-19,1912,3.835614034235502
STAT,1898,35,25-29,1933,3.715779337956927
SIM,1928,31,45-49,1959,3
STAT,1832,82,na,1914,281.0699154998015
SIM,1862,40,na,1902,1987
STAT,1831,27,15-19,1858,0.3902568644769993
STAT,1858,46,45-49,1904,0.17529711981233884
STAT,1859,40,20-24,1899,0.12061490348475147
SIM,1933,25,40-44,1958,5
STAT,1880,40,35-39,1920,1.8216500591822136
SIM,1889,28,35-39,1917,15
STAT,1950,16,35-39,1966,4.688579940524349
STAT,1832,54,25-29,1886,0.002140225033787958
STAT,1865,72,na,1937,1081.3741959134954
SIM,1818,44,40-44,1862,7
SIM,1873,26,30-34,1899,32
SIM,1852,74,na,1926,805
STAT,1898,28,35-39,1926,12.291958773147298
SIM,1869,39,25-29,1908,2
STAT,1849,37,50-100,1886,0.9420633208469087
STAT,1929,22,20-24,1951,132.83319565521452
STAT,1905,40,15-19,1945,0.0013226989569311135
STAT,1903,51,na,1954,2908.112472743907
STAT,1817,45,45-49,1862,0.549000133297867
SIM,1941,29,50-100,1970,1
SIM,1924,20,20-24,1944,118
STAT,1861,30,35-39,1891,8.018620998778434
STAT,1922,40,15-19,1962,0.0016697928786797193
STAT,1886,71,na,1957,1390.025871299249
SIM,1896,19,15-19,1915,10
STAT,1874,30,45-49,1904,1.6967076125405354
STAT,1841,44,25-29,1885,0.44839397834167344
SIM,1871,5,na,1876,2636
SIM,1869,21,35-39,1890,7
STAT,1916,31,na,1947,3703.817504511666
STAT,1821,41,40-44,1862,3.9870353410051327
SIM,1937,22,20-24,1959,94
STAT,1857,34,25-29,1891,7.5660282418421465
STAT,1930,39,40-44,1969,1.8406655294733514
SIM,1915,14,na,1929,3732
STAT,1844,55,na,1899,1436.0760478831983
STAT,1940,31,15-19,1971,0.12571407375512156
STAT,1929,15,30-34,1944,14.76287646659574
STAT,1816,48,35-39,1864,0.3254101112175177
STAT,1853,54,45-49,1907,0.01068091519124163
SIM,1895,20,na,1915,3032
STAT,1822,46,30-34,1868,0.13205452523452
SIM,1870,20,25-29,1890,55
STAT,1928,12,na,1940,4716.337646255227
STAT,1852,33,45-49,1885,1.2954552091571319
STAT,1930,32,20-24,1962,2.973677020402273
STAT,1854,50,35-39,1904,0.006248169716255314
SIM,1860,33,45-49,1893,1
STAT,1820,97,na,1917,2.8301385099689886
STAT,1869,16,na,1885,2357.2998494663307
SIM,1855,91,na,1946,28
STAT,1837,48,15-19,1885,2.660519839016648E-4
SIM,1839,37,35-39,1876,13
STAT,1884,36,45-49,1920,1.8695174283845055
STAT,1878,44,20-24,1922,0.15424420648721743
SIM,1838,35,30-34,1873,4
STAT,1872,51,na,1923,2050.0547606547675
SIM,1841,19,na,1860,1931
STAT,1853,91,na,1944,43.85468340223681
STAT,1856,36,na,1892,1744.896519915235
STAT,1859,33,30-34,1892,13.072396720525706
STAT,1846,10,na,1856,2252.1285916271995
SIM,1859,37,40-44,1896,6
SIM,1835,78,na,1913,466
STAT,1875,16,na,1891,2458.423747627051
SIM,1921,14,na,1935,4282
SIM,1865,34,25-29,1899,10
STAT,1853,37,45-49,1890,1.508663021550455
STAT,1822,39,40-44,1861,6.911238528586263
SIM,1860,24,30-34,1884,18
STAT,1837,17,45-49,1854,0.08008530867302821
STAT,1862,20,25-29,1882,48.020777764558716
SIM,1937,15,30-34,1952,15
STAT,1897,26,30-34,1923,31.92354698263197
STAT,1852,24,30-34,1876,15.12132106695795
SIM,1849,91,na,1940,28
STAT,1849,54,na,1903,1570.191353457304
STAT,1833,48,35-39,1881,0.09039752055602542
SIM,1924,37,45-49,1961,3
STAT,1887,39,15-19,1926,0.05874043675115675
SIM,1904,20,15-19,1924,6
STAT,1808,46,35-39,1854,0.540638297465667
STAT,1860,35,45-49,1895,1.5425387040098495
STAT,1863,36,25-29,1899,2.398392548313648
SIM,1844,55,na,1899,1377
SIM,1895,29,25-29,1924,55
STAT,1839,39,35-39,1878,5.511816338024573
STAT,1835,46,40-44,1881,0.11633504730461167
STAT,1919,35,20-24,1954,0.26902764453402844
STAT,1889,27,30-34,1916,29.368513044903978
STAT,1904,45,25-29,1949,0.04446633820387036
STAT,1907,33,25-29,1940,8.127205823993386
STAT,1807,56,na,1863,1129.5538228919688
SIM,1910,32,45-49,1942,1
SIM,1894,6,na,1900,3293
STAT,1843,70,na,1913,947.7018400265925
STAT,1895,20,na,1915,2930.1701551835354
STAT,1831,44,na,1875,1458.365957713566
SIM,1851,37,35-39,1888,10
SIM,1891,36,30-34,1927,4
STAT,1801,78,na,1879,301.4027935471309
SIM,1861,37,45-49,1898,2
STAT,1908,35,na,1943,3359.304147377236
STAT,1792,77,na,1869,330.99689674286276
STAT,1878,21,35-39,1899,5.762495449699872
SIM,1913,20,45-49,1933,3
STAT,1879,38,30-34,1917,5.244136039011008
STAT,1779,112,na,1891,4.06108087315565E-4
SIM,1887,38,30-34,1925,9
STAT,1920,18,15-19,1938,47.97491072841163
SIM,1888,26,30-34,1914,28
SIM,1850,92,na,1942,30
SIM,1811,64,na,1875,797
STAT,1847,84,na,1931,245.30824701447003
STAT,1845,45,20-24,1890,0.008576203478692866
SIM,1828,38,25-29,1866,2
STAT,1871,38,25-29,1909,2.687498677762785
SIM,1838,38,35-39,1876,11
STAT,1771,108,na,1879,0.003558437945259281
STAT,1888,82,na,1970,924.3010815731967
SIM,1828,92,na,1920,18
STAT,1800,54,30-34,1854,0.016662799322720613
STAT,1930,42,15-19,1972,0.0019087829131728294
SIM,1834,34,30-34,1868,19
STAT,1778,85,na,1863,76.5152646366735
SIM,1859,84,na,1943,242
SIM,1856,40,na,1896,1837
STAT,1906,43,30-34,1949,0.10905222070089421
STAT,1934,20,35-39,1954,11.99310316631515
STAT,1826,34,30-34,1860,21.056253775336863
STAT,1836,49,15-19,1885,2.642214062292872E-4
SIM,1897,27,30-34,1924,38
STAT,1902,32,45-49,1934,2.324918566296862
STAT,1893,25,30-34,1918,30.373286098609675
STAT,1853,34,50-100,1887,0.6993933196179082
STAT,1819,41,na,1860,1519.9435194194434
STAT,1875,37,35-39,1912,6.867910524025623
STAT,1809,49,50-100,1858,0.6691834910292506
SIM,1840,18,20-24,1858,16
STAT,1897,29,35-39,1926,12.103159931867417
STAT,1901,46,15-19,1947,2.9921122839597446E-4
STAT,1887,29,25-29,1916,44.379773367756776
SIM,1896,46,na,1942,2812
STAT,1838,104,na,1942,0.044779082792039786
STAT,1896,42,15-19,1938,0.0011950359020582114
SIM,1885,31,25-29,1916,12
STAT,1905,20,45-49,1925,0.9578699986679561
STAT,1913,20,15-19,1933,4.9021787344427805
SIM,1909,22,45-49,1931,1
STAT,1843,32,40-44,1875,3.5214859226551876
SIM,1935,13,na,1948,5039
STAT,1851,40,50-100,1891,0.7676194095925584
SIM,1939,27,na,1966,3476
SIM,1851,32,40-44,1883,4
SIM,1959,3,na,1962,4884
STAT,1883,36,30-34,1919,4.960084993809022
STAT,1835,33,45-49,1868,1.398423248878937
STAT,1922,44,30-34,1966,0.13816421567832585
SIM,1817,49,50-100,1866,3
SIM,1937,4,na,1941,3602
STAT,1882,15,30-34,1897,1.4711157549544875
STAT,1912,44,20-24,1956,0.015966876990034982
SIM,1921,32,20-24,1953,4
SIM,1942,20,35-39,1962,11
STAT,1921,17,na,1938,3963.526837859121
SIM,1843,33,45-49,1876,1
STAT,1830,37,25-29,1867,2.3398299588499123
STAT,1869,16,50-100,1885,0.04572706207558128
SIM,1826,63,na,1889,955
STAT,1835,26,50-100,1861,0.534462812585118
SIM,1857,37,50-100,1894,4
STAT,1816,45,30-34,1861,0.23599079526591388
STAT,1867,35,30-34,1902,4.772651522540519
SIM,1869,19,20-24,1888,13
SIM,1863,58,na,1921,1636
STAT,1850,53,50-100,1903,0.010475343826646825
SIM,1866,38,50-100,1904,2
STAT,1883,51,50-100,1934,0.014055297504298276
STAT,1933,23,25-29,1956,115.70877591386862
SIM,1846,37,30-34,1883,5
SIM,1941,23,25-29,1964,98
STAT,1837,46,25-29,1883,0.03930587555531968
SIM,1930,35,na,1965,4657
STAT,1899,6,na,1905,3381.4423050371893
STAT,1817,47,35-39,1864,0.31561108132465304
SIM,1889,32,20-24,1921,3
SIM,1900,15,35-39,1915,1
SIM,1861,34,50-100,1895,1
STAT,1827,47,45-49,1874,0.21586579904315792
SIM,1856,26,30-34,1882,26
STAT,1850,18,35-39,1868,0.469876901883379
STAT,1945,25,20-24,1970,18.935214598452937
SIM,1827,52,na,1879,1273
STAT,1909,36,50-100,1945,0.3772503189904022
SIM,1923,28,na,1951,4085
SIM,1845,77,na,1922,565
STAT,1857,46,30-34,1903,0.07232667158490956
STAT,1894,38,45-49,1932,2.4081873180408455
STAT,1884,38,35-39,1922,6.568561662273845
SIM,1847,39,35-39,1886,13
STAT,1910,31,40-44,1941,3.579275689294192
STAT,1859,17,na,1876,2003.4330085983895
STAT,1813,63,na,1876,896.665596469944
STAT,1882,57,na,1939,1846.2788742359037
SIM,1864,28,35-39,1892,7
SIM,1854,28,25-29,1882,39
SIM,1892,38,35-39,1930,12
STAT,1817,77,na,1894,400.0769364882041
STAT,1883,35,na,1918,2202.8615724453466
STAT,1936,2,na,1938,3698.943676799422
SIM,1906,21,15-19,1927,4
SIM,1942,26,50-100,1968,5
STAT,1861,36,40-44,1897,3.4550217324333534
SIM,1842,36,35-39,1878,17
STAT,1840,96,na,1936,5.635059751274938
SIM,1855,18,15-19,1873,7
STAT,1847,18,15-19,1865,5.429733942761676
SIM,1916,46,na,1962,3484
SIM,1881,19,20-24,1900,15
SIM,1844,29,45-49,1873,1
STAT,1901,65,na,1966,2478.421212189112
STAT,1863,47,30-34,1910,0.07987474959884366
STAT,1899,44,40-44,1943,0.19944933048404356
SIM,1832,26,na,1858,1693
SIM,1861,88,na,1949,98
STAT,1840,30,15-19,1870,0.11621756624426346
STAT,1914,41,15-19,1955,0.001439637345261689
SIM,1931,21,50-100,1952,4
STAT,1856,28,35-39,1884,7.316757405182782
SIM,1798,81,na,1879,170
STAT,1864,32,na,1896,2009.2065697071323
STAT,1834,36,35-39,1870,5.516870251424046
STAT,1846,28,25-29,1874,37.6836199103846
STAT,1863,43,15-19,1906,0.011365885503688136
SIM,1865,39,40-44,1904,5
STAT,1782,105,na,1887,0.018033409407473392
STAT,1936,33,15-19,1969,0.11783862646668293
SIM,1937,18,35-39,1955,5
SIM,1898,16,na,1914,3182
STAT,1812,78,na,1890,339.4011347706073
STAT,1896,49,na,1945,2748.994622036946
SIM,1867,33,30-34,1900,17
STAT,1870,40,25-29,1910,0.6011313170181684
SIM,1839,92,na,1931,17
STAT,1885,30,20-24,1915,2.565777513625232
STAT,1955,15,25-29,1970,54.369046569208194
SIM,1876,32,na,1908,2328
STAT,1884,30,25-29,1914,9.636476509472338
STAT,1923,21,50-100,1944,0.725438792698828
STAT,1821,38,15-19,1859,0.1122910605474567
STAT,1842,35,30-34,1877,4.6225949369434325
STAT,1882,18,35-39,1900,0.5027867582395054
STAT,1842,44,na,1886,1687.8770928332497
SIM,1938,18,30-34,1956,14
SIM,1824,38,40-44,1862,2
SIM,1847,27,20-24,1874,13
STAT,1803,105,na,1908,0.00985593230025714
STAT,1893,21,15-19,1914,3.96425443054108
STAT,1935,29,15-19,1964,0.9081808045590924
STAT,1911,28,na,1939,3439.230775027263
STAT,1855,41,15-19,1896,0.009858037704347586
STAT,1866,42,25-29,1908,0.5588362465362793
STAT,1881,19,50-100,1900,0.044470534762548246
SIM,1891,29,40-44,1920,3
SIM,1813,60,na,1873,1031
SIM,1897,31,na,1928,3098
SIM,1798,77,na,1875,327
STAT,1883,29,40-44,1912,2.7547012335356706
STAT,1921,40,45-49,1961,0.17757727184036076
SIM,1825,41,na,1866,1508
STAT,1876,34,45-49,1910,1.6874071648363376
SIM,1871,36,25-29,1907,3
SIM,1884,34,45-49,1918,2
STAT,1816,38,40-44,1854,16.12075218933302
STAT,1839,27,20-24,1866,9.839828371527314
SIM,1876,34,50-100,1910,4
SIM,1936,2,na,1938,3054
STAT,1930,17,25-29,1947,52.92601485174875
STAT,1929,18,35-39,1947,5.045543680659983
SIM,1828,37,na,1865,1612
SIM,1898,71,na,1969,1990
STAT,1868,34,50-100,1902,0.8187801001484754
SIM,1849,36,na,1885,1838
SIM,1944,27,na,1971,3727
STAT,1860,73,na,1933,910.4239045826608
SIM,1893,30,20-24,1923,3
STAT,1855,45,30-34,1900,0.06947445597021157
SIM,1881,87,na,1968,287
STAT,1798,62,na,1860,910.6118379996698
STAT,1890,44,20-24,1934,0.18094774852018242
SIM,1831,41,na,1872,1545
SIM,1875,43,na,1918,2217
STAT,1908,30,35-39,1938,8.214545332980569
SIM,1833,41,25-29,1874,4
STAT,1864,54,50-100,1918,0.012366404861259197
SIM,1831,29,35-39,1860,11
STAT,1964,2,na,1966,4681.103073141073
STAT,1864,54,20-24,1918,6.04221759814863E-4
STAT,1876,47,40-44,1923,0.16631302983649351
SIM,1817,43,45-49,1860,2
STAT,1928,31,15-19,1959,0.1518788311647003
SIM,1796,70,na,1866,636
SIM,1908,32,na,1940,3316
STAT,1886,17,40-44,1903,0.18252086229324008
STAT,1940,0,na,1940,4303.546755101551
SIM,1923,25,30-34,1948,57
STAT,1869,28,45-49,1897,1.0125608986440553
SIM,1848,31,20-24,1879,1
STAT,1838,37,30-34,1875,4.317527790579487
SIM,1848,14,na,1862,2167
STAT,1886,46,20-24,1932,0.01200892417423697
STAT,1877,31,25-29,1908,10.07810076281292
SIM,1917,20,25-29,1937,100
STAT,1907,26,35-39,1933,13.436036274317754
STAT,1868,48,45-49,1916,0.21004394583397867
STAT,1899,49,35-39,1948,0.10008682863419757
STAT,1899,23,25-29,1922,73.86990794030106
SIM,1875,35,30-34,1910,8
SIM,1916,30,35-39,1946,6
STAT,1878,15,50-100,1893,0.04845761375445932
SIM,1954,6,na,1960,4487
STAT,1865,17,na,1882,2228.510731795319
STAT,1892,32,25-29,1924,12.11956477768662
STAT,1878,47,25-29,1925,0.05644400865567864
STAT,1915,25,30-34,1940,38.01196867669459
STAT,1872,18,25-29,1890,5.355594480923671
SIM,1866,91,na,1957,58
STAT,1823,53,20-24,1876,8.573838796833512E-4
STAT,1889,20,na,1909,2774.7067262172955
STAT,1865,29,35-39,1894,8.203000671065825
SIM,1879,39,35-39,1918,11
SIM,1873,17,20-24,1890,16
STAT,1829,62,na,1891,1104.3801428766708
STAT,1947,20,45-49,1967,1.2021909058385876
SIM,1912,27,25-29,1939,59
STAT,1909,39,15-19,1948,0.01699921554858293
STAT,1929,25,25-29,1954,78.11235286849313
STAT,1959,6,na,1965,4856.761580399294
SIM,1845,92,na,1937,22
SIM,1867,17,na,1884,2472
STAT,1930,35,25-29,1965,1.2153379248833402
STAT,1904,27,25-29,1931,57.32081105145298
SIM,1860,20,15-19,1880,2
STAT,1839,24,50-100,1863,0.3438616383843281
STAT,1822,42,15-19,1864,0.020099478423540137
SIM,1825,42,40-44,1867,11
SIM,1880,18,25-29,1898,6
STAT,1848,40,45-49,1888,1.1395495947640488
SIM,1904,14,na,1918,3554
STAT,1913,50,na,1963,3357.061526136972
STAT,1927,36,50-100,1963,0.4935757310465469
SIM,1915,26,35-39,1941,16
STAT,1902,14,na,1916,3431.9357819741467
STAT,1862,19,45-49,1881,0.05434413343109782
SIM,1786,96,na,1882,1
SIM,1807,60,na,1867,965
SIM,1883,37,35-39,1920,11
SIM,1844,92,na,1936,16
STAT,1899,41,25-29,1940,0.0579820864769342
SIM,1928,31,na,1959,4450
SIM,1841,15,30-34,1856,2
SIM,1953,1,na,1954,4485
STAT,1841,17,35-39,1858,0.48789040360852864
SIM,1820,78,na,1898,405
STAT,1865,51,50-100,1916,0.012993848200219127
STAT,1948,24,30-34,1972,31.15522441997647
SIM,1872,27,30-34,1899,31
STAT,1881,53,30-34,1934,0.005345113390749694
SIM,1823,93,na,1916,13
STAT,1865,17,20-24,1882,15.643065647654527
STAT,1914,22,50-100,1936,0.6350793777467427
STAT,1830,59,na,1889,1174.0942987339088
STAT,1909,24,na,1933,3329.7785681541704
SIM,1892,33,40-44,1925,5
SIM,1826,32,30-34,1858,22
SIM,1814,78,na,1892,315
SIM,1820,36,45-49,1856,2
STAT,1873,43,na,1916,2198.4356967113
STAT,1843,37,35-39,1880,5.5771697924681165
STAT,1817,42,40-44,1859,5.715975128410397
SIM,1915,33,25-29,1948,14
STAT,1864,27,30-34,1891,21.2024490138153
STAT,1867,37,50-100,1904,1.0891036627138868
STAT,1852,20,15-19,1872,2.8825281330248353
STAT,1885,23,30-34,1908,16.720993865307154
STAT,1927,37,20-24,1964,0.30961377625644565
SIM,1890,21,na,1911,2989
SIM,1893,23,30-34,1916,27
SIM,1938,15,15-19,1953,37
SIM,1937,25,25-29,1962,67
STAT,1884,33,40-44,1917,4.030466699062699
STAT,1937,32,50-100,1969,0.7727536437700254
STAT,1821,82,na,1903,248.57930432746525
STAT,1822,35,25-29,1857,5.612855674924138
SIM,1850,35,30-34,1885,4
SIM,1858,44,45-49,1902,2
STAT,1923,13,na,1936,4388.472158652718
STAT,1880,45,50-100,1925,0.247040174640328
STAT,1959,11,na,1970,4853.751133640221
STAT,1864,37,20-24,1901,0.6490330117621997
SIM,1961,9,na,1970,4754
STAT,1788,88,na,1876,41.59612141581525
STAT,1872,26,na,1898,2269.1757260693917
SIM,1800,96,na,1896,2
SIM,1834,32,40-44,1866,4
STAT,1873,21,15-19,1894,3.170385522420286
SIM,1920,45,na,1965,3930
SIM,1905,22,25-29,1927,76
SIM,1859,26,35-39,1885,9
STAT,1815,46,25-29,1861,0.13164783444878936
STAT,1832,43,20-24,1875,0.11593447456492034
STAT,1901,28,na,1929,3144.6911158324924
SIM,1902,21,45-49,1923,5
STAT,1893,23,40-44,1916,2.488746554977479
SIM,1843,69,na,1912,1023
STAT,1914,45,30-34,1959,0.08391662305656519
SIM,1909,24,35-39,1933,10
STAT,1875,34,30-34,1909,16.808491458857315
STAT,1866,50,25-29,1916,0.0031305817831629285
STAT,1927,33,na,1960,4392.264074948162
STAT,1882,37,25-29,1919,2.645162681581579
SIM,1869,74,na,1943,943
STAT,1900,32,25-29,1932,13.422978747885082
STAT,1857,6,na,1863,2184.670497172065
STAT,1838,33,15-19,1871,0.11757528196764233
STAT,1807,60,na,1867,1043.5239496682457
SIM,1852,23,45-49,1875,1
STAT,1932,36,35-39,1968,3.072867369533192
SIM,1926,21,30-34,1947,44
STAT,1826,32,40-44,1858,5.944018596854641
STAT,1850,34,25-29,1884,7.397865333586953
STAT,1870,20,35-39,1890,5.440364797070107
STAT,1937,32,20-24,1969,2.279736569312906
STAT,1876,26,45-49,1902,1.087380015128781
SIM,1919,35,30-34,1954,2
STAT,1803,94,na,1897,6.718176021598715
STAT,1820,76,na,1896,499.0995241813724
SIM,1812,81,na,1893,196
SIM,1857,55,na,1912,1603
SIM,1941,8,na,1949,3788
STAT,1811,99,na,1910,0.8213562857942146
STAT,1857,52,25-29,1909,0.0026249668011447116
STAT,1828,41,50-100,1869,0.9107859988862728
SIM,1845,20,35-39,1865,6
STAT,1851,17,40-44,1868,0.15996506915621453
STAT,1846,49,20-24,1895,0.00871461150101971
SIM,1931,36,25-29,1967,4
STAT,1946,25,25-29,1971,69.32566550476089
SIM,1846,26,25-29,1872,45
SIM,1890,37,25-29,1927,2
STAT,1824,44,25-29,1868,0.8016373186524831
STAT,1952,10,na,1962,4448.168367307907
SIM,1912,16,na,1928,3688
STAT,1835,49,45-49,1884,0.15432157070068134
SIM,1918,22,35-39,1940,11
SIM,1928,35,25-29,1963,1
STAT,1914,38,25-29,1952,0.9241190389792252
STAT,1883,28,50-100,1911,0.5904060709355385
STAT,1923,36,25-29,1959,1.0787252519935273
SIM,1799,60,na,1859,940
SIM,1894,51,na,1945,2744
SIM,1858,8,na,1866,2334
SIM,1922,38,25-29,1960,6
STAT,1837,20,35-39,1857,5.150667568422202
SIM,1843,49,45-49,1892,1
SIM,1888,49,50-100,1937,3
SIM,1866,29,45-49,1895,1
STAT,1820,42,na,1862,1433.6433316887203
SIM,1895,29,na,1924,3002
SIM,1842,33,30-34,1875,25
STAT,1884,15,50-100,1899,0.04593758096511468
SIM,1867,25,30-34,1892,30
STAT,1786,77,na,1863,303.0787141741969
SIM,1894,20,30-34,1914,23
SIM,1887,38,50-100,1925,2
SIM,1920,35,na,1955,3952
STAT,1866,48,50-100,1914,0.2113076419649024
SIM,1882,56,na,1938,1916
STAT,1841,36,25-29,1877,2.3630752781834703
STAT,1931,35,20-24,1966,0.33037389154411184
SIM,1826,33,45-49,1859,2
STAT,1833,108,na,1941,0.0011238102559942046
STAT,1943,27,50-100,1970,1.0014279378856001
SIM,1843,25,45-49,1868,2
SIM,1817,90,na,1907,19
SIM,1866,32,na,1898,2094
SIM,1860,22,40-44,1882,1
STAT,1929,33,25-29,1962,11.083617157775457
STAT,1861,58,na,1919,1553.3773959621894
STAT,1821,43,45-49,1864,2.500611949832447
SIM,1862,42,45-49,1904,1
STAT,1837,43,50-100,1880,0.7987642978121045
STAT,1918,21,30-34,1939,29.37253637119193
SIM,1936,25,20-24,1961,17
STAT,1845,34,na,1879,1785.991196342608
STAT,1907,29,na,1936,3289.2648241661705
SIM,1919,28,25-29,1947,72
SIM,1869,36,20-24,1905,1
STAT,1904,16,20-24,1920,24.082161228525706
STAT,1942,16,na,1958,3634.8514612858817
STAT,1834,33,30-34,1867,13.736049564507507
SIM,1787,75,na,1862,350
SIM,1889,39,40-44,1928,7
STAT,1885,24,45-49,1909,0.6525177677276959
SIM,1912,16,20-24,1928,24
STAT,1827,29,15-19,1856,0.6697171800882615
STAT,1890,17,na,1907,2916.9887471204815
STAT,1929,17,20-24,1946,163.4473483083789
SIM,1874,37,na,1911,2196
SIM,1858,33,50-100,1891,3
SIM,1870,37,na,1907,2168
STAT,1852,22,40-44,1874,1.7946798474510253
STAT,1884,39,50-100,1923,1.1343450054066828
STAT,1886,20,30-34,1906,17.88111855522956
SIM,1836,20,25-29,1856,51
SIM,1889,31,45-49,1920,3
STAT,1883,73,na,1956,1131.4489242698828
SIM,1916,7,na,1923,3919
SIM,1941,13,na,1954,3760
SIM,1872,37,20-24,1909,1
STAT,1801,93,na,1894,10.331304124524994
STAT,1877,16,35-39,1893,0.53901970072129
STAT,1917,25,45-49,1942,1.7232058077508043
SIM,1887,27,25-29,1914,43
STAT,1776,105,na,1881,0.019449847472370153
STAT,1905,17,35-39,1922,0.7492592591238211
STAT,1820,53,40-44,1873,0.01663489829959803
STAT,1916,35,40-44,1951,1.4619705981700328
SIM,1937,17,20-24,1954,112
STAT,1835,25,45-49,1860,0.9343667023692327
SIM,1878,9,na,1887,2666
SIM,1857,89,na,1946,67
SIM,1936,27,30-34,1963,34
STAT,1892,40,25-29,1932,0.7674994954659674
STAT,1928,25,20-24,1953,21.3884979368023
STAT,1845,24,na,1869,1851.4175048822538
STAT,1940,15,na,1955,3532.3908828644085
STAT,1915,48,na,1963,3487.5465901796274
STAT,1829,33,20-24,1862,2.6241816403013853
STAT,1881,29,20-24,1910,10.629679502820498
STAT,1943,5,na,1948,3993.226935382356
STAT,1832,61,na,1893,1125.6687095231218
STAT,1874,42,15-19,1916,0.013313159823811947
SIM,1897,3,na,1900,3430
STAT,1879,27,25-29,1906,41.83074121005422
SIM,1925,25,45-49,1950,1
STAT,1896,24,20-24,1920,85.44285858217553
STAT,1910,36,15-19,1946,0.017434295663002017
STAT,1903,29,na,1932,3184.9234760298705
STAT,1924,37,40-44,1961,1.6675508159243826
SIM,1861,19,15-19,1880,6
SIM,1872,16,25-29,1888,6
STAT,1892,18,40-44,1910,0.21585308034378062
SIM,1880,6,na,1886,2726
STAT,1895,19,20-24,1914,21.717342609412007
STAT,1942,10,na,1952,3895.1830468944986
STAT,1786,108,na,1894,8.606767124863858E-4
STAT,1954,18,25-29,1972,50.58939614272375
SIM,1880,21,na,1901,2398
SIM,1799,94,na,1893,7
STAT,1918,17,45-49,1935,0.10305429197393634
SIM,1833,27,40-44,1860,2
SIM,1942,17,45-49,1959,1
SIM,1821,41,45-49,1862,2
SIM,1836,28,20-24,1864,13
SIM,1884,21,15-19,1905,3
STAT,1870,52,40-44,1922,0.009704678496599688
STAT,1863,25,20-24,1888,9.866753917075267
SIM,1802,81,na,1883,177
STAT,1865,42,20-24,1907,0.13581880677676156
STAT,1934,17,45-49,1951,0.6383086441870643
STAT,1937,18,25-29,1955,39.72222205821286
STAT,1818,46,50-100,1864,0.5316165544498107
SIM,1876,2,na,1878,3065
SIM,1797,65,na,1862,768
SIM,1899,29,na,1928,3128
STAT,1852,81,na,1933,392.0468354469629
SIM,1863,89,na,1952,78
STAT,1856,102,na,1958,0.36851575002890974
STAT,1864,16,25-29,1880,5.45601167358786
SIM,1886,19,20-24,1905,23
SIM,1817,59,na,1876,1130
SIM,1878,34,20-24,1912,1
STAT,1881,16,25-29,1897,5.184194493499716
SIM,1849,43,40-44,1892,5
SIM,1868,31,25-29,1899,10
STAT,1862,44,45-49,1906,1.1925466167114989
SIM,1857,44,30-34,1901,1
SIM,1913,47,50-100,1960,3
SIM,1853,69,na,1922,1124
SIM,1914,35,na,1949,3590
STAT,1853,19,15-19,1872,5.339219394119305
STAT,1885,15,30-34,1900,1.507830114731973
SIM,1852,30,35-39,1882,15
STAT,1890,21,na,1911,2739.7970843714274
SIM,1821,64,na,1885,906
STAT,1868,90,na,1958,100.50753648496539
STAT,1887,35,na,1922,2513.167395107795
STAT,1918,30,45-49,1948,1.5923760343795612
SIM,1917,19,45-49,1936,3
STAT,1802,57,na,1859,1039.736502315105
STAT,1810,76,na,1886,382.3342203508224
STAT,1879,48,20-24,1927,0.011717376074245452
STAT,1885,6,na,1891,2459.909454363732
STAT,1874,21,na,1895,2289.6922347684945
STAT,1905,24,25-29,1929,77.67921299676743
SIM,1863,99,na,1962,2
STAT,1907,13,na,1920,3578.2644620127057
STAT,1927,43,na,1970,4393.1725509913185
STAT,1880,32,45-49,1912,1.7367333138644934
STAT,1853,48,50-100,1901,0.18353367685119903
STAT,1859,28,35-39,1887,7.327175644909627
STAT,1828,28,20-24,1856,16.59828644981389
STAT,1909,19,45-49,1928,0.09205134068123731
STAT,1933,35,40-44,1968,1.9295667836516948
SIM,1859,30,20-24,1889,2
STAT,1820,38,45-49,1858,4.314042371663697
SIM,1926,30,45-49,1956,3
STAT,1884,16,40-44,1900,0.17112647322449182
SIM,1926,20,na,1946,4141
STAT,1918,8,na,1926,4101.10416273569
STAT,1813,41,45-49,1854,5.297921386109944
SIM,1932,37,40-44,1969,2
SIM,1912,10,na,1922,3769
SIM,1925,40,40-44,1965,1
SIM,1937,33,25-29,1970,13
SIM,1945,18,25-29,1963,43
STAT,1925,27,45-49,1952,1.927605110940629
STAT,1844,30,35-39,1874,8.587374546835807
SIM,1853,48,50-100,1901,2
STAT,1932,40,20-24,1972,0.022674294921237206
STAT,1923,38,35-39,1961,2.6448681484925434
STAT,1914,3,na,1917,3950.792033387301
STAT,1790,82,na,1872,154.86195875108416
STAT,1843,15,40-44,1858,0.15975359396955863
SIM,1812,43,45-49,1855,1
STAT,1908,27,45-49,1935,1.5559701886550472
SIM,1845,18,20-24,1863,16
STAT,1833,41,15-19,1874,0.01039939552173702
SIM,1863,26,25-29,1889,38
SIM,1916,1,na,1917,4006
STAT,1891,35,25-29,1926,3.397110890756373
STAT,1858,29,45-49,1887,0.8298218692293998
STAT,1863,43,na,1906,1902.2165552150034
STAT,1838,26,25-29,1864,36.387101801604906
STAT,1902,51,na,1953,2884.4849728461513
SIM,1805,95,na,1900,1
STAT,1862,36,na,1898,1912.1255071809373
STAT,1845,22,35-39,1867,5.126326522506503
SIM,1856,18,na,1874,2147
STAT,1925,14,na,1939,4506.93238028639
SIM,1931,38,35-39,1969,5
STAT,1868,23,30-34,1891,16.00535111259596
SIM,1831,36,20-24,1867,4
SIM,1926,30,na,1956,4254
STAT,1861,54,40-44,1915,0.008041932115887438
SIM,1894,41,na,1935,2950
SIM,1873,37,25-29,1910,2
STAT,1854,18,20-24,1872,15.084313696656448
STAT,1798,78,na,1876,316.5741501397866
STAT,1833,39,na,1872,1608.8879177326903
STAT,1886,16,na,1902,2526.5185695187693
STAT,1861,23,45-49,1884,0.5586714034276982
STAT,1860,33,40-44,1893,3.3101073060325157
STAT,1837,18,20-24,1855,17.28438009623825
SIM,1826,49,45-49,1875,3
STAT,1905,21,50-100,1926,0.5585166526096552
SIM,1874,28,40-44,1902,3
SIM,1932,30,na,1962,4684
STAT,1856,47,25-29,1903,0.04225775027462933
SIM,1925,22,25-29,1947,120
SIM,1906,16,na,1922,3458
SIM,1916,27,45-49,1943,1
STAT,1844,23,45-49,1867,0.6003463799890871
SIM,1872,23,15-19,1895,3
STAT,1937,25,30-34,1962,36.11401704480821
SIM,1876,23,30-34,1899,21
SIM,1876,48,50-100,1924,4
STAT,1899,20,na,1919,3079.5908786011273
STAT,1960,1,na,1961,4843.598724070565
STAT,1874,90,na,1964,179.77524510741063
STAT,1802,105,na,1907,0.01027967079346846
STAT,1913,13,na,1926,3808.8011578434875
STAT,1942,25,40-44,1967,4.625532728339037
STAT,1943,15,45-49,1958,0.5006938963111944
SIM,1878,41,50-100,1919,1
STAT,1823,36,20-24,1859,1.3246185238694401
STAT,1890,27,20-24,1917,13.549425224811886
STAT,1868,30,20-24,1898,2.4559646581522716
STAT,1913,16,30-34,1929,2.3601422887504437
SIM,1921,16,30-34,1937,14
SIM,1865,54,na,1919,1838
STAT,1871,50,35-39,1921,0.008191974316634794
STAT,1850,41,15-19,1891,0.009778919810020588
STAT,1877,54,50-100,1931,0.014392725358775295
STAT,1902,41,na,1943,3106.050171364461
SIM,1886,22,na,1908,2331
STAT,1829,52,50-100,1881,0.010850963546837521
STAT,1855,26,25-29,1881,31.559675346958116
SIM,1911,17,15-19,1928,8
STAT,1917,22,25-29,1939,92.74311482692897
STAT,1919,14,na,1933,4123.08041883838
SIM,1945,25,30-34,1970,47
STAT,1869,53,45-49,1922,0.013068357753610212
STAT,1948,20,15-19,1968,5.778190534025022
STAT,1864,23,15-19,1887,2.802088125898764
STAT,1903,17,15-19,1920,7.976939782582423
STAT,1833,49,na,1882,1433.9568795435239
SIM,1883,34,30-34,1917,28
STAT,1848,76,na,1924,703.9758885145194
STAT,1914,46,50-100,1960,0.21244188678278234
STAT,1855,48,35-39,1903,0.09823766825476625
SIM,1922,22,25-29,1944,100
STAT,1838,47,20-24,1885,0.008288390702174351
SIM,1867,41,35-39,1908,1
SIM,1842,43,40-44,1885,3
STAT,1871,72,na,1943,1184.6867279405667
SIM,1807,59,na,1866,1000
STAT,1827,39,na,1866,1590.3662221004574
STAT,1892,34,30-34,1926,20.48234011726225
SIM,1908,25,45-49,1933,1
STAT,1879,24,20-24,1903,67.71911398982273
STAT,1899,27,40-44,1926,3.8774659593539353
SIM,1844,22,25-29,1866,52
SIM,1911,35,45-49,1946,1
STAT,1904,46,na,1950,3057.885291546516
STAT,1914,48,35-39,1962,0.12046265100287236
STAT,1840,54,20-24,1894,4.7094827232966967E-4
STAT,1835,20,15-19,1855,3.817908524551875
STAT,1856,21,15-19,1877,2.8445431787675384
STAT,1806,52,50-100,1858,0.05316493142693707
STAT,1845,20,25-29,1865,51.01887059797321
STAT,1944,21,50-100,1965,0.6713715695292999
SIM,1846,87,na,1933,100
SIM,1912,22,15-19,1934,4
STAT,1825,43,30-34,1868,1.2236236067254211
STAT,1814,47,35-39,1861,0.42821856512649714
STAT,1846,33,20-24,1879,2.3447807214695655
SIM,1909,21,30-34,1930,31
STAT,1905,48,25-29,1953,0.043809079624537936
STAT,1873,73,na,1946,1138.0030098808713
STAT,1906,36,25-29,1942,0.8591700419983187
STAT,1899,43,50-100,1942,0.09427423977389672
SIM,1854,33,20-24,1887,2
SIM,1850,17,na,1867,2161
STAT,1881,38,35-39,1919,6.42277833080838
STAT,1876,87,na,1963,324.7348225432764
SIM,1853,22,35-39,1875,6
SIM,1904,31,20-24,1935,1
STAT,1840,34,50-100,1874,0.7173182598375469
SIM,1833,43,30-34,1876,5
STAT,1911,21,45-49,1932,1.0111726387623252
STAT,1839,24,na,1863,1802.9362752524141
STAT,1871,18,20-24,1889,16.639463932784537
STAT,1909,31,30-34,1940,14.261795229966555
STAT,1904,22,15-19,1926,4.470363621785414
STAT,1824,41,20-24,1865,0.21422624403735066
STAT,1944,20,45-49,1964,1.1484587853140023
STAT,1851,58,na,1909,1422.5708250363564
STAT,1917,43,na,1960,3655.7044588334616
STAT,1877,20,20-24,1897,67.93266152229812
SIM,1887,24,20-24,1911,62
STAT,1785,108,na,1893,0.0013539266890717377
STAT,1836,22,25-29,1858,48.92408063476449
SIM,1917,24,40-44,1941,4
STAT,1831,75,na,1906,601.0880860995834
STAT,1932,33,30-34,1965,19.773419551792376
STAT,1861,88,na,1949,107.8344951509316
STAT,1883,50,25-29,1933,0.003327804143851074
SIM,1903,19,30-34,1922,6
SIM,1892,22,na,1914,3128
STAT,1838,48,na,1886,1534.143113002892
STAT,1818,93,na,1911,14.352553272016463
STAT,1937,19,20-24,1956,124.22867832250896
SIM,1933,27,45-49,1960,2
STAT,1897,15,50-100,1912,0.06218305177457182
STAT,1839,65,na,1904,1125.1740693433765
STAT,1929,30,20-24,1959,2.93012968143332
STAT,1931,31,50-100,1962,1.0240307148029972
SIM,1864,21,15-19,1885,2
SIM,1913,24,25-29,1937,90
SIM,1904,16,30-34,1920,5
STAT,1877,73,na,1950,1163.9199861117206
SIM,1867,28,35-39,1895,12
STAT,1786,102,na,1888,0.07980468777598408
STAT,1952,16,na,1968,4168.071396959477
STAT,1872,39,20-24,1911,0.7230873318279694
SIM,1930,21,20-24,1951,138
SIM,1881,27,20-24,1908,12
STAT,1858,90,na,1948,58.395747384481865
STAT,1812,51,40-44,1863,0.03436092029677025
STAT,1872,15,20-24,1887,17.054724858124295
SIM,1812,77,na,1889,326
SIM,1873,3,na,1876,2811
STAT,1888,72,na,1960,1559.8212053566674
STAT,1903,35,45-49,1938,0.5838499785324877
STAT,1834,43,40-44,1877,1.6613902592011873
SIM,1843,20,15-19,1863,2
SIM,1945,19,20-24,1964,129
STAT,1914,22,25-29,1936,89.15243373534179
SIM,1853,20,25-29,1873,56
STAT,1928,28,25-29,1956,76.56645527702823
STAT,1840,37,35-39,1877,5.4899468166444425
SIM,1908,11,na,1919,3604
STAT,1875,44,40-44,1919,2.1545988658995876
STAT,1943,16,40-44,1959,1.4015927647762334
STAT,1828,52,45-49,1880,0.011347174779086897
STAT,1918,28,15-19,1946,0.7072486444978922
STAT,1900,19,40-44,1919,0.23840983872102384
STAT,1898,31,45-49,1929,2.238446961027463
STAT,1895,54,na,1949,2578.985394464921
STAT,1864,31,15-19,1895,0.12039324351776527
STAT,1775,115,na,1890,1.7486559590287664E-4
STAT,1906,38,35-39,1944,2.0900747774983586
SIM,1877,21,25-29,1898,53
SIM,1900,30,25-29,1930,19
STAT,1891,32,20-24,1923,3.1592843417368472
SIM,1893,21,40-44,1914,4
SIM,1894,23,35-39,1917,7
STAT,1779,95,na,1874,2.0774357429994814
STAT,1872,20,na,1892,2254.4377484457173
STAT,1813,108,na,1921,7.538397321280089E-4
STAT,1834,50,30-34,1884,0.003940841914469376
SIM,1868,30,30-34,1898,21
SIM,1880,15,20-24,1895,19
STAT,1897,59,na,1956,2476.650242787574
SIM,1826,30,40-44,1856,4
STAT,1848,26,50-100,1874,0.5715562478411366
SIM,1914,38,35-39,1952,3
STAT,1816,92,na,1908,19.40869713513742
STAT,1926,19,45-49,1945,0.575470279638604
STAT,1865,88,na,1953,117.55129541650847
SIM,1832,36,na,1868,1572
SIM,1866,26,40-44,1892,5
SIM,1846,23,20-24,1869,66
STAT,1909,24,40-44,1933,2.933817931324759
STAT,1861,53,45-49,1914,0.01121628642207211
STAT,1886,23,35-39,1909,5.805292238462613
SIM,1893,31,35-39,1924,16
SIM,1839,40,45-49,1879,3
SIM,1824,62,na,1886,990
STAT,1875,40,25-29,1915,0.6298356848075495
STAT,1891,42,15-19,1933,0.016120797915130707
SIM,1879,18,15-19,1897,6
STAT,1889,48,50-100,1937,0.15954145836297234
STAT,1848,49,40-44,1897,0.12455545399335877
STAT,1895,43,45-49,1938,0.1270751208784982
STAT,1842,41,25-29,1883,0.4873368385340295
STAT,1808,53,40-44,1861,0.0372750078411511
SIM,1839,22,15-19,1861,1
STAT,1847,54,20-24,1901,5.291834126777258E-4
SIM,1936,28,25-29,1964,47
SIM,1877,29,20-24,1906,10
SIM,1883,44,40-44,1927,4
SIM,1951,16,40-44,1967,1
SIM,1812,43,na,1855,1366
STAT,1921,16,20-24,1937,146.34936228982593
STAT,1832,23,na,1855,1703.7061895536033
STAT,1907,49,20-24,1956,0.00924683678953928
STAT,1865,45,25-29,1910,0.04981264005380822
STAT,1903,16,50-100,1919,0.06601427902655871
STAT,1885,31,35-39,1916,9.575057078275073
STAT,1869,21,25-29,1890,52.54875154398592
STAT,1853,1,na,1854,2890.0
STAT,1935,21,30-34,1956,36.98582223049141
SIM,1847,35,na,1882,1832
SIM,1943,21,30-34,1964,33
SIM,1946,23,25-29,1969,109
SIM,1827,32,35-39,1859,10
SIM,1880,37,na,1917,2376
STAT,1874,86,na,1960,322.52713603741967
SIM,1914,36,25-29,1950,7
SIM,1931,28,25-29,1959,79
STAT,1851,33,30-34,1884,12.93717828424463
STAT,1886,21,25-29,1907,57.29845899978862
STAT,1931,38,25-29,1969,1.2306012799793813
STAT,1885,21,40-44,1906,1.96812926349081
STAT,1924,41,25-29,1965,0.08035519396839395
SIM,1830,31,na,1861,1726
STAT,1938,23,25-29,1961,86.33508432984428
STAT,1868,21,na,1889,2147.134336198637
STAT,1879,54,50-100,1933,0.014524009640630383
SIM,1852,56,na,1908,1547
STAT,1814,42,na,1856,1477.5324772936028
STAT,1866,28,40-44,1894,2.600911141667134
SIM,1875,84,na,1959,402
STAT,1896,49,35-39,1945,0.09647452080034966
STAT,1818,40,35-39,1858,4.5621370208505
STAT,1855,24,na,1879,1749.6504619253212
SIM,1859,20,na,1879,1992
STAT,1880,55,na,1935,2059.308024331053
SIM,1884,51,na,1935,2126
SIM,1919,29,20-24,1948,21
STAT,1816,51,25-29,1867,0.008171781111212485
SIM,1895,67,na,1962,2136
SIM,1909,32,35-39,1941,7
STAT,1897,48,25-29,1945,0.04053302565759981
SIM,1838,21,na,1859,1820
SIM,1894,21,25-29,1915,65
STAT,1839,52,20-24,1891,4.886899580547859E-4
STAT,1944,18,15-19,1962,46.1233677819623
STAT,1928,27,30-34,1955,45.60165327539331
STAT,1900,22,30-34,1922,23.343076649440118
STAT,1853,52,40-44,1905,0.007924870439596866
STAT,1879,8,na,1887,2618.932497955102
STAT,1838,41,15-19,1879,0.010982554767395371
STAT,1879,34,15-19,1913,0.13961746002919886
STAT,1883,69,na,1952,1359.2583016793844
SIM,1899,37,45-49,1936,3
STAT,1824,43,50-100,1867,1.3532063740751392
STAT,1917,26,40-44,1943,4.633674928715717
STAT,1913,29,na,1942,3501.1821523362546
SIM,1917,25,na,1942,3841
SIM,1827,30,25-29,1857,13
STAT,1909,33,50-100,1942,0.7422344031884526
STAT,1771,85,na,1856,58.29201761000001
STAT,1831,38,20-24,1869,0.5838862227871245
STAT,1951,17,45-49,1968,0.561960249473868
STAT,1891,34,na,1925,2765.1966302275428
SIM,1832,97,na,1929,1
SIM,1854,25,20-24,1879,14
STAT,1863,28,25-29,1891,34.945167882422695
SIM,1886,21,35-39,1907,7
STAT,1922,2,na,1924,4471.459832101875
STAT,1846,25,20-24,1871,10.679178593336848
STAT,1936,27,20-24,1963,16.502721665837193
STAT,1946,18,35-39,1964,4.395366707603736
SIM,1952,18,15-19,1970,44
SIM,1876,30,20-24,1906,2
STAT,1828,93,na,1921,16.4591642176872
STAT,1882,20,na,1902,2185.7706909479216
SIM,1882,22,na,1904,2230
SIM,1871,28,25-29,1899,41
STAT,1859,25,30-34,1884,19.54044525443794
SIM,1859,33,25-29,1892,11
STAT,1861,15,45-49,1876,0.059675807872651726
SIM,1826,40,35-39,1866,1
SIM,1875,33,40-44,1908,7
STAT,1832,108,na,1940,0.0011034328860701874
STAT,1954,15,20-24,1969,158.4050628675655
STAT,1838,23,20-24,1861,59.59384637514284
STAT,1843,18,45-49,1861,0.05605260847069108
SIM,1806,81,na,1887,189
SIM,1868,33,35-39,1901,11
SIM,1911,1,na,1912,3838
STAT,1822,92,na,1914,21.16363247930125
STAT,1858,26,40-44,1884,2.287759415817297
STAT,1847,59,na,1906,1433.1245372630042
STAT,1911,28,15-19,1939,0.6481147138583763
STAT,1844,32,50-100,1876,0.7609733642628729
STAT,1895,45,50-100,1940,0.17232532207647736
STAT,1807,48,40-44,1855,0.6483861013114605
STAT,1914,28,30-34,1942,37.1849964601607
STAT,1844,17,35-39,1861,0.48443264691551646
SIM,1864,37,na,1901,2050
SIM,1867,34,45-49,1901,1
SIM,1867,55,na,1922,2005
STAT,1854,42,45-49,1896,1.0695052734673667
SIM,1898,21,45-49,1919,6
STAT,1829,41,na,1870,1595.857527044258
STAT,1933,39,20-24,1972,0.338474093306266
STAT,1807,94,na,1901,7.433785602409593
SIM,1844,21,na,1865,1809
SIM,1869,84,na,1953,291
STAT,1922,21,20-24,1943,120.82621268995017
STAT,1867,33,40-44,1900,3.8307716717482347
STAT,1916,1,na,1917,4171.954480138
STAT,1875,51,30-34,1926,0.005807668062087735
STAT,1908,60,na,1968,2922.890082782137
SIM,1859,44,50-100,1903,1
STAT,1871,88,na,1959,191.735940804861
SIM,1836,56,na,1892,1302
SIM,1922,28,30-34,1950,56
STAT,1910,28,15-19,1938,0.64175400787231
STAT,1922,34,na,1956,4017.1917663364243
SIM,1800,58,na,1858,977
SIM,1849,54,na,1903,1594
STAT,1947,15,15-19,1962,48.32237127023418
STAT,1878,3,na,1881,3009.1208001045784
STAT,1878,18,50-100,1896,0.04810714200869624
STAT,1933,38,45-49,1971,0.876306856705675
STAT,1926,39,15-19,1965,0.022123226418058917
STAT,1867,73,na,1940,1053.6293178778922
STAT,1926,32,45-49,1958,1.7974444990307317
STAT,1909,16,40-44,1925,0.2597699327383669
SIM,1929,10,na,1939,4760
SIM,1899,50,na,1949,2883
STAT,1813,94,na,1907,8.225203557228728
STAT,1843,60,na,1903,1288.1982143178486
STAT,1847,108,na,1955,0.001350726248144087
STAT,1872,45,50-100,1917,0.2350451420620134
STAT,1844,20,40-44,1864,1.8332222474662543
SIM,1893,18,35-39,1911,3
SIM,1894,46,50-100,1940,2
SIM,1955,15,15-19,1970,45
STAT,1788,78,na,1866,273.2148234448935
STAT,1928,17,20-24,1945,161.37700795398942
STAT,1820,52,45-49,1872,0.02339284237905102
SIM,1921,19,35-39,1940,5
SIM,1879,36,na,1915,2397
STAT,1860,19,50-100,1879,0.0428016626551216
SIM,1835,22,30-34,1857,21
SIM,1858,72,na,1930,995
STAT,1871,31,40-44,1902,4.084778668960401
STAT,1918,46,45-49,1964,0.21903660695817306
STAT,1954,17,30-34,1971,14.23373367329784
STAT,1925,47,15-19,1972,4.2167776831062646E-4
SIM,1937,30,20-24,1967,1
STAT,1878,19,20-24,1897,17.36050159151536
STAT,1885,18,35-39,1903,0.5153347129950655
STAT,1914,35,20-24,1949,0.2510095846675617
SIM,1954,11,na,1965,4484
STAT,1884,19,45-49,1903,0.06063989438774555
SIM,1936,17,20-24,1953,82
SIM,1916,24,40-44,1940,4
STAT,1913,19,35-39,1932,0.8061707034776027
STAT,1833,45,30-34,1878,0.07137637052678533
SIM,1930,32,50-100,1962,1
SIM,1855,54,na,1909,1673
SIM,1848,38,40-44,1886,5
SIM,1870,33,50-100,1903,6
SIM,1910,5,na,1915,3734
STAT,1915,14,na,1929,3892.2431197546457
SIM,1944,27,20-24,1971,20
STAT,1909,14,na,1923,3647.0036244271796
STAT,1838,76,na,1914,636.0395893760332
STAT,1857,30,45-49,1887,1.334707832565761
STAT,1883,40,15-19,1923,0.012919913065146607
SIM,1860,17,na,1877,2223
STAT,1908,24,40-44,1932,2.9019523830132368
SIM,1828,35,20-24,1863,4
SIM,1904,24,30-34,1928,31
SIM,1934,32,45-49,1966,2
STAT,1859,41,35-39,1900,1.3676943350445248
STAT,1843,39,na,1882,1655.8016596506613
STAT,1883,42,25-29,1925,0.5940421639707807
STAT,1894,20,20-24,1914,84.16235847700575
SIM,1831,39,25-29,1870,2
STAT,1823,39,25-29,1862,4.17753059963774
STAT,1897,22,15-19,1919,4.167928831902432
STAT,1849,54,40-44,1903,0.007677258151180094
SIM,1895,26,20-24,1921,14
STAT,1873,44,20-24,1917,0.15010717532613377
STAT,1885,37,40-44,1922,4.122047377778115
SIM,1918,8,na,1926,4113
SIM,1928,28,35-39,1956,23
STAT,1887,26,20-24,1913,12.438981703279483
SIM,1893,37,40-44,1930,7
STAT,1906,46,35-39,1952,0.10896590512381091
SIM,1830,72,na,1902,720
STAT,1904,40,45-49,1944,0.1422517248315008
STAT,1927,22,35-39,1949,10.959112578005609
SIM,1857,20,45-49,1877,1
SIM,1926,22,45-49,1948,1
SIM,1935,22,35-39,1957,11
SIM,1921,17,25-29,1938,53
STAT,1833,38,40-44,1871,3.3232701030474927
STAT,1872,23,20-24,1895,65.0981352149675
SIM,1865,30,45-49,1895,1
STAT,1806,53,20-24,1859,0.0025457820812722445
STAT,1822,49,35-39,1871,0.18295410427331477
SIM,1880,45,50-100,1925,1
STAT,1850,31,20-24,1881,2.014096581423798
SIM,1841,38,40-44,1879,8
STAT,1836,54,45-49,1890,0.00913958945356645
STAT,1913,17,25-29,1930,8.370521496095089
STAT,1825,75,na,1900,547.1443458510767
SIM,1858,36,45-49,1894,1
STAT,1901,24,40-44,1925,2.73825765508367
SIM,1844,82,na,1926,257
SIM,1873,34,20-24,1907,3
SIM,1925,26,40-44,1951,10
SIM,1861,22,25-29,1883,45
SIM,1906,36,35-39,1942,4
SIM,1889,33,na,1922,2872
STAT,1907,48,45-49,1955,0.1824181219563565
SIM,1830,62,na,1892,1074
SIM,1943,24,35-39,1967,10
STAT,1846,36,25-29,1882,2.253351008056243
SIM,1892,18,na,1910,3317
SIM,1946,20,20-24,1966,122
SIM,1849,21,30-34,1870,26
SIM,1880,37,30-34,1917,4
STAT,1871,20,35-39,1891,5.506763819481751
SIM,1821,33,45-49,1854,1
SIM,1822,43,na,1865,1458
STAT,1842,43,30-34,1885,0.8504179333591243
STAT,1945,23,15-19,1968,5.509648468001327
SIM,1792,83,na,1875,111
STAT,1940,18,30-34,1958,11.687543494810761
SIM,1911,4,na,1915,3782
STAT,1797,83,na,1880,137.47116150758598
STAT,1864,38,na,1902,1973.8273117768724
STAT,1924,45,40-44,1969,0.17814938476917874
SIM,1904,52,na,1956,2982
SIM,1950,11,na,1961,4259
STAT,1889,24,50-100,1913,0.4726102869926247
STAT,1842,23,na,1865,1938.9589505491201
STAT,1845,43,50-100,1888,0.751579343592285
STAT,1909,52,na,1961,3135.582233989206
STAT,1888,38,20-24,1926,0.8563442251443177
SIM,1790,95,na,1885,2
SIM,1825,88,na,1913,64
STAT,1881,23,15-19,1904,3.001407677134585
STAT,1851,43,40-44,1894,1.6063126635031084
SIM,1897,52,na,1949,2794
SIM,1944,17,na,1961,3690
STAT,1841,65,na,1906,1165.0803089735296
STAT,1884,52,na,1936,1998.9526821683473
STAT,1929,41,50-100,1970,0.14392821200959338
STAT,1897,18,na,1915,3182.446373654753
STAT,1873,15,na,1888,2448.5790969182613
SIM,1877,48,na,1925,2144
STAT,1815,58,na,1873,1114.9364510127616
SIM,1904,18,20-24,1922,25
STAT,1894,16,35-39,1910,0.6677961419689552
SIM,1882,39,40-44,1921,5
STAT,1823,40,na,1863,1514.0486771996655
STAT,1864,38,35-39,1902,5.925662503827758
STAT,1934,37,15-19,1971,0.02503436704165335
STAT,1872,37,30-34,1909,5.050186696536356
STAT,1836,32,35-39,1868,8.289406021534104
STAT,1884,4,na,1888,2604.947817815743
SIM,1854,36,25-29,1890,9
SIM,1886,43,45-49,1929,2
SIM,1858,33,40-44,1891,3
STAT,1777,79,na,1856,230.82160618709997
STAT,1935,24,35-39,1959,12.104687080280904
SIM,1866,60,na,1926,1689
SIM,1810,48,na,1858,1255
STAT,1836,37,45-49,1873,1.5845400520188369
SIM,1858,68,na,1926,1217
STAT,1930,19,35-39,1949,5.097341025311859
SIM,1810,58,na,1868,1048
STAT,1933,31,25-29,1964,11.773576526228776
STAT,1901,41,40-44,1942,0.20747685097760757
STAT,1837,38,25-29,1875,2.2515735253240114
STAT,1930,30,45-49,1960,1.92057558901967
SIM,1845,38,25-29,1883,4
STAT,1868,24,45-49,1892,0.6245906232498499
STAT,1870,38,50-100,1908,1.1321808525415429
STAT,1890,19,20-24,1909,20.366039981061306
SIM,1908,22,25-29,1930,76
STAT,1774,112,na,1886,6.014111183335957E-4
STAT,1850,42,na,1892,1627.2410845651184
SIM,1841,31,20-24,1872,1
SIM,1850,43,30-34,1893,6
STAT,1941,30,20-24,1971,2.422026363814026
SIM,1835,25,35-39,1860,9
SIM,1835,39,45-49,1874,5
SIM,1844,37,45-49,1881,3
STAT,1808,73,na,1881,534.7863172817019
STAT,1815,51,50-100,1866,0.03329342793549852
STAT,1876,21,15-19,1897,3.2295843323883378
STAT,1848,38,na,1886,1785.4204174284494
SIM,1939,25,50-100,1964,6
STAT,1905,39,45-49,1944,0.5816269428348747
SIM,1877,31,35-39,1908,8
STAT,1854,35,20-24,1889,0.5599698708604928
SIM,1914,35,30-34,1949,2
STAT,1871,25,50-100,1896,0.6041488343182699
STAT,1823,37,35-39,1860,11.509393050242503
SIM,1849,26,40-44,1875,3
STAT,1874,39,40-44,1913,4.182742711445165
SIM,1867,31,40-44,1898,5
STAT,1879,38,50-100,1917,1.2080600631051315
STAT,1797,93,na,1890,7.171595663448694
STAT,1892,44,40-44,1936,0.1823223060861571
SIM,1920,25,45-49,1945,3
STAT,1904,27,50-100,1931,0.8668192648668018
STAT,1898,72,na,1970,1989.9467892159744
SIM,1852,36,40-44,1888,3
STAT,1827,39,45-49,1866,1.9741540503283501
STAT,1848,45,25-29,1893,0.043226840918267596
STAT,1921,19,25-29,1940,46.41409085377533
SIM,1844,32,35-39,1876,10
STAT,1837,60,na,1897,1237.7289525706742
SIM,1935,20,45-49,1955,1
STAT,1919,33,15-19,1952,0.13042120361564224
STAT,1868,31,35-39,1899,9.165253674239334
STAT,1922,24,25-29,1946,99.4417808336979
SIM,1861,30,na,1891,2045
STAT,1859,31,40-44,1890,3.2740614603749436
STAT,1825,53,40-44,1878,0.010145896259596048
STAT,1890,28,35-39,1918,11.104954997462588
STAT,1902,38,15-19,1940,0.01607923948115603
STAT,1909,34,35-39,1943,8.16798962666088
SIM,1896,38,20-24,1934,4
STAT,1829,34,na,1863,1683.303640725313
STAT,1860,40,30-34,1900,0.8901237713531764
STAT,1844,36,40-44,1880,3.5673334825916774
STAT,1830,25,na,1855,1719.4039120464406
STAT,1841,68,na,1909,1053.5576109978315
SIM,1930,24,25-29,1954,123
SIM,1928,27,20-24,1955,25
STAT,1930,37,50-100,1967,0.51734632696398
SIM,1831,28,20-24,1859,9
SIM,1892,39,50-100,1931,1
STAT,1910,49,na,1959,3219.2019551621775
STAT,1861,17,35-39,1878,0.4953892277178824
STAT,1875,23,50-100,1898,0.394746921634239
STAT,1802,54,50-100,1856,0.04247313558815517
STAT,1900,49,na,1949,2887.4022419535872
STAT,1912,25,45-49,1937,1.6193014125233938
STAT,1855,8,na,1863,2075.5613666780096
STAT,1887,37,25-29,1924,3.042402451100003
SIM,1826,36,na,1862,1534
STAT,1938,20,20-24,1958,104.03659758817808
SIM,1917,27,45-49,1944,1
STAT,1905,46,35-39,1951,0.10814152256281725
SIM,1858,38,35-39,1896,8
STAT,1861,50,40-44,1911,0.00838816712529974
STAT,1810,80,na,1890,261.6903341458877
STAT,1898,65,na,1963,2342.379857415388
STAT,1836,19,15-19,1855,7.327917452029888
SIM,1885,38,45-49,1923,3
STAT,1870,49,15-19,1919,3.6296418127798456E-4
SIM,1938,0,na,1938,3726
STAT,1906,35,30-34,1941,1.5977923536308776
STAT,1943,19,45-49,1962,0.5000933325051129
STAT,1874,32,20-24,1906,2.6090555561727067
SIM,1882,32,20-24,1914,2
SIM,1855,23,na,1878,1984
STAT,1875,18,40-44,1893,0.17713623719531493
STAT,1940,25,20-24,1965,17.599827518605476
STAT,1876,25,30-34,1901,24.744397875044964
STAT,1830,30,40-44,1860,3.844011011930169
SIM,1899,34,40-44,1933,5
SIM,1867,49,50-100,1916,1
STAT,1877,38,45-49,1915,1.94379740443533
STAT,1897,28,na,1925,3004.4782908661327
STAT,1900,36,40-44,1936,1.244183923043738
SIM,1845,42,45-49,1887,2
STAT,1909,27,45-49,1936,1.5598154649078875
STAT,1908,25,50-100,1933,0.9025418333760659
SIM,1844,19,15-19,1863,8
STAT,1874,46,30-34,1920,0.09369890080497692
STAT,1927,20,45-49,1947,1.3173932914971385
STAT,1928,30,50-100,1958,0.9777203647547824
SIM,1885,67,na,1952,1474
STAT,1853,22,25-29,1875,51.188252459058006
SIM,1831,37,35-39,1868,8
STAT,1872,67,na,1939,1502.1163649338853
STAT,1880,24,45-49,1904,0.6901392555879797
SIM,1884,25,30-34,1909,24
STAT,1912,44,na,1956,3357.7903277518035
SIM,1909,30,45-49,1939,1
STAT,1935,17,45-49,1952,0.6451308476978418
SIM,1928,15,20-24,1943,144
STAT,1923,28,25-29,1951,71.13736534032665
SIM,1890,17,20-24,1907,24
SIM,1815,88,na,1903,63
STAT,1931,29,45-49,1960,2.10494547306291
STAT,1910,15,na,1925,3632.2728523738574
SIM,1899,20,30-34,1919,35
STAT,1940,23,50-100,1963,0.6330144137697526
STAT,1831,36,30-34,1867,4.135352485539517
SIM,1885,30,30-34,1915,17
STAT,1863,15,na,1878,2197.2654654565968
SIM,1871,32,45-49,1903,1
SIM,1896,15,na,1911,3195
STAT,1905,47,50-100,1952,0.18829208834273675
SIM,1917,6,na,1923,4069
SIM,1830,27,25-29,1857,47
STAT,1819,51,40-44,1870,0.019532446976367742
STAT,1843,51,35-39,1894,0.0058427829858527045
STAT,1907,41,25-29,1948,0.06216253017573462
SIM,1840,26,20-24,1866,12
STAT,1864,40,50-100,1904,0.898478082007816
SIM,1848,16,30-34,1864,1
SIM,1934,5,na,1939,5008
STAT,1941,23,30-34,1964,28.049823233594054
STAT,1909,15,45-49,1924,0.0929776446828429
STAT,1947,16,50-100,1963,0.39881904982013894
STAT,1823,46,na,1869,1412.0242362643135
SIM,1848,41,na,1889,1668
SIM,1876,60,na,1936,1839
SIM,1875,36,45-49,1911,1
STAT,1835,24,30-34,1859,14.854134632858662
STAT,1846,43,15-19,1889,0.01023483401730297
STAT,1873,47,25-29,1920,0.05493010659100454
SIM,1872,29,20-24,1901,10
SIM,1876,33,25-29,1909,12
SIM,1881,21,15-19,1902,2
SIM,1927,15,na,1942,4304
STAT,1838,28,15-19,1866,0.38468456016492253
STAT,1892,40,na,1932,2762.3700396316685
STAT,1889,46,25-29,1935,0.06736700548747987
STAT,1846,108,na,1954,0.0013585963684965446
STAT,1870,26,40-44,1896,2.785699744507615
STAT,1917,29,45-49,1946,1.6993607121980026
STAT,1904,26,30-34,1930,34.23999517870276
STAT,1939,30,15-19,1969,0.1240050331470934
STAT,1915,26,25-29,1941,63.64117853160344
STAT,1866,44,30-34,1910,0.9882089609645827
STAT,1941,16,25-29,1957,42.17911465799354
STAT,1862,27,45-49,1889,0.9001184816034905
SIM,1827,73,na,1900,645
SIM,1843,24,30-34,1867,21
STAT,1912,49,30-34,1961,0.08046332825655708
SIM,1874,44,30-34,1918,3
STAT,1802,88,na,1890,48.13089415587541
SIM,1949,21,35-39,1970,10
STAT,1876,23,40-44,1899,2.027522961018339
STAT,1873,27,20-24,1900,11.240073249998611
STAT,1917,17,45-49,1934,0.10155303309025861
STAT,1868,33,25-29,1901,9.193131220793992
STAT,1897,45,20-24,1942,0.008637092964461869
STAT,1878,9,na,1887,2594.810786344106
SIM,1954,15,30-34,1969,18
SIM,1864,75,na,1939,844
STAT,1841,75,na,1916,709.7234311565217
STAT,1877,30,30-34,1907,17.24690971213998
SIM,1912,26,30-34,1938,32
STAT,1946,15,30-34,1961,12.778352538206216
STAT,1822,36,50-100,1858,2.278239921021646
STAT,1886,42,40-44,1928,2.2418122909858313
STAT,1926,15,45-49,1941,0.5812611830506494
STAT,1912,34,na,1946,3485.716000407628
SIM,1872,38,35-39,1910,13
SIM,1876,26,35-39,1902,17
SIM,1928,25,30-34,1953,53
STAT,1877,23,25-29,1900,55.923618823762276
SIM,1923,26,25-29,1949,71
STAT,1847,35,30-34,1882,4.163188936859
SIM,1925,29,45-49,1954,1
SIM,1835,32,25-29,1867,12
STAT,1854,42,50-100,1896,0.7549448967547501
STAT,1854,38,na,1892,1677.305474348804
SIM,1913,16,20-24,1929,18
STAT,1946,22,20-24,1968,116.89618076986766
SIM,1840,62,na,1902,1217
STAT,1901,20,25-29,1921,76.14992634289575
SIM,1817,80,na,1897,267
SIM,1940,26,25-29,1966,56
STAT,1915,47,40-44,1962,0.15008714677544643
STAT,1904,15,na,1919,3438.2394342221223
STAT,1894,23,25-29,1917,69.28425221838253
STAT,1905,16,20-24,1921,24.267666036123664
SIM,1904,27,35-39,1931,15
SIM,1886,39,25-29,1925,1
STAT,1929,39,30-34,1968,2.205684563984624
STAT,1845,41,40-44,1886,1.641708133263552
STAT,1857,53,na,1910,1578.4834425913934
STAT,1832,26,20-24,1858,9.746489215204177
STAT,1878,43,45-49,1921,1.4628290454191464
STAT,1791,98,na,1889,0.5728089647127608
STAT,1872,26,25-29,1898,40.221421612466024
SIM,1809,61,na,1870,957
STAT,1846,19,na,1865,2113.6118796265328
STAT,1829,29,50-100,1858,0.7166394372074051
SIM,1944,11,na,1955,3898
STAT,1840,80,na,1920,405.95855215919124
STAT,1868,48,50-100,1916,0.2185881059834848
STAT,1827,32,25-29,1859,12.289264979176492
STAT,1903,30,na,1933,3233.348237672537
STAT,1898,23,50-100,1921,0.5197163531482072
STAT,1848,48,na,1896,1650.7564919003798
STAT,1853,60,na,1913,1443.3461932983378
SIM,1870,27,45-49,1897,1
STAT,1915,40,20-24,1955,0.016843613158745916
SIM,1830,31,45-49,1861,1
STAT,1915,33,50-100,1948,0.7921452914676513
STAT,1919,31,50-100,1950,0.8461249025815838
SIM,1911,31,na,1942,3472
STAT,1860,42,50-100,1902,0.8087836208254495
STAT,1833,34,25-29,1867,7.924888372282727
SIM,1843,38,na,1881,1752
STAT,1901,28,20-24,1929,15.458383159332051
SIM,1855,35,30-34,1890,6
SIM,1904,34,25-29,1938,9
STAT,1785,98,na,1883,0.5983514064523976
STAT,1867,36,45-49,1903,1.7768896108632892
STAT,1862,22,35-39,1884,4.825081069035412
SIM,1905,24,15-19,1929,5
SIM,1899,36,30-34,1935,2
STAT,1915,33,30-34,1948,15.094897740135842
STAT,1931,36,35-39,1967,3.0288588692820513
SIM,1923,33,30-34,1956,20
STAT,1811,53,50-100,1864,0.047127467235656084
STAT,1861,3,na,1864,2550.779490010218
SIM,1853,41,40-44,1894,4
STAT,1883,44,30-34,1927,1.0504647707897155
SIM,1870,22,35-39,1892,5
STAT,1853,20,35-39,1873,5.293752817990826
SIM,1940,6,na,1946,3736
STAT,1878,50,35-39,1928,0.008597596871114407
SIM,1885,23,25-29,1908,56
STAT,1878,52,na,1930,2108.5529623057414
STAT,1867,19,45-49,1886,0.058542587549835004
STAT,1932,26,25-29,1958,81.47878739607522
SIM,1922,46,50-100,1968,4
SIM,1932,30,20-24,1962,3
STAT,1945,6,na,1951,4089.2739545206664
STAT,1816,53,30-34,1869,0.0131946226634042
STAT,1828,86,na,1914,124.9562823421353
STAT,1878,39,25-29,1917,2.8060996530878115
STAT,1783,79,na,1862,229.08564757628062
SIM,1908,29,45-49,1937,1
SIM,1841,34,25-29,1875,20
STAT,1949,21,na,1970,4026.9932960041706
STAT,1854,20,35-39,1874,4.9769236561660595
SIM,1817,37,35-39,1854,13
STAT,1916,49,15-19,1965,3.5484180255637346E-4
STAT,1832,46,25-29,1878,0.041690113221280814
STAT,1927,36,45-49,1963,0.801419228327786
STAT,1882,34,20-24,1916,2.4620802172123946
SIM,1827,37,45-49,1864,2
SIM,1863,37,30-34,1900,4
SIM,1840,20,15-19,1860,2
SIM,1923,36,35-39,1959,10
SIM,1926,24,35-39,1950,15
SIM,1876,21,40-44,1897,4
STAT,1893,26,45-49,1919,1.3347386533388004
STAT,1933,15,50-100,1948,0.4759936080645788
SIM,1866,21,30-34,1887,18
STAT,1876,28,35-39,1904,9.38425121468671
SIM,1868,34,na,1902,2125
STAT,1924,48,45-49,1972,0.24374982294758216
STAT,1866,67,na,1933,1381.2340923226097
STAT,1886,28,45-49,1914,1.1040829216880894
STAT,1863,53,na,1916,1756.3529474970637
SIM,1961,0,na,1961,4756
SIM,1940,21,15-19,1961,4
STAT,1775,105,na,1880,0.01872040870536725
SIM,1849,20,na,1869,1996
STAT,1961,3,na,1964,4799.963246070866
STAT,1815,43,20-24,1858,0.3854341186760754
STAT,1935,22,45-49,1957,1.447456258299463
STAT,1944,4,na,1948,4062.5305356787503
SIM,1896,37,50-100,1933,1
SIM,1898,29,40-44,1927,4
STAT,1896,33,na,1929,2964.8010725733698
STAT,1896,27,25-29,1923,52.778866925745504
SIM,1861,20,35-39,1881,8
STAT,1890,55,na,1945,2388.13848766705
SIM,1884,28,35-39,1912,13
SIM,1886,15,na,1901,2500
STAT,1868,37,40-44,1905,3.945627641248002
SIM,1894,28,45-49,1922,1
SIM,1906,33,30-34,1939,12
STAT,1907,45,40-44,1952,0.1353503941552837
SIM,1804,58,na,1862,1014
SIM,1859,23,30-34,1882,13
SIM,1876,22,na,1898,2310
STAT,1818,49,45-49,1867,0.4882327123192065
STAT,1829,36,25-29,1865,2.661839567665124
STAT,1828,48,25-29,1876,0.046027656108271364
STAT,1874,52,25-29,1926,0.0034006335218684787
SIM,1858,35,30-34,1893,5
SIM,1889,29,na,1918,2844
STAT,1838,48,35-39,1886,0.09546692387634248
STAT,1830,33,45-49,1863,1.4713030479810285
SIM,1943,22,45-49,1965,1
SIM,1927,37,30-34,1964,1
STAT,1878,36,20-24,1914,0.7625693160538273
STAT,1932,21,15-19,1953,6.618059843534785
SIM,1862,20,35-39,1882,9
STAT,1805,49,35-39,1854,0.5201974944235521
STAT,1840,28,20-24,1868,9.530424637284975
STAT,1819,37,45-49,1856,5.531924857214682
STAT,1880,21,40-44,1901,2.0816034933983505
SIM,1819,54,na,1873,1224
SIM,1890,34,20-24,1924,3
STAT,1846,47,30-34,1893,0.07146220763180379
STAT,1913,30,45-49,1943,1.4909479897907614
SIM,1856,49,na,1905,1731
STAT,1888,36,30-34,1924,5.978836232761846
SIM,1919,38,35-39,1957,7
STAT,1940,16,40-44,1956,1.3419986482101531
STAT,1891,46,30-34,1937,0.0640004622372394
STAT,1930,16,30-34,1946,14.922956220221053
STAT,1915,36,35-39,1951,2.319449030750699
SIM,1900,19,15-19,1919,7
STAT,1855,33,15-19,1888,0.10197673167310099
STAT,1910,42,45-49,1952,0.14859515349005342
STAT,1913,26,50-100,1939,0.9401739286576076
SIM,1876,37,40-44,1913,9
SIM,1834,35,45-49,1869,2
SIM,1922,36,35-39,1958,4
STAT,1866,40,15-19,1906,0.012154214230585663
STAT,1843,102,na,1945,0.19802407856500137
SIM,1861,23,na,1884,2076
SIM,1845,61,na,1906,1303
STAT,1888,37,50-100,1925,1.3707112178970122
STAT,1921,42,20-24,1963,0.018791103541025103
SIM,1908,20,35-39,1928,13
STAT,1833,46,na,1879,1490.0812402989047
SIM,1914,45,na,1959,3458
SIM,1873,89,na,1962,146
STAT,1881,34,na,1915,2159.1178402557775
SIM,1775,87,na,1862,46
STAT,1826,35,45-49,1861,2.319580836853751
STAT,1914,36,35-39,1950,2.292451072525924
SIM,1786,80,na,1866,207
STAT,1866,20,45-49,1886,0.6214440976339304
STAT,1831,29,40-44,1860,2.4532942039865637
SIM,1816,43,na,1859,1415
STAT,1856,33,15-19,1889,0.10515309322560105
SIM,1921,26,50-100,1947,5
STAT,1868,26,35-39,1894,8.726831328741998
SIM,1880,22,45-49,1902,1
SIM,1919,25,20-24,1944,17
STAT,1844,39,45-49,1883,1.4329902367628422
STAT,1856,26,50-100,1882,0.492118530899345
STAT,1919,37,30-34,1956,1.8497168822880135
SIM,1864,26,50-100,1890,3
SIM,1875,74,na,1949,1003
STAT,1929,37,40-44,1966,1.8155264238914695
SIM,1807,69,na,1876,705
STAT,1859,34,45-49,1893,1.2999377201257694
STAT,1874,35,25-29,1909,2.8054616443893985
STAT,1945,17,20-24,1962,139.90849096817004
STAT,1808,79,na,1887,302.82871494013614
STAT,1933,33,na,1966,4811.928237457938
STAT,1848,42,20-24,1890,0.11786201148756718
STAT,1887,48,30-34,1935,0.10100180003372493
SIM,1936,29,na,1965,2806
SIM,1867,21,15-19,1888,6
SIM,1878,88,na,1966,265
SIM,1931,35,30-34,1966,2
STAT,1871,34,45-49,1905,1.6218259597175253
SIM,1893,15,30-34,1908,2
STAT,1850,79,na,1929,492.81563969119406
SIM,1923,23,20-24,1946,118
SIM,1961,3,na,1964,4755
STAT,1842,25,50-100,1867,0.5811987686727486
STAT,1966,0,na,1966,4672.6629739324635
SIM,1885,74,na,1959,1147
SIM,1849,29,45-49,1878,2
SIM,1889,17,30-34,1906,2
STAT,1894,21,35-39,1915,7.105950363396661
STAT,1852,25,45-49,1877,0.9511734779584953
STAT,1893,66,na,1959,2060.5801034449664
SIM,1860,25,45-49,1885,3
SIM,1839,29,35-39,1868,13
STAT,1805,58,na,1863,1074.2640536706774
STAT,1840,15,25-29,1855,4.872101667355541
STAT,1795,64,na,1859,862.2856978070665
SIM,1774,95,na,1869,2
STAT,1851,53,35-39,1904,0.006093433007955765
SIM,1928,32,20-24,1960,3
STAT,1827,30,35-39,1857,13.250523905064878
STAT,1861,39,50-100,1900,0.9546701388782052
SIM,1882,35,25-29,1917,4
STAT,1877,1,na,1878,3375.3801606565867
STAT,1922,17,35-39,1939,4.587675159777829
STAT,1832,24,30-34,1856,15.411436720996054
SIM,1852,39,45-49,1891,1
STAT,1839,34,na,1873,1739.2232204115046
SIM,1877,42,40-44,1919,9
STAT,1906,31,15-19,1937,0.11296811030676844
STAT,1851,68,na,1919,1099.2981459775579
STAT,1918,24,35-39,1942,9.533710242097934
STAT,1868,21,40-44,1889,1.8918078447464461
STAT,1858,21,30-34,1879,15.246840923028245
SIM,1858,41,na,1899,1895
STAT,1854,38,25-29,1892,2.049804748139353
STAT,1870,93,na,1963,68.65302803205384
STAT,1837,42,45-49,1879,1.1461735477392312
SIM,1835,30,35-39,1865,11
STAT,1772,91,na,1863,15.208599683665929
SIM,1870,75,na,1945,863
STAT,1829,43,15-19,1872,0.011597632816719954
SIM,1930,17,35-39,1947,7
STAT,1941,26,35-39,1967,14.678688712247938
STAT,1859,21,15-19,1880,2.8485934883662636
SIM,1837,36,25-29,1873,5
SIM,1843,42,na,1885,1661
STAT,1903,67,na,1970,2460.338217940198
SIM,1827,80,na,1907,333
SIM,1838,49,50-100,1887,1
STAT,1824,35,na,1859,1608.8191229929846
STAT,1865,49,40-44,1914,0.14353202465664944
SIM,1936,23,15-19,1959,4
SIM,1912,19,25-29,1931,8
STAT,1904,19,25-29,1923,7.637557155886303
SIM,1834,24,na,1858,1725
STAT,1841,33,20-24,1874,2.237650929821151
SIM,1789,94,na,1883,1
STAT,1913,18,20-24,1931,26.11881870117458
SIM,1926,29,na,1955,4129
STAT,1923,18,30-34,1941,13.4854187099663
SIM,1921,18,20-24,1939,148
SIM,1948,16,35-39,1964,5
STAT,1842,46,35-39,1888,0.1027099593008384
SIM,1871,25,20-24,1896,11
STAT,1887,17,50-100,1904,0.05176894900623149
STAT,1928,23,15-19,1951,6.259128459075399
SIM,1931,18,30-34,1949,16
SIM,1837,35,na,1872,1717
SIM,1848,30,45-49,1878,1
STAT,1877,33,35-39,1910,9.881984190393265
SIM,1862,42,50-100,1904,3
SIM,1904,17,25-29,1921,7
STAT,1945,27,30-34,1972,40.60963271787006
STAT,1900,25,35-39,1925,12.730751433830855
SIM,1830,24,20-24,1854,56
STAT,1896,34,15-19,1930,0.17615875622162164
STAT,1869,29,20-24,1898,10.659764674246237
SIM,1945,15,20-24,1960,122
STAT,1879,49,35-39,1928,0.13555167900125056
STAT,1849,28,40-44,1877,2.643632693998139
SIM,1895,30,40-44,1925,5
STAT,1940,28,25-29,1968,63.37605400338173
STAT,1904,29,35-39,1933,12.981393888958218
STAT,1927,18,15-19,1945,53.16719736884836
STAT,1822,61,na,1883,1008.1248539402673
STAT,1917,24,50-100,1941,0.6565218438277204
SIM,1936,29,20-24,1965,14
STAT,1833,51,25-29,1884,0.0022845283007529734
STAT,1853,15,35-39,1868,0.5054687882175578
SIM,1931,25,20-24,1956,21
STAT,1877,66,na,1943,1606.122833650759
STAT,1915,23,20-24,1938,108.25044268299624
SIM,1905,28,30-34,1933,34
STAT,1859,85,na,1944,206.11907968778198
SIM,1877,1,na,1878,3214
STAT,1819,54,45-49,1873,0.025361010445004356
STAT,1801,62,na,1863,866.9720875472518
SIM,1885,33,35-39,1918,11
STAT,1868,52,na,1920,1930.4091613637218
SIM,1861,15,35-39,1876,1
STAT,1855,39,20-24,1894,0.5422725639861675
STAT,1916,39,20-24,1955,0.25245457441472263
SIM,1839,36,50-100,1875,4
STAT,1845,24,40-44,1869,1.8043824127371975
STAT,1897,34,15-19,1931,0.178374982702119
SIM,1896,7,na,1903,3293
SIM,1860,75,na,1935,797
STAT,1921,48,na,1969,3901.583230483459
STAT,1923,25,20-24,1948,19.932529856969122
SIM,1857,28,40-44,1885,2
SIM,1899,23,35-39,1922,8
STAT,1892,30,15-19,1922,0.16985838318177027
STAT,1816,98,na,1914,1.5138256753457484
STAT,1928,29,20-24,1957,21.22334243592889
SIM,1912,29,35-39,1941,18
STAT,1883,47,35-39,1930,0.12906534405111283
STAT,1870,29,45-49,1899,1.0216315936319507
STAT,1855,23,20-24,1878,56.799575459881346
SIM,1934,16,40-44,1950,5
SIM,1868,38,45-49,1906,6
SIM,1925,44,na,1969,4192
STAT,1823,87,na,1910,94.2886339609773
SIM,1871,23,na,1894,2221
STAT,1867,16,40-44,1883,0.166850196922662
STAT,1850,38,40-44,1888,3.1022883821368095
SIM,1953,17,20-24,1970,146
SIM,1902,16,na,1918,3378
SIM,1908,26,40-44,1934,5
STAT,1914,26,40-44,1940,4.454275638729071
STAT,1937,15,20-24,1952,125.17752534200251
STAT,1833,26,50-100,1859,0.5210856938283905
STAT,1831,39,35-39,1870,5.292998944572142
STAT,1905,26,15-19,1931,0.6216543326705943
SIM,1954,17,20-24,1971,143
STAT,1956,15,50-100,1971,0.4685190488783513
STAT,1835,22,40-44,1857,1.762968722036321
SIM,1853,24,40-44,1877,1
STAT,1866,54,40-44,1920,0.008920714946684696
SIM,1853,44,45-49,1897,1
STAT,1931,16,15-19,1947,56.253830989778514
STAT,1827,36,40-44,1863,4.653982528909441
STAT,1869,31,35-39,1900,9.30605963148953
SIM,1904,45,na,1949,3141
STAT,1856,44,20-24,1900,0.11547750264880301
STAT,1902,49,20-24,1951,0.008836215407435065
STAT,1847,53,na,1900,1562.2682355155118
SIM,1900,34,40-44,1934,5
STAT,1847,37,20-24,1884,0.5897709500506886
SIM,1795,94,na,1889,4
SIM,1876,31,35-39,1907,8
STAT,1801,99,na,1900,0.6694902532794639
STAT,1842,102,na,1944,0.21231213501981422
SIM,1917,32,45-49,1949,1
STAT,1835,72,na,1907,803.802273524077
STAT,1890,48,na,1938,2566.3161392183347
SIM,1843,22,40-44,1865,1
SIM,1899,39,35-39,1938,8
SIM,1818,42,35-39,1860,5
SIM,1850,24,na,1874,1958
STAT,1946,17,20-24,1963,142.0576659859315
STAT,1887,30,40-44,1917,4.619375343743855
STAT,1804,80,na,1884,264.517761671723
STAT,1888,32,15-19,1920,0.158990793410829
SIM,1840,29,25-29,1869,41
SIM,1922,26,40-44,1948,6
STAT,1856,67,na,1923,1168.4288701530443
SIM,1878,37,25-29,1915,6
STAT,1926,16,40-44,1942,1.6239836891926955
SIM,1935,18,15-19,1953,50
STAT,1832,29,25-29,1861,33.841628691352064
STAT,1923,35,30-34,1958,1.9984280181793437
STAT,1905,19,25-29,1924,7.6963892331768955
STAT,1909,32,45-49,1941,1.4186262822156077
STAT,1847,31,15-19,1878,0.12458495900337195
SIM,1863,23,20-24,1886,52
SIM,1913,21,20-24,1934,96
SIM,1921,30,45-49,1951,1
STAT,1837,35,20-24,1872,0.6218888331251713
STAT,1900,15,25-29,1915,7.460776503075832
STAT,1845,44,45-49,1889,1.0511832992891375
STAT,1894,27,40-44,1921,3.6367627493617767
STAT,1828,30,35-39,1858,11.328696292147514
STAT,1840,22,15-19,1862,2.7532482757761074
SIM,1885,20,20-24,1905,62
SIM,1916,30,na,1946,3641
SIM,1858,22,35-39,1880,9
SIM,1928,21,15-19,1949,5
SIM,1796,79,na,1875,271
STAT,1937,28,35-39,1965,13.819106502783333
SIM,1843,27,35-39,1870,11
SIM,1854,75,na,1929,776
SIM,1917,15,na,1932,3956
SIM,1869,40,40-44,1909,4
STAT,1836,20,na,1856,1824.1790237005926
STAT,1824,48,40-44,1872,0.2057612361349587
SIM,1907,63,na,1970,2785
STAT,1833,31,20-24,1864,2.1575969611587174
SIM,1919,44,na,1963,3862
SIM,1821,95,na,1916,10
SIM,1833,76,na,1909,502
STAT,1869,37,na,1906,2156.1654487075884
STAT,1881,18,15-19,1899,5.401719930776725
STAT,1891,39,40-44,1930,5.0648494327837525
STAT,1863,32,45-49,1895,1.4456587521178492
STAT,1886,45,45-49,1931,0.23785475436286865
STAT,1905,21,20-24,1926,94.38371912135777
SIM,1835,36,40-44,1871,3
SIM,1904,38,40-44,1942,1
SIM,1927,27,20-24,1954,19
SIM,1913,19,25-29,1932,8
STAT,1835,27,35-39,1862,8.003794186359292
SIM,1815,95,na,1910,4
SIM,1836,30,35-39,1866,9
SIM,1914,34,35-39,1948,14
STAT,1817,87,na,1904,81.54385542875355
STAT,1808,101,na,1909,0.2206345922530851
SIM,1935,36,45-49,1971,2
STAT,1908,47,15-19,1955,3.147263648010939E-4
STAT,1901,38,15-19,1939,0.01594790711424738
STAT,1762,102,na,1864,0.038732979844811305
STAT,1838,86,na,1924,148.95661013077353
STAT,1889,43,20-24,1932,0.18387850834276662
STAT,1938,3,na,1941,3779.8513345223614
STAT,1938,25,15-19,1963,0.6612967770629625
STAT,1895,21,35-39,1916,7.208667751136455
SIM,1933,3,na,1936,5174
SIM,1851,61,na,1912,1396
STAT,1889,51,na,1940,2523.2263028685484
SIM,1901,31,na,1932,3144
STAT,1939,21,na,1960,3465.775711248146
STAT,1920,37,20-24,1957,0.27265712556547483
STAT,1829,49,20-24,1878,0.009554610065757403
STAT,1850,45,30-34,1895,0.06891687312961722
SIM,1853,90,na,1943,49
SIM,1884,23,40-44,1907,1
STAT,1917,49,15-19,1966,3.6135917349062693E-4
STAT,1857,19,35-39,1876,0.4748627959062979
STAT,1859,32,50-100,1891,0.6889163466623451
STAT,1915,43,25-29,1958,0.06781094657480799
STAT,1853,53,na,1906,1603.3454592658484
STAT,1937,35,25-29,1972,0.9317253664133991
SIM,1836,94,na,1930,12
SIM,1867,32,50-100,1899,6
STAT,1942,29,20-24,1971,18.08118689054295
STAT,1919,27,20-24,1946,18.63240919332845
SIM,1871,16,na,1887,2422
STAT,1859,50,30-34,1909,0.004539982738385273
SIM,1863,96,na,1959,9
STAT,1906,50,na,1956,3021.884328125093
STAT,1880,31,50-100,1911,0.916250025697034
SIM,1910,29,25-29,1939,69
STAT,1847,38,na,1885,1783.920968422708
STAT,1904,26,25-29,1930,57.51752097318124
SIM,1881,36,25-29,1917,1
SIM,1848,91,na,1939,35
STAT,1906,34,35-39,1940,7.93232797305821
STAT,1851,43,na,1894,1650.5639861713037
STAT,1862,46,20-24,1908,0.009720141937361473
STAT,1923,20,20-24,1943,122.95213835078506
STAT,1930,18,20-24,1948,165.14681757085066
SIM,1826,88,na,1914,55
STAT,1921,23,20-24,1944,118.279696488305
SIM,1871,91,na,1962,107
SIM,1793,84,na,1877,91
SIM,1931,39,40-44,1970,3
STAT,1877,30,25-29,1907,10.117762391387158
SIM,1834,26,40-44,1860,2
SIM,1838,20,40-44,1858,1
SIM,1912,26,25-29,1938,60
SIM,1850,39,50-100,1889,3
SIM,1935,33,40-44,1968,4
STAT,1932,26,30-34,1958,48.504059987372926
STAT,1869,27,45-49,1896,1.0161377033598822
STAT,1927,33,40-44,1960,4.544719025732202
STAT,1875,21,30-34,1896,17.348206371917918
STAT,1893,17,40-44,1910,0.219122922261786
SIM,1914,14,na,1928,3872
STAT,1858,49,50-100,1907,0.17811319902749329
SIM,1903,39,35-39,1942,5
SIM,1918,28,na,1946,3708
STAT,1852,27,50-100,1879,0.5401699108143126
STAT,1914,42,15-19,1956,0.0014375642674845125
SIM,1884,42,na,1926,2274
SIM,1839,55,na,1894,1412
SIM,1876,43,35-39,1919,7
SIM,1893,40,30-34,1933,1
SIM,1899,25,30-34,1924,36
STAT,1859,23,na,1882,1831.7554576634645
SIM,1834,83,na,1917,227
STAT,1943,16,35-39,1959,4.204778050877053
STAT,1811,109,na,1920,3.085548990599759E-4
STAT,1924,16,50-100,1940,0.4225030305769553
STAT,1836,48,15-19,1884,2.6762831467510114E-4
STAT,1843,48,na,1891,1500.5531002220666
STAT,1838,61,na,1899,1254.5087788115038
STAT,1902,29,25-29,1931,55.99450001338763
SIM,1883,33,25-29,1916,16
STAT,1875,33,25-29,1908,9.9037481524593
STAT,1934,21,35-39,1955,11.957963374037847
SIM,1841,16,30-34,1857,2
SIM,1928,0,na,1928,4994
SIM,1941,28,na,1969,3573
SIM,1785,89,na,1874,33
STAT,1892,30,20-24,1922,3.2241042593920666
SIM,1928,18,30-34,1946,18
STAT,1912,45,15-19,1957,3.360273053067298E-4
SIM,1920,36,30-34,1956,4
STAT,1810,47,40-44,1857,0.5713138704222728
STAT,1910,23,45-49,1933,0.9951505164018911
STAT,1864,93,na,1957,31.945605062040965
SIM,1800,71,na,1871,552
STAT,1892,38,50-100,1930,1.445521483412583
SIM,1942,21,35-39,1963,10
SIM,1951,16,35-39,1967,6
STAT,1911,16,15-19,1927,8.60074730077519
SIM,1832,29,40-44,1861,2
STAT,1930,29,30-34,1959,47.019385940061696
STAT,1904,39,30-34,1943,1.5430906059254201
STAT,1796,80,na,1876,254.27232686176143
SIM,1942,29,45-49,1971,1
STAT,1892,25,na,1917,2843.0123257501973
STAT,1913,20,50-100,1933,0.6059554139427606
SIM,1858,34,na,1892,1921
SIM,1854,20,na,1874,2025
SIM,1942,23,30-34,1965,32
STAT,1911,16,50-100,1927,0.0710023023695396
SIM,1857,31,30-34,1888,22
STAT,1939,27,25-29,1966,62.5100997209252
STAT,1932,24,35-39,1956,11.630985820512434
STAT,1916,41,40-44,1957,0.2424947390459794
SIM,1891,43,30-34,1934,5
SIM,1935,31,45-49,1966,1
STAT,1876,17,35-39,1893,0.5355427569266493
STAT,1937,19,15-19,1956,41.585023729523094
STAT,1896,15,na,1911,3165.802755211717
STAT,1866,46,35-39,1912,0.12233132286533999
SIM,1858,10,na,1868,2291
STAT,1894,37,50-100,1931,1.490540444662629
STAT,1914,44,40-44,1958,0.23336421410875327
SIM,1888,22,20-24,1910,74
STAT,1778,112,na,1890,7.20367336331751E-4
STAT,1849,31,30-34,1880,15.318915329667437
STAT,1866,40,20-24,1906,0.13977345610244932
STAT,1881,65,na,1946,1542.2707764318277
STAT,1856,98,na,1954,2.3944275868794715
SIM,1911,27,50-100,1938,5
STAT,1870,40,40-44,1910,2.10557554804988
STAT,1818,43,50-100,1861,2.4086949634253627
STAT,1843,25,50-100,1868,0.5394682258398008
SIM,1877,24,40-44,1901,2
SIM,1829,37,na,1866,1532
SIM,1940,24,35-39,1964,12
STAT,1883,43,30-34,1926,1.057145933086824
SIM,1825,47,na,1872,1428
SIM,1925,26,35-39,1951,17
SIM,1821,33,na,1854,1550
SIM,1953,7,na,1960,4443
STAT,1914,33,30-34,1947,14.919195919060035
STAT,1852,84,na,1936,241.17624314817402
SIM,1922,44,40-44,1966,3
SIM,1945,19,15-19,1964,47
STAT,1863,33,50-100,1896,0.7563779654614307
STAT,1940,32,15-19,1972,0.12564115959234362
STAT,1794,97,na,1891,1.0118886949031756
STAT,1870,22,na,1892,2191.835486580617
SIM,1813,45,50-100,1858,4
SIM,1922,33,30-34,1955,25
STAT,1809,64,na,1873,865.2829473138795
STAT,1866,50,50-100,1916,0.013348452975154442
STAT,1864,49,35-39,1913,0.11541488773620472
STAT,1840,20,50-100,1860,0.3452676348047905
STAT,1865,27,30-34,1892,21.562409092335795
STAT,1868,99,na,1967,8.753499233427325
SIM,1909,43,40-44,1952,1
STAT,1934,23,30-34,1957,36.476531642809725
STAT,1863,19,20-24,1882,15.082317196325434
STAT,1915,29,35-39,1944,14.363470332135245
SIM,1885,30,25-29,1915,12
SIM,1838,73,na,1911,742
SIM,1940,26,30-34,1966,41
STAT,1917,26,35-39,1943,14.925402794894566
STAT,1958,7,na,1965,4875.998504488613
SIM,1929,34,25-29,1963,14
STAT,1864,43,20-24,1907,0.13275015632943055
STAT,1881,46,30-34,1927,0.08859112387062876
SIM,1879,21,40-44,1900,3
SIM,1888,32,na,1920,2671
STAT,1930,16,25-29,1946,53.05600205678787
SIM,1906,23,20-24,1929,89
STAT,1866,17,na,1883,2258.7520105348635
SIM,1871,19,20-24,1890,15
STAT,1835,19,45-49,1854,0.10905546275963224
SIM,1923,29,35-39,1952,22
SIM,1924,41,40-44,1965,1
STAT,1818,104,na,1922,0.03275630439874336
STAT,1844,89,na,1933,72.96215921211919
SIM,1934,34,na,1968,4787
SIM,1804,61,na,1865,932
SIM,1892,77,na,1969,1550
STAT,1876,94,na,1970,87.83227469861055
SIM,1916,33,30-34,1949,20
STAT,1830,27,15-19,1857,0.45470124236480586
STAT,1890,9,na,1899,2996.7125316451566
STAT,1938,34,25-29,1972,8.768333194910007
SIM,1847,24,25-29,1871,49
STAT,1849,40,15-19,1889,0.010536535849746903
SIM,1873,16,20-24,1889,15
SIM,1859,75,na,1934,774
STAT,1896,41,45-49,1937,0.13025838735232131
SIM,1856,16,20-24,1872,10
STAT,1831,82,na,1913,272.4307639948054
STAT,1869,7,na,1876,2523.7115804622185
STAT,1777,110,na,1887,0.0017473842099941747
STAT,1869,21,30-34,1890,16.35082959305851
STAT,1852,16,40-44,1868,0.16132755944305582
SIM,1863,80,na,1943,464
STAT,1910,25,40-44,1935,4.317325114409804
STAT,1894,33,35-39,1927,12.242875183434244
STAT,1865,16,20-24,1881,15.7357492105044
SIM,1905,30,20-24,1935,3
STAT,1909,39,na,1948,3330.3815542608972
STAT,1908,33,30-34,1941,13.990187463455063
STAT,1861,29,50-100,1890,0.4988788986515865
STAT,1899,38,40-44,1937,1.2169444518885435
STAT,1894,44,45-49,1938,0.12447273736468525
SIM,1852,42,35-39,1894,2
SIM,1926,39,na,1965,4283
STAT,1877,49,15-19,1926,3.837894220379106E-4
STAT,1830,38,25-29,1868,2.3077196274194716
STAT,1879,54,20-24,1933,7.096421929482375E-4
STAT,1839,37,30-34,1876,4.240410442645714
SIM,1912,39,30-34,1951,3
SIM,1905,21,na,1926,3228
STAT,1934,29,45-49,1963,2.1933483362956974
STAT,1851,32,25-29,1883,7.668710510720774
SIM,1846,25,na,1871,1880
STAT,1945,24,15-19,1969,5.507720091037526
STAT,1867,58,na,1925,1754.2833272172272
STAT,1944,24,50-100,1968,0.6706937124176828
SIM,1851,95,na,1946,6
STAT,1805,74,na,1879,486.7654222798633
SIM,1881,5,na,1886,2063
STAT,1907,16,25-29,1923,7.8831897055718105
STAT,1928,24,15-19,1952,6.239224430575538
STAT,1792,90,na,1882,30.021176598826806
STAT,1848,27,30-34,1875,22.338129329579463
STAT,1904,28,20-24,1932,15.840821490332772
SIM,1877,21,30-34,1898,16
STAT,1871,63,na,1934,1673.806388724007
SIM,1760,97,na,1857,1
STAT,1886,5,na,1891,2615.1624049464926
SIM,1851,55,na,1906,1552
STAT,1844,42,35-39,1886,1.2880465696157333
STAT,1788,85,na,1873,78.4737155660226
SIM,1842,19,na,1861,1999
STAT,1912,36,30-34,1948,1.6886244131119577
STAT,1784,79,na,1863,249.7024282720882
SIM,1897,15,25-29,1912,7
SIM,1856,27,30-34,1883,23
STAT,1862,27,na,1889,1934.7452347783938
SIM,1896,67,na,1963,2203
SIM,1915,16,25-29,1931,12
STAT,1889,15,25-29,1904,6.639555290650559
SIM,1858,27,35-39,1885,9
STAT,1848,16,20-24,1864,16.427045588872378
STAT,1780,106,na,1886,0.010726155405255875
STAT,1844,53,45-49,1897,0.009917382682682755
SIM,1901,25,40-44,1926,9
SIM,1912,28,20-24,1940,21
STAT,1798,87,na,1885,59.55448698653764
STAT,1936,34,20-24,1970,2.235211835344712
STAT,1899,31,15-19,1930,0.18508617631686325
STAT,1927,31,45-49,1958,1.8296563041504086
SIM,1861,32,35-39,1893,17
STAT,1823,42,20-24,1865,0.21185122078761734
STAT,1930,16,na,1946,4506.414927378073
SIM,1847,37,30-34,1884,5
SIM,1898,34,na,1932,2957
STAT,1899,22,30-34,1921,23.056267130462828
SIM,1821,73,na,1894,685
STAT,1885,40,30-34,1925,1.0935012995318583
STAT,1889,17,20-24,1906,20.67598597341415
SIM,1916,20,25-29,1936,81
STAT,1823,48,35-39,1871,0.1699865214436794
STAT,1852,68,na,1920,1107.9222217938252
STAT,1840,48,35-39,1888,0.09147025576748796
STAT,1840,42,20-24,1882,0.10871902039338852
STAT,1914,47,45-49,1961,0.20363170755446564
SIM,1814,63,na,1877,868
SIM,1772,82,na,1854,104
STAT,1834,20,30-34,1854,24.229994642537733
SIM,1922,33,50-100,1955,2
STAT,1821,48,25-29,1869,0.0895427647339469
SIM,1901,23,45-49,1924,3
SIM,1830,36,50-100,1866,1
SIM,1854,42,50-100,1896,1
SIM,1916,31,35-39,1947,11
STAT,1829,39,50-100,1868,1.0729961142244502
STAT,1889,45,na,1934,2650.046780181439
STAT,1839,26,20-24,1865,9.910989274518363
SIM,1876,47,na,1923,2182
STAT,1890,33,20-24,1923,3.108765861296824
STAT,1890,39,35-39,1929,8.086765346201672
STAT,1923,39,40-44,1962,1.6351023464191483
STAT,1858,30,15-19,1888,0.10769215393389744
STAT,1856,74,na,1930,818.0005190338109
SIM,1936,24,15-19,1960,3
STAT,1881,30,45-49,1911,1.604215556249442
SIM,1850,30,na,1880,1915
STAT,1853,32,35-39,1885,7.892460726180047
SIM,1894,20,na,1914,3014
STAT,1821,37,15-19,1858,0.1186206782828918
STAT,1927,12,na,1939,4654.05223724093
STAT,1810,45,45-49,1855,0.8139390837186543
STAT,1924,16,25-29,1940,48.869527066651905
STAT,1825,42,25-29,1867,0.6992050766622944
STAT,1839,24,25-29,1863,48.27129175403632
SIM,1897,17,20-24,1914,21
SIM,1807,48,50-100,1855,3
STAT,1908,20,25-29,1928,80.70221580748081
STAT,1834,32,25-29,1866,8.14225369371344
SIM,1893,19,na,1912,3146
STAT,1858,37,40-44,1895,3.2423352340829292
STAT,1822,46,na,1868,1341.3791702876092
SIM,1875,22,na,1897,2305
SIM,1868,12,na,1880,2398
SIM,1880,52,na,1932,2163
SIM,1797,74,na,1871,393
SIM,1959,10,na,1969,4878
STAT,1889,28,30-34,1917,29.265135878985927
SIM,1899,28,35-39,1927,16
STAT,1901,19,na,1920,3321.8044505038624
STAT,1947,24,25-29,1971,98.55699462004053
STAT,1871,39,25-29,1910,2.6737118095458627
SIM,1897,28,30-34,1925,32
SIM,1809,47,50-100,1856,2
STAT,1845,21,45-49,1866,0.6170100796450586
STAT,1908,31,35-39,1939,8.182344315275285
STAT,1913,44,na,1957,3410.2008811232326
SIM,1817,68,na,1885,800
SIM,1847,26,20-24,1873,9
STAT,1919,34,15-19,1953,0.12985256716787802
STAT,1911,3,na,1914,3821.955147508947
SIM,1842,32,25-29,1874,10
SIM,1932,16,25-29,1948,66
STAT,1835,96,na,1931,5.465201274150812
SIM,1931,20,20-24,1951,125
STAT,1906,34,na,1940,3282.9136423747304
SIM,1819,94,na,1913,4
SIM,1898,32,30-34,1930,32
STAT,1908,39,45-49,1947,0.5969174918936409
STAT,1923,37,45-49,1960,0.7462036916784612
SIM,1836,23,40-44,1859,3
STAT,1900,18,35-39,1918,0.7172017796461628
STAT,1849,47,50-100,1896,0.1833089824143458
STAT,1893,50,na,1943,2616.695435576589
STAT,1815,39,40-44,1854,13.420817971350226
STAT,1895,17,45-49,1912,0.08045111210271712
STAT,1906,20,20-24,1926,95.38269473165109
STAT,1921,26,25-29,1947,69.53744570744819
SIM,1932,4,na,1936,4999
STAT,1851,46,45-49,1897,0.1702469326556103
STAT,1905,7,na,1912,3557.599261180571
SIM,1883,47,50-100,1930,2
SIM,1837,19,15-19,1856,4
SIM,1883,30,20-24,1913,2
STAT,1846,96,na,1942,6.36875658065902
SIM,1905,37,na,1942,3204
SIM,1867,27,na,1894,2285
STAT,1920,14,na,1934,4185.943901829059
STAT,1851,100,na,1951,0.7636868843267983
STAT,1887,15,15-19,1902,6.30008235782785
STAT,1918,24,50-100,1942,0.6662272088018898
STAT,1853,43,45-49,1896,1.1244694712922148
STAT,1874,17,30-34,1891,1.5384400873953819
STAT,1865,2,na,1867,2903.891594785142
STAT,1875,24,35-39,1899,5.630864515064378
STAT,1850,16,30-34,1866,1.3811020175703932
STAT,1932,6,na,1938,5013.70965662656
SIM,1895,15,15-19,1910,5
STAT,1875,47,50-100,1922,0.23736939156107786
STAT,1845,38,15-19,1883,0.04131958220702851
STAT,1875,30,20-24,1905,2.6458074905603435
SIM,1836,26,45-49,1862,1
SIM,1910,26,20-24,1936,17
STAT,1917,23,30-34,1940,28.768354395285588
STAT,1910,20,40-44,1930,3.0008282757338534
SIM,1907,41,40-44,1948,2
SIM,1836,66,na,1902,1053
SIM,1914,20,20-24,1934,103
STAT,1916,44,45-49,1960,0.16058454984546924
SIM,1859,7,na,1866,2320
SIM,1882,17,30-34,1899,1
SIM,1862,39,25-29,1901,2
STAT,1902,26,20-24,1928,15.694414556358462
STAT,1923,23,25-29,1946,101.21682802666065
STAT,1847,46,25-29,1893,0.0425952501926728
STAT,1939,15,30-34,1954,11.554419646616042
SIM,1879,12,na,1891,2584
SIM,1851,26,40-44,1877,4
STAT,1828,26,45-49,1854,2.6796287653031334
SIM,1797,58,na,1855,991
SIM,1879,32,20-24,1911,2
SIM,1910,15,35-39,1925,2
STAT,1826,29,45-49,1855,2.211023045714964
STAT,1764,99,na,1863,0.21736255902877247
SIM,1831,35,na,1866,1637
STAT,1838,21,na,1859,1875.791162556354
STAT,1862,49,25-29,1911,0.04555318929226664
STAT,1864,53,na,1917,1783.798282318638
SIM,1839,15,na,1854,2065
SIM,1888,27,20-24,1915,12
STAT,1806,99,na,1905,0.656761755367753
SIM,1923,24,35-39,1947,12
STAT,1862,38,15-19,1900,0.04513210921668784
SIM,1917,49,50-100,1966,2
STAT,1931,33,30-34,1964,19.490231755293646
SIM,1912,31,na,1943,3483
STAT,1894,30,25-29,1924,12.534982823977636
STAT,1823,71,na,1894,714.3601240636568
SIM,1947,15,30-34,1962,14
SIM,1894,20,25-29,1914,79
SIM,1925,23,30-34,1948,41
SIM,1888,38,30-34,1926,9
STAT,1886,46,50-100,1932,0.24578263836820546
SIM,1884,82,na,1966,733
STAT,1902,18,45-49,1920,0.08686184124631183
STAT,1886,39,15-19,1925,0.05547323095117864
STAT,1930,32,na,1962,4610.847407424785
SIM,1939,2,na,1941,3791
STAT,1921,35,15-19,1956,0.020291241271881474
SIM,1904,18,15-19,1922,7
SIM,1906,26,25-29,1932,54
SIM,1902,16,15-19,1918,8
STAT,1885,71,na,1956,1285.8802401698595
SIM,1878,19,30-34,1897,4
STAT,1888,47,25-29,1935,0.0640076121944039
SIM,1838,31,20-24,1869,1
STAT,1883,40,20-24,1923,0.14857899222430548
STAT,1901,59,na,1960,2673.587149264089
SIM,1860,2,na,1862,2756
STAT,1841,29,40-44,1870,2.5283481097088845
STAT,1878,17,45-49,1895,0.06431135175318833
STAT,1928,44,50-100,1972,0.14100811600078694
STAT,1842,42,30-34,1884,0.8613833433195829
STAT,1937,4,na,1941,3709.402035491373
SIM,1847,10,na,1857,2243
STAT,1897,22,20-24,1919,87.06283062303469
SIM,1821,34,50-100,1855,3
STAT,1913,16,25-29,1929,8.391079641216066
SIM,1921,16,25-29,1937,49
STAT,1814,94,na,1908,9.186121468530297
STAT,1891,17,30-34,1908,1.862884700676249
STAT,1881,49,35-39,1930,0.12509727638486584
STAT,1896,6,na,1902,3259.400167276646
SIM,1916,34,45-49,1950,2
STAT,1843,26,40-44,1869,2.5080939034247427
STAT,1847,81,na,1928,398.7636621903031
STAT,1825,45,35-39,1870,0.1468234058221748
STAT,1908,36,50-100,1944,0.37315282945740386
SIM,1850,14,na,1864,2217
SIM,1947,24,20-24,1971,120
STAT,1833,42,50-100,1875,0.7854258311163043
STAT,1841,41,na,1882,1677.0874417467219
STAT,1872,88,na,1960,210.0217843816185
STAT,1949,2,na,1951,4407.501853145194
SIM,1802,78,na,1880,292
SIM,1901,22,30-34,1923,21
STAT,1827,53,45-49,1880,0.012564409498905511
STAT,1893,10,na,1903,3103.2821912836116
STAT,1928,24,45-49,1952,1.3187978489516732
STAT,1827,42,35-39,1869,1.7370889058674068
SIM,1843,60,na,1903,1358
STAT,1819,48,15-19,1867,7.465648911188472E-4
STAT,1943,27,15-19,1970,0.7102638814621856
SIM,1909,11,na,1920,3675
STAT,1918,41,45-49,1959,0.16740757144752097
SIM,1857,34,35-39,1891,8
STAT,1868,40,25-29,1908,0.5846435116119781
SIM,1832,22,15-19,1854,5
STAT,1927,44,20-24,1971,0.02085374150939138
STAT,1939,24,20-24,1963,105.42388452085751
STAT,1905,43,30-34,1948,0.10822718511860546
STAT,1776,84,na,1860,96.88868556294031
SIM,1918,31,45-49,1949,2
STAT,1757,104,na,1861,0.03538286778140945
STAT,1875,53,na,1928,2057.1880682879028
SIM,1853,19,na,1872,2069
STAT,1859,17,35-39,1876,0.4789064003473056
SIM,1905,44,40-44,1949,1
SIM,1832,26,30-34,1858,22
STAT,1854,16,45-49,1870,0.05624018490471557
STAT,1900,43,50-100,1943,0.09544696861193906
STAT,1849,34,35-39,1883,7.837671388963361
STAT,1832,35,25-29,1867,2.248601197213476
STAT,1873,16,50-100,1889,0.04721794162626371
STAT,1917,34,na,1951,3709.3811007748745
SIM,1835,42,35-39,1877,1
SIM,1882,16,na,1898,2406
SIM,1938,24,na,1962,3261
STAT,1840,43,na,1883,1562.0694338716667
STAT,1920,42,15-19,1962,0.0016022495332051183
STAT,1834,71,na,1905,827.536226353115
SIM,1863,40,45-49,1903,5
STAT,1822,102,na,1924,0.14897323036593857
SIM,1855,45,na,1900,1834
STAT,1921,29,35-39,1950,15.694225993872918
SIM,1905,33,25-29,1938,9
STAT,1902,26,15-19,1928,0.6069663136761089
SIM,1931,34,40-44,1965,5
STAT,1848,19,25-29,1867,5.158488068585716
STAT,1908,34,45-49,1942,1.391204136791568
SIM,1796,89,na,1885,30
STAT,1862,49,30-34,1911,0.07655466607621537
STAT,1816,52,30-34,1868,0.013461184540419887
STAT,1846,50,45-49,1896,0.010918594696600588
STAT,1843,91,na,1934,39.14066154782792
STAT,1852,19,45-49,1871,0.056604864405847916
STAT,1914,45,25-29,1959,0.04993385786645287
STAT,1869,24,35-39,1893,5.30713689782093
SIM,1864,21,20-24,1885,50
SIM,1914,36,30-34,1950,3
SIM,1861,43,45-49,1904,3
SIM,1864,22,na,1886,2091
SIM,1866,37,40-44,1903,2
STAT,1909,27,15-19,1936,0.6373865154191058
STAT,1904,23,15-19,1927,4.4565501981941
SIM,1860,91,na,1951,46
SIM,1856,19,25-29,1875,10
STAT,1882,16,20-24,1898,16.327476492650614
SIM,1864,81,na,1945,429
SIM,1858,24,30-34,1882,17
STAT,1923,34,40-44,1957,4.23261714311443
SIM,1840,35,25-29,1875,2
STAT,1837,29,20-24,1866,9.632472715708875
SIM,1849,21,25-29,1870,63
SIM,1867,70,na,1937,1312
STAT,1875,49,40-44,1924,0.1627667951874185
STAT,1938,31,20-24,1969,2.3183260604169353
STAT,1905,49,na,1954,3008.560190631286
STAT,1933,18,50-100,1951,0.47255096411525466
SIM,1877,27,45-49,1904,4
SIM,1837,19,20-24,1856,15
STAT,1845,74,na,1919,785.3184013109569
STAT,1892,36,35-39,1928,8.40931717202419
STAT,1872,35,50-100,1907,1.1744298916241254
STAT,1912,22,40-44,1934,3.0442372049976743
SIM,1887,47,na,1934,2326
SIM,1806,68,na,1874,751
SIM,1920,22,40-44,1942,4
STAT,1925,47,20-24,1972,0.01265034417698277
STAT,1782,102,na,1884,0.073275894486712
STAT,1915,24,35-39,1939,9.13745070549532
STAT,1948,17,25-29,1965,46.852052907887334
STAT,1826,36,na,1862,1564.9776723438085
STAT,1871,28,15-19,1899,0.42410765256417954
STAT,1864,51,50-100,1915,0.012776930572953779
STAT,1906,36,30-34,1942,1.5903785971100297
STAT,1910,55,na,1965,3136.5556320899686
STAT,1938,32,50-100,1970,0.7853783931384916
STAT,1892,47,45-49,1939,0.15678424532103036
SIM,1892,27,40-44,1919,11
SIM,1847,50,na,1897,1634
SIM,1873,27,30-34,1900,34
STAT,1912,33,20-24,1945,2.2578896395731003
STAT,1858,34,30-34,1892,12.821369827637279
SIM,1872,57,na,1929,1859
STAT,1920,42,45-49,1962,0.17364378096993935
STAT,1934,24,45-49,1958,1.427496389458493
SIM,1931,8,na,1939,4912
SIM,1845,29,20-24,1874,13
STAT,1868,54,45-49,1922,0.012720940711696336
STAT,1878,45,na,1923,2237.097334071184
STAT,1949,21,25-29,1970,101.85970438301526
STAT,1834,48,40-44,1882,0.11124247827917928
STAT,1922,22,50-100,1944,0.7128382659141549
STAT,1886,20,25-29,1906,57.46683683170551
STAT,1901,31,25-29,1932,13.599574514111163
STAT,1840,45,30-34,1885,0.06572330488474702
STAT,1863,68,na,1931,1266.9021921690264
STAT,1845,49,25-29,1894,0.03990839522973526
STAT,1942,30,50-100,1972,0.8329670359506364
SIM,1966,1,na,1967,4466
STAT,1941,19,35-39,1960,4.08032362042436
SIM,1898,10,na,1908,3259
STAT,1889,61,na,1950,2179.305323774556
SIM,1911,30,45-49,1941,1
STAT,1919,39,20-24,1958,0.266966128693434
SIM,1818,53,na,1871,1206
SIM,1936,27,25-29,1963,53
STAT,1868,43,35-39,1911,1.6203723424977918
SIM,1825,36,40-44,1861,4
STAT,1858,23,20-24,1881,52.910354519773435
SIM,1922,49,na,1971,3944
STAT,1902,15,35-39,1917,0.7349551962681409
STAT,1874,31,na,1905,2312.736106851517
STAT,1892,65,na,1957,2048.497390925356
SIM,1898,35,35-39,1933,20
SIM,1931,23,25-29,1954,121
SIM,1822,47,50-100,1869,1
STAT,1917,37,15-19,1954,0.018842975668979203
SIM,1869,53,na,1922,1933
STAT,1926,30,na,1956,4325.005036857522
STAT,1925,36,40-44,1961,1.6988468066230396
STAT,1873,36,25-29,1909,2.771877775158541
SIM,1929,28,na,1957,4378
STAT,1855,33,na,1888,1708.8138242133095
STAT,1784,95,na,1879,2.353693904328612
STAT,1839,27,50-100,1866,0.5365460041810225
SIM,1835,25,na,1860,1778
STAT,1860,63,na,1923,1367.6864695330328
STAT,1834,23,35-39,1857,4.808637544829419
SIM,1820,42,45-49,1862,2
STAT,1781,90,na,1871,28.556575771800716
STAT,1844,38,50-100,1882,0.8917576940296674
SIM,1866,23,20-24,1889,61
STAT,1939,18,40-44,1957,1.3222328648971933
STAT,1856,21,20-24,1877,59.41895626368129
STAT,1928,27,25-29,1955,76.60322482494422
STAT,1839,33,15-19,1872,0.11547521582615872
STAT,1857,36,50-100,1893,0.9191459505546984
SIM,1903,20,45-49,1923,1
SIM,1851,71,na,1922,966
SIM,1920,33,20-24,1953,3
SIM,1938,21,15-19,1959,5
STAT,1903,30,45-49,1933,2.36280362904995
SIM,1855,85,na,1940,181
SIM,1912,23,20-24,1935,2
STAT,1859,35,50-100,1894,0.9318952066151793
STAT,1851,35,35-39,1886,5.250251231625135
STAT,1869,24,40-44,1893,1.8951412123671099
STAT,1857,53,30-34,1910,0.004363803549454982
STAT,1904,23,20-24,1927,93.09177068921397
SIM,1926,23,na,1949,4117
STAT,1876,19,na,1895,2451.784393735199
SIM,1947,18,40-44,1965,1
STAT,1812,42,45-49,1854,5.718208240882184
SIM,1852,38,50-100,1890,1
STAT,1821,45,20-24,1866,0.01949095746669407
STAT,1875,30,15-19,1905,0.13939145461801458
STAT,1884,27,40-44,1911,2.79582184490206
SIM,1933,36,40-44,1969,3
STAT,1875,93,na,1968,105.03063263298857
SIM,1927,24,na,1951,4162
STAT,1853,40,40-44,1893,1.7194194969905516
STAT,1938,31,15-19,1969,0.12213845602649209
STAT,1939,18,35-39,1957,3.9666983650244623
STAT,1897,37,25-29,1934,3.6375269851585466
SIM,1844,31,45-49,1875,1
STAT,1830,32,50-100,1862,0.7859139079164872
STAT,1854,32,na,1886,1748.4497739076292
SIM,1788,78,na,1866,310
SIM,1911,32,40-44,1943,4
STAT,1826,102,na,1928,0.16009784642102498
STAT,1928,34,na,1962,4461.633639178019
SIM,1874,80,na,1954,514
SIM,1919,24,45-49,1943,1
STAT,1865,94,na,1959,28.84917321433045
SIM,1870,23,40-44,1893,1
STAT,1847,23,45-49,1870,0.6258452306074923
SIM,1796,73,na,1869,469
STAT,1850,19,35-39,1869,0.4671093269312858
STAT,1889,19,40-44,1908,0.21216763501369165
STAT,1910,22,30-34,1932,25.49877454577492
STAT,1955,11,na,1966,4926.4460900731365
SIM,1900,62,na,1962,2580
SIM,1894,32,50-100,1926,6
STAT,1831,52,20-24,1883,4.624357181442833E-4
STAT,1825,30,30-34,1855,38.459181210775974
SIM,1872,17,na,1889,2417
STAT,1842,39,50-100,1881,0.9296156670164603
STAT,1862,20,50-100,1882,0.3420770963153298
SIM,1921,47,50-100,1968,2
STAT,1839,21,15-19,1860,2.8426320472492836
STAT,1888,32,20-24,1920,3.0178251119429707
SIM,1842,23,35-39,1865,4
SIM,1947,18,35-39,1965,5
SIM,1873,23,15-19,1896,3
SIM,1847,21,15-19,1868,1
SIM,1896,32,20-24,1928,3
STAT,1828,31,50-100,1859,0.986800513751244
STAT,1834,35,35-39,1869,5.574454365014646
STAT,1838,40,45-49,1878,1.2055813398083832
STAT,1845,55,na,1900,1463.1737525578158
STAT,1862,23,40-44,1885,1.7106313128954156
STAT,1946,21,50-100,1967,0.6919627293740017
STAT,1834,46,45-49,1880,0.17288820885549816
STAT,1936,34,15-19,1970,0.11775967458695026
SIM,1847,29,25-29,1876,47
STAT,1928,28,30-34,1956,45.57976448182112
STAT,1940,23,25-29,1963,88.86255412253233
SIM,1915,39,na,1954,3399
STAT,1811,46,na,1857,1322.3142716967586
SIM,1827,89,na,1916,67
STAT,1932,27,45-49,1959,2.137645507285174
SIM,1837,18,30-34,1855,2
STAT,1899,35,30-34,1934,6.964136826643699
SIM,1872,20,40-44,1892,5
STAT,1876,53,35-39,1929,0.008267572203795932
STAT,1868,42,50-100,1910,0.9510522337370069
SIM,1842,35,35-39,1877,12
STAT,1880,40,na,1920,2325.070691186922
SIM,1808,94,na,1902,7
SIM,1854,19,15-19,1873,7
STAT,1846,19,15-19,1865,5.464453196131696
STAT,1816,52,25-29,1868,0.008009960971646038
STAT,1874,68,na,1942,1475.0520346039775
STAT,1820,82,na,1902,245.799209080828
STAT,1895,17,na,1912,3110.5332243246316
SIM,1889,42,30-34,1931,1
STAT,1814,44,15-19,1858,0.04447551733731426
STAT,1899,24,20-24,1923,88.64210647521749
SIM,1889,57,na,1946,2391
STAT,1948,15,50-100,1963,0.4052756621277683
SIM,1885,43,na,1928,2199
STAT,1864,20,40-44,1884,1.808600451122322
STAT,1832,39,40-44,1871,3.2740127612690917
STAT,1917,37,20-24,1954,0.2586626334576022
STAT,1947,16,na,1963,3918.148190185956
STAT,1931,40,25-29,1971,0.09036996625300195
SIM,1840,39,40-44,1879,8
STAT,1903,27,50-100,1930,0.8598439641122215
SIM,1855,31,20-24,1886,2
STAT,1883,43,25-29,1926,0.5904779109869561
SIM,1902,19,25-29,1921,7
SIM,1871,32,na,1903,2277
STAT,1891,30,50-100,1921,1.0794985815424671
STAT,1910,39,25-29,1949,0.8806683283883201
STAT,1827,50,40-44,1877,0.009673298221767525
SIM,1846,40,45-49,1886,4
STAT,1841,25,25-29,1866,36.74778496040285
STAT,1904,35,15-19,1939,0.016579898787203923
SIM,1818,41,45-49,1859,3
STAT,1890,36,30-34,1926,6.185106819176235
SIM,1862,29,20-24,1891,9
SIM,1883,24,35-39,1907,7
STAT,1855,73,na,1928,844.0487261299834
SIM,1873,58,na,1931,1938
STAT,1866,38,50-100,1904,1.064452442292701
SIM,1826,43,50-100,1869,1
SIM,1906,62,na,1968,2734
SIM,1836,63,na,1899,1119
STAT,1919,34,20-24,1953,2.4647486162100805
STAT,1823,45,30-34,1868,0.12269664279618489
STAT,1886,56,na,1942,2035.3719766380163
STAT,1892,21,30-34,1913,21.14002105446738
STAT,1931,17,na,1948,4551.221622301357
STAT,1854,29,20-24,1883,8.673406150046636
SIM,1863,37,na,1900,1962
STAT,1886,47,20-24,1933,0.011919097421413677
SIM,1904,17,30-34,1921,3
STAT,1876,35,na,1911,2321.283131011057
STAT,1899,22,25-29,1921,74.09887345929025
STAT,1894,41,40-44,1935,2.743088045184508
STAT,1954,18,30-34,1972,14.229178878522386
STAT,1825,51,na,1876,1293.3786867212775
STAT,1830,81,na,1911,326.376153843745
SIM,1873,19,25-29,1892,7
STAT,1843,29,45-49,1872,0.9097421506619632
STAT,1905,65,na,1970,2623.4718444984587
STAT,1928,2,na,1930,4868.1927983278
STAT,1843,23,30-34,1866,14.993248301064186
STAT,1922,43,30-34,1965,0.13840642692544533
STAT,1875,47,45-49,1922,0.22809110952938352
STAT,1829,65,na,1894,1021.1354413479481
SIM,1895,42,na,1937,2952
STAT,1764,100,na,1864,0.13306501138623392
STAT,1845,20,30-34,1865,15.874798823326852
STAT,1865,23,15-19,1888,2.8386521353304572
SIM,1940,0,na,1940,3915
SIM,1923,2,na,1925,4567
STAT,1872,53,20-24,1925,6.880086496428922E-4
SIM,1927,34,20-24,1961,2
STAT,1901,2,na,1903,3524.913666398363
SIM,1895,8,na,1903,3301
SIM,1833,30,30-34,1863,17
SIM,1848,51,na,1899,1546
STAT,1877,32,45-49,1909,1.7088317906407322
STAT,1943,26,na,1969,3770.723121649033
SIM,1885,32,45-49,1917,1
STAT,1797,62,na,1859,901.7134913753424
STAT,1950,0,na,1950,4921.07076604938
SIM,1841,34,na,1875,1676
STAT,1902,15,40-44,1917,0.24498507960705748
SIM,1851,23,30-34,1874,15
STAT,1835,52,35-39,1887,0.005584074884971275
STAT,1910,39,na,1949,3365.0469210988485
SIM,1923,31,na,1954,4182
STAT,1875,36,35-39,1911,6.900966151893193
STAT,1910,20,35-39,1930,8.403493292343903
STAT,1894,21,50-100,1915,0.4965724105590978
SIM,1883,36,35-39,1919,9
SIM,1866,36,35-39,1902,8
STAT,1882,23,20-24,1905,63.11533600177686
STAT,1865,19,25-29,1884,4.941404351347884
STAT,1879,41,45-49,1920,1.4866839470987399
STAT,1912,48,25-29,1960,0.0480274094774054
SIM,1933,33,30-34,1966,30
SIM,1897,37,50-100,1934,1
STAT,1901,33,45-49,1934,2.296198024577685
STAT,1930,25,15-19,1955,0.8487262793958887
SIM,1922,30,20-24,1952,1
SIM,1937,23,na,1960,3283
SIM,1914,39,35-39,1953,2
SIM,1896,24,45-49,1920,4
STAT,1898,41,na,1939,2978.3541935628455
STAT,1894,30,30-34,1924,21.367344739425914
SIM,1837,88,na,1925,63
SIM,1848,41,30-34,1889,4
STAT,1837,33,50-100,1870,0.7378643016009797
SIM,1928,18,25-29,1946,52
SIM,1942,13,na,1955,3804
STAT,1906,37,45-49,1943,0.5920192010886826
STAT,1878,42,na,1920,2272.6616883588977
SIM,1869,29,30-34,1898,31
STAT,1877,34,40-44,1911,4.213314542973816
SIM,1907,30,25-29,1937,7
STAT,1817,56,na,1873,1148.1230090137124
STAT,1890,46,50-100,1936,0.1604619310923646
STAT,1910,28,45-49,1938,1.5705036142593018
STAT,1844,33,na,1877,1781.3838512103814
SIM,1823,32,20-24,1855,2
SIM,1861,33,na,1894,2047
STAT,1888,24,45-49,1912,0.7736497337728605
SIM,1836,23,35-39,1859,4
STAT,1906,39,35-39,1945,2.079352693889792
SIM,1915,36,na,1951,3453
STAT,1871,22,50-100,1893,0.38253688671581293
STAT,1770,90,na,1860,20.791650301920523
SIM,1885,34,40-44,1919,10
STAT,1906,20,15-19,1926,4.566222813934276
STAT,1844,92,na,1936,28.926504421667055
STAT,1790,67,na,1857,682.2514445553521
SIM,1926,43,40-44,1969,3
STAT,1822,86,na,1908,112.74362776296398
STAT,1862,21,45-49,1883,0.5807518583977652
STAT,1864,46,30-34,1910,0.08173427041285933
STAT,1918,35,na,1953,3781.7504626188993
STAT,1787,84,na,1871,103.4733725806678
STAT,1810,50,50-100,1860,0.05014363929272689
STAT,1857,43,na,1900,1709.575140298013
STAT,1866,36,na,1902,2062.693435986664
SIM,1841,93,na,1934,16
STAT,1879,83,na,1962,593.8741621249345
STAT,1862,43,na,1905,1853.3456206354892
STAT,1915,17,40-44,1932,0.2765586964919935
SIM,1829,33,45-49,1862,1
SIM,1923,17,40-44,1940,2
SIM,1852,96,na,1948,5
SIM,1887,41,45-49,1928,1
STAT,1873,24,25-29,1897,54.504491836065185
STAT,1925,33,30-34,1958,17.66300476505807
STAT,1880,19,20-24,1899,17.56177448394853
STAT,1884,24,30-34,1908,16.520500132191643
SIM,1890,7,na,1897,3252
SIM,1938,24,25-29,1962,90
SIM,1883,57,na,1940,1824
SIM,1881,21,20-24,1902,43
SIM,1914,20,15-19,1934,5
STAT,1917,38,50-100,1955,0.409932515422078
SIM,1919,24,15-19,1943,4
SIM,1940,27,45-49,1967,2
STAT,1881,25,na,1906,2192.7325947217596
SIM,1828,52,na,1880,1365
SIM,1844,33,40-44,1877,8
STAT,1845,46,20-24,1891,0.008515655482133297
SIM,1933,31,35-39,1964,14
SIM,1908,23,30-34,1931,39
STAT,1866,57,na,1923,1751.0343331630947
SIM,1825,33,30-34,1858,27
STAT,1916,43,30-34,1959,0.12357185642959967
SIM,1807,53,na,1860,1148
STAT,1941,16,30-34,1957,11.86363572542106
STAT,1868,40,30-34,1908,1.0467004761840364
SIM,1825,39,45-49,1864,3
STAT,1845,58,na,1903,1399.4050120385502
SIM,1803,79,na,1882,259
SIM,1925,38,na,1963,4219
SIM,1870,21,45-49,1891,2
SIM,1855,34,25-29,1889,8
SIM,1890,14,na,1904,3222
STAT,1806,49,40-44,1855,0.6114353243070612
STAT,1862,47,50-100,1909,0.19745083415778436
STAT,1847,34,25-29,1881,7.904150874632042
STAT,1836,31,45-49,1867,1.4422865917237624
STAT,1914,30,20-24,1944,2.338176316144035
SIM,1860,27,50-100,1887,1
SIM,1786,71,na,1857,543
STAT,1867,98,na,1965,11.218643190248969
STAT,1817,39,45-49,1856,5.87832766925127
STAT,1833,30,na,1863,1747.6017335774948
STAT,1919,46,15-19,1965,3.783895654826258E-4
STAT,1867,27,40-44,1894,2.6572989984500763
STAT,1916,49,na,1965,3538.8686817894377
SIM,1834,22,25-29,1856,47
SIM,1823,39,40-44,1862,4
SIM,1869,18,20-24,1887,15
SIM,1890,23,20-24,1913,71
STAT,1868,51,40-44,1919,0.009534415184773517
SIM,1840,20,20-24,1860,56
STAT,1921,26,30-34,1947,41.39541770015619
STAT,1890,20,45-49,1910,0.8101879509377024
STAT,1914,49,40-44,1963,0.14685342927283931
SIM,1803,60,na,1863,955
STAT,1842,42,25-29,1884,0.48113304057949147
STAT,1850,51,25-29,1901,0.002508794179524582
STAT,1935,15,50-100,1950,0.4860961647766812
SIM,1874,83,na,1957,367
STAT,1925,20,25-29,1945,105.07093388956237
STAT,1851,20,30-34,1871,15.523506124843566
STAT,1829,25,na,1854,1600.1548128535803
SIM,1859,35,na,1894,1905
STAT,1846,42,50-100,1888,0.7930604040532777
SIM,1877,24,35-39,1901,8
STAT,1836,33,40-44,1869,3.513105640251717
STAT,1901,45,45-49,1946,0.17778997053190662
STAT,1917,50,na,1967,3592.4417573489436
SIM,1888,72,na,1960,1552
STAT,1856,36,25-29,1892,2.1324065450407605
SIM,1868,31,30-34,1899,15
SIM,1933,20,25-29,1953,119
SIM,1876,40,30-34,1916,1
STAT,1945,24,20-24,1969,115.04939761320531
SIM,1874,21,na,1895,2237
SIM,1934,16,35-39,1950,6
STAT,1892,17,50-100,1909,0.05796965581619646
STAT,1928,29,15-19,1957,0.8207922554844523
STAT,1869,68,na,1937,1398.590271670017
STAT,1768,89,na,1857,23.852897116064995
SIM,1904,36,na,1940,3305
SIM,1864,36,25-29,1900,3
SIM,1901,47,na,1948,2992
STAT,1865,54,na,1919,1792.9845614929968
SIM,1948,23,na,1971,3950
STAT,1868,43,na,1911,2068.1690335424973
STAT,1849,44,30-34,1893,0.8504626978865742
SIM,1916,36,40-44,1952,1
STAT,1914,49,50-100,1963,0.2106729100646556
STAT,1915,26,30-34,1941,37.885388821001214
STAT,1892,33,25-29,1925,12.068420214324778
STAT,1928,24,20-24,1952,130.3296101556405
SIM,1894,22,45-49,1916,1
SIM,1922,3,na,1925,4389
STAT,1814,52,20-24,1866,0.002155879435395973
STAT,1915,8,na,1923,3930.645695484529
STAT,1789,105,na,1894,0.006478604380814644
SIM,1827,31,45-49,1858,2
STAT,1925,39,45-49,1964,0.7712944366013367
STAT,1847,20,40-44,1867,1.9110857306096514
STAT,1877,20,na,1897,2331.421159577024
SIM,1853,81,na,1934,369
SIM,1862,55,na,1917,1780
STAT,1920,25,50-100,1945,1.0384760851103318
STAT,1874,53,30-34,1927,0.0056532892631837766
STAT,1925,31,35-39,1956,10.257282739188156
STAT,1841,81,na,1922,372.8094980205443
SIM,1903,11,na,1914,3480
SIM,1945,18,30-34,1963,20
STAT,1864,23,45-49,1887,0.5922831970747741
SIM,1889,48,50-100,1937,1
STAT,1926,16,35-39,1942,4.87195078549793
SIM,1813,78,na,1891,302
STAT,1855,40,45-49,1895,1.0742840664069246
STAT,1881,43,20-24,1924,0.14388683576449496
STAT,1932,29,35-39,1961,18.558512035773244
SIM,1913,32,na,1945,3435
SIM,1840,71,na,1911,825
STAT,1875,3,na,1878,2993.1946795954004
SIM,1917,46,na,1963,3605
SIM,1901,20,35-39,1921,9
STAT,1854,91,na,1945,41.46079503640789
SIM,1872,23,45-49,1895,1
SIM,1866,34,30-34,1900,22
SIM,1885,83,na,1968,632
SIM,1859,44,40-44,1903,6
STAT,1783,104,na,1887,0.02863362952708652
SIM,1840,55,na,1895,1354
SIM,1940,29,35-39,1969,21
STAT,1855,17,na,1872,1940.1527090812672
STAT,1940,20,20-24,1960,107.08228127261815
SIM,1856,23,15-19,1879,2
STAT,1929,30,50-100,1959,0.993214926024867
SIM,1870,47,50-100,1917,3
SIM,1937,30,50-100,1967,1
STAT,1821,103,na,1924,0.07645993863565233
STAT,1875,23,20-24,1898,66.70827521697169
SIM,1774,86,na,1860,52
SIM,1842,20,30-34,1862,17
SIM,1853,59,na,1912,1477
STAT,1886,22,45-49,1908,0.6958644427505228
STAT,1841,22,20-24,1863,60.18456384620444
SIM,1894,57,na,1951,2526
SIM,1936,24,20-24,1960,76
STAT,1906,10,na,1916,3564.0394109675753
SIM,1897,49,na,1946,2874
STAT,1922,46,35-39,1968,0.14027210969055082
STAT,1873,53,50-100,1926,0.014237828865120174
STAT,1848,23,15-19,1871,2.963358614473896
STAT,1825,33,35-39,1858,16.0720285252001
SIM,1913,19,30-34,1932,3
SIM,1833,33,35-39,1866,9
STAT,1952,17,15-19,1969,51.37742371463852
STAT,1866,43,25-29,1909,0.555483229057062
STAT,1818,52,35-39,1870,0.017621499173870042
SIM,1783,82,na,1865,124
STAT,1929,41,20-24,1970,0.021636267577285637
SIM,1872,30,45-49,1902,2
SIM,1872,73,na,1945,1047
SIM,1883,21,30-34,1904,17
SIM,1849,37,40-44,1886,8
STAT,1831,66,na,1897,956.9944278016402
SIM,1787,96,na,1883,1
STAT,1905,31,50-100,1936,0.7213336635116363
SIM,1835,22,na,1857,1752
STAT,1918,43,40-44,1961,0.2508348364302849
SIM,1903,36,30-34,1939,2
SIM,1852,40,na,1892,1786
STAT,1818,41,na,1859,1468.0460151814823
STAT,1844,50,40-44,1894,0.007416774167267384
STAT,1899,46,50-100,1945,0.17983420081151674
SIM,1849,33,25-29,1882,20
STAT,1885,43,35-39,1928,1.6928235942975491
SIM,1850,70,na,1920,1017
SIM,1876,87,na,1963,297
STAT,1816,74,na,1890,517.1633483280049
STAT,1853,69,na,1922,1110.6311531654194
SIM,1901,28,45-49,1929,2
STAT,1905,19,30-34,1924,2.1647480987645484
SIM,1812,53,na,1865,1173
SIM,1923,26,30-34,1949,41
SIM,1916,21,na,1937,3540
SIM,1818,43,40-44,1861,8
STAT,1951,21,35-39,1972,10.63097601499887
STAT,1866,31,30-34,1897,15.2751940332009
STAT,1888,35,25-29,1923,3.245002806092302
STAT,1921,23,15-19,1944,5.6623630738218225
SIM,1861,40,40-44,1901,4
STAT,1849,46,35-39,1895,0.1052795825475411
STAT,1825,53,50-100,1878,0.014555094156173915
STAT,1864,9,na,1873,2331.9109318671417
STAT,1937,18,30-34,1955,11.172590428320285
SIM,1839,16,15-19,1855,5
STAT,1829,50,45-49,1879,0.011921431558759701
SIM,1863,40,na,1903,1938
STAT,1921,28,20-24,1949,19.151212460269377
STAT,1783,101,na,1884,0.11634820507811888
STAT,1821,45,na,1866,1419.7857939788164
SIM,1861,44,35-39,1905,3
SIM,1930,28,na,1958,4490
SIM,1874,43,na,1917,2160
SIM,1883,17,na,1900,2352
STAT,1833,52,30-34,1885,0.003763988533101803
STAT,1835,36,50-100,1871,0.9761422553995466
STAT,1907,35,na,1942,3326.548536624213
SIM,1845,40,na,1885,1674
STAT,1921,39,30-34,1960,1.918400064940572
STAT,1897,34,20-24,1931,3.3857589524060034
SIM,1833,53,50-100,1886,1
STAT,1789,70,na,1859,582.5997876833503
SIM,1843,36,50-100,1879,3
SIM,1896,35,25-29,1931,4
SIM,1816,67,na,1883,809
STAT,1828,62,na,1890,1029.3420609159027
SIM,1837,29,na,1866,1756
SIM,1927,37,25-29,1964,3
SIM,1922,33,25-29,1955,15
SIM,1914,34,40-44,1948,9
SIM,1836,20,30-34,1856,20
STAT,1772,108,na,1880,0.004368302437396349
STAT,1845,23,35-39,1868,5.089519498074906
SIM,1859,91,na,1950,35
SIM,1838,92,na,1930,20
STAT,1858,21,25-29,1879,49.000722008320984
STAT,1908,47,20-24,1955,0.009441799249353832
STAT,1780,89,na,1869,29.601229257023256
SIM,1818,93,na,1911,18
STAT,1879,17,50-100,1896,0.04844675562909554
SIM,1786,74,na,1860,398
STAT,1882,26,25-29,1908,38.99633270840982
SIM,1832,29,35-39,1861,8
STAT,1912,45,20-24,1957,0.010080828026633903
STAT,1902,40,50-100,1942,0.098795698990116
SIM,1898,31,na,1929,3018
SIM,1866,21,25-29,1887,53
STAT,1855,53,20-24,1908,5.159656352204958E-4
STAT,1927,26,50-100,1953,1.1470371348409352
STAT,1841,44,na,1885,1613.8513432771529
STAT,1872,45,15-19,1917,3.8280935604971316E-4
STAT,1856,33,20-24,1889,1.9959246603337297
STAT,1919,37,25-29,1956,0.9992723332219502
SIM,1864,33,20-24,1897,2
SIM,1866,44,40-44,1910,7
STAT,1847,31,20-24,1878,2.364763454442597
STAT,1860,23,30-34,1883,13.973533160276807
STAT,1801,53,30-34,1854,0.016298253120582692
SIM,1905,8,na,1913,3506
SIM,1824,78,na,1902,367
STAT,1900,15,30-34,1915,2.0984777745802727
STAT,1830,35,20-24,1865,0.6438099305664292
SIM,1820,43,35-39,1863,5
STAT,1906,34,40-44,1940,3.396863174833663
SIM,1942,26,40-44,1968,4
SIM,1829,30,40-44,1859,7
SIM,1857,47,50-100,1904,5
SIM,1932,7,na,1939,4966
SIM,1814,60,na,1874,972
STAT,1848,18,40-44,1866,0.16748524531963493
SIM,1896,21,40-44,1917,2
STAT,1767,116,na,1883,1.0197654575653836E-4
SIM,1935,26,50-100,1961,2
STAT,1832,23,25-29,1855,54.05753474083405
STAT,1870,43,45-49,1913,1.3770085935546854
STAT,1926,27,15-19,1953,0.7994471869874108
SIM,1908,47,50-100,1955,1
SIM,1888,22,15-19,1910,3
STAT,1876,31,50-100,1907,0.8979145690149505
STAT,1881,47,15-19,1928,3.633404469977148E-4
STAT,1883,41,50-100,1924,0.9829273405020901
STAT,1891,24,na,1915,2746.919909497794
STAT,1870,32,35-39,1902,9.385372714311389
STAT,1903,43,20-24,1946,0.014716634725478761
STAT,1843,51,50-100,1894,0.010249910692629932
STAT,1890,61,na,1951,2158.210209597557
STAT,1893,24,50-100,1917,0.4854858163253653
STAT,1934,26,40-44,1960,5.926116315374932
SIM,1868,32,45-49,1900,1
SIM,1849,23,15-19,1872,2
STAT,1860,16,50-100,1876,0.04356696555013572
STAT,1819,103,na,1922,0.07576085179968192
SIM,1848,44,35-39,1892,3
STAT,1851,48,40-44,1899,0.12160411151780323
STAT,1860,36,45-49,1896,1.5353813244232442
STAT,1888,21,40-44,1909,2.333488459682311
SIM,1877,32,na,1909,2297
SIM,1840,23,25-29,1863,38
SIM,1934,27,15-19,1961,3
STAT,1858,44,40-44,1902,1.6435091130887531
SIM,1886,46,na,1932,2201
SIM,1882,32,na,1914,2252
STAT,1860,25,35-39,1885,7.583754528464628
STAT,1919,42,50-100,1961,0.12026975063027978
STAT,1839,29,25-29,1868,34.97291008784873
STAT,1917,24,45-49,1941,1.1226523101691348
STAT,1912,20,45-49,1932,1.024795625909952
SIM,1873,98,na,1971,14
STAT,1934,37,20-24,1971,0.34365354069838683
SIM,1857,33,20-24,1890,2
STAT,1803,52,45-49,1855,0.04228709213191719
SIM,1870,3,na,1873,2723
SIM,1875,27,40-44,1902,7
SIM,1878,15,15-19,1893,4
SIM,1949,3,na,1952,4282
STAT,1812,43,35-39,1855,6.673418010816687
STAT,1892,24,35-39,1916,6.861608160022957
SIM,1908,26,35-39,1934,22
SIM,1919,28,30-34,1947,53
STAT,1947,21,15-19,1968,5.685510186334435
STAT,1877,18,50-100,1895,0.047883056378951856
STAT,1884,20,15-19,1904,3.0974188195803904
SIM,1802,75,na,1877,388
STAT,1919,20,na,1939,3800.159725598025
SIM,1933,24,40-44,1957,6
STAT,1916,46,35-39,1962,0.1252375730289956
SIM,1938,28,40-44,1966,5
STAT,1831,44,15-19,1875,0.009926880761639228
STAT,1777,113,na,1890,4.3003630418587014E-4
SIM,1881,24,25-29,1905,46
STAT,1889,24,15-19,1913,3.8234167816066322
STAT,1941,16,na,1957,3582.565299868
STAT,1819,66,na,1885,899.2929592124283
STAT,1888,20,na,1908,2656.2087507772358
SIM,1825,63,na,1888,973
STAT,1830,41,na,1871,1567.9038198053954
SIM,1891,41,50-100,1932,1
STAT,1920,17,na,1937,3901.168663518409
SIM,1828,74,na,1902,653
SIM,1850,51,50-100,1901,1
STAT,1871,36,20-24,1907,0.7265923659150334
STAT,1913,18,15-19,1931,8.7431638985622
STAT,1925,24,40-44,1949,3.7782215015461493
STAT,1908,36,40-44,1944,1.3304721549390919
STAT,1912,39,35-39,1951,2.207804939498624
STAT,1812,54,45-49,1866,0.044602174505348674
STAT,1856,58,na,1914,1457.6431983194875
SIM,1865,47,na,1912,1982
SIM,1921,18,15-19,1939,41
SIM,1920,39,35-39,1959,4
STAT,1808,63,na,1871,922.6254072779345
STAT,1923,35,25-29,1958,1.079610532630284
SIM,1897,24,15-19,1921,4
SIM,1925,24,45-49,1949,1
SIM,1892,20,15-19,1912,4
STAT,1892,49,40-44,1941,0.11188191069540405
SIM,1860,102,na,1962,2
SIM,1920,20,45-49,1940,2
STAT,1777,85,na,1862,72.8887140979657
STAT,1903,32,40-44,1935,5.829207244653952
STAT,1952,19,na,1971,4164.112977755844
STAT,1867,23,25-29,1890,50.62441152109248
STAT,1873,21,20-24,1894,66.22539608532841
STAT,1849,33,20-24,1882,2.11382236420188
STAT,1945,27,25-29,1972,68.2174570811891
STAT,1854,31,50-100,1885,0.6783402433725325
STAT,1851,23,35-39,1874,4.976893753436505
STAT,1932,24,40-44,1956,4.153343128940392
SIM,1865,0,na,1865,3187
SIM,1931,35,25-29,1966,5
STAT,1901,30,40-44,1931,5.78071737615068
SIM,1862,95,na,1957,7
STAT,1840,46,15-19,1886,2.681264154484308E-4
SIM,1855,20,40-44,1875,2
STAT,1923,1,na,1924,4632.463210874472
SIM,1858,44,50-100,1902,4
STAT,1804,89,na,1893,35.1894120116739
STAT,1879,86,na,1965,432.3408469519274
SIM,1830,93,na,1923,16
SIM,1890,26,25-29,1916,53
SIM,1906,24,35-39,1930,8
STAT,1828,39,20-24,1867,0.6731400686047068
SIM,1841,96,na,1937,2
SIM,1823,35,25-29,1858,1
SIM,1875,23,25-29,1898,63
STAT,1798,84,na,1882,112.35330875549022
STAT,1859,53,35-39,1912,0.006369137920911966
STAT,1849,20,50-100,1869,0.37507479968077945
SIM,1940,24,40-44,1964,4
STAT,1914,33,25-29,1947,8.752227610570172
SIM,1849,14,na,1863,2224
STAT,1895,7,na,1902,3208.753283694658
STAT,1868,83,na,1951,357.8210975817324
STAT,1831,45,50-100,1876,0.17953388045092716
SIM,1905,37,40-44,1942,1
STAT,1890,45,20-24,1935,0.013997764496340081
STAT,1825,51,20-24,1876,7.399927548232016E-4
STAT,1867,37,45-49,1904,1.7683783096272547
SIM,1928,29,50-100,1957,2
STAT,1870,25,na,1895,2226.7424979081115
SIM,1869,50,na,1919,1994
STAT,1861,52,45-49,1913,0.011338630242387474
SIM,1886,68,na,1954,1405
SIM,1950,1,na,1951,4349
STAT,1838,44,25-29,1882,0.4472038707060469
STAT,1929,22,na,1951,4362.438814866302
SIM,1878,41,40-44,1919,5
STAT,1842,51,50-100,1893,0.010989473798765099
SIM,1825,43,40-44,1868,5
STAT,1874,4,na,1878,2817.4138748986306
STAT,1932,25,25-29,1957,81.5130228656788
STAT,1792,93,na,1885,6.887555641508504
STAT,1905,45,20-24,1950,0.009335180072689707
STAT,1914,9,na,1923,3877.551256629604
SIM,1890,26,30-34,1916,32
STAT,1934,22,25-29,1956,117.26799176305259
SIM,1827,40,40-44,1867,4
SIM,1892,34,40-44,1926,1
STAT,1874,15,na,1889,2458.2403919833287
STAT,1920,35,45-49,1955,0.7063380487950597
STAT,1936,30,35-39,1966,8.394564252162102
STAT,1884,34,40-44,1918,4.012893864254787
STAT,1903,48,20-24,1951,0.008984242261439717
SIM,1872,31,20-24,1903,2
SIM,1919,17,15-19,1936,42
STAT,1803,70,na,1873,671.9768070569133
STAT,1898,45,35-39,1943,0.10196543461203204
STAT,1849,47,35-39,1896,0.10449209127008549
STAT,1925,32,na,1957,4242.669083261132
STAT,1921,22,15-19,1943,5.67991400810687
STAT,1930,27,50-100,1957,1.1956104546018442
SIM,1823,35,30-34,1858,2
STAT,1885,52,na,1937,2016.7782716486715
STAT,1840,41,45-49,1881,1.0377693819974534
STAT,1820,39,50-100,1859,2.4920997572500454
SIM,1827,33,35-39,1860,6
SIM,1848,29,na,1877,1848
SIM,1865,60,na,1925,1667
STAT,1880,19,15-19,1899,5.878729601804102
STAT,1852,52,35-39,1904,0.006208223171683314
SIM,1922,46,na,1968,3981
SIM,1873,29,35-39,1902,9
SIM,1892,27,35-39,1919,12
STAT,1886,24,35-39,1910,5.786831409144301
STAT,1796,83,na,1879,134.78070337991215
SIM,1818,40,30-34,1858,1
SIM,1854,23,na,1877,2006
STAT,1912,48,30-34,1960,0.08071273059409283
STAT,1915,24,na,1939,3543.7995773438556
SIM,1844,30,30-34,1874,16
STAT,1854,88,na,1942,98.22435280229679
STAT,1860,17,na,1877,2029.242930446835
STAT,1896,18,na,1914,3142.905952575443
STAT,1923,30,25-29,1953,10.090106186165677
SIM,1823,43,na,1866,1401
SIM,1830,25,20-24,1855,12
STAT,1847,39,25-29,1886,2.1575772108404347
STAT,1844,41,45-49,1885,1.078299078516954
STAT,1892,42,20-24,1934,0.18768421482604827
SIM,1907,34,40-44,1941,3
SIM,1815,48,na,1863,1396
STAT,1784,98,na,1882,0.5399920844466909
SIM,1868,22,40-44,1890,2
STAT,1823,54,20-24,1877,8.404895717855087E-4
STAT,1882,26,30-34,1908,23.214391394678195
STAT,1760,103,na,1863,0.03886089430422771
STAT,1855,41,20-24,1896,0.11336742747692392
SIM,1894,24,35-39,1918,7
STAT,1873,48,25-29,1921,0.05449396154467199
SIM,1842,22,20-24,1864,56
STAT,1914,30,15-19,1944,0.12318424489443204
SIM,1825,36,35-39,1861,21
SIM,1931,30,25-29,1961,14
SIM,1940,25,25-29,1965,75
STAT,1856,39,35-39,1895,5.1608239081355265
SIM,1865,36,50-100,1901,1
SIM,1853,30,40-44,1883,7
STAT,1814,51,45-49,1865,0.043257778100060915
SIM,1857,65,na,1922,1286
STAT,1866,1,na,1867,3119.8833044914763
SIM,1840,25,20-24,1865,13
STAT,1824,56,na,1880,1223.4964506810177
STAT,1908,15,50-100,1923,0.06897582873330323
SIM,1873,15,30-34,1888,5
SIM,1891,15,na,1906,2996
STAT,1829,51,20-24,1880,5.942763859228431E-4
STAT,1919,21,50-100,1940,0.6827218658106907
STAT,1867,18,45-49,1885,0.0588894463890666
SIM,1910,22,35-39,1932,6
STAT,1863,29,25-29,1892,34.817967471330654
STAT,1834,22,20-24,1856,57.196954193147
SIM,1840,15,na,1855,2020
STAT,1882,19,25-29,1901,5.178191182288804
STAT,1914,49,35-39,1963,0.12009042141127349
STAT,1858,78,na,1936,578.7186594478017
STAT,1907,40,25-29,1947,0.06250694343405626
STAT,1847,46,30-34,1893,0.07158368504148838
STAT,1853,36,45-49,1889,1.524410178696389
STAT,1848,18,35-39,1866,0.5024557068673171
SIM,1887,34,45-49,1921,4
STAT,1896,42,20-24,1938,0.013742912131402805
STAT,1940,20,15-19,1960,5.126313081118086
STAT,1958,4,na,1962,4878.48611580791
STAT,1884,15,40-44,1899,0.17150034397435587
STAT,1879,34,45-49,1913,1.7096552357128072
STAT,1866,73,na,1939,1034.914212869727
STAT,1924,19,40-44,1943,1.5650422821824486
SIM,1932,19,40-44,1951,5
SIM,1897,21,50-100,1918,1
SIM,1837,40,40-44,1877,4
SIM,1947,15,25-29,1962,52
STAT,1899,60,na,1959,2553.664479153589
STAT,1903,39,na,1942,3159.656481833283
STAT,1884,27,35-39,1911,9.005544804044797
STAT,1880,50,45-49,1930,0.01466112077881617
STAT,1892,48,35-39,1940,0.09226912291611208
SIM,1861,70,na,1931,1174
SIM,1919,24,20-24,1943,110
SIM,1875,37,45-49,1912,2
STAT,1833,92,na,1925,25.553002862153622
STAT,1860,48,15-19,1908,3.0275112709804734E-4
SIM,1808,54,na,1862,1170
SIM,1858,13,na,1871,2262
SIM,1870,47,na,1917,2053
STAT,1829,100,na,1929,0.6414836813871703
STAT,1846,59,na,1905,1441.4747581932745
SIM,1910,19,20-24,1929,17
STAT,1832,25,20-24,1857,9.9063639661434
STAT,1902,22,35-39,1924,7.780045474429177
STAT,1929,40,45-49,1969,0.20416984682750136
SIM,1853,23,35-39,1876,7
SIM,1894,31,40-44,1925,5
STAT,1817,43,40-44,1860,5.4921312893506
STAT,1833,40,30-34,1873,0.8769132312077642
STAT,1886,2,na,1888,2949.64059825242
SIM,1886,37,20-24,1923,1
SIM,1912,27,30-34,1939,38
STAT,1849,48,na,1897,1665.8853436661857
STAT,1879,46,na,1925,2231.1238761028435
STAT,1865,15,30-34,1880,1.5638373340204685
SIM,1890,19,25-29,1909,10
STAT,1904,27,30-34,1931,34.122894395191615
SIM,1884,44,50-100,1928,1
STAT,1902,19,20-24,1921,23.509479105918796
STAT,1918,45,50-100,1963,0.22845144795666764
STAT,1816,43,35-39,1859,4.6682347363458
STAT,1818,51,45-49,1869,0.03030336556288715
STAT,1913,25,15-19,1938,0.6690473347483312
STAT,1911,34,na,1945,3449.486083081827
STAT,1844,51,30-34,1895,0.004153967128340933
STAT,1844,101,na,1945,0.3963116005355967
SIM,1853,75,na,1928,770
SIM,1811,58,na,1869,1000
SIM,1870,20,30-34,1890,27
STAT,1874,53,25-29,1927,0.0033639406861675166
STAT,1819,40,40-44,1859,5.081849625697101
SIM,1898,34,20-24,1932,4
SIM,1899,24,25-29,1923,81
SIM,1795,70,na,1865,612
STAT,1878,37,20-24,1915,0.7589166090299292
STAT,1882,10,na,1892,2379.7722963835117
SIM,1820,88,na,1908,58
STAT,1886,31,40-44,1917,4.345339987985456
SIM,1896,37,20-24,1933,3
STAT,1884,28,50-100,1912,0.5949365839300196
STAT,1889,16,30-34,1905,1.8634233787483825
SIM,1851,26,35-39,1877,11
STAT,1933,30,25-29,1963,11.78005555678501
SIM,1832,73,na,1905,669
SIM,1859,4,na,1863,2374
SIM,1845,33,50-100,1878,3
STAT,1842,54,30-34,1896,0.004192188667176003
SIM,1838,76,na,1914,590
SIM,1858,90,na,1948,52
SIM,1835,31,50-100,1866,4
STAT,1831,54,25-29,1885,0.0021334727488770844
STAT,1871,23,45-49,1894,0.6521167647808068
STAT,1832,45,50-100,1877,0.18005705139045433
SIM,1867,35,50-100,1902,3
STAT,1837,36,20-24,1873,0.6154647214789885
STAT,1856,95,na,1951,9.799846137218179
SIM,1910,21,na,1931,3417
SIM,1847,25,30-34,1872,28
SIM,1877,20,25-29,1897,58
SIM,1944,5,na,1949,3952
SIM,1873,95,na,1968,42
STAT,1859,17,40-44,1876,0.15963547602513883
STAT,1862,20,30-34,1882,14.94192594656027
SIM,1863,18,na,1881,2173
SIM,1868,41,40-44,1909,4
STAT,1942,30,35-39,1972,9.206606383666347
SIM,1778,82,na,1860,132
STAT,1841,28,na,1869,1839.0713692368063
SIM,1795,88,na,1883,36
STAT,1840,30,20-24,1870,2.2059408745421476
STAT,1866,34,35-39,1900,8.748381560426433
SIM,1923,30,50-100,1953,6
STAT,1821,39,50-100,1860,2.316197879984205
SIM,1847,38,50-100,1885,4
STAT,1860,26,35-39,1886,7.5293031709502545
STAT,1915,22,15-19,1937,5.198298812338552
SIM,1874,34,35-39,1908,14
SIM,1864,36,30-34,1900,5
STAT,1908,32,25-29,1940,8.242013486839246
SIM,1856,30,na,1886,1923
SIM,1923,22,15-19,1945,6
STAT,1829,43,45-49,1872,1.2568933682681793
STAT,1923,27,40-44,1950,5.055368558611425
STAT,1939,19,50-100,1958,0.3540454719570676
STAT,1820,51,45-49,1871,0.023863690380748644
STAT,1841,28,35-39,1869,8.202889261344856
SIM,1896,30,na,1926,3027
STAT,1843,26,35-39,1869,8.078752249979063
STAT,1849,52,20-24,1901,5.503964118306333E-4
STAT,1867,21,na,1888,2121.8604803515937
SIM,1783,85,na,1868,52
STAT,1849,43,30-34,1892,0.8558718077113102
STAT,1866,52,20-24,1918,6.395420605811511E-4
STAT,1888,37,20-24,1925,0.8606128649544921
STAT,1894,35,na,1929,2887.4371778989316
STAT,1899,26,40-44,1925,3.890772400965238
SIM,1885,44,50-100,1929,1
STAT,1899,45,40-44,1944,0.1262480506570861
STAT,1855,33,45-49,1888,1.2487338846397544
SIM,1956,15,35-39,1971,8
STAT,1948,11,na,1959,4247.572977792588
SIM,1914,32,20-24,1946,1
STAT,1887,27,50-100,1914,0.6759529032380843
STAT,1908,20,na,1928,3334.1361474360583
STAT,1840,49,40-44,1889,0.11043114051147894
STAT,1839,25,30-34,1864,21.42807893641827
STAT,1862,36,50-100,1898,0.9964435502311056
STAT,1771,91,na,1862,12.388990685560618
STAT,1879,42,20-24,1921,0.15685260095292422
SIM,1916,32,25-29,1948,16
SIM,1789,76,na,1865,300
STAT,1881,42,45-49,1923,1.364161978252552
SIM,1931,27,40-44,1958,3
SIM,1916,24,na,1940,3515
STAT,1870,48,15-19,1918,3.6604629104861384E-4
SIM,1860,69,na,1929,1173
SIM,1878,33,na,1911,2398
STAT,1854,29,15-19,1883,0.3354355996526575
STAT,1828,40,na,1868,1529.2125485637562
STAT,1873,67,na,1940,1518.8201445746927
STAT,1830,39,15-19,1869,0.04439336141307245
SIM,1852,41,45-49,1893,1
STAT,1878,18,20-24,1896,17.408374621725095
STAT,1948,15,35-39,1963,4.539088256815999
STAT,1828,46,na,1874,1422.2423052191732
SIM,1835,62,na,1897,1175
STAT,1848,51,30-34,1899,0.004444252473504395
SIM,1890,67,na,1957,2087
STAT,1891,19,35-39,1910,0.6378816781730555
SIM,1871,26,20-24,1897,11
STAT,1845,33,45-49,1878,1.452050026503409
STAT,1896,34,45-49,1930,2.1571137293857525
STAT,1927,3,na,1930,4764.221713305799
STAT,1939,25,35-39,1964,14.270928842947663
SIM,1832,28,35-39,1860,10
SIM,1868,34,35-39,1902,10
STAT,1924,40,25-29,1964,0.0804622087059729
STAT,1809,67,na,1876,773.7097519711753
STAT,1906,32,20-24,1938,2.1355353765335954
STAT,1860,22,30-34,1882,14.074588707194465
STAT,1864,34,25-29,1898,8.550148717186119
SIM,1831,30,20-24,1861,1
STAT,1840,110,na,1950,1.8134898541034004E-4
STAT,1816,77,na,1893,402.80819904415796
STAT,1847,16,50-100,1863,0.04535716572075138
STAT,1869,29,50-100,1898,0.5812554777913344
STAT,1928,36,15-19,1964,0.022947109832487513
STAT,1851,44,25-29,1895,0.4556959379636103
STAT,1878,15,40-44,1893,0.18090846867572988
SIM,1851,33,40-44,1884,3
STAT,1923,49,45-49,1972,0.23877654694957726
STAT,1833,52,25-29,1885,0.0022397286923256337
STAT,1838,46,20-24,1884,0.008395262392429985
STAT,1893,35,50-100,1928,1.4848388140628608
STAT,1860,110,na,1970,0.0029409155481024602
SIM,1798,59,na,1857,979
STAT,1881,20,40-44,1901,1.913044101481614
STAT,1898,33,50-100,1931,1.1664031985662149
SIM,1942,22,25-29,1964,87
SIM,1897,16,30-34,1913,3
STAT,1765,97,na,1862,0.6258564629406678
SIM,1941,30,25-29,1971,7
STAT,1920,46,25-29,1966,0.05553121199327773
SIM,1830,47,na,1877,1447
STAT,1853,47,na,1900,1694.7328495859051
STAT,1899,38,35-39,1937,1.966270019605836
SIM,1872,54,na,1926,1955
STAT,1843,45,na,1888,1551.8207279289018
STAT,1843,33,40-44,1876,3.4851089730741585
SIM,1810,70,na,1880,658
SIM,1853,33,45-49,1886,2
STAT,1914,37,40-44,1951,1.4120250592043206
SIM,1866,25,40-44,1891,3
STAT,1892,28,na,1920,2813.914403097463
SIM,1867,73,na,1940,1089
STAT,1823,49,40-44,1872,0.20491336783818412
STAT,1869,28,20-24,1897,10.698707971261632
STAT,1902,38,20-24,1940,0.2207240778343892
SIM,1906,29,40-44,1935,4
STAT,1869,20,25-29,1889,52.928780185719404
SIM,1883,23,20-24,1906,55
SIM,1925,33,35-39,1958,18
STAT,1940,30,25-29,1970,9.046900861352706
SIM,1931,29,na,1960,4533
STAT,1944,27,na,1971,3824.9174320110646
STAT,1957,8,na,1965,4894.250587255688
SIM,1952,8,na,1960,4389
STAT,1890,21,20-24,1911,79.83186873286776
STAT,1895,34,50-100,1929,1.1187855198105825
SIM,1846,33,45-49,1879,1
STAT,1854,36,20-24,1890,0.5541853820945037
STAT,1890,32,45-49,1922,2.014055022682014
STAT,1875,26,50-100,1901,0.6232823207703722
SIM,1911,52,na,1963,3197
STAT,1810,46,35-39,1856,0.47495597134589396
STAT,1838,33,45-49,1871,1.4397425391090086
STAT,1858,25,40-44,1883,2.304304320840935
STAT,1839,89,na,1928,69.94445000596201
SIM,1840,35,30-34,1875,5
STAT,1916,34,40-44,1950,3.7841010498296153
SIM,1949,22,35-39,1971,11
SIM,1922,37,40-44,1959,1
SIM,1847,87,na,1934,103
STAT,1790,64,na,1854,762.9999999999999
STAT,1845,71,na,1916,944.5434105082085
SIM,1858,20,15-19,1878,3
SIM,1914,30,25-29,1944,14
STAT,1917,33,35-39,1950,9.002027234315179
STAT,1863,19,15-19,1882,5.048741779874073
STAT,1895,21,50-100,1916,0.5037504259163429
STAT,1834,32,30-34,1866,13.879424014578097
STAT,1867,34,40-44,1901,3.814069507259411
STAT,1819,43,45-49,1862,3.0414027362999114
STAT,1826,39,na,1865,1518.6294296043172
STAT,1827,40,30-34,1867,1.1415162564381005
STAT,1873,45,20-24,1918,0.01161199797515962
SIM,1875,34,40-44,1909,6
STAT,1919,30,35-39,1949,9.388841727171238
STAT,1924,42,50-100,1966,0.13200688971676863
SIM,1909,14,na,1923,3662
STAT,1796,67,na,1863,733.6989438474781
STAT,1921,27,30-34,1948,41.25384537162166
SIM,1831,41,45-49,1872,5
STAT,1856,48,25-29,1904,0.04192222373744875
SIM,1843,97,na,1940,2
STAT,1806,54,20-24,1860,0.0024949643773182315
STAT,1932,22,20-24,1954,137.82689758853334
SIM,1842,32,30-34,1874,22
STAT,1858,28,45-49,1886,0.8358230789361619
STAT,1837,23,na,1860,1803.4306401079414
SIM,1871,19,15-19,1890,4
STAT,1849,61,na,1910,1401.230023881372
SIM,1940,22,20-24,1962,96
STAT,1887,81,na,1968,930.9394731439502
SIM,1865,44,na,1909,2018
STAT,1825,32,20-24,1857,4.728412871243703
STAT,1864,30,50-100,1894,0.7776539495926551
SIM,1924,34,40-44,1958,5
SIM,1946,22,na,1968,3671
STAT,1922,45,20-24,1967,0.012049954526792625
STAT,1931,30,15-19,1961,0.1592477934861226
SIM,1848,17,30-34,1865,1
SIM,1861,30,30-34,1891,24
STAT,1863,26,20-24,1889,9.795910623950668
STAT,1814,40,20-24,1854,0.60051440587525
STAT,1832,35,30-34,1867,4.162304366626532
SIM,1869,37,20-24,1906,1
SIM,1892,37,45-49,1929,5
STAT,1837,76,na,1913,614.8497436729698
SIM,1844,33,35-39,1877,10
STAT,1906,30,25-29,1936,8.157153739289098
STAT,1856,18,na,1874,1988.8009592656729
STAT,1892,45,25-29,1937,0.03882850088218474
SIM,1901,21,25-29,1922,81
STAT,1869,47,20-24,1916,0.010931073888544566
SIM,1865,44,35-39,1909,2
STAT,1892,23,20-24,1915,81.28876913043555
STAT,1840,40,na,1880,1622.6807231983912
SIM,1864,29,25-29,1893,32
SIM,1927,1,na,1928,4799
SIM,1863,43,na,1906,1905
SIM,1882,41,30-34,1923,3
STAT,1834,34,na,1868,1685.6547438033533
STAT,1857,44,35-39,1901,1.3309554939758912
STAT,1825,54,25-29,1879,0.003346411698902447
STAT,1898,59,na,1957,2526.833072070631
STAT,1920,48,20-24,1968,0.011508229843614654
STAT,1842,28,50-100,1870,0.5687694186412101
SIM,1892,24,30-34,1916,32
SIM,1949,11,na,1960,4243
STAT,1911,18,na,1929,3641.742958262064
STAT,1817,46,45-49,1863,0.5404460492464066
STAT,1881,31,20-24,1912,2.4769100043836545
STAT,1862,45,45-49,1907,0.1925219894254376
SIM,1849,25,40-44,1874,3
STAT,1816,105,na,1921,0.013663482180414905
SIM,1811,74,na,1885,413
SIM,1884,27,45-49,1911,1
SIM,1881,37,na,1918,1822
SIM,1872,34,25-29,1906,16
STAT,1920,32,40-44,1952,4.049338125128202
STAT,1874,41,30-34,1915,1.1147077521956346
STAT,1884,37,45-49,1921,1.860562439902543
SIM,1856,52,50-100,1908,1
STAT,1846,51,20-24,1897,5.499363247711389E-4
STAT,1851,22,20-24,1873,59.1982991825942
STAT,1853,30,30-34,1883,13.892652967607411
STAT,1863,50,45-49,1913,0.012203933327328435
STAT,1873,36,30-34,1909,5.130922718352577
STAT,1775,81,na,1856,175.93148523899998
STAT,1945,20,35-39,1965,9.755691482913472
STAT,1837,29,15-19,1866,0.3725265721027367
STAT,1949,5,na,1954,4333.061749869094
STAT,1865,18,35-39,1883,0.481310954539912
STAT,1912,32,15-19,1944,0.11945854479359128
STAT,1851,53,50-100,1904,0.010689622444355578
STAT,1861,42,35-39,1903,1.420619771478875
SIM,1886,62,na,1948,1740
SIM,1931,24,30-34,1955,36
STAT,1858,47,45-49,1905,0.17398589735614248
STAT,1912,2,na,1914,3894.2637219822477
STAT,1943,23,35-39,1966,9.460693015295506
SIM,1878,67,na,1945,1569
SIM,1938,21,20-24,1959,96
STAT,1838,24,na,1862,1835.6760312068466
STAT,1875,33,30-34,1908,16.88209740353673
STAT,1936,26,na,1962,3388.2851876007057
SIM,1894,34,45-49,1928,3
STAT,1882,29,50-100,1911,0.5834948575733768
STAT,1895,37,20-24,1932,0.9493764868136805
SIM,1931,20,15-19,1951,6
STAT,1856,29,25-29,1885,31.84674442365617
STAT,1811,83,na,1894,172.1703579228065
SIM,1830,28,25-29,1858,38
STAT,1913,17,30-34,1930,2.354359940143005
STAT,1914,40,25-29,1954,0.06731403240223141
SIM,1820,40,30-34,1860,1
STAT,1836,33,35-39,1869,8.203776457331651
STAT,1828,46,20-24,1874,0.009845781691617829
STAT,1864,42,45-49,1906,1.2585773737362098
STAT,1960,11,na,1971,4832.759470028054
SIM,1921,17,30-34,1938,20
STAT,1883,45,na,1928,2104.6075172677624
STAT,1803,88,na,1891,46.14688970901287
STAT,1886,34,45-49,1920,1.7252795726401136
SIM,1881,36,30-34,1917,4
SIM,1891,34,35-39,1925,12
STAT,1844,54,35-39,1898,0.005814771589003111
STAT,1879,31,40-44,1910,4.305988072439335
SIM,1866,48,na,1914,1970
STAT,1845,109,na,1954,5.034494475388374E-4
STAT,1901,32,30-34,1933,23.087714818032172
STAT,1850,58,na,1908,1394.0547093766713
STAT,1875,48,35-39,1923,0.13423393771578204
SIM,1872,42,45-49,1914,1
STAT,1842,52,35-39,1894,0.006201338605674098
STAT,1923,20,15-19,1943,5.88604526993992
STAT,1940,27,40-44,1967,4.490113711803786
STAT,1833,86,na,1919,136.12683199513395
STAT,1928,17,15-19,1945,54.020269681563136
STAT,1859,46,50-100,1905,0.18518860805726828
SIM,1899,35,na,1934,3156
SIM,1846,71,na,1917,927
STAT,1838,41,20-24,1879,0.12629937300350794
STAT,1862,26,45-49,1888,0.9066280711543795
STAT,1891,40,na,1931,2728.591098274605
SIM,1867,46,50-100,1913,1
STAT,1806,53,na,1859,1156.9877083093147
STAT,1941,19,40-44,1960,1.3601079522234147
STAT,1887,41,40-44,1928,2.387528805764023
SIM,1895,41,40-44,1936,1
SIM,1870,26,45-49,1896,1
STAT,1776,111,na,1887,0.001178011764294763
SIM,1931,39,35-39,1970,9
SIM,1934,26,50-100,1960,1
STAT,1892,45,30-34,1937,0.06525345350035275
SIM,1770,96,na,1866,2
SIM,1887,31,40-44,1918,4
STAT,1885,42,45-49,1927,1.4075665199575091
SIM,1791,64,na,1855,763
SIM,1827,43,45-49,1870,3
STAT,1858,22,50-100,1880,0.3465515166412669
SIM,1931,23,na,1954,4432
SIM,1936,17,15-19,1953,27
STAT,1923,24,30-34,1947,31.39401460513552
SIM,1824,43,35-39,1867,5
SIM,1841,40,30-34,1881,2
SIM,1844,45,na,1889,1518
SIM,1819,78,na,1897,400
SIM,1876,41,30-34,1917,1
SIM,1918,25,na,1943,3753
STAT,1850,52,25-29,1902,0.0024835557100785647
STAT,1862,23,35-39,1885,4.7904369869597385
STAT,1839,28,35-39,1867,8.034990812937904
SIM,1868,44,45-49,1912,3
SIM,1858,23,25-29,1881,63
STAT,1837,39,25-29,1876,2.228314770807415
STAT,1883,34,35-39,1917,9.299517605754323
STAT,1803,53,35-39,1856,0.02458603514044871
STAT,1858,44,na,1902,1688.7851379398567
SIM,1905,34,30-34,1939,22
STAT,1939,15,25-29,1954,41.07975011715005
STAT,1826,48,50-100,1874,0.22370542495261314
STAT,1854,17,20-24,1871,15.173686711386512
STAT,1844,22,50-100,1866,0.3536187503844875
STAT,1825,54,30-34,1879,0.005623830825968278
SIM,1862,17,20-24,1879,18
SIM,1843,26,45-49,1869,5
STAT,1775,99,na,1874,0.31640378194973645
STAT,1846,40,40-44,1886,1.7323170555494094
STAT,1862,48,25-29,1910,0.04594000412701612
STAT,1854,94,na,1948,14.299739286753303
STAT,1857,53,25-29,1910,0.0025966434093603603
SIM,1888,37,30-34,1925,9
SIM,1871,94,na,1965,53
SIM,1883,33,30-34,1916,19
STAT,1880,26,20-24,1906,11.723856911273511
STAT,1938,33,na,1971,3590.3778852464397
STAT,1899,48,45-49,1947,0.17015046350803403
STAT,1901,42,40-44,1943,0.2062880086215058
SIM,1876,84,na,1960,424
SIM,1853,20,30-34,1873,22
SIM,1933,30,35-39,1963,15
STAT,1836,41,na,1877,1640.5022826922761
SIM,1853,41,na,1894,1766
SIM,1861,17,na,1878,2262
STAT,1886,34,na,1920,2360.936642005815
SIM,1914,51,na,1965,3413
SIM,1870,23,35-39,1893,5
STAT,1768,86,na,1854,45.0
STAT,1879,45,25-29,1924,0.05752695328573943
STAT,1868,41,30-34,1909,1.0409331565602622
SIM,1847,28,35-39,1875,8
STAT,1867,17,30-34,1884,1.4454162859545552
STAT,1908,14,na,1922,3607.391837701884
STAT,1841,37,25-29,1878,2.3386647105598355
STAT,1914,46,30-34,1960,0.0837311673196102
SIM,1861,41,30-34,1902,3
STAT,1871,20,40-44,1891,1.9664265802822911
STAT,1847,35,na,1882,1840.3668140777409
STAT,1899,29,45-49,1928,1.426907553943835
STAT,1831,51,20-24,1882,4.716872266130555E-4
SIM,1846,30,40-44,1876,4
STAT,1763,96,na,1859,0.7738168719006149
STAT,1870,44,35-39,1914,1.6555396641205984
STAT,1824,101,na,1925,0.31463435266393
STAT,1841,18,25-29,1859,5.008952612924879
STAT,1845,30,40-44,1875,3.725368123522365
SIM,1816,42,30-34,1858,3
STAT,1818,39,20-24,1857,2.0395138102601202
SIM,1831,72,na,1903,740
STAT,1877,37,45-49,1914,1.9534866984596897
SIM,1874,31,30-34,1905,29
STAT,1942,24,40-44,1966,3.328196334625755
STAT,1807,50,30-34,1857,0.022709613321121706
SIM,1874,38,50-100,1912,3
STAT,1882,18,50-100,1900,0.04489166652545433
STAT,1863,90,na,1953,65.36019341371943
STAT,1938,30,45-49,1968,1.4964429380324193
SIM,1854,40,40-44,1894,6
STAT,1922,19,30-34,1941,13.25463911048872
STAT,1853,13,na,1866,2163.4180553946526
SIM,1885,37,45-49,1922,1
SIM,1848,35,na,1883,1785
SIM,1880,35,50-100,1915,1
STAT,1927,43,15-19,1970,0.0018165478836415963
STAT,1869,62,na,1931,1672.7202554907885
SIM,1930,19,30-34,1949,15
SIM,1826,39,20-24,1865,4
STAT,1801,54,45-49,1855,0.03894520331961322
STAT,1850,15,30-34,1865,1.3892849056647587
STAT,1814,41,50-100,1855,3.91196671404871
SIM,1936,28,30-34,1964,34
SIM,1841,56,na,1897,1361
STAT,1836,36,45-49,1872,1.6010792001564533
STAT,1851,41,20-24,1892,0.11475794998400464
STAT,1872,52,20-24,1924,6.955132374752498E-4
SIM,1857,43,30-34,1900,1
SIM,1893,56,na,1949,2537
STAT,1828,27,20-24,1855,20.255451348469975
STAT,1876,27,45-49,1903,1.0836611754770404
STAT,1906,35,25-29,1941,0.8631751748094345
SIM,1912,22,45-49,1934,4
SIM,1831,33,25-29,1864,12
SIM,1851,36,45-49,1887,1
SIM,1851,58,na,1909,1482
STAT,1895,30,na,1925,2962.6015059473248
SIM,1827,27,na,1854,1649
STAT,1881,46,25-29,1927,0.052715378985203475
SIM,1829,56,na,1885,1180
SIM,1852,29,20-24,1881,9
SIM,1782,81,na,1863,173
STAT,1842,33,35-39,1875,8.767944377392702
SIM,1832,25,30-34,1857,21
SIM,1866,28,45-49,1894,1
SIM,1890,11,na,1901,3231
SIM,1850,33,35-39,1883,8
SIM,1902,42,40-44,1944,1
STAT,1886,21,30-34,1907,17.828726877862746
STAT,1859,52,45-49,1911,0.010853657732936534
STAT,1890,24,25-29,1914,65.70282240369087
SIM,1909,17,15-19,1926,7
STAT,1843,36,45-49,1879,1.5883198680777058
STAT,1835,26,45-49,1861,0.9276579494462219
STAT,1870,31,45-49,1901,1.622711331809342
SIM,1906,22,na,1928,3252
STAT,1895,18,20-24,1913,21.777229991889694
STAT,1881,62,na,1943,1667.9993186622924
SIM,1890,41,50-100,1931,1
STAT,1838,30,40-44,1868,3.6937921306964414
SIM,1927,30,35-39,1957,19
STAT,1814,47,50-100,1861,0.7512177091123236
STAT,1790,100,na,1890,0.21067472785400737
STAT,1815,73,na,1888,555.4214691088745
STAT,1838,49,25-29,1887,0.038777813067826475
SIM,1928,17,25-29,1945,57
SIM,1903,57,na,1960,2796
STAT,1820,41,35-39,1861,3.4331424403973876
STAT,1878,18,45-49,1896,0.064142856011595
SIM,1844,36,45-49,1880,1
STAT,1904,22,45-49,1926,0.944910059582291
STAT,1927,40,35-39,1967,0.23923398795917472
STAT,1917,27,50-100,1944,0.9861212674312664
STAT,1935,36,50-100,1971,0.5551232323692283
STAT,1823,33,25-29,1856,23.285641254894113
SIM,1845,39,25-29,1884,1
SIM,1881,26,20-24,1907,8
SIM,1900,47,50-100,1947,1
STAT,1888,47,30-34,1935,0.10756834930787927
SIM,1859,42,45-49,1901,2
STAT,1821,44,45-49,1865,2.4282606676610943
STAT,1866,33,20-24,1899,2.3452936281031618
SIM,1890,38,25-29,1928,3
STAT,1937,35,50-100,1972,0.39730487554823524
SIM,1894,21,30-34,1915,30
STAT,1864,31,20-24,1895,2.2851999527881524
STAT,1887,19,na,1906,2654.45628577227
SIM,1785,86,na,1871,62
SIM,1918,46,50-100,1964,3
SIM,1836,27,20-24,1863,7
STAT,1894,31,30-34,1925,21.283584748047357
STAT,1920,43,20-24,1963,0.018396755764215764
STAT,1891,16,30-34,1907,1.8674599776214214
SIM,1892,40,na,1932,3073
SIM,1839,23,15-19,1862,6
STAT,1815,47,25-29,1862,0.12967743137497414
STAT,1890,48,25-29,1938,0.0370547031463868
STAT,1784,103,na,1887,0.04980378866815818
SIM,1838,39,25-29,1877,1
SIM,1834,86,na,1920,128
SIM,1866,37,35-39,1903,14
SIM,1827,30,30-34,1857,24
SIM,1812,59,na,1871,1049
STAT,1818,78,na,1896,383.7114871374178
SIM,1849,22,30-34,1871,25
SIM,1888,29,35-39,1917,12
STAT,1882,38,25-29,1920,2.632042674680934
SIM,1835,40,30-34,1875,3
SIM,1870,13,na,1883,2424
STAT,1780,103,na,1883,0.04358402861956235
SIM,1868,74,na,1942,948
SIM,1845,46,50-100,1891,1
STAT,1881,34,25-29,1915,9.267438007220042
STAT,1851,32,30-34,1883,13.072214257524868
STAT,1869,84,na,1953,304.44984385170034
STAT,1920,46,30-34,1966,0.09332328772147258
STAT,1856,45,20-24,1901,0.008933114116770237
SIM,1923,22,20-24,1945,125
STAT,1933,34,40-44,1967,4.975613783895158
SIM,1870,90,na,1960,96
STAT,1836,21,40-44,1857,1.793774442037739
STAT,1832,38,35-39,1870,5.347562407134396
SIM,1823,99,na,1922,1
STAT,1795,82,na,1877,175.01343665196305
SIM,1917,16,35-39,1933,1
STAT,1897,26,50-100,1923,0.8109495404154581
STAT,1864,3,na,1867,2704.2440728247075
SIM,1933,30,na,1963,4870
STAT,1871,26,na,1897,2246.414079886463
SIM,1853,26,45-49,1879,4
STAT,1846,37,na,1883,1824.8153395532781
SIM,1882,44,35-39,1926,4
SIM,1929,38,40-44,1967,1
STAT,1845,26,45-49,1871,0.963231804934112
STAT,1799,72,na,1871,535.1890632529617
SIM,1921,45,na,1966,3954
SIM,1850,76,na,1926,684
SIM,1904,29,30-34,1933,47
STAT,1853,45,50-100,1898,0.18772216436275277
SIM,1906,25,25-29,1931,66
STAT,1814,43,25-29,1857,2.170688360832002
STAT,1899,23,30-34,1922,22.9850232650297
STAT,1844,29,20-24,1873,9.831530923790657
SIM,1858,27,40-44,1885,4
SIM,1919,29,na,1948,3874
STAT,1873,42,50-100,1915,1.0109556550622683
STAT,1926,33,na,1959,4317.440686962753
SIM,1870,30,40-44,1900,6
STAT,1887,44,45-49,1931,1.5601292183121174
STAT,1888,66,na,1954,1829.8699520854786
STAT,1900,18,40-44,1918,0.23906727372376416
STAT,1813,47,na,1860,1267.6992051624914
STAT,1910,21,25-29,1931,82.1960820254129
STAT,1857,99,na,1956,1.663127076896336
STAT,1861,51,30-34,1912,0.0046980223099287195
STAT,1947,21,20-24,1968,118.76321077498685
SIM,1844,43,45-49,1887,4
STAT,1827,43,35-39,1870,1.7075291234743863
SIM,1908,33,35-39,1941,11
SIM,1864,26,20-24,1890,16
STAT,1819,49,15-19,1868,7.353331574010433E-4
STAT,1763,101,na,1864,0.06810729743328042
SIM,1947,19,40-44,1966,3
STAT,1840,45,25-29,1885,0.039108081868551234
STAT,1867,20,15-19,1887,2.981204134669968
SIM,1868,30,25-29,1898,9
STAT,1903,49,35-39,1952,0.10393360385256464
SIM,1849,44,40-44,1893,7
STAT,1906,32,15-19,1938,0.11250833009781984
STAT,1881,19,na,1900,2292.5239484699505
STAT,1814,107,na,1921,0.0021675750840186516
STAT,1914,23,na,1937,3513.7240474130526
STAT,1954,17,25-29,1971,50.60558993150184
SIM,1881,31,na,1912,1839
STAT,1842,32,20-24,1874,2.3647172729274346
STAT,1851,44,30-34,1895,0.8158427243065118
STAT,1942,20,25-29,1962,91.55632405876904
STAT,1858,22,na,1880,1817.0398522266719
STAT,1828,49,25-29,1877,0.04542376792046492
STAT,1901,35,40-44,1936,1.2612745546509672
SIM,1807,50,na,1857,1215
STAT,1894,34,35-39,1928,12.18949624763447
STAT,1836,43,45-49,1879,1.1382872704997546
STAT,1914,48,na,1962,3432.524743486569
SIM,1850,32,20-24,1882,2
SIM,1868,9,na,1877,2436
STAT,1939,19,40-44,1958,1.3217700833944788
SIM,1856,89,na,1945,75
SIM,1875,20,15-19,1895,3
STAT,1834,47,35-39,1881,0.09214228788434958
SIM,1949,15,35-39,1964,5
STAT,1923,35,50-100,1958,0.46036583715476953
STAT,1870,19,20-24,1889,16.39181486352591
STAT,1825,42,30-34,1867,1.2518026321284932
STAT,1906,31,50-100,1937,0.7268325216631042
STAT,1932,17,40-44,1949,1.749659121181653
STAT,1907,44,40-44,1951,0.21382940452956212
STAT,1807,53,35-39,1860,0.03091649086461104
STAT,1888,44,20-24,1932,0.17491322085739383
SIM,1882,4,na,1886,2548
STAT,1874,44,35-39,1918,1.7242472807487208
STAT,1940,24,30-34,1964,27.64038907142819
STAT,1852,8,na,1860,2153.2184058287257
STAT,1873,39,35-39,1912,6.708464258720549
SIM,1899,28,40-44,1927,4
STAT,1868,37,na,1905,2123.541443272701
SIM,1921,48,na,1969,3925
SIM,1843,47,50-100,1890,2
SIM,1887,28,50-100,1915,4
STAT,1889,21,50-100,1910,0.4770233880965025
STAT,1847,43,20-24,1890,0.11626390413584972
STAT,1876,24,40-44,1900,2.0210754380023
STAT,1831,32,45-49,1863,1.3917618156490426
STAT,1806,48,35-39,1854,0.5093299134764612
STAT,1870,41,na,1911,2151.6594278296257
STAT,1900,22,50-100,1922,0.5344111534125815
SIM,1884,24,40-44,1908,1
STAT,1784,109,na,1893,7.182081079463767E-4
SIM,1906,56,na,1962,2919
STAT,1868,21,50-100,1889,0.3702168262979735
SIM,1940,17,40-44,1957,2
SIM,1833,42,30-34,1875,3
STAT,1872,52,45-49,1924,0.013678426484579764
STAT,1909,16,35-39,1925,0.7793097530939929
SIM,1831,94,na,1925,10
STAT,1910,29,20-24,1939,16.533523040911316
STAT,1894,51,na,1945,2626.631311729474
SIM,1767,92,na,1859,7
SIM,1872,30,50-100,1902,4
STAT,1851,89,na,1940,75.56951128835635
STAT,1892,33,30-34,1925,20.57203418631458
SIM,1868,34,40-44,1902,4
STAT,1890,46,35-39,1936,0.09146852777338502
SIM,1943,17,15-19,1960,40
SIM,1826,42,na,1868,1445
SIM,1801,96,na,1897,3
STAT,1845,39,15-19,1884,0.0408927509228299
STAT,1853,33,35-39,1886,7.8109316068786105
STAT,1949,22,25-29,1971,101.82609068056885
STAT,1898,44,20-24,1942,0.013908491148759567
STAT,1932,22,15-19,1954,6.598139483405744
STAT,1894,49,15-19,1943,2.6821032603754376E-4
STAT,1923,39,35-39,1962,2.6419058961662314
STAT,1857,17,30-34,1874,1.3957569798953013
SIM,1940,22,15-19,1962,2
SIM,1881,53,na,1934,1656
STAT,1855,44,50-100,1899,0.7406092759235878
STAT,1914,45,na,1959,3458.2942097758514
SIM,1861,33,35-39,1894,10
STAT,1935,17,15-19,1952,58.61014937345618
STAT,1927,9,na,1936,4675.901372478031
SIM,1907,29,50-100,1936,5
STAT,1820,50,30-34,1870,0.009985172710343113
STAT,1932,29,40-44,1961,5.761594049833404
STAT,1867,27,35-39,1894,8.55935267546485
SIM,1874,33,20-24,1907,1
STAT,1919,33,45-49,1952,1.597044478268097
STAT,1857,50,20-24,1907,5.576957343994429E-4
STAT,1914,29,na,1943,3542.2253399261044
SIM,1821,38,25-29,1859,2
STAT,1827,31,50-100,1858,1.1473598108996779
SIM,1835,87,na,1922,91
STAT,1883,50,30-34,1933,0.0055925597956500055
STAT,1915,29,40-44,1944,4.459219846993568
STAT,1937,26,15-19,1963,0.6503933267886419
STAT,1941,22,na,1963,3565.1234666961254
STAT,1815,54,50-100,1869,0.03135888223933755
STAT,1868,44,35-39,1912,1.6101315892932055
SIM,1933,32,25-29,1965,12
SIM,1899,32,na,1931,3156
STAT,1839,38,50-100,1877,0.9667471024557384
STAT,1832,32,20-24,1864,2.133564777299205
STAT,1853,48,15-19,1901,2.989145320446867E-4
STAT,1893,17,35-39,1910,0.6573687287244906
STAT,1901,46,20-24,1947,0.008976344747770978
SIM,1859,44,35-39,1903,7
STAT,1872,40,45-49,1912,1.4324921649978575
SIM,1813,84,na,1897,147
SIM,1834,23,30-34,1857,18
STAT,1831,32,50-100,1863,0.7312646782845742
STAT,1915,30,50-100,1945,0.801896671848815
SIM,1880,40,45-49,1920,2
SIM,1918,41,na,1959,3730
SIM,1919,26,na,1945,3897
SIM,1940,29,40-44,1969,5
SIM,1890,22,15-19,1912,4
SIM,1860,23,40-44,1883,1
STAT,1882,22,15-19,1904,3.030864059735815
SIM,1881,39,35-39,1920,8
SIM,1918,21,35-39,1939,11
STAT,1883,29,na,1912,2194.631371700905
SIM,1929,31,20-24,1960,2
STAT,1857,41,30-34,1898,0.8604487439400578
STAT,1916,30,25-29,1946,9.087058394684082
STAT,1922,40,na,1962,4038.2575689393934
SIM,1782,84,na,1866,78
SIM,1893,41,na,1934,2905
SIM,1923,29,40-44,1952,7
STAT,1858,25,35-39,1883,7.4223312337750205
STAT,1874,50,20-24,1924,7.224924934573498E-4
SIM,1839,27,30-34,1866,32
STAT,1871,16,45-49,1887,0.062038389489511674
SIM,1863,44,50-100,1907,3
STAT,1815,44,20-24,1859,0.37071425204009884
SIM,1924,30,25-29,1954,9
STAT,1916,42,25-29,1958,0.06913134581451288
STAT,1893,24,40-44,1917,2.4808323409326514
STAT,1800,99,na,1899,0.7528747102034439
STAT,1841,15,20-24,1856,15.950854558742323
STAT,1901,23,40-44,1924,2.7469930931197912
SIM,1788,75,na,1863,397
SIM,1929,24,15-19,1953,4
SIM,1900,68,na,1968,2305
STAT,1898,18,30-34,1916,2.032295348125864
STAT,1877,41,40-44,1918,2.214116560793545
STAT,1901,41,na,1942,3080.6805062618055
STAT,1841,34,20-24,1875,2.214535995716099
STAT,1876,17,40-44,1893,0.178514262644646
STAT,1757,107,na,1864,0.00870782602085282
SIM,1861,45,50-100,1906,2
STAT,1867,15,40-44,1882,0.16783876726183425
SIM,1818,47,na,1865,1333
STAT,1826,33,40-44,1859,5.565459422247947
STAT,1909,22,50-100,1931,0.577749521767693
SIM,1848,29,30-34,1877,22
STAT,1834,49,na,1883,1441.8108857791888
STAT,1821,61,na,1882,1053.59669809754
STAT,1759,105,na,1864,0.00830979305302207
SIM,1885,22,40-44,1907,1
STAT,1877,44,50-100,1921,1.0212798283572597
SIM,1876,44,35-39,1920,2
SIM,1868,89,na,1957,95
STAT,1912,38,20-24,1950,0.2418604069939804
SIM,1827,33,40-44,1860,10
SIM,1845,24,na,1869,1833
SIM,1899,21,15-19,1920,5
SIM,1927,21,45-49,1948,1
STAT,1856,26,20-24,1882,9.025063731280675
STAT,1926,23,35-39,1949,10.772870686624364
SIM,1885,41,40-44,1926,6
SIM,1859,35,45-49,1894,2
STAT,1880,29,25-29,1909,41.82835260390746
STAT,1773,116,na,1889,1.002825996525285E-4
SIM,1834,33,40-44,1867,1
STAT,1919,21,45-49,1940,1.1674543460529283
SIM,1889,51,na,1940,2598
STAT,1886,24,40-44,1910,2.0664367442627505
STAT,1897,5,na,1902,3310.8685288786164
SIM,1885,34,35-39,1919,6
STAT,1916,49,45-49,1965,0.2093568397203637
STAT,1911,45,45-49,1956,0.19529745034078522
STAT,1831,51,45-49,1882,0.009276515104677056
SIM,1934,23,35-39,1957,14
STAT,1848,107,na,1955,0.0035042272889544276
STAT,1831,69,na,1900,856.8774557258189
STAT,1945,23,45-49,1968,1.1645858598181194
SIM,1818,43,35-39,1861,2
STAT,1882,66,na,1948,1505.7838011957322
STAT,1895,14,na,1909,3170.318017461662
SIM,1839,15,30-34,1854,3
SIM,1823,77,na,1900,404
SIM,1890,35,20-24,1925,1
SIM,1904,16,25-29,1920,14
STAT,1806,62,na,1868,934.9977119498081
SIM,1835,43,35-39,1878,4
SIM,1868,71,na,1939,1148
STAT,1887,1,na,1888,3138.7453753022523
STAT,1852,23,40-44,1875,1.7817940461463262
STAT,1812,84,na,1896,144.50472150103133
SIM,1894,24,40-44,1918,2
STAT,1812,54,20-24,1866,0.0022679072643057847
SIM,1950,20,25-29,1970,111
STAT,1847,24,20-24,1871,61.404801291621546
STAT,1917,21,35-39,1938,9.482552716413307
STAT,1762,92,na,1854,5.0
STAT,1902,1,na,1903,3628.877959085235
STAT,1910,36,20-24,1946,0.23932530126303855
SIM,1869,37,na,1906,2160
STAT,1862,33,45-49,1895,1.4025735615737842
STAT,1882,35,20-24,1917,0.714916488820237
STAT,1853,31,45-49,1884,1.3732214650247294
SIM,1833,32,20-24,1865,1
SIM,1849,37,35-39,1886,15
STAT,1846,43,45-49,1889,1.1092000587506017
STAT,1781,84,na,1865,101.63630959674506
STAT,1925,32,25-29,1957,10.368289583878656
STAT,1841,21,15-19,1862,2.902031431920206
STAT,1849,64,na,1913,1303.5393509481223
STAT,1883,33,20-24,1916,2.4930439115581584
SIM,1925,21,35-39,1946,12
SIM,1844,21,40-44,1865,5
STAT,1842,54,25-29,1896,0.0024945254638645046
SIM,1767,98,na,1865,1
STAT,1862,45,20-24,1907,0.009789254071103464
STAT,1948,6,na,1954,4261.0319907796165
STAT,1812,47,15-19,1859,0.0013392310376859095
STAT,1897,27,20-24,1924,14.821308866337073
STAT,1910,48,20-24,1958,0.009713689934302425
STAT,1857,15,50-100,1872,0.04341224767843001
STAT,1906,27,40-44,1933,4.121607775863217
SIM,1858,96,na,1954,5
STAT,1852,16,35-39,1868,0.4839826503071477
SIM,1943,6,na,1949,3869
SIM,1843,23,40-44,1866,1
SIM,1914,39,40-44,1953,2
STAT,1940,20,50-100,1960,0.6336605279697511
SIM,1908,21,35-39,1929,11
STAT,1936,21,45-49,1957,1.0165329402744745
STAT,1908,11,na,1919,3624.508786328493
STAT,1816,42,20-24,1858,0.4284013829078396
STAT,1841,103,na,1944,0.09894096652881774
SIM,1840,32,20-24,1872,4
SIM,1840,38,35-39,1878,14
SIM,1837,39,50-100,1876,3
SIM,1847,72,na,1919,906
STAT,1880,18,na,1898,2508.749003265196
SIM,1914,27,40-44,1941,7
STAT,1863,74,na,1937,920.0339184523989
SIM,1939,15,35-39,1954,6
STAT,1877,34,35-39,1911,9.83889873932315
STAT,1876,50,30-34,1926,0.005893204945421097
STAT,1850,24,na,1874,1783.1555065731147
STAT,1915,22,20-24,1937,108.58597334061874
SIM,1871,29,25-29,1900,41
STAT,1906,39,40-44,1945,1.2869324655908359
SIM,1889,18,30-34,1907,3
STAT,1821,49,15-19,1870,6.128068464789744E-4
STAT,1827,61,na,1888,1110.4695690532399
STAT,1832,44,20-24,1876,0.1144410180861724
STAT,1898,42,30-34,1940,0.10193738297114503
SIM,1845,46,na,1891,1575
STAT,1835,23,40-44,1858,1.7503106066121006
STAT,1848,54,35-39,1902,0.006221116397618533
STAT,1855,44,25-29,1899,0.4501742685872231
SIM,1861,31,45-49,1892,2
STAT,1848,60,na,1908,1417.1451612241945
STAT,1801,53,25-29,1854,0.009698133994811411
SIM,1900,33,40-44,1933,6
SIM,1844,61,na,1905,1228
SIM,1853,23,40-44,1876,2
STAT,1913,36,50-100,1949,0.3933210072527099
STAT,1847,36,20-24,1883,0.5959268746659886
STAT,1902,20,na,1922,3171.9706816348503
STAT,1842,19,45-49,1861,0.060032867142960994
SIM,1874,19,30-34,1893,1
STAT,1840,22,45-49,1862,0.5819598163402647
STAT,1903,46,30-34,1949,0.07360347914287076
STAT,1913,29,30-34,1942,36.62035489828049
SIM,1906,22,20-24,1928,86
STAT,1842,51,20-24,1893,5.369449951400875E-4
STAT,1920,49,35-39,1969,0.1338478049300095
STAT,1894,69,na,1963,1979.3110709028322
SIM,1900,46,na,1946,3016
SIM,1923,25,25-29,1948,78
SIM,1888,35,50-100,1923,1
STAT,1845,45,45-49,1890,0.16866532868006287
STAT,1901,56,na,1957,2737.250569596858
STAT,1882,29,35-39,1911,8.801261712040255
STAT,1866,19,30-34,1885,1.4087196065017953
SIM,1828,39,30-34,1867,2
SIM,1869,8,na,1877,2529
SIM,1869,34,na,1903,2163
STAT,1856,36,30-34,1892,3.9472206475942366
STAT,1836,40,40-44,1876,1.777744634293132
STAT,1915,25,25-29,1940,63.85381172464648
SIM,1861,19,20-24,1880,17
SIM,1890,29,35-39,1919,14
STAT,1845,23,40-44,1868,1.817431571419993
STAT,1897,33,15-19,1930,0.17915610331256174
SIM,1875,27,35-39,1902,12
STAT,1827,41,45-49,1868,1.4606280855965807
STAT,1922,15,15-19,1937,49.84842427161699
STAT,1923,32,15-19,1955,0.13916876324732805
SIM,1877,88,na,1965,290
STAT,1916,46,40-44,1962,0.1531476603794242
STAT,1898,47,25-29,1945,0.041343733378691544
SIM,1890,16,20-24,1906,27
STAT,1836,24,45-49,1860,0.5874279533115494
STAT,1873,33,20-24,1906,2.5789105750466583
SIM,1823,38,35-39,1861,7
SIM,1899,18,30-34,1917,4
SIM,1881,33,20-24,1914,2
SIM,1859,30,50-100,1889,5
SIM,1878,11,na,1889,2634
STAT,1836,75,na,1911,666.645225387922
SIM,1839,17,20-24,1856,15
SIM,1881,29,25-29,1910,38
STAT,1861,42,na,1903,1813.2140019631522
STAT,1912,19,na,1931,3669.8721691910014
STAT,1873,29,25-29,1902,40.23993081442532
SIM,1919,27,25-29,1946,75
STAT,1852,21,50-100,1873,0.3537493090843908
STAT,1842,30,30-34,1872,15.594811810556731
SIM,1837,43,45-49,1880,2
SIM,1930,15,15-19,1945,44
STAT,1853,19,20-24,1872,15.950073106113267
STAT,1840,31,50-100,1871,0.7400152495007872
SIM,1842,44,30-34,1886,8
SIM,1835,41,45-49,1876,4
STAT,1918,17,15-19,1935,9.362484320385693
SIM,1829,34,20-24,1863,1
SIM,1856,15,30-34,1871,1
STAT,1873,26,20-24,1899,11.278646220071257
STAT,1832,28,25-29,1860,34.2252556600602
SIM,1810,73,na,1883,498
STAT,1858,37,35-39,1895,5.238781897066267
STAT,1810,44,45-49,1854,5.232755168477514
STAT,1834,31,na,1865,1738.991303651366
STAT,1944,21,na,1965,3726.0324614940673
SIM,1840,28,25-29,1868,31
SIM,1850,30,30-34,1880,26
STAT,1894,32,45-49,1926,2.117086398765666
SIM,1868,37,45-49,1905,4
STAT,1846,19,20-24,1865,16.324189273666555
SIM,1888,26,na,1914,2715
STAT,1864,46,25-29,1910,0.04863526787610219
STAT,1923,36,30-34,1959,1.9967893072044365
STAT,1901,38,45-49,1939,0.5661506352266257
SIM,1829,53,na,1882,1253
SIM,1832,76,na,1908,519
SIM,1850,35,25-29,1885,2
SIM,1808,69,na,1877,743
STAT,1834,44,30-34,1878,0.8383732506209519
STAT,1938,24,15-19,1962,4.973688324484818
SIM,1832,57,na,1889,1158
STAT,1871,35,50-100,1906,1.162649421141961
STAT,1904,30,na,1934,3259.578085579125
STAT,1815,76,na,1891,422.8824104358262
STAT,1848,15,30-34,1863,1.48561064933797
STAT,1816,40,30-34,1856,3.3992839431474544
SIM,1844,40,40-44,1884,4
STAT,1842,35,25-29,1877,2.497263917743813
STAT,1848,29,50-100,1877,0.5593331099921806
SIM,1878,44,45-49,1922,2
SIM,1864,39,35-39,1903,16
STAT,1847,49,35-39,1896,0.10108150389151059
STAT,1838,53,20-24,1891,4.874601964060065E-4
SIM,1901,30,50-100,1931,1
STAT,1855,52,45-49,1907,0.01025800767707829
STAT,1829,54,25-29,1883,0.002445938246572485
STAT,1861,64,na,1925,1365.4581836747793
STAT,1941,15,25-29,1956,42.18966207351191
SIM,1868,6,na,1874,2498
SIM,1928,19,15-19,1947,46
STAT,1787,101,na,1888,0.13468403592176997
STAT,1870,41,30-34,1911,1.0702889998824536
STAT,1886,46,45-49,1932,0.23617549979706684
STAT,1861,54,35-39,1915,0.006576346371615818
SIM,1889,73,na,1962,1549
SIM,1834,26,35-39,1860,8
SIM,1858,17,30-34,1875,1
STAT,1896,45,25-29,1941,0.040942947311590365
SIM,1856,29,50-100,1885,3
SIM,1938,33,20-24,1971,5
STAT,1836,97,na,1933,3.4788845055118967
SIM,1833,21,na,1854,1748
STAT,1883,46,35-39,1929,0.13003802850432522
STAT,1883,52,20-24,1935,6.798323336625145E-4
SIM,1921,29,30-34,1950,48
STAT,1903,42,15-19,1945,0.0012874320287233829
SIM,1856,86,na,1942,157
SIM,1885,44,45-49,1929,2
SIM,1859,32,40-44,1891,4
STAT,1887,4,na,1891,2779.806434618574
STAT,1884,49,50-100,1933,0.22443755429901394
SIM,1877,85,na,1962,456
SIM,1812,48,50-100,1860,2
SIM,1901,29,20-24,1930,14
SIM,1878,29,50-100,1907,1
STAT,1883,31,30-34,1914,16.237510316838645
STAT,1783,94,na,1877,3.527328934780517
SIM,1913,19,na,1932,3591
STAT,1833,43,35-39,1876,1.3291222445271362
STAT,1856,32,15-19,1888,0.10625066256994861
STAT,1868,42,45-49,1910,1.347324001655023
SIM,1883,63,na,1946,1582
SIM,1939,17,25-29,1956,50
SIM,1875,24,30-34,1899,21
STAT,1820,53,35-39,1873,0.013603304715621498
STAT,1829,40,40-44,1869,1.979734484673829
STAT,1762,95,na,1857,1.1471162062611597
STAT,1867,24,30-34,1891,15.701969184916011
STAT,1873,52,na,1925,2051.998816717282
STAT,1815,98,na,1913,1.450016495694251
SIM,1833,39,na,1872,1595
SIM,1931,36,30-34,1967,1
STAT,1876,41,na,1917,2265.9879733336065
SIM,1854,19,20-24,1873,21
SIM,1929,29,50-100,1958,1
STAT,1818,87,na,1905,86.52215642587639
STAT,1877,25,45-49,1902,1.0954060175033051
SIM,1841,43,35-39,1884,3
SIM,1885,25,45-49,1910,2
STAT,1877,44,45-49,1921,1.4468130943188138
SIM,1871,78,na,1949,655
STAT,1846,34,na,1880,1860.5728772810796
STAT,1828,39,15-19,1867,0.04903669990900536
STAT,1856,12,na,1868,2080.5880602690663
SIM,1892,49,50-100,1941,1
STAT,1854,39,25-29,1893,2.0392892497813984
STAT,1912,44,15-19,1956,0.00138842416107999
STAT,1883,36,25-29,1919,2.6795861313715177
SIM,1891,31,30-34,1922,25
STAT,1896,31,40-44,1927,5.4329702244075655
SIM,1866,22,30-34,1888,18
STAT,1866,43,30-34,1909,0.9944941640815785
SIM,1926,17,15-19,1943,46
SIM,1891,6,na,1897,3083
STAT,1929,41,15-19,1970,0.001881414673554717
SIM,1791,98,na,1889,1
SIM,1876,42,45-49,1918,2
SIM,1908,63,na,1971,2748
STAT,1842,45,35-39,1887,0.10403431614536893
STAT,1852,26,45-49,1878,0.9443440523867535
SIM,1822,32,45-49,1854,1
SIM,1870,93,na,1963,51
STAT,1897,37,30-34,1934,6.733294669063481
SIM,1921,30,na,1951,4044
SIM,1897,19,35-39,1916,1
SIM,1915,44,40-44,1959,1
STAT,1811,51,35-39,1862,0.027962765465678992
STAT,1837,17,20-24,1854,21.735157143993515
SIM,1922,34,30-34,1956,25
SIM,1845,17,20-24,1862,15
SIM,1854,29,30-34,1883,14
STAT,1846,29,30-34,1875,22.27186919691965
STAT,1881,23,45-49,1904,0.6344137853151403
SIM,1934,18,na,1952,4577
STAT,1889,19,35-39,1908,0.6365028681883158
STAT,1914,34,30-34,1948,14.85414822485293
STAT,1923,46,40-44,1969,0.17466861635688233
STAT,1875,45,30-34,1920,0.09493130243439747
SIM,1882,19,na,1901,2380
STAT,1837,54,50-100,1891,0.009532310297334623
STAT,1830,34,45-49,1864,1.4473286447423346
STAT,1858,22,30-34,1880,15.137368605200908
STAT,1897,40,na,1937,2959.6292895446995
STAT,1906,44,50-100,1950,0.09957682039354797
SIM,1791,80,na,1871,215
SIM,1854,38,na,1892,1879
STAT,1824,72,na,1896,696.3436607589146
STAT,1836,30,30-34,1866,14.591373357458167
STAT,1839,86,na,1925,147.72477283390322
STAT,1840,33,25-29,1873,8.102517860479903
STAT,1947,10,na,1957,4181.450166790256
STAT,1825,35,na,1860,1547.218484769988
STAT,1916,40,35-39,1956,0.19548407762206754
SIM,1860,26,45-49,1886,4
STAT,1808,54,30-34,1862,0.020656365990480537
SIM,1881,56,na,1937,1583
STAT,1847,53,30-34,1900,0.004318975725301999
SIM,1944,8,na,1952,3923
STAT,1893,27,45-49,1920,1.330173847144381
SIM,1874,43,30-34,1917,1
STAT,1864,56,na,1920,1717.3142880504247
STAT,1930,17,30-34,1947,14.886394977481517
SIM,1792,65,na,1857,740
SIM,1819,91,na,1910,24
STAT,1855,30,40-44,1885,3.203741829612696
SIM,1856,64,na,1920,1338
SIM,1920,29,50-100,1949,1
STAT,1912,29,50-100,1941,0.9200379482434728
STAT,1948,3,na,1951,4312.059985648512
STAT,1851,47,35-39,1898,0.1002385085461336
STAT,1870,78,na,1948,724.1089021979379
STAT,1832,47,25-29,1879,0.04115872426140169
STAT,1911,42,40-44,1953,0.22553464004330934
SIM,1881,43,30-34,1924,4
STAT,1834,23,50-100,1857,0.3360334107371297
STAT,1872,19,30-34,1891,1.5022149295446465
STAT,1824,40,50-100,1864,1.462319345594813
STAT,1937,17,25-29,1954,39.826567665496455
STAT,1837,20,na,1857,1839.6037944492662
SIM,1834,36,45-49,1870,1
SIM,1885,31,30-34,1916,19
SIM,1855,39,25-29,1894,2
STAT,1885,55,na,1940,1947.0491849581947
SIM,1821,36,na,1857,1530
STAT,1927,20,50-100,1947,0.7704054629787099
SIM,1842,35,na,1877,1722
SIM,1863,30,40-44,1893,3
STAT,1826,36,45-49,1862,2.2471104101981862
STAT,1812,87,na,1899,76.5307244065533
STAT,1816,45,25-29,1861,0.14042427351558465
SIM,1945,17,25-29,1962,46
SIM,1886,18,20-24,1904,14
SIM,1835,29,20-24,1864,12
STAT,1841,25,30-34,1866,21.87583815475778
SIM,1933,33,na,1966,4847
STAT,1877,31,30-34,1908,17.1793018260684
SIM,1827,36,45-49,1863,2
SIM,1860,5,na,1865,2424
SIM,1863,34,na,1897,1995
STAT,1904,8,na,1912,3522.531764399203
SIM,1849,34,30-34,1883,20
SIM,1849,28,45-49,1877,1
SIM,1891,36,25-29,1927,5
STAT,1805,80,na,1885,275.63634772027353
STAT,1890,36,25-29,1926,3.3413795276497176
STAT,1916,55,na,1971,3448.0155795426826
STAT,1810,58,na,1868,1019.910913386834
STAT,1877,22,40-44,1899,2.041996485550963
STAT,1883,11,na,1894,2395.523803668621
SIM,1914,23,25-29,1937,89
STAT,1886,27,45-49,1913,1.1079830219252664
SIM,1912,34,na,1946,3432
STAT,1901,49,25-29,1950,0.04206740334481686
STAT,1919,38,30-34,1957,1.8478486682369024
STAT,1773,113,na,1886,4.0748241361096056E-4
STAT,1906,23,25-29,1929,78.52107282452437
SIM,1832,40,50-100,1872,1
STAT,1825,57,na,1882,1148.5206450347848
STAT,1827,83,na,1910,229.31228206951675
STAT,1871,35,45-49,1906,1.8877946043491074
STAT,1823,45,25-29,1868,0.07300957186928074
STAT,1862,30,40-44,1892,3.5310026713442184
STAT,1819,36,45-49,1855,6.13096016446538
SIM,1789,79,na,1868,233
STAT,1759,102,na,1861,0.033765524044904925
STAT,1827,29,20-24,1856,17.316972660577296
SIM,1828,29,20-24,1857,9
SIM,1927,38,30-34,1965,2
SIM,1857,49,na,1906,1742
STAT,1774,80,na,1854,184.0
STAT,1852,50,50-100,1902,0.01110663169839183
SIM,1892,17,30-34,1909,3
SIM,1893,49,50-100,1942,1
SIM,1791,95,na,1886,3
SIM,1824,87,na,1911,72
SIM,1857,19,30-34,1876,1
STAT,1848,53,20-24,1901,5.395131052748193E-4
STAT,1837,46,50-100,1883,0.16759588723069985
SIM,1864,1,na,1865,3008
STAT,1886,30,35-39,1916,10.187137089889841
STAT,1895,42,50-100,1937,0.09024153427459924
SIM,1892,33,35-39,1925,16
STAT,1895,36,45-49,1931,2.4669925276882285
STAT,1851,27,45-49,1878,0.935153531879196
STAT,1898,46,40-44,1944,0.12380885428445754
STAT,1866,70,na,1936,1222.528467004805
STAT,1890,44,15-19,1934,0.015734587677680652
SIM,1939,15,40-44,1954,1
STAT,1826,42,na,1868,1479.9349245989222
STAT,1849,39,na,1888,1770.616881848991
SIM,1949,19,15-19,1968,49
STAT,1787,107,na,1894,0.0017380653906318773
STAT,1904,61,na,1965,2735.51798714288
STAT,1917,15,40-44,1932,0.28566968668674575
SIM,1869,99,na,1968,21
STAT,1836,37,20-24,1873,0.6127158673648897
SIM,1871,43,45-49,1914,2
STAT,1941,26,40-44,1967,4.557081159352801
STAT,1853,44,na,1897,1725.5272339860219
SIM,1890,36,35-39,1926,11
STAT,1855,103,na,1958,0.1779744831949603
SIM,1928,29,25-29,1957,91
SIM,1897,39,25-29,1936,1
STAT,1873,43,30-34,1916,1.093556681278528
STAT,1850,40,25-29,1890,0.4572391283937511
STAT,1881,87,na,1968,378.64914893170635
STAT,1815,47,30-34,1862,0.21793012982776633
STAT,1852,53,40-44,1905,0.007509854833786684
STAT,1892,41,15-19,1933,0.016414422026300772
STAT,1924,29,45-49,1953,1.8866443478154928
SIM,1886,31,na,1917,2344
SIM,1943,17,na,1960,3587
STAT,1853,24,45-49,1877,0.6146137032210798
SIM,1945,26,20-24,1971,22
STAT,1870,21,40-44,1891,1.9370237992194215
STAT,1908,51,na,1959,3098.808115540481
STAT,1857,34,na,1891,1762.7252045401838
SIM,1919,18,20-24,1937,148
STAT,1850,24,20-24,1874,57.47163205715375
STAT,1806,52,30-34,1858,0.020954256414584115
STAT,1880,40,40-44,1920,2.2627359654543335
STAT,1884,17,30-34,1901,1.4875913714504787
SIM,1904,6,na,1910,3604
SIM,1795,85,na,1880,72
STAT,1863,43,45-49,1906,1.2317777549816713
SIM,1828,77,na,1905,490
SIM,1820,97,na,1917,1
STAT,1852,21,20-24,1873,59.78008940644846
STAT,1840,37,40-44,1877,3.3977837494658605
SIM,1894,30,35-39,1924,15
SIM,1921,4,na,1925,4377
STAT,1833,27,25-29,1860,34.20995351461748
STAT,1884,33,35-39,1917,9.411913902896654
STAT,1909,39,20-24,1948,0.2333528386256249
STAT,1831,29,na,1860,1645.5489497163994
STAT,1854,17,15-19,1871,5.079327337921353
SIM,1879,39,50-100,1918,2
STAT,1784,73,na,1857,440.9669078387309
STAT,1828,45,45-49,1873,0.19620849085029404
SIM,1862,17,15-19,1879,5
STAT,1864,24,20-24,1888,58.11186255975827
SIM,1851,89,na,1940,75
STAT,1872,30,35-39,1902,9.673312868909957
SIM,1825,42,35-39,1867,2
STAT,1814,57,na,1871,1184.8404239294834
SIM,1951,12,na,1963,4294
SIM,1924,10,na,1934,4491
STAT,1864,36,15-19,1900,0.04750812037093906
STAT,1893,72,na,1965,1781.4003105607617
STAT,1845,100,na,1945,0.7512506475926873
SIM,1872,24,20-24,1896,58
SIM,1925,15,40-44,1940,2
SIM,1836,72,na,1908,792
STAT,1835,24,25-29,1859,47.73863159545028
STAT,1910,16,50-100,1926,0.07030547392227633
SIM,1876,32,40-44,1908,5
STAT,1862,27,20-24,1889,9.510642557012707
SIM,1859,69,na,1928,1148
STAT,1921,22,50-100,1943,0.7020908111243932
STAT,1857,46,25-29,1903,0.043037357883670746
SIM,1947,21,25-29,1968,98
STAT,1815,45,35-39,1860,0.3248157809089694
STAT,1950,19,45-49,1969,0.5576340864613227
SIM,1905,23,15-19,1928,8
STAT,1917,28,na,1945,3698.353125892817
SIM,1890,38,30-34,1928,7
SIM,1935,19,15-19,1954,50
STAT,1903,0,na,1903,3946.8833156973988
SIM,1901,53,na,1954,2820
STAT,1941,30,50-100,1971,0.8209850748275038
STAT,1892,23,15-19,1915,3.8915091795667287
STAT,1841,53,35-39,1894,0.005839892249548354
STAT,1776,78,na,1854,273.00000000000006
STAT,1929,16,15-19,1945,54.84768416967815
STAT,1901,23,35-39,1924,7.692655464099127
SIM,1955,16,35-39,1971,6
STAT,1810,67,na,1877,755.1034913929734
STAT,1909,6,na,1915,3701.137023170325
SIM,1867,64,na,1931,1677
SIM,1887,17,20-24,1904,18
STAT,1903,20,35-39,1923,7.890574091170896
STAT,1939,21,25-29,1960,87.66413635599079
STAT,1817,42,35-39,1859,4.6017328534671265
SIM,1892,15,35-39,1907,2
STAT,1889,39,25-29,1928,3.3240821654374146
SIM,1841,27,25-29,1868,49
STAT,1831,48,25-29,1879,0.040510262870655595
STAT,1952,16,45-49,1968,0.5656775236429513
STAT,1877,22,35-39,1899,5.718389122123587
STAT,1839,45,20-24,1884,0.00835162696415398
SIM,1912,25,na,1937,3466
SIM,1840,42,30-34,1882,4
STAT,1849,37,30-34,1886,4.089455783502493
STAT,1869,46,45-49,1915,0.2165979308389174
STAT,1876,39,15-19,1915,0.054255512467697636
SIM,1855,104,na,1959,1
STAT,1882,38,30-34,1920,4.872079020302929
SIM,1851,32,35-39,1883,10
SIM,1916,15,na,1931,3819
STAT,1836,60,na,1896,1235.0257981128386
STAT,1842,54,50-100,1896,0.010636379483457723
STAT,1835,23,50-100,1858,0.3425265624175809
SIM,1938,30,na,1968,3431
STAT,1866,53,40-44,1919,0.009025683647505183
SIM,1882,41,na,1923,2197
SIM,1870,27,20-24,1897,17
STAT,1896,49,40-44,1945,0.11797455659236471
STAT,1849,19,30-34,1868,1.453906479410051
STAT,1947,16,35-39,1963,4.466774185572475
SIM,1922,37,35-39,1959,9
STAT,1870,16,na,1886,2376.931000208336
STAT,1828,27,15-19,1855,0.783360003183147
STAT,1927,19,15-19,1946,53.02098757608403
STAT,1860,29,50-100,1889,0.4884931004550561
STAT,1897,33,45-49,1930,2.193817091173044
STAT,1849,109,na,1958,9.349374089629249E-4
STAT,1879,28,50-100,1907,0.6303479934198172
STAT,1862,80,na,1942,499.65168913576116
STAT,1939,27,50-100,1966,0.9452929519473254
STAT,1919,30,40-44,1949,4.020586494367287
STAT,1821,98,na,1919,1.7307126364583691
SIM,1869,21,40-44,1890,7
STAT,1882,36,35-39,1918,6.529276855037238
STAT,1920,18,20-24,1938,143.31745464893788
STAT,1832,42,30-34,1874,0.8502176172362089
STAT,1868,32,40-44,1900,3.9088652197286384
STAT,1925,23,na,1948,4116.550917662872
STAT,1854,85,na,1939,196.13907918471375
STAT,1871,4,na,1875,2765.382204665493
SIM,1878,36,na,1914,2392
STAT,1845,49,na,1894,1558.8113821307152
STAT,1854,50,40-44,1904,0.007640618949686354
SIM,1848,38,na,1886,1737
SIM,1832,82,na,1914,250
STAT,1958,10,na,1968,4874.243355174166
SIM,1911,20,35-39,1931,9
STAT,1825,32,15-19,1857,0.24911122616015272
SIM,1920,20,na,1940,3891
STAT,1895,18,15-19,1913,7.289835472812309
SIM,1838,42,45-49,1880,6
STAT,1864,38,40-44,1902,3.6674526061495594
STAT,1915,33,na,1948,3623.5595450318533
STAT,1757,110,na,1867,0.002143021150176001
STAT,1879,35,20-24,1914,0.769511189839509
STAT,1906,9,na,1915,3569.9655537868616
SIM,1882,25,20-24,1907,12
STAT,1881,38,40-44,1919,3.975122631913022
STAT,1867,32,20-24,1899,2.3978240930205805
STAT,1843,16,30-34,1859,1.3839387110247316
SIM,1911,18,20-24,1929,21
STAT,1837,85,na,1922,177.908838875696
SIM,1898,56,na,1954,2548
STAT,1914,37,35-39,1951,2.281470231888526
STAT,1848,38,25-29,1886,2.1819300688150727
STAT,1820,45,45-49,1865,0.40770210868746487
SIM,1879,43,45-49,1922,5
STAT,1881,31,50-100,1912,0.8395887739585525
SIM,1929,23,30-34,1952,36
STAT,1870,49,20-24,1919,0.01088893501660936
STAT,1933,31,30-34,1964,20.06943862505541
STAT,1929,34,15-19,1963,0.15399741747863177
STAT,1878,21,40-44,1899,2.0577465445234964
SIM,1946,23,30-34,1969,37
STAT,1869,28,15-19,1897,0.41376219005142717
STAT,1809,48,15-19,1857,0.0011092635677984652
SIM,1925,33,40-44,1958,8
SIM,1856,38,25-29,1894,1
STAT,1859,27,45-49,1886,0.8492363216402227
STAT,1925,16,50-100,1941,0.42859068642375764
STAT,1823,35,15-19,1858,0.10129844509559374
STAT,1843,32,35-39,1875,8.223346026404577
SIM,1897,15,na,1912,3285
SIM,1813,44,na,1857,1367
STAT,1820,57,na,1877,1138.8583289789367
STAT,1897,15,15-19,1912,7.532441862526893
STAT,1861,46,15-19,1907,3.150866496389294E-4
SIM,1867,27,45-49,1894,1
STAT,1919,23,na,1942,3765.947444875668
STAT,1876,25,25-29,1901,41.56649019132722
STAT,1935,28,50-100,1963,1.2811318783815286
STAT,1860,16,30-34,1876,1.4173789007320678
STAT,1910,47,45-49,1957,0.19156845509658332
STAT,1917,33,40-44,1950,3.8549408086697845
SIM,1868,40,35-39,1908,3
SIM,1884,25,25-29,1909,38
STAT,1854,35,15-19,1889,0.040792512281118506
SIM,1872,38,40-44,1910,7
SIM,1844,36,50-100,1880,3
SIM,1835,31,40-44,1866,3
SIM,1890,76,na,1966,1527
SIM,1893,25,50-100,1918,4
STAT,1866,38,45-49,1904,1.728352107355527
SIM,1888,15,15-19,1903,8
SIM,1909,45,na,1954,3272
STAT,1841,21,45-49,1862,0.6134084216062528
STAT,1872,11,na,1883,2505.3663613419544
STAT,1918,31,35-39,1949,9.211307771509317
SIM,1877,43,40-44,1920,3
SIM,1844,36,na,1880,1693
SIM,1866,23,na,1889,2093
STAT,1905,18,25-29,1923,7.717612668013932
SIM,1946,24,15-19,1970,5
STAT,1890,26,15-19,1916,0.5258091919345363
STAT,1905,37,50-100,1942,0.3618525862435568
SIM,1884,36,na,1920,2315
STAT,1860,32,35-39,1892,7.762494080607054
STAT,1892,28,45-49,1920,1.309142058782946
STAT,1906,56,na,1962,2935.7388945496177
SIM,1838,24,15-19,1862,2
STAT,1814,48,25-29,1862,0.17326379876169937
STAT,1851,54,35-39,1905,0.00602256638207324
SIM,1880,30,35-39,1910,12
STAT,1818,41,40-44,1859,5.486084351579805
STAT,1903,18,20-24,1921,23.767411200701034
STAT,1856,48,30-34,1904,0.07045262668222475
STAT,1857,111,na,1968,7.122156380741323E-4
SIM,1880,74,na,1954,1098
SIM,1904,39,40-44,1943,3
SIM,1937,16,15-19,1953,36
STAT,1824,50,25-29,1874,0.004325421717019218
STAT,1861,67,na,1928,1245.1682262009658
SIM,1841,59,na,1900,1283
SIM,1888,1,na,1889,3130
STAT,1874,43,20-24,1917,0.15218272172647335
SIM,1857,37,30-34,1894,4
STAT,1885,32,40-44,1917,4.083641208467941
STAT,1881,39,25-29,1920,2.6011286958799986
STAT,1891,41,25-29,1932,0.7539371126438775
STAT,1823,93,na,1916,15.640879721137624
STAT,1807,52,20-24,1859,0.0027039629770971383
SIM,1801,59,na,1860,993
SIM,1896,61,na,1957,2381
STAT,1850,42,20-24,1892,0.11181318985522784
SIM,1913,18,25-29,1931,8
STAT,1885,15,25-29,1900,5.360830420456812
STAT,1839,48,25-29,1887,0.03857626052524633
STAT,1921,33,na,1954,3959.277325532738
STAT,1820,45,15-19,1865,6.91019941578832E-4
SIM,1866,40,30-34,1906,6
STAT,1869,43,40-44,1912,2.0436432760814167
STAT,1827,31,40-44,1858,5.4306121391448565
SIM,1862,35,45-49,1897,1
SIM,1874,38,45-49,1912,1
STAT,1825,37,45-49,1862,2.502284829429051
STAT,1899,28,30-34,1927,32.4807824417584
STAT,1891,43,20-24,1934,0.18427683101490747
STAT,1859,29,40-44,1888,2.258429938657367
SIM,1843,24,25-29,1867,50
STAT,1864,28,50-100,1892,0.5367070583804353
SIM,1830,87,na,1917,83
STAT,1844,31,40-44,1875,3.639386691527956
STAT,1930,24,50-100,1954,0.7913161530979357
STAT,1850,95,na,1945,9.372335887483386
SIM,1829,90,na,1919,42
SIM,1823,31,45-49,1854,1
STAT,1776,114,na,1890,2.899120997588076E-4
STAT,1843,14,na,1857,2041.9344043323053
SIM,1845,30,50-100,1875,4
STAT,1805,109,na,1914,2.48353879199445E-4
STAT,1879,47,15-19,1926,3.9370487562080523E-4
SIM,1855,79,na,1934,514
STAT,1899,44,35-39,1943,0.16056972188850077
STAT,1841,15,50-100,1856,0.044079360772708104
STAT,1844,110,na,1954,1.9192334673872588E-4
SIM,1932,29,45-49,1961,3
SIM,1789,85,na,1874,67
STAT,1833,42,20-24,1875,0.11807055202639227
SIM,1831,37,40-44,1868,4
SIM,1926,31,35-39,1957,6
STAT,1794,63,na,1857,853.9320177593202
STAT,1825,29,na,1854,1364.6023051872244
STAT,1910,61,na,1971,2982.9958330058653
STAT,1924,41,30-34,1965,0.1438617176451281
STAT,1899,69,na,1968,2204.035394246716
STAT,1938,23,30-34,1961,26.863630634459465
SIM,1846,34,20-24,1880,1
STAT,1868,77,na,1945,779.1130450689938
STAT,1948,15,40-44,1963,1.51302950654127
STAT,1855,49,25-29,1904,0.04007746536895075
STAT,1946,25,na,1971,3945.6607329112253
STAT,1856,46,35-39,1902,0.1034838700799254
STAT,1875,87,na,1962,304.738672759201
STAT,1924,47,45-49,1971,0.24442933650306065
SIM,1933,27,na,1960,4724
STAT,1868,17,45-49,1885,0.059943958929203685
SIM,1851,16,30-34,1867,1
SIM,1902,28,20-24,1930,18
STAT,1824,52,20-24,1876,8.65980707901529E-4
STAT,1854,35,45-49,1889,1.4481340137611578
SIM,1833,37,45-49,1870,4
SIM,1887,5,na,1892,2717
STAT,1937,26,20-24,1963,16.817313029264835
STAT,1880,37,50-100,1917,1.2227518193954052
STAT,1954,8,na,1962,4589.472037301533
STAT,1838,34,20-24,1872,2.2086582713817564
STAT,1894,22,40-44,1916,2.529847003996971
STAT,1909,23,35-39,1932,8.242047821240467
SIM,1893,15,25-29,1908,10
STAT,1891,25,20-24,1916,13.804523470470537
SIM,1764,93,na,1857,4
STAT,1838,16,20-24,1854,15.814817326038666
SIM,1915,29,45-49,1944,1
STAT,1814,47,40-44,1861,0.5236501298613762
STAT,1880,22,40-44,1902,2.0753378668832227
SIM,1846,16,20-24,1862,17
STAT,1824,34,20-24,1858,5.085208053040842
SIM,1832,34,20-24,1866,1
STAT,1943,23,40-44,1966,3.378346851802866
STAT,1872,49,25-29,1921,0.053440851381154626
SIM,1883,28,45-49,1911,1
STAT,1882,22,45-49,1904,0.6406400421912402
SIM,1822,80,na,1902,303
STAT,1821,36,50-100,1857,2.7301999003128676
STAT,1907,41,30-34,1948,0.11129098098830743
STAT,1922,47,40-44,1969,0.17110734966096625
SIM,1898,38,30-34,1936,1
STAT,1875,28,45-49,1903,1.0743256379645192
SIM,1867,29,40-44,1896,2
SIM,1917,23,35-39,1940,11
SIM,1918,10,na,1928,4101
STAT,1777,91,na,1868,15.491273712359463
STAT,1808,57,na,1865,1094.9867544424492
STAT,1861,46,45-49,1907,0.1859012797569244
STAT,1872,82,na,1954,442.12289952834783
STAT,1907,29,45-49,1936,1.5169097895685753
SIM,1877,30,35-39,1907,9
STAT,1831,48,50-100,1879,0.1727312609587074
SIM,1852,31,40-44,1883,5
STAT,1875,40,30-34,1915,1.1276090439934578
STAT,1885,49,na,1934,2074.3144317450024
SIM,1936,18,20-24,1954,99
STAT,1897,30,40-44,1927,5.522971644125856
STAT,1865,53,20-24,1918,6.217102972706423E-4
SIM,1875,33,35-39,1908,9
SIM,1902,35,na,1937,3196
SIM,1928,26,20-24,1954,22
STAT,1833,24,20-24,1857,56.03806924067005
STAT,1895,4,na,1899,3239.951603060846
SIM,1806,90,na,1896,30
SIM,1871,40,40-44,1911,7
STAT,1930,37,20-24,1967,0.32482035516222546
SIM,1899,33,20-24,1932,6
STAT,1833,40,25-29,1873,0.489807392408381
STAT,1899,26,35-39,1925,12.532459907316026
SIM,1875,45,50-100,1920,4
STAT,1902,37,15-19,1939,0.01615939005583296
STAT,1866,42,na,1908,2011.3531195936623
STAT,1812,50,35-39,1862,0.0286678260698149
STAT,1937,29,25-29,1966,60.55280791579518
SIM,1846,62,na,1908,1311
SIM,1956,15,40-44,1971,1
STAT,1878,51,50-100,1929,0.014940110361889695
SIM,1938,31,25-29,1969,8
STAT,1873,44,15-19,1917,0.013052798559439365
SIM,1867,42,40-44,1909,2
STAT,1894,8,na,1902,3155.977717248751
SIM,1842,42,35-39,1884,1
STAT,1810,53,35-39,1863,0.026915771676056112
STAT,1867,33,35-39,1900,8.94558765726425
STAT,1862,52,na,1914,1729.8950459189175
SIM,1926,29,20-24,1955,22
STAT,1867,49,15-19,1916,3.4742232436563766E-4
STAT,1871,97,na,1968,24.929720870327035
STAT,1922,29,40-44,1951,4.9469454414302705
STAT,1859,42,40-44,1901,1.689127028864407
STAT,1910,29,15-19,1939,0.639418023283655
STAT,1882,40,45-49,1922,1.388860433792652
STAT,1848,85,na,1933,203.69778829853405
STAT,1909,26,45-49,1935,1.5784541865999238
STAT,1926,23,40-44,1949,3.8469162576352773
SIM,1930,29,40-44,1959,6
STAT,1923,28,na,1951,4048.773380283111
STAT,1895,33,40-44,1928,5.318554980402627
STAT,1804,98,na,1902,1.088152517733868
STAT,1867,45,50-100,1912,0.2200384041720693
SIM,1841,24,20-24,1865,58
SIM,1861,21,40-44,1882,2
SIM,1831,23,20-24,1854,60
STAT,1943,26,45-49,1969,1.7389438439125902
STAT,1926,39,20-24,1965,0.3036915244387152
STAT,1928,18,20-24,1946,160.95420019314997
SIM,1833,36,na,1869,1641
STAT,1873,46,35-39,1919,0.13451686322621756
SIM,1851,49,na,1900,1647
STAT,1880,46,na,1926,2247.0566093882967
SIM,1890,33,30-34,1923,30
SIM,1914,20,na,1934,3544
STAT,1863,40,40-44,1903,1.8835039473689252
SIM,1934,23,40-44,1957,4
STAT,1855,16,20-24,1871,15.073282976902314
SIM,1838,67,na,1905,1030
STAT,1882,51,30-34,1933,0.005494864316806655
SIM,1810,95,na,1905,3
SIM,1890,40,45-49,1930,3
STAT,1935,16,45-49,1951,0.646715300183291
SIM,1863,16,20-24,1879,15
SIM,1899,35,40-44,1934,9
SIM,1855,42,45-49,1897,2
STAT,1865,54,35-39,1919,0.007168930813920686
STAT,1919,15,45-49,1934,0.10511486843991114
STAT,1793,78,na,1871,277.3186878015073
SIM,1871,30,50-100,1901,3
STAT,1846,40,35-39,1886,1.3946282354381163
STAT,1854,57,na,1911,1437.8608824254366
STAT,1941,29,45-49,1970,1.6866470125297492
STAT,1899,43,20-24,1942,0.014171944811328977
STAT,1865,36,35-39,1901,6.085452765275075
STAT,1889,39,na,1928,2720.015756785807
SIM,1938,16,35-39,1954,4
STAT,1838,46,15-19,1884,2.7984183358925455E-4
STAT,1841,19,na,1860,2017.0438729823593
STAT,1928,36,20-24,1964,0.3150011953411184
SIM,1873,36,35-39,1909,17
SIM,1918,19,15-19,1937,38
SIM,1847,32,45-49,1879,2
STAT,1827,34,50-100,1861,1.0132179578469915
SIM,1873,64,na,1937,1651
STAT,1851,9,na,1860,2130.781008470465
STAT,1847,42,45-49,1889,1.109788512691652
STAT,1853,21,40-44,1874,1.8767890536176588
STAT,1931,23,na,1954,4460.454465130946
STAT,1824,53,35-39,1877,0.00990411077871064
STAT,1818,110,na,1928,1.3570927925975982E-4
STAT,1832,45,35-39,1877,0.10263838465474671
STAT,1843,54,na,1897,1414.3563435085784
STAT,1889,36,20-24,1925,0.9033332300280253
STAT,1882,33,30-34,1915,15.972819662527558
STAT,1933,19,45-49,1952,0.6283352652852503
SIM,1893,32,40-44,1925,9
STAT,1866,33,15-19,1899,0.12355921263887007
STAT,1868,35,45-49,1903,1.8138780785113957
STAT,1854,53,45-49,1907,0.010216698034438792
SIM,1896,21,na,1917,2983
STAT,1857,43,20-24,1900,0.1174706388297746
STAT,1894,54,na,1948,2542.2370448552715
STAT,1865,35,20-24,1900,0.6663204242098334
SIM,1866,25,35-39,1891,10
SIM,1892,31,na,1923,3160
SIM,1937,17,na,1954,3301
SIM,1826,41,40-44,1867,3
SIM,1888,33,45-49,1921,2
STAT,1871,50,40-44,1921,0.010017614284097347
STAT,1828,45,15-19,1873,3.3255648424564946E-4
STAT,1850,17,50-100,1867,0.042201855969730924
STAT,1935,31,35-39,1966,11.95051338775939
STAT,1950,16,40-44,1966,1.5628600706625169
SIM,1906,20,25-29,1926,86
SIM,1839,23,20-24,1862,62
STAT,1807,50,25-29,1857,0.013513158209603145
SIM,1856,92,na,1948,19
SIM,1905,15,na,1920,3439
STAT,1852,24,25-29,1876,48.59732279894542
SIM,1834,77,na,1911,512
SIM,1868,18,na,1886,2296
SIM,1860,24,25-29,1884,52
SIM,1927,30,na,1957,4342
STAT,1942,24,35-39,1966,9.320251945037208
SIM,1929,26,50-100,1955,1
SIM,1815,79,na,1894,335
STAT,1914,51,na,1965,3398.2442054408502
STAT,1895,36,15-19,1931,0.0694927555232105
SIM,1876,35,45-49,1911,5
SIM,1830,49,50-100,1879,3
STAT,1844,18,40-44,1862,0.16052645550268493
STAT,1900,49,50-100,1949,0.17776503990313153
STAT,1952,7,na,1959,4449.770092763847
SIM,1834,32,35-39,1866,8
SIM,1897,36,20-24,1933,1
STAT,1857,45,40-44,1902,0.12882610478316614
SIM,1887,35,20-24,1922,1
STAT,1828,42,40-44,1870,1.9069725029232223
STAT,1830,75,na,1905,621.327527821962
STAT,1874,41,25-29,1915,0.6226295578279303
SIM,1885,4,na,1889,2535
SIM,1944,22,50-100,1966,2
STAT,1845,80,na,1925,437.7365755732046
SIM,1858,32,20-24,1890,2
STAT,1871,47,15-19,1918,3.734792690427802E-4
SIM,1906,36,40-44,1942,3
STAT,1790,73,na,1863,459.0635100946887
STAT,1835,59,na,1894,1236.9682504522618
STAT,1891,44,35-39,1935,2.0878771333419546
STAT,1893,23,35-39,1916,6.969464114364451
SIM,1809,70,na,1879,650
STAT,1897,46,20-24,1943,0.008576115088132772
STAT,1893,39,15-19,1932,0.06659762791278143
STAT,1830,38,50-100,1868,0.9840541992556476
SIM,1861,4,na,1865,2498
SIM,1910,30,na,1940,3488
STAT,1894,48,50-100,1942,0.16607966934188978
SIM,1840,18,na,1858,1986
STAT,1856,50,45-49,1906,0.010850495395649041
SIM,1836,42,40-44,1878,7
STAT,1834,42,35-39,1876,1.354773808126853
STAT,1847,24,15-19,1871,2.9396108521754885
STAT,1935,13,na,1948,5109.133968156751
STAT,1826,48,15-19,1874,3.643407769233676E-4
STAT,1936,27,15-19,1963,0.6382268098734469
SIM,1858,34,40-44,1892,5
STAT,1936,22,50-100,1958,0.5942675573825833
SIM,1862,100,na,1962,5
STAT,1826,32,35-39,1858,13.880425133849293
STAT,1841,50,30-34,1891,0.004162731336046057
STAT,1887,72,na,1959,1453.7784275567624
SIM,1925,9,na,1934,4514
SIM,1927,30,40-44,1957,6
STAT,1886,40,50-100,1926,1.0648820209946817
STAT,1931,4,na,1935,4990.710232923052
SIM,1906,7,na,1913,3572
STAT,1849,53,35-39,1902,0.006352005504176318
STAT,1850,43,35-39,1893,1.267263935785807
SIM,1814,57,na,1871,1049
STAT,1855,79,na,1934,496.8028424151412
STAT,1910,44,40-44,1954,0.2205783565284484
STAT,1905,15,20-24,1920,24.320685129706423
STAT,1830,46,15-19,1876,3.0362799398130693E-4
STAT,1897,49,30-34,1946,0.06754444853111007
SIM,1908,33,40-44,1941,4
STAT,1860,26,na,1886,1862.264509740652
SIM,1845,20,40-44,1865,3
STAT,1774,106,na,1880,0.009929743381449859
STAT,1841,19,30-34,1860,1.4005599688957844
SIM,1862,9,na,1871,2384
STAT,1891,26,35-39,1917,11.316187881147535
SIM,1822,41,50-100,1863,2
STAT,1833,95,na,1928,8.157159925270637
STAT,1842,52,40-44,1894,0.007583351191736246
STAT,1816,44,40-44,1860,5.550057194477256
SIM,1885,38,20-24,1923,3
SIM,1889,35,50-100,1924,1
STAT,1877,82,na,1959,584.7232742795554
STAT,1878,67,na,1945,1560.679611002833
STAT,1901,41,35-39,1942,0.16703239955193333
STAT,1854,32,40-44,1886,3.1775115730770436
SIM,1839,21,na,1860,1890
SIM,1880,46,na,1926,2287
STAT,1920,48,15-19,1968,3.836073240197493E-4
SIM,1832,35,35-39,1867,10
SIM,1862,0,na,1862,3135
SIM,1762,98,na,1860,3
STAT,1849,21,15-19,1870,3.012568112772024
STAT,1824,35,35-39,1859,12.188627649703767
STAT,1900,21,25-29,1921,75.24712372190479
STAT,1855,70,na,1925,997.0619616593647
STAT,1887,26,15-19,1913,0.48106559459175713
STAT,1853,51,35-39,1904,0.00654647591276509
SIM,1857,74,na,1931,787
STAT,1906,46,40-44,1952,0.13324973510125673
SIM,1913,15,20-24,1928,17
STAT,1887,41,35-39,1928,1.9221164363496515
STAT,1865,22,45-49,1887,0.6043510483489956
STAT,1845,35,50-100,1880,1.0241549087460387
STAT,1883,35,40-44,1918,4.0930077148332895
STAT,1916,43,50-100,1959,0.11355251646991192
STAT,1880,25,15-19,1905,0.4549237304806724
STAT,1855,46,20-24,1901,0.008551731677369603
SIM,1843,82,na,1925,281
SIM,1857,21,15-19,1878,1
STAT,1851,80,na,1931,444.9828863730042
STAT,1916,34,35-39,1950,8.8366027907239
SIM,1883,25,40-44,1908,3
STAT,1851,22,15-19,1873,2.833979738506695
SIM,1840,77,na,1917,537
SIM,1899,47,50-100,1946,1
STAT,1880,25,45-49,1905,1.1132916260249934
SIM,1919,39,25-29,1958,4
STAT,1860,19,35-39,1879,0.4793787105548247
STAT,1848,35,20-24,1883,0.6026531797405388
STAT,1938,26,35-39,1964,14.057944981691547
STAT,1796,98,na,1894,0.6996355272156628
SIM,1824,44,40-44,1868,6
SIM,1900,30,30-34,1930,29
STAT,1852,38,15-19,1890,0.04050935766908355
STAT,1820,42,40-44,1862,4.133391373760072
STAT,1929,13,na,1942,4769.440447549576
STAT,1815,42,30-34,1857,2.910023424781242
SIM,1849,45,50-100,1894,1
SIM,1952,19,20-24,1971,135
STAT,1917,36,45-49,1953,0.6721451318788538
STAT,1849,70,na,1919,1052.120451606902
STAT,1864,16,na,1880,2210.086491047009
STAT,1799,63,na,1862,839.824384970518
STAT,1817,41,20-24,1858,0.42000973522792245
SIM,1831,40,50-100,1871,2
SIM,1779,95,na,1874,2
STAT,1851,40,15-19,1891,0.010034241381506118
SIM,1884,22,20-24,1906,60
SIM,1909,17,20-24,1926,22
SIM,1926,45,na,1971,4256
SIM,1898,34,50-100,1932,2
STAT,1833,45,25-29,1878,0.042471889490897946
STAT,1877,38,20-24,1915,0.7516348426300656
STAT,1884,15,35-39,1899,0.5145010021340716
SIM,1924,34,35-39,1958,12
STAT,1839,32,45-49,1871,1.4287859953339919
STAT,1944,19,20-24,1963,137.73803787715403
STAT,1859,25,25-29,1884,32.82471168239268
STAT,1918,47,15-19,1965,3.70327478424964E-4
STAT,1921,16,15-19,1937,48.9898289654449
STAT,1930,8,na,1938,4871.115929573143
STAT,1841,37,30-34,1878,4.329017679480687
SIM,1863,74,na,1937,888
STAT,1883,82,na,1965,693.1335121195036
SIM,1934,12,na,1946,4949
STAT,1842,60,na,1902,1381.1457434493673
STAT,1885,19,40-44,1904,0.17130585742984786
SIM,1908,51,na,1959,3055
SIM,1843,21,20-24,1864,54
STAT,1834,107,na,1941,0.0029237494641144116
STAT,1842,34,40-44,1876,3.7159133918175518
STAT,1814,45,20-24,1859,0.03795122302627389
STAT,1836,19,20-24,1855,21.89099387902551
STAT,1847,44,na,1891,1681.3197502724386
SIM,1917,26,45-49,1943,1
STAT,1940,27,35-39,1967,14.462981709881236
SIM,1826,28,40-44,1854,3
STAT,1895,39,na,1934,2872.4149175319244
STAT,1858,16,na,1874,1997.816811674066
STAT,1881,36,20-24,1917,0.7068676012281033
SIM,1827,36,na,1863,1564
STAT,1787,78,na,1865,291.5534517822709
STAT,1913,25,20-24,1938,17.299652374069392
SIM,1891,35,40-44,1926,10
STAT,1823,40,50-100,1863,1.4895374939961432
SIM,1868,22,35-39,1890,7
STAT,1904,47,20-24,1951,0.009129614146776753
STAT,1918,29,20-24,1947,18.22086284778733
SIM,1854,40,35-39,1894,1
STAT,1875,43,35-39,1918,1.7456249897760787
SIM,1883,43,35-39,1926,2
STAT,1867,0,na,1867,3353.3566652904683
STAT,1924,44,40-44,1968,0.2801187531313312
SIM,1844,19,20-24,1863,16
STAT,1874,46,25-29,1920,0.0557547172970105
SIM,1850,34,40-44,1884,4
SIM,1935,23,50-100,1958,4
STAT,1861,43,40-44,1904,1.75401444934721
STAT,1837,20,40-44,1857,1.8392671167249326
SIM,1819,69,na,1888,773
SIM,1862,32,40-44,1894,4
STAT,1875,25,40-44,1900,2.9284703233775407
STAT,1830,107,na,1937,0.002846294155706624
STAT,1818,47,na,1865,1376.7524414368297
SIM,1867,25,25-29,1892,45
STAT,1827,34,45-49,1861,1.9283825768384453
SIM,1803,54,na,1857,1097
SIM,1797,80,na,1877,190
STAT,1835,21,20-24,1856,58.72380412238375
STAT,1945,20,40-44,1965,3.4836887271551853
STAT,1913,38,na,1951,3490.1587751978996
SIM,1895,76,na,1971,1535
STAT,1879,50,40-44,1929,0.010560113807243164
STAT,1894,25,45-49,1919,1.35710793390189
SIM,1864,43,30-34,1907,4
SIM,1919,20,35-39,1939,14
STAT,1808,52,35-39,1860,0.031101223873788754
SIM,1821,34,45-49,1855,2
STAT,1863,29,30-34,1892,20.727024012499836
STAT,1917,18,45-49,1935,0.10128696414356213
STAT,1849,50,30-34,1899,0.004527770587037244
STAT,1835,19,na,1854,1927.9174459015558
STAT,1843,31,20-24,1874,2.217838931555889
SIM,1879,40,40-44,1919,6
STAT,1872,33,45-49,1905,1.6454330952394176
STAT,1884,36,na,1920,2209.465638926032
STAT,1880,43,45-49,1923,1.4797886840306649
SIM,1932,26,40-44,1958,6
SIM,1882,28,25-29,1910,44
STAT,1821,106,na,1927,0.006468680826611496
SIM,1892,71,na,1963,2042
STAT,1874,28,25-29,1902,40.68659862076244
STAT,1902,66,na,1968,2472.1972495008417
STAT,1932,36,40-44,1968,1.901828771967136
SIM,1813,42,45-49,1855,1
SIM,1948,20,30-34,1968,33
STAT,1869,46,15-19,1915,3.671148280205262E-4
SIM,1803,85,na,1888,74
SIM,1880,33,45-49,1913,2
STAT,1813,52,45-49,1865,0.03794165437922078
SIM,1845,21,na,1866,1872
SIM,1851,31,20-24,1882,1
SIM,1879,89,na,1968,225
SIM,1940,12,na,1952,3709
STAT,1924,26,40-44,1950,5.144344312025775
SIM,1835,34,45-49,1869,1
STAT,1850,25,35-39,1875,8.120498208529398
SIM,1913,29,40-44,1942,5
SIM,1904,28,25-29,1932,63
STAT,1816,40,25-29,1856,1.8986991471842127
SIM,1769,96,na,1865,1
STAT,1873,32,45-49,1905,1.670781277350291
SIM,1845,39,30-34,1884,1
SIM,1849,27,30-34,1876,33
SIM,1807,75,na,1882,377
STAT,1923,15,35-39,1938,4.676342960216754
STAT,1857,16,25-29,1873,4.99177523756209
SIM,1863,30,35-39,1893,9
STAT,1827,55,na,1882,1272.640253630831
SIM,1953,17,15-19,1970,48
STAT,1888,37,15-19,1925,0.06269366030175384
STAT,1860,44,35-39,1904,1.3692708040619603
SIM,1886,33,40-44,1919,13
SIM,1790,70,na,1860,547
SIM,1819,42,40-44,1861,6
STAT,1773,107,na,1880,0.006727836709806671
SIM,1925,35,na,1960,4233
STAT,1831,60,na,1891,1113.5747546069595
STAT,1856,44,15-19,1900,0.010041522511812456
STAT,1884,49,15-19,1933,3.655331689940229E-4
STAT,1840,35,20-24,1875,0.6108825783680599
SIM,1842,24,40-44,1866,2
STAT,1885,49,50-100,1934,0.2264389682107041
STAT,1945,15,na,1960,3800.4110745942075
SIM,1926,45,50-100,1971,1
STAT,1900,28,45-49,1928,1.4499354024130449
STAT,1878,33,40-44,1911,4.25156907373308
SIM,1880,16,20-24,1896,20
SIM,1921,25,20-24,1946,14
SIM,1794,60,na,1854,862
STAT,1831,100,na,1931,0.6198792543708713
STAT,1911,46,20-24,1957,0.009908433069698942
STAT,1868,19,50-100,1887,0.04442992400612643
STAT,1858,42,20-24,1900,0.11748504884295094
SIM,1849,21,50-100,1870,1
STAT,1956,9,na,1965,4911.537584072746
SIM,1864,84,na,1948,275
STAT,1823,38,25-29,1861,4.421842089358308
SIM,1886,30,50-100,1916,1
SIM,1836,41,na,1877,1566
STAT,1922,43,na,1965,4020.7165442036453
STAT,1947,15,20-24,1962,144.35543803835685
SIM,1873,36,na,1909,2269
SIM,1831,38,25-29,1869,9
STAT,1836,33,50-100,1869,0.7422360720654451
STAT,1919,27,15-19,1946,0.7205904165694131
STAT,1910,1,na,1911,3896.4269347630934
SIM,1815,70,na,1885,710
SIM,1931,15,35-39,1946,9
SIM,1881,32,45-49,1913,2
STAT,1837,50,40-44,1887,0.0071343990333830095
STAT,1805,100,na,1905,0.3705953268850215
SIM,1923,32,25-29,1955,13
STAT,1825,52,35-39,1877,0.008463392170735906
STAT,1870,22,50-100,1892,0.377924363617498
STAT,1945,17,15-19,1962,46.833774579560504
STAT,1883,31,25-29,1914,9.525606265441882
SIM,1865,16,25-29,1881,5
SIM,1892,32,20-24,1924,1
SIM,1858,39,40-44,1897,5
SIM,1840,27,40-44,1867,4
SIM,1899,41,na,1940,3096
SIM,1909,29,20-24,1938,22
SIM,1918,40,40-44,1958,1
STAT,1812,48,20-24,1860,0.039515915402585866
STAT,1874,45,40-44,1919,0.16689368041772218
STAT,1881,24,20-24,1905,62.49628762801925
STAT,1943,17,50-100,1960,0.3753214226960418
SIM,1955,15,20-24,1970,149
STAT,1876,32,na,1908,2329.0510378605104
STAT,1933,5,na,1938,5084.697848164724
STAT,1950,3,na,1953,4430.536941203159
STAT,1909,23,40-44,1932,2.9431772349318406
STAT,1893,0,na,1893,3517.812334497899
STAT,1884,18,45-49,1902,0.06080711395111111
STAT,1931,23,15-19,1954,6.501954019521297
SIM,1824,56,na,1880,1189
SIM,1826,44,45-49,1870,1
SIM,1814,41,45-49,1855,3
SIM,1877,28,20-24,1905,10
SIM,1888,19,30-34,1907,4
STAT,1931,37,40-44,1968,1.8728855867097982
SIM,1903,1,na,1904,3591
STAT,1884,32,20-24,1916,2.522820722624584
STAT,1915,32,25-29,1947,8.892829426456709
STAT,1924,44,35-39,1968,0.22551386949704433
STAT,1834,24,40-44,1858,1.7048016062026847
STAT,1856,43,30-34,1899,0.8412735386205865
SIM,1866,46,50-100,1912,2
SIM,1891,31,25-29,1922,12
SIM,1885,21,na,1906,2282
SIM,1875,17,30-34,1892,1
SIM,1881,68,na,1949,1154
STAT,1802,60,na,1862,979.7604617278489
STAT,1847,42,15-19,1889,0.010240263811834585
SIM,1873,33,na,1906,2262
STAT,1923,27,35-39,1950,16.28370854121049
STAT,1844,39,na,1883,1693.5614725881032
STAT,1886,31,na,1917,2391.0561912407347
SIM,1926,2,na,1928,4626
STAT,1878,51,40-44,1929,0.01041427889178936
STAT,1892,43,35-39,1935,2.1271679760972875
SIM,1949,16,40-44,1965,1
STAT,1896,47,20-24,1943,0.008406208518292062
STAT,1911,28,20-24,1939,16.758394609683222
SIM,1944,25,50-100,1969,5
SIM,1898,36,40-44,1934,7
STAT,1870,25,50-100,1895,0.596864176158799
SIM,1931,27,35-39,1958,24
STAT,1807,54,40-44,1861,0.03705174653197992
SIM,1884,23,35-39,1907,5
STAT,1867,9,na,1876,2427.9147601881773
SIM,1917,23,40-44,1940,3
SIM,1858,37,45-49,1895,2
STAT,1860,50,35-39,1910,0.006693756522320777
SIM,1833,92,na,1925,13
STAT,1872,16,20-24,1888,16.954272528709946
STAT,1891,41,30-34,1932,1.3497906316300876
STAT,1824,50,30-34,1874,0.007269111566715946
STAT,1931,37,50-100,1968,0.5252816102436544
STAT,1783,88,na,1871,38.34514037492499
STAT,1827,52,na,1879,1350.492820313418
STAT,1832,27,40-44,1859,2.454002502192468
STAT,1851,42,35-39,1893,1.300992434696695
STAT,1889,23,45-49,1912,0.8107417186292843
SIM,1819,60,na,1879,1072
SIM,1820,34,50-100,1854,1
STAT,1878,18,15-19,1896,5.827379647857831
STAT,1914,22,30-34,1936,27.7402642114691
SIM,1950,21,30-34,1971,43
STAT,1839,18,30-34,1857,1.3800213410141582
SIM,1949,22,40-44,1971,4
STAT,1840,17,20-24,1857,15.063489420373791
STAT,1837,39,30-34,1876,4.124752896264498
SIM,1900,33,35-39,1933,15
STAT,1798,103,na,1901,0.04076522534854444
STAT,1882,34,15-19,1916,0.12971198550458019
STAT,1855,30,35-39,1885,7.48135253776829
STAT,1897,49,25-29,1946,0.04019173758156284
STAT,1922,18,25-29,1940,47.25453773002105
STAT,1850,43,50-100,1893,0.7393379658872417
STAT,1847,36,15-19,1883,0.0434118969938602
STAT,1905,15,15-19,1920,8.141246303945024
SIM,1929,25,20-24,1954,25
STAT,1884,50,20-24,1934,6.986125803732235E-4
STAT,1848,51,25-29,1899,0.0026445138430440983
SIM,1951,9,na,1960,4295
STAT,1876,44,50-100,1920,1.0171841693157393
SIM,1805,89,na,1894,21
SIM,1897,23,45-49,1920,5
SIM,1896,39,40-44,1935,2
STAT,1903,36,15-19,1939,0.016370168556167998
SIM,1930,18,25-29,1948,75
STAT,1890,29,25-29,1919,48.50750715719108
STAT,1815,43,15-19,1858,0.033516012129887585
STAT,1843,17,45-49,1860,0.0563847144387352
SIM,1855,24,15-19,1879,3
STAT,1820,104,na,1924,0.03513809405592241
SIM,1918,50,na,1968,3655
STAT,1763,104,na,1867,0.016761402734887576
SIM,1967,0,na,1967,4499
STAT,1918,13,na,1931,4067.9109700656036
SIM,1869,27,50-100,1896,1
SIM,1878,27,20-24,1905,11
STAT,1840,23,20-24,1863,57.09898411688034
SIM,1913,15,15-19,1928,4
STAT,1839,40,na,1879,1663.3317066846182
STAT,1838,52,45-49,1890,0.009691285806013056
STAT,1894,24,50-100,1918,0.491978454984009
SIM,1886,21,40-44,1907,2
STAT,1942,21,30-34,1963,28.47799197916467
STAT,1859,45,45-49,1904,0.17921522517906693
STAT,1861,16,45-49,1877,0.05932431736428181
SIM,1872,28,50-100,1900,1
STAT,1887,27,20-24,1914,12.396440385854266
STAT,1936,33,45-49,1969,1.4429672668865139
STAT,1941,22,25-29,1963,90.17706157269991
SIM,1831,97,na,1928,3
SIM,1872,39,25-29,1911,3
STAT,1899,38,na,1937,3058.4013409715963
STAT,1842,49,45-49,1891,0.1673386122847376
SIM,1854,69,na,1923,1155
SIM,1900,1,na,1901,3553
STAT,1815,67,na,1882,825.456807835639
STAT,1916,31,30-34,1947,15.429233543404415
SIM,1932,17,na,1949,4551
STAT,1873,48,30-34,1921,0.09158013070076537
SIM,1935,21,35-39,1956,12
STAT,1838,39,na,1877,1699.3869330857165
STAT,1910,4,na,1914,3765.9020571004758
SIM,1875,68,na,1943,1407
STAT,1906,45,35-39,1951,0.10974067428425777
STAT,1872,30,40-44,1902,4.142405656277531
SIM,1890,16,15-19,1906,8
SIM,1897,71,na,1968,2063
STAT,1859,69,na,1928,1103.4319617702104
STAT,1871,17,20-24,1888,16.73805105348959
SIM,1879,21,na,1900,2382
SIM,1918,22,40-44,1940,3
STAT,1915,20,25-29,1935,87.07472277969384
STAT,1945,21,50-100,1966,0.6814941003079724
STAT,1846,44,20-24,1890,0.11620225639683625
STAT,1841,32,30-34,1873,14.604397953309235
STAT,1833,47,45-49,1880,0.16961448193842463
SIM,1923,39,45-49,1962,3
STAT,1853,49,20-24,1902,0.008891937972190843
STAT,1888,43,45-49,1931,1.6588508944691815
SIM,1889,29,25-29,1918,60
SIM,1890,36,na,1926,2976
STAT,1828,77,na,1905,486.80857613761
STAT,1898,42,25-29,1940,0.056937997928556056
SIM,1905,37,35-39,1942,7
SIM,1839,26,25-29,1865,37
STAT,1869,87,na,1956,178.8277427853444
SIM,1895,27,20-24,1922,16
STAT,1836,36,50-100,1872,0.9860679763443639
STAT,1789,73,na,1862,438.40823700038925
STAT,1927,21,35-39,1948,10.992199097288447
SIM,1858,20,20-24,1878,71
SIM,1866,54,na,1920,1852
STAT,1931,19,40-44,1950,1.7202223846073383
STAT,1832,31,45-49,1863,1.39168785578235
STAT,1861,18,40-44,1879,0.1641571378933772
STAT,1832,31,15-19,1863,0.11365093939352196
SIM,1822,52,na,1874,1284
STAT,1832,43,15-19,1875,0.0100812592023167
STAT,1925,42,50-100,1967,0.13436196653101518
SIM,1860,22,35-39,1882,6
SIM,1887,53,na,1940,2194
STAT,1856,15,50-100,1871,0.04320616366566214
STAT,1877,41,50-100,1918,1.0399380894045658
STAT,1896,29,20-24,1925,14.532546444025112
STAT,1873,50,45-49,1923,0.014104368187485915
STAT,1909,61,na,1970,2937.915998556884
STAT,1850,40,30-34,1890,0.8186055329685245
SIM,1871,25,45-49,1896,2
STAT,1829,44,20-24,1873,0.13131202974424414
STAT,1837,54,na,1891,1358.9444342749607
STAT,1866,50,30-34,1916,0.005261116658521361
STAT,1879,53,45-49,1932,0.014120517550785602
SIM,1889,17,25-29,1906,11
SIM,1866,2,na,1868,2875
STAT,1843,85,na,1928,185.1631959283487
STAT,1811,49,15-19,1860,0.0012891308550477298
STAT,1784,100,na,1884,0.20236978382879017
SIM,1923,20,25-29,1943,112
STAT,1829,38,20-24,1867,0.6863840626158844
STAT,1868,46,na,1914,2033.633758363439
SIM,1905,25,35-39,1930,15
STAT,1796,58,na,1854,990.9999999999999
STAT,1861,23,50-100,1884,0.3267084355056597
STAT,1863,25,45-49,1888,0.9338220315770844
SIM,1857,35,40-44,1892,7
STAT,1896,35,20-24,1931,0.9709110455984407
SIM,1902,66,na,1968,2404
STAT,1910,47,15-19,1957,3.2469202348586756E-4
SIM,1840,45,50-100,1885,2
STAT,1906,49,45-49,1955,0.17934098963199258
STAT,1951,15,na,1966,4142.876908147704
SIM,1853,44,na,1897,1727
SIM,1845,35,45-49,1880,1
SIM,1775,96,na,1871,1
STAT,1852,22,35-39,1874,5.025805768999314
SIM,1854,26,20-24,1880,8
SIM,1840,31,45-49,1871,5
SIM,1867,22,20-24,1889,74
STAT,1891,49,na,1940,2575.1469321035506
STAT,1832,25,15-19,1857,0.3831190514862403
STAT,1900,43,40-44,1943,0.2032147067545501
STAT,1916,19,45-49,1935,0.09958645531314529
STAT,1849,35,40-44,1884,3.4294015069443096
STAT,1821,67,na,1888,842.3920368002541
SIM,1796,95,na,1891,2
SIM,1940,20,25-29,1960,86
SIM,1837,26,20-24,1863,11
STAT,1837,30,50-100,1867,0.7612113978119471
SIM,1901,25,na,1926,3166
STAT,1835,106,na,1941,0.007727893970503757
SIM,1848,28,25-29,1876,35
SIM,1880,30,40-44,1910,4
STAT,1885,25,50-100,1910,0.6064488479185685
STAT,1859,22,20-24,1881,53.75945697293243
STAT,1809,109,na,1918,2.8550320039916834E-4
STAT,1892,40,30-34,1932,1.374071671744483
SIM,1849,25,35-39,1874,11
SIM,1909,31,35-39,1940,8
STAT,1888,25,15-19,1913,0.5099718935325245
STAT,1896,17,20-24,1913,22.119630514802246
SIM,1835,37,50-100,1872,1
STAT,1905,47,40-44,1952,0.1312524655855804
STAT,1898,17,25-29,1915,7.244456754920803
SIM,1891,9,na,1900,3073
STAT,1801,54,50-100,1855,0.04052941491350919
SIM,1924,19,45-49,1943,2
SIM,1937,33,30-34,1970,16
STAT,1841,33,15-19,1874,0.11788817559400941
STAT,1897,44,30-34,1941,0.0995010826273171
STAT,1841,44,50-100,1885,0.7376804113444813
SIM,1837,26,na,1863,1820
STAT,1842,30,25-29,1872,9.148572299102813
SIM,1848,69,na,1917,1056
STAT,1837,35,45-49,1872,1.608262192112049
STAT,1864,39,25-29,1903,2.3998042571191385
STAT,1932,39,45-49,1971,0.8634503979216593
STAT,1855,34,20-24,1889,1.9156386285363793
STAT,1905,29,40-44,1934,4.061190675884552
STAT,1808,88,na,1896,53.08141723259711
STAT,1846,26,20-24,1872,10.602502091036689
SIM,1924,31,30-34,1955,21
STAT,1852,22,na,1874,1841.4620214513152
SIM,1948,23,35-39,1971,17
SIM,1842,41,na,1883,1615
STAT,1817,93,na,1910,13.52673785990811
STAT,1929,33,30-34,1962,18.893322160520803
STAT,1907,17,45-49,1924,0.09064984788058687
SIM,1838,36,na,1874,1722
STAT,1945,24,50-100,1969,0.6808060228805308
STAT,1915,39,45-49,1954,0.6440520202441685
SIM,1863,28,20-24,1891,5
SIM,1885,40,35-39,1925,4
STAT,1857,43,15-19,1900,0.010214838710823116
SIM,1850,30,25-29,1880,14
SIM,1943,28,50-100,1971,5
SIM,1813,75,na,1888,404
STAT,1823,41,45-49,1864,2.052434836193185
STAT,1885,22,50-100,1907,0.38399321666645303
SIM,1848,16,25-29,1864,3
STAT,1876,22,20-24,1898,67.25892475397647
STAT,1873,28,40-44,1901,2.8599903942206986
STAT,1795,73,na,1868,518.7993435645609
STAT,1936,15,45-49,1951,0.45389437407838895
SIM,1829,62,na,1891,1028
SIM,1949,20,15-19,1969,5
STAT,1877,40,35-39,1917,1.7923843043158307
SIM,1782,75,na,1857,387
SIM,1849,43,35-39,1892,2
SIM,1881,28,40-44,1909,2
STAT,1821,33,50-100,1854,2.8726204329549345
STAT,1888,43,15-19,1931,0.015306583722570894
STAT,1806,93,na,1899,10.134883067862694
STAT,1874,46,na,1920,2177.7645387581
STAT,1898,48,30-34,1946,0.06892876678120656
SIM,1830,28,30-34,1858,23
STAT,1873,21,na,1894,2272.828508036951
SIM,1897,46,na,1943,2924
STAT,1928,8,na,1936,4747.451873580292
STAT,1932,20,25-29,1952,115.17593901715973
SIM,1861,48,na,1909,1924
SIM,1865,69,na,1934,1251
SIM,1880,19,25-29,1899,7
SIM,1869,28,na,1897,2170
SIM,1825,29,35-39,1854,14
STAT,1905,46,na,1951,3081.4401717452643
STAT,1840,38,25-29,1878,2.2117249374348362
STAT,1904,21,na,1925,3214.4497424820843
SIM,1806,100,na,1906,2
SIM,1891,21,na,1912,2815
SIM,1874,18,25-29,1892,5
STAT,1834,27,45-49,1861,0.9035383527062686
STAT,1827,28,15-19,1855,0.8354588444873594
STAT,1844,95,na,1939,9.234066302088607
STAT,1883,33,15-19,1916,0.13134327365029844
STAT,1819,37,20-24,1856,2.1391053717873416
STAT,1890,33,50-100,1923,1.0537665532421665
SIM,1906,25,na,1931,3274
STAT,1876,29,40-44,1905,2.902788620205209
STAT,1874,48,45-49,1922,0.2249304993767303
STAT,1817,46,50-100,1863,0.5624302943937479
SIM,1864,39,50-100,1903,1
STAT,1890,26,20-24,1916,13.595923282437822
STAT,1878,36,45-49,1914,1.9720749666962847
STAT,1869,31,40-44,1900,3.9851366928321226
SIM,1901,22,na,1923,3136
STAT,1912,23,50-100,1935,0.5939003391056097
SIM,1842,27,45-49,1869,4
STAT,1934,18,50-100,1952,0.4774772066544708
STAT,1837,17,15-19,1854,7.275751765235627
STAT,1863,25,15-19,1888,0.38158717112325635
SIM,1944,15,15-19,1959,46
STAT,1775,96,na,1871,1.3791269804347177
STAT,1762,111,na,1873,5.773392070388527E-4
SIM,1885,22,35-39,1907,6
SIM,1899,34,35-39,1933,17
STAT,1936,15,15-19,1951,41.23631222943109
STAT,1868,47,45-49,1915,0.21172504267280068
STAT,1855,28,20-24,1883,8.62720957534632
STAT,1834,54,35-39,1888,0.005265470492774639
STAT,1897,34,na,1931,2989.0116238701976
SIM,1908,18,15-19,1926,7
STAT,1829,26,20-24,1855,20.89800745830707
SIM,1871,29,30-34,1900,29
SIM,1817,38,40-44,1855,2
STAT,1940,15,35-39,1955,4.027002462145632
SIM,1855,70,na,1925,1053
SIM,1877,31,40-44,1908,8
SIM,1853,27,20-24,1880,2
STAT,1856,80,na,1936,455.9535920987318
STAT,1823,37,40-44,1860,7.123280056878916
STAT,1850,22,30-34,1872,15.07072406746273
STAT,1866,18,25-29,1884,5.038134682250601
SIM,1939,17,30-34,1956,14
STAT,1838,40,50-100,1878,0.8509985903672715
SIM,1851,18,na,1869,2054
STAT,1816,42,15-19,1858,0.03725229617792789
STAT,1844,16,45-49,1860,0.05801223458092924
STAT,1890,28,40-44,1918,3.4475955030078116
STAT,1832,47,30-34,1879,0.06916952338372372
SIM,1787,81,na,1868,154
STAT,1894,19,15-19,1913,7.166200119871501
STAT,1820,107,na,1927,0.0024844006749024654
SIM,1919,35,na,1954,3907
STAT,1845,40,na,1885,1708.6861183118183
STAT,1940,31,na,1971,3699.925201724336
SIM,1843,28,40-44,1871,2
STAT,1823,35,20-24,1858,1.3905512077225999
STAT,1804,67,na,1871,763.2619906489248
STAT,1862,21,na,1883,1969.6886299779778
STAT,1876,72,na,1948,1232.5914879063864
STAT,1904,16,15-19,1920,8.061401438616038
STAT,1913,28,25-29,1941,61.740867818870655
STAT,1842,36,30-34,1878,4.574843531244803
STAT,1900,25,40-44,1925,3.9523331164524484
SIM,1833,67,na,1900,937
STAT,1837,53,45-49,1890,0.00926749280560281
SIM,1825,46,50-100,1871,1
STAT,1845,27,20-24,1872,10.104422847408856
STAT,1854,39,30-34,1893,3.7748545894658334
STAT,1883,47,40-44,1930,0.15782847750424742
STAT,1921,22,45-49,1943,1.2005752412773583
SIM,1912,16,15-19,1928,9
SIM,1921,28,25-29,1949,70
SIM,1888,44,30-34,1932,1
SIM,1908,21,40-44,1929,3
SIM,1823,74,na,1897,565
STAT,1838,34,15-19,1872,0.11636072930491657
STAT,1946,16,15-19,1962,47.56652043673484
STAT,1873,32,15-19,1905,0.1364428531175355
STAT,1835,22,35-39,1857,4.937002210371832
SIM,1844,21,35-39,1865,7
SIM,1882,72,na,1954,1132
SIM,1842,44,na,1886,1555
STAT,1938,25,20-24,1963,17.09924509838315
SIM,1830,56,na,1886,1230
SIM,1864,28,na,1892,2075
SIM,1820,35,45-49,1855,1
STAT,1911,15,45-49,1926,0.0948765674096725
SIM,1850,36,30-34,1886,5
SIM,1945,12,na,1957,3888
STAT,1895,21,40-44,1916,2.574164489152279
SIM,1922,23,15-19,1945,6
STAT,1800,110,na,1910,1.0985351885236113E-4
SIM,1898,39,45-49,1937,3
STAT,1867,15,35-39,1882,0.5035162726325094
STAT,1939,12,na,1951,3738.679702335798
STAT,1878,54,45-49,1932,0.013894866310111293
SIM,1845,17,15-19,1862,5
SIM,1889,9,na,1898,3146
SIM,1874,35,50-100,1909,2
SIM,1843,22,35-39,1865,6
STAT,1828,49,30-34,1877,0.07633716626873015
STAT,1842,32,15-19,1874,0.12458252598109122
STAT,1925,43,40-44,1968,0.28561605660573486
STAT,1866,35,50-100,1901,1.0799180697464716
SIM,1899,21,20-24,1920,103
STAT,1861,36,na,1897,1859.4967653636518
SIM,1836,30,40-44,1866,3
STAT,1897,31,na,1928,3027.143813089993
SIM,1848,66,na,1914,1179
STAT,1914,23,15-19,1937,5.121915798527327
STAT,1845,18,na,1863,2040.9079944331318
STAT,1849,6,na,1855,2302.73373
SIM,1934,29,50-100,1963,2
STAT,1858,47,na,1905,1658.6464663022068
STAT,1926,29,50-100,1955,1.1191147558078611
SIM,1901,9,na,1910,3423
STAT,1788,109,na,1897,1.9193957277381494E-4
STAT,1881,20,35-39,1901,5.357271992122693
STAT,1933,34,35-39,1967,11.619013887145524
STAT,1837,35,15-19,1872,0.04530316572883816
STAT,1836,21,35-39,1857,5.023270279588298
STAT,1850,27,25-29,1877,35.091309817523445
SIM,1954,16,15-19,1970,47
SIM,1906,32,25-29,1938,13
STAT,1901,20,30-34,1921,23.69446338062708
STAT,1870,24,45-49,1894,0.642204995854928
STAT,1879,49,40-44,1928,0.16576033851069538
SIM,1918,25,45-49,1943,1
STAT,1851,18,na,1869,1995.7448345909422
STAT,1914,25,35-39,1939,14.395481632795498
STAT,1879,47,20-24,1926,0.011811156658110847
STAT,1903,48,15-19,1951,2.9947447862003546E-4
SIM,1913,10,na,1923,3702
STAT,1869,90,na,1959,113.18407393043007
STAT,1872,19,25-29,1891,5.34086659610113
STAT,1858,27,30-34,1885,19.093729735080675
STAT,1875,42,20-24,1917,0.15401992661996883
STAT,1782,78,na,1860,253.11873397639098
SIM,1922,25,35-39,1947,21
STAT,1891,23,30-34,1914,20.75433264045664
STAT,1891,43,50-100,1934,1.2258415046878888
SIM,1888,21,45-49,1909,5
STAT,1881,18,20-24,1899,16.13678356981048
SIM,1886,36,45-49,1922,6
SIM,1866,27,30-34,1893,30
STAT,1944,21,35-39,1965,9.60732603549094
STAT,1812,93,na,1905,12.695144739394896
STAT,1808,51,20-24,1859,0.00271998308621206
SIM,1877,54,na,1931,2006
STAT,1923,45,35-39,1968,0.1431528534741472
STAT,1824,32,30-34,1856,42.51949126061461
SIM,1862,20,40-44,1882,2
STAT,1927,19,20-24,1946,158.39181078198763
SIM,1832,32,30-34,1864,14
SIM,1939,12,na,1951,3699
STAT,1866,53,35-39,1919,0.007380816083906087
SIM,1867,24,40-44,1891,6
STAT,1882,44,50-100,1926,0.9574775912579487
STAT,1922,15,20-24,1937,148.91427991001106
SIM,1908,36,45-49,1944,1
STAT,1846,47,25-29,1893,0.04252296611487945
STAT,1882,72,na,1954,1160.2409518814734
SIM,1858,28,na,1886,1990
SIM,1886,18,15-19,1904,5
STAT,1841,35,35-39,1876,5.865628849851833
STAT,1864,24,15-19,1888,2.7819691331548118
STAT,1827,46,45-49,1873,0.21874745180063396
STAT,1822,42,45-49,1864,2.178280821218638
STAT,1816,46,30-34,1862,0.23226738060879537
STAT,1956,15,na,1971,4602.907168697788
STAT,1927,0,na,1927,5291.699969430816
STAT,1917,49,20-24,1966,0.01084078474063405
SIM,1857,38,45-49,1895,1
STAT,1850,45,25-29,1895,0.04100838692156407
STAT,1870,47,na,1917,2075.3446467314247
SIM,1817,74,na,1891,501
STAT,1898,44,15-19,1942,0.0012094340782581963
SIM,1852,34,45-49,1886,2
SIM,1903,32,45-49,1935,3
SIM,1794,63,na,1857,768
SIM,1946,25,20-24,1971,18
SIM,1832,37,25-29,1869,4
STAT,1912,28,na,1940,3475.352980956635
STAT,1864,87,na,1951,148.33924853098097
STAT,1842,46,40-44,1888,0.12559960708394954
STAT,1839,20,45-49,1859,0.6051983744128494
SIM,1872,24,15-19,1896,2
STAT,1883,37,30-34,1920,4.936326186688675
STAT,1901,35,35-39,1936,2.037896092507133
STAT,1843,48,15-19,1891,2.6678365052093165E-4
SIM,1930,15,20-24,1945,153
STAT,1859,24,40-44,1883,1.6023442137592045
STAT,1924,13,na,1937,4450.4376388561295
STAT,1919,19,50-100,1938,0.38902979641226915
SIM,1891,37,30-34,1928,7
STAT,1864,47,na,1911,1885.4711120487589
SIM,1923,36,40-44,1959,1
STAT,1824,37,25-29,1861,4.516431119611582
SIM,1769,93,na,1862,2
STAT,1920,36,15-19,1956,0.019880533395127752
STAT,1818,44,45-49,1862,3.2992327757069226
STAT,1828,30,40-44,1858,4.851290993561161
SIM,1905,22,30-34,1927,29
STAT,1844,34,45-49,1878,1.4185367369527815
STAT,1873,26,15-19,1899,0.4361907412901953
STAT,1945,12,na,1957,4053.692374574783
SIM,1878,41,35-39,1919,2
SIM,1918,25,15-19,1943,2
STAT,1870,87,na,1957,199.1917226329003
SIM,1861,1,na,1862,2929
STAT,1933,27,na,1960,4699.015811739388
SIM,1907,10,na,1917,3599
STAT,1906,42,30-34,1948,0.10971048360250925
SIM,1876,29,45-49,1905,1
SIM,1901,44,40-44,1945,4
STAT,1901,39,20-24,1940,0.2177981768669577
STAT,1860,31,20-24,1891,2.080387859065379
SIM,1888,35,na,1923,2681
SIM,1923,5,na,1928,4510
STAT,1936,30,40-44,1966,3.5948067545612172
STAT,1870,51,35-39,1921,0.008016717055925902
STAT,1891,28,25-29,1919,49.26707430088853
STAT,1835,28,40-44,1863,2.466981725200413
STAT,1888,40,40-44,1928,2.5365389131220915
STAT,1837,32,40-44,1869,3.5288666404262377
SIM,1945,4,na,1949,3944
SIM,1845,32,40-44,1877,4
SIM,1804,64,na,1868,831
SIM,1861,36,45-49,1897,1
SIM,1828,39,25-29,1867,2
STAT,1860,17,45-49,1877,0.057747141497393906
STAT,1885,46,na,1931,2124.563051360721
SIM,1858,35,25-29,1893,5
STAT,1900,46,45-49,1946,0.17495446529784883
STAT,1838,48,40-44,1886,0.11674240949956315
SIM,1934,26,45-49,1960,3
STAT,1885,35,45-49,1920,1.894981497740157
STAT,1896,31,35-39,1927,12.68702902346686
STAT,1878,36,15-19,1914,0.05555141411899231
STAT,1901,43,50-100,1944,0.09630911072323044
STAT,1865,38,25-29,1903,2.453130986565854
SIM,1871,69,na,1940,1338
SIM,1926,17,20-24,1943,156
STAT,1875,15,30-34,1890,1.554861320151482
STAT,1893,13,na,1906,3089.1217817202382
SIM,1870,84,na,1954,284
STAT,1764,103,na,1867,0.032747683872671345
STAT,1833,55,na,1888,1282.7783624015842
STAT,1891,46,25-29,1937,0.03808291931131964
STAT,1915,36,40-44,1951,1.4355305229015074
STAT,1897,47,35-39,1944,0.09930626342126592
SIM,1861,18,15-19,1879,8
STAT,1827,28,45-49,1855,2.0445390581703444
STAT,1853,18,15-19,1871,5.370853722545099
SIM,1854,29,25-29,1883,32
STAT,1817,37,na,1854,1431.5689949325044
SIM,1845,18,na,1863,2018
STAT,1769,96,na,1865,1.1512325851735872
STAT,1894,19,45-49,1913,0.07887945701429727
STAT,1846,29,25-29,1875,37.41305151942806
STAT,1870,49,50-100,1919,0.22286019451632003
SIM,1824,49,50-100,1873,1
SIM,1893,35,45-49,1928,2
STAT,1864,36,20-24,1900,0.6521568430403633
STAT,1929,36,35-39,1965,2.9360967645012175
STAT,1834,41,20-24,1875,0.12034919716188713
STAT,1809,106,na,1915,0.004872364527801447
SIM,1822,33,20-24,1855,2
SIM,1840,29,30-34,1869,23
STAT,1906,28,na,1934,3272.068046721962
STAT,1816,52,na,1868,1285.2296486128712
STAT,1863,22,40-44,1885,1.761941041438772
SIM,1830,42,45-49,1872,4
SIM,1894,28,20-24,1922,18
STAT,1832,29,30-34,1861,20.14581267804691
STAT,1928,39,25-29,1967,1.1729876252340108
SIM,1873,33,30-34,1906,25
STAT,1928,20,35-39,1948,11.172042320127343
SIM,1841,44,40-44,1885,5
STAT,1926,26,45-49,1952,1.963125037651495
STAT,1949,15,25-29,1964,47.63970217211594
SIM,1935,19,20-24,1954,156
SIM,1871,22,40-44,1893,5
STAT,1918,17,20-24,1935,27.968940465242504
SIM,1805,49,na,1854,1222
STAT,1841,59,na,1900,1339.8473582153238
STAT,1854,20,40-44,1874,1.777224389195197
STAT,1930,13,na,1943,4831.69047653593
SIM,1830,24,15-19,1854,2
STAT,1843,19,35-39,1862,0.4680687390191036
SIM,1859,32,35-39,1891,8
STAT,1894,37,45-49,1931,2.42019146772074
SIM,1877,94,na,1971,77
SIM,1884,29,40-44,1913,4
SIM,1904,25,20-24,1929,23
STAT,1829,40,35-39,1869,1.593815405876144
STAT,1848,22,45-49,1870,0.6309011460056346
STAT,1849,38,45-49,1887,1.5138277474072352
STAT,1907,44,35-39,1951,0.17214661956281863
STAT,1822,52,na,1874,1225.9976795356088
SIM,1810,64,na,1874,870
STAT,1883,18,50-100,1901,0.045258045398282286
STAT,1851,40,na,1891,1679.3500223744759
SIM,1936,20,35-39,1956,9
STAT,1865,38,50-100,1903,1.046060283914848
SIM,1892,15,40-44,1907,1
STAT,1886,28,20-24,1914,11.665728719147937
STAT,1865,51,30-34,1916,0.005121353864130437
STAT,1857,47,30-34,1904,0.07178566808145447
STAT,1816,49,50-100,1865,0.5618634684011139
STAT,1927,27,na,1954,4302.28434029603
STAT,1910,32,40-44,1942,3.5647080372387654
STAT,1877,57,na,1934,1969.3070511467442
STAT,1948,18,45-49,1966,0.5399083665465737
SIM,1801,90,na,1891,25
SIM,1894,35,na,1929,2999
STAT,1921,47,20-24,1968,0.011769062305085181
STAT,1834,29,50-100,1863,0.5131179986706413
STAT,1811,52,40-44,1863,0.03351603743150469
SIM,1812,90,na,1902,25
STAT,1875,34,50-100,1909,0.8820707231692875
STAT,1885,17,45-49,1902,0.06151051678204177
STAT,1833,44,40-44,1877,1.6299321739280501
SIM,1841,15,25-29,1856,4
SIM,1888,34,20-24,1922,2
STAT,1838,28,20-24,1866,9.946843547367619
STAT,1826,54,45-49,1880,0.012421407128028248
STAT,1825,97,na,1922,2.855269811543513
SIM,1890,73,na,1963,1743
STAT,1823,43,50-100,1866,1.3711932281210237
STAT,1898,39,50-100,1937,0.3353683364798002
SIM,1876,44,40-44,1920,5
STAT,1817,54,35-39,1871,0.01786818329782724
STAT,1855,15,45-49,1870,0.05586804564153455
STAT,1862,45,15-19,1907,3.263081820049873E-4
STAT,1878,30,50-100,1908,0.9093135290933769
SIM,1923,17,35-39,1940,10
STAT,1826,38,40-44,1864,4.623869968614547
STAT,1835,20,50-100,1855,0.4719294145959765
SIM,1907,41,na,1948,3250
STAT,1907,39,50-100,1946,0.36404316638200995
SIM,1864,28,40-44,1892,2
STAT,1953,15,15-19,1968,51.889323478084584
STAT,1849,25,30-34,1874,22.70907604249441
SIM,1860,41,40-44,1901,3
STAT,1906,17,25-29,1923,7.796873245655176
SIM,1896,21,35-39,1917,6
STAT,1767,92,na,1859,9.137864774800727
STAT,1847,28,30-34,1875,22.159116036041866
STAT,1801,103,na,1904,0.050733185696177095
STAT,1921,28,15-19,1949,0.7406546314738602
STAT,1782,111,na,1893,2.6005533307237104E-4
STAT,1853,18,45-49,1871,0.0591178055665533
STAT,1893,29,40-44,1922,3.5631187992737128
STAT,1902,40,35-39,1942,0.16934099439987227
STAT,1915,24,40-44,1939,3.262919299305662
SIM,1853,41,35-39,1894,3
SIM,1844,39,na,1883,1618
SIM,1903,51,na,1954,2907
STAT,1887,41,na,1928,2453.301372938504
STAT,1890,39,na,1929,2693.6867048963445
STAT,1863,37,na,1900,1953.1458133088295
SIM,1838,30,45-49,1868,5
STAT,1893,45,45-49,1938,0.16107582424545058
STAT,1915,17,35-39,1932,0.8296760414387242
STAT,1786,99,na,1885,0.33194907023423953
STAT,1856,28,40-44,1884,2.271528334195957
SIM,1840,49,na,1889,1464
SIM,1897,34,30-34,1931,29
STAT,1808,54,25-29,1862,0.012291391214715841
STAT,1888,21,35-39,1909,6.534680700416523
STAT,1878,48,15-19,1926,3.888596984943927E-4
STAT,1894,29,na,1923,2876.6493063829384
STAT,1897,21,45-49,1918,0.883643555915266
STAT,1906,6,na,1912,3594.3523538750283
SIM,1901,17,15-19,1918,9
STAT,1887,48,25-29,1935,0.0601002440689294
STAT,1839,18,na,1857,1987.4647657337352
SIM,1876,42,50-100,1918,1
SIM,1821,38,30-34,1859,2
STAT,1924,17,45-49,1941,0.5619571975360559
SIM,1883,21,25-29,1904,63
SIM,1938,33,na,1971,3436
STAT,1911,24,40-44,1935,2.993736566230777
SIM,1882,78,na,1960,839
STAT,1892,40,50-100,1932,1.26266045234577
STAT,1906,24,30-34,1930,24.354563911197864
STAT,1788,100,na,1888,0.20140177248727376
STAT,1901,40,50-100,1941,0.09798875330067759
SIM,1874,15,20-24,1889,12
STAT,1843,51,40-44,1894,0.007144888891937229
STAT,1833,22,30-34,1855,14.714457414489287
STAT,1883,51,na,1934,2003.8346317189596
STAT,1930,35,30-34,1965,2.249668086069469
STAT,1794,94,na,1888,4.315618249212047
STAT,1866,15,20-24,1881,16.043783955266598
SIM,1932,17,45-49,1949,1
SIM,1836,33,45-49,1869,1
SIM,1837,51,na,1888,1416
STAT,1864,42,15-19,1906,0.011613171507250619
STAT,1884,45,35-39,1929,0.13196757343457735
SIM,1848,25,20-24,1873,13
SIM,1852,34,na,1886,1842
STAT,1909,27,20-24,1936,16.48099405226343
SIM,1883,15,30-34,1898,3
STAT,1917,21,40-44,1938,3.3861527971319534
SIM,1872,18,20-24,1890,13
SIM,1917,27,20-24,1944,19
SIM,1893,16,na,1909,3162
SIM,1825,32,na,1857,1650
STAT,1852,99,na,1951,1.3730275698013847
SIM,1899,31,30-34,1930,30
STAT,1871,29,20-24,1900,10.926295059292945
SIM,1875,90,na,1965,207
SIM,1914,24,30-34,1938,36
STAT,1866,47,40-44,1913,0.1484747705035758
STAT,1915,46,50-100,1961,0.2158472358477606
SIM,1878,23,40-44,1901,1
SIM,1925,21,40-44,1946,7
SIM,1897,27,25-29,1924,57
STAT,1895,70,na,1965,1977.0725771246302
STAT,1927,25,15-19,1952,0.8162554975529103
SIM,1862,39,30-34,1901,4
STAT,1843,44,35-39,1887,1.227469739693461
SIM,1860,28,40-44,1888,5
STAT,1864,18,20-24,1882,15.35062015099171
STAT,1837,54,20-24,1891,4.6574807857054074E-4
SIM,1880,43,na,1923,2311
STAT,1852,28,40-44,1880,2.511356174903214
STAT,1837,82,na,1919,302.80449765254724
STAT,1845,49,30-34,1894,0.06706827596303279
STAT,1862,83,na,1945,320.653753836635
STAT,1936,25,50-100,1961,0.9006435328977799
STAT,1851,39,45-49,1890,1.4195680483847029
STAT,1868,74,na,1942,1000.2991797834221
SIM,1855,76,na,1931,693
SIM,1824,84,na,1908,140
SIM,1926,14,na,1940,4502
SIM,1799,100,na,1899,1
SIM,1841,22,30-34,1863,14
SIM,1855,20,35-39,1875,7
SIM,1808,60,na,1868,1031
STAT,1948,17,30-34,1965,13.177983776906775
STAT,1823,41,15-19,1864,0.018938269714328264
STAT,1875,45,25-29,1920,0.056488047185135164
STAT,1883,15,50-100,1898,0.0455877608109687
STAT,1857,31,15-19,1888,0.1078717705336743
STAT,1913,35,na,1948,3540.8679409878305
SIM,1877,34,45-49,1911,2
SIM,1857,25,30-34,1882,23
SIM,1948,4,na,1952,4272
STAT,1890,32,15-19,1922,0.16447599536562332
STAT,1913,38,35-39,1951,2.2438502335850212
STAT,1856,26,15-19,1882,0.3490356167155053
STAT,1876,50,25-29,1926,0.003506700429593992
SIM,1937,22,45-49,1959,1
SIM,1921,38,35-39,1959,6
STAT,1927,43,45-49,1970,0.1968683630679435
SIM,1904,9,na,1913,3577
SIM,1847,33,20-24,1880,1
STAT,1831,36,25-29,1867,2.2340409856716823
STAT,1930,28,25-29,1958,79.02508368528194
STAT,1863,54,50-100,1917,0.012176136642413696
SIM,1939,27,40-44,1966,5
STAT,1939,33,25-29,1972,8.903403968169176
STAT,1868,44,40-44,1912,2.000001393156409
SIM,1863,71,na,1934,1060
STAT,1831,91,na,1922,33.834895976281906
STAT,1829,87,na,1916,106.45469398165191
STAT,1869,34,45-49,1903,1.5822639768883493
STAT,1921,30,na,1951,4008.0163884946005
STAT,1931,7,na,1938,4942.653412702731
SIM,1907,21,20-24,1928,92
STAT,1920,17,45-49,1937,0.5294543252071913
SIM,1849,30,20-24,1879,2
STAT,1858,23,15-19,1881,2.532959134581559
STAT,1845,41,35-39,1886,1.3216821422286382
STAT,1847,20,35-39,1867,5.351787787438427
STAT,1837,47,15-19,1884,2.694824960767214E-4
STAT,1925,28,15-19,1953,0.7849035712580442
STAT,1933,22,35-39,1955,11.798968189278185
SIM,1924,13,na,1937,4471
SIM,1851,44,35-39,1895,4
STAT,1823,96,na,1919,4.595417227958005
STAT,1916,17,50-100,1933,0.07509254742271478
SIM,1816,89,na,1905,41
SIM,1855,28,30-34,1883,21
STAT,1844,64,na,1908,1207.3310929413647
STAT,1889,37,50-100,1926,1.4318609690926751
STAT,1955,7,na,1962,4928.811494267901
STAT,1860,34,25-29,1894,7.783837717454394
SIM,1898,26,30-34,1924,42
SIM,1837,57,na,1894,1286
STAT,1872,37,25-29,1909,2.7282617636121906
STAT,1844,43,40-44,1887,1.5795611129475795
SIM,1799,78,na,1877,299
STAT,1827,43,40-44,1870,2.120982315056008
STAT,1788,106,na,1894,0.0032756185028993633
STAT,1924,22,25-29,1946,102.96417478118188
STAT,1825,49,45-49,1874,0.23416641547557587
STAT,1852,24,50-100,1876,0.3461841279053843
STAT,1865,33,30-34,1898,14.887075819059298
STAT,1922,33,15-19,1955,0.13658549918081414
STAT,1858,84,na,1942,246.397463483664
STAT,1854,54,na,1908,1498.1948732521294
STAT,1840,47,50-100,1887,0.1625340205695753
STAT,1841,18,50-100,1859,0.04330505707760902
STAT,1907,22,25-29,1929,79.44131950535181
SIM,1953,16,na,1969,4192
STAT,1851,20,25-29,1871,49.88987633950137
SIM,1929,28,25-29,1957,84
STAT,1854,23,45-49,1877,0.5820081171043568
STAT,1808,49,45-49,1857,0.8642251356034535
STAT,1917,45,40-44,1962,0.1563059559719161
STAT,1910,42,50-100,1952,0.1048906962806364
SIM,1843,51,na,1894,1526
STAT,1830,30,35-39,1860,8.976504059563894
STAT,1839,36,25-29,1875,2.3147073604858006
SIM,1932,22,25-29,1954,106
STAT,1864,20,35-39,1884,5.064788905929573
STAT,1894,34,40-44,1928,5.21991161535383
SIM,1842,20,25-29,1862,52
SIM,1887,29,20-24,1916,10
SIM,1924,4,na,1928,4554
SIM,1820,94,na,1914,10
SIM,1837,25,45-49,1862,5
SIM,1875,20,20-24,1895,66
SIM,1873,26,25-29,1899,49
SIM,1868,49,na,1917,1985
STAT,1904,45,30-34,1949,0.07472815242394575
SIM,1902,16,20-24,1918,26
STAT,1879,29,20-24,1908,11.518003792661395
STAT,1889,27,25-29,1916,49.33423781736085
SIM,1929,35,30-34,1964,2
SIM,1822,89,na,1911,50
STAT,1811,43,45-49,1854,5.454882137237857
STAT,1834,20,25-29,1854,77.87103162786103
STAT,1938,28,25-29,1966,61.573483014341306
STAT,1895,76,na,1971,1601.6447887367374
STAT,1910,35,45-49,1945,0.6218025864332036
SIM,1901,0,na,1901,3579
SIM,1906,22,15-19,1928,4
STAT,1914,19,40-44,1933,0.271873740092517
SIM,1884,20,30-34,1904,20
STAT,1922,40,20-24,1962,0.01920261706766674
STAT,1896,24,na,1920,2932.3639611535805
SIM,1915,22,25-29,1937,97
STAT,1848,54,na,1902,1555.931553213112
STAT,1865,32,na,1897,2043.317447847881
STAT,1910,19,50-100,1929,0.06975711540006156
SIM,1835,43,40-44,1878,7
SIM,1879,31,45-49,1910,5
STAT,1868,8,na,1876,2476.3227427331585
STAT,1906,0,na,1906,4040.11656940306
STAT,1878,54,50-100,1932,0.014460081187113293
STAT,1850,64,na,1914,1225.4094956941656
SIM,1847,36,25-29,1883,4
STAT,1897,27,15-19,1924,0.573199795006751
SIM,1831,66,na,1897,979
STAT,1858,52,30-34,1910,0.004385472063594106
SIM,1934,35,40-44,1969,2
STAT,1848,33,30-34,1881,13.625627634127042
STAT,1840,41,15-19,1881,0.009575727380457328
STAT,1858,30,20-24,1888,2.044118904804509
SIM,1856,33,30-34,1889,23
STAT,1807,78,na,1885,336.7114326922527
STAT,1800,54,25-29,1854,0.009915054046885474
SIM,1906,27,45-49,1933,2
SIM,1881,18,30-34,1899,2
SIM,1846,34,na,1880,1791
SIM,1918,19,na,1937,3763
STAT,1813,72,na,1885,571.4118680213769
STAT,1901,10,na,1911,3425.2964523078467
STAT,1828,33,45-49,1861,1.7447896254756181
STAT,1926,35,40-44,1961,1.731278965280395
SIM,1851,86,na,1937,121
STAT,1848,26,25-29,1874,37.79573091607918
STAT,1923,32,20-24,1955,2.641580556432565
SIM,1842,39,45-49,1881,5
STAT,1875,56,na,1931,1980.5145558754386
STAT,1922,18,na,1940,4013.6562492023113
STAT,1870,5,na,1875,2585.2604533869066
STAT,1884,39,na,1923,2176.7515262438665
STAT,1859,32,na,1891,1794.2446608650002
STAT,1788,94,na,1882,3.826383244657394
STAT,1908,21,30-34,1929,25.037357951048577
STAT,1904,38,25-29,1942,0.8379221969667309
STAT,1867,20,20-24,1887,62.273633043535135
STAT,1839,43,30-34,1882,0.7964777621128933
STAT,1865,26,25-29,1891,36.34557792305867
SIM,1832,22,20-24,1854,58
STAT,1829,25,45-49,1854,3.1586848180696627
SIM,1768,86,na,1854,60
SIM,1793,81,na,1874,168
STAT,1867,48,50-100,1915,0.2151288714535142
STAT,1826,73,na,1899,648.6114087046758
STAT,1851,12,na,1863,2087.8524091856557
SIM,1916,21,30-34,1937,36
STAT,1853,33,40-44,1886,3.3448775727210562
STAT,1819,63,na,1882,1005.729681270633
SIM,1907,47,na,1954,3114
SIM,1833,30,25-29,1863,18
STAT,1780,74,na,1854,351.0
STAT,1873,18,30-34,1891,1.5231083532113756
STAT,1895,24,45-49,1919,0.853443977173704
STAT,1898,19,na,1917,3211.469087834423
STAT,1864,84,na,1948,280.0930209776787
STAT,1870,37,20-24,1907,0.7143929057863075
SIM,1862,58,na,1920,1688
SIM,1922,19,40-44,1941,2
SIM,1861,33,40-44,1894,5
SIM,1817,37,na,1854,1538
STAT,1886,42,35-39,1928,1.8048051363031075
STAT,1880,29,30-34,1909,24.900283726738937
SIM,1848,60,na,1908,1355
SIM,1908,26,50-100,1934,1
SIM,1823,37,na,1860,1473
SIM,1846,28,20-24,1874,14
STAT,1896,16,45-49,1912,0.0817021085128176
SIM,1856,26,25-29,1882,32
SIM,1880,37,25-29,1917,3
SIM,1901,56,na,1957,2737
STAT,1885,50,35-39,1935,0.008223161420327236
SIM,1931,32,20-24,1963,1
STAT,1852,48,50-100,1900,0.17581933717174167
STAT,1846,99,na,1945,1.404688383646576
STAT,1889,76,na,1965,1416.935194960627
STAT,1903,46,25-29,1949,0.043797111133978134
SIM,1852,43,40-44,1895,9
STAT,1891,8,na,1899,3038.300866146042
STAT,1819,51,35-39,1870,0.015972795461434902
SIM,1892,42,30-34,1934,5
STAT,1889,34,30-34,1923,20.188144902822206
STAT,1778,103,na,1881,0.04832856175160197
SIM,1806,65,na,1871,841
SIM,1912,38,25-29,1950,3
STAT,1947,18,25-29,1965,46.10240549182695
STAT,1841,15,15-19,1856,5.339480982075981
STAT,1820,39,15-19,1859,0.11398378708742465
STAT,1868,29,45-49,1897,0.9936103236768697
STAT,1825,30,25-29,1855,22.561772732191745
STAT,1910,17,15-19,1927,8.49547310269478
SIM,1821,42,na,1863,1428
STAT,1881,56,na,1937,1861.3832612560996
SIM,1947,16,na,1963,3861
STAT,1830,38,30-34,1868,4.271736355055362
SIM,1800,74,na,1874,422
SIM,1876,78,na,1954,687
SIM,1847,43,30-34,1890,3
STAT,1834,44,25-29,1878,0.4682805563168595
STAT,1892,21,25-29,1913,67.94038844961389
SIM,1838,36,50-100,1874,1
SIM,1924,19,na,1943,4173
SIM,1847,28,40-44,1875,2
SIM,1940,17,35-39,1957,5
SIM,1869,33,40-44,1902,4
SIM,1887,16,na,1903,2640
STAT,1843,54,45-49,1897,0.009532803661743439
SIM,1920,29,na,1949,3905
SIM,1839,49,50-100,1888,2
SIM,1829,93,na,1922,16
SIM,1846,30,35-39,1876,14
STAT,1893,42,40-44,1935,2.6913770524159872
STAT,1901,17,50-100,1918,0.06478401099635235
STAT,1828,52,50-100,1880,0.011808754750706687
SIM,1869,90,na,1959,122
STAT,1904,28,15-19,1932,0.6126284603392992
SIM,1851,80,na,1931,409
STAT,1866,25,30-34,1891,22.090384616036356
STAT,1830,44,na,1874,1508.80680658868
STAT,1911,40,na,1951,3386.76849781062
STAT,1845,39,20-24,1884,0.5613458738599538
SIM,1860,44,45-49,1904,3
STAT,1817,51,30-34,1868,0.013118044412830402
STAT,1852,28,na,1880,1813.5959749984454
SIM,1790,79,na,1869,239
SIM,1892,35,25-29,1927,3
STAT,1845,51,45-49,1896,0.010318537905172573
STAT,1888,19,20-24,1907,19.686841523759345
SIM,1886,24,45-49,1910,1
STAT,1876,45,45-49,1921,0.23263349492286217
SIM,1794,69,na,1863,597
STAT,1884,42,30-34,1926,1.0716881284889899
STAT,1850,15,25-29,1865,4.93936333556582
SIM,1882,16,25-29,1898,5
SIM,1891,21,15-19,1912,3
STAT,1911,27,45-49,1938,1.591672252053631
STAT,1951,2,na,1953,4482.835671777239
SIM,1879,21,35-39,1900,6
STAT,1874,16,25-29,1890,5.483092485760673
STAT,1809,54,45-49,1863,0.03747015521874717
SIM,1928,32,45-49,1960,5
SIM,1900,27,40-44,1927,5
STAT,1850,52,30-34,1902,0.0041737533863302895
SIM,1815,42,na,1857,1499
STAT,1798,56,na,1854,1061.9999999999998
STAT,1826,51,40-44,1877,0.009563748986750786
SIM,1857,31,25-29,1888,9
SIM,1862,24,na,1886,2025
SIM,1917,31,na,1948,3743
SIM,1932,14,na,1946,4900
STAT,1859,109,na,1968,0.0059446232285689194
STAT,1860,29,45-49,1889,0.847869107478073
STAT,1932,17,35-39,1949,5.248977059635431
STAT,1835,87,na,1922,112.13483714305774
STAT,1883,39,50-100,1922,1.125706832992958
SIM,1855,48,na,1903,1779
SIM,1896,19,20-24,1915,22
STAT,1910,25,35-39,1935,13.90641711392999
STAT,1817,62,na,1879,984.458007050553
STAT,1831,33,20-24,1864,2.129680067559497
STAT,1851,36,40-44,1887,3.215867071189889
SIM,1930,27,20-24,1957,21
SIM,1902,28,50-100,1930,1
SIM,1926,24,50-100,1950,4
STAT,1772,114,na,1886,2.645733684318352E-4
STAT,1849,31,25-29,1880,8.986719823218808
STAT,1905,34,50-100,1939,0.7122472000179995
STAT,1836,18,45-49,1854,0.09980653599156354
SIM,1872,88,na,1960,179
SIM,1913,34,50-100,1947,4
SIM,1784,70,na,1854,548
SIM,1939,32,20-24,1971,2
STAT,1834,39,45-49,1873,1.507226407774011
SIM,1829,28,20-24,1857,9
STAT,1832,45,na,1877,1487.4687241471336
STAT,1857,41,25-29,1898,0.48061101209509843
STAT,1861,26,50-100,1887,0.5097809272267207
STAT,1833,21,na,1854,1765.2905887914947
STAT,1896,29,50-100,1925,0.792430460238455
STAT,1947,25,30-34,1972,41.91465057766725
STAT,1836,51,35-39,1887,0.0057536852800470625
STAT,1838,30,35-39,1868,8.625714118267496
SIM,1850,39,na,1889,1776
STAT,1867,52,40-44,1919,0.009289131364528915
STAT,1953,0,na,1953,4953.615826595834
STAT,1885,48,20-24,1933,0.011157741859552645
STAT,1927,40,40-44,1967,0.2971609975174419
STAT,1860,54,na,1914,1605.038300808091
SIM,1872,20,35-39,1892,6
STAT,1835,56,na,1891,1298.1780609045052
STAT,1867,27,na,1894,2117.0323935648034
STAT,1906,27,35-39,1933,13.275997380847375
STAT,1891,16,25-29,1907,6.6394324925643655
SIM,1842,75,na,1917,639
STAT,1908,24,35-39,1932,8.126602106010013
STAT,1822,49,50-100,1871,0.3209537705220626
SIM,1914,27,35-39,1941,15
STAT,1937,11,na,1948,3646.901642283732
STAT,1878,24,45-49,1902,0.682229671947623
SIM,1874,31,25-29,1905,10
SIM,1846,43,50-100,1889,1
SIM,1898,32,25-29,1930,19
STAT,1906,25,na,1931,3305.9036114545656
SIM,1888,63,na,1951,2020
SIM,1895,23,40-44,1918,2
SIM,1888,29,40-44,1917,3
STAT,1912,38,15-19,1950,0.017618972262663467
STAT,1857,26,35-39,1883,7.458374509050478
STAT,1838,43,50-100,1881,0.7452090029509035
STAT,1848,20,na,1868,1962.550481353606
STAT,1887,23,40-44,1910,2.1951241235464045
STAT,1913,43,15-19,1956,0.0014125675725843818
STAT,1893,41,na,1934,2781.4579024160325
STAT,1946,22,na,1968,3839.043650080852
STAT,1768,100,na,1868,0.1427059383955601
STAT,1911,30,35-39,1941,8.474358463721273
STAT,1859,39,15-19,1898,0.041797136252147385
STAT,1922,12,na,1934,4331.9801029868995
SIM,1902,32,na,1934,3160
STAT,1877,51,na,1928,2120.0590038812597
SIM,1865,26,35-39,1891,11
STAT,1883,21,15-19,1904,3.06482527949579
SIM,1814,94,na,1908,2
SIM,1874,25,30-34,1899,5
STAT,1843,41,30-34,1884,0.8098446431577077
STAT,1887,45,20-24,1932,0.012806628342901992
STAT,1904,24,na,1928,3184.7118049702285
STAT,1811,100,na,1911,0.46042769312766285
STAT,1913,35,30-34,1948,1.7153485533212316
STAT,1871,31,35-39,1902,9.538742784696566
SIM,1921,35,30-34,1956,1
STAT,1889,20,40-44,1909,2.444752460538633
STAT,1879,25,50-100,1904,0.6368662503847938
SIM,1888,37,25-29,1925,3
SIM,1897,20,40-44,1917,2
SIM,1849,76,na,1925,688
SIM,1867,33,na,1900,2300
STAT,1863,37,15-19,1900,0.04655310275055738
SIM,1846,65,na,1911,1198
SIM,1889,26,20-24,1915,19
SIM,1900,21,35-39,1921,7
SIM,1828,32,40-44,1860,11
SIM,1919,32,50-100,1951,3
SIM,1941,22,35-39,1963,9
STAT,1858,45,25-29,1903,0.043088586835673064
STAT,1921,45,30-34,1966,0.09538392691780981
STAT,1816,49,35-39,1865,0.32028047970278484
STAT,1871,38,50-100,1909,1.1459989887522655
STAT,1819,97,na,1916,2.8359794648405146
STAT,1925,36,35-39,1961,2.744900589819142
SIM,1881,90,na,1971,176
SIM,1894,40,50-100,1934,1
SIM,1853,35,50-100,1888,2
SIM,1858,50,na,1908,1806
STAT,1875,21,25-29,1896,55.754148814487344
STAT,1866,37,30-34,1903,4.6437747438808605
STAT,1856,20,45-49,1876,0.6056052556654742
SIM,1879,58,na,1937,2006
STAT,1899,66,na,1965,2349.061199919334
STAT,1838,30,na,1868,1845.9074162588427
STAT,1848,7,na,1855,2279.9147399999997
SIM,1866,23,15-19,1889,3
SIM,1858,59,na,1917,1605
SIM,1907,22,35-39,1929,7
STAT,1779,89,na,1868,29.85536423682963
STAT,1839,33,20-24,1872,2.191850223847493
SIM,1880,34,20-24,1914,4
STAT,1867,30,30-34,1897,15.61262795753678
STAT,1912,32,45-49,1944,1.4628036243768079
SIM,1887,2,na,1889,2896
STAT,1905,33,15-19,1938,0.11118595412643267
SIM,1882,23,30-34,1905,17
STAT,1836,69,na,1905,950.332035873243
STAT,1890,48,30-34,1938,0.0622724878322955
STAT,1919,49,25-29,1968,0.05403442694467309
STAT,1921,25,50-100,1946,1.0550755911428564
STAT,1844,46,45-49,1890,0.16437295403956745
STAT,1931,33,25-29,1964,11.433789423407474
STAT,1823,62,na,1885,1022.2486491967074
SIM,1911,46,na,1957,3261
STAT,1907,8,na,1915,3607.462254832197
STAT,1923,42,30-34,1965,0.14115972790781728
SIM,1910,61,na,1971,2943
SIM,1933,36,35-39,1969,7
STAT,1830,28,20-24,1858,11.067892930259992
STAT,1850,101,na,1951,0.40224591364322554
STAT,1888,39,40-44,1927,4.838067154810745
STAT,1928,37,na,1965,4491.565301764073
SIM,1874,37,30-34,1911,11
STAT,1939,23,15-19,1962,5.048688266877304
SIM,1839,36,35-39,1875,15
STAT,1861,34,45-49,1895,1.3580226601314052
SIM,1935,25,15-19,1960,3
STAT,1865,18,40-44,1883,0.16043699413574788
STAT,1821,44,15-19,1865,0.022406097699138903
SIM,1901,32,40-44,1933,7
SIM,1924,21,20-24,1945,117
STAT,1843,17,na,1860,1981.3670459382079
STAT,1898,27,35-39,1925,12.335379308312561
SIM,1788,69,na,1857,640
SIM,1905,46,na,1951,3042
SIM,1908,29,na,1937,3268
STAT,1946,22,45-49,1968,1.1828657475907858
SIM,1850,20,15-19,1870,3
SIM,1896,29,30-34,1925,39
STAT,1802,63,na,1865,876.0720712084446
STAT,1856,39,50-100,1895,0.8958340955596141
STAT,1871,7,na,1878,2567.959675538304
STAT,1905,43,25-29,1948,0.0604512207640344
SIM,1875,39,40-44,1914,8
STAT,1888,29,30-34,1917,27.913348965561735
STAT,1919,39,15-19,1958,0.019447866126502164
STAT,1922,27,20-24,1949,19.51306106721689
SIM,1878,73,na,1951,1123
STAT,1867,39,40-44,1906,3.844104133651318
SIM,1832,25,25-29,1857,35
SIM,1899,72,na,1971,2027
STAT,1806,90,na,1896,27.340604428125978
STAT,1830,40,45-49,1870,1.1972458869155749
SIM,1838,20,35-39,1858,10
SIM,1827,67,na,1894,879
STAT,1916,21,20-24,1937,110.4051463618561
STAT,1811,77,na,1888,366.48179944796203
STAT,1890,0,na,1890,3391.3682836504536
STAT,1842,20,15-19,1862,3.057094655417101
STAT,1918,10,na,1928,4086.558109762179
SIM,1925,0,na,1925,4755
SIM,1916,24,35-39,1940,10
STAT,1870,18,15-19,1888,5.519601025859585
STAT,1840,104,na,1944,0.043772412622824844
STAT,1871,66,na,1937,1537.5100159425479
STAT,1925,46,45-49,1971,0.24940862609839748
STAT,1823,31,na,1854,1531.1599187550862
SIM,1895,45,na,1940,2889
STAT,1880,44,20-24,1924,0.1560324714988641
STAT,1879,31,35-39,1910,10.055309231093215
STAT,1898,32,15-19,1930,0.18205676246941666
SIM,1843,44,45-49,1887,1
SIM,1866,33,25-29,1899,14
STAT,1842,39,35-39,1881,5.3554366634359045
SIM,1947,23,15-19,1970,4
STAT,1846,22,40-44,1868,1.9070185726874964
STAT,1884,67,na,1951,1479.5166422004959
STAT,1927,23,50-100,1950,0.7634696155742128
STAT,1939,28,45-49,1967,1.639941235760995
SIM,1910,34,40-44,1944,4
SIM,1837,29,25-29,1866,51
SIM,1902,8,na,1910,3479
STAT,1865,23,20-24,1888,59.29589971985795
STAT,1819,49,20-24,1868,0.022060014126754277
SIM,1839,52,na,1891,1447
STAT,1909,49,50-100,1958,0.1951973941578014
SIM,1943,17,20-24,1960,121
STAT,1847,38,40-44,1885,3.314598782665076
SIM,1838,39,na,1877,1668
STAT,1907,32,35-39,1939,8.069583202128614
SIM,1850,39,35-39,1889,9
SIM,1915,32,35-39,1947,15
SIM,1923,24,40-44,1947,6
STAT,1829,106,na,1935,0.007336440741453932
STAT,1831,97,na,1928,3.1367749284678634
STAT,1858,33,25-29,1891,7.554492207303207
STAT,1842,69,na,1911,1062.7689301839018
STAT,1926,38,45-49,1964,0.7862550500969715
SIM,1855,38,40-44,1893,4
STAT,1826,45,na,1871,1431.2871067383564
STAT,1899,24,15-19,1923,4.243532959527687
STAT,1805,77,na,1882,366.2925650265622
STAT,1757,113,na,1870,5.274036985929458E-4
SIM,1829,38,30-34,1867,8
SIM,1870,39,50-100,1909,1
STAT,1844,30,na,1874,1837.7494187986647
STAT,1949,22,30-34,1971,31.683741438684148
STAT,1822,36,15-19,1858,0.10420225488017942
STAT,1935,17,20-24,1952,175.08854726900466
STAT,1862,39,50-100,1901,0.981689862276255
SIM,1888,38,50-100,1926,1
SIM,1946,3,na,1949,4064
SIM,1884,73,na,1957,1184
SIM,1887,31,35-39,1918,9
STAT,1839,28,40-44,1867,2.4945079200882314
STAT,1951,18,15-19,1969,51.03776168411841
STAT,1934,37,na,1971,4904.578918941311
STAT,1844,47,20-24,1891,0.008295429688204637
STAT,1921,35,20-24,1956,0.27854336786885964
SIM,1859,20,35-39,1879,9
SIM,1819,38,na,1857,1514
SIM,1920,26,50-100,1946,1
STAT,1911,40,45-49,1951,0.1517690376408284
STAT,1825,46,40-44,1871,0.17707447731433631
SIM,1856,24,na,1880,1947
STAT,1842,15,35-39,1857,0.5163339504516239
SIM,1854,22,40-44,1876,6
STAT,1813,53,20-24,1866,0.0018909895595496896
SIM,1772,85,na,1857,60
STAT,1930,18,15-19,1948,55.28219747866947
SIM,1866,88,na,1954,99
STAT,1839,103,na,1942,0.09555204828075589
SIM,1920,32,45-49,1952,1
STAT,1854,34,50-100,1888,0.6575348863175632
STAT,1834,26,50-100,1860,0.5243311950977565
SIM,1914,29,na,1943,3534
STAT,1916,16,40-44,1932,0.28103411212587687
STAT,1858,110,na,1968,0.0021042807024141768
STAT,1886,65,na,1951,1686.4311526143047
SIM,1864,59,na,1923,1743
STAT,1922,38,50-100,1960,0.45086315519349074
SIM,1834,38,40-44,1872,5
SIM,1898,22,15-19,1920,4
STAT,1864,30,45-49,1894,1.4800510744900743
SIM,1951,15,na,1966,4021
SIM,1938,25,50-100,1963,4
SIM,1930,38,50-100,1968,1
STAT,1829,29,25-29,1858,47.38975636229949
SIM,1924,16,40-44,1940,1
STAT,1835,44,45-49,1879,1.1124847790121697
SIM,1873,23,20-24,1896,69
STAT,1902,34,40-44,1936,3.291512637554893
SIM,1902,24,40-44,1926,2
STAT,1892,37,40-44,1929,5.179681573143403
SIM,1914,17,25-29,1931,10
STAT,1882,16,15-19,1898,5.4655535787591365
STAT,1872,34,20-24,1906,2.5394276738965136
SIM,1929,38,35-39,1967,8
STAT,1867,42,30-34,1909,1.0185898631836423
SIM,1831,43,50-100,1874,2
STAT,1844,28,15-19,1872,0.38297471435147556
STAT,1877,19,45-49,1896,0.063668503965213
SIM,1828,46,na,1874,1486
STAT,1804,95,na,1899,4.453560135228788
STAT,1865,40,50-100,1905,0.9137318029689054
SIM,1925,18,15-19,1943,46
STAT,1913,37,20-24,1950,0.24576709762094343
STAT,1943,27,20-24,1970,18.36539450198249
SIM,1842,29,35-39,1871,8
SIM,1826,100,na,1926,1
STAT,1924,44,na,1968,4159.289955211399
STAT,1829,56,na,1885,1268.611830383429
SIM,1929,25,na,1954,4386
SIM,1866,85,na,1951,206
SIM,1863,19,25-29,1882,8
STAT,1860,38,40-44,1898,3.3387554844915304
STAT,1892,15,30-34,1907,1.894708901894703
STAT,1822,83,na,1905,201.7240121770843
SIM,1930,37,30-34,1967,1
STAT,1891,15,na,1906,2965.5959263709497
SIM,1881,20,45-49,1901,1
SIM,1833,24,30-34,1857,14
STAT,1886,46,15-19,1932,4.0029712035957954E-4
STAT,1857,48,45-49,1905,0.17362502887532663
SIM,1941,28,40-44,1969,4
SIM,1811,80,na,1891,234
STAT,1859,100,na,1959,1.523633552989235
STAT,1922,37,30-34,1959,1.9591560378855581
STAT,1871,41,45-49,1912,1.410309265244799
STAT,1907,26,40-44,1933,4.171292747082
SIM,1841,25,na,1866,1792
STAT,1848,16,15-19,1864,5.498883911859516
SIM,1875,35,25-29,1910,5
STAT,1834,29,35-39,1863,7.739718245744303
STAT,1834,36,40-44,1870,3.414446936237831
SIM,1860,94,na,1954,15
SIM,1869,36,45-49,1905,1
STAT,1855,19,25-29,1874,4.73337399413063
STAT,1804,50,45-49,1854,0.05339113899243477
STAT,1926,41,35-39,1967,0.23484581237423863
SIM,1852,65,na,1917,1256
SIM,1911,15,na,1926,3671
SIM,1865,9,na,1874,2450
SIM,1906,26,30-34,1932,44
STAT,1830,52,45-49,1882,0.009564048262890095
STAT,1854,47,15-19,1901,2.848595183878556E-4
SIM,1866,49,50-100,1915,6
STAT,1904,41,15-19,1945,0.0013053557348082568
STAT,1853,75,na,1928,779.0929143459542
STAT,1876,23,50-100,1899,0.3967755593988898
STAT,1865,17,50-100,1882,0.043228802051624285
SIM,1839,83,na,1922,242
STAT,1821,48,30-34,1869,0.15048159218375834
STAT,1867,35,25-29,1902,2.5783289692880493
STAT,1893,9,na,1902,3108.4422053444837
STAT,1810,98,na,1908,1.3742594995565633
STAT,1862,41,35-39,1903,1.469245897191936
STAT,1939,25,40-44,1964,4.430489823140462
SIM,1880,12,na,1892,2630
SIM,1910,25,45-49,1935,1
SIM,1938,18,25-29,1956,44
STAT,1874,25,20-24,1899,11.40029347315637
SIM,1829,37,50-100,1866,3
STAT,1912,59,na,1971,3136.5505622047353
STAT,1885,47,45-49,1932,0.22119184482480186
SIM,1859,38,na,1897,1894
SIM,1895,26,45-49,1921,1
SIM,1939,30,30-34,1969,16
SIM,1915,26,40-44,1941,5
STAT,1839,46,35-39,1885,0.09619528860063686
STAT,1835,50,na,1885,1453.0017253932438
STAT,1878,36,na,1914,2330.6719745677037
SIM,1889,32,50-100,1921,1
SIM,1923,34,na,1957,4157
STAT,1897,25,25-29,1922,53.8054437884483
STAT,1902,25,45-49,1927,1.4903338068001615
SIM,1870,41,35-39,1911,1
STAT,1882,53,20-24,1935,6.67052857212349E-4
SIM,1777,91,na,1868,11
SIM,1888,30,40-44,1918,5
STAT,1909,25,50-100,1934,0.9124523992981545
STAT,1880,77,na,1957,936.367343940487
STAT,1821,40,35-39,1861,3.3048537106483167
STAT,1842,38,na,1880,1800.7121461595232
STAT,1924,16,30-34,1940,13.745434722691325
SIM,1833,36,30-34,1869,6
STAT,1849,33,15-19,1882,0.11136440394905239
STAT,1884,30,na,1914,2245.096037610151
SIM,1822,58,na,1880,1145
STAT,1900,16,45-49,1916,0.08581568308687443
STAT,1872,42,na,1914,2187.381887976736
SIM,1784,79,na,1863,218
SIM,1864,50,na,1914,1950
STAT,1949,15,50-100,1964,0.41187054083929625
SIM,1828,35,45-49,1863,2
SIM,1889,11,na,1900,3141
STAT,1899,46,25-29,1945,0.042176098915588704
STAT,1868,48,20-24,1916,0.010680201040942666
STAT,1953,9,na,1962,4490.601024367125
SIM,1865,23,30-34,1888,17
SIM,1902,30,35-39,1932,19
STAT,1893,32,30-34,1925,20.91722431322996
SIM,1838,34,25-29,1872,17
SIM,1901,25,35-39,1926,13
STAT,1876,54,40-44,1930,0.009992479705870926
STAT,1903,24,15-19,1927,4.4066305184152466
STAT,1892,7,na,1899,3082.78851745191
SIM,1877,23,na,1900,2305
SIM,1911,24,15-19,1935,5
SIM,1932,16,30-34,1948,17
SIM,1879,35,25-29,1914,4
SIM,1877,26,na,1903,2324
SIM,1827,98,na,1925,1
STAT,1857,35,30-34,1892,4.008572253965739
STAT,1892,27,30-34,1919,29.79649075333735
STAT,1907,19,35-39,1926,0.7573753154924414
SIM,1878,70,na,1948,1345
STAT,1932,40,15-19,1972,0.0019716779257300506
STAT,1814,88,na,1902,63.09911096389898
STAT,1858,49,40-44,1907,0.12415708345185758
STAT,1826,76,na,1902,517.3609293044117
STAT,1885,29,15-19,1914,0.42417261475978346
STAT,1917,18,15-19,1935,9.201922554505579
SIM,1882,26,35-39,1908,8
STAT,1830,35,50-100,1865,1.0254058821995011
STAT,1885,40,25-29,1925,0.610784512147447
STAT,1849,40,20-24,1889,0.12117015572758401
SIM,1856,16,15-19,1872,4
STAT,1825,36,30-34,1861,6.974849874564765
SIM,1933,24,35-39,1957,15
STAT,1859,63,na,1922,1341.6014510390505
SIM,1915,19,35-39,1934,2
STAT,1898,50,na,1948,2792.2850805759626
SIM,1796,98,na,1894,1
STAT,1850,40,50-100,1890,0.7522321097257835
SIM,1860,60,na,1920,1569
STAT,1857,23,30-34,1880,15.210876553903136
STAT,1956,15,30-34,1971,15.242489489129973
SIM,1816,39,35-39,1855,7
SIM,1884,42,40-44,1926,6
STAT,1876,42,40-44,1918,2.1926012351951387
STAT,1908,43,40-44,1951,0.21730831254402683
STAT,1899,34,25-29,1933,13.144544384427977
SIM,1916,31,40-44,1947,3
STAT,1809,51,40-44,1860,0.02887272861522122
STAT,1874,26,35-39,1900,9.345332572936696
STAT,1925,24,35-39,1949,10.58049849169328
SIM,1839,86,na,1925,141
STAT,1818,38,15-19,1856,0.1614935351356263
STAT,1845,45,15-19,1890,2.85873197825957E-4
SIM,1939,23,25-29,1962,93
STAT,1860,26,40-44,1886,2.337514358129483
SIM,1864,24,25-29,1888,46
SIM,1880,15,na,1895,2579
SIM,1897,17,15-19,1914,6
STAT,1919,46,20-24,1965,0.011351696949809401
STAT,1937,17,na,1954,3382.747136543141
STAT,1805,103,na,1908,0.05009772008805484
STAT,1899,30,50-100,1929,1.1955238668071293
STAT,1888,24,50-100,1912,0.452426762135164
STAT,1914,42,20-24,1956,0.01653198818316485
STAT,1880,71,na,1951,1329.3744650546653
STAT,1870,36,45-49,1906,1.8563783545169907
STAT,1893,25,25-29,1918,51.022090134167
STAT,1856,41,50-100,1897,0.7822106069467335
STAT,1916,18,na,1934,3860.9930688060094
STAT,1936,32,na,1968,3470.292345270141
SIM,1907,24,25-29,1931,81
STAT,1825,103,na,1928,0.07627617749785748
STAT,1807,52,50-100,1859,0.05534110674015554
STAT,1843,34,25-29,1877,8.146219947227294
STAT,1898,29,25-29,1927,53.692453350831244
STAT,1877,52,35-39,1929,0.008391404570234708
STAT,1921,48,35-39,1969,0.13692401196647858
STAT,1874,77,na,1951,834.3315281117908
STAT,1891,18,na,1909,2944.147128111718
STAT,1893,20,30-34,1913,21.466932064107738
SIM,1848,35,30-34,1883,5
STAT,1901,17,40-44,1918,0.24186036653410764
STAT,1908,31,40-44,1939,3.5039277476637727
SIM,1854,60,na,1914,1529
STAT,1875,23,15-19,1898,3.193502228375027
SIM,1851,34,25-29,1885,13
STAT,1898,24,30-34,1922,22.629018002562354
STAT,1835,41,40-44,1876,1.7374470380867637
STAT,1948,20,20-24,1968,120.69918754870407
STAT,1859,60,na,1919,1433.9903189691456
STAT,1911,16,20-24,1927,25.693371650107775
STAT,1930,31,15-19,1961,0.15675581818940762
STAT,1943,11,na,1954,3940.9989404881
SIM,1815,73,na,1888,537
SIM,1816,58,na,1874,1116
SIM,1924,24,25-29,1948,116
STAT,1859,50,25-29,1909,0.0027014773058952842
SIM,1850,37,45-49,1887,1
STAT,1909,30,na,1939,3437.044883968261
STAT,1911,20,25-29,1931,83.25469978519664
STAT,1889,17,15-19,1906,6.921198703439198
SIM,1828,43,na,1871,1535
STAT,1934,33,40-44,1967,5.044377558247231
STAT,1826,41,30-34,1867,1.1461185239104186
STAT,1905,40,20-24,1945,0.015211037183146469
STAT,1930,5,na,1935,4910.639342344624
SIM,1809,79,na,1888,292
SIM,1933,31,40-44,1964,7
STAT,1873,92,na,1965,113.063836275633
SIM,1933,21,30-34,1954,49
STAT,1868,50,35-39,1918,0.007871217874253612
STAT,1886,62,na,1948,1823.9118944077754
STAT,1896,31,50-100,1927,1.147858018503496
SIM,1859,29,45-49,1888,4
SIM,1847,19,na,1866,2125
STAT,1887,26,45-49,1913,1.1772661264820332
STAT,1934,15,50-100,1949,0.48095573942925146
STAT,1846,90,na,1936,58.476348734039576
STAT,1822,46,25-29,1868,0.07857789855578035
STAT,1861,31,40-44,1892,3.4203559024519423
SIM,1860,34,35-39,1894,9
SIM,1875,48,50-100,1923,1
STAT,1920,20,35-39,1940,9.947852660132122
STAT,1843,22,25-29,1865,48.53419449333853
STAT,1852,34,35-39,1886,7.445506512391939
SIM,1851,22,25-29,1873,53
STAT,1849,47,40-44,1896,0.1277788998870317
STAT,1856,18,30-34,1874,1.3809491439224617
STAT,1847,42,50-100,1889,0.7833801243609954
STAT,1789,79,na,1868,248.2535523811187
STAT,1925,31,40-44,1956,4.392479248077798
SIM,1839,38,25-29,1877,1
SIM,1778,79,na,1857,238
STAT,1940,32,20-24,1972,2.3848113364127905
STAT,1811,43,na,1854,1346.2404071966728
SIM,1910,19,15-19,1929,8
STAT,1914,33,50-100,1947,0.7829248666152576
SIM,1891,38,45-49,1929,1
STAT,1785,80,na,1865,251.66789463810667
SIM,1892,23,25-29,1915,79
STAT,1835,53,40-44,1888,0.006694618451796157
STAT,1896,55,na,1951,2579.8561113258843
STAT,1817,44,25-29,1861,1.507081452147133
STAT,1867,24,50-100,1891,0.3594773554908
SIM,1865,28,25-29,1893,44
STAT,1832,50,20-24,1882,4.8264119471258526E-4
STAT,1898,36,30-34,1934,6.846230177987953
SIM,1843,41,40-44,1884,5
STAT,1902,37,45-49,1939,0.5736582787600716
STAT,1951,21,40-44,1972,3.796246669646474
SIM,1843,20,na,1863,1965
STAT,1847,18,20-24,1865,16.220470997910475
SIM,1891,55,na,1946,2416
STAT,1862,39,20-24,1901,0.6163624502661849
SIM,1889,36,30-34,1925,12
STAT,1894,40,35-39,1934,2.2206003263816245
STAT,1934,21,40-44,1955,4.2701045106675934
STAT,1880,47,25-29,1927,0.057098405006081605
SIM,1916,55,na,1971,3369
STAT,1912,36,25-29,1948,0.912245367593068
STAT,1924,47,na,1971,4131.717526003124
STAT,1846,25,45-49,1871,1.0107125741066814
SIM,1824,47,45-49,1871,3
STAT,1863,47,25-29,1910,0.04752877616272403
STAT,1866,48,na,1914,1935.7025636062012
STAT,1902,19,15-19,1921,7.869698524444674
STAT,1857,28,25-29,1885,32.23005829338236
SIM,1891,39,50-100,1930,4
STAT,1884,35,25-29,1919,2.7127351720238764
SIM,1911,49,na,1960,3242
SIM,1825,32,25-29,1857,13
STAT,1907,5,na,1912,3636.732594897325
SIM,1855,18,20-24,1873,21
STAT,1920,28,30-34,1948,40.461869662778675
SIM,1942,21,40-44,1963,4
STAT,1836,35,na,1871,1738.1060270845976
STAT,1852,41,40-44,1893,1.6380725803978
SIM,1874,12,na,1886,2451
STAT,1841,41,50-100,1882,0.7665851994621562
SIM,1907,31,30-34,1938,16
STAT,1916,24,25-29,1940,90.86508732671068
STAT,1887,10,na,1897,2737.1568176094374
SIM,1780,80,na,1860,193
SIM,1796,64,na,1860,850
STAT,1860,57,na,1917,1540.4016051109288
STAT,1884,23,25-29,1907,53.263421127444126
SIM,1875,42,30-34,1917,5
STAT,1885,18,na,1903,2371.9898355948553
SIM,1854,25,45-49,1879,2
STAT,1909,49,30-34,1958,0.07693447802640867
STAT,1851,26,30-34,1877,21.362856863481372
STAT,1866,11,na,1877,2356.8575256735894
SIM,1938,25,30-34,1963,34
STAT,1841,52,20-24,1893,5.060221905531454E-4
STAT,1856,24,25-29,1880,48.303745052797645
SIM,1860,48,50-100,1908,2
SIM,1903,36,25-29,1939,1
SIM,1834,34,25-29,1868,10
STAT,1815,106,na,1921,0.005419555913777728
STAT,1839,35,50-100,1874,0.9973363823053474
SIM,1891,15,20-24,1906,24
SIM,1839,33,30-34,1872,26
STAT,1931,26,na,1957,4570.939482060656
SIM,1875,30,30-34,1905,31
STAT,1816,47,45-49,1863,0.5573382499410086
STAT,1837,23,45-49,1860,0.588191215594513
STAT,1816,51,50-100,1867,0.03484356692833866
STAT,1915,27,45-49,1942,1.6647038600978072
SIM,1838,18,20-24,1856,16
SIM,1853,13,na,1866,2166
SIM,1923,27,45-49,1950,2
STAT,1841,50,na,1891,1505.7512134627857
STAT,1883,38,45-49,1921,1.8372359207560505
STAT,1826,34,25-29,1860,12.352483784480427
STAT,1890,30,50-100,1920,1.0667385150833752
STAT,1853,78,na,1931,591.3095664207743
STAT,1791,80,na,1871,240.92468844319927
STAT,1931,30,20-24,1961,3.022703264094764
STAT,1909,41,35-39,1950,0.178961482316276
STAT,1821,50,45-49,1871,0.022903844291025315
SIM,1897,37,35-39,1934,16
STAT,1903,45,na,1948,3054.845677462776
STAT,1843,38,40-44,1881,3.1086602801104
SIM,1928,40,na,1968,4490
STAT,1849,43,25-29,1892,0.47805452518209474
STAT,1828,71,na,1899,751.73332972066
SIM,1849,45,na,1894,1712
STAT,1872,15,45-49,1887,0.0628397989279732
STAT,1906,15,35-39,1921,0.7584787045540423
SIM,1846,19,25-29,1865,4
STAT,1898,49,45-49,1947,0.16663449601385633
STAT,1902,22,40-44,1924,2.7781994503919516
SIM,1851,49,50-100,1900,2
SIM,1808,91,na,1899,19
SIM,1905,12,na,1917,3487
SIM,1942,18,15-19,1960,32
STAT,1861,28,15-19,1889,0.3563892901846097
STAT,1907,18,50-100,1925,0.06780925895935482
STAT,1926,27,20-24,1953,20.671419954930705
STAT,1897,19,30-34,1916,2.0028676927583215
SIM,1846,31,na,1877,1835
SIM,1934,27,20-24,1961,23
SIM,1883,26,na,1909,2231
SIM,1908,26,na,1934,3297
STAT,1821,36,na,1857,1526.9200352148548
STAT,1916,40,50-100,1956,0.11404790764666037
SIM,1798,90,na,1888,20
SIM,1887,84,na,1971,640
SIM,1902,2,na,1904,3542
SIM,1838,28,30-34,1866,38
SIM,1893,44,40-44,1937,1
SIM,1938,15,20-24,1953,108
SIM,1892,30,30-34,1922,28
SIM,1924,28,40-44,1952,5
STAT,1773,95,na,1868,2.0616143322307074
STAT,1851,24,40-44,1875,1.7644533166950604
SIM,1861,79,na,1940,560
STAT,1890,30,na,1920,2778.26167792401
STAT,1893,44,na,1937,2740.9873660242074
STAT,1929,1,na,1930,5034.612642162262
STAT,1899,31,20-24,1930,3.5131449990266566
SIM,1898,25,na,1923,3009
STAT,1930,38,35-39,1968,2.977377924748123
SIM,1871,33,50-100,1904,3
STAT,1915,30,na,1945,3668.165891668006
SIM,1858,42,30-34,1900,2
SIM,1873,16,15-19,1889,4
STAT,1838,19,25-29,1857,4.966233644502422
STAT,1833,25,35-39,1858,7.917004641360546
STAT,1939,27,30-34,1966,37.21206124413271
STAT,1882,18,40-44,1900,0.16759559578342026
STAT,1884,30,30-34,1914,16.42650161892575
SIM,1857,71,na,1928,969
STAT,1930,25,20-24,1955,21.945636476990376
SIM,1861,37,20-24,1898,1
SIM,1932,19,35-39,1951,6
STAT,1860,23,na,1883,1855.3536838107077
SIM,1818,84,na,1902,161
SIM,1934,31,25-29,1965,11
SIM,1840,42,50-100,1882,1
SIM,1842,26,30-34,1868,30
STAT,1921,38,25-29,1959,1.0375390846628645
SIM,1855,30,45-49,1885,2
STAT,1874,16,50-100,1890,0.047404248234447444
STAT,1865,16,15-19,1881,5.267475378123575
SIM,1947,5,na,1952,4154
STAT,1912,26,15-19,1938,0.6594907829408394
SIM,1865,38,35-39,1903,13
STAT,1862,89,na,1951,84.85367666643349
STAT,1814,44,50-100,1858,3.4023768276808566
STAT,1895,48,15-19,1943,2.7439776854693395E-4
SIM,1851,38,40-44,1889,6
STAT,1853,37,20-24,1890,0.5833754537368004
STAT,1883,18,25-29,1901,5.234848307608216
SIM,1903,7,na,1910,3496
STAT,1839,49,na,1888,1487.5972612776939
STAT,1819,94,na,1913,10.550549103923824
STAT,1859,54,40-44,1913,0.0076979649950181
SIM,1845,86,na,1931,122
STAT,1924,19,35-39,1943,4.695126574705103
STAT,1834,26,30-34,1860,20.640632625042837
STAT,1934,18,15-19,1952,57.83841733668766
SIM,1863,2,na,1865,2699
STAT,1863,49,15-19,1912,3.2468294420676813E-4
SIM,1862,27,na,1889,2044
SIM,1929,16,25-29,1945,63
SIM,1806,99,na,1905,2
SIM,1947,2,na,1949,4190
STAT,1826,44,35-39,1870,1.7000270016525454
STAT,1842,17,25-29,1859,5.269747077726558
STAT,1842,37,45-49,1879,1.693507753668236
STAT,1885,15,na,1900,2389.27033457904
SIM,1911,28,30-34,1939,45
SIM,1869,18,15-19,1887,5
STAT,1925,21,30-34,1946,32.59760039699031
STAT,1944,25,15-19,1969,0.7214239331688138
STAT,1870,19,na,1889,2335.1775259248266
SIM,1942,26,35-39,1968,18
STAT,1893,35,35-39,1928,8.554029913938763
STAT,1913,47,30-34,1960,0.08220106582362947
STAT,1875,27,30-34,1902,24.45199413075342
STAT,1900,34,na,1934,3100.496849334907
SIM,1866,30,20-24,1896,2
STAT,1907,16,30-34,1923,2.2172890962653073
SIM,1805,80,na,1885,232
SIM,1864,18,30-34,1882,1
SIM,1913,41,na,1954,3315
SIM,1896,31,45-49,1927,2
SIM,1829,40,45-49,1869,1
STAT,1825,39,35-39,1864,8.17569879691294
SIM,1878,26,45-49,1904,1
SIM,1879,52,na,1931,2180
STAT,1849,106,na,1955,0.009104664731563149
SIM,1834,44,35-39,1878,3
STAT,1903,28,30-34,1931,33.72916118125056
STAT,1832,42,50-100,1874,0.781281051962073
STAT,1871,39,30-34,1910,4.949211249093329
STAT,1829,109,na,1938,4.2988928666408275E-4
STAT,1835,38,15-19,1873,0.0437292051700743
STAT,1856,18,50-100,1874,0.04244719866274648
SIM,1883,23,15-19,1906,2
SIM,1906,29,35-39,1935,19
STAT,1871,35,15-19,1906,0.0531773191226494
STAT,1934,26,35-39,1960,19.08845017768267
SIM,1906,24,40-44,1930,3
STAT,1874,23,30-34,1897,17.139706665488337
STAT,1818,53,40-44,1871,0.021122948645565725
STAT,1885,44,40-44,1929,2.0894268916884786
STAT,1894,45,50-100,1939,0.16986983272168985
SIM,1915,16,30-34,1931,2
STAT,1908,28,15-19,1936,0.6282443350435633
STAT,1908,46,45-49,1954,0.18708813074163375
SIM,1883,27,30-34,1910,25
SIM,1856,36,35-39,1892,15
STAT,1821,39,na,1860,1486.465232853468
SIM,1833,39,35-39,1872,11
STAT,1873,51,20-24,1924,7.103940222874926E-4
STAT,1883,15,20-24,1898,16.49669436233569
STAT,1832,76,na,1908,570.7173005651109
STAT,1918,44,na,1962,3717.95546714442
SIM,1820,39,25-29,1859,9
SIM,1888,25,25-29,1913,47
SIM,1864,53,na,1917,1893
SIM,1875,32,20-24,1907,3
STAT,1911,19,25-29,1930,8.1485458320362
STAT,1792,68,na,1860,692.4010916001208
SIM,1850,17,25-29,1867,6
STAT,1865,63,na,1928,1527.839381528126
STAT,1821,38,20-24,1859,1.5414498190309298
STAT,1847,75,na,1922,759.1327904812291
SIM,1879,39,40-44,1918,10
STAT,1923,32,50-100,1955,0.8954065253734752
STAT,1941,17,45-49,1958,0.48607834000387745
STAT,1881,42,15-19,1923,0.01258742398179932
STAT,1860,22,25-29,1882,45.233305187899354
STAT,1889,24,20-24,1913,79.8664039343364
STAT,1825,100,na,1925,0.5642491291754106
STAT,1852,90,na,1942,57.15832773153887
SIM,1842,72,na,1914,794
STAT,1839,26,15-19,1865,0.38329793081709296
STAT,1904,48,35-39,1952,0.10566645459250266
SIM,1895,11,na,1906,3287
STAT,1866,21,15-19,1887,2.9189386194600746
STAT,1900,31,na,1931,3140.0513065976497
STAT,1913,31,15-19,1944,0.12127964196711609
STAT,1857,38,35-39,1895,5.243619887624693
SIM,1874,21,15-19,1895,2
SIM,1914,15,35-39,1929,3
SIM,1897,24,20-24,1921,84
STAT,1888,31,45-49,1919,1.9548433879329326
SIM,1928,20,45-49,1948,1
SIM,1916,52,na,1968,3428
SIM,1948,22,20-24,1970,114
SIM,1860,31,30-34,1891,15
STAT,1841,17,40-44,1858,0.16263014395226755
SIM,1812,99,na,1911,1
STAT,1836,38,na,1874,1684.7966195325719
SIM,1929,26,35-39,1955,20
STAT,1816,83,na,1899,184.9966096821519
SIM,1833,98,na,1931,2
SIM,1924,22,35-39,1946,14
SIM,1884,47,50-100,1931,1
SIM,1891,28,35-39,1919,11
SIM,1893,40,25-29,1933,4
STAT,1870,101,na,1971,4.687438333887599
SIM,1802,100,na,1902,1
SIM,1834,31,20-24,1865,2
STAT,1876,47,50-100,1923,0.2385892529089495
STAT,1813,46,15-19,1859,0.0011116273685597223
STAT,1875,37,40-44,1912,4.250619459658629
STAT,1898,26,20-24,1924,15.049185567054094
STAT,1848,36,35-39,1884,5.472521093858374
SIM,1886,3,na,1889,2713
STAT,1873,20,45-49,1893,0.6721002377377586
STAT,1870,33,40-44,1903,4.0021403519126215
STAT,1893,22,20-24,1915,82.5590735548935
SIM,1871,38,na,1909,2215
SIM,1840,46,na,1886,1512
STAT,1894,38,20-24,1932,0.9312068694449029
STAT,1927,37,15-19,1964,0.02255464879018655
SIM,1842,22,15-19,1864,2
SIM,1939,20,20-24,1959,93
STAT,1920,30,45-49,1950,1.6413536894022753
SIM,1892,39,40-44,1931,12
SIM,1931,32,50-100,1963,5
STAT,1929,22,45-49,1951,1.3441314870064622
SIM,1885,52,na,1937,2047
STAT,1925,34,45-49,1959,1.7629439369470075
STAT,1857,37,na,1894,1755.3466868195314
STAT,1883,28,35-39,1911,8.905508384926286
STAT,1916,22,35-39,1938,9.320919197042025
SIM,1870,53,na,1923,1932
STAT,1852,31,30-34,1883,13.242701812115573
STAT,1808,46,40-44,1854,0.6611234022333907
STAT,1770,84,na,1854,73.99999999999999
STAT,1786,68,na,1854,634.0
STAT,1952,17,20-24,1969,153.48192380984048
SIM,1886,37,na,1923,2292
STAT,1875,22,na,1897,2296.4968977556478
STAT,1822,48,15-19,1870,5.302652149021036E-4
STAT,1862,51,45-49,1913,0.011778030855611356
SIM,1903,33,20-24,1936,1
SIM,1950,18,40-44,1968,2
SIM,1916,36,35-39,1952,8
SIM,1933,34,45-49,1967,2
SIM,1874,35,40-44,1909,4
SIM,1891,52,na,1943,2519
STAT,1834,22,15-19,1856,2.7381700407928977
STAT,1942,18,40-44,1960,1.3804413586785367
SIM,1880,32,50-100,1912,1
STAT,1850,19,40-44,1869,0.1557031179921201
SIM,1938,28,35-39,1966,13
STAT,1869,22,45-49,1891,0.6381813463871052
STAT,1866,35,40-44,1901,3.850435553450001
STAT,1859,103,na,1962,0.3594325683425589
STAT,1884,20,20-24,1904,64.70121274470942
STAT,1918,35,15-19,1953,0.019303130952897346
SIM,1837,22,40-44,1859,3
SIM,1848,97,na,1945,6
STAT,1880,37,15-19,1917,0.05592628571037694
STAT,1948,23,25-29,1971,100.1625848704723
STAT,1908,7,na,1915,3651.1259567792576
SIM,1865,38,na,1903,2078
STAT,1839,21,20-24,1860,59.37903511186158
SIM,1892,20,20-24,1912,88
STAT,1933,16,40-44,1949,1.773169281320014
STAT,1791,83,na,1874,127.70559569234776
STAT,1908,36,35-39,1944,2.1497016614992592
STAT,1917,48,45-49,1965,0.21386292825636885
SIM,1838,38,40-44,1876,4
SIM,1847,21,20-24,1868,53
STAT,1926,31,25-29,1957,10.563690025490354
SIM,1883,37,40-44,1920,7
STAT,1808,54,na,1862,1161.8116018347544
SIM,1841,25,35-39,1866,8
STAT,1899,41,30-34,1940,0.10380663826785143
STAT,1919,29,na,1948,3796.4946273711757
SIM,1891,18,25-29,1909,8
STAT,1817,48,40-44,1865,0.3799406859883498
STAT,1836,49,20-24,1885,0.007926649159423163
STAT,1871,53,45-49,1924,0.013395111160504179
STAT,1831,45,20-24,1876,0.008772014050121004
SIM,1833,61,na,1894,1119
SIM,1834,46,na,1880,1476
STAT,1898,39,35-39,1937,1.932028416327916
STAT,1850,107,na,1957,0.005302148342811623
SIM,1831,32,na,1863,1663
SIM,1941,22,na,1963,3472
STAT,1922,43,25-29,1965,0.07730809463502286
SIM,1877,22,45-49,1899,2
SIM,1941,16,40-44,1957,3
STAT,1863,44,20-24,1907,0.12988160371898722
STAT,1892,25,40-44,1917,3.5685489880842334
STAT,1838,110,na,1948,1.855196171596806E-4
STAT,1858,43,35-39,1901,1.3315474282191286
SIM,1901,20,40-44,1921,2
STAT,1801,84,na,1885,106.96893953032878
STAT,1866,31,25-29,1897,8.961071072429535
STAT,1856,32,45-49,1888,1.3010693757261995
STAT,1897,29,40-44,1926,3.7574938181041473
SIM,1860,21,20-24,1881,59
SIM,1907,34,35-39,1941,7
SIM,1865,25,20-24,1890,9
SIM,1842,36,40-44,1878,6
SIM,1856,23,20-24,1879,64
SIM,1864,32,45-49,1896,1
STAT,1830,34,15-19,1864,0.11819479447397324
STAT,1847,30,45-49,1877,1.541501727273271
STAT,1852,44,45-49,1896,1.0703975123670701
SIM,1898,31,50-100,1929,1
SIM,1924,1,na,1925,4647
STAT,1858,40,30-34,1898,0.8601302864933902
STAT,1849,26,50-100,1875,0.57273361640384
SIM,1813,47,na,1860,1329
STAT,1872,32,50-100,1904,0.8682134478269216
SIM,1888,66,na,1954,1848
STAT,1827,47,20-24,1874,0.010976227486541998
STAT,1903,42,45-49,1945,0.13952543631710862
STAT,1848,23,20-24,1871,61.90086240255914
STAT,1822,43,20-24,1865,0.22496284228205932
SIM,1762,92,na,1854,10
STAT,1872,46,20-24,1918,0.011403211690524774
SIM,1783,91,na,1874,7
STAT,1904,35,20-24,1939,0.22759676380726337
SIM,1799,75,na,1874,402
SIM,1894,66,na,1960,2193
STAT,1826,31,20-24,1857,3.9706481509067277
SIM,1850,27,35-39,1877,7
SIM,1879,29,30-34,1908,31
SIM,1893,46,50-100,1939,2
STAT,1860,104,na,1964,0.2418883284072456
STAT,1888,29,na,1917,2645.38643572817
STAT,1907,41,50-100,1948,0.10226738771078585
STAT,1952,1,na,1953,4585.0591650223
STAT,1848,23,na,1871,1920.5799401168877
STAT,1889,37,35-39,1926,8.248829062264504
STAT,1867,45,35-39,1912,0.1254290581336643
SIM,1910,22,40-44,1932,4
SIM,1940,31,50-100,1971,4
STAT,1916,28,40-44,1944,4.536793288695394
STAT,1854,23,na,1877,1784.5535993148317
STAT,1884,39,40-44,1923,4.044494171415912
STAT,1877,88,na,1965,299.4379231977241
STAT,1935,29,20-24,1964,23.482960615312642
SIM,1904,67,na,1971,2538
STAT,1851,29,35-39,1880,8.010534175532209
STAT,1825,34,40-44,1859,6.288943289301903
STAT,1833,24,na,1857,1737.870485359561
SIM,1833,34,40-44,1867,8
STAT,1856,89,na,1945,77.43261860230065
STAT,1885,46,50-100,1931,0.23192427236983498
STAT,1906,59,na,1965,2867.4590003715343
SIM,1829,30,35-39,1859,8
STAT,1934,36,45-49,1970,0.8895293960385554
STAT,1869,22,na,1891,2164.4675323307715
STAT,1785,83,na,1868,133.4001866270988
STAT,1879,17,20-24,1896,17.53126949520319
SIM,1778,76,na,1854,302
SIM,1873,67,na,1940,1492
STAT,1857,25,20-24,1882,9.133691227307963
STAT,1932,31,50-100,1963,1.0389096041519303
